PokerStars Hand #155012507516:  Hold'em No Limit ($0.50/$1.00 USD) - 2016/06/21 12:53:27 CET [2016/06/21 6:53:27 ET]
Table 'Umbriel II' 9-max Seat #4 is the button
Seat 3: mxustin ($39.25 in chips) 
Seat 4: DIMAN_324 ($109.42 in chips) 
Seat 5: matiko09 ($131.91 in chips) 
Seat 7: chenconhaste ($171.85 in chips) 
Seat 8: ozone2003 ($109.32 in chips) 
Seat 9: Troll8989 ($100 in chips) 
matiko09: posts small blind $0.50
chenconhaste: posts big blind $1
Avtovo: sits out 
rura53: sits out 
*** HOLE CARDS ***
Dealt to matiko09 [5d 8h]
ozone2003: folds 
Troll8989: folds 
mxustin: folds 
DIMAN_324: raises $1.10 to $2.10
matiko09: folds 
chenconhaste: folds 
Uncalled bet ($1.10) returned to DIMAN_324
DIMAN_324 collected $2.50 from pot
DIMAN_324: doesn't show hand 
*** SUMMARY ***
Total pot $2.50 | Rake $0 
Seat 3: mxustin folded before Flop (didn't bet)
Seat 4: DIMAN_324 (button) collected ($2.50)
Seat 5: matiko09 (small blind) folded before Flop
Seat 7: chenconhaste (big blind) folded before Flop
Seat 8: ozone2003 folded before Flop (didn't bet)
Seat 9: Troll8989 folded before Flop (didn't bet)





PokerStars Hand #155012510844:  Hold'em No Limit ($0.50/$1.00 USD) - 2016/06/21 12:53:35 CET [2016/06/21 6:53:35 ET]
Table 'Brauna II' 9-max Seat #1 is the button
Seat 1: wisbc ($103.32 in chips) 
Seat 2: pyromid ($149.47 in chips) 
Seat 3: matiko09 ($100 in chips) 
Seat 4: chenconhaste ($100 in chips) 
Seat 6: mbk88 ($174.01 in chips) 
Seat 8: DIMAN_324 ($132.65 in chips) 
Seat 9: torkkdnm ($100 in chips) 
pyromid: posts small blind $0.50
matiko09: posts big blind $1
fukumimi: sits out 
*** HOLE CARDS ***
Dealt to matiko09 [6h 7d]
chenconhaste: folds 
mbk88: folds 
DIMAN_324: folds 
torkkdnm: folds 
wisbc: folds 
pyromid: raises $1.50 to $2.50
matiko09: folds 
Uncalled bet ($1.50) returned to pyromid
pyromid collected $2 from pot
pyromid: doesn't show hand 
*** SUMMARY ***
Total pot $2 | Rake $0 
Seat 1: wisbc (button) folded before Flop (didn't bet)
Seat 2: pyromid (small blind) collected ($2)
Seat 3: matiko09 (big blind) folded before Flop
Seat 4: chenconhaste folded before Flop (didn't bet)
Seat 6: mbk88 folded before Flop (didn't bet)
Seat 8: DIMAN_324 folded before Flop (didn't bet)
Seat 9: torkkdnm folded before Flop (didn't bet)





PokerStars Hand #155012510604:  Hold'em No Limit ($0.50/$1.00 USD) - 2016/06/21 12:53:35 CET [2016/06/21 6:53:35 ET]
Table 'Moreau' 9-max Seat #1 is the button
Seat 1: 50CandyJoe ($105.47 in chips) 
Seat 2: nubpoker ($100 in chips) 
Seat 3: matiko09 ($100 in chips) 
Seat 4: bonesnz1 ($77.27 in chips) 
Seat 5: DIMAN_324 ($107.38 in chips) 
Seat 7: PanKwn15 ($44.78 in chips) 
nubpoker: posts small blind $0.50
matiko09: posts big blind $1
Toonersens: sits out 
*** HOLE CARDS ***
Dealt to matiko09 [6c Kd]
bonesnz1: folds 
DIMAN_324: folds 
PanKwn15: folds 
50CandyJoe: folds 
nubpoker: folds 
Uncalled bet ($0.50) returned to matiko09
matiko09 collected $1 from pot
matiko09: doesn't show hand 
*** SUMMARY ***
Total pot $1 | Rake $0 
Seat 1: 50CandyJoe (button) folded before Flop (didn't bet)
Seat 2: nubpoker (small blind) folded before Flop
Seat 3: matiko09 (big blind) collected ($1)
Seat 4: bonesnz1 folded before Flop (didn't bet)
Seat 5: DIMAN_324 folded before Flop (didn't bet)
Seat 7: PanKwn15 folded before Flop (didn't bet)





PokerStars Hand #155012513518:  Hold'em No Limit (€0.25/€0.50 EUR) - 2016/06/21 12:53:42 CET [2016/06/21 6:53:42 ET]
Table 'Lotis II' 6-max Seat #3 is the button
Seat 1: acaestanemo (€50 in chips) 
Seat 2: broh202 (€111.55 in chips) 
Seat 3: bricasse1961 (€25.98 in chips) 
Seat 4: matiko09 (€73.38 in chips) 
Seat 5: AlexPles (€50 in chips) 
Seat 6: patriot424 (€50.75 in chips) 
matiko09: posts small blind €0.25
AlexPles: posts big blind €0.50
*** HOLE CARDS ***
Dealt to matiko09 [Ad Jd]
patriot424: raises €1 to €1.50
acaestanemo: folds 
broh202: folds 
bricasse1961: folds 
matiko09: folds 
AlexPles: raises €3.75 to €5.25
patriot424: calls €3.75
*** FLOP *** [2c Ah 7h]
AlexPles: checks 
patriot424: bets €5
AlexPles: calls €5
*** TURN *** [2c Ah 7h] [7s]
AlexPles: checks 
patriot424: bets €9
AlexPles: calls €9
*** RIVER *** [2c Ah 7h 7s] [9s]
AlexPles: checks 
patriot424: bets €31.50 and is all-in
AlexPles: folds 
Uncalled bet (€31.50) returned to patriot424
patriot424 collected €36.95 from pot
patriot424: doesn't show hand 
*** SUMMARY ***
Total pot €38.75 | Rake €1.80 
Board [2c Ah 7h 7s 9s]
Seat 1: acaestanemo folded before Flop (didn't bet)
Seat 2: broh202 folded before Flop (didn't bet)
Seat 3: bricasse1961 (button) folded before Flop (didn't bet)
Seat 4: matiko09 (small blind) folded before Flop
Seat 5: AlexPles (big blind) folded on the River
Seat 6: patriot424 collected (€36.95)





PokerStars Hand #155012513744:  Hold'em No Limit ($0.50/$1.00 USD) - 2016/06/21 12:53:42 CET [2016/06/21 6:53:42 ET]
Table 'Umbriel II' 9-max Seat #5 is the button
Seat 3: mxustin ($39.25 in chips) 
Seat 4: DIMAN_324 ($110.92 in chips) 
Seat 5: matiko09 ($131.41 in chips) 
Seat 7: chenconhaste ($170.85 in chips) 
Seat 8: ozone2003 ($109.32 in chips) 
Seat 9: Troll8989 ($100 in chips) 
chenconhaste: posts small blind $0.50
ozone2003: posts big blind $1
Avtovo: sits out 
rura53: sits out 
*** HOLE CARDS ***
Dealt to matiko09 [Kc 7d]
Troll8989: raises $1.50 to $2.50
mxustin: folds 
DIMAN_324: folds 
matiko09: folds 
chenconhaste: folds 
ozone2003: folds 
Uncalled bet ($1.50) returned to Troll8989
Troll8989 collected $2.50 from pot
Troll8989: doesn't show hand 
*** SUMMARY ***
Total pot $2.50 | Rake $0 
Seat 3: mxustin folded before Flop (didn't bet)
Seat 4: DIMAN_324 folded before Flop (didn't bet)
Seat 5: matiko09 (button) folded before Flop (didn't bet)
Seat 7: chenconhaste (small blind) folded before Flop
Seat 8: ozone2003 (big blind) folded before Flop
Seat 9: Troll8989 collected ($2.50)





PokerStars Hand #155012515018:  Hold'em No Limit ($0.50/$1.00 USD) - 2016/06/21 12:53:45 CET [2016/06/21 6:53:45 ET]
Table 'Carlova II' 9-max Seat #1 is the button
Seat 1: matiko09 ($132.55 in chips) 
Seat 2: chenconhaste ($129.58 in chips) 
Seat 3: King_Z�Manel ($101.50 in chips) 
Seat 4: Dandy Monk ($48.65 in chips) 
Seat 6: DIMAN_324 ($100 in chips) 
Seat 7: mi$$I$Elena ($101.50 in chips) 
Seat 8: pyromid ($87.52 in chips) 
Seat 9: Troll8989 ($105.50 in chips) 
chenconhaste: posts small blind $0.50
King_Z�Manel: posts big blind $1
ozone2003: sits out 
*** HOLE CARDS ***
Dealt to matiko09 [Qs 3d]
Dandy Monk has timed out
Dandy Monk: folds 
DIMAN_324: folds 
mi$$I$Elena: raises $1.38 to $2.38
pyromid: calls $2.38
Troll8989: folds 
matiko09: folds 
chenconhaste: folds 
King_Z�Manel: folds 
*** FLOP *** [7h Tc 7s]
mi$$I$Elena: checks 
pyromid: bets $3.50
mi$$I$Elena: folds 
Uncalled bet ($3.50) returned to pyromid
pyromid collected $5.95 from pot
pyromid: doesn't show hand 
*** SUMMARY ***
Total pot $6.26 | Rake $0.31 
Board [7h Tc 7s]
Seat 1: matiko09 (button) folded before Flop (didn't bet)
Seat 2: chenconhaste (small blind) folded before Flop
Seat 3: King_Z�Manel (big blind) folded before Flop
Seat 4: Dandy Monk folded before Flop (didn't bet)
Seat 6: DIMAN_324 folded before Flop (didn't bet)
Seat 7: mi$$I$Elena folded on the Flop
Seat 8: pyromid collected ($5.95)
Seat 9: Troll8989 folded before Flop (didn't bet)





PokerStars Hand #155012515895:  Hold'em No Limit ($0.50/$1.00 USD) - 2016/06/21 12:53:48 CET [2016/06/21 6:53:48 ET]
Table 'Moreau' 9-max Seat #2 is the button
Seat 1: 50CandyJoe ($105.47 in chips) 
Seat 2: nubpoker ($100 in chips) 
Seat 3: matiko09 ($100.50 in chips) 
Seat 4: bonesnz1 ($77.27 in chips) 
Seat 5: DIMAN_324 ($107.38 in chips) 
Seat 7: PanKwn15 ($44.78 in chips) 
matiko09: posts small blind $0.50
bonesnz1: posts big blind $1
Toonersens: sits out 
*** HOLE CARDS ***
Dealt to matiko09 [8c 8h]
DIMAN_324: folds 
PanKwn15: folds 
50CandyJoe: folds 
nubpoker: raises $1.50 to $2.50
matiko09: raises $6.50 to $9
bonesnz1: folds 
nubpoker: calls $6.50
*** FLOP *** [9c 3c Qh]
matiko09: checks 
nubpoker: bets $10
matiko09: folds 
Uncalled bet ($10) returned to nubpoker
nubpoker collected $18.05 from pot
nubpoker: doesn't show hand 
*** SUMMARY ***
Total pot $19 | Rake $0.95 
Board [9c 3c Qh]
Seat 1: 50CandyJoe folded before Flop (didn't bet)
Seat 2: nubpoker (button) collected ($18.05)
Seat 3: matiko09 (small blind) folded on the Flop
Seat 4: bonesnz1 (big blind) folded before Flop
Seat 5: DIMAN_324 folded before Flop (didn't bet)
Seat 7: PanKwn15 folded before Flop (didn't bet)





PokerStars Hand #155012516216:  Hold'em No Limit ($0.50/$1.00 USD) - 2016/06/21 12:53:49 CET [2016/06/21 6:53:49 ET]
Table 'Pyxis' 9-max Seat #2 is the button
Seat 1: ntoperman19 ($105 in chips) 
Seat 2: 50CandyJoe ($101.90 in chips) 
Seat 3: Avtovo ($100 in chips) 
Seat 5: matiko09 ($100 in chips) 
Avtovo: posts small blind $0.50
matiko09: posts big blind $1
Troll8989 joins the table at seat #4 
ozone2003: sits out 
*** HOLE CARDS ***
Dealt to matiko09 [7h 3h]
ntoperman19: folds 
50CandyJoe: folds 
Avtovo: raises $1.50 to $2.50
matiko09: folds 
Uncalled bet ($1.50) returned to Avtovo
Avtovo collected $2 from pot
Avtovo: doesn't show hand 
*** SUMMARY ***
Total pot $2 | Rake $0 
Seat 1: ntoperman19 folded before Flop (didn't bet)
Seat 2: 50CandyJoe (button) folded before Flop (didn't bet)
Seat 3: Avtovo (small blind) collected ($2)
Seat 5: matiko09 (big blind) folded before Flop





PokerStars Hand #155012518240:  Hold'em No Limit (€0.25/€0.50 EUR) - 2016/06/21 12:53:54 CET [2016/06/21 6:53:54 ET]
Table 'Actor II' 6-max Seat #6 is the button
Seat 1: hmverlin (€82.77 in chips) 
Seat 2: ooak182 (€51.09 in chips) 
Seat 3: asmodej666 (€55.71 in chips) 
Seat 4: matiko09 (€50 in chips) 
Seat 5: Rybka1294 (€50 in chips) 
Seat 6: fanmtZ (€21.68 in chips) 
hmverlin: posts small blind €0.25
ooak182: posts big blind €0.50
*** HOLE CARDS ***
Dealt to matiko09 [Qs 2c]
asmodej666: folds 
matiko09: folds 
Rybka1294: folds 
fanmtZ: folds 
hmverlin: folds 
Uncalled bet (€0.25) returned to ooak182
ooak182 collected €0.50 from pot
ooak182: doesn't show hand 
*** SUMMARY ***
Total pot €0.50 | Rake €0 
Seat 1: hmverlin (small blind) folded before Flop
Seat 2: ooak182 (big blind) collected (€0.50)
Seat 3: asmodej666 folded before Flop (didn't bet)
Seat 4: matiko09 folded before Flop (didn't bet)
Seat 5: Rybka1294 folded before Flop (didn't bet)
Seat 6: fanmtZ (button) folded before Flop (didn't bet)





PokerStars Hand #155012520696:  Hold'em No Limit ($0.50/$1.00 USD) - 2016/06/21 12:54:00 CET [2016/06/21 6:54:00 ET]
Table 'Umbriel II' 9-max Seat #7 is the button
Seat 3: mxustin ($39.25 in chips) 
Seat 4: DIMAN_324 ($110.92 in chips) 
Seat 5: matiko09 ($131.41 in chips) 
Seat 7: chenconhaste ($170.35 in chips) 
Seat 8: ozone2003 ($108.32 in chips) 
Seat 9: Troll8989 ($101.50 in chips) 
ozone2003: posts small blind $0.50
Troll8989: posts big blind $1
Avtovo: sits out 
rura53: sits out 
*** HOLE CARDS ***
Dealt to matiko09 [4d Qc]
mxustin: folds 
DIMAN_324: folds 
matiko09: folds 
chenconhaste: raises $1.25 to $2.25
ozone2003: folds 
Troll8989: calls $1.25
*** FLOP *** [Jd Jc 7c]
Troll8989: checks 
chenconhaste: bets $2
Troll8989: folds 
Uncalled bet ($2) returned to chenconhaste
chenconhaste collected $4.75 from pot
*** SUMMARY ***
Total pot $5 | Rake $0.25 
Board [Jd Jc 7c]
Seat 3: mxustin folded before Flop (didn't bet)
Seat 4: DIMAN_324 folded before Flop (didn't bet)
Seat 5: matiko09 folded before Flop (didn't bet)
Seat 7: chenconhaste (button) collected ($4.75)
Seat 8: ozone2003 (small blind) folded before Flop
Seat 9: Troll8989 (big blind) folded on the Flop





PokerStars Hand #155012520836:  Hold'em No Limit ($0.50/$1.00 USD) - 2016/06/21 12:54:00 CET [2016/06/21 6:54:00 ET]
Table 'Chimay' 9-max Seat #4 is the button
Seat 1: chenconhaste ($116.05 in chips) 
Seat 2: DIMAN_324 ($131.27 in chips) 
Seat 3: Yuder_Lin ($47.12 in chips) 
Seat 4: fukumimi ($106 in chips) 
Seat 5: SooperGloo ($45.78 in chips) 
Seat 6: mbk88 ($113.17 in chips) 
Seat 8: matiko09 ($101.50 in chips) 
SooperGloo: posts small blind $0.50
mbk88: posts big blind $1
Troll8989: sits out 
SharingaaN: sits out 
*** HOLE CARDS ***
Dealt to matiko09 [2c 4d]
matiko09: folds 
chenconhaste: folds 
DIMAN_324: raises $2 to $3
Yuder_Lin: calls $3
fukumimi: folds 
SooperGloo: calls $2.50
mbk88: folds 
*** FLOP *** [7s 2d Jd]
SooperGloo: checks 
DIMAN_324: bets $7.12
Yuder_Lin: folds 
SooperGloo: folds 
Uncalled bet ($7.12) returned to DIMAN_324
DIMAN_324 collected $9.50 from pot
DIMAN_324: doesn't show hand 
*** SUMMARY ***
Total pot $10 | Rake $0.50 
Board [7s 2d Jd]
Seat 1: chenconhaste folded before Flop (didn't bet)
Seat 2: DIMAN_324 collected ($9.50)
Seat 3: Yuder_Lin folded on the Flop
Seat 4: fukumimi (button) folded before Flop (didn't bet)
Seat 5: SooperGloo (small blind) folded on the Flop
Seat 6: mbk88 (big blind) folded before Flop
Seat 8: matiko09 folded before Flop (didn't bet)





PokerStars Hand #155012522585:  Hold'em No Limit (€0.25/€0.50 EUR) - 2016/06/21 12:54:04 CET [2016/06/21 6:54:04 ET]
Table 'Actor II' 6-max Seat #1 is the button
Seat 1: hmverlin (€82.52 in chips) 
Seat 2: ooak182 (€51.34 in chips) 
Seat 3: asmodej666 (€55.71 in chips) 
Seat 4: matiko09 (€50 in chips) 
Seat 5: Rybka1294 (€50 in chips) 
Seat 6: fanmtZ (€21.68 in chips) 
ooak182: posts small blind €0.25
asmodej666: posts big blind €0.50
*** HOLE CARDS ***
Dealt to matiko09 [3h Qd]
matiko09: folds 
Rybka1294: folds 
fanmtZ: folds 
hmverlin: raises €1 to €1.50
ooak182: folds 
asmodej666: calls €1
*** FLOP *** [Ac 2d 6h]
asmodej666: checks 
hmverlin: bets €1.50
asmodej666: folds 
Uncalled bet (€1.50) returned to hmverlin
hmverlin collected €3.09 from pot
hmverlin: doesn't show hand 
*** SUMMARY ***
Total pot €3.25 | Rake €0.16 
Board [Ac 2d 6h]
Seat 1: hmverlin (button) collected (€3.09)
Seat 2: ooak182 (small blind) folded before Flop
Seat 3: asmodej666 (big blind) folded on the Flop
Seat 4: matiko09 folded before Flop (didn't bet)
Seat 5: Rybka1294 folded before Flop (didn't bet)
Seat 6: fanmtZ folded before Flop (didn't bet)





PokerStars Hand #155012523757:  Hold'em No Limit ($0.50/$1.00 USD) - 2016/06/21 12:54:07 CET [2016/06/21 6:54:07 ET]
Table 'Pyxis' 9-max Seat #3 is the button
Seat 1: ntoperman19 ($105 in chips) 
Seat 2: 50CandyJoe ($101.90 in chips) 
Seat 3: Avtovo ($101 in chips) 
Seat 5: matiko09 ($100 in chips) 
Seat 6: ozone2003 ($100 in chips) 
Troll8989 will be allowed to play after the button
matiko09: posts small blind $0.50
ozone2003: posts big blind $1
*** HOLE CARDS ***
Dealt to matiko09 [5s 9d]
ntoperman19: folds 
50CandyJoe: raises $1 to $2
Avtovo: folds 
matiko09: folds 
ozone2003: calls $1
*** FLOP *** [6c Kh Ts]
ozone2003: checks 
50CandyJoe: bets $3.21
ozone2003: folds 
Uncalled bet ($3.21) returned to 50CandyJoe
50CandyJoe collected $4.28 from pot
50CandyJoe: doesn't show hand 
*** SUMMARY ***
Total pot $4.50 | Rake $0.22 
Board [6c Kh Ts]
Seat 1: ntoperman19 folded before Flop (didn't bet)
Seat 2: 50CandyJoe collected ($4.28)
Seat 3: Avtovo (button) folded before Flop (didn't bet)
Seat 5: matiko09 (small blind) folded before Flop
Seat 6: ozone2003 (big blind) folded on the Flop





PokerStars Hand #155012525918:  Hold'em No Limit ($0.50/$1.00 USD) - 2016/06/21 12:54:13 CET [2016/06/21 6:54:13 ET]
Table 'Brauna II' 9-max Seat #2 is the button
Seat 1: wisbc ($103.32 in chips) 
Seat 2: pyromid ($150.47 in chips) 
Seat 3: matiko09 ($100 in chips) 
Seat 4: chenconhaste ($100 in chips) 
Seat 6: mbk88 ($174.01 in chips) 
Seat 8: DIMAN_324 ($132.65 in chips) 
Seat 9: torkkdnm ($100 in chips) 
matiko09: posts small blind $0.50
chenconhaste: posts big blind $1
fukumimi: sits out 
*** HOLE CARDS ***
Dealt to matiko09 [Ah Ts]
mbk88: folds 
DIMAN_324: folds 
torkkdnm: raises $2 to $3
wisbc: folds 
pyromid: folds 
matiko09: folds 
chenconhaste: folds 
Uncalled bet ($2) returned to torkkdnm
torkkdnm collected $2.50 from pot
*** SUMMARY ***
Total pot $2.50 | Rake $0 
Seat 1: wisbc folded before Flop (didn't bet)
Seat 2: pyromid (button) folded before Flop (didn't bet)
Seat 3: matiko09 (small blind) folded before Flop
Seat 4: chenconhaste (big blind) folded before Flop
Seat 6: mbk88 folded before Flop (didn't bet)
Seat 8: DIMAN_324 folded before Flop (didn't bet)
Seat 9: torkkdnm collected ($2.50)





PokerStars Hand #155012527550:  Hold'em No Limit ($0.50/$1.00 USD) - 2016/06/21 12:54:17 CET [2016/06/21 6:54:17 ET]
Table 'Feronia' 9-max Seat #8 is the button
Seat 1: DIMAN_324 ($100 in chips) 
Seat 2: Yuder_Lin ($98 in chips) 
Seat 3: mbk88 ($107.85 in chips) 
Seat 4: pyromid ($122.94 in chips) 
Seat 5: matiko09 ($115.39 in chips) 
Seat 6: chenconhaste ($120.45 in chips) 
Seat 7: arctur17 ($101.45 in chips) 
Seat 8: letmegonow ($181.91 in chips) 
Seat 9: mi$$I$Elena ($121.04 in chips) 
mi$$I$Elena: posts small blind $0.50
DIMAN_324: posts big blind $1
*** HOLE CARDS ***
Dealt to matiko09 [3c Jh]
Yuder_Lin: folds 
mbk88: raises $2 to $3
pyromid: folds 
matiko09: folds 
chenconhaste: folds 
arctur17: folds 
letmegonow: calls $3
mi$$I$Elena: folds 
DIMAN_324: folds 
*** FLOP *** [Ks 2h 7h]
mbk88: bets $5
letmegonow: raises $5 to $10
mbk88: calls $5
*** TURN *** [Ks 2h 7h] [5h]
mbk88: checks 
letmegonow: checks 
*** RIVER *** [Ks 2h 7h 5h] [8c]
mbk88: bets $26
letmegonow: calls $26
*** SHOW DOWN ***
mbk88: shows [Ah 4h] (a flush, Ace high)
letmegonow: mucks hand 
mbk88 collected $77 from pot
*** SUMMARY ***
Total pot $79.50 | Rake $2.50 
Board [Ks 2h 7h 5h 8c]
Seat 1: DIMAN_324 (big blind) folded before Flop
Seat 2: Yuder_Lin folded before Flop (didn't bet)
Seat 3: mbk88 showed [Ah 4h] and won ($77) with a flush, Ace high
Seat 4: pyromid folded before Flop (didn't bet)
Seat 5: matiko09 folded before Flop (didn't bet)
Seat 6: chenconhaste folded before Flop (didn't bet)
Seat 7: arctur17 folded before Flop (didn't bet)
Seat 8: letmegonow (button) mucked [Qc Kh]
Seat 9: mi$$I$Elena (small blind) folded before Flop





PokerStars Hand #155012533341:  Hold'em No Limit ($0.50/$1.00 USD) - 2016/06/21 12:54:31 CET [2016/06/21 6:54:31 ET]
Table 'Rupertwildt' 9-max Seat #1 is the button
Seat 1: pokernixxx ($79.85 in chips) 
Seat 2: SharingaaN ($57.85 in chips) 
Seat 3: Saymon_Moo ($78.42 in chips) 
Seat 4: matiko09 ($127.92 in chips) 
Seat 5: pyromid ($94.46 in chips) 
Seat 6: ozone2003 ($101.50 in chips) 
Seat 7: chenconhaste ($103.84 in chips) 
Seat 8: Gonzanary ($118.14 in chips) 
Seat 9: mbk88 ($122.93 in chips) 
SharingaaN: posts small blind $0.50
Saymon_Moo: posts big blind $1
*** HOLE CARDS ***
Dealt to matiko09 [5h 5s]
matiko09: raises $2 to $3
pyromid: folds 
ozone2003: calls $3
chenconhaste: folds 
Gonzanary: folds 
mbk88: folds 
pokernixxx: folds 
SharingaaN: calls $2.50
Saymon_Moo: folds 
*** FLOP *** [5c 9d 2c]
SharingaaN: checks 
matiko09: bets $6.50
ozone2003: folds 
SharingaaN: folds 
Uncalled bet ($6.50) returned to matiko09
matiko09 collected $9.50 from pot
matiko09: doesn't show hand 
*** SUMMARY ***
Total pot $10 | Rake $0.50 
Board [5c 9d 2c]
Seat 1: pokernixxx (button) folded before Flop (didn't bet)
Seat 2: SharingaaN (small blind) folded on the Flop
Seat 3: Saymon_Moo (big blind) folded before Flop
Seat 4: matiko09 collected ($9.50)
Seat 5: pyromid folded before Flop (didn't bet)
Seat 6: ozone2003 folded on the Flop
Seat 7: chenconhaste folded before Flop (didn't bet)
Seat 8: Gonzanary folded before Flop (didn't bet)
Seat 9: mbk88 folded before Flop (didn't bet)





PokerStars Hand #155012534086:  Hold'em No Limit ($0.50/$1.00 USD) - 2016/06/21 12:54:33 CET [2016/06/21 6:54:33 ET]
Table 'Pyxis' 9-max Seat #5 is the button
Seat 1: ntoperman19 ($105 in chips) 
Seat 2: 50CandyJoe ($104.18 in chips) 
Seat 3: Avtovo ($101 in chips) 
Seat 5: matiko09 ($100 in chips) 
Seat 6: ozone2003 ($100 in chips) 
ozone2003: posts small blind $0.50
ntoperman19: posts big blind $1
Troll8989: sits out 
*** HOLE CARDS ***
Dealt to matiko09 [6s 8d]
50CandyJoe: raises $2 to $3
Avtovo: folds 
matiko09: folds 
ozone2003: folds 
ntoperman19: folds 
Uncalled bet ($2) returned to 50CandyJoe
50CandyJoe collected $2.50 from pot
50CandyJoe: doesn't show hand 
*** SUMMARY ***
Total pot $2.50 | Rake $0 
Seat 1: ntoperman19 (big blind) folded before Flop
Seat 2: 50CandyJoe collected ($2.50)
Seat 3: Avtovo folded before Flop (didn't bet)
Seat 5: matiko09 (button) folded before Flop (didn't bet)
Seat 6: ozone2003 (small blind) folded before Flop





PokerStars Hand #155012535895:  Hold'em No Limit (€0.25/€0.50 EUR) - 2016/06/21 12:54:38 CET [2016/06/21 6:54:38 ET]
Table 'Actor II' 6-max Seat #2 is the button
Seat 1: hmverlin (€84.11 in chips) 
Seat 2: ooak182 (€51.09 in chips) 
Seat 3: asmodej666 (€54.21 in chips) 
Seat 4: matiko09 (€50 in chips) 
Seat 5: Rybka1294 (€50 in chips) 
Seat 6: fanmtZ (€21.68 in chips) 
asmodej666: posts small blind €0.25
matiko09: posts big blind €0.50
*** HOLE CARDS ***
Dealt to matiko09 [9h 6c]
Rybka1294: folds 
fanmtZ: folds 
hmverlin: folds 
ooak182: folds 
asmodej666: folds 
Uncalled bet (€0.25) returned to matiko09
matiko09 collected €0.50 from pot
matiko09: doesn't show hand 
*** SUMMARY ***
Total pot €0.50 | Rake €0 
Seat 1: hmverlin folded before Flop (didn't bet)
Seat 2: ooak182 (button) folded before Flop (didn't bet)
Seat 3: asmodej666 (small blind) folded before Flop
Seat 4: matiko09 (big blind) collected (€0.50)
Seat 5: Rybka1294 folded before Flop (didn't bet)
Seat 6: fanmtZ folded before Flop (didn't bet)





PokerStars Hand #155012536353:  Hold'em No Limit ($0.50/$1.00 USD) - 2016/06/21 12:54:39 CET [2016/06/21 6:54:39 ET]
Table 'Leo' 9-max Seat #1 is the button
Seat 1: letmegonow ($80.79 in chips) 
Seat 2: torkkdnm ($144.46 in chips) 
Seat 3: matiko09 ($102.50 in chips) 
Seat 4: SharingaaN ($78 in chips) 
Seat 5: DIMAN_324 ($105 in chips) 
Seat 6: chenconhaste ($126.67 in chips) 
Seat 8: pyromid ($65.17 in chips) 
Seat 9: Wladimir205 ($100 in chips) 
torkkdnm: posts small blind $0.50
matiko09: posts big blind $1
*** HOLE CARDS ***
Dealt to matiko09 [8s Jc]
SharingaaN: folds 
DIMAN_324: folds 
chenconhaste: folds 
pyromid: folds 
Wladimir205: folds 
letmegonow: folds 
torkkdnm: raises $1 to $2
matiko09: calls $1
*** FLOP *** [4s 5c 8d]
torkkdnm: checks 
matiko09: bets $1.97
torkkdnm: folds 
Uncalled bet ($1.97) returned to matiko09
matiko09 collected $3.80 from pot
matiko09: doesn't show hand 
*** SUMMARY ***
Total pot $4 | Rake $0.20 
Board [4s 5c 8d]
Seat 1: letmegonow (button) folded before Flop (didn't bet)
Seat 2: torkkdnm (small blind) folded on the Flop
Seat 3: matiko09 (big blind) collected ($3.80)
Seat 4: SharingaaN folded before Flop (didn't bet)
Seat 5: DIMAN_324 folded before Flop (didn't bet)
Seat 6: chenconhaste folded before Flop (didn't bet)
Seat 8: pyromid folded before Flop (didn't bet)
Seat 9: Wladimir205 folded before Flop (didn't bet)





PokerStars Hand #155012537608:  Hold'em No Limit ($0.50/$1.00 USD) - 2016/06/21 12:54:42 CET [2016/06/21 6:54:42 ET]
Table 'Brauna II' 9-max Seat #3 is the button
Seat 1: wisbc ($103.32 in chips) 
Seat 2: pyromid ($150.47 in chips) 
Seat 3: matiko09 ($100 in chips) 
Seat 4: chenconhaste ($100 in chips) 
Seat 5: fukumimi ($100 in chips) 
Seat 6: mbk88 ($174.01 in chips) 
Seat 8: DIMAN_324 ($132.65 in chips) 
Seat 9: torkkdnm ($101.50 in chips) 
chenconhaste: posts small blind $0.50
fukumimi: posts big blind $1
*** HOLE CARDS ***
Dealt to matiko09 [8c Kd]
mbk88: folds 
DIMAN_324: folds 
torkkdnm: folds 
wisbc: calls $1
pyromid: calls $1
matiko09: folds 
chenconhaste: calls $0.50
fukumimi: checks 
*** FLOP *** [Ks 2c Ah]
chenconhaste: checks 
fukumimi: checks 
wisbc: checks 
pyromid: bets $2
chenconhaste: folds 
fukumimi: folds 
wisbc: folds 
Uncalled bet ($2) returned to pyromid
pyromid collected $3.80 from pot
pyromid: doesn't show hand 
*** SUMMARY ***
Total pot $4 | Rake $0.20 
Board [Ks 2c Ah]
Seat 1: wisbc folded on the Flop
Seat 2: pyromid collected ($3.80)
Seat 3: matiko09 (button) folded before Flop (didn't bet)
Seat 4: chenconhaste (small blind) folded on the Flop
Seat 5: fukumimi (big blind) folded on the Flop
Seat 6: mbk88 folded before Flop (didn't bet)
Seat 8: DIMAN_324 folded before Flop (didn't bet)
Seat 9: torkkdnm folded before Flop (didn't bet)





PokerStars Hand #155012539091:  Hold'em No Limit ($0.50/$1.00 USD) - 2016/06/21 12:54:45 CET [2016/06/21 6:54:45 ET]
Table 'Chimay' 9-max Seat #5 is the button
Seat 1: chenconhaste ($116.05 in chips) 
Seat 2: DIMAN_324 ($137.77 in chips) 
Seat 3: Yuder_Lin ($44.12 in chips) 
Seat 4: fukumimi ($106 in chips) 
Seat 5: SooperGloo ($42.78 in chips) 
Seat 6: mbk88 ($112.17 in chips) 
Seat 7: Troll8989 ($100 in chips) 
Seat 8: matiko09 ($101.50 in chips) 
mbk88: posts small blind $0.50
Troll8989: posts big blind $1
SharingaaN: sits out 
*** HOLE CARDS ***
Dealt to matiko09 [9h 9c]
matiko09: raises $2 to $3
chenconhaste: folds 
DIMAN_324: folds 
Yuder_Lin: calls $3
fukumimi: folds 
SooperGloo: folds 
SooperGloo leaves the table
mbk88: folds 
Avtovo joins the table at seat #5 
Troll8989: folds 
*** FLOP *** [Ad 7d 3h]
matiko09: checks 
Yuder_Lin: checks 
*** TURN *** [Ad 7d 3h] [5d]
matiko09: bets $4
Yuder_Lin: folds 
Uncalled bet ($4) returned to matiko09
matiko09 collected $7.12 from pot
matiko09: doesn't show hand 
*** SUMMARY ***
Total pot $7.50 | Rake $0.38 
Board [Ad 7d 3h 5d]
Seat 1: chenconhaste folded before Flop (didn't bet)
Seat 2: DIMAN_324 folded before Flop (didn't bet)
Seat 3: Yuder_Lin folded on the Turn
Seat 4: fukumimi folded before Flop (didn't bet)
Seat 5: SooperGloo (button) folded before Flop (didn't bet)
Seat 6: mbk88 (small blind) folded before Flop
Seat 7: Troll8989 (big blind) folded before Flop
Seat 8: matiko09 collected ($7.12)





PokerStars Hand #155012541104:  Hold'em No Limit (€0.25/€0.50 EUR) - 2016/06/21 12:54:50 CET [2016/06/21 6:54:50 ET]
Table 'Actor II' 6-max Seat #3 is the button
Seat 1: hmverlin (€84.11 in chips) 
Seat 2: ooak182 (€51.09 in chips) 
Seat 3: asmodej666 (€53.96 in chips) 
Seat 4: matiko09 (€50.25 in chips) 
Seat 5: Rybka1294 (€50 in chips) 
Seat 6: fanmtZ (€21.68 in chips) 
matiko09: posts small blind €0.25
Rybka1294: posts big blind €0.50
*** HOLE CARDS ***
Dealt to matiko09 [Th Qd]
fanmtZ: folds 
hmverlin: raises €1 to €1.50
ooak182: folds 
asmodej666: folds 
matiko09: folds 
Rybka1294: folds 
Uncalled bet (€1) returned to hmverlin
hmverlin collected €1.25 from pot
hmverlin: doesn't show hand 
*** SUMMARY ***
Total pot €1.25 | Rake €0 
Seat 1: hmverlin collected (€1.25)
Seat 2: ooak182 folded before Flop (didn't bet)
Seat 3: asmodej666 (button) folded before Flop (didn't bet)
Seat 4: matiko09 (small blind) folded before Flop
Seat 5: Rybka1294 (big blind) folded before Flop
Seat 6: fanmtZ folded before Flop (didn't bet)





PokerStars Hand #155012542763:  Hold'em No Limit ($0.50/$1.00 USD) - 2016/06/21 12:54:55 CET [2016/06/21 6:54:55 ET]
Table 'Moreau' 9-max Seat #3 is the button
Seat 1: 50CandyJoe ($105.47 in chips) 
Seat 2: nubpoker ($109.05 in chips) 
Seat 3: matiko09 ($100 in chips) 
Seat 4: bonesnz1 ($76.27 in chips) 
Seat 5: DIMAN_324 ($107.38 in chips) 
Seat 7: PanKwn15 ($44.78 in chips) 
bonesnz1: posts small blind $0.50
DIMAN_324: posts big blind $1
mbk88: sits out 
Toonersens: sits out 
*** HOLE CARDS ***
Dealt to matiko09 [2d Qs]
PanKwn15: folds 
50CandyJoe: folds 
nubpoker: raises $1.50 to $2.50
matiko09: folds 
bonesnz1: folds 
DIMAN_324: folds 
Uncalled bet ($1.50) returned to nubpoker
nubpoker collected $2.50 from pot
nubpoker: doesn't show hand 
*** SUMMARY ***
Total pot $2.50 | Rake $0 
Seat 1: 50CandyJoe folded before Flop (didn't bet)
Seat 2: nubpoker collected ($2.50)
Seat 3: matiko09 (button) folded before Flop (didn't bet)
Seat 4: bonesnz1 (small blind) folded before Flop
Seat 5: DIMAN_324 (big blind) folded before Flop
Seat 7: PanKwn15 folded before Flop (didn't bet)





PokerStars Hand #155012544704:  Hold'em No Limit ($0.50/$1.00 USD) - 2016/06/21 12:54:59 CET [2016/06/21 6:54:59 ET]
Table 'Carlova II' 9-max Seat #2 is the button
Seat 1: matiko09 ($132.55 in chips) 
Seat 2: chenconhaste ($129.08 in chips) 
Seat 3: King_Z�Manel ($100.50 in chips) 
Seat 4: Dandy Monk ($48.65 in chips) 
Seat 6: DIMAN_324 ($100 in chips) 
Seat 7: mi$$I$Elena ($100 in chips) 
Seat 8: pyromid ($91.09 in chips) 
Seat 9: Troll8989 ($105.50 in chips) 
King_Z�Manel: posts small blind $0.50
Dandy Monk: posts big blind $1
ozone2003: sits out 
*** HOLE CARDS ***
Dealt to matiko09 [Js 4c]
DIMAN_324: folds 
mi$$I$Elena: folds 
pyromid: folds 
Troll8989: folds 
matiko09: folds 
chenconhaste: folds 
King_Z�Manel: raises $2 to $3
Dandy Monk: calls $2
*** FLOP *** [Ah 3c 7h]
King_Z�Manel: bets $2.85
Dandy Monk: folds 
Uncalled bet ($2.85) returned to King_Z�Manel
King_Z�Manel collected $5.70 from pot
King_Z�Manel: doesn't show hand 
*** SUMMARY ***
Total pot $6 | Rake $0.30 
Board [Ah 3c 7h]
Seat 1: matiko09 folded before Flop (didn't bet)
Seat 2: chenconhaste (button) folded before Flop (didn't bet)
Seat 3: King_Z�Manel (small blind) collected ($5.70)
Seat 4: Dandy Monk (big blind) folded on the Flop
Seat 6: DIMAN_324 folded before Flop (didn't bet)
Seat 7: mi$$I$Elena folded before Flop (didn't bet)
Seat 8: pyromid folded before Flop (didn't bet)
Seat 9: Troll8989 folded before Flop (didn't bet)





PokerStars Hand #155012545458:  Hold'em No Limit ($0.50/$1.00 USD) - 2016/06/21 12:55:01 CET [2016/06/21 6:55:01 ET]
Table 'Pyxis' 9-max Seat #6 is the button
Seat 1: ntoperman19 ($104 in chips) 
Seat 2: 50CandyJoe ($105.68 in chips) 
Seat 3: Avtovo ($101 in chips) 
Seat 5: matiko09 ($100 in chips) 
Seat 6: ozone2003 ($100 in chips) 
ntoperman19: posts small blind $0.50
50CandyJoe: posts big blind $1
Troll8989: sits out 
*** HOLE CARDS ***
Dealt to matiko09 [Qh Qs]
Avtovo: folds 
matiko09: raises $1.50 to $2.50
ozone2003: calls $2.50
ntoperman19: folds 
50CandyJoe: folds 
*** FLOP *** [Qc 5h 7d]
mbk88 leaves the table
matiko09: checks 
ozone2003: checks 
*** TURN *** [Qc 5h 7d] [7h]
matiko09: checks 
ozone2003: bets $4.89
matiko09: calls $4.89
*** RIVER *** [Qc 5h 7d 7h] [Jc]
matiko09: checks 
ozone2003: bets $9.75
matiko09: raises $22.73 to $32.48
ozone2003: folds 
Uncalled bet ($22.73) returned to matiko09
matiko09 collected $33.99 from pot
matiko09: doesn't show hand 
*** SUMMARY ***
Total pot $35.78 | Rake $1.79 
Board [Qc 5h 7d 7h Jc]
Seat 1: ntoperman19 (small blind) folded before Flop
Seat 2: 50CandyJoe (big blind) folded before Flop
Seat 3: Avtovo folded before Flop (didn't bet)
Seat 5: matiko09 collected ($33.99)
Seat 6: ozone2003 (button) folded on the River





PokerStars Hand #155012549448:  Hold'em No Limit ($0.50/$1.00 USD) - 2016/06/21 12:55:11 CET [2016/06/21 6:55:11 ET]
Table 'Umbriel II' 9-max Seat #8 is the button
Seat 1: Avtovo ($100 in chips) 
Seat 3: mxustin ($39.25 in chips) 
Seat 4: DIMAN_324 ($110.92 in chips) 
Seat 5: matiko09 ($131.41 in chips) 
Seat 7: chenconhaste ($172.85 in chips) 
Seat 8: ozone2003 ($107.82 in chips) 
Seat 9: Troll8989 ($100 in chips) 
Troll8989: posts small blind $0.50
Avtovo: posts big blind $1
rura53: sits out 
*** HOLE CARDS ***
Dealt to matiko09 [Ad 3c]
mxustin: folds 
DIMAN_324: raises $2 to $3
matiko09: folds 
chenconhaste: folds 
ozone2003: folds 
Troll8989: folds 
Avtovo: folds 
Uncalled bet ($2) returned to DIMAN_324
DIMAN_324 collected $2.50 from pot
DIMAN_324: doesn't show hand 
*** SUMMARY ***
Total pot $2.50 | Rake $0 
Seat 1: Avtovo (big blind) folded before Flop
Seat 3: mxustin folded before Flop (didn't bet)
Seat 4: DIMAN_324 collected ($2.50)
Seat 5: matiko09 folded before Flop (didn't bet)
Seat 7: chenconhaste folded before Flop (didn't bet)
Seat 8: ozone2003 (button) folded before Flop (didn't bet)
Seat 9: Troll8989 (small blind) folded before Flop





PokerStars Hand #155012550631:  Hold'em No Limit (€0.25/€0.50 EUR) - 2016/06/21 12:55:15 CET [2016/06/21 6:55:15 ET]
Table 'Actor II' 6-max Seat #4 is the button
Seat 1: hmverlin (€84.86 in chips) 
Seat 2: ooak182 (€51.09 in chips) 
Seat 3: asmodej666 (€53.96 in chips) 
Seat 4: matiko09 (€50 in chips) 
Seat 5: Rybka1294 (€50 in chips) 
Seat 6: fanmtZ (€21.68 in chips) 
Rybka1294: posts small blind €0.25
fanmtZ: posts big blind €0.50
*** HOLE CARDS ***
Dealt to matiko09 [5s Th]
hmverlin: raises €1 to €1.50
ooak182: folds 
asmodej666: folds 
matiko09: folds 
Rybka1294: folds 
fanmtZ: folds 
Uncalled bet (€1) returned to hmverlin
hmverlin collected €1.25 from pot
hmverlin: doesn't show hand 
*** SUMMARY ***
Total pot €1.25 | Rake €0 
Seat 1: hmverlin collected (€1.25)
Seat 2: ooak182 folded before Flop (didn't bet)
Seat 3: asmodej666 folded before Flop (didn't bet)
Seat 4: matiko09 (button) folded before Flop (didn't bet)
Seat 5: Rybka1294 (small blind) folded before Flop
Seat 6: fanmtZ (big blind) folded before Flop





PokerStars Hand #155012550735:  Hold'em No Limit ($0.50/$1.00 USD) - 2016/06/21 12:55:15 CET [2016/06/21 6:55:15 ET]
Table 'Moreau' 9-max Seat #4 is the button
Seat 1: 50CandyJoe ($105.47 in chips) 
Seat 2: nubpoker ($110.55 in chips) 
Seat 3: matiko09 ($100 in chips) 
Seat 4: bonesnz1 ($75.77 in chips) 
Seat 5: DIMAN_324 ($106.38 in chips) 
Seat 6: mbk88 ($100 in chips) 
Seat 7: PanKwn15 ($44.78 in chips) 
DIMAN_324: posts small blind $0.50
mbk88: posts big blind $1
Toonersens: sits out 
*** HOLE CARDS ***
Dealt to matiko09 [8h 7h]
PanKwn15: raises $1 to $2
50CandyJoe: folds 
nubpoker: folds 
matiko09: folds 
bonesnz1: folds 
DIMAN_324: folds 
mbk88: calls $1
*** FLOP *** [6s 2d 7s]
mbk88: checks 
PanKwn15: bets $3
mbk88: folds 
Uncalled bet ($3) returned to PanKwn15
PanKwn15 collected $4.28 from pot
PanKwn15: doesn't show hand 
*** SUMMARY ***
Total pot $4.50 | Rake $0.22 
Board [6s 2d 7s]
Seat 1: 50CandyJoe folded before Flop (didn't bet)
Seat 2: nubpoker folded before Flop (didn't bet)
Seat 3: matiko09 folded before Flop (didn't bet)
Seat 4: bonesnz1 (button) folded before Flop (didn't bet)
Seat 5: DIMAN_324 (small blind) folded before Flop
Seat 6: mbk88 (big blind) folded on the Flop
Seat 7: PanKwn15 collected ($4.28)





PokerStars Hand #155012551181:  Hold'em No Limit ($0.50/$1.00 USD) - 2016/06/21 12:55:16 CET [2016/06/21 6:55:16 ET]
Table 'Leo' 9-max Seat #2 is the button
Seat 1: letmegonow ($80.79 in chips) 
Seat 2: torkkdnm ($142.46 in chips) 
Seat 3: matiko09 ($104.30 in chips) 
Seat 4: SharingaaN ($78 in chips) 
Seat 5: DIMAN_324 ($105 in chips) 
Seat 6: chenconhaste ($126.67 in chips) 
Seat 8: pyromid ($65.17 in chips) 
Seat 9: Wladimir205 ($100 in chips) 
matiko09: posts small blind $0.50
SharingaaN: posts big blind $1
*** HOLE CARDS ***
Dealt to matiko09 [6d Kc]
DIMAN_324: folds 
chenconhaste: folds 
pyromid: folds 
Wladimir205: folds 
letmegonow: folds 
torkkdnm: raises $1 to $2
matiko09: folds 
SharingaaN: raises $7 to $9
torkkdnm: folds 
Uncalled bet ($7) returned to SharingaaN
SharingaaN collected $4.50 from pot
SharingaaN: doesn't show hand 
*** SUMMARY ***
Total pot $4.50 | Rake $0 
Seat 1: letmegonow folded before Flop (didn't bet)
Seat 2: torkkdnm (button) folded before Flop
Seat 3: matiko09 (small blind) folded before Flop
Seat 4: SharingaaN (big blind) collected ($4.50)
Seat 5: DIMAN_324 folded before Flop (didn't bet)
Seat 6: chenconhaste folded before Flop (didn't bet)
Seat 8: pyromid folded before Flop (didn't bet)
Seat 9: Wladimir205 folded before Flop (didn't bet)





PokerStars Hand #155012553966:  Hold'em No Limit (€0.25/€0.50 EUR) - 2016/06/21 12:55:24 CET [2016/06/21 6:55:24 ET]
Table 'Lotis II' 6-max Seat #4 is the button
Seat 1: acaestanemo (€50 in chips) 
Seat 2: broh202 (€111.55 in chips) 
Seat 3: bricasse1961 (€25.98 in chips) 
Seat 4: matiko09 (€73.13 in chips) 
Seat 5: AlexPles (€50 in chips) 
Seat 6: patriot424 (€68.45 in chips) 
AlexPles: posts small blind €0.25
patriot424: posts big blind €0.50
*** HOLE CARDS ***
Dealt to matiko09 [Td 6h]
acaestanemo: folds 
broh202: raises €1 to €1.50
bricasse1961: folds 
matiko09: folds 
AlexPles: folds 
patriot424: folds 
Uncalled bet (€1) returned to broh202
broh202 collected €1.25 from pot
broh202: doesn't show hand 
*** SUMMARY ***
Total pot €1.25 | Rake €0 
Seat 1: acaestanemo folded before Flop (didn't bet)
Seat 2: broh202 collected (€1.25)
Seat 3: bricasse1961 folded before Flop (didn't bet)
Seat 4: matiko09 (button) folded before Flop (didn't bet)
Seat 5: AlexPles (small blind) folded before Flop
Seat 6: patriot424 (big blind) folded before Flop





PokerStars Hand #155012560849:  Hold'em No Limit ($0.50/$1.00 USD) - 2016/06/21 12:55:43 CET [2016/06/21 6:55:43 ET]
Table 'Feronia' 9-max Seat #9 is the button
Seat 1: DIMAN_324 ($100 in chips) 
Seat 2: Yuder_Lin ($98 in chips) 
Seat 3: mbk88 ($145.85 in chips) 
Seat 4: pyromid ($122.94 in chips) 
Seat 5: matiko09 ($115.39 in chips) 
Seat 6: chenconhaste ($120.45 in chips) 
Seat 7: arctur17 ($101.45 in chips) 
Seat 8: letmegonow ($142.91 in chips) 
Seat 9: mi$$I$Elena ($120.54 in chips) 
DIMAN_324: posts small blind $0.50
Yuder_Lin: posts big blind $1
*** HOLE CARDS ***
Dealt to matiko09 [7d Kd]
mbk88: folds 
pyromid: folds 
matiko09: folds 
chenconhaste: folds 
arctur17: folds 
letmegonow: folds 
mi$$I$Elena: raises $1 to $2
DIMAN_324: folds 
Yuder_Lin: folds 
Uncalled bet ($1) returned to mi$$I$Elena
mi$$I$Elena collected $2.50 from pot
mi$$I$Elena: doesn't show hand 
*** SUMMARY ***
Total pot $2.50 | Rake $0 
Seat 1: DIMAN_324 (small blind) folded before Flop
Seat 2: Yuder_Lin (big blind) folded before Flop
Seat 3: mbk88 folded before Flop (didn't bet)
Seat 4: pyromid folded before Flop (didn't bet)
Seat 5: matiko09 folded before Flop (didn't bet)
Seat 6: chenconhaste folded before Flop (didn't bet)
Seat 7: arctur17 folded before Flop (didn't bet)
Seat 8: letmegonow folded before Flop (didn't bet)
Seat 9: mi$$I$Elena (button) collected ($2.50)





PokerStars Hand #155012561412:  Hold'em No Limit ($0.50/$1.00 USD) - 2016/06/21 12:55:44 CET [2016/06/21 6:55:44 ET]
Table 'Umbriel II' 9-max Seat #9 is the button
Seat 1: Avtovo ($100 in chips) 
Seat 2: rura53 ($80 in chips) 
Seat 3: mxustin ($39.25 in chips) 
Seat 4: DIMAN_324 ($112.42 in chips) 
Seat 5: matiko09 ($131.41 in chips) 
Seat 7: chenconhaste ($172.85 in chips) 
Seat 8: ozone2003 ($107.82 in chips) 
Seat 9: Troll8989 ($100 in chips) 
Avtovo: posts small blind $0.50
rura53: posts big blind $1
*** HOLE CARDS ***
Dealt to matiko09 [5h Ah]
mxustin: folds 
DIMAN_324: folds 
matiko09: raises $2 to $3
chenconhaste: folds 
ozone2003: folds 
Troll8989: folds 
Avtovo: folds 
rura53: folds 
Uncalled bet ($2) returned to matiko09
matiko09 collected $2.50 from pot
matiko09: doesn't show hand 
*** SUMMARY ***
Total pot $2.50 | Rake $0 
Seat 1: Avtovo (small blind) folded before Flop
Seat 2: rura53 (big blind) folded before Flop
Seat 3: mxustin folded before Flop (didn't bet)
Seat 4: DIMAN_324 folded before Flop (didn't bet)
Seat 5: matiko09 collected ($2.50)
Seat 7: chenconhaste folded before Flop (didn't bet)
Seat 8: ozone2003 folded before Flop (didn't bet)
Seat 9: Troll8989 (button) folded before Flop (didn't bet)





PokerStars Hand #155012561937:  Hold'em No Limit ($0.50/$1.00 USD) - 2016/06/21 12:55:46 CET [2016/06/21 6:55:46 ET]
Table 'Carlova II' 9-max Seat #3 is the button
Seat 1: matiko09 ($132.55 in chips) 
Seat 2: chenconhaste ($129.08 in chips) 
Seat 3: King_Z�Manel ($103.20 in chips) 
Seat 4: Dandy Monk ($45.65 in chips) 
Seat 5: ozone2003 ($100 in chips) 
Seat 6: DIMAN_324 ($100 in chips) 
Seat 7: mi$$I$Elena ($100 in chips) 
Seat 8: pyromid ($91.09 in chips) 
Seat 9: Troll8989 ($105.50 in chips) 
Dandy Monk: posts small blind $0.50
ozone2003: posts big blind $1
*** HOLE CARDS ***
Dealt to matiko09 [2c 8s]
DIMAN_324: folds 
mi$$I$Elena: folds 
pyromid: folds 
Troll8989: folds 
matiko09: folds 
chenconhaste: folds 
King_Z�Manel: raises $1 to $2
Dandy Monk: calls $1.50
ozone2003: folds 
*** FLOP *** [Kd 2d 8c]
Dandy Monk: checks 
King_Z�Manel: bets $2.37
Dandy Monk: folds 
Uncalled bet ($2.37) returned to King_Z�Manel
King_Z�Manel collected $4.75 from pot
King_Z�Manel: doesn't show hand 
*** SUMMARY ***
Total pot $5 | Rake $0.25 
Board [Kd 2d 8c]
Seat 1: matiko09 folded before Flop (didn't bet)
Seat 2: chenconhaste folded before Flop (didn't bet)
Seat 3: King_Z�Manel (button) collected ($4.75)
Seat 4: Dandy Monk (small blind) folded on the Flop
Seat 5: ozone2003 (big blind) folded before Flop
Seat 6: DIMAN_324 folded before Flop (didn't bet)
Seat 7: mi$$I$Elena folded before Flop (didn't bet)
Seat 8: pyromid folded before Flop (didn't bet)
Seat 9: Troll8989 folded before Flop (didn't bet)





PokerStars Hand #155012564841:  Hold'em No Limit (€0.25/€0.50 EUR) - 2016/06/21 12:55:54 CET [2016/06/21 6:55:54 ET]
Table 'Lotis II' 6-max Seat #5 is the button
Seat 1: acaestanemo (€50 in chips) 
Seat 2: broh202 (€112.30 in chips) 
Seat 3: bricasse1961 (€25.98 in chips) 
Seat 4: matiko09 (€73.13 in chips) 
Seat 5: AlexPles (€50 in chips) 
Seat 6: patriot424 (€67.95 in chips) 
patriot424: posts small blind €0.25
acaestanemo: posts big blind €0.50
*** HOLE CARDS ***
Dealt to matiko09 [6c 8h]
broh202: folds 
bricasse1961: folds 
matiko09: folds 
AlexPles: raises €0.75 to €1.25
patriot424: folds 
acaestanemo: folds 
Uncalled bet (€0.75) returned to AlexPles
AlexPles collected €1.25 from pot
AlexPles: doesn't show hand 
*** SUMMARY ***
Total pot €1.25 | Rake €0 
Seat 1: acaestanemo (big blind) folded before Flop
Seat 2: broh202 folded before Flop (didn't bet)
Seat 3: bricasse1961 folded before Flop (didn't bet)
Seat 4: matiko09 folded before Flop (didn't bet)
Seat 5: AlexPles (button) collected (€1.25)
Seat 6: patriot424 (small blind) folded before Flop





PokerStars Hand #155012565518:  Hold'em No Limit ($0.50/$1.00 USD) - 2016/06/21 12:55:56 CET [2016/06/21 6:55:56 ET]
Table 'Chimay' 9-max Seat #6 is the button
Seat 1: chenconhaste ($116.05 in chips) 
Seat 2: DIMAN_324 ($137.77 in chips) 
Seat 3: Yuder_Lin ($41.12 in chips) 
Seat 4: fukumimi ($106 in chips) 
Seat 6: mbk88 ($111.67 in chips) 
Seat 7: Troll8989 ($100 in chips) 
Seat 8: matiko09 ($105.62 in chips) 
Troll8989: posts small blind $0.50
matiko09: posts big blind $1
SharingaaN: sits out 
Avtovo: sits out 
*** HOLE CARDS ***
Dealt to matiko09 [Tc As]
chenconhaste: folds 
DIMAN_324: folds 
Yuder_Lin: raises $2 to $3
fukumimi: calls $3
mbk88: folds 
Troll8989: folds 
matiko09: folds 
*** FLOP *** [2s 5s Jd]
Yuder_Lin: bets $3.56
fukumimi: calls $3.56
*** TURN *** [2s 5s Jd] [4d]
Yuder_Lin: bets $5
fukumimi: raises $5 to $10
Yuder_Lin: calls $5
*** RIVER *** [2s 5s Jd 4d] [3s]
Yuder_Lin: bets $24.56 and is all-in
fukumimi: calls $24.56
*** SHOW DOWN ***
Yuder_Lin: shows [Ts Qs] (a flush, Queen high)
fukumimi: shows [Jh Kh] (a pair of Jacks)
Yuder_Lin collected $81.24 from pot
*** SUMMARY ***
Total pot $83.74 | Rake $2.50 
Board [2s 5s Jd 4d 3s]
Seat 1: chenconhaste folded before Flop (didn't bet)
Seat 2: DIMAN_324 folded before Flop (didn't bet)
Seat 3: Yuder_Lin showed [Ts Qs] and won ($81.24) with a flush, Queen high
Seat 4: fukumimi showed [Jh Kh] and lost with a pair of Jacks
Seat 6: mbk88 (button) folded before Flop (didn't bet)
Seat 7: Troll8989 (small blind) folded before Flop
Seat 8: matiko09 (big blind) folded before Flop





PokerStars Hand #155012567387:  Hold'em No Limit ($0.50/$1.00 USD) - 2016/06/21 12:56:01 CET [2016/06/21 6:56:01 ET]
Table 'Leo' 9-max Seat #3 is the button
Seat 1: letmegonow ($80.79 in chips) 
Seat 2: torkkdnm ($140.46 in chips) 
Seat 3: matiko09 ($103.80 in chips) 
Seat 4: SharingaaN ($80.50 in chips) 
Seat 5: DIMAN_324 ($105 in chips) 
Seat 6: chenconhaste ($126.67 in chips) 
Seat 8: pyromid ($65.17 in chips) 
Seat 9: Wladimir205 ($100 in chips) 
SharingaaN: posts small blind $0.50
DIMAN_324: posts big blind $1
*** HOLE CARDS ***
Dealt to matiko09 [Kh Tc]
chenconhaste: folds 
pyromid: folds 
Wladimir205: folds 
letmegonow: raises $3 to $4
torkkdnm: folds 
matiko09: folds 
SharingaaN: calls $3.50
DIMAN_324: folds 
*** FLOP *** [8s 3h 7d]
SharingaaN: checks 
letmegonow: checks 
*** TURN *** [8s 3h 7d] [5s]
SharingaaN: bets $5
letmegonow: raises $10 to $15
SharingaaN: calls $10
*** RIVER *** [8s 3h 7d 5s] [6d]
SharingaaN: bets $61.50 and is all-in
letmegonow: folds 
Uncalled bet ($61.50) returned to SharingaaN
SharingaaN collected $37.05 from pot
SharingaaN: doesn't show hand 
*** SUMMARY ***
Total pot $39 | Rake $1.95 
Board [8s 3h 7d 5s 6d]
Seat 1: letmegonow folded on the River
Seat 2: torkkdnm folded before Flop (didn't bet)
Seat 3: matiko09 (button) folded before Flop (didn't bet)
Seat 4: SharingaaN (small blind) collected ($37.05)
Seat 5: DIMAN_324 (big blind) folded before Flop
Seat 6: chenconhaste folded before Flop (didn't bet)
Seat 8: pyromid folded before Flop (didn't bet)
Seat 9: Wladimir205 folded before Flop (didn't bet)





PokerStars Hand #155012570650:  Hold'em No Limit (€0.25/€0.50 EUR) - 2016/06/21 12:56:05 CET [2016/06/21 6:56:05 ET]
Table 'Actor II' 6-max Seat #5 is the button
Seat 1: hmverlin (€85.61 in chips) 
Seat 2: ooak182 (€51.09 in chips) 
Seat 3: asmodej666 (€53.96 in chips) 
Seat 4: matiko09 (€50 in chips) 
Seat 5: Rybka1294 (€50 in chips) 
Seat 6: fanmtZ (€21.18 in chips) 
fanmtZ: posts small blind €0.25
hmverlin: posts big blind €0.50
*** HOLE CARDS ***
Dealt to matiko09 [9s 7h]
ooak182: folds 
asmodej666: raises €1 to €1.50
matiko09: folds 
Rybka1294: calls €1.50
fanmtZ: raises €4.50 to €6
hmverlin: folds 
asmodej666: raises €6 to €12
Rybka1294: folds 
fanmtZ: raises €9.18 to €21.18 and is all-in
asmodej666: calls €9.18
*** FIRST FLOP *** [9c Qc 6s]
*** FIRST TURN *** [9c Qc 6s] [Qd]
*** FIRST RIVER *** [9c Qc 6s Qd] [4s]
*** SECOND FLOP *** [3s Qh Kh]
*** SECOND TURN *** [3s Qh Kh] [2d]
*** SECOND RIVER *** [3s Qh Kh 2d] [7c]
*** FIRST SHOW DOWN ***
fanmtZ: shows [Kc Ah] (a pair of Queens)
asmodej666: shows [Ac Ad] (two pair, Aces and Queens)
asmodej666 collected €21.28 from pot
*** SECOND SHOW DOWN ***
fanmtZ: shows [Kc Ah] (a pair of Kings)
asmodej666: shows [Ac Ad] (a pair of Aces)
asmodej666 collected €21.28 from pot
*** SUMMARY ***
Total pot €44.36 | Rake €1.80 
Hand was run twice
FIRST Board [9c Qc 6s Qd 4s]
SECOND Board [3s Qh Kh 2d 7c]
Seat 1: hmverlin (big blind) folded before Flop
Seat 2: ooak182 folded before Flop (didn't bet)
Seat 3: asmodej666 showed [Ac Ad] and won (€21.28) with two pair, Aces and Queens, and won (€21.28) with a pair of Aces
Seat 4: matiko09 folded before Flop (didn't bet)
Seat 5: Rybka1294 (button) folded before Flop
Seat 6: fanmtZ (small blind) showed [Kc Ah] and lost with a pair of Queens, and lost with a pair of Kings





PokerStars Hand #155012571502:  Hold'em No Limit ($0.50/$1.00 USD) - 2016/06/21 12:56:07 CET [2016/06/21 6:56:07 ET]
Table 'Moreau' 9-max Seat #5 is the button
Seat 1: 50CandyJoe ($105.47 in chips) 
Seat 2: nubpoker ($110.55 in chips) 
Seat 3: matiko09 ($100 in chips) 
Seat 4: bonesnz1 ($75.77 in chips) 
Seat 5: DIMAN_324 ($105.88 in chips) 
Seat 6: mbk88 ($100 in chips) 
Seat 7: PanKwn15 ($47.06 in chips) 
mbk88: posts small blind $0.50
PanKwn15: posts big blind $1
Toonersens: sits out 
*** HOLE CARDS ***
Dealt to matiko09 [Kc 9c]
50CandyJoe: folds 
nubpoker: folds 
matiko09: raises $2 to $3
bonesnz1: folds 
DIMAN_324: folds 
mbk88: folds 
PanKwn15: folds 
Uncalled bet ($2) returned to matiko09
matiko09 collected $2.50 from pot
matiko09: doesn't show hand 
*** SUMMARY ***
Total pot $2.50 | Rake $0 
Seat 1: 50CandyJoe folded before Flop (didn't bet)
Seat 2: nubpoker folded before Flop (didn't bet)
Seat 3: matiko09 collected ($2.50)
Seat 4: bonesnz1 folded before Flop (didn't bet)
Seat 5: DIMAN_324 (button) folded before Flop (didn't bet)
Seat 6: mbk88 (small blind) folded before Flop
Seat 7: PanKwn15 (big blind) folded before Flop





PokerStars Hand #155012572164:  Hold'em No Limit ($0.50/$1.00 USD) - 2016/06/21 12:56:09 CET [2016/06/21 6:56:09 ET]
Table 'Brauna II' 9-max Seat #4 is the button
Seat 1: wisbc ($102.32 in chips) 
Seat 2: pyromid ($153.27 in chips) 
Seat 3: matiko09 ($100 in chips) 
Seat 4: chenconhaste ($100 in chips) 
Seat 5: fukumimi ($99 in chips) 
Seat 6: mbk88 ($174.01 in chips) 
Seat 8: DIMAN_324 ($132.65 in chips) 
Seat 9: torkkdnm ($101.50 in chips) 
fukumimi: posts small blind $0.50
mbk88: posts big blind $1
*** HOLE CARDS ***
Dealt to matiko09 [Js 6c]
DIMAN_324: folds 
torkkdnm: folds 
wisbc: folds 
pyromid: folds 
matiko09: folds 
chenconhaste: raises $1.25 to $2.25
fukumimi: raises $6.75 to $9
mbk88: folds 
chenconhaste: raises $11 to $20
fukumimi: raises $79 to $99 and is all-in
chenconhaste: calls $79
*** FLOP *** [6s 9c Th]
*** TURN *** [6s 9c Th] [7c]
*** RIVER *** [6s 9c Th 7c] [4h]
*** SHOW DOWN ***
fukumimi: shows [Ac Kc] (high card Ace)
chenconhaste: shows [Kh Kd] (a pair of Kings)
chenconhaste collected $196.50 from pot
*** SUMMARY ***
Total pot $199 | Rake $2.50 
Board [6s 9c Th 7c 4h]
Seat 1: wisbc folded before Flop (didn't bet)
Seat 2: pyromid folded before Flop (didn't bet)
Seat 3: matiko09 folded before Flop (didn't bet)
Seat 4: chenconhaste (button) showed [Kh Kd] and won ($196.50) with a pair of Kings
Seat 5: fukumimi (small blind) showed [Ac Kc] and lost with high card Ace
Seat 6: mbk88 (big blind) folded before Flop
Seat 8: DIMAN_324 folded before Flop (didn't bet)
Seat 9: torkkdnm folded before Flop (didn't bet)





PokerStars Hand #155012573360:  Hold'em No Limit ($0.50/$1.00 USD) - 2016/06/21 12:56:12 CET [2016/06/21 6:56:12 ET]
Table 'Rupertwildt' 9-max Seat #2 is the button
Seat 1: pokernixxx ($79.85 in chips) 
Seat 2: SharingaaN ($77.85 in chips) 
Seat 3: Saymon_Moo ($77.42 in chips) 
Seat 4: matiko09 ($134.42 in chips) 
Seat 5: pyromid ($94.46 in chips) 
Seat 6: ozone2003 ($100 in chips) 
Seat 7: chenconhaste ($103.84 in chips) 
Seat 8: Gonzanary ($118.14 in chips) 
Seat 9: mbk88 ($122.93 in chips) 
Saymon_Moo: posts small blind $0.50
matiko09: posts big blind $1
*** HOLE CARDS ***
Dealt to matiko09 [Qh 9s]
pyromid: folds 
ozone2003: folds 
chenconhaste: folds 
Gonzanary: folds 
mbk88: folds 
pokernixxx: folds 
SharingaaN: raises $1 to $2
Saymon_Moo: folds 
matiko09: calls $1
*** FLOP *** [7h Qd 2s]
matiko09: checks 
SharingaaN: checks 
*** TURN *** [7h Qd 2s] [7s]
matiko09: bets $3.46
SharingaaN: folds 
Uncalled bet ($3.46) returned to matiko09
matiko09 collected $4.28 from pot
matiko09: doesn't show hand 
*** SUMMARY ***
Total pot $4.50 | Rake $0.22 
Board [7h Qd 2s 7s]
Seat 1: pokernixxx folded before Flop (didn't bet)
Seat 2: SharingaaN (button) folded on the Turn
Seat 3: Saymon_Moo (small blind) folded before Flop
Seat 4: matiko09 (big blind) collected ($4.28)
Seat 5: pyromid folded before Flop (didn't bet)
Seat 6: ozone2003 folded before Flop (didn't bet)
Seat 7: chenconhaste folded before Flop (didn't bet)
Seat 8: Gonzanary folded before Flop (didn't bet)
Seat 9: mbk88 folded before Flop (didn't bet)





PokerStars Hand #155012573630:  Hold'em No Limit ($0.50/$1.00 USD) - 2016/06/21 12:56:13 CET [2016/06/21 6:56:13 ET]
Table 'Feronia' 9-max Seat #1 is the button
Seat 1: DIMAN_324 ($100 in chips) 
Seat 2: Yuder_Lin ($97 in chips) 
Seat 3: mbk88 ($145.85 in chips) 
Seat 4: pyromid ($122.94 in chips) 
Seat 5: matiko09 ($115.39 in chips) 
Seat 6: chenconhaste ($120.45 in chips) 
Seat 7: arctur17 ($101.45 in chips) 
Seat 8: letmegonow ($142.91 in chips) 
Seat 9: mi$$I$Elena ($122.04 in chips) 
Yuder_Lin: posts small blind $0.50
mbk88: posts big blind $1
*** HOLE CARDS ***
Dealt to matiko09 [Tc 7c]
pyromid: folds 
matiko09: folds 
chenconhaste: raises $1.25 to $2.25
arctur17: folds 
letmegonow: folds 
mi$$I$Elena: folds 
DIMAN_324: calls $2.25
Yuder_Lin: folds 
mbk88: folds 
*** FLOP *** [2s 2d 8c]
chenconhaste: checks 
DIMAN_324: bets $2.50
chenconhaste: folds 
Uncalled bet ($2.50) returned to DIMAN_324
DIMAN_324 collected $5.70 from pot
DIMAN_324: doesn't show hand 
*** SUMMARY ***
Total pot $6 | Rake $0.30 
Board [2s 2d 8c]
Seat 1: DIMAN_324 (button) collected ($5.70)
Seat 2: Yuder_Lin (small blind) folded before Flop
Seat 3: mbk88 (big blind) folded before Flop
Seat 4: pyromid folded before Flop (didn't bet)
Seat 5: matiko09 folded before Flop (didn't bet)
Seat 6: chenconhaste folded on the Flop
Seat 7: arctur17 folded before Flop (didn't bet)
Seat 8: letmegonow folded before Flop (didn't bet)
Seat 9: mi$$I$Elena folded before Flop (didn't bet)





PokerStars Hand #155012575271:  Hold'em No Limit ($0.50/$1.00 USD) - 2016/06/21 12:56:17 CET [2016/06/21 6:56:17 ET]
Table 'Umbriel II' 9-max Seat #1 is the button
Seat 1: Avtovo ($100 in chips) 
Seat 2: rura53 ($79 in chips) 
Seat 3: mxustin ($39.25 in chips) 
Seat 4: DIMAN_324 ($112.42 in chips) 
Seat 5: matiko09 ($132.91 in chips) 
Seat 7: chenconhaste ($172.85 in chips) 
Seat 8: ozone2003 ($107.82 in chips) 
Seat 9: Troll8989 ($100 in chips) 
rura53: posts small blind $0.50
mxustin: posts big blind $1
*** HOLE CARDS ***
Dealt to matiko09 [Ad Qs]
DIMAN_324: folds 
matiko09: raises $2 to $3
chenconhaste: folds 
ozone2003: folds 
Troll8989: folds 
Avtovo: folds 
rura53: folds 
mxustin: folds 
Uncalled bet ($2) returned to matiko09
matiko09 collected $2.50 from pot
matiko09: doesn't show hand 
*** SUMMARY ***
Total pot $2.50 | Rake $0 
Seat 1: Avtovo (button) folded before Flop (didn't bet)
Seat 2: rura53 (small blind) folded before Flop
Seat 3: mxustin (big blind) folded before Flop
Seat 4: DIMAN_324 folded before Flop (didn't bet)
Seat 5: matiko09 collected ($2.50)
Seat 7: chenconhaste folded before Flop (didn't bet)
Seat 8: ozone2003 folded before Flop (didn't bet)
Seat 9: Troll8989 folded before Flop (didn't bet)





PokerStars Hand #155012575057:  Hold'em No Limit (€0.25/€0.50 EUR) - 2016/06/21 12:56:17 CET [2016/06/21 6:56:17 ET]
Table 'Lotis II' 6-max Seat #6 is the button
Seat 1: acaestanemo (€50 in chips) 
Seat 2: broh202 (€112.30 in chips) 
Seat 3: bricasse1961 (€25.98 in chips) 
Seat 4: matiko09 (€73.13 in chips) 
Seat 5: AlexPles (€50.75 in chips) 
Seat 6: patriot424 (€67.70 in chips) 
acaestanemo: posts small blind €0.25
broh202: posts big blind €0.50
*** HOLE CARDS ***
Dealt to matiko09 [4h 5d]
bricasse1961: calls €0.50
matiko09: folds 
AlexPles: folds 
patriot424: folds 
acaestanemo: raises €1.50 to €2
broh202: calls €1.50
bricasse1961: folds 
*** FLOP *** [Ah Jc 2h]
acaestanemo: checks 
broh202: bets €2.14
acaestanemo: folds 
Uncalled bet (€2.14) returned to broh202
broh202 collected €4.28 from pot
broh202: doesn't show hand 
*** SUMMARY ***
Total pot €4.50 | Rake €0.22 
Board [Ah Jc 2h]
Seat 1: acaestanemo (small blind) folded on the Flop
Seat 2: broh202 (big blind) collected (€4.28)
Seat 3: bricasse1961 folded before Flop
Seat 4: matiko09 folded before Flop (didn't bet)
Seat 5: AlexPles folded before Flop (didn't bet)
Seat 6: patriot424 (button) folded before Flop (didn't bet)





PokerStars Hand #155012581265:  Hold'em No Limit ($0.50/$1.00 USD) - 2016/06/21 12:56:34 CET [2016/06/21 6:56:34 ET]
Table 'Moreau' 9-max Seat #6 is the button
Seat 1: 50CandyJoe ($105.47 in chips) 
Seat 2: nubpoker ($110.55 in chips) 
Seat 3: matiko09 ($101.50 in chips) 
Seat 4: bonesnz1 ($75.77 in chips) 
Seat 5: DIMAN_324 ($105.88 in chips) 
Seat 6: mbk88 ($100 in chips) 
Seat 7: PanKwn15 ($46.06 in chips) 
Seat 9: Toonersens ($130.91 in chips) 
PanKwn15: posts small blind $0.50
Toonersens: posts big blind $1
*** HOLE CARDS ***
Dealt to matiko09 [Qc 2h]
50CandyJoe: folds 
nubpoker: raises $1.50 to $2.50
matiko09: folds 
bonesnz1: folds 
DIMAN_324: folds 
mbk88: folds 
PanKwn15: calls $2
Toonersens: folds 
*** FLOP *** [Ac 9s As]
PanKwn15: checks 
nubpoker: bets $3.79
PanKwn15: calls $3.79
*** TURN *** [Ac 9s As] [9h]
PanKwn15: checks 
nubpoker: bets $6.45
PanKwn15: calls $6.45
*** RIVER *** [Ac 9s As 9h] [7c]
PanKwn15: bets $18.60
nubpoker: raises $31.18 to $49.78
PanKwn15: folds 
Uncalled bet ($31.18) returned to nubpoker
nubpoker collected $61.18 from pot
nubpoker: doesn't show hand 
*** SUMMARY ***
Total pot $63.68 | Rake $2.50 
Board [Ac 9s As 9h 7c]
Seat 1: 50CandyJoe folded before Flop (didn't bet)
Seat 2: nubpoker collected ($61.18)
Seat 3: matiko09 folded before Flop (didn't bet)
Seat 4: bonesnz1 folded before Flop (didn't bet)
Seat 5: DIMAN_324 folded before Flop (didn't bet)
Seat 6: mbk88 (button) folded before Flop (didn't bet)
Seat 7: PanKwn15 (small blind) folded on the River
Seat 9: Toonersens (big blind) folded before Flop





PokerStars Hand #155012583407:  Hold'em No Limit ($0.50/$1.00 USD) - 2016/06/21 12:56:40 CET [2016/06/21 6:56:40 ET]
Table 'Leo' 9-max Seat #4 is the button
Seat 1: letmegonow ($61.79 in chips) 
Seat 2: torkkdnm ($140.46 in chips) 
Seat 3: matiko09 ($103.80 in chips) 
Seat 4: SharingaaN ($98.55 in chips) 
Seat 5: DIMAN_324 ($104 in chips) 
Seat 6: chenconhaste ($126.67 in chips) 
Seat 8: pyromid ($65.17 in chips) 
Seat 9: Wladimir205 ($100 in chips) 
DIMAN_324: posts small blind $0.50
chenconhaste: posts big blind $1
*** HOLE CARDS ***
Dealt to matiko09 [Kh 9s]
pyromid: folds 
Wladimir205: folds 
letmegonow: folds 
torkkdnm: folds 
matiko09: folds 
SharingaaN: raises $1 to $2
DIMAN_324: folds 
chenconhaste: calls $1
*** FLOP *** [5c Ts 6c]
chenconhaste: checks 
SharingaaN: checks 
*** TURN *** [5c Ts 6c] [Th]
chenconhaste: checks 
SharingaaN: checks 
*** RIVER *** [5c Ts 6c Th] [7h]
chenconhaste: checks 
SharingaaN: checks 
*** SHOW DOWN ***
chenconhaste: shows [Qd Kc] (a pair of Tens)
SharingaaN: shows [2s 2c] (two pair, Tens and Deuces)
SharingaaN collected $4.28 from pot
*** SUMMARY ***
Total pot $4.50 | Rake $0.22 
Board [5c Ts 6c Th 7h]
Seat 1: letmegonow folded before Flop (didn't bet)
Seat 2: torkkdnm folded before Flop (didn't bet)
Seat 3: matiko09 folded before Flop (didn't bet)
Seat 4: SharingaaN (button) showed [2s 2c] and won ($4.28) with two pair, Tens and Deuces
Seat 5: DIMAN_324 (small blind) folded before Flop
Seat 6: chenconhaste (big blind) showed [Qd Kc] and lost with a pair of Tens
Seat 8: pyromid folded before Flop (didn't bet)
Seat 9: Wladimir205 folded before Flop (didn't bet)





PokerStars Hand #155012588285:  Hold'em No Limit ($0.50/$1.00 USD) - 2016/06/21 12:56:53 CET [2016/06/21 6:56:53 ET]
Table 'Pyxis' 9-max Seat #1 is the button
Seat 1: ntoperman19 ($103.50 in chips) 
Seat 2: 50CandyJoe ($104.68 in chips) 
Seat 3: Avtovo ($101 in chips) 
Seat 5: matiko09 ($116.85 in chips) 
Seat 6: ozone2003 ($100 in chips) 
50CandyJoe: posts small blind $0.50
Avtovo: posts big blind $1
Troll8989: sits out 
*** HOLE CARDS ***
Dealt to matiko09 [Ac 8h]
matiko09: folds 
ozone2003: folds 
ntoperman19: raises $2 to $3
50CandyJoe: folds 
Avtovo: folds 
Uncalled bet ($2) returned to ntoperman19
ntoperman19 collected $2.50 from pot
ntoperman19: doesn't show hand 
*** SUMMARY ***
Total pot $2.50 | Rake $0 
Seat 1: ntoperman19 (button) collected ($2.50)
Seat 2: 50CandyJoe (small blind) folded before Flop
Seat 3: Avtovo (big blind) folded before Flop
Seat 5: matiko09 folded before Flop (didn't bet)
Seat 6: ozone2003 folded before Flop (didn't bet)





PokerStars Hand #155012588563:  Hold'em No Limit ($0.50/$1.00 USD) - 2016/06/21 12:56:54 CET [2016/06/21 6:56:54 ET]
Table 'Umbriel II' 9-max Seat #2 is the button
Seat 1: Avtovo ($100 in chips) 
Seat 2: rura53 ($78.50 in chips) 
Seat 3: mxustin ($38.25 in chips) 
Seat 4: DIMAN_324 ($112.42 in chips) 
Seat 5: matiko09 ($134.41 in chips) 
Seat 7: chenconhaste ($172.85 in chips) 
Seat 8: ozone2003 ($107.82 in chips) 
Seat 9: Troll8989 ($100 in chips) 
mxustin: posts small blind $0.50
DIMAN_324: posts big blind $1
*** HOLE CARDS ***
Dealt to matiko09 [4s Qs]
matiko09: folds 
chenconhaste: folds 
ozone2003: folds 
Troll8989: raises $1.50 to $2.50
Avtovo: folds 
rura53: folds 
mxustin: folds 
DIMAN_324: folds 
Uncalled bet ($1.50) returned to Troll8989
Troll8989 collected $2.50 from pot
Troll8989: doesn't show hand 
*** SUMMARY ***
Total pot $2.50 | Rake $0 
Seat 1: Avtovo folded before Flop (didn't bet)
Seat 2: rura53 (button) folded before Flop (didn't bet)
Seat 3: mxustin (small blind) folded before Flop
Seat 4: DIMAN_324 (big blind) folded before Flop
Seat 5: matiko09 folded before Flop (didn't bet)
Seat 7: chenconhaste folded before Flop (didn't bet)
Seat 8: ozone2003 folded before Flop (didn't bet)
Seat 9: Troll8989 collected ($2.50)





PokerStars Hand #155012588886:  Hold'em No Limit ($0.50/$1.00 USD) - 2016/06/21 12:56:55 CET [2016/06/21 6:56:55 ET]
Table 'Carlova II' 9-max Seat #4 is the button
Seat 1: matiko09 ($132.55 in chips) 
Seat 2: chenconhaste ($129.08 in chips) 
Seat 3: King_Z�Manel ($105.95 in chips) 
Seat 4: Dandy Monk ($43.65 in chips) 
Seat 5: ozone2003 ($100 in chips) 
Seat 6: DIMAN_324 ($100 in chips) 
Seat 7: mi$$I$Elena ($100 in chips) 
Seat 8: pyromid ($91.09 in chips) 
Seat 9: Troll8989 ($105.50 in chips) 
ozone2003: posts small blind $0.50
DIMAN_324: posts big blind $1
*** HOLE CARDS ***
Dealt to matiko09 [6h 2d]
mi$$I$Elena: folds 
pyromid: folds 
Troll8989: raises $1.50 to $2.50
matiko09: folds 
chenconhaste: folds 
King_Z�Manel: folds 
Dandy Monk: calls $2.50
ozone2003: folds 
DIMAN_324: folds 
*** FLOP *** [6c Js 4h]
Troll8989: bets $3.50
Dandy Monk: folds 
Uncalled bet ($3.50) returned to Troll8989
Troll8989 collected $6.18 from pot
Troll8989: doesn't show hand 
*** SUMMARY ***
Total pot $6.50 | Rake $0.32 
Board [6c Js 4h]
Seat 1: matiko09 folded before Flop (didn't bet)
Seat 2: chenconhaste folded before Flop (didn't bet)
Seat 3: King_Z�Manel folded before Flop (didn't bet)
Seat 4: Dandy Monk (button) folded on the Flop
Seat 5: ozone2003 (small blind) folded before Flop
Seat 6: DIMAN_324 (big blind) folded before Flop
Seat 7: mi$$I$Elena folded before Flop (didn't bet)
Seat 8: pyromid folded before Flop (didn't bet)
Seat 9: Troll8989 collected ($6.18)





PokerStars Hand #155012590633:  Hold'em No Limit (€0.25/€0.50 EUR) - 2016/06/21 12:56:59 CET [2016/06/21 6:56:59 ET]
Table 'Lotis II' 6-max Seat #1 is the button
Seat 1: acaestanemo (€50 in chips) 
Seat 2: broh202 (€114.58 in chips) 
Seat 3: bricasse1961 (€25.48 in chips) 
Seat 4: matiko09 (€73.13 in chips) 
Seat 5: AlexPles (€50.75 in chips) 
Seat 6: patriot424 (€67.70 in chips) 
broh202: posts small blind €0.25
bricasse1961: posts big blind €0.50
*** HOLE CARDS ***
Dealt to matiko09 [6d Kd]
matiko09: folds 
AlexPles: folds 
patriot424: folds 
acaestanemo: raises €0.50 to €1
broh202: folds 
bricasse1961: folds 
Uncalled bet (€0.50) returned to acaestanemo
acaestanemo collected €1.25 from pot
*** SUMMARY ***
Total pot €1.25 | Rake €0 
Seat 1: acaestanemo (button) collected (€1.25)
Seat 2: broh202 (small blind) folded before Flop
Seat 3: bricasse1961 (big blind) folded before Flop
Seat 4: matiko09 folded before Flop (didn't bet)
Seat 5: AlexPles folded before Flop (didn't bet)
Seat 6: patriot424 folded before Flop (didn't bet)





PokerStars Hand #155012591261:  Hold'em No Limit ($0.50/$1.00 USD) - 2016/06/21 12:57:01 CET [2016/06/21 6:57:01 ET]
Table 'Rupertwildt' 9-max Seat #3 is the button
Seat 1: pokernixxx ($79.85 in chips) 
Seat 2: SharingaaN ($75.85 in chips) 
Seat 3: Saymon_Moo ($76.92 in chips) 
Seat 4: matiko09 ($136.70 in chips) 
Seat 5: pyromid ($94.46 in chips) 
Seat 6: ozone2003 ($100 in chips) 
Seat 7: chenconhaste ($103.84 in chips) 
Seat 8: Gonzanary ($118.14 in chips) 
Seat 9: mbk88 ($122.93 in chips) 
matiko09: posts small blind $0.50
pyromid: posts big blind $1
*** HOLE CARDS ***
Dealt to matiko09 [Qs 5s]
ozone2003: folds 
chenconhaste: folds 
Gonzanary: folds 
mbk88: folds 
pokernixxx: calls $1
SharingaaN: raises $4 to $5
Saymon_Moo: calls $5
matiko09: folds 
pyromid: folds 
pokernixxx: folds 
*** FLOP *** [Qh 3h 8s]
SharingaaN: checks 
Saymon_Moo: checks 
*** TURN *** [Qh 3h 8s] [2h]
SharingaaN: checks 
Saymon_Moo: checks 
*** RIVER *** [Qh 3h 8s 2h] [Jd]
SharingaaN: bets $11
Saymon_Moo: folds 
Uncalled bet ($11) returned to SharingaaN
SharingaaN collected $11.88 from pot
*** SUMMARY ***
Total pot $12.50 | Rake $0.62 
Board [Qh 3h 8s 2h Jd]
Seat 1: pokernixxx folded before Flop
Seat 2: SharingaaN collected ($11.88)
Seat 3: Saymon_Moo (button) folded on the River
Seat 4: matiko09 (small blind) folded before Flop
Seat 5: pyromid (big blind) folded before Flop
Seat 6: ozone2003 folded before Flop (didn't bet)
Seat 7: chenconhaste folded before Flop (didn't bet)
Seat 8: Gonzanary folded before Flop (didn't bet)
Seat 9: mbk88 folded before Flop (didn't bet)





PokerStars Hand #155012594343:  Hold'em No Limit ($0.50/$1.00 USD) - 2016/06/21 12:57:09 CET [2016/06/21 6:57:09 ET]
Table 'Pyxis' 9-max Seat #2 is the button
Seat 1: ntoperman19 ($105 in chips) 
Seat 2: 50CandyJoe ($104.18 in chips) 
Seat 3: Avtovo ($100 in chips) 
Seat 4: Troll8989 ($102 in chips) 
Seat 5: matiko09 ($116.85 in chips) 
Seat 6: ozone2003 ($100 in chips) 
Avtovo: posts small blind $0.50
Troll8989: posts big blind $1
*** HOLE CARDS ***
Dealt to matiko09 [4s 6c]
matiko09: folds 
ozone2003: folds 
ntoperman19: folds 
matiko09 leaves the table
plaindaft1 joins the table at seat #7 
50CandyJoe: folds 
Avtovo: raises $1.50 to $2.50
Troll8989: folds 
Uncalled bet ($1.50) returned to Avtovo
Avtovo collected $2 from pot
Avtovo: doesn't show hand 
*** SUMMARY ***
Total pot $2 | Rake $0 
Seat 1: ntoperman19 folded before Flop (didn't bet)
Seat 2: 50CandyJoe (button) folded before Flop (didn't bet)
Seat 3: Avtovo (small blind) collected ($2)
Seat 4: Troll8989 (big blind) folded before Flop
Seat 5: matiko09 folded before Flop (didn't bet)
Seat 6: ozone2003 folded before Flop (didn't bet)





PokerStars Hand #155012594905:  Hold'em No Limit (€0.25/€0.50 EUR) - 2016/06/21 12:57:11 CET [2016/06/21 6:57:11 ET]
Table 'Lotis II' 6-max Seat #2 is the button
Seat 1: acaestanemo (€50.75 in chips) 
Seat 2: broh202 (€114.33 in chips) 
Seat 3: bricasse1961 (€24.98 in chips) 
Seat 4: matiko09 (€73.13 in chips) 
Seat 5: AlexPles (€50.75 in chips) 
Seat 6: patriot424 (€67.70 in chips) 
bricasse1961: posts small blind €0.25
matiko09: posts big blind €0.50
*** HOLE CARDS ***
Dealt to matiko09 [4s Qc]
AlexPles: folds 
patriot424: folds 
acaestanemo: folds 
broh202: raises €1 to €1.50
bricasse1961: folds 
matiko09: folds 
Uncalled bet (€1) returned to broh202
broh202 collected €1.25 from pot
broh202: doesn't show hand 
*** SUMMARY ***
Total pot €1.25 | Rake €0 
Seat 1: acaestanemo folded before Flop (didn't bet)
Seat 2: broh202 (button) collected (€1.25)
Seat 3: bricasse1961 (small blind) folded before Flop
Seat 4: matiko09 (big blind) folded before Flop
Seat 5: AlexPles folded before Flop (didn't bet)
Seat 6: patriot424 folded before Flop (didn't bet)





PokerStars Hand #155012595966:  Hold'em No Limit (€0.25/€0.50 EUR) - 2016/06/21 12:57:14 CET [2016/06/21 6:57:14 ET]
Table 'Actor II' 6-max Seat #6 is the button
Seat 1: hmverlin (€85.11 in chips) 
Seat 2: ooak182 (€51.09 in chips) 
Seat 3: asmodej666 (€75.34 in chips) 
Seat 4: matiko09 (€50 in chips) 
Seat 5: Rybka1294 (€50 in chips) 
Seat 6: fanmtZ (€20 in chips) 
hmverlin: posts small blind €0.25
ooak182: posts big blind €0.50
*** HOLE CARDS ***
Dealt to matiko09 [4h 9h]
asmodej666: raises €1 to €1.50
matiko09: folds 
Rybka1294: folds 
fanmtZ: folds 
hmverlin: folds 
ooak182: folds 
Uncalled bet (€1) returned to asmodej666
asmodej666 collected €1.25 from pot
asmodej666: doesn't show hand 
*** SUMMARY ***
Total pot €1.25 | Rake €0 
Seat 1: hmverlin (small blind) folded before Flop
Seat 2: ooak182 (big blind) folded before Flop
Seat 3: asmodej666 collected (€1.25)
Seat 4: matiko09 folded before Flop (didn't bet)
Seat 5: Rybka1294 folded before Flop (didn't bet)
Seat 6: fanmtZ (button) folded before Flop (didn't bet)





PokerStars Hand #155012597453:  Hold'em No Limit ($0.50/$1.00 USD) - 2016/06/21 12:57:17 CET [2016/06/21 6:57:17 ET]
Table 'Brauna II' 9-max Seat #6 is the button
Seat 1: wisbc ($102.32 in chips) 
Seat 2: pyromid ($153.27 in chips) 
Seat 3: matiko09 ($100 in chips) 
Seat 4: chenconhaste ($197.50 in chips) 
Seat 6: mbk88 ($173.01 in chips) 
Seat 8: DIMAN_324 ($132.65 in chips) 
Seat 9: torkkdnm ($101.50 in chips) 
DIMAN_324: posts small blind $0.50
torkkdnm: posts big blind $1
*** HOLE CARDS ***
Dealt to matiko09 [Td Qs]
wisbc: raises $2 to $3
pyromid: folds 
matiko09: folds 
chenconhaste: folds 
mbk88: folds 
DIMAN_324: folds 
torkkdnm: calls $2
*** FLOP *** [8s 2s 7s]
torkkdnm: bets $4
wisbc: calls $4
*** TURN *** [8s 2s 7s] [5h]
torkkdnm: bets $9
wisbc: folds 
Uncalled bet ($9) returned to torkkdnm
torkkdnm collected $13.78 from pot
*** SUMMARY ***
Total pot $14.50 | Rake $0.72 
Board [8s 2s 7s 5h]
Seat 1: wisbc folded on the Turn
Seat 2: pyromid folded before Flop (didn't bet)
Seat 3: matiko09 folded before Flop (didn't bet)
Seat 4: chenconhaste folded before Flop (didn't bet)
Seat 6: mbk88 (button) folded before Flop (didn't bet)
Seat 8: DIMAN_324 (small blind) folded before Flop
Seat 9: torkkdnm (big blind) collected ($13.78)





PokerStars Hand #155012598007:  Hold'em No Limit ($0.50/$1.00 USD) - 2016/06/21 12:57:19 CET [2016/06/21 6:57:19 ET]
Table 'Umbriel II' 9-max Seat #3 is the button
Seat 1: Avtovo ($100 in chips) 
Seat 2: rura53 ($78.50 in chips) 
Seat 3: mxustin ($37.75 in chips) 
Seat 4: DIMAN_324 ($111.42 in chips) 
Seat 5: matiko09 ($134.41 in chips) 
Seat 7: chenconhaste ($172.85 in chips) 
Seat 8: ozone2003 ($107.82 in chips) 
Seat 9: Troll8989 ($101.50 in chips) 
DIMAN_324: posts small blind $0.50
matiko09: posts big blind $1
*** HOLE CARDS ***
Dealt to matiko09 [8h Ks]
chenconhaste: folds 
ozone2003: folds 
Troll8989: folds 
Avtovo: folds 
rura53: folds 
mxustin: folds 
DIMAN_324: folds 
Uncalled bet ($0.50) returned to matiko09
matiko09 collected $1 from pot
matiko09: doesn't show hand 
*** SUMMARY ***
Total pot $1 | Rake $0 
Seat 1: Avtovo folded before Flop (didn't bet)
Seat 2: rura53 folded before Flop (didn't bet)
Seat 3: mxustin (button) folded before Flop (didn't bet)
Seat 4: DIMAN_324 (small blind) folded before Flop
Seat 5: matiko09 (big blind) collected ($1)
Seat 7: chenconhaste folded before Flop (didn't bet)
Seat 8: ozone2003 folded before Flop (didn't bet)
Seat 9: Troll8989 folded before Flop (didn't bet)





PokerStars Hand #155012600435:  Hold'em No Limit ($0.50/$1.00 USD) - 2016/06/21 12:57:26 CET [2016/06/21 6:57:26 ET]
Table 'Leo' 9-max Seat #5 is the button
Seat 1: letmegonow ($61.79 in chips) 
Seat 2: torkkdnm ($140.46 in chips) 
Seat 3: matiko09 ($103.80 in chips) 
Seat 4: SharingaaN ($100.83 in chips) 
Seat 5: DIMAN_324 ($103.50 in chips) 
Seat 6: chenconhaste ($124.67 in chips) 
Seat 8: pyromid ($65.17 in chips) 
Seat 9: Wladimir205 ($100 in chips) 
chenconhaste: posts small blind $0.50
pyromid: posts big blind $1
*** HOLE CARDS ***
Dealt to matiko09 [Qd Ks]
Wladimir205: folds 
letmegonow: folds 
torkkdnm: folds 
matiko09: raises $2 to $3
SharingaaN: folds 
DIMAN_324: folds 
chenconhaste: folds 
pyromid: folds 
Uncalled bet ($2) returned to matiko09
matiko09 collected $2.50 from pot
matiko09: doesn't show hand 
*** SUMMARY ***
Total pot $2.50 | Rake $0 
Seat 1: letmegonow folded before Flop (didn't bet)
Seat 2: torkkdnm folded before Flop (didn't bet)
Seat 3: matiko09 collected ($2.50)
Seat 4: SharingaaN folded before Flop (didn't bet)
Seat 5: DIMAN_324 (button) folded before Flop (didn't bet)
Seat 6: chenconhaste (small blind) folded before Flop
Seat 8: pyromid (big blind) folded before Flop
Seat 9: Wladimir205 folded before Flop (didn't bet)





PokerStars Hand #155012601711:  Hold'em No Limit ($0.50/$1.00 USD) - 2016/06/21 12:57:29 CET [2016/06/21 6:57:29 ET]
Table 'Feronia' 9-max Seat #2 is the button
Seat 1: DIMAN_324 ($103.45 in chips) 
Seat 2: Yuder_Lin ($96.50 in chips) 
Seat 3: mbk88 ($144.85 in chips) 
Seat 4: pyromid ($122.94 in chips) 
Seat 5: matiko09 ($115.39 in chips) 
Seat 6: chenconhaste ($118.20 in chips) 
Seat 7: arctur17 ($101.45 in chips) 
Seat 8: letmegonow ($142.91 in chips) 
Seat 9: mi$$I$Elena ($122.04 in chips) 
mbk88: posts small blind $0.50
pyromid: posts big blind $1
*** HOLE CARDS ***
Dealt to matiko09 [6h Th]
matiko09: folds 
chenconhaste: raises $1.25 to $2.25
arctur17: folds 
letmegonow: folds 
mi$$I$Elena: folds 
DIMAN_324: folds 
Yuder_Lin: calls $2.25
mbk88: folds 
pyromid: folds 
*** FLOP *** [8d Kc Qc]
chenconhaste: checks 
Yuder_Lin: bets $3
chenconhaste: folds 
Uncalled bet ($3) returned to Yuder_Lin
Yuder_Lin collected $5.70 from pot
Yuder_Lin: doesn't show hand 
*** SUMMARY ***
Total pot $6 | Rake $0.30 
Board [8d Kc Qc]
Seat 1: DIMAN_324 folded before Flop (didn't bet)
Seat 2: Yuder_Lin (button) collected ($5.70)
Seat 3: mbk88 (small blind) folded before Flop
Seat 4: pyromid (big blind) folded before Flop
Seat 5: matiko09 folded before Flop (didn't bet)
Seat 6: chenconhaste folded on the Flop
Seat 7: arctur17 folded before Flop (didn't bet)
Seat 8: letmegonow folded before Flop (didn't bet)
Seat 9: mi$$I$Elena folded before Flop (didn't bet)





PokerStars Hand #155012602190:  Hold'em No Limit (€0.25/€0.50 EUR) - 2016/06/21 12:57:30 CET [2016/06/21 6:57:30 ET]
Table 'Actor II' 6-max Seat #1 is the button
Seat 1: hmverlin (€84.86 in chips) 
Seat 2: ooak182 (€50.59 in chips) 
Seat 3: asmodej666 (€76.09 in chips) 
Seat 4: matiko09 (€50 in chips) 
Seat 5: Rybka1294 (€50 in chips) 
Seat 6: fanmtZ (€20 in chips) 
ooak182: posts small blind €0.25
asmodej666: posts big blind €0.50
*** HOLE CARDS ***
Dealt to matiko09 [2d As]
matiko09: folds 
Rybka1294: folds 
fanmtZ: raises €0.69 to €1.19
hmverlin: folds 
ooak182: folds 
asmodej666: folds 
Uncalled bet (€0.69) returned to fanmtZ
fanmtZ collected €1.25 from pot
fanmtZ: doesn't show hand 
*** SUMMARY ***
Total pot €1.25 | Rake €0 
Seat 1: hmverlin (button) folded before Flop (didn't bet)
Seat 2: ooak182 (small blind) folded before Flop
Seat 3: asmodej666 (big blind) folded before Flop
Seat 4: matiko09 folded before Flop (didn't bet)
Seat 5: Rybka1294 folded before Flop (didn't bet)
Seat 6: fanmtZ collected (€1.25)





PokerStars Hand #155012603366:  Hold'em No Limit (€0.25/€0.50 EUR) - 2016/06/21 12:57:34 CET [2016/06/21 6:57:34 ET]
Table 'Lotis II' 6-max Seat #3 is the button
Seat 1: acaestanemo (€50.75 in chips) 
Seat 2: broh202 (€115.08 in chips) 
Seat 3: bricasse1961 (€24.73 in chips) 
Seat 4: matiko09 (€72.63 in chips) 
Seat 5: AlexPles (€50.75 in chips) 
Seat 6: patriot424 (€67.70 in chips) 
matiko09: posts small blind €0.25
AlexPles: posts big blind €0.50
*** HOLE CARDS ***
Dealt to matiko09 [4h 2s]
patriot424: folds 
acaestanemo: folds 
broh202: raises €1 to €1.50
bricasse1961: folds 
matiko09: folds 
AlexPles: folds 
Uncalled bet (€1) returned to broh202
broh202 collected €1.25 from pot
broh202: doesn't show hand 
*** SUMMARY ***
Total pot €1.25 | Rake €0 
Seat 1: acaestanemo folded before Flop (didn't bet)
Seat 2: broh202 collected (€1.25)
Seat 3: bricasse1961 (button) folded before Flop (didn't bet)
Seat 4: matiko09 (small blind) folded before Flop
Seat 5: AlexPles (big blind) folded before Flop
Seat 6: patriot424 folded before Flop (didn't bet)





PokerStars Hand #155012606575:  Hold'em No Limit ($0.50/$1.00 USD) - 2016/06/21 12:57:42 CET [2016/06/21 6:57:42 ET]
Table 'Leo' 9-max Seat #6 is the button
Seat 1: letmegonow ($61.79 in chips) 
Seat 2: torkkdnm ($140.46 in chips) 
Seat 3: matiko09 ($105.30 in chips) 
Seat 4: SharingaaN ($100.83 in chips) 
Seat 5: DIMAN_324 ($103.50 in chips) 
Seat 6: chenconhaste ($124.17 in chips) 
Seat 8: pyromid ($64.17 in chips) 
Seat 9: Wladimir205 ($100 in chips) 
pyromid: posts small blind $0.50
Wladimir205: posts big blind $1
*** HOLE CARDS ***
Dealt to matiko09 [7c 8c]
letmegonow: calls $1
torkkdnm: raises $4 to $5
matiko09: folds 
SharingaaN: folds 
DIMAN_324: calls $5
chenconhaste: folds 
pyromid: folds 
Wladimir205: folds 
letmegonow: calls $4
*** FLOP *** [Jh 2c 7d]
letmegonow: checks 
torkkdnm: bets $10
DIMAN_324: calls $10
letmegonow: folds 
*** TURN *** [Jh 2c 7d] [2h]
torkkdnm: bets $22
DIMAN_324: folds 
Uncalled bet ($22) returned to torkkdnm
torkkdnm collected $34.68 from pot
*** SUMMARY ***
Total pot $36.50 | Rake $1.82 
Board [Jh 2c 7d 2h]
Seat 1: letmegonow folded on the Flop
Seat 2: torkkdnm collected ($34.68)
Seat 3: matiko09 folded before Flop (didn't bet)
Seat 4: SharingaaN folded before Flop (didn't bet)
Seat 5: DIMAN_324 folded on the Turn
Seat 6: chenconhaste (button) folded before Flop (didn't bet)
Seat 8: pyromid (small blind) folded before Flop
Seat 9: Wladimir205 (big blind) folded before Flop





PokerStars Hand #155012608109:  Hold'em No Limit ($0.50/$1.00 USD) - 2016/06/21 12:57:47 CET [2016/06/21 6:57:47 ET]
Table 'Carlova II' 9-max Seat #5 is the button
Seat 1: matiko09 ($132.55 in chips) 
Seat 2: chenconhaste ($129.08 in chips) 
Seat 3: King_Z�Manel ($105.95 in chips) 
Seat 4: Dandy Monk ($41.15 in chips) 
Seat 5: ozone2003 ($100 in chips) 
Seat 6: DIMAN_324 ($100 in chips) 
Seat 7: mi$$I$Elena ($100 in chips) 
Seat 8: pyromid ($91.09 in chips) 
Seat 9: Troll8989 ($109.18 in chips) 
DIMAN_324: posts small blind $0.50
mi$$I$Elena: posts big blind $1
*** HOLE CARDS ***
Dealt to matiko09 [5c 3h]
pyromid: folds 
Troll8989: folds 
matiko09: folds 
chenconhaste: folds 
King_Z�Manel: raises $2 to $3
Dandy Monk: folds 
ozone2003: folds 
DIMAN_324: folds 
mi$$I$Elena: folds 
Uncalled bet ($2) returned to King_Z�Manel
King_Z�Manel collected $2.50 from pot
King_Z�Manel: doesn't show hand 
*** SUMMARY ***
Total pot $2.50 | Rake $0 
Seat 1: matiko09 folded before Flop (didn't bet)
Seat 2: chenconhaste folded before Flop (didn't bet)
Seat 3: King_Z�Manel collected ($2.50)
Seat 4: Dandy Monk folded before Flop (didn't bet)
Seat 5: ozone2003 (button) folded before Flop (didn't bet)
Seat 6: DIMAN_324 (small blind) folded before Flop
Seat 7: mi$$I$Elena (big blind) folded before Flop
Seat 8: pyromid folded before Flop (didn't bet)
Seat 9: Troll8989 folded before Flop (didn't bet)





PokerStars Hand #155012608127:  Hold'em No Limit ($0.50/$1.00 USD) - 2016/06/21 12:57:47 CET [2016/06/21 6:57:47 ET]
Table 'Umbriel II' 9-max Seat #4 is the button
Seat 1: Avtovo ($100 in chips) 
Seat 2: rura53 ($78.50 in chips) 
Seat 3: mxustin ($37.75 in chips) 
Seat 4: DIMAN_324 ($110.92 in chips) 
Seat 5: matiko09 ($134.91 in chips) 
Seat 7: chenconhaste ($172.85 in chips) 
Seat 8: ozone2003 ($107.82 in chips) 
Seat 9: Troll8989 ($101.50 in chips) 
matiko09: posts small blind $0.50
chenconhaste: posts big blind $1
*** HOLE CARDS ***
Dealt to matiko09 [Ac Jh]
ozone2003: folds 
Troll8989: folds 
Avtovo: folds 
rura53: folds 
mxustin: folds 
DIMAN_324: raises $1.10 to $2.10
matiko09: raises $6.90 to $9
chenconhaste: folds 
DIMAN_324: calls $6.90
*** FLOP *** [3h Jd 6h]
matiko09: checks 
DIMAN_324: checks 
*** TURN *** [3h Jd 6h] [Jc]
matiko09: bets $9.38
DIMAN_324: folds 
Uncalled bet ($9.38) returned to matiko09
matiko09 collected $18.05 from pot
matiko09: doesn't show hand 
*** SUMMARY ***
Total pot $19 | Rake $0.95 
Board [3h Jd 6h Jc]
Seat 1: Avtovo folded before Flop (didn't bet)
Seat 2: rura53 folded before Flop (didn't bet)
Seat 3: mxustin folded before Flop (didn't bet)
Seat 4: DIMAN_324 (button) folded on the Turn
Seat 5: matiko09 (small blind) collected ($18.05)
Seat 7: chenconhaste (big blind) folded before Flop
Seat 8: ozone2003 folded before Flop (didn't bet)
Seat 9: Troll8989 folded before Flop (didn't bet)





PokerStars Hand #155012609473:  Hold'em No Limit (€0.25/€0.50 EUR) - 2016/06/21 12:57:50 CET [2016/06/21 6:57:50 ET]
Table 'Actor II' 6-max Seat #2 is the button
Seat 1: hmverlin (€84.86 in chips) 
Seat 2: ooak182 (€50.34 in chips) 
Seat 3: asmodej666 (€75.59 in chips) 
Seat 4: matiko09 (€50 in chips) 
Seat 5: Rybka1294 (€50 in chips) 
Seat 6: fanmtZ (€20.75 in chips) 
asmodej666: posts small blind €0.25
matiko09: posts big blind €0.50
*** HOLE CARDS ***
Dealt to matiko09 [6s 2h]
Rybka1294: folds 
fanmtZ: folds 
hmverlin: folds 
ooak182: folds 
asmodej666: folds 
Uncalled bet (€0.25) returned to matiko09
matiko09 collected €0.50 from pot
matiko09: doesn't show hand 
*** SUMMARY ***
Total pot €0.50 | Rake €0 
Seat 1: hmverlin folded before Flop (didn't bet)
Seat 2: ooak182 (button) folded before Flop (didn't bet)
Seat 3: asmodej666 (small blind) folded before Flop
Seat 4: matiko09 (big blind) collected (€0.50)
Seat 5: Rybka1294 folded before Flop (didn't bet)
Seat 6: fanmtZ folded before Flop (didn't bet)





PokerStars Hand #155012610451:  Hold'em No Limit (€0.25/€0.50 EUR) - 2016/06/21 12:57:53 CET [2016/06/21 6:57:53 ET]
Table 'Lotis II' 6-max Seat #4 is the button
Seat 1: acaestanemo (€50.75 in chips) 
Seat 2: broh202 (€115.83 in chips) 
Seat 3: bricasse1961 (€24.73 in chips) 
Seat 4: matiko09 (€72.38 in chips) 
Seat 5: AlexPles (€50.25 in chips) 
Seat 6: patriot424 (€67.70 in chips) 
AlexPles: posts small blind €0.25
patriot424: posts big blind €0.50
*** HOLE CARDS ***
Dealt to matiko09 [Qd Qs]
acaestanemo: folds 
broh202: folds 
bricasse1961: folds 
matiko09: raises €0.63 to €1.13
AlexPles: folds 
patriot424: calls €0.63
*** FLOP *** [6d 6s 6h]
patriot424: checks 
matiko09: bets €1.55
patriot424: calls €1.55
*** TURN *** [6d 6s 6h] [Jh]
patriot424: checks 
matiko09: bets €2.77
patriot424: calls €2.77
*** RIVER *** [6d 6s 6h Jh] [Qh]
patriot424: checks 
matiko09: bets €5.50
patriot424: folds 
Uncalled bet (€5.50) returned to matiko09
matiko09 collected €10.59 from pot
matiko09: doesn't show hand 
*** SUMMARY ***
Total pot €11.15 | Rake €0.56 
Board [6d 6s 6h Jh Qh]
Seat 1: acaestanemo folded before Flop (didn't bet)
Seat 2: broh202 folded before Flop (didn't bet)
Seat 3: bricasse1961 folded before Flop (didn't bet)
Seat 4: matiko09 (button) collected (€10.59)
Seat 5: AlexPles (small blind) folded before Flop
Seat 6: patriot424 (big blind) folded on the River





PokerStars Hand #155012611779:  Hold'em No Limit ($0.50/$1.00 USD) - 2016/06/21 12:57:56 CET [2016/06/21 6:57:56 ET]
Table 'Chimay' 9-max Seat #7 is the button
Seat 1: chenconhaste ($116.05 in chips) 
Seat 2: DIMAN_324 ($137.77 in chips) 
Seat 3: Yuder_Lin ($81.24 in chips) 
Seat 4: fukumimi ($64.88 in chips) 
Seat 6: mbk88 ($111.67 in chips) 
Seat 7: Troll8989 ($100 in chips) 
Seat 8: matiko09 ($104.62 in chips) 
Seat 9: SharingaaN ($96.55 in chips) 
matiko09: posts small blind $0.50
SharingaaN: posts big blind $1
Avtovo: sits out 
*** HOLE CARDS ***
Dealt to matiko09 [Qd 7d]
chenconhaste: folds 
DIMAN_324: folds 
Yuder_Lin: folds 
fukumimi: folds 
mbk88: raises $2 to $3
Troll8989: folds 
matiko09: folds 
SharingaaN: folds 
Uncalled bet ($2) returned to mbk88
mbk88 collected $2.50 from pot
mbk88: doesn't show hand 
*** SUMMARY ***
Total pot $2.50 | Rake $0 
Seat 1: chenconhaste folded before Flop (didn't bet)
Seat 2: DIMAN_324 folded before Flop (didn't bet)
Seat 3: Yuder_Lin folded before Flop (didn't bet)
Seat 4: fukumimi folded before Flop (didn't bet)
Seat 6: mbk88 collected ($2.50)
Seat 7: Troll8989 (button) folded before Flop (didn't bet)
Seat 8: matiko09 (small blind) folded before Flop
Seat 9: SharingaaN (big blind) folded before Flop





PokerStars Hand #155012617917:  Hold'em No Limit (€0.25/€0.50 EUR) - 2016/06/21 12:58:13 CET [2016/06/21 6:58:13 ET]
Table 'Actor II' 6-max Seat #3 is the button
Seat 1: hmverlin (€84.86 in chips) 
Seat 2: ooak182 (€50.34 in chips) 
Seat 3: asmodej666 (€75.34 in chips) 
Seat 4: matiko09 (€50.25 in chips) 
Seat 5: Rybka1294 (€50 in chips) 
Seat 6: fanmtZ (€20.75 in chips) 
matiko09: posts small blind €0.25
Rybka1294: posts big blind €0.50
*** HOLE CARDS ***
Dealt to matiko09 [3d Qd]
fanmtZ: folds 
hmverlin: folds 
ooak182: raises €0.75 to €1.25
asmodej666: folds 
matiko09: folds 
Rybka1294: folds 
Uncalled bet (€0.75) returned to ooak182
ooak182 collected €1.25 from pot
ooak182: doesn't show hand 
*** SUMMARY ***
Total pot €1.25 | Rake €0 
Seat 1: hmverlin folded before Flop (didn't bet)
Seat 2: ooak182 collected (€1.25)
Seat 3: asmodej666 (button) folded before Flop (didn't bet)
Seat 4: matiko09 (small blind) folded before Flop
Seat 5: Rybka1294 (big blind) folded before Flop
Seat 6: fanmtZ folded before Flop (didn't bet)





PokerStars Hand #155012619323:  Hold'em No Limit ($0.50/$1.00 USD) - 2016/06/21 12:58:17 CET [2016/06/21 6:58:17 ET]
Table 'Rupertwildt' 9-max Seat #4 is the button
Seat 1: pokernixxx ($78.85 in chips) 
Seat 2: SharingaaN ($82.73 in chips) 
Seat 3: Saymon_Moo ($71.92 in chips) 
Seat 4: matiko09 ($136.20 in chips) 
Seat 5: pyromid ($93.46 in chips) 
Seat 6: ozone2003 ($100 in chips) 
Seat 7: chenconhaste ($103.84 in chips) 
Seat 8: Gonzanary ($118.14 in chips) 
Seat 9: mbk88 ($122.93 in chips) 
pyromid: posts small blind $0.50
ozone2003: posts big blind $1
*** HOLE CARDS ***
Dealt to matiko09 [Js Jd]
chenconhaste: folds 
Gonzanary: folds 
mbk88: folds 
pokernixxx: calls $1
SharingaaN: raises $4 to $5
Saymon_Moo: folds 
matiko09: calls $5
pyromid: folds 
ozone2003: calls $4
pokernixxx: calls $4
*** FLOP *** [8h 9h Qd]
ozone2003: checks 
pokernixxx: checks 
SharingaaN: checks 
matiko09: checks 
*** TURN *** [8h 9h Qd] [4c]
ozone2003: checks 
pokernixxx: checks 
SharingaaN: checks 
matiko09: bets $10
ozone2003: folds 
pokernixxx: folds 
SharingaaN: folds 
Uncalled bet ($10) returned to matiko09
matiko09 collected $19.48 from pot
matiko09: doesn't show hand 
*** SUMMARY ***
Total pot $20.50 | Rake $1.02 
Board [8h 9h Qd 4c]
Seat 1: pokernixxx folded on the Turn
Seat 2: SharingaaN folded on the Turn
Seat 3: Saymon_Moo folded before Flop (didn't bet)
Seat 4: matiko09 (button) collected ($19.48)
Seat 5: pyromid (small blind) folded before Flop
Seat 6: ozone2003 (big blind) folded on the Turn
Seat 7: chenconhaste folded before Flop (didn't bet)
Seat 8: Gonzanary folded before Flop (didn't bet)
Seat 9: mbk88 folded before Flop (didn't bet)





PokerStars Hand #155012619719:  Hold'em No Limit ($0.50/$1.00 USD) - 2016/06/21 12:58:18 CET [2016/06/21 6:58:18 ET]
Table 'Feronia' 9-max Seat #3 is the button
Seat 1: DIMAN_324 ($103.45 in chips) 
Seat 2: Yuder_Lin ($99.95 in chips) 
Seat 3: mbk88 ($144.35 in chips) 
Seat 4: pyromid ($121.94 in chips) 
Seat 5: matiko09 ($115.39 in chips) 
Seat 6: chenconhaste ($115.95 in chips) 
Seat 7: arctur17 ($101.45 in chips) 
Seat 8: letmegonow ($142.91 in chips) 
Seat 9: mi$$I$Elena ($122.04 in chips) 
pyromid: posts small blind $0.50
matiko09: posts big blind $1
*** HOLE CARDS ***
Dealt to matiko09 [2s 6c]
chenconhaste: folds 
arctur17: folds 
letmegonow: folds 
mi$$I$Elena: folds 
DIMAN_324: folds 
Yuder_Lin: raises $2 to $3
mbk88: folds 
pyromid: folds 
matiko09: folds 
Uncalled bet ($2) returned to Yuder_Lin
Yuder_Lin collected $2.50 from pot
Yuder_Lin: doesn't show hand 
*** SUMMARY ***
Total pot $2.50 | Rake $0 
Seat 1: DIMAN_324 folded before Flop (didn't bet)
Seat 2: Yuder_Lin collected ($2.50)
Seat 3: mbk88 (button) folded before Flop (didn't bet)
Seat 4: pyromid (small blind) folded before Flop
Seat 5: matiko09 (big blind) folded before Flop
Seat 6: chenconhaste folded before Flop (didn't bet)
Seat 7: arctur17 folded before Flop (didn't bet)
Seat 8: letmegonow folded before Flop (didn't bet)
Seat 9: mi$$I$Elena folded before Flop (didn't bet)





PokerStars Hand #155012624448:  Hold'em No Limit ($0.50/$1.00 USD) - 2016/06/21 12:58:31 CET [2016/06/21 6:58:31 ET]
Table 'Chimay' 9-max Seat #8 is the button
Seat 1: chenconhaste ($116.05 in chips) 
Seat 2: DIMAN_324 ($137.77 in chips) 
Seat 3: Yuder_Lin ($81.24 in chips) 
Seat 4: fukumimi ($100 in chips) 
Seat 6: mbk88 ($113.17 in chips) 
Seat 7: Troll8989 ($100 in chips) 
Seat 8: matiko09 ($104.12 in chips) 
Seat 9: SharingaaN ($95.55 in chips) 
SharingaaN: posts small blind $0.50
chenconhaste: posts big blind $1
Avtovo: sits out 
*** HOLE CARDS ***
Dealt to matiko09 [6c 8d]
DIMAN_324: raises $2 to $3
Yuder_Lin: folds 
fukumimi: folds 
mbk88: folds 
Troll8989: folds 
matiko09: folds 
SharingaaN: calls $2.50
chenconhaste: calls $2
*** FLOP *** [9s 4s Jc]
SharingaaN: checks 
chenconhaste: checks 
DIMAN_324: checks 
*** TURN *** [9s 4s Jc] [Kc]
SharingaaN: checks 
chenconhaste: checks 
DIMAN_324: bets $6.41
SharingaaN: folds 
chenconhaste: folds 
Uncalled bet ($6.41) returned to DIMAN_324
DIMAN_324 collected $8.55 from pot
DIMAN_324: doesn't show hand 
*** SUMMARY ***
Total pot $9 | Rake $0.45 
Board [9s 4s Jc Kc]
Seat 1: chenconhaste (big blind) folded on the Turn
Seat 2: DIMAN_324 collected ($8.55)
Seat 3: Yuder_Lin folded before Flop (didn't bet)
Seat 4: fukumimi folded before Flop (didn't bet)
Seat 6: mbk88 folded before Flop (didn't bet)
Seat 7: Troll8989 folded before Flop (didn't bet)
Seat 8: matiko09 (button) folded before Flop (didn't bet)
Seat 9: SharingaaN (small blind) folded on the Turn





PokerStars Hand #155012625024:  Hold'em No Limit ($0.50/$1.00 USD) - 2016/06/21 12:58:32 CET [2016/06/21 6:58:32 ET]
Table 'Carlova II' 9-max Seat #6 is the button
Seat 1: matiko09 ($132.55 in chips) 
Seat 2: chenconhaste ($129.08 in chips) 
Seat 3: King_Z�Manel ($107.45 in chips) 
Seat 4: Dandy Monk ($41.15 in chips) 
Seat 5: ozone2003 ($100 in chips) 
Seat 6: DIMAN_324 ($100 in chips) 
Seat 7: mi$$I$Elena ($100 in chips) 
Seat 8: pyromid ($91.09 in chips) 
Seat 9: Troll8989 ($109.18 in chips) 
mi$$I$Elena: posts small blind $0.50
pyromid: posts big blind $1
*** HOLE CARDS ***
Dealt to matiko09 [Js Jd]
Troll8989: folds 
matiko09: raises $2 to $3
chenconhaste: folds 
King_Z�Manel: folds 
Dandy Monk: folds 
ozone2003: folds 
DIMAN_324: folds 
mi$$I$Elena: folds 
pyromid: folds 
Uncalled bet ($2) returned to matiko09
matiko09 collected $2.50 from pot
matiko09: doesn't show hand 
*** SUMMARY ***
Total pot $2.50 | Rake $0 
Seat 1: matiko09 collected ($2.50)
Seat 2: chenconhaste folded before Flop (didn't bet)
Seat 3: King_Z�Manel folded before Flop (didn't bet)
Seat 4: Dandy Monk folded before Flop (didn't bet)
Seat 5: ozone2003 folded before Flop (didn't bet)
Seat 6: DIMAN_324 (button) folded before Flop (didn't bet)
Seat 7: mi$$I$Elena (small blind) folded before Flop
Seat 8: pyromid (big blind) folded before Flop
Seat 9: Troll8989 folded before Flop (didn't bet)





PokerStars Hand #155012625419:  Hold'em No Limit (€0.25/€0.50 EUR) - 2016/06/21 12:58:33 CET [2016/06/21 6:58:33 ET]
Table 'Actor II' 6-max Seat #4 is the button
Seat 1: hmverlin (€84.86 in chips) 
Seat 2: ooak182 (€51.09 in chips) 
Seat 3: asmodej666 (€75.34 in chips) 
Seat 4: matiko09 (€50 in chips) 
Seat 5: Rybka1294 (€50 in chips) 
Seat 6: fanmtZ (€20.75 in chips) 
Rybka1294: posts small blind €0.25
fanmtZ: posts big blind €0.50
*** HOLE CARDS ***
Dealt to matiko09 [Kd 2s]
hmverlin: raises €1 to €1.50
ooak182: folds 
asmodej666: folds 
matiko09: folds 
Rybka1294: folds 
fanmtZ: calls €1
*** FLOP *** [9c Jh 8s]
fanmtZ: checks 
hmverlin: bets €2
fanmtZ: calls €2
*** TURN *** [9c Jh 8s] [Td]
fanmtZ: checks 
hmverlin: checks 
*** RIVER *** [9c Jh 8s Td] [5d]
fanmtZ: bets €1.75
hmverlin: calls €1.75
*** SHOW DOWN ***
fanmtZ: shows [Jd Ks] (a pair of Jacks)
hmverlin: mucks hand 
fanmtZ collected €10.21 from pot
*** SUMMARY ***
Total pot €10.75 | Rake €0.54 
Board [9c Jh 8s Td 5d]
Seat 1: hmverlin mucked [Ts Kh]
Seat 2: ooak182 folded before Flop (didn't bet)
Seat 3: asmodej666 folded before Flop (didn't bet)
Seat 4: matiko09 (button) folded before Flop (didn't bet)
Seat 5: Rybka1294 (small blind) folded before Flop
Seat 6: fanmtZ (big blind) showed [Jd Ks] and won (€10.21) with a pair of Jacks





PokerStars Hand #155012625758:  Hold'em No Limit ($0.50/$1.00 USD) - 2016/06/21 12:58:34 CET [2016/06/21 6:58:34 ET]
Table 'Brauna II' 9-max Seat #8 is the button
Seat 1: wisbc ($95.32 in chips) 
Seat 2: pyromid ($153.27 in chips) 
Seat 3: matiko09 ($100 in chips) 
Seat 4: chenconhaste ($197.50 in chips) 
Seat 5: fukumimi ($100 in chips) 
Seat 6: mbk88 ($173.01 in chips) 
Seat 8: DIMAN_324 ($132.15 in chips) 
Seat 9: torkkdnm ($108.28 in chips) 
torkkdnm: posts small blind $0.50
wisbc: posts big blind $1
*** HOLE CARDS ***
Dealt to matiko09 [4s Th]
pyromid: folds 
matiko09: folds 
chenconhaste: folds 
fukumimi: folds 
mbk88: folds 
DIMAN_324: folds 
torkkdnm: folds 
Uncalled bet ($0.50) returned to wisbc
wisbc collected $1 from pot
wisbc: doesn't show hand 
*** SUMMARY ***
Total pot $1 | Rake $0 
Seat 1: wisbc (big blind) collected ($1)
Seat 2: pyromid folded before Flop (didn't bet)
Seat 3: matiko09 folded before Flop (didn't bet)
Seat 4: chenconhaste folded before Flop (didn't bet)
Seat 5: fukumimi folded before Flop (didn't bet)
Seat 6: mbk88 folded before Flop (didn't bet)
Seat 8: DIMAN_324 (button) folded before Flop (didn't bet)
Seat 9: torkkdnm (small blind) folded before Flop





PokerStars Hand #155012627006:  Hold'em No Limit ($0.50/$1.00 USD) - 2016/06/21 12:58:38 CET [2016/06/21 6:58:38 ET]
Table 'Umbriel II' 9-max Seat #5 is the button
Seat 1: Avtovo ($100 in chips) 
Seat 2: rura53 ($78.50 in chips) 
Seat 3: mxustin ($37.75 in chips) 
Seat 4: DIMAN_324 ($101.92 in chips) 
Seat 5: matiko09 ($143.96 in chips) 
Seat 7: chenconhaste ($171.85 in chips) 
Seat 8: ozone2003 ($107.82 in chips) 
Seat 9: Troll8989 ($101.50 in chips) 
chenconhaste: posts small blind $0.50
ozone2003: posts big blind $1
*** HOLE CARDS ***
Dealt to matiko09 [2h 4d]
Troll8989: folds 
Avtovo: folds 
rura53: folds 
mxustin: raises $2 to $3
DIMAN_324: folds 
matiko09: folds 
chenconhaste: folds 
ozone2003: folds 
Uncalled bet ($2) returned to mxustin
mxustin collected $2.50 from pot
mxustin: doesn't show hand 
*** SUMMARY ***
Total pot $2.50 | Rake $0 
Seat 1: Avtovo folded before Flop (didn't bet)
Seat 2: rura53 folded before Flop (didn't bet)
Seat 3: mxustin collected ($2.50)
Seat 4: DIMAN_324 folded before Flop (didn't bet)
Seat 5: matiko09 (button) folded before Flop (didn't bet)
Seat 7: chenconhaste (small blind) folded before Flop
Seat 8: ozone2003 (big blind) folded before Flop
Seat 9: Troll8989 folded before Flop (didn't bet)





PokerStars Hand #155012628057:  Hold'em No Limit ($0.50/$1.00 USD) - 2016/06/21 12:58:41 CET [2016/06/21 6:58:41 ET]
Table 'Moreau' 9-max Seat #7 is the button
Seat 1: 50CandyJoe ($105.47 in chips) 
Seat 2: nubpoker ($140.39 in chips) 
Seat 3: matiko09 ($101.50 in chips) 
Seat 4: bonesnz1 ($75.77 in chips) 
Seat 5: DIMAN_324 ($105.88 in chips) 
Seat 6: mbk88 ($100 in chips) 
Seat 7: PanKwn15 ($14.72 in chips) 
Seat 9: Toonersens ($129.91 in chips) 
Toonersens: posts small blind $0.50
50CandyJoe: posts big blind $1
*** HOLE CARDS ***
Dealt to matiko09 [Kc 6c]
nubpoker: folds 
matiko09: folds 
bonesnz1: folds 
DIMAN_324: raises $2 to $3
mbk88: folds 
PanKwn15: folds 
Toonersens: folds 
50CandyJoe: folds 
Uncalled bet ($2) returned to DIMAN_324
DIMAN_324 collected $2.50 from pot
DIMAN_324: doesn't show hand 
*** SUMMARY ***
Total pot $2.50 | Rake $0 
Seat 1: 50CandyJoe (big blind) folded before Flop
Seat 2: nubpoker folded before Flop (didn't bet)
Seat 3: matiko09 folded before Flop (didn't bet)
Seat 4: bonesnz1 folded before Flop (didn't bet)
Seat 5: DIMAN_324 collected ($2.50)
Seat 6: mbk88 folded before Flop (didn't bet)
Seat 7: PanKwn15 (button) folded before Flop (didn't bet)
Seat 9: Toonersens (small blind) folded before Flop





PokerStars Hand #155012635528:  Hold'em No Limit ($0.50/$1.00 USD) - 2016/06/21 12:59:01 CET [2016/06/21 6:59:01 ET]
Table 'Feronia' 9-max Seat #4 is the button
Seat 1: DIMAN_324 ($103.45 in chips) 
Seat 2: Yuder_Lin ($101.45 in chips) 
Seat 3: mbk88 ($144.35 in chips) 
Seat 4: pyromid ($121.44 in chips) 
Seat 5: matiko09 ($114.39 in chips) 
Seat 6: chenconhaste ($115.95 in chips) 
Seat 7: arctur17 ($101.45 in chips) 
Seat 8: letmegonow ($142.91 in chips) 
Seat 9: mi$$I$Elena ($122.04 in chips) 
matiko09: posts small blind $0.50
chenconhaste: posts big blind $1
*** HOLE CARDS ***
Dealt to matiko09 [8c 6s]
arctur17: folds 
letmegonow: folds 
mi$$I$Elena: folds 
DIMAN_324: folds 
Yuder_Lin: folds 
mbk88: folds 
pyromid: folds 
matiko09: folds 
Uncalled bet ($0.50) returned to chenconhaste
chenconhaste collected $1 from pot
*** SUMMARY ***
Total pot $1 | Rake $0 
Seat 1: DIMAN_324 folded before Flop (didn't bet)
Seat 2: Yuder_Lin folded before Flop (didn't bet)
Seat 3: mbk88 folded before Flop (didn't bet)
Seat 4: pyromid (button) folded before Flop (didn't bet)
Seat 5: matiko09 (small blind) folded before Flop
Seat 6: chenconhaste (big blind) collected ($1)
Seat 7: arctur17 folded before Flop (didn't bet)
Seat 8: letmegonow folded before Flop (didn't bet)
Seat 9: mi$$I$Elena folded before Flop (didn't bet)





PokerStars Hand #155012636874:  Hold'em No Limit (€0.25/€0.50 EUR) - 2016/06/21 12:59:04 CET [2016/06/21 6:59:04 ET]
Table 'Lotis II' 6-max Seat #5 is the button
Seat 1: acaestanemo (€50.75 in chips) 
Seat 2: broh202 (€115.83 in chips) 
Seat 3: bricasse1961 (€24.73 in chips) 
Seat 4: matiko09 (€77.52 in chips) 
Seat 5: AlexPles (€50 in chips) 
Seat 6: patriot424 (€62.25 in chips) 
patriot424: posts small blind €0.25
acaestanemo: posts big blind €0.50
*** HOLE CARDS ***
Dealt to matiko09 [Js 7h]
broh202: folds 
bricasse1961: folds 
matiko09: folds 
AlexPles: folds 
patriot424: folds 
Uncalled bet (€0.25) returned to acaestanemo
acaestanemo collected €0.50 from pot
*** SUMMARY ***
Total pot €0.50 | Rake €0 
Seat 1: acaestanemo (big blind) collected (€0.50)
Seat 2: broh202 folded before Flop (didn't bet)
Seat 3: bricasse1961 folded before Flop (didn't bet)
Seat 4: matiko09 folded before Flop (didn't bet)
Seat 5: AlexPles (button) folded before Flop (didn't bet)
Seat 6: patriot424 (small blind) folded before Flop





PokerStars Hand #155012638182:  Hold'em No Limit ($0.50/$1.00 USD) - 2016/06/21 12:59:08 CET [2016/06/21 6:59:08 ET]
Table 'Carlova II' 9-max Seat #7 is the button
Seat 1: matiko09 ($134.05 in chips) 
Seat 2: chenconhaste ($129.08 in chips) 
Seat 3: King_Z�Manel ($107.45 in chips) 
Seat 4: Dandy Monk ($41.15 in chips) 
Seat 5: ozone2003 ($100 in chips) 
Seat 6: DIMAN_324 ($100 in chips) 
Seat 7: mi$$I$Elena ($100 in chips) 
Seat 8: pyromid ($90.09 in chips) 
Seat 9: Troll8989 ($109.18 in chips) 
pyromid: posts small blind $0.50
Troll8989: posts big blind $1
*** HOLE CARDS ***
Dealt to matiko09 [Qd 3d]
matiko09: folds 
chenconhaste: folds 
King_Z�Manel: folds 
Dandy Monk: raises $1.50 to $2.50
ozone2003: folds 
DIMAN_324: folds 
mi$$I$Elena: calls $2.50
pyromid: folds 
Troll8989: folds 
*** FLOP *** [5d 6d 6c]
Dandy Monk: checks 
mi$$I$Elena: bets $4
Dandy Monk: folds 
Uncalled bet ($4) returned to mi$$I$Elena
mi$$I$Elena collected $6.18 from pot
mi$$I$Elena: doesn't show hand 
*** SUMMARY ***
Total pot $6.50 | Rake $0.32 
Board [5d 6d 6c]
Seat 1: matiko09 folded before Flop (didn't bet)
Seat 2: chenconhaste folded before Flop (didn't bet)
Seat 3: King_Z�Manel folded before Flop (didn't bet)
Seat 4: Dandy Monk folded on the Flop
Seat 5: ozone2003 folded before Flop (didn't bet)
Seat 6: DIMAN_324 folded before Flop (didn't bet)
Seat 7: mi$$I$Elena (button) collected ($6.18)
Seat 8: pyromid (small blind) folded before Flop
Seat 9: Troll8989 (big blind) folded before Flop





PokerStars Hand #155012640376:  Hold'em No Limit ($0.50/$1.00 USD) - 2016/06/21 12:59:14 CET [2016/06/21 6:59:14 ET]
Table 'Umbriel II' 9-max Seat #7 is the button
Seat 1: Avtovo ($100 in chips) 
Seat 2: rura53 ($78.50 in chips) 
Seat 3: mxustin ($39.25 in chips) 
Seat 4: DIMAN_324 ($101.92 in chips) 
Seat 5: matiko09 ($143.96 in chips) 
Seat 7: chenconhaste ($171.35 in chips) 
Seat 8: ozone2003 ($106.82 in chips) 
Seat 9: Troll8989 ($101.50 in chips) 
ozone2003: posts small blind $0.50
Troll8989: posts big blind $1
*** HOLE CARDS ***
Dealt to matiko09 [Th Qd]
Avtovo: folds 
rura53: folds 
mxustin: folds 
DIMAN_324: folds 
matiko09: raises $1.50 to $2.50
chenconhaste: folds 
ozone2003: folds 
Troll8989: folds 
Uncalled bet ($1.50) returned to matiko09
matiko09 collected $2.50 from pot
matiko09: doesn't show hand 
*** SUMMARY ***
Total pot $2.50 | Rake $0 
Seat 1: Avtovo folded before Flop (didn't bet)
Seat 2: rura53 folded before Flop (didn't bet)
Seat 3: mxustin folded before Flop (didn't bet)
Seat 4: DIMAN_324 folded before Flop (didn't bet)
Seat 5: matiko09 collected ($2.50)
Seat 7: chenconhaste (button) folded before Flop (didn't bet)
Seat 8: ozone2003 (small blind) folded before Flop
Seat 9: Troll8989 (big blind) folded before Flop





PokerStars Hand #155012642686:  Hold'em No Limit ($0.50/$1.00 USD) - 2016/06/21 12:59:20 CET [2016/06/21 6:59:20 ET]
Table 'Brauna II' 9-max Seat #9 is the button
Seat 1: wisbc ($95.82 in chips) 
Seat 2: pyromid ($153.27 in chips) 
Seat 3: matiko09 ($100 in chips) 
Seat 4: chenconhaste ($197.50 in chips) 
Seat 5: fukumimi ($100 in chips) 
Seat 6: mbk88 ($173.01 in chips) 
Seat 8: DIMAN_324 ($132.15 in chips) 
Seat 9: torkkdnm ($107.78 in chips) 
wisbc: posts small blind $0.50
pyromid: posts big blind $1
*** HOLE CARDS ***
Dealt to matiko09 [Tc 5d]
matiko09: folds 
chenconhaste: raises $1.25 to $2.25
fukumimi: folds 
mbk88: folds 
DIMAN_324: folds 
torkkdnm: folds 
wisbc: folds 
pyromid: folds 
Uncalled bet ($1.25) returned to chenconhaste
chenconhaste collected $2.50 from pot
*** SUMMARY ***
Total pot $2.50 | Rake $0 
Seat 1: wisbc (small blind) folded before Flop
Seat 2: pyromid (big blind) folded before Flop
Seat 3: matiko09 folded before Flop (didn't bet)
Seat 4: chenconhaste collected ($2.50)
Seat 5: fukumimi folded before Flop (didn't bet)
Seat 6: mbk88 folded before Flop (didn't bet)
Seat 8: DIMAN_324 folded before Flop (didn't bet)
Seat 9: torkkdnm (button) folded before Flop (didn't bet)





PokerStars Hand #155012643109:  Hold'em No Limit ($0.50/$1.00 USD) - 2016/06/21 12:59:21 CET [2016/06/21 6:59:21 ET]
Table 'Moreau' 9-max Seat #9 is the button
Seat 1: 50CandyJoe ($104.47 in chips) 
Seat 2: nubpoker ($140.39 in chips) 
Seat 3: matiko09 ($101.50 in chips) 
Seat 4: bonesnz1 ($75.77 in chips) 
Seat 5: DIMAN_324 ($107.38 in chips) 
Seat 6: mbk88 ($100 in chips) 
Seat 7: PanKwn15 ($14.72 in chips) 
Seat 9: Toonersens ($129.41 in chips) 
50CandyJoe: posts small blind $0.50
nubpoker: posts big blind $1
*** HOLE CARDS ***
Dealt to matiko09 [6s Td]
matiko09: folds 
bonesnz1: folds 
DIMAN_324: folds 
mbk88: folds 
PanKwn15: raises $1.50 to $2.50
Toonersens: folds 
50CandyJoe: folds 
nubpoker: folds 
Uncalled bet ($1.50) returned to PanKwn15
PanKwn15 collected $2.50 from pot
PanKwn15: doesn't show hand 
*** SUMMARY ***
Total pot $2.50 | Rake $0 
Seat 1: 50CandyJoe (small blind) folded before Flop
Seat 2: nubpoker (big blind) folded before Flop
Seat 3: matiko09 folded before Flop (didn't bet)
Seat 4: bonesnz1 folded before Flop (didn't bet)
Seat 5: DIMAN_324 folded before Flop (didn't bet)
Seat 6: mbk88 folded before Flop (didn't bet)
Seat 7: PanKwn15 collected ($2.50)
Seat 9: Toonersens (button) folded before Flop (didn't bet)





PokerStars Hand #155012645010:  Hold'em No Limit ($0.50/$1.00 USD) - 2016/06/21 12:59:26 CET [2016/06/21 6:59:26 ET]
Table 'Leo' 9-max Seat #8 is the button
Seat 1: letmegonow ($56.79 in chips) 
Seat 2: torkkdnm ($160.14 in chips) 
Seat 3: matiko09 ($105.30 in chips) 
Seat 4: SharingaaN ($100.83 in chips) 
Seat 5: DIMAN_324 ($100 in chips) 
Seat 6: chenconhaste ($124.17 in chips) 
Seat 8: pyromid ($63.67 in chips) 
Seat 9: Wladimir205 ($99 in chips) 
Wladimir205: posts small blind $0.50
letmegonow: posts big blind $1
*** HOLE CARDS ***
Dealt to matiko09 [9c Qc]
torkkdnm: raises $2 to $3
matiko09: folds 
SharingaaN: folds 
DIMAN_324: folds 
chenconhaste: folds 
pyromid: folds 
Wladimir205: folds 
letmegonow: calls $2
*** FLOP *** [9s 5h Td]
letmegonow: checks 
torkkdnm: bets $4
letmegonow: calls $4
*** TURN *** [9s 5h Td] [6d]
letmegonow: checks 
torkkdnm: checks 
*** RIVER *** [9s 5h Td 6d] [Kh]
letmegonow: checks 
torkkdnm: checks 
*** SHOW DOWN ***
letmegonow: shows [Ts 8s] (a pair of Tens)
torkkdnm: mucks hand 
letmegonow collected $13.78 from pot
*** SUMMARY ***
Total pot $14.50 | Rake $0.72 
Board [9s 5h Td 6d Kh]
Seat 1: letmegonow (big blind) showed [Ts 8s] and won ($13.78) with a pair of Tens
Seat 2: torkkdnm mucked [Ad Qd]
Seat 3: matiko09 folded before Flop (didn't bet)
Seat 4: SharingaaN folded before Flop (didn't bet)
Seat 5: DIMAN_324 folded before Flop (didn't bet)
Seat 6: chenconhaste folded before Flop (didn't bet)
Seat 8: pyromid (button) folded before Flop (didn't bet)
Seat 9: Wladimir205 (small blind) folded before Flop





PokerStars Hand #155012645918:  Hold'em No Limit (€0.25/€0.50 EUR) - 2016/06/21 12:59:29 CET [2016/06/21 6:59:29 ET]
Table 'Lotis II' 6-max Seat #6 is the button
Seat 1: acaestanemo (€51 in chips) 
Seat 2: broh202 (€115.83 in chips) 
Seat 3: bricasse1961 (€24.73 in chips) 
Seat 4: matiko09 (€77.52 in chips) 
Seat 5: AlexPles (€50 in chips) 
Seat 6: patriot424 (€62 in chips) 
acaestanemo: posts small blind €0.25
broh202: posts big blind €0.50
*** HOLE CARDS ***
Dealt to matiko09 [5d 9s]
bricasse1961: folds 
matiko09: folds 
AlexPles: raises €0.75 to €1.25
patriot424 is disconnected 
patriot424 has timed out while disconnected
patriot424: folds 
acaestanemo: folds 
broh202: folds 
Uncalled bet (€0.75) returned to AlexPles
AlexPles collected €1.25 from pot
AlexPles: doesn't show hand 
*** SUMMARY ***
Total pot €1.25 | Rake €0 
Seat 1: acaestanemo (small blind) folded before Flop
Seat 2: broh202 (big blind) folded before Flop
Seat 3: bricasse1961 folded before Flop (didn't bet)
Seat 4: matiko09 folded before Flop (didn't bet)
Seat 5: AlexPles collected (€1.25)
Seat 6: patriot424 (button) folded before Flop (didn't bet)





PokerStars Hand #155012647042:  Hold'em No Limit ($0.50/$1.00 USD) - 2016/06/21 12:59:32 CET [2016/06/21 6:59:32 ET]
Table 'Feronia' 9-max Seat #5 is the button
Seat 1: DIMAN_324 ($103.45 in chips) 
Seat 2: Yuder_Lin ($101.45 in chips) 
Seat 3: mbk88 ($144.35 in chips) 
Seat 4: pyromid ($121.44 in chips) 
Seat 5: matiko09 ($113.89 in chips) 
Seat 6: chenconhaste ($116.45 in chips) 
Seat 7: arctur17 ($101.45 in chips) 
Seat 8: letmegonow ($142.91 in chips) 
Seat 9: mi$$I$Elena ($122.04 in chips) 
chenconhaste: posts small blind $0.50
arctur17: posts big blind $1
*** HOLE CARDS ***
Dealt to matiko09 [Qs 2d]
letmegonow: folds 
mi$$I$Elena: folds 
DIMAN_324: folds 
Yuder_Lin: folds 
mbk88: folds 
pyromid: folds 
matiko09: folds 
chenconhaste: raises $2 to $3
arctur17: raises $5 to $8
chenconhaste: folds 
Uncalled bet ($5) returned to arctur17
arctur17 collected $6 from pot
arctur17: doesn't show hand 
*** SUMMARY ***
Total pot $6 | Rake $0 
Seat 1: DIMAN_324 folded before Flop (didn't bet)
Seat 2: Yuder_Lin folded before Flop (didn't bet)
Seat 3: mbk88 folded before Flop (didn't bet)
Seat 4: pyromid folded before Flop (didn't bet)
Seat 5: matiko09 (button) folded before Flop (didn't bet)
Seat 6: chenconhaste (small blind) folded before Flop
Seat 7: arctur17 (big blind) collected ($6)
Seat 8: letmegonow folded before Flop (didn't bet)
Seat 9: mi$$I$Elena folded before Flop (didn't bet)





PokerStars Hand #155012647496:  Hold'em No Limit (€0.25/€0.50 EUR) - 2016/06/21 12:59:33 CET [2016/06/21 6:59:33 ET]
Table 'Actor II' 6-max Seat #5 is the button
Seat 1: hmverlin (€79.61 in chips) 
Seat 2: ooak182 (€51.09 in chips) 
Seat 3: asmodej666 (€75.34 in chips) 
Seat 4: matiko09 (€50 in chips) 
Seat 5: Rybka1294 (€50 in chips) 
Seat 6: fanmtZ (€25.71 in chips) 
fanmtZ: posts small blind €0.25
hmverlin: posts big blind €0.50
*** HOLE CARDS ***
Dealt to matiko09 [Ac 9d]
ooak182: folds 
asmodej666: folds 
matiko09: raises €1 to €1.50
Rybka1294: folds 
fanmtZ: folds 
hmverlin: folds 
Uncalled bet (€1) returned to matiko09
matiko09 collected €1.25 from pot
matiko09: doesn't show hand 
*** SUMMARY ***
Total pot €1.25 | Rake €0 
Seat 1: hmverlin (big blind) folded before Flop
Seat 2: ooak182 folded before Flop (didn't bet)
Seat 3: asmodej666 folded before Flop (didn't bet)
Seat 4: matiko09 collected (€1.25)
Seat 5: Rybka1294 (button) folded before Flop (didn't bet)
Seat 6: fanmtZ (small blind) folded before Flop





PokerStars Hand #155012650962:  Hold'em No Limit ($0.50/$1.00 USD) - 2016/06/21 12:59:43 CET [2016/06/21 6:59:43 ET]
Table 'Rupertwildt' 9-max Seat #5 is the button
Seat 1: pokernixxx ($73.85 in chips) 
Seat 2: SharingaaN ($77.73 in chips) 
Seat 3: Saymon_Moo ($71.92 in chips) 
Seat 4: matiko09 ($150.68 in chips) 
Seat 5: pyromid ($92.96 in chips) 
Seat 6: ozone2003 ($100 in chips) 
Seat 7: chenconhaste ($103.84 in chips) 
Seat 8: Gonzanary ($118.14 in chips) 
Seat 9: mbk88 ($122.93 in chips) 
ozone2003: posts small blind $0.50
chenconhaste: posts big blind $1
*** HOLE CARDS ***
Dealt to matiko09 [Ks 4h]
Gonzanary: folds 
mbk88: folds 
pokernixxx: raises $1 to $2
SharingaaN: calls $2
Saymon_Moo: calls $2
matiko09: folds 
pyromid: folds 
ozone2003: folds 
chenconhaste: folds 
*** FLOP *** [3s 8c Th]
pokernixxx: checks 
SharingaaN: checks 
Saymon_Moo: checks 
*** TURN *** [3s 8c Th] [4s]
pokernixxx: bets $2
SharingaaN: folds 
Saymon_Moo: calls $2
*** RIVER *** [3s 8c Th 4s] [As]
pokernixxx: bets $7
Saymon_Moo: folds 
Uncalled bet ($7) returned to pokernixxx
pokernixxx collected $10.92 from pot
pokernixxx: doesn't show hand 
*** SUMMARY ***
Total pot $11.50 | Rake $0.58 
Board [3s 8c Th 4s As]
Seat 1: pokernixxx collected ($10.92)
Seat 2: SharingaaN folded on the Turn
Seat 3: Saymon_Moo folded on the River
Seat 4: matiko09 folded before Flop (didn't bet)
Seat 5: pyromid (button) folded before Flop (didn't bet)
Seat 6: ozone2003 (small blind) folded before Flop
Seat 7: chenconhaste (big blind) folded before Flop
Seat 8: Gonzanary folded before Flop (didn't bet)
Seat 9: mbk88 folded before Flop (didn't bet)





PokerStars Hand #155012652652:  Hold'em No Limit (€0.25/€0.50 EUR) - 2016/06/21 12:59:47 CET [2016/06/21 6:59:47 ET]
Table 'Actor II' 6-max Seat #6 is the button
Seat 1: hmverlin (€79.11 in chips) 
Seat 2: ooak182 (€51.09 in chips) 
Seat 3: asmodej666 (€75.34 in chips) 
Seat 4: matiko09 (€50.75 in chips) 
Seat 5: Rybka1294 (€50 in chips) 
Seat 6: fanmtZ (€25.46 in chips) 
hmverlin: posts small blind €0.25
ooak182: posts big blind €0.50
*** HOLE CARDS ***
Dealt to matiko09 [3s 9h]
asmodej666: folds 
matiko09: folds 
Rybka1294: folds 
fanmtZ: raises €0.79 to €1.29
hmverlin: folds 
ooak182: folds 
Uncalled bet (€0.79) returned to fanmtZ
fanmtZ collected €1.25 from pot
fanmtZ: doesn't show hand 
*** SUMMARY ***
Total pot €1.25 | Rake €0 
Seat 1: hmverlin (small blind) folded before Flop
Seat 2: ooak182 (big blind) folded before Flop
Seat 3: asmodej666 folded before Flop (didn't bet)
Seat 4: matiko09 folded before Flop (didn't bet)
Seat 5: Rybka1294 folded before Flop (didn't bet)
Seat 6: fanmtZ (button) collected (€1.25)





PokerStars Hand #155012653346:  Hold'em No Limit ($0.50/$1.00 USD) - 2016/06/21 12:59:49 CET [2016/06/21 6:59:49 ET]
Table 'Cheleb' 9-max Seat #4 is the button
Seat 1: SharingaaN ($91.22 in chips) 
Seat 2: pyromid ($139.88 in chips) 
Seat 3: bonesnz1 ($42.39 in chips) 
Seat 4: DIMAN_324 ($181.07 in chips) 
Seat 5: Avtovo ($139.50 in chips) 
Seat 6: matiko09 ($100 in chips) 
Seat 7: DomiVY ($40 in chips) 
Seat 8: Troll8989 ($100 in chips) 
Seat 9: chenconhaste ($117.52 in chips) 
Avtovo: posts small blind $0.50
matiko09: posts big blind $1
*** HOLE CARDS ***
Dealt to matiko09 [7d 8d]
DomiVY: folds 
Troll8989: folds 
chenconhaste: folds 
SharingaaN: raises $2 to $3
pyromid: folds 
bonesnz1: folds 
DIMAN_324: folds 
Avtovo: calls $2.50
matiko09: calls $2
*** FLOP *** [6s Qs 9c]
Avtovo: checks 
matiko09: checks 
SharingaaN: bets $6.84
Avtovo: folds 
matiko09: calls $6.84
*** TURN *** [6s Qs 9c] [4h]
matiko09: checks 
SharingaaN: checks 
*** RIVER *** [6s Qs 9c 4h] [6d]
matiko09: bets $10
SharingaaN: calls $10
*** SHOW DOWN ***
matiko09: shows [7d 8d] (a pair of Sixes)
SharingaaN: shows [Qd Jh] (two pair, Queens and Sixes)
SharingaaN collected $40.55 from pot
*** SUMMARY ***
Total pot $42.68 | Rake $2.13 
Board [6s Qs 9c 4h 6d]
Seat 1: SharingaaN showed [Qd Jh] and won ($40.55) with two pair, Queens and Sixes
Seat 2: pyromid folded before Flop (didn't bet)
Seat 3: bonesnz1 folded before Flop (didn't bet)
Seat 4: DIMAN_324 (button) folded before Flop (didn't bet)
Seat 5: Avtovo (small blind) folded on the Flop
Seat 6: matiko09 (big blind) showed [7d 8d] and lost with a pair of Sixes
Seat 7: DomiVY folded before Flop (didn't bet)
Seat 8: Troll8989 folded before Flop (didn't bet)
Seat 9: chenconhaste folded before Flop (didn't bet)





PokerStars Hand #155012653710:  Hold'em No Limit ($0.50/$1.00 USD) - 2016/06/21 12:59:50 CET [2016/06/21 6:59:50 ET]
Table 'Brauna II' 9-max Seat #1 is the button
Seat 1: wisbc ($95.32 in chips) 
Seat 2: pyromid ($152.27 in chips) 
Seat 3: matiko09 ($100 in chips) 
Seat 4: chenconhaste ($199 in chips) 
Seat 5: fukumimi ($100 in chips) 
Seat 6: mbk88 ($173.01 in chips) 
Seat 8: DIMAN_324 ($132.15 in chips) 
Seat 9: torkkdnm ($107.78 in chips) 
pyromid: posts small blind $0.50
matiko09: posts big blind $1
*** HOLE CARDS ***
Dealt to matiko09 [5h 9h]
chenconhaste: folds 
fukumimi: folds 
mbk88: folds 
DIMAN_324: raises $1.50 to $2.50
torkkdnm: folds 
wisbc: folds 
pyromid: folds 
matiko09: folds 
Uncalled bet ($1.50) returned to DIMAN_324
DIMAN_324 collected $2.50 from pot
DIMAN_324: doesn't show hand 
*** SUMMARY ***
Total pot $2.50 | Rake $0 
Seat 1: wisbc (button) folded before Flop (didn't bet)
Seat 2: pyromid (small blind) folded before Flop
Seat 3: matiko09 (big blind) folded before Flop
Seat 4: chenconhaste folded before Flop (didn't bet)
Seat 5: fukumimi folded before Flop (didn't bet)
Seat 6: mbk88 folded before Flop (didn't bet)
Seat 8: DIMAN_324 collected ($2.50)
Seat 9: torkkdnm folded before Flop (didn't bet)





PokerStars Hand #155012653891:  Hold'em No Limit ($0.50/$1.00 USD) - 2016/06/21 12:59:51 CET [2016/06/21 6:59:51 ET]
Table 'Chimay' 9-max Seat #9 is the button
Seat 1: chenconhaste ($113.05 in chips) 
Seat 3: Yuder_Lin ($81.24 in chips) 
Seat 4: fukumimi ($100 in chips) 
Seat 6: mbk88 ($113.17 in chips) 
Seat 7: Troll8989 ($100 in chips) 
Seat 8: matiko09 ($104.12 in chips) 
Seat 9: SharingaaN ($92.55 in chips) 
chenconhaste: posts small blind $0.50
DIMAN_324: is sitting out 
Yuder_Lin: posts big blind $1
Avtovo: sits out 
*** HOLE CARDS ***
Dealt to matiko09 [3d Ad]
DIMAN_324 leaves the table
fukumimi: folds 
mbk88: folds 
Troll8989: raises $1.50 to $2.50
matiko09: raises $6.50 to $9
SharingaaN: folds 
chenconhaste: folds 
Yuder_Lin: folds 
Troll8989: folds 
Uncalled bet ($6.50) returned to matiko09
matiko09 collected $6.50 from pot
matiko09: doesn't show hand 
*** SUMMARY ***
Total pot $6.50 | Rake $0 
Seat 1: chenconhaste (small blind) folded before Flop
Seat 3: Yuder_Lin (big blind) folded before Flop
Seat 4: fukumimi folded before Flop (didn't bet)
Seat 6: mbk88 folded before Flop (didn't bet)
Seat 7: Troll8989 folded before Flop
Seat 8: matiko09 collected ($6.50)
Seat 9: SharingaaN (button) folded before Flop (didn't bet)





PokerStars Hand #155012654290:  Hold'em No Limit ($0.50/$1.00 USD) - 2016/06/21 12:59:52 CET [2016/06/21 6:59:52 ET]
Table 'Carlova II' 9-max Seat #8 is the button
Seat 1: matiko09 ($134.05 in chips) 
Seat 2: chenconhaste ($129.08 in chips) 
Seat 3: King_Z�Manel ($107.45 in chips) 
Seat 4: Dandy Monk ($38.65 in chips) 
Seat 5: ozone2003 ($100 in chips) 
Seat 6: DIMAN_324 ($100 in chips) 
Seat 7: mi$$I$Elena ($103.68 in chips) 
Seat 8: pyromid ($89.59 in chips) 
Seat 9: Troll8989 ($108.18 in chips) 
Troll8989: posts small blind $0.50
matiko09: posts big blind $1
*** HOLE CARDS ***
Dealt to matiko09 [9c 5d]
chenconhaste: folds 
King_Z�Manel: folds 
Dandy Monk: folds 
ozone2003: folds 
DIMAN_324: folds 
mi$$I$Elena: raises $1.38 to $2.38
pyromid: folds 
Troll8989: folds 
matiko09: folds 
Uncalled bet ($1.38) returned to mi$$I$Elena
mi$$I$Elena collected $2.50 from pot
mi$$I$Elena: doesn't show hand 
*** SUMMARY ***
Total pot $2.50 | Rake $0 
Seat 1: matiko09 (big blind) folded before Flop
Seat 2: chenconhaste folded before Flop (didn't bet)
Seat 3: King_Z�Manel folded before Flop (didn't bet)
Seat 4: Dandy Monk folded before Flop (didn't bet)
Seat 5: ozone2003 folded before Flop (didn't bet)
Seat 6: DIMAN_324 folded before Flop (didn't bet)
Seat 7: mi$$I$Elena collected ($2.50)
Seat 8: pyromid (button) folded before Flop (didn't bet)
Seat 9: Troll8989 (small blind) folded before Flop





PokerStars Hand #155012654592:  Hold'em No Limit ($0.50/$1.00 USD) - 2016/06/21 12:59:53 CET [2016/06/21 6:59:53 ET]
Table 'Moreau' 9-max Seat #1 is the button
Seat 1: 50CandyJoe ($103.97 in chips) 
Seat 2: nubpoker ($139.39 in chips) 
Seat 3: matiko09 ($101.50 in chips) 
Seat 4: bonesnz1 ($75.77 in chips) 
Seat 5: DIMAN_324 ($107.38 in chips) 
Seat 6: mbk88 ($100 in chips) 
Seat 7: PanKwn15 ($16.22 in chips) 
Seat 9: Toonersens ($129.41 in chips) 
nubpoker: posts small blind $0.50
matiko09: posts big blind $1
*** HOLE CARDS ***
Dealt to matiko09 [8h 2d]
bonesnz1: raises $1 to $2
DIMAN_324: folds 
mbk88: folds 
PanKwn15: folds 
Toonersens: folds 
50CandyJoe: folds 
nubpoker: folds 
matiko09: folds 
Uncalled bet ($1) returned to bonesnz1
bonesnz1 collected $2.50 from pot
bonesnz1: doesn't show hand 
*** SUMMARY ***
Total pot $2.50 | Rake $0 
Seat 1: 50CandyJoe (button) folded before Flop (didn't bet)
Seat 2: nubpoker (small blind) folded before Flop
Seat 3: matiko09 (big blind) folded before Flop
Seat 4: bonesnz1 collected ($2.50)
Seat 5: DIMAN_324 folded before Flop (didn't bet)
Seat 6: mbk88 folded before Flop (didn't bet)
Seat 7: PanKwn15 folded before Flop (didn't bet)
Seat 9: Toonersens folded before Flop (didn't bet)





PokerStars Hand #155012657662:  Hold'em No Limit (€0.25/€0.50 EUR) - 2016/06/21 13:00:01 CET [2016/06/21 7:00:01 ET]
Table 'Actor II' 6-max Seat #1 is the button
Seat 1: hmverlin (€78.86 in chips) 
Seat 2: ooak182 (€50.59 in chips) 
Seat 3: asmodej666 (€75.34 in chips) 
Seat 4: matiko09 (€50.75 in chips) 
Seat 5: Rybka1294 (€50 in chips) 
Seat 6: fanmtZ (€26.21 in chips) 
ooak182: posts small blind €0.25
asmodej666: posts big blind €0.50
*** HOLE CARDS ***
Dealt to matiko09 [8c 6d]
matiko09: folds 
Rybka1294: folds 
fanmtZ: folds 
hmverlin: folds 
ooak182: raises €0.75 to €1.25
asmodej666: calls €0.75
*** FLOP *** [Ts Js 2c]
ooak182: bets €1.50
asmodej666: calls €1.50
*** TURN *** [Ts Js 2c] [5c]
ooak182: bets €4
asmodej666: calls €4
*** RIVER *** [Ts Js 2c 5c] [4c]
ooak182: bets €9
asmodej666: calls €9
*** SHOW DOWN ***
ooak182: shows [8s Kc] (high card King)
asmodej666: shows [Jc Ad] (a pair of Jacks)
asmodej666 collected €29.92 from pot
*** SUMMARY ***
Total pot €31.50 | Rake €1.58 
Board [Ts Js 2c 5c 4c]
Seat 1: hmverlin (button) folded before Flop (didn't bet)
Seat 2: ooak182 (small blind) showed [8s Kc] and lost with high card King
Seat 3: asmodej666 (big blind) showed [Jc Ad] and won (€29.92) with a pair of Jacks
Seat 4: matiko09 folded before Flop (didn't bet)
Seat 5: Rybka1294 folded before Flop (didn't bet)
Seat 6: fanmtZ folded before Flop (didn't bet)





PokerStars Hand #155012664956:  Hold'em No Limit (€0.25/€0.50 EUR) - 2016/06/21 13:00:21 CET [2016/06/21 7:00:21 ET]
Table 'Lotis II' 6-max Seat #1 is the button
Seat 1: acaestanemo (€50.75 in chips) 
Seat 2: broh202 (€115.33 in chips) 
Seat 3: bricasse1961 (€24.73 in chips) 
Seat 4: matiko09 (€77.52 in chips) 
Seat 5: AlexPles (€50.75 in chips) 
broh202: posts small blind €0.25
bricasse1961: posts big blind €0.50
*** HOLE CARDS ***
Dealt to matiko09 [Qc 3c]
matiko09: folds 
AlexPles: folds 
acaestanemo: raises €0.50 to €1
broh202: folds 
bricasse1961: calls €0.50
*** FLOP *** [3s 7c Qd]
bricasse1961: bets €0.50
acaestanemo: folds 
Uncalled bet (€0.50) returned to bricasse1961
bricasse1961 collected €2.14 from pot
bricasse1961: doesn't show hand 
*** SUMMARY ***
Total pot €2.25 | Rake €0.11 
Board [3s 7c Qd]
Seat 1: acaestanemo (button) folded on the Flop
Seat 2: broh202 (small blind) folded before Flop
Seat 3: bricasse1961 (big blind) collected (€2.14)
Seat 4: matiko09 folded before Flop (didn't bet)
Seat 5: AlexPles folded before Flop (didn't bet)





PokerStars Hand #155012665555:  Hold'em No Limit ($0.50/$1.00 USD) - 2016/06/21 13:00:22 CET [2016/06/21 7:00:22 ET]
Table 'Umbriel II' 9-max Seat #8 is the button
Seat 1: Avtovo ($100 in chips) 
Seat 2: rura53 ($78.50 in chips) 
Seat 3: mxustin ($39.25 in chips) 
Seat 4: DIMAN_324 ($101.92 in chips) 
Seat 5: matiko09 ($145.46 in chips) 
Seat 7: chenconhaste ($171.35 in chips) 
Seat 8: ozone2003 ($106.32 in chips) 
Seat 9: Troll8989 ($100.50 in chips) 
Troll8989: posts small blind $0.50
Avtovo: posts big blind $1
*** HOLE CARDS ***
Dealt to matiko09 [Jh Ac]
rura53: folds 
mxustin: folds 
DIMAN_324: folds 
matiko09: raises $2 to $3
chenconhaste: folds 
ozone2003: folds 
Troll8989: folds 
Avtovo: folds 
Uncalled bet ($2) returned to matiko09
matiko09 collected $2.50 from pot
matiko09: doesn't show hand 
*** SUMMARY ***
Total pot $2.50 | Rake $0 
Seat 1: Avtovo (big blind) folded before Flop
Seat 2: rura53 folded before Flop (didn't bet)
Seat 3: mxustin folded before Flop (didn't bet)
Seat 4: DIMAN_324 folded before Flop (didn't bet)
Seat 5: matiko09 collected ($2.50)
Seat 7: chenconhaste folded before Flop (didn't bet)
Seat 8: ozone2003 (button) folded before Flop (didn't bet)
Seat 9: Troll8989 (small blind) folded before Flop





PokerStars Hand #155012666195:  Hold'em No Limit ($0.50/$1.00 USD) - 2016/06/21 13:00:24 CET [2016/06/21 7:00:24 ET]
Table 'Chimay' 9-max Seat #1 is the button
Seat 1: chenconhaste ($112.55 in chips) 
Seat 3: Yuder_Lin ($80.24 in chips) 
Seat 4: fukumimi ($100 in chips) 
Seat 6: mbk88 ($113.17 in chips) 
Seat 7: Troll8989 ($100 in chips) 
Seat 8: matiko09 ($108.12 in chips) 
Seat 9: SharingaaN ($92.55 in chips) 
Yuder_Lin: posts small blind $0.50
fukumimi: posts big blind $1
Avtovo: sits out 
*** HOLE CARDS ***
Dealt to matiko09 [As 9c]
mbk88: folds 
Troll8989: folds 
matiko09: folds 
SharingaaN: raises $1 to $2
chenconhaste: folds 
pyromid joins the table at seat #2 
Yuder_Lin: folds 
fukumimi: calls $1
*** FLOP *** [2c 8c 3s]
fukumimi: checks 
SharingaaN: bets $2.14
fukumimi: calls $2.14
*** TURN *** [2c 8c 3s] [Js]
fukumimi: checks 
SharingaaN: bets $6.67
fukumimi: calls $6.67
*** RIVER *** [2c 8c 3s Js] [7s]
fukumimi: checks 
SharingaaN: bets $6.93
fukumimi: calls $6.93
*** SHOW DOWN ***
SharingaaN: shows [Tc 9d] (a straight, Seven to Jack)
fukumimi: mucks hand 
SharingaaN collected $34.18 from pot
*** SUMMARY ***
Total pot $35.98 | Rake $1.80 
Board [2c 8c 3s Js 7s]
Seat 1: chenconhaste (button) folded before Flop (didn't bet)
Seat 3: Yuder_Lin (small blind) folded before Flop
Seat 4: fukumimi (big blind) mucked [8d Td]
Seat 6: mbk88 folded before Flop (didn't bet)
Seat 7: Troll8989 folded before Flop (didn't bet)
Seat 8: matiko09 folded before Flop (didn't bet)
Seat 9: SharingaaN showed [Tc 9d] and won ($34.18) with a straight, Seven to Jack





PokerStars Hand #155012666419:  Hold'em No Limit ($0.50/$1.00 USD) - 2016/06/21 13:00:24 CET [2016/06/21 7:00:24 ET]
Table 'Feronia' 9-max Seat #6 is the button
Seat 1: DIMAN_324 ($103.45 in chips) 
Seat 2: Yuder_Lin ($101.45 in chips) 
Seat 3: mbk88 ($144.35 in chips) 
Seat 4: pyromid ($121.44 in chips) 
Seat 5: matiko09 ($113.89 in chips) 
Seat 6: chenconhaste ($113.45 in chips) 
Seat 7: arctur17 ($104.45 in chips) 
Seat 8: letmegonow ($142.91 in chips) 
Seat 9: mi$$I$Elena ($122.04 in chips) 
arctur17: posts small blind $0.50
letmegonow: posts big blind $1
*** HOLE CARDS ***
Dealt to matiko09 [3s Td]
mi$$I$Elena: folds 
DIMAN_324: folds 
Yuder_Lin: calls $1
mbk88: folds 
pyromid: folds 
matiko09: folds 
chenconhaste: folds 
arctur17: folds 
letmegonow: raises $4 to $5
Yuder_Lin: calls $4
*** FLOP *** [Qd Jd 3d]
letmegonow: bets $5
Yuder_Lin: folds 
Uncalled bet ($5) returned to letmegonow
letmegonow collected $9.98 from pot
*** SUMMARY ***
Total pot $10.50 | Rake $0.52 
Board [Qd Jd 3d]
Seat 1: DIMAN_324 folded before Flop (didn't bet)
Seat 2: Yuder_Lin folded on the Flop
Seat 3: mbk88 folded before Flop (didn't bet)
Seat 4: pyromid folded before Flop (didn't bet)
Seat 5: matiko09 folded before Flop (didn't bet)
Seat 6: chenconhaste (button) folded before Flop (didn't bet)
Seat 7: arctur17 (small blind) folded before Flop
Seat 8: letmegonow (big blind) collected ($9.98)
Seat 9: mi$$I$Elena folded before Flop (didn't bet)





PokerStars Hand #155012668329:  Hold'em No Limit ($0.50/$1.00 USD) - 2016/06/21 13:00:30 CET [2016/06/21 7:00:30 ET]
Table 'Carlova II' 9-max Seat #9 is the button
Seat 1: matiko09 ($133.05 in chips) 
Seat 2: chenconhaste ($129.08 in chips) 
Seat 3: King_Z�Manel ($107.45 in chips) 
Seat 4: Dandy Monk ($38.65 in chips) 
Seat 5: ozone2003 ($100 in chips) 
Seat 6: DIMAN_324 ($100 in chips) 
Seat 7: mi$$I$Elena ($105.18 in chips) 
Seat 8: pyromid ($89.59 in chips) 
Seat 9: Troll8989 ($107.68 in chips) 
matiko09: posts small blind $0.50
chenconhaste: posts big blind $1
*** HOLE CARDS ***
Dealt to matiko09 [4s Tc]
King_Z�Manel: folds 
Dandy Monk: folds 
ozone2003: folds 
DIMAN_324: folds 
mi$$I$Elena: folds 
pyromid: folds 
Troll8989: folds 
matiko09: folds 
Uncalled bet ($0.50) returned to chenconhaste
chenconhaste collected $1 from pot
*** SUMMARY ***
Total pot $1 | Rake $0 
Seat 1: matiko09 (small blind) folded before Flop
Seat 2: chenconhaste (big blind) collected ($1)
Seat 3: King_Z�Manel folded before Flop (didn't bet)
Seat 4: Dandy Monk folded before Flop (didn't bet)
Seat 5: ozone2003 folded before Flop (didn't bet)
Seat 6: DIMAN_324 folded before Flop (didn't bet)
Seat 7: mi$$I$Elena folded before Flop (didn't bet)
Seat 8: pyromid folded before Flop (didn't bet)
Seat 9: Troll8989 (button) folded before Flop (didn't bet)





PokerStars Hand #155012669563:  Hold'em No Limit ($0.50/$1.00 USD) - 2016/06/21 13:00:33 CET [2016/06/21 7:00:33 ET]
Table 'Moreau' 9-max Seat #2 is the button
Seat 1: 50CandyJoe ($103.97 in chips) 
Seat 2: nubpoker ($138.89 in chips) 
Seat 3: matiko09 ($100.50 in chips) 
Seat 4: bonesnz1 ($77.27 in chips) 
Seat 5: DIMAN_324 ($107.38 in chips) 
Seat 6: mbk88 ($100 in chips) 
Seat 7: PanKwn15 ($16.22 in chips) 
Seat 9: Toonersens ($129.41 in chips) 
matiko09: posts small blind $0.50
bonesnz1: posts big blind $1
*** HOLE CARDS ***
Dealt to matiko09 [4h As]
DIMAN_324: folds 
mbk88: folds 
PanKwn15: folds 
Toonersens: folds 
50CandyJoe: raises $1 to $2
nubpoker: folds 
matiko09: folds 
bonesnz1: calls $1
*** FLOP *** [Ts 6h Qh]
bonesnz1: checks 
50CandyJoe: bets $2.14
bonesnz1: folds 
Uncalled bet ($2.14) returned to 50CandyJoe
50CandyJoe collected $4.28 from pot
50CandyJoe: doesn't show hand 
*** SUMMARY ***
Total pot $4.50 | Rake $0.22 
Board [Ts 6h Qh]
Seat 1: 50CandyJoe collected ($4.28)
Seat 2: nubpoker (button) folded before Flop (didn't bet)
Seat 3: matiko09 (small blind) folded before Flop
Seat 4: bonesnz1 (big blind) folded on the Flop
Seat 5: DIMAN_324 folded before Flop (didn't bet)
Seat 6: mbk88 folded before Flop (didn't bet)
Seat 7: PanKwn15 folded before Flop (didn't bet)
Seat 9: Toonersens folded before Flop (didn't bet)





PokerStars Hand #155012672479:  Hold'em No Limit ($0.50/$1.00 USD) - 2016/06/21 13:00:41 CET [2016/06/21 7:00:41 ET]
Table 'Leo' 9-max Seat #9 is the button
Seat 1: letmegonow ($63.57 in chips) 
Seat 2: torkkdnm ($153.14 in chips) 
Seat 3: matiko09 ($105.30 in chips) 
Seat 4: SharingaaN ($100.83 in chips) 
Seat 5: DIMAN_324 ($100 in chips) 
Seat 6: chenconhaste ($124.17 in chips) 
Seat 8: pyromid ($63.67 in chips) 
Seat 9: Wladimir205 ($98.50 in chips) 
letmegonow: posts small blind $0.50
torkkdnm: posts big blind $1
*** HOLE CARDS ***
Dealt to matiko09 [Kc 6s]
matiko09: folds 
SharingaaN: folds 
DIMAN_324: folds 
chenconhaste: folds 
pyromid: folds 
Wladimir205: folds 
letmegonow: calls $0.50
torkkdnm: raises $3 to $4
letmegonow: calls $3
*** FLOP *** [3c Ts 3h]
letmegonow: checks 
torkkdnm: bets $6
letmegonow: calls $6
*** TURN *** [3c Ts 3h] [8s]
letmegonow: checks 
torkkdnm: bets $16
letmegonow: folds 
Uncalled bet ($16) returned to torkkdnm
torkkdnm collected $19 from pot
*** SUMMARY ***
Total pot $20 | Rake $1 
Board [3c Ts 3h 8s]
Seat 1: letmegonow (small blind) folded on the Turn
Seat 2: torkkdnm (big blind) collected ($19)
Seat 3: matiko09 folded before Flop (didn't bet)
Seat 4: SharingaaN folded before Flop (didn't bet)
Seat 5: DIMAN_324 folded before Flop (didn't bet)
Seat 6: chenconhaste folded before Flop (didn't bet)
Seat 8: pyromid folded before Flop (didn't bet)
Seat 9: Wladimir205 (button) folded before Flop (didn't bet)





PokerStars Hand #155012674407:  Hold'em No Limit (€0.25/€0.50 EUR) - 2016/06/21 13:00:46 CET [2016/06/21 7:00:46 ET]
Table 'Lotis II' 6-max Seat #2 is the button
Seat 1: acaestanemo (€50 in chips) 
Seat 2: broh202 (€115.08 in chips) 
Seat 3: bricasse1961 (€25.87 in chips) 
Seat 4: matiko09 (€77.52 in chips) 
Seat 5: AlexPles (€50.75 in chips) 
Seat 6: patriot424 (€62 in chips) 
bricasse1961: posts small blind €0.25
matiko09: posts big blind €0.50
*** HOLE CARDS ***
Dealt to matiko09 [9d Ts]
AlexPles: folds 
patriot424: raises €1 to €1.50
acaestanemo: folds 
broh202: calls €1.50
bricasse1961: folds 
matiko09: folds 
*** FLOP *** [7s 7c 5h]
patriot424: checks 
broh202: checks 
*** TURN *** [7s 7c 5h] [Qc]
patriot424: checks 
broh202: checks 
*** RIVER *** [7s 7c 5h Qc] [3d]
patriot424: bets €2.50
broh202: raises €5 to €7.50
patriot424: folds 
Uncalled bet (€5) returned to broh202
broh202 collected €8.31 from pot
broh202: doesn't show hand 
*** SUMMARY ***
Total pot €8.75 | Rake €0.44 
Board [7s 7c 5h Qc 3d]
Seat 1: acaestanemo folded before Flop (didn't bet)
Seat 2: broh202 (button) collected (€8.31)
Seat 3: bricasse1961 (small blind) folded before Flop
Seat 4: matiko09 (big blind) folded before Flop
Seat 5: AlexPles folded before Flop (didn't bet)
Seat 6: patriot424 folded on the River





PokerStars Hand #155012675220:  Hold'em No Limit ($0.50/$1.00 USD) - 2016/06/21 13:00:48 CET [2016/06/21 7:00:48 ET]
Table 'Umbriel II' 9-max Seat #9 is the button
Seat 1: Avtovo ($100 in chips) 
Seat 2: rura53 ($78.50 in chips) 
Seat 3: mxustin ($39.25 in chips) 
Seat 4: DIMAN_324 ($101.92 in chips) 
Seat 5: matiko09 ($146.96 in chips) 
Seat 7: chenconhaste ($171.35 in chips) 
Seat 8: ozone2003 ($106.32 in chips) 
Seat 9: Troll8989 ($100 in chips) 
Avtovo: posts small blind $0.50
rura53: posts big blind $1
*** HOLE CARDS ***
Dealt to matiko09 [8h Qs]
mxustin: folds 
DIMAN_324: folds 
matiko09: folds 
chenconhaste: folds 
ozone2003: folds 
Troll8989: raises $1.50 to $2.50
Avtovo: folds 
rura53: folds 
Uncalled bet ($1.50) returned to Troll8989
Troll8989 collected $2.50 from pot
Troll8989: doesn't show hand 
*** SUMMARY ***
Total pot $2.50 | Rake $0 
Seat 1: Avtovo (small blind) folded before Flop
Seat 2: rura53 (big blind) folded before Flop
Seat 3: mxustin folded before Flop (didn't bet)
Seat 4: DIMAN_324 folded before Flop (didn't bet)
Seat 5: matiko09 folded before Flop (didn't bet)
Seat 7: chenconhaste folded before Flop (didn't bet)
Seat 8: ozone2003 folded before Flop (didn't bet)
Seat 9: Troll8989 (button) collected ($2.50)





PokerStars Hand #155012677277:  Hold'em No Limit ($0.50/$1.00 USD) - 2016/06/21 13:00:53 CET [2016/06/21 7:00:53 ET]
Table 'Brauna II' 9-max Seat #2 is the button
Seat 1: wisbc ($95.32 in chips) 
Seat 2: pyromid ($151.77 in chips) 
Seat 3: matiko09 ($100 in chips) 
Seat 4: chenconhaste ($199 in chips) 
Seat 5: fukumimi ($100 in chips) 
Seat 6: mbk88 ($173.01 in chips) 
Seat 8: DIMAN_324 ($133.65 in chips) 
Seat 9: torkkdnm ($107.78 in chips) 
matiko09: posts small blind $0.50
chenconhaste: posts big blind $1
*** HOLE CARDS ***
Dealt to matiko09 [3h Tc]
fukumimi: folds 
mbk88: folds 
DIMAN_324: folds 
torkkdnm: raises $2 to $3
wisbc: calls $3
pyromid: folds 
matiko09: folds 
chenconhaste: folds 
*** FLOP *** [Jc 5d Kd]
torkkdnm: bets $5
wisbc: calls $5
*** TURN *** [Jc 5d Kd] [Qh]
torkkdnm: bets $12
wisbc: raises $20 to $32
torkkdnm: calls $20
*** RIVER *** [Jc 5d Kd Qh] [9s]
torkkdnm: checks 
wisbc: bets $55.32 and is all-in
torkkdnm: folds 
Uncalled bet ($55.32) returned to wisbc
wisbc collected $79 from pot
wisbc: doesn't show hand 
*** SUMMARY ***
Total pot $81.50 | Rake $2.50 
Board [Jc 5d Kd Qh 9s]
Seat 1: wisbc collected ($79)
Seat 2: pyromid (button) folded before Flop (didn't bet)
Seat 3: matiko09 (small blind) folded before Flop
Seat 4: chenconhaste (big blind) folded before Flop
Seat 5: fukumimi folded before Flop (didn't bet)
Seat 6: mbk88 folded before Flop (didn't bet)
Seat 8: DIMAN_324 folded before Flop (didn't bet)
Seat 9: torkkdnm folded on the River





PokerStars Hand #155012685266:  Hold'em No Limit ($0.50/$1.00 USD) - 2016/06/21 13:01:13 CET [2016/06/21 7:01:13 ET]
Table 'Umbriel II' 9-max Seat #1 is the button
Seat 1: Avtovo ($100 in chips) 
Seat 2: rura53 ($77.50 in chips) 
Seat 3: mxustin ($39.25 in chips) 
Seat 4: DIMAN_324 ($101.92 in chips) 
Seat 5: matiko09 ($146.96 in chips) 
Seat 7: chenconhaste ($171.35 in chips) 
Seat 8: ozone2003 ($106.32 in chips) 
Seat 9: Troll8989 ($101.50 in chips) 
rura53: posts small blind $0.50
mxustin: posts big blind $1
*** HOLE CARDS ***
Dealt to matiko09 [3h Ad]
DIMAN_324: folds 
matiko09: folds 
chenconhaste: folds 
ozone2003: raises $2 to $3
Troll8989: folds 
Avtovo: folds 
rura53: raises $5 to $8
mxustin: folds 
ozone2003: calls $5
*** FLOP *** [7c 3c 7s]
rura53: checks 
ozone2003: bets $8.07
rura53: folds 
Uncalled bet ($8.07) returned to ozone2003
ozone2003 collected $16.15 from pot
ozone2003: doesn't show hand 
*** SUMMARY ***
Total pot $17 | Rake $0.85 
Board [7c 3c 7s]
Seat 1: Avtovo (button) folded before Flop (didn't bet)
Seat 2: rura53 (small blind) folded on the Flop
Seat 3: mxustin (big blind) folded before Flop
Seat 4: DIMAN_324 folded before Flop (didn't bet)
Seat 5: matiko09 folded before Flop (didn't bet)
Seat 7: chenconhaste folded before Flop (didn't bet)
Seat 8: ozone2003 collected ($16.15)
Seat 9: Troll8989 folded before Flop (didn't bet)





PokerStars Hand #155012685980:  Hold'em No Limit ($0.50/$1.00 USD) - 2016/06/21 13:01:15 CET [2016/06/21 7:01:15 ET]
Table 'Moreau' 9-max Seat #3 is the button
Seat 1: 50CandyJoe ($106.25 in chips) 
Seat 2: nubpoker ($138.89 in chips) 
Seat 3: matiko09 ($100 in chips) 
Seat 4: bonesnz1 ($75.27 in chips) 
Seat 5: DIMAN_324 ($107.38 in chips) 
Seat 6: mbk88 ($100 in chips) 
Seat 7: PanKwn15 ($16.22 in chips) 
Seat 9: Toonersens ($129.41 in chips) 
bonesnz1: posts small blind $0.50
DIMAN_324: posts big blind $1
*** HOLE CARDS ***
Dealt to matiko09 [9c 6h]
mbk88: folds 
PanKwn15: raises $1.50 to $2.50
Toonersens: folds 
50CandyJoe: folds 
nubpoker: folds 
matiko09: folds 
bonesnz1: calls $2
DIMAN_324: calls $1.50
*** FLOP *** [Th 9s 3h]
bonesnz1: bets $3.56
DIMAN_324: folds 
PanKwn15: raises $10.16 to $13.72 and is all-in
Toonersens is disconnected 
bonesnz1: folds 
Uncalled bet ($10.16) returned to PanKwn15
PanKwn15 collected $13.89 from pot
PanKwn15: doesn't show hand 
*** SUMMARY ***
Total pot $14.62 | Rake $0.73 
Board [Th 9s 3h]
Seat 1: 50CandyJoe folded before Flop (didn't bet)
Seat 2: nubpoker folded before Flop (didn't bet)
Seat 3: matiko09 (button) folded before Flop (didn't bet)
Seat 4: bonesnz1 (small blind) folded on the Flop
Seat 5: DIMAN_324 (big blind) folded on the Flop
Seat 6: mbk88 folded before Flop (didn't bet)
Seat 7: PanKwn15 collected ($13.89)
Seat 9: Toonersens folded before Flop (didn't bet)





PokerStars Hand #155012687362:  Hold'em No Limit ($0.50/$1.00 USD) - 2016/06/21 13:01:18 CET [2016/06/21 7:01:18 ET]
Table 'Rupertwildt' 9-max Seat #6 is the button
Seat 1: pokernixxx ($80.77 in chips) 
Seat 2: SharingaaN ($75.73 in chips) 
Seat 3: Saymon_Moo ($67.92 in chips) 
Seat 4: matiko09 ($150.68 in chips) 
Seat 5: pyromid ($92.96 in chips) 
Seat 6: ozone2003 ($100 in chips) 
Seat 7: chenconhaste ($102.84 in chips) 
Seat 8: Gonzanary ($118.14 in chips) 
Seat 9: mbk88 ($122.93 in chips) 
chenconhaste: posts small blind $0.50
Gonzanary: posts big blind $1
*** HOLE CARDS ***
Dealt to matiko09 [Qs 9d]
mbk88: raises $2 to $3
pokernixxx: calls $3
SharingaaN: folds 
Saymon_Moo: calls $3
matiko09: folds 
pyromid: folds 
ozone2003: folds 
chenconhaste: folds 
Gonzanary: calls $2
*** FLOP *** [8c 3d 6d]
Gonzanary: checks 
mbk88: checks 
pokernixxx: bets $7
Saymon_Moo: calls $7
Gonzanary: folds 
mbk88: folds 
*** TURN *** [8c 3d 6d] [2c]
pokernixxx: bets $12
Saymon_Moo: calls $12
*** RIVER *** [8c 3d 6d 2c] [Ad]
pokernixxx: checks 
Saymon_Moo: bets $12
pokernixxx: calls $12
*** SHOW DOWN ***
Saymon_Moo: shows [Ah 8d] (two pair, Aces and Eights)
pokernixxx: mucks hand 
Saymon_Moo collected $72 from pot
*** SUMMARY ***
Total pot $74.50 | Rake $2.50 
Board [8c 3d 6d 2c Ad]
Seat 1: pokernixxx mucked [7d 7s]
Seat 2: SharingaaN folded before Flop (didn't bet)
Seat 3: Saymon_Moo showed [Ah 8d] and won ($72) with two pair, Aces and Eights
Seat 4: matiko09 folded before Flop (didn't bet)
Seat 5: pyromid folded before Flop (didn't bet)
Seat 6: ozone2003 (button) folded before Flop (didn't bet)
Seat 7: chenconhaste (small blind) folded before Flop
Seat 8: Gonzanary (big blind) folded on the Flop
Seat 9: mbk88 folded on the Flop





PokerStars Hand #155012692561:  Hold'em No Limit ($0.50/$1.00 USD) - 2016/06/21 13:01:32 CET [2016/06/21 7:01:32 ET]
Table 'Cheleb' 9-max Seat #5 is the button
Seat 1: SharingaaN ($111.93 in chips) 
Seat 2: pyromid ($139.88 in chips) 
Seat 3: bonesnz1 ($42.39 in chips) 
Seat 4: DIMAN_324 ($181.07 in chips) 
Seat 5: Avtovo ($136.50 in chips) 
Seat 6: matiko09 ($100 in chips) 
Seat 7: DomiVY ($40 in chips) 
Seat 8: Troll8989 ($100 in chips) 
Seat 9: chenconhaste ($117.52 in chips) 
matiko09: posts small blind $0.50
DomiVY: posts big blind $1
*** HOLE CARDS ***
Dealt to matiko09 [8s 6c]
Troll8989: raises $1.50 to $2.50
chenconhaste: folds 
SharingaaN: folds 
pyromid: folds 
bonesnz1: folds 
DIMAN_324: folds 
Avtovo: folds 
matiko09: folds 
DomiVY: folds 
Uncalled bet ($1.50) returned to Troll8989
Troll8989 collected $2.50 from pot
Troll8989: doesn't show hand 
*** SUMMARY ***
Total pot $2.50 | Rake $0 
Seat 1: SharingaaN folded before Flop (didn't bet)
Seat 2: pyromid folded before Flop (didn't bet)
Seat 3: bonesnz1 folded before Flop (didn't bet)
Seat 4: DIMAN_324 folded before Flop (didn't bet)
Seat 5: Avtovo (button) folded before Flop (didn't bet)
Seat 6: matiko09 (small blind) folded before Flop
Seat 7: DomiVY (big blind) folded before Flop
Seat 8: Troll8989 collected ($2.50)
Seat 9: chenconhaste folded before Flop (didn't bet)





PokerStars Hand #155012692703:  Hold'em No Limit ($0.50/$1.00 USD) - 2016/06/21 13:01:32 CET [2016/06/21 7:01:32 ET]
Table 'Carlova II' 9-max Seat #1 is the button
Seat 1: matiko09 ($132.55 in chips) 
Seat 2: chenconhaste ($129.58 in chips) 
Seat 3: King_Z�Manel ($107.45 in chips) 
Seat 4: Dandy Monk ($38.65 in chips) 
Seat 5: ozone2003 ($100 in chips) 
Seat 6: DIMAN_324 ($100 in chips) 
Seat 7: mi$$I$Elena ($105.18 in chips) 
Seat 8: pyromid ($89.59 in chips) 
Seat 9: Troll8989 ($107.68 in chips) 
chenconhaste: posts small blind $0.50
King_Z�Manel: posts big blind $1
*** HOLE CARDS ***
Dealt to matiko09 [3d 2c]
Dandy Monk: folds 
ozone2003: folds 
DIMAN_324: folds 
mi$$I$Elena: folds 
pyromid: folds 
Troll8989: folds 
matiko09: folds 
chenconhaste: calls $0.50
King_Z�Manel: checks 
*** FLOP *** [7c 4h 2s]
chenconhaste: bets $1
King_Z�Manel: folds 
Uncalled bet ($1) returned to chenconhaste
chenconhaste collected $1.90 from pot
*** SUMMARY ***
Total pot $2 | Rake $0.10 
Board [7c 4h 2s]
Seat 1: matiko09 (button) folded before Flop (didn't bet)
Seat 2: chenconhaste (small blind) collected ($1.90)
Seat 3: King_Z�Manel (big blind) folded on the Flop
Seat 4: Dandy Monk folded before Flop (didn't bet)
Seat 5: ozone2003 folded before Flop (didn't bet)
Seat 6: DIMAN_324 folded before Flop (didn't bet)
Seat 7: mi$$I$Elena folded before Flop (didn't bet)
Seat 8: pyromid folded before Flop (didn't bet)
Seat 9: Troll8989 folded before Flop (didn't bet)





PokerStars Hand #155012695524:  Hold'em No Limit ($0.50/$1.00 USD) - 2016/06/21 13:01:39 CET [2016/06/21 7:01:39 ET]
Table 'Feronia' 9-max Seat #7 is the button
Seat 1: DIMAN_324 ($103.45 in chips) 
Seat 2: Yuder_Lin ($96.45 in chips) 
Seat 3: mbk88 ($144.35 in chips) 
Seat 4: pyromid ($121.44 in chips) 
Seat 5: matiko09 ($113.89 in chips) 
Seat 6: chenconhaste ($113.45 in chips) 
Seat 7: arctur17 ($103.95 in chips) 
Seat 8: letmegonow ($147.89 in chips) 
Seat 9: mi$$I$Elena ($122.04 in chips) 
letmegonow: posts small blind $0.50
mi$$I$Elena: posts big blind $1
*** HOLE CARDS ***
Dealt to matiko09 [Js 5h]
DIMAN_324: folds 
Yuder_Lin: folds 
mbk88: folds 
pyromid: folds 
matiko09: folds 
chenconhaste: raises $1.25 to $2.25
arctur17: folds 
letmegonow: folds 
mi$$I$Elena: folds 
Uncalled bet ($1.25) returned to chenconhaste
chenconhaste collected $2.50 from pot
*** SUMMARY ***
Total pot $2.50 | Rake $0 
Seat 1: DIMAN_324 folded before Flop (didn't bet)
Seat 2: Yuder_Lin folded before Flop (didn't bet)
Seat 3: mbk88 folded before Flop (didn't bet)
Seat 4: pyromid folded before Flop (didn't bet)
Seat 5: matiko09 folded before Flop (didn't bet)
Seat 6: chenconhaste collected ($2.50)
Seat 7: arctur17 (button) folded before Flop (didn't bet)
Seat 8: letmegonow (small blind) folded before Flop
Seat 9: mi$$I$Elena (big blind) folded before Flop





PokerStars Hand #155012700118:  Hold'em No Limit ($0.50/$1.00 USD) - 2016/06/21 13:01:51 CET [2016/06/21 7:01:51 ET]
Table 'Chimay' 9-max Seat #3 is the button
Seat 1: chenconhaste ($112.55 in chips) 
Seat 3: Yuder_Lin ($79.74 in chips) 
Seat 4: fukumimi ($82.26 in chips) 
Seat 5: Avtovo ($100 in chips) 
Seat 6: mbk88 ($113.17 in chips) 
Seat 7: Troll8989 ($100 in chips) 
Seat 8: matiko09 ($108.12 in chips) 
Seat 9: SharingaaN ($108.99 in chips) 
fukumimi: posts small blind $0.50
Avtovo: posts big blind $1
pyromid: sits out 
*** HOLE CARDS ***
Dealt to matiko09 [6c 8s]
mbk88: folds 
Troll8989: raises $1.50 to $2.50
matiko09: folds 
SharingaaN: folds 
chenconhaste: calls $2.50
Yuder_Lin: calls $2.50
fukumimi: folds 
Avtovo: folds 
*** FLOP *** [Th 4s Jd]
Troll8989: bets $5
chenconhaste: folds 
Yuder_Lin: calls $5
*** TURN *** [Th 4s Jd] [9h]
Troll8989: checks 
Yuder_Lin: checks 
*** RIVER *** [Th 4s Jd 9h] [As]
Troll8989: bets $5.50
Yuder_Lin: calls $5.50
*** SHOW DOWN ***
Troll8989: shows [Ks Ad] (a pair of Aces)
Yuder_Lin: mucks hand 
Troll8989 collected $28.50 from pot
*** SUMMARY ***
Total pot $30 | Rake $1.50 
Board [Th 4s Jd 9h As]
Seat 1: chenconhaste folded on the Flop
Seat 3: Yuder_Lin (button) mucked [Kc Td]
Seat 4: fukumimi (small blind) folded before Flop
Seat 5: Avtovo (big blind) folded before Flop
Seat 6: mbk88 folded before Flop (didn't bet)
Seat 7: Troll8989 showed [Ks Ad] and won ($28.50) with a pair of Aces
Seat 8: matiko09 folded before Flop (didn't bet)
Seat 9: SharingaaN folded before Flop (didn't bet)





PokerStars Hand #155012701108:  Hold'em No Limit (€0.25/€0.50 EUR) - 2016/06/21 13:01:54 CET [2016/06/21 7:01:54 ET]
Table 'Lotis II' 6-max Seat #3 is the button
Seat 1: acaestanemo (€50 in chips) 
Seat 2: broh202 (€119.39 in chips) 
Seat 3: bricasse1961 (€25.62 in chips) 
Seat 4: matiko09 (€77.02 in chips) 
Seat 5: AlexPles (€50.75 in chips) 
Seat 6: patriot424 (€58 in chips) 
matiko09: posts small blind €0.25
AlexPles: posts big blind €0.50
*** HOLE CARDS ***
Dealt to matiko09 [Ah 7c]
patriot424: folds 
acaestanemo: folds 
broh202: folds 
bricasse1961: folds 
matiko09: raises €1 to €1.50
AlexPles: folds 
Uncalled bet (€1) returned to matiko09
matiko09 collected €1 from pot
matiko09: doesn't show hand 
*** SUMMARY ***
Total pot €1 | Rake €0 
Seat 1: acaestanemo folded before Flop (didn't bet)
Seat 2: broh202 folded before Flop (didn't bet)
Seat 3: bricasse1961 (button) folded before Flop (didn't bet)
Seat 4: matiko09 (small blind) collected (€1)
Seat 5: AlexPles (big blind) folded before Flop
Seat 6: patriot424 folded before Flop (didn't bet)





PokerStars Hand #155012702644:  Hold'em No Limit ($0.50/$1.00 USD) - 2016/06/21 13:01:58 CET [2016/06/21 7:01:58 ET]
Table 'Leo' 9-max Seat #1 is the button
Seat 1: letmegonow ($53.57 in chips) 
Seat 2: torkkdnm ($162.14 in chips) 
Seat 3: matiko09 ($105.30 in chips) 
Seat 4: SharingaaN ($100.83 in chips) 
Seat 5: DIMAN_324 ($100 in chips) 
Seat 6: chenconhaste ($124.17 in chips) 
Seat 8: pyromid ($63.67 in chips) 
Seat 9: Wladimir205 ($98.50 in chips) 
torkkdnm: posts small blind $0.50
matiko09: posts big blind $1
*** HOLE CARDS ***
Dealt to matiko09 [6h Ah]
SharingaaN: folds 
DIMAN_324: folds 
chenconhaste: folds 
pyromid: folds 
Wladimir205: raises $1 to $2
letmegonow: calls $2
torkkdnm: folds 
matiko09: calls $1
*** FLOP *** [2c 9d 7c]
matiko09: checks 
Wladimir205: checks 
letmegonow: checks 
*** TURN *** [2c 9d 7c] [4h]
matiko09: checks 
Wladimir205: bets $3.09
letmegonow: folds 
matiko09: folds 
Uncalled bet ($3.09) returned to Wladimir205
Wladimir205 collected $6.18 from pot
Wladimir205: doesn't show hand 
*** SUMMARY ***
Total pot $6.50 | Rake $0.32 
Board [2c 9d 7c 4h]
Seat 1: letmegonow (button) folded on the Turn
Seat 2: torkkdnm (small blind) folded before Flop
Seat 3: matiko09 (big blind) folded on the Turn
Seat 4: SharingaaN folded before Flop (didn't bet)
Seat 5: DIMAN_324 folded before Flop (didn't bet)
Seat 6: chenconhaste folded before Flop (didn't bet)
Seat 8: pyromid folded before Flop (didn't bet)
Seat 9: Wladimir205 collected ($6.18)





PokerStars Hand #155012704016:  Hold'em No Limit ($0.50/$1.00 USD) - 2016/06/21 13:02:01 CET [2016/06/21 7:02:01 ET]
Table 'Feronia' 9-max Seat #8 is the button
Seat 1: DIMAN_324 ($103.45 in chips) 
Seat 2: Yuder_Lin ($96.45 in chips) 
Seat 3: mbk88 ($144.35 in chips) 
Seat 4: pyromid ($121.44 in chips) 
Seat 5: matiko09 ($113.89 in chips) 
Seat 6: chenconhaste ($114.95 in chips) 
Seat 7: arctur17 ($103.95 in chips) 
Seat 8: letmegonow ($147.39 in chips) 
Seat 9: mi$$I$Elena ($121.04 in chips) 
mi$$I$Elena: posts small blind $0.50
DIMAN_324: posts big blind $1
*** HOLE CARDS ***
Dealt to matiko09 [Th Ts]
Yuder_Lin: folds 
mbk88: folds 
pyromid: folds 
matiko09: raises $2 to $3
chenconhaste: folds 
arctur17: folds 
letmegonow: folds 
mi$$I$Elena: folds 
DIMAN_324: folds 
Uncalled bet ($2) returned to matiko09
matiko09 collected $2.50 from pot
matiko09: doesn't show hand 
*** SUMMARY ***
Total pot $2.50 | Rake $0 
Seat 1: DIMAN_324 (big blind) folded before Flop
Seat 2: Yuder_Lin folded before Flop (didn't bet)
Seat 3: mbk88 folded before Flop (didn't bet)
Seat 4: pyromid folded before Flop (didn't bet)
Seat 5: matiko09 collected ($2.50)
Seat 6: chenconhaste folded before Flop (didn't bet)
Seat 7: arctur17 folded before Flop (didn't bet)
Seat 8: letmegonow (button) folded before Flop (didn't bet)
Seat 9: mi$$I$Elena (small blind) folded before Flop





PokerStars Hand #155012704654:  Hold'em No Limit ($0.50/$1.00 USD) - 2016/06/21 13:02:02 CET [2016/06/21 7:02:02 ET]
Table 'Umbriel II' 9-max Seat #2 is the button
Seat 1: Avtovo ($100 in chips) 
Seat 2: rura53 ($69.50 in chips) 
Seat 3: mxustin ($38.25 in chips) 
Seat 5: matiko09 ($146.96 in chips) 
Seat 7: chenconhaste ($171.35 in chips) 
Seat 8: ozone2003 ($114.47 in chips) 
Seat 9: Troll8989 ($101.50 in chips) 
mxustin: posts small blind $0.50
DIMAN_324: is sitting out 
matiko09: posts big blind $1
*** HOLE CARDS ***
Dealt to matiko09 [Kh 8c]
chenconhaste: folds 
DIMAN_324 leaves the table
ozone2003: raises $2 to $3
Troll8989: folds 
Avtovo: folds 
rura53: folds 
mxustin: folds 
Eskimo Fox joins the table at seat #4 
matiko09: folds 
Uncalled bet ($2) returned to ozone2003
ozone2003 collected $2.50 from pot
ozone2003: doesn't show hand 
*** SUMMARY ***
Total pot $2.50 | Rake $0 
Seat 1: Avtovo folded before Flop (didn't bet)
Seat 2: rura53 (button) folded before Flop (didn't bet)
Seat 3: mxustin (small blind) folded before Flop
Seat 5: matiko09 (big blind) folded before Flop
Seat 7: chenconhaste folded before Flop (didn't bet)
Seat 8: ozone2003 collected ($2.50)
Seat 9: Troll8989 folded before Flop (didn't bet)





PokerStars Hand #155012705732:  Hold'em No Limit ($0.50/$1.00 USD) - 2016/06/21 13:02:05 CET [2016/06/21 7:02:05 ET]
Table 'Cheleb' 9-max Seat #6 is the button
Seat 1: SharingaaN ($111.93 in chips) 
Seat 2: pyromid ($139.88 in chips) 
Seat 3: bonesnz1 ($42.39 in chips) 
Seat 4: DIMAN_324 ($181.07 in chips) 
Seat 5: Avtovo ($136.50 in chips) 
Seat 6: matiko09 ($100 in chips) 
Seat 7: DomiVY ($40 in chips) 
Seat 8: Troll8989 ($101.50 in chips) 
Seat 9: chenconhaste ($117.52 in chips) 
DomiVY: posts small blind $0.50
Troll8989: posts big blind $1
*** HOLE CARDS ***
Dealt to matiko09 [Jh 8s]
chenconhaste: folds 
SharingaaN: folds 
pyromid: folds 
bonesnz1: folds 
DIMAN_324: folds 
Avtovo: folds 
matiko09: raises $1.27 to $2.27
DomiVY: folds 
Troll8989: calls $1.27
*** FLOP *** [Js 5c 6c]
Troll8989: checks 
matiko09: checks 
*** TURN *** [Js 5c 6c] [6h]
Troll8989: checks 
matiko09: bets $2.49
Troll8989: folds 
Uncalled bet ($2.49) returned to matiko09
matiko09 collected $4.79 from pot
matiko09: doesn't show hand 
*** SUMMARY ***
Total pot $5.04 | Rake $0.25 
Board [Js 5c 6c 6h]
Seat 1: SharingaaN folded before Flop (didn't bet)
Seat 2: pyromid folded before Flop (didn't bet)
Seat 3: bonesnz1 folded before Flop (didn't bet)
Seat 4: DIMAN_324 folded before Flop (didn't bet)
Seat 5: Avtovo folded before Flop (didn't bet)
Seat 6: matiko09 (button) collected ($4.79)
Seat 7: DomiVY (small blind) folded before Flop
Seat 8: Troll8989 (big blind) folded on the Turn
Seat 9: chenconhaste folded before Flop (didn't bet)





PokerStars Hand #155012709385:  Hold'em No Limit (€0.25/€0.50 EUR) - 2016/06/21 13:02:14 CET [2016/06/21 7:02:14 ET]
Table 'Lotis II' 6-max Seat #4 is the button
Seat 1: acaestanemo (€50 in chips) 
Seat 2: broh202 (€119.39 in chips) 
Seat 3: bricasse1961 (€25.62 in chips) 
Seat 4: matiko09 (€77.52 in chips) 
Seat 5: AlexPles (€50.25 in chips) 
Seat 6: patriot424 (€58 in chips) 
AlexPles: posts small blind €0.25
patriot424: posts big blind €0.50
*** HOLE CARDS ***
Dealt to matiko09 [5h 8s]
acaestanemo: folds 
broh202: raises €1 to €1.50
bricasse1961: folds 
matiko09: folds 
AlexPles: calls €1.25
patriot424: folds 
*** FLOP *** [Ks 3c Qs]
AlexPles: checks 
broh202: checks 
*** TURN *** [Ks 3c Qs] [2s]
AlexPles: bets €2.19
broh202: folds 
Uncalled bet (€2.19) returned to AlexPles
AlexPles collected €3.32 from pot
AlexPles: doesn't show hand 
*** SUMMARY ***
Total pot €3.50 | Rake €0.18 
Board [Ks 3c Qs 2s]
Seat 1: acaestanemo folded before Flop (didn't bet)
Seat 2: broh202 folded on the Turn
Seat 3: bricasse1961 folded before Flop (didn't bet)
Seat 4: matiko09 (button) folded before Flop (didn't bet)
Seat 5: AlexPles (small blind) collected (€3.32)
Seat 6: patriot424 (big blind) folded before Flop





PokerStars Hand #155012710604:  Hold'em No Limit ($0.50/$1.00 USD) - 2016/06/21 13:02:17 CET [2016/06/21 7:02:17 ET]
Table 'Carlova II' 9-max Seat #2 is the button
Seat 1: matiko09 ($132.55 in chips) 
Seat 2: chenconhaste ($130.48 in chips) 
Seat 3: King_Z�Manel ($106.45 in chips) 
Seat 4: Dandy Monk ($38.65 in chips) 
Seat 5: ozone2003 ($100 in chips) 
Seat 6: DIMAN_324 ($100 in chips) 
Seat 7: mi$$I$Elena ($105.18 in chips) 
Seat 8: pyromid ($89.59 in chips) 
Seat 9: Troll8989 ($107.68 in chips) 
King_Z�Manel: posts small blind $0.50
Dandy Monk: posts big blind $1
*** HOLE CARDS ***
Dealt to matiko09 [Qh 8h]
ozone2003: folds 
DIMAN_324: folds 
mi$$I$Elena: folds 
pyromid: folds 
Troll8989: folds 
matiko09: folds 
chenconhaste: raises $1.25 to $2.25
King_Z�Manel: folds 
Dandy Monk: raises $2.25 to $4.50
chenconhaste: calls $2.25
*** FLOP *** [5c Ah 7s]
Dandy Monk: bets $5
chenconhaste: calls $5
*** TURN *** [5c Ah 7s] [3h]
Dandy Monk: bets $9
chenconhaste: folds 
Uncalled bet ($9) returned to Dandy Monk
Dandy Monk collected $18.52 from pot
Dandy Monk: doesn't show hand 
*** SUMMARY ***
Total pot $19.50 | Rake $0.98 
Board [5c Ah 7s 3h]
Seat 1: matiko09 folded before Flop (didn't bet)
Seat 2: chenconhaste (button) folded on the Turn
Seat 3: King_Z�Manel (small blind) folded before Flop
Seat 4: Dandy Monk (big blind) collected ($18.52)
Seat 5: ozone2003 folded before Flop (didn't bet)
Seat 6: DIMAN_324 folded before Flop (didn't bet)
Seat 7: mi$$I$Elena folded before Flop (didn't bet)
Seat 8: pyromid folded before Flop (didn't bet)
Seat 9: Troll8989 folded before Flop (didn't bet)





PokerStars Hand #155012712202:  Hold'em No Limit (€0.25/€0.50 EUR) - 2016/06/21 13:02:21 CET [2016/06/21 7:02:21 ET]
Table 'Actor II' 6-max Seat #2 is the button
Seat 1: hmverlin (€78.86 in chips) 
Seat 2: ooak182 (€50 in chips) 
Seat 3: asmodej666 (€89.51 in chips) 
Seat 4: matiko09 (€50.75 in chips) 
Seat 5: Rybka1294 (€50 in chips) 
Seat 6: fanmtZ (€26.21 in chips) 
asmodej666: posts small blind €0.25
matiko09: posts big blind €0.50
*** HOLE CARDS ***
Dealt to matiko09 [5c 2c]
Rybka1294: folds 
fanmtZ: raises €0.69 to €1.19
hmverlin: raises €1.69 to €2.88
ooak182: folds 
asmodej666: folds 
matiko09: folds 
fanmtZ: calls €1.69
*** FLOP *** [2s 6h Th]
fanmtZ: checks 
hmverlin: bets €3
fanmtZ: calls €3
*** TURN *** [2s 6h Th] [3s]
fanmtZ: checks 
hmverlin: bets €4
fanmtZ: calls €4
*** RIVER *** [2s 6h Th 3s] [Ad]
fanmtZ: checks 
hmverlin: checks 
*** SHOW DOWN ***
fanmtZ: shows [6s 5s] (a pair of Sixes)
hmverlin: shows [Ac Kd] (a pair of Aces)
hmverlin collected €19.48 from pot
*** SUMMARY ***
Total pot €20.51 | Rake €1.03 
Board [2s 6h Th 3s Ad]
Seat 1: hmverlin showed [Ac Kd] and won (€19.48) with a pair of Aces
Seat 2: ooak182 (button) folded before Flop (didn't bet)
Seat 3: asmodej666 (small blind) folded before Flop
Seat 4: matiko09 (big blind) folded before Flop
Seat 5: Rybka1294 folded before Flop (didn't bet)
Seat 6: fanmtZ showed [6s 5s] and lost with a pair of Sixes





PokerStars Hand #155012713133:  Hold'em No Limit ($0.50/$1.00 USD) - 2016/06/21 13:02:24 CET [2016/06/21 7:02:24 ET]
Table 'Moreau' 9-max Seat #4 is the button
Seat 1: 50CandyJoe ($106.25 in chips) 
Seat 2: nubpoker ($138.89 in chips) 
Seat 3: matiko09 ($100 in chips) 
Seat 4: bonesnz1 ($69.21 in chips) 
Seat 5: DIMAN_324 ($104.88 in chips) 
Seat 6: mbk88 ($100 in chips) 
Seat 7: PanKwn15 ($24.05 in chips) 
Seat 9: Toonersens ($129.41 in chips) 
DIMAN_324: posts small blind $0.50
mbk88: posts big blind $1
*** HOLE CARDS ***
Dealt to matiko09 [5h 9c]
PanKwn15: folds 
Toonersens has timed out while disconnected
Toonersens: folds 
50CandyJoe: raises $2 to $3
nubpoker: folds 
matiko09: folds 
bonesnz1: folds 
DIMAN_324: folds 
mbk88: folds 
Uncalled bet ($2) returned to 50CandyJoe
50CandyJoe collected $2.50 from pot
50CandyJoe: doesn't show hand 
*** SUMMARY ***
Total pot $2.50 | Rake $0 
Seat 1: 50CandyJoe collected ($2.50)
Seat 2: nubpoker folded before Flop (didn't bet)
Seat 3: matiko09 folded before Flop (didn't bet)
Seat 4: bonesnz1 (button) folded before Flop (didn't bet)
Seat 5: DIMAN_324 (small blind) folded before Flop
Seat 6: mbk88 (big blind) folded before Flop
Seat 7: PanKwn15 folded before Flop (didn't bet)
Seat 9: Toonersens folded before Flop (didn't bet)





PokerStars Hand #155012715051:  Hold'em No Limit ($0.50/$1.00 USD) - 2016/06/21 13:02:29 CET [2016/06/21 7:02:29 ET]
Table 'Feronia' 9-max Seat #9 is the button
Seat 1: DIMAN_324 ($102.45 in chips) 
Seat 2: Yuder_Lin ($96.45 in chips) 
Seat 3: mbk88 ($144.35 in chips) 
Seat 4: pyromid ($121.44 in chips) 
Seat 5: matiko09 ($115.39 in chips) 
Seat 6: chenconhaste ($114.95 in chips) 
Seat 7: arctur17 ($103.95 in chips) 
Seat 8: letmegonow ($147.39 in chips) 
Seat 9: mi$$I$Elena ($120.54 in chips) 
DIMAN_324: posts small blind $0.50
Yuder_Lin: posts big blind $1
*** HOLE CARDS ***
Dealt to matiko09 [4s 7h]
mbk88: folds 
pyromid: folds 
matiko09: folds 
chenconhaste: raises $1.25 to $2.25
arctur17: folds 
letmegonow: folds 
mi$$I$Elena: folds 
DIMAN_324: folds 
Yuder_Lin: folds 
Uncalled bet ($1.25) returned to chenconhaste
chenconhaste collected $2.50 from pot
*** SUMMARY ***
Total pot $2.50 | Rake $0 
Seat 1: DIMAN_324 (small blind) folded before Flop
Seat 2: Yuder_Lin (big blind) folded before Flop
Seat 3: mbk88 folded before Flop (didn't bet)
Seat 4: pyromid folded before Flop (didn't bet)
Seat 5: matiko09 folded before Flop (didn't bet)
Seat 6: chenconhaste collected ($2.50)
Seat 7: arctur17 folded before Flop (didn't bet)
Seat 8: letmegonow folded before Flop (didn't bet)
Seat 9: mi$$I$Elena (button) folded before Flop (didn't bet)





PokerStars Hand #155012718682:  Hold'em No Limit ($0.50/$1.00 USD) - 2016/06/21 13:02:38 CET [2016/06/21 7:02:38 ET]
Table 'Leo' 9-max Seat #2 is the button
Seat 1: letmegonow ($51.57 in chips) 
Seat 2: torkkdnm ($161.64 in chips) 
Seat 3: matiko09 ($103.30 in chips) 
Seat 4: SharingaaN ($100.83 in chips) 
Seat 5: DIMAN_324 ($100 in chips) 
Seat 6: chenconhaste ($124.17 in chips) 
Seat 8: pyromid ($63.67 in chips) 
Seat 9: Wladimir205 ($102.68 in chips) 
matiko09: posts small blind $0.50
SharingaaN: posts big blind $1
maxxmeister: sits out 
*** HOLE CARDS ***
Dealt to matiko09 [2d 5c]
DIMAN_324: folds 
chenconhaste: folds 
pyromid: folds 
Wladimir205: raises $1 to $2
letmegonow: folds 
torkkdnm: folds 
matiko09: folds 
SharingaaN: folds 
Uncalled bet ($1) returned to Wladimir205
Wladimir205 collected $2.50 from pot
Wladimir205: doesn't show hand 
*** SUMMARY ***
Total pot $2.50 | Rake $0 
Seat 1: letmegonow folded before Flop (didn't bet)
Seat 2: torkkdnm (button) folded before Flop (didn't bet)
Seat 3: matiko09 (small blind) folded before Flop
Seat 4: SharingaaN (big blind) folded before Flop
Seat 5: DIMAN_324 folded before Flop (didn't bet)
Seat 6: chenconhaste folded before Flop (didn't bet)
Seat 8: pyromid folded before Flop (didn't bet)
Seat 9: Wladimir205 collected ($2.50)





PokerStars Hand #155012718767:  Hold'em No Limit ($0.50/$1.00 USD) - 2016/06/21 13:02:38 CET [2016/06/21 7:02:38 ET]
Table 'Chimay' 9-max Seat #4 is the button
Seat 1: chenconhaste ($110.05 in chips) 
Seat 3: Yuder_Lin ($66.74 in chips) 
Seat 4: fukumimi ($100 in chips) 
Seat 5: Avtovo ($100 in chips) 
Seat 6: mbk88 ($113.17 in chips) 
Seat 7: Troll8989 ($115.50 in chips) 
Seat 8: matiko09 ($108.12 in chips) 
Seat 9: SharingaaN ($108.99 in chips) 
Avtovo: posts small blind $0.50
mbk88: posts big blind $1
pyromid: sits out 
*** HOLE CARDS ***
Dealt to matiko09 [8h 2h]
Troll8989: folds 
matiko09: folds 
SharingaaN: folds 
chenconhaste: folds 
Yuder_Lin: folds 
fukumimi: raises $2 to $3
Avtovo: folds 
mbk88: calls $2
*** FLOP *** [5h 8c 5d]
mbk88: checks 
fukumimi: bets $4
mbk88: calls $4
*** TURN *** [5h 8c 5d] [Kd]
mbk88: checks 
fukumimi: checks 
*** RIVER *** [5h 8c 5d Kd] [Ks]
mbk88: bets $9
fukumimi: folds 
Uncalled bet ($9) returned to mbk88
mbk88 collected $13.78 from pot
mbk88: doesn't show hand 
*** SUMMARY ***
Total pot $14.50 | Rake $0.72 
Board [5h 8c 5d Kd Ks]
Seat 1: chenconhaste folded before Flop (didn't bet)
Seat 3: Yuder_Lin folded before Flop (didn't bet)
Seat 4: fukumimi (button) folded on the River
Seat 5: Avtovo (small blind) folded before Flop
Seat 6: mbk88 (big blind) collected ($13.78)
Seat 7: Troll8989 folded before Flop (didn't bet)
Seat 8: matiko09 folded before Flop (didn't bet)
Seat 9: SharingaaN folded before Flop (didn't bet)





PokerStars Hand #155012719152:  Hold'em No Limit ($0.50/$1.00 USD) - 2016/06/21 13:02:39 CET [2016/06/21 7:02:39 ET]
Table 'Umbriel II' 9-max Seat #3 is the button
Seat 1: Avtovo ($100 in chips) 
Seat 2: rura53 ($69.50 in chips) 
Seat 3: mxustin ($37.75 in chips) 
Seat 5: matiko09 ($145.96 in chips) 
Seat 6: maxxmeister ($100 in chips) 
Seat 7: chenconhaste ($171.35 in chips) 
Seat 8: ozone2003 ($115.97 in chips) 
Seat 9: Troll8989 ($101.50 in chips) 
Eskimo Fox will be allowed to play after the button
matiko09: posts small blind $0.50
maxxmeister: posts big blind $1
*** HOLE CARDS ***
Dealt to matiko09 [3s 7c]
chenconhaste: folds 
ozone2003: folds 
Troll8989: folds 
Avtovo: folds 
rura53: raises $2 to $3
mxustin: folds 
matiko09: folds 
maxxmeister: folds 
Uncalled bet ($2) returned to rura53
rura53 collected $2.50 from pot
rura53: doesn't show hand 
*** SUMMARY ***
Total pot $2.50 | Rake $0 
Seat 1: Avtovo folded before Flop (didn't bet)
Seat 2: rura53 collected ($2.50)
Seat 3: mxustin (button) folded before Flop (didn't bet)
Seat 5: matiko09 (small blind) folded before Flop
Seat 6: maxxmeister (big blind) folded before Flop
Seat 7: chenconhaste folded before Flop (didn't bet)
Seat 8: ozone2003 folded before Flop (didn't bet)
Seat 9: Troll8989 folded before Flop (didn't bet)





PokerStars Hand #155012723177:  Hold'em No Limit ($0.50/$1.00 USD) - 2016/06/21 13:02:49 CET [2016/06/21 7:02:49 ET]
Table 'Brauna II' 9-max Seat #3 is the button
Seat 1: wisbc ($134.32 in chips) 
Seat 2: pyromid ($151.77 in chips) 
Seat 3: matiko09 ($100 in chips) 
Seat 4: chenconhaste ($198 in chips) 
Seat 5: fukumimi ($100 in chips) 
Seat 6: mbk88 ($173.01 in chips) 
Seat 8: DIMAN_324 ($133.65 in chips) 
Seat 9: torkkdnm ($100 in chips) 
chenconhaste: posts small blind $0.50
fukumimi: posts big blind $1
*** HOLE CARDS ***
Dealt to matiko09 [5s Kd]
mbk88: folds 
DIMAN_324: folds 
torkkdnm: folds 
wisbc: folds 
pyromid: folds 
matiko09: folds 
chenconhaste: raises $2 to $3
fukumimi: folds 
Uncalled bet ($2) returned to chenconhaste
chenconhaste collected $2 from pot
*** SUMMARY ***
Total pot $2 | Rake $0 
Seat 1: wisbc folded before Flop (didn't bet)
Seat 2: pyromid folded before Flop (didn't bet)
Seat 3: matiko09 (button) folded before Flop (didn't bet)
Seat 4: chenconhaste (small blind) collected ($2)
Seat 5: fukumimi (big blind) folded before Flop
Seat 6: mbk88 folded before Flop (didn't bet)
Seat 8: DIMAN_324 folded before Flop (didn't bet)
Seat 9: torkkdnm folded before Flop (didn't bet)





PokerStars Hand #155012723949:  Hold'em No Limit ($0.50/$1.00 USD) - 2016/06/21 13:02:50 CET [2016/06/21 7:02:50 ET]
Table 'Saldanha' 9-max Seat #3 is the button
Seat 1: IceSharK.AA ($60.37 in chips) 
Seat 2: matiko09 ($100 in chips) 
Seat 3: Avtovo ($100 in chips) 
Seat 4: 50CandyJoe ($100 in chips) 
Seat 8: pattexpro ($80 in chips) 
Seat 9: maxxmeister ($100 in chips) 
50CandyJoe: posts small blind $0.50
pattexpro: posts big blind $1
IceSharK.AA: posts the ante $0.20
matiko09: posts the ante $0.20
Avtovo: posts the ante $0.20
50CandyJoe: posts the ante $0.20
pattexpro: posts the ante $0.20
maxxmeister: posts the ante $0.20
*** HOLE CARDS ***
Dealt to matiko09 [6h 2h]
chenconhaste joins the table at seat #7 
SharingaaN joins the table at seat #6 
maxxmeister: raises $3 to $4
IceSharK.AA: calls $4
matiko09: folds 
Avtovo: folds 
50CandyJoe: calls $3.50
pattexpro: folds 
*** FLOP *** [Qd 8s Th]
50CandyJoe: checks 
Eskimo Fox joins the table at seat #5 
maxxmeister: bets $6.74
IceSharK.AA: raises $13.48 to $20.22
50CandyJoe: folds 
maxxmeister: folds 
Uncalled bet ($13.48) returned to IceSharK.AA
IceSharK.AA collected $26.30 from pot
*** SUMMARY ***
Total pot $27.68 | Rake $1.38 
Board [Qd 8s Th]
Seat 1: IceSharK.AA collected ($26.30)
Seat 2: matiko09 folded before Flop (didn't bet)
Seat 3: Avtovo (button) folded before Flop (didn't bet)
Seat 4: 50CandyJoe (small blind) folded on the Flop
Seat 8: pattexpro (big blind) folded before Flop
Seat 9: maxxmeister folded on the Flop





PokerStars Hand #155012726894:  Hold'em No Limit ($0.50/$1.00 USD) - 2016/06/21 13:02:58 CET [2016/06/21 7:02:58 ET]
Table 'Feronia' 9-max Seat #1 is the button
Seat 1: DIMAN_324 ($101.95 in chips) 
Seat 2: Yuder_Lin ($95.45 in chips) 
Seat 3: mbk88 ($144.35 in chips) 
Seat 4: pyromid ($121.44 in chips) 
Seat 5: matiko09 ($115.39 in chips) 
Seat 6: chenconhaste ($116.45 in chips) 
Seat 7: arctur17 ($103.95 in chips) 
Seat 8: letmegonow ($147.39 in chips) 
Seat 9: mi$$I$Elena ($120.54 in chips) 
Yuder_Lin: posts small blind $0.50
mbk88: posts big blind $1
*** HOLE CARDS ***
Dealt to matiko09 [Qs 9c]
pyromid: folds 
matiko09: folds 
chenconhaste: folds 
arctur17: folds 
letmegonow: folds 
mi$$I$Elena: folds 
DIMAN_324: raises $1.10 to $2.10
Yuder_Lin: calls $1.60
mbk88: calls $1.10
*** FLOP *** [9s 6c Ks]
Yuder_Lin: checks 
mbk88: checks 
DIMAN_324: bets $4.48
Yuder_Lin: calls $4.48
mbk88: folds 
*** TURN *** [9s 6c Ks] [5d]
Yuder_Lin: checks 
DIMAN_324: checks 
*** RIVER *** [9s 6c Ks 5d] [7d]
Yuder_Lin: bets $6
DIMAN_324: folds 
Uncalled bet ($6) returned to Yuder_Lin
Yuder_Lin collected $14.50 from pot
Yuder_Lin: doesn't show hand 
*** SUMMARY ***
Total pot $15.26 | Rake $0.76 
Board [9s 6c Ks 5d 7d]
Seat 1: DIMAN_324 (button) folded on the River
Seat 2: Yuder_Lin (small blind) collected ($14.50)
Seat 3: mbk88 (big blind) folded on the Flop
Seat 4: pyromid folded before Flop (didn't bet)
Seat 5: matiko09 folded before Flop (didn't bet)
Seat 6: chenconhaste folded before Flop (didn't bet)
Seat 7: arctur17 folded before Flop (didn't bet)
Seat 8: letmegonow folded before Flop (didn't bet)
Seat 9: mi$$I$Elena folded before Flop (didn't bet)





PokerStars Hand #155012728975:  Hold'em No Limit ($0.50/$1.00 USD) - 2016/06/21 13:03:03 CET [2016/06/21 7:03:03 ET]
Table 'Moreau' 9-max Seat #5 is the button
Seat 1: 50CandyJoe ($107.75 in chips) 
Seat 2: nubpoker ($138.89 in chips) 
Seat 3: matiko09 ($100 in chips) 
Seat 4: bonesnz1 ($69.21 in chips) 
Seat 5: DIMAN_324 ($104.38 in chips) 
Seat 6: mbk88 ($100 in chips) 
Seat 7: PanKwn15 ($24.05 in chips) 
mbk88: posts small blind $0.50
PanKwn15: posts big blind $1
maxxmeister: sits out 
*** HOLE CARDS ***
Dealt to matiko09 [Kh 8d]
50CandyJoe: folds 
nubpoker: folds 
matiko09: folds 
bonesnz1: calls $1
DIMAN_324: folds 
mbk88: folds 
PanKwn15: raises $2 to $3
bonesnz1: calls $2
*** FLOP *** [2h Th 3c]
PanKwn15: bets $6.18
bonesnz1: folds 
Uncalled bet ($6.18) returned to PanKwn15
PanKwn15 collected $6.18 from pot
PanKwn15: doesn't show hand 
*** SUMMARY ***
Total pot $6.50 | Rake $0.32 
Board [2h Th 3c]
Seat 1: 50CandyJoe folded before Flop (didn't bet)
Seat 2: nubpoker folded before Flop (didn't bet)
Seat 3: matiko09 folded before Flop (didn't bet)
Seat 4: bonesnz1 folded on the Flop
Seat 5: DIMAN_324 (button) folded before Flop (didn't bet)
Seat 6: mbk88 (small blind) folded before Flop
Seat 7: PanKwn15 (big blind) collected ($6.18)





PokerStars Hand #155012728984:  Hold'em No Limit ($0.50/$1.00 USD) - 2016/06/21 13:03:03 CET [2016/06/21 7:03:03 ET]
Table 'Rupertwildt' 9-max Seat #7 is the button
Seat 1: pokernixxx ($46.77 in chips) 
Seat 2: SharingaaN ($75.73 in chips) 
Seat 3: Saymon_Moo ($105.92 in chips) 
Seat 4: matiko09 ($150.68 in chips) 
Seat 5: pyromid ($92.96 in chips) 
Seat 6: ozone2003 ($100 in chips) 
Seat 7: chenconhaste ($102.34 in chips) 
Seat 8: Gonzanary ($115.14 in chips) 
Seat 9: mbk88 ($119.93 in chips) 
Gonzanary: posts small blind $0.50
mbk88: posts big blind $1
*** HOLE CARDS ***
Dealt to matiko09 [6c 3c]
pokernixxx: calls $1
SharingaaN: raises $1 to $2
Saymon_Moo: folds 
matiko09: folds 
pyromid: calls $2
ozone2003: folds 
chenconhaste: folds 
Gonzanary: folds 
mbk88: folds 
pokernixxx: raises $3 to $5
SharingaaN: calls $3
pyromid: calls $3
*** FLOP *** [9d Td As]
pokernixxx: bets $7
SharingaaN: folds 
pyromid: folds 
Uncalled bet ($7) returned to pokernixxx
pokernixxx collected $15.68 from pot
pokernixxx: doesn't show hand 
*** SUMMARY ***
Total pot $16.50 | Rake $0.82 
Board [9d Td As]
Seat 1: pokernixxx collected ($15.68)
Seat 2: SharingaaN folded on the Flop
Seat 3: Saymon_Moo folded before Flop (didn't bet)
Seat 4: matiko09 folded before Flop (didn't bet)
Seat 5: pyromid folded on the Flop
Seat 6: ozone2003 folded before Flop (didn't bet)
Seat 7: chenconhaste (button) folded before Flop (didn't bet)
Seat 8: Gonzanary (small blind) folded before Flop
Seat 9: mbk88 (big blind) folded before Flop





PokerStars Hand #155012729604:  Hold'em No Limit ($0.50/$1.00 USD) - 2016/06/21 13:03:04 CET [2016/06/21 7:03:04 ET]
Table 'Leo' 9-max Seat #3 is the button
Seat 1: letmegonow ($51.57 in chips) 
Seat 2: torkkdnm ($161.64 in chips) 
Seat 3: matiko09 ($102.80 in chips) 
Seat 4: SharingaaN ($99.83 in chips) 
Seat 5: DIMAN_324 ($100 in chips) 
Seat 6: chenconhaste ($124.17 in chips) 
Seat 8: pyromid ($63.67 in chips) 
Seat 9: Wladimir205 ($104.18 in chips) 
SharingaaN: posts small blind $0.50
DIMAN_324: posts big blind $1
maxxmeister: sits out 
*** HOLE CARDS ***
Dealt to matiko09 [6c Ts]
chenconhaste: folds 
pyromid: folds 
Wladimir205: folds 
letmegonow: folds 
torkkdnm: folds 
matiko09: folds 
SharingaaN: folds 
Uncalled bet ($0.50) returned to DIMAN_324
DIMAN_324 collected $1 from pot
DIMAN_324: doesn't show hand 
*** SUMMARY ***
Total pot $1 | Rake $0 
Seat 1: letmegonow folded before Flop (didn't bet)
Seat 2: torkkdnm folded before Flop (didn't bet)
Seat 3: matiko09 (button) folded before Flop (didn't bet)
Seat 4: SharingaaN (small blind) folded before Flop
Seat 5: DIMAN_324 (big blind) collected ($1)
Seat 6: chenconhaste folded before Flop (didn't bet)
Seat 8: pyromid folded before Flop (didn't bet)
Seat 9: Wladimir205 folded before Flop (didn't bet)





PokerStars Hand #155012730169:  Hold'em No Limit ($0.50/$1.00 USD) - 2016/06/21 13:03:06 CET [2016/06/21 7:03:06 ET]
Table 'Carlova II' 9-max Seat #3 is the button
Seat 1: matiko09 ($132.55 in chips) 
Seat 2: chenconhaste ($120.98 in chips) 
Seat 3: King_Z�Manel ($105.95 in chips) 
Seat 4: Dandy Monk ($47.67 in chips) 
Seat 5: ozone2003 ($100 in chips) 
Seat 6: DIMAN_324 ($100 in chips) 
Seat 7: mi$$I$Elena ($105.18 in chips) 
Seat 8: pyromid ($89.59 in chips) 
Seat 9: Troll8989 ($107.68 in chips) 
Dandy Monk: posts small blind $0.50
ozone2003: posts big blind $1
*** HOLE CARDS ***
Dealt to matiko09 [Kc 2d]
DIMAN_324: folds 
mi$$I$Elena: folds 
pyromid: folds 
Troll8989: folds 
matiko09: folds 
chenconhaste: raises $1.25 to $2.25
King_Z�Manel: folds 
Dandy Monk: calls $1.75
ozone2003: folds 
*** FLOP *** [Qc Jh 6c]
Dandy Monk: bets $5
chenconhaste: folds 
Uncalled bet ($5) returned to Dandy Monk
Dandy Monk collected $5.22 from pot
Dandy Monk: doesn't show hand 
*** SUMMARY ***
Total pot $5.50 | Rake $0.28 
Board [Qc Jh 6c]
Seat 1: matiko09 folded before Flop (didn't bet)
Seat 2: chenconhaste folded on the Flop
Seat 3: King_Z�Manel (button) folded before Flop (didn't bet)
Seat 4: Dandy Monk (small blind) collected ($5.22)
Seat 5: ozone2003 (big blind) folded before Flop
Seat 6: DIMAN_324 folded before Flop (didn't bet)
Seat 7: mi$$I$Elena folded before Flop (didn't bet)
Seat 8: pyromid folded before Flop (didn't bet)
Seat 9: Troll8989 folded before Flop (didn't bet)





PokerStars Hand #155012732088:  Hold'em No Limit ($0.50/$1.00 USD) - 2016/06/21 13:03:10 CET [2016/06/21 7:03:10 ET]
Table 'Umbriel II' 9-max Seat #5 is the button
Seat 1: Avtovo ($100 in chips) 
Seat 2: rura53 ($71 in chips) 
Seat 3: mxustin ($37.75 in chips) 
Seat 5: matiko09 ($145.46 in chips) 
Seat 6: maxxmeister ($100 in chips) 
Seat 7: chenconhaste ($171.35 in chips) 
Seat 8: ozone2003 ($115.97 in chips) 
Seat 9: Troll8989 ($101.50 in chips) 
maxxmeister: posts small blind $0.50
chenconhaste: posts big blind $1
Eskimo Fox: sits out 
*** HOLE CARDS ***
Dealt to matiko09 [5h Ac]
ozone2003: folds 
Troll8989: raises $1.50 to $2.50
Avtovo: folds 
rura53: folds 
mxustin: folds 
matiko09: folds 
maxxmeister: folds 
chenconhaste: folds 
Uncalled bet ($1.50) returned to Troll8989
Troll8989 collected $2.50 from pot
Troll8989: doesn't show hand 
*** SUMMARY ***
Total pot $2.50 | Rake $0 
Seat 1: Avtovo folded before Flop (didn't bet)
Seat 2: rura53 folded before Flop (didn't bet)
Seat 3: mxustin folded before Flop (didn't bet)
Seat 5: matiko09 (button) folded before Flop (didn't bet)
Seat 6: maxxmeister (small blind) folded before Flop
Seat 7: chenconhaste (big blind) folded before Flop
Seat 8: ozone2003 folded before Flop (didn't bet)
Seat 9: Troll8989 collected ($2.50)





PokerStars Hand #155012732591:  Hold'em No Limit (€0.25/€0.50 EUR) - 2016/06/21 13:03:11 CET [2016/06/21 7:03:11 ET]
Table 'Lotis II' 6-max Seat #5 is the button
Seat 1: acaestanemo (€50 in chips) 
Seat 2: broh202 (€117.89 in chips) 
Seat 3: bricasse1961 (€25.62 in chips) 
Seat 4: matiko09 (€77.52 in chips) 
Seat 5: AlexPles (€52.07 in chips) 
Seat 6: patriot424 (€57.50 in chips) 
patriot424: posts small blind €0.25
acaestanemo: posts big blind €0.50
*** HOLE CARDS ***
Dealt to matiko09 [Ah Td]
broh202: folds 
bricasse1961: folds 
matiko09: raises €1 to €1.50
AlexPles: folds 
patriot424: folds 
acaestanemo: folds 
Uncalled bet (€1) returned to matiko09
matiko09 collected €1.25 from pot
matiko09: doesn't show hand 
*** SUMMARY ***
Total pot €1.25 | Rake €0 
Seat 1: acaestanemo (big blind) folded before Flop
Seat 2: broh202 folded before Flop (didn't bet)
Seat 3: bricasse1961 folded before Flop (didn't bet)
Seat 4: matiko09 collected (€1.25)
Seat 5: AlexPles (button) folded before Flop (didn't bet)
Seat 6: patriot424 (small blind) folded before Flop





PokerStars Hand #155012733319:  Hold'em No Limit ($0.50/$1.00 USD) - 2016/06/21 13:03:13 CET [2016/06/21 7:03:13 ET]
Table 'Brauna II' 9-max Seat #4 is the button
Seat 1: wisbc ($134.32 in chips) 
Seat 2: pyromid ($151.77 in chips) 
Seat 3: matiko09 ($100 in chips) 
Seat 4: chenconhaste ($199 in chips) 
Seat 5: fukumimi ($99 in chips) 
Seat 6: mbk88 ($173.01 in chips) 
Seat 8: DIMAN_324 ($133.65 in chips) 
Seat 9: torkkdnm ($100 in chips) 
fukumimi: posts small blind $0.50
mbk88: posts big blind $1
*** HOLE CARDS ***
Dealt to matiko09 [4h Ad]
DIMAN_324: folds 
torkkdnm: raises $2 to $3
wisbc: calls $3
pyromid: folds 
matiko09: folds 
chenconhaste: folds 
fukumimi: calls $2.50
mbk88: calls $2
*** FLOP *** [3s 9d 2s]
fukumimi: checks 
mbk88: checks 
torkkdnm: bets $8
wisbc: folds 
fukumimi: folds 
mbk88: calls $8
*** TURN *** [3s 9d 2s] [Tc]
mbk88: checks 
torkkdnm: checks 
*** RIVER *** [3s 9d 2s Tc] [7s]
mbk88: bets $16
torkkdnm: calls $16
*** SHOW DOWN ***
mbk88: shows [8s As] (a flush, Ace high)
torkkdnm: mucks hand 
mbk88 collected $57.50 from pot
*** SUMMARY ***
Total pot $60 | Rake $2.50 
Board [3s 9d 2s Tc 7s]
Seat 1: wisbc folded on the Flop
Seat 2: pyromid folded before Flop (didn't bet)
Seat 3: matiko09 folded before Flop (didn't bet)
Seat 4: chenconhaste (button) folded before Flop (didn't bet)
Seat 5: fukumimi (small blind) folded on the Flop
Seat 6: mbk88 (big blind) showed [8s As] and won ($57.50) with a flush, Ace high
Seat 8: DIMAN_324 folded before Flop (didn't bet)
Seat 9: torkkdnm mucked [2h 2d]





PokerStars Hand #155012734189:  Hold'em No Limit ($0.50/$1.00 USD) - 2016/06/21 13:03:15 CET [2016/06/21 7:03:15 ET]
Table 'Cheleb' 9-max Seat #7 is the button
Seat 1: SharingaaN ($111.93 in chips) 
Seat 2: pyromid ($139.88 in chips) 
Seat 3: bonesnz1 ($42.39 in chips) 
Seat 4: DIMAN_324 ($181.07 in chips) 
Seat 5: Avtovo ($136.50 in chips) 
Seat 6: matiko09 ($102.52 in chips) 
Seat 7: DomiVY ($40 in chips) 
Seat 8: Troll8989 ($100 in chips) 
Seat 9: chenconhaste ($117.52 in chips) 
Troll8989: posts small blind $0.50
chenconhaste: posts big blind $1
*** HOLE CARDS ***
Dealt to matiko09 [3c 6d]
SharingaaN: folds 
pyromid: folds 
bonesnz1: folds 
DIMAN_324: raises $2 to $3
Avtovo: folds 
matiko09: folds 
DomiVY: folds 
Troll8989: folds 
chenconhaste: folds 
Uncalled bet ($2) returned to DIMAN_324
DIMAN_324 collected $2.50 from pot
DIMAN_324: doesn't show hand 
*** SUMMARY ***
Total pot $2.50 | Rake $0 
Seat 1: SharingaaN folded before Flop (didn't bet)
Seat 2: pyromid folded before Flop (didn't bet)
Seat 3: bonesnz1 folded before Flop (didn't bet)
Seat 4: DIMAN_324 collected ($2.50)
Seat 5: Avtovo folded before Flop (didn't bet)
Seat 6: matiko09 folded before Flop (didn't bet)
Seat 7: DomiVY (button) folded before Flop (didn't bet)
Seat 8: Troll8989 (small blind) folded before Flop
Seat 9: chenconhaste (big blind) folded before Flop





PokerStars Hand #155012737822:  Hold'em No Limit ($0.50/$1.00 USD) - 2016/06/21 13:03:24 CET [2016/06/21 7:03:24 ET]
Table 'Lamberta II' 9-max Seat #1 is the button
Seat 1: Avtovo ($100 in chips) 
Seat 3: matiko09 ($100 in chips) 
Seat 9: Sjtu_Michael ($100 in chips) 
matiko09: posts small blind $0.50
Sjtu_Michael: posts big blind $1
*** HOLE CARDS ***
Dealt to matiko09 [Jh Ah]
Avtovo: raises $1.50 to $2.50
matiko09: raises $6.50 to $9
Sjtu_Michael: folds 
Eskimo Fox joins the table at seat #4 
Avtovo: folds 
Uncalled bet ($6.50) returned to matiko09
matiko09 collected $6 from pot
matiko09: doesn't show hand 
*** SUMMARY ***
Total pot $6 | Rake $0 
Seat 1: Avtovo (button) folded before Flop
Seat 3: matiko09 (small blind) collected ($6)
Seat 9: Sjtu_Michael (big blind) folded before Flop





PokerStars Hand #155012739767:  Hold'em No Limit ($0.50/$1.00 USD) - 2016/06/21 13:03:29 CET [2016/06/21 7:03:29 ET]
Table 'Leo' 9-max Seat #4 is the button
Seat 1: letmegonow ($51.57 in chips) 
Seat 2: torkkdnm ($161.64 in chips) 
Seat 3: matiko09 ($102.80 in chips) 
Seat 4: SharingaaN ($99.33 in chips) 
Seat 5: DIMAN_324 ($100.50 in chips) 
Seat 6: chenconhaste ($124.17 in chips) 
Seat 8: pyromid ($63.67 in chips) 
Seat 9: Wladimir205 ($104.18 in chips) 
DIMAN_324: posts small blind $0.50
chenconhaste: posts big blind $1
maxxmeister: sits out 
*** HOLE CARDS ***
Dealt to matiko09 [Js Ts]
pyromid: folds 
Wladimir205: raises $1 to $2
letmegonow: folds 
torkkdnm: folds 
matiko09: raises $5 to $7
SharingaaN: folds 
DIMAN_324: folds 
chenconhaste: folds 
Wladimir205: folds 
Uncalled bet ($5) returned to matiko09
matiko09 collected $5.50 from pot
matiko09: doesn't show hand 
*** SUMMARY ***
Total pot $5.50 | Rake $0 
Seat 1: letmegonow folded before Flop (didn't bet)
Seat 2: torkkdnm folded before Flop (didn't bet)
Seat 3: matiko09 collected ($5.50)
Seat 4: SharingaaN (button) folded before Flop (didn't bet)
Seat 5: DIMAN_324 (small blind) folded before Flop
Seat 6: chenconhaste (big blind) folded before Flop
Seat 8: pyromid folded before Flop (didn't bet)
Seat 9: Wladimir205 folded before Flop





PokerStars Hand #155012740571:  Hold'em No Limit (€0.25/€0.50 EUR) - 2016/06/21 13:03:31 CET [2016/06/21 7:03:31 ET]
Table 'Actor II' 6-max Seat #3 is the button
Seat 1: hmverlin (€88.46 in chips) 
Seat 2: ooak182 (€50 in chips) 
Seat 3: asmodej666 (€89.26 in chips) 
Seat 4: matiko09 (€50.25 in chips) 
Seat 5: Rybka1294 (€50 in chips) 
Seat 6: fanmtZ (€20 in chips) 
matiko09: posts small blind €0.25
Rybka1294: posts big blind €0.50
*** HOLE CARDS ***
Dealt to matiko09 [8h Jc]
fanmtZ: folds 
hmverlin: folds 
ooak182: raises €0.75 to €1.25
asmodej666: raises €3 to €4.25
matiko09: folds 
Rybka1294: folds 
ooak182: calls €3
*** FLOP *** [6c 4s 7d]
ooak182: checks 
asmodej666: bets €4.50
ooak182: folds 
Uncalled bet (€4.50) returned to asmodej666
asmodej666 collected €8.79 from pot
asmodej666: doesn't show hand 
*** SUMMARY ***
Total pot €9.25 | Rake €0.46 
Board [6c 4s 7d]
Seat 1: hmverlin folded before Flop (didn't bet)
Seat 2: ooak182 folded on the Flop
Seat 3: asmodej666 (button) collected (€8.79)
Seat 4: matiko09 (small blind) folded before Flop
Seat 5: Rybka1294 (big blind) folded before Flop
Seat 6: fanmtZ folded before Flop (didn't bet)





PokerStars Hand #155012740968:  Hold'em No Limit (€0.25/€0.50 EUR) - 2016/06/21 13:03:32 CET [2016/06/21 7:03:32 ET]
Table 'Lotis II' 6-max Seat #6 is the button
Seat 1: acaestanemo (€50 in chips) 
Seat 2: broh202 (€117.89 in chips) 
Seat 3: bricasse1961 (€25.62 in chips) 
Seat 4: matiko09 (€78.27 in chips) 
Seat 5: AlexPles (€52.07 in chips) 
Seat 6: patriot424 (€57.25 in chips) 
acaestanemo: posts small blind €0.25
broh202: posts big blind €0.50
*** HOLE CARDS ***
Dealt to matiko09 [9s 2h]
bricasse1961: folds 
matiko09: folds 
AlexPles: folds 
patriot424: raises €0.50 to €1
acaestanemo: folds 
broh202: calls €0.50
*** FLOP *** [5c Kd 6s]
broh202: checks 
patriot424: checks 
*** TURN *** [5c Kd 6s] [6d]
broh202: bets €1.50
patriot424: calls €1.50
*** RIVER *** [5c Kd 6s 6d] [Ac]
broh202: bets €3
patriot424: folds 
Uncalled bet (€3) returned to broh202
broh202 collected €4.99 from pot
broh202: doesn't show hand 
*** SUMMARY ***
Total pot €5.25 | Rake €0.26 
Board [5c Kd 6s 6d Ac]
Seat 1: acaestanemo (small blind) folded before Flop
Seat 2: broh202 (big blind) collected (€4.99)
Seat 3: bricasse1961 folded before Flop (didn't bet)
Seat 4: matiko09 folded before Flop (didn't bet)
Seat 5: AlexPles folded before Flop (didn't bet)
Seat 6: patriot424 (button) folded on the River





PokerStars Hand #155012744555:  Hold'em No Limit ($0.50/$1.00 USD) - 2016/06/21 13:03:41 CET [2016/06/21 7:03:41 ET]
Table 'Lamberta II' 9-max Seat #3 is the button
Seat 1: Avtovo ($100 in chips) 
Seat 2: mavin80 ($100 in chips) 
Seat 3: matiko09 ($103.50 in chips) 
Seat 9: Sjtu_Michael ($99 in chips) 
Eskimo Fox will be allowed to play after the button
Sjtu_Michael: posts small blind $0.50
Avtovo: posts big blind $1
mavin80: posts big blind $1
*** HOLE CARDS ***
Dealt to matiko09 [7s Js]
50CandyJoe joins the table at seat #6 
chenconhaste joins the table at seat #8 
mavin80: raises $1.50 to $2.50
matiko09: folds 
Sjtu_Michael: calls $2
Avtovo: folds 
*** FLOP *** [Jc 7c 8c]
mi$$I$Elena joins the table at seat #5 
Sjtu_Michael: checks 
mavin80: bets $3
Sjtu_Michael: calls $3
*** TURN *** [Jc 7c 8c] [Ks]
Sjtu_Michael: checks 
mavin80: checks 
*** RIVER *** [Jc 7c 8c Ks] [Qd]
Sjtu_Michael: bets $7
mavin80: folds 
Uncalled bet ($7) returned to Sjtu_Michael
Sjtu_Michael collected $11.40 from pot
MarinoC1979 joins the table at seat #7 
Sjtu_Michael: doesn't show hand 
*** SUMMARY ***
Total pot $12 | Rake $0.60 
Board [Jc 7c 8c Ks Qd]
Seat 1: Avtovo (big blind) folded before Flop
Seat 2: mavin80 folded on the River
Seat 3: matiko09 (button) folded before Flop (didn't bet)
Seat 9: Sjtu_Michael (small blind) collected ($11.40)





PokerStars Hand #155012744978:  Hold'em No Limit ($0.50/$1.00 USD) - 2016/06/21 13:03:42 CET [2016/06/21 7:03:42 ET]
Table 'Chimay' 9-max Seat #5 is the button
Seat 1: chenconhaste ($110.05 in chips) 
Seat 3: Yuder_Lin ($66.74 in chips) 
Seat 4: fukumimi ($100 in chips) 
Seat 5: Avtovo ($100 in chips) 
Seat 6: mbk88 ($119.95 in chips) 
Seat 7: Troll8989 ($115.50 in chips) 
Seat 8: matiko09 ($108.12 in chips) 
Seat 9: SharingaaN ($108.99 in chips) 
mbk88: posts small blind $0.50
Troll8989: posts big blind $1
pyromid: sits out 
*** HOLE CARDS ***
Dealt to matiko09 [5d As]
matiko09: folds 
SharingaaN: folds 
chenconhaste: folds 
Yuder_Lin: calls $1
fukumimi: folds 
Avtovo: folds 
mbk88: folds 
Troll8989: checks 
*** FLOP *** [Ks Ac 5s]
Troll8989: checks 
Yuder_Lin: checks 
*** TURN *** [Ks Ac 5s] [Tc]
Troll8989: bets $1.50
Yuder_Lin: calls $1.50
*** RIVER *** [Ks Ac 5s Tc] [Jh]
Troll8989: checks 
Yuder_Lin: checks 
*** SHOW DOWN ***
Troll8989: shows [Kh 4d] (a pair of Kings)
Yuder_Lin: mucks hand 
Troll8989 collected $5.22 from pot
*** SUMMARY ***
Total pot $5.50 | Rake $0.28 
Board [Ks Ac 5s Tc Jh]
Seat 1: chenconhaste folded before Flop (didn't bet)
Seat 3: Yuder_Lin mucked [9s 9c]
Seat 4: fukumimi folded before Flop (didn't bet)
Seat 5: Avtovo (button) folded before Flop (didn't bet)
Seat 6: mbk88 (small blind) folded before Flop
Seat 7: Troll8989 (big blind) showed [Kh 4d] and won ($5.22) with a pair of Kings
Seat 8: matiko09 folded before Flop (didn't bet)
Seat 9: SharingaaN folded before Flop (didn't bet)





PokerStars Hand #155012749523:  Hold'em No Limit ($0.50/$1.00 USD) - 2016/06/21 13:03:52 CET [2016/06/21 7:03:52 ET]
Table 'Moreau' 9-max Seat #6 is the button
Seat 1: 50CandyJoe ($107.75 in chips) 
Seat 2: nubpoker ($138.89 in chips) 
Seat 3: matiko09 ($100 in chips) 
Seat 4: bonesnz1 ($66.21 in chips) 
Seat 5: DIMAN_324 ($104.38 in chips) 
Seat 6: mbk88 ($100 in chips) 
Seat 7: PanKwn15 ($27.23 in chips) 
Seat 8: maxxmeister ($111.30 in chips) 
PanKwn15: posts small blind $0.50
maxxmeister: posts big blind $1
*** HOLE CARDS ***
Dealt to matiko09 [Qd Qs]
50CandyJoe: folds 
nubpoker: folds 
50CandyJoe leaves the table
matiko09: raises $2 to $3
bonesnz1: folds 
DIMAN_324: calls $3
mbk88: folds 
PanKwn15: folds 
maxxmeister: folds 
*** FLOP *** [Kc Ad 2d]
matiko09: checks 
DIMAN_324: checks 
*** TURN *** [Kc Ad 2d] [8h]
ozone2003 joins the table at seat #1 
matiko09: checks 
DIMAN_324: checks 
*** RIVER *** [Kc Ad 2d 8h] [4s]
matiko09: checks 
DIMAN_324: checks 
*** SHOW DOWN ***
matiko09: shows [Qd Qs] (a pair of Queens)
DIMAN_324: mucks hand 
matiko09 collected $7.12 from pot
*** SUMMARY ***
Total pot $7.50 | Rake $0.38 
Board [Kc Ad 2d 8h 4s]
Seat 1: 50CandyJoe folded before Flop (didn't bet)
Seat 2: nubpoker folded before Flop (didn't bet)
Seat 3: matiko09 showed [Qd Qs] and won ($7.12) with a pair of Queens
Seat 4: bonesnz1 folded before Flop (didn't bet)
Seat 5: DIMAN_324 mucked [Jd Jc]
Seat 6: mbk88 (button) folded before Flop (didn't bet)
Seat 7: PanKwn15 (small blind) folded before Flop
Seat 8: maxxmeister (big blind) folded before Flop





PokerStars Hand #155012751244:  Hold'em No Limit ($0.50/$1.00 USD) - 2016/06/21 13:03:57 CET [2016/06/21 7:03:57 ET]
Table 'Umbriel II' 9-max Seat #6 is the button
Seat 1: Avtovo ($100 in chips) 
Seat 2: rura53 ($71 in chips) 
Seat 3: mxustin ($37.75 in chips) 
Seat 5: matiko09 ($145.46 in chips) 
Seat 6: maxxmeister ($100 in chips) 
Seat 7: chenconhaste ($170.35 in chips) 
Seat 8: ozone2003 ($115.97 in chips) 
Seat 9: Troll8989 ($103 in chips) 
chenconhaste: posts small blind $0.50
ozone2003: posts big blind $1
Eskimo Fox: sits out 
*** HOLE CARDS ***
Dealt to matiko09 [3c 9d]
Troll8989: folds 
Avtovo: folds 
rura53: folds 
mxustin: folds 
matiko09: folds 
maxxmeister: raises $2 to $3
chenconhaste: raises $8 to $11
ozone2003: folds 
maxxmeister: folds 
Uncalled bet ($8) returned to chenconhaste
chenconhaste collected $7 from pot
*** SUMMARY ***
Total pot $7 | Rake $0 
Seat 1: Avtovo folded before Flop (didn't bet)
Seat 2: rura53 folded before Flop (didn't bet)
Seat 3: mxustin folded before Flop (didn't bet)
Seat 5: matiko09 folded before Flop (didn't bet)
Seat 6: maxxmeister (button) folded before Flop
Seat 7: chenconhaste (small blind) collected ($7)
Seat 8: ozone2003 (big blind) folded before Flop
Seat 9: Troll8989 folded before Flop (didn't bet)





PokerStars Hand #155012751820:  Hold'em No Limit ($0.50/$1.00 USD) - 2016/06/21 13:03:58 CET [2016/06/21 7:03:58 ET]
Table 'Cheleb' 9-max Seat #8 is the button
Seat 1: SharingaaN ($111.93 in chips) 
Seat 2: pyromid ($139.88 in chips) 
Seat 3: bonesnz1 ($42.39 in chips) 
Seat 4: DIMAN_324 ($182.57 in chips) 
Seat 5: Avtovo ($136.50 in chips) 
Seat 6: matiko09 ($102.52 in chips) 
Seat 7: DomiVY ($40 in chips) 
Seat 8: Troll8989 ($100 in chips) 
Seat 9: chenconhaste ($116.52 in chips) 
chenconhaste: posts small blind $0.50
SharingaaN: posts big blind $1
*** HOLE CARDS ***
Dealt to matiko09 [Jd 5s]
pyromid: folds 
bonesnz1: folds 
DIMAN_324: raises $2 to $3
Avtovo: folds 
matiko09: folds 
DomiVY: folds 
Troll8989: folds 
chenconhaste: folds 
SharingaaN: folds 
Uncalled bet ($2) returned to DIMAN_324
DIMAN_324 collected $2.50 from pot
DIMAN_324: doesn't show hand 
*** SUMMARY ***
Total pot $2.50 | Rake $0 
Seat 1: SharingaaN (big blind) folded before Flop
Seat 2: pyromid folded before Flop (didn't bet)
Seat 3: bonesnz1 folded before Flop (didn't bet)
Seat 4: DIMAN_324 collected ($2.50)
Seat 5: Avtovo folded before Flop (didn't bet)
Seat 6: matiko09 folded before Flop (didn't bet)
Seat 7: DomiVY folded before Flop (didn't bet)
Seat 8: Troll8989 (button) folded before Flop (didn't bet)
Seat 9: chenconhaste (small blind) folded before Flop





PokerStars Hand #155012757253:  Hold'em No Limit ($0.50/$1.00 USD) - 2016/06/21 13:04:11 CET [2016/06/21 7:04:11 ET]
Table 'Saldanha' 9-max Seat #4 is the button
Seat 1: IceSharK.AA ($75.73 in chips) 
Seat 2: matiko09 ($100 in chips) 
Seat 3: Avtovo ($100 in chips) 
Seat 4: 50CandyJoe ($100 in chips) 
Seat 8: pattexpro ($78.80 in chips) 
Seat 9: maxxmeister ($100 in chips) 
Eskimo Fox will be allowed to play after the button
SharingaaN will be allowed to play after the button
chenconhaste will be allowed to play after the button
pattexpro: posts small blind $0.50
maxxmeister: posts big blind $1
IceSharK.AA: posts the ante $0.20
matiko09: posts the ante $0.20
Avtovo: posts the ante $0.20
50CandyJoe: posts the ante $0.20
pattexpro: posts the ante $0.20
maxxmeister: posts the ante $0.20
*** HOLE CARDS ***
Dealt to matiko09 [Qd 8c]
IceSharK.AA: folds 
matiko09: folds 
Avtovo: folds 
50CandyJoe: raises $1 to $2
pattexpro: calls $1.50
maxxmeister: raises $9 to $11
50CandyJoe: calls $9
pattexpro: calls $9
*** FLOP *** [9h Kd Jd]
pattexpro: checks 
maxxmeister: bets $15.49
50CandyJoe: calls $15.49
pattexpro: folds 
*** TURN *** [9h Kd Jd] [5s]
maxxmeister: bets $24.34
50CandyJoe: folds 
Uncalled bet ($24.34) returned to maxxmeister
maxxmeister collected $62.68 from pot
maxxmeister: doesn't show hand 
*** SUMMARY ***
Total pot $65.18 | Rake $2.50 
Board [9h Kd Jd 5s]
Seat 1: IceSharK.AA folded before Flop (didn't bet)
Seat 2: matiko09 folded before Flop (didn't bet)
Seat 3: Avtovo folded before Flop (didn't bet)
Seat 4: 50CandyJoe (button) folded on the Turn
Seat 8: pattexpro (small blind) folded on the Flop
Seat 9: maxxmeister (big blind) collected ($62.68)





PokerStars Hand #155012759317:  Hold'em No Limit ($0.50/$1.00 USD) - 2016/06/21 13:04:16 CET [2016/06/21 7:04:16 ET]
Table 'Leo' 9-max Seat #5 is the button
Seat 1: letmegonow ($51.57 in chips) 
Seat 2: torkkdnm ($161.64 in chips) 
Seat 3: matiko09 ($106.30 in chips) 
Seat 4: SharingaaN ($99.33 in chips) 
Seat 5: DIMAN_324 ($100 in chips) 
Seat 6: chenconhaste ($123.17 in chips) 
Seat 7: maxxmeister ($100 in chips) 
Seat 8: pyromid ($63.67 in chips) 
Seat 9: Wladimir205 ($102.18 in chips) 
chenconhaste: posts small blind $0.50
maxxmeister: posts big blind $1
*** HOLE CARDS ***
Dealt to matiko09 [9h Qs]
pyromid: folds 
Wladimir205: raises $1 to $2
letmegonow: folds 
torkkdnm: folds 
matiko09: folds 
SharingaaN: folds 
DIMAN_324: folds 
chenconhaste: folds 
maxxmeister: folds 
Uncalled bet ($1) returned to Wladimir205
Wladimir205 collected $2.50 from pot
Wladimir205: doesn't show hand 
*** SUMMARY ***
Total pot $2.50 | Rake $0 
Seat 1: letmegonow folded before Flop (didn't bet)
Seat 2: torkkdnm folded before Flop (didn't bet)
Seat 3: matiko09 folded before Flop (didn't bet)
Seat 4: SharingaaN folded before Flop (didn't bet)
Seat 5: DIMAN_324 (button) folded before Flop (didn't bet)
Seat 6: chenconhaste (small blind) folded before Flop
Seat 7: maxxmeister (big blind) folded before Flop
Seat 8: pyromid folded before Flop (didn't bet)
Seat 9: Wladimir205 collected ($2.50)





PokerStars Hand #155012760365:  Hold'em No Limit ($0.50/$1.00 USD) - 2016/06/21 13:04:19 CET [2016/06/21 7:04:19 ET]
Table 'Feronia' 9-max Seat #2 is the button
Seat 1: DIMAN_324 ($100 in chips) 
Seat 2: Yuder_Lin ($103.37 in chips) 
Seat 3: mbk88 ($142.25 in chips) 
Seat 4: pyromid ($121.44 in chips) 
Seat 5: matiko09 ($115.39 in chips) 
Seat 6: chenconhaste ($116.45 in chips) 
Seat 7: arctur17 ($103.95 in chips) 
Seat 8: letmegonow ($147.39 in chips) 
Seat 9: mi$$I$Elena ($120.54 in chips) 
mbk88: posts small blind $0.50
pyromid: posts big blind $1
*** HOLE CARDS ***
Dealt to matiko09 [6d Ah]
matiko09: folds 
chenconhaste: folds 
arctur17: folds 
letmegonow: folds 
mi$$I$Elena: folds 
DIMAN_324: raises $1.50 to $2.50
Yuder_Lin: folds 
mbk88: folds 
pyromid: folds 
Uncalled bet ($1.50) returned to DIMAN_324
DIMAN_324 collected $2.50 from pot
DIMAN_324: doesn't show hand 
*** SUMMARY ***
Total pot $2.50 | Rake $0 
Seat 1: DIMAN_324 collected ($2.50)
Seat 2: Yuder_Lin (button) folded before Flop (didn't bet)
Seat 3: mbk88 (small blind) folded before Flop
Seat 4: pyromid (big blind) folded before Flop
Seat 5: matiko09 folded before Flop (didn't bet)
Seat 6: chenconhaste folded before Flop (didn't bet)
Seat 7: arctur17 folded before Flop (didn't bet)
Seat 8: letmegonow folded before Flop (didn't bet)
Seat 9: mi$$I$Elena folded before Flop (didn't bet)





PokerStars Hand #155012762421:  Hold'em No Limit (€0.25/€0.50 EUR) - 2016/06/21 13:04:24 CET [2016/06/21 7:04:24 ET]
Table 'Actor II' 6-max Seat #4 is the button
Seat 1: hmverlin (€88.46 in chips) 
Seat 2: ooak182 (€50 in chips) 
Seat 3: asmodej666 (€93.80 in chips) 
Seat 4: matiko09 (€50 in chips) 
Seat 5: Rybka1294 (€50 in chips) 
Seat 6: fanmtZ (€20 in chips) 
Rybka1294: posts small blind €0.25
fanmtZ: posts big blind €0.50
*** HOLE CARDS ***
Dealt to matiko09 [6d 5d]
hmverlin: raises €1 to €1.50
ooak182: folds 
asmodej666: folds 
matiko09: folds 
Rybka1294: folds 
fanmtZ: calls €1
*** FLOP *** [6c 3d 7s]
fanmtZ: checks 
hmverlin: bets €2
fanmtZ: folds 
Uncalled bet (€2) returned to hmverlin
hmverlin collected €3.09 from pot
hmverlin: doesn't show hand 
*** SUMMARY ***
Total pot €3.25 | Rake €0.16 
Board [6c 3d 7s]
Seat 1: hmverlin collected (€3.09)
Seat 2: ooak182 folded before Flop (didn't bet)
Seat 3: asmodej666 folded before Flop (didn't bet)
Seat 4: matiko09 (button) folded before Flop (didn't bet)
Seat 5: Rybka1294 (small blind) folded before Flop
Seat 6: fanmtZ (big blind) folded on the Flop





PokerStars Hand #155012763757:  Hold'em No Limit ($0.50/$1.00 USD) - 2016/06/21 13:04:27 CET [2016/06/21 7:04:27 ET]
Table 'Moreau' 9-max Seat #7 is the button
Seat 2: nubpoker ($138.89 in chips) 
Seat 3: matiko09 ($104.12 in chips) 
Seat 4: bonesnz1 ($66.21 in chips) 
Seat 5: DIMAN_324 ($101.38 in chips) 
Seat 6: mbk88 ($100 in chips) 
Seat 7: PanKwn15 ($26.73 in chips) 
Seat 8: maxxmeister ($110.30 in chips) 
Seat 9: Toonersens ($129.41 in chips) 
maxxmeister: posts small blind $0.50
Toonersens: posts big blind $1
ozone2003: sits out 
*** HOLE CARDS ***
Dealt to matiko09 [5c Kh]
nubpoker: raises $1.50 to $2.50
matiko09: folds 
bonesnz1: folds 
DIMAN_324: folds 
mbk88: folds 
PanKwn15: calls $2.50
maxxmeister: folds 
Toonersens: folds 
*** FLOP *** [5s 3c 7s]
nubpoker: checks 
PanKwn15: checks 
*** TURN *** [5s 3c 7s] [Tc]
nubpoker: checks 
PanKwn15: checks 
*** RIVER *** [5s 3c 7s Tc] [6d]
nubpoker: checks 
PanKwn15: bets $3
nubpoker: folds 
Uncalled bet ($3) returned to PanKwn15
PanKwn15 collected $6.18 from pot
PanKwn15: doesn't show hand 
*** SUMMARY ***
Total pot $6.50 | Rake $0.32 
Board [5s 3c 7s Tc 6d]
Seat 2: nubpoker folded on the River
Seat 3: matiko09 folded before Flop (didn't bet)
Seat 4: bonesnz1 folded before Flop (didn't bet)
Seat 5: DIMAN_324 folded before Flop (didn't bet)
Seat 6: mbk88 folded before Flop (didn't bet)
Seat 7: PanKwn15 (button) collected ($6.18)
Seat 8: maxxmeister (small blind) folded before Flop
Seat 9: Toonersens (big blind) folded before Flop





PokerStars Hand #155012765191:  Hold'em No Limit ($0.50/$1.00 USD) - 2016/06/21 13:04:31 CET [2016/06/21 7:04:31 ET]
Table 'Carlova II' 9-max Seat #4 is the button
Seat 1: matiko09 ($132.55 in chips) 
Seat 2: chenconhaste ($118.73 in chips) 
Seat 3: King_Z�Manel ($105.95 in chips) 
Seat 4: Dandy Monk ($50.64 in chips) 
Seat 5: ozone2003 ($100 in chips) 
Seat 6: DIMAN_324 ($100 in chips) 
Seat 7: mi$$I$Elena ($105.18 in chips) 
Seat 8: pyromid ($89.59 in chips) 
Seat 9: Troll8989 ($107.68 in chips) 
ozone2003: posts small blind $0.50
DIMAN_324: posts big blind $1
*** HOLE CARDS ***
Dealt to matiko09 [Qh 2c]
mi$$I$Elena: folds 
pyromid: folds 
Troll8989: folds 
matiko09: folds 
chenconhaste: folds 
King_Z�Manel: folds 
Dandy Monk: folds 
ozone2003: folds 
Uncalled bet ($0.50) returned to DIMAN_324
DIMAN_324 collected $1 from pot
DIMAN_324: doesn't show hand 
*** SUMMARY ***
Total pot $1 | Rake $0 
Seat 1: matiko09 folded before Flop (didn't bet)
Seat 2: chenconhaste folded before Flop (didn't bet)
Seat 3: King_Z�Manel folded before Flop (didn't bet)
Seat 4: Dandy Monk (button) folded before Flop (didn't bet)
Seat 5: ozone2003 (small blind) folded before Flop
Seat 6: DIMAN_324 (big blind) collected ($1)
Seat 7: mi$$I$Elena folded before Flop (didn't bet)
Seat 8: pyromid folded before Flop (didn't bet)
Seat 9: Troll8989 folded before Flop (didn't bet)





PokerStars Hand #155012765291:  Hold'em No Limit (€0.25/€0.50 EUR) - 2016/06/21 13:04:31 CET [2016/06/21 7:04:31 ET]
Table 'Lotis II' 6-max Seat #1 is the button
Seat 1: acaestanemo (€50 in chips) 
Seat 2: broh202 (€120.38 in chips) 
Seat 3: bricasse1961 (€25.62 in chips) 
Seat 4: matiko09 (€78.27 in chips) 
Seat 5: AlexPles (€52.07 in chips) 
Seat 6: patriot424 (€54.75 in chips) 
broh202: posts small blind €0.25
bricasse1961: posts big blind €0.50
*** HOLE CARDS ***
Dealt to matiko09 [2c 4s]
matiko09: folds 
AlexPles: folds 
patriot424 is disconnected 
patriot424 has timed out while disconnected
patriot424: folds 
acaestanemo: folds 
broh202: raises €1 to €1.50
bricasse1961: calls €1
*** FLOP *** [As 3d Jh]
broh202: bets €1.42
bricasse1961: calls €1.42
*** TURN *** [As 3d Jh] [9s]
broh202: bets €3
bricasse1961: calls €3
*** RIVER *** [As 3d Jh 9s] [Qd]
broh202: checks 
bricasse1961: bets €1.50
broh202: calls €1.50
*** SHOW DOWN ***
bricasse1961: shows [Ad 9d] (two pair, Aces and Nines)
broh202: mucks hand 
bricasse1961 collected €14.10 from pot
*** SUMMARY ***
Total pot €14.84 | Rake €0.74 
Board [As 3d Jh 9s Qd]
Seat 1: acaestanemo (button) folded before Flop (didn't bet)
Seat 2: broh202 (small blind) mucked [6c Ac]
Seat 3: bricasse1961 (big blind) showed [Ad 9d] and won (€14.10) with two pair, Aces and Nines
Seat 4: matiko09 folded before Flop (didn't bet)
Seat 5: AlexPles folded before Flop (didn't bet)
Seat 6: patriot424 folded before Flop (didn't bet)





PokerStars Hand #155012765708:  Hold'em No Limit ($0.50/$1.00 USD) - 2016/06/21 13:04:32 CET [2016/06/21 7:04:32 ET]
Table 'Cheleb' 9-max Seat #9 is the button
Seat 1: SharingaaN ($110.93 in chips) 
Seat 2: pyromid ($139.88 in chips) 
Seat 3: bonesnz1 ($42.39 in chips) 
Seat 4: DIMAN_324 ($184.07 in chips) 
Seat 5: Avtovo ($136.50 in chips) 
Seat 6: matiko09 ($102.52 in chips) 
Seat 7: DomiVY ($40 in chips) 
Seat 8: Troll8989 ($100 in chips) 
Seat 9: chenconhaste ($116.02 in chips) 
SharingaaN: posts small blind $0.50
pyromid: posts big blind $1
*** HOLE CARDS ***
Dealt to matiko09 [Jh Qs]
bonesnz1: folds 
DIMAN_324: folds 
Avtovo: folds 
matiko09: folds 
DomiVY: folds 
Troll8989: folds 
chenconhaste: raises $1.25 to $2.25
SharingaaN: folds 
pyromid: folds 
Uncalled bet ($1.25) returned to chenconhaste
chenconhaste collected $2.50 from pot
*** SUMMARY ***
Total pot $2.50 | Rake $0 
Seat 1: SharingaaN (small blind) folded before Flop
Seat 2: pyromid (big blind) folded before Flop
Seat 3: bonesnz1 folded before Flop (didn't bet)
Seat 4: DIMAN_324 folded before Flop (didn't bet)
Seat 5: Avtovo folded before Flop (didn't bet)
Seat 6: matiko09 folded before Flop (didn't bet)
Seat 7: DomiVY folded before Flop (didn't bet)
Seat 8: Troll8989 folded before Flop (didn't bet)
Seat 9: chenconhaste (button) collected ($2.50)





PokerStars Hand #155012766059:  Hold'em No Limit ($0.50/$1.00 USD) - 2016/06/21 13:04:33 CET [2016/06/21 7:04:33 ET]
Table 'Rupertwildt' 9-max Seat #8 is the button
Seat 1: pokernixxx ($57.45 in chips) 
Seat 2: SharingaaN ($80 in chips) 
Seat 3: Saymon_Moo ($105.92 in chips) 
Seat 4: matiko09 ($150.68 in chips) 
Seat 5: pyromid ($87.96 in chips) 
Seat 6: ozone2003 ($100 in chips) 
Seat 7: chenconhaste ($102.34 in chips) 
Seat 8: Gonzanary ($114.64 in chips) 
Seat 9: mbk88 ($118.93 in chips) 
mbk88: posts small blind $0.50
pokernixxx: posts big blind $1
*** HOLE CARDS ***
Dealt to matiko09 [5c 6h]
SharingaaN: folds 
Saymon_Moo: calls $1
matiko09: folds 
pyromid: raises $1.50 to $2.50
ozone2003: calls $2.50
chenconhaste: folds 
Gonzanary: calls $2.50
mbk88: folds 
pokernixxx: calls $1.50
Saymon_Moo: calls $1.50
*** FLOP *** [Js Qc 2d]
pokernixxx: checks 
Saymon_Moo: checks 
pyromid: checks 
ozone2003: checks 
Gonzanary: checks 
*** TURN *** [Js Qc 2d] [2h]
pokernixxx: checks 
Saymon_Moo: checks 
pyromid: checks 
ozone2003: bets $7.78
Gonzanary: folds 
pokernixxx: folds 
Saymon_Moo: calls $7.78
pyromid: folds 
*** RIVER *** [Js Qc 2d 2h] [As]
Saymon_Moo: checks 
ozone2003: bets $13.56
Saymon_Moo: calls $13.56
*** SHOW DOWN ***
ozone2003: shows [Ad Jh] (two pair, Aces and Jacks)
Saymon_Moo: mucks hand 
ozone2003 collected $53.18 from pot
*** SUMMARY ***
Total pot $55.68 | Rake $2.50 
Board [Js Qc 2d 2h As]
Seat 1: pokernixxx (big blind) folded on the Turn
Seat 2: SharingaaN folded before Flop (didn't bet)
Seat 3: Saymon_Moo mucked [9d Jc]
Seat 4: matiko09 folded before Flop (didn't bet)
Seat 5: pyromid folded on the Turn
Seat 6: ozone2003 showed [Ad Jh] and won ($53.18) with two pair, Aces and Jacks
Seat 7: chenconhaste folded before Flop (didn't bet)
Seat 8: Gonzanary (button) folded on the Turn
Seat 9: mbk88 (small blind) folded before Flop





PokerStars Hand #155012767451:  Hold'em No Limit ($0.50/$1.00 USD) - 2016/06/21 13:04:36 CET [2016/06/21 7:04:36 ET]
Table 'Leo' 9-max Seat #6 is the button
Seat 1: letmegonow ($51.57 in chips) 
Seat 2: torkkdnm ($161.64 in chips) 
Seat 3: matiko09 ($106.30 in chips) 
Seat 4: SharingaaN ($99.33 in chips) 
Seat 5: DIMAN_324 ($100 in chips) 
Seat 6: chenconhaste ($122.67 in chips) 
Seat 7: maxxmeister ($100 in chips) 
Seat 8: pyromid ($63.67 in chips) 
Seat 9: Wladimir205 ($103.68 in chips) 
maxxmeister: posts small blind $0.50
pyromid: posts big blind $1
*** HOLE CARDS ***
Dealt to matiko09 [As 7d]
Wladimir205: folds 
letmegonow: folds 
torkkdnm: folds 
matiko09: folds 
SharingaaN: folds 
DIMAN_324: folds 
chenconhaste: raises $1.25 to $2.25
maxxmeister: folds 
pyromid: calls $1.25
*** FLOP *** [Ts Jh 8d]
pyromid: checks 
chenconhaste: checks 
*** TURN *** [Ts Jh 8d] [2c]
pyromid: checks 
chenconhaste: bets $2.50
pyromid: calls $2.50
*** RIVER *** [Ts Jh 8d 2c] [5d]
pyromid: checks 
chenconhaste: checks 
*** SHOW DOWN ***
pyromid: shows [Qd Ac] (high card Ace)
chenconhaste: mucks hand 
pyromid collected $9.50 from pot
*** SUMMARY ***
Total pot $10 | Rake $0.50 
Board [Ts Jh 8d 2c 5d]
Seat 1: letmegonow folded before Flop (didn't bet)
Seat 2: torkkdnm folded before Flop (didn't bet)
Seat 3: matiko09 folded before Flop (didn't bet)
Seat 4: SharingaaN folded before Flop (didn't bet)
Seat 5: DIMAN_324 folded before Flop (didn't bet)
Seat 6: chenconhaste (button) mucked [4c 7s]
Seat 7: maxxmeister (small blind) folded before Flop
Seat 8: pyromid (big blind) showed [Qd Ac] and won ($9.50) with high card Ace
Seat 9: Wladimir205 folded before Flop (didn't bet)





PokerStars Hand #155012770174:  Hold'em No Limit ($0.50/$1.00 USD) - 2016/06/21 13:04:43 CET [2016/06/21 7:04:43 ET]
Table 'Feronia' 9-max Seat #3 is the button
Seat 1: DIMAN_324 ($101.50 in chips) 
Seat 2: Yuder_Lin ($103.37 in chips) 
Seat 3: mbk88 ($141.75 in chips) 
Seat 4: pyromid ($120.44 in chips) 
Seat 5: matiko09 ($115.39 in chips) 
Seat 6: chenconhaste ($116.45 in chips) 
Seat 7: arctur17 ($103.95 in chips) 
Seat 8: letmegonow ($147.39 in chips) 
Seat 9: mi$$I$Elena ($120.54 in chips) 
pyromid: posts small blind $0.50
matiko09: posts big blind $1
*** HOLE CARDS ***
Dealt to matiko09 [8h 7h]
chenconhaste: folds 
arctur17: folds 
letmegonow: folds 
mi$$I$Elena: folds 
DIMAN_324: folds 
Yuder_Lin: folds 
mbk88: raises $1 to $2
pyromid: folds 
matiko09: calls $1
*** FLOP *** [7c Qs 7s]
matiko09: checks 
mbk88: bets $3
matiko09: raises $9 to $12
mbk88: folds 
Uncalled bet ($9) returned to matiko09
matiko09 collected $9.98 from pot
matiko09: doesn't show hand 
*** SUMMARY ***
Total pot $10.50 | Rake $0.52 
Board [7c Qs 7s]
Seat 1: DIMAN_324 folded before Flop (didn't bet)
Seat 2: Yuder_Lin folded before Flop (didn't bet)
Seat 3: mbk88 (button) folded on the Flop
Seat 4: pyromid (small blind) folded before Flop
Seat 5: matiko09 (big blind) collected ($9.98)
Seat 6: chenconhaste folded before Flop (didn't bet)
Seat 7: arctur17 folded before Flop (didn't bet)
Seat 8: letmegonow folded before Flop (didn't bet)
Seat 9: mi$$I$Elena folded before Flop (didn't bet)





PokerStars Hand #155012770336:  Hold'em No Limit ($0.50/$1.00 USD) - 2016/06/21 13:04:43 CET [2016/06/21 7:04:43 ET]
Table 'Brauna II' 9-max Seat #5 is the button
Seat 1: wisbc ($131.32 in chips) 
Seat 2: pyromid ($151.77 in chips) 
Seat 3: matiko09 ($100 in chips) 
Seat 4: chenconhaste ($199 in chips) 
Seat 5: fukumimi ($100 in chips) 
Seat 6: mbk88 ($203.51 in chips) 
Seat 8: DIMAN_324 ($133.65 in chips) 
Seat 9: torkkdnm ($100 in chips) 
mbk88: posts small blind $0.50
CoolFireX was removed from the table for failing to post
DIMAN_324: posts big blind $1
*** HOLE CARDS ***
Dealt to matiko09 [9h Kh]
torkkdnm: folds 
Troll8989 joins the table at seat #7 
wisbc: folds 
pyromid: raises $1.50 to $2.50
matiko09: folds 
chenconhaste: folds 
fukumimi: folds 
mbk88: folds 
DIMAN_324: folds 
Uncalled bet ($1.50) returned to pyromid
pyromid collected $2.50 from pot
pyromid: doesn't show hand 
*** SUMMARY ***
Total pot $2.50 | Rake $0 
Seat 1: wisbc folded before Flop (didn't bet)
Seat 2: pyromid collected ($2.50)
Seat 3: matiko09 folded before Flop (didn't bet)
Seat 4: chenconhaste folded before Flop (didn't bet)
Seat 5: fukumimi (button) folded before Flop (didn't bet)
Seat 6: mbk88 (small blind) folded before Flop
Seat 8: DIMAN_324 (big blind) folded before Flop
Seat 9: torkkdnm folded before Flop (didn't bet)





PokerStars Hand #155012771310:  Hold'em No Limit ($0.50/$1.00 USD) - 2016/06/21 13:04:46 CET [2016/06/21 7:04:46 ET]
Table 'Umbriel II' 9-max Seat #7 is the button
Seat 1: Avtovo ($100 in chips) 
Seat 2: rura53 ($71 in chips) 
Seat 3: mxustin ($37.75 in chips) 
Seat 5: matiko09 ($145.46 in chips) 
Seat 6: maxxmeister ($100 in chips) 
Seat 7: chenconhaste ($174.35 in chips) 
Seat 8: ozone2003 ($114.97 in chips) 
Seat 9: Troll8989 ($103 in chips) 
ozone2003: posts small blind $0.50
Troll8989: posts big blind $1
Eskimo Fox: sits out 
*** HOLE CARDS ***
Dealt to matiko09 [9c 6s]
Avtovo: folds 
Avtovo leaves the table
rura53: folds 
phil_cheng joins the table at seat #1 
mxustin: folds 
matiko09: folds 
maxxmeister: folds 
chenconhaste: raises $1.25 to $2.25
ozone2003: raises $5.75 to $8
Troll8989: folds 
chenconhaste: folds 
Uncalled bet ($5.75) returned to ozone2003
ozone2003 collected $5.50 from pot
ozone2003: doesn't show hand 
*** SUMMARY ***
Total pot $5.50 | Rake $0 
Seat 1: Avtovo folded before Flop (didn't bet)
Seat 2: rura53 folded before Flop (didn't bet)
Seat 3: mxustin folded before Flop (didn't bet)
Seat 5: matiko09 folded before Flop (didn't bet)
Seat 6: maxxmeister folded before Flop (didn't bet)
Seat 7: chenconhaste (button) folded before Flop
Seat 8: ozone2003 (small blind) collected ($5.50)
Seat 9: Troll8989 (big blind) folded before Flop





PokerStars Hand #155012771993:  Hold'em No Limit ($0.50/$1.00 USD) - 2016/06/21 13:04:48 CET [2016/06/21 7:04:48 ET]
Table 'Lamberta II' 9-max Seat #9 is the button
Seat 1: Avtovo ($100 in chips) 
Seat 2: mavin80 ($94.50 in chips) 
Seat 3: matiko09 ($103.50 in chips) 
Seat 9: Sjtu_Michael ($104.90 in chips) 
Avtovo: posts small blind $0.50
mavin80: posts big blind $1
Eskimo Fox: sits out 
mi$$I$Elena: sits out 
50CandyJoe: sits out 
MarinoC1979: sits out 
chenconhaste: sits out 
*** HOLE CARDS ***
Dealt to matiko09 [Js 6d]
matiko09: folds 
Sjtu_Michael: folds 
Avtovo: raises $1.50 to $2.50
mavin80: folds 
Uncalled bet ($1.50) returned to Avtovo
Avtovo collected $2 from pot
Avtovo: doesn't show hand 
*** SUMMARY ***
Total pot $2 | Rake $0 
Seat 1: Avtovo (small blind) collected ($2)
Seat 2: mavin80 (big blind) folded before Flop
Seat 3: matiko09 folded before Flop (didn't bet)
Seat 9: Sjtu_Michael (button) folded before Flop (didn't bet)





PokerStars Hand #155012776178:  Hold'em No Limit ($0.50/$1.00 USD) - 2016/06/21 13:04:58 CET [2016/06/21 7:04:58 ET]
Table 'Cheleb' 9-max Seat #1 is the button
Seat 1: SharingaaN ($110.43 in chips) 
Seat 2: pyromid ($138.88 in chips) 
Seat 3: bonesnz1 ($42.39 in chips) 
Seat 4: DIMAN_324 ($184.07 in chips) 
Seat 5: Avtovo ($136.50 in chips) 
Seat 6: matiko09 ($102.52 in chips) 
Seat 7: DomiVY ($40 in chips) 
Seat 8: Troll8989 ($100 in chips) 
Seat 9: chenconhaste ($117.52 in chips) 
pyromid: posts small blind $0.50
bonesnz1: posts big blind $1
*** HOLE CARDS ***
Dealt to matiko09 [2s Qh]
DIMAN_324: folds 
Avtovo: folds 
matiko09: folds 
DomiVY: folds 
Troll8989: folds 
chenconhaste: folds 
SharingaaN: folds 
pyromid: folds 
Uncalled bet ($0.50) returned to bonesnz1
bonesnz1 collected $1 from pot
bonesnz1: doesn't show hand 
*** SUMMARY ***
Total pot $1 | Rake $0 
Seat 1: SharingaaN (button) folded before Flop (didn't bet)
Seat 2: pyromid (small blind) folded before Flop
Seat 3: bonesnz1 (big blind) collected ($1)
Seat 4: DIMAN_324 folded before Flop (didn't bet)
Seat 5: Avtovo folded before Flop (didn't bet)
Seat 6: matiko09 folded before Flop (didn't bet)
Seat 7: DomiVY folded before Flop (didn't bet)
Seat 8: Troll8989 folded before Flop (didn't bet)
Seat 9: chenconhaste folded before Flop (didn't bet)





PokerStars Hand #155012777565:  Hold'em No Limit ($0.50/$1.00 USD) - 2016/06/21 13:05:01 CET [2016/06/21 7:05:01 ET]
Table 'Lamberta II' 9-max Seat #1 is the button
Seat 1: Avtovo ($101 in chips) 
Seat 2: mavin80 ($93.50 in chips) 
Seat 3: matiko09 ($103.50 in chips) 
Seat 7: MarinoC1979 ($74.67 in chips) 
Seat 9: Sjtu_Michael ($104.90 in chips) 
mavin80: posts small blind $0.50
matiko09: posts big blind $1
Eskimo Fox: sits out 
mi$$I$Elena: sits out 
50CandyJoe: sits out 
MarinoC1979: posts big blind $1
chenconhaste: sits out 
*** HOLE CARDS ***
Dealt to matiko09 [Th 9c]
MarinoC1979: checks 
Sjtu_Michael: folds 
Avtovo: raises $3.50 to $4.50
mavin80: calls $4
matiko09: folds 
MarinoC1979: folds 
*** FLOP *** [6s Jh Ks]
mavin80: checks 
Avtovo: bets $5.22
mavin80: folds 
Uncalled bet ($5.22) returned to Avtovo
Avtovo collected $10.45 from pot
Avtovo: doesn't show hand 
*** SUMMARY ***
Total pot $11 | Rake $0.55 
Board [6s Jh Ks]
Seat 1: Avtovo (button) collected ($10.45)
Seat 2: mavin80 (small blind) folded on the Flop
Seat 3: matiko09 (big blind) folded before Flop
Seat 7: MarinoC1979 folded before Flop
Seat 9: Sjtu_Michael folded before Flop (didn't bet)





PokerStars Hand #155012777855:  Hold'em No Limit ($0.50/$1.00 USD) - 2016/06/21 13:05:02 CET [2016/06/21 7:05:02 ET]
Table 'Carlova II' 9-max Seat #5 is the button
Seat 1: matiko09 ($132.55 in chips) 
Seat 2: chenconhaste ($118.73 in chips) 
Seat 3: King_Z�Manel ($105.95 in chips) 
Seat 4: Dandy Monk ($50.64 in chips) 
Seat 5: ozone2003 ($100 in chips) 
Seat 6: DIMAN_324 ($100.50 in chips) 
Seat 7: mi$$I$Elena ($105.18 in chips) 
Seat 8: pyromid ($89.59 in chips) 
Seat 9: Troll8989 ($107.68 in chips) 
DIMAN_324: posts small blind $0.50
mi$$I$Elena: posts big blind $1
*** HOLE CARDS ***
Dealt to matiko09 [Qc 6s]
pyromid: folds 
Troll8989: folds 
matiko09: folds 
chenconhaste: raises $1.25 to $2.25
King_Z�Manel: folds 
Dandy Monk: folds 
ozone2003: folds 
DIMAN_324: folds 
mi$$I$Elena: folds 
Uncalled bet ($1.25) returned to chenconhaste
chenconhaste collected $2.50 from pot
*** SUMMARY ***
Total pot $2.50 | Rake $0 
Seat 1: matiko09 folded before Flop (didn't bet)
Seat 2: chenconhaste collected ($2.50)
Seat 3: King_Z�Manel folded before Flop (didn't bet)
Seat 4: Dandy Monk folded before Flop (didn't bet)
Seat 5: ozone2003 (button) folded before Flop (didn't bet)
Seat 6: DIMAN_324 (small blind) folded before Flop
Seat 7: mi$$I$Elena (big blind) folded before Flop
Seat 8: pyromid folded before Flop (didn't bet)
Seat 9: Troll8989 folded before Flop (didn't bet)





PokerStars Hand #155012780152:  Hold'em No Limit ($0.50/$1.00 USD) - 2016/06/21 13:05:07 CET [2016/06/21 7:05:07 ET]
Table 'Brauna II' 9-max Seat #6 is the button
Seat 1: wisbc ($131.32 in chips) 
Seat 2: pyromid ($153.27 in chips) 
Seat 3: matiko09 ($100 in chips) 
Seat 4: chenconhaste ($199 in chips) 
Seat 5: fukumimi ($100 in chips) 
Seat 6: mbk88 ($203.01 in chips) 
Seat 8: DIMAN_324 ($132.65 in chips) 
Seat 9: torkkdnm ($100 in chips) 
Troll8989 will be allowed to play after the button
DIMAN_324: posts small blind $0.50
torkkdnm: posts big blind $1
*** HOLE CARDS ***
Dealt to matiko09 [Qc 7c]
wisbc: raises $1.50 to $2.50
pyromid: folds 
matiko09: folds 
chenconhaste: folds 
fukumimi: folds 
mbk88: folds 
DIMAN_324: folds 
torkkdnm: folds 
Uncalled bet ($1.50) returned to wisbc
wisbc collected $2.50 from pot
wisbc: doesn't show hand 
*** SUMMARY ***
Total pot $2.50 | Rake $0 
Seat 1: wisbc collected ($2.50)
Seat 2: pyromid folded before Flop (didn't bet)
Seat 3: matiko09 folded before Flop (didn't bet)
Seat 4: chenconhaste folded before Flop (didn't bet)
Seat 5: fukumimi folded before Flop (didn't bet)
Seat 6: mbk88 (button) folded before Flop (didn't bet)
Seat 8: DIMAN_324 (small blind) folded before Flop
Seat 9: torkkdnm (big blind) folded before Flop





PokerStars Hand #155012784547:  Hold'em No Limit ($0.50/$1.00 USD) - 2016/06/21 13:05:18 CET [2016/06/21 7:05:18 ET]
Table 'Saldanha' 9-max Seat #8 is the button
Seat 1: IceSharK.AA ($75.53 in chips) 
Seat 2: matiko09 ($100 in chips) 
Seat 3: Avtovo ($100 in chips) 
Seat 4: 50CandyJoe ($100 in chips) 
Seat 8: pattexpro ($67.60 in chips) 
Seat 9: maxxmeister ($135.99 in chips) 
maxxmeister: posts small blind $0.50
IceSharK.AA: posts big blind $1
Eskimo Fox: sits out 
SharingaaN: sits out 
chenconhaste: sits out 
IceSharK.AA: posts the ante $0.20
matiko09: posts the ante $0.20
Avtovo: posts the ante $0.20
50CandyJoe: posts the ante $0.20
pattexpro: posts the ante $0.20
maxxmeister: posts the ante $0.20
*** HOLE CARDS ***
Dealt to matiko09 [Qh 4d]
matiko09: folds 
Avtovo: folds 
50CandyJoe: folds 
pattexpro: calls $1
maxxmeister: calls $0.50
IceSharK.AA: raises $1 to $2
pattexpro: calls $1
IceSharK.AA said, "erroe"
IceSharK.AA said, "error"
maxxmeister: calls $1
*** FLOP *** [7s 2d Ad]
IceSharK.AA said, "sorry"
maxxmeister: checks 
IceSharK.AA: bets $5.26
pattexpro: calls $5.26
maxxmeister: folds 
*** TURN *** [7s 2d Ad] [Td]
IceSharK.AA: checks 
pattexpro: checks 
*** RIVER *** [7s 2d Ad Td] [Ac]
IceSharK.AA: checks 
pattexpro: checks 
*** SHOW DOWN ***
IceSharK.AA: shows [8s 5d] (a pair of Aces)
pattexpro: shows [6s As] (three of a kind, Aces)
pattexpro collected $16.83 from pot
*** SUMMARY ***
Total pot $17.72 | Rake $0.89 
Board [7s 2d Ad Td Ac]
Seat 1: IceSharK.AA (big blind) showed [8s 5d] and lost with a pair of Aces
Seat 2: matiko09 folded before Flop (didn't bet)
Seat 3: Avtovo folded before Flop (didn't bet)
Seat 4: 50CandyJoe folded before Flop (didn't bet)
Seat 8: pattexpro (button) showed [6s As] and won ($16.83) with three of a kind, Aces
Seat 9: maxxmeister (small blind) folded on the Flop





PokerStars Hand #155012784579:  Hold'em No Limit ($0.50/$1.00 USD) - 2016/06/21 13:05:18 CET [2016/06/21 7:05:18 ET]
Table 'Umbriel II' 9-max Seat #8 is the button
Seat 1: phil_cheng ($100 in chips) 
Seat 2: rura53 ($71 in chips) 
Seat 3: mxustin ($37.75 in chips) 
Seat 5: matiko09 ($145.46 in chips) 
Seat 6: maxxmeister ($100 in chips) 
Seat 7: chenconhaste ($172.10 in chips) 
Seat 8: ozone2003 ($118.22 in chips) 
Seat 9: Troll8989 ($102 in chips) 
Troll8989: posts small blind $0.50
phil_cheng: posts big blind $1
Eskimo Fox: sits out 
*** HOLE CARDS ***
Dealt to matiko09 [4d Ts]
rura53: raises $2 to $3
mxustin: folds 
matiko09: folds 
maxxmeister: folds 
chenconhaste: folds 
ozone2003: calls $3
Troll8989: folds 
phil_cheng: folds 
*** FLOP *** [6s Kh 3s]
rura53: bets $5
ozone2003: calls $5
*** TURN *** [6s Kh 3s] [7s]
rura53: checks 
ozone2003: bets $10.47
rura53: folds 
Uncalled bet ($10.47) returned to ozone2003
ozone2003 collected $16.62 from pot
ozone2003: doesn't show hand 
*** SUMMARY ***
Total pot $17.50 | Rake $0.88 
Board [6s Kh 3s 7s]
Seat 1: phil_cheng (big blind) folded before Flop
Seat 2: rura53 folded on the Turn
Seat 3: mxustin folded before Flop (didn't bet)
Seat 5: matiko09 folded before Flop (didn't bet)
Seat 6: maxxmeister folded before Flop (didn't bet)
Seat 7: chenconhaste folded before Flop (didn't bet)
Seat 8: ozone2003 (button) collected ($16.62)
Seat 9: Troll8989 (small blind) folded before Flop





PokerStars Hand #155012785330:  Hold'em No Limit ($0.50/$1.00 USD) - 2016/06/21 13:05:20 CET [2016/06/21 7:05:20 ET]
Table 'Cheleb' 9-max Seat #2 is the button
Seat 1: SharingaaN ($110.43 in chips) 
Seat 2: pyromid ($138.38 in chips) 
Seat 3: bonesnz1 ($42.89 in chips) 
Seat 4: DIMAN_324 ($184.07 in chips) 
Seat 5: Avtovo ($136.50 in chips) 
Seat 6: matiko09 ($102.52 in chips) 
Seat 7: DomiVY ($40 in chips) 
Seat 8: Troll8989 ($100 in chips) 
Seat 9: chenconhaste ($117.52 in chips) 
bonesnz1: posts small blind $0.50
DIMAN_324: posts big blind $1
*** HOLE CARDS ***
Dealt to matiko09 [Td 2d]
Avtovo: folds 
matiko09: folds 
DomiVY: folds 
Troll8989: folds 
chenconhaste: raises $1.25 to $2.25
SharingaaN: folds 
pyromid: folds 
bonesnz1: folds 
DIMAN_324: folds 
Uncalled bet ($1.25) returned to chenconhaste
chenconhaste collected $2.50 from pot
*** SUMMARY ***
Total pot $2.50 | Rake $0 
Seat 1: SharingaaN folded before Flop (didn't bet)
Seat 2: pyromid (button) folded before Flop (didn't bet)
Seat 3: bonesnz1 (small blind) folded before Flop
Seat 4: DIMAN_324 (big blind) folded before Flop
Seat 5: Avtovo folded before Flop (didn't bet)
Seat 6: matiko09 folded before Flop (didn't bet)
Seat 7: DomiVY folded before Flop (didn't bet)
Seat 8: Troll8989 folded before Flop (didn't bet)
Seat 9: chenconhaste collected ($2.50)





PokerStars Hand #155012786407:  Hold'em No Limit (€0.25/€0.50 EUR) - 2016/06/21 13:05:22 CET [2016/06/21 7:05:22 ET]
Table 'Actor II' 6-max Seat #5 is the button
Seat 1: hmverlin (€90.05 in chips) 
Seat 2: ooak182 (€50 in chips) 
Seat 3: asmodej666 (€93.80 in chips) 
Seat 4: matiko09 (€50 in chips) 
Seat 5: Rybka1294 (€50 in chips) 
Seat 6: fanmtZ (€20 in chips) 
fanmtZ: posts small blind €0.25
hmverlin: posts big blind €0.50
*** HOLE CARDS ***
Dealt to matiko09 [3h 9d]
ooak182: folds 
asmodej666: folds 
matiko09: folds 
Rybka1294: raises €0.50 to €1
fanmtZ: calls €0.75
hmverlin: calls €0.50
*** FLOP *** [2h 7d Jh]
fanmtZ: checks 
hmverlin: checks 
Rybka1294: bets €2
fanmtZ: folds 
hmverlin: folds 
Uncalled bet (€2) returned to Rybka1294
Rybka1294 collected €2.85 from pot
Rybka1294: doesn't show hand 
*** SUMMARY ***
Total pot €3 | Rake €0.15 
Board [2h 7d Jh]
Seat 1: hmverlin (big blind) folded on the Flop
Seat 2: ooak182 folded before Flop (didn't bet)
Seat 3: asmodej666 folded before Flop (didn't bet)
Seat 4: matiko09 folded before Flop (didn't bet)
Seat 5: Rybka1294 (button) collected (€2.85)
Seat 6: fanmtZ (small blind) folded on the Flop





PokerStars Hand #155012788908:  Hold'em No Limit ($0.50/$1.00 USD) - 2016/06/21 13:05:28 CET [2016/06/21 7:05:28 ET]
Table 'Moreau' 9-max Seat #8 is the button
Seat 1: ozone2003 ($119.19 in chips) 
Seat 2: nubpoker ($136.39 in chips) 
Seat 3: matiko09 ($104.12 in chips) 
Seat 4: bonesnz1 ($66.21 in chips) 
Seat 5: DIMAN_324 ($101.38 in chips) 
Seat 6: mbk88 ($100 in chips) 
Seat 7: PanKwn15 ($30.41 in chips) 
Seat 8: maxxmeister ($109.80 in chips) 
Seat 9: Toonersens ($128.41 in chips) 
Toonersens: posts small blind $0.50
ozone2003: posts big blind $1
*** HOLE CARDS ***
Dealt to matiko09 [9c 5s]
nubpoker: folds 
matiko09: folds 
bonesnz1: raises $1 to $2
DIMAN_324: folds 
mbk88: raises $4 to $6
PanKwn15: folds 
maxxmeister: folds 
Toonersens: folds 
ozone2003: folds 
bonesnz1: calls $4
*** FLOP *** [Jd 9s Qd]
bonesnz1: bets $6.41
mbk88: folds 
Uncalled bet ($6.41) returned to bonesnz1
bonesnz1 collected $12.82 from pot
bonesnz1: doesn't show hand 
*** SUMMARY ***
Total pot $13.50 | Rake $0.68 
Board [Jd 9s Qd]
Seat 1: ozone2003 (big blind) folded before Flop
Seat 2: nubpoker folded before Flop (didn't bet)
Seat 3: matiko09 folded before Flop (didn't bet)
Seat 4: bonesnz1 collected ($12.82)
Seat 5: DIMAN_324 folded before Flop (didn't bet)
Seat 6: mbk88 folded on the Flop
Seat 7: PanKwn15 folded before Flop (didn't bet)
Seat 8: maxxmeister (button) folded before Flop (didn't bet)
Seat 9: Toonersens (small blind) folded before Flop





PokerStars Hand #155012793363:  Hold'em No Limit ($0.50/$1.00 USD) - 2016/06/21 13:05:39 CET [2016/06/21 7:05:39 ET]
Table 'Brauna II' 9-max Seat #8 is the button
Seat 1: wisbc ($132.82 in chips) 
Seat 2: pyromid ($153.27 in chips) 
Seat 3: matiko09 ($100 in chips) 
Seat 4: chenconhaste ($199 in chips) 
Seat 5: fukumimi ($100 in chips) 
Seat 6: mbk88 ($203.01 in chips) 
Seat 8: DIMAN_324 ($132.15 in chips) 
Seat 9: torkkdnm ($100 in chips) 
torkkdnm: posts small blind $0.50
wisbc: posts big blind $1
Troll8989: sits out 
*** HOLE CARDS ***
Dealt to matiko09 [8c 6h]
pyromid: raises $1.50 to $2.50
matiko09: folds 
chenconhaste: folds 
fukumimi: calls $2.50
mbk88: folds 
DIMAN_324: folds 
torkkdnm: folds 
wisbc: folds 
*** FLOP *** [Kc 5d 3c]
pyromid: checks 
fukumimi: checks 
*** TURN *** [Kc 5d 3c] [9s]
pyromid: checks 
fukumimi: bets $4
pyromid: folds 
Uncalled bet ($4) returned to fukumimi
fukumimi collected $6.18 from pot
fukumimi: doesn't show hand 
*** SUMMARY ***
Total pot $6.50 | Rake $0.32 
Board [Kc 5d 3c 9s]
Seat 1: wisbc (big blind) folded before Flop
Seat 2: pyromid folded on the Turn
Seat 3: matiko09 folded before Flop (didn't bet)
Seat 4: chenconhaste folded before Flop (didn't bet)
Seat 5: fukumimi collected ($6.18)
Seat 6: mbk88 folded before Flop (didn't bet)
Seat 8: DIMAN_324 (button) folded before Flop (didn't bet)
Seat 9: torkkdnm (small blind) folded before Flop





PokerStars Hand #155012793225:  Hold'em No Limit ($0.50/$1.00 USD) - 2016/06/21 13:05:39 CET [2016/06/21 7:05:39 ET]
Table 'Carlova II' 9-max Seat #6 is the button
Seat 1: matiko09 ($132.55 in chips) 
Seat 2: chenconhaste ($120.23 in chips) 
Seat 3: King_Z�Manel ($105.95 in chips) 
Seat 4: Dandy Monk ($50.64 in chips) 
Seat 5: ozone2003 ($100 in chips) 
Seat 6: DIMAN_324 ($100 in chips) 
Seat 7: mi$$I$Elena ($104.18 in chips) 
Seat 8: pyromid ($89.59 in chips) 
Seat 9: Troll8989 ($107.68 in chips) 
mi$$I$Elena: posts small blind $0.50
pyromid: posts big blind $1
*** HOLE CARDS ***
Dealt to matiko09 [Th Ah]
Troll8989: folds 
matiko09: raises $2 to $3
chenconhaste: folds 
King_Z�Manel: folds 
Dandy Monk: calls $3
ozone2003: folds 
DIMAN_324: folds 
mi$$I$Elena: folds 
pyromid: folds 
*** FLOP *** [Qs Qh 4h]
matiko09: checks 
Dandy Monk: bets $5
matiko09: calls $5
*** TURN *** [Qs Qh 4h] [9s]
matiko09: checks 
Dandy Monk: bets $6
matiko09: calls $6
*** RIVER *** [Qs Qh 4h 9s] [4d]
matiko09: checks 
Dandy Monk: checks 
*** SHOW DOWN ***
matiko09: shows [Th Ah] (two pair, Queens and Fours)
Dandy Monk: shows [6d 6s] (two pair, Queens and Sixes)
Dandy Monk collected $28.02 from pot
*** SUMMARY ***
Total pot $29.50 | Rake $1.48 
Board [Qs Qh 4h 9s 4d]
Seat 1: matiko09 showed [Th Ah] and lost with two pair, Queens and Fours
Seat 2: chenconhaste folded before Flop (didn't bet)
Seat 3: King_Z�Manel folded before Flop (didn't bet)
Seat 4: Dandy Monk showed [6d 6s] and won ($28.02) with two pair, Queens and Sixes
Seat 5: ozone2003 folded before Flop (didn't bet)
Seat 6: DIMAN_324 (button) folded before Flop (didn't bet)
Seat 7: mi$$I$Elena (small blind) folded before Flop
Seat 8: pyromid (big blind) folded before Flop
Seat 9: Troll8989 folded before Flop (didn't bet)





PokerStars Hand #155012793596:  Hold'em No Limit ($0.50/$1.00 USD) - 2016/06/21 13:05:40 CET [2016/06/21 7:05:40 ET]
Table 'Leo' 9-max Seat #7 is the button
Seat 1: letmegonow ($51.57 in chips) 
Seat 2: torkkdnm ($161.64 in chips) 
Seat 3: matiko09 ($106.30 in chips) 
Seat 4: SharingaaN ($99.33 in chips) 
Seat 5: DIMAN_324 ($100 in chips) 
Seat 6: chenconhaste ($117.92 in chips) 
Seat 7: maxxmeister ($100 in chips) 
Seat 8: pyromid ($68.42 in chips) 
Seat 9: Wladimir205 ($103.68 in chips) 
pyromid: posts small blind $0.50
Wladimir205: posts big blind $1
*** HOLE CARDS ***
Dealt to matiko09 [2c 9d]
letmegonow: folds 
torkkdnm: folds 
matiko09: folds 
SharingaaN: folds 
DIMAN_324: raises $2 to $3
chenconhaste: folds 
maxxmeister: folds 
pyromid: folds 
Wladimir205: calls $2
*** FLOP *** [7s 9c Kd]
Wladimir205: checks 
DIMAN_324: bets $4.11
Wladimir205: calls $4.11
*** TURN *** [7s 9c Kd] [8h]
Wladimir205: checks 
DIMAN_324: checks 
*** RIVER *** [7s 9c Kd 8h] [8s]
Wladimir205: checks 
DIMAN_324: bets $6.99
Wladimir205: calls $6.99
*** SHOW DOWN ***
DIMAN_324: shows [Kh Jd] (two pair, Kings and Eights)
Wladimir205: mucks hand 
DIMAN_324 collected $27.26 from pot
*** SUMMARY ***
Total pot $28.70 | Rake $1.44 
Board [7s 9c Kd 8h 8s]
Seat 1: letmegonow folded before Flop (didn't bet)
Seat 2: torkkdnm folded before Flop (didn't bet)
Seat 3: matiko09 folded before Flop (didn't bet)
Seat 4: SharingaaN folded before Flop (didn't bet)
Seat 5: DIMAN_324 showed [Kh Jd] and won ($27.26) with two pair, Kings and Eights
Seat 6: chenconhaste folded before Flop (didn't bet)
Seat 7: maxxmeister (button) folded before Flop (didn't bet)
Seat 8: pyromid (small blind) folded before Flop
Seat 9: Wladimir205 (big blind) mucked [Jc As]





PokerStars Hand #155012795240:  Hold'em No Limit ($0.50/$1.00 USD) - 2016/06/21 13:05:43 CET [2016/06/21 7:05:43 ET]
Table 'Lamberta II' 9-max Seat #2 is the button
Seat 1: Avtovo ($106.95 in chips) 
Seat 2: mavin80 ($89 in chips) 
Seat 3: matiko09 ($102.50 in chips) 
Seat 4: Eskimo Fox ($100 in chips) 
Seat 7: MarinoC1979 ($73.67 in chips) 
Seat 9: Sjtu_Michael ($104.90 in chips) 
matiko09: posts small blind $0.50
Eskimo Fox: posts big blind $1
mi$$I$Elena: sits out 
50CandyJoe: sits out 
chenconhaste: sits out 
*** HOLE CARDS ***
Dealt to matiko09 [Kh 7h]
MarinoC1979: folds 
Sjtu_Michael: raises $2 to $3
Avtovo: folds 
mavin80: folds 
matiko09: folds 
Eskimo Fox: calls $2
*** FLOP *** [3d Qc 9s]
Eskimo Fox: checks 
Sjtu_Michael: bets $3.09
Eskimo Fox: folds 
Uncalled bet ($3.09) returned to Sjtu_Michael
Sjtu_Michael collected $6.18 from pot
Sjtu_Michael: doesn't show hand 
*** SUMMARY ***
Total pot $6.50 | Rake $0.32 
Board [3d Qc 9s]
Seat 1: Avtovo folded before Flop (didn't bet)
Seat 2: mavin80 (button) folded before Flop (didn't bet)
Seat 3: matiko09 (small blind) folded before Flop
Seat 4: Eskimo Fox (big blind) folded on the Flop
Seat 7: MarinoC1979 folded before Flop (didn't bet)
Seat 9: Sjtu_Michael collected ($6.18)





PokerStars Hand #155012795535:  Hold'em No Limit ($0.50/$1.00 USD) - 2016/06/21 13:05:44 CET [2016/06/21 7:05:44 ET]
Table 'Feronia' 9-max Seat #4 is the button
Seat 1: DIMAN_324 ($101.50 in chips) 
Seat 2: Yuder_Lin ($103.37 in chips) 
Seat 3: mbk88 ($136.75 in chips) 
Seat 4: pyromid ($119.94 in chips) 
Seat 5: matiko09 ($120.37 in chips) 
Seat 6: chenconhaste ($116.45 in chips) 
Seat 7: arctur17 ($103.95 in chips) 
Seat 8: letmegonow ($147.39 in chips) 
Seat 9: mi$$I$Elena ($120.54 in chips) 
matiko09: posts small blind $0.50
chenconhaste: posts big blind $1
*** HOLE CARDS ***
Dealt to matiko09 [5d 4d]
arctur17: folds 
letmegonow: folds 
mi$$I$Elena: folds 
DIMAN_324: folds 
Yuder_Lin: folds 
mbk88: raises $1 to $2
pyromid: calls $2
matiko09: folds 
chenconhaste: folds 
*** FLOP *** [Kd 2c As]
mbk88: checks 
pyromid: bets $2.50
mbk88: calls $2.50
*** TURN *** [Kd 2c As] [Th]
mbk88: checks 
pyromid: bets $5.50
mbk88: calls $5.50
*** RIVER *** [Kd 2c As Th] [Qh]
mbk88: checks 
pyromid: checks 
*** SHOW DOWN ***
mbk88: shows [9s Ac] (a pair of Aces)
pyromid: shows [Ad Tc] (two pair, Aces and Tens)
pyromid collected $20.42 from pot
*** SUMMARY ***
Total pot $21.50 | Rake $1.08 
Board [Kd 2c As Th Qh]
Seat 1: DIMAN_324 folded before Flop (didn't bet)
Seat 2: Yuder_Lin folded before Flop (didn't bet)
Seat 3: mbk88 showed [9s Ac] and lost with a pair of Aces
Seat 4: pyromid (button) showed [Ad Tc] and won ($20.42) with two pair, Aces and Tens
Seat 5: matiko09 (small blind) folded before Flop
Seat 6: chenconhaste (big blind) folded before Flop
Seat 7: arctur17 folded before Flop (didn't bet)
Seat 8: letmegonow folded before Flop (didn't bet)
Seat 9: mi$$I$Elena folded before Flop (didn't bet)





PokerStars Hand #155012797160:  Hold'em No Limit ($0.50/$1.00 USD) - 2016/06/21 13:05:48 CET [2016/06/21 7:05:48 ET]
Table 'Cheleb' 9-max Seat #3 is the button
Seat 1: SharingaaN ($110.43 in chips) 
Seat 2: pyromid ($138.38 in chips) 
Seat 3: bonesnz1 ($42.39 in chips) 
Seat 4: DIMAN_324 ($183.07 in chips) 
Seat 5: Avtovo ($136.50 in chips) 
Seat 6: matiko09 ($102.52 in chips) 
Seat 7: DomiVY ($40 in chips) 
Seat 8: Troll8989 ($100 in chips) 
Seat 9: chenconhaste ($119.02 in chips) 
DIMAN_324: posts small blind $0.50
Avtovo: posts big blind $1
*** HOLE CARDS ***
Dealt to matiko09 [7c Js]
matiko09: folds 
DomiVY: folds 
Troll8989: raises $1.50 to $2.50
chenconhaste: folds 
SharingaaN: folds 
pyromid: folds 
bonesnz1: folds 
DIMAN_324: folds 
Avtovo: folds 
Uncalled bet ($1.50) returned to Troll8989
Troll8989 collected $2.50 from pot
Troll8989: doesn't show hand 
*** SUMMARY ***
Total pot $2.50 | Rake $0 
Seat 1: SharingaaN folded before Flop (didn't bet)
Seat 2: pyromid folded before Flop (didn't bet)
Seat 3: bonesnz1 (button) folded before Flop (didn't bet)
Seat 4: DIMAN_324 (small blind) folded before Flop
Seat 5: Avtovo (big blind) folded before Flop
Seat 6: matiko09 folded before Flop (didn't bet)
Seat 7: DomiVY folded before Flop (didn't bet)
Seat 8: Troll8989 collected ($2.50)
Seat 9: chenconhaste folded before Flop (didn't bet)





PokerStars Hand #155012802035:  Hold'em No Limit (€0.25/€0.50 EUR) - 2016/06/21 13:06:00 CET [2016/06/21 7:06:00 ET]
Table 'Lotis II' 6-max Seat #2 is the button
Seat 1: acaestanemo (€50 in chips) 
Seat 2: broh202 (€112.96 in chips) 
Seat 3: bricasse1961 (€32.30 in chips) 
Seat 4: matiko09 (€78.27 in chips) 
Seat 5: AlexPles (€52.07 in chips) 
Seat 6: patriot424 (€54.75 in chips) 
bricasse1961: posts small blind €0.25
matiko09: posts big blind €0.50
*** HOLE CARDS ***
Dealt to matiko09 [7d 2c]
AlexPles: folds 
patriot424: raises €1 to €1.50
acaestanemo: calls €1.50
broh202: folds 
bricasse1961: folds 
matiko09: folds 
*** FLOP *** [4s 8c 3d]
patriot424: checks 
acaestanemo: checks 
*** TURN *** [4s 8c 3d] [9c]
patriot424: checks 
acaestanemo: bets €2.50
patriot424: calls €2.50
*** RIVER *** [4s 8c 3d 9c] [2d]
patriot424: checks 
acaestanemo: checks 
*** SHOW DOWN ***
patriot424: shows [Jd 8d] (a pair of Eights)
acaestanemo: mucks hand 
patriot424 collected €8.31 from pot
*** SUMMARY ***
Total pot €8.75 | Rake €0.44 
Board [4s 8c 3d 9c 2d]
Seat 1: acaestanemo mucked [Kh Qs]
Seat 2: broh202 (button) folded before Flop (didn't bet)
Seat 3: bricasse1961 (small blind) folded before Flop
Seat 4: matiko09 (big blind) folded before Flop
Seat 5: AlexPles folded before Flop (didn't bet)
Seat 6: patriot424 showed [Jd 8d] and won (€8.31) with a pair of Eights





PokerStars Hand #155012806739:  Hold'em No Limit ($0.50/$1.00 USD) - 2016/06/21 13:06:11 CET [2016/06/21 7:06:11 ET]
Table 'Cheleb' 9-max Seat #4 is the button
Seat 1: SharingaaN ($110.43 in chips) 
Seat 2: pyromid ($138.38 in chips) 
Seat 3: bonesnz1 ($42.39 in chips) 
Seat 4: DIMAN_324 ($182.57 in chips) 
Seat 5: Avtovo ($135.50 in chips) 
Seat 6: matiko09 ($102.52 in chips) 
Seat 7: DomiVY ($40 in chips) 
Seat 8: Troll8989 ($101.50 in chips) 
Seat 9: chenconhaste ($119.02 in chips) 
Avtovo: posts small blind $0.50
matiko09: posts big blind $1
*** HOLE CARDS ***
Dealt to matiko09 [2c 3h]
DomiVY: folds 
Troll8989: folds 
chenconhaste: folds 
SharingaaN: folds 
pyromid: folds 
bonesnz1: raises $1 to $2
DIMAN_324: folds 
Avtovo: folds 
matiko09: folds 
Uncalled bet ($1) returned to bonesnz1
bonesnz1 collected $2.50 from pot
bonesnz1: doesn't show hand 
*** SUMMARY ***
Total pot $2.50 | Rake $0 
Seat 1: SharingaaN folded before Flop (didn't bet)
Seat 2: pyromid folded before Flop (didn't bet)
Seat 3: bonesnz1 collected ($2.50)
Seat 4: DIMAN_324 (button) folded before Flop (didn't bet)
Seat 5: Avtovo (small blind) folded before Flop
Seat 6: matiko09 (big blind) folded before Flop
Seat 7: DomiVY folded before Flop (didn't bet)
Seat 8: Troll8989 folded before Flop (didn't bet)
Seat 9: chenconhaste folded before Flop (didn't bet)





PokerStars Hand #155012806695:  Hold'em No Limit (€0.25/€0.50 EUR) - 2016/06/21 13:06:11 CET [2016/06/21 7:06:11 ET]
Table 'Actor II' 6-max Seat #6 is the button
Seat 1: hmverlin (€89.05 in chips) 
Seat 2: ooak182 (€50 in chips) 
Seat 3: asmodej666 (€93.80 in chips) 
Seat 4: matiko09 (€50 in chips) 
Seat 5: Rybka1294 (€51.85 in chips) 
Seat 6: fanmtZ (€20 in chips) 
hmverlin: posts small blind €0.25
ooak182: posts big blind €0.50
*** HOLE CARDS ***
Dealt to matiko09 [Ts 4h]
asmodej666: folds 
matiko09: folds 
Rybka1294: raises €0.75 to €1.25
fanmtZ: folds 
hmverlin: calls €1
ooak182: folds 
*** FLOP *** [Kd 8s 8d]
hmverlin: checks 
Rybka1294: checks 
*** TURN *** [Kd 8s 8d] [2h]
hmverlin: bets €1.50
Rybka1294: folds 
Uncalled bet (€1.50) returned to hmverlin
hmverlin collected €2.85 from pot
hmverlin: doesn't show hand 
*** SUMMARY ***
Total pot €3 | Rake €0.15 
Board [Kd 8s 8d 2h]
Seat 1: hmverlin (small blind) collected (€2.85)
Seat 2: ooak182 (big blind) folded before Flop
Seat 3: asmodej666 folded before Flop (didn't bet)
Seat 4: matiko09 folded before Flop (didn't bet)
Seat 5: Rybka1294 folded on the Turn
Seat 6: fanmtZ (button) folded before Flop (didn't bet)





PokerStars Hand #155012812551:  Hold'em No Limit ($0.50/$1.00 USD) - 2016/06/21 13:06:25 CET [2016/06/21 7:06:25 ET]
Table 'Moreau' 9-max Seat #9 is the button
Seat 1: ozone2003 ($118.19 in chips) 
Seat 2: nubpoker ($136.39 in chips) 
Seat 3: matiko09 ($104.12 in chips) 
Seat 4: bonesnz1 ($73.03 in chips) 
Seat 5: DIMAN_324 ($101.38 in chips) 
Seat 6: mbk88 ($100 in chips) 
Seat 7: PanKwn15 ($30.41 in chips) 
Seat 8: maxxmeister ($109.80 in chips) 
Seat 9: Toonersens ($127.91 in chips) 
ozone2003: posts small blind $0.50
nubpoker: posts big blind $1
*** HOLE CARDS ***
Dealt to matiko09 [4c 5h]
matiko09: folds 
bonesnz1: calls $1
DIMAN_324: folds 
mbk88: folds 
PanKwn15: folds 
maxxmeister: folds 
Toonersens: raises $2 to $3
ozone2003: folds 
nubpoker: folds 
bonesnz1: calls $2
*** FLOP *** [6c Kh 3h]
bonesnz1: checks 
Toonersens: bets $4
bonesnz1: folds 
Uncalled bet ($4) returned to Toonersens
Toonersens collected $7.12 from pot
*** SUMMARY ***
Total pot $7.50 | Rake $0.38 
Board [6c Kh 3h]
Seat 1: ozone2003 (small blind) folded before Flop
Seat 2: nubpoker (big blind) folded before Flop
Seat 3: matiko09 folded before Flop (didn't bet)
Seat 4: bonesnz1 folded on the Flop
Seat 5: DIMAN_324 folded before Flop (didn't bet)
Seat 6: mbk88 folded before Flop (didn't bet)
Seat 7: PanKwn15 folded before Flop (didn't bet)
Seat 8: maxxmeister folded before Flop (didn't bet)
Seat 9: Toonersens (button) collected ($7.12)





PokerStars Hand #155012813460:  Hold'em No Limit ($0.50/$1.00 USD) - 2016/06/21 13:06:27 CET [2016/06/21 7:06:27 ET]
Table 'Lamberta II' 9-max Seat #3 is the button
Seat 1: Avtovo ($106.95 in chips) 
Seat 2: mavin80 ($89 in chips) 
Seat 3: matiko09 ($102 in chips) 
Seat 4: Eskimo Fox ($100 in chips) 
Seat 5: mi$$I$Elena ($100 in chips) 
Seat 7: MarinoC1979 ($73.67 in chips) 
Seat 9: Sjtu_Michael ($108.08 in chips) 
Eskimo Fox: posts small blind $0.50
mi$$I$Elena: posts big blind $1
50CandyJoe: sits out 
chenconhaste: sits out 
*** HOLE CARDS ***
Dealt to matiko09 [4h 9s]
MarinoC1979: calls $1
Sjtu_Michael: folds 
Avtovo: raises $3.50 to $4.50
mavin80: calls $4.50
matiko09: folds 
Eskimo Fox: folds 
mi$$I$Elena: folds 
MarinoC1979: folds 
*** FLOP *** [5d 7h 6c]
Avtovo: checks 
mavin80: checks 
*** TURN *** [5d 7h 6c] [Ad]
Avtovo: checks 
mavin80: bets $3
Avtovo: folds 
Uncalled bet ($3) returned to mavin80
mavin80 collected $10.92 from pot
mavin80: doesn't show hand 
*** SUMMARY ***
Total pot $11.50 | Rake $0.58 
Board [5d 7h 6c Ad]
Seat 1: Avtovo folded on the Turn
Seat 2: mavin80 collected ($10.92)
Seat 3: matiko09 (button) folded before Flop (didn't bet)
Seat 4: Eskimo Fox (small blind) folded before Flop
Seat 5: mi$$I$Elena (big blind) folded before Flop
Seat 7: MarinoC1979 folded before Flop
Seat 9: Sjtu_Michael folded before Flop (didn't bet)





PokerStars Hand #155012816556:  Hold'em No Limit ($0.50/$1.00 USD) - 2016/06/21 13:06:34 CET [2016/06/21 7:06:34 ET]
Table 'Brauna II' 9-max Seat #9 is the button
Seat 1: wisbc ($131.82 in chips) 
Seat 2: pyromid ($150.77 in chips) 
Seat 3: matiko09 ($100 in chips) 
Seat 4: chenconhaste ($199 in chips) 
Seat 5: fukumimi ($103.68 in chips) 
Seat 6: mbk88 ($203.01 in chips) 
Seat 8: DIMAN_324 ($132.15 in chips) 
Seat 9: torkkdnm ($100 in chips) 
wisbc: posts small blind $0.50
pyromid: posts big blind $1
Troll8989: sits out 
*** HOLE CARDS ***
Dealt to matiko09 [3c 6s]
matiko09: folds 
chenconhaste: raises $1.25 to $2.25
fukumimi: calls $2.25
mbk88: folds 
DIMAN_324: folds 
torkkdnm: calls $2.25
wisbc: calls $1.75
pyromid: calls $1.25
*** FLOP *** [Qh 7c 6h]
wisbc: checks 
pyromid: checks 
chenconhaste: checks 
fukumimi: bets $7
torkkdnm: folds 
wisbc: raises $13 to $20
pyromid: folds 
chenconhaste: folds 
fukumimi: folds 
Uncalled bet ($13) returned to wisbc
wisbc collected $23.99 from pot
*** SUMMARY ***
Total pot $25.25 | Rake $1.26 
Board [Qh 7c 6h]
Seat 1: wisbc (small blind) collected ($23.99)
Seat 2: pyromid (big blind) folded on the Flop
Seat 3: matiko09 folded before Flop (didn't bet)
Seat 4: chenconhaste folded on the Flop
Seat 5: fukumimi folded on the Flop
Seat 6: mbk88 folded before Flop (didn't bet)
Seat 8: DIMAN_324 folded before Flop (didn't bet)
Seat 9: torkkdnm (button) folded on the Flop





PokerStars Hand #155012816730:  Hold'em No Limit ($0.50/$1.00 USD) - 2016/06/21 13:06:35 CET [2016/06/21 7:06:35 ET]
Table 'Rupertwildt' 9-max Seat #9 is the button
Seat 1: pokernixxx ($54.95 in chips) 
Seat 2: SharingaaN ($80 in chips) 
Seat 3: Saymon_Moo ($82.08 in chips) 
Seat 4: matiko09 ($150.68 in chips) 
Seat 5: pyromid ($85.46 in chips) 
Seat 6: ozone2003 ($129.34 in chips) 
Seat 7: chenconhaste ($102.34 in chips) 
Seat 8: Gonzanary ($112.14 in chips) 
Seat 9: mbk88 ($118.43 in chips) 
pokernixxx: posts small blind $0.50
SharingaaN: posts big blind $1
*** HOLE CARDS ***
Dealt to matiko09 [3d Ts]
Saymon_Moo: calls $1
matiko09: folds 
pyromid: calls $1
ozone2003: folds 
chenconhaste: folds 
Gonzanary: folds 
mbk88: folds 
pokernixxx: calls $0.50
SharingaaN: checks 
*** FLOP *** [Qs 5d 3c]
pokernixxx: checks 
SharingaaN: checks 
Saymon_Moo: checks 
pyromid: checks 
*** TURN *** [Qs 5d 3c] [7h]
pokernixxx: bets $3
SharingaaN: folds 
Saymon_Moo: folds 
pyromid: folds 
Uncalled bet ($3) returned to pokernixxx
pokernixxx collected $3.80 from pot
pokernixxx: doesn't show hand 
*** SUMMARY ***
Total pot $4 | Rake $0.20 
Board [Qs 5d 3c 7h]
Seat 1: pokernixxx (small blind) collected ($3.80)
Seat 2: SharingaaN (big blind) folded on the Turn
Seat 3: Saymon_Moo folded on the Turn
Seat 4: matiko09 folded before Flop (didn't bet)
Seat 5: pyromid folded on the Turn
Seat 6: ozone2003 folded before Flop (didn't bet)
Seat 7: chenconhaste folded before Flop (didn't bet)
Seat 8: Gonzanary folded before Flop (didn't bet)
Seat 9: mbk88 (button) folded before Flop (didn't bet)





PokerStars Hand #155012817237:  Hold'em No Limit ($0.50/$1.00 USD) - 2016/06/21 13:06:36 CET [2016/06/21 7:06:36 ET]
Table 'Carlova II' 9-max Seat #7 is the button
Seat 1: matiko09 ($118.55 in chips) 
Seat 2: chenconhaste ($120.23 in chips) 
Seat 3: King_Z�Manel ($105.95 in chips) 
Seat 4: Dandy Monk ($64.66 in chips) 
Seat 5: ozone2003 ($100 in chips) 
Seat 6: DIMAN_324 ($100 in chips) 
Seat 7: mi$$I$Elena ($103.68 in chips) 
Seat 8: pyromid ($88.59 in chips) 
Seat 9: Troll8989 ($107.68 in chips) 
pyromid: posts small blind $0.50
Troll8989: posts big blind $1
*** HOLE CARDS ***
Dealt to matiko09 [Th 2h]
matiko09: folds 
chenconhaste: folds 
King_Z�Manel: folds 
Dandy Monk: folds 
ozone2003: folds 
DIMAN_324: raises $1.50 to $2.50
mi$$I$Elena: folds 
pyromid: folds 
Troll8989: calls $1.50
*** FLOP *** [4c Jh Ah]
Troll8989: checks 
DIMAN_324: bets $3.47
Troll8989: folds 
Uncalled bet ($3.47) returned to DIMAN_324
DIMAN_324 collected $5.22 from pot
DIMAN_324: doesn't show hand 
*** SUMMARY ***
Total pot $5.50 | Rake $0.28 
Board [4c Jh Ah]
Seat 1: matiko09 folded before Flop (didn't bet)
Seat 2: chenconhaste folded before Flop (didn't bet)
Seat 3: King_Z�Manel folded before Flop (didn't bet)
Seat 4: Dandy Monk folded before Flop (didn't bet)
Seat 5: ozone2003 folded before Flop (didn't bet)
Seat 6: DIMAN_324 collected ($5.22)
Seat 7: mi$$I$Elena (button) folded before Flop (didn't bet)
Seat 8: pyromid (small blind) folded before Flop
Seat 9: Troll8989 (big blind) folded on the Flop





PokerStars Hand #155012818087:  Hold'em No Limit ($0.50/$1.00 USD) - 2016/06/21 13:06:38 CET [2016/06/21 7:06:38 ET]
Table 'Umbriel II' 9-max Seat #9 is the button
Seat 1: phil_cheng ($100 in chips) 
Seat 2: rura53 ($63 in chips) 
Seat 3: mxustin ($37.75 in chips) 
Seat 5: matiko09 ($145.46 in chips) 
Seat 6: maxxmeister ($100 in chips) 
Seat 7: chenconhaste ($172.10 in chips) 
Seat 8: ozone2003 ($126.84 in chips) 
Seat 9: Troll8989 ($101.50 in chips) 
phil_cheng: posts small blind $0.50
rura53: posts big blind $1
Eskimo Fox: sits out 
*** HOLE CARDS ***
Dealt to matiko09 [Qs 2d]
mxustin: folds 
matiko09: folds 
maxxmeister: folds 
chenconhaste: folds 
ozone2003: raises $1.50 to $2.50
Troll8989: folds 
phil_cheng: folds 
rura53: folds 
Uncalled bet ($1.50) returned to ozone2003
ozone2003 collected $2.50 from pot
ozone2003: doesn't show hand 
*** SUMMARY ***
Total pot $2.50 | Rake $0 
Seat 1: phil_cheng (small blind) folded before Flop
Seat 2: rura53 (big blind) folded before Flop
Seat 3: mxustin folded before Flop (didn't bet)
Seat 5: matiko09 folded before Flop (didn't bet)
Seat 6: maxxmeister folded before Flop (didn't bet)
Seat 7: chenconhaste folded before Flop (didn't bet)
Seat 8: ozone2003 collected ($2.50)
Seat 9: Troll8989 (button) folded before Flop (didn't bet)





PokerStars Hand #155012818308:  Hold'em No Limit ($0.50/$1.00 USD) - 2016/06/21 13:06:39 CET [2016/06/21 7:06:39 ET]
Table 'Feronia' 9-max Seat #5 is the button
Seat 1: DIMAN_324 ($101.50 in chips) 
Seat 2: Yuder_Lin ($103.37 in chips) 
Seat 3: mbk88 ($126.75 in chips) 
Seat 4: pyromid ($130.36 in chips) 
Seat 5: matiko09 ($119.87 in chips) 
Seat 6: chenconhaste ($115.45 in chips) 
Seat 7: arctur17 ($103.95 in chips) 
Seat 8: letmegonow ($147.39 in chips) 
Seat 9: mi$$I$Elena ($120.54 in chips) 
chenconhaste: posts small blind $0.50
arctur17: posts big blind $1
*** HOLE CARDS ***
Dealt to matiko09 [5h Ac]
letmegonow: folds 
mi$$I$Elena: folds 
DIMAN_324: folds 
Yuder_Lin: folds 
mbk88: folds 
pyromid: folds 
matiko09: raises $1.27 to $2.27
chenconhaste: folds 
arctur17: folds 
Uncalled bet ($1.27) returned to matiko09
matiko09 collected $2.50 from pot
matiko09: doesn't show hand 
*** SUMMARY ***
Total pot $2.50 | Rake $0 
Seat 1: DIMAN_324 folded before Flop (didn't bet)
Seat 2: Yuder_Lin folded before Flop (didn't bet)
Seat 3: mbk88 folded before Flop (didn't bet)
Seat 4: pyromid folded before Flop (didn't bet)
Seat 5: matiko09 (button) collected ($2.50)
Seat 6: chenconhaste (small blind) folded before Flop
Seat 7: arctur17 (big blind) folded before Flop
Seat 8: letmegonow folded before Flop (didn't bet)
Seat 9: mi$$I$Elena folded before Flop (didn't bet)





PokerStars Hand #155012824928:  Hold'em No Limit ($0.50/$1.00 USD) - 2016/06/21 13:06:55 CET [2016/06/21 7:06:55 ET]
Table 'Cheleb' 9-max Seat #5 is the button
Seat 1: SharingaaN ($110.43 in chips) 
Seat 2: pyromid ($138.38 in chips) 
Seat 3: bonesnz1 ($43.89 in chips) 
Seat 4: DIMAN_324 ($182.57 in chips) 
Seat 5: Avtovo ($135 in chips) 
Seat 6: matiko09 ($101.52 in chips) 
Seat 7: DomiVY ($40 in chips) 
Seat 8: Troll8989 ($101.50 in chips) 
Seat 9: chenconhaste ($119.02 in chips) 
matiko09: posts small blind $0.50
DomiVY: posts big blind $1
*** HOLE CARDS ***
Dealt to matiko09 [7s 7c]
Troll8989: folds 
chenconhaste: folds 
SharingaaN: folds 
pyromid: folds 
bonesnz1: folds 
DIMAN_324: folds 
Avtovo: raises $1.50 to $2.50
matiko09: raises $6.50 to $9
DomiVY: folds 
Avtovo: raises $15.50 to $24.50
matiko09: folds 
Uncalled bet ($15.50) returned to Avtovo
Avtovo collected $19 from pot
Avtovo: doesn't show hand 
*** SUMMARY ***
Total pot $19 | Rake $0 
Seat 1: SharingaaN folded before Flop (didn't bet)
Seat 2: pyromid folded before Flop (didn't bet)
Seat 3: bonesnz1 folded before Flop (didn't bet)
Seat 4: DIMAN_324 folded before Flop (didn't bet)
Seat 5: Avtovo (button) collected ($19)
Seat 6: matiko09 (small blind) folded before Flop
Seat 7: DomiVY (big blind) folded before Flop
Seat 8: Troll8989 folded before Flop (didn't bet)
Seat 9: chenconhaste folded before Flop (didn't bet)





PokerStars Hand #155012828566:  Hold'em No Limit ($0.50/$1.00 USD) - 2016/06/21 13:07:03 CET [2016/06/21 7:07:03 ET]
Table 'Saldanha' 9-max Seat #9 is the button
Seat 1: IceSharK.AA ($68.07 in chips) 
Seat 2: matiko09 ($100 in chips) 
Seat 3: Avtovo ($100 in chips) 
Seat 4: 50CandyJoe ($100 in chips) 
Seat 8: pattexpro ($76.97 in chips) 
Seat 9: maxxmeister ($133.79 in chips) 
IceSharK.AA: posts small blind $0.50
matiko09: posts big blind $1
Eskimo Fox: sits out 
SharingaaN: sits out 
chenconhaste: sits out 
IceSharK.AA: posts the ante $0.20
matiko09: posts the ante $0.20
Avtovo: posts the ante $0.20
50CandyJoe: posts the ante $0.20
pattexpro: posts the ante $0.20
maxxmeister: posts the ante $0.20
*** HOLE CARDS ***
Dealt to matiko09 [4c 5d]
Avtovo: folds 
50CandyJoe: folds 
pattexpro: raises $2 to $3
maxxmeister: folds 
IceSharK.AA: folds 
matiko09: folds 
Uncalled bet ($2) returned to pattexpro
pattexpro collected $3.70 from pot
*** SUMMARY ***
Total pot $3.70 | Rake $0 
Seat 1: IceSharK.AA (small blind) folded before Flop
Seat 2: matiko09 (big blind) folded before Flop
Seat 3: Avtovo folded before Flop (didn't bet)
Seat 4: 50CandyJoe folded before Flop (didn't bet)
Seat 8: pattexpro collected ($3.70)
Seat 9: maxxmeister (button) folded before Flop (didn't bet)





PokerStars Hand #155012828669:  Hold'em No Limit (€0.25/€0.50 EUR) - 2016/06/21 13:07:03 CET [2016/06/21 7:07:03 ET]
Table 'Actor II' 6-max Seat #1 is the button
Seat 1: hmverlin (€90.65 in chips) 
Seat 2: ooak182 (€50 in chips) 
Seat 3: asmodej666 (€93.80 in chips) 
Seat 4: matiko09 (€50 in chips) 
Seat 5: Rybka1294 (€50.60 in chips) 
Seat 6: fanmtZ (€20 in chips) 
ooak182: posts small blind €0.25
asmodej666: posts big blind €0.50
*** HOLE CARDS ***
Dealt to matiko09 [8h Jh]
matiko09: folds 
Rybka1294: raises €1 to €1.50
fanmtZ: raises €2.50 to €4
hmverlin: folds 
ooak182: folds 
asmodej666: folds 
Rybka1294: raises €4 to €8
fanmtZ: raises €12 to €20 and is all-in
Rybka1294: calls €12
*** FIRST FLOP *** [Ac 4h 3s]
*** FIRST TURN *** [Ac 4h 3s] [2d]
*** FIRST RIVER *** [Ac 4h 3s 2d] [6s]
*** SECOND FLOP *** [Th Js 8c]
*** SECOND TURN *** [Th Js 8c] [Tc]
*** SECOND RIVER *** [Th Js 8c Tc] [3d]
*** FIRST SHOW DOWN ***
Rybka1294: shows [Kd Ks] (a pair of Kings)
fanmtZ: shows [Kh Ah] (a pair of Aces)
fanmtZ collected €19.48 from pot
*** SECOND SHOW DOWN ***
Rybka1294: shows [Kd Ks] (two pair, Kings and Tens)
fanmtZ: shows [Kh Ah] (a pair of Tens)
Rybka1294 collected €19.47 from pot
*** SUMMARY ***
Total pot €40.75 | Rake €1.80 
Hand was run twice
FIRST Board [Ac 4h 3s 2d 6s]
SECOND Board [Th Js 8c Tc 3d]
Seat 1: hmverlin (button) folded before Flop (didn't bet)
Seat 2: ooak182 (small blind) folded before Flop
Seat 3: asmodej666 (big blind) folded before Flop
Seat 4: matiko09 folded before Flop (didn't bet)
Seat 5: Rybka1294 showed [Kd Ks] and lost with a pair of Kings, and won (€19.47) with two pair, Kings and Tens
Seat 6: fanmtZ showed [Kh Ah] and won (€19.48) with a pair of Aces, and lost with a pair of Tens





PokerStars Hand #155012830154:  Hold'em No Limit (€0.25/€0.50 EUR) - 2016/06/21 13:07:07 CET [2016/06/21 7:07:07 ET]
Table 'Lotis II' 6-max Seat #3 is the button
Seat 1: acaestanemo (€50 in chips) 
Seat 2: broh202 (€112.96 in chips) 
Seat 3: bricasse1961 (€32.05 in chips) 
Seat 4: matiko09 (€77.77 in chips) 
Seat 5: AlexPles (€52.07 in chips) 
Seat 6: patriot424 (€59.06 in chips) 
matiko09: posts small blind €0.25
AlexPles: posts big blind €0.50
*** HOLE CARDS ***
Dealt to matiko09 [3s 2d]
patriot424: folds 
acaestanemo: folds 
broh202: folds 
bricasse1961: folds 
matiko09: folds 
Uncalled bet (€0.25) returned to AlexPles
AlexPles collected €0.50 from pot
AlexPles: doesn't show hand 
*** SUMMARY ***
Total pot €0.50 | Rake €0 
Seat 1: acaestanemo folded before Flop (didn't bet)
Seat 2: broh202 folded before Flop (didn't bet)
Seat 3: bricasse1961 (button) folded before Flop (didn't bet)
Seat 4: matiko09 (small blind) folded before Flop
Seat 5: AlexPles (big blind) collected (€0.50)
Seat 6: patriot424 folded before Flop (didn't bet)





PokerStars Hand #155012831195:  Hold'em No Limit ($0.50/$1.00 USD) - 2016/06/21 13:07:10 CET [2016/06/21 7:07:10 ET]
Table 'Leo' 9-max Seat #8 is the button
Seat 1: letmegonow ($51.57 in chips) 
Seat 2: torkkdnm ($161.64 in chips) 
Seat 3: matiko09 ($106.30 in chips) 
Seat 4: SharingaaN ($99.33 in chips) 
Seat 5: DIMAN_324 ($113.16 in chips) 
Seat 6: chenconhaste ($117.92 in chips) 
Seat 7: maxxmeister ($100 in chips) 
Seat 8: pyromid ($67.92 in chips) 
Seat 9: Wladimir205 ($89.58 in chips) 
Wladimir205: posts small blind $0.50
letmegonow: posts big blind $1
*** HOLE CARDS ***
Dealt to matiko09 [8c 6d]
torkkdnm: raises $2 to $3
matiko09: folds 
SharingaaN: calls $3
DIMAN_324: folds 
chenconhaste: folds 
maxxmeister: folds 
pyromid: folds 
Wladimir205: folds 
letmegonow: folds 
*** FLOP *** [Jh Jc 7c]
torkkdnm: checks 
SharingaaN: bets $5.69
torkkdnm: folds 
Uncalled bet ($5.69) returned to SharingaaN
SharingaaN collected $7.12 from pot
SharingaaN: doesn't show hand 
*** SUMMARY ***
Total pot $7.50 | Rake $0.38 
Board [Jh Jc 7c]
Seat 1: letmegonow (big blind) folded before Flop
Seat 2: torkkdnm folded on the Flop
Seat 3: matiko09 folded before Flop (didn't bet)
Seat 4: SharingaaN collected ($7.12)
Seat 5: DIMAN_324 folded before Flop (didn't bet)
Seat 6: chenconhaste folded before Flop (didn't bet)
Seat 7: maxxmeister folded before Flop (didn't bet)
Seat 8: pyromid (button) folded before Flop (didn't bet)
Seat 9: Wladimir205 (small blind) folded before Flop





PokerStars Hand #155012832295:  Hold'em No Limit ($0.50/$1.00 USD) - 2016/06/21 13:07:12 CET [2016/06/21 7:07:12 ET]
Table 'Umbriel II' 9-max Seat #1 is the button
Seat 1: phil_cheng ($100 in chips) 
Seat 2: rura53 ($62 in chips) 
Seat 3: mxustin ($37.75 in chips) 
Seat 5: matiko09 ($145.46 in chips) 
Seat 6: maxxmeister ($100 in chips) 
Seat 7: chenconhaste ($172.10 in chips) 
Seat 8: ozone2003 ($128.34 in chips) 
Seat 9: Troll8989 ($101.50 in chips) 
rura53: posts small blind $0.50
mxustin: posts big blind $1
Eskimo Fox: sits out 
*** HOLE CARDS ***
Dealt to matiko09 [2d 8c]
matiko09: folds 
maxxmeister: folds 
chenconhaste: folds 
ozone2003: folds 
Troll8989: raises $1.50 to $2.50
phil_cheng: raises $6.50 to $9
rura53: folds 
mxustin: folds 
Troll8989: folds 
Uncalled bet ($6.50) returned to phil_cheng
phil_cheng collected $6.50 from pot
phil_cheng: doesn't show hand 
*** SUMMARY ***
Total pot $6.50 | Rake $0 
Seat 1: phil_cheng (button) collected ($6.50)
Seat 2: rura53 (small blind) folded before Flop
Seat 3: mxustin (big blind) folded before Flop
Seat 5: matiko09 folded before Flop (didn't bet)
Seat 6: maxxmeister folded before Flop (didn't bet)
Seat 7: chenconhaste folded before Flop (didn't bet)
Seat 8: ozone2003 folded before Flop (didn't bet)
Seat 9: Troll8989 folded before Flop





PokerStars Hand #155012832555:  Hold'em No Limit ($0.50/$1.00 USD) - 2016/06/21 13:07:13 CET [2016/06/21 7:07:13 ET]
Table 'Moreau' 9-max Seat #1 is the button
Seat 1: ozone2003 ($117.69 in chips) 
Seat 2: nubpoker ($135.39 in chips) 
Seat 3: matiko09 ($104.12 in chips) 
Seat 4: bonesnz1 ($70.03 in chips) 
Seat 5: DIMAN_324 ($101.38 in chips) 
Seat 6: mbk88 ($100 in chips) 
Seat 7: PanKwn15 ($30.41 in chips) 
Seat 8: maxxmeister ($109.80 in chips) 
Seat 9: Toonersens ($132.03 in chips) 
nubpoker: posts small blind $0.50
matiko09: posts big blind $1
*** HOLE CARDS ***
Dealt to matiko09 [7s Kd]
bonesnz1: calls $1
DIMAN_324: folds 
mbk88: calls $1
PanKwn15: raises $3.50 to $4.50
maxxmeister: folds 
Toonersens: calls $4.50
ozone2003: folds 
nubpoker: folds 
matiko09: folds 
bonesnz1: calls $3.50
mbk88: calls $3.50
*** FLOP *** [9h As 2h]
bonesnz1: bets $1
mbk88: folds 
PanKwn15: calls $1
Toonersens: calls $1
*** TURN *** [9h As 2h] [3d]
bonesnz1: bets $1
PanKwn15: calls $1
Toonersens: calls $1
*** RIVER *** [9h As 2h 3d] [Tc]
bonesnz1: bets $12.11
PanKwn15: calls $12.11
Toonersens: calls $12.11
*** SHOW DOWN ***
bonesnz1: shows [6s 5s] (high card Ace)
PanKwn15: shows [Js Jh] (a pair of Jacks)
Toonersens: mucks hand 
PanKwn15 collected $59.33 from pot
*** SUMMARY ***
Total pot $61.83 | Rake $2.50 
Board [9h As 2h 3d Tc]
Seat 1: ozone2003 (button) folded before Flop (didn't bet)
Seat 2: nubpoker (small blind) folded before Flop
Seat 3: matiko09 (big blind) folded before Flop
Seat 4: bonesnz1 showed [6s 5s] and lost with high card Ace
Seat 5: DIMAN_324 folded before Flop (didn't bet)
Seat 6: mbk88 folded on the Flop
Seat 7: PanKwn15 showed [Js Jh] and won ($59.33) with a pair of Jacks
Seat 8: maxxmeister folded before Flop (didn't bet)
Seat 9: Toonersens mucked [Td Jd]





PokerStars Hand #155012835344:  Hold'em No Limit ($0.50/$1.00 USD) - 2016/06/21 13:07:20 CET [2016/06/21 7:07:20 ET]
Table 'Lamberta II' 9-max Seat #4 is the button
Seat 1: Avtovo ($102.45 in chips) 
Seat 2: mavin80 ($95.42 in chips) 
Seat 3: matiko09 ($102 in chips) 
Seat 4: Eskimo Fox ($100 in chips) 
Seat 5: mi$$I$Elena ($100 in chips) 
Seat 6: 50CandyJoe ($100 in chips) 
Seat 7: MarinoC1979 ($72.67 in chips) 
Seat 9: Sjtu_Michael ($108.08 in chips) 
mi$$I$Elena: posts small blind $0.50
50CandyJoe: posts big blind $1
chenconhaste: sits out 
*** HOLE CARDS ***
Dealt to matiko09 [Qd 8s]
MarinoC1979: folds 
Sjtu_Michael: folds 
Avtovo: folds 
mavin80: raises $1.50 to $2.50
matiko09: folds 
Eskimo Fox: folds 
mi$$I$Elena: folds 
50CandyJoe: folds 
Uncalled bet ($1.50) returned to mavin80
mavin80 collected $2.50 from pot
mavin80: doesn't show hand 
*** SUMMARY ***
Total pot $2.50 | Rake $0 
Seat 1: Avtovo folded before Flop (didn't bet)
Seat 2: mavin80 collected ($2.50)
Seat 3: matiko09 folded before Flop (didn't bet)
Seat 4: Eskimo Fox (button) folded before Flop (didn't bet)
Seat 5: mi$$I$Elena (small blind) folded before Flop
Seat 6: 50CandyJoe (big blind) folded before Flop
Seat 7: MarinoC1979 folded before Flop (didn't bet)
Seat 9: Sjtu_Michael folded before Flop (didn't bet)





PokerStars Hand #155012835804:  Hold'em No Limit ($0.50/$1.00 USD) - 2016/06/21 13:07:21 CET [2016/06/21 7:07:21 ET]
Table 'Carlova II' 9-max Seat #8 is the button
Seat 1: matiko09 ($118.55 in chips) 
Seat 2: chenconhaste ($120.23 in chips) 
Seat 3: King_Z�Manel ($105.95 in chips) 
Seat 4: Dandy Monk ($64.66 in chips) 
Seat 5: ozone2003 ($100 in chips) 
Seat 6: DIMAN_324 ($102.72 in chips) 
Seat 7: mi$$I$Elena ($103.68 in chips) 
Seat 8: pyromid ($88.09 in chips) 
Seat 9: Troll8989 ($105.18 in chips) 
Troll8989: posts small blind $0.50
matiko09: posts big blind $1
*** HOLE CARDS ***
Dealt to matiko09 [5h 5s]
chenconhaste: raises $1.25 to $2.25
King_Z�Manel: folds 
Dandy Monk: folds 
ozone2003: folds 
DIMAN_324: folds 
mi$$I$Elena: folds 
pyromid: folds 
Troll8989: folds 
matiko09: calls $1.25
*** FLOP *** [9h Qs 6c]
matiko09: checks 
chenconhaste: bets $3
matiko09: folds 
Uncalled bet ($3) returned to chenconhaste
chenconhaste collected $4.75 from pot
*** SUMMARY ***
Total pot $5 | Rake $0.25 
Board [9h Qs 6c]
Seat 1: matiko09 (big blind) folded on the Flop
Seat 2: chenconhaste collected ($4.75)
Seat 3: King_Z�Manel folded before Flop (didn't bet)
Seat 4: Dandy Monk folded before Flop (didn't bet)
Seat 5: ozone2003 folded before Flop (didn't bet)
Seat 6: DIMAN_324 folded before Flop (didn't bet)
Seat 7: mi$$I$Elena folded before Flop (didn't bet)
Seat 8: pyromid (button) folded before Flop (didn't bet)
Seat 9: Troll8989 (small blind) folded before Flop





PokerStars Hand #155012836431:  Hold'em No Limit (€0.25/€0.50 EUR) - 2016/06/21 13:07:22 CET [2016/06/21 7:07:22 ET]
Table 'Lotis II' 6-max Seat #4 is the button
Seat 1: acaestanemo (€50 in chips) 
Seat 2: broh202 (€112.96 in chips) 
Seat 3: bricasse1961 (€32.05 in chips) 
Seat 4: matiko09 (€77.52 in chips) 
Seat 5: AlexPles (€52.32 in chips) 
AlexPles: posts small blind €0.25
patriot424: is sitting out 
acaestanemo: posts big blind €0.50
*** HOLE CARDS ***
Dealt to matiko09 [Ac 8h]
broh202: folds 
bricasse1961: folds 
matiko09: raises €0.63 to €1.13
AlexPles: folds 
acaestanemo: calls €0.63
*** FLOP *** [Ks 4d 5c]
acaestanemo: checks 
matiko09: checks 
*** TURN *** [Ks 4d 5c] [Kc]
acaestanemo: bets €1.50
matiko09: folds 
Uncalled bet (€1.50) returned to acaestanemo
acaestanemo collected €2.38 from pot
*** SUMMARY ***
Total pot €2.51 | Rake €0.13 
Board [Ks 4d 5c Kc]
Seat 1: acaestanemo (big blind) collected (€2.38)
Seat 2: broh202 folded before Flop (didn't bet)
Seat 3: bricasse1961 folded before Flop (didn't bet)
Seat 4: matiko09 (button) folded on the Turn
Seat 5: AlexPles (small blind) folded before Flop





PokerStars Hand #155012839022:  Hold'em No Limit ($0.50/$1.00 USD) - 2016/06/21 13:07:29 CET [2016/06/21 7:07:29 ET]
Table 'Saldanha' 9-max Seat #1 is the button
Seat 1: IceSharK.AA ($67.37 in chips) 
Seat 2: matiko09 ($100 in chips) 
Seat 3: Avtovo ($100 in chips) 
Seat 4: 50CandyJoe ($100 in chips) 
Seat 8: pattexpro ($79.47 in chips) 
Seat 9: maxxmeister ($133.59 in chips) 
matiko09: posts small blind $0.50
Avtovo: posts big blind $1
Eskimo Fox: sits out 
SharingaaN: sits out 
chenconhaste: sits out 
IceSharK.AA: posts the ante $0.20
matiko09: posts the ante $0.20
Avtovo: posts the ante $0.20
50CandyJoe: posts the ante $0.20
pattexpro: posts the ante $0.20
maxxmeister: posts the ante $0.20
*** HOLE CARDS ***
Dealt to matiko09 [8s Jc]
50CandyJoe: folds 
pattexpro: folds 
maxxmeister: folds 
IceSharK.AA: raises $3.70 to $4.70
matiko09: folds 
Avtovo: folds 
Uncalled bet ($3.70) returned to IceSharK.AA
IceSharK.AA collected $3.70 from pot
*** SUMMARY ***
Total pot $3.70 | Rake $0 
Seat 1: IceSharK.AA (button) collected ($3.70)
Seat 2: matiko09 (small blind) folded before Flop
Seat 3: Avtovo (big blind) folded before Flop
Seat 4: 50CandyJoe folded before Flop (didn't bet)
Seat 8: pattexpro folded before Flop (didn't bet)
Seat 9: maxxmeister folded before Flop (didn't bet)





PokerStars Hand #155012841404:  Hold'em No Limit ($0.50/$1.00 USD) - 2016/06/21 13:07:34 CET [2016/06/21 7:07:34 ET]
Table 'Feronia' 9-max Seat #6 is the button
Seat 1: DIMAN_324 ($101.50 in chips) 
Seat 2: Yuder_Lin ($103.37 in chips) 
Seat 3: mbk88 ($126.75 in chips) 
Seat 4: pyromid ($130.36 in chips) 
Seat 5: matiko09 ($121.37 in chips) 
Seat 6: chenconhaste ($114.95 in chips) 
Seat 7: arctur17 ($102.95 in chips) 
Seat 8: letmegonow ($147.39 in chips) 
Seat 9: mi$$I$Elena ($120.54 in chips) 
arctur17: posts small blind $0.50
letmegonow: posts big blind $1
*** HOLE CARDS ***
Dealt to matiko09 [Js 5c]
mi$$I$Elena: raises $2 to $3
DIMAN_324: folds 
Yuder_Lin: calls $3
mbk88: folds 
pyromid: calls $3
matiko09: folds 
chenconhaste: folds 
arctur17: folds 
letmegonow: calls $2
*** FLOP *** [3c 4h Jd]
letmegonow: checks 
mi$$I$Elena: bets $7
Yuder_Lin: calls $7
pyromid: folds 
letmegonow: calls $7
*** TURN *** [3c 4h Jd] [Td]
letmegonow: checks 
mi$$I$Elena: checks 
Yuder_Lin: bets $11
letmegonow: folds 
mi$$I$Elena: calls $11
*** RIVER *** [3c 4h Jd Td] [2h]
mi$$I$Elena: checks 
Yuder_Lin: checks 
*** SHOW DOWN ***
mi$$I$Elena: shows [Ac Ad] (a pair of Aces)
Yuder_Lin: mucks hand 
mi$$I$Elena collected $53 from pot
*** SUMMARY ***
Total pot $55.50 | Rake $2.50 
Board [3c 4h Jd Td 2h]
Seat 1: DIMAN_324 folded before Flop (didn't bet)
Seat 2: Yuder_Lin mucked [Kd Jc]
Seat 3: mbk88 folded before Flop (didn't bet)
Seat 4: pyromid folded on the Flop
Seat 5: matiko09 folded before Flop (didn't bet)
Seat 6: chenconhaste (button) folded before Flop (didn't bet)
Seat 7: arctur17 (small blind) folded before Flop
Seat 8: letmegonow (big blind) folded on the Turn
Seat 9: mi$$I$Elena showed [Ac Ad] and won ($53) with a pair of Aces





PokerStars Hand #155012844056:  Hold'em No Limit ($0.50/$1.00 USD) - 2016/06/21 13:07:40 CET [2016/06/21 7:07:40 ET]
Table 'Cheleb' 9-max Seat #6 is the button
Seat 1: SharingaaN ($110.43 in chips) 
Seat 2: pyromid ($138.38 in chips) 
Seat 3: bonesnz1 ($43.89 in chips) 
Seat 4: DIMAN_324 ($182.57 in chips) 
Seat 5: Avtovo ($145 in chips) 
Seat 6: matiko09 ($100 in chips) 
Seat 7: DomiVY ($40 in chips) 
Seat 8: Troll8989 ($101.50 in chips) 
Seat 9: chenconhaste ($119.02 in chips) 
DomiVY: posts small blind $0.50
Troll8989: posts big blind $1
*** HOLE CARDS ***
Dealt to matiko09 [3c Th]
chenconhaste: folds 
SharingaaN: folds 
pyromid: folds 
bonesnz1: calls $1
DIMAN_324: folds 
Avtovo: raises $3.50 to $4.50
matiko09: folds 
DomiVY: folds 
Troll8989: folds 
bonesnz1: raises $3.50 to $8
Avtovo: calls $3.50
*** FLOP *** [3s 4h Ks]
bonesnz1: checks 
Avtovo: checks 
*** TURN *** [3s 4h Ks] [4s]
bonesnz1: bets $16.62
Avtovo: folds 
Uncalled bet ($16.62) returned to bonesnz1
bonesnz1 collected $16.62 from pot
bonesnz1: doesn't show hand 
*** SUMMARY ***
Total pot $17.50 | Rake $0.88 
Board [3s 4h Ks 4s]
Seat 1: SharingaaN folded before Flop (didn't bet)
Seat 2: pyromid folded before Flop (didn't bet)
Seat 3: bonesnz1 collected ($16.62)
Seat 4: DIMAN_324 folded before Flop (didn't bet)
Seat 5: Avtovo folded on the Turn
Seat 6: matiko09 (button) folded before Flop (didn't bet)
Seat 7: DomiVY (small blind) folded before Flop
Seat 8: Troll8989 (big blind) folded before Flop
Seat 9: chenconhaste folded before Flop (didn't bet)





PokerStars Hand #155012846541:  Hold'em No Limit (€0.25/€0.50 EUR) - 2016/06/21 13:07:46 CET [2016/06/21 7:07:46 ET]
Table 'Lotis II' 6-max Seat #5 is the button
Seat 1: acaestanemo (€51.25 in chips) 
Seat 2: broh202 (€112.96 in chips) 
Seat 3: bricasse1961 (€32.05 in chips) 
Seat 4: matiko09 (€76.39 in chips) 
Seat 5: AlexPles (€52.07 in chips) 
acaestanemo: posts small blind €0.25
broh202: posts big blind €0.50
*** HOLE CARDS ***
Dealt to matiko09 [4c 3s]
bricasse1961: folds 
matiko09: folds 
AlexPles: raises €1 to €1.50
acaestanemo: raises €3 to €4.50
broh202: folds 
AlexPles: calls €3
*** FLOP *** [5d 5h 6h]
acaestanemo: bets €4.50
AlexPles: calls €4.50
*** TURN *** [5d 5h 6h] [Kc]
acaestanemo: bets €12.50
AlexPles: calls €12.50
*** RIVER *** [5d 5h 6h Kc] [Ks]
acaestanemo: checks 
AlexPles: checks 
*** SHOW DOWN ***
acaestanemo: shows [As Qc] (two pair, Kings and Fives)
AlexPles: shows [8c 8d] (two pair, Kings and Eights)
AlexPles collected €41.70 from pot
*** SUMMARY ***
Total pot €43.50 | Rake €1.80 
Board [5d 5h 6h Kc Ks]
Seat 1: acaestanemo (small blind) showed [As Qc] and lost with two pair, Kings and Fives
Seat 2: broh202 (big blind) folded before Flop
Seat 3: bricasse1961 folded before Flop (didn't bet)
Seat 4: matiko09 folded before Flop (didn't bet)
Seat 5: AlexPles (button) showed [8c 8d] and won (€41.70) with two pair, Kings and Eights





PokerStars Hand #155012847743:  Hold'em No Limit ($0.50/$1.00 USD) - 2016/06/21 13:07:49 CET [2016/06/21 7:07:49 ET]
Table 'Rupertwildt' 9-max Seat #1 is the button
Seat 1: pokernixxx ($57.75 in chips) 
Seat 2: SharingaaN ($79 in chips) 
Seat 3: Saymon_Moo ($81.08 in chips) 
Seat 4: matiko09 ($150.68 in chips) 
Seat 5: pyromid ($84.46 in chips) 
Seat 6: ozone2003 ($129.34 in chips) 
Seat 7: chenconhaste ($102.34 in chips) 
Seat 8: Gonzanary ($112.14 in chips) 
Seat 9: mbk88 ($118.43 in chips) 
SharingaaN: posts small blind $0.50
Saymon_Moo: posts big blind $1
*** HOLE CARDS ***
Dealt to matiko09 [7s Th]
matiko09: folds 
pyromid: raises $1.50 to $2.50
ozone2003: calls $2.50
chenconhaste: folds 
Gonzanary: folds 
mbk88: folds 
pokernixxx: folds 
SharingaaN: folds 
Saymon_Moo: folds 
*** FLOP *** [4h 8s 7h]
pyromid: bets $3
ozone2003: raises $8.92 to $11.92
pyromid: folds 
Uncalled bet ($8.92) returned to ozone2003
ozone2003 collected $11.88 from pot
ozone2003: doesn't show hand 
*** SUMMARY ***
Total pot $12.50 | Rake $0.62 
Board [4h 8s 7h]
Seat 1: pokernixxx (button) folded before Flop (didn't bet)
Seat 2: SharingaaN (small blind) folded before Flop
Seat 3: Saymon_Moo (big blind) folded before Flop
Seat 4: matiko09 folded before Flop (didn't bet)
Seat 5: pyromid folded on the Flop
Seat 6: ozone2003 collected ($11.88)
Seat 7: chenconhaste folded before Flop (didn't bet)
Seat 8: Gonzanary folded before Flop (didn't bet)
Seat 9: mbk88 folded before Flop (didn't bet)





PokerStars Hand #155012847684:  Hold'em No Limit ($0.50/$1.00 USD) - 2016/06/21 13:07:49 CET [2016/06/21 7:07:49 ET]
Table 'Saldanha' 9-max Seat #2 is the button
Seat 1: IceSharK.AA ($69.87 in chips) 
Seat 2: matiko09 ($100 in chips) 
Seat 3: Avtovo ($100 in chips) 
Seat 4: 50CandyJoe ($100 in chips) 
Seat 8: pattexpro ($79.27 in chips) 
Seat 9: maxxmeister ($133.39 in chips) 
Avtovo: posts small blind $0.50
50CandyJoe: posts big blind $1
Eskimo Fox: sits out 
SharingaaN: sits out 
chenconhaste: sits out 
IceSharK.AA: posts the ante $0.20
matiko09: posts the ante $0.20
Avtovo: posts the ante $0.20
50CandyJoe: posts the ante $0.20
pattexpro: posts the ante $0.20
maxxmeister: posts the ante $0.20
*** HOLE CARDS ***
Dealt to matiko09 [Tc 8s]
pattexpro: raises $1 to $2
maxxmeister: folds 
IceSharK.AA: folds 
matiko09: folds 
Avtovo: folds 
50CandyJoe: calls $1
*** FLOP *** [Jd 7d Jc]
50CandyJoe: checks 
pattexpro: checks 
*** TURN *** [Jd 7d Jc] [Kc]
50CandyJoe: checks 
pattexpro: checks 
*** RIVER *** [Jd 7d Jc Kc] [4h]
50CandyJoe: checks 
pattexpro: checks 
*** SHOW DOWN ***
50CandyJoe: shows [8c 7s] (two pair, Jacks and Sevens)
pattexpro: mucks hand 
50CandyJoe collected $5.42 from pot
*** SUMMARY ***
Total pot $5.70 | Rake $0.28 
Board [Jd 7d Jc Kc 4h]
Seat 1: IceSharK.AA folded before Flop (didn't bet)
Seat 2: matiko09 (button) folded before Flop (didn't bet)
Seat 3: Avtovo (small blind) folded before Flop
Seat 4: 50CandyJoe (big blind) showed [8c 7s] and won ($5.42) with two pair, Jacks and Sevens
Seat 8: pattexpro mucked [2c 4d]
Seat 9: maxxmeister folded before Flop (didn't bet)





PokerStars Hand #155012850601:  Hold'em No Limit ($0.50/$1.00 USD) - 2016/06/21 13:07:56 CET [2016/06/21 7:07:56 ET]
Table 'Lamberta II' 9-max Seat #5 is the button
Seat 1: Avtovo ($102.45 in chips) 
Seat 2: mavin80 ($96.92 in chips) 
Seat 3: matiko09 ($102 in chips) 
Seat 4: Eskimo Fox ($100 in chips) 
Seat 5: mi$$I$Elena ($100 in chips) 
Seat 6: 50CandyJoe ($100 in chips) 
Seat 7: MarinoC1979 ($72.67 in chips) 
Seat 9: Sjtu_Michael ($108.08 in chips) 
50CandyJoe: posts small blind $0.50
MarinoC1979: posts big blind $1
chenconhaste: sits out 
*** HOLE CARDS ***
Dealt to matiko09 [5s Kh]
Sjtu_Michael: raises $2 to $3
Avtovo: folds 
mavin80: folds 
matiko09: folds 
Eskimo Fox: folds 
mi$$I$Elena: folds 
50CandyJoe: folds 
MarinoC1979: folds 
Uncalled bet ($2) returned to Sjtu_Michael
Sjtu_Michael collected $2.50 from pot
Sjtu_Michael: doesn't show hand 
*** SUMMARY ***
Total pot $2.50 | Rake $0 
Seat 1: Avtovo folded before Flop (didn't bet)
Seat 2: mavin80 folded before Flop (didn't bet)
Seat 3: matiko09 folded before Flop (didn't bet)
Seat 4: Eskimo Fox folded before Flop (didn't bet)
Seat 5: mi$$I$Elena (button) folded before Flop (didn't bet)
Seat 6: 50CandyJoe (small blind) folded before Flop
Seat 7: MarinoC1979 (big blind) folded before Flop
Seat 9: Sjtu_Michael collected ($2.50)





PokerStars Hand #155012850884:  Hold'em No Limit ($0.50/$1.00 USD) - 2016/06/21 13:07:57 CET [2016/06/21 7:07:57 ET]
Table 'Leo' 9-max Seat #9 is the button
Seat 1: letmegonow ($50.57 in chips) 
Seat 2: torkkdnm ($158.64 in chips) 
Seat 3: matiko09 ($106.30 in chips) 
Seat 4: SharingaaN ($103.45 in chips) 
Seat 5: DIMAN_324 ($113.16 in chips) 
Seat 6: chenconhaste ($117.92 in chips) 
Seat 7: maxxmeister ($100 in chips) 
Seat 8: pyromid ($67.92 in chips) 
Seat 9: Wladimir205 ($100 in chips) 
letmegonow: posts small blind $0.50
torkkdnm: posts big blind $1
*** HOLE CARDS ***
Dealt to matiko09 [Qh Jh]
matiko09: raises $2 to $3
SharingaaN: folds 
DIMAN_324: folds 
chenconhaste: folds 
maxxmeister: folds 
pyromid: folds 
Wladimir205: calls $3
letmegonow: folds 
torkkdnm: calls $2
*** FLOP *** [7s 8s 6s]
torkkdnm: bets $6
matiko09: folds 
Wladimir205: folds 
Uncalled bet ($6) returned to torkkdnm
torkkdnm collected $9.02 from pot
*** SUMMARY ***
Total pot $9.50 | Rake $0.48 
Board [7s 8s 6s]
Seat 1: letmegonow (small blind) folded before Flop
Seat 2: torkkdnm (big blind) collected ($9.02)
Seat 3: matiko09 folded on the Flop
Seat 4: SharingaaN folded before Flop (didn't bet)
Seat 5: DIMAN_324 folded before Flop (didn't bet)
Seat 6: chenconhaste folded before Flop (didn't bet)
Seat 7: maxxmeister folded before Flop (didn't bet)
Seat 8: pyromid folded before Flop (didn't bet)
Seat 9: Wladimir205 (button) folded on the Flop





PokerStars Hand #155012853623:  Hold'em No Limit (€0.25/€0.50 EUR) - 2016/06/21 13:08:03 CET [2016/06/21 7:08:03 ET]
Table 'Actor II' 6-max Seat #2 is the button
Seat 1: hmverlin (€90.65 in chips) 
Seat 2: ooak182 (€50 in chips) 
Seat 3: asmodej666 (€93.30 in chips) 
Seat 4: matiko09 (€50 in chips) 
Seat 5: Rybka1294 (€50.07 in chips) 
Seat 6: fanmtZ (€20 in chips) 
asmodej666: posts small blind €0.25
matiko09: posts big blind €0.50
*** HOLE CARDS ***
Dealt to matiko09 [Qs Jc]
Rybka1294: folds 
fanmtZ: folds 
hmverlin: raises €1 to €1.50
ooak182: folds 
asmodej666: folds 
matiko09: calls €1
*** FLOP *** [3s Ad 8s]
matiko09: checks 
hmverlin: bets €1.50
matiko09: folds 
Uncalled bet (€1.50) returned to hmverlin
hmverlin collected €3.09 from pot
hmverlin: doesn't show hand 
*** SUMMARY ***
Total pot €3.25 | Rake €0.16 
Board [3s Ad 8s]
Seat 1: hmverlin collected (€3.09)
Seat 2: ooak182 (button) folded before Flop (didn't bet)
Seat 3: asmodej666 (small blind) folded before Flop
Seat 4: matiko09 (big blind) folded on the Flop
Seat 5: Rybka1294 folded before Flop (didn't bet)
Seat 6: fanmtZ folded before Flop (didn't bet)





PokerStars Hand #155012854962:  Hold'em No Limit ($0.50/$1.00 USD) - 2016/06/21 13:08:07 CET [2016/06/21 7:08:07 ET]
Table 'Umbriel II' 9-max Seat #2 is the button
Seat 1: phil_cheng ($104 in chips) 
Seat 2: rura53 ($61.50 in chips) 
Seat 3: mxustin ($36.75 in chips) 
Seat 4: Eskimo Fox ($100 in chips) 
Seat 5: matiko09 ($145.46 in chips) 
Seat 6: maxxmeister ($100 in chips) 
Seat 7: chenconhaste ($172.10 in chips) 
Seat 8: ozone2003 ($128.34 in chips) 
Seat 9: Troll8989 ($100 in chips) 
mxustin: posts small blind $0.50
Eskimo Fox: posts big blind $1
*** HOLE CARDS ***
Dealt to matiko09 [6h 2s]
matiko09: folds 
maxxmeister: folds 
chenconhaste: folds 
ozone2003: folds 
Troll8989: folds 
phil_cheng: raises $2 to $3
rura53: folds 
mxustin: folds 
Eskimo Fox: folds 
Uncalled bet ($2) returned to phil_cheng
phil_cheng collected $2.50 from pot
phil_cheng: doesn't show hand 
*** SUMMARY ***
Total pot $2.50 | Rake $0 
Seat 1: phil_cheng collected ($2.50)
Seat 2: rura53 (button) folded before Flop (didn't bet)
Seat 3: mxustin (small blind) folded before Flop
Seat 4: Eskimo Fox (big blind) folded before Flop
Seat 5: matiko09 folded before Flop (didn't bet)
Seat 6: maxxmeister folded before Flop (didn't bet)
Seat 7: chenconhaste folded before Flop (didn't bet)
Seat 8: ozone2003 folded before Flop (didn't bet)
Seat 9: Troll8989 folded before Flop (didn't bet)





PokerStars Hand #155012863429:  Hold'em No Limit ($0.50/$1.00 USD) - 2016/06/21 13:08:27 CET [2016/06/21 7:08:27 ET]
Table 'Lamberta II' 9-max Seat #6 is the button
Seat 1: Avtovo ($102.45 in chips) 
Seat 2: mavin80 ($96.92 in chips) 
Seat 3: matiko09 ($102 in chips) 
Seat 4: Eskimo Fox ($100 in chips) 
Seat 5: mi$$I$Elena ($100 in chips) 
Seat 6: 50CandyJoe ($100 in chips) 
Seat 7: MarinoC1979 ($71.67 in chips) 
Seat 8: chenconhaste ($100 in chips) 
Seat 9: Sjtu_Michael ($109.58 in chips) 
MarinoC1979: posts small blind $0.50
chenconhaste: posts big blind $1
*** HOLE CARDS ***
Dealt to matiko09 [Qs 8d]
Sjtu_Michael: folds 
Avtovo: folds 
mavin80: folds 
matiko09: folds 
Eskimo Fox: raises $1.50 to $2.50
mi$$I$Elena: folds 
50CandyJoe: folds 
MarinoC1979: folds 
50CandyJoe leaves the table
DIMAN_324 joins the table at seat #6 
chenconhaste: raises $6.50 to $9
Eskimo Fox: folds 
Uncalled bet ($6.50) returned to chenconhaste
chenconhaste collected $5.50 from pot
*** SUMMARY ***
Total pot $5.50 | Rake $0 
Seat 1: Avtovo folded before Flop (didn't bet)
Seat 2: mavin80 folded before Flop (didn't bet)
Seat 3: matiko09 folded before Flop (didn't bet)
Seat 4: Eskimo Fox folded before Flop
Seat 5: mi$$I$Elena folded before Flop (didn't bet)
Seat 6: 50CandyJoe (button) folded before Flop (didn't bet)
Seat 7: MarinoC1979 (small blind) folded before Flop
Seat 8: chenconhaste (big blind) collected ($5.50)
Seat 9: Sjtu_Michael folded before Flop (didn't bet)





PokerStars Hand #155012866067:  Hold'em No Limit ($0.50/$1.00 USD) - 2016/06/21 13:08:34 CET [2016/06/21 7:08:34 ET]
Table 'Saldanha' 9-max Seat #3 is the button
Seat 1: IceSharK.AA ($69.67 in chips) 
Seat 2: matiko09 ($100 in chips) 
Seat 3: Avtovo ($100 in chips) 
Seat 4: 50CandyJoe ($103.22 in chips) 
Seat 5: Eskimo Fox ($100 in chips) 
Seat 8: pattexpro ($77.07 in chips) 
Seat 9: maxxmeister ($133.19 in chips) 
50CandyJoe: posts small blind $0.50
Eskimo Fox: posts big blind $1
SharingaaN: sits out 
chenconhaste: sits out 
IceSharK.AA: posts the ante $0.20
matiko09: posts the ante $0.20
Avtovo: posts the ante $0.20
50CandyJoe: posts the ante $0.20
Eskimo Fox: posts the ante $0.20
pattexpro: posts the ante $0.20
maxxmeister: posts the ante $0.20
*** HOLE CARDS ***
Dealt to matiko09 [5d 8c]
pattexpro: raises $1 to $2
maxxmeister: folds 
IceSharK.AA: folds 
matiko09: folds 
Avtovo: folds 
50CandyJoe: calls $1.50
Eskimo Fox: calls $1
*** FLOP *** [Qd 9c 6d]
50CandyJoe: checks 
Eskimo Fox: checks 
pattexpro: bets $3
50CandyJoe: folds 
Eskimo Fox: folds 
Uncalled bet ($3) returned to pattexpro
pattexpro collected $7.03 from pot
*** SUMMARY ***
Total pot $7.40 | Rake $0.37 
Board [Qd 9c 6d]
Seat 1: IceSharK.AA folded before Flop (didn't bet)
Seat 2: matiko09 folded before Flop (didn't bet)
Seat 3: Avtovo (button) folded before Flop (didn't bet)
Seat 4: 50CandyJoe (small blind) folded on the Flop
Seat 5: Eskimo Fox (big blind) folded on the Flop
Seat 8: pattexpro collected ($7.03)
Seat 9: maxxmeister folded before Flop (didn't bet)





PokerStars Hand #155012867947:  Hold'em No Limit (€0.25/€0.50 EUR) - 2016/06/21 13:08:38 CET [2016/06/21 7:08:38 ET]
Table 'Actor II' 6-max Seat #3 is the button
Seat 1: hmverlin (€92.24 in chips) 
Seat 2: ooak182 (€50 in chips) 
Seat 3: asmodej666 (€93.05 in chips) 
Seat 4: matiko09 (€50 in chips) 
Seat 5: Rybka1294 (€50.07 in chips) 
Seat 6: fanmtZ (€20 in chips) 
matiko09: posts small blind €0.25
Rybka1294: posts big blind €0.50
*** HOLE CARDS ***
Dealt to matiko09 [3d 5s]
fanmtZ: folds 
hmverlin: raises €1 to €1.50
ooak182: folds 
asmodej666: raises €3 to €4.50
matiko09: folds 
Rybka1294: folds 
hmverlin: calls €3
*** FLOP *** [8d 4c 6c]
hmverlin: bets €3.50
asmodej666: folds 
Uncalled bet (€3.50) returned to hmverlin
hmverlin collected €9.26 from pot
hmverlin: doesn't show hand 
*** SUMMARY ***
Total pot €9.75 | Rake €0.49 
Board [8d 4c 6c]
Seat 1: hmverlin collected (€9.26)
Seat 2: ooak182 folded before Flop (didn't bet)
Seat 3: asmodej666 (button) folded on the Flop
Seat 4: matiko09 (small blind) folded before Flop
Seat 5: Rybka1294 (big blind) folded before Flop
Seat 6: fanmtZ folded before Flop (didn't bet)





PokerStars Hand #155012869092:  Hold'em No Limit ($0.50/$1.00 USD) - 2016/06/21 13:08:41 CET [2016/06/21 7:08:41 ET]
Table 'Cheleb' 9-max Seat #7 is the button
Seat 1: SharingaaN ($110.43 in chips) 
Seat 2: pyromid ($138.38 in chips) 
Seat 3: bonesnz1 ($52.51 in chips) 
Seat 4: DIMAN_324 ($182.57 in chips) 
Seat 5: Avtovo ($137 in chips) 
Seat 6: matiko09 ($100 in chips) 
Seat 7: DomiVY ($40 in chips) 
Seat 8: Troll8989 ($100.50 in chips) 
Seat 9: chenconhaste ($119.02 in chips) 
Troll8989: posts small blind $0.50
chenconhaste: posts big blind $1
*** HOLE CARDS ***
Dealt to matiko09 [Tc Kh]
SharingaaN: folds 
pyromid: calls $1
bonesnz1: folds 
DIMAN_324: folds 
Avtovo: folds 
matiko09: raises $3 to $4
DomiVY: folds 
Troll8989: folds 
chenconhaste: folds 
pyromid: folds 
Uncalled bet ($3) returned to matiko09
matiko09 collected $3.50 from pot
matiko09: doesn't show hand 
*** SUMMARY ***
Total pot $3.50 | Rake $0 
Seat 1: SharingaaN folded before Flop (didn't bet)
Seat 2: pyromid folded before Flop
Seat 3: bonesnz1 folded before Flop (didn't bet)
Seat 4: DIMAN_324 folded before Flop (didn't bet)
Seat 5: Avtovo folded before Flop (didn't bet)
Seat 6: matiko09 collected ($3.50)
Seat 7: DomiVY (button) folded before Flop (didn't bet)
Seat 8: Troll8989 (small blind) folded before Flop
Seat 9: chenconhaste (big blind) folded before Flop





PokerStars Hand #155012871316:  Hold'em No Limit ($0.50/$1.00 USD) - 2016/06/21 13:08:46 CET [2016/06/21 7:08:46 ET]
Table 'Carlova II' 9-max Seat #9 is the button
Seat 1: matiko09 ($116.30 in chips) 
Seat 2: chenconhaste ($122.73 in chips) 
Seat 3: King_Z�Manel ($105.95 in chips) 
Seat 4: Dandy Monk ($64.66 in chips) 
Seat 5: ozone2003 ($100 in chips) 
Seat 6: DIMAN_324 ($102.72 in chips) 
Seat 7: mi$$I$Elena ($103.68 in chips) 
Seat 8: pyromid ($88.09 in chips) 
Seat 9: Troll8989 ($104.68 in chips) 
matiko09: posts small blind $0.50
chenconhaste: posts big blind $1
*** HOLE CARDS ***
Dealt to matiko09 [Ts Jh]
King_Z�Manel: folds 
Dandy Monk: folds 
ozone2003: folds 
DIMAN_324: folds 
mi$$I$Elena: folds 
pyromid: raises $1.50 to $2.50
Troll8989: folds 
matiko09: folds 
chenconhaste: folds 
Uncalled bet ($1.50) returned to pyromid
pyromid collected $2.50 from pot
pyromid: doesn't show hand 
*** SUMMARY ***
Total pot $2.50 | Rake $0 
Seat 1: matiko09 (small blind) folded before Flop
Seat 2: chenconhaste (big blind) folded before Flop
Seat 3: King_Z�Manel folded before Flop (didn't bet)
Seat 4: Dandy Monk folded before Flop (didn't bet)
Seat 5: ozone2003 folded before Flop (didn't bet)
Seat 6: DIMAN_324 folded before Flop (didn't bet)
Seat 7: mi$$I$Elena folded before Flop (didn't bet)
Seat 8: pyromid collected ($2.50)
Seat 9: Troll8989 (button) folded before Flop (didn't bet)





PokerStars Hand #155012872470:  Hold'em No Limit ($0.50/$1.00 USD) - 2016/06/21 13:08:49 CET [2016/06/21 7:08:49 ET]
Table 'Brauna II' 9-max Seat #1 is the button
Seat 1: wisbc ($146.56 in chips) 
Seat 2: pyromid ($148.52 in chips) 
Seat 3: matiko09 ($100 in chips) 
Seat 4: chenconhaste ($196.75 in chips) 
Seat 5: fukumimi ($100 in chips) 
Seat 6: mbk88 ($203.01 in chips) 
Seat 8: DIMAN_324 ($132.15 in chips) 
Seat 9: torkkdnm ($100 in chips) 
pyromid: posts small blind $0.50
matiko09: posts big blind $1
Troll8989: sits out 
*** HOLE CARDS ***
Dealt to matiko09 [Ac 2h]
chenconhaste: folds 
fukumimi: folds 
mbk88: folds 
DIMAN_324: folds 
torkkdnm: folds 
wisbc: raises $2 to $3
pyromid: calls $2.50
matiko09: folds 
*** FLOP *** [5h Ks 9h]
pyromid: bets $3.50
wisbc: raises $6.50 to $10
pyromid: folds 
Uncalled bet ($6.50) returned to wisbc
wisbc collected $13.30 from pot
*** SUMMARY ***
Total pot $14 | Rake $0.70 
Board [5h Ks 9h]
Seat 1: wisbc (button) collected ($13.30)
Seat 2: pyromid (small blind) folded on the Flop
Seat 3: matiko09 (big blind) folded before Flop
Seat 4: chenconhaste folded before Flop (didn't bet)
Seat 5: fukumimi folded before Flop (didn't bet)
Seat 6: mbk88 folded before Flop (didn't bet)
Seat 8: DIMAN_324 folded before Flop (didn't bet)
Seat 9: torkkdnm folded before Flop (didn't bet)





PokerStars Hand #155012873545:  Hold'em No Limit ($0.50/$1.00 USD) - 2016/06/21 13:08:52 CET [2016/06/21 7:08:52 ET]
Table 'Leo' 9-max Seat #1 is the button
Seat 1: letmegonow ($50.07 in chips) 
Seat 2: torkkdnm ($164.66 in chips) 
Seat 3: matiko09 ($103.30 in chips) 
Seat 4: SharingaaN ($103.45 in chips) 
Seat 5: DIMAN_324 ($113.16 in chips) 
Seat 6: chenconhaste ($117.92 in chips) 
Seat 7: maxxmeister ($100 in chips) 
Seat 8: pyromid ($67.92 in chips) 
Seat 9: Wladimir205 ($97 in chips) 
torkkdnm: posts small blind $0.50
matiko09: posts big blind $1
*** HOLE CARDS ***
Dealt to matiko09 [Qs As]
SharingaaN: folds 
DIMAN_324: folds 
chenconhaste: folds 
maxxmeister: folds 
pyromid: raises $2 to $3
Wladimir205: calls $3
letmegonow: raises $6 to $9
torkkdnm: folds 
matiko09: folds 
pyromid: calls $6
Wladimir205: calls $6
*** FLOP *** [Qh 5h Qc]
pyromid: checks 
Wladimir205: checks 
letmegonow: checks 
*** TURN *** [Qh 5h Qc] [6h]
pyromid: checks 
Wladimir205: bets $13.54
letmegonow: folds 
pyromid: folds 
Uncalled bet ($13.54) returned to Wladimir205
Wladimir205 collected $27.08 from pot
Wladimir205: doesn't show hand 
*** SUMMARY ***
Total pot $28.50 | Rake $1.42 
Board [Qh 5h Qc 6h]
Seat 1: letmegonow (button) folded on the Turn
Seat 2: torkkdnm (small blind) folded before Flop
Seat 3: matiko09 (big blind) folded before Flop
Seat 4: SharingaaN folded before Flop (didn't bet)
Seat 5: DIMAN_324 folded before Flop (didn't bet)
Seat 6: chenconhaste folded before Flop (didn't bet)
Seat 7: maxxmeister folded before Flop (didn't bet)
Seat 8: pyromid folded on the Turn
Seat 9: Wladimir205 collected ($27.08)





PokerStars Hand #155012873843:  Hold'em No Limit ($0.50/$1.00 USD) - 2016/06/21 13:08:53 CET [2016/06/21 7:08:53 ET]
Table 'Umbriel II' 9-max Seat #3 is the button
Seat 1: phil_cheng ($105.50 in chips) 
Seat 2: rura53 ($61.50 in chips) 
Seat 3: mxustin ($36.25 in chips) 
Seat 4: Eskimo Fox ($100 in chips) 
Seat 5: matiko09 ($145.46 in chips) 
Seat 6: maxxmeister ($100 in chips) 
Seat 7: chenconhaste ($172.10 in chips) 
Seat 8: ozone2003 ($128.34 in chips) 
Seat 9: Troll8989 ($100 in chips) 
Eskimo Fox: posts small blind $0.50
matiko09: posts big blind $1
*** HOLE CARDS ***
Dealt to matiko09 [Ks 7c]
maxxmeister: raises $2.50 to $3.50
chenconhaste: folds 
ozone2003: calls $3.50
Troll8989: folds 
phil_cheng: folds 
rura53: folds 
mxustin: folds 
Eskimo Fox: folds 
matiko09: folds 
*** FLOP *** [3c 4d 4s]
maxxmeister: bets $6
ozone2003: folds 
Uncalled bet ($6) returned to maxxmeister
maxxmeister collected $8.08 from pot
maxxmeister: doesn't show hand 
*** SUMMARY ***
Total pot $8.50 | Rake $0.42 
Board [3c 4d 4s]
Seat 1: phil_cheng folded before Flop (didn't bet)
Seat 2: rura53 folded before Flop (didn't bet)
Seat 3: mxustin (button) folded before Flop (didn't bet)
Seat 4: Eskimo Fox (small blind) folded before Flop
Seat 5: matiko09 (big blind) folded before Flop
Seat 6: maxxmeister collected ($8.08)
Seat 7: chenconhaste folded before Flop (didn't bet)
Seat 8: ozone2003 folded on the Flop
Seat 9: Troll8989 folded before Flop (didn't bet)





PokerStars Hand #155012875695:  Hold'em No Limit (€0.25/€0.50 EUR) - 2016/06/21 13:08:57 CET [2016/06/21 7:08:57 ET]
Table 'Lotis II' 6-max Seat #1 is the button
Seat 1: acaestanemo (€50 in chips) 
Seat 2: broh202 (€112.46 in chips) 
Seat 3: bricasse1961 (€32.05 in chips) 
Seat 4: matiko09 (€76.39 in chips) 
Seat 5: AlexPles (€72.27 in chips) 
broh202: posts small blind €0.25
bricasse1961: posts big blind €0.50
*** HOLE CARDS ***
Dealt to matiko09 [3s Kc]
matiko09: folds 
AlexPles: folds 
acaestanemo: folds 
patriot424 leaves the table
broh202: raises €1 to €1.50
bricasse1961: raises €1 to €2.50
broh202: calls €1
*** FLOP *** [Ad 7s Js]
broh202: checks 
bricasse1961: bets €2
asmodej666 joins the table at seat #6 
broh202: calls €2
*** TURN *** [Ad 7s Js] [Kh]
broh202: checks 
bricasse1961: bets €3
broh202: folds 
Uncalled bet (€3) returned to bricasse1961
bricasse1961 collected €8.55 from pot
bricasse1961: doesn't show hand 
*** SUMMARY ***
Total pot €9 | Rake €0.45 
Board [Ad 7s Js Kh]
Seat 1: acaestanemo (button) folded before Flop (didn't bet)
Seat 2: broh202 (small blind) folded on the Turn
Seat 3: bricasse1961 (big blind) collected (€8.55)
Seat 4: matiko09 folded before Flop (didn't bet)
Seat 5: AlexPles folded before Flop (didn't bet)





PokerStars Hand #155012879947:  Hold'em No Limit ($0.50/$1.00 USD) - 2016/06/21 13:09:07 CET [2016/06/21 7:09:07 ET]
Table 'Rupertwildt' 9-max Seat #2 is the button
Seat 1: pokernixxx ($57.75 in chips) 
Seat 2: SharingaaN ($78.50 in chips) 
Seat 3: Saymon_Moo ($80.08 in chips) 
Seat 4: matiko09 ($150.68 in chips) 
Seat 5: pyromid ($78.96 in chips) 
Seat 6: ozone2003 ($135.72 in chips) 
Seat 7: chenconhaste ($102.34 in chips) 
Seat 8: Gonzanary ($112.14 in chips) 
Seat 9: mbk88 ($118.43 in chips) 
Saymon_Moo: posts small blind $0.50
matiko09: posts big blind $1
*** HOLE CARDS ***
Dealt to matiko09 [Jh Kc]
pyromid: raises $2 to $3
ozone2003: folds 
chenconhaste: folds 
Gonzanary: folds 
mbk88: folds 
pokernixxx: folds 
SharingaaN: folds 
Saymon_Moo: folds 
matiko09: folds 
Uncalled bet ($2) returned to pyromid
pyromid collected $2.50 from pot
pyromid: doesn't show hand 
*** SUMMARY ***
Total pot $2.50 | Rake $0 
Seat 1: pokernixxx folded before Flop (didn't bet)
Seat 2: SharingaaN (button) folded before Flop (didn't bet)
Seat 3: Saymon_Moo (small blind) folded before Flop
Seat 4: matiko09 (big blind) folded before Flop
Seat 5: pyromid collected ($2.50)
Seat 6: ozone2003 folded before Flop (didn't bet)
Seat 7: chenconhaste folded before Flop (didn't bet)
Seat 8: Gonzanary folded before Flop (didn't bet)
Seat 9: mbk88 folded before Flop (didn't bet)





PokerStars Hand #155012882306:  Hold'em No Limit (€0.25/€0.50 EUR) - 2016/06/21 13:09:13 CET [2016/06/21 7:09:13 ET]
Table 'Actor II' 6-max Seat #4 is the button
Seat 1: hmverlin (€97 in chips) 
Seat 2: ooak182 (€50 in chips) 
Seat 3: asmodej666 (€88.55 in chips) 
Seat 4: matiko09 (€50 in chips) 
Seat 5: Rybka1294 (€50 in chips) 
Seat 6: fanmtZ (€20 in chips) 
Rybka1294: posts small blind €0.25
fanmtZ: posts big blind €0.50
*** HOLE CARDS ***
Dealt to matiko09 [9h 7s]
hmverlin: raises €0.50 to €1
ooak182: folds 
asmodej666: folds 
matiko09: folds 
Rybka1294: folds 
fanmtZ: folds 
Uncalled bet (€0.50) returned to hmverlin
hmverlin collected €1.25 from pot
hmverlin: doesn't show hand 
*** SUMMARY ***
Total pot €1.25 | Rake €0 
Seat 1: hmverlin collected (€1.25)
Seat 2: ooak182 folded before Flop (didn't bet)
Seat 3: asmodej666 folded before Flop (didn't bet)
Seat 4: matiko09 (button) folded before Flop (didn't bet)
Seat 5: Rybka1294 (small blind) folded before Flop
Seat 6: fanmtZ (big blind) folded before Flop





PokerStars Hand #155012883034:  Hold'em No Limit ($0.50/$1.00 USD) - 2016/06/21 13:09:14 CET [2016/06/21 7:09:14 ET]
Table 'Lamberta II' 9-max Seat #7 is the button
Seat 1: Avtovo ($102.45 in chips) 
Seat 2: mavin80 ($96.92 in chips) 
Seat 3: matiko09 ($102 in chips) 
Seat 4: Eskimo Fox ($100 in chips) 
Seat 5: mi$$I$Elena ($100 in chips) 
Seat 7: MarinoC1979 ($71.17 in chips) 
Seat 8: chenconhaste ($103 in chips) 
Seat 9: Sjtu_Michael ($109.58 in chips) 
chenconhaste: posts small blind $0.50
Sjtu_Michael: posts big blind $1
DIMAN_324: sits out 
*** HOLE CARDS ***
Dealt to matiko09 [5d Tc]
Avtovo: folds 
mavin80: folds 
matiko09: folds 
Eskimo Fox: folds 
mi$$I$Elena: folds 
MarinoC1979 is disconnected 
MarinoC1979 has timed out while disconnected
MarinoC1979: folds 
chenconhaste: calls $0.50
Sjtu_Michael: checks 
*** FLOP *** [Js 2h 8s]
chenconhaste: bets $1
Sjtu_Michael: folds 
Uncalled bet ($1) returned to chenconhaste
chenconhaste collected $1.90 from pot
*** SUMMARY ***
Total pot $2 | Rake $0.10 
Board [Js 2h 8s]
Seat 1: Avtovo folded before Flop (didn't bet)
Seat 2: mavin80 folded before Flop (didn't bet)
Seat 3: matiko09 folded before Flop (didn't bet)
Seat 4: Eskimo Fox folded before Flop (didn't bet)
Seat 5: mi$$I$Elena folded before Flop (didn't bet)
Seat 7: MarinoC1979 (button) folded before Flop (didn't bet)
Seat 8: chenconhaste (small blind) collected ($1.90)
Seat 9: Sjtu_Michael (big blind) folded on the Flop





PokerStars Hand #155012883834:  Hold'em No Limit ($0.50/$1.00 USD) - 2016/06/21 13:09:16 CET [2016/06/21 7:09:16 ET]
Table 'Cheleb' 9-max Seat #8 is the button
Seat 1: SharingaaN ($110.43 in chips) 
Seat 2: pyromid ($137.38 in chips) 
Seat 3: bonesnz1 ($52.51 in chips) 
Seat 4: DIMAN_324 ($182.57 in chips) 
Seat 5: Avtovo ($137 in chips) 
Seat 6: matiko09 ($102.50 in chips) 
Seat 7: DomiVY ($40 in chips) 
Seat 8: Troll8989 ($100 in chips) 
Seat 9: chenconhaste ($118.02 in chips) 
chenconhaste: posts small blind $0.50
SharingaaN: posts big blind $1
*** HOLE CARDS ***
Dealt to matiko09 [6c 4d]
pyromid: folds 
bonesnz1: folds 
DIMAN_324: folds 
Avtovo: folds 
matiko09: folds 
DomiVY: folds 
Troll8989: folds 
chenconhaste: raises $2 to $3
SharingaaN: raises $6 to $9
chenconhaste: folds 
Uncalled bet ($6) returned to SharingaaN
SharingaaN collected $6 from pot
SharingaaN: doesn't show hand 
*** SUMMARY ***
Total pot $6 | Rake $0 
Seat 1: SharingaaN (big blind) collected ($6)
Seat 2: pyromid folded before Flop (didn't bet)
Seat 3: bonesnz1 folded before Flop (didn't bet)
Seat 4: DIMAN_324 folded before Flop (didn't bet)
Seat 5: Avtovo folded before Flop (didn't bet)
Seat 6: matiko09 folded before Flop (didn't bet)
Seat 7: DomiVY folded before Flop (didn't bet)
Seat 8: Troll8989 (button) folded before Flop (didn't bet)
Seat 9: chenconhaste (small blind) folded before Flop





PokerStars Hand #155012886701:  Hold'em No Limit ($0.50/$1.00 USD) - 2016/06/21 13:09:23 CET [2016/06/21 7:09:23 ET]
Table 'Moreau' 9-max Seat #2 is the button
Seat 1: ozone2003 ($117.69 in chips) 
Seat 2: nubpoker ($134.89 in chips) 
Seat 3: matiko09 ($103.12 in chips) 
Seat 4: bonesnz1 ($51.42 in chips) 
Seat 5: DIMAN_324 ($101.38 in chips) 
Seat 6: mbk88 ($100 in chips) 
Seat 7: PanKwn15 ($71.13 in chips) 
Seat 8: maxxmeister ($109.80 in chips) 
Seat 9: Toonersens ($113.42 in chips) 
matiko09: posts small blind $0.50
bonesnz1: posts big blind $1
*** HOLE CARDS ***
Dealt to matiko09 [Ad 9c]
DIMAN_324: folds 
mbk88: raises $2 to $3
PanKwn15: folds 
maxxmeister: folds 
Toonersens: folds 
ozone2003: calls $3
nubpoker: folds 
matiko09: folds 
bonesnz1: calls $2
*** FLOP *** [4s Ks Js]
bonesnz1: checks 
mbk88: checks 
ozone2003: bets $5.86
bonesnz1: folds 
mbk88: calls $5.86
*** TURN *** [4s Ks Js] [8d]
mbk88: checks 
ozone2003: bets $13.70
mbk88: folds 
Uncalled bet ($13.70) returned to ozone2003
ozone2003 collected $20.16 from pot
ozone2003: doesn't show hand 
*** SUMMARY ***
Total pot $21.22 | Rake $1.06 
Board [4s Ks Js 8d]
Seat 1: ozone2003 collected ($20.16)
Seat 2: nubpoker (button) folded before Flop (didn't bet)
Seat 3: matiko09 (small blind) folded before Flop
Seat 4: bonesnz1 (big blind) folded on the Flop
Seat 5: DIMAN_324 folded before Flop (didn't bet)
Seat 6: mbk88 folded on the Turn
Seat 7: PanKwn15 folded before Flop (didn't bet)
Seat 8: maxxmeister folded before Flop (didn't bet)
Seat 9: Toonersens folded before Flop (didn't bet)





PokerStars Hand #155012887551:  Hold'em No Limit ($0.50/$1.00 USD) - 2016/06/21 13:09:25 CET [2016/06/21 7:09:25 ET]
Table 'Saldanha' 9-max Seat #4 is the button
Seat 1: IceSharK.AA ($69.47 in chips) 
Seat 2: matiko09 ($100 in chips) 
Seat 3: Avtovo ($100 in chips) 
Seat 4: 50CandyJoe ($101.02 in chips) 
Seat 5: Eskimo Fox ($100 in chips) 
Seat 6: SharingaaN ($80 in chips) 
Seat 8: pattexpro ($81.90 in chips) 
Seat 9: maxxmeister ($132.99 in chips) 
Eskimo Fox: posts small blind $0.50
SharingaaN: posts big blind $1
chenconhaste: sits out 
IceSharK.AA: posts the ante $0.20
matiko09: posts the ante $0.20
Avtovo: posts the ante $0.20
50CandyJoe: posts the ante $0.20
Eskimo Fox: posts the ante $0.20
SharingaaN: posts the ante $0.20
pattexpro: posts the ante $0.20
maxxmeister: posts the ante $0.20
*** HOLE CARDS ***
Dealt to matiko09 [As Ac]
pattexpro: folds 
maxxmeister: folds 
IceSharK.AA: raises $2 to $3
matiko09: raises $6.50 to $9.50
Avtovo: folds 
50CandyJoe: folds 
Eskimo Fox: folds 
SharingaaN: folds 
IceSharK.AA: calls $6.50
*** FLOP *** [Jh 9h Ks]
IceSharK.AA: checks 
matiko09: bets $14
IceSharK.AA: folds 
Uncalled bet ($14) returned to matiko09
matiko09 collected $21 from pot
matiko09: doesn't show hand 
*** SUMMARY ***
Total pot $22.10 | Rake $1.10 
Board [Jh 9h Ks]
Seat 1: IceSharK.AA folded on the Flop
Seat 2: matiko09 collected ($21)
Seat 3: Avtovo folded before Flop (didn't bet)
Seat 4: 50CandyJoe (button) folded before Flop (didn't bet)
Seat 5: Eskimo Fox (small blind) folded before Flop
Seat 6: SharingaaN (big blind) folded before Flop
Seat 8: pattexpro folded before Flop (didn't bet)
Seat 9: maxxmeister folded before Flop (didn't bet)





PokerStars Hand #155012892729:  Hold'em No Limit ($0.50/$1.00 USD) - 2016/06/21 13:09:38 CET [2016/06/21 7:09:38 ET]
Table 'Feronia' 9-max Seat #7 is the button
Seat 1: DIMAN_324 ($101.50 in chips) 
Seat 2: Yuder_Lin ($82.37 in chips) 
Seat 3: mbk88 ($126.75 in chips) 
Seat 4: pyromid ($127.36 in chips) 
Seat 5: matiko09 ($121.37 in chips) 
Seat 6: chenconhaste ($114.95 in chips) 
Seat 7: arctur17 ($102.45 in chips) 
Seat 8: letmegonow ($137.39 in chips) 
Seat 9: mi$$I$Elena ($152.54 in chips) 
letmegonow: posts small blind $0.50
mi$$I$Elena: posts big blind $1
*** HOLE CARDS ***
Dealt to matiko09 [2s Qh]
DIMAN_324: folds 
Yuder_Lin: folds 
mbk88: folds 
pyromid: folds 
matiko09: folds 
chenconhaste: raises $1.25 to $2.25
arctur17: folds 
letmegonow: folds 
mi$$I$Elena: folds 
Uncalled bet ($1.25) returned to chenconhaste
chenconhaste collected $2.50 from pot
*** SUMMARY ***
Total pot $2.50 | Rake $0 
Seat 1: DIMAN_324 folded before Flop (didn't bet)
Seat 2: Yuder_Lin folded before Flop (didn't bet)
Seat 3: mbk88 folded before Flop (didn't bet)
Seat 4: pyromid folded before Flop (didn't bet)
Seat 5: matiko09 folded before Flop (didn't bet)
Seat 6: chenconhaste collected ($2.50)
Seat 7: arctur17 (button) folded before Flop (didn't bet)
Seat 8: letmegonow (small blind) folded before Flop
Seat 9: mi$$I$Elena (big blind) folded before Flop





PokerStars Hand #155012895918:  Hold'em No Limit ($0.50/$1.00 USD) - 2016/06/21 13:09:45 CET [2016/06/21 7:09:45 ET]
Table 'Carlova II' 9-max Seat #1 is the button
Seat 1: matiko09 ($115.80 in chips) 
Seat 2: chenconhaste ($121.73 in chips) 
Seat 3: King_Z�Manel ($105.95 in chips) 
Seat 4: Dandy Monk ($64.66 in chips) 
Seat 5: ozone2003 ($100 in chips) 
Seat 6: DIMAN_324 ($102.72 in chips) 
Seat 7: mi$$I$Elena ($103.68 in chips) 
Seat 8: pyromid ($89.59 in chips) 
Seat 9: Troll8989 ($104.68 in chips) 
chenconhaste: posts small blind $0.50
King_Z�Manel: posts big blind $1
*** HOLE CARDS ***
Dealt to matiko09 [7h 6c]
Dandy Monk: folds 
ozone2003: folds 
DIMAN_324: folds 
mi$$I$Elena: raises $1.38 to $2.38
pyromid: calls $2.38
Troll8989: folds 
matiko09: folds 
chenconhaste: folds 
King_Z�Manel: folds 
*** FLOP *** [2d 8c Jc]
mi$$I$Elena: checks 
pyromid: checks 
*** TURN *** [2d 8c Jc] [Ts]
mi$$I$Elena: bets $4
pyromid: folds 
Uncalled bet ($4) returned to mi$$I$Elena
mi$$I$Elena collected $5.95 from pot
mi$$I$Elena: doesn't show hand 
*** SUMMARY ***
Total pot $6.26 | Rake $0.31 
Board [2d 8c Jc Ts]
Seat 1: matiko09 (button) folded before Flop (didn't bet)
Seat 2: chenconhaste (small blind) folded before Flop
Seat 3: King_Z�Manel (big blind) folded before Flop
Seat 4: Dandy Monk folded before Flop (didn't bet)
Seat 5: ozone2003 folded before Flop (didn't bet)
Seat 6: DIMAN_324 folded before Flop (didn't bet)
Seat 7: mi$$I$Elena collected ($5.95)
Seat 8: pyromid folded on the Turn
Seat 9: Troll8989 folded before Flop (didn't bet)





PokerStars Hand #155012897047:  Hold'em No Limit (€0.25/€0.50 EUR) - 2016/06/21 13:09:48 CET [2016/06/21 7:09:48 ET]
Table 'Actor II' 6-max Seat #5 is the button
Seat 1: hmverlin (€97.75 in chips) 
Seat 2: ooak182 (€50 in chips) 
Seat 3: asmodej666 (€88.55 in chips) 
Seat 4: matiko09 (€50 in chips) 
Seat 5: Rybka1294 (€50 in chips) 
Seat 6: fanmtZ (€20 in chips) 
fanmtZ: posts small blind €0.25
hmverlin: posts big blind €0.50
*** HOLE CARDS ***
Dealt to matiko09 [Jh Tc]
ooak182: folds 
asmodej666: folds 
matiko09: raises €1 to €1.50
Rybka1294: folds 
fanmtZ: folds 
hmverlin: folds 
Uncalled bet (€1) returned to matiko09
matiko09 collected €1.25 from pot
matiko09: doesn't show hand 
*** SUMMARY ***
Total pot €1.25 | Rake €0 
Seat 1: hmverlin (big blind) folded before Flop
Seat 2: ooak182 folded before Flop (didn't bet)
Seat 3: asmodej666 folded before Flop (didn't bet)
Seat 4: matiko09 collected (€1.25)
Seat 5: Rybka1294 (button) folded before Flop (didn't bet)
Seat 6: fanmtZ (small blind) folded before Flop





PokerStars Hand #155012897434:  Hold'em No Limit ($0.50/$1.00 USD) - 2016/06/21 13:09:49 CET [2016/06/21 7:09:49 ET]
Table 'Rupertwildt' 9-max Seat #3 is the button
Seat 1: pokernixxx ($57.75 in chips) 
Seat 2: SharingaaN ($78.50 in chips) 
Seat 3: Saymon_Moo ($79.58 in chips) 
Seat 4: matiko09 ($149.68 in chips) 
Seat 5: pyromid ($80.46 in chips) 
Seat 6: ozone2003 ($135.72 in chips) 
Seat 7: chenconhaste ($102.34 in chips) 
Seat 8: Gonzanary ($112.14 in chips) 
Seat 9: mbk88 ($118.43 in chips) 
matiko09: posts small blind $0.50
pyromid: posts big blind $1
*** HOLE CARDS ***
Dealt to matiko09 [3s 6s]
ozone2003: folds 
chenconhaste: folds 
Gonzanary: folds 
mbk88: folds 
pokernixxx: raises $1 to $2
SharingaaN: calls $2
Saymon_Moo: calls $2
matiko09: folds 
pyromid: folds 
*** FLOP *** [7c 2h Qd]
pokernixxx: bets $7
SharingaaN: folds 
Saymon_Moo: folds 
Uncalled bet ($7) returned to pokernixxx
pokernixxx collected $7.12 from pot
pokernixxx: doesn't show hand 
*** SUMMARY ***
Total pot $7.50 | Rake $0.38 
Board [7c 2h Qd]
Seat 1: pokernixxx collected ($7.12)
Seat 2: SharingaaN folded on the Flop
Seat 3: Saymon_Moo (button) folded on the Flop
Seat 4: matiko09 (small blind) folded before Flop
Seat 5: pyromid (big blind) folded before Flop
Seat 6: ozone2003 folded before Flop (didn't bet)
Seat 7: chenconhaste folded before Flop (didn't bet)
Seat 8: Gonzanary folded before Flop (didn't bet)
Seat 9: mbk88 folded before Flop (didn't bet)





PokerStars Hand #155012898226:  Hold'em No Limit (€0.25/€0.50 EUR) - 2016/06/21 13:09:51 CET [2016/06/21 7:09:51 ET]
Table 'Lotis II' 6-max Seat #2 is the button
Seat 1: acaestanemo (€50 in chips) 
Seat 2: broh202 (€107.96 in chips) 
Seat 3: bricasse1961 (€36.10 in chips) 
Seat 4: matiko09 (€76.39 in chips) 
Seat 5: AlexPles (€72.27 in chips) 
bricasse1961: posts small blind €0.25
matiko09: posts big blind €0.50
asmodej666: sits out 
*** HOLE CARDS ***
Dealt to matiko09 [Ah 8s]
AlexPles: folds 
acaestanemo: folds 
broh202: folds 
bricasse1961: folds 
Uncalled bet (€0.25) returned to matiko09
matiko09 collected €0.50 from pot
matiko09: doesn't show hand 
*** SUMMARY ***
Total pot €0.50 | Rake €0 
Seat 1: acaestanemo folded before Flop (didn't bet)
Seat 2: broh202 (button) folded before Flop (didn't bet)
Seat 3: bricasse1961 (small blind) folded before Flop
Seat 4: matiko09 (big blind) collected (€0.50)
Seat 5: AlexPles folded before Flop (didn't bet)





PokerStars Hand #155012901956:  Hold'em No Limit (€0.25/€0.50 EUR) - 2016/06/21 13:10:00 CET [2016/06/21 7:10:00 ET]
Table 'Lotis II' 6-max Seat #3 is the button
Seat 1: acaestanemo (€50 in chips) 
Seat 2: broh202 (€107.96 in chips) 
Seat 3: bricasse1961 (€35.85 in chips) 
Seat 4: matiko09 (€76.64 in chips) 
Seat 5: AlexPles (€72.27 in chips) 
matiko09: posts small blind €0.25
AlexPles: posts big blind €0.50
asmodej666: sits out 
*** HOLE CARDS ***
Dealt to matiko09 [8h Ah]
acaestanemo: folds 
broh202: raises €1 to €1.50
bricasse1961: calls €1.50
matiko09: folds 
AlexPles: folds 
*** FLOP *** [5h Ts 7h]
broh202: bets €2
bricasse1961: folds 
Uncalled bet (€2) returned to broh202
broh202 collected €3.56 from pot
broh202: doesn't show hand 
*** SUMMARY ***
Total pot €3.75 | Rake €0.19 
Board [5h Ts 7h]
Seat 1: acaestanemo folded before Flop (didn't bet)
Seat 2: broh202 collected (€3.56)
Seat 3: bricasse1961 (button) folded on the Flop
Seat 4: matiko09 (small blind) folded before Flop
Seat 5: AlexPles (big blind) folded before Flop





PokerStars Hand #155012905354:  Hold'em No Limit (€0.25/€0.50 EUR) - 2016/06/21 13:10:08 CET [2016/06/21 7:10:08 ET]
Table 'Actor II' 6-max Seat #6 is the button
Seat 1: hmverlin (€97.25 in chips) 
Seat 2: ooak182 (€50 in chips) 
Seat 3: asmodej666 (€88.55 in chips) 
Seat 4: matiko09 (€50.75 in chips) 
Seat 5: Rybka1294 (€50 in chips) 
Seat 6: fanmtZ (€20 in chips) 
hmverlin: posts small blind €0.25
ooak182: posts big blind €0.50
*** HOLE CARDS ***
Dealt to matiko09 [6s Kh]
asmodej666: folds 
matiko09: folds 
Rybka1294: folds 
fanmtZ: raises €0.79 to €1.29
hmverlin: calls €1.04
ooak182: raises €3.96 to €5.25
fanmtZ: folds 
hmverlin: calls €3.96
*** FLOP *** [3d Ts 7d]
hmverlin: checks 
ooak182: bets €6.50
hmverlin: folds 
Uncalled bet (€6.50) returned to ooak182
ooak182 collected €11.20 from pot
ooak182: doesn't show hand 
*** SUMMARY ***
Total pot €11.79 | Rake €0.59 
Board [3d Ts 7d]
Seat 1: hmverlin (small blind) folded on the Flop
Seat 2: ooak182 (big blind) collected (€11.20)
Seat 3: asmodej666 folded before Flop (didn't bet)
Seat 4: matiko09 folded before Flop (didn't bet)
Seat 5: Rybka1294 folded before Flop (didn't bet)
Seat 6: fanmtZ (button) folded before Flop





PokerStars Hand #155012907541:  Hold'em No Limit ($0.50/$1.00 USD) - 2016/06/21 13:10:13 CET [2016/06/21 7:10:13 ET]
Table 'Cheleb' 9-max Seat #9 is the button
Seat 1: SharingaaN ($113.43 in chips) 
Seat 2: pyromid ($137.38 in chips) 
Seat 3: bonesnz1 ($52.51 in chips) 
Seat 4: DIMAN_324 ($182.57 in chips) 
Seat 5: Avtovo ($137 in chips) 
Seat 6: matiko09 ($102.50 in chips) 
Seat 7: DomiVY ($40 in chips) 
Seat 8: Troll8989 ($100 in chips) 
Seat 9: chenconhaste ($115.02 in chips) 
SharingaaN: posts small blind $0.50
pyromid: posts big blind $1
*** HOLE CARDS ***
Dealt to matiko09 [6c 4h]
bonesnz1: folds 
DIMAN_324: folds 
Avtovo: folds 
matiko09: folds 
DomiVY: folds 
Troll8989: folds 
chenconhaste: raises $1.25 to $2.25
SharingaaN: folds 
pyromid: folds 
Uncalled bet ($1.25) returned to chenconhaste
chenconhaste collected $2.50 from pot
*** SUMMARY ***
Total pot $2.50 | Rake $0 
Seat 1: SharingaaN (small blind) folded before Flop
Seat 2: pyromid (big blind) folded before Flop
Seat 3: bonesnz1 folded before Flop (didn't bet)
Seat 4: DIMAN_324 folded before Flop (didn't bet)
Seat 5: Avtovo folded before Flop (didn't bet)
Seat 6: matiko09 folded before Flop (didn't bet)
Seat 7: DomiVY folded before Flop (didn't bet)
Seat 8: Troll8989 folded before Flop (didn't bet)
Seat 9: chenconhaste (button) collected ($2.50)





PokerStars Hand #155012909305:  Hold'em No Limit ($0.50/$1.00 USD) - 2016/06/21 13:10:17 CET [2016/06/21 7:10:17 ET]
Table 'Umbriel II' 9-max Seat #4 is the button
Seat 1: phil_cheng ($105.50 in chips) 
Seat 2: rura53 ($61.50 in chips) 
Seat 3: mxustin ($36.25 in chips) 
Seat 4: Eskimo Fox ($100 in chips) 
Seat 5: matiko09 ($144.46 in chips) 
Seat 6: maxxmeister ($104.58 in chips) 
Seat 7: chenconhaste ($172.10 in chips) 
Seat 8: ozone2003 ($124.84 in chips) 
Seat 9: Troll8989 ($100 in chips) 
matiko09: posts small blind $0.50
maxxmeister: posts big blind $1
*** HOLE CARDS ***
Dealt to matiko09 [Jh Qc]
chenconhaste: folds 
ozone2003: folds 
Troll8989: folds 
phil_cheng: raises $2 to $3
rura53: folds 
mxustin: folds 
Eskimo Fox: folds 
matiko09: folds 
maxxmeister: folds 
Uncalled bet ($2) returned to phil_cheng
phil_cheng collected $2.50 from pot
phil_cheng: doesn't show hand 
*** SUMMARY ***
Total pot $2.50 | Rake $0 
Seat 1: phil_cheng collected ($2.50)
Seat 2: rura53 folded before Flop (didn't bet)
Seat 3: mxustin folded before Flop (didn't bet)
Seat 4: Eskimo Fox (button) folded before Flop (didn't bet)
Seat 5: matiko09 (small blind) folded before Flop
Seat 6: maxxmeister (big blind) folded before Flop
Seat 7: chenconhaste folded before Flop (didn't bet)
Seat 8: ozone2003 folded before Flop (didn't bet)
Seat 9: Troll8989 folded before Flop (didn't bet)





PokerStars Hand #155012909819:  Hold'em No Limit ($0.50/$1.00 USD) - 2016/06/21 13:10:18 CET [2016/06/21 7:10:18 ET]
Table 'Feronia' 9-max Seat #8 is the button
Seat 1: DIMAN_324 ($101.50 in chips) 
Seat 2: Yuder_Lin ($82.37 in chips) 
Seat 3: mbk88 ($126.75 in chips) 
Seat 4: pyromid ($127.36 in chips) 
Seat 5: matiko09 ($121.37 in chips) 
Seat 6: chenconhaste ($116.45 in chips) 
Seat 7: arctur17 ($102.45 in chips) 
Seat 8: letmegonow ($136.89 in chips) 
Seat 9: mi$$I$Elena ($151.54 in chips) 
mi$$I$Elena: posts small blind $0.50
DIMAN_324: posts big blind $1
*** HOLE CARDS ***
Dealt to matiko09 [2c 6s]
Yuder_Lin: raises $2 to $3
mbk88: folds 
pyromid: folds 
matiko09: folds 
chenconhaste: folds 
arctur17: folds 
letmegonow: folds 
mi$$I$Elena: folds 
DIMAN_324: folds 
Uncalled bet ($2) returned to Yuder_Lin
Yuder_Lin collected $2.50 from pot
Yuder_Lin: doesn't show hand 
*** SUMMARY ***
Total pot $2.50 | Rake $0 
Seat 1: DIMAN_324 (big blind) folded before Flop
Seat 2: Yuder_Lin collected ($2.50)
Seat 3: mbk88 folded before Flop (didn't bet)
Seat 4: pyromid folded before Flop (didn't bet)
Seat 5: matiko09 folded before Flop (didn't bet)
Seat 6: chenconhaste folded before Flop (didn't bet)
Seat 7: arctur17 folded before Flop (didn't bet)
Seat 8: letmegonow (button) folded before Flop (didn't bet)
Seat 9: mi$$I$Elena (small blind) folded before Flop





PokerStars Hand #155012912876:  Hold'em No Limit ($0.50/$1.00 USD) - 2016/06/21 13:10:25 CET [2016/06/21 7:10:25 ET]
Table 'Moreau' 9-max Seat #3 is the button
Seat 1: ozone2003 ($128.99 in chips) 
Seat 2: nubpoker ($134.89 in chips) 
Seat 3: matiko09 ($102.62 in chips) 
Seat 4: bonesnz1 ($48.42 in chips) 
Seat 5: DIMAN_324 ($101.38 in chips) 
Seat 6: mbk88 ($100 in chips) 
Seat 7: PanKwn15 ($71.13 in chips) 
Seat 8: maxxmeister ($109.80 in chips) 
Seat 9: Toonersens ($113.42 in chips) 
bonesnz1: posts small blind $0.50
DIMAN_324: posts big blind $1
*** HOLE CARDS ***
Dealt to matiko09 [5h 3h]
mbk88: folds 
PanKwn15: folds 
maxxmeister: folds 
Toonersens: folds 
ozone2003: folds 
nubpoker: folds 
matiko09: folds 
bonesnz1: calls $0.50
DIMAN_324: checks 
*** FLOP *** [Qs 9s 7d]
bonesnz1: checks 
DIMAN_324: checks 
*** TURN *** [Qs 9s 7d] [9c]
bonesnz1: bets $1
DIMAN_324: folds 
Uncalled bet ($1) returned to bonesnz1
bonesnz1 collected $1.90 from pot
bonesnz1: doesn't show hand 
*** SUMMARY ***
Total pot $2 | Rake $0.10 
Board [Qs 9s 7d 9c]
Seat 1: ozone2003 folded before Flop (didn't bet)
Seat 2: nubpoker folded before Flop (didn't bet)
Seat 3: matiko09 (button) folded before Flop (didn't bet)
Seat 4: bonesnz1 (small blind) collected ($1.90)
Seat 5: DIMAN_324 (big blind) folded on the Turn
Seat 6: mbk88 folded before Flop (didn't bet)
Seat 7: PanKwn15 folded before Flop (didn't bet)
Seat 8: maxxmeister folded before Flop (didn't bet)
Seat 9: Toonersens folded before Flop (didn't bet)





PokerStars Hand #155012913317:  Hold'em No Limit (€0.25/€0.50 EUR) - 2016/06/21 13:10:26 CET [2016/06/21 7:10:26 ET]
Table 'Lotis II' 6-max Seat #4 is the button
Seat 1: acaestanemo (€50 in chips) 
Seat 2: broh202 (€110.02 in chips) 
Seat 3: bricasse1961 (€34.35 in chips) 
Seat 4: matiko09 (€76.39 in chips) 
Seat 5: AlexPles (€71.77 in chips) 
Seat 6: asmodej666 (€50 in chips) 
AlexPles: posts small blind €0.25
asmodej666: posts big blind €0.50
*** HOLE CARDS ***
Dealt to matiko09 [Th Jd]
acaestanemo: folds 
broh202: raises €1 to €1.50
bricasse1961: folds 
matiko09: folds 
AlexPles: folds 
asmodej666: folds 
Uncalled bet (€1) returned to broh202
broh202 collected €1.25 from pot
broh202: doesn't show hand 
*** SUMMARY ***
Total pot €1.25 | Rake €0 
Seat 1: acaestanemo folded before Flop (didn't bet)
Seat 2: broh202 collected (€1.25)
Seat 3: bricasse1961 folded before Flop (didn't bet)
Seat 4: matiko09 (button) folded before Flop (didn't bet)
Seat 5: AlexPles (small blind) folded before Flop
Seat 6: asmodej666 (big blind) folded before Flop





PokerStars Hand #155012913999:  Hold'em No Limit ($0.50/$1.00 USD) - 2016/06/21 13:10:28 CET [2016/06/21 7:10:28 ET]
Table 'Brauna II' 9-max Seat #2 is the button
Seat 1: wisbc ($153.36 in chips) 
Seat 2: pyromid ($142.02 in chips) 
Seat 3: matiko09 ($100 in chips) 
Seat 4: chenconhaste ($196.75 in chips) 
Seat 5: fukumimi ($100 in chips) 
Seat 6: mbk88 ($203.01 in chips) 
Seat 8: DIMAN_324 ($132.15 in chips) 
Seat 9: torkkdnm ($100 in chips) 
matiko09: posts small blind $0.50
chenconhaste: posts big blind $1
Troll8989: sits out 
*** HOLE CARDS ***
Dealt to matiko09 [4s 7c]
fukumimi: folds 
mbk88: raises $2 to $3
DIMAN_324: calls $3
torkkdnm: folds 
wisbc: folds 
pyromid: folds 
matiko09: folds 
chenconhaste: folds 
*** FLOP *** [Tc 8h 3c]
mbk88: bets $4
DIMAN_324: raises $8.50 to $12.50
mbk88: folds 
Uncalled bet ($8.50) returned to DIMAN_324
DIMAN_324 collected $14.72 from pot
DIMAN_324: doesn't show hand 
*** SUMMARY ***
Total pot $15.50 | Rake $0.78 
Board [Tc 8h 3c]
Seat 1: wisbc folded before Flop (didn't bet)
Seat 2: pyromid (button) folded before Flop (didn't bet)
Seat 3: matiko09 (small blind) folded before Flop
Seat 4: chenconhaste (big blind) folded before Flop
Seat 5: fukumimi folded before Flop (didn't bet)
Seat 6: mbk88 folded on the Flop
Seat 8: DIMAN_324 collected ($14.72)
Seat 9: torkkdnm folded before Flop (didn't bet)





PokerStars Hand #155012914723:  Hold'em No Limit ($0.50/$1.00 USD) - 2016/06/21 13:10:30 CET [2016/06/21 7:10:30 ET]
Table 'Lamberta II' 9-max Seat #8 is the button
Seat 1: Avtovo ($102.45 in chips) 
Seat 2: mavin80 ($96.92 in chips) 
Seat 3: matiko09 ($102 in chips) 
Seat 4: Eskimo Fox ($100 in chips) 
Seat 5: mi$$I$Elena ($100 in chips) 
Seat 8: chenconhaste ($103.90 in chips) 
Seat 9: Sjtu_Michael ($108.58 in chips) 
Sjtu_Michael: posts small blind $0.50
Avtovo: posts big blind $1
DIMAN_324: sits out 
*** HOLE CARDS ***
Dealt to matiko09 [6c Ts]
mavin80: folds 
matiko09: folds 
Eskimo Fox: raises $2 to $3
mi$$I$Elena: folds 
chenconhaste: folds 
Sjtu_Michael: folds 
Avtovo: folds 
Uncalled bet ($2) returned to Eskimo Fox
Eskimo Fox collected $2.50 from pot
Eskimo Fox: doesn't show hand 
*** SUMMARY ***
Total pot $2.50 | Rake $0 
Seat 1: Avtovo (big blind) folded before Flop
Seat 2: mavin80 folded before Flop (didn't bet)
Seat 3: matiko09 folded before Flop (didn't bet)
Seat 4: Eskimo Fox collected ($2.50)
Seat 5: mi$$I$Elena folded before Flop (didn't bet)
Seat 8: chenconhaste (button) folded before Flop (didn't bet)
Seat 9: Sjtu_Michael (small blind) folded before Flop





PokerStars Hand #155012918288:  Hold'em No Limit ($0.50/$1.00 USD) - 2016/06/21 13:10:38 CET [2016/06/21 7:10:38 ET]
Table 'Saldanha' 9-max Seat #5 is the button
Seat 1: IceSharK.AA ($59.77 in chips) 
Seat 2: matiko09 ($111.30 in chips) 
Seat 3: Avtovo ($100 in chips) 
Seat 4: 50CandyJoe ($100.82 in chips) 
Seat 5: Eskimo Fox ($100 in chips) 
Seat 6: SharingaaN ($78.80 in chips) 
Seat 7: chenconhaste ($100 in chips) 
Seat 8: pattexpro ($81.70 in chips) 
Seat 9: maxxmeister ($132.79 in chips) 
SharingaaN: posts small blind $0.50
chenconhaste: posts big blind $1
IceSharK.AA: posts the ante $0.20
matiko09: posts the ante $0.20
Avtovo: posts the ante $0.20
50CandyJoe: posts the ante $0.20
Eskimo Fox: posts the ante $0.20
SharingaaN: posts the ante $0.20
chenconhaste: posts the ante $0.20
pattexpro: posts the ante $0.20
maxxmeister: posts the ante $0.20
*** HOLE CARDS ***
Dealt to matiko09 [Ad Ac]
pattexpro: raises $1 to $2
maxxmeister: folds 
IceSharK.AA: raises $7.30 to $9.30
matiko09: calls $9.30
Avtovo: folds 
50CandyJoe: folds 
Eskimo Fox: folds 
SharingaaN: folds 
chenconhaste: folds 
pattexpro: calls $7.30
*** FLOP *** [2h 6d Qc]
pattexpro: checks 
IceSharK.AA: bets $22.82
matiko09: calls $22.82
pattexpro: folds 
*** TURN *** [2h 6d Qc] [5c]
IceSharK.AA: bets $27.45 and is all-in
matiko09: calls $27.45
*** RIVER *** [2h 6d Qc 5c] [5d]
*** SHOW DOWN ***
IceSharK.AA: shows [Js Jc] (two pair, Jacks and Fives)
matiko09: shows [Ad Ac] (two pair, Aces and Fives)
matiko09 collected $129.24 from pot
*** SUMMARY ***
Total pot $131.74 | Rake $2.50 
Board [2h 6d Qc 5c 5d]
Seat 1: IceSharK.AA showed [Js Jc] and lost with two pair, Jacks and Fives
Seat 2: matiko09 showed [Ad Ac] and won ($129.24) with two pair, Aces and Fives
Seat 3: Avtovo folded before Flop (didn't bet)
Seat 4: 50CandyJoe folded before Flop (didn't bet)
Seat 5: Eskimo Fox (button) folded before Flop (didn't bet)
Seat 6: SharingaaN (small blind) folded before Flop
Seat 7: chenconhaste (big blind) folded before Flop
Seat 8: pattexpro folded on the Flop
Seat 9: maxxmeister folded before Flop (didn't bet)





PokerStars Hand #155012920156:  Hold'em No Limit ($0.50/$1.00 USD) - 2016/06/21 13:10:43 CET [2016/06/21 7:10:43 ET]
Table 'Cheleb' 9-max Seat #1 is the button
Seat 1: SharingaaN ($112.93 in chips) 
Seat 2: pyromid ($136.38 in chips) 
Seat 3: bonesnz1 ($52.51 in chips) 
Seat 4: DIMAN_324 ($182.57 in chips) 
Seat 5: Avtovo ($137 in chips) 
Seat 6: matiko09 ($102.50 in chips) 
Seat 7: DomiVY ($40 in chips) 
Seat 8: Troll8989 ($100 in chips) 
Seat 9: chenconhaste ($116.52 in chips) 
pyromid: posts small blind $0.50
bonesnz1: posts big blind $1
*** HOLE CARDS ***
Dealt to matiko09 [5c Qd]
DIMAN_324: folds 
Avtovo: folds 
matiko09: folds 
DomiVY: folds 
Troll8989: folds 
chenconhaste: folds 
SharingaaN: raises $2 to $3
pyromid: folds 
bonesnz1: folds 
Uncalled bet ($2) returned to SharingaaN
SharingaaN collected $2.50 from pot
SharingaaN: doesn't show hand 
*** SUMMARY ***
Total pot $2.50 | Rake $0 
Seat 1: SharingaaN (button) collected ($2.50)
Seat 2: pyromid (small blind) folded before Flop
Seat 3: bonesnz1 (big blind) folded before Flop
Seat 4: DIMAN_324 folded before Flop (didn't bet)
Seat 5: Avtovo folded before Flop (didn't bet)
Seat 6: matiko09 folded before Flop (didn't bet)
Seat 7: DomiVY folded before Flop (didn't bet)
Seat 8: Troll8989 folded before Flop (didn't bet)
Seat 9: chenconhaste folded before Flop (didn't bet)





PokerStars Hand #155012920817:  Hold'em No Limit ($0.50/$1.00 USD) - 2016/06/21 13:10:44 CET [2016/06/21 7:10:44 ET]
Table 'Feronia' 9-max Seat #9 is the button
Seat 1: DIMAN_324 ($100.50 in chips) 
Seat 2: Yuder_Lin ($83.87 in chips) 
Seat 3: mbk88 ($126.75 in chips) 
Seat 4: pyromid ($127.36 in chips) 
Seat 5: matiko09 ($121.37 in chips) 
Seat 6: chenconhaste ($116.45 in chips) 
Seat 7: arctur17 ($102.45 in chips) 
Seat 8: letmegonow ($136.89 in chips) 
Seat 9: mi$$I$Elena ($151.04 in chips) 
DIMAN_324: posts small blind $0.50
Yuder_Lin: posts big blind $1
*** HOLE CARDS ***
Dealt to matiko09 [Qc 2s]
mbk88: folds 
pyromid: raises $1 to $2
matiko09: folds 
chenconhaste: raises $6 to $8
arctur17: folds 
letmegonow: folds 
mi$$I$Elena: folds 
DIMAN_324: folds 
Yuder_Lin: folds 
pyromid: folds 
Uncalled bet ($6) returned to chenconhaste
chenconhaste collected $5.50 from pot
*** SUMMARY ***
Total pot $5.50 | Rake $0 
Seat 1: DIMAN_324 (small blind) folded before Flop
Seat 2: Yuder_Lin (big blind) folded before Flop
Seat 3: mbk88 folded before Flop (didn't bet)
Seat 4: pyromid folded before Flop
Seat 5: matiko09 folded before Flop (didn't bet)
Seat 6: chenconhaste collected ($5.50)
Seat 7: arctur17 folded before Flop (didn't bet)
Seat 8: letmegonow folded before Flop (didn't bet)
Seat 9: mi$$I$Elena (button) folded before Flop (didn't bet)





PokerStars Hand #155012921307:  Hold'em No Limit ($0.50/$1.00 USD) - 2016/06/21 13:10:45 CET [2016/06/21 7:10:45 ET]
Table 'Carlova II' 9-max Seat #2 is the button
Seat 1: matiko09 ($115.80 in chips) 
Seat 2: chenconhaste ($121.23 in chips) 
Seat 3: King_Z�Manel ($104.95 in chips) 
Seat 4: Dandy Monk ($64.66 in chips) 
Seat 5: ozone2003 ($100 in chips) 
Seat 6: DIMAN_324 ($102.72 in chips) 
Seat 7: mi$$I$Elena ($107.25 in chips) 
Seat 8: pyromid ($87.21 in chips) 
Seat 9: Troll8989 ($104.68 in chips) 
King_Z�Manel: posts small blind $0.50
Dandy Monk: posts big blind $1
*** HOLE CARDS ***
Dealt to matiko09 [Js Ah]
ozone2003: folds 
DIMAN_324: raises $2 to $3
mi$$I$Elena: folds 
pyromid: folds 
Troll8989: folds 
matiko09: raises $7 to $10
chenconhaste: folds 
King_Z�Manel: folds 
Dandy Monk: folds 
DIMAN_324: folds 
Uncalled bet ($7) returned to matiko09
matiko09 collected $7.50 from pot
matiko09: doesn't show hand 
*** SUMMARY ***
Total pot $7.50 | Rake $0 
Seat 1: matiko09 collected ($7.50)
Seat 2: chenconhaste (button) folded before Flop (didn't bet)
Seat 3: King_Z�Manel (small blind) folded before Flop
Seat 4: Dandy Monk (big blind) folded before Flop
Seat 5: ozone2003 folded before Flop (didn't bet)
Seat 6: DIMAN_324 folded before Flop
Seat 7: mi$$I$Elena folded before Flop (didn't bet)
Seat 8: pyromid folded before Flop (didn't bet)
Seat 9: Troll8989 folded before Flop (didn't bet)





PokerStars Hand #155012921932:  Hold'em No Limit (€0.25/€0.50 EUR) - 2016/06/21 13:10:47 CET [2016/06/21 7:10:47 ET]
Table 'Lotis II' 6-max Seat #5 is the button
Seat 1: acaestanemo (€50 in chips) 
Seat 2: broh202 (€110.77 in chips) 
Seat 4: matiko09 (€76.39 in chips) 
Seat 5: AlexPles (€71.52 in chips) 
Seat 6: asmodej666 (€50 in chips) 
asmodej666: posts small blind €0.25
acaestanemo: posts big blind €0.50
*** HOLE CARDS ***
Dealt to matiko09 [5d 4s]
broh202: folds 
matiko09: folds 
AlexPles: folds 
asmodej666: calls €0.25
acaestanemo: checks 
*** FLOP *** [Js Tc Kh]
asmodej666: bets €0.50
acaestanemo: calls €0.50
*** TURN *** [Js Tc Kh] [Kd]
asmodej666: checks 
acaestanemo: bets €1.50
asmodej666: raises €4.50 to €6
acaestanemo: folds 
Uncalled bet (€4.50) returned to asmodej666
asmodej666 collected €4.75 from pot
asmodej666: doesn't show hand 
*** SUMMARY ***
Total pot €5 | Rake €0.25 
Board [Js Tc Kh Kd]
Seat 1: acaestanemo (big blind) folded on the Turn
Seat 2: broh202 folded before Flop (didn't bet)
Seat 4: matiko09 folded before Flop (didn't bet)
Seat 5: AlexPles (button) folded before Flop (didn't bet)
Seat 6: asmodej666 (small blind) collected (€4.75)





PokerStars Hand #155012923296:  Hold'em No Limit ($0.50/$1.00 USD) - 2016/06/21 13:10:50 CET [2016/06/21 7:10:50 ET]
Table 'Umbriel II' 9-max Seat #5 is the button
Seat 1: phil_cheng ($107 in chips) 
Seat 2: rura53 ($61.50 in chips) 
Seat 3: mxustin ($36.25 in chips) 
Seat 4: Eskimo Fox ($100 in chips) 
Seat 5: matiko09 ($143.96 in chips) 
Seat 6: maxxmeister ($103.58 in chips) 
Seat 7: chenconhaste ($172.10 in chips) 
Seat 8: ozone2003 ($124.84 in chips) 
Seat 9: Troll8989 ($100 in chips) 
maxxmeister: posts small blind $0.50
chenconhaste: posts big blind $1
*** HOLE CARDS ***
Dealt to matiko09 [4c 8c]
ozone2003: folds 
Troll8989: folds 
phil_cheng: folds 
rura53: folds 
mxustin: folds 
Eskimo Fox: folds 
matiko09: folds 
maxxmeister: folds 
Uncalled bet ($0.50) returned to chenconhaste
chenconhaste collected $1 from pot
*** SUMMARY ***
Total pot $1 | Rake $0 
Seat 1: phil_cheng folded before Flop (didn't bet)
Seat 2: rura53 folded before Flop (didn't bet)
Seat 3: mxustin folded before Flop (didn't bet)
Seat 4: Eskimo Fox folded before Flop (didn't bet)
Seat 5: matiko09 (button) folded before Flop (didn't bet)
Seat 6: maxxmeister (small blind) folded before Flop
Seat 7: chenconhaste (big blind) collected ($1)
Seat 8: ozone2003 folded before Flop (didn't bet)
Seat 9: Troll8989 folded before Flop (didn't bet)





PokerStars Hand #155012924429:  Hold'em No Limit ($0.50/$1.00 USD) - 2016/06/21 13:10:53 CET [2016/06/21 7:10:53 ET]
Table 'Rupertwildt' 9-max Seat #4 is the button
Seat 1: pokernixxx ($62.87 in chips) 
Seat 2: SharingaaN ($76.50 in chips) 
Seat 3: Saymon_Moo ($77.58 in chips) 
Seat 4: matiko09 ($149.18 in chips) 
Seat 5: pyromid ($79.46 in chips) 
Seat 6: ozone2003 ($135.72 in chips) 
Seat 7: chenconhaste ($102.34 in chips) 
Seat 8: Gonzanary ($112.14 in chips) 
Seat 9: mbk88 ($118.43 in chips) 
pyromid: posts small blind $0.50
ozone2003: posts big blind $1
*** HOLE CARDS ***
Dealt to matiko09 [9s 4c]
chenconhaste: folds 
Gonzanary has timed out
Gonzanary: folds 
mbk88: raises $2 to $3
pokernixxx: calls $3
SharingaaN: folds 
Saymon_Moo: folds 
matiko09: folds 
pyromid: folds 
ozone2003: folds 
*** FLOP *** [Qc 6s 8d]
mbk88: checks 
pokernixxx: checks 
*** TURN *** [Qc 6s 8d] [Ts]
mbk88: checks 
pokernixxx: bets $7
mbk88: calls $7
*** RIVER *** [Qc 6s 8d Ts] [Ad]
mbk88: checks 
pokernixxx: bets $21
mbk88: folds 
Uncalled bet ($21) returned to pokernixxx
pokernixxx collected $20.42 from pot
pokernixxx: doesn't show hand 
*** SUMMARY ***
Total pot $21.50 | Rake $1.08 
Board [Qc 6s 8d Ts Ad]
Seat 1: pokernixxx collected ($20.42)
Seat 2: SharingaaN folded before Flop (didn't bet)
Seat 3: Saymon_Moo folded before Flop (didn't bet)
Seat 4: matiko09 (button) folded before Flop (didn't bet)
Seat 5: pyromid (small blind) folded before Flop
Seat 6: ozone2003 (big blind) folded before Flop
Seat 7: chenconhaste folded before Flop (didn't bet)
Seat 8: Gonzanary folded before Flop (didn't bet)
Seat 9: mbk88 folded on the River





PokerStars Hand #155012925330:  Hold'em No Limit ($0.50/$1.00 USD) - 2016/06/21 13:10:55 CET [2016/06/21 7:10:55 ET]
Table 'Leo' 9-max Seat #2 is the button
Seat 1: letmegonow ($41.07 in chips) 
Seat 2: torkkdnm ($164.16 in chips) 
Seat 3: matiko09 ($102.30 in chips) 
Seat 4: SharingaaN ($103.45 in chips) 
Seat 5: DIMAN_324 ($113.16 in chips) 
Seat 6: chenconhaste ($117.92 in chips) 
Seat 7: maxxmeister ($100 in chips) 
Seat 8: pyromid ($58.92 in chips) 
Seat 9: Wladimir205 ($115.08 in chips) 
matiko09: posts small blind $0.50
SharingaaN: posts big blind $1
*** HOLE CARDS ***
Dealt to matiko09 [4h 8s]
DIMAN_324: folds 
chenconhaste: folds 
maxxmeister: folds 
pyromid: folds 
Wladimir205: folds 
letmegonow: folds 
torkkdnm: raises $1 to $2
matiko09: folds 
SharingaaN: folds 
Uncalled bet ($1) returned to torkkdnm
torkkdnm collected $2.50 from pot
*** SUMMARY ***
Total pot $2.50 | Rake $0 
Seat 1: letmegonow folded before Flop (didn't bet)
Seat 2: torkkdnm (button) collected ($2.50)
Seat 3: matiko09 (small blind) folded before Flop
Seat 4: SharingaaN (big blind) folded before Flop
Seat 5: DIMAN_324 folded before Flop (didn't bet)
Seat 6: chenconhaste folded before Flop (didn't bet)
Seat 7: maxxmeister folded before Flop (didn't bet)
Seat 8: pyromid folded before Flop (didn't bet)
Seat 9: Wladimir205 folded before Flop (didn't bet)





PokerStars Hand #155012931124:  Hold'em No Limit ($0.50/$1.00 USD) - 2016/06/21 13:11:09 CET [2016/06/21 7:11:09 ET]
Table 'Lamberta II' 9-max Seat #9 is the button
Seat 1: Avtovo ($101.45 in chips) 
Seat 2: mavin80 ($96.92 in chips) 
Seat 3: matiko09 ($102 in chips) 
Seat 4: Eskimo Fox ($101.50 in chips) 
Seat 5: mi$$I$Elena ($100 in chips) 
Seat 8: chenconhaste ($103.90 in chips) 
Seat 9: Sjtu_Michael ($108.08 in chips) 
Avtovo: posts small blind $0.50
mavin80: posts big blind $1
DIMAN_324: sits out 
*** HOLE CARDS ***
Dealt to matiko09 [Qh Js]
matiko09: folds 
Eskimo Fox: folds 
mi$$I$Elena: folds 
chenconhaste: folds 
Sjtu_Michael: folds 
Avtovo: raises $1.50 to $2.50
mavin80: folds 
Uncalled bet ($1.50) returned to Avtovo
Avtovo collected $2 from pot
Avtovo: doesn't show hand 
*** SUMMARY ***
Total pot $2 | Rake $0 
Seat 1: Avtovo (small blind) collected ($2)
Seat 2: mavin80 (big blind) folded before Flop
Seat 3: matiko09 folded before Flop (didn't bet)
Seat 4: Eskimo Fox folded before Flop (didn't bet)
Seat 5: mi$$I$Elena folded before Flop (didn't bet)
Seat 8: chenconhaste folded before Flop (didn't bet)
Seat 9: Sjtu_Michael (button) folded before Flop (didn't bet)





PokerStars Hand #155012931203:  Hold'em No Limit ($0.50/$1.00 USD) - 2016/06/21 13:11:09 CET [2016/06/21 7:11:09 ET]
Table 'Umbriel II' 9-max Seat #6 is the button
Seat 1: phil_cheng ($107 in chips) 
Seat 2: rura53 ($61.50 in chips) 
Seat 3: mxustin ($36.25 in chips) 
Seat 4: Eskimo Fox ($100 in chips) 
Seat 5: matiko09 ($143.96 in chips) 
Seat 6: maxxmeister ($103.08 in chips) 
Seat 7: chenconhaste ($172.60 in chips) 
Seat 8: ozone2003 ($124.84 in chips) 
Seat 9: Troll8989 ($100 in chips) 
chenconhaste: posts small blind $0.50
ozone2003: posts big blind $1
*** HOLE CARDS ***
Dealt to matiko09 [6h 7d]
Troll8989: folds 
phil_cheng: raises $2 to $3
rura53: folds 
mxustin: folds 
Eskimo Fox: folds 
matiko09: folds 
maxxmeister: folds 
chenconhaste: folds 
ozone2003: calls $2
*** FLOP *** [7s 6d 3h]
ozone2003: checks 
phil_cheng: bets $3.09
ozone2003: calls $3.09
*** TURN *** [7s 6d 3h] [5s]
ozone2003: checks 
phil_cheng: checks 
*** RIVER *** [7s 6d 3h 5s] [8d]
ozone2003: bets $10.59
phil_cheng: folds 
Uncalled bet ($10.59) returned to ozone2003
ozone2003 collected $12.05 from pot
ozone2003: doesn't show hand 
*** SUMMARY ***
Total pot $12.68 | Rake $0.63 
Board [7s 6d 3h 5s 8d]
Seat 1: phil_cheng folded on the River
Seat 2: rura53 folded before Flop (didn't bet)
Seat 3: mxustin folded before Flop (didn't bet)
Seat 4: Eskimo Fox folded before Flop (didn't bet)
Seat 5: matiko09 folded before Flop (didn't bet)
Seat 6: maxxmeister (button) folded before Flop (didn't bet)
Seat 7: chenconhaste (small blind) folded before Flop
Seat 8: ozone2003 (big blind) collected ($12.05)
Seat 9: Troll8989 folded before Flop (didn't bet)





PokerStars Hand #155012933746:  Hold'em No Limit ($0.50/$1.00 USD) - 2016/06/21 13:11:15 CET [2016/06/21 7:11:15 ET]
Table 'Leo' 9-max Seat #3 is the button
Seat 1: letmegonow ($41.07 in chips) 
Seat 2: torkkdnm ($165.66 in chips) 
Seat 3: matiko09 ($101.80 in chips) 
Seat 4: SharingaaN ($102.45 in chips) 
Seat 5: DIMAN_324 ($113.16 in chips) 
Seat 6: chenconhaste ($117.92 in chips) 
Seat 7: maxxmeister ($100 in chips) 
Seat 8: pyromid ($58.92 in chips) 
Seat 9: Wladimir205 ($115.08 in chips) 
SharingaaN: posts small blind $0.50
DIMAN_324: posts big blind $1
*** HOLE CARDS ***
Dealt to matiko09 [Qs 7c]
chenconhaste: folds 
maxxmeister: raises $2.50 to $3.50
pyromid: folds 
Wladimir205: folds 
letmegonow: calls $3.50
torkkdnm: raises $8.50 to $12
matiko09: folds 
SharingaaN: folds 
DIMAN_324: folds 
maxxmeister: folds 
letmegonow: folds 
Uncalled bet ($8.50) returned to torkkdnm
torkkdnm collected $12 from pot
*** SUMMARY ***
Total pot $12 | Rake $0 
Seat 1: letmegonow folded before Flop
Seat 2: torkkdnm collected ($12)
Seat 3: matiko09 (button) folded before Flop (didn't bet)
Seat 4: SharingaaN (small blind) folded before Flop
Seat 5: DIMAN_324 (big blind) folded before Flop
Seat 6: chenconhaste folded before Flop (didn't bet)
Seat 7: maxxmeister folded before Flop
Seat 8: pyromid folded before Flop (didn't bet)
Seat 9: Wladimir205 folded before Flop (didn't bet)





PokerStars Hand #155012937367:  Hold'em No Limit (€0.25/€0.50 EUR) - 2016/06/21 13:11:24 CET [2016/06/21 7:11:24 ET]
Table 'Actor II' 6-max Seat #1 is the button
Seat 1: hmverlin (€92 in chips) 
Seat 2: ooak182 (€55.95 in chips) 
Seat 3: asmodej666 (€88.55 in chips) 
Seat 4: matiko09 (€50.75 in chips) 
Seat 5: Rybka1294 (€50 in chips) 
Seat 6: fanmtZ (€20 in chips) 
ooak182: posts small blind €0.25
asmodej666: posts big blind €0.50
*** HOLE CARDS ***
Dealt to matiko09 [9h 8c]
matiko09: folds 
Rybka1294: folds 
fanmtZ: folds 
hmverlin: raises €1 to €1.50
ooak182: calls €1.25
asmodej666: raises €5 to €6.50
hmverlin: folds 
ooak182: folds 
Uncalled bet (€5) returned to asmodej666
asmodej666 collected €4.50 from pot
asmodej666: doesn't show hand 
*** SUMMARY ***
Total pot €4.50 | Rake €0 
Seat 1: hmverlin (button) folded before Flop
Seat 2: ooak182 (small blind) folded before Flop
Seat 3: asmodej666 (big blind) collected (€4.50)
Seat 4: matiko09 folded before Flop (didn't bet)
Seat 5: Rybka1294 folded before Flop (didn't bet)
Seat 6: fanmtZ folded before Flop (didn't bet)





PokerStars Hand #155012938205:  Hold'em No Limit ($0.50/$1.00 USD) - 2016/06/21 13:11:26 CET [2016/06/21 7:11:26 ET]
Table 'Feronia' 9-max Seat #1 is the button
Seat 1: DIMAN_324 ($100 in chips) 
Seat 2: Yuder_Lin ($82.87 in chips) 
Seat 3: mbk88 ($126.75 in chips) 
Seat 4: pyromid ($125.36 in chips) 
Seat 5: matiko09 ($121.37 in chips) 
Seat 6: chenconhaste ($119.95 in chips) 
Seat 7: arctur17 ($102.45 in chips) 
Seat 8: letmegonow ($136.89 in chips) 
Seat 9: mi$$I$Elena ($151.04 in chips) 
Yuder_Lin: posts small blind $0.50
mbk88: posts big blind $1
*** HOLE CARDS ***
Dealt to matiko09 [4c 6d]
pyromid: folds 
matiko09: folds 
chenconhaste: folds 
arctur17: folds 
letmegonow: folds 
mi$$I$Elena: folds 
DIMAN_324: raises $1.10 to $2.10
Yuder_Lin: calls $1.60
mbk88: raises $8.90 to $11
DIMAN_324: folds 
Yuder_Lin: folds 
Uncalled bet ($8.90) returned to mbk88
mbk88 collected $6.30 from pot
mbk88: doesn't show hand 
*** SUMMARY ***
Total pot $6.30 | Rake $0 
Seat 1: DIMAN_324 (button) folded before Flop
Seat 2: Yuder_Lin (small blind) folded before Flop
Seat 3: mbk88 (big blind) collected ($6.30)
Seat 4: pyromid folded before Flop (didn't bet)
Seat 5: matiko09 folded before Flop (didn't bet)
Seat 6: chenconhaste folded before Flop (didn't bet)
Seat 7: arctur17 folded before Flop (didn't bet)
Seat 8: letmegonow folded before Flop (didn't bet)
Seat 9: mi$$I$Elena folded before Flop (didn't bet)





PokerStars Hand #155012938878:  Hold'em No Limit ($0.50/$1.00 USD) - 2016/06/21 13:11:27 CET [2016/06/21 7:11:27 ET]
Table 'Moreau' 9-max Seat #4 is the button
Seat 1: ozone2003 ($128.99 in chips) 
Seat 2: nubpoker ($134.89 in chips) 
Seat 3: matiko09 ($102.62 in chips) 
Seat 4: bonesnz1 ($49.32 in chips) 
Seat 5: DIMAN_324 ($100.38 in chips) 
Seat 6: mbk88 ($100 in chips) 
Seat 7: PanKwn15 ($71.13 in chips) 
Seat 8: maxxmeister ($109.80 in chips) 
Seat 9: Toonersens ($113.42 in chips) 
DIMAN_324: posts small blind $0.50
mbk88: posts big blind $1
*** HOLE CARDS ***
Dealt to matiko09 [9c 5d]
PanKwn15: folds 
maxxmeister: folds 
Toonersens: folds 
ozone2003: raises $2 to $3
nubpoker: folds 
matiko09: folds 
bonesnz1: folds 
DIMAN_324: folds 
mbk88: folds 
Uncalled bet ($2) returned to ozone2003
ozone2003 collected $2.50 from pot
ozone2003: doesn't show hand 
*** SUMMARY ***
Total pot $2.50 | Rake $0 
Seat 1: ozone2003 collected ($2.50)
Seat 2: nubpoker folded before Flop (didn't bet)
Seat 3: matiko09 folded before Flop (didn't bet)
Seat 4: bonesnz1 (button) folded before Flop (didn't bet)
Seat 5: DIMAN_324 (small blind) folded before Flop
Seat 6: mbk88 (big blind) folded before Flop
Seat 7: PanKwn15 folded before Flop (didn't bet)
Seat 8: maxxmeister folded before Flop (didn't bet)
Seat 9: Toonersens folded before Flop (didn't bet)





PokerStars Hand #155012938970:  Hold'em No Limit ($0.50/$1.00 USD) - 2016/06/21 13:11:28 CET [2016/06/21 7:11:28 ET]
Table 'Cheleb' 9-max Seat #2 is the button
Seat 1: SharingaaN ($114.43 in chips) 
Seat 2: pyromid ($135.88 in chips) 
Seat 3: bonesnz1 ($51.51 in chips) 
Seat 4: DIMAN_324 ($182.57 in chips) 
Seat 5: Avtovo ($137 in chips) 
Seat 6: matiko09 ($102.50 in chips) 
Seat 7: DomiVY ($40 in chips) 
Seat 8: Troll8989 ($100 in chips) 
Seat 9: chenconhaste ($116.52 in chips) 
bonesnz1: posts small blind $0.50
DIMAN_324: posts big blind $1
*** HOLE CARDS ***
Dealt to matiko09 [4s 3s]
Avtovo: folds 
matiko09: folds 
DomiVY: folds 
Troll8989: folds 
chenconhaste: folds 
SharingaaN: folds 
pyromid: folds 
bonesnz1: calls $0.50
DIMAN_324: raises $3 to $4
bonesnz1: calls $3
*** FLOP *** [9h 2c 6c]
bonesnz1: bets $1
DIMAN_324: raises $5.50 to $6.50
bonesnz1: folds 
Uncalled bet ($5.50) returned to DIMAN_324
DIMAN_324 collected $9.50 from pot
DIMAN_324: doesn't show hand 
*** SUMMARY ***
Total pot $10 | Rake $0.50 
Board [9h 2c 6c]
Seat 1: SharingaaN folded before Flop (didn't bet)
Seat 2: pyromid (button) folded before Flop (didn't bet)
Seat 3: bonesnz1 (small blind) folded on the Flop
Seat 4: DIMAN_324 (big blind) collected ($9.50)
Seat 5: Avtovo folded before Flop (didn't bet)
Seat 6: matiko09 folded before Flop (didn't bet)
Seat 7: DomiVY folded before Flop (didn't bet)
Seat 8: Troll8989 folded before Flop (didn't bet)
Seat 9: chenconhaste folded before Flop (didn't bet)





PokerStars Hand #155012939053:  Hold'em No Limit ($0.50/$1.00 USD) - 2016/06/21 13:11:28 CET [2016/06/21 7:11:28 ET]
Table 'Lamberta II' 9-max Seat #1 is the button
Seat 1: Avtovo ($102.45 in chips) 
Seat 2: mavin80 ($95.92 in chips) 
Seat 3: matiko09 ($102 in chips) 
Seat 4: Eskimo Fox ($101.50 in chips) 
Seat 5: mi$$I$Elena ($100 in chips) 
Seat 8: chenconhaste ($103.90 in chips) 
Seat 9: Sjtu_Michael ($108.08 in chips) 
mavin80: posts small blind $0.50
matiko09: posts big blind $1
DIMAN_324: sits out 
*** HOLE CARDS ***
Dealt to matiko09 [Td 3c]
Eskimo Fox: folds 
mi$$I$Elena: folds 
chenconhaste: folds 
Sjtu_Michael: folds 
Avtovo: folds 
mavin80: folds 
Uncalled bet ($0.50) returned to matiko09
matiko09 collected $1 from pot
matiko09: doesn't show hand 
*** SUMMARY ***
Total pot $1 | Rake $0 
Seat 1: Avtovo (button) folded before Flop (didn't bet)
Seat 2: mavin80 (small blind) folded before Flop
Seat 3: matiko09 (big blind) collected ($1)
Seat 4: Eskimo Fox folded before Flop (didn't bet)
Seat 5: mi$$I$Elena folded before Flop (didn't bet)
Seat 8: chenconhaste folded before Flop (didn't bet)
Seat 9: Sjtu_Michael folded before Flop (didn't bet)





PokerStars Hand #155012939464:  Hold'em No Limit ($0.50/$1.00 USD) - 2016/06/21 13:11:29 CET [2016/06/21 7:11:29 ET]
Table 'Brauna II' 9-max Seat #3 is the button
Seat 1: wisbc ($153.36 in chips) 
Seat 2: pyromid ($142.02 in chips) 
Seat 3: matiko09 ($100 in chips) 
Seat 4: chenconhaste ($195.75 in chips) 
Seat 5: fukumimi ($100 in chips) 
Seat 6: mbk88 ($196.01 in chips) 
Seat 8: DIMAN_324 ($139.87 in chips) 
Seat 9: torkkdnm ($100 in chips) 
chenconhaste: posts small blind $0.50
fukumimi: posts big blind $1
Troll8989: sits out 
*** HOLE CARDS ***
Dealt to matiko09 [Jh 3h]
mbk88: folds 
DIMAN_324: folds 
torkkdnm: folds 
wisbc: raises $2 to $3
pyromid: folds 
matiko09: folds 
chenconhaste: folds 
fukumimi: folds 
Uncalled bet ($2) returned to wisbc
wisbc collected $2.50 from pot
wisbc: doesn't show hand 
*** SUMMARY ***
Total pot $2.50 | Rake $0 
Seat 1: wisbc collected ($2.50)
Seat 2: pyromid folded before Flop (didn't bet)
Seat 3: matiko09 (button) folded before Flop (didn't bet)
Seat 4: chenconhaste (small blind) folded before Flop
Seat 5: fukumimi (big blind) folded before Flop
Seat 6: mbk88 folded before Flop (didn't bet)
Seat 8: DIMAN_324 folded before Flop (didn't bet)
Seat 9: torkkdnm folded before Flop (didn't bet)





PokerStars Hand #155012939982:  Hold'em No Limit ($0.50/$1.00 USD) - 2016/06/21 13:11:30 CET [2016/06/21 7:11:30 ET]
Table 'Saldanha' 9-max Seat #6 is the button
Seat 2: matiko09 ($180.77 in chips) 
Seat 3: Avtovo ($100 in chips) 
Seat 4: 50CandyJoe ($100.62 in chips) 
Seat 5: Eskimo Fox ($100 in chips) 
Seat 6: SharingaaN ($78.10 in chips) 
Seat 7: chenconhaste ($100 in chips) 
Seat 8: pattexpro ($72.20 in chips) 
Seat 9: maxxmeister ($132.59 in chips) 
chenconhaste: posts small blind $0.50
pattexpro: posts big blind $1
matiko09: posts the ante $0.20
Avtovo: posts the ante $0.20
50CandyJoe: posts the ante $0.20
Eskimo Fox: posts the ante $0.20
SharingaaN: posts the ante $0.20
chenconhaste: posts the ante $0.20
pattexpro: posts the ante $0.20
maxxmeister: posts the ante $0.20
*** HOLE CARDS ***
Dealt to matiko09 [Jc Qd]
IceSharK.AA leaves the table
maxxmeister: folds 
SanychStar joins the table at seat #1 
matiko09: folds 
Avtovo: folds 
50CandyJoe: raises $2 to $3
Eskimo Fox: folds 
SharingaaN: folds 
chenconhaste: folds 
pattexpro: calls $2
*** FLOP *** [4s 9d 8c]
pattexpro: checks 
50CandyJoe: bets $3.85
pattexpro: folds 
Uncalled bet ($3.85) returned to 50CandyJoe
50CandyJoe collected $7.70 from pot
50CandyJoe: doesn't show hand 
*** SUMMARY ***
Total pot $8.10 | Rake $0.40 
Board [4s 9d 8c]
Seat 2: matiko09 folded before Flop (didn't bet)
Seat 3: Avtovo folded before Flop (didn't bet)
Seat 4: 50CandyJoe collected ($7.70)
Seat 5: Eskimo Fox folded before Flop (didn't bet)
Seat 6: SharingaaN (button) folded before Flop (didn't bet)
Seat 7: chenconhaste (small blind) folded before Flop
Seat 8: pattexpro (big blind) folded on the Flop
Seat 9: maxxmeister folded before Flop (didn't bet)





PokerStars Hand #155012940908:  Hold'em No Limit ($0.50/$1.00 USD) - 2016/06/21 13:11:32 CET [2016/06/21 7:11:32 ET]
Table 'Carlova II' 9-max Seat #3 is the button
Seat 1: matiko09 ($120.30 in chips) 
Seat 2: chenconhaste ($121.23 in chips) 
Seat 3: King_Z�Manel ($104.45 in chips) 
Seat 4: Dandy Monk ($63.66 in chips) 
Seat 5: ozone2003 ($100 in chips) 
Seat 6: DIMAN_324 ($100 in chips) 
Seat 7: mi$$I$Elena ($107.25 in chips) 
Seat 8: pyromid ($87.21 in chips) 
Seat 9: Troll8989 ($104.68 in chips) 
Dandy Monk: posts small blind $0.50
ozone2003: posts big blind $1
*** HOLE CARDS ***
Dealt to matiko09 [8d Kh]
DIMAN_324: folds 
mi$$I$Elena: folds 
pyromid: folds 
Troll8989: folds 
matiko09: folds 
chenconhaste: folds 
King_Z�Manel: raises $1 to $2
Dandy Monk: calls $1.50
ozone2003: folds 
*** FLOP *** [Jd 2d 9s]
Dandy Monk: bets $2.50
King_Z�Manel: folds 
Uncalled bet ($2.50) returned to Dandy Monk
Dandy Monk collected $4.75 from pot
Dandy Monk: doesn't show hand 
*** SUMMARY ***
Total pot $5 | Rake $0.25 
Board [Jd 2d 9s]
Seat 1: matiko09 folded before Flop (didn't bet)
Seat 2: chenconhaste folded before Flop (didn't bet)
Seat 3: King_Z�Manel (button) folded on the Flop
Seat 4: Dandy Monk (small blind) collected ($4.75)
Seat 5: ozone2003 (big blind) folded before Flop
Seat 6: DIMAN_324 folded before Flop (didn't bet)
Seat 7: mi$$I$Elena folded before Flop (didn't bet)
Seat 8: pyromid folded before Flop (didn't bet)
Seat 9: Troll8989 folded before Flop (didn't bet)





PokerStars Hand #155012942772:  Hold'em No Limit (€0.25/€0.50 EUR) - 2016/06/21 13:11:37 CET [2016/06/21 7:11:37 ET]
Table 'Lotis II' 6-max Seat #6 is the button
Seat 1: acaestanemo (€50 in chips) 
Seat 2: broh202 (€110.77 in chips) 
Seat 4: matiko09 (€76.39 in chips) 
Seat 5: AlexPles (€71.52 in chips) 
Seat 6: asmodej666 (€52.25 in chips) 
acaestanemo: posts small blind €0.25
broh202: posts big blind €0.50
*** HOLE CARDS ***
Dealt to matiko09 [Jc 5c]
matiko09: folds 
AlexPles: folds 
asmodej666: raises €0.62 to €1.12
acaestanemo: calls €0.87
broh202: folds 
*** FLOP *** [4c As 8s]
acaestanemo: checks 
asmodej666: bets €1.50
acaestanemo: calls €1.50
*** TURN *** [4c As 8s] [Tc]
acaestanemo: checks 
asmodej666: bets €4.50
acaestanemo: calls €4.50
*** RIVER *** [4c As 8s Tc] [Ts]
acaestanemo: checks 
asmodej666: bets €9.75
acaestanemo: folds 
Uncalled bet (€9.75) returned to asmodej666
asmodej666 collected €14 from pot
asmodej666: doesn't show hand 
*** SUMMARY ***
Total pot €14.74 | Rake €0.74 
Board [4c As 8s Tc Ts]
Seat 1: acaestanemo (small blind) folded on the River
Seat 2: broh202 (big blind) folded before Flop
Seat 4: matiko09 folded before Flop (didn't bet)
Seat 5: AlexPles folded before Flop (didn't bet)
Seat 6: asmodej666 (button) collected (€14)





PokerStars Hand #155012947157:  Hold'em No Limit (€0.25/€0.50 EUR) - 2016/06/21 13:11:47 CET [2016/06/21 7:11:47 ET]
Table 'Actor II' 6-max Seat #2 is the button
Seat 1: hmverlin (€90.50 in chips) 
Seat 2: ooak182 (€54.45 in chips) 
Seat 3: asmodej666 (€91.55 in chips) 
Seat 4: matiko09 (€50.75 in chips) 
Seat 5: Rybka1294 (€50 in chips) 
Seat 6: fanmtZ (€20 in chips) 
asmodej666: posts small blind €0.25
matiko09: posts big blind €0.50
*** HOLE CARDS ***
Dealt to matiko09 [3s 7d]
Rybka1294: folds 
fanmtZ: raises €0.69 to €1.19
hmverlin: raises €3.13 to €4.32
ooak182: folds 
asmodej666: folds 
matiko09: folds 
fanmtZ: folds 
Uncalled bet (€3.13) returned to hmverlin
hmverlin collected €3.13 from pot
hmverlin: doesn't show hand 
*** SUMMARY ***
Total pot €3.13 | Rake €0 
Seat 1: hmverlin collected (€3.13)
Seat 2: ooak182 (button) folded before Flop (didn't bet)
Seat 3: asmodej666 (small blind) folded before Flop
Seat 4: matiko09 (big blind) folded before Flop
Seat 5: Rybka1294 folded before Flop (didn't bet)
Seat 6: fanmtZ folded before Flop





PokerStars Hand #155012948190:  Hold'em No Limit ($0.50/$1.00 USD) - 2016/06/21 13:11:50 CET [2016/06/21 7:11:50 ET]
Table 'Brauna II' 9-max Seat #4 is the button
Seat 1: wisbc ($154.86 in chips) 
Seat 2: pyromid ($142.02 in chips) 
Seat 3: matiko09 ($100 in chips) 
Seat 4: chenconhaste ($195.25 in chips) 
Seat 5: fukumimi ($99 in chips) 
Seat 6: mbk88 ($196.01 in chips) 
Seat 8: DIMAN_324 ($139.87 in chips) 
Seat 9: torkkdnm ($100 in chips) 
fukumimi: posts small blind $0.50
mbk88: posts big blind $1
Troll8989: sits out 
*** HOLE CARDS ***
Dealt to matiko09 [Ad 4c]
DIMAN_324: folds 
torkkdnm: folds 
wisbc: raises $1.50 to $2.50
pyromid: folds 
matiko09: folds 
chenconhaste: folds 
fukumimi: folds 
mbk88: calls $1.50
*** FLOP *** [4h Qd Kd]
mbk88: checks 
wisbc: bets $3.25
mbk88: calls $3.25
*** TURN *** [4h Qd Kd] [8c]
mbk88: checks 
wisbc: bets $9
mbk88: raises $19 to $28
wisbc: calls $19
*** RIVER *** [4h Qd Kd 8c] [Qc]
mbk88: checks 
wisbc: bets $38
mbk88: folds 
Uncalled bet ($38) returned to wisbc
wisbc collected $65.50 from pot
wisbc: doesn't show hand 
*** SUMMARY ***
Total pot $68 | Rake $2.50 
Board [4h Qd Kd 8c Qc]
Seat 1: wisbc collected ($65.50)
Seat 2: pyromid folded before Flop (didn't bet)
Seat 3: matiko09 folded before Flop (didn't bet)
Seat 4: chenconhaste (button) folded before Flop (didn't bet)
Seat 5: fukumimi (small blind) folded before Flop
Seat 6: mbk88 (big blind) folded on the River
Seat 8: DIMAN_324 folded before Flop (didn't bet)
Seat 9: torkkdnm folded before Flop (didn't bet)





PokerStars Hand #155012960574:  Hold'em No Limit ($0.50/$1.00 USD) - 2016/06/21 13:11:57 CET [2016/06/21 7:11:57 ET]
Table 'Leo' 9-max Seat #4 is the button
Seat 1: letmegonow ($37.57 in chips) 
Seat 2: torkkdnm ($174.16 in chips) 
Seat 3: matiko09 ($101.80 in chips) 
Seat 4: SharingaaN ($101.95 in chips) 
Seat 5: DIMAN_324 ($112.16 in chips) 
Seat 6: chenconhaste ($117.92 in chips) 
Seat 7: maxxmeister ($100 in chips) 
Seat 8: pyromid ($98.92 in chips) 
Seat 9: Wladimir205 ($115.08 in chips) 
DIMAN_324: posts small blind $0.50
chenconhaste: posts big blind $1
*** HOLE CARDS ***
Dealt to matiko09 [3c 8s]
maxxmeister: folds 
pyromid: folds 
Wladimir205: folds 
letmegonow: calls $1
torkkdnm: raises $3 to $4
matiko09: folds 
SharingaaN: folds 
DIMAN_324: folds 
chenconhaste: folds 
letmegonow: raises $8 to $12
torkkdnm: folds 
Uncalled bet ($8) returned to letmegonow
letmegonow collected $9.50 from pot
*** SUMMARY ***
Total pot $9.50 | Rake $0 
Seat 1: letmegonow collected ($9.50)
Seat 2: torkkdnm folded before Flop
Seat 3: matiko09 folded before Flop (didn't bet)
Seat 4: SharingaaN (button) folded before Flop (didn't bet)
Seat 5: DIMAN_324 (small blind) folded before Flop
Seat 6: chenconhaste (big blind) folded before Flop
Seat 7: maxxmeister folded before Flop (didn't bet)
Seat 8: pyromid folded before Flop (didn't bet)
Seat 9: Wladimir205 folded before Flop (didn't bet)





PokerStars Hand #155012961400:  Hold'em No Limit ($0.50/$1.00 USD) - 2016/06/21 13:11:59 CET [2016/06/21 7:11:59 ET]
Table 'Lamberta II' 9-max Seat #2 is the button
Seat 1: Avtovo ($102.45 in chips) 
Seat 2: mavin80 ($95.42 in chips) 
Seat 3: matiko09 ($102.50 in chips) 
Seat 4: Eskimo Fox ($101.50 in chips) 
Seat 5: mi$$I$Elena ($100 in chips) 
Seat 8: chenconhaste ($103.90 in chips) 
Seat 9: Sjtu_Michael ($108.08 in chips) 
matiko09: posts small blind $0.50
Eskimo Fox: posts big blind $1
DIMAN_324: sits out 
*** HOLE CARDS ***
Dealt to matiko09 [Jd 7h]
mi$$I$Elena: folds 
chenconhaste: folds 
Sjtu_Michael: folds 
Avtovo: folds 
mavin80: folds 
matiko09: folds 
Uncalled bet ($0.50) returned to Eskimo Fox
Eskimo Fox collected $1 from pot
Eskimo Fox: doesn't show hand 
*** SUMMARY ***
Total pot $1 | Rake $0 
Seat 1: Avtovo folded before Flop (didn't bet)
Seat 2: mavin80 (button) folded before Flop (didn't bet)
Seat 3: matiko09 (small blind) folded before Flop
Seat 4: Eskimo Fox (big blind) collected ($1)
Seat 5: mi$$I$Elena folded before Flop (didn't bet)
Seat 8: chenconhaste folded before Flop (didn't bet)
Seat 9: Sjtu_Michael folded before Flop (didn't bet)





PokerStars Hand #155012963185:  Hold'em No Limit ($0.50/$1.00 USD) - 2016/06/21 13:12:03 CET [2016/06/21 7:12:03 ET]
Table 'Feronia' 9-max Seat #2 is the button
Seat 1: DIMAN_324 ($100 in chips) 
Seat 2: Yuder_Lin ($80.77 in chips) 
Seat 3: mbk88 ($130.95 in chips) 
Seat 4: pyromid ($125.36 in chips) 
Seat 5: matiko09 ($121.37 in chips) 
Seat 6: chenconhaste ($119.95 in chips) 
Seat 7: arctur17 ($102.45 in chips) 
Seat 8: letmegonow ($136.89 in chips) 
Seat 9: mi$$I$Elena ($151.04 in chips) 
mbk88: posts small blind $0.50
pyromid: posts big blind $1
*** HOLE CARDS ***
Dealt to matiko09 [9d 8d]
matiko09: raises $2 to $3
chenconhaste: folds 
arctur17: folds 
letmegonow: calls $3
mi$$I$Elena: folds 
DIMAN_324: calls $3
Yuder_Lin: folds 
mbk88: folds 
pyromid: folds 
*** FLOP *** [5s 8c 9s]
matiko09: bets $6
letmegonow: folds 
DIMAN_324: folds 
Uncalled bet ($6) returned to matiko09
matiko09 collected $9.98 from pot
matiko09: doesn't show hand 
*** SUMMARY ***
Total pot $10.50 | Rake $0.52 
Board [5s 8c 9s]
Seat 1: DIMAN_324 folded on the Flop
Seat 2: Yuder_Lin (button) folded before Flop (didn't bet)
Seat 3: mbk88 (small blind) folded before Flop
Seat 4: pyromid (big blind) folded before Flop
Seat 5: matiko09 collected ($9.98)
Seat 6: chenconhaste folded before Flop (didn't bet)
Seat 7: arctur17 folded before Flop (didn't bet)
Seat 8: letmegonow folded on the Flop
Seat 9: mi$$I$Elena folded before Flop (didn't bet)





PokerStars Hand #155012963797:  Hold'em No Limit ($0.50/$1.00 USD) - 2016/06/21 13:12:04 CET [2016/06/21 7:12:04 ET]
Table 'Moreau' 9-max Seat #5 is the button
Seat 1: ozone2003 ($130.49 in chips) 
Seat 2: nubpoker ($134.89 in chips) 
Seat 3: matiko09 ($102.62 in chips) 
Seat 4: bonesnz1 ($49.32 in chips) 
Seat 5: DIMAN_324 ($100 in chips) 
Seat 6: mbk88 ($100 in chips) 
Seat 7: PanKwn15 ($71.13 in chips) 
Seat 8: maxxmeister ($109.80 in chips) 
Seat 9: Toonersens ($113.42 in chips) 
mbk88: posts small blind $0.50
PanKwn15: posts big blind $1
*** HOLE CARDS ***
Dealt to matiko09 [Ad Jd]
maxxmeister: folds 
Toonersens: folds 
ozone2003: folds 
nubpoker: folds 
matiko09: raises $2 to $3
bonesnz1: folds 
DIMAN_324: folds 
mbk88: folds 
PanKwn15: folds 
Uncalled bet ($2) returned to matiko09
matiko09 collected $2.50 from pot
matiko09: doesn't show hand 
*** SUMMARY ***
Total pot $2.50 | Rake $0 
Seat 1: ozone2003 folded before Flop (didn't bet)
Seat 2: nubpoker folded before Flop (didn't bet)
Seat 3: matiko09 collected ($2.50)
Seat 4: bonesnz1 folded before Flop (didn't bet)
Seat 5: DIMAN_324 (button) folded before Flop (didn't bet)
Seat 6: mbk88 (small blind) folded before Flop
Seat 7: PanKwn15 (big blind) folded before Flop
Seat 8: maxxmeister folded before Flop (didn't bet)
Seat 9: Toonersens folded before Flop (didn't bet)





PokerStars Hand #155012965562:  Hold'em No Limit ($0.50/$1.00 USD) - 2016/06/21 13:12:09 CET [2016/06/21 7:12:09 ET]
Table 'Umbriel II' 9-max Seat #7 is the button
Seat 1: phil_cheng ($100.91 in chips) 
Seat 2: rura53 ($61.50 in chips) 
Seat 3: mxustin ($36.25 in chips) 
Seat 4: Eskimo Fox ($100 in chips) 
Seat 5: matiko09 ($143.96 in chips) 
Seat 6: maxxmeister ($103.08 in chips) 
Seat 7: chenconhaste ($172.10 in chips) 
Seat 8: ozone2003 ($130.80 in chips) 
Seat 9: Troll8989 ($100 in chips) 
ozone2003: posts small blind $0.50
Troll8989: posts big blind $1
*** HOLE CARDS ***
Dealt to matiko09 [Js 4h]
phil_cheng: folds 
rura53: folds 
mxustin: folds 
Eskimo Fox: folds 
matiko09: folds 
maxxmeister: folds 
chenconhaste: raises $1.25 to $2.25
ozone2003: raises $5.75 to $8
Troll8989: folds 
chenconhaste: raises $12 to $20
ozone2003: raises $110.80 to $130.80 and is all-in
chenconhaste: calls $110.80
*** FLOP *** [4c 3s 5s]
*** TURN *** [4c 3s 5s] [2d]
*** RIVER *** [4c 3s 5s 2d] [8h]
*** SHOW DOWN ***
ozone2003: shows [Jd As] (a straight, Ace to Five)
chenconhaste: shows [Kh Kd] (a pair of Kings)
ozone2003 collected $260.10 from pot
*** SUMMARY ***
Total pot $262.60 | Rake $2.50 
Board [4c 3s 5s 2d 8h]
Seat 1: phil_cheng folded before Flop (didn't bet)
Seat 2: rura53 folded before Flop (didn't bet)
Seat 3: mxustin folded before Flop (didn't bet)
Seat 4: Eskimo Fox folded before Flop (didn't bet)
Seat 5: matiko09 folded before Flop (didn't bet)
Seat 6: maxxmeister folded before Flop (didn't bet)
Seat 7: chenconhaste (button) showed [Kh Kd] and lost with a pair of Kings
Seat 8: ozone2003 (small blind) showed [Jd As] and won ($260.10) with a straight, Ace to Five
Seat 9: Troll8989 (big blind) folded before Flop





PokerStars Hand #155012968088:  Hold'em No Limit ($0.50/$1.00 USD) - 2016/06/21 13:12:15 CET [2016/06/21 7:12:15 ET]
Table 'Cheleb' 9-max Seat #3 is the button
Seat 1: SharingaaN ($114.43 in chips) 
Seat 2: pyromid ($135.88 in chips) 
Seat 3: bonesnz1 ($46.51 in chips) 
Seat 4: DIMAN_324 ($187.07 in chips) 
Seat 5: Avtovo ($137 in chips) 
Seat 6: matiko09 ($102.50 in chips) 
Seat 7: DomiVY ($40 in chips) 
Seat 8: Troll8989 ($100 in chips) 
Seat 9: chenconhaste ($116.52 in chips) 
DIMAN_324: posts small blind $0.50
Avtovo: posts big blind $1
*** HOLE CARDS ***
Dealt to matiko09 [7s 9h]
matiko09: folds 
DomiVY: folds 
Troll8989: folds 
chenconhaste: raises $1.25 to $2.25
SharingaaN: raises $4.75 to $7
pyromid: folds 
bonesnz1: folds 
DIMAN_324: folds 
Avtovo: folds 
chenconhaste: calls $4.75
*** FLOP *** [Ts 6s Qs]
chenconhaste: checks 
SharingaaN: bets $10
chenconhaste: folds 
Uncalled bet ($10) returned to SharingaaN
SharingaaN collected $14.72 from pot
SharingaaN: doesn't show hand 
*** SUMMARY ***
Total pot $15.50 | Rake $0.78 
Board [Ts 6s Qs]
Seat 1: SharingaaN collected ($14.72)
Seat 2: pyromid folded before Flop (didn't bet)
Seat 3: bonesnz1 (button) folded before Flop (didn't bet)
Seat 4: DIMAN_324 (small blind) folded before Flop
Seat 5: Avtovo (big blind) folded before Flop
Seat 6: matiko09 folded before Flop (didn't bet)
Seat 7: DomiVY folded before Flop (didn't bet)
Seat 8: Troll8989 folded before Flop (didn't bet)
Seat 9: chenconhaste folded on the Flop





PokerStars Hand #155012970851:  Hold'em No Limit ($0.50/$1.00 USD) - 2016/06/21 13:12:21 CET [2016/06/21 7:12:21 ET]
Table 'Moreau' 9-max Seat #6 is the button
Seat 1: ozone2003 ($130.49 in chips) 
Seat 2: nubpoker ($134.89 in chips) 
Seat 3: matiko09 ($104.12 in chips) 
Seat 4: bonesnz1 ($49.32 in chips) 
Seat 5: DIMAN_324 ($100 in chips) 
Seat 6: mbk88 ($100 in chips) 
Seat 7: PanKwn15 ($70.13 in chips) 
Seat 8: maxxmeister ($109.80 in chips) 
Seat 9: Toonersens ($113.42 in chips) 
PanKwn15: posts small blind $0.50
maxxmeister: posts big blind $1
*** HOLE CARDS ***
Dealt to matiko09 [7s 3s]
Toonersens: folds 
ozone2003: folds 
nubpoker: folds 
matiko09: folds 
bonesnz1: folds 
DIMAN_324: folds 
mbk88: folds 
PanKwn15: calls $0.50
maxxmeister: raises $4 to $5
PanKwn15: folds 
Uncalled bet ($4) returned to maxxmeister
maxxmeister collected $2 from pot
maxxmeister: doesn't show hand 
*** SUMMARY ***
Total pot $2 | Rake $0 
Seat 1: ozone2003 folded before Flop (didn't bet)
Seat 2: nubpoker folded before Flop (didn't bet)
Seat 3: matiko09 folded before Flop (didn't bet)
Seat 4: bonesnz1 folded before Flop (didn't bet)
Seat 5: DIMAN_324 folded before Flop (didn't bet)
Seat 6: mbk88 (button) folded before Flop (didn't bet)
Seat 7: PanKwn15 (small blind) folded before Flop
Seat 8: maxxmeister (big blind) collected ($2)
Seat 9: Toonersens folded before Flop (didn't bet)





PokerStars Hand #155012971280:  Hold'em No Limit ($0.50/$1.00 USD) - 2016/06/21 13:12:22 CET [2016/06/21 7:12:22 ET]
Table 'Lamberta II' 9-max Seat #3 is the button
Seat 1: Avtovo ($102.45 in chips) 
Seat 2: mavin80 ($95.42 in chips) 
Seat 3: matiko09 ($102 in chips) 
Seat 4: Eskimo Fox ($102 in chips) 
Seat 5: mi$$I$Elena ($100 in chips) 
Seat 8: chenconhaste ($103.90 in chips) 
Seat 9: Sjtu_Michael ($108.08 in chips) 
Eskimo Fox: posts small blind $0.50
mi$$I$Elena: posts big blind $1
DIMAN_324: sits out 
*** HOLE CARDS ***
Dealt to matiko09 [Ad Ts]
chenconhaste: folds 
Sjtu_Michael: folds 
Avtovo: folds 
mavin80: raises $1.50 to $2.50
matiko09: raises $6.50 to $9
Eskimo Fox: folds 
mi$$I$Elena: folds 
mavin80: folds 
Uncalled bet ($6.50) returned to matiko09
matiko09 collected $6.50 from pot
matiko09: doesn't show hand 
*** SUMMARY ***
Total pot $6.50 | Rake $0 
Seat 1: Avtovo folded before Flop (didn't bet)
Seat 2: mavin80 folded before Flop
Seat 3: matiko09 (button) collected ($6.50)
Seat 4: Eskimo Fox (small blind) folded before Flop
Seat 5: mi$$I$Elena (big blind) folded before Flop
Seat 8: chenconhaste folded before Flop (didn't bet)
Seat 9: Sjtu_Michael folded before Flop (didn't bet)





PokerStars Hand #155012971439:  Hold'em No Limit ($0.50/$1.00 USD) - 2016/06/21 13:12:23 CET [2016/06/21 7:12:23 ET]
Table 'Rupertwildt' 9-max Seat #5 is the button
Seat 1: pokernixxx ($73.29 in chips) 
Seat 2: SharingaaN ($76.50 in chips) 
Seat 3: Saymon_Moo ($77.58 in chips) 
Seat 4: matiko09 ($149.18 in chips) 
Seat 5: pyromid ($100 in chips) 
Seat 6: ozone2003 ($134.72 in chips) 
Seat 7: chenconhaste ($102.34 in chips) 
Seat 9: mbk88 ($108.43 in chips) 
ozone2003: posts small blind $0.50
chenconhaste: posts big blind $1
*** HOLE CARDS ***
Dealt to matiko09 [4d As]
mbk88: folds 
pokernixxx: calls $1
SharingaaN: raises $4 to $5
Saymon_Moo: folds 
Saymon_Moo leaves the table
matiko09: folds 
pyromid: folds 
ozone2003: folds 
chenconhaste: folds 
pokernixxx: calls $4
*** FLOP *** [4s Kh 4h]
pokernixxx: checks 
SharingaaN: bets $5.46
pokernixxx: folds 
Uncalled bet ($5.46) returned to SharingaaN
SharingaaN collected $10.92 from pot
SharingaaN: doesn't show hand 
*** SUMMARY ***
Total pot $11.50 | Rake $0.58 
Board [4s Kh 4h]
Seat 1: pokernixxx folded on the Flop
Seat 2: SharingaaN collected ($10.92)
Seat 3: Saymon_Moo folded before Flop (didn't bet)
Seat 4: matiko09 folded before Flop (didn't bet)
Seat 5: pyromid (button) folded before Flop (didn't bet)
Seat 6: ozone2003 (small blind) folded before Flop
Seat 7: chenconhaste (big blind) folded before Flop
Seat 9: mbk88 folded before Flop (didn't bet)





PokerStars Hand #155012973310:  Hold'em No Limit (€0.25/€0.50 EUR) - 2016/06/21 13:12:27 CET [2016/06/21 7:12:27 ET]
Table 'Actor II' 6-max Seat #3 is the button
Seat 1: hmverlin (€92.44 in chips) 
Seat 2: ooak182 (€54.45 in chips) 
Seat 3: asmodej666 (€91.30 in chips) 
Seat 4: matiko09 (€50.25 in chips) 
Seat 5: Rybka1294 (€50 in chips) 
Seat 6: fanmtZ (€20 in chips) 
matiko09: posts small blind €0.25
Rybka1294: posts big blind €0.50
*** HOLE CARDS ***
Dealt to matiko09 [Tc Ts]
fanmtZ: folds 
hmverlin: folds 
ooak182: folds 
asmodej666: raises €0.62 to €1.12
matiko09: raises €2.88 to €4
Rybka1294: folds 
asmodej666: folds 
Uncalled bet (€2.88) returned to matiko09
matiko09 collected €2.74 from pot
matiko09: doesn't show hand 
*** SUMMARY ***
Total pot €2.74 | Rake €0 
Seat 1: hmverlin folded before Flop (didn't bet)
Seat 2: ooak182 folded before Flop (didn't bet)
Seat 3: asmodej666 (button) folded before Flop
Seat 4: matiko09 (small blind) collected (€2.74)
Seat 5: Rybka1294 (big blind) folded before Flop
Seat 6: fanmtZ folded before Flop (didn't bet)





PokerStars Hand #155012974291:  Hold'em No Limit ($0.50/$1.00 USD) - 2016/06/21 13:12:29 CET [2016/06/21 7:12:29 ET]
Table 'Carlova II' 9-max Seat #4 is the button
Seat 1: matiko09 ($120.30 in chips) 
Seat 2: chenconhaste ($121.23 in chips) 
Seat 3: King_Z�Manel ($102.45 in chips) 
Seat 4: Dandy Monk ($66.41 in chips) 
Seat 5: ozone2003 ($100 in chips) 
Seat 6: DIMAN_324 ($100 in chips) 
Seat 7: mi$$I$Elena ($107.25 in chips) 
Seat 8: pyromid ($100 in chips) 
Seat 9: Troll8989 ($104.68 in chips) 
ozone2003: posts small blind $0.50
DIMAN_324: posts big blind $1
*** HOLE CARDS ***
Dealt to matiko09 [3c 8c]
mi$$I$Elena: raises $1.38 to $2.38
pyromid: folds 
Troll8989: folds 
matiko09: folds 
chenconhaste: folds 
King_Z�Manel: folds 
Dandy Monk: folds 
ozone2003: folds 
DIMAN_324: folds 
Uncalled bet ($1.38) returned to mi$$I$Elena
mi$$I$Elena collected $2.50 from pot
mi$$I$Elena: doesn't show hand 
*** SUMMARY ***
Total pot $2.50 | Rake $0 
Seat 1: matiko09 folded before Flop (didn't bet)
Seat 2: chenconhaste folded before Flop (didn't bet)
Seat 3: King_Z�Manel folded before Flop (didn't bet)
Seat 4: Dandy Monk (button) folded before Flop (didn't bet)
Seat 5: ozone2003 (small blind) folded before Flop
Seat 6: DIMAN_324 (big blind) folded before Flop
Seat 7: mi$$I$Elena collected ($2.50)
Seat 8: pyromid folded before Flop (didn't bet)
Seat 9: Troll8989 folded before Flop (didn't bet)





PokerStars Hand #155012976797:  Hold'em No Limit ($0.50/$1.00 USD) - 2016/06/21 13:12:35 CET [2016/06/21 7:12:35 ET]
Table 'Saldanha' 9-max Seat #7 is the button
Seat 2: matiko09 ($180.57 in chips) 
Seat 3: Avtovo ($100 in chips) 
Seat 4: 50CandyJoe ($105.12 in chips) 
Seat 5: Eskimo Fox ($100 in chips) 
Seat 6: SharingaaN ($77.90 in chips) 
Seat 7: chenconhaste ($100 in chips) 
Seat 8: pattexpro ($69 in chips) 
Seat 9: maxxmeister ($132.39 in chips) 
pattexpro: posts small blind $0.50
maxxmeister: posts big blind $1
SanychStar: sits out 
matiko09: posts the ante $0.20
Avtovo: posts the ante $0.20
50CandyJoe: posts the ante $0.20
Eskimo Fox: posts the ante $0.20
SharingaaN: posts the ante $0.20
chenconhaste: posts the ante $0.20
pattexpro: posts the ante $0.20
maxxmeister: posts the ante $0.20
*** HOLE CARDS ***
Dealt to matiko09 [Qh Td]
matiko09: folds 
Avtovo: folds 
50CandyJoe: folds 
Eskimo Fox: folds 
SharingaaN: raises $3 to $4
chenconhaste: folds 
pattexpro: folds 
maxxmeister: folds 
Uncalled bet ($3) returned to SharingaaN
pattexpro leaves the table
SharingaaN collected $4.10 from pot
SharingaaN: doesn't show hand 
*** SUMMARY ***
Total pot $4.10 | Rake $0 
Seat 2: matiko09 folded before Flop (didn't bet)
Seat 3: Avtovo folded before Flop (didn't bet)
Seat 4: 50CandyJoe folded before Flop (didn't bet)
Seat 5: Eskimo Fox folded before Flop (didn't bet)
Seat 6: SharingaaN collected ($4.10)
Seat 7: chenconhaste (button) folded before Flop (didn't bet)
Seat 8: pattexpro (small blind) folded before Flop
Seat 9: maxxmeister (big blind) folded before Flop





PokerStars Hand #155012980588:  Hold'em No Limit ($0.50/$1.00 USD) - 2016/06/21 13:12:44 CET [2016/06/21 7:12:44 ET]
Table 'Leo' 9-max Seat #5 is the button
Seat 1: letmegonow ($43.07 in chips) 
Seat 2: torkkdnm ($170.16 in chips) 
Seat 3: matiko09 ($101.80 in chips) 
Seat 4: SharingaaN ($101.95 in chips) 
Seat 5: DIMAN_324 ($111.66 in chips) 
Seat 6: chenconhaste ($116.92 in chips) 
Seat 7: maxxmeister ($100 in chips) 
Seat 8: pyromid ($98.92 in chips) 
Seat 9: Wladimir205 ($115.08 in chips) 
chenconhaste: posts small blind $0.50
maxxmeister: posts big blind $1
*** HOLE CARDS ***
Dealt to matiko09 [7s 5d]
pyromid: folds 
Wladimir205: folds 
letmegonow: folds 
torkkdnm: folds 
matiko09: folds 
SharingaaN: folds 
DIMAN_324: folds 
chenconhaste: calls $0.50
maxxmeister: raises $4 to $5
chenconhaste: folds 
Uncalled bet ($4) returned to maxxmeister
maxxmeister collected $2 from pot
maxxmeister: doesn't show hand 
*** SUMMARY ***
Total pot $2 | Rake $0 
Seat 1: letmegonow folded before Flop (didn't bet)
Seat 2: torkkdnm folded before Flop (didn't bet)
Seat 3: matiko09 folded before Flop (didn't bet)
Seat 4: SharingaaN folded before Flop (didn't bet)
Seat 5: DIMAN_324 (button) folded before Flop (didn't bet)
Seat 6: chenconhaste (small blind) folded before Flop
Seat 7: maxxmeister (big blind) collected ($2)
Seat 8: pyromid folded before Flop (didn't bet)
Seat 9: Wladimir205 folded before Flop (didn't bet)





PokerStars Hand #155012985347:  Hold'em No Limit (€0.25/€0.50 EUR) - 2016/06/21 13:12:56 CET [2016/06/21 7:12:56 ET]
Table 'Actor II' 6-max Seat #4 is the button
Seat 1: hmverlin (€92.44 in chips) 
Seat 2: ooak182 (€54.45 in chips) 
Seat 3: asmodej666 (€90.18 in chips) 
Seat 4: matiko09 (€51.87 in chips) 
Seat 5: Rybka1294 (€50 in chips) 
Seat 6: fanmtZ (€20 in chips) 
Rybka1294: posts small blind €0.25
fanmtZ: posts big blind €0.50
*** HOLE CARDS ***
Dealt to matiko09 [6s 2c]
hmverlin: folds 
ooak182: folds 
asmodej666: folds 
matiko09: folds 
Rybka1294: raises €1 to €1.50
fanmtZ: folds 
Uncalled bet (€1) returned to Rybka1294
Rybka1294 collected €1 from pot
Rybka1294: doesn't show hand 
*** SUMMARY ***
Total pot €1 | Rake €0 
Seat 1: hmverlin folded before Flop (didn't bet)
Seat 2: ooak182 folded before Flop (didn't bet)
Seat 3: asmodej666 folded before Flop (didn't bet)
Seat 4: matiko09 (button) folded before Flop (didn't bet)
Seat 5: Rybka1294 (small blind) collected (€1)
Seat 6: fanmtZ (big blind) folded before Flop





PokerStars Hand #155012986541:  Hold'em No Limit ($0.50/$1.00 USD) - 2016/06/21 13:12:59 CET [2016/06/21 7:12:59 ET]
Table 'Carlova II' 9-max Seat #5 is the button
Seat 1: matiko09 ($120.30 in chips) 
Seat 2: chenconhaste ($121.23 in chips) 
Seat 3: King_Z�Manel ($102.45 in chips) 
Seat 4: Dandy Monk ($66.41 in chips) 
Seat 5: ozone2003 ($100 in chips) 
Seat 6: DIMAN_324 ($100 in chips) 
Seat 7: mi$$I$Elena ($108.75 in chips) 
Seat 8: pyromid ($100 in chips) 
Seat 9: Troll8989 ($104.68 in chips) 
DIMAN_324: posts small blind $0.50
mi$$I$Elena: posts big blind $1
*** HOLE CARDS ***
Dealt to matiko09 [9d Jh]
pyromid: folds 
Troll8989: folds 
matiko09: folds 
chenconhaste: folds 
King_Z�Manel: folds 
Dandy Monk: folds 
ozone2003: folds 
DIMAN_324: raises $1.50 to $2.50
mi$$I$Elena: calls $1.50
*** FLOP *** [7h Kh 6s]
DIMAN_324: checks 
mi$$I$Elena: checks 
*** TURN *** [7h Kh 6s] [Kd]
DIMAN_324: bets $3.56
mi$$I$Elena: calls $3.56
*** RIVER *** [7h Kh 6s Kd] [5s]
DIMAN_324: bets $8.63
mi$$I$Elena: calls $8.63
*** SHOW DOWN ***
DIMAN_324: shows [Qc 8s] (a pair of Kings)
mi$$I$Elena: shows [8d 8c] (two pair, Kings and Eights)
mi$$I$Elena collected $27.91 from pot
*** SUMMARY ***
Total pot $29.38 | Rake $1.47 
Board [7h Kh 6s Kd 5s]
Seat 1: matiko09 folded before Flop (didn't bet)
Seat 2: chenconhaste folded before Flop (didn't bet)
Seat 3: King_Z�Manel folded before Flop (didn't bet)
Seat 4: Dandy Monk folded before Flop (didn't bet)
Seat 5: ozone2003 (button) folded before Flop (didn't bet)
Seat 6: DIMAN_324 (small blind) showed [Qc 8s] and lost with a pair of Kings
Seat 7: mi$$I$Elena (big blind) showed [8d 8c] and won ($27.91) with two pair, Kings and Eights
Seat 8: pyromid folded before Flop (didn't bet)
Seat 9: Troll8989 folded before Flop (didn't bet)





PokerStars Hand #155012986799:  Hold'em No Limit ($0.50/$1.00 USD) - 2016/06/21 13:12:59 CET [2016/06/21 7:12:59 ET]
Table 'Lamberta II' 9-max Seat #4 is the button
Seat 1: Avtovo ($102.45 in chips) 
Seat 2: mavin80 ($92.92 in chips) 
Seat 3: matiko09 ($106 in chips) 
Seat 4: Eskimo Fox ($101.50 in chips) 
Seat 5: mi$$I$Elena ($100 in chips) 
Seat 6: DIMAN_324 ($100 in chips) 
Seat 8: chenconhaste ($103.90 in chips) 
Seat 9: Sjtu_Michael ($108.08 in chips) 
mi$$I$Elena: posts small blind $0.50
DIMAN_324: posts big blind $1
*** HOLE CARDS ***
Dealt to matiko09 [2s Jd]
chenconhaste: folds 
Sjtu_Michael: folds 
Avtovo: folds 
mavin80: raises $1.50 to $2.50
matiko09: folds 
Eskimo Fox: folds 
mi$$I$Elena: folds 
DIMAN_324: folds 
Uncalled bet ($1.50) returned to mavin80
mavin80 collected $2.50 from pot
mavin80: doesn't show hand 
*** SUMMARY ***
Total pot $2.50 | Rake $0 
Seat 1: Avtovo folded before Flop (didn't bet)
Seat 2: mavin80 collected ($2.50)
Seat 3: matiko09 folded before Flop (didn't bet)
Seat 4: Eskimo Fox (button) folded before Flop (didn't bet)
Seat 5: mi$$I$Elena (small blind) folded before Flop
Seat 6: DIMAN_324 (big blind) folded before Flop
Seat 8: chenconhaste folded before Flop (didn't bet)
Seat 9: Sjtu_Michael folded before Flop (didn't bet)





PokerStars Hand #155012987888:  Hold'em No Limit ($0.50/$1.00 USD) - 2016/06/21 13:13:02 CET [2016/06/21 7:13:02 ET]
Table 'Moreau' 9-max Seat #7 is the button
Seat 1: ozone2003 ($130.49 in chips) 
Seat 2: nubpoker ($134.89 in chips) 
Seat 3: matiko09 ($104.12 in chips) 
Seat 4: bonesnz1 ($49.32 in chips) 
Seat 5: DIMAN_324 ($100 in chips) 
Seat 6: mbk88 ($100 in chips) 
Seat 7: PanKwn15 ($69.13 in chips) 
Seat 8: maxxmeister ($110.80 in chips) 
Seat 9: Toonersens ($113.42 in chips) 
maxxmeister: posts small blind $0.50
Toonersens: posts big blind $1
*** HOLE CARDS ***
Dealt to matiko09 [Ts Ah]
ozone2003: folds 
nubpoker: folds 
matiko09: raises $2 to $3
bonesnz1: folds 
DIMAN_324: folds 
mbk88: folds 
PanKwn15: calls $3
maxxmeister: folds 
Toonersens: folds 
*** FLOP *** [3d 7c As]
matiko09: checks 
PanKwn15: checks 
*** TURN *** [3d 7c As] [Th]
matiko09: bets $4
PanKwn15: calls $4
*** RIVER *** [3d 7c As Th] [Tc]
matiko09: checks 
PanKwn15: bets $11.70
matiko09: raises $85.42 to $97.12 and is all-in
PanKwn15: folds 
Uncalled bet ($85.42) returned to matiko09
bonesnz1 leaves the table
matiko09 collected $36.96 from pot
matiko09: doesn't show hand 
*** SUMMARY ***
Total pot $38.90 | Rake $1.94 
Board [3d 7c As Th Tc]
Seat 1: ozone2003 folded before Flop (didn't bet)
Seat 2: nubpoker folded before Flop (didn't bet)
Seat 3: matiko09 collected ($36.96)
Seat 4: bonesnz1 folded before Flop (didn't bet)
Seat 5: DIMAN_324 folded before Flop (didn't bet)
Seat 6: mbk88 folded before Flop (didn't bet)
Seat 7: PanKwn15 (button) folded on the River
Seat 8: maxxmeister (small blind) folded before Flop
Seat 9: Toonersens (big blind) folded before Flop





PokerStars Hand #155012989466:  Hold'em No Limit ($0.50/$1.00 USD) - 2016/06/21 13:13:06 CET [2016/06/21 7:13:06 ET]
Table 'Rupertwildt' 9-max Seat #6 is the button
Seat 1: pokernixxx ($68.29 in chips) 
Seat 2: SharingaaN ($82.42 in chips) 
Seat 4: matiko09 ($149.18 in chips) 
Seat 5: pyromid ($100 in chips) 
Seat 6: ozone2003 ($134.22 in chips) 
Seat 7: chenconhaste ($101.34 in chips) 
Seat 9: mbk88 ($108.43 in chips) 
chenconhaste: posts small blind $0.50
mbk88: posts big blind $1
*** HOLE CARDS ***
Dealt to matiko09 [2s 2c]
pokernixxx: calls $1
SharingaaN: folds 
matiko09: raises $2 to $3
pyromid: folds 
Troll8989 joins the table at seat #3 
ozone2003: calls $3
chenconhaste: folds 
mbk88: calls $2
pokernixxx: calls $2
*** FLOP *** [9c 7h 8h]
mbk88: checks 
pokernixxx: bets $7
matiko09: folds 
ozone2003: folds 
mbk88: folds 
Uncalled bet ($7) returned to pokernixxx
pokernixxx collected $11.88 from pot
pokernixxx: doesn't show hand 
*** SUMMARY ***
Total pot $12.50 | Rake $0.62 
Board [9c 7h 8h]
Seat 1: pokernixxx collected ($11.88)
Seat 2: SharingaaN folded before Flop (didn't bet)
Seat 4: matiko09 folded on the Flop
Seat 5: pyromid folded before Flop (didn't bet)
Seat 6: ozone2003 (button) folded on the Flop
Seat 7: chenconhaste (small blind) folded before Flop
Seat 9: mbk88 (big blind) folded on the Flop





PokerStars Hand #155012995674:  Hold'em No Limit (€0.25/€0.50 EUR) - 2016/06/21 13:13:21 CET [2016/06/21 7:13:21 ET]
Table 'Actor II' 6-max Seat #5 is the button
Seat 1: hmverlin (€92.44 in chips) 
Seat 2: ooak182 (€54.45 in chips) 
Seat 3: asmodej666 (€90.18 in chips) 
Seat 4: matiko09 (€51.87 in chips) 
Seat 5: Rybka1294 (€50.50 in chips) 
Seat 6: fanmtZ (€20 in chips) 
fanmtZ: posts small blind €0.25
hmverlin: posts big blind €0.50
*** HOLE CARDS ***
Dealt to matiko09 [9c 9d]
ooak182: folds 
asmodej666: folds 
matiko09: raises €1 to €1.50
Rybka1294: folds 
fanmtZ: calls €1.25
hmverlin: calls €1
*** FLOP *** [Td Js 2h]
fanmtZ: checks 
hmverlin: bets €2
matiko09: folds 
fanmtZ: folds 
Uncalled bet (€2) returned to hmverlin
hmverlin collected €4.28 from pot
hmverlin: doesn't show hand 
*** SUMMARY ***
Total pot €4.50 | Rake €0.22 
Board [Td Js 2h]
Seat 1: hmverlin (big blind) collected (€4.28)
Seat 2: ooak182 folded before Flop (didn't bet)
Seat 3: asmodej666 folded before Flop (didn't bet)
Seat 4: matiko09 folded on the Flop
Seat 5: Rybka1294 (button) folded before Flop (didn't bet)
Seat 6: fanmtZ (small blind) folded on the Flop





PokerStars Hand #155012995622:  Hold'em No Limit ($0.50/$1.00 USD) - 2016/06/21 13:13:21 CET [2016/06/21 7:13:21 ET]
Table 'Leo' 9-max Seat #6 is the button
Seat 1: letmegonow ($43.07 in chips) 
Seat 2: torkkdnm ($170.16 in chips) 
Seat 3: matiko09 ($101.80 in chips) 
Seat 4: SharingaaN ($101.95 in chips) 
Seat 5: DIMAN_324 ($111.66 in chips) 
Seat 6: chenconhaste ($115.92 in chips) 
Seat 7: maxxmeister ($101 in chips) 
Seat 8: pyromid ($98.92 in chips) 
Seat 9: Wladimir205 ($115.08 in chips) 
maxxmeister: posts small blind $0.50
pyromid: posts big blind $1
*** HOLE CARDS ***
Dealt to matiko09 [2h Qd]
Wladimir205: raises $1 to $2
letmegonow: folds 
torkkdnm: folds 
matiko09: folds 
SharingaaN: calls $2
DIMAN_324: folds 
chenconhaste: raises $9 to $11
maxxmeister: folds 
pyromid: folds 
Wladimir205: folds 
SharingaaN: folds 
Uncalled bet ($9) returned to chenconhaste
chenconhaste collected $7.50 from pot
*** SUMMARY ***
Total pot $7.50 | Rake $0 
Seat 1: letmegonow folded before Flop (didn't bet)
Seat 2: torkkdnm folded before Flop (didn't bet)
Seat 3: matiko09 folded before Flop (didn't bet)
Seat 4: SharingaaN folded before Flop
Seat 5: DIMAN_324 folded before Flop (didn't bet)
Seat 6: chenconhaste (button) collected ($7.50)
Seat 7: maxxmeister (small blind) folded before Flop
Seat 8: pyromid (big blind) folded before Flop
Seat 9: Wladimir205 folded before Flop





PokerStars Hand #155012996023:  Hold'em No Limit ($0.50/$1.00 USD) - 2016/06/21 13:13:22 CET [2016/06/21 7:13:22 ET]
Table 'Saldanha' 9-max Seat #9 is the button
Seat 2: matiko09 ($180.37 in chips) 
Seat 4: 50CandyJoe ($104.92 in chips) 
Seat 5: Eskimo Fox ($100 in chips) 
Seat 6: SharingaaN ($80.80 in chips) 
Seat 7: chenconhaste ($100 in chips) 
Seat 9: maxxmeister ($131.19 in chips) 
SanychStar will be allowed to play after the button
matiko09: posts small blind $0.50
Avtovo: is sitting out 
50CandyJoe: posts big blind $1
matiko09: posts the ante $0.20
50CandyJoe: posts the ante $0.20
Eskimo Fox: posts the ante $0.20
SharingaaN: posts the ante $0.20
chenconhaste: posts the ante $0.20
maxxmeister: posts the ante $0.20
*** HOLE CARDS ***
Dealt to matiko09 [Qd As]
Troll8989 joins the table at seat #8 
Avtovo leaves the table
Eskimo Fox: folds 
SharingaaN: folds 
SanychStar leaves the table
chenconhaste: folds 
phil_cheng joins the table at seat #1 
maxxmeister: raises $2.50 to $3.50
matiko09: raises $7.50 to $11
50CandyJoe: folds 
maxxmeister: folds 
Uncalled bet ($7.50) returned to matiko09
matiko09 collected $9.20 from pot
matiko09: doesn't show hand 
*** SUMMARY ***
Total pot $9.20 | Rake $0 
Seat 2: matiko09 (small blind) collected ($9.20)
Seat 4: 50CandyJoe (big blind) folded before Flop
Seat 5: Eskimo Fox folded before Flop (didn't bet)
Seat 6: SharingaaN folded before Flop (didn't bet)
Seat 7: chenconhaste folded before Flop (didn't bet)
Seat 9: maxxmeister (button) folded before Flop





PokerStars Hand #155012998072:  Hold'em No Limit ($0.50/$1.00 USD) - 2016/06/21 13:13:27 CET [2016/06/21 7:13:27 ET]
Table 'Brauna II' 9-max Seat #5 is the button
Seat 1: wisbc ($186.61 in chips) 
Seat 2: pyromid ($142.02 in chips) 
Seat 3: matiko09 ($100 in chips) 
Seat 4: chenconhaste ($195.25 in chips) 
Seat 5: fukumimi ($100 in chips) 
Seat 6: mbk88 ($162.26 in chips) 
Seat 7: Troll8989 ($100 in chips) 
Seat 8: DIMAN_324 ($139.87 in chips) 
Seat 9: torkkdnm ($100 in chips) 
mbk88: posts small blind $0.50
Troll8989: posts big blind $1
*** HOLE CARDS ***
Dealt to matiko09 [Kd 9c]
DIMAN_324: folds 
DIMAN_324 leaves the table
Avtovo joins the table at seat #8 
torkkdnm: folds 
wisbc: folds 
pyromid: folds 
matiko09: folds 
chenconhaste: raises $1.25 to $2.25
fukumimi: folds 
mbk88: folds 
Troll8989: folds 
Uncalled bet ($1.25) returned to chenconhaste
chenconhaste collected $2.50 from pot
*** SUMMARY ***
Total pot $2.50 | Rake $0 
Seat 1: wisbc folded before Flop (didn't bet)
Seat 2: pyromid folded before Flop (didn't bet)
Seat 3: matiko09 folded before Flop (didn't bet)
Seat 4: chenconhaste collected ($2.50)
Seat 5: fukumimi (button) folded before Flop (didn't bet)
Seat 6: mbk88 (small blind) folded before Flop
Seat 7: Troll8989 (big blind) folded before Flop
Seat 8: DIMAN_324 folded before Flop (didn't bet)
Seat 9: torkkdnm folded before Flop (didn't bet)





PokerStars Hand #155012998923:  Hold'em No Limit ($0.50/$1.00 USD) - 2016/06/21 13:13:29 CET [2016/06/21 7:13:29 ET]
Table 'Umbriel II' 9-max Seat #8 is the button
Seat 1: phil_cheng ($100.91 in chips) 
Seat 2: rura53 ($61.50 in chips) 
Seat 3: mxustin ($36.25 in chips) 
Seat 4: Eskimo Fox ($100 in chips) 
Seat 5: matiko09 ($143.96 in chips) 
Seat 6: maxxmeister ($103.08 in chips) 
Seat 7: chenconhaste ($100 in chips) 
Seat 8: ozone2003 ($260.10 in chips) 
Seat 9: Troll8989 ($100 in chips) 
Troll8989: posts small blind $0.50
phil_cheng: posts big blind $1
*** HOLE CARDS ***
Dealt to matiko09 [Jc Kh]
rura53: folds 
mxustin: folds 
Eskimo Fox: folds 
matiko09: folds 
maxxmeister: folds 
chenconhaste: folds 
ozone2003: folds 
Troll8989: raises $1.50 to $2.50
phil_cheng: folds 
Uncalled bet ($1.50) returned to Troll8989
Troll8989 collected $2 from pot
Troll8989: doesn't show hand 
*** SUMMARY ***
Total pot $2 | Rake $0 
Seat 1: phil_cheng (big blind) folded before Flop
Seat 2: rura53 folded before Flop (didn't bet)
Seat 3: mxustin folded before Flop (didn't bet)
Seat 4: Eskimo Fox folded before Flop (didn't bet)
Seat 5: matiko09 folded before Flop (didn't bet)
Seat 6: maxxmeister folded before Flop (didn't bet)
Seat 7: chenconhaste folded before Flop (didn't bet)
Seat 8: ozone2003 (button) folded before Flop (didn't bet)
Seat 9: Troll8989 (small blind) collected ($2)





PokerStars Hand #155013001948:  Hold'em No Limit (€0.25/€0.50 EUR) - 2016/06/21 13:13:36 CET [2016/06/21 7:13:36 ET]
Table 'Lotis II' 6-max Seat #1 is the button
Seat 1: acaestanemo (€50 in chips) 
Seat 2: broh202 (€110.27 in chips) 
Seat 3: bricasse1961 (€34.35 in chips) 
Seat 4: matiko09 (€76.39 in chips) 
Seat 5: AlexPles (€71.52 in chips) 
Seat 6: asmodej666 (€59.13 in chips) 
broh202: posts small blind €0.25
bricasse1961: posts big blind €0.50
*** HOLE CARDS ***
Dealt to matiko09 [7h 8s]
matiko09: folds 
AlexPles: folds 
asmodej666: folds 
acaestanemo: raises €1 to €1.50
broh202: calls €1.25
bricasse1961: folds 
*** FLOP *** [2d 9d 4c]
broh202: checks 
acaestanemo: bets €2.50
broh202: folds 
Uncalled bet (€2.50) returned to acaestanemo
acaestanemo collected €3.32 from pot
*** SUMMARY ***
Total pot €3.50 | Rake €0.18 
Board [2d 9d 4c]
Seat 1: acaestanemo (button) collected (€3.32)
Seat 2: broh202 (small blind) folded on the Flop
Seat 3: bricasse1961 (big blind) folded before Flop
Seat 4: matiko09 folded before Flop (didn't bet)
Seat 5: AlexPles folded before Flop (didn't bet)
Seat 6: asmodej666 folded before Flop (didn't bet)





PokerStars Hand #155013003145:  Hold'em No Limit ($0.50/$1.00 USD) - 2016/06/21 13:13:39 CET [2016/06/21 7:13:39 ET]
Table 'Cheleb' 9-max Seat #4 is the button
Seat 1: SharingaaN ($122.15 in chips) 
Seat 2: pyromid ($135.88 in chips) 
Seat 3: bonesnz1 ($46.51 in chips) 
Seat 4: DIMAN_324 ($186.57 in chips) 
Seat 5: Avtovo ($136 in chips) 
Seat 6: matiko09 ($102.50 in chips) 
Seat 7: DomiVY ($40 in chips) 
Seat 8: Troll8989 ($100 in chips) 
Seat 9: chenconhaste ($109.52 in chips) 
Avtovo: posts small blind $0.50
matiko09: posts big blind $1
*** HOLE CARDS ***
Dealt to matiko09 [5h 7h]
DomiVY: folds 
Troll8989: folds 
DomiVY leaves the table
chenconhaste: folds 
SharingaaN: folds 
pyromid: folds 
bonesnz1: calls $1
The Big Ape joins the table at seat #7 
DIMAN_324 has timed out
DIMAN_324: folds 
Avtovo: folds 
matiko09: checks 
*** FLOP *** [3s Js 4c]
matiko09: checks 
bonesnz1: bets $1
matiko09: folds 
Uncalled bet ($1) returned to bonesnz1
bonesnz1 collected $2.38 from pot
bonesnz1: doesn't show hand 
*** SUMMARY ***
Total pot $2.50 | Rake $0.12 
Board [3s Js 4c]
Seat 1: SharingaaN folded before Flop (didn't bet)
Seat 2: pyromid folded before Flop (didn't bet)
Seat 3: bonesnz1 collected ($2.38)
Seat 4: DIMAN_324 (button) folded before Flop (didn't bet)
Seat 5: Avtovo (small blind) folded before Flop
Seat 6: matiko09 (big blind) folded on the Flop
Seat 7: DomiVY folded before Flop (didn't bet)
Seat 8: Troll8989 folded before Flop (didn't bet)
Seat 9: chenconhaste folded before Flop (didn't bet)





PokerStars Hand #155013007654:  Hold'em No Limit ($0.50/$1.00 USD) - 2016/06/21 13:13:50 CET [2016/06/21 7:13:50 ET]
Table 'Lamberta II' 9-max Seat #5 is the button
Seat 1: Avtovo ($102.45 in chips) 
Seat 2: mavin80 ($94.42 in chips) 
Seat 3: matiko09 ($106 in chips) 
Seat 4: Eskimo Fox ($101.50 in chips) 
Seat 5: mi$$I$Elena ($100 in chips) 
Seat 6: DIMAN_324 ($100 in chips) 
Seat 9: Sjtu_Michael ($108.08 in chips) 
DIMAN_324: posts small blind $0.50
chenconhaste: is sitting out 
Sjtu_Michael: posts big blind $1
*** HOLE CARDS ***
Dealt to matiko09 [7c 6c]
chenconhaste leaves the table
Avtovo: folds 
mavin80: folds 
matiko09: raises $2 to $3
Eskimo Fox: raises $6 to $9
mi$$I$Elena: folds 
DIMAN_324: folds 
Sjtu_Michael: folds 
matiko09: folds 
Uncalled bet ($6) returned to Eskimo Fox
Eskimo Fox collected $7.50 from pot
Eskimo Fox: doesn't show hand 
*** SUMMARY ***
Total pot $7.50 | Rake $0 
Seat 1: Avtovo folded before Flop (didn't bet)
Seat 2: mavin80 folded before Flop (didn't bet)
Seat 3: matiko09 folded before Flop
Seat 4: Eskimo Fox collected ($7.50)
Seat 5: mi$$I$Elena (button) folded before Flop (didn't bet)
Seat 6: DIMAN_324 (small blind) folded before Flop
Seat 9: Sjtu_Michael (big blind) folded before Flop





PokerStars Hand #155013013284:  Hold'em No Limit ($0.50/$1.00 USD) - 2016/06/21 13:14:03 CET [2016/06/21 7:14:03 ET]
Table 'Leo' 9-max Seat #7 is the button
Seat 1: letmegonow ($43.07 in chips) 
Seat 2: torkkdnm ($170.16 in chips) 
Seat 3: matiko09 ($101.80 in chips) 
Seat 4: SharingaaN ($99.95 in chips) 
Seat 5: DIMAN_324 ($111.66 in chips) 
Seat 6: chenconhaste ($121.42 in chips) 
Seat 7: maxxmeister ($100.50 in chips) 
Seat 8: pyromid ($97.92 in chips) 
Seat 9: Wladimir205 ($113.08 in chips) 
pyromid: posts small blind $0.50
Wladimir205: posts big blind $1
*** HOLE CARDS ***
Dealt to matiko09 [4s 5d]
letmegonow: folds 
letmegonow leaves the table
torkkdnm: folds 
matiko09: folds 
SharingaaN: raises $2 to $3
DIMAN_324: folds 
chenconhaste: folds 
maxxmeister: folds 
pyromid: calls $2.50
Wladimir205: folds 
*** FLOP *** [3d 9c Qd]
pyromid: checks 
SharingaaN: checks 
*** TURN *** [3d 9c Qd] [4c]
pyromid: bets $2.50
SharingaaN: raises $5.82 to $8.32
pyromid: folds 
Uncalled bet ($5.82) returned to SharingaaN
SharingaaN collected $11.40 from pot
SharingaaN: doesn't show hand 
*** SUMMARY ***
Total pot $12 | Rake $0.60 
Board [3d 9c Qd 4c]
Seat 1: letmegonow folded before Flop (didn't bet)
Seat 2: torkkdnm folded before Flop (didn't bet)
Seat 3: matiko09 folded before Flop (didn't bet)
Seat 4: SharingaaN collected ($11.40)
Seat 5: DIMAN_324 folded before Flop (didn't bet)
Seat 6: chenconhaste folded before Flop (didn't bet)
Seat 7: maxxmeister (button) folded before Flop (didn't bet)
Seat 8: pyromid (small blind) folded on the Turn
Seat 9: Wladimir205 (big blind) folded before Flop





PokerStars Hand #155013013040:  Hold'em No Limit ($0.50/$1.00 USD) - 2016/06/21 13:14:03 CET [2016/06/21 7:14:03 ET]
Table 'Saldanha' 9-max Seat #2 is the button
Seat 2: matiko09 ($185.87 in chips) 
Seat 5: Eskimo Fox ($100 in chips) 
Seat 6: SharingaaN ($80.60 in chips) 
Seat 7: chenconhaste ($100 in chips) 
Seat 9: maxxmeister ($127.49 in chips) 
Eskimo Fox: posts small blind $0.50
SharingaaN: posts big blind $1
Troll8989: sits out 
phil_cheng: sits out 
matiko09: posts the ante $0.20
Eskimo Fox: posts the ante $0.20
SharingaaN: posts the ante $0.20
chenconhaste: posts the ante $0.20
maxxmeister: posts the ante $0.20
*** HOLE CARDS ***
Dealt to matiko09 [Ac 9c]
50CandyJoe leaves the table
chenconhaste: folds 
maxxmeister: folds 
mi$$I$Elena joins the table at seat #3 
mi$$I$Elena leaves the table
matiko09: raises $1.27 to $2.27
Eskimo Fox: raises $5.73 to $8
CoolFireX joins the table at seat #4 
SharingaaN: folds 
matiko09: folds 
Uncalled bet ($5.73) returned to Eskimo Fox
Eskimo Fox collected $6.54 from pot
Eskimo Fox: doesn't show hand 
*** SUMMARY ***
Total pot $6.54 | Rake $0 
Seat 2: matiko09 (button) folded before Flop
Seat 5: Eskimo Fox (small blind) collected ($6.54)
Seat 6: SharingaaN (big blind) folded before Flop
Seat 7: chenconhaste folded before Flop (didn't bet)
Seat 9: maxxmeister folded before Flop (didn't bet)





PokerStars Hand #155013014034:  Hold'em No Limit ($0.50/$1.00 USD) - 2016/06/21 13:14:05 CET [2016/06/21 7:14:05 ET]
Table 'Brauna II' 9-max Seat #6 is the button
Seat 1: wisbc ($186.61 in chips) 
Seat 2: pyromid ($142.02 in chips) 
Seat 3: matiko09 ($100 in chips) 
Seat 4: chenconhaste ($196.75 in chips) 
Seat 5: fukumimi ($100 in chips) 
Seat 6: mbk88 ($161.76 in chips) 
Seat 7: Troll8989 ($100 in chips) 
Seat 8: Avtovo ($100 in chips) 
Seat 9: torkkdnm ($100 in chips) 
Troll8989: posts small blind $0.50
Avtovo: posts big blind $1
*** HOLE CARDS ***
Dealt to matiko09 [Ac Ad]
torkkdnm: folds 
wisbc: folds 
pyromid: folds 
matiko09: raises $2 to $3
chenconhaste: folds 
fukumimi: folds 
mbk88: folds 
Troll8989: folds 
Avtovo: folds 
Uncalled bet ($2) returned to matiko09
matiko09 collected $2.50 from pot
matiko09: doesn't show hand 
*** SUMMARY ***
Total pot $2.50 | Rake $0 
Seat 1: wisbc folded before Flop (didn't bet)
Seat 2: pyromid folded before Flop (didn't bet)
Seat 3: matiko09 collected ($2.50)
Seat 4: chenconhaste folded before Flop (didn't bet)
Seat 5: fukumimi folded before Flop (didn't bet)
Seat 6: mbk88 (button) folded before Flop (didn't bet)
Seat 7: Troll8989 (small blind) folded before Flop
Seat 8: Avtovo (big blind) folded before Flop
Seat 9: torkkdnm folded before Flop (didn't bet)





PokerStars Hand #155013015201:  Hold'em No Limit ($0.50/$1.00 USD) - 2016/06/21 13:14:08 CET [2016/06/21 7:14:08 ET]
Table 'Umbriel II' 9-max Seat #9 is the button
Seat 1: phil_cheng ($100 in chips) 
Seat 2: rura53 ($61.50 in chips) 
Seat 3: mxustin ($36.25 in chips) 
Seat 4: Eskimo Fox ($100 in chips) 
Seat 5: matiko09 ($143.96 in chips) 
Seat 6: maxxmeister ($103.08 in chips) 
Seat 7: chenconhaste ($100 in chips) 
Seat 8: ozone2003 ($260.10 in chips) 
Seat 9: Troll8989 ($101 in chips) 
phil_cheng: posts small blind $0.50
rura53: posts big blind $1
*** HOLE CARDS ***
Dealt to matiko09 [9d 8s]
mxustin: folds 
Eskimo Fox: folds 
matiko09: folds 
maxxmeister: folds 
chenconhaste: folds 
ozone2003: folds 
Troll8989: folds 
phil_cheng: folds 
Uncalled bet ($0.50) returned to rura53
rura53 collected $1 from pot
rura53: doesn't show hand 
*** SUMMARY ***
Total pot $1 | Rake $0 
Seat 1: phil_cheng (small blind) folded before Flop
Seat 2: rura53 (big blind) collected ($1)
Seat 3: mxustin folded before Flop (didn't bet)
Seat 4: Eskimo Fox folded before Flop (didn't bet)
Seat 5: matiko09 folded before Flop (didn't bet)
Seat 6: maxxmeister folded before Flop (didn't bet)
Seat 7: chenconhaste folded before Flop (didn't bet)
Seat 8: ozone2003 folded before Flop (didn't bet)
Seat 9: Troll8989 (button) folded before Flop (didn't bet)





PokerStars Hand #155013016911:  Hold'em No Limit (€0.25/€0.50 EUR) - 2016/06/21 13:14:12 CET [2016/06/21 7:14:12 ET]
Table 'Actor II' 6-max Seat #6 is the button
Seat 1: hmverlin (€95.22 in chips) 
Seat 2: ooak182 (€54.45 in chips) 
Seat 3: asmodej666 (€90.18 in chips) 
Seat 4: matiko09 (€50.37 in chips) 
Seat 5: Rybka1294 (€50.50 in chips) 
Seat 6: fanmtZ (€20 in chips) 
hmverlin: posts small blind €0.25
ooak182: posts big blind €0.50
*** HOLE CARDS ***
Dealt to matiko09 [5h 7s]
asmodej666: folds 
matiko09: folds 
Rybka1294: folds 
fanmtZ: raises €0.79 to €1.29
hmverlin: folds 
ooak182: folds 
Uncalled bet (€0.79) returned to fanmtZ
fanmtZ collected €1.25 from pot
fanmtZ: doesn't show hand 
*** SUMMARY ***
Total pot €1.25 | Rake €0 
Seat 1: hmverlin (small blind) folded before Flop
Seat 2: ooak182 (big blind) folded before Flop
Seat 3: asmodej666 folded before Flop (didn't bet)
Seat 4: matiko09 folded before Flop (didn't bet)
Seat 5: Rybka1294 folded before Flop (didn't bet)
Seat 6: fanmtZ (button) collected (€1.25)





PokerStars Hand #155013021653:  Hold'em No Limit ($0.50/$1.00 USD) - 2016/06/21 13:14:23 CET [2016/06/21 7:14:23 ET]
Table 'Lamberta II' 9-max Seat #6 is the button
Seat 2: mavin80 ($94.42 in chips) 
Seat 3: matiko09 ($103 in chips) 
Seat 4: Eskimo Fox ($106 in chips) 
Seat 5: mi$$I$Elena ($100 in chips) 
Seat 6: DIMAN_324 ($100 in chips) 
Seat 9: Sjtu_Michael ($107.08 in chips) 
Sjtu_Michael: posts small blind $0.50
Avtovo: is sitting out 
mavin80: posts big blind $1
*** HOLE CARDS ***
Dealt to matiko09 [8d 2d]
matiko09: folds 
Eskimo Fox: folds 
Troll8989 joins the table at seat #8 
mi$$I$Elena: folds 
DIMAN_324: folds 
Sjtu_Michael: folds 
Uncalled bet ($0.50) returned to mavin80
mavin80 collected $1 from pot
mavin80: doesn't show hand 
*** SUMMARY ***
Total pot $1 | Rake $0 
Seat 2: mavin80 (big blind) collected ($1)
Seat 3: matiko09 folded before Flop (didn't bet)
Seat 4: Eskimo Fox folded before Flop (didn't bet)
Seat 5: mi$$I$Elena folded before Flop (didn't bet)
Seat 6: DIMAN_324 (button) folded before Flop (didn't bet)
Seat 9: Sjtu_Michael (small blind) folded before Flop





PokerStars Hand #155013022294:  Hold'em No Limit (€0.25/€0.50 EUR) - 2016/06/21 13:14:25 CET [2016/06/21 7:14:25 ET]
Table 'Lotis II' 6-max Seat #2 is the button
Seat 1: acaestanemo (€51.82 in chips) 
Seat 2: broh202 (€108.77 in chips) 
Seat 3: bricasse1961 (€33.85 in chips) 
Seat 4: matiko09 (€76.39 in chips) 
Seat 5: AlexPles (€71.52 in chips) 
Seat 6: asmodej666 (€59.13 in chips) 
bricasse1961: posts small blind €0.25
matiko09: posts big blind €0.50
*** HOLE CARDS ***
Dealt to matiko09 [Ks 7s]
AlexPles: folds 
asmodej666: folds 
acaestanemo: folds 
broh202: raises €1 to €1.50
bricasse1961: calls €1.25
matiko09: calls €1
*** FLOP *** [6h 6s Ah]
bricasse1961: bets €0.50
matiko09: folds 
broh202: raises €2.64 to €3.14
bricasse1961: calls €2.64
*** TURN *** [6h 6s Ah] [Kh]
bricasse1961: bets €0.50
broh202: calls €0.50
*** RIVER *** [6h 6s Ah Kh] [4c]
bricasse1961: bets €0.50
broh202: calls €0.50
*** SHOW DOWN ***
bricasse1961: shows [Ad Jh] (two pair, Aces and Sixes)
broh202: mucks hand 
bricasse1961 collected €12.14 from pot
*** SUMMARY ***
Total pot €12.78 | Rake €0.64 
Board [6h 6s Ah Kh 4c]
Seat 1: acaestanemo folded before Flop (didn't bet)
Seat 2: broh202 (button) mucked [4d Kd]
Seat 3: bricasse1961 (small blind) showed [Ad Jh] and won (€12.14) with two pair, Aces and Sixes
Seat 4: matiko09 (big blind) folded on the Flop
Seat 5: AlexPles folded before Flop (didn't bet)
Seat 6: asmodej666 folded before Flop (didn't bet)





PokerStars Hand #155013022768:  Hold'em No Limit ($0.50/$1.00 USD) - 2016/06/21 13:14:26 CET [2016/06/21 7:14:26 ET]
Table 'Rupertwildt' 9-max Seat #7 is the button
Seat 1: pokernixxx ($77.17 in chips) 
Seat 2: SharingaaN ($82.42 in chips) 
Seat 4: matiko09 ($146.18 in chips) 
Seat 5: pyromid ($100 in chips) 
Seat 6: ozone2003 ($131.22 in chips) 
Seat 7: chenconhaste ($100.84 in chips) 
Seat 9: mbk88 ($105.43 in chips) 
mbk88: posts small blind $0.50
pokernixxx: posts big blind $1
Troll8989: sits out 
*** HOLE CARDS ***
Dealt to matiko09 [4h 9c]
SharingaaN: folds 
matiko09: folds 
pyromid: folds 
ozone2003: raises $1.50 to $2.50
chenconhaste: folds 
mbk88: folds 
pokernixxx: calls $1.50
*** FLOP *** [5s Ad Qs]
pokernixxx: checks 
ozone2003: checks 
*** TURN *** [5s Ad Qs] [5h]
pokernixxx: bets $4
ozone2003: calls $4
*** RIVER *** [5s Ad Qs 5h] [7h]
pokernixxx: checks 
ozone2003: checks 
*** SHOW DOWN ***
pokernixxx: shows [Ac 8h] (two pair, Aces and Fives)
ozone2003: mucks hand 
pokernixxx collected $12.82 from pot
*** SUMMARY ***
Total pot $13.50 | Rake $0.68 
Board [5s Ad Qs 5h 7h]
Seat 1: pokernixxx (big blind) showed [Ac 8h] and won ($12.82) with two pair, Aces and Fives
Seat 2: SharingaaN folded before Flop (didn't bet)
Seat 4: matiko09 folded before Flop (didn't bet)
Seat 5: pyromid folded before Flop (didn't bet)
Seat 6: ozone2003 mucked [Ks Kc]
Seat 7: chenconhaste (button) folded before Flop (didn't bet)
Seat 9: mbk88 (small blind) folded before Flop





PokerStars Hand #155013024482:  Hold'em No Limit ($0.50/$1.00 USD) - 2016/06/21 13:14:30 CET [2016/06/21 7:14:30 ET]
Table 'Umbriel II' 9-max Seat #1 is the button
Seat 1: phil_cheng ($100 in chips) 
Seat 2: rura53 ($62 in chips) 
Seat 3: mxustin ($36.25 in chips) 
Seat 4: Eskimo Fox ($100 in chips) 
Seat 5: matiko09 ($143.96 in chips) 
Seat 6: maxxmeister ($103.08 in chips) 
Seat 7: chenconhaste ($100 in chips) 
Seat 8: ozone2003 ($260.10 in chips) 
rura53: posts small blind $0.50
mxustin: posts big blind $1
*** HOLE CARDS ***
Dealt to matiko09 [4d 5c]
Troll8989 leaves the table
Eskimo Fox: folds 
matiko09: folds 
maxxmeister: folds 
chenconhaste: raises $1.25 to $2.25
ozone2003: folds 
phil_cheng: raises $5.75 to $8
rura53: folds 
mxustin: folds 
chenconhaste: folds 
Uncalled bet ($5.75) returned to phil_cheng
phil_cheng collected $6 from pot
phil_cheng: doesn't show hand 
*** SUMMARY ***
Total pot $6 | Rake $0 
Seat 1: phil_cheng (button) collected ($6)
Seat 2: rura53 (small blind) folded before Flop
Seat 3: mxustin (big blind) folded before Flop
Seat 4: Eskimo Fox folded before Flop (didn't bet)
Seat 5: matiko09 folded before Flop (didn't bet)
Seat 6: maxxmeister folded before Flop (didn't bet)
Seat 7: chenconhaste folded before Flop
Seat 8: ozone2003 folded before Flop (didn't bet)





PokerStars Hand #155013025314:  Hold'em No Limit (€0.25/€0.50 EUR) - 2016/06/21 13:14:32 CET [2016/06/21 7:14:32 ET]
Table 'Actor II' 6-max Seat #1 is the button
Seat 1: hmverlin (€94.97 in chips) 
Seat 2: ooak182 (€53.95 in chips) 
Seat 3: asmodej666 (€90.18 in chips) 
Seat 4: matiko09 (€50.37 in chips) 
Seat 5: Rybka1294 (€50.50 in chips) 
Seat 6: fanmtZ (€20.75 in chips) 
ooak182: posts small blind €0.25
asmodej666: posts big blind €0.50
*** HOLE CARDS ***
Dealt to matiko09 [9h 2c]
matiko09: folds 
Rybka1294: folds 
fanmtZ: folds 
hmverlin: folds 
ooak182: folds 
Uncalled bet (€0.25) returned to asmodej666
asmodej666 collected €0.50 from pot
asmodej666: doesn't show hand 
*** SUMMARY ***
Total pot €0.50 | Rake €0 
Seat 1: hmverlin (button) folded before Flop (didn't bet)
Seat 2: ooak182 (small blind) folded before Flop
Seat 3: asmodej666 (big blind) collected (€0.50)
Seat 4: matiko09 folded before Flop (didn't bet)
Seat 5: Rybka1294 folded before Flop (didn't bet)
Seat 6: fanmtZ folded before Flop (didn't bet)





PokerStars Hand #155013029537:  Hold'em No Limit ($0.50/$1.00 USD) - 2016/06/21 13:14:42 CET [2016/06/21 7:14:42 ET]
Table 'Carlova II' 9-max Seat #6 is the button
Seat 1: matiko09 ($120.30 in chips) 
Seat 2: chenconhaste ($121.23 in chips) 
Seat 3: King_Z�Manel ($102.45 in chips) 
Seat 4: Dandy Monk ($66.41 in chips) 
Seat 5: ozone2003 ($100 in chips) 
Seat 6: DIMAN_324 ($100 in chips) 
Seat 7: mi$$I$Elena ($121.97 in chips) 
Seat 8: pyromid ($100 in chips) 
Seat 9: Troll8989 ($104.68 in chips) 
mi$$I$Elena: posts small blind $0.50
pyromid: posts big blind $1
*** HOLE CARDS ***
Dealt to matiko09 [2d Td]
Troll8989: folds 
matiko09: folds 
chenconhaste: folds 
King_Z�Manel: raises $2 to $3
Dandy Monk: calls $3
ozone2003: raises $9 to $12
DIMAN_324: folds 
mi$$I$Elena: folds 
pyromid: folds 
King_Z�Manel: folds 
Dandy Monk: folds 
Uncalled bet ($9) returned to ozone2003
ozone2003 collected $10.50 from pot
ozone2003: doesn't show hand 
*** SUMMARY ***
Total pot $10.50 | Rake $0 
Seat 1: matiko09 folded before Flop (didn't bet)
Seat 2: chenconhaste folded before Flop (didn't bet)
Seat 3: King_Z�Manel folded before Flop
Seat 4: Dandy Monk folded before Flop
Seat 5: ozone2003 collected ($10.50)
Seat 6: DIMAN_324 (button) folded before Flop (didn't bet)
Seat 7: mi$$I$Elena (small blind) folded before Flop
Seat 8: pyromid (big blind) folded before Flop
Seat 9: Troll8989 folded before Flop (didn't bet)





PokerStars Hand #155013032867:  Hold'em No Limit ($0.50/$1.00 USD) - 2016/06/21 13:14:50 CET [2016/06/21 7:14:50 ET]
Table 'Brauna II' 9-max Seat #7 is the button
Seat 1: wisbc ($186.61 in chips) 
Seat 2: pyromid ($142.02 in chips) 
Seat 3: matiko09 ($101.50 in chips) 
Seat 4: chenconhaste ($196.75 in chips) 
Seat 5: fukumimi ($100 in chips) 
Seat 6: mbk88 ($161.76 in chips) 
Seat 7: Troll8989 ($100 in chips) 
Seat 8: Avtovo ($100 in chips) 
Seat 9: torkkdnm ($100 in chips) 
Avtovo: posts small blind $0.50
torkkdnm: posts big blind $1
*** HOLE CARDS ***
Dealt to matiko09 [5c Kc]
wisbc: folds 
pyromid: folds 
matiko09: folds 
chenconhaste: folds 
fukumimi: folds 
mbk88: raises $2 to $3
Troll8989: folds 
Avtovo: folds 
torkkdnm: folds 
Uncalled bet ($2) returned to mbk88
mbk88 collected $2.50 from pot
mbk88: doesn't show hand 
*** SUMMARY ***
Total pot $2.50 | Rake $0 
Seat 1: wisbc folded before Flop (didn't bet)
Seat 2: pyromid folded before Flop (didn't bet)
Seat 3: matiko09 folded before Flop (didn't bet)
Seat 4: chenconhaste folded before Flop (didn't bet)
Seat 5: fukumimi folded before Flop (didn't bet)
Seat 6: mbk88 collected ($2.50)
Seat 7: Troll8989 (button) folded before Flop (didn't bet)
Seat 8: Avtovo (small blind) folded before Flop
Seat 9: torkkdnm (big blind) folded before Flop





PokerStars Hand #155013034420:  Hold'em No Limit (€0.25/€0.50 EUR) - 2016/06/21 13:14:54 CET [2016/06/21 7:14:54 ET]
Table 'Actor II' 6-max Seat #2 is the button
Seat 1: hmverlin (€94.97 in chips) 
Seat 2: ooak182 (€53.70 in chips) 
Seat 3: asmodej666 (€90.43 in chips) 
Seat 4: matiko09 (€50.37 in chips) 
Seat 5: Rybka1294 (€50.50 in chips) 
Seat 6: fanmtZ (€20.75 in chips) 
asmodej666: posts small blind €0.25
matiko09: posts big blind €0.50
*** HOLE CARDS ***
Dealt to matiko09 [8c 2d]
Rybka1294: folds 
fanmtZ: folds 
hmverlin: folds 
ooak182: raises €0.62 to €1.12
asmodej666: folds 
matiko09: folds 
Uncalled bet (€0.62) returned to ooak182
ooak182 collected €1.25 from pot
ooak182: doesn't show hand 
*** SUMMARY ***
Total pot €1.25 | Rake €0 
Seat 1: hmverlin folded before Flop (didn't bet)
Seat 2: ooak182 (button) collected (€1.25)
Seat 3: asmodej666 (small blind) folded before Flop
Seat 4: matiko09 (big blind) folded before Flop
Seat 5: Rybka1294 folded before Flop (didn't bet)
Seat 6: fanmtZ folded before Flop (didn't bet)





PokerStars Hand #155013035087:  Hold'em No Limit ($0.50/$1.00 USD) - 2016/06/21 13:14:56 CET [2016/06/21 7:14:56 ET]
Table 'Saldanha' 9-max Seat #5 is the button
Seat 2: matiko09 ($183.40 in chips) 
Seat 5: Eskimo Fox ($104.07 in chips) 
Seat 6: SharingaaN ($79.40 in chips) 
Seat 8: Troll8989 ($100 in chips) 
Seat 9: maxxmeister ($127.29 in chips) 
SharingaaN: posts small blind $0.50
chenconhaste: is sitting out 
Troll8989: posts big blind $1
phil_cheng: sits out 
chenconhaste leaves the table
CoolFireX: sits out 
matiko09: posts the ante $0.20
Eskimo Fox: posts the ante $0.20
SharingaaN: posts the ante $0.20
Troll8989: posts the ante $0.20
maxxmeister: posts the ante $0.20
*** HOLE CARDS ***
Dealt to matiko09 [3d Jc]
maxxmeister: raises $2.50 to $3.50
matiko09: folds 
Eskimo Fox: folds 
SharingaaN: folds 
Troll8989: folds 
Uncalled bet ($2.50) returned to maxxmeister
Avtovo joins the table at seat #7 
maxxmeister collected $3.50 from pot
maxxmeister: doesn't show hand 
*** SUMMARY ***
Total pot $3.50 | Rake $0 
Seat 2: matiko09 folded before Flop (didn't bet)
Seat 5: Eskimo Fox (button) folded before Flop (didn't bet)
Seat 6: SharingaaN (small blind) folded before Flop
Seat 8: Troll8989 (big blind) folded before Flop
Seat 9: maxxmeister collected ($3.50)





PokerStars Hand #155013035520:  Hold'em No Limit ($0.50/$1.00 USD) - 2016/06/21 13:14:57 CET [2016/06/21 7:14:57 ET]
Table 'Lamberta II' 9-max Seat #9 is the button
Seat 2: mavin80 ($94.92 in chips) 
Seat 3: matiko09 ($103 in chips) 
Seat 4: Eskimo Fox ($106 in chips) 
Seat 5: mi$$I$Elena ($100 in chips) 
Seat 6: DIMAN_324 ($100 in chips) 
Seat 9: Sjtu_Michael ($106.58 in chips) 
mavin80: posts small blind $0.50
matiko09: posts big blind $1
Troll8989: sits out 
*** HOLE CARDS ***
Dealt to matiko09 [Ah 7s]
Eskimo Fox: folds 
mi$$I$Elena: raises $2 to $3
DIMAN_324: folds 
Sjtu_Michael: folds 
mavin80: folds 
matiko09: folds 
Uncalled bet ($2) returned to mi$$I$Elena
mi$$I$Elena collected $2.50 from pot
mi$$I$Elena: doesn't show hand 
*** SUMMARY ***
Total pot $2.50 | Rake $0 
Seat 2: mavin80 (small blind) folded before Flop
Seat 3: matiko09 (big blind) folded before Flop
Seat 4: Eskimo Fox folded before Flop (didn't bet)
Seat 5: mi$$I$Elena collected ($2.50)
Seat 6: DIMAN_324 folded before Flop (didn't bet)
Seat 9: Sjtu_Michael (button) folded before Flop (didn't bet)





PokerStars Hand #155013038264:  Hold'em No Limit ($0.50/$1.00 USD) - 2016/06/21 13:15:03 CET [2016/06/21 7:15:03 ET]
Table 'Cheleb' 9-max Seat #5 is the button
Seat 1: SharingaaN ($122.15 in chips) 
Seat 2: pyromid ($135.88 in chips) 
Seat 3: bonesnz1 ($47.89 in chips) 
Seat 4: DIMAN_324 ($186.57 in chips) 
Seat 5: Avtovo ($135.50 in chips) 
Seat 6: matiko09 ($101.50 in chips) 
Seat 7: The Big Ape ($100 in chips) 
Seat 8: Troll8989 ($100 in chips) 
Seat 9: chenconhaste ($109.52 in chips) 
matiko09: posts small blind $0.50
The Big Ape: posts big blind $1
*** HOLE CARDS ***
Dealt to matiko09 [8s 3h]
Troll8989: folds 
chenconhaste: folds 
SharingaaN: folds 
pyromid: folds 
bonesnz1: folds 
DIMAN_324: raises $1.50 to $2.50
bonesnz1 leaves the table
Avtovo: folds 
phil_cheng joins the table at seat #3 
matiko09: folds 
The Big Ape: folds 
Uncalled bet ($1.50) returned to DIMAN_324
DIMAN_324 collected $2.50 from pot
DIMAN_324: doesn't show hand 
*** SUMMARY ***
Total pot $2.50 | Rake $0 
Seat 1: SharingaaN folded before Flop (didn't bet)
Seat 2: pyromid folded before Flop (didn't bet)
Seat 3: bonesnz1 folded before Flop (didn't bet)
Seat 4: DIMAN_324 collected ($2.50)
Seat 5: Avtovo (button) folded before Flop (didn't bet)
Seat 6: matiko09 (small blind) folded before Flop
Seat 7: The Big Ape (big blind) folded before Flop
Seat 8: Troll8989 folded before Flop (didn't bet)
Seat 9: chenconhaste folded before Flop (didn't bet)





PokerStars Hand #155013041884:  Hold'em No Limit ($0.50/$1.00 USD) - 2016/06/21 13:15:12 CET [2016/06/21 7:15:12 ET]
Table 'Saldanha' 9-max Seat #6 is the button
Seat 2: matiko09 ($183.20 in chips) 
Seat 5: Eskimo Fox ($103.87 in chips) 
Seat 6: SharingaaN ($78.70 in chips) 
Seat 8: Troll8989 ($100 in chips) 
Seat 9: maxxmeister ($129.59 in chips) 
Avtovo will be allowed to play after the button
Troll8989: posts small blind $0.50
maxxmeister: posts big blind $1
phil_cheng: sits out 
CoolFireX: sits out 
matiko09: posts the ante $0.20
Eskimo Fox: posts the ante $0.20
SharingaaN: posts the ante $0.20
Troll8989: posts the ante $0.20
maxxmeister: posts the ante $0.20
*** HOLE CARDS ***
Dealt to matiko09 [8h Jh]
matiko09: folds 
Eskimo Fox: raises $1.50 to $2.50
SharingaaN: folds 
Avtovo leaves the table
Troll8989: folds 
maxxmeister: folds 
Uncalled bet ($1.50) returned to Eskimo Fox
Troll8989 leaves the table
Eskimo Fox collected $3.50 from pot
Eskimo Fox: doesn't show hand 
*** SUMMARY ***
Total pot $3.50 | Rake $0 
Seat 2: matiko09 folded before Flop (didn't bet)
Seat 5: Eskimo Fox collected ($3.50)
Seat 6: SharingaaN (button) folded before Flop (didn't bet)
Seat 8: Troll8989 (small blind) folded before Flop
Seat 9: maxxmeister (big blind) folded before Flop





PokerStars Hand #155013042544:  Hold'em No Limit (€0.25/€0.50 EUR) - 2016/06/21 13:15:13 CET [2016/06/21 7:15:13 ET]
Table 'Actor II' 6-max Seat #3 is the button
Seat 1: hmverlin (€94.97 in chips) 
Seat 2: ooak182 (€54.45 in chips) 
Seat 3: asmodej666 (€90.18 in chips) 
Seat 4: matiko09 (€50 in chips) 
Seat 5: Rybka1294 (€50.50 in chips) 
Seat 6: fanmtZ (€20.75 in chips) 
matiko09: posts small blind €0.25
Rybka1294: posts big blind €0.50
*** HOLE CARDS ***
Dealt to matiko09 [7d 2h]
fanmtZ: folds 
hmverlin: folds 
ooak182: folds 
asmodej666: raises €0.62 to €1.12
matiko09: folds 
Rybka1294: raises €2.88 to €4
asmodej666: folds 
Uncalled bet (€2.88) returned to Rybka1294
Rybka1294 collected €2.49 from pot
Rybka1294: doesn't show hand 
*** SUMMARY ***
Total pot €2.49 | Rake €0 
Seat 1: hmverlin folded before Flop (didn't bet)
Seat 2: ooak182 folded before Flop (didn't bet)
Seat 3: asmodej666 (button) folded before Flop
Seat 4: matiko09 (small blind) folded before Flop
Seat 5: Rybka1294 (big blind) collected (€2.49)
Seat 6: fanmtZ folded before Flop (didn't bet)





PokerStars Hand #155013042793:  Hold'em No Limit ($0.50/$1.00 USD) - 2016/06/21 13:15:14 CET [2016/06/21 7:15:14 ET]
Table 'Leo' 9-max Seat #8 is the button
Seat 2: torkkdnm ($170.16 in chips) 
Seat 3: matiko09 ($101.80 in chips) 
Seat 4: SharingaaN ($105.85 in chips) 
Seat 5: DIMAN_324 ($111.66 in chips) 
Seat 6: chenconhaste ($121.42 in chips) 
Seat 7: maxxmeister ($100.50 in chips) 
Seat 8: pyromid ($92.42 in chips) 
Seat 9: Wladimir205 ($112.08 in chips) 
Wladimir205: posts small blind $0.50
torkkdnm: posts big blind $1
*** HOLE CARDS ***
Dealt to matiko09 [Kd 3h]
fukumimi joins the table at seat #1 
matiko09: folds 
SharingaaN: folds 
DIMAN_324: folds 
chenconhaste: folds 
maxxmeister: folds 
pyromid: folds 
Wladimir205: folds 
Uncalled bet ($0.50) returned to torkkdnm
torkkdnm collected $1 from pot
*** SUMMARY ***
Total pot $1 | Rake $0 
Seat 2: torkkdnm (big blind) collected ($1)
Seat 3: matiko09 folded before Flop (didn't bet)
Seat 4: SharingaaN folded before Flop (didn't bet)
Seat 5: DIMAN_324 folded before Flop (didn't bet)
Seat 6: chenconhaste folded before Flop (didn't bet)
Seat 7: maxxmeister folded before Flop (didn't bet)
Seat 8: pyromid (button) folded before Flop (didn't bet)
Seat 9: Wladimir205 (small blind) folded before Flop





PokerStars Hand #155013045377:  Hold'em No Limit ($0.50/$1.00 USD) - 2016/06/21 13:15:20 CET [2016/06/21 7:15:20 ET]
Table 'Rupertwildt' 9-max Seat #9 is the button
Seat 1: pokernixxx ($83.49 in chips) 
Seat 2: SharingaaN ($82.42 in chips) 
Seat 4: matiko09 ($146.18 in chips) 
Seat 5: pyromid ($100 in chips) 
Seat 6: ozone2003 ($124.72 in chips) 
Seat 7: chenconhaste ($100.84 in chips) 
Seat 9: mbk88 ($104.93 in chips) 
pokernixxx: posts small blind $0.50
SharingaaN: posts big blind $1
Troll8989: sits out 
*** HOLE CARDS ***
Dealt to matiko09 [2h Ts]
matiko09: folds 
pyromid: raises $1 to $2
ozone2003: folds 
chenconhaste: folds 
mbk88: folds 
pokernixxx: calls $1.50
SharingaaN: calls $1
*** FLOP *** [7h 9s 4d]
pokernixxx: bets $6
SharingaaN: folds 
pyromid: folds 
Uncalled bet ($6) returned to pokernixxx
pokernixxx collected $5.70 from pot
pokernixxx: doesn't show hand 
*** SUMMARY ***
Total pot $6 | Rake $0.30 
Board [7h 9s 4d]
Seat 1: pokernixxx (small blind) collected ($5.70)
Seat 2: SharingaaN (big blind) folded on the Flop
Seat 4: matiko09 folded before Flop (didn't bet)
Seat 5: pyromid folded on the Flop
Seat 6: ozone2003 folded before Flop (didn't bet)
Seat 7: chenconhaste folded before Flop (didn't bet)
Seat 9: mbk88 (button) folded before Flop (didn't bet)





PokerStars Hand #155013046990:  Hold'em No Limit ($0.50/$1.00 USD) - 2016/06/21 13:15:24 CET [2016/06/21 7:15:24 ET]
Table 'Moreau' 9-max Seat #8 is the button
Seat 1: ozone2003 ($130.49 in chips) 
Seat 2: nubpoker ($134.89 in chips) 
Seat 3: matiko09 ($122.38 in chips) 
Seat 5: DIMAN_324 ($100 in chips) 
Seat 6: mbk88 ($100 in chips) 
Seat 7: PanKwn15 ($50.43 in chips) 
Seat 8: maxxmeister ($110.30 in chips) 
Seat 9: Toonersens ($112.42 in chips) 
Toonersens: posts small blind $0.50
ozone2003: posts big blind $1
*** HOLE CARDS ***
Dealt to matiko09 [9s Tc]
nubpoker: folds 
matiko09: folds 
DIMAN_324: folds 
mbk88: raises $2 to $3
PanKwn15: folds 
maxxmeister: folds 
Toonersens: folds 
ozone2003: raises $6 to $9
mbk88: folds 
Uncalled bet ($6) returned to ozone2003
ozone2003 collected $6.50 from pot
ozone2003: doesn't show hand 
*** SUMMARY ***
Total pot $6.50 | Rake $0 
Seat 1: ozone2003 (big blind) collected ($6.50)
Seat 2: nubpoker folded before Flop (didn't bet)
Seat 3: matiko09 folded before Flop (didn't bet)
Seat 5: DIMAN_324 folded before Flop (didn't bet)
Seat 6: mbk88 folded before Flop
Seat 7: PanKwn15 folded before Flop (didn't bet)
Seat 8: maxxmeister (button) folded before Flop (didn't bet)
Seat 9: Toonersens (small blind) folded before Flop





PokerStars Hand #155013047326:  Hold'em No Limit (€0.25/€0.50 EUR) - 2016/06/21 13:15:25 CET [2016/06/21 7:15:25 ET]
Table 'Lotis II' 6-max Seat #3 is the button
Seat 1: acaestanemo (€51.82 in chips) 
Seat 2: broh202 (€103.13 in chips) 
Seat 3: bricasse1961 (€40.35 in chips) 
Seat 4: matiko09 (€74.89 in chips) 
Seat 5: AlexPles (€71.52 in chips) 
Seat 6: asmodej666 (€59.13 in chips) 
matiko09: posts small blind €0.25
AlexPles: posts big blind €0.50
*** HOLE CARDS ***
Dealt to matiko09 [2s 5h]
asmodej666: folds 
acaestanemo: folds 
broh202: folds 
bricasse1961: folds 
matiko09: folds 
Uncalled bet (€0.25) returned to AlexPles
AlexPles collected €0.50 from pot
AlexPles: doesn't show hand 
*** SUMMARY ***
Total pot €0.50 | Rake €0 
Seat 1: acaestanemo folded before Flop (didn't bet)
Seat 2: broh202 folded before Flop (didn't bet)
Seat 3: bricasse1961 (button) folded before Flop (didn't bet)
Seat 4: matiko09 (small blind) folded before Flop
Seat 5: AlexPles (big blind) collected (€0.50)
Seat 6: asmodej666 folded before Flop (didn't bet)





PokerStars Hand #155013047720:  Hold'em No Limit ($0.50/$1.00 USD) - 2016/06/21 13:15:26 CET [2016/06/21 7:15:26 ET]
Table 'Leo' 9-max Seat #9 is the button
Seat 2: torkkdnm ($170.66 in chips) 
Seat 3: matiko09 ($101.80 in chips) 
Seat 4: SharingaaN ($105.85 in chips) 
Seat 5: DIMAN_324 ($111.66 in chips) 
Seat 6: chenconhaste ($121.42 in chips) 
Seat 7: maxxmeister ($100.50 in chips) 
Seat 8: pyromid ($92.42 in chips) 
Seat 9: Wladimir205 ($111.58 in chips) 
fukumimi will be allowed to play after the button
torkkdnm: posts small blind $0.50
matiko09: posts big blind $1
*** HOLE CARDS ***
Dealt to matiko09 [7d 7h]
SharingaaN: folds 
DIMAN_324: folds 
chenconhaste: folds 
maxxmeister: folds 
pyromid: folds 
Wladimir205: folds 
torkkdnm: raises $1 to $2
matiko09: calls $1
*** FLOP *** [5d 3s Ad]
torkkdnm: checks 
matiko09: checks 
*** TURN *** [5d 3s Ad] [5h]
torkkdnm: checks 
matiko09: bets $1.97
torkkdnm: folds 
Uncalled bet ($1.97) returned to matiko09
matiko09 collected $3.80 from pot
matiko09: doesn't show hand 
*** SUMMARY ***
Total pot $4 | Rake $0.20 
Board [5d 3s Ad 5h]
Seat 2: torkkdnm (small blind) folded on the Turn
Seat 3: matiko09 (big blind) collected ($3.80)
Seat 4: SharingaaN folded before Flop (didn't bet)
Seat 5: DIMAN_324 folded before Flop (didn't bet)
Seat 6: chenconhaste folded before Flop (didn't bet)
Seat 7: maxxmeister folded before Flop (didn't bet)
Seat 8: pyromid folded before Flop (didn't bet)
Seat 9: Wladimir205 (button) folded before Flop (didn't bet)





PokerStars Hand #155013048632:  Hold'em No Limit ($0.50/$1.00 USD) - 2016/06/21 13:15:28 CET [2016/06/21 7:15:28 ET]
Table 'Saldanha' 9-max Seat #9 is the button
Seat 2: matiko09 ($183 in chips) 
Seat 4: CoolFireX ($100 in chips) 
Seat 5: Eskimo Fox ($106.17 in chips) 
Seat 6: SharingaaN ($78.50 in chips) 
Seat 9: maxxmeister ($128.39 in chips) 
phil_cheng will be allowed to play after the button
matiko09: posts small blind $0.50
CoolFireX: posts big blind $1
matiko09: posts the ante $0.20
CoolFireX: posts the ante $0.20
Eskimo Fox: posts the ante $0.20
SharingaaN: posts the ante $0.20
maxxmeister: posts the ante $0.20
*** HOLE CARDS ***
Dealt to matiko09 [7c 4c]
Eskimo Fox: raises $1.50 to $2.50
SharingaaN: folds 
maxxmeister: folds 
matiko09: folds 
CoolFireX: folds 
Uncalled bet ($1.50) returned to Eskimo Fox
Eskimo Fox collected $3.50 from pot
Eskimo Fox: doesn't show hand 
*** SUMMARY ***
Total pot $3.50 | Rake $0 
Seat 2: matiko09 (small blind) folded before Flop
Seat 4: CoolFireX (big blind) folded before Flop
Seat 5: Eskimo Fox collected ($3.50)
Seat 6: SharingaaN folded before Flop (didn't bet)
Seat 9: maxxmeister (button) folded before Flop (didn't bet)





PokerStars Hand #155013049525:  Hold'em No Limit ($0.50/$1.00 USD) - 2016/06/21 13:15:30 CET [2016/06/21 7:15:30 ET]
Table 'Lamberta II' 9-max Seat #2 is the button
Seat 2: mavin80 ($94.42 in chips) 
Seat 3: matiko09 ($102 in chips) 
Seat 4: Eskimo Fox ($106 in chips) 
Seat 5: mi$$I$Elena ($101.50 in chips) 
Seat 6: DIMAN_324 ($100 in chips) 
Seat 9: Sjtu_Michael ($106.58 in chips) 
matiko09: posts small blind $0.50
Eskimo Fox: posts big blind $1
Troll8989: sits out 
*** HOLE CARDS ***
Dealt to matiko09 [Ks 6d]
mi$$I$Elena: folds 
DIMAN_324: folds 
Sjtu_Michael: raises $2 to $3
mavin80: folds 
matiko09: folds 
Eskimo Fox: calls $2
*** FLOP *** [Ts Tc 8s]
Eskimo Fox: checks 
Sjtu_Michael: bets $3.09
Eskimo Fox: folds 
Uncalled bet ($3.09) returned to Sjtu_Michael
Sjtu_Michael collected $6.18 from pot
Sjtu_Michael: doesn't show hand 
*** SUMMARY ***
Total pot $6.50 | Rake $0.32 
Board [Ts Tc 8s]
Seat 2: mavin80 (button) folded before Flop (didn't bet)
Seat 3: matiko09 (small blind) folded before Flop
Seat 4: Eskimo Fox (big blind) folded on the Flop
Seat 5: mi$$I$Elena folded before Flop (didn't bet)
Seat 6: DIMAN_324 folded before Flop (didn't bet)
Seat 9: Sjtu_Michael collected ($6.18)





PokerStars Hand #155013051654:  Hold'em No Limit (€0.25/€0.50 EUR) - 2016/06/21 13:15:35 CET [2016/06/21 7:15:35 ET]
Table 'Lotis II' 6-max Seat #4 is the button
Seat 1: acaestanemo (€51.82 in chips) 
Seat 2: broh202 (€103.13 in chips) 
Seat 3: bricasse1961 (€40.35 in chips) 
Seat 4: matiko09 (€74.64 in chips) 
Seat 5: AlexPles (€71.77 in chips) 
Seat 6: asmodej666 (€59.13 in chips) 
AlexPles: posts small blind €0.25
asmodej666: posts big blind €0.50
*** HOLE CARDS ***
Dealt to matiko09 [7h 7d]
acaestanemo: raises €1 to €1.50
broh202: folds 
bricasse1961: folds 
matiko09: calls €1.50
AlexPles: folds 
asmodej666: folds 
*** FLOP *** [7s 6c 5d]
acaestanemo: bets €2.50
matiko09: calls €2.50
*** TURN *** [7s 6c 5d] [Qs]
acaestanemo: bets €6
matiko09: raises €8.50 to €14.50
acaestanemo: calls €8.50
*** RIVER *** [7s 6c 5d Qs] [4d]
acaestanemo: checks 
matiko09: checks 
*** SHOW DOWN ***
acaestanemo: shows [Ks Qc] (a pair of Queens)
matiko09: shows [7h 7d] (three of a kind, Sevens)
matiko09 collected €35.95 from pot
*** SUMMARY ***
Total pot €37.75 | Rake €1.80 
Board [7s 6c 5d Qs 4d]
Seat 1: acaestanemo showed [Ks Qc] and lost with a pair of Queens
Seat 2: broh202 folded before Flop (didn't bet)
Seat 3: bricasse1961 folded before Flop (didn't bet)
Seat 4: matiko09 (button) showed [7h 7d] and won (€35.95) with three of a kind, Sevens
Seat 5: AlexPles (small blind) folded before Flop
Seat 6: asmodej666 (big blind) folded before Flop





PokerStars Hand #155013052195:  Hold'em No Limit ($0.50/$1.00 USD) - 2016/06/21 13:15:37 CET [2016/06/21 7:15:37 ET]
Table 'Cheleb' 9-max Seat #6 is the button
Seat 1: SharingaaN ($122.15 in chips) 
Seat 2: pyromid ($135.88 in chips) 
Seat 4: DIMAN_324 ($188.07 in chips) 
Seat 5: Avtovo ($135.50 in chips) 
Seat 6: matiko09 ($101 in chips) 
Seat 7: The Big Ape ($99 in chips) 
Seat 8: Troll8989 ($100 in chips) 
Seat 9: chenconhaste ($109.52 in chips) 
The Big Ape: posts small blind $0.50
Troll8989: posts big blind $1
phil_cheng: sits out 
*** HOLE CARDS ***
Dealt to matiko09 [6s Ts]
chenconhaste: folds 
chenconhaste leaves the table
mbk88 joins the table at seat #9 
SharingaaN: raises $2 to $3
pyromid: folds 
DIMAN_324: folds 
Avtovo: folds 
matiko09: folds 
The Big Ape: calls $2.50
Troll8989: calls $2
*** FLOP *** [6c 5d 8s]
The Big Ape: checks 
Troll8989: checks 
SharingaaN: bets $6.84
The Big Ape: calls $6.84
Troll8989: folds 
*** TURN *** [6c 5d 8s] [2c]
The Big Ape: checks 
SharingaaN: bets $11
The Big Ape: calls $11
*** RIVER *** [6c 5d 8s 2c] [2d]
The Big Ape: checks 
SharingaaN: bets $26
The Big Ape: calls $26
*** SHOW DOWN ***
SharingaaN: shows [Qd Qh] (two pair, Queens and Deuces)
The Big Ape: mucks hand 
SharingaaN collected $94.18 from pot
*** SUMMARY ***
Total pot $96.68 | Rake $2.50 
Board [6c 5d 8s 2c 2d]
Seat 1: SharingaaN showed [Qd Qh] and won ($94.18) with two pair, Queens and Deuces
Seat 2: pyromid folded before Flop (didn't bet)
Seat 4: DIMAN_324 folded before Flop (didn't bet)
Seat 5: Avtovo folded before Flop (didn't bet)
Seat 6: matiko09 (button) folded before Flop (didn't bet)
Seat 7: The Big Ape (small blind) mucked [Ks As]
Seat 8: Troll8989 (big blind) folded on the Flop
Seat 9: chenconhaste folded before Flop (didn't bet)





PokerStars Hand #155013053274:  Hold'em No Limit ($0.50/$1.00 USD) - 2016/06/21 13:15:39 CET [2016/06/21 7:15:39 ET]
Table 'Brauna II' 9-max Seat #8 is the button
Seat 1: wisbc ($186.61 in chips) 
Seat 2: pyromid ($142.02 in chips) 
Seat 3: matiko09 ($101.50 in chips) 
Seat 4: chenconhaste ($196.75 in chips) 
Seat 5: fukumimi ($100 in chips) 
Seat 6: mbk88 ($163.26 in chips) 
Seat 7: Troll8989 ($100 in chips) 
Seat 8: Avtovo ($100 in chips) 
Seat 9: torkkdnm ($100 in chips) 
torkkdnm: posts small blind $0.50
wisbc: posts big blind $1
*** HOLE CARDS ***
Dealt to matiko09 [3d 6d]
pyromid: folds 
matiko09: folds 
chenconhaste: folds 
fukumimi: raises $2 to $3
mbk88: folds 
Troll8989: folds 
Avtovo: folds 
torkkdnm: folds 
wisbc: folds 
Uncalled bet ($2) returned to fukumimi
fukumimi collected $2.50 from pot
fukumimi: doesn't show hand 
*** SUMMARY ***
Total pot $2.50 | Rake $0 
Seat 1: wisbc (big blind) folded before Flop
Seat 2: pyromid folded before Flop (didn't bet)
Seat 3: matiko09 folded before Flop (didn't bet)
Seat 4: chenconhaste folded before Flop (didn't bet)
Seat 5: fukumimi collected ($2.50)
Seat 6: mbk88 folded before Flop (didn't bet)
Seat 7: Troll8989 folded before Flop (didn't bet)
Seat 8: Avtovo (button) folded before Flop (didn't bet)
Seat 9: torkkdnm (small blind) folded before Flop





PokerStars Hand #155013056833:  Hold'em No Limit (€0.25/€0.50 EUR) - 2016/06/21 13:15:48 CET [2016/06/21 7:15:48 ET]
Table 'Actor II' 6-max Seat #4 is the button
Seat 1: hmverlin (€94.97 in chips) 
Seat 2: ooak182 (€54.45 in chips) 
Seat 3: asmodej666 (€89.06 in chips) 
Seat 4: matiko09 (€50 in chips) 
Seat 5: Rybka1294 (€51.87 in chips) 
Seat 6: fanmtZ (€20.75 in chips) 
Rybka1294: posts small blind €0.25
fanmtZ: posts big blind €0.50
*** HOLE CARDS ***
Dealt to matiko09 [3c Jh]
hmverlin: folds 
ooak182: folds 
asmodej666: folds 
matiko09: folds 
Rybka1294: raises €1 to €1.50
fanmtZ: folds 
Uncalled bet (€1) returned to Rybka1294
Rybka1294 collected €1 from pot
Rybka1294: doesn't show hand 
*** SUMMARY ***
Total pot €1 | Rake €0 
Seat 1: hmverlin folded before Flop (didn't bet)
Seat 2: ooak182 folded before Flop (didn't bet)
Seat 3: asmodej666 folded before Flop (didn't bet)
Seat 4: matiko09 (button) folded before Flop (didn't bet)
Seat 5: Rybka1294 (small blind) collected (€1)
Seat 6: fanmtZ (big blind) folded before Flop





PokerStars Hand #155013058003:  Hold'em No Limit ($0.50/$1.00 USD) - 2016/06/21 13:15:51 CET [2016/06/21 7:15:51 ET]
Table 'Saldanha' 9-max Seat #2 is the button
Seat 2: matiko09 ($182.30 in chips) 
Seat 4: CoolFireX ($100 in chips) 
Seat 6: SharingaaN ($78.30 in chips) 
Seat 9: maxxmeister ($128.19 in chips) 
CoolFireX: posts small blind $0.50
Eskimo Fox: is sitting out 
SharingaaN: posts big blind $1
phil_cheng: sits out 
matiko09: posts the ante $0.20
CoolFireX: posts the ante $0.20
SharingaaN: posts the ante $0.20
maxxmeister: posts the ante $0.20
*** HOLE CARDS ***
Dealt to matiko09 [9s Jh]
Eskimo Fox leaves the table
maxxmeister: folds 
matiko09: raises $1.27 to $2.27
CoolFireX: folds 
SharingaaN: folds 
Uncalled bet ($1.27) returned to matiko09
matiko09 collected $3.30 from pot
matiko09: doesn't show hand 
*** SUMMARY ***
Total pot $3.30 | Rake $0 
Seat 2: matiko09 (button) collected ($3.30)
Seat 4: CoolFireX (small blind) folded before Flop
Seat 6: SharingaaN (big blind) folded before Flop
Seat 9: maxxmeister folded before Flop (didn't bet)





PokerStars Hand #155013059129:  Hold'em No Limit ($0.50/$1.00 USD) - 2016/06/21 13:15:53 CET [2016/06/21 7:15:53 ET]
Table 'Rupertwildt' 9-max Seat #1 is the button
Seat 1: pokernixxx ($87.19 in chips) 
Seat 2: SharingaaN ($80.42 in chips) 
Seat 3: Troll8989 ($100 in chips) 
Seat 4: matiko09 ($146.18 in chips) 
Seat 5: pyromid ($98 in chips) 
Seat 6: ozone2003 ($124.72 in chips) 
Seat 7: chenconhaste ($100.84 in chips) 
Seat 9: mbk88 ($104.93 in chips) 
SharingaaN: posts small blind $0.50
Troll8989: posts big blind $1
*** HOLE CARDS ***
Dealt to matiko09 [Kh 4h]
matiko09: folds 
pyromid: folds 
ozone2003: folds 
chenconhaste: raises $1.25 to $2.25
mbk88: folds 
pokernixxx: calls $2.25
SharingaaN: raises $9.75 to $12
Troll8989: folds 
chenconhaste: calls $9.75
pokernixxx: calls $9.75
*** FLOP *** [9c Th 4s]
SharingaaN: checks 
chenconhaste: checks 
pokernixxx: checks 
*** TURN *** [9c Th 4s] [6h]
SharingaaN: checks 
chenconhaste: bets $23
pokernixxx: folds 
SharingaaN: folds 
Uncalled bet ($23) returned to chenconhaste
chenconhaste collected $35.15 from pot
*** SUMMARY ***
Total pot $37 | Rake $1.85 
Board [9c Th 4s 6h]
Seat 1: pokernixxx (button) folded on the Turn
Seat 2: SharingaaN (small blind) folded on the Turn
Seat 3: Troll8989 (big blind) folded before Flop
Seat 4: matiko09 folded before Flop (didn't bet)
Seat 5: pyromid folded before Flop (didn't bet)
Seat 6: ozone2003 folded before Flop (didn't bet)
Seat 7: chenconhaste collected ($35.15)
Seat 9: mbk88 folded before Flop (didn't bet)





PokerStars Hand #155013059722:  Hold'em No Limit ($0.50/$1.00 USD) - 2016/06/21 13:15:55 CET [2016/06/21 7:15:55 ET]
Table 'Moreau' 9-max Seat #9 is the button
Seat 1: ozone2003 ($133.99 in chips) 
Seat 2: nubpoker ($134.89 in chips) 
Seat 3: matiko09 ($122.38 in chips) 
Seat 5: DIMAN_324 ($100 in chips) 
Seat 6: mbk88 ($100 in chips) 
Seat 7: PanKwn15 ($50.43 in chips) 
Seat 8: maxxmeister ($110.30 in chips) 
Seat 9: Toonersens ($111.92 in chips) 
ozone2003: posts small blind $0.50
nubpoker: posts big blind $1
*** HOLE CARDS ***
Dealt to matiko09 [Qh 8h]
matiko09: folds 
DIMAN_324: folds 
mbk88: folds 
PanKwn15: folds 
maxxmeister: folds 
Toonersens: raises $2 to $3
ozone2003: folds 
nubpoker: calls $2
*** FLOP *** [Qc 7s 8c]
SharingaaN joins the table at seat #4 
nubpoker: checks 
Toonersens: bets $4
nubpoker: calls $4
*** TURN *** [Qc 7s 8c] [3h]
nubpoker: checks 
Toonersens: checks 
*** RIVER *** [Qc 7s 8c 3h] [5c]
nubpoker: checks 
Toonersens: checks 
*** SHOW DOWN ***
nubpoker: shows [Qs Jc] (a pair of Queens)
Toonersens: mucks hand 
nubpoker collected $13.78 from pot
*** SUMMARY ***
Total pot $14.50 | Rake $0.72 
Board [Qc 7s 8c 3h 5c]
Seat 1: ozone2003 (small blind) folded before Flop
Seat 2: nubpoker (big blind) showed [Qs Jc] and won ($13.78) with a pair of Queens
Seat 3: matiko09 folded before Flop (didn't bet)
Seat 5: DIMAN_324 folded before Flop (didn't bet)
Seat 6: mbk88 folded before Flop (didn't bet)
Seat 7: PanKwn15 folded before Flop (didn't bet)
Seat 8: maxxmeister folded before Flop (didn't bet)
Seat 9: Toonersens (button) mucked [Js Ac]





PokerStars Hand #155013064959:  Hold'em No Limit (€0.25/€0.50 EUR) - 2016/06/21 13:16:07 CET [2016/06/21 7:16:07 ET]
Table 'Actor II' 6-max Seat #5 is the button
Seat 1: hmverlin (€94.97 in chips) 
Seat 2: ooak182 (€54.45 in chips) 
Seat 3: asmodej666 (€89.06 in chips) 
Seat 4: matiko09 (€50 in chips) 
Seat 5: Rybka1294 (€52.37 in chips) 
Seat 6: fanmtZ (€20.25 in chips) 
fanmtZ: posts small blind €0.25
hmverlin: posts big blind €0.50
*** HOLE CARDS ***
Dealt to matiko09 [Td 5d]
ooak182: folds 
asmodej666: folds 
matiko09: folds 
Rybka1294: raises €0.50 to €1
fanmtZ: calls €0.75
hmverlin: calls €0.50
*** FLOP *** [As 4h 5h]
fanmtZ: checks 
hmverlin: bets €1.50
Rybka1294: folds 
fanmtZ: folds 
Uncalled bet (€1.50) returned to hmverlin
hmverlin collected €2.85 from pot
hmverlin: doesn't show hand 
*** SUMMARY ***
Total pot €3 | Rake €0.15 
Board [As 4h 5h]
Seat 1: hmverlin (big blind) collected (€2.85)
Seat 2: ooak182 folded before Flop (didn't bet)
Seat 3: asmodej666 folded before Flop (didn't bet)
Seat 4: matiko09 folded before Flop (didn't bet)
Seat 5: Rybka1294 (button) folded on the Flop
Seat 6: fanmtZ (small blind) folded on the Flop





PokerStars Hand #155013064912:  Hold'em No Limit ($0.50/$1.00 USD) - 2016/06/21 13:16:07 CET [2016/06/21 7:16:07 ET]
Table 'Carlova II' 9-max Seat #7 is the button
Seat 1: matiko09 ($120.30 in chips) 
Seat 2: chenconhaste ($121.23 in chips) 
Seat 3: King_Z�Manel ($100 in chips) 
Seat 4: Dandy Monk ($63.41 in chips) 
Seat 5: ozone2003 ($107.50 in chips) 
Seat 6: DIMAN_324 ($100 in chips) 
Seat 7: mi$$I$Elena ($121.47 in chips) 
Seat 8: pyromid ($99 in chips) 
Seat 9: Troll8989 ($104.68 in chips) 
pyromid: posts small blind $0.50
Troll8989: posts big blind $1
*** HOLE CARDS ***
Dealt to matiko09 [9c Ac]
matiko09: folds 
chenconhaste: folds 
King_Z�Manel: folds 
Dandy Monk: folds 
ozone2003: folds 
DIMAN_324: folds 
mi$$I$Elena: raises $1 to $2
pyromid: folds 
Troll8989: folds 
Uncalled bet ($1) returned to mi$$I$Elena
mi$$I$Elena collected $2.50 from pot
mi$$I$Elena: doesn't show hand 
*** SUMMARY ***
Total pot $2.50 | Rake $0 
Seat 1: matiko09 folded before Flop (didn't bet)
Seat 2: chenconhaste folded before Flop (didn't bet)
Seat 3: King_Z�Manel folded before Flop (didn't bet)
Seat 4: Dandy Monk folded before Flop (didn't bet)
Seat 5: ozone2003 folded before Flop (didn't bet)
Seat 6: DIMAN_324 folded before Flop (didn't bet)
Seat 7: mi$$I$Elena (button) collected ($2.50)
Seat 8: pyromid (small blind) folded before Flop
Seat 9: Troll8989 (big blind) folded before Flop





PokerStars Hand #155013065333:  Hold'em No Limit ($0.50/$1.00 USD) - 2016/06/21 13:16:08 CET [2016/06/21 7:16:08 ET]
Table 'Saldanha' 9-max Seat #4 is the button
Seat 2: matiko09 ($184.40 in chips) 
Seat 4: CoolFireX ($100 in chips) 
Seat 6: SharingaaN ($77.10 in chips) 
Seat 9: maxxmeister ($127.99 in chips) 
SharingaaN: posts small blind $0.50
maxxmeister: posts big blind $1
phil_cheng: sits out 
matiko09: posts the ante $0.20
CoolFireX: posts the ante $0.20
SharingaaN: posts the ante $0.20
maxxmeister: posts the ante $0.20
*** HOLE CARDS ***
Dealt to matiko09 [9d Ks]
matiko09: folds 
CoolFireX: folds 
Michael Quan joins the table at seat #5 
SharingaaN: raises $1 to $2
ozone2003 joins the table at seat #7 
maxxmeister: calls $1
*** FLOP *** [2c Td Ts]
erick222 joins the table at seat #8 
SharingaaN: checks 
maxxmeister: bets $3.10
SharingaaN: folds 
Uncalled bet ($3.10) returned to maxxmeister
maxxmeister collected $4.56 from pot
maxxmeister: doesn't show hand 
*** SUMMARY ***
Total pot $4.80 | Rake $0.24 
Board [2c Td Ts]
Seat 2: matiko09 folded before Flop (didn't bet)
Seat 4: CoolFireX (button) folded before Flop (didn't bet)
Seat 6: SharingaaN (small blind) folded on the Flop
Seat 9: maxxmeister (big blind) collected ($4.56)





PokerStars Hand #155013066848:  Hold'em No Limit ($0.50/$1.00 USD) - 2016/06/21 13:16:12 CET [2016/06/21 7:16:12 ET]
Table 'Lamberta II' 9-max Seat #3 is the button
Seat 2: mavin80 ($94.42 in chips) 
Seat 3: matiko09 ($101.50 in chips) 
Seat 4: Eskimo Fox ($103 in chips) 
Seat 5: mi$$I$Elena ($101.50 in chips) 
Seat 6: DIMAN_324 ($100 in chips) 
Seat 9: Sjtu_Michael ($109.76 in chips) 
Eskimo Fox: posts small blind $0.50
mi$$I$Elena: posts big blind $1
Troll8989: sits out 
*** HOLE CARDS ***
Dealt to matiko09 [7d Js]
DIMAN_324: folds 
Sjtu_Michael: folds 
mavin80: folds 
matiko09: folds 
Eskimo Fox: folds 
Uncalled bet ($0.50) returned to mi$$I$Elena
mi$$I$Elena collected $1 from pot
mi$$I$Elena: doesn't show hand 
*** SUMMARY ***
Total pot $1 | Rake $0 
Seat 2: mavin80 folded before Flop (didn't bet)
Seat 3: matiko09 (button) folded before Flop (didn't bet)
Seat 4: Eskimo Fox (small blind) folded before Flop
Seat 5: mi$$I$Elena (big blind) collected ($1)
Seat 6: DIMAN_324 folded before Flop (didn't bet)
Seat 9: Sjtu_Michael folded before Flop (didn't bet)





PokerStars Hand #155013074589:  Hold'em No Limit ($0.50/$1.00 USD) - 2016/06/21 13:16:30 CET [2016/06/21 7:16:30 ET]
Table 'Brauna II' 9-max Seat #9 is the button
Seat 1: wisbc ($185.61 in chips) 
Seat 2: pyromid ($142.02 in chips) 
Seat 3: matiko09 ($101.50 in chips) 
Seat 4: chenconhaste ($196.75 in chips) 
Seat 5: fukumimi ($101.50 in chips) 
Seat 6: mbk88 ($163.26 in chips) 
Seat 7: Troll8989 ($100 in chips) 
Seat 8: Avtovo ($100 in chips) 
Seat 9: torkkdnm ($100 in chips) 
wisbc: posts small blind $0.50
pyromid: posts big blind $1
*** HOLE CARDS ***
Dealt to matiko09 [3c Qh]
matiko09: folds 
chenconhaste: folds 
fukumimi: raises $2 to $3
mbk88: folds 
Troll8989: folds 
Avtovo: folds 
torkkdnm: folds 
wisbc: folds 
pyromid: folds 
Uncalled bet ($2) returned to fukumimi
fukumimi collected $2.50 from pot
fukumimi: doesn't show hand 
*** SUMMARY ***
Total pot $2.50 | Rake $0 
Seat 1: wisbc (small blind) folded before Flop
Seat 2: pyromid (big blind) folded before Flop
Seat 3: matiko09 folded before Flop (didn't bet)
Seat 4: chenconhaste folded before Flop (didn't bet)
Seat 5: fukumimi collected ($2.50)
Seat 6: mbk88 folded before Flop (didn't bet)
Seat 7: Troll8989 folded before Flop (didn't bet)
Seat 8: Avtovo folded before Flop (didn't bet)
Seat 9: torkkdnm (button) folded before Flop (didn't bet)





PokerStars Hand #155013075976:  Hold'em No Limit ($0.50/$1.00 USD) - 2016/06/21 13:16:34 CET [2016/06/21 7:16:34 ET]
Table 'Lamberta II' 9-max Seat #4 is the button
Seat 2: mavin80 ($94.42 in chips) 
Seat 3: matiko09 ($101.50 in chips) 
Seat 4: Eskimo Fox ($102.50 in chips) 
Seat 5: mi$$I$Elena ($102 in chips) 
Seat 6: DIMAN_324 ($100 in chips) 
Seat 9: Sjtu_Michael ($109.76 in chips) 
mi$$I$Elena: posts small blind $0.50
DIMAN_324: posts big blind $1
Troll8989: sits out 
*** HOLE CARDS ***
Dealt to matiko09 [4s 7c]
Sjtu_Michael: folds 
mavin80: folds 
matiko09: folds 
Eskimo Fox: folds 
mi$$I$Elena: raises $2 to $3
DIMAN_324: folds 
Uncalled bet ($2) returned to mi$$I$Elena
mi$$I$Elena collected $2 from pot
mi$$I$Elena: doesn't show hand 
*** SUMMARY ***
Total pot $2 | Rake $0 
Seat 2: mavin80 folded before Flop (didn't bet)
Seat 3: matiko09 folded before Flop (didn't bet)
Seat 4: Eskimo Fox (button) folded before Flop (didn't bet)
Seat 5: mi$$I$Elena (small blind) collected ($2)
Seat 6: DIMAN_324 (big blind) folded before Flop
Seat 9: Sjtu_Michael folded before Flop (didn't bet)





PokerStars Hand #155013076331:  Hold'em No Limit (€0.25/€0.50 EUR) - 2016/06/21 13:16:35 CET [2016/06/21 7:16:35 ET]
Table 'Lotis II' 6-max Seat #5 is the button
Seat 2: broh202 (€103.13 in chips) 
Seat 3: bricasse1961 (€40.35 in chips) 
Seat 4: matiko09 (€92.09 in chips) 
Seat 5: AlexPles (€71.52 in chips) 
Seat 6: asmodej666 (€58.63 in chips) 
asmodej666: posts small blind €0.25
acaestanemo: is sitting out 
broh202: posts big blind €0.50
*** HOLE CARDS ***
Dealt to matiko09 [Qd As]
acaestanemo leaves the table
bricasse1961: folds 
matiko09: raises €1 to €1.50
tyoma_knp joins the table at seat #1 
AlexPles: folds 
asmodej666: folds 
broh202: calls €1
*** FLOP *** [Qc 2c 7d]
broh202: checks 
matiko09: bets €2
broh202: folds 
Uncalled bet (€2) returned to matiko09
matiko09 collected €3.09 from pot
matiko09: doesn't show hand 
*** SUMMARY ***
Total pot €3.25 | Rake €0.16 
Board [Qc 2c 7d]
Seat 2: broh202 (big blind) folded on the Flop
Seat 3: bricasse1961 folded before Flop (didn't bet)
Seat 4: matiko09 collected (€3.09)
Seat 5: AlexPles (button) folded before Flop (didn't bet)
Seat 6: asmodej666 (small blind) folded before Flop





PokerStars Hand #155013079309:  Hold'em No Limit ($0.50/$1.00 USD) - 2016/06/21 13:16:42 CET [2016/06/21 7:16:42 ET]
Table 'Leo' 9-max Seat #2 is the button
Seat 2: torkkdnm ($168.66 in chips) 
Seat 3: matiko09 ($103.60 in chips) 
Seat 4: SharingaaN ($105.85 in chips) 
Seat 5: DIMAN_324 ($111.66 in chips) 
Seat 6: chenconhaste ($121.42 in chips) 
Seat 7: maxxmeister ($100.50 in chips) 
Seat 8: pyromid ($92.42 in chips) 
Seat 9: Wladimir205 ($111.58 in chips) 
matiko09: posts small blind $0.50
SharingaaN: posts big blind $1
fukumimi: sits out 
*** HOLE CARDS ***
Dealt to matiko09 [5d 7h]
DIMAN_324: folds 
chenconhaste: folds 
maxxmeister: folds 
pyromid: folds 
Wladimir205: folds 
torkkdnm: raises $1 to $2
matiko09: folds 
SharingaaN: folds 
Uncalled bet ($1) returned to torkkdnm
torkkdnm collected $2.50 from pot
*** SUMMARY ***
Total pot $2.50 | Rake $0 
Seat 2: torkkdnm (button) collected ($2.50)
Seat 3: matiko09 (small blind) folded before Flop
Seat 4: SharingaaN (big blind) folded before Flop
Seat 5: DIMAN_324 folded before Flop (didn't bet)
Seat 6: chenconhaste folded before Flop (didn't bet)
Seat 7: maxxmeister folded before Flop (didn't bet)
Seat 8: pyromid folded before Flop (didn't bet)
Seat 9: Wladimir205 folded before Flop (didn't bet)





PokerStars Hand #155013083936:  Hold'em No Limit ($0.50/$1.00 USD) - 2016/06/21 13:16:53 CET [2016/06/21 7:16:53 ET]
Table 'Lamberta II' 9-max Seat #5 is the button
Seat 2: mavin80 ($94.42 in chips) 
Seat 3: matiko09 ($101.50 in chips) 
Seat 4: Eskimo Fox ($102.50 in chips) 
Seat 5: mi$$I$Elena ($103 in chips) 
Seat 6: DIMAN_324 ($100 in chips) 
Seat 8: Troll8989 ($100 in chips) 
Seat 9: Sjtu_Michael ($109.76 in chips) 
DIMAN_324: posts small blind $0.50
Troll8989: posts big blind $1
*** HOLE CARDS ***
Dealt to matiko09 [7d Ac]
Sjtu_Michael: folds 
mavin80: raises $1.50 to $2.50
matiko09: folds 
Eskimo Fox: folds 
mi$$I$Elena: folds 
DIMAN_324: folds 
Troll8989: folds 
Uncalled bet ($1.50) returned to mavin80
mavin80 collected $2.50 from pot
mavin80: doesn't show hand 
*** SUMMARY ***
Total pot $2.50 | Rake $0 
Seat 2: mavin80 collected ($2.50)
Seat 3: matiko09 folded before Flop (didn't bet)
Seat 4: Eskimo Fox folded before Flop (didn't bet)
Seat 5: mi$$I$Elena (button) folded before Flop (didn't bet)
Seat 6: DIMAN_324 (small blind) folded before Flop
Seat 8: Troll8989 (big blind) folded before Flop
Seat 9: Sjtu_Michael folded before Flop (didn't bet)





PokerStars Hand #155013085678:  Hold'em No Limit (€0.25/€0.50 EUR) - 2016/06/21 13:16:57 CET [2016/06/21 7:16:57 ET]
Table 'Actor II' 6-max Seat #6 is the button
Seat 1: hmverlin (€96.82 in chips) 
Seat 3: asmodej666 (€89.06 in chips) 
Seat 4: matiko09 (€50 in chips) 
Seat 5: Rybka1294 (€51.37 in chips) 
Seat 6: fanmtZ (€20 in chips) 
hmverlin: posts small blind €0.25
ooak182: is sitting out 
asmodej666: posts big blind €0.50
*** HOLE CARDS ***
Dealt to matiko09 [As 7d]
matiko09: folds 
ooak182 leaves the table
alôha joins the table at seat #2 
Rybka1294: folds 
fanmtZ: raises €0.79 to €1.29
hmverlin: folds 
asmodej666: folds 
Uncalled bet (€0.79) returned to fanmtZ
fanmtZ collected €1.25 from pot
fanmtZ: doesn't show hand 
*** SUMMARY ***
Total pot €1.25 | Rake €0 
Seat 1: hmverlin (small blind) folded before Flop
Seat 3: asmodej666 (big blind) folded before Flop
Seat 4: matiko09 folded before Flop (didn't bet)
Seat 5: Rybka1294 folded before Flop (didn't bet)
Seat 6: fanmtZ (button) collected (€1.25)





PokerStars Hand #155013085498:  Hold'em No Limit ($0.50/$1.00 USD) - 2016/06/21 13:16:57 CET [2016/06/21 7:16:57 ET]
Table 'Rupertwildt' 9-max Seat #2 is the button
Seat 1: pokernixxx ($75.19 in chips) 
Seat 2: SharingaaN ($68.42 in chips) 
Seat 3: Troll8989 ($100 in chips) 
Seat 4: matiko09 ($146.18 in chips) 
Seat 5: pyromid ($98 in chips) 
Seat 6: ozone2003 ($124.72 in chips) 
Seat 7: chenconhaste ($123.99 in chips) 
Seat 8: Gonzanary ($112.14 in chips) 
Seat 9: mbk88 ($104.93 in chips) 
Troll8989: posts small blind $0.50
matiko09: posts big blind $1
Gonzanary: posts small & big blinds $1.50
*** HOLE CARDS ***
Dealt to matiko09 [2d 5d]
pyromid: calls $1
ozone2003: folds 
chenconhaste: folds 
Gonzanary: raises $4 to $5
mbk88: folds 
pokernixxx: folds 
SharingaaN: calls $5
Troll8989: folds 
matiko09: folds 
pyromid: calls $4
*** FLOP *** [9d Qd Kd]
pyromid: checks 
Gonzanary: bets $11
SharingaaN: folds 
pyromid: folds 
Uncalled bet ($11) returned to Gonzanary
Gonzanary collected $16.15 from pot
*** SUMMARY ***
Total pot $17 | Rake $0.85 
Board [9d Qd Kd]
Seat 1: pokernixxx folded before Flop (didn't bet)
Seat 2: SharingaaN (button) folded on the Flop
Seat 3: Troll8989 (small blind) folded before Flop
Seat 4: matiko09 (big blind) folded before Flop
Seat 5: pyromid folded on the Flop
Seat 6: ozone2003 folded before Flop (didn't bet)
Seat 7: chenconhaste folded before Flop (didn't bet)
Seat 8: Gonzanary collected ($16.15)
Seat 9: mbk88 folded before Flop (didn't bet)





PokerStars Hand #155013087388:  Hold'em No Limit ($0.50/$1.00 USD) - 2016/06/21 13:17:01 CET [2016/06/21 7:17:01 ET]
Table 'Carlova II' 9-max Seat #8 is the button
Seat 1: matiko09 ($120.30 in chips) 
Seat 2: chenconhaste ($121.23 in chips) 
Seat 3: King_Z�Manel ($100 in chips) 
Seat 4: Dandy Monk ($63.41 in chips) 
Seat 5: ozone2003 ($107.50 in chips) 
Seat 6: DIMAN_324 ($100 in chips) 
Seat 7: mi$$I$Elena ($122.97 in chips) 
Seat 8: pyromid ($98.50 in chips) 
Seat 9: Troll8989 ($103.68 in chips) 
Troll8989: posts small blind $0.50
matiko09: posts big blind $1
*** HOLE CARDS ***
Dealt to matiko09 [Qh 2h]
chenconhaste: raises $1.25 to $2.25
King_Z�Manel: folds 
Dandy Monk: folds 
ozone2003: folds 
DIMAN_324: folds 
mi$$I$Elena: folds 
pyromid: calls $2.25
Troll8989: folds 
matiko09: folds 
*** FLOP *** [6h Ac 8s]
chenconhaste: bets $3.50
pyromid: calls $3.50
*** TURN *** [6h Ac 8s] [7h]
chenconhaste: checks 
pyromid: bets $5.50
chenconhaste: folds 
Uncalled bet ($5.50) returned to pyromid
pyromid collected $12.35 from pot
pyromid: doesn't show hand 
*** SUMMARY ***
Total pot $13 | Rake $0.65 
Board [6h Ac 8s 7h]
Seat 1: matiko09 (big blind) folded before Flop
Seat 2: chenconhaste folded on the Turn
Seat 3: King_Z�Manel folded before Flop (didn't bet)
Seat 4: Dandy Monk folded before Flop (didn't bet)
Seat 5: ozone2003 folded before Flop (didn't bet)
Seat 6: DIMAN_324 folded before Flop (didn't bet)
Seat 7: mi$$I$Elena folded before Flop (didn't bet)
Seat 8: pyromid (button) collected ($12.35)
Seat 9: Troll8989 (small blind) folded before Flop





PokerStars Hand #155013090549:  Hold'em No Limit ($0.50/$1.00 USD) - 2016/06/21 13:17:09 CET [2016/06/21 7:17:09 ET]
Table 'Cheleb' 9-max Seat #7 is the button
Seat 1: SharingaaN ($169.49 in chips) 
Seat 2: pyromid ($135.88 in chips) 
Seat 4: DIMAN_324 ($188.07 in chips) 
Seat 5: Avtovo ($135.50 in chips) 
Seat 6: matiko09 ($101 in chips) 
Seat 7: The Big Ape ($52.16 in chips) 
Seat 8: Troll8989 ($100 in chips) 
Seat 9: mbk88 ($104.12 in chips) 
Troll8989: posts small blind $0.50
mbk88: posts big blind $1
phil_cheng: sits out 
*** HOLE CARDS ***
Dealt to matiko09 [3h 6d]
SharingaaN: raises $1 to $2
pyromid: calls $2
DIMAN_324: folds 
Avtovo: folds 
matiko09: folds 
The Big Ape: folds 
Troll8989: folds 
mbk88: folds 
*** FLOP *** [7s 5c 4c]
SharingaaN: checks 
pyromid: bets $3
SharingaaN: folds 
Uncalled bet ($3) returned to pyromid
pyromid collected $5.22 from pot
pyromid: doesn't show hand 
*** SUMMARY ***
Total pot $5.50 | Rake $0.28 
Board [7s 5c 4c]
Seat 1: SharingaaN folded on the Flop
Seat 2: pyromid collected ($5.22)
Seat 4: DIMAN_324 folded before Flop (didn't bet)
Seat 5: Avtovo folded before Flop (didn't bet)
Seat 6: matiko09 folded before Flop (didn't bet)
Seat 7: The Big Ape (button) folded before Flop (didn't bet)
Seat 8: Troll8989 (small blind) folded before Flop
Seat 9: mbk88 (big blind) folded before Flop





PokerStars Hand #155013092416:  Hold'em No Limit (€0.25/€0.50 EUR) - 2016/06/21 13:17:13 CET [2016/06/21 7:17:13 ET]
Table 'Lotis II' 6-max Seat #6 is the button
Seat 2: broh202 (€101.63 in chips) 
Seat 3: bricasse1961 (€40.35 in chips) 
Seat 4: matiko09 (€93.68 in chips) 
Seat 5: AlexPles (€71.52 in chips) 
Seat 6: asmodej666 (€58.38 in chips) 
tyoma_knp will be allowed to play after the button
broh202: posts small blind €0.25
bricasse1961: posts big blind €0.50
*** HOLE CARDS ***
Dealt to matiko09 [6d 5c]
matiko09: folds 
AlexPles: folds 
asmodej666: raises €0.62 to €1.12
broh202: raises €2.74 to €3.86
bricasse1961: folds 
asmodej666: calls €2.74
*** FLOP *** [3c Tc 8h]
broh202: bets €5.50
asmodej666: folds 
Uncalled bet (€5.50) returned to broh202
broh202 collected €7.81 from pot
broh202: doesn't show hand 
*** SUMMARY ***
Total pot €8.22 | Rake €0.41 
Board [3c Tc 8h]
Seat 2: broh202 (small blind) collected (€7.81)
Seat 3: bricasse1961 (big blind) folded before Flop
Seat 4: matiko09 folded before Flop (didn't bet)
Seat 5: AlexPles folded before Flop (didn't bet)
Seat 6: asmodej666 (button) folded on the Flop





PokerStars Hand #155013092805:  Hold'em No Limit ($0.50/$1.00 USD) - 2016/06/21 13:17:14 CET [2016/06/21 7:17:14 ET]
Table 'Leo' 9-max Seat #3 is the button
Seat 2: torkkdnm ($170.16 in chips) 
Seat 3: matiko09 ($103.10 in chips) 
Seat 4: SharingaaN ($104.85 in chips) 
Seat 7: maxxmeister ($100.50 in chips) 
Seat 8: pyromid ($92.42 in chips) 
Seat 9: Wladimir205 ($111.58 in chips) 
SharingaaN: posts small blind $0.50
DIMAN_324: is sitting out 
chenconhaste: is sitting out 
maxxmeister: posts big blind $1
chenconhaste leaves the table
fukumimi: sits out 
*** HOLE CARDS ***
Dealt to matiko09 [4d Ks]
DIMAN_324 leaves the table
pyromid: folds 
Wladimir205: raises $1 to $2
Troll8989 joins the table at seat #5 
torkkdnm: folds 
matiko09: folds 
SharingaaN: folds 
maxxmeister: calls $1
*** FLOP *** [Jh Jc 8d]
Avtovo joins the table at seat #6 
maxxmeister: checks 
Wladimir205: bets $3
maxxmeister: folds 
Uncalled bet ($3) returned to Wladimir205
Wladimir205 collected $4.28 from pot
Wladimir205: doesn't show hand 
*** SUMMARY ***
Total pot $4.50 | Rake $0.22 
Board [Jh Jc 8d]
Seat 2: torkkdnm folded before Flop (didn't bet)
Seat 3: matiko09 (button) folded before Flop (didn't bet)
Seat 4: SharingaaN (small blind) folded before Flop
Seat 7: maxxmeister (big blind) folded on the Flop
Seat 8: pyromid folded before Flop (didn't bet)
Seat 9: Wladimir205 collected ($4.28)





PokerStars Hand #155013095996:  Hold'em No Limit (€0.25/€0.50 EUR) - 2016/06/21 13:17:22 CET [2016/06/21 7:17:22 ET]
Table 'Actor II' 6-max Seat #1 is the button
Seat 1: hmverlin (€96.57 in chips) 
Seat 3: asmodej666 (€88.56 in chips) 
Seat 4: matiko09 (€50 in chips) 
Seat 5: Rybka1294 (€51.37 in chips) 
Seat 6: fanmtZ (€20.75 in chips) 
alôha will be allowed to play after the button
asmodej666: posts small blind €0.25
matiko09: posts big blind €0.50
*** HOLE CARDS ***
Dealt to matiko09 [2h 8c]
Rybka1294: folds 
fanmtZ: raises €0.69 to €1.19
hmverlin: calls €1.19
asmodej666: folds 
matiko09: folds 
*** FLOP *** [6d Qd 6c]
fanmtZ: checks 
hmverlin: bets €1.50
fanmtZ: calls €1.50
*** TURN *** [6d Qd 6c] [8d]
fanmtZ: checks 
hmverlin: bets €3
Rybka1294 is disconnected 
fanmtZ: calls €3
*** RIVER *** [6d Qd 6c 8d] [Qs]
fanmtZ: checks 
hmverlin: checks 
*** SHOW DOWN ***
fanmtZ: shows [Ks Ac] (two pair, Queens and Sixes)
hmverlin: shows [3d Ah] (two pair, Queens and Sixes)
fanmtZ collected €5.76 from pot
hmverlin collected €5.76 from pot
*** SUMMARY ***
Total pot €12.13 | Rake €0.61 
Board [6d Qd 6c 8d Qs]
Seat 1: hmverlin (button) showed [3d Ah] and won (€5.76) with two pair, Queens and Sixes
Seat 3: asmodej666 (small blind) folded before Flop
Seat 4: matiko09 (big blind) folded before Flop
Seat 5: Rybka1294 folded before Flop (didn't bet)
Seat 6: fanmtZ showed [Ks Ac] and won (€5.76) with two pair, Queens and Sixes





PokerStars Hand #155013097206:  Hold'em No Limit ($0.50/$1.00 USD) - 2016/06/21 13:17:25 CET [2016/06/21 7:17:25 ET]
Table 'Lamberta II' 9-max Seat #6 is the button
Seat 2: mavin80 ($95.92 in chips) 
Seat 3: matiko09 ($101.50 in chips) 
Seat 4: Eskimo Fox ($102.50 in chips) 
Seat 5: mi$$I$Elena ($103 in chips) 
Seat 6: DIMAN_324 ($100 in chips) 
Seat 8: Troll8989 ($100 in chips) 
Seat 9: Sjtu_Michael ($109.76 in chips) 
Troll8989: posts small blind $0.50
Sjtu_Michael: posts big blind $1
*** HOLE CARDS ***
Dealt to matiko09 [5c Ah]
mavin80: raises $1.50 to $2.50
matiko09: folds 
Eskimo Fox: folds 
mi$$I$Elena: folds 
DIMAN_324: folds 
Troll8989: folds 
Sjtu_Michael: calls $1.50
*** FLOP *** [4d 6c Kh]
Sjtu_Michael: checks 
mavin80: checks 
*** TURN *** [4d 6c Kh] [Ts]
Sjtu_Michael: bets $2.61
mavin80: calls $2.61
*** RIVER *** [4d 6c Kh Ts] [Qs]
Sjtu_Michael: checks 
mavin80: bets $6
Sjtu_Michael: calls $6
*** SHOW DOWN ***
mavin80: shows [Qd As] (a pair of Queens)
Sjtu_Michael: shows [Qc Ac] (a pair of Queens)
Sjtu_Michael collected $10.79 from pot
mavin80 collected $10.79 from pot
*** SUMMARY ***
Total pot $22.72 | Rake $1.14 
Board [4d 6c Kh Ts Qs]
Seat 2: mavin80 showed [Qd As] and won ($10.79) with a pair of Queens
Seat 3: matiko09 folded before Flop (didn't bet)
Seat 4: Eskimo Fox folded before Flop (didn't bet)
Seat 5: mi$$I$Elena folded before Flop (didn't bet)
Seat 6: DIMAN_324 (button) folded before Flop (didn't bet)
Seat 8: Troll8989 (small blind) folded before Flop
Seat 9: Sjtu_Michael (big blind) showed [Qc Ac] and won ($10.79) with a pair of Queens





PokerStars Hand #155013097962:  Hold'em No Limit ($0.50/$1.00 USD) - 2016/06/21 13:17:27 CET [2016/06/21 7:17:27 ET]
Table 'Saldanha' 9-max Seat #6 is the button
Seat 1: phil_cheng ($100 in chips) 
Seat 2: matiko09 ($184.20 in chips) 
Seat 4: CoolFireX ($100 in chips) 
Seat 5: Michael Quan ($100 in chips) 
Seat 6: SharingaaN ($74.90 in chips) 
Seat 9: maxxmeister ($130.35 in chips) 
ozone2003 will be allowed to play after the button
erick222 will be allowed to play after the button
maxxmeister: posts small blind $0.50
phil_cheng: posts big blind $1
Michael Quan: posts big blind $1
phil_cheng: posts the ante $0.20
matiko09: posts the ante $0.20
CoolFireX: posts the ante $0.20
Michael Quan: posts the ante $0.20
SharingaaN: posts the ante $0.20
maxxmeister: posts the ante $0.20
*** HOLE CARDS ***
Dealt to matiko09 [7c Jc]
matiko09: folds 
CoolFireX: raises $2 to $3
Michael Quan: folds 
SharingaaN: folds 
maxxmeister: folds 
phil_cheng: raises $7 to $10
CoolFireX: raises $12.50 to $22.50
phil_cheng: raises $77.30 to $99.80 and is all-in
CoolFireX: calls $77.30 and is all-in
*** FIRST FLOP *** [Jh Th 2c]
*** FIRST TURN *** [Jh Th 2c] [Qc]
*** FIRST RIVER *** [Jh Th 2c Qc] [7d]
*** SECOND FLOP *** [5s 3h 6s]
*** SECOND TURN *** [5s 3h 6s] [Jd]
*** SECOND RIVER *** [5s 3h 6s Jd] [5h]
*** FIRST SHOW DOWN ***
phil_cheng: shows [Ad Kc] (a straight, Ten to Ace)
CoolFireX: shows [Ks Ah] (a straight, Ten to Ace)
phil_cheng collected $49.95 from pot
CoolFireX collected $49.95 from pot
*** SECOND SHOW DOWN ***
phil_cheng: shows [Ad Kc] (a pair of Fives)
CoolFireX: shows [Ks Ah] (a pair of Fives)
phil_cheng collected $49.95 from pot
CoolFireX collected $49.95 from pot
*** SUMMARY ***
Total pot $202.30 | Rake $2.50 
Hand was run twice
FIRST Board [Jh Th 2c Qc 7d]
SECOND Board [5s 3h 6s Jd 5h]
Seat 1: phil_cheng (big blind) showed [Ad Kc] and won ($49.95) with a straight, Ten to Ace, and won ($49.95) with a pair of Fives
Seat 2: matiko09 folded before Flop (didn't bet)
Seat 4: CoolFireX showed [Ks Ah] and won ($49.95) with a straight, Ten to Ace, and won ($49.95) with a pair of Fives
Seat 5: Michael Quan folded before Flop
Seat 6: SharingaaN (button) folded before Flop (didn't bet)
Seat 9: maxxmeister (small blind) folded before Flop





PokerStars Hand #155013099438:  Hold'em No Limit ($0.50/$1.00 USD) - 2016/06/21 13:17:30 CET [2016/06/21 7:17:30 ET]
Table 'Moreau' 9-max Seat #1 is the button
Seat 1: ozone2003 ($133.49 in chips) 
Seat 2: nubpoker ($141.67 in chips) 
Seat 3: matiko09 ($122.38 in chips) 
Seat 5: DIMAN_324 ($100 in chips) 
Seat 6: mbk88 ($100 in chips) 
Seat 7: PanKwn15 ($50.43 in chips) 
Seat 8: maxxmeister ($110.30 in chips) 
Seat 9: Toonersens ($104.92 in chips) 
nubpoker: posts small blind $0.50
matiko09: posts big blind $1
SharingaaN: sits out 
*** HOLE CARDS ***
Dealt to matiko09 [Qh Ah]
DIMAN_324: folds 
mbk88: folds 
PanKwn15: folds 
maxxmeister: raises $2.50 to $3.50
Toonersens: folds 
ozone2003: folds 
nubpoker: calls $3
matiko09: calls $2.50
*** FLOP *** [3s 3c 9d]
nubpoker: checks 
matiko09: checks 
maxxmeister: bets $6.76
nubpoker: folds 
matiko09: folds 
Uncalled bet ($6.76) returned to maxxmeister
maxxmeister collected $9.98 from pot
maxxmeister: doesn't show hand 
*** SUMMARY ***
Total pot $10.50 | Rake $0.52 
Board [3s 3c 9d]
Seat 1: ozone2003 (button) folded before Flop (didn't bet)
Seat 2: nubpoker (small blind) folded on the Flop
Seat 3: matiko09 (big blind) folded on the Flop
Seat 5: DIMAN_324 folded before Flop (didn't bet)
Seat 6: mbk88 folded before Flop (didn't bet)
Seat 7: PanKwn15 folded before Flop (didn't bet)
Seat 8: maxxmeister collected ($9.98)
Seat 9: Toonersens folded before Flop (didn't bet)





PokerStars Hand #155013104117:  Hold'em No Limit ($0.50/$1.00 USD) - 2016/06/21 13:17:42 CET [2016/06/21 7:17:42 ET]
Table 'Rupertwildt' 9-max Seat #3 is the button
Seat 1: pokernixxx ($75.19 in chips) 
Seat 2: SharingaaN ($63.42 in chips) 
Seat 3: Troll8989 ($100 in chips) 
Seat 4: matiko09 ($145.18 in chips) 
Seat 5: pyromid ($93 in chips) 
Seat 6: ozone2003 ($124.72 in chips) 
Seat 7: chenconhaste ($123.99 in chips) 
Seat 8: Gonzanary ($122.79 in chips) 
Seat 9: mbk88 ($104.93 in chips) 
matiko09: posts small blind $0.50
pyromid: posts big blind $1
*** HOLE CARDS ***
Dealt to matiko09 [Td As]
ozone2003: folds 
chenconhaste: folds 
Gonzanary: folds 
mbk88: raises $2 to $3
pokernixxx: folds 
SharingaaN: folds 
Troll8989: folds 
matiko09: folds 
pyromid: folds 
Uncalled bet ($2) returned to mbk88
mbk88 collected $2.50 from pot
mbk88: doesn't show hand 
*** SUMMARY ***
Total pot $2.50 | Rake $0 
Seat 1: pokernixxx folded before Flop (didn't bet)
Seat 2: SharingaaN folded before Flop (didn't bet)
Seat 3: Troll8989 (button) folded before Flop (didn't bet)
Seat 4: matiko09 (small blind) folded before Flop
Seat 5: pyromid (big blind) folded before Flop
Seat 6: ozone2003 folded before Flop (didn't bet)
Seat 7: chenconhaste folded before Flop (didn't bet)
Seat 8: Gonzanary folded before Flop (didn't bet)
Seat 9: mbk88 collected ($2.50)





PokerStars Hand #155013104561:  Hold'em No Limit ($0.50/$1.00 USD) - 2016/06/21 13:17:43 CET [2016/06/21 7:17:43 ET]
Table 'Cheleb' 9-max Seat #8 is the button
Seat 1: SharingaaN ($167.49 in chips) 
Seat 2: pyromid ($139.10 in chips) 
Seat 4: DIMAN_324 ($188.07 in chips) 
Seat 5: Avtovo ($135.50 in chips) 
Seat 6: matiko09 ($101 in chips) 
Seat 7: The Big Ape ($92.16 in chips) 
Seat 8: Troll8989 ($100 in chips) 
Seat 9: mbk88 ($103.12 in chips) 
mbk88: posts small blind $0.50
SharingaaN: posts big blind $1
phil_cheng: sits out 
*** HOLE CARDS ***
Dealt to matiko09 [2h 9h]
pyromid: folds 
DIMAN_324: folds 
Avtovo: folds 
matiko09: folds 
The Big Ape: raises $1 to $2
Troll8989: folds 
mbk88: folds 
SharingaaN: folds 
Uncalled bet ($1) returned to The Big Ape
The Big Ape collected $2.50 from pot
The Big Ape: doesn't show hand 
*** SUMMARY ***
Total pot $2.50 | Rake $0 
Seat 1: SharingaaN (big blind) folded before Flop
Seat 2: pyromid folded before Flop (didn't bet)
Seat 4: DIMAN_324 folded before Flop (didn't bet)
Seat 5: Avtovo folded before Flop (didn't bet)
Seat 6: matiko09 folded before Flop (didn't bet)
Seat 7: The Big Ape collected ($2.50)
Seat 8: Troll8989 (button) folded before Flop (didn't bet)
Seat 9: mbk88 (small blind) folded before Flop





PokerStars Hand #155013111754:  Hold'em No Limit ($0.50/$1.00 USD) - 2016/06/21 13:18:00 CET [2016/06/21 7:18:00 ET]
Table 'Megrez II' 9-max Seat #6 is the button
Seat 5: exreedik ($34.90 in chips) 
Seat 6: mi$$I$Elena ($100 in chips) 
Seat 7: CoolFireX ($107.27 in chips) 
Seat 9: matiko09 ($100 in chips) 
CoolFireX: posts small blind $0.50
matiko09: posts big blind $1
*** HOLE CARDS ***
Dealt to matiko09 [2h Qc]
exreedik: calls $1
mi$$I$Elena: calls $1
CoolFireX: calls $0.50
matiko09: checks 
*** FLOP *** [6d 5c 4d]
CoolFireX: checks 
matiko09: checks 
exreedik: checks 
mi$$I$Elena: bets $2.50
CoolFireX: folds 
matiko09: folds 
exreedik: calls $2.50
*** TURN *** [6d 5c 4d] [2d]
exreedik: checks 
mi$$I$Elena: bets $6
exreedik: folds 
Uncalled bet ($6) returned to mi$$I$Elena
mi$$I$Elena collected $8.55 from pot
mi$$I$Elena: doesn't show hand 
*** SUMMARY ***
Total pot $9 | Rake $0.45 
Board [6d 5c 4d 2d]
Seat 5: exreedik folded on the Turn
Seat 6: mi$$I$Elena (button) collected ($8.55)
Seat 7: CoolFireX (small blind) folded on the Flop
Seat 9: matiko09 (big blind) folded on the Flop





PokerStars Hand #155013112108:  Hold'em No Limit (€0.25/€0.50 EUR) - 2016/06/21 13:18:01 CET [2016/06/21 7:18:01 ET]
Table 'Lotis II' 6-max Seat #2 is the button
Seat 2: broh202 (€105.58 in chips) 
Seat 3: bricasse1961 (€39.85 in chips) 
Seat 4: matiko09 (€93.68 in chips) 
Seat 5: AlexPles (€71.52 in chips) 
Seat 6: asmodej666 (€54.52 in chips) 
bricasse1961: posts small blind €0.25
matiko09: posts big blind €0.50
tyoma_knp: sits out 
*** HOLE CARDS ***
Dealt to matiko09 [3h 6c]
AlexPles: raises €1 to €1.50
asmodej666: folds 
broh202: calls €1.50
bricasse1961: folds 
matiko09: folds 
*** FLOP *** [4s Td 7s]
AlexPles: checks 
broh202: checks 
*** TURN *** [4s Td 7s] [Ad]
AlexPles: checks 
broh202: bets €1.78
AlexPles: calls €1.78
*** RIVER *** [4s Td 7s Ad] [Tc]
AlexPles: checks 
broh202: checks 
*** SHOW DOWN ***
AlexPles: shows [6h Ah] (two pair, Aces and Tens)
broh202: mucks hand 
AlexPles collected €6.94 from pot
*** SUMMARY ***
Total pot €7.31 | Rake €0.37 
Board [4s Td 7s Ad Tc]
Seat 2: broh202 (button) mucked [9d 6d]
Seat 3: bricasse1961 (small blind) folded before Flop
Seat 4: matiko09 (big blind) folded before Flop
Seat 5: AlexPles showed [6h Ah] and won (€6.94) with two pair, Aces and Tens
Seat 6: asmodej666 folded before Flop (didn't bet)





PokerStars Hand #155013112387:  Hold'em No Limit ($0.50/$1.00 USD) - 2016/06/21 13:18:02 CET [2016/06/21 7:18:02 ET]
Table 'Carlova II' 9-max Seat #9 is the button
Seat 1: matiko09 ($119.30 in chips) 
Seat 3: King_Z�Manel ($100 in chips) 
Seat 4: Dandy Monk ($63.41 in chips) 
Seat 5: ozone2003 ($107.50 in chips) 
Seat 6: DIMAN_324 ($100 in chips) 
Seat 7: mi$$I$Elena ($122.97 in chips) 
Seat 8: pyromid ($105.10 in chips) 
Seat 9: Troll8989 ($103.18 in chips) 
matiko09: posts small blind $0.50
chenconhaste: is sitting out 
King_Z�Manel: posts big blind $1
*** HOLE CARDS ***
Dealt to matiko09 [2c 5s]
chenconhaste leaves the table
Avtovo joins the table at seat #2 
Dandy Monk: folds 
Avtovo leaves the table
ozone2003: raises $2 to $3
mbk88 joins the table at seat #2 
DIMAN_324: folds 
mi$$I$Elena: folds 
pyromid: folds 
Troll8989: folds 
matiko09: folds 
King_Z�Manel: calls $2
*** FLOP *** [Jc 6s 4d]
King_Z�Manel: checks 
ozone2003: bets $4.02
King_Z�Manel: folds 
Uncalled bet ($4.02) returned to ozone2003
ozone2003 collected $6.18 from pot
ozone2003: doesn't show hand 
*** SUMMARY ***
Total pot $6.50 | Rake $0.32 
Board [Jc 6s 4d]
Seat 1: matiko09 (small blind) folded before Flop
Seat 3: King_Z�Manel (big blind) folded on the Flop
Seat 4: Dandy Monk folded before Flop (didn't bet)
Seat 5: ozone2003 collected ($6.18)
Seat 6: DIMAN_324 folded before Flop (didn't bet)
Seat 7: mi$$I$Elena folded before Flop (didn't bet)
Seat 8: pyromid folded before Flop (didn't bet)
Seat 9: Troll8989 (button) folded before Flop (didn't bet)





PokerStars Hand #155013112648:  Hold'em No Limit ($0.50/$1.00 USD) - 2016/06/21 13:18:03 CET [2016/06/21 7:18:03 ET]
Table 'Leo' 9-max Seat #4 is the button
Seat 2: torkkdnm ($170.16 in chips) 
Seat 3: matiko09 ($103.10 in chips) 
Seat 4: SharingaaN ($104.35 in chips) 
Seat 7: maxxmeister ($100 in chips) 
Seat 8: pyromid ($92.42 in chips) 
Seat 9: Wladimir205 ($113.86 in chips) 
Troll8989 will be allowed to play after the button
maxxmeister: posts small blind $0.50
pyromid: posts big blind $1
fukumimi: sits out 
*** HOLE CARDS ***
Dealt to matiko09 [7h 6h]
Wladimir205: folds 
torkkdnm: folds 
matiko09: raises $1.50 to $2.50
SharingaaN: folds 
maxxmeister: folds 
pyromid: folds 
Uncalled bet ($1.50) returned to matiko09
matiko09 collected $2.50 from pot
matiko09: doesn't show hand 
*** SUMMARY ***
Total pot $2.50 | Rake $0 
Seat 2: torkkdnm folded before Flop (didn't bet)
Seat 3: matiko09 collected ($2.50)
Seat 4: SharingaaN (button) folded before Flop (didn't bet)
Seat 7: maxxmeister (small blind) folded before Flop
Seat 8: pyromid (big blind) folded before Flop
Seat 9: Wladimir205 folded before Flop (didn't bet)





PokerStars Hand #155013117615:  Hold'em No Limit ($0.50/$1.00 USD) - 2016/06/21 13:18:15 CET [2016/06/21 7:18:15 ET]
Table 'Cheleb' 9-max Seat #9 is the button
Seat 1: SharingaaN ($166.49 in chips) 
Seat 2: pyromid ($139.10 in chips) 
Seat 4: DIMAN_324 ($188.07 in chips) 
Seat 5: Avtovo ($135.50 in chips) 
Seat 6: matiko09 ($101 in chips) 
Seat 7: The Big Ape ($93.66 in chips) 
Seat 8: Troll8989 ($100 in chips) 
Seat 9: mbk88 ($102.62 in chips) 
SharingaaN: posts small blind $0.50
pyromid: posts big blind $1
phil_cheng: sits out 
*** HOLE CARDS ***
Dealt to matiko09 [Kh 2s]
DIMAN_324: raises $2 to $3
Avtovo: folds 
matiko09: folds 
The Big Ape: folds 
Troll8989: folds 
mbk88: calls $3
SharingaaN: calls $2.50
pyromid: folds 
*** FLOP *** [7d 3s Ah]
SharingaaN: checks 
DIMAN_324: bets $4.50
mbk88: folds 
SharingaaN: folds 
Uncalled bet ($4.50) returned to DIMAN_324
DIMAN_324 collected $9.50 from pot
DIMAN_324: doesn't show hand 
*** SUMMARY ***
Total pot $10 | Rake $0.50 
Board [7d 3s Ah]
Seat 1: SharingaaN (small blind) folded on the Flop
Seat 2: pyromid (big blind) folded before Flop
Seat 4: DIMAN_324 collected ($9.50)
Seat 5: Avtovo folded before Flop (didn't bet)
Seat 6: matiko09 folded before Flop (didn't bet)
Seat 7: The Big Ape folded before Flop (didn't bet)
Seat 8: Troll8989 folded before Flop (didn't bet)
Seat 9: mbk88 (button) folded on the Flop





PokerStars Hand #155013118710:  Hold'em No Limit ($0.50/$1.00 USD) - 2016/06/21 13:18:17 CET [2016/06/21 7:18:17 ET]
Table 'Moreau' 9-max Seat #2 is the button
Seat 1: ozone2003 ($133.49 in chips) 
Seat 2: nubpoker ($138.17 in chips) 
Seat 3: matiko09 ($118.88 in chips) 
Seat 4: SharingaaN ($100 in chips) 
Seat 5: DIMAN_324 ($100 in chips) 
Seat 6: mbk88 ($100 in chips) 
Seat 7: PanKwn15 ($50.43 in chips) 
Seat 8: maxxmeister ($116.78 in chips) 
Seat 9: Toonersens ($104.92 in chips) 
matiko09: posts small blind $0.50
SharingaaN: posts big blind $1
*** HOLE CARDS ***
Dealt to matiko09 [Ac 7d]
DIMAN_324: folds 
mbk88: folds 
PanKwn15: raises $1 to $2
maxxmeister: raises $5 to $7
Toonersens: folds 
ozone2003: folds 
nubpoker: folds 
matiko09: folds 
SharingaaN: folds 
PanKwn15: folds 
Uncalled bet ($5) returned to maxxmeister
maxxmeister collected $5.50 from pot
maxxmeister: doesn't show hand 
*** SUMMARY ***
Total pot $5.50 | Rake $0 
Seat 1: ozone2003 folded before Flop (didn't bet)
Seat 2: nubpoker (button) folded before Flop (didn't bet)
Seat 3: matiko09 (small blind) folded before Flop
Seat 4: SharingaaN (big blind) folded before Flop
Seat 5: DIMAN_324 folded before Flop (didn't bet)
Seat 6: mbk88 folded before Flop (didn't bet)
Seat 7: PanKwn15 folded before Flop
Seat 8: maxxmeister collected ($5.50)
Seat 9: Toonersens folded before Flop (didn't bet)





PokerStars Hand #155013121081:  Hold'em No Limit ($0.50/$1.00 USD) - 2016/06/21 13:18:23 CET [2016/06/21 7:18:23 ET]
Table 'Rupertwildt' 9-max Seat #4 is the button
Seat 2: SharingaaN ($63.42 in chips) 
Seat 3: Troll8989 ($100 in chips) 
Seat 4: matiko09 ($144.68 in chips) 
Seat 5: pyromid ($92 in chips) 
Seat 6: ozone2003 ($124.72 in chips) 
Seat 7: chenconhaste ($123.99 in chips) 
Seat 8: Gonzanary ($122.79 in chips) 
Seat 9: mbk88 ($106.43 in chips) 
pyromid: posts small blind $0.50
ozone2003: posts big blind $1
*** HOLE CARDS ***
Dealt to matiko09 [4c 8c]
chenconhaste: folds 
chenconhaste leaves the table
Gonzanary: folds 
mbk88: folds 
SharingaaN: raises $2 to $3
Troll8989: calls $3
matiko09: folds 
pyromid: folds 
mi$$I$Elena joins the table at seat #7 
mi$$I$Elena leaves the table
ozone2003: folds 
*** FLOP *** [9h Kc 6s]
SharingaaN: checks 
Troll8989: bets $3.56
SharingaaN: calls $3.56
*** TURN *** [9h Kc 6s] [Kh]
SharingaaN: checks 
Avtovo joins the table at seat #7 
Troll8989: bets $7
SharingaaN: calls $7
*** RIVER *** [9h Kc 6s Kh] [3s]
SharingaaN: checks 
Troll8989: checks 
*** SHOW DOWN ***
SharingaaN: shows [Ad Ah] (two pair, Aces and Kings)
Troll8989: mucks hand 
SharingaaN collected $27.19 from pot
*** SUMMARY ***
Total pot $28.62 | Rake $1.43 
Board [9h Kc 6s Kh 3s]
Seat 2: SharingaaN showed [Ad Ah] and won ($27.19) with two pair, Aces and Kings
Seat 3: Troll8989 mucked [Js Jh]
Seat 4: matiko09 (button) folded before Flop (didn't bet)
Seat 5: pyromid (small blind) folded before Flop
Seat 6: ozone2003 (big blind) folded before Flop
Seat 7: chenconhaste folded before Flop (didn't bet)
Seat 8: Gonzanary folded before Flop (didn't bet)
Seat 9: mbk88 folded before Flop (didn't bet)





PokerStars Hand #155013122286:  Hold'em No Limit ($0.50/$1.00 USD) - 2016/06/21 13:18:26 CET [2016/06/21 7:18:26 ET]
Table 'Leo' 9-max Seat #7 is the button
Seat 2: torkkdnm ($170.16 in chips) 
Seat 3: matiko09 ($104.60 in chips) 
Seat 4: SharingaaN ($104.35 in chips) 
Seat 7: maxxmeister ($100 in chips) 
Seat 8: pyromid ($91.42 in chips) 
Seat 9: Wladimir205 ($113.86 in chips) 
pyromid: posts small blind $0.50
Wladimir205: posts big blind $1
fukumimi: sits out 
Troll8989: sits out 
*** HOLE CARDS ***
Dealt to matiko09 [5s 3d]
torkkdnm has timed out
torkkdnm: folds 
matiko09: folds 
SharingaaN: folds 
maxxmeister: raises $2 to $3
pyromid: folds 
Wladimir205: calls $2
*** FLOP *** [Jh 7s Th]
Wladimir205: checks 
maxxmeister: checks 
*** TURN *** [Jh 7s Th] [9c]
Wladimir205: bets $4
maxxmeister: folds 
Uncalled bet ($4) returned to Wladimir205
Wladimir205 collected $6.18 from pot
Wladimir205: doesn't show hand 
*** SUMMARY ***
Total pot $6.50 | Rake $0.32 
Board [Jh 7s Th 9c]
Seat 2: torkkdnm folded before Flop (didn't bet)
Seat 3: matiko09 folded before Flop (didn't bet)
Seat 4: SharingaaN folded before Flop (didn't bet)
Seat 7: maxxmeister (button) folded on the Turn
Seat 8: pyromid (small blind) folded before Flop
Seat 9: Wladimir205 (big blind) collected ($6.18)





PokerStars Hand #155013125706:  Hold'em No Limit ($0.50/$1.00 USD) - 2016/06/21 13:18:34 CET [2016/06/21 7:18:34 ET]
Table 'Saldanha' 9-max Seat #9 is the button
Seat 1: phil_cheng ($100 in chips) 
Seat 2: matiko09 ($184 in chips) 
Seat 4: CoolFireX ($100 in chips) 
Seat 5: Michael Quan ($98.80 in chips) 
Seat 6: SharingaaN ($74.70 in chips) 
Seat 9: maxxmeister ($129.65 in chips) 
phil_cheng: posts small blind $0.50
matiko09: posts big blind $1
ozone2003: sits out 
erick222: sits out 
phil_cheng: posts the ante $0.20
matiko09: posts the ante $0.20
CoolFireX: posts the ante $0.20
Michael Quan: posts the ante $0.20
SharingaaN: posts the ante $0.20
maxxmeister: posts the ante $0.20
*** HOLE CARDS ***
Dealt to matiko09 [Kh Kd]
CoolFireX: raises $2 to $3
Michael Quan: folds 
SharingaaN: folds 
maxxmeister: folds 
phil_cheng: folds 
matiko09: raises $8 to $11
CoolFireX: calls $8
*** FLOP *** [2h Qd 4h]
matiko09: checks 
CoolFireX: bets $11.50
matiko09: raises $18.50 to $30
CoolFireX: raises $58.80 to $88.80 and is all-in
matiko09: calls $58.80
*** TURN *** [2h Qd 4h] [5s]
*** RIVER *** [2h Qd 4h 5s] [Jd]
*** SHOW DOWN ***
matiko09: shows [Kh Kd] (a pair of Kings)
CoolFireX: shows [Th 9h] (high card Queen)
matiko09 collected $198.80 from pot
*** SUMMARY ***
Total pot $201.30 | Rake $2.50 
Board [2h Qd 4h 5s Jd]
Seat 1: phil_cheng (small blind) folded before Flop
Seat 2: matiko09 (big blind) showed [Kh Kd] and won ($198.80) with a pair of Kings
Seat 4: CoolFireX showed [Th 9h] and lost with high card Queen
Seat 5: Michael Quan folded before Flop (didn't bet)
Seat 6: SharingaaN folded before Flop (didn't bet)
Seat 9: maxxmeister (button) folded before Flop (didn't bet)





PokerStars Hand #155013130446:  Hold'em No Limit (€0.25/€0.50 EUR) - 2016/06/21 13:18:45 CET [2016/06/21 7:18:45 ET]
Table 'Actor II' 6-max Seat #3 is the button
Seat 1: hmverlin (€96.64 in chips) 
Seat 3: asmodej666 (€88.31 in chips) 
Seat 4: matiko09 (€50 in chips) 
Seat 5: Rybka1294 (€51.37 in chips) 
Seat 6: fanmtZ (€20.82 in chips) 
matiko09: posts small blind €0.25
Rybka1294: posts big blind €0.50
alôha: sits out 
*** HOLE CARDS ***
Dealt to matiko09 [5c 4c]
fanmtZ: raises €0.69 to €1.19
hmverlin: calls €1.19
asmodej666: folds 
matiko09: folds 
Rybka1294: folds 
*** FLOP *** [6s 9s 5d]
fanmtZ: bets €1.69
hmverlin: raises €1.69 to €3.38
fanmtZ: folds 
Uncalled bet (€1.69) returned to hmverlin
hmverlin collected €6.18 from pot
hmverlin: doesn't show hand 
*** SUMMARY ***
Total pot €6.51 | Rake €0.33 
Board [6s 9s 5d]
Seat 1: hmverlin collected (€6.18)
Seat 3: asmodej666 (button) folded before Flop (didn't bet)
Seat 4: matiko09 (small blind) folded before Flop
Seat 5: Rybka1294 (big blind) folded before Flop
Seat 6: fanmtZ folded on the Flop





PokerStars Hand #155013132540:  Hold'em No Limit ($0.50/$1.00 USD) - 2016/06/21 13:18:50 CET [2016/06/21 7:18:50 ET]
Table 'Moreau' 9-max Seat #3 is the button
Seat 1: ozone2003 ($133.49 in chips) 
Seat 2: nubpoker ($138.17 in chips) 
Seat 3: matiko09 ($118.38 in chips) 
Seat 4: SharingaaN ($99 in chips) 
Seat 5: DIMAN_324 ($100 in chips) 
Seat 6: mbk88 ($100 in chips) 
Seat 7: PanKwn15 ($48.43 in chips) 
Seat 8: maxxmeister ($120.28 in chips) 
Seat 9: Toonersens ($104.92 in chips) 
SharingaaN: posts small blind $0.50
DIMAN_324: posts big blind $1
*** HOLE CARDS ***
Dealt to matiko09 [2c Ac]
mbk88: raises $2 to $3
PanKwn15: folds 
maxxmeister: folds 
Toonersens: folds 
ozone2003: folds 
nubpoker: calls $3
matiko09: folds 
SharingaaN: folds 
DIMAN_324: calls $2
*** FLOP *** [9c 5d Ts]
DIMAN_324: checks 
mbk88: bets $6
nubpoker: folds 
DIMAN_324: folds 
Uncalled bet ($6) returned to mbk88
mbk88 collected $9.02 from pot
mbk88: doesn't show hand 
*** SUMMARY ***
Total pot $9.50 | Rake $0.48 
Board [9c 5d Ts]
Seat 1: ozone2003 folded before Flop (didn't bet)
Seat 2: nubpoker folded on the Flop
Seat 3: matiko09 (button) folded before Flop (didn't bet)
Seat 4: SharingaaN (small blind) folded before Flop
Seat 5: DIMAN_324 (big blind) folded on the Flop
Seat 6: mbk88 collected ($9.02)
Seat 7: PanKwn15 folded before Flop (didn't bet)
Seat 8: maxxmeister folded before Flop (didn't bet)
Seat 9: Toonersens folded before Flop (didn't bet)





PokerStars Hand #155013134006:  Hold'em No Limit ($0.50/$1.00 USD) - 2016/06/21 13:18:54 CET [2016/06/21 7:18:54 ET]
Table 'Lamberta II' 9-max Seat #8 is the button
Seat 2: mavin80 ($95.60 in chips) 
Seat 3: matiko09 ($101.50 in chips) 
Seat 4: Eskimo Fox ($102.50 in chips) 
Seat 5: mi$$I$Elena ($103 in chips) 
Seat 6: DIMAN_324 ($100 in chips) 
Seat 8: Troll8989 ($100 in chips) 
Seat 9: Sjtu_Michael ($109.44 in chips) 
Sjtu_Michael: posts small blind $0.50
mavin80: posts big blind $1
*** HOLE CARDS ***
Dealt to matiko09 [Ac 4d]
matiko09: folds 
Eskimo Fox: folds 
mi$$I$Elena: folds 
DIMAN_324: folds 
Troll8989: raises $1.50 to $2.50
Sjtu_Michael: folds 
mavin80: calls $1.50
*** FLOP *** [Jd Tc Jh]
mavin80: bets $1
Troll8989: folds 
Uncalled bet ($1) returned to mavin80
mavin80 collected $5.22 from pot
mavin80: doesn't show hand 
*** SUMMARY ***
Total pot $5.50 | Rake $0.28 
Board [Jd Tc Jh]
Seat 2: mavin80 (big blind) collected ($5.22)
Seat 3: matiko09 folded before Flop (didn't bet)
Seat 4: Eskimo Fox folded before Flop (didn't bet)
Seat 5: mi$$I$Elena folded before Flop (didn't bet)
Seat 6: DIMAN_324 folded before Flop (didn't bet)
Seat 8: Troll8989 (button) folded on the Flop
Seat 9: Sjtu_Michael (small blind) folded before Flop





PokerStars Hand #155013134977:  Hold'em No Limit ($0.50/$1.00 USD) - 2016/06/21 13:18:56 CET [2016/06/21 7:18:56 ET]
Table 'Cheleb' 9-max Seat #1 is the button
Seat 1: SharingaaN ($163.49 in chips) 
Seat 2: pyromid ($138.10 in chips) 
Seat 3: phil_cheng ($100 in chips) 
Seat 4: DIMAN_324 ($194.57 in chips) 
Seat 5: Avtovo ($135.50 in chips) 
Seat 6: matiko09 ($101 in chips) 
Seat 7: The Big Ape ($100 in chips) 
Seat 8: Troll8989 ($100 in chips) 
Seat 9: mbk88 ($100 in chips) 
pyromid: posts small blind $0.50
phil_cheng: posts big blind $1
*** HOLE CARDS ***
Dealt to matiko09 [5s Jd]
DIMAN_324: folds 
DIMAN_324 leaves the table
CoolFireX joins the table at seat #4 
Avtovo has timed out
Avtovo: folds 
matiko09: folds 
The Big Ape: folds 
Troll8989: folds 
mbk88: folds 
SharingaaN: raises $1.80 to $2.80
pyromid: folds 
phil_cheng: folds 
Uncalled bet ($1.80) returned to SharingaaN
SharingaaN collected $2.50 from pot
SharingaaN: doesn't show hand 
*** SUMMARY ***
Total pot $2.50 | Rake $0 
Seat 1: SharingaaN (button) collected ($2.50)
Seat 2: pyromid (small blind) folded before Flop
Seat 3: phil_cheng (big blind) folded before Flop
Seat 4: DIMAN_324 folded before Flop (didn't bet)
Seat 5: Avtovo folded before Flop (didn't bet)
Seat 6: matiko09 folded before Flop (didn't bet)
Seat 7: The Big Ape folded before Flop (didn't bet)
Seat 8: Troll8989 folded before Flop (didn't bet)
Seat 9: mbk88 folded before Flop (didn't bet)





PokerStars Hand #155013136489:  Hold'em No Limit ($0.50/$1.00 USD) - 2016/06/21 13:19:00 CET [2016/06/21 7:19:00 ET]
Table 'Megrez II' 9-max Seat #7 is the button
Seat 5: exreedik ($31.40 in chips) 
Seat 6: mi$$I$Elena ($105.05 in chips) 
Seat 7: CoolFireX ($106.27 in chips) 
Seat 9: matiko09 ($100 in chips) 
matiko09: posts small blind $0.50
exreedik: posts big blind $1
*** HOLE CARDS ***
Dealt to matiko09 [6h As]
mi$$I$Elena: folds 
CoolFireX: folds 
matiko09: raises $2 to $3
exreedik: folds 
Uncalled bet ($2) returned to matiko09
matiko09 collected $2 from pot
matiko09: doesn't show hand 
*** SUMMARY ***
Total pot $2 | Rake $0 
Seat 5: exreedik (big blind) folded before Flop
Seat 6: mi$$I$Elena folded before Flop (didn't bet)
Seat 7: CoolFireX (button) folded before Flop (didn't bet)
Seat 9: matiko09 (small blind) collected ($2)





PokerStars Hand #155013141428:  Hold'em No Limit (€0.25/€0.50 EUR) - 2016/06/21 13:19:12 CET [2016/06/21 7:19:12 ET]
Table 'Lotis II' 6-max Seat #3 is the button
Seat 2: broh202 (€102.30 in chips) 
Seat 3: bricasse1961 (€39.60 in chips) 
Seat 4: matiko09 (€93.18 in chips) 
Seat 5: AlexPles (€75.18 in chips) 
Seat 6: asmodej666 (€54.52 in chips) 
matiko09: posts small blind €0.25
AlexPles: posts big blind €0.50
tyoma_knp: sits out 
*** HOLE CARDS ***
Dealt to matiko09 [Qs 8d]
asmodej666: raises €1 to €1.50
broh202: folds 
bricasse1961: folds 
matiko09: folds 
AlexPles: folds 
Uncalled bet (€1) returned to asmodej666
asmodej666 collected €1.25 from pot
asmodej666: doesn't show hand 
*** SUMMARY ***
Total pot €1.25 | Rake €0 
Seat 2: broh202 folded before Flop (didn't bet)
Seat 3: bricasse1961 (button) folded before Flop (didn't bet)
Seat 4: matiko09 (small blind) folded before Flop
Seat 5: AlexPles (big blind) folded before Flop
Seat 6: asmodej666 collected (€1.25)





PokerStars Hand #155013148439:  Hold'em No Limit ($0.50/$1.00 USD) - 2016/06/21 13:19:29 CET [2016/06/21 7:19:29 ET]
Table 'Moreau' 9-max Seat #4 is the button
Seat 1: ozone2003 ($133.49 in chips) 
Seat 2: nubpoker ($135.17 in chips) 
Seat 3: matiko09 ($118.38 in chips) 
Seat 4: SharingaaN ($98.50 in chips) 
Seat 5: DIMAN_324 ($100 in chips) 
Seat 7: PanKwn15 ($48.43 in chips) 
Seat 8: maxxmeister ($120.28 in chips) 
Seat 9: Toonersens ($104.92 in chips) 
DIMAN_324: posts small blind $0.50
mbk88: is sitting out 
PanKwn15: posts big blind $1
*** HOLE CARDS ***
Dealt to matiko09 [Qh 7c]
maxxmeister: folds 
Toonersens: calls $1
ozone2003: folds 
nubpoker: folds 
matiko09: folds 
SharingaaN: raises $4 to $5
DIMAN_324: folds 
PanKwn15: folds 
Toonersens is disconnected 
Toonersens has timed out while disconnected
Toonersens: folds 
Uncalled bet ($4) returned to SharingaaN
SharingaaN collected $3.50 from pot
SharingaaN: doesn't show hand 
*** SUMMARY ***
Total pot $3.50 | Rake $0 
Seat 1: ozone2003 folded before Flop (didn't bet)
Seat 2: nubpoker folded before Flop (didn't bet)
Seat 3: matiko09 folded before Flop (didn't bet)
Seat 4: SharingaaN (button) collected ($3.50)
Seat 5: DIMAN_324 (small blind) folded before Flop
Seat 7: PanKwn15 (big blind) folded before Flop
Seat 8: maxxmeister folded before Flop (didn't bet)
Seat 9: Toonersens folded before Flop





PokerStars Hand #155013148780:  Hold'em No Limit ($0.50/$1.00 USD) - 2016/06/21 13:19:30 CET [2016/06/21 7:19:30 ET]
Table 'Lamberta II' 9-max Seat #9 is the button
Seat 2: mavin80 ($98.32 in chips) 
Seat 3: matiko09 ($101.50 in chips) 
Seat 4: Eskimo Fox ($102.50 in chips) 
Seat 5: mi$$I$Elena ($103 in chips) 
Seat 6: DIMAN_324 ($100 in chips) 
Seat 8: Troll8989 ($100 in chips) 
Seat 9: Sjtu_Michael ($108.94 in chips) 
mavin80: posts small blind $0.50
matiko09: posts big blind $1
*** HOLE CARDS ***
Dealt to matiko09 [Ac 2d]
Eskimo Fox: raises $2 to $3
mi$$I$Elena: folds 
DIMAN_324: folds 
Troll8989: folds 
MarinoC1979 was removed from the table for failing to post
Sjtu_Michael: folds 
mavin80: folds 
matiko09: folds 
Uncalled bet ($2) returned to Eskimo Fox
Eskimo Fox collected $2.50 from pot
*** SUMMARY ***
Total pot $2.50 | Rake $0 
Seat 2: mavin80 (small blind) folded before Flop
Seat 3: matiko09 (big blind) folded before Flop
Seat 4: Eskimo Fox collected ($2.50)
Seat 5: mi$$I$Elena folded before Flop (didn't bet)
Seat 6: DIMAN_324 folded before Flop (didn't bet)
Seat 8: Troll8989 folded before Flop (didn't bet)
Seat 9: Sjtu_Michael (button) folded before Flop (didn't bet)





PokerStars Hand #155013149481:  Hold'em No Limit (€0.25/€0.50 EUR) - 2016/06/21 13:19:32 CET [2016/06/21 7:19:32 ET]
Table 'Lotis II' 6-max Seat #4 is the button
Seat 1: tyoma_knp (€50 in chips) 
Seat 2: broh202 (€102.30 in chips) 
Seat 3: bricasse1961 (€39.60 in chips) 
Seat 4: matiko09 (€92.93 in chips) 
Seat 5: AlexPles (€74.68 in chips) 
AlexPles: posts small blind €0.25
asmodej666: is sitting out 
tyoma_knp: posts big blind €0.50
*** HOLE CARDS ***
Dealt to matiko09 [6c 4c]
broh202: raises €1 to €1.50
bricasse1961: folds 
asmodej666 leaves the table
matiko09: folds 
AlexPles: calls €1.25
tyoma_knp: folds 
*** FLOP *** [Ah 9s Tc]
torkkdnm joins the table at seat #6 
AlexPles: checks 
broh202: checks 
*** TURN *** [Ah 9s Tc] [6d]
AlexPles: bets €2.25
broh202: calls €2.25
*** RIVER *** [Ah 9s Tc 6d] [5h]
AlexPles: bets €4.56
broh202: folds 
Uncalled bet (€4.56) returned to AlexPles
AlexPles collected €7.60 from pot
AlexPles: doesn't show hand 
*** SUMMARY ***
Total pot €8 | Rake €0.40 
Board [Ah 9s Tc 6d 5h]
Seat 1: tyoma_knp (big blind) folded before Flop
Seat 2: broh202 folded on the River
Seat 3: bricasse1961 folded before Flop (didn't bet)
Seat 4: matiko09 (button) folded before Flop (didn't bet)
Seat 5: AlexPles (small blind) collected (€7.60)





PokerStars Hand #155013149878:  Hold'em No Limit ($0.50/$1.00 USD) - 2016/06/21 13:19:33 CET [2016/06/21 7:19:33 ET]
Table 'Carlova II' 9-max Seat #1 is the button
Seat 1: matiko09 ($118.80 in chips) 
Seat 3: King_Z�Manel ($100 in chips) 
Seat 4: Dandy Monk ($63.41 in chips) 
Seat 5: ozone2003 ($110.68 in chips) 
Seat 6: DIMAN_324 ($100 in chips) 
Seat 7: mi$$I$Elena ($122.97 in chips) 
Seat 8: pyromid ($105.10 in chips) 
Seat 9: Troll8989 ($103.18 in chips) 
mbk88 will be allowed to play after the button
King_Z�Manel: posts small blind $0.50
Dandy Monk: posts big blind $1
*** HOLE CARDS ***
Dealt to matiko09 [Jd Ac]
ozone2003: folds 
DIMAN_324: folds 
mi$$I$Elena: folds 
pyromid: folds 
Troll8989: folds 
matiko09: raises $1.27 to $2.27
King_Z�Manel: raises $6.73 to $9
Dandy Monk: folds 
matiko09: calls $6.73
*** FLOP *** [4h 7c Qh]
King_Z�Manel: bets $7
matiko09: folds 
Uncalled bet ($7) returned to King_Z�Manel
King_Z�Manel collected $18.05 from pot
King_Z�Manel: doesn't show hand 
*** SUMMARY ***
Total pot $19 | Rake $0.95 
Board [4h 7c Qh]
Seat 1: matiko09 (button) folded on the Flop
Seat 3: King_Z�Manel (small blind) collected ($18.05)
Seat 4: Dandy Monk (big blind) folded before Flop
Seat 5: ozone2003 folded before Flop (didn't bet)
Seat 6: DIMAN_324 folded before Flop (didn't bet)
Seat 7: mi$$I$Elena folded before Flop (didn't bet)
Seat 8: pyromid folded before Flop (didn't bet)
Seat 9: Troll8989 folded before Flop (didn't bet)





PokerStars Hand #155013151160:  Hold'em No Limit ($0.50/$1.00 USD) - 2016/06/21 13:19:36 CET [2016/06/21 7:19:36 ET]
Table 'Leo' 9-max Seat #8 is the button
Seat 1: fukumimi ($100 in chips) 
Seat 2: torkkdnm ($170.16 in chips) 
Seat 3: matiko09 ($104.60 in chips) 
Seat 4: SharingaaN ($104.35 in chips) 
Seat 7: maxxmeister ($100 in chips) 
Seat 8: pyromid ($90.92 in chips) 
Seat 9: Wladimir205 ($117.04 in chips) 
Wladimir205: posts small blind $0.50
fukumimi: posts big blind $1
Troll8989: sits out 
*** HOLE CARDS ***
Dealt to matiko09 [Qd 4h]
torkkdnm: folds 
matiko09: folds 
SharingaaN: folds 
maxxmeister: folds 
pyromid: folds 
Wladimir205: folds 
Uncalled bet ($0.50) returned to fukumimi
fukumimi collected $1 from pot
fukumimi: doesn't show hand 
*** SUMMARY ***
Total pot $1 | Rake $0 
Seat 1: fukumimi (big blind) collected ($1)
Seat 2: torkkdnm folded before Flop (didn't bet)
Seat 3: matiko09 folded before Flop (didn't bet)
Seat 4: SharingaaN folded before Flop (didn't bet)
Seat 7: maxxmeister folded before Flop (didn't bet)
Seat 8: pyromid (button) folded before Flop (didn't bet)
Seat 9: Wladimir205 (small blind) folded before Flop





PokerStars Hand #155013152325:  Hold'em No Limit ($0.50/$1.00 USD) - 2016/06/21 13:19:38 CET [2016/06/21 7:19:38 ET]
Table 'Megrez II' 9-max Seat #9 is the button
Seat 5: exreedik ($30.40 in chips) 
Seat 6: mi$$I$Elena ($105.05 in chips) 
Seat 7: CoolFireX ($106.27 in chips) 
Seat 9: matiko09 ($101 in chips) 
exreedik: posts small blind $0.50
mi$$I$Elena: posts big blind $1
*** HOLE CARDS ***
Dealt to matiko09 [3c Qh]
CoolFireX: folds 
matiko09: folds 
exreedik: folds 
Uncalled bet ($0.50) returned to mi$$I$Elena
mi$$I$Elena collected $1 from pot
mi$$I$Elena: doesn't show hand 
*** SUMMARY ***
Total pot $1 | Rake $0 
Seat 5: exreedik (small blind) folded before Flop
Seat 6: mi$$I$Elena (big blind) collected ($1)
Seat 7: CoolFireX folded before Flop (didn't bet)
Seat 9: matiko09 (button) folded before Flop (didn't bet)





PokerStars Hand #155013153574:  Hold'em No Limit ($0.50/$1.00 USD) - 2016/06/21 13:19:41 CET [2016/06/21 7:19:41 ET]
Table 'Rupertwildt' 9-max Seat #5 is the button
Seat 2: SharingaaN ($77.05 in chips) 
Seat 3: Troll8989 ($100 in chips) 
Seat 4: matiko09 ($144.68 in chips) 
Seat 5: pyromid ($91.50 in chips) 
Seat 6: ozone2003 ($123.72 in chips) 
Seat 7: Avtovo ($100 in chips) 
Seat 8: Gonzanary ($122.79 in chips) 
Seat 9: mbk88 ($106.43 in chips) 
ozone2003: posts small blind $0.50
Avtovo: posts big blind $1
*** HOLE CARDS ***
Dealt to matiko09 [3d 8s]
Gonzanary: folds 
mbk88: folds 
SharingaaN: folds 
Troll8989: folds 
matiko09: folds 
pyromid: folds 
ozone2003: raises $1.95 to $2.95
Avtovo has timed out
Avtovo: folds 
Uncalled bet ($1.95) returned to ozone2003
ozone2003 collected $2 from pot
ozone2003: doesn't show hand 
*** SUMMARY ***
Total pot $2 | Rake $0 
Seat 2: SharingaaN folded before Flop (didn't bet)
Seat 3: Troll8989 folded before Flop (didn't bet)
Seat 4: matiko09 folded before Flop (didn't bet)
Seat 5: pyromid (button) folded before Flop (didn't bet)
Seat 6: ozone2003 (small blind) collected ($2)
Seat 7: Avtovo (big blind) folded before Flop
Seat 8: Gonzanary folded before Flop (didn't bet)
Seat 9: mbk88 folded before Flop (didn't bet)





PokerStars Hand #155013156795:  Hold'em No Limit (€0.25/€0.50 EUR) - 2016/06/21 13:19:49 CET [2016/06/21 7:19:49 ET]
Table 'Actor II' 6-max Seat #4 is the button
Seat 1: hmverlin (€99.94 in chips) 
Seat 3: asmodej666 (€88.31 in chips) 
Seat 4: matiko09 (€50 in chips) 
Seat 5: Rybka1294 (€50.87 in chips) 
Seat 6: fanmtZ (€20 in chips) 
Rybka1294: posts small blind €0.25
fanmtZ: posts big blind €0.50
alôha: sits out 
*** HOLE CARDS ***
Dealt to matiko09 [Td Ts]
hmverlin: folds 
asmodej666: folds 
matiko09: raises €0.63 to €1.13
Rybka1294: folds 
fanmtZ: calls €0.63
*** FLOP *** [3s Ah 3h]
fanmtZ: checks 
matiko09: bets €1.23
fanmtZ: calls €1.23
*** TURN *** [3s Ah 3h] [7h]
fanmtZ: checks 
matiko09: checks 
*** RIVER *** [3s Ah 3h 7h] [8s]
fanmtZ: bets €3.31
matiko09: folds 
Uncalled bet (€3.31) returned to fanmtZ
fanmtZ collected €4.72 from pot
fanmtZ: doesn't show hand 
*** SUMMARY ***
Total pot €4.97 | Rake €0.25 
Board [3s Ah 3h 7h 8s]
Seat 1: hmverlin folded before Flop (didn't bet)
Seat 3: asmodej666 folded before Flop (didn't bet)
Seat 4: matiko09 (button) folded on the River
Seat 5: Rybka1294 (small blind) folded before Flop
Seat 6: fanmtZ (big blind) collected (€4.72)





PokerStars Hand #155013160591:  Hold'em No Limit ($0.50/$1.00 USD) - 2016/06/21 13:19:58 CET [2016/06/21 7:19:58 ET]
Table 'Admete II' 9-max Seat #5 is the button
Seat 1: xxxxusedomer ($74.99 in chips) 
Seat 2: Eskimo Fox ($104.50 in chips) 
Seat 3: 50CandyJoe ($104.12 in chips) 
Seat 4: krustophsky ($95.28 in chips) 
Seat 5: ramzes160468 ($68.42 in chips) 
Seat 6: mbk88 ($100 in chips) 
Seat 7: matiko09 ($100 in chips) 
Seat 8: koutani7 ($98.50 in chips) 
Seat 9: ozone2003 ($100 in chips) 
mbk88: posts small blind $0.50
matiko09: posts big blind $1
*** HOLE CARDS ***
Dealt to matiko09 [8h Jh]
koutani7: folds 
ozone2003: folds 
xxxxusedomer: calls $1
Eskimo Fox: folds 
50CandyJoe: raises $3 to $4
krustophsky: folds 
ramzes160468: folds 
mbk88: raises $8 to $12
matiko09: folds 
xxxxusedomer: calls $11
50CandyJoe: folds 
*** FLOP *** [Kd Js 8s]
mbk88: checks 
xxxxusedomer: checks 
*** TURN *** [Kd Js 8s] [9h]
mbk88: bets $14
xxxxusedomer: calls $14
*** RIVER *** [Kd Js 8s 9h] [6s]
mbk88: bets $74 and is all-in
xxxxusedomer: folds 
Uncalled bet ($74) returned to mbk88
mbk88 collected $54.50 from pot
mbk88: doesn't show hand 
*** SUMMARY ***
Total pot $57 | Rake $2.50 
Board [Kd Js 8s 9h 6s]
Seat 1: xxxxusedomer folded on the River
Seat 2: Eskimo Fox folded before Flop (didn't bet)
Seat 3: 50CandyJoe folded before Flop
Seat 4: krustophsky folded before Flop (didn't bet)
Seat 5: ramzes160468 (button) folded before Flop (didn't bet)
Seat 6: mbk88 (small blind) collected ($54.50)
Seat 7: matiko09 (big blind) folded before Flop
Seat 8: koutani7 folded before Flop (didn't bet)
Seat 9: ozone2003 folded before Flop (didn't bet)





PokerStars Hand #155013162611:  Hold'em No Limit ($0.50/$1.00 USD) - 2016/06/21 13:20:03 CET [2016/06/21 7:20:03 ET]
Table 'Megrez II' 9-max Seat #5 is the button
Seat 5: exreedik ($29.90 in chips) 
Seat 6: mi$$I$Elena ($105.55 in chips) 
Seat 7: CoolFireX ($106.27 in chips) 
Seat 9: matiko09 ($101 in chips) 
mi$$I$Elena: posts small blind $0.50
CoolFireX: posts big blind $1
*** HOLE CARDS ***
Dealt to matiko09 [4h 3d]
matiko09: folds 
exreedik: raises $2 to $3
mi$$I$Elena: folds 
CoolFireX: calls $2
*** FLOP *** [Ac 7d Js]
CoolFireX: checks 
exreedik: checks 
*** TURN *** [Ac 7d Js] [Qs]
CoolFireX: bets $5
exreedik: folds 
Uncalled bet ($5) returned to CoolFireX
CoolFireX collected $6.18 from pot
CoolFireX: doesn't show hand 
*** SUMMARY ***
Total pot $6.50 | Rake $0.32 
Board [Ac 7d Js Qs]
Seat 5: exreedik (button) folded on the Turn
Seat 6: mi$$I$Elena (small blind) folded before Flop
Seat 7: CoolFireX (big blind) collected ($6.18)
Seat 9: matiko09 folded before Flop (didn't bet)





PokerStars Hand #155013163499:  Hold'em No Limit ($0.50/$1.00 USD) - 2016/06/21 13:20:05 CET [2016/06/21 7:20:05 ET]
Table 'Lamberta II' 9-max Seat #2 is the button
Seat 2: mavin80 ($97.82 in chips) 
Seat 3: matiko09 ($100.50 in chips) 
Seat 4: Eskimo Fox ($104 in chips) 
Seat 5: mi$$I$Elena ($103 in chips) 
Seat 6: DIMAN_324 ($100 in chips) 
Seat 8: Troll8989 ($100 in chips) 
Seat 9: Sjtu_Michael ($108.94 in chips) 
matiko09: posts small blind $0.50
Eskimo Fox: posts big blind $1
*** HOLE CARDS ***
Dealt to matiko09 [Ac 9h]
mi$$I$Elena: folds 
DIMAN_324: folds 
Troll8989: folds 
Sjtu_Michael: folds 
mavin80: folds 
phil_cheng joins the table at seat #7 
matiko09: raises $1.50 to $2.50
Eskimo Fox: calls $1.50
*** FLOP *** [Ah Qs 7h]
matiko09: bets $2.47
Eskimo Fox: calls $2.47
*** TURN *** [Ah Qs 7h] [As]
matiko09: checks 
Eskimo Fox: bets $6.60
matiko09: calls $6.60
*** RIVER *** [Ah Qs 7h As] [8h]
matiko09: checks 
Eskimo Fox: bets $12
matiko09: folds 
Uncalled bet ($12) returned to Eskimo Fox
Eskimo Fox collected $21.98 from pot
Eskimo Fox: doesn't show hand 
*** SUMMARY ***
Total pot $23.14 | Rake $1.16 
Board [Ah Qs 7h As 8h]
Seat 2: mavin80 (button) folded before Flop (didn't bet)
Seat 3: matiko09 (small blind) folded on the River
Seat 4: Eskimo Fox (big blind) collected ($21.98)
Seat 5: mi$$I$Elena folded before Flop (didn't bet)
Seat 6: DIMAN_324 folded before Flop (didn't bet)
Seat 8: Troll8989 folded before Flop (didn't bet)
Seat 9: Sjtu_Michael folded before Flop (didn't bet)





PokerStars Hand #155013171539:  Hold'em No Limit ($0.50/$1.00 USD) - 2016/06/21 13:20:24 CET [2016/06/21 7:20:24 ET]
Table 'Leo' 9-max Seat #9 is the button
Seat 1: fukumimi ($100.50 in chips) 
Seat 2: torkkdnm ($170.16 in chips) 
Seat 3: matiko09 ($104.60 in chips) 
Seat 4: SharingaaN ($104.35 in chips) 
Seat 7: maxxmeister ($100 in chips) 
Seat 8: pyromid ($90.92 in chips) 
Seat 9: Wladimir205 ($116.54 in chips) 
fukumimi: posts small blind $0.50
torkkdnm: posts big blind $1
Troll8989: sits out 
*** HOLE CARDS ***
Dealt to matiko09 [Tc Ac]
matiko09: raises $2 to $3
SharingaaN: folds 
maxxmeister: folds 
pyromid: folds 
Wladimir205: folds 
fukumimi: calls $2.50
torkkdnm: folds 
*** FLOP *** [2s 4s 7c]
fukumimi: checks 
matiko09: bets $4.32
fukumimi: calls $4.32
*** TURN *** [2s 4s 7c] [7h]
fukumimi: checks 
matiko09: checks 
*** RIVER *** [2s 4s 7c 7h] [Qd]
fukumimi: bets $7.43
matiko09: folds 
Uncalled bet ($7.43) returned to fukumimi
fukumimi collected $14.86 from pot
fukumimi: doesn't show hand 
*** SUMMARY ***
Total pot $15.64 | Rake $0.78 
Board [2s 4s 7c 7h Qd]
Seat 1: fukumimi (small blind) collected ($14.86)
Seat 2: torkkdnm (big blind) folded before Flop
Seat 3: matiko09 folded on the River
Seat 4: SharingaaN folded before Flop (didn't bet)
Seat 7: maxxmeister folded before Flop (didn't bet)
Seat 8: pyromid folded before Flop (didn't bet)
Seat 9: Wladimir205 (button) folded before Flop (didn't bet)





PokerStars Hand #155013171637:  Hold'em No Limit ($0.50/$1.00 USD) - 2016/06/21 13:20:24 CET [2016/06/21 7:20:24 ET]
Table 'Saldanha' 9-max Seat #1 is the button
Seat 1: phil_cheng ($100 in chips) 
Seat 2: matiko09 ($282.80 in chips) 
Seat 4: CoolFireX ($100 in chips) 
Seat 5: Michael Quan ($98.60 in chips) 
Seat 6: SharingaaN ($74.50 in chips) 
Seat 9: maxxmeister ($129.45 in chips) 
matiko09: posts small blind $0.50
CoolFireX: posts big blind $1
ozone2003: sits out 
erick222: sits out 
phil_cheng: posts the ante $0.20
matiko09: posts the ante $0.20
CoolFireX: posts the ante $0.20
Michael Quan: posts the ante $0.20
SharingaaN: posts the ante $0.20
maxxmeister: posts the ante $0.20
*** HOLE CARDS ***
Dealt to matiko09 [Ks 3d]
Michael Quan: folds 
wisbc joins the table at seat #3 
SharingaaN: raises $2 to $3
maxxmeister: folds 
phil_cheng: folds 
matiko09: folds 
CoolFireX: folds 
Uncalled bet ($2) returned to SharingaaN
SharingaaN collected $3.70 from pot
SharingaaN: doesn't show hand 
*** SUMMARY ***
Total pot $3.70 | Rake $0 
Seat 1: phil_cheng (button) folded before Flop (didn't bet)
Seat 2: matiko09 (small blind) folded before Flop
Seat 4: CoolFireX (big blind) folded before Flop
Seat 5: Michael Quan folded before Flop (didn't bet)
Seat 6: SharingaaN collected ($3.70)
Seat 9: maxxmeister folded before Flop (didn't bet)





PokerStars Hand #155013173241:  Hold'em No Limit (€0.25/€0.50 EUR) - 2016/06/21 13:20:28 CET [2016/06/21 7:20:28 ET]
Table 'Lotis II' 6-max Seat #5 is the button
Seat 1: tyoma_knp (€50 in chips) 
Seat 3: bricasse1961 (€39.60 in chips) 
Seat 4: matiko09 (€92.93 in chips) 
Seat 5: AlexPles (€78.53 in chips) 
torkkdnm will be allowed to play after the button
tyoma_knp: posts small blind €0.25
broh202: is sitting out 
bricasse1961: posts big blind €0.50
*** HOLE CARDS ***
Dealt to matiko09 [5h Qh]
matiko09: folds 
broh202 leaves the table
AlexPles: raises €1 to €1.50
tyoma_knp: folds 
bricasse1961: folds 
Uncalled bet (€1) returned to AlexPles
AlexPles collected €1.25 from pot
AlexPles: doesn't show hand 
*** SUMMARY ***
Total pot €1.25 | Rake €0 
Seat 1: tyoma_knp (small blind) folded before Flop
Seat 3: bricasse1961 (big blind) folded before Flop
Seat 4: matiko09 folded before Flop (didn't bet)
Seat 5: AlexPles (button) collected (€1.25)





PokerStars Hand #155013173485:  Hold'em No Limit ($0.50/$1.00 USD) - 2016/06/21 13:20:29 CET [2016/06/21 7:20:29 ET]
Table 'Cheleb' 9-max Seat #2 is the button
Seat 1: SharingaaN ($164.99 in chips) 
Seat 2: pyromid ($137.60 in chips) 
Seat 3: phil_cheng ($100 in chips) 
Seat 4: CoolFireX ($168.55 in chips) 
Seat 5: Avtovo ($135.50 in chips) 
Seat 6: matiko09 ($101 in chips) 
Seat 7: The Big Ape ($100 in chips) 
Seat 8: Troll8989 ($100 in chips) 
Seat 9: mbk88 ($100 in chips) 
phil_cheng: posts small blind $0.50
CoolFireX: posts big blind $1
*** HOLE CARDS ***
Dealt to matiko09 [5h 2h]
Avtovo has timed out
Avtovo: folds 
matiko09: folds 
The Big Ape: raises $4 to $5
Troll8989: folds 
mbk88: folds 
SharingaaN: folds 
pyromid: folds 
phil_cheng: folds 
CoolFireX: folds 
Uncalled bet ($4) returned to The Big Ape
The Big Ape collected $2.50 from pot
The Big Ape: doesn't show hand 
*** SUMMARY ***
Total pot $2.50 | Rake $0 
Seat 1: SharingaaN folded before Flop (didn't bet)
Seat 2: pyromid (button) folded before Flop (didn't bet)
Seat 3: phil_cheng (small blind) folded before Flop
Seat 4: CoolFireX (big blind) folded before Flop
Seat 5: Avtovo folded before Flop (didn't bet)
Seat 6: matiko09 folded before Flop (didn't bet)
Seat 7: The Big Ape collected ($2.50)
Seat 8: Troll8989 folded before Flop (didn't bet)
Seat 9: mbk88 folded before Flop (didn't bet)





PokerStars Hand #155013178927:  Hold'em No Limit ($0.50/$1.00 USD) - 2016/06/21 13:20:42 CET [2016/06/21 7:20:42 ET]
Table 'Carlova II' 9-max Seat #3 is the button
Seat 1: matiko09 ($109.80 in chips) 
Seat 3: King_Z�Manel ($109.05 in chips) 
Seat 4: Dandy Monk ($62.41 in chips) 
Seat 5: ozone2003 ($110.68 in chips) 
Seat 6: DIMAN_324 ($100 in chips) 
Seat 7: mi$$I$Elena ($122.97 in chips) 
Seat 8: pyromid ($105.10 in chips) 
Seat 9: Troll8989 ($103.18 in chips) 
Dandy Monk: posts small blind $0.50
ozone2003: posts big blind $1
mbk88: sits out 
*** HOLE CARDS ***
Dealt to matiko09 [8d 3h]
DIMAN_324: folds 
mi$$I$Elena: folds 
pyromid: raises $1.50 to $2.50
Troll8989: folds 
matiko09: folds 
King_Z�Manel: folds 
Dandy Monk: folds 
ozone2003: folds 
Uncalled bet ($1.50) returned to pyromid
pyromid collected $2.50 from pot
pyromid: doesn't show hand 
*** SUMMARY ***
Total pot $2.50 | Rake $0 
Seat 1: matiko09 folded before Flop (didn't bet)
Seat 3: King_Z�Manel (button) folded before Flop (didn't bet)
Seat 4: Dandy Monk (small blind) folded before Flop
Seat 5: ozone2003 (big blind) folded before Flop
Seat 6: DIMAN_324 folded before Flop (didn't bet)
Seat 7: mi$$I$Elena folded before Flop (didn't bet)
Seat 8: pyromid collected ($2.50)
Seat 9: Troll8989 folded before Flop (didn't bet)





PokerStars Hand #155013180160:  Hold'em No Limit (€0.25/€0.50 EUR) - 2016/06/21 13:20:45 CET [2016/06/21 7:20:45 ET]
Table 'Lotis II' 6-max Seat #1 is the button
Seat 1: tyoma_knp (€50 in chips) 
Seat 3: bricasse1961 (€39.10 in chips) 
Seat 4: matiko09 (€92.93 in chips) 
Seat 5: AlexPles (€79.28 in chips) 
bricasse1961: posts small blind €0.25
matiko09: posts big blind €0.50
torkkdnm: sits out 
*** HOLE CARDS ***
Dealt to matiko09 [6c 3h]
AlexPles: folds 
tyoma_knp: folds 
bricasse1961: raises €0.50 to €1
matiko09: folds 
Uncalled bet (€0.50) returned to bricasse1961
bricasse1961 collected €1 from pot
bricasse1961: doesn't show hand 
*** SUMMARY ***
Total pot €1 | Rake €0 
Seat 1: tyoma_knp (button) folded before Flop (didn't bet)
Seat 3: bricasse1961 (small blind) collected (€1)
Seat 4: matiko09 (big blind) folded before Flop
Seat 5: AlexPles folded before Flop (didn't bet)





PokerStars Hand #155013181408:  Hold'em No Limit ($0.50/$1.00 USD) - 2016/06/21 13:20:48 CET [2016/06/21 7:20:48 ET]
Table 'Megrez II' 9-max Seat #6 is the button
Seat 5: exreedik ($26.90 in chips) 
Seat 6: mi$$I$Elena ($105.05 in chips) 
Seat 7: CoolFireX ($109.45 in chips) 
Seat 9: matiko09 ($101 in chips) 
CoolFireX: posts small blind $0.50
matiko09: posts big blind $1
*** HOLE CARDS ***
Dealt to matiko09 [Tc 5h]
exreedik: folds 
mi$$I$Elena: raises $1 to $2
CoolFireX: folds 
matiko09: folds 
Uncalled bet ($1) returned to mi$$I$Elena
mi$$I$Elena collected $2.50 from pot
mi$$I$Elena: doesn't show hand 
*** SUMMARY ***
Total pot $2.50 | Rake $0 
Seat 5: exreedik folded before Flop (didn't bet)
Seat 6: mi$$I$Elena (button) collected ($2.50)
Seat 7: CoolFireX (small blind) folded before Flop
Seat 9: matiko09 (big blind) folded before Flop





PokerStars Hand #155013181894:  Hold'em No Limit ($0.50/$1.00 USD) - 2016/06/21 13:20:49 CET [2016/06/21 7:20:49 ET]
Table 'Saldanha' 9-max Seat #2 is the button
Seat 1: phil_cheng ($100 in chips) 
Seat 2: matiko09 ($282.10 in chips) 
Seat 4: CoolFireX ($100 in chips) 
Seat 5: Michael Quan ($98.40 in chips) 
Seat 6: SharingaaN ($77 in chips) 
Seat 9: maxxmeister ($129.25 in chips) 
wisbc will be allowed to play after the button
CoolFireX: posts small blind $0.50
Michael Quan: posts big blind $1
ozone2003: sits out 
erick222: sits out 
phil_cheng: posts the ante $0.20
matiko09: posts the ante $0.20
CoolFireX: posts the ante $0.20
Michael Quan: posts the ante $0.20
SharingaaN: posts the ante $0.20
maxxmeister: posts the ante $0.20
*** HOLE CARDS ***
Dealt to matiko09 [Kd Ah]
SharingaaN: folds 
maxxmeister: folds 
phil_cheng: folds 
matiko09: raises $1.27 to $2.27
CoolFireX: raises $8.23 to $10.50
Michael Quan: folds 
matiko09: raises $13.50 to $24
CoolFireX: calls $13.50
*** FLOP *** [9c Ad Js]
CoolFireX: checks 
matiko09: bets $14
CoolFireX: calls $14
*** TURN *** [9c Ad Js] [9d]
CoolFireX: checks 
matiko09: checks 
*** RIVER *** [9c Ad Js 9d] [3c]
CoolFireX: bets $61.80 and is all-in
matiko09: calls $61.80
*** SHOW DOWN ***
CoolFireX: shows [Qd Ac] (two pair, Aces and Nines)
matiko09: shows [Kd Ah] (two pair, Aces and Nines - King kicker)
matiko09 collected $199.30 from pot
*** SUMMARY ***
Total pot $201.80 | Rake $2.50 
Board [9c Ad Js 9d 3c]
Seat 1: phil_cheng folded before Flop (didn't bet)
Seat 2: matiko09 (button) showed [Kd Ah] and won ($199.30) with two pair, Aces and Nines
Seat 4: CoolFireX (small blind) showed [Qd Ac] and lost with two pair, Aces and Nines
Seat 5: Michael Quan (big blind) folded before Flop
Seat 6: SharingaaN folded before Flop (didn't bet)
Seat 9: maxxmeister folded before Flop (didn't bet)





PokerStars Hand #155013183946:  Hold'em No Limit (€0.25/€0.50 EUR) - 2016/06/21 13:20:54 CET [2016/06/21 7:20:54 ET]
Table 'Lotis II' 6-max Seat #3 is the button
Seat 1: tyoma_knp (€50 in chips) 
Seat 3: bricasse1961 (€39.60 in chips) 
Seat 4: matiko09 (€92.43 in chips) 
Seat 5: AlexPles (€79.28 in chips) 
matiko09: posts small blind €0.25
AlexPles: posts big blind €0.50
torkkdnm: sits out 
*** HOLE CARDS ***
Dealt to matiko09 [3s 9c]
tyoma_knp: folds 
bricasse1961: raises €0.50 to €1
matiko09: folds 
AlexPles: calls €0.50
*** FLOP *** [5h Ad Js]
AlexPles: checks 
bricasse1961: bets €0.50
AlexPles: folds 
Uncalled bet (€0.50) returned to bricasse1961
bricasse1961 collected €2.14 from pot
bricasse1961: doesn't show hand 
*** SUMMARY ***
Total pot €2.25 | Rake €0.11 
Board [5h Ad Js]
Seat 1: tyoma_knp folded before Flop (didn't bet)
Seat 3: bricasse1961 (button) collected (€2.14)
Seat 4: matiko09 (small blind) folded before Flop
Seat 5: AlexPles (big blind) folded on the Flop





PokerStars Hand #155013187002:  Hold'em No Limit ($0.50/$1.00 USD) - 2016/06/21 13:21:01 CET [2016/06/21 7:21:01 ET]
Table 'Megrez II' 9-max Seat #7 is the button
Seat 5: exreedik ($26.90 in chips) 
Seat 6: mi$$I$Elena ($106.55 in chips) 
Seat 7: CoolFireX ($108.95 in chips) 
Seat 9: matiko09 ($100 in chips) 
matiko09: posts small blind $0.50
exreedik: posts big blind $1
*** HOLE CARDS ***
Dealt to matiko09 [Qs 6s]
mi$$I$Elena: raises $1.38 to $2.38
CoolFireX: folds 
matiko09: folds 
exreedik: calls $1.38
*** FLOP *** [Tc 8s 3d]
exreedik: checks 
mi$$I$Elena: bets $3
exreedik: folds 
Uncalled bet ($3) returned to mi$$I$Elena
mi$$I$Elena collected $5 from pot
mi$$I$Elena: doesn't show hand 
*** SUMMARY ***
Total pot $5.26 | Rake $0.26 
Board [Tc 8s 3d]
Seat 5: exreedik (big blind) folded on the Flop
Seat 6: mi$$I$Elena collected ($5)
Seat 7: CoolFireX (button) folded before Flop (didn't bet)
Seat 9: matiko09 (small blind) folded before Flop





PokerStars Hand #155013192506:  Hold'em No Limit ($0.50/$1.00 USD) - 2016/06/21 13:21:14 CET [2016/06/21 7:21:14 ET]
Table 'Carlova II' 9-max Seat #4 is the button
Seat 1: matiko09 ($109.80 in chips) 
Seat 3: King_Z�Manel ($109.05 in chips) 
Seat 4: Dandy Monk ($61.91 in chips) 
Seat 5: ozone2003 ($109.68 in chips) 
Seat 7: mi$$I$Elena ($122.97 in chips) 
Seat 8: pyromid ($106.60 in chips) 
Seat 9: Troll8989 ($103.18 in chips) 
ozone2003: posts small blind $0.50
DIMAN_324: is sitting out 
mi$$I$Elena: posts big blind $1
mbk88: sits out 
*** HOLE CARDS ***
Dealt to matiko09 [7s 7h]
pyromid: folds 
Troll8989: folds 
DIMAN_324 leaves the table
phil_cheng joins the table at seat #6 
matiko09: raises $2 to $3
King_Z�Manel: folds 
Dandy Monk: folds 
ozone2003: folds 
mi$$I$Elena: folds 
Uncalled bet ($2) returned to matiko09
matiko09 collected $2.50 from pot
matiko09: doesn't show hand 
*** SUMMARY ***
Total pot $2.50 | Rake $0 
Seat 1: matiko09 collected ($2.50)
Seat 3: King_Z�Manel folded before Flop (didn't bet)
Seat 4: Dandy Monk (button) folded before Flop (didn't bet)
Seat 5: ozone2003 (small blind) folded before Flop
Seat 7: mi$$I$Elena (big blind) folded before Flop
Seat 8: pyromid folded before Flop (didn't bet)
Seat 9: Troll8989 folded before Flop (didn't bet)





PokerStars Hand #155013194355:  Hold'em No Limit ($0.50/$1.00 USD) - 2016/06/21 13:21:19 CET [2016/06/21 7:21:19 ET]
Table 'Rupertwildt' 9-max Seat #6 is the button
Seat 2: SharingaaN ($77.05 in chips) 
Seat 3: Troll8989 ($100 in chips) 
Seat 4: matiko09 ($144.68 in chips) 
Seat 5: pyromid ($91.50 in chips) 
Seat 6: ozone2003 ($124.72 in chips) 
Seat 7: Avtovo ($100 in chips) 
Seat 8: Gonzanary ($122.79 in chips) 
Seat 9: mbk88 ($106.43 in chips) 
Avtovo: posts small blind $0.50
Gonzanary: posts big blind $1
*** HOLE CARDS ***
Dealt to matiko09 [Ah Th]
mbk88: folds 
SharingaaN: folds 
Troll8989: folds 
matiko09: raises $2 to $3
pyromid: folds 
ozone2003: folds 
Avtovo: folds 
Gonzanary: folds 
Uncalled bet ($2) returned to matiko09
matiko09 collected $2.50 from pot
matiko09: doesn't show hand 
*** SUMMARY ***
Total pot $2.50 | Rake $0 
Seat 2: SharingaaN folded before Flop (didn't bet)
Seat 3: Troll8989 folded before Flop (didn't bet)
Seat 4: matiko09 collected ($2.50)
Seat 5: pyromid folded before Flop (didn't bet)
Seat 6: ozone2003 (button) folded before Flop (didn't bet)
Seat 7: Avtovo (small blind) folded before Flop
Seat 8: Gonzanary (big blind) folded before Flop
Seat 9: mbk88 folded before Flop (didn't bet)





PokerStars Hand #155013194871:  Hold'em No Limit ($0.50/$1.00 USD) - 2016/06/21 13:21:20 CET [2016/06/21 7:21:20 ET]
Table 'Cheleb' 9-max Seat #3 is the button
Seat 1: SharingaaN ($164.99 in chips) 
Seat 2: pyromid ($137.60 in chips) 
Seat 3: phil_cheng ($100 in chips) 
Seat 4: CoolFireX ($167.55 in chips) 
Seat 6: matiko09 ($101 in chips) 
Seat 7: The Big Ape ($101.50 in chips) 
Seat 8: Troll8989 ($100 in chips) 
Seat 9: mbk88 ($100 in chips) 
CoolFireX: posts small blind $0.50
matiko09: posts big blind $1
*** HOLE CARDS ***
Dealt to matiko09 [6c 8c]
The Big Ape: raises $1 to $2
Troll8989: folds 
mbk88: folds 
SharingaaN: folds 
pyromid: folds 
phil_cheng: calls $2
CoolFireX: folds 
matiko09: calls $1
*** FLOP *** [3d Qc 9c]
matiko09: bets $4
The Big Ape: folds 
phil_cheng: raises $8 to $12
matiko09: calls $8
*** TURN *** [3d Qc 9c] [Ad]
matiko09: checks 
phil_cheng: bets $19.31
matiko09: folds 
Uncalled bet ($19.31) returned to phil_cheng
phil_cheng collected $28.98 from pot
*** SUMMARY ***
Total pot $30.50 | Rake $1.52 
Board [3d Qc 9c Ad]
Seat 1: SharingaaN folded before Flop (didn't bet)
Seat 2: pyromid folded before Flop (didn't bet)
Seat 3: phil_cheng (button) collected ($28.98)
Seat 4: CoolFireX (small blind) folded before Flop
Seat 6: matiko09 (big blind) folded on the Turn
Seat 7: The Big Ape folded on the Flop
Seat 8: Troll8989 folded before Flop (didn't bet)
Seat 9: mbk88 folded before Flop (didn't bet)





PokerStars Hand #155013195563:  Hold'em No Limit (€0.25/€0.50 EUR) - 2016/06/21 13:21:22 CET [2016/06/21 7:21:22 ET]
Table 'Lotis II' 6-max Seat #4 is the button
Seat 1: tyoma_knp (€50 in chips) 
Seat 3: bricasse1961 (€40.74 in chips) 
Seat 4: matiko09 (€92.18 in chips) 
Seat 5: AlexPles (€78.28 in chips) 
Seat 6: torkkdnm (€50 in chips) 
AlexPles: posts small blind €0.25
torkkdnm: posts big blind €0.50
*** HOLE CARDS ***
Dealt to matiko09 [9h 8c]
janska.fi joins the table at seat #2 
tyoma_knp: folds 
bricasse1961: folds 
matiko09: folds 
AlexPles: raises €1 to €1.50
torkkdnm: calls €1
*** FLOP *** [Tc 7c Js]
AlexPles: bets €2.28
torkkdnm: calls €2.28
*** TURN *** [Tc 7c Js] [3c]
AlexPles: checks 
torkkdnm: checks 
*** RIVER *** [Tc 7c Js 3c] [Td]
AlexPles: bets €4.31
torkkdnm: calls €4.31
*** SHOW DOWN ***
AlexPles: shows [Qd Ad] (a pair of Tens)
torkkdnm: shows [Ks Th] (three of a kind, Tens)
torkkdnm collected €15.37 from pot
*** SUMMARY ***
Total pot €16.18 | Rake €0.81 
Board [Tc 7c Js 3c Td]
Seat 1: tyoma_knp folded before Flop (didn't bet)
Seat 3: bricasse1961 folded before Flop (didn't bet)
Seat 4: matiko09 (button) folded before Flop (didn't bet)
Seat 5: AlexPles (small blind) showed [Qd Ad] and lost with a pair of Tens
Seat 6: torkkdnm (big blind) showed [Ks Th] and won (€15.37) with three of a kind, Tens





PokerStars Hand #155013195998:  Hold'em No Limit ($0.50/$1.00 USD) - 2016/06/21 13:21:23 CET [2016/06/21 7:21:23 ET]
Table 'Admete II' 9-max Seat #6 is the button
Seat 1: xxxxusedomer ($48.99 in chips) 
Seat 2: Eskimo Fox ($104.50 in chips) 
Seat 4: krustophsky ($95.28 in chips) 
Seat 5: ramzes160468 ($68.42 in chips) 
Seat 6: mbk88 ($128.50 in chips) 
Seat 7: matiko09 ($100 in chips) 
Seat 8: koutani7 ($98.50 in chips) 
Seat 9: ozone2003 ($100 in chips) 
matiko09: posts small blind $0.50
koutani7: posts big blind $1
*** HOLE CARDS ***
Dealt to matiko09 [4d 3h]
ozone2003: folds 
xxxxusedomer: folds 
Eskimo Fox: folds 
krustophsky: raises $2.50 to $3.50
ramzes160468: folds 
mbk88: folds 
matiko09: folds 
koutani7: folds 
Uncalled bet ($2.50) returned to krustophsky
krustophsky collected $2.50 from pot
krustophsky: doesn't show hand 
*** SUMMARY ***
Total pot $2.50 | Rake $0 
Seat 1: xxxxusedomer folded before Flop (didn't bet)
Seat 2: Eskimo Fox folded before Flop (didn't bet)
Seat 4: krustophsky collected ($2.50)
Seat 5: ramzes160468 folded before Flop (didn't bet)
Seat 6: mbk88 (button) folded before Flop (didn't bet)
Seat 7: matiko09 (small blind) folded before Flop
Seat 8: koutani7 (big blind) folded before Flop
Seat 9: ozone2003 folded before Flop (didn't bet)





PokerStars Hand #155013198588:  Hold'em No Limit ($0.50/$1.00 USD) - 2016/06/21 13:21:29 CET [2016/06/21 7:21:29 ET]
Table 'Moreau' 9-max Seat #5 is the button
Seat 1: ozone2003 ($133.49 in chips) 
Seat 2: nubpoker ($135.17 in chips) 
Seat 3: matiko09 ($118.38 in chips) 
Seat 4: SharingaaN ($101 in chips) 
Seat 5: DIMAN_324 ($100 in chips) 
Seat 7: PanKwn15 ($47.43 in chips) 
Seat 8: maxxmeister ($120.28 in chips) 
PanKwn15: posts small blind $0.50
maxxmeister: posts big blind $1
*** HOLE CARDS ***
Dealt to matiko09 [Ks Tc]
ozone2003: folds 
nubpoker: folds 
matiko09: folds 
SharingaaN: folds 
DIMAN_324: folds 
PanKwn15: calls $0.50
maxxmeister: raises $4 to $5
PanKwn15: calls $4
*** FLOP *** [7h 3c Ac]
PanKwn15: checks 
maxxmeister: checks 
*** TURN *** [7h 3c Ac] [9d]
PanKwn15: checks 
maxxmeister: bets $9
PanKwn15: calls $9
*** RIVER *** [7h 3c Ac 9d] [2c]
PanKwn15: checks 
maxxmeister: bets $35
PanKwn15: calls $33.43 and is all-in
Uncalled bet ($1.57) returned to maxxmeister
*** SHOW DOWN ***
maxxmeister: shows [9c Ad] (two pair, Aces and Nines)
PanKwn15: shows [Qc 6c] (a flush, Ace high)
PanKwn15 collected $92.36 from pot
*** SUMMARY ***
Total pot $94.86 | Rake $2.50 
Board [7h 3c Ac 9d 2c]
Seat 1: ozone2003 folded before Flop (didn't bet)
Seat 2: nubpoker folded before Flop (didn't bet)
Seat 3: matiko09 folded before Flop (didn't bet)
Seat 4: SharingaaN folded before Flop (didn't bet)
Seat 5: DIMAN_324 (button) folded before Flop (didn't bet)
Seat 7: PanKwn15 (small blind) showed [Qc 6c] and won ($92.36) with a flush, Ace high
Seat 8: maxxmeister (big blind) showed [9c Ad] and lost with two pair, Aces and Nines





PokerStars Hand #155013199348:  Hold'em No Limit ($0.50/$1.00 USD) - 2016/06/21 13:21:31 CET [2016/06/21 7:21:31 ET]
Table 'Megrez II' 9-max Seat #9 is the button
Seat 5: exreedik ($24.52 in chips) 
Seat 6: mi$$I$Elena ($109.17 in chips) 
Seat 7: CoolFireX ($108.95 in chips) 
Seat 9: matiko09 ($100 in chips) 
exreedik: posts small blind $0.50
mi$$I$Elena: posts big blind $1
*** HOLE CARDS ***
Dealt to matiko09 [5h 6s]
CoolFireX: raises $2 to $3
matiko09: folds 
exreedik: raises $7 to $10
mi$$I$Elena: folds 
CoolFireX: raises $21 to $31
exreedik: calls $14.52 and is all-in
Uncalled bet ($6.48) returned to CoolFireX
*** FLOP *** [As Kc Ac]
*** TURN *** [As Kc Ac] [9h]
*** RIVER *** [As Kc Ac 9h] [8d]
*** SHOW DOWN ***
exreedik: shows [Qc Qs] (two pair, Aces and Queens)
CoolFireX: shows [Ks Kh] (a full house, Kings full of Aces)
CoolFireX collected $49.04 from pot
*** SUMMARY ***
Total pot $50.04 | Rake $1 
Board [As Kc Ac 9h 8d]
Seat 5: exreedik (small blind) showed [Qc Qs] and lost with two pair, Aces and Queens
Seat 6: mi$$I$Elena (big blind) folded before Flop
Seat 7: CoolFireX showed [Ks Kh] and won ($49.04) with a full house, Kings full of Aces
Seat 9: matiko09 (button) folded before Flop (didn't bet)





PokerStars Hand #155013201105:  Hold'em No Limit ($0.50/$1.00 USD) - 2016/06/21 13:21:35 CET [2016/06/21 7:21:35 ET]
Table 'Lamberta II' 9-max Seat #3 is the button
Seat 2: mavin80 ($97.82 in chips) 
Seat 3: matiko09 ($100 in chips) 
Seat 4: Eskimo Fox ($114.41 in chips) 
Seat 5: mi$$I$Elena ($103 in chips) 
Seat 6: DIMAN_324 ($100 in chips) 
Seat 8: Troll8989 ($100 in chips) 
Seat 9: Sjtu_Michael ($108.94 in chips) 
Eskimo Fox: posts small blind $0.50
mi$$I$Elena: posts big blind $1
phil_cheng: sits out 
*** HOLE CARDS ***
Dealt to matiko09 [8c 3s]
DIMAN_324: folds 
DIMAN_324 leaves the table
Troll8989: folds 
Sjtu_Michael: folds 
mavin80: folds 
matiko09: folds 
Eskimo Fox: raises $2 to $3
Avtovo leaves the table
mi$$I$Elena: folds 
Uncalled bet ($2) returned to Eskimo Fox
Eskimo Fox collected $2 from pot
Eskimo Fox: doesn't show hand 
*** SUMMARY ***
Total pot $2 | Rake $0 
Seat 2: mavin80 folded before Flop (didn't bet)
Seat 3: matiko09 (button) folded before Flop (didn't bet)
Seat 4: Eskimo Fox (small blind) collected ($2)
Seat 5: mi$$I$Elena (big blind) folded before Flop
Seat 6: DIMAN_324 folded before Flop (didn't bet)
Seat 8: Troll8989 folded before Flop (didn't bet)
Seat 9: Sjtu_Michael folded before Flop (didn't bet)





PokerStars Hand #155013203786:  Hold'em No Limit ($0.50/$1.00 USD) - 2016/06/21 13:21:42 CET [2016/06/21 7:21:42 ET]
Table 'Leo' 9-max Seat #1 is the button
Seat 1: fukumimi ($108.04 in chips) 
Seat 2: torkkdnm ($169.16 in chips) 
Seat 3: matiko09 ($100 in chips) 
Seat 4: SharingaaN ($104.35 in chips) 
Seat 7: maxxmeister ($100 in chips) 
Seat 8: pyromid ($90.92 in chips) 
Seat 9: Wladimir205 ($116.54 in chips) 
torkkdnm: posts small blind $0.50
matiko09: posts big blind $1
Troll8989: sits out 
*** HOLE CARDS ***
Dealt to matiko09 [2c 7c]
SharingaaN: folds 
maxxmeister: folds 
SharingaaN leaves the table
pyromid: raises $1.50 to $2.50
Wladimir205: folds 
fukumimi: folds 
torkkdnm: folds 
phil_cheng joins the table at seat #4 
matiko09: folds 
Uncalled bet ($1.50) returned to pyromid
pyromid collected $2.50 from pot
pyromid: doesn't show hand 
*** SUMMARY ***
Total pot $2.50 | Rake $0 
Seat 1: fukumimi (button) folded before Flop (didn't bet)
Seat 2: torkkdnm (small blind) folded before Flop
Seat 3: matiko09 (big blind) folded before Flop
Seat 4: SharingaaN folded before Flop (didn't bet)
Seat 7: maxxmeister folded before Flop (didn't bet)
Seat 8: pyromid collected ($2.50)
Seat 9: Wladimir205 folded before Flop (didn't bet)





PokerStars Hand #155013206821:  Hold'em No Limit (€0.25/€0.50 EUR) - 2016/06/21 13:21:49 CET [2016/06/21 7:21:49 ET]
Table 'Actor II' 6-max Seat #5 is the button
Seat 1: hmverlin (€99.94 in chips) 
Seat 3: asmodej666 (€88.31 in chips) 
Seat 4: matiko09 (€50 in chips) 
Seat 5: Rybka1294 (€50.62 in chips) 
Seat 6: fanmtZ (€22.36 in chips) 
fanmtZ: posts small blind €0.25
hmverlin: posts big blind €0.50
alôha: sits out 
*** HOLE CARDS ***
Dealt to matiko09 [Qc 8d]
asmodej666: folds 
matiko09: folds 
Rybka1294: raises €0.50 to €1
fanmtZ: folds 
hmverlin: calls €0.50
*** FLOP *** [7s 6d 6s]
hmverlin: bets €1
Rybka1294: calls €1
*** TURN *** [7s 6d 6s] [2h]
hmverlin: bets €2
Rybka1294: calls €2
*** RIVER *** [7s 6d 6s 2h] [5d]
hmverlin: bets €3.50
Rybka1294: calls €3.50
*** SHOW DOWN ***
hmverlin: shows [4d Qh] (a pair of Sixes)
Rybka1294: shows [2s Ks] (two pair, Sixes and Deuces)
Rybka1294 collected €14.49 from pot
*** SUMMARY ***
Total pot €15.25 | Rake €0.76 
Board [7s 6d 6s 2h 5d]
Seat 1: hmverlin (big blind) showed [4d Qh] and lost with a pair of Sixes
Seat 3: asmodej666 folded before Flop (didn't bet)
Seat 4: matiko09 folded before Flop (didn't bet)
Seat 5: Rybka1294 (button) showed [2s Ks] and won (€14.49) with two pair, Sixes and Deuces
Seat 6: fanmtZ (small blind) folded before Flop





PokerStars Hand #155013211093:  Hold'em No Limit ($0.50/$1.00 USD) - 2016/06/21 13:21:59 CET [2016/06/21 7:21:59 ET]
Table 'Admete II' 9-max Seat #7 is the button
Seat 1: xxxxusedomer ($48.99 in chips) 
Seat 2: Eskimo Fox ($104.50 in chips) 
Seat 4: krustophsky ($96.78 in chips) 
Seat 5: ramzes160468 ($68.42 in chips) 
Seat 6: mbk88 ($128.50 in chips) 
Seat 7: matiko09 ($100 in chips) 
Seat 8: koutani7 ($97.50 in chips) 
Seat 9: ozone2003 ($100 in chips) 
koutani7: posts small blind $0.50
ozone2003: posts big blind $1
*** HOLE CARDS ***
Dealt to matiko09 [Kh Jd]
xxxxusedomer: raises $3 to $4
Eskimo Fox: folds 
krustophsky: calls $4
ramzes160468: folds 
mbk88: folds 
matiko09: folds 
koutani7: calls $3.50
ozone2003: folds 
*** FLOP *** [7c 8d Ks]
koutani7: checks 
xxxxusedomer: bets $12
krustophsky: folds 
koutani7: folds 
Uncalled bet ($12) returned to xxxxusedomer
xxxxusedomer collected $12.35 from pot
*** SUMMARY ***
Total pot $13 | Rake $0.65 
Board [7c 8d Ks]
Seat 1: xxxxusedomer collected ($12.35)
Seat 2: Eskimo Fox folded before Flop (didn't bet)
Seat 4: krustophsky folded on the Flop
Seat 5: ramzes160468 folded before Flop (didn't bet)
Seat 6: mbk88 folded before Flop (didn't bet)
Seat 7: matiko09 (button) folded before Flop (didn't bet)
Seat 8: koutani7 (small blind) folded on the Flop
Seat 9: ozone2003 (big blind) folded before Flop





PokerStars Hand #155013212281:  Hold'em No Limit ($0.50/$1.00 USD) - 2016/06/21 13:22:02 CET [2016/06/21 7:22:02 ET]
Table 'Carlova II' 9-max Seat #5 is the button
Seat 1: matiko09 ($111.30 in chips) 
Seat 3: King_Z�Manel ($109.05 in chips) 
Seat 4: Dandy Monk ($61.91 in chips) 
Seat 5: ozone2003 ($109.18 in chips) 
Seat 7: mi$$I$Elena ($121.97 in chips) 
Seat 8: pyromid ($106.60 in chips) 
Seat 9: Troll8989 ($103.18 in chips) 
phil_cheng will be allowed to play after the button
mi$$I$Elena: posts small blind $0.50
pyromid: posts big blind $1
mbk88: sits out 
*** HOLE CARDS ***
Dealt to matiko09 [Ac 7h]
Troll8989: folds 
matiko09: folds 
King_Z�Manel: folds 
Dandy Monk: raises $2 to $3
ozone2003: folds 
mi$$I$Elena: folds 
pyromid: folds 
Uncalled bet ($2) returned to Dandy Monk
Dandy Monk collected $2.50 from pot
Dandy Monk: doesn't show hand 
*** SUMMARY ***
Total pot $2.50 | Rake $0 
Seat 1: matiko09 folded before Flop (didn't bet)
Seat 3: King_Z�Manel folded before Flop (didn't bet)
Seat 4: Dandy Monk collected ($2.50)
Seat 5: ozone2003 (button) folded before Flop (didn't bet)
Seat 7: mi$$I$Elena (small blind) folded before Flop
Seat 8: pyromid (big blind) folded before Flop
Seat 9: Troll8989 folded before Flop (didn't bet)





PokerStars Hand #155013216507:  Hold'em No Limit ($0.50/$1.00 USD) - 2016/06/21 13:22:12 CET [2016/06/21 7:22:12 ET]
Table 'Megrez II' 9-max Seat #6 is the button
Seat 6: mi$$I$Elena ($108.17 in chips) 
Seat 7: CoolFireX ($133.47 in chips) 
Seat 9: matiko09 ($100 in chips) 
CoolFireX: posts small blind $0.50
matiko09: posts big blind $1
*** HOLE CARDS ***
Dealt to matiko09 [Tc 4s]
mi$$I$Elena: folds 
exreedik leaves the table
CoolFireX: folds 
Uncalled bet ($0.50) returned to matiko09
matiko09 collected $1 from pot
matiko09: doesn't show hand 
*** SUMMARY ***
Total pot $1 | Rake $0 
Seat 6: mi$$I$Elena (button) folded before Flop (didn't bet)
Seat 7: CoolFireX (small blind) folded before Flop
Seat 9: matiko09 (big blind) collected ($1)





PokerStars Hand #155013217193:  Hold'em No Limit ($0.50/$1.00 USD) - 2016/06/21 13:22:13 CET [2016/06/21 7:22:13 ET]
Table 'Lamberta II' 9-max Seat #4 is the button
Seat 2: mavin80 ($97.82 in chips) 
Seat 3: matiko09 ($100 in chips) 
Seat 4: Eskimo Fox ($115.41 in chips) 
Seat 5: mi$$I$Elena ($102 in chips) 
Seat 7: phil_cheng ($100 in chips) 
Seat 8: Troll8989 ($100 in chips) 
Seat 9: Sjtu_Michael ($108.94 in chips) 
mi$$I$Elena: posts small blind $0.50
phil_cheng: posts big blind $1
*** HOLE CARDS ***
Dealt to matiko09 [Ts Ah]
mbk88 joins the table at seat #1 
Troll8989: raises $1.50 to $2.50
Sjtu_Michael: folds 
mavin80: folds 
matiko09: folds 
Eskimo Fox: raises $6 to $8.50
mi$$I$Elena: folds 
phil_cheng: folds 
Chen423 joins the table at seat #6 
Troll8989: folds 
Uncalled bet ($6) returned to Eskimo Fox
Eskimo Fox collected $6.50 from pot
Eskimo Fox: doesn't show hand 
*** SUMMARY ***
Total pot $6.50 | Rake $0 
Seat 2: mavin80 folded before Flop (didn't bet)
Seat 3: matiko09 folded before Flop (didn't bet)
Seat 4: Eskimo Fox (button) collected ($6.50)
Seat 5: mi$$I$Elena (small blind) folded before Flop
Seat 7: phil_cheng (big blind) folded before Flop
Seat 8: Troll8989 folded before Flop
Seat 9: Sjtu_Michael folded before Flop (didn't bet)





PokerStars Hand #155013216990:  Hold'em No Limit ($0.50/$1.00 USD) - 2016/06/21 13:22:13 CET [2016/06/21 7:22:13 ET]
Table 'Rupertwildt' 9-max Seat #7 is the button
Seat 2: SharingaaN ($77.05 in chips) 
Seat 3: Troll8989 ($100 in chips) 
Seat 4: matiko09 ($146.18 in chips) 
Seat 5: pyromid ($91.50 in chips) 
Seat 6: ozone2003 ($124.72 in chips) 
Seat 7: Avtovo ($100 in chips) 
Seat 8: Gonzanary ($121.79 in chips) 
Seat 9: mbk88 ($106.43 in chips) 
Gonzanary: posts small blind $0.50
mbk88: posts big blind $1
*** HOLE CARDS ***
Dealt to matiko09 [Qh 6d]
SharingaaN: folds 
Troll8989: raises $1.50 to $2.50
matiko09: folds 
pyromid: folds 
ozone2003: raises $6.50 to $9
Avtovo: folds 
Gonzanary: folds 
mbk88: folds 
Troll8989: calls $6.50
*** FLOP *** [2h Qs 9s]
Troll8989: checks 
ozone2003: bets $10
Troll8989: calls $10
*** TURN *** [2h Qs 9s] [4h]
Troll8989: checks 
ozone2003: bets $20.44
Troll8989: calls $20.44
*** RIVER *** [2h Qs 9s 4h] [Js]
Troll8989: checks 
ozone2003: bets $85.28 and is all-in
Troll8989: folds 
Uncalled bet ($85.28) returned to ozone2003
ozone2003 collected $77.88 from pot
ozone2003: doesn't show hand 
*** SUMMARY ***
Total pot $80.38 | Rake $2.50 
Board [2h Qs 9s 4h Js]
Seat 2: SharingaaN folded before Flop (didn't bet)
Seat 3: Troll8989 folded on the River
Seat 4: matiko09 folded before Flop (didn't bet)
Seat 5: pyromid folded before Flop (didn't bet)
Seat 6: ozone2003 collected ($77.88)
Seat 7: Avtovo (button) folded before Flop (didn't bet)
Seat 8: Gonzanary (small blind) folded before Flop
Seat 9: mbk88 (big blind) folded before Flop





PokerStars Hand #155013218849:  Hold'em No Limit ($0.50/$1.00 USD) - 2016/06/21 13:22:17 CET [2016/06/21 7:22:17 ET]
Table 'Leo' 9-max Seat #2 is the button
Seat 1: fukumimi ($108.04 in chips) 
Seat 2: torkkdnm ($168.66 in chips) 
Seat 3: matiko09 ($100 in chips) 
Seat 4: phil_cheng ($100 in chips) 
Seat 7: maxxmeister ($100 in chips) 
Seat 8: pyromid ($92.42 in chips) 
Seat 9: Wladimir205 ($116.54 in chips) 
matiko09: posts small blind $0.50
phil_cheng: posts big blind $1
Troll8989: sits out 
Avtovo: sits out 
*** HOLE CARDS ***
Dealt to matiko09 [9c 2c]
maxxmeister: folds 
pyromid: folds 
Wladimir205: folds 
fukumimi: folds 
torkkdnm: raises $1 to $2
matiko09: folds 
phil_cheng: folds 
Uncalled bet ($1) returned to torkkdnm
torkkdnm collected $2.50 from pot
*** SUMMARY ***
Total pot $2.50 | Rake $0 
Seat 1: fukumimi folded before Flop (didn't bet)
Seat 2: torkkdnm (button) collected ($2.50)
Seat 3: matiko09 (small blind) folded before Flop
Seat 4: phil_cheng (big blind) folded before Flop
Seat 7: maxxmeister folded before Flop (didn't bet)
Seat 8: pyromid folded before Flop (didn't bet)
Seat 9: Wladimir205 folded before Flop (didn't bet)





PokerStars Hand #155013219744:  Hold'em No Limit ($0.50/$1.00 USD) - 2016/06/21 13:22:20 CET [2016/06/21 7:22:20 ET]
Table 'Megrez II' 9-max Seat #9 is the button
Seat 7: CoolFireX ($132.97 in chips) 
Seat 9: matiko09 ($100.50 in chips) 
matiko09: posts small blind $0.50
mi$$I$Elena: is sitting out 
CoolFireX: posts big blind $1
*** HOLE CARDS ***
Dealt to matiko09 [3s 2d]
mi$$I$Elena leaves the table
matiko09: folds 
Uncalled bet ($0.50) returned to CoolFireX
CoolFireX collected $1 from pot
CoolFireX: doesn't show hand 
*** SUMMARY ***
Total pot $1 | Rake $0 
Seat 7: CoolFireX (big blind) collected ($1)
Seat 9: matiko09 (button) (small blind) folded before Flop





PokerStars Hand #155013225526:  Hold'em No Limit (€0.25/€0.50 EUR) - 2016/06/21 13:22:33 CET [2016/06/21 7:22:33 ET]
Table 'Lotis II' 6-max Seat #5 is the button
Seat 1: tyoma_knp (€50 in chips) 
Seat 3: bricasse1961 (€40.74 in chips) 
Seat 4: matiko09 (€92.18 in chips) 
Seat 5: AlexPles (€70.19 in chips) 
Seat 6: torkkdnm (€57.28 in chips) 
torkkdnm: posts small blind €0.25
tyoma_knp: posts big blind €0.50
*** HOLE CARDS ***
Dealt to matiko09 [Ah 2d]
bricasse1961: folds 
matiko09: folds 
AlexPles: folds 
torkkdnm: raises €0.50 to €1
tyoma_knp has timed out
tyoma_knp: folds 
Uncalled bet (€0.50) returned to torkkdnm
torkkdnm collected €1 from pot
*** SUMMARY ***
Total pot €1 | Rake €0 
Seat 1: tyoma_knp (big blind) folded before Flop
Seat 3: bricasse1961 folded before Flop (didn't bet)
Seat 4: matiko09 folded before Flop (didn't bet)
Seat 5: AlexPles (button) folded before Flop (didn't bet)
Seat 6: torkkdnm (small blind) collected (€1)





PokerStars Hand #155013230659:  Hold'em No Limit ($0.50/$1.00 USD) - 2016/06/21 13:22:45 CET [2016/06/21 7:22:45 ET]
Table 'Moreau' 9-max Seat #7 is the button
Seat 1: ozone2003 ($133.49 in chips) 
Seat 2: nubpoker ($135.17 in chips) 
Seat 3: matiko09 ($118.38 in chips) 
Seat 4: SharingaaN ($101 in chips) 
Seat 5: DIMAN_324 ($100 in chips) 
Seat 7: PanKwn15 ($92.36 in chips) 
Seat 8: maxxmeister ($100 in chips) 
maxxmeister: posts small blind $0.50
ozone2003: posts big blind $1
*** HOLE CARDS ***
Dealt to matiko09 [2c Jh]
nubpoker: folds 
matiko09: folds 
SharingaaN: folds 
DIMAN_324: folds 
PanKwn15: raises $2 to $3
maxxmeister: folds 
ozone2003: folds 
Uncalled bet ($2) returned to PanKwn15
PanKwn15 collected $2.50 from pot
PanKwn15: doesn't show hand 
*** SUMMARY ***
Total pot $2.50 | Rake $0 
Seat 1: ozone2003 (big blind) folded before Flop
Seat 2: nubpoker folded before Flop (didn't bet)
Seat 3: matiko09 folded before Flop (didn't bet)
Seat 4: SharingaaN folded before Flop (didn't bet)
Seat 5: DIMAN_324 folded before Flop (didn't bet)
Seat 7: PanKwn15 (button) collected ($2.50)
Seat 8: maxxmeister (small blind) folded before Flop





PokerStars Hand #155013230481:  Hold'em No Limit ($0.50/$1.00 USD) - 2016/06/21 13:22:45 CET [2016/06/21 7:22:45 ET]
Table 'Carlova II' 9-max Seat #7 is the button
Seat 1: matiko09 ($111.30 in chips) 
Seat 3: King_Z�Manel ($109.05 in chips) 
Seat 4: Dandy Monk ($63.41 in chips) 
Seat 5: ozone2003 ($109.18 in chips) 
Seat 7: mi$$I$Elena ($121.47 in chips) 
Seat 8: pyromid ($105.60 in chips) 
Seat 9: Troll8989 ($103.18 in chips) 
pyromid: posts small blind $0.50
Troll8989: posts big blind $1
mbk88: sits out 
phil_cheng: sits out 
*** HOLE CARDS ***
Dealt to matiko09 [Th 7c]
matiko09: folds 
King_Z�Manel: folds 
Dandy Monk: folds 
ozone2003: folds 
mi$$I$Elena: raises $1 to $2
pyromid: folds 
Troll8989: calls $1
*** FLOP *** [Ah 6d 4s]
Troll8989: checks 
mi$$I$Elena: bets $3
Troll8989: folds 
Uncalled bet ($3) returned to mi$$I$Elena
mi$$I$Elena collected $4.28 from pot
mi$$I$Elena: doesn't show hand 
*** SUMMARY ***
Total pot $4.50 | Rake $0.22 
Board [Ah 6d 4s]
Seat 1: matiko09 folded before Flop (didn't bet)
Seat 3: King_Z�Manel folded before Flop (didn't bet)
Seat 4: Dandy Monk folded before Flop (didn't bet)
Seat 5: ozone2003 folded before Flop (didn't bet)
Seat 7: mi$$I$Elena (button) collected ($4.28)
Seat 8: pyromid (small blind) folded before Flop
Seat 9: Troll8989 (big blind) folded on the Flop





PokerStars Hand #155013231563:  Hold'em No Limit (€0.25/€0.50 EUR) - 2016/06/21 13:22:48 CET [2016/06/21 7:22:48 ET]
Table 'Actor II' 6-max Seat #6 is the button
Seat 1: hmverlin (€92.44 in chips) 
Seat 2: alôha (€50 in chips) 
Seat 3: asmodej666 (€88.31 in chips) 
Seat 4: matiko09 (€50 in chips) 
Seat 5: Rybka1294 (€57.61 in chips) 
Seat 6: fanmtZ (€22.11 in chips) 
hmverlin: posts small blind €0.25
alôha: posts big blind €0.50
*** HOLE CARDS ***
Dealt to matiko09 [7d Td]
asmodej666: raises €1 to €1.50
matiko09: folds 
Rybka1294: folds 
fanmtZ: folds 
hmverlin: folds 
alôha: folds 
Uncalled bet (€1) returned to asmodej666
asmodej666 collected €1.25 from pot
asmodej666: doesn't show hand 
*** SUMMARY ***
Total pot €1.25 | Rake €0 
Seat 1: hmverlin (small blind) folded before Flop
Seat 2: alôha (big blind) folded before Flop
Seat 3: asmodej666 collected (€1.25)
Seat 4: matiko09 folded before Flop (didn't bet)
Seat 5: Rybka1294 folded before Flop (didn't bet)
Seat 6: fanmtZ (button) folded before Flop (didn't bet)





PokerStars Hand #155013234794:  Hold'em No Limit ($0.50/$1.00 USD) - 2016/06/21 13:22:55 CET [2016/06/21 7:22:55 ET]
Table 'Leo' 9-max Seat #3 is the button
Seat 1: fukumimi ($108.04 in chips) 
Seat 2: torkkdnm ($170.16 in chips) 
Seat 3: matiko09 ($100 in chips) 
Seat 4: phil_cheng ($100 in chips) 
Seat 5: Troll8989 ($100 in chips) 
Seat 7: maxxmeister ($100 in chips) 
Seat 8: pyromid ($92.42 in chips) 
Seat 9: Wladimir205 ($116.54 in chips) 
phil_cheng: posts small blind $0.50
Troll8989: posts big blind $1
Avtovo: sits out 
*** HOLE CARDS ***
Dealt to matiko09 [8d Ac]
maxxmeister: folds 
pyromid: folds 
Wladimir205: folds 
fukumimi: folds 
torkkdnm: folds 
matiko09: raises $1.27 to $2.27
phil_cheng: folds 
Troll8989: calls $1.27
*** FLOP *** [Qh Td 5s]
Troll8989: checks 
matiko09: checks 
*** TURN *** [Qh Td 5s] [Jc]
Troll8989: bets $3
matiko09: folds 
Uncalled bet ($3) returned to Troll8989
Troll8989 collected $4.79 from pot
Troll8989: doesn't show hand 
*** SUMMARY ***
Total pot $5.04 | Rake $0.25 
Board [Qh Td 5s Jc]
Seat 1: fukumimi folded before Flop (didn't bet)
Seat 2: torkkdnm folded before Flop (didn't bet)
Seat 3: matiko09 (button) folded on the Turn
Seat 4: phil_cheng (small blind) folded before Flop
Seat 5: Troll8989 (big blind) collected ($4.79)
Seat 7: maxxmeister folded before Flop (didn't bet)
Seat 8: pyromid folded before Flop (didn't bet)
Seat 9: Wladimir205 folded before Flop (didn't bet)





PokerStars Hand #155013235859:  Hold'em No Limit ($0.50/$1.00 USD) - 2016/06/21 13:22:58 CET [2016/06/21 7:22:58 ET]
Table 'Cheleb' 9-max Seat #4 is the button
Seat 1: SharingaaN ($164.99 in chips) 
Seat 2: pyromid ($137.60 in chips) 
Seat 3: phil_cheng ($114.98 in chips) 
Seat 4: CoolFireX ($167.05 in chips) 
Seat 6: matiko09 ($100 in chips) 
Seat 7: The Big Ape ($99.50 in chips) 
Seat 8: Troll8989 ($100 in chips) 
Seat 9: mbk88 ($100 in chips) 
Avtovo will be allowed to play after the button
matiko09: posts small blind $0.50
The Big Ape: posts big blind $1
*** HOLE CARDS ***
Dealt to matiko09 [6s Ah]
Troll8989: folds 
mbk88: folds 
SharingaaN: raises $2 to $3
pyromid: folds 
phil_cheng: folds 
CoolFireX: calls $3
matiko09: folds 
The Big Ape: folds 
*** FLOP *** [7h 7d 2h]
SharingaaN: checks 
CoolFireX: bets $4
SharingaaN: folds 
Uncalled bet ($4) returned to CoolFireX
CoolFireX collected $7.12 from pot
CoolFireX: doesn't show hand 
*** SUMMARY ***
Total pot $7.50 | Rake $0.38 
Board [7h 7d 2h]
Seat 1: SharingaaN folded on the Flop
Seat 2: pyromid folded before Flop (didn't bet)
Seat 3: phil_cheng folded before Flop (didn't bet)
Seat 4: CoolFireX (button) collected ($7.12)
Seat 6: matiko09 (small blind) folded before Flop
Seat 7: The Big Ape (big blind) folded before Flop
Seat 8: Troll8989 folded before Flop (didn't bet)
Seat 9: mbk88 folded before Flop (didn't bet)





PokerStars Hand #155013239154:  Hold'em No Limit (€0.25/€0.50 EUR) - 2016/06/21 13:23:06 CET [2016/06/21 7:23:06 ET]
Table 'Actor II' 6-max Seat #1 is the button
Seat 1: hmverlin (€92.19 in chips) 
Seat 2: alôha (€50 in chips) 
Seat 3: asmodej666 (€89.06 in chips) 
Seat 4: matiko09 (€50 in chips) 
Seat 5: Rybka1294 (€57.61 in chips) 
Seat 6: fanmtZ (€22.11 in chips) 
alôha: posts small blind €0.25
asmodej666: posts big blind €0.50
*** HOLE CARDS ***
Dealt to matiko09 [2c Ah]
matiko09: folds 
Rybka1294: folds 
fanmtZ: folds 
hmverlin: raises €1 to €1.50
alôha: folds 
asmodej666: folds 
Uncalled bet (€1) returned to hmverlin
hmverlin collected €1.25 from pot
hmverlin: doesn't show hand 
*** SUMMARY ***
Total pot €1.25 | Rake €0 
Seat 1: hmverlin (button) collected (€1.25)
Seat 2: alôha (small blind) folded before Flop
Seat 3: asmodej666 (big blind) folded before Flop
Seat 4: matiko09 folded before Flop (didn't bet)
Seat 5: Rybka1294 folded before Flop (didn't bet)
Seat 6: fanmtZ folded before Flop (didn't bet)





PokerStars Hand #155013240754:  Hold'em No Limit ($0.50/$1.00 USD) - 2016/06/21 13:23:09 CET [2016/06/21 7:23:09 ET]
Table 'Lamberta II' 9-max Seat #5 is the button
Seat 2: mavin80 ($97.82 in chips) 
Seat 3: matiko09 ($100 in chips) 
Seat 4: Eskimo Fox ($119.41 in chips) 
Seat 5: mi$$I$Elena ($101.50 in chips) 
Seat 7: phil_cheng ($100 in chips) 
Seat 8: Troll8989 ($100 in chips) 
Seat 9: Sjtu_Michael ($108.94 in chips) 
Chen423 will be allowed to play after the button
phil_cheng: posts small blind $0.50
Troll8989: posts big blind $1
mbk88: sits out 
*** HOLE CARDS ***
Dealt to matiko09 [Ks Jd]
Sjtu_Michael: folds 
mavin80: folds 
matiko09: raises $2 to $3
Eskimo Fox: folds 
mi$$I$Elena: folds 
phil_cheng: folds 
Troll8989: folds 
Uncalled bet ($2) returned to matiko09
matiko09 collected $2.50 from pot
matiko09: doesn't show hand 
*** SUMMARY ***
Total pot $2.50 | Rake $0 
Seat 2: mavin80 folded before Flop (didn't bet)
Seat 3: matiko09 collected ($2.50)
Seat 4: Eskimo Fox folded before Flop (didn't bet)
Seat 5: mi$$I$Elena (button) folded before Flop (didn't bet)
Seat 7: phil_cheng (small blind) folded before Flop
Seat 8: Troll8989 (big blind) folded before Flop
Seat 9: Sjtu_Michael folded before Flop (didn't bet)





PokerStars Hand #155013240410:  Hold'em No Limit ($0.50/$1.00 USD) - 2016/06/21 13:23:09 CET [2016/06/21 7:23:09 ET]
Table 'Saldanha' 9-max Seat #4 is the button
Seat 1: phil_cheng ($100 in chips) 
Seat 2: matiko09 ($381.40 in chips) 
Seat 4: CoolFireX ($100 in chips) 
Seat 5: Michael Quan ($97.20 in chips) 
Seat 7: ozone2003 ($100 in chips) 
Seat 9: maxxmeister ($129.05 in chips) 
Michael Quan: posts small blind $0.50
SharingaaN: is sitting out 
ozone2003: posts big blind $1
erick222: sits out 
wisbc: sits out 
phil_cheng: posts the ante $0.20
matiko09: posts the ante $0.20
CoolFireX: posts the ante $0.20
Michael Quan: posts the ante $0.20
ozone2003: posts the ante $0.20
maxxmeister: posts the ante $0.20
*** HOLE CARDS ***
Dealt to matiko09 [4s Js]
maxxmeister: raises $2.50 to $3.50
phil_cheng: folds 
matiko09: folds 
CoolFireX: calls $3.50
Michael Quan: raises $12.70 to $16.20
ozone2003: folds 
maxxmeister: folds 
CoolFireX: folds 
Uncalled bet ($12.70) returned to Michael Quan
Michael Quan collected $12.70 from pot
*** SUMMARY ***
Total pot $12.70 | Rake $0 
Seat 1: phil_cheng folded before Flop (didn't bet)
Seat 2: matiko09 folded before Flop (didn't bet)
Seat 4: CoolFireX (button) folded before Flop
Seat 5: Michael Quan (small blind) collected ($12.70)
Seat 7: ozone2003 (big blind) folded before Flop
Seat 9: maxxmeister folded before Flop





PokerStars Hand #155013242093:  Hold'em No Limit ($0.50/$1.00 USD) - 2016/06/21 13:23:13 CET [2016/06/21 7:23:13 ET]
Table 'Admete II' 9-max Seat #8 is the button
Seat 1: xxxxusedomer ($57.34 in chips) 
Seat 2: Eskimo Fox ($104.50 in chips) 
Seat 4: krustophsky ($92.78 in chips) 
Seat 5: ramzes160468 ($68.42 in chips) 
Seat 6: mbk88 ($128.50 in chips) 
Seat 7: matiko09 ($100 in chips) 
Seat 8: koutani7 ($93.50 in chips) 
Seat 9: ozone2003 ($100 in chips) 
ozone2003: posts small blind $0.50
xxxxusedomer: posts big blind $1
*** HOLE CARDS ***
Dealt to matiko09 [Qs 4d]
Eskimo Fox: raises $2 to $3
krustophsky: calls $3
ramzes160468: folds 
mbk88: folds 
matiko09: folds 
koutani7: folds 
ozone2003: raises $9 to $12
xxxxusedomer: folds 
Eskimo Fox: folds 
krustophsky: raises $28 to $40
ozone2003: folds 
Uncalled bet ($28) returned to krustophsky
krustophsky collected $28 from pot
krustophsky: doesn't show hand 
*** SUMMARY ***
Total pot $28 | Rake $0 
Seat 1: xxxxusedomer (big blind) folded before Flop
Seat 2: Eskimo Fox folded before Flop
Seat 4: krustophsky collected ($28)
Seat 5: ramzes160468 folded before Flop (didn't bet)
Seat 6: mbk88 folded before Flop (didn't bet)
Seat 7: matiko09 folded before Flop (didn't bet)
Seat 8: koutani7 (button) folded before Flop (didn't bet)
Seat 9: ozone2003 (small blind) folded before Flop





PokerStars Hand #155013242664:  Hold'em No Limit ($0.50/$1.00 USD) - 2016/06/21 13:23:14 CET [2016/06/21 7:23:14 ET]
Table 'Moreau' 9-max Seat #8 is the button
Seat 1: ozone2003 ($132.49 in chips) 
Seat 3: matiko09 ($118.38 in chips) 
Seat 4: SharingaaN ($101 in chips) 
Seat 5: DIMAN_324 ($100 in chips) 
Seat 7: PanKwn15 ($93.86 in chips) 
Seat 8: maxxmeister ($100 in chips) 
ozone2003: posts small blind $0.50
nubpoker: is sitting out 
matiko09: posts big blind $1
*** HOLE CARDS ***
Dealt to matiko09 [2h 8h]
nubpoker leaves the table
SharingaaN: folds 
DIMAN_324: folds 
PanKwn15: raises $2 to $3
maxxmeister: raises $7.50 to $10.50
ozone2003: folds 
matiko09: folds 
PanKwn15: folds 
Uncalled bet ($7.50) returned to maxxmeister
maxxmeister collected $7.50 from pot
maxxmeister: doesn't show hand 
mbk88 leaves the table
*** SUMMARY ***
Total pot $7.50 | Rake $0 
Seat 1: ozone2003 (small blind) folded before Flop
Seat 3: matiko09 (big blind) folded before Flop
Seat 4: SharingaaN folded before Flop (didn't bet)
Seat 5: DIMAN_324 folded before Flop (didn't bet)
Seat 7: PanKwn15 folded before Flop
Seat 8: maxxmeister (button) collected ($7.50)





PokerStars Hand #155013249593:  Hold'em No Limit (€0.25/€0.50 EUR) - 2016/06/21 13:23:31 CET [2016/06/21 7:23:31 ET]
Table 'Actor II' 6-max Seat #2 is the button
Seat 1: hmverlin (€92.94 in chips) 
Seat 2: alôha (€50 in chips) 
Seat 3: asmodej666 (€88.56 in chips) 
Seat 4: matiko09 (€50 in chips) 
Seat 5: Rybka1294 (€57.61 in chips) 
Seat 6: fanmtZ (€22.11 in chips) 
asmodej666: posts small blind €0.25
matiko09: posts big blind €0.50
*** HOLE CARDS ***
Dealt to matiko09 [Js 9h]
Rybka1294: folds 
fanmtZ: folds 
hmverlin: folds 
alôha: raises €0.50 to €1
asmodej666: raises €3 to €4
matiko09: folds 
alôha: calls €3
*** FLOP *** [Qh 9s Jh]
asmodej666: checks 
alôha: checks 
*** TURN *** [Qh 9s Jh] [4d]
asmodej666: bets €5
alôha: calls €5
*** RIVER *** [Qh 9s Jh 4d] [Jd]
asmodej666: checks 
alôha: checks 
*** SHOW DOWN ***
asmodej666: shows [6s 5s] (a pair of Jacks)
alôha: shows [Ah Kh] (a pair of Jacks - Ace kicker)
alôha collected €17.58 from pot
*** SUMMARY ***
Total pot €18.50 | Rake €0.92 
Board [Qh 9s Jh 4d Jd]
Seat 1: hmverlin folded before Flop (didn't bet)
Seat 2: alôha (button) showed [Ah Kh] and won (€17.58) with a pair of Jacks
Seat 3: asmodej666 (small blind) showed [6s 5s] and lost with a pair of Jacks
Seat 4: matiko09 (big blind) folded before Flop
Seat 5: Rybka1294 folded before Flop (didn't bet)
Seat 6: fanmtZ folded before Flop (didn't bet)





PokerStars Hand #155013249924:  Hold'em No Limit ($0.50/$1.00 USD) - 2016/06/21 13:23:31 CET [2016/06/21 7:23:31 ET]
Table 'Moreau' 9-max Seat #1 is the button
Seat 1: ozone2003 ($131.99 in chips) 
Seat 3: matiko09 ($117.38 in chips) 
Seat 4: SharingaaN ($101 in chips) 
Seat 5: DIMAN_324 ($100 in chips) 
Seat 7: PanKwn15 ($90.86 in chips) 
Seat 8: maxxmeister ($104.50 in chips) 
matiko09: posts small blind $0.50
SharingaaN: posts big blind $1
*** HOLE CARDS ***
Dealt to matiko09 [5d 7d]
Troll8989 joins the table at seat #6 
DIMAN_324: raises $2 to $3
PanKwn15: calls $3
maxxmeister: folds 
ozone2003: folds 
matiko09: folds 
SharingaaN: folds 
*** FLOP *** [Ah 8s 6s]
DIMAN_324: checks 
PanKwn15: bets $7.12
DIMAN_324: calls $7.12
*** TURN *** [Ah 8s 6s] [Kh]
DIMAN_324: checks 
PanKwn15: bets $20.65
DIMAN_324: folds 
Uncalled bet ($20.65) returned to PanKwn15
PanKwn15 collected $20.65 from pot
PanKwn15: doesn't show hand 
*** SUMMARY ***
Total pot $21.74 | Rake $1.09 
Board [Ah 8s 6s Kh]
Seat 1: ozone2003 (button) folded before Flop (didn't bet)
Seat 3: matiko09 (small blind) folded before Flop
Seat 4: SharingaaN (big blind) folded before Flop
Seat 5: DIMAN_324 folded on the Turn
Seat 7: PanKwn15 collected ($20.65)
Seat 8: maxxmeister folded before Flop (didn't bet)





PokerStars Hand #155013250773:  Hold'em No Limit ($0.50/$1.00 USD) - 2016/06/21 13:23:33 CET [2016/06/21 7:23:33 ET]
Table 'Carlova II' 9-max Seat #8 is the button
Seat 1: matiko09 ($111.30 in chips) 
Seat 3: King_Z�Manel ($109.05 in chips) 
Seat 4: Dandy Monk ($63.41 in chips) 
Seat 5: ozone2003 ($109.18 in chips) 
Seat 7: mi$$I$Elena ($123.75 in chips) 
Seat 8: pyromid ($105.10 in chips) 
Seat 9: Troll8989 ($101.18 in chips) 
Troll8989: posts small blind $0.50
matiko09: posts big blind $1
mbk88: sits out 
phil_cheng: sits out 
*** HOLE CARDS ***
Dealt to matiko09 [4s Kh]
King_Z�Manel: raises $1 to $2
Dandy Monk: folds 
ozone2003: folds 
mi$$I$Elena: folds 
pyromid: folds 
Troll8989: folds 
matiko09: folds 
Uncalled bet ($1) returned to King_Z�Manel
King_Z�Manel collected $2.50 from pot
King_Z�Manel: doesn't show hand 
*** SUMMARY ***
Total pot $2.50 | Rake $0 
Seat 1: matiko09 (big blind) folded before Flop
Seat 3: King_Z�Manel collected ($2.50)
Seat 4: Dandy Monk folded before Flop (didn't bet)
Seat 5: ozone2003 folded before Flop (didn't bet)
Seat 7: mi$$I$Elena folded before Flop (didn't bet)
Seat 8: pyromid (button) folded before Flop (didn't bet)
Seat 9: Troll8989 (small blind) folded before Flop





PokerStars Hand #155013254371:  Hold'em No Limit ($0.50/$1.00 USD) - 2016/06/21 13:23:42 CET [2016/06/21 7:23:42 ET]
Table 'Lamberta II' 9-max Seat #7 is the button
Seat 2: mavin80 ($97.82 in chips) 
Seat 3: matiko09 ($101.50 in chips) 
Seat 4: Eskimo Fox ($119.41 in chips) 
Seat 5: mi$$I$Elena ($101.50 in chips) 
Seat 7: phil_cheng ($100 in chips) 
Seat 8: Troll8989 ($100 in chips) 
Seat 9: Sjtu_Michael ($108.94 in chips) 
Troll8989: posts small blind $0.50
Sjtu_Michael: posts big blind $1
mbk88: sits out 
Chen423: sits out 
*** HOLE CARDS ***
Dealt to matiko09 [Js 5s]
mavin80: folds 
matiko09: folds 
Eskimo Fox: folds 
mi$$I$Elena: folds 
phil_cheng: raises $2 to $3
Troll8989: folds 
Sjtu_Michael: folds 
Uncalled bet ($2) returned to phil_cheng
phil_cheng collected $2.50 from pot
*** SUMMARY ***
Total pot $2.50 | Rake $0 
Seat 2: mavin80 folded before Flop (didn't bet)
Seat 3: matiko09 folded before Flop (didn't bet)
Seat 4: Eskimo Fox folded before Flop (didn't bet)
Seat 5: mi$$I$Elena folded before Flop (didn't bet)
Seat 7: phil_cheng (button) collected ($2.50)
Seat 8: Troll8989 (small blind) folded before Flop
Seat 9: Sjtu_Michael (big blind) folded before Flop





PokerStars Hand #155013254882:  Hold'em No Limit ($0.50/$1.00 USD) - 2016/06/21 13:23:43 CET [2016/06/21 7:23:43 ET]
Table 'Leo' 9-max Seat #4 is the button
Seat 1: fukumimi ($108.04 in chips) 
Seat 2: torkkdnm ($170.16 in chips) 
Seat 3: matiko09 ($100 in chips) 
Seat 4: phil_cheng ($100 in chips) 
Seat 5: Troll8989 ($102.52 in chips) 
Seat 6: Avtovo ($100 in chips) 
Seat 7: maxxmeister ($100 in chips) 
Seat 8: pyromid ($92.42 in chips) 
Seat 9: Wladimir205 ($116.54 in chips) 
Troll8989: posts small blind $0.50
Avtovo: posts big blind $1
*** HOLE CARDS ***
Dealt to matiko09 [8h 2c]
maxxmeister: raises $2.50 to $3.50
pyromid: folds 
Wladimir205: folds 
fukumimi: folds 
torkkdnm: folds 
matiko09: folds 
phil_cheng: folds 
Troll8989: folds 
Avtovo: calls $2.50
*** FLOP *** [6c 4c 8s]
Avtovo: checks 
maxxmeister: bets $5.02
Avtovo: folds 
Uncalled bet ($5.02) returned to maxxmeister
maxxmeister collected $7.12 from pot
maxxmeister: doesn't show hand 
*** SUMMARY ***
Total pot $7.50 | Rake $0.38 
Board [6c 4c 8s]
Seat 1: fukumimi folded before Flop (didn't bet)
Seat 2: torkkdnm folded before Flop (didn't bet)
Seat 3: matiko09 folded before Flop (didn't bet)
Seat 4: phil_cheng (button) folded before Flop (didn't bet)
Seat 5: Troll8989 (small blind) folded before Flop
Seat 6: Avtovo (big blind) folded on the Flop
Seat 7: maxxmeister collected ($7.12)
Seat 8: pyromid folded before Flop (didn't bet)
Seat 9: Wladimir205 folded before Flop (didn't bet)





PokerStars Hand #155013257029:  Hold'em No Limit (€0.25/€0.50 EUR) - 2016/06/21 13:23:48 CET [2016/06/21 7:23:48 ET]
Table 'Lotis II' 6-max Seat #6 is the button
Seat 1: tyoma_knp (€50 in chips) 
Seat 4: matiko09 (€92.18 in chips) 
Seat 5: AlexPles (€70.19 in chips) 
Seat 6: torkkdnm (€57.78 in chips) 
tyoma_knp: posts small blind €0.25
matiko09: posts big blind €0.50
*** HOLE CARDS ***
Dealt to matiko09 [2d 2h]
AlexPles: folds 
AlexPles leaves the table
torkkdnm: raises €0.50 to €1
tyoma_knp has timed out
tyoma_knp: folds 
matiko09: calls €0.50
*** FLOP *** [5c 4s 2s]
matiko09: checks 
torkkdnm: bets €1.50
matiko09: raises €3 to €4.50
torkkdnm: calls €3
*** TURN *** [5c 4s 2s] [7c]
matiko09: bets €10.50
torkkdnm: calls €10.50
*** RIVER *** [5c 4s 2s 7c] [Kd]
tyoma_knp leaves the table
matiko09: checks 
torkkdnm: checks 
*** SHOW DOWN ***
matiko09: shows [2d 2h] (three of a kind, Deuces)
torkkdnm: mucks hand 
matiko09 collected €31.55 from pot
*** SUMMARY ***
Total pot €32.25 | Rake €0.70 
Board [5c 4s 2s 7c Kd]
Seat 1: tyoma_knp (small blind) folded before Flop
Seat 4: matiko09 (big blind) showed [2d 2h] and won (€31.55) with three of a kind, Deuces
Seat 5: AlexPles folded before Flop (didn't bet)
Seat 6: torkkdnm (button) mucked [Jh 5h]





PokerStars Hand #155013258851:  Hold'em No Limit ($0.50/$1.00 USD) - 2016/06/21 13:23:52 CET [2016/06/21 7:23:52 ET]
Table 'Cheleb' 9-max Seat #6 is the button
Seat 1: SharingaaN ($161.99 in chips) 
Seat 2: pyromid ($137.60 in chips) 
Seat 3: phil_cheng ($114.98 in chips) 
Seat 4: CoolFireX ($171.17 in chips) 
Seat 6: matiko09 ($100 in chips) 
Seat 7: The Big Ape ($98.50 in chips) 
Seat 8: Troll8989 ($100 in chips) 
Seat 9: mbk88 ($100 in chips) 
The Big Ape: posts small blind $0.50
Troll8989: posts big blind $1
Avtovo: sits out 
*** HOLE CARDS ***
Dealt to matiko09 [5d Tc]
mbk88: folds 
SharingaaN: folds 
pyromid: folds 
phil_cheng: folds 
CoolFireX: folds 
matiko09: folds 
The Big Ape: folds 
Uncalled bet ($0.50) returned to Troll8989
Troll8989 collected $1 from pot
Troll8989: doesn't show hand 
*** SUMMARY ***
Total pot $1 | Rake $0 
Seat 1: SharingaaN folded before Flop (didn't bet)
Seat 2: pyromid folded before Flop (didn't bet)
Seat 3: phil_cheng folded before Flop (didn't bet)
Seat 4: CoolFireX folded before Flop (didn't bet)
Seat 6: matiko09 (button) folded before Flop (didn't bet)
Seat 7: The Big Ape (small blind) folded before Flop
Seat 8: Troll8989 (big blind) collected ($1)
Seat 9: mbk88 folded before Flop (didn't bet)





PokerStars Hand #155013260075:  Hold'em No Limit ($0.50/$1.00 USD) - 2016/06/21 13:23:55 CET [2016/06/21 7:23:55 ET]
Table 'Saldanha' 9-max Seat #5 is the button
Seat 1: phil_cheng ($100 in chips) 
Seat 2: matiko09 ($381.20 in chips) 
Seat 4: CoolFireX ($100 in chips) 
Seat 5: Michael Quan ($106.20 in chips) 
Seat 7: ozone2003 ($100 in chips) 
Seat 8: erick222 ($100 in chips) 
Seat 9: maxxmeister ($125.35 in chips) 
ozone2003: posts small blind $0.50
erick222: posts big blind $1
wisbc: sits out 
phil_cheng: posts the ante $0.20
matiko09: posts the ante $0.20
CoolFireX: posts the ante $0.20
Michael Quan: posts the ante $0.20
ozone2003: posts the ante $0.20
erick222: posts the ante $0.20
maxxmeister: posts the ante $0.20
*** HOLE CARDS ***
Dealt to matiko09 [9c 8c]
SharingaaN leaves the table
maxxmeister: folds 
maxxmeister leaves the table
KovIFish89 joins the table at seat #9 
Donetsk1y joins the table at seat #6 
phil_cheng: folds 
matiko09: raises $2 to $3
CoolFireX: folds 
Michael Quan: folds 
ozone2003: folds 
erick222: folds 
Uncalled bet ($2) returned to matiko09
matiko09 collected $3.90 from pot
matiko09: doesn't show hand 
*** SUMMARY ***
Total pot $3.90 | Rake $0 
Seat 1: phil_cheng folded before Flop (didn't bet)
Seat 2: matiko09 collected ($3.90)
Seat 4: CoolFireX folded before Flop (didn't bet)
Seat 5: Michael Quan (button) folded before Flop (didn't bet)
Seat 7: ozone2003 (small blind) folded before Flop
Seat 8: erick222 (big blind) folded before Flop
Seat 9: maxxmeister folded before Flop (didn't bet)





PokerStars Hand #155013261981:  Hold'em No Limit ($0.50/$1.00 USD) - 2016/06/21 13:24:00 CET [2016/06/21 7:24:00 ET]
Table 'Rupertwildt' 9-max Seat #8 is the button
Seat 2: SharingaaN ($77.05 in chips) 
Seat 3: Troll8989 ($100 in chips) 
Seat 4: matiko09 ($146.18 in chips) 
Seat 5: pyromid ($91.50 in chips) 
Seat 6: ozone2003 ($163.16 in chips) 
Seat 7: Avtovo ($100 in chips) 
Seat 8: Gonzanary ($121.29 in chips) 
Seat 9: mbk88 ($105.43 in chips) 
mbk88: posts small blind $0.50
SharingaaN: posts big blind $1
*** HOLE CARDS ***
Dealt to matiko09 [3c 7s]
Troll8989: folds 
matiko09: folds 
pyromid: raises $1.50 to $2.50
ozone2003: folds 
Avtovo: folds 
Gonzanary: folds 
mbk88: folds 
SharingaaN: folds 
Uncalled bet ($1.50) returned to pyromid
pyromid collected $2.50 from pot
pyromid: doesn't show hand 
*** SUMMARY ***
Total pot $2.50 | Rake $0 
Seat 2: SharingaaN (big blind) folded before Flop
Seat 3: Troll8989 folded before Flop (didn't bet)
Seat 4: matiko09 folded before Flop (didn't bet)
Seat 5: pyromid collected ($2.50)
Seat 6: ozone2003 folded before Flop (didn't bet)
Seat 7: Avtovo folded before Flop (didn't bet)
Seat 8: Gonzanary (button) folded before Flop (didn't bet)
Seat 9: mbk88 (small blind) folded before Flop





PokerStars Hand #155013264686:  Hold'em No Limit ($0.50/$1.00 USD) - 2016/06/21 13:24:06 CET [2016/06/21 7:24:06 ET]
Table 'Moreau' 9-max Seat #3 is the button
Seat 1: ozone2003 ($131.99 in chips) 
Seat 3: matiko09 ($116.88 in chips) 
Seat 4: SharingaaN ($100 in chips) 
Seat 6: Troll8989 ($100 in chips) 
Seat 7: PanKwn15 ($101.39 in chips) 
Seat 8: maxxmeister ($104.50 in chips) 
SharingaaN: posts small blind $0.50
DIMAN_324: is sitting out 
Troll8989: posts big blind $1
*** HOLE CARDS ***
Dealt to matiko09 [3c Qc]
PanKwn15: folds 
maxxmeister: folds 
ozone2003: folds 
Avtovo joins the table at seat #2 
matiko09: folds 
SharingaaN: folds 
Uncalled bet ($0.50) returned to Troll8989
Troll8989 collected $1 from pot
Troll8989: doesn't show hand 
*** SUMMARY ***
Total pot $1 | Rake $0 
Seat 1: ozone2003 folded before Flop (didn't bet)
Seat 3: matiko09 (button) folded before Flop (didn't bet)
Seat 4: SharingaaN (small blind) folded before Flop
Seat 6: Troll8989 (big blind) collected ($1)
Seat 7: PanKwn15 folded before Flop (didn't bet)
Seat 8: maxxmeister folded before Flop (didn't bet)





PokerStars Hand #155013266347:  Hold'em No Limit ($0.50/$1.00 USD) - 2016/06/21 13:24:10 CET [2016/06/21 7:24:10 ET]
Table 'Carlova II' 9-max Seat #9 is the button
Seat 1: matiko09 ($110.30 in chips) 
Seat 2: mbk88 ($133.15 in chips) 
Seat 3: King_Z�Manel ($110.55 in chips) 
Seat 4: Dandy Monk ($63.41 in chips) 
Seat 5: ozone2003 ($109.18 in chips) 
Seat 7: mi$$I$Elena ($123.75 in chips) 
Seat 8: pyromid ($105.10 in chips) 
Seat 9: Troll8989 ($100.68 in chips) 
matiko09: posts small blind $0.50
mbk88: posts big blind $1
phil_cheng: sits out 
*** HOLE CARDS ***
Dealt to matiko09 [2s Td]
King_Z�Manel: raises $2 to $3
Dandy Monk: folds 
ozone2003: folds 
mi$$I$Elena: folds 
pyromid: folds 
Troll8989: folds 
matiko09: folds 
mbk88: folds 
Uncalled bet ($2) returned to King_Z�Manel
King_Z�Manel collected $2.50 from pot
King_Z�Manel: doesn't show hand 
*** SUMMARY ***
Total pot $2.50 | Rake $0 
Seat 1: matiko09 (small blind) folded before Flop
Seat 2: mbk88 (big blind) folded before Flop
Seat 3: King_Z�Manel collected ($2.50)
Seat 4: Dandy Monk folded before Flop (didn't bet)
Seat 5: ozone2003 folded before Flop (didn't bet)
Seat 7: mi$$I$Elena folded before Flop (didn't bet)
Seat 8: pyromid folded before Flop (didn't bet)
Seat 9: Troll8989 (button) folded before Flop (didn't bet)





PokerStars Hand #155013267682:  Hold'em No Limit ($0.50/$1.00 USD) - 2016/06/21 13:24:13 CET [2016/06/21 7:24:13 ET]
Table 'Cheleb' 9-max Seat #7 is the button
Seat 1: SharingaaN ($161.99 in chips) 
Seat 2: pyromid ($137.60 in chips) 
Seat 3: phil_cheng ($114.98 in chips) 
Seat 4: CoolFireX ($171.17 in chips) 
Seat 6: matiko09 ($100 in chips) 
Seat 7: The Big Ape ($98 in chips) 
Seat 8: Troll8989 ($100.50 in chips) 
Seat 9: mbk88 ($100 in chips) 
Troll8989: posts small blind $0.50
mbk88: posts big blind $1
Avtovo: sits out 
*** HOLE CARDS ***
Dealt to matiko09 [Td 9s]
SharingaaN: folds 
pyromid: raises $1.50 to $2.50
phil_cheng: folds 
CoolFireX: folds 
matiko09: folds 
The Big Ape: folds 
Troll8989: calls $2
mbk88: folds 
*** FLOP *** [4d Jh Qc]
Troll8989: checks 
pyromid: bets $3
Troll8989: calls $3
*** TURN *** [4d Jh Qc] [6s]
Troll8989: checks 
pyromid: checks 
*** RIVER *** [4d Jh Qc 6s] [5c]
Troll8989: checks 
pyromid: bets $3
Troll8989: folds 
Uncalled bet ($3) returned to pyromid
pyromid collected $11.40 from pot
pyromid: doesn't show hand 
*** SUMMARY ***
Total pot $12 | Rake $0.60 
Board [4d Jh Qc 6s 5c]
Seat 1: SharingaaN folded before Flop (didn't bet)
Seat 2: pyromid collected ($11.40)
Seat 3: phil_cheng folded before Flop (didn't bet)
Seat 4: CoolFireX folded before Flop (didn't bet)
Seat 6: matiko09 folded before Flop (didn't bet)
Seat 7: The Big Ape (button) folded before Flop (didn't bet)
Seat 8: Troll8989 (small blind) folded on the River
Seat 9: mbk88 (big blind) folded before Flop





PokerStars Hand #155013272085:  Hold'em No Limit ($0.50/$1.00 USD) - 2016/06/21 13:24:24 CET [2016/06/21 7:24:24 ET]
Table 'Moreau' 9-max Seat #4 is the button
Seat 1: ozone2003 ($131.99 in chips) 
Seat 3: matiko09 ($116.88 in chips) 
Seat 4: SharingaaN ($99.50 in chips) 
Seat 6: Troll8989 ($100.50 in chips) 
Seat 7: PanKwn15 ($101.39 in chips) 
Seat 8: maxxmeister ($104.50 in chips) 
Troll8989: posts small blind $0.50
PanKwn15: posts big blind $1
Avtovo: sits out 
*** HOLE CARDS ***
Dealt to matiko09 [8d Js]
maxxmeister: folds 
ozone2003: folds 
matiko09: folds 
SharingaaN: folds 
Troll8989: folds 
Uncalled bet ($0.50) returned to PanKwn15
PanKwn15 collected $1 from pot
PanKwn15: doesn't show hand 
*** SUMMARY ***
Total pot $1 | Rake $0 
Seat 1: ozone2003 folded before Flop (didn't bet)
Seat 3: matiko09 folded before Flop (didn't bet)
Seat 4: SharingaaN (button) folded before Flop (didn't bet)
Seat 6: Troll8989 (small blind) folded before Flop
Seat 7: PanKwn15 (big blind) collected ($1)
Seat 8: maxxmeister folded before Flop (didn't bet)





PokerStars Hand #155013272946:  Hold'em No Limit ($0.50/$1.00 USD) - 2016/06/21 13:24:26 CET [2016/06/21 7:24:26 ET]
Table 'Lamberta II' 9-max Seat #8 is the button
Seat 1: mbk88 ($100 in chips) 
Seat 2: mavin80 ($97.82 in chips) 
Seat 3: matiko09 ($101.50 in chips) 
Seat 4: Eskimo Fox ($119.41 in chips) 
Seat 5: mi$$I$Elena ($101.50 in chips) 
Seat 7: phil_cheng ($101.50 in chips) 
Seat 8: Troll8989 ($100 in chips) 
Seat 9: Sjtu_Michael ($107.94 in chips) 
Sjtu_Michael: posts small blind $0.50
mbk88: posts big blind $1
Chen423: sits out 
*** HOLE CARDS ***
Dealt to matiko09 [Qd Js]
mavin80: folds 
matiko09: folds 
Eskimo Fox: folds 
mi$$I$Elena: folds 
phil_cheng: folds 
Troll8989: folds 
Sjtu_Michael: folds 
Uncalled bet ($0.50) returned to mbk88
mbk88 collected $1 from pot
mbk88: doesn't show hand 
*** SUMMARY ***
Total pot $1 | Rake $0 
Seat 1: mbk88 (big blind) collected ($1)
Seat 2: mavin80 folded before Flop (didn't bet)
Seat 3: matiko09 folded before Flop (didn't bet)
Seat 4: Eskimo Fox folded before Flop (didn't bet)
Seat 5: mi$$I$Elena folded before Flop (didn't bet)
Seat 7: phil_cheng folded before Flop (didn't bet)
Seat 8: Troll8989 (button) folded before Flop (didn't bet)
Seat 9: Sjtu_Michael (small blind) folded before Flop





PokerStars Hand #155013277442:  Hold'em No Limit ($0.50/$1.00 USD) - 2016/06/21 13:24:37 CET [2016/06/21 7:24:37 ET]
Table 'Rupertwildt' 9-max Seat #9 is the button
Seat 2: SharingaaN ($76.05 in chips) 
Seat 3: Troll8989 ($100 in chips) 
Seat 4: matiko09 ($146.18 in chips) 
Seat 5: pyromid ($93 in chips) 
Seat 6: ozone2003 ($163.16 in chips) 
Seat 7: Avtovo ($100 in chips) 
Seat 8: Gonzanary ($121.29 in chips) 
Seat 9: mbk88 ($104.93 in chips) 
SharingaaN: posts small blind $0.50
Troll8989: posts big blind $1
*** HOLE CARDS ***
Dealt to matiko09 [Jh 5c]
matiko09: folds 
pyromid: folds 
ozone2003: folds 
Avtovo: folds 
Gonzanary: raises $2 to $3
mbk88: folds 
SharingaaN: folds 
Troll8989: folds 
Uncalled bet ($2) returned to Gonzanary
Gonzanary collected $2.50 from pot
*** SUMMARY ***
Total pot $2.50 | Rake $0 
Seat 2: SharingaaN (small blind) folded before Flop
Seat 3: Troll8989 (big blind) folded before Flop
Seat 4: matiko09 folded before Flop (didn't bet)
Seat 5: pyromid folded before Flop (didn't bet)
Seat 6: ozone2003 folded before Flop (didn't bet)
Seat 7: Avtovo folded before Flop (didn't bet)
Seat 8: Gonzanary collected ($2.50)
Seat 9: mbk88 (button) folded before Flop (didn't bet)





PokerStars Hand #155013279414:  Hold'em No Limit ($0.50/$1.00 USD) - 2016/06/21 13:24:41 CET [2016/06/21 7:24:41 ET]
Table 'Moreau' 9-max Seat #6 is the button
Seat 1: ozone2003 ($131.99 in chips) 
Seat 3: matiko09 ($116.88 in chips) 
Seat 4: SharingaaN ($99.50 in chips) 
Seat 6: Troll8989 ($100 in chips) 
Seat 7: PanKwn15 ($101.89 in chips) 
Seat 8: maxxmeister ($104.50 in chips) 
PanKwn15: posts small blind $0.50
maxxmeister: posts big blind $1
Avtovo: sits out 
*** HOLE CARDS ***
Dealt to matiko09 [Ah Qh]
DIMAN_324 is disconnected 
ozone2003: folds 
matiko09: raises $2 to $3
SharingaaN: folds 
Troll8989: folds 
PanKwn15: folds 
maxxmeister: folds 
Uncalled bet ($2) returned to matiko09
matiko09 collected $2.50 from pot
matiko09: doesn't show hand 
*** SUMMARY ***
Total pot $2.50 | Rake $0 
Seat 1: ozone2003 folded before Flop (didn't bet)
Seat 3: matiko09 collected ($2.50)
Seat 4: SharingaaN folded before Flop (didn't bet)
Seat 6: Troll8989 (button) folded before Flop (didn't bet)
Seat 7: PanKwn15 (small blind) folded before Flop
Seat 8: maxxmeister (big blind) folded before Flop





PokerStars Hand #155013279836:  Hold'em No Limit ($0.50/$1.00 USD) - 2016/06/21 13:24:42 CET [2016/06/21 7:24:42 ET]
Table 'Carlova II' 9-max Seat #1 is the button
Seat 1: matiko09 ($109.80 in chips) 
Seat 2: mbk88 ($132.15 in chips) 
Seat 4: Dandy Monk ($63.41 in chips) 
Seat 5: ozone2003 ($109.18 in chips) 
Seat 7: mi$$I$Elena ($123.75 in chips) 
Seat 8: pyromid ($105.10 in chips) 
Seat 9: Troll8989 ($100.68 in chips) 
mbk88: posts small blind $0.50
King_Z�Manel: is sitting out 
Dandy Monk: posts big blind $1
phil_cheng: sits out 
*** HOLE CARDS ***
Dealt to matiko09 [8c 9s]
ozone2003: folds 
mi$$I$Elena: folds 
King_Z�Manel leaves the table
pyromid: folds 
Troll8989: folds 
SharingaaN joins the table at seat #3 
matiko09: folds 
mbk88: folds 
Uncalled bet ($0.50) returned to Dandy Monk
Dandy Monk collected $1 from pot
Dandy Monk: doesn't show hand 
*** SUMMARY ***
Total pot $1 | Rake $0 
Seat 1: matiko09 (button) folded before Flop (didn't bet)
Seat 2: mbk88 (small blind) folded before Flop
Seat 4: Dandy Monk (big blind) collected ($1)
Seat 5: ozone2003 folded before Flop (didn't bet)
Seat 7: mi$$I$Elena folded before Flop (didn't bet)
Seat 8: pyromid folded before Flop (didn't bet)
Seat 9: Troll8989 folded before Flop (didn't bet)





PokerStars Hand #155013280569:  Hold'em No Limit ($0.50/$1.00 USD) - 2016/06/21 13:24:44 CET [2016/06/21 7:24:44 ET]
Table 'Saldanha' 9-max Seat #7 is the button
Seat 1: phil_cheng ($100 in chips) 
Seat 2: matiko09 ($383.90 in chips) 
Seat 4: CoolFireX ($100 in chips) 
Seat 5: Michael Quan ($106 in chips) 
Seat 7: ozone2003 ($100 in chips) 
Seat 8: erick222 ($100 in chips) 
Seat 9: KovIFish89 ($100 in chips) 
erick222: posts small blind $0.50
KovIFish89: posts big blind $1
wisbc: sits out 
Donetsk1y: sits out 
phil_cheng: posts the ante $0.20
matiko09: posts the ante $0.20
CoolFireX: posts the ante $0.20
Michael Quan: posts the ante $0.20
ozone2003: posts the ante $0.20
erick222: posts the ante $0.20
KovIFish89: posts the ante $0.20
*** HOLE CARDS ***
Dealt to matiko09 [3s 2c]
phil_cheng: folds 
matiko09: folds 
CoolFireX: raises $2 to $3
Michael Quan: raises $4 to $7
ozone2003: folds 
erick222: folds 
KovIFish89: folds 
CoolFireX: calls $4
*** FLOP *** [7s 6d Ts]
KovIFish89 leaves the table
CoolFireX: checks 
Michael Quan: checks 
*** TURN *** [7s 6d Ts] [As]
CoolFireX: checks 
Michael Quan: bets $8
CoolFireX: calls $8
*** RIVER *** [7s 6d Ts As] [7d]
CoolFireX: checks 
Michael Quan: checks 
*** SHOW DOWN ***
CoolFireX: shows [Qs Jh] (a pair of Sevens)
Michael Quan: shows [Qh Ac] (two pair, Aces and Sevens)
Michael Quan collected $31.26 from pot
*** SUMMARY ***
Total pot $32.90 | Rake $1.64 
Board [7s 6d Ts As 7d]
Seat 1: phil_cheng folded before Flop (didn't bet)
Seat 2: matiko09 folded before Flop (didn't bet)
Seat 4: CoolFireX showed [Qs Jh] and lost with a pair of Sevens
Seat 5: Michael Quan showed [Qh Ac] and won ($31.26) with two pair, Aces and Sevens
Seat 7: ozone2003 (button) folded before Flop (didn't bet)
Seat 8: erick222 (small blind) folded before Flop
Seat 9: KovIFish89 (big blind) folded before Flop





PokerStars Hand #155013280738:  Hold'em No Limit ($0.50/$1.00 USD) - 2016/06/21 13:24:45 CET [2016/06/21 7:24:45 ET]
Table 'Leo' 9-max Seat #5 is the button
Seat 1: fukumimi ($108.04 in chips) 
Seat 2: torkkdnm ($170.16 in chips) 
Seat 3: matiko09 ($100 in chips) 
Seat 4: phil_cheng ($100 in chips) 
Seat 5: Troll8989 ($102.02 in chips) 
Seat 6: Avtovo ($100 in chips) 
Seat 8: pyromid ($92.42 in chips) 
Seat 9: Wladimir205 ($116.54 in chips) 
Avtovo: posts small blind $0.50
maxxmeister: is sitting out 
pyromid: posts big blind $1
*** HOLE CARDS ***
Dealt to matiko09 [4h Kc]
maxxmeister leaves the table
Wladimir205: folds 
fukumimi: folds 
torkkdnm: folds 
CoolFireX joins the table at seat #7 
matiko09: folds 
phil_cheng: folds 
Troll8989: folds 
Avtovo: raises $1.50 to $2.50
pyromid: folds 
Uncalled bet ($1.50) returned to Avtovo
Avtovo collected $2 from pot
*** SUMMARY ***
Total pot $2 | Rake $0 
Seat 1: fukumimi folded before Flop (didn't bet)
Seat 2: torkkdnm folded before Flop (didn't bet)
Seat 3: matiko09 folded before Flop (didn't bet)
Seat 4: phil_cheng folded before Flop (didn't bet)
Seat 5: Troll8989 (button) folded before Flop (didn't bet)
Seat 6: Avtovo (small blind) collected ($2)
Seat 8: pyromid (big blind) folded before Flop
Seat 9: Wladimir205 folded before Flop (didn't bet)





PokerStars Hand #155013280852:  Hold'em No Limit ($0.50/$1.00 USD) - 2016/06/21 13:24:45 CET [2016/06/21 7:24:45 ET]
Table 'Admete II' 9-max Seat #9 is the button
Seat 1: xxxxusedomer ($56.34 in chips) 
Seat 2: Eskimo Fox ($101.50 in chips) 
Seat 4: krustophsky ($108.78 in chips) 
Seat 5: ramzes160468 ($68.42 in chips) 
Seat 6: mbk88 ($128.50 in chips) 
Seat 7: matiko09 ($100 in chips) 
Seat 8: koutani7 ($93.50 in chips) 
Seat 9: ozone2003 ($100 in chips) 
xxxxusedomer: posts small blind $0.50
Eskimo Fox: posts big blind $1
*** HOLE CARDS ***
Dealt to matiko09 [Ad Jh]
krustophsky: folds 
ramzes160468: folds 
mbk88: folds 
matiko09: raises $2 to $3
koutani7: folds 
ozone2003: folds 
xxxxusedomer: folds 
Eskimo Fox: calls $2
*** FLOP *** [Kc Ks Jc]
Eskimo Fox: checks 
matiko09: checks 
*** TURN *** [Kc Ks Jc] [2d]
Eskimo Fox: checks 
matiko09: bets $3.21
Eskimo Fox: calls $3.21
*** RIVER *** [Kc Ks Jc 2d] [9d]
Eskimo Fox: checks 
matiko09: checks 
*** SHOW DOWN ***
Eskimo Fox: shows [6s 6c] (two pair, Kings and Sixes)
matiko09: shows [Ad Jh] (two pair, Kings and Jacks)
matiko09 collected $12.27 from pot
*** SUMMARY ***
Total pot $12.92 | Rake $0.65 
Board [Kc Ks Jc 2d 9d]
Seat 1: xxxxusedomer (small blind) folded before Flop
Seat 2: Eskimo Fox (big blind) showed [6s 6c] and lost with two pair, Kings and Sixes
Seat 4: krustophsky folded before Flop (didn't bet)
Seat 5: ramzes160468 folded before Flop (didn't bet)
Seat 6: mbk88 folded before Flop (didn't bet)
Seat 7: matiko09 showed [Ad Jh] and won ($12.27) with two pair, Kings and Jacks
Seat 8: koutani7 folded before Flop (didn't bet)
Seat 9: ozone2003 (button) folded before Flop (didn't bet)





PokerStars Hand #155013286792:  Hold'em No Limit ($0.50/$1.00 USD) - 2016/06/21 13:24:59 CET [2016/06/21 7:24:59 ET]
Table 'Lamberta II' 9-max Seat #9 is the button
Seat 1: mbk88 ($100.50 in chips) 
Seat 2: mavin80 ($97.82 in chips) 
Seat 3: matiko09 ($101.50 in chips) 
Seat 4: Eskimo Fox ($119.41 in chips) 
Seat 5: mi$$I$Elena ($101.50 in chips) 
Seat 7: phil_cheng ($101.50 in chips) 
Seat 8: Troll8989 ($100 in chips) 
Seat 9: Sjtu_Michael ($107.44 in chips) 
mbk88: posts small blind $0.50
mavin80: posts big blind $1
Chen423: sits out 
*** HOLE CARDS ***
Dealt to matiko09 [8c Js]
matiko09: folds 
Eskimo Fox: folds 
mi$$I$Elena: folds 
phil_cheng: folds 
Troll8989: raises $1.50 to $2.50
Sjtu_Michael: folds 
mbk88: folds 
mavin80: folds 
Uncalled bet ($1.50) returned to Troll8989
Troll8989 collected $2.50 from pot
Troll8989: doesn't show hand 
*** SUMMARY ***
Total pot $2.50 | Rake $0 
Seat 1: mbk88 (small blind) folded before Flop
Seat 2: mavin80 (big blind) folded before Flop
Seat 3: matiko09 folded before Flop (didn't bet)
Seat 4: Eskimo Fox folded before Flop (didn't bet)
Seat 5: mi$$I$Elena folded before Flop (didn't bet)
Seat 7: phil_cheng folded before Flop (didn't bet)
Seat 8: Troll8989 collected ($2.50)
Seat 9: Sjtu_Michael (button) folded before Flop (didn't bet)





PokerStars Hand #155013286815:  Hold'em No Limit ($0.50/$1.00 USD) - 2016/06/21 13:24:59 CET [2016/06/21 7:24:59 ET]
Table 'Moreau' 9-max Seat #7 is the button
Seat 1: ozone2003 ($131.99 in chips) 
Seat 3: matiko09 ($118.38 in chips) 
Seat 4: SharingaaN ($99.50 in chips) 
Seat 6: Troll8989 ($100 in chips) 
Seat 7: PanKwn15 ($101.39 in chips) 
Seat 8: maxxmeister ($103.50 in chips) 
maxxmeister: posts small blind $0.50
ozone2003: posts big blind $1
Avtovo: sits out 
*** HOLE CARDS ***
Dealt to matiko09 [Th Qs]
matiko09: folds 
SharingaaN: folds 
Troll8989: folds 
PanKwn15: folds 
maxxmeister: raises $2.50 to $3.50
ozone2003: folds 
Uncalled bet ($2.50) returned to maxxmeister
maxxmeister collected $2 from pot
maxxmeister: doesn't show hand 
*** SUMMARY ***
Total pot $2 | Rake $0 
Seat 1: ozone2003 (big blind) folded before Flop
Seat 3: matiko09 folded before Flop (didn't bet)
Seat 4: SharingaaN folded before Flop (didn't bet)
Seat 6: Troll8989 folded before Flop (didn't bet)
Seat 7: PanKwn15 (button) folded before Flop (didn't bet)
Seat 8: maxxmeister (small blind) collected ($2)





PokerStars Hand #155013289876:  Hold'em No Limit ($0.50/$1.00 USD) - 2016/06/21 13:25:06 CET [2016/06/21 7:25:06 ET]
Table 'Cheleb' 9-max Seat #8 is the button
Seat 1: SharingaaN ($161.99 in chips) 
Seat 2: pyromid ($143.50 in chips) 
Seat 3: phil_cheng ($114.98 in chips) 
Seat 4: CoolFireX ($171.17 in chips) 
Seat 6: matiko09 ($100 in chips) 
Seat 7: The Big Ape ($98 in chips) 
Seat 8: Troll8989 ($100 in chips) 
Seat 9: mbk88 ($100 in chips) 
mbk88: posts small blind $0.50
SharingaaN: posts big blind $1
Avtovo: sits out 
*** HOLE CARDS ***
Dealt to matiko09 [6d Qh]
pyromid: folds 
phil_cheng: folds 
CoolFireX: folds 
matiko09: folds 
The Big Ape: folds 
Troll8989: raises $1.50 to $2.50
mbk88: folds 
SharingaaN: raises $7.50 to $10
Troll8989: folds 
Uncalled bet ($7.50) returned to SharingaaN
SharingaaN collected $5.50 from pot
SharingaaN: doesn't show hand 
*** SUMMARY ***
Total pot $5.50 | Rake $0 
Seat 1: SharingaaN (big blind) collected ($5.50)
Seat 2: pyromid folded before Flop (didn't bet)
Seat 3: phil_cheng folded before Flop (didn't bet)
Seat 4: CoolFireX folded before Flop (didn't bet)
Seat 6: matiko09 folded before Flop (didn't bet)
Seat 7: The Big Ape folded before Flop (didn't bet)
Seat 8: Troll8989 (button) folded before Flop
Seat 9: mbk88 (small blind) folded before Flop





PokerStars Hand #155013294597:  Hold'em No Limit ($0.50/$1.00 USD) - 2016/06/21 13:25:17 CET [2016/06/21 7:25:17 ET]
Table 'Rupertwildt' 9-max Seat #2 is the button
Seat 2: SharingaaN ($75.55 in chips) 
Seat 3: Troll8989 ($100 in chips) 
Seat 4: matiko09 ($146.18 in chips) 
Seat 5: pyromid ($93 in chips) 
Seat 6: ozone2003 ($163.16 in chips) 
Seat 7: Avtovo ($100 in chips) 
Seat 8: Gonzanary ($122.79 in chips) 
Seat 9: mbk88 ($104.93 in chips) 
Troll8989: posts small blind $0.50
matiko09: posts big blind $1
*** HOLE CARDS ***
Dealt to matiko09 [8h Tc]
pyromid: folds 
ozone2003: folds 
Avtovo: folds 
Gonzanary: folds 
mbk88: folds 
SharingaaN: raises $1 to $2
Troll8989: folds 
matiko09: folds 
Uncalled bet ($1) returned to SharingaaN
SharingaaN collected $2.50 from pot
SharingaaN: doesn't show hand 
*** SUMMARY ***
Total pot $2.50 | Rake $0 
Seat 2: SharingaaN (button) collected ($2.50)
Seat 3: Troll8989 (small blind) folded before Flop
Seat 4: matiko09 (big blind) folded before Flop
Seat 5: pyromid folded before Flop (didn't bet)
Seat 6: ozone2003 folded before Flop (didn't bet)
Seat 7: Avtovo folded before Flop (didn't bet)
Seat 8: Gonzanary folded before Flop (didn't bet)
Seat 9: mbk88 folded before Flop (didn't bet)





PokerStars Hand #155013296969:  Hold'em No Limit ($0.50/$1.00 USD) - 2016/06/21 13:25:23 CET [2016/06/21 7:25:23 ET]
Table 'Moreau' 9-max Seat #8 is the button
Seat 1: ozone2003 ($130.99 in chips) 
Seat 2: Avtovo ($100 in chips) 
Seat 3: matiko09 ($118.38 in chips) 
Seat 4: SharingaaN ($99.50 in chips) 
Seat 6: Troll8989 ($100 in chips) 
Seat 7: PanKwn15 ($101.39 in chips) 
Seat 8: maxxmeister ($104.50 in chips) 
ozone2003: posts small blind $0.50
Avtovo: posts big blind $1
*** HOLE CARDS ***
Dealt to matiko09 [4d 9h]
matiko09: folds 
SharingaaN: folds 
Troll8989: folds 
PanKwn15: folds 
maxxmeister: raises $2 to $3
ozone2003: folds 
Avtovo: raises $7.50 to $10.50
maxxmeister: folds 
Uncalled bet ($7.50) returned to Avtovo
Avtovo collected $6.50 from pot
Avtovo: doesn't show hand 
*** SUMMARY ***
Total pot $6.50 | Rake $0 
Seat 1: ozone2003 (small blind) folded before Flop
Seat 2: Avtovo (big blind) collected ($6.50)
Seat 3: matiko09 folded before Flop (didn't bet)
Seat 4: SharingaaN folded before Flop (didn't bet)
Seat 6: Troll8989 folded before Flop (didn't bet)
Seat 7: PanKwn15 folded before Flop (didn't bet)
Seat 8: maxxmeister (button) folded before Flop





PokerStars Hand #155013298856:  Hold'em No Limit ($0.50/$1.00 USD) - 2016/06/21 13:25:27 CET [2016/06/21 7:25:27 ET]
Table 'Carlova II' 9-max Seat #2 is the button
Seat 1: matiko09 ($109.80 in chips) 
Seat 2: mbk88 ($131.65 in chips) 
Seat 4: Dandy Monk ($63.91 in chips) 
Seat 5: ozone2003 ($109.18 in chips) 
Seat 7: mi$$I$Elena ($123.75 in chips) 
Seat 8: pyromid ($105.10 in chips) 
Seat 9: Troll8989 ($100.68 in chips) 
SharingaaN will be allowed to play after the button
Dandy Monk: posts small blind $0.50
ozone2003: posts big blind $1
phil_cheng: sits out 
*** HOLE CARDS ***
Dealt to matiko09 [8d Tc]
mi$$I$Elena: folds 
pyromid: folds 
Troll8989: folds 
matiko09: folds 
mbk88: folds 
Dandy Monk: raises $2.91 to $3.91
ozone2003: calls $2.91
*** FLOP *** [Ad 5s 7d]
Dandy Monk: checks 
ozone2003: bets $4.83
Dandy Monk: raises $4.83 to $9.66
ozone2003: calls $4.83
*** TURN *** [Ad 5s 7d] [3d]
Dandy Monk: checks 
ozone2003: checks 
*** RIVER *** [Ad 5s 7d 3d] [4d]
Dandy Monk: bets $13
ozone2003: calls $13
*** SHOW DOWN ***
Dandy Monk: shows [Kc Kd] (a flush, Ace high)
ozone2003: mucks hand 
Dandy Monk collected $50.64 from pot
*** SUMMARY ***
Total pot $53.14 | Rake $2.50 
Board [Ad 5s 7d 3d 4d]
Seat 1: matiko09 folded before Flop (didn't bet)
Seat 2: mbk88 (button) folded before Flop (didn't bet)
Seat 4: Dandy Monk (small blind) showed [Kc Kd] and won ($50.64) with a flush, Ace high
Seat 5: ozone2003 (big blind) mucked [4h Ah]
Seat 7: mi$$I$Elena folded before Flop (didn't bet)
Seat 8: pyromid folded before Flop (didn't bet)
Seat 9: Troll8989 folded before Flop (didn't bet)





PokerStars Hand #155013298931:  Hold'em No Limit (€0.25/€0.50 EUR) - 2016/06/21 13:25:28 CET [2016/06/21 7:25:28 ET]
Table 'Actor II' 6-max Seat #3 is the button
Seat 1: hmverlin (€92.94 in chips) 
Seat 2: alôha (€58.58 in chips) 
Seat 3: asmodej666 (€79.56 in chips) 
Seat 4: matiko09 (€50 in chips) 
Seat 5: Rybka1294 (€57.61 in chips) 
Seat 6: fanmtZ (€22.11 in chips) 
matiko09: posts small blind €0.25
Rybka1294: posts big blind €0.50
*** HOLE CARDS ***
Dealt to matiko09 [9d 3s]
fanmtZ: folds 
hmverlin: folds 
alôha: folds 
asmodej666: raises €0.62 to €1.12
matiko09: folds 
Rybka1294: folds 
Uncalled bet (€0.62) returned to asmodej666
asmodej666 collected €1.25 from pot
asmodej666: doesn't show hand 
*** SUMMARY ***
Total pot €1.25 | Rake €0 
Seat 1: hmverlin folded before Flop (didn't bet)
Seat 2: alôha folded before Flop (didn't bet)
Seat 3: asmodej666 (button) collected (€1.25)
Seat 4: matiko09 (small blind) folded before Flop
Seat 5: Rybka1294 (big blind) folded before Flop
Seat 6: fanmtZ folded before Flop (didn't bet)





PokerStars Hand #155013302476:  Hold'em No Limit ($0.50/$1.00 USD) - 2016/06/21 13:25:36 CET [2016/06/21 7:25:36 ET]
Table 'Leo' 9-max Seat #6 is the button
Seat 1: fukumimi ($108.04 in chips) 
Seat 2: torkkdnm ($170.16 in chips) 
Seat 3: matiko09 ($100 in chips) 
Seat 4: phil_cheng ($100 in chips) 
Seat 5: Troll8989 ($102.02 in chips) 
Seat 6: Avtovo ($101 in chips) 
Seat 8: pyromid ($91.42 in chips) 
Seat 9: Wladimir205 ($116.54 in chips) 
CoolFireX will be allowed to play after the button
pyromid: posts small blind $0.50
Wladimir205: posts big blind $1
*** HOLE CARDS ***
Dealt to matiko09 [2c 3s]
fukumimi: folds 
torkkdnm: folds 
matiko09: folds 
phil_cheng: folds 
Troll8989: folds 
Avtovo: folds 
pyromid: folds 
Uncalled bet ($0.50) returned to Wladimir205
Wladimir205 collected $1 from pot
Wladimir205: doesn't show hand 
*** SUMMARY ***
Total pot $1 | Rake $0 
Seat 1: fukumimi folded before Flop (didn't bet)
Seat 2: torkkdnm folded before Flop (didn't bet)
Seat 3: matiko09 folded before Flop (didn't bet)
Seat 4: phil_cheng folded before Flop (didn't bet)
Seat 5: Troll8989 folded before Flop (didn't bet)
Seat 6: Avtovo (button) folded before Flop (didn't bet)
Seat 8: pyromid (small blind) folded before Flop
Seat 9: Wladimir205 (big blind) collected ($1)





PokerStars Hand #155013303359:  Hold'em No Limit ($0.50/$1.00 USD) - 2016/06/21 13:25:38 CET [2016/06/21 7:25:38 ET]
Table 'Lamberta II' 9-max Seat #1 is the button
Seat 1: mbk88 ($100 in chips) 
Seat 2: mavin80 ($96.82 in chips) 
Seat 3: matiko09 ($101.50 in chips) 
Seat 4: Eskimo Fox ($119.41 in chips) 
Seat 5: mi$$I$Elena ($101.50 in chips) 
Seat 7: phil_cheng ($101.50 in chips) 
Seat 8: Troll8989 ($101.50 in chips) 
Seat 9: Sjtu_Michael ($107.44 in chips) 
mavin80: posts small blind $0.50
matiko09: posts big blind $1
Chen423: sits out 
*** HOLE CARDS ***
Dealt to matiko09 [2d 5h]
Eskimo Fox: folds 
mi$$I$Elena: folds 
phil_cheng: folds 
Troll8989: raises $1.50 to $2.50
Sjtu_Michael: raises $5.50 to $8
mbk88: folds 
mavin80: folds 
matiko09: folds 
Troll8989: folds 
Uncalled bet ($5.50) returned to Sjtu_Michael
Sjtu_Michael collected $6.50 from pot
Sjtu_Michael: doesn't show hand 
*** SUMMARY ***
Total pot $6.50 | Rake $0 
Seat 1: mbk88 (button) folded before Flop (didn't bet)
Seat 2: mavin80 (small blind) folded before Flop
Seat 3: matiko09 (big blind) folded before Flop
Seat 4: Eskimo Fox folded before Flop (didn't bet)
Seat 5: mi$$I$Elena folded before Flop (didn't bet)
Seat 7: phil_cheng folded before Flop (didn't bet)
Seat 8: Troll8989 folded before Flop
Seat 9: Sjtu_Michael collected ($6.50)





PokerStars Hand #155013306272:  Hold'em No Limit ($0.50/$1.00 USD) - 2016/06/21 13:25:45 CET [2016/06/21 7:25:45 ET]
Table 'Rupertwildt' 9-max Seat #3 is the button
Seat 2: SharingaaN ($77.05 in chips) 
Seat 3: Troll8989 ($100 in chips) 
Seat 4: matiko09 ($145.18 in chips) 
Seat 5: pyromid ($93 in chips) 
Seat 6: ozone2003 ($163.16 in chips) 
Seat 7: Avtovo ($100 in chips) 
Seat 8: Gonzanary ($122.79 in chips) 
Seat 9: mbk88 ($104.93 in chips) 
matiko09: posts small blind $0.50
pyromid: posts big blind $1
*** HOLE CARDS ***
Dealt to matiko09 [8c As]
ozone2003: folds 
Avtovo: folds 
ozone2003 leaves the table
Gonzanary: folds 
mbk88: folds 
SharingaaN: raises $2 to $3
phil_cheng joins the table at seat #6 
Troll8989: folds 
matiko09: folds 
pyromid: folds 
Uncalled bet ($2) returned to SharingaaN
SharingaaN collected $2.50 from pot
SharingaaN: doesn't show hand 
*** SUMMARY ***
Total pot $2.50 | Rake $0 
Seat 2: SharingaaN collected ($2.50)
Seat 3: Troll8989 (button) folded before Flop (didn't bet)
Seat 4: matiko09 (small blind) folded before Flop
Seat 5: pyromid (big blind) folded before Flop
Seat 6: ozone2003 folded before Flop (didn't bet)
Seat 7: Avtovo folded before Flop (didn't bet)
Seat 8: Gonzanary folded before Flop (didn't bet)
Seat 9: mbk88 folded before Flop (didn't bet)





PokerStars Hand #155013309844:  Hold'em No Limit ($0.50/$1.00 USD) - 2016/06/21 13:25:53 CET [2016/06/21 7:25:53 ET]
Table 'Cheleb' 9-max Seat #9 is the button
Seat 1: SharingaaN ($164.99 in chips) 
Seat 2: pyromid ($143.50 in chips) 
Seat 3: phil_cheng ($114.98 in chips) 
Seat 4: CoolFireX ($171.17 in chips) 
Seat 6: matiko09 ($100 in chips) 
Seat 7: The Big Ape ($98 in chips) 
Seat 8: Troll8989 ($100 in chips) 
Seat 9: mbk88 ($100 in chips) 
SharingaaN: posts small blind $0.50
pyromid: posts big blind $1
Avtovo: sits out 
*** HOLE CARDS ***
Dealt to matiko09 [Ac 6d]
phil_cheng: folds 
CoolFireX: folds 
matiko09: folds 
The Big Ape: folds 
Troll8989: folds 
mbk88: folds 
SharingaaN: folds 
Uncalled bet ($0.50) returned to pyromid
pyromid collected $1 from pot
pyromid: doesn't show hand 
*** SUMMARY ***
Total pot $1 | Rake $0 
Seat 1: SharingaaN (small blind) folded before Flop
Seat 2: pyromid (big blind) collected ($1)
Seat 3: phil_cheng folded before Flop (didn't bet)
Seat 4: CoolFireX folded before Flop (didn't bet)
Seat 6: matiko09 folded before Flop (didn't bet)
Seat 7: The Big Ape folded before Flop (didn't bet)
Seat 8: Troll8989 folded before Flop (didn't bet)
Seat 9: mbk88 (button) folded before Flop (didn't bet)





PokerStars Hand #155013311139:  Hold'em No Limit ($0.50/$1.00 USD) - 2016/06/21 13:25:56 CET [2016/06/21 7:25:56 ET]
Table 'Leo' 9-max Seat #8 is the button
Seat 1: fukumimi ($108.04 in chips) 
Seat 2: torkkdnm ($170.16 in chips) 
Seat 3: matiko09 ($100 in chips) 
Seat 4: phil_cheng ($100 in chips) 
Seat 5: Troll8989 ($102.02 in chips) 
Seat 6: Avtovo ($101 in chips) 
Seat 8: pyromid ($90.92 in chips) 
Seat 9: Wladimir205 ($117.04 in chips) 
Wladimir205: posts small blind $0.50
fukumimi: posts big blind $1
CoolFireX: sits out 
*** HOLE CARDS ***
Dealt to matiko09 [9d 3c]
torkkdnm: folds 
matiko09: folds 
phil_cheng: raises $2 to $3
Troll8989: folds 
Avtovo: calls $3
pyromid: folds 
Wladimir205: folds 
fukumimi: folds 
*** FLOP *** [5h 8h Ac]
phil_cheng: checks 
Avtovo: checks 
*** TURN *** [5h 8h Ac] [Ad]
phil_cheng: bets $3.56
Avtovo: calls $3.56
*** RIVER *** [5h 8h Ac Ad] [Qs]
phil_cheng: checks 
Avtovo: checks 
*** SHOW DOWN ***
phil_cheng: shows [Qc Qh] (a full house, Queens full of Aces)
Avtovo: mucks hand 
phil_cheng collected $13.89 from pot
*** SUMMARY ***
Total pot $14.62 | Rake $0.73 
Board [5h 8h Ac Ad Qs]
Seat 1: fukumimi (big blind) folded before Flop
Seat 2: torkkdnm folded before Flop (didn't bet)
Seat 3: matiko09 folded before Flop (didn't bet)
Seat 4: phil_cheng showed [Qc Qh] and won ($13.89) with a full house, Queens full of Aces
Seat 5: Troll8989 folded before Flop (didn't bet)
Seat 6: Avtovo mucked [9s 9h]
Seat 8: pyromid (button) folded before Flop (didn't bet)
Seat 9: Wladimir205 (small blind) folded before Flop





PokerStars Hand #155013312342:  Hold'em No Limit ($0.50/$1.00 USD) - 2016/06/21 13:25:59 CET [2016/06/21 7:25:59 ET]
Table 'Admete II' 9-max Seat #1 is the button
Seat 1: xxxxusedomer ($55.84 in chips) 
Seat 2: Eskimo Fox ($100 in chips) 
Seat 3: 50CandyJoe ($100.12 in chips) 
Seat 4: krustophsky ($108.78 in chips) 
Seat 5: ramzes160468 ($68.42 in chips) 
Seat 6: mbk88 ($128.50 in chips) 
Seat 7: matiko09 ($106.06 in chips) 
Seat 8: koutani7 ($93.50 in chips) 
Seat 9: ozone2003 ($100 in chips) 
Eskimo Fox: posts small blind $0.50
50CandyJoe: posts big blind $1
*** HOLE CARDS ***
Dealt to matiko09 [Qh 7s]
krustophsky: folds 
ramzes160468: folds 
mbk88: folds 
matiko09: folds 
koutani7: folds 
ozone2003: folds 
xxxxusedomer: raises $2 to $3
Eskimo Fox: folds 
50CandyJoe: folds 
Uncalled bet ($2) returned to xxxxusedomer
xxxxusedomer collected $2.50 from pot
*** SUMMARY ***
Total pot $2.50 | Rake $0 
Seat 1: xxxxusedomer (button) collected ($2.50)
Seat 2: Eskimo Fox (small blind) folded before Flop
Seat 3: 50CandyJoe (big blind) folded before Flop
Seat 4: krustophsky folded before Flop (didn't bet)
Seat 5: ramzes160468 folded before Flop (didn't bet)
Seat 6: mbk88 folded before Flop (didn't bet)
Seat 7: matiko09 folded before Flop (didn't bet)
Seat 8: koutani7 folded before Flop (didn't bet)
Seat 9: ozone2003 folded before Flop (didn't bet)





PokerStars Hand #155013312325:  Hold'em No Limit (€0.25/€0.50 EUR) - 2016/06/21 13:25:59 CET [2016/06/21 7:25:59 ET]
Table 'Actor II' 6-max Seat #4 is the button
Seat 1: hmverlin (€92.94 in chips) 
Seat 2: alôha (€58.58 in chips) 
Seat 3: asmodej666 (€80.31 in chips) 
Seat 4: matiko09 (€50 in chips) 
Seat 5: Rybka1294 (€57.11 in chips) 
Seat 6: fanmtZ (€22.11 in chips) 
Rybka1294: posts small blind €0.25
fanmtZ: posts big blind €0.50
*** HOLE CARDS ***
Dealt to matiko09 [As Ah]
hmverlin: raises €1 to €1.50
alôha: folds 
asmodej666: folds 
matiko09: raises €3.50 to €5
Rybka1294: folds 
fanmtZ: folds 
hmverlin: calls €3.50
*** FLOP *** [2d 3s Th]
hmverlin: checks 
matiko09: bets €3.16
hmverlin: raises €3.16 to €6.32
matiko09: calls €3.16
*** TURN *** [2d 3s Th] [Jh]
hmverlin: bets €4
matiko09: raises €9.50 to €13.50
hmverlin: folds 
Uncalled bet (€9.50) returned to matiko09
matiko09 collected €29.82 from pot
matiko09: doesn't show hand 
*** SUMMARY ***
Total pot €31.39 | Rake €1.57 
Board [2d 3s Th Jh]
Seat 1: hmverlin folded on the Turn
Seat 2: alôha folded before Flop (didn't bet)
Seat 3: asmodej666 folded before Flop (didn't bet)
Seat 4: matiko09 (button) collected (€29.82)
Seat 5: Rybka1294 (small blind) folded before Flop
Seat 6: fanmtZ (big blind) folded before Flop





PokerStars Hand #155013314046:  Hold'em No Limit ($0.50/$1.00 USD) - 2016/06/21 13:26:03 CET [2016/06/21 7:26:03 ET]
Table 'Saldanha' 9-max Seat #8 is the button
Seat 1: phil_cheng ($100 in chips) 
Seat 2: matiko09 ($383.70 in chips) 
Seat 4: CoolFireX ($100 in chips) 
Seat 5: Michael Quan ($122.06 in chips) 
Seat 7: ozone2003 ($100 in chips) 
Seat 8: erick222 ($100 in chips) 
phil_cheng: posts small blind $0.50
matiko09: posts big blind $1
wisbc: sits out 
Donetsk1y: sits out 
phil_cheng: posts the ante $0.20
matiko09: posts the ante $0.20
CoolFireX: posts the ante $0.20
Michael Quan: posts the ante $0.20
ozone2003: posts the ante $0.20
erick222: posts the ante $0.20
*** HOLE CARDS ***
Dealt to matiko09 [Ah Qd]
CoolFireX: folds 
Michael Quan: folds 
ozone2003: folds 
erick222: folds 
phil_cheng: folds 
Uncalled bet ($0.50) returned to matiko09
matiko09 collected $2.20 from pot
matiko09: doesn't show hand 
*** SUMMARY ***
Total pot $2.20 | Rake $0 
Seat 1: phil_cheng (small blind) folded before Flop
Seat 2: matiko09 (big blind) collected ($2.20)
Seat 4: CoolFireX folded before Flop (didn't bet)
Seat 5: Michael Quan folded before Flop (didn't bet)
Seat 7: ozone2003 folded before Flop (didn't bet)
Seat 8: erick222 (button) folded before Flop (didn't bet)





PokerStars Hand #155013315350:  Hold'em No Limit ($0.50/$1.00 USD) - 2016/06/21 13:26:06 CET [2016/06/21 7:26:06 ET]
Table 'Rupertwildt' 9-max Seat #4 is the button
Seat 2: SharingaaN ($78.55 in chips) 
Seat 3: Troll8989 ($100 in chips) 
Seat 4: matiko09 ($144.68 in chips) 
Seat 5: pyromid ($92 in chips) 
Seat 6: phil_cheng ($100 in chips) 
Seat 7: Avtovo ($100 in chips) 
Seat 8: Gonzanary ($122.79 in chips) 
Seat 9: mbk88 ($104.93 in chips) 
pyromid: posts small blind $0.50
phil_cheng: posts big blind $1
*** HOLE CARDS ***
Dealt to matiko09 [2h 9d]
Avtovo: folds 
Gonzanary: folds 
mbk88: raises $2 to $3
SharingaaN: folds 
Troll8989: folds 
matiko09: folds 
pyromid: calls $2.50
phil_cheng: calls $2
*** FLOP *** [Kd 5s 8s]
pyromid: bets $2.50
phil_cheng: calls $2.50
mbk88: raises $9.50 to $12
pyromid: folds 
phil_cheng: calls $9.50
*** TURN *** [Kd 5s 8s] [7c]
phil_cheng: checks 
mbk88: checks 
*** RIVER *** [Kd 5s 8s 7c] [7d]
phil_cheng: checks 
mbk88: checks 
*** SHOW DOWN ***
phil_cheng: shows [Jh Kh] (two pair, Kings and Sevens)
mbk88: mucks hand 
phil_cheng collected $33.72 from pot
*** SUMMARY ***
Total pot $35.50 | Rake $1.78 
Board [Kd 5s 8s 7c 7d]
Seat 2: SharingaaN folded before Flop (didn't bet)
Seat 3: Troll8989 folded before Flop (didn't bet)
Seat 4: matiko09 (button) folded before Flop (didn't bet)
Seat 5: pyromid (small blind) folded on the Flop
Seat 6: phil_cheng (big blind) showed [Jh Kh] and won ($33.72) with two pair, Kings and Sevens
Seat 7: Avtovo folded before Flop (didn't bet)
Seat 8: Gonzanary folded before Flop (didn't bet)
Seat 9: mbk88 mucked [As Jc]





PokerStars Hand #155013319295:  Hold'em No Limit ($0.50/$1.00 USD) - 2016/06/21 13:26:15 CET [2016/06/21 7:26:15 ET]
Table 'Cheleb' 9-max Seat #1 is the button
Seat 1: SharingaaN ($164.49 in chips) 
Seat 2: pyromid ($144 in chips) 
Seat 3: phil_cheng ($114.98 in chips) 
Seat 4: CoolFireX ($171.17 in chips) 
Seat 6: matiko09 ($100 in chips) 
Seat 7: The Big Ape ($98 in chips) 
Seat 8: Troll8989 ($100 in chips) 
Seat 9: mbk88 ($100 in chips) 
pyromid: posts small blind $0.50
phil_cheng: posts big blind $1
Avtovo: sits out 
*** HOLE CARDS ***
Dealt to matiko09 [Qs 5d]
CoolFireX: folds 
matiko09: folds 
The Big Ape: raises $2 to $3
Troll8989: folds 
mbk88: folds 
SharingaaN: folds 
pyromid: calls $2.50
phil_cheng: folds 
*** FLOP *** [Qd 7d Qc]
pyromid: checks 
The Big Ape: bets $6
pyromid: folds 
Uncalled bet ($6) returned to The Big Ape
The Big Ape collected $6.65 from pot
The Big Ape: doesn't show hand 
*** SUMMARY ***
Total pot $7 | Rake $0.35 
Board [Qd 7d Qc]
Seat 1: SharingaaN (button) folded before Flop (didn't bet)
Seat 2: pyromid (small blind) folded on the Flop
Seat 3: phil_cheng (big blind) folded before Flop
Seat 4: CoolFireX folded before Flop (didn't bet)
Seat 6: matiko09 folded before Flop (didn't bet)
Seat 7: The Big Ape collected ($6.65)
Seat 8: Troll8989 folded before Flop (didn't bet)
Seat 9: mbk88 folded before Flop (didn't bet)





PokerStars Hand #155013319814:  Hold'em No Limit ($0.50/$1.00 USD) - 2016/06/21 13:26:17 CET [2016/06/21 7:26:17 ET]
Table 'Chimay' 9-max Seat #5 is the button
Seat 1: phil_cheng ($103 in chips) 
Seat 2: pyromid ($141.48 in chips) 
Seat 3: maxxmeister ($100 in chips) 
Seat 4: fukumimi ($100 in chips) 
Seat 5: The Big Ape ($98.50 in chips) 
Seat 6: mbk88 ($152.47 in chips) 
Seat 7: matiko09 ($108.12 in chips) 
Seat 8: Eskimo Fox ($139.30 in chips) 
Seat 9: SharingaaN ($108.99 in chips) 
mbk88: posts small blind $0.50
matiko09: posts big blind $1
*** HOLE CARDS ***
Dealt to matiko09 [Ks 8h]
Eskimo Fox: folds 
SharingaaN: folds 
phil_cheng: folds 
pyromid: folds 
maxxmeister: folds 
fukumimi: folds 
The Big Ape: folds 
mbk88: calls $0.50
matiko09: raises $3 to $4
mbk88: calls $3
*** FLOP *** [3c Kh 6c]
mbk88: checks 
matiko09: bets $3.95
mbk88: folds 
Uncalled bet ($3.95) returned to matiko09
matiko09 collected $7.60 from pot
matiko09: doesn't show hand 
*** SUMMARY ***
Total pot $8 | Rake $0.40 
Board [3c Kh 6c]
Seat 1: phil_cheng folded before Flop (didn't bet)
Seat 2: pyromid folded before Flop (didn't bet)
Seat 3: maxxmeister folded before Flop (didn't bet)
Seat 4: fukumimi folded before Flop (didn't bet)
Seat 5: The Big Ape (button) folded before Flop (didn't bet)
Seat 6: mbk88 (small blind) folded on the Flop
Seat 7: matiko09 (big blind) collected ($7.60)
Seat 8: Eskimo Fox folded before Flop (didn't bet)
Seat 9: SharingaaN folded before Flop (didn't bet)





PokerStars Hand #155013321790:  Hold'em No Limit ($0.50/$1.00 USD) - 2016/06/21 13:26:21 CET [2016/06/21 7:26:21 ET]
Table 'Lamberta II' 9-max Seat #2 is the button
Seat 1: mbk88 ($100 in chips) 
Seat 2: mavin80 ($96.32 in chips) 
Seat 3: matiko09 ($100.50 in chips) 
Seat 4: Eskimo Fox ($119.41 in chips) 
Seat 5: mi$$I$Elena ($101.50 in chips) 
Seat 7: phil_cheng ($101.50 in chips) 
Seat 8: Troll8989 ($100 in chips) 
Seat 9: Sjtu_Michael ($111.44 in chips) 
matiko09: posts small blind $0.50
Eskimo Fox: posts big blind $1
Chen423: sits out 
*** HOLE CARDS ***
Dealt to matiko09 [7s Kc]
mi$$I$Elena: raises $1.38 to $2.38
phil_cheng: folds 
Troll8989: folds 
Sjtu_Michael: folds 
mbk88: folds 
mavin80: calls $2.38
matiko09: folds 
Eskimo Fox: folds 
*** FLOP *** [As 4d Js]
mi$$I$Elena: checks 
mavin80: bets $2
mi$$I$Elena: calls $2
*** TURN *** [As 4d Js] [9c]
mi$$I$Elena: bets $7
mavin80: folds 
Uncalled bet ($7) returned to mi$$I$Elena
mi$$I$Elena collected $9.75 from pot
mi$$I$Elena: doesn't show hand 
*** SUMMARY ***
Total pot $10.26 | Rake $0.51 
Board [As 4d Js 9c]
Seat 1: mbk88 folded before Flop (didn't bet)
Seat 2: mavin80 (button) folded on the Turn
Seat 3: matiko09 (small blind) folded before Flop
Seat 4: Eskimo Fox (big blind) folded before Flop
Seat 5: mi$$I$Elena collected ($9.75)
Seat 7: phil_cheng folded before Flop (didn't bet)
Seat 8: Troll8989 folded before Flop (didn't bet)
Seat 9: Sjtu_Michael folded before Flop (didn't bet)





PokerStars Hand #155013325511:  Hold'em No Limit ($0.50/$1.00 USD) - 2016/06/21 13:26:30 CET [2016/06/21 7:26:30 ET]
Table 'Admete II' 9-max Seat #2 is the button
Seat 1: xxxxusedomer ($57.34 in chips) 
Seat 2: Eskimo Fox ($100 in chips) 
Seat 3: 50CandyJoe ($100 in chips) 
Seat 4: krustophsky ($108.78 in chips) 
Seat 5: ramzes160468 ($68.42 in chips) 
Seat 6: mbk88 ($128.50 in chips) 
Seat 7: matiko09 ($106.06 in chips) 
Seat 8: koutani7 ($93.50 in chips) 
Seat 9: ozone2003 ($100 in chips) 
50CandyJoe: posts small blind $0.50
krustophsky: posts big blind $1
*** HOLE CARDS ***
Dealt to matiko09 [8s 3d]
ramzes160468: folds 
mbk88: folds 
ramzes160468 leaves the table
matiko09: folds 
koutani7: folds 
ozone2003: folds 
xxxxusedomer: calls $1
mi$$I$Elena joins the table at seat #5 
Eskimo Fox: raises $3 to $4
50CandyJoe: folds 
krustophsky: calls $3
xxxxusedomer: calls $3
*** FLOP *** [7d 8h Th]
krustophsky: checks 
xxxxusedomer: checks 
Eskimo Fox: bets $6.29
krustophsky: calls $6.29
xxxxusedomer: raises $9.29 to $15.58
Eskimo Fox: calls $9.29
krustophsky: calls $9.29
*** TURN *** [7d 8h Th] [9d]
krustophsky: checks 
xxxxusedomer: bets $37.76 and is all-in
Eskimo Fox: calls $37.76
krustophsky: folds 
*** RIVER *** [7d 8h Th 9d] [2c]
*** SHOW DOWN ***
xxxxusedomer: shows [Td 7c] (two pair, Tens and Sevens)
Eskimo Fox: shows [Jh 9h] (a straight, Seven to Jack)
Eskimo Fox collected $132.26 from pot
*** SUMMARY ***
Total pot $134.76 | Rake $2.50 
Board [7d 8h Th 9d 2c]
Seat 1: xxxxusedomer showed [Td 7c] and lost with two pair, Tens and Sevens
Seat 2: Eskimo Fox (button) showed [Jh 9h] and won ($132.26) with a straight, Seven to Jack
Seat 3: 50CandyJoe (small blind) folded before Flop
Seat 4: krustophsky (big blind) folded on the Turn
Seat 5: ramzes160468 folded before Flop (didn't bet)
Seat 6: mbk88 folded before Flop (didn't bet)
Seat 7: matiko09 folded before Flop (didn't bet)
Seat 8: koutani7 folded before Flop (didn't bet)
Seat 9: ozone2003 folded before Flop (didn't bet)





PokerStars Hand #155013326887:  Hold'em No Limit ($0.50/$1.00 USD) - 2016/06/21 13:26:33 CET [2016/06/21 7:26:33 ET]
Table 'Saldanha' 9-max Seat #1 is the button
Seat 1: phil_cheng ($100 in chips) 
Seat 2: matiko09 ($385.20 in chips) 
Seat 3: wisbc ($100 in chips) 
Seat 4: CoolFireX ($100 in chips) 
Seat 5: Michael Quan ($121.86 in chips) 
Seat 7: ozone2003 ($100 in chips) 
Seat 8: erick222 ($100 in chips) 
matiko09: posts small blind $0.50
wisbc: posts big blind $1
Donetsk1y: sits out 
phil_cheng: posts the ante $0.20
matiko09: posts the ante $0.20
wisbc: posts the ante $0.20
CoolFireX: posts the ante $0.20
Michael Quan: posts the ante $0.20
ozone2003: posts the ante $0.20
erick222: posts the ante $0.20
*** HOLE CARDS ***
Dealt to matiko09 [Kd Jh]
CoolFireX: folds 
Michael Quan: folds 
ozone2003: folds 
erick222: folds 
phil_cheng: folds 
matiko09: raises $2 to $3
wisbc: folds 
Uncalled bet ($2) returned to matiko09
matiko09 collected $3.40 from pot
matiko09: doesn't show hand 
*** SUMMARY ***
Total pot $3.40 | Rake $0 
Seat 1: phil_cheng (button) folded before Flop (didn't bet)
Seat 2: matiko09 (small blind) collected ($3.40)
Seat 3: wisbc (big blind) folded before Flop
Seat 4: CoolFireX folded before Flop (didn't bet)
Seat 5: Michael Quan folded before Flop (didn't bet)
Seat 7: ozone2003 folded before Flop (didn't bet)
Seat 8: erick222 folded before Flop (didn't bet)





PokerStars Hand #155013327801:  Hold'em No Limit ($0.50/$1.00 USD) - 2016/06/21 13:26:36 CET [2016/06/21 7:26:36 ET]
Table 'Carlova II' 9-max Seat #4 is the button
Seat 1: matiko09 ($109.80 in chips) 
Seat 2: mbk88 ($131.65 in chips) 
Seat 4: Dandy Monk ($87.98 in chips) 
Seat 5: ozone2003 ($100 in chips) 
Seat 6: phil_cheng ($100 in chips) 
Seat 7: mi$$I$Elena ($123.75 in chips) 
Seat 8: pyromid ($105.10 in chips) 
Seat 9: Troll8989 ($100.68 in chips) 
ozone2003: posts small blind $0.50
phil_cheng: posts big blind $1
SharingaaN: sits out 
*** HOLE CARDS ***
Dealt to matiko09 [3h Jd]
mi$$I$Elena: folds 
pyromid: folds 
Troll8989: raises $1.50 to $2.50
matiko09: folds 
mbk88: folds 
Dandy Monk: folds 
ozone2003: raises $6.50 to $9
phil_cheng: folds 
Troll8989: calls $6.50
*** FLOP *** [Qh 5d 6s]
ozone2003: checks 
Troll8989: checks 
*** TURN *** [Qh 5d 6s] [Ad]
ozone2003: bets $10.05
Troll8989: folds 
Uncalled bet ($10.05) returned to ozone2003
ozone2003 collected $18.05 from pot
ozone2003: doesn't show hand 
*** SUMMARY ***
Total pot $19 | Rake $0.95 
Board [Qh 5d 6s Ad]
Seat 1: matiko09 folded before Flop (didn't bet)
Seat 2: mbk88 folded before Flop (didn't bet)
Seat 4: Dandy Monk (button) folded before Flop (didn't bet)
Seat 5: ozone2003 (small blind) collected ($18.05)
Seat 6: phil_cheng (big blind) folded before Flop
Seat 7: mi$$I$Elena folded before Flop (didn't bet)
Seat 8: pyromid folded before Flop (didn't bet)
Seat 9: Troll8989 folded on the Turn





PokerStars Hand #155013330375:  Hold'em No Limit ($0.50/$1.00 USD) - 2016/06/21 13:26:41 CET [2016/06/21 7:26:41 ET]
Table 'Moreau' 9-max Seat #1 is the button
Seat 1: ozone2003 ($130.49 in chips) 
Seat 2: Avtovo ($103.50 in chips) 
Seat 3: matiko09 ($118.38 in chips) 
Seat 4: SharingaaN ($99.50 in chips) 
Seat 6: Troll8989 ($100 in chips) 
Seat 7: PanKwn15 ($101.39 in chips) 
Seat 8: maxxmeister ($101.50 in chips) 
Avtovo: posts small blind $0.50
matiko09: posts big blind $1
Toonersens is disconnected 
Toonersens has timed out while disconnected
Toonersens: is sitting out 
*** HOLE CARDS ***
Dealt to matiko09 [6c Qh]
SharingaaN: folds 
Troll8989: folds 
PanKwn15: folds 
maxxmeister: folds 
ozone2003: folds 
Avtovo: raises $1.50 to $2.50
matiko09: folds 
Uncalled bet ($1.50) returned to Avtovo
Avtovo collected $2 from pot
Avtovo: doesn't show hand 
*** SUMMARY ***
Total pot $2 | Rake $0 
Seat 1: ozone2003 (button) folded before Flop (didn't bet)
Seat 2: Avtovo (small blind) collected ($2)
Seat 3: matiko09 (big blind) folded before Flop
Seat 4: SharingaaN folded before Flop (didn't bet)
Seat 6: Troll8989 folded before Flop (didn't bet)
Seat 7: PanKwn15 folded before Flop (didn't bet)
Seat 8: maxxmeister folded before Flop (didn't bet)





PokerStars Hand #155013333697:  Hold'em No Limit ($0.50/$1.00 USD) - 2016/06/21 13:26:49 CET [2016/06/21 7:26:49 ET]
Table 'Leo' 9-max Seat #9 is the button
Seat 1: fukumimi ($107.04 in chips) 
Seat 3: matiko09 ($100 in chips) 
Seat 4: phil_cheng ($107.33 in chips) 
Seat 5: Troll8989 ($102.02 in chips) 
Seat 6: Avtovo ($100 in chips) 
Seat 8: pyromid ($90.92 in chips) 
Seat 9: Wladimir205 ($116.54 in chips) 
fukumimi: posts small blind $0.50
torkkdnm: is sitting out 
matiko09: posts big blind $1
CoolFireX: sits out 
*** HOLE CARDS ***
Dealt to matiko09 [3s 8s]
phil_cheng: folds 
Troll8989: raises $1.50 to $2.50
Avtovo: folds 
pyromid: folds 
Wladimir205: folds 
fukumimi: folds 
torkkdnm leaves the table
mbk88 joins the table at seat #2 
matiko09: folds 
Uncalled bet ($1.50) returned to Troll8989
Troll8989 collected $2.50 from pot
Troll8989: doesn't show hand 
*** SUMMARY ***
Total pot $2.50 | Rake $0 
Seat 1: fukumimi (small blind) folded before Flop
Seat 3: matiko09 (big blind) folded before Flop
Seat 4: phil_cheng folded before Flop (didn't bet)
Seat 5: Troll8989 collected ($2.50)
Seat 6: Avtovo folded before Flop (didn't bet)
Seat 8: pyromid folded before Flop (didn't bet)
Seat 9: Wladimir205 (button) folded before Flop (didn't bet)





PokerStars Hand #155013335345:  Hold'em No Limit ($0.50/$1.00 USD) - 2016/06/21 13:26:53 CET [2016/06/21 7:26:53 ET]
Table 'Saldanha' 9-max Seat #2 is the button
Seat 1: phil_cheng ($100 in chips) 
Seat 2: matiko09 ($387.40 in chips) 
Seat 3: wisbc ($98.80 in chips) 
Seat 4: CoolFireX ($100 in chips) 
Seat 5: Michael Quan ($121.66 in chips) 
Seat 7: ozone2003 ($100 in chips) 
Seat 8: erick222 ($100 in chips) 
wisbc: posts small blind $0.50
CoolFireX: posts big blind $1
Donetsk1y: sits out 
phil_cheng: posts the ante $0.20
matiko09: posts the ante $0.20
wisbc: posts the ante $0.20
CoolFireX: posts the ante $0.20
Michael Quan: posts the ante $0.20
ozone2003: posts the ante $0.20
erick222: posts the ante $0.20
*** HOLE CARDS ***
Dealt to matiko09 [Tc 5c]
Michael Quan: folds 
ozone2003: folds 
erick222: folds 
phil_cheng: folds 
matiko09: folds 
23SmOkEr07 joins the table at seat #9 
wisbc: raises $2 to $3
CoolFireX: folds 
Uncalled bet ($2) returned to wisbc
wisbc collected $3.40 from pot
wisbc: doesn't show hand 
*** SUMMARY ***
Total pot $3.40 | Rake $0 
Seat 1: phil_cheng folded before Flop (didn't bet)
Seat 2: matiko09 (button) folded before Flop (didn't bet)
Seat 3: wisbc (small blind) collected ($3.40)
Seat 4: CoolFireX (big blind) folded before Flop
Seat 5: Michael Quan folded before Flop (didn't bet)
Seat 7: ozone2003 folded before Flop (didn't bet)
Seat 8: erick222 folded before Flop (didn't bet)





PokerStars Hand #155013344079:  Hold'em No Limit ($0.50/$1.00 USD) - 2016/06/21 13:27:14 CET [2016/06/21 7:27:14 ET]
Table 'Cheleb' 9-max Seat #2 is the button
Seat 1: SharingaaN ($164.49 in chips) 
Seat 2: pyromid ($141 in chips) 
Seat 3: phil_cheng ($113.98 in chips) 
Seat 4: CoolFireX ($171.17 in chips) 
Seat 6: matiko09 ($100 in chips) 
Seat 7: The Big Ape ($101.65 in chips) 
Seat 8: Troll8989 ($100 in chips) 
Seat 9: mbk88 ($100 in chips) 
phil_cheng: posts small blind $0.50
CoolFireX: posts big blind $1
Avtovo: sits out 
*** HOLE CARDS ***
Dealt to matiko09 [9d 2c]
matiko09: folds 
The Big Ape: raises $1 to $2
Troll8989: folds 
mbk88: folds 
SharingaaN: folds 
pyromid: folds 
phil_cheng: folds 
CoolFireX: calls $1
*** FLOP *** [5c Ts 3h]
CoolFireX: checks 
The Big Ape: checks 
*** TURN *** [5c Ts 3h] [2h]
CoolFireX: bets $3.50
The Big Ape: calls $3.50
*** RIVER *** [5c Ts 3h 2h] [7h]
CoolFireX: bets $8.50
The Big Ape: folds 
Uncalled bet ($8.50) returned to CoolFireX
CoolFireX collected $10.92 from pot
CoolFireX: doesn't show hand 
*** SUMMARY ***
Total pot $11.50 | Rake $0.58 
Board [5c Ts 3h 2h 7h]
Seat 1: SharingaaN folded before Flop (didn't bet)
Seat 2: pyromid (button) folded before Flop (didn't bet)
Seat 3: phil_cheng (small blind) folded before Flop
Seat 4: CoolFireX (big blind) collected ($10.92)
Seat 6: matiko09 folded before Flop (didn't bet)
Seat 7: The Big Ape folded on the River
Seat 8: Troll8989 folded before Flop (didn't bet)
Seat 9: mbk88 folded before Flop (didn't bet)





PokerStars Hand #155013344077:  Hold'em No Limit (€0.25/€0.50 EUR) - 2016/06/21 13:27:14 CET [2016/06/21 7:27:14 ET]
Table 'Actor II' 6-max Seat #5 is the button
Seat 1: hmverlin (€77.62 in chips) 
Seat 2: alôha (€58.58 in chips) 
Seat 3: asmodej666 (€80.31 in chips) 
Seat 4: matiko09 (€64.50 in chips) 
Seat 5: Rybka1294 (€56.86 in chips) 
Seat 6: fanmtZ (€21.61 in chips) 
fanmtZ: posts small blind €0.25
hmverlin: posts big blind €0.50
*** HOLE CARDS ***
Dealt to matiko09 [6c Qd]
alôha: folds 
asmodej666: folds 
matiko09: folds 
Rybka1294: raises €0.50 to €1
fanmtZ: folds 
hmverlin: calls €0.50
*** FLOP *** [2c Kh 4h]
hmverlin: checks 
Rybka1294: bets €1.50
hmverlin: raises €1.50 to €3
Rybka1294: calls €1.50
*** TURN *** [2c Kh 4h] [7s]
hmverlin: bets €3
Rybka1294: calls €3
*** RIVER *** [2c Kh 4h 7s] [8h]
hmverlin: checks 
Rybka1294: checks 
*** SHOW DOWN ***
hmverlin: shows [4d 2h] (two pair, Fours and Deuces)
Rybka1294: mucks hand 
hmverlin collected €13.54 from pot
*** SUMMARY ***
Total pot €14.25 | Rake €0.71 
Board [2c Kh 4h 7s 8h]
Seat 1: hmverlin (big blind) showed [4d 2h] and won (€13.54) with two pair, Fours and Deuces
Seat 2: alôha folded before Flop (didn't bet)
Seat 3: asmodej666 folded before Flop (didn't bet)
Seat 4: matiko09 folded before Flop (didn't bet)
Seat 5: Rybka1294 (button) mucked [Kd Jd]
Seat 6: fanmtZ (small blind) folded before Flop





PokerStars Hand #155013345940:  Hold'em No Limit ($0.50/$1.00 USD) - 2016/06/21 13:27:18 CET [2016/06/21 7:27:18 ET]
Table 'Leo' 9-max Seat #1 is the button
Seat 1: fukumimi ($106.54 in chips) 
Seat 3: matiko09 ($100 in chips) 
Seat 4: phil_cheng ($107.33 in chips) 
Seat 5: Troll8989 ($103.52 in chips) 
Seat 6: Avtovo ($100 in chips) 
Seat 8: pyromid ($90.92 in chips) 
Seat 9: Wladimir205 ($116.54 in chips) 
mbk88 will be allowed to play after the button
matiko09: posts small blind $0.50
phil_cheng: posts big blind $1
CoolFireX: sits out 
*** HOLE CARDS ***
Dealt to matiko09 [6d Qh]
Troll8989: folds 
Avtovo: folds 
pyromid: folds 
Wladimir205: folds 
fukumimi: folds 
matiko09: folds 
Uncalled bet ($0.50) returned to phil_cheng
phil_cheng collected $1 from pot
phil_cheng: doesn't show hand 
*** SUMMARY ***
Total pot $1 | Rake $0 
Seat 1: fukumimi (button) folded before Flop (didn't bet)
Seat 3: matiko09 (small blind) folded before Flop
Seat 4: phil_cheng (big blind) collected ($1)
Seat 5: Troll8989 folded before Flop (didn't bet)
Seat 6: Avtovo folded before Flop (didn't bet)
Seat 8: pyromid folded before Flop (didn't bet)
Seat 9: Wladimir205 folded before Flop (didn't bet)





PokerStars Hand #155013346138:  Hold'em No Limit ($0.50/$1.00 USD) - 2016/06/21 13:27:19 CET [2016/06/21 7:27:19 ET]
Table 'Chimay' 9-max Seat #6 is the button
Seat 1: phil_cheng ($103 in chips) 
Seat 2: pyromid ($141.48 in chips) 
Seat 3: maxxmeister ($100 in chips) 
Seat 4: fukumimi ($100 in chips) 
Seat 5: The Big Ape ($98.50 in chips) 
Seat 6: mbk88 ($148.47 in chips) 
Seat 7: matiko09 ($111.72 in chips) 
Seat 8: Eskimo Fox ($139.30 in chips) 
Seat 9: SharingaaN ($108.99 in chips) 
matiko09: posts small blind $0.50
Eskimo Fox: posts big blind $1
*** HOLE CARDS ***
Dealt to matiko09 [Qs 5c]
SharingaaN: folds 
phil_cheng: raises $2 to $3
pyromid: folds 
maxxmeister: folds 
fukumimi: folds 
The Big Ape: folds 
mbk88: folds 
matiko09: folds 
Eskimo Fox: folds 
Uncalled bet ($2) returned to phil_cheng
phil_cheng collected $2.50 from pot
phil_cheng: doesn't show hand 
*** SUMMARY ***
Total pot $2.50 | Rake $0 
Seat 1: phil_cheng collected ($2.50)
Seat 2: pyromid folded before Flop (didn't bet)
Seat 3: maxxmeister folded before Flop (didn't bet)
Seat 4: fukumimi folded before Flop (didn't bet)
Seat 5: The Big Ape folded before Flop (didn't bet)
Seat 6: mbk88 (button) folded before Flop (didn't bet)
Seat 7: matiko09 (small blind) folded before Flop
Seat 8: Eskimo Fox (big blind) folded before Flop
Seat 9: SharingaaN folded before Flop (didn't bet)





PokerStars Hand #155013347826:  Hold'em No Limit ($0.50/$1.00 USD) - 2016/06/21 13:27:23 CET [2016/06/21 7:27:23 ET]
Table 'Moreau' 9-max Seat #2 is the button
Seat 1: ozone2003 ($130.49 in chips) 
Seat 2: Avtovo ($104.50 in chips) 
Seat 3: matiko09 ($117.38 in chips) 
Seat 4: SharingaaN ($99.50 in chips) 
Seat 6: Troll8989 ($100 in chips) 
Seat 7: PanKwn15 ($101.39 in chips) 
Seat 8: maxxmeister ($101.50 in chips) 
matiko09: posts small blind $0.50
SharingaaN: posts big blind $1
*** HOLE CARDS ***
Dealt to matiko09 [Kh 7c]
Troll8989: folds 
PanKwn15: folds 
maxxmeister: folds 
ozone2003: folds 
Avtovo: folds 
matiko09: folds 
Uncalled bet ($0.50) returned to SharingaaN
SharingaaN collected $1 from pot
SharingaaN: doesn't show hand 
*** SUMMARY ***
Total pot $1 | Rake $0 
Seat 1: ozone2003 folded before Flop (didn't bet)
Seat 2: Avtovo (button) folded before Flop (didn't bet)
Seat 3: matiko09 (small blind) folded before Flop
Seat 4: SharingaaN (big blind) collected ($1)
Seat 6: Troll8989 folded before Flop (didn't bet)
Seat 7: PanKwn15 folded before Flop (didn't bet)
Seat 8: maxxmeister folded before Flop (didn't bet)





PokerStars Hand #155013351096:  Hold'em No Limit ($0.50/$1.00 USD) - 2016/06/21 13:27:30 CET [2016/06/21 7:27:30 ET]
Table 'Saldanha' 9-max Seat #3 is the button
Seat 1: phil_cheng ($100 in chips) 
Seat 2: matiko09 ($387.20 in chips) 
Seat 3: wisbc ($101 in chips) 
Seat 4: CoolFireX ($100 in chips) 
Seat 5: Michael Quan ($121.46 in chips) 
Seat 7: ozone2003 ($100 in chips) 
Seat 8: erick222 ($100 in chips) 
CoolFireX: posts small blind $0.50
Michael Quan: posts big blind $1
Donetsk1y: sits out 
23SmOkEr07: sits out 
phil_cheng: posts the ante $0.20
matiko09: posts the ante $0.20
wisbc: posts the ante $0.20
CoolFireX: posts the ante $0.20
Michael Quan: posts the ante $0.20
ozone2003: posts the ante $0.20
erick222: posts the ante $0.20
*** HOLE CARDS ***
Dealt to matiko09 [3h Ks]
ozone2003: folds 
erick222: folds 
phil_cheng: folds 
matiko09: folds 
wisbc: folds 
CoolFireX: raises $2 to $3
Michael Quan: calls $2
*** FLOP *** [9d Tc Jh]
CoolFireX: checks 
Michael Quan: checks 
*** TURN *** [9d Tc Jh] [2s]
CoolFireX: checks 
Michael Quan: bets $4
CoolFireX: folds 
Uncalled bet ($4) returned to Michael Quan
Michael Quan collected $7.03 from pot
*** SUMMARY ***
Total pot $7.40 | Rake $0.37 
Board [9d Tc Jh 2s]
Seat 1: phil_cheng folded before Flop (didn't bet)
Seat 2: matiko09 folded before Flop (didn't bet)
Seat 3: wisbc (button) folded before Flop (didn't bet)
Seat 4: CoolFireX (small blind) folded on the Turn
Seat 5: Michael Quan (big blind) collected ($7.03)
Seat 7: ozone2003 folded before Flop (didn't bet)
Seat 8: erick222 folded before Flop (didn't bet)





PokerStars Hand #155013352702:  Hold'em No Limit ($0.50/$1.00 USD) - 2016/06/21 13:27:34 CET [2016/06/21 7:27:34 ET]
Table 'Leo' 9-max Seat #3 is the button
Seat 1: fukumimi ($106.54 in chips) 
Seat 3: matiko09 ($100 in chips) 
Seat 4: phil_cheng ($107.83 in chips) 
Seat 5: Troll8989 ($103.52 in chips) 
Seat 6: Avtovo ($100 in chips) 
Seat 8: pyromid ($90.92 in chips) 
Seat 9: Wladimir205 ($116.54 in chips) 
phil_cheng: posts small blind $0.50
Troll8989: posts big blind $1
CoolFireX: sits out 
mbk88: sits out 
*** HOLE CARDS ***
Dealt to matiko09 [6d Kc]
Avtovo: folds 
pyromid: folds 
Wladimir205: folds 
fukumimi: folds 
matiko09: folds 
phil_cheng: folds 
Uncalled bet ($0.50) returned to Troll8989
Troll8989 collected $1 from pot
Troll8989: doesn't show hand 
*** SUMMARY ***
Total pot $1 | Rake $0 
Seat 1: fukumimi folded before Flop (didn't bet)
Seat 3: matiko09 (button) folded before Flop (didn't bet)
Seat 4: phil_cheng (small blind) folded before Flop
Seat 5: Troll8989 (big blind) collected ($1)
Seat 6: Avtovo folded before Flop (didn't bet)
Seat 8: pyromid folded before Flop (didn't bet)
Seat 9: Wladimir205 folded before Flop (didn't bet)





PokerStars Hand #155013352517:  Hold'em No Limit ($0.50/$1.00 USD) - 2016/06/21 13:27:34 CET [2016/06/21 7:27:34 ET]
Table 'Rupertwildt' 9-max Seat #5 is the button
Seat 2: SharingaaN ($78.55 in chips) 
Seat 3: Troll8989 ($100 in chips) 
Seat 4: matiko09 ($144.68 in chips) 
Seat 5: pyromid ($86.50 in chips) 
Seat 6: phil_cheng ($118.72 in chips) 
Seat 8: Gonzanary ($122.79 in chips) 
Seat 9: mbk88 ($100 in chips) 
phil_cheng: posts small blind $0.50
Avtovo: is sitting out 
Gonzanary: posts big blind $1
*** HOLE CARDS ***
Dealt to matiko09 [3d Qc]
mbk88: folds 
SharingaaN: raises $1 to $2
Avtovo leaves the table
Donetsk1y joins the table at seat #7 
Troll8989: folds 
matiko09: folds 
pyromid: folds 
phil_cheng: folds 
Gonzanary: folds 
Uncalled bet ($1) returned to SharingaaN
SharingaaN collected $2.50 from pot
SharingaaN: doesn't show hand 
*** SUMMARY ***
Total pot $2.50 | Rake $0 
Seat 2: SharingaaN collected ($2.50)
Seat 3: Troll8989 folded before Flop (didn't bet)
Seat 4: matiko09 folded before Flop (didn't bet)
Seat 5: pyromid (button) folded before Flop (didn't bet)
Seat 6: phil_cheng (small blind) folded before Flop
Seat 8: Gonzanary (big blind) folded before Flop
Seat 9: mbk88 folded before Flop (didn't bet)





PokerStars Hand #155013356889:  Hold'em No Limit ($0.50/$1.00 USD) - 2016/06/21 13:27:44 CET [2016/06/21 7:27:44 ET]
Table 'Moreau' 9-max Seat #3 is the button
Seat 1: ozone2003 ($130.49 in chips) 
Seat 2: Avtovo ($104.50 in chips) 
Seat 3: matiko09 ($116.88 in chips) 
Seat 4: SharingaaN ($100 in chips) 
Seat 6: Troll8989 ($100 in chips) 
Seat 7: PanKwn15 ($101.39 in chips) 
Seat 8: maxxmeister ($101.50 in chips) 
SharingaaN: posts small blind $0.50
Troll8989: posts big blind $1
*** HOLE CARDS ***
Dealt to matiko09 [2d 7d]
PanKwn15: folds 
maxxmeister: folds 
ozone2003: folds 
Avtovo: raises $1.50 to $2.50
matiko09: folds 
SharingaaN: folds 
Troll8989: folds 
Uncalled bet ($1.50) returned to Avtovo
Avtovo collected $2.50 from pot
Avtovo: doesn't show hand 
*** SUMMARY ***
Total pot $2.50 | Rake $0 
Seat 1: ozone2003 folded before Flop (didn't bet)
Seat 2: Avtovo collected ($2.50)
Seat 3: matiko09 (button) folded before Flop (didn't bet)
Seat 4: SharingaaN (small blind) folded before Flop
Seat 6: Troll8989 (big blind) folded before Flop
Seat 7: PanKwn15 folded before Flop (didn't bet)
Seat 8: maxxmeister folded before Flop (didn't bet)





PokerStars Hand #155013359393:  Hold'em No Limit ($0.50/$1.00 USD) - 2016/06/21 13:27:50 CET [2016/06/21 7:27:50 ET]
Table 'Carlova II' 9-max Seat #5 is the button
Seat 1: matiko09 ($109.80 in chips) 
Seat 2: mbk88 ($131.65 in chips) 
Seat 4: Dandy Monk ($87.98 in chips) 
Seat 5: ozone2003 ($109.05 in chips) 
Seat 6: phil_cheng ($100 in chips) 
Seat 7: mi$$I$Elena ($123.75 in chips) 
Seat 8: pyromid ($105.10 in chips) 
Seat 9: Troll8989 ($100 in chips) 
phil_cheng: posts small blind $0.50
mi$$I$Elena: posts big blind $1
SharingaaN: sits out 
*** HOLE CARDS ***
Dealt to matiko09 [3c 6d]
pyromid: folds 
Troll8989: raises $1.50 to $2.50
matiko09: folds 
mbk88: folds 
Dandy Monk: folds 
ozone2003: folds 
phil_cheng: folds 
mi$$I$Elena: folds 
Uncalled bet ($1.50) returned to Troll8989
Troll8989 collected $2.50 from pot
Troll8989: doesn't show hand 
*** SUMMARY ***
Total pot $2.50 | Rake $0 
Seat 1: matiko09 folded before Flop (didn't bet)
Seat 2: mbk88 folded before Flop (didn't bet)
Seat 4: Dandy Monk folded before Flop (didn't bet)
Seat 5: ozone2003 (button) folded before Flop (didn't bet)
Seat 6: phil_cheng (small blind) folded before Flop
Seat 7: mi$$I$Elena (big blind) folded before Flop
Seat 8: pyromid folded before Flop (didn't bet)
Seat 9: Troll8989 collected ($2.50)





PokerStars Hand #155013359657:  Hold'em No Limit ($0.50/$1.00 USD) - 2016/06/21 13:27:51 CET [2016/06/21 7:27:51 ET]
Table 'Rupertwildt' 9-max Seat #6 is the button
Seat 2: SharingaaN ($80.05 in chips) 
Seat 3: Troll8989 ($100 in chips) 
Seat 4: matiko09 ($144.68 in chips) 
Seat 5: pyromid ($86.50 in chips) 
Seat 6: phil_cheng ($118.22 in chips) 
Seat 8: Gonzanary ($121.79 in chips) 
Seat 9: mbk88 ($100 in chips) 
Gonzanary: posts small blind $0.50
mbk88: posts big blind $1
*** HOLE CARDS ***
Dealt to matiko09 [3c 6h]
SharingaaN: folds 
Troll8989: folds 
matiko09: folds 
pyromid: folds 
phil_cheng: folds 
Gonzanary: folds 
Uncalled bet ($0.50) returned to mbk88
mbk88 collected $1 from pot
mbk88: doesn't show hand 
*** SUMMARY ***
Total pot $1 | Rake $0 
Seat 2: SharingaaN folded before Flop (didn't bet)
Seat 3: Troll8989 folded before Flop (didn't bet)
Seat 4: matiko09 folded before Flop (didn't bet)
Seat 5: pyromid folded before Flop (didn't bet)
Seat 6: phil_cheng (button) folded before Flop (didn't bet)
Seat 8: Gonzanary (small blind) folded before Flop
Seat 9: mbk88 (big blind) collected ($1)





PokerStars Hand #155013361523:  Hold'em No Limit ($0.50/$1.00 USD) - 2016/06/21 13:27:55 CET [2016/06/21 7:27:55 ET]
Table 'Leo' 9-max Seat #4 is the button
Seat 1: fukumimi ($106.54 in chips) 
Seat 3: matiko09 ($100 in chips) 
Seat 4: phil_cheng ($107.33 in chips) 
Seat 5: Troll8989 ($104.02 in chips) 
Seat 6: Avtovo ($100 in chips) 
Seat 8: pyromid ($90.92 in chips) 
Seat 9: Wladimir205 ($116.54 in chips) 
Troll8989: posts small blind $0.50
Avtovo: posts big blind $1
CoolFireX: sits out 
mbk88: sits out 
*** HOLE CARDS ***
Dealt to matiko09 [2h 4c]
pyromid: raises $1 to $2
Wladimir205: folds 
fukumimi: folds 
matiko09: folds 
phil_cheng: folds 
Troll8989: folds 
Avtovo: folds 
Uncalled bet ($1) returned to pyromid
pyromid collected $2.50 from pot
pyromid: doesn't show hand 
*** SUMMARY ***
Total pot $2.50 | Rake $0 
Seat 1: fukumimi folded before Flop (didn't bet)
Seat 3: matiko09 folded before Flop (didn't bet)
Seat 4: phil_cheng (button) folded before Flop (didn't bet)
Seat 5: Troll8989 (small blind) folded before Flop
Seat 6: Avtovo (big blind) folded before Flop
Seat 8: pyromid collected ($2.50)
Seat 9: Wladimir205 folded before Flop (didn't bet)





PokerStars Hand #155013361929:  Hold'em No Limit ($0.50/$1.00 USD) - 2016/06/21 13:27:56 CET [2016/06/21 7:27:56 ET]
Table 'Lamberta II' 9-max Seat #3 is the button
Seat 1: mbk88 ($100 in chips) 
Seat 2: mavin80 ($91.94 in chips) 
Seat 3: matiko09 ($100 in chips) 
Seat 4: Eskimo Fox ($118.41 in chips) 
Seat 5: mi$$I$Elena ($106.87 in chips) 
Seat 7: phil_cheng ($101.50 in chips) 
Seat 8: Troll8989 ($100 in chips) 
Seat 9: Sjtu_Michael ($111.44 in chips) 
Eskimo Fox: posts small blind $0.50
mi$$I$Elena: posts big blind $1
Chen423: sits out 
*** HOLE CARDS ***
Dealt to matiko09 [7s Qc]
phil_cheng: folds 
Troll8989: folds 
Sjtu_Michael: folds 
mbk88: folds 
mavin80: folds 
matiko09: folds 
Eskimo Fox: raises $1.50 to $2.50
mi$$I$Elena: folds 
Uncalled bet ($1.50) returned to Eskimo Fox
Eskimo Fox collected $2 from pot
Eskimo Fox: doesn't show hand 
*** SUMMARY ***
Total pot $2 | Rake $0 
Seat 1: mbk88 folded before Flop (didn't bet)
Seat 2: mavin80 folded before Flop (didn't bet)
Seat 3: matiko09 (button) folded before Flop (didn't bet)
Seat 4: Eskimo Fox (small blind) collected ($2)
Seat 5: mi$$I$Elena (big blind) folded before Flop
Seat 7: phil_cheng folded before Flop (didn't bet)
Seat 8: Troll8989 folded before Flop (didn't bet)
Seat 9: Sjtu_Michael folded before Flop (didn't bet)





PokerStars Hand #155013362164:  Hold'em No Limit ($0.50/$1.00 USD) - 2016/06/21 13:27:57 CET [2016/06/21 7:27:57 ET]
Table 'Chimay' 9-max Seat #7 is the button
Seat 1: phil_cheng ($104.50 in chips) 
Seat 2: pyromid ($141.48 in chips) 
Seat 3: maxxmeister ($100 in chips) 
Seat 4: fukumimi ($100 in chips) 
Seat 5: The Big Ape ($98.50 in chips) 
Seat 6: mbk88 ($148.47 in chips) 
Seat 7: matiko09 ($111.22 in chips) 
Seat 8: Eskimo Fox ($138.30 in chips) 
Seat 9: SharingaaN ($108.99 in chips) 
Eskimo Fox: posts small blind $0.50
SharingaaN: posts big blind $1
*** HOLE CARDS ***
Dealt to matiko09 [Th 2s]
phil_cheng: folds 
pyromid: raises $1 to $2
maxxmeister: folds 
fukumimi: folds 
The Big Ape: folds 
mbk88: folds 
matiko09: folds 
Eskimo Fox: folds 
SharingaaN: folds 
Uncalled bet ($1) returned to pyromid
pyromid collected $2.50 from pot
pyromid: doesn't show hand 
*** SUMMARY ***
Total pot $2.50 | Rake $0 
Seat 1: phil_cheng folded before Flop (didn't bet)
Seat 2: pyromid collected ($2.50)
Seat 3: maxxmeister folded before Flop (didn't bet)
Seat 4: fukumimi folded before Flop (didn't bet)
Seat 5: The Big Ape folded before Flop (didn't bet)
Seat 6: mbk88 folded before Flop (didn't bet)
Seat 7: matiko09 (button) folded before Flop (didn't bet)
Seat 8: Eskimo Fox (small blind) folded before Flop
Seat 9: SharingaaN (big blind) folded before Flop





PokerStars Hand #155013363249:  Hold'em No Limit (€0.25/€0.50 EUR) - 2016/06/21 13:27:59 CET [2016/06/21 7:27:59 ET]
Table 'Actor II' 6-max Seat #6 is the button
Seat 1: hmverlin (€84.16 in chips) 
Seat 2: alôha (€58.58 in chips) 
Seat 3: asmodej666 (€80.31 in chips) 
Seat 4: matiko09 (€64.50 in chips) 
Seat 5: Rybka1294 (€50 in chips) 
Seat 6: fanmtZ (€21.36 in chips) 
hmverlin: posts small blind €0.25
alôha: posts big blind €0.50
*** HOLE CARDS ***
Dealt to matiko09 [5c Kd]
asmodej666: folds 
matiko09: folds 
Rybka1294: folds 
fanmtZ: raises €0.79 to €1.29
hmverlin: calls €1.04
alôha: folds 
*** FLOP *** [Jc 2c 4h]
hmverlin: bets €1.50
fanmtZ: calls €1.50
*** TURN *** [Jc 2c 4h] [6d]
hmverlin: bets €3
fanmtZ: calls €3
*** RIVER *** [Jc 2c 4h 6d] [2d]
hmverlin: checks 
fanmtZ: checks 
*** SHOW DOWN ***
hmverlin: shows [7h 7c] (two pair, Sevens and Deuces)
fanmtZ: mucks hand 
hmverlin collected €11.48 from pot
*** SUMMARY ***
Total pot €12.08 | Rake €0.60 
Board [Jc 2c 4h 6d 2d]
Seat 1: hmverlin (small blind) showed [7h 7c] and won (€11.48) with two pair, Sevens and Deuces
Seat 2: alôha (big blind) folded before Flop
Seat 3: asmodej666 folded before Flop (didn't bet)
Seat 4: matiko09 folded before Flop (didn't bet)
Seat 5: Rybka1294 folded before Flop (didn't bet)
Seat 6: fanmtZ (button) mucked [5s Ad]





PokerStars Hand #155013366522:  Hold'em No Limit ($0.50/$1.00 USD) - 2016/06/21 13:28:07 CET [2016/06/21 7:28:07 ET]
Table 'Admete II' 9-max Seat #3 is the button
Seat 2: Eskimo Fox ($174.92 in chips) 
Seat 3: 50CandyJoe ($100 in chips) 
Seat 4: krustophsky ($89.20 in chips) 
Seat 5: mi$$I$Elena ($100 in chips) 
Seat 6: mbk88 ($128.50 in chips) 
Seat 7: matiko09 ($106.06 in chips) 
Seat 8: koutani7 ($93.50 in chips) 
Seat 9: ozone2003 ($100 in chips) 
krustophsky: posts small blind $0.50
mi$$I$Elena: posts big blind $1
*** HOLE CARDS ***
Dealt to matiko09 [5d 2h]
mbk88: folds 
matiko09: folds 
koutani7: folds 
xxxxusedomer leaves the table
ozone2003: folds 
Eskimo Fox: folds 
50CandyJoe: folds 
krustophsky: raises $2 to $3
mi$$I$Elena: folds 
Uncalled bet ($2) returned to krustophsky
krustophsky collected $2 from pot
*** SUMMARY ***
Total pot $2 | Rake $0 
Seat 2: Eskimo Fox folded before Flop (didn't bet)
Seat 3: 50CandyJoe (button) folded before Flop (didn't bet)
Seat 4: krustophsky (small blind) collected ($2)
Seat 5: mi$$I$Elena (big blind) folded before Flop
Seat 6: mbk88 folded before Flop (didn't bet)
Seat 7: matiko09 folded before Flop (didn't bet)
Seat 8: koutani7 folded before Flop (didn't bet)
Seat 9: ozone2003 folded before Flop (didn't bet)





PokerStars Hand #155013368543:  Hold'em No Limit ($0.50/$1.00 USD) - 2016/06/21 13:28:12 CET [2016/06/21 7:28:12 ET]
Table 'Leo' 9-max Seat #5 is the button
Seat 1: fukumimi ($106.54 in chips) 
Seat 3: matiko09 ($100 in chips) 
Seat 4: phil_cheng ($107.33 in chips) 
Seat 5: Troll8989 ($103.52 in chips) 
Seat 6: Avtovo ($100 in chips) 
Seat 7: CoolFireX ($257.95 in chips) 
Seat 8: pyromid ($92.42 in chips) 
Seat 9: Wladimir205 ($116.54 in chips) 
Avtovo: posts small blind $0.50
CoolFireX: posts big blind $1
mbk88: sits out 
*** HOLE CARDS ***
Dealt to matiko09 [2s Ac]
pyromid: folds 
Wladimir205: folds 
fukumimi: folds 
matiko09: folds 
phil_cheng: folds 
Troll8989: folds 
Avtovo: raises $1.50 to $2.50
CoolFireX: calls $1.50
*** FLOP *** [3d 5d 5h]
Avtovo: checks 
CoolFireX: bets $3
Avtovo: folds 
Uncalled bet ($3) returned to CoolFireX
CoolFireX collected $4.75 from pot
CoolFireX: doesn't show hand 
*** SUMMARY ***
Total pot $5 | Rake $0.25 
Board [3d 5d 5h]
Seat 1: fukumimi folded before Flop (didn't bet)
Seat 3: matiko09 folded before Flop (didn't bet)
Seat 4: phil_cheng folded before Flop (didn't bet)
Seat 5: Troll8989 (button) folded before Flop (didn't bet)
Seat 6: Avtovo (small blind) folded on the Flop
Seat 7: CoolFireX (big blind) collected ($4.75)
Seat 8: pyromid folded before Flop (didn't bet)
Seat 9: Wladimir205 folded before Flop (didn't bet)





PokerStars Hand #155013372060:  Hold'em No Limit ($0.50/$1.00 USD) - 2016/06/21 13:28:20 CET [2016/06/21 7:28:20 ET]
Table 'Rupertwildt' 9-max Seat #8 is the button
Seat 2: SharingaaN ($80.05 in chips) 
Seat 3: Troll8989 ($100 in chips) 
Seat 4: matiko09 ($144.68 in chips) 
Seat 5: pyromid ($86.50 in chips) 
Seat 6: phil_cheng ($118.22 in chips) 
Seat 8: Gonzanary ($121.29 in chips) 
Seat 9: mbk88 ($100.50 in chips) 
mbk88: posts small blind $0.50
SharingaaN: posts big blind $1
Donetsk1y: sits out 
*** HOLE CARDS ***
Dealt to matiko09 [Qd 2s]
Troll8989: folds 
matiko09: folds 
pyromid: folds 
phil_cheng: folds 
Gonzanary: raises $1 to $2
mbk88: folds 
SharingaaN: calls $1
*** FLOP *** [6s Qs 7h]
SharingaaN: checks 
Gonzanary: checks 
*** TURN *** [6s Qs 7h] [5d]
SharingaaN: checks 
Gonzanary: bets $2
SharingaaN: raises $5 to $7
Gonzanary: calls $5
*** RIVER *** [6s Qs 7h 5d] [As]
SharingaaN: bets $16
Gonzanary: calls $16
*** SHOW DOWN ***
SharingaaN: shows [8s 9d] (a straight, Five to Nine)
Gonzanary: mucks hand 
SharingaaN collected $48 from pot
*** SUMMARY ***
Total pot $50.50 | Rake $2.50 
Board [6s Qs 7h 5d As]
Seat 2: SharingaaN (big blind) showed [8s 9d] and won ($48) with a straight, Five to Nine
Seat 3: Troll8989 folded before Flop (didn't bet)
Seat 4: matiko09 folded before Flop (didn't bet)
Seat 5: pyromid folded before Flop (didn't bet)
Seat 6: phil_cheng folded before Flop (didn't bet)
Seat 8: Gonzanary (button) mucked [8h Ah]
Seat 9: mbk88 (small blind) folded before Flop





PokerStars Hand #155013372358:  Hold'em No Limit ($0.50/$1.00 USD) - 2016/06/21 13:28:21 CET [2016/06/21 7:28:21 ET]
Table 'Moreau' 9-max Seat #4 is the button
Seat 1: ozone2003 ($130.49 in chips) 
Seat 2: Avtovo ($106 in chips) 
Seat 3: matiko09 ($116.88 in chips) 
Seat 4: SharingaaN ($99.50 in chips) 
Seat 6: Troll8989 ($100 in chips) 
Seat 7: PanKwn15 ($101.39 in chips) 
Seat 8: maxxmeister ($101.50 in chips) 
Troll8989: posts small blind $0.50
PanKwn15: posts big blind $1
*** HOLE CARDS ***
Dealt to matiko09 [6c Jd]
maxxmeister: folds 
ozone2003: folds 
Avtovo: folds 
matiko09: folds 
SharingaaN: raises $1 to $2
Troll8989: folds 
PanKwn15: folds 
Uncalled bet ($1) returned to SharingaaN
SharingaaN collected $2.50 from pot
SharingaaN: doesn't show hand 
*** SUMMARY ***
Total pot $2.50 | Rake $0 
Seat 1: ozone2003 folded before Flop (didn't bet)
Seat 2: Avtovo folded before Flop (didn't bet)
Seat 3: matiko09 folded before Flop (didn't bet)
Seat 4: SharingaaN (button) collected ($2.50)
Seat 6: Troll8989 (small blind) folded before Flop
Seat 7: PanKwn15 (big blind) folded before Flop
Seat 8: maxxmeister folded before Flop (didn't bet)





PokerStars Hand #155013377137:  Hold'em No Limit ($0.50/$1.00 USD) - 2016/06/21 13:28:32 CET [2016/06/21 7:28:32 ET]
Table 'Carlova II' 9-max Seat #6 is the button
Seat 1: matiko09 ($109.80 in chips) 
Seat 2: mbk88 ($131.65 in chips) 
Seat 4: Dandy Monk ($87.98 in chips) 
Seat 5: ozone2003 ($109.05 in chips) 
Seat 6: phil_cheng ($100 in chips) 
Seat 7: mi$$I$Elena ($122.75 in chips) 
Seat 8: pyromid ($105.10 in chips) 
Seat 9: Troll8989 ($101.50 in chips) 
mi$$I$Elena: posts small blind $0.50
pyromid: posts big blind $1
SharingaaN: sits out 
*** HOLE CARDS ***
Dealt to matiko09 [Kd 3d]
Troll8989: folds 
matiko09: folds 
mbk88: folds 
Dandy Monk: folds 
ozone2003: folds 
phil_cheng: folds 
mi$$I$Elena: raises $2 to $3
pyromid: calls $2
*** FLOP *** [4h 3s Ah]
mi$$I$Elena: checks 
pyromid: bets $2
mi$$I$Elena: folds 
Uncalled bet ($2) returned to pyromid
pyromid collected $5.70 from pot
pyromid: doesn't show hand 
*** SUMMARY ***
Total pot $6 | Rake $0.30 
Board [4h 3s Ah]
Seat 1: matiko09 folded before Flop (didn't bet)
Seat 2: mbk88 folded before Flop (didn't bet)
Seat 4: Dandy Monk folded before Flop (didn't bet)
Seat 5: ozone2003 folded before Flop (didn't bet)
Seat 6: phil_cheng (button) folded before Flop (didn't bet)
Seat 7: mi$$I$Elena (small blind) folded on the Flop
Seat 8: pyromid (big blind) collected ($5.70)
Seat 9: Troll8989 folded before Flop (didn't bet)





PokerStars Hand #155013380539:  Hold'em No Limit ($0.50/$1.00 USD) - 2016/06/21 13:28:40 CET [2016/06/21 7:28:40 ET]
Table 'Admete II' 9-max Seat #4 is the button
Seat 2: Eskimo Fox ($174.92 in chips) 
Seat 4: krustophsky ($90.20 in chips) 
Seat 5: mi$$I$Elena ($100 in chips) 
Seat 6: mbk88 ($128.50 in chips) 
Seat 7: matiko09 ($106.06 in chips) 
Seat 8: koutani7 ($93.50 in chips) 
Seat 9: ozone2003 ($100 in chips) 
mi$$I$Elena: posts small blind $0.50
mbk88: posts big blind $1
*** HOLE CARDS ***
Dealt to matiko09 [Ts 2d]
matiko09: folds 
koutani7: folds 
ozone2003: folds 
Eskimo Fox: folds 
krustophsky: raises $2 to $3
mi$$I$Elena: folds 
mbk88: folds 
Uncalled bet ($2) returned to krustophsky
krustophsky collected $2.50 from pot
Donetsk1y joins the table at seat #1 
krustophsky: doesn't show hand 
*** SUMMARY ***
Total pot $2.50 | Rake $0 
Seat 2: Eskimo Fox folded before Flop (didn't bet)
Seat 4: krustophsky (button) collected ($2.50)
Seat 5: mi$$I$Elena (small blind) folded before Flop
Seat 6: mbk88 (big blind) folded before Flop
Seat 7: matiko09 folded before Flop (didn't bet)
Seat 8: koutani7 folded before Flop (didn't bet)
Seat 9: ozone2003 folded before Flop (didn't bet)





PokerStars Hand #155013381261:  Hold'em No Limit ($0.50/$1.00 USD) - 2016/06/21 13:28:42 CET [2016/06/21 7:28:42 ET]
Table 'Chimay' 9-max Seat #8 is the button
Seat 1: phil_cheng ($104.50 in chips) 
Seat 2: pyromid ($142.98 in chips) 
Seat 3: maxxmeister ($100 in chips) 
Seat 4: fukumimi ($100 in chips) 
Seat 5: The Big Ape ($98.50 in chips) 
Seat 6: mbk88 ($148.47 in chips) 
Seat 7: matiko09 ($111.22 in chips) 
Seat 8: Eskimo Fox ($137.80 in chips) 
Seat 9: SharingaaN ($107.99 in chips) 
SharingaaN: posts small blind $0.50
phil_cheng: posts big blind $1
*** HOLE CARDS ***
Dealt to matiko09 [8s Jh]
pyromid: folds 
maxxmeister: folds 
fukumimi: folds 
The Big Ape: folds 
mbk88: folds 
matiko09: folds 
Eskimo Fox: folds 
SharingaaN: folds 
Uncalled bet ($0.50) returned to phil_cheng
phil_cheng collected $1 from pot
phil_cheng: doesn't show hand 
*** SUMMARY ***
Total pot $1 | Rake $0 
Seat 1: phil_cheng (big blind) collected ($1)
Seat 2: pyromid folded before Flop (didn't bet)
Seat 3: maxxmeister folded before Flop (didn't bet)
Seat 4: fukumimi folded before Flop (didn't bet)
Seat 5: The Big Ape folded before Flop (didn't bet)
Seat 6: mbk88 folded before Flop (didn't bet)
Seat 7: matiko09 folded before Flop (didn't bet)
Seat 8: Eskimo Fox (button) folded before Flop (didn't bet)
Seat 9: SharingaaN (small blind) folded before Flop





PokerStars Hand #155013381298:  Hold'em No Limit ($0.50/$1.00 USD) - 2016/06/21 13:28:42 CET [2016/06/21 7:28:42 ET]
Table 'Lamberta II' 9-max Seat #4 is the button
Seat 1: mbk88 ($100 in chips) 
Seat 2: mavin80 ($91.94 in chips) 
Seat 3: matiko09 ($100 in chips) 
Seat 4: Eskimo Fox ($119.41 in chips) 
Seat 5: mi$$I$Elena ($105.87 in chips) 
Seat 6: Chen423 ($80 in chips) 
Seat 7: phil_cheng ($101.50 in chips) 
Seat 8: Troll8989 ($100 in chips) 
Seat 9: Sjtu_Michael ($111.44 in chips) 
mi$$I$Elena: posts small blind $0.50
Chen423: posts big blind $1
*** HOLE CARDS ***
Dealt to matiko09 [Kh 7d]
phil_cheng: folds 
Troll8989: folds 
Sjtu_Michael: folds 
mbk88: raises $2 to $3
mavin80: folds 
matiko09: folds 
Eskimo Fox: folds 
mi$$I$Elena: folds 
Chen423: raises $7 to $10
mbk88: calls $7
*** FLOP *** [Qh 9h Kc]
Chen423: bets $9.74
mbk88: raises $15.26 to $25
Chen423: calls $15.26
*** TURN *** [Qh 9h Kc] [2s]
Chen423: checks 
mbk88: bets $65 and is all-in
Chen423: calls $45 and is all-in
Uncalled bet ($20) returned to mbk88
mavin80 is disconnected 
*** FIRST RIVER *** [Qh 9h Kc 2s] [8s]
*** SECOND RIVER *** [Qh 9h Kc 2s] [4c]
*** FIRST SHOW DOWN ***
Chen423: shows [Ac Ah] (a pair of Aces)
mbk88: shows [Qd Qs] (three of a kind, Queens)
mbk88 collected $79 from pot
*** SECOND SHOW DOWN ***
Chen423: shows [Ac Ah] (a pair of Aces)
mbk88: shows [Qd Qs] (three of a kind, Queens)
mbk88 collected $79 from pot
*** SUMMARY ***
Total pot $160.50 | Rake $2.50 
Hand was run twice
FIRST Board [Qh 9h Kc 2s 8s]
SECOND Board [Qh 9h Kc 2s 4c]
Seat 1: mbk88 showed [Qd Qs] and won ($79) with three of a kind, Queens, and won ($79) with three of a kind, Queens
Seat 2: mavin80 folded before Flop (didn't bet)
Seat 3: matiko09 folded before Flop (didn't bet)
Seat 4: Eskimo Fox (button) folded before Flop (didn't bet)
Seat 5: mi$$I$Elena (small blind) folded before Flop
Seat 6: Chen423 (big blind) showed [Ac Ah] and lost with a pair of Aces, and lost with a pair of Aces
Seat 7: phil_cheng folded before Flop (didn't bet)
Seat 8: Troll8989 folded before Flop (didn't bet)
Seat 9: Sjtu_Michael folded before Flop (didn't bet)





PokerStars Hand #155013383804:  Hold'em No Limit ($0.50/$1.00 USD) - 2016/06/21 13:28:47 CET [2016/06/21 7:28:47 ET]
Table 'Saldanha' 9-max Seat #4 is the button
Seat 1: phil_cheng ($100 in chips) 
Seat 2: matiko09 ($387 in chips) 
Seat 3: wisbc ($100.80 in chips) 
Seat 4: CoolFireX ($100 in chips) 
Seat 5: Michael Quan ($125.29 in chips) 
Seat 6: Donetsk1y ($100 in chips) 
Seat 7: ozone2003 ($100 in chips) 
Seat 8: erick222 ($100 in chips) 
Michael Quan: posts small blind $0.50
Donetsk1y: posts big blind $1
23SmOkEr07: sits out 
phil_cheng: posts the ante $0.20
matiko09: posts the ante $0.20
wisbc: posts the ante $0.20
CoolFireX: posts the ante $0.20
Michael Quan: posts the ante $0.20
Donetsk1y: posts the ante $0.20
ozone2003: posts the ante $0.20
erick222: posts the ante $0.20
*** HOLE CARDS ***
Dealt to matiko09 [Kh 5c]
ozone2003: folds 
erick222: folds 
phil_cheng: raises $2 to $3
matiko09: folds 
wisbc: folds 
CoolFireX: folds 
Michael Quan: folds 
Donetsk1y: folds 
Uncalled bet ($2) returned to phil_cheng
phil_cheng collected $4.10 from pot
phil_cheng: doesn't show hand 
*** SUMMARY ***
Total pot $4.10 | Rake $0 
Seat 1: phil_cheng collected ($4.10)
Seat 2: matiko09 folded before Flop (didn't bet)
Seat 3: wisbc folded before Flop (didn't bet)
Seat 4: CoolFireX (button) folded before Flop (didn't bet)
Seat 5: Michael Quan (small blind) folded before Flop
Seat 6: Donetsk1y (big blind) folded before Flop
Seat 7: ozone2003 folded before Flop (didn't bet)
Seat 8: erick222 folded before Flop (didn't bet)





PokerStars Hand #155013388789:  Hold'em No Limit ($0.50/$1.00 USD) - 2016/06/21 13:28:59 CET [2016/06/21 7:28:59 ET]
Table 'Chimay' 9-max Seat #9 is the button
Seat 1: phil_cheng ($105 in chips) 
Seat 2: pyromid ($142.98 in chips) 
Seat 3: maxxmeister ($100 in chips) 
Seat 4: fukumimi ($100 in chips) 
Seat 5: The Big Ape ($98.50 in chips) 
Seat 6: mbk88 ($148.47 in chips) 
Seat 7: matiko09 ($111.22 in chips) 
Seat 8: Eskimo Fox ($137.80 in chips) 
Seat 9: SharingaaN ($107.49 in chips) 
phil_cheng: posts small blind $0.50
pyromid: posts big blind $1
*** HOLE CARDS ***
Dealt to matiko09 [Kd 7h]
maxxmeister: folds 
fukumimi: folds 
The Big Ape: raises $1 to $2
mbk88: folds 
matiko09: folds 
Eskimo Fox: folds 
SharingaaN: raises $5 to $7
phil_cheng: folds 
pyromid: folds 
The Big Ape: folds 
Uncalled bet ($5) returned to SharingaaN
SharingaaN collected $5.50 from pot
SharingaaN: doesn't show hand 
*** SUMMARY ***
Total pot $5.50 | Rake $0 
Seat 1: phil_cheng (small blind) folded before Flop
Seat 2: pyromid (big blind) folded before Flop
Seat 3: maxxmeister folded before Flop (didn't bet)
Seat 4: fukumimi folded before Flop (didn't bet)
Seat 5: The Big Ape folded before Flop
Seat 6: mbk88 folded before Flop (didn't bet)
Seat 7: matiko09 folded before Flop (didn't bet)
Seat 8: Eskimo Fox folded before Flop (didn't bet)
Seat 9: SharingaaN (button) collected ($5.50)





PokerStars Hand #155013392810:  Hold'em No Limit ($0.50/$1.00 USD) - 2016/06/21 13:29:08 CET [2016/06/21 7:29:08 ET]
Table 'Admete II' 9-max Seat #5 is the button
Seat 2: Eskimo Fox ($174.92 in chips) 
Seat 4: krustophsky ($91.70 in chips) 
Seat 5: mi$$I$Elena ($100 in chips) 
Seat 6: mbk88 ($127.50 in chips) 
Seat 7: matiko09 ($106.06 in chips) 
Seat 8: koutani7 ($93.50 in chips) 
Seat 9: ozone2003 ($100 in chips) 
mbk88: posts small blind $0.50
matiko09: posts big blind $1
Donetsk1y: is sitting out 
Donetsk1y leaves the table
*** HOLE CARDS ***
Dealt to matiko09 [Ad Ks]
phil_cheng joins the table at seat #1 
koutani7: folds 
ozone2003: raises $2 to $3
Eskimo Fox: calls $3
krustophsky: calls $3
mi$$I$Elena: folds 
mbk88: folds 
matiko09: raises $12 to $15
ozone2003: calls $12
Eskimo Fox: folds 
krustophsky: raises $76.70 to $91.70 and is all-in
matiko09: raises $14.36 to $106.06 and is all-in
ozone2003: folds 
Uncalled bet ($14.36) returned to matiko09
*** FLOP *** [5s Td 5d]
*** TURN *** [5s Td 5d] [6h]
*** RIVER *** [5s Td 5d 6h] [5h]
*** SHOW DOWN ***
matiko09: shows [Ad Ks] (three of a kind, Fives)
krustophsky: shows [8c 8h] (a full house, Fives full of Eights)
krustophsky collected $199.40 from pot
*** SUMMARY ***
Total pot $201.90 | Rake $2.50 
Board [5s Td 5d 6h 5h]
Seat 2: Eskimo Fox folded before Flop
Seat 4: krustophsky showed [8c 8h] and won ($199.40) with a full house, Fives full of Eights
Seat 5: mi$$I$Elena (button) folded before Flop (didn't bet)
Seat 6: mbk88 (small blind) folded before Flop
Seat 7: matiko09 (big blind) showed [Ad Ks] and lost with three of a kind, Fives
Seat 8: koutani7 folded before Flop (didn't bet)
Seat 9: ozone2003 folded before Flop





PokerStars Hand #155013396277:  Hold'em No Limit ($0.50/$1.00 USD) - 2016/06/21 13:29:17 CET [2016/06/21 7:29:17 ET]
Table 'Rupertwildt' 9-max Seat #9 is the button
Seat 2: SharingaaN ($103.05 in chips) 
Seat 3: Troll8989 ($100 in chips) 
Seat 4: matiko09 ($144.68 in chips) 
Seat 5: pyromid ($86.50 in chips) 
Seat 6: phil_cheng ($118.22 in chips) 
Seat 8: Gonzanary ($96.29 in chips) 
Seat 9: mbk88 ($100 in chips) 
SharingaaN: posts small blind $0.50
Troll8989: posts big blind $1
Donetsk1y: sits out 
*** HOLE CARDS ***
Dealt to matiko09 [2s Qd]
matiko09: folds 
pyromid: folds 
phil_cheng: folds 
Gonzanary: folds 
mbk88: raises $1 to $2
SharingaaN: folds 
Troll8989: folds 
Uncalled bet ($1) returned to mbk88
mbk88 collected $2.50 from pot
mbk88: doesn't show hand 
*** SUMMARY ***
Total pot $2.50 | Rake $0 
Seat 2: SharingaaN (small blind) folded before Flop
Seat 3: Troll8989 (big blind) folded before Flop
Seat 4: matiko09 folded before Flop (didn't bet)
Seat 5: pyromid folded before Flop (didn't bet)
Seat 6: phil_cheng folded before Flop (didn't bet)
Seat 8: Gonzanary folded before Flop (didn't bet)
Seat 9: mbk88 (button) collected ($2.50)





PokerStars Hand #155013398464:  Hold'em No Limit ($0.50/$1.00 USD) - 2016/06/21 13:29:22 CET [2016/06/21 7:29:22 ET]
Table 'Moreau' 9-max Seat #6 is the button
Seat 1: ozone2003 ($130.49 in chips) 
Seat 2: Avtovo ($106 in chips) 
Seat 3: matiko09 ($116.88 in chips) 
Seat 4: SharingaaN ($101 in chips) 
Seat 6: Troll8989 ($100 in chips) 
Seat 7: PanKwn15 ($100.39 in chips) 
PanKwn15: posts small blind $0.50
ozone2003: posts big blind $1
*** HOLE CARDS ***
Dealt to matiko09 [5s 5c]
Avtovo: folds 
matiko09: raises $2 to $3
SharingaaN: folds 
Troll8989: folds 
PanKwn15: folds 
ozone2003: folds 
Uncalled bet ($2) returned to matiko09
matiko09 collected $2.50 from pot
matiko09: doesn't show hand 
*** SUMMARY ***
Total pot $2.50 | Rake $0 
Seat 1: ozone2003 (big blind) folded before Flop
Seat 2: Avtovo folded before Flop (didn't bet)
Seat 3: matiko09 collected ($2.50)
Seat 4: SharingaaN folded before Flop (didn't bet)
Seat 6: Troll8989 (button) folded before Flop (didn't bet)
Seat 7: PanKwn15 (small blind) folded before Flop





PokerStars Hand #155013399375:  Hold'em No Limit ($0.50/$1.00 USD) - 2016/06/21 13:29:24 CET [2016/06/21 7:29:24 ET]
Table 'Carlova II' 9-max Seat #7 is the button
Seat 1: matiko09 ($109.80 in chips) 
Seat 2: mbk88 ($131.65 in chips) 
Seat 4: Dandy Monk ($87.98 in chips) 
Seat 5: ozone2003 ($109.05 in chips) 
Seat 6: phil_cheng ($100 in chips) 
Seat 7: mi$$I$Elena ($119.75 in chips) 
Seat 8: pyromid ($107.80 in chips) 
Seat 9: Troll8989 ($101.50 in chips) 
pyromid: posts small blind $0.50
Troll8989: posts big blind $1
SharingaaN: sits out 
*** HOLE CARDS ***
Dealt to matiko09 [6h 8s]
matiko09: folds 
mbk88: raises $2 to $3
Dandy Monk: folds 
ozone2003: folds 
phil_cheng: folds 
mi$$I$Elena: folds 
pyromid: folds 
Troll8989: folds 
Uncalled bet ($2) returned to mbk88
mbk88 collected $2.50 from pot
mbk88: doesn't show hand 
*** SUMMARY ***
Total pot $2.50 | Rake $0 
Seat 1: matiko09 folded before Flop (didn't bet)
Seat 2: mbk88 collected ($2.50)
Seat 4: Dandy Monk folded before Flop (didn't bet)
Seat 5: ozone2003 folded before Flop (didn't bet)
Seat 6: phil_cheng folded before Flop (didn't bet)
Seat 7: mi$$I$Elena (button) folded before Flop (didn't bet)
Seat 8: pyromid (small blind) folded before Flop
Seat 9: Troll8989 (big blind) folded before Flop





PokerStars Hand #155013399629:  Hold'em No Limit ($0.50/$1.00 USD) - 2016/06/21 13:29:24 CET [2016/06/21 7:29:24 ET]
Table 'Leo' 9-max Seat #6 is the button
Seat 1: fukumimi ($106.54 in chips) 
Seat 3: matiko09 ($100 in chips) 
Seat 4: phil_cheng ($107.33 in chips) 
Seat 5: Troll8989 ($103.52 in chips) 
Seat 6: Avtovo ($100 in chips) 
Seat 7: CoolFireX ($260.20 in chips) 
Seat 8: pyromid ($92.42 in chips) 
Seat 9: Wladimir205 ($116.54 in chips) 
CoolFireX: posts small blind $0.50
pyromid: posts big blind $1
mbk88: sits out 
*** HOLE CARDS ***
Dealt to matiko09 [3s 3d]
Wladimir205: raises $1 to $2
fukumimi: calls $2
matiko09: calls $2
phil_cheng: folds 
Troll8989: folds 
Avtovo: folds 
CoolFireX: folds 
pyromid: calls $1
*** FLOP *** [2s Qs Kc]
pyromid: checks 
Wladimir205: checks 
fukumimi: checks 
matiko09: checks 
*** TURN *** [2s Qs Kc] [8d]
pyromid: checks 
Wladimir205: checks 
fukumimi: checks 
matiko09: checks 
*** RIVER *** [2s Qs Kc 8d] [4c]
pyromid: checks 
Wladimir205: bets $4.04
fukumimi: folds 
matiko09: folds 
pyromid: folds 
Uncalled bet ($4.04) returned to Wladimir205
Wladimir205 collected $8.08 from pot
Wladimir205: doesn't show hand 
*** SUMMARY ***
Total pot $8.50 | Rake $0.42 
Board [2s Qs Kc 8d 4c]
Seat 1: fukumimi folded on the River
Seat 3: matiko09 folded on the River
Seat 4: phil_cheng folded before Flop (didn't bet)
Seat 5: Troll8989 folded before Flop (didn't bet)
Seat 6: Avtovo (button) folded before Flop (didn't bet)
Seat 7: CoolFireX (small blind) folded before Flop
Seat 8: pyromid (big blind) folded on the River
Seat 9: Wladimir205 collected ($8.08)





PokerStars Hand #155013403413:  Hold'em No Limit ($0.50/$1.00 USD) - 2016/06/21 13:29:33 CET [2016/06/21 7:29:33 ET]
Table 'Rupertwildt' 9-max Seat #2 is the button
Seat 2: SharingaaN ($102.55 in chips) 
Seat 3: Troll8989 ($100 in chips) 
Seat 4: matiko09 ($144.68 in chips) 
Seat 5: pyromid ($86.50 in chips) 
Seat 6: phil_cheng ($118.22 in chips) 
Seat 8: Gonzanary ($100 in chips) 
Seat 9: mbk88 ($101.50 in chips) 
Troll8989: posts small blind $0.50
matiko09: posts big blind $1
Donetsk1y: sits out 
*** HOLE CARDS ***
Dealt to matiko09 [2d 4d]
pyromid: folds 
phil_cheng: folds 
Gonzanary: folds 
mbk88: folds 
SharingaaN: folds 
Troll8989: raises $1.50 to $2.50
matiko09: folds 
Uncalled bet ($1.50) returned to Troll8989
Troll8989 collected $2 from pot
Troll8989: doesn't show hand 
*** SUMMARY ***
Total pot $2 | Rake $0 
Seat 2: SharingaaN (button) folded before Flop (didn't bet)
Seat 3: Troll8989 (small blind) collected ($2)
Seat 4: matiko09 (big blind) folded before Flop
Seat 5: pyromid folded before Flop (didn't bet)
Seat 6: phil_cheng folded before Flop (didn't bet)
Seat 8: Gonzanary folded before Flop (didn't bet)
Seat 9: mbk88 folded before Flop (didn't bet)





PokerStars Hand #155013405395:  Hold'em No Limit (€0.25/€0.50 EUR) - 2016/06/21 13:29:38 CET [2016/06/21 7:29:38 ET]
Table 'Actor II' 6-max Seat #1 is the button
Seat 1: hmverlin (€89.85 in chips) 
Seat 2: alôha (€58.08 in chips) 
Seat 3: asmodej666 (€80.31 in chips) 
Seat 4: matiko09 (€64.50 in chips) 
Seat 5: Rybka1294 (€50 in chips) 
Seat 6: fanmtZ (€20 in chips) 
alôha: posts small blind €0.25
asmodej666: posts big blind €0.50
*** HOLE CARDS ***
Dealt to matiko09 [7s 2c]
matiko09: folds 
Rybka1294: folds 
fanmtZ: folds 
hmverlin: raises €1 to €1.50
alôha: folds 
asmodej666: calls €1
*** FLOP *** [5s Ts Jc]
asmodej666: checks 
hmverlin: bets €1.50
asmodej666: folds 
Uncalled bet (€1.50) returned to hmverlin
hmverlin collected €3.09 from pot
hmverlin: doesn't show hand 
*** SUMMARY ***
Total pot €3.25 | Rake €0.16 
Board [5s Ts Jc]
Seat 1: hmverlin (button) collected (€3.09)
Seat 2: alôha (small blind) folded before Flop
Seat 3: asmodej666 (big blind) folded on the Flop
Seat 4: matiko09 folded before Flop (didn't bet)
Seat 5: Rybka1294 folded before Flop (didn't bet)
Seat 6: fanmtZ folded before Flop (didn't bet)





PokerStars Hand #155013407876:  Hold'em No Limit ($0.50/$1.00 USD) - 2016/06/21 13:29:44 CET [2016/06/21 7:29:44 ET]
Table 'Moreau' 9-max Seat #7 is the button
Seat 1: ozone2003 ($129.49 in chips) 
Seat 2: Avtovo ($106 in chips) 
Seat 3: matiko09 ($118.38 in chips) 
Seat 4: SharingaaN ($101 in chips) 
Seat 6: Troll8989 ($100 in chips) 
Seat 7: PanKwn15 ($99.89 in chips) 
Toonersens will be allowed to play after the button
ozone2003: posts small blind $0.50
Avtovo: posts big blind $1
*** HOLE CARDS ***
Dealt to matiko09 [2d 3h]
matiko09: folds 
SharingaaN: folds 
Troll8989: folds 
PanKwn15: folds 
ozone2003: folds 
Uncalled bet ($0.50) returned to Avtovo
Avtovo collected $1 from pot
Avtovo: doesn't show hand 
*** SUMMARY ***
Total pot $1 | Rake $0 
Seat 1: ozone2003 (small blind) folded before Flop
Seat 2: Avtovo (big blind) collected ($1)
Seat 3: matiko09 folded before Flop (didn't bet)
Seat 4: SharingaaN folded before Flop (didn't bet)
Seat 6: Troll8989 folded before Flop (didn't bet)
Seat 7: PanKwn15 (button) folded before Flop (didn't bet)





PokerStars Hand #155013409848:  Hold'em No Limit ($0.50/$1.00 USD) - 2016/06/21 13:29:48 CET [2016/06/21 7:29:48 ET]
Table 'Saldanha' 9-max Seat #5 is the button
Seat 1: phil_cheng ($102.90 in chips) 
Seat 2: matiko09 ($386.80 in chips) 
Seat 3: wisbc ($100.60 in chips) 
Seat 4: CoolFireX ($100 in chips) 
Seat 5: Michael Quan ($124.59 in chips) 
Seat 6: Donetsk1y ($100 in chips) 
Seat 7: ozone2003 ($100 in chips) 
Seat 8: erick222 ($100 in chips) 
Donetsk1y: posts small blind $0.50
ozone2003: posts big blind $1
23SmOkEr07: sits out 
phil_cheng: posts the ante $0.20
matiko09: posts the ante $0.20
wisbc: posts the ante $0.20
CoolFireX: posts the ante $0.20
Michael Quan: posts the ante $0.20
Donetsk1y: posts the ante $0.20
ozone2003: posts the ante $0.20
erick222: posts the ante $0.20
*** HOLE CARDS ***
Dealt to matiko09 [4s Jd]
erick222: folds 
phil_cheng: folds 
matiko09: folds 
wisbc: folds 
CoolFireX: folds 
Michael Quan: folds 
Donetsk1y: raises $2 to $3
ozone2003: folds 
Uncalled bet ($2) returned to Donetsk1y
Donetsk1y collected $3.60 from pot
Donetsk1y: doesn't show hand 
*** SUMMARY ***
Total pot $3.60 | Rake $0 
Seat 1: phil_cheng folded before Flop (didn't bet)
Seat 2: matiko09 folded before Flop (didn't bet)
Seat 3: wisbc folded before Flop (didn't bet)
Seat 4: CoolFireX folded before Flop (didn't bet)
Seat 5: Michael Quan (button) folded before Flop (didn't bet)
Seat 6: Donetsk1y (small blind) collected ($3.60)
Seat 7: ozone2003 (big blind) folded before Flop
Seat 8: erick222 folded before Flop (didn't bet)





PokerStars Hand #155013412240:  Hold'em No Limit ($0.50/$1.00 USD) - 2016/06/21 13:29:54 CET [2016/06/21 7:29:54 ET]
Table 'Chimay' 9-max Seat #1 is the button
Seat 1: phil_cheng ($104.50 in chips) 
Seat 2: pyromid ($141.98 in chips) 
Seat 4: fukumimi ($100 in chips) 
Seat 5: The Big Ape ($96.50 in chips) 
Seat 6: mbk88 ($148.47 in chips) 
Seat 7: matiko09 ($111.22 in chips) 
Seat 8: Eskimo Fox ($137.80 in chips) 
Seat 9: SharingaaN ($110.99 in chips) 
pyromid: posts small blind $0.50
fukumimi: posts big blind $1
*** HOLE CARDS ***
Dealt to matiko09 [2h 7d]
The Big Ape: folds 
mbk88: folds 
matiko09: folds 
Eskimo Fox: folds 
SharingaaN: raises $1.80 to $2.80
phil_cheng: calls $2.80
pyromid: folds 
fukumimi: folds 
*** FLOP *** [As 8h 5d]
SharingaaN: checks 
phil_cheng: bets $4.49
SharingaaN: raises $7.86 to $12.35
phil_cheng: folds 
Uncalled bet ($7.86) returned to SharingaaN
SharingaaN collected $15.28 from pot
SharingaaN: doesn't show hand 
*** SUMMARY ***
Total pot $16.08 | Rake $0.80 
Board [As 8h 5d]
Seat 1: phil_cheng (button) folded on the Flop
Seat 2: pyromid (small blind) folded before Flop
Seat 4: fukumimi (big blind) folded before Flop
Seat 5: The Big Ape folded before Flop (didn't bet)
Seat 6: mbk88 folded before Flop (didn't bet)
Seat 7: matiko09 folded before Flop (didn't bet)
Seat 8: Eskimo Fox folded before Flop (didn't bet)
Seat 9: SharingaaN collected ($15.28)





PokerStars Hand #155013413213:  Hold'em No Limit ($0.50/$1.00 USD) - 2016/06/21 13:29:56 CET [2016/06/21 7:29:56 ET]
Table 'Carlova II' 9-max Seat #8 is the button
Seat 1: matiko09 ($109.80 in chips) 
Seat 2: mbk88 ($133.15 in chips) 
Seat 4: Dandy Monk ($87.98 in chips) 
Seat 5: ozone2003 ($109.05 in chips) 
Seat 6: phil_cheng ($100 in chips) 
Seat 7: mi$$I$Elena ($119.75 in chips) 
Seat 8: pyromid ($107.30 in chips) 
Seat 9: Troll8989 ($100.50 in chips) 
Troll8989: posts small blind $0.50
matiko09: posts big blind $1
SharingaaN: sits out 
*** HOLE CARDS ***
Dealt to matiko09 [5s 6h]
mbk88: folds 
Dandy Monk: raises $2 to $3
ozone2003: folds 
phil_cheng: folds 
mi$$I$Elena: folds 
pyromid: folds 
Troll8989: folds 
matiko09: folds 
Uncalled bet ($2) returned to Dandy Monk
Dandy Monk collected $2.50 from pot
Dandy Monk: doesn't show hand 
*** SUMMARY ***
Total pot $2.50 | Rake $0 
Seat 1: matiko09 (big blind) folded before Flop
Seat 2: mbk88 folded before Flop (didn't bet)
Seat 4: Dandy Monk collected ($2.50)
Seat 5: ozone2003 folded before Flop (didn't bet)
Seat 6: phil_cheng folded before Flop (didn't bet)
Seat 7: mi$$I$Elena folded before Flop (didn't bet)
Seat 8: pyromid (button) folded before Flop (didn't bet)
Seat 9: Troll8989 (small blind) folded before Flop





PokerStars Hand #155013413980:  Hold'em No Limit ($0.50/$1.00 USD) - 2016/06/21 13:29:58 CET [2016/06/21 7:29:58 ET]
Table 'Moreau' 9-max Seat #1 is the button
Seat 1: ozone2003 ($128.99 in chips) 
Seat 2: Avtovo ($106.50 in chips) 
Seat 3: matiko09 ($118.38 in chips) 
Seat 4: SharingaaN ($101 in chips) 
Seat 6: Troll8989 ($100 in chips) 
Seat 7: PanKwn15 ($99.89 in chips) 
Seat 9: Toonersens ($103.92 in chips) 
Avtovo: posts small blind $0.50
matiko09: posts big blind $1
Toonersens: posts small & big blinds $1.50
*** HOLE CARDS ***
Dealt to matiko09 [As 5s]
SharingaaN: folds 
Troll8989: folds 
PanKwn15: folds 
Toonersens: checks 
ozone2003: folds 
Avtovo: folds 
matiko09: raises $3.50 to $4.50
Toonersens: calls $3.50
*** FLOP *** [6s 5h 4d]
matiko09: checks 
Toonersens: bets $5
matiko09: calls $5
*** TURN *** [6s 5h 4d] [7c]
matiko09: checks 
Toonersens: checks 
*** RIVER *** [6s 5h 4d 7c] [Qh]
matiko09: checks 
Toonersens: checks 
*** SHOW DOWN ***
matiko09: shows [As 5s] (a pair of Fives)
Toonersens: shows [Ah 3h] (a straight, Three to Seven)
Toonersens collected $19 from pot
*** SUMMARY ***
Total pot $20 | Rake $1 
Board [6s 5h 4d 7c Qh]
Seat 1: ozone2003 (button) folded before Flop (didn't bet)
Seat 2: Avtovo (small blind) folded before Flop
Seat 3: matiko09 (big blind) showed [As 5s] and lost with a pair of Fives
Seat 4: SharingaaN folded before Flop (didn't bet)
Seat 6: Troll8989 folded before Flop (didn't bet)
Seat 7: PanKwn15 folded before Flop (didn't bet)
Seat 9: Toonersens showed [Ah 3h] and won ($19) with a straight, Three to Seven





PokerStars Hand #155013414021:  Hold'em No Limit ($0.50/$1.00 USD) - 2016/06/21 13:29:58 CET [2016/06/21 7:29:58 ET]
Table 'Rupertwildt' 9-max Seat #3 is the button
Seat 2: SharingaaN ($102.55 in chips) 
Seat 3: Troll8989 ($101 in chips) 
Seat 4: matiko09 ($143.68 in chips) 
Seat 5: pyromid ($86.50 in chips) 
Seat 6: phil_cheng ($118.22 in chips) 
Seat 8: Gonzanary ($100 in chips) 
Seat 9: mbk88 ($101.50 in chips) 
matiko09: posts small blind $0.50
pyromid: posts big blind $1
Donetsk1y: sits out 
*** HOLE CARDS ***
Dealt to matiko09 [Qs Jh]
phil_cheng: raises $2 to $3
Gonzanary: folds 
mbk88: calls $3
SharingaaN: folds 
Troll8989: folds 
matiko09: folds 
pyromid: folds 
*** FLOP *** [Ts 6s As]
phil_cheng: checks 
mbk88: checks 
*** TURN *** [Ts 6s As] [3h]
phil_cheng: bets $3.56
mbk88: folds 
Uncalled bet ($3.56) returned to phil_cheng
phil_cheng collected $7.12 from pot
phil_cheng: doesn't show hand 
*** SUMMARY ***
Total pot $7.50 | Rake $0.38 
Board [Ts 6s As 3h]
Seat 2: SharingaaN folded before Flop (didn't bet)
Seat 3: Troll8989 (button) folded before Flop (didn't bet)
Seat 4: matiko09 (small blind) folded before Flop
Seat 5: pyromid (big blind) folded before Flop
Seat 6: phil_cheng collected ($7.12)
Seat 8: Gonzanary folded before Flop (didn't bet)
Seat 9: mbk88 folded on the Turn





PokerStars Hand #155013425176:  Hold'em No Limit (€0.25/€0.50 EUR) - 2016/06/21 13:30:23 CET [2016/06/21 7:30:23 ET]
Table 'Actor II' 6-max Seat #2 is the button
Seat 1: hmverlin (€91.44 in chips) 
Seat 2: alôha (€57.83 in chips) 
Seat 3: asmodej666 (€78.81 in chips) 
Seat 4: matiko09 (€64.50 in chips) 
Seat 5: Rybka1294 (€50 in chips) 
Seat 6: fanmtZ (€20 in chips) 
asmodej666: posts small blind €0.25
matiko09: posts big blind €0.50
*** HOLE CARDS ***
Dealt to matiko09 [4c Td]
Rybka1294 is disconnected 
Rybka1294 has timed out while disconnected
Rybka1294: folds 
fanmtZ: raises €0.69 to €1.19
hmverlin: calls €1.19
alôha: calls €1.19
asmodej666: folds 
matiko09: folds 
*** FLOP *** [Ac Qd 6d]
fanmtZ: bets €2.25
hmverlin: calls €2.25
alôha: folds 
*** TURN *** [Ac Qd 6d] [Ah]
fanmtZ: checks 
hmverlin: bets €3
fanmtZ: calls €3
*** RIVER *** [Ac Qd 6d Ah] [Ad]
fanmtZ: checks 
hmverlin: bets €5
fanmtZ: calls €5
*** SHOW DOWN ***
hmverlin: shows [As 8d] (four of a kind, Aces)
fanmtZ: mucks hand 
hmverlin collected €23.58 from pot
*** SUMMARY ***
Total pot €24.82 | Rake €1.24 
Board [Ac Qd 6d Ah Ad]
Seat 1: hmverlin showed [As 8d] and won (€23.58) with four of a kind, Aces
Seat 2: alôha (button) folded on the Flop
Seat 3: asmodej666 (small blind) folded before Flop
Seat 4: matiko09 (big blind) folded before Flop
Seat 5: Rybka1294 folded before Flop (didn't bet)
Seat 6: fanmtZ mucked [Qc Tc]





PokerStars Hand #155013425867:  Hold'em No Limit ($0.50/$1.00 USD) - 2016/06/21 13:30:25 CET [2016/06/21 7:30:25 ET]
Table 'Saldanha' 9-max Seat #6 is the button
Seat 1: phil_cheng ($102.70 in chips) 
Seat 2: matiko09 ($386.60 in chips) 
Seat 3: wisbc ($100.40 in chips) 
Seat 4: CoolFireX ($100 in chips) 
Seat 5: Michael Quan ($124.39 in chips) 
Seat 6: Donetsk1y ($102.40 in chips) 
Seat 7: ozone2003 ($100 in chips) 
Seat 8: erick222 ($100 in chips) 
ozone2003: posts small blind $0.50
erick222: posts big blind $1
23SmOkEr07: sits out 
phil_cheng: posts the ante $0.20
matiko09: posts the ante $0.20
wisbc: posts the ante $0.20
CoolFireX: posts the ante $0.20
Michael Quan: posts the ante $0.20
Donetsk1y: posts the ante $0.20
ozone2003: posts the ante $0.20
erick222: posts the ante $0.20
*** HOLE CARDS ***
Dealt to matiko09 [Jc 9h]
phil_cheng: raises $2 to $3
matiko09: folds 
wisbc: calls $3
CoolFireX: raises $9 to $12
Michael Quan: folds 
Donetsk1y: folds 
ozone2003: raises $12.50 to $24.50
erick222: folds 
phil_cheng: folds 
wisbc: folds 
CoolFireX: folds 
Uncalled bet ($12.50) returned to ozone2003
ozone2003 collected $32.60 from pot
ozone2003: doesn't show hand 
*** SUMMARY ***
Total pot $32.60 | Rake $0 
Seat 1: phil_cheng folded before Flop
Seat 2: matiko09 folded before Flop (didn't bet)
Seat 3: wisbc folded before Flop
Seat 4: CoolFireX folded before Flop
Seat 5: Michael Quan folded before Flop (didn't bet)
Seat 6: Donetsk1y (button) folded before Flop (didn't bet)
Seat 7: ozone2003 (small blind) collected ($32.60)
Seat 8: erick222 (big blind) folded before Flop





PokerStars Hand #155013429204:  Hold'em No Limit ($0.50/$1.00 USD) - 2016/06/21 13:30:33 CET [2016/06/21 7:30:33 ET]
Table 'Admete II' 9-max Seat #6 is the button
Seat 2: Eskimo Fox ($171.92 in chips) 
Seat 4: krustophsky ($199.40 in chips) 
Seat 5: mi$$I$Elena ($100 in chips) 
Seat 6: mbk88 ($127 in chips) 
Seat 7: matiko09 ($100 in chips) 
Seat 8: koutani7 ($93.50 in chips) 
Seat 9: ozone2003 ($100 in chips) 
matiko09: posts small blind $0.50
koutani7: posts big blind $1
phil_cheng: sits out 
*** HOLE CARDS ***
Dealt to matiko09 [Kc 8d]
ozone2003: folds 
ozone2003 leaves the table
Eskimo Fox: folds 
krustophsky: raises $2.50 to $3.50
mi$$I$Elena: folds 
CoolFireX joins the table at seat #9 
mbk88: raises $6.50 to $10
matiko09: folds 
koutani7: folds 
krustophsky: calls $6.50
*** FLOP *** [Qc 6s 5h]
krustophsky: checks 
mbk88: bets $15
krustophsky: calls $15
*** TURN *** [Qc 6s 5h] [8c]
krustophsky: checks 
mbk88: bets $32
phil_cheng leaves the table
krustophsky: raises $85 to $117
mbk88: calls $70 and is all-in
Uncalled bet ($15) returned to krustophsky
*** RIVER *** [Qc 6s 5h 8c] [9c]
*** SHOW DOWN ***
krustophsky: shows [Qs Ks] (a pair of Queens)
mbk88: shows [Ad As] (a pair of Aces)
mbk88 collected $253 from pot
*** SUMMARY ***
Total pot $255.50 | Rake $2.50 
Board [Qc 6s 5h 8c 9c]
Seat 2: Eskimo Fox folded before Flop (didn't bet)
Seat 4: krustophsky showed [Qs Ks] and lost with a pair of Queens
Seat 5: mi$$I$Elena folded before Flop (didn't bet)
Seat 6: mbk88 (button) showed [Ad As] and won ($253) with a pair of Aces
Seat 7: matiko09 (small blind) folded before Flop
Seat 8: koutani7 (big blind) folded before Flop
Seat 9: ozone2003 folded before Flop (didn't bet)





PokerStars Hand #155013433233:  Hold'em No Limit ($0.50/$1.00 USD) - 2016/06/21 13:30:42 CET [2016/06/21 7:30:42 ET]
Table 'Carlova II' 9-max Seat #9 is the button
Seat 1: matiko09 ($108.80 in chips) 
Seat 2: mbk88 ($133.15 in chips) 
Seat 4: Dandy Monk ($89.48 in chips) 
Seat 5: ozone2003 ($109.05 in chips) 
Seat 6: phil_cheng ($100 in chips) 
Seat 7: mi$$I$Elena ($119.75 in chips) 
Seat 8: pyromid ($107.30 in chips) 
Seat 9: Troll8989 ($100 in chips) 
matiko09: posts small blind $0.50
mbk88: posts big blind $1
SharingaaN: sits out 
*** HOLE CARDS ***
Dealt to matiko09 [7h 2c]
Dandy Monk: folds 
ozone2003: folds 
phil_cheng: folds 
mi$$I$Elena: folds 
pyromid: folds 
Troll8989: folds 
matiko09: folds 
Uncalled bet ($0.50) returned to mbk88
mbk88 collected $1 from pot
mbk88: doesn't show hand 
*** SUMMARY ***
Total pot $1 | Rake $0 
Seat 1: matiko09 (small blind) folded before Flop
Seat 2: mbk88 (big blind) collected ($1)
Seat 4: Dandy Monk folded before Flop (didn't bet)
Seat 5: ozone2003 folded before Flop (didn't bet)
Seat 6: phil_cheng folded before Flop (didn't bet)
Seat 7: mi$$I$Elena folded before Flop (didn't bet)
Seat 8: pyromid folded before Flop (didn't bet)
Seat 9: Troll8989 (button) folded before Flop (didn't bet)





PokerStars Hand #155013435360:  Hold'em No Limit (€0.50/€1.00 EUR) - 2016/06/21 13:30:47 CET [2016/06/21 7:30:47 ET]
Table 'Alkes' 9-max Seat #6 is the button
Seat 1: Ping_Ping14 (€52.66 in chips) 
Seat 2: matiko09 (€100 in chips) 
Seat 4: 50CandyJoe (€100 in chips) 
Seat 5: CoolFireX (€101.50 in chips) 
Seat 6: Filojoes (€100 in chips) 
Ping_Ping14: posts small blind €0.50
matiko09: posts big blind €1
erick222: sits out 
*** HOLE CARDS ***
Dealt to matiko09 [6c 6d]
50CandyJoe: raises €2 to €3
CoolFireX: calls €3
Filojoes: folds 
Ping_Ping14: folds 
matiko09: calls €2
*** FLOP *** [Qd 4h 2s]
el Fatto joins the table at seat #7 
matiko09: checks 
ozone2003 joins the table at seat #8 
50CandyJoe: checks 
CoolFireX: checks 
*** TURN *** [Qd 4h 2s] [8h]
matiko09: checks 
50CandyJoe: bets €6.76
CoolFireX: folds 
matiko09: folds 
Uncalled bet (€6.76) returned to 50CandyJoe
50CandyJoe collected €9.02 from pot
50CandyJoe: doesn't show hand 
*** SUMMARY ***
Total pot €9.50 | Rake €0.48 
Board [Qd 4h 2s 8h]
Seat 1: Ping_Ping14 (small blind) folded before Flop
Seat 2: matiko09 (big blind) folded on the Turn
Seat 4: 50CandyJoe collected (€9.02)
Seat 5: CoolFireX folded on the Turn
Seat 6: Filojoes (button) folded before Flop (didn't bet)





PokerStars Hand #155013437271:  Hold'em No Limit ($0.50/$1.00 USD) - 2016/06/21 13:30:51 CET [2016/06/21 7:30:51 ET]
Table 'Lamberta II' 9-max Seat #5 is the button
Seat 1: mbk88 ($178 in chips) 
Seat 2: mavin80 ($91.94 in chips) 
Seat 3: matiko09 ($100 in chips) 
Seat 4: Eskimo Fox ($119.41 in chips) 
Seat 5: mi$$I$Elena ($105.37 in chips) 
Seat 7: phil_cheng ($101.50 in chips) 
Seat 8: Troll8989 ($100 in chips) 
Seat 9: Sjtu_Michael ($111.44 in chips) 
phil_cheng: posts small blind $0.50
Troll8989: posts big blind $1
*** HOLE CARDS ***
Dealt to matiko09 [Js Qs]
Sjtu_Michael: folds 
mbk88: folds 
mavin80 has timed out while disconnected
mavin80: folds 
matiko09: raises $2 to $3
Eskimo Fox: calls $3
mi$$I$Elena: folds 
phil_cheng: calls $2.50
Troll8989: folds 
*** FLOP *** [Qd Jh 8s]
phil_cheng: checks 
matiko09: bets $6
Eskimo Fox: folds 
phil_cheng: calls $6
*** TURN *** [Qd Jh 8s] [Th]
phil_cheng: checks 
matiko09: checks 
*** RIVER *** [Qd Jh 8s Th] [As]
phil_cheng: bets $10.45
matiko09: folds 
Uncalled bet ($10.45) returned to phil_cheng
phil_cheng collected $20.90 from pot
phil_cheng: doesn't show hand 
*** SUMMARY ***
Total pot $22 | Rake $1.10 
Board [Qd Jh 8s Th As]
Seat 1: mbk88 folded before Flop (didn't bet)
Seat 2: mavin80 folded before Flop (didn't bet)
Seat 3: matiko09 folded on the River
Seat 4: Eskimo Fox folded on the Flop
Seat 5: mi$$I$Elena (button) folded before Flop (didn't bet)
Seat 7: phil_cheng (small blind) collected ($20.90)
Seat 8: Troll8989 (big blind) folded before Flop
Seat 9: Sjtu_Michael folded before Flop (didn't bet)





PokerStars Hand #155013439981:  Hold'em No Limit ($0.50/$1.00 USD) - 2016/06/21 13:30:58 CET [2016/06/21 7:30:58 ET]
Table 'Rupertwildt' 9-max Seat #4 is the button
Seat 2: SharingaaN ($102.55 in chips) 
Seat 3: Troll8989 ($101 in chips) 
Seat 4: matiko09 ($143.18 in chips) 
Seat 5: pyromid ($85.50 in chips) 
Seat 6: phil_cheng ($122.34 in chips) 
Seat 8: Gonzanary ($100 in chips) 
Seat 9: mbk88 ($100 in chips) 
pyromid: posts small blind $0.50
phil_cheng: posts big blind $1
Donetsk1y: sits out 
*** HOLE CARDS ***
Dealt to matiko09 [6d 2h]
Gonzanary: folds 
pokernixxx leaves the table
mbk88: folds 
SharingaaN: folds 
CoolFireX joins the table at seat #1 
Troll8989: raises $1.50 to $2.50
matiko09: folds 
pyromid: folds 
phil_cheng: folds 
Uncalled bet ($1.50) returned to Troll8989
Troll8989 collected $2.50 from pot
Troll8989: doesn't show hand 
*** SUMMARY ***
Total pot $2.50 | Rake $0 
Seat 2: SharingaaN folded before Flop (didn't bet)
Seat 3: Troll8989 collected ($2.50)
Seat 4: matiko09 (button) folded before Flop (didn't bet)
Seat 5: pyromid (small blind) folded before Flop
Seat 6: phil_cheng (big blind) folded before Flop
Seat 8: Gonzanary folded before Flop (didn't bet)
Seat 9: mbk88 folded before Flop (didn't bet)





PokerStars Hand #155013444259:  Hold'em No Limit ($0.50/$1.00 USD) - 2016/06/21 13:31:07 CET [2016/06/21 7:31:07 ET]
Table 'Carlova II' 9-max Seat #1 is the button
Seat 1: matiko09 ($108.30 in chips) 
Seat 2: mbk88 ($133.65 in chips) 
Seat 3: SharingaaN ($100 in chips) 
Seat 4: Dandy Monk ($89.48 in chips) 
Seat 5: ozone2003 ($109.05 in chips) 
Seat 6: phil_cheng ($100 in chips) 
Seat 7: mi$$I$Elena ($119.75 in chips) 
Seat 8: pyromid ($107.30 in chips) 
Seat 9: Troll8989 ($100 in chips) 
mbk88: posts small blind $0.50
SharingaaN: posts big blind $1
*** HOLE CARDS ***
Dealt to matiko09 [6s 6d]
Dandy Monk: raises $1 to $2
ozone2003: folds 
phil_cheng: folds 
mi$$I$Elena: folds 
pyromid: folds 
Troll8989: folds 
matiko09: calls $2
mbk88: folds 
SharingaaN: calls $1
*** FLOP *** [Tc Qs 3s]
SharingaaN: checks 
Dandy Monk: checks 
matiko09: checks 
*** TURN *** [Tc Qs 3s] [4d]
SharingaaN: bets $5.56
Dandy Monk: folds 
matiko09: folds 
Uncalled bet ($5.56) returned to SharingaaN
SharingaaN collected $6.18 from pot
SharingaaN: doesn't show hand 
*** SUMMARY ***
Total pot $6.50 | Rake $0.32 
Board [Tc Qs 3s 4d]
Seat 1: matiko09 (button) folded on the Turn
Seat 2: mbk88 (small blind) folded before Flop
Seat 3: SharingaaN (big blind) collected ($6.18)
Seat 4: Dandy Monk folded on the Turn
Seat 5: ozone2003 folded before Flop (didn't bet)
Seat 6: phil_cheng folded before Flop (didn't bet)
Seat 7: mi$$I$Elena folded before Flop (didn't bet)
Seat 8: pyromid folded before Flop (didn't bet)
Seat 9: Troll8989 folded before Flop (didn't bet)





PokerStars Hand #155013444853:  Hold'em No Limit ($0.50/$1.00 USD) - 2016/06/21 13:31:09 CET [2016/06/21 7:31:09 ET]
Table 'Chimay' 9-max Seat #2 is the button
Seat 1: phil_cheng ($100 in chips) 
Seat 2: pyromid ($141.48 in chips) 
Seat 4: fukumimi ($99 in chips) 
Seat 5: The Big Ape ($96.50 in chips) 
Seat 6: mbk88 ($148.47 in chips) 
Seat 7: matiko09 ($111.22 in chips) 
Seat 8: Eskimo Fox ($137.80 in chips) 
Seat 9: SharingaaN ($118.98 in chips) 
fukumimi: posts small blind $0.50
The Big Ape: posts big blind $1
*** HOLE CARDS ***
Dealt to matiko09 [Jd 8s]
mbk88: folds 
matiko09: folds 
Eskimo Fox: folds 
SharingaaN: raises $1.80 to $2.80
phil_cheng: folds 
pyromid: folds 
fukumimi: folds 
The Big Ape: folds 
Uncalled bet ($1.80) returned to SharingaaN
SharingaaN collected $2.50 from pot
SharingaaN: doesn't show hand 
*** SUMMARY ***
Total pot $2.50 | Rake $0 
Seat 1: phil_cheng folded before Flop (didn't bet)
Seat 2: pyromid (button) folded before Flop (didn't bet)
Seat 4: fukumimi (small blind) folded before Flop
Seat 5: The Big Ape (big blind) folded before Flop
Seat 6: mbk88 folded before Flop (didn't bet)
Seat 7: matiko09 folded before Flop (didn't bet)
Seat 8: Eskimo Fox folded before Flop (didn't bet)
Seat 9: SharingaaN collected ($2.50)





PokerStars Hand #155013451253:  Hold'em No Limit ($0.50/$1.00 USD) - 2016/06/21 13:31:23 CET [2016/06/21 7:31:23 ET]
Table 'Moreau' 9-max Seat #2 is the button
Seat 1: ozone2003 ($128.99 in chips) 
Seat 2: Avtovo ($106 in chips) 
Seat 3: matiko09 ($108.88 in chips) 
Seat 4: SharingaaN ($101 in chips) 
Seat 6: Troll8989 ($100 in chips) 
Seat 7: PanKwn15 ($99.89 in chips) 
Seat 9: Toonersens ($112.92 in chips) 
matiko09: posts small blind $0.50
SharingaaN: posts big blind $1
*** HOLE CARDS ***
Dealt to matiko09 [Jc 2d]
Troll8989: folds 
PanKwn15: folds 
Toonersens: folds 
ozone2003: raises $1.50 to $2.50
Avtovo: folds 
matiko09: folds 
SharingaaN: folds 
Uncalled bet ($1.50) returned to ozone2003
ozone2003 collected $2.50 from pot
ozone2003: doesn't show hand 
*** SUMMARY ***
Total pot $2.50 | Rake $0 
Seat 1: ozone2003 collected ($2.50)
Seat 2: Avtovo (button) folded before Flop (didn't bet)
Seat 3: matiko09 (small blind) folded before Flop
Seat 4: SharingaaN (big blind) folded before Flop
Seat 6: Troll8989 folded before Flop (didn't bet)
Seat 7: PanKwn15 folded before Flop (didn't bet)
Seat 9: Toonersens folded before Flop (didn't bet)





PokerStars Hand #155013452232:  Hold'em No Limit ($0.50/$1.00 USD) - 2016/06/21 13:31:26 CET [2016/06/21 7:31:26 ET]
Table 'Saldanha' 9-max Seat #7 is the button
Seat 1: phil_cheng ($100 in chips) 
Seat 2: matiko09 ($386.40 in chips) 
Seat 3: wisbc ($97.20 in chips) 
Seat 4: CoolFireX ($100 in chips) 
Seat 5: Michael Quan ($124.19 in chips) 
Seat 6: Donetsk1y ($102.20 in chips) 
Seat 7: ozone2003 ($120.40 in chips) 
Seat 8: erick222 ($100 in chips) 
Seat 9: 23SmOkEr07 ($100 in chips) 
erick222: posts small blind $0.50
23SmOkEr07: posts big blind $1
phil_cheng: posts the ante $0.20
matiko09: posts the ante $0.20
wisbc: posts the ante $0.20
CoolFireX: posts the ante $0.20
Michael Quan: posts the ante $0.20
Donetsk1y: posts the ante $0.20
ozone2003: posts the ante $0.20
erick222: posts the ante $0.20
23SmOkEr07: posts the ante $0.20
*** HOLE CARDS ***
Dealt to matiko09 [4h 4c]
phil_cheng: folds 
matiko09: folds 
wisbc: folds 
CoolFireX: raises $2 to $3
Michael Quan: raises $5 to $8
Donetsk1y: calls $8
ozone2003: folds 
erick222: folds 
23SmOkEr07: folds 
CoolFireX: calls $5
*** FLOP *** [5c Qc 3h]
CoolFireX: checks 
Michael Quan: bets $13
Donetsk1y: folds 
CoolFireX: folds 
Uncalled bet ($13) returned to Michael Quan
Michael Quan collected $25.94 from pot
*** SUMMARY ***
Total pot $27.30 | Rake $1.36 
Board [5c Qc 3h]
Seat 1: phil_cheng folded before Flop (didn't bet)
Seat 2: matiko09 folded before Flop (didn't bet)
Seat 3: wisbc folded before Flop (didn't bet)
Seat 4: CoolFireX folded on the Flop
Seat 5: Michael Quan collected ($25.94)
Seat 6: Donetsk1y folded on the Flop
Seat 7: ozone2003 (button) folded before Flop (didn't bet)
Seat 8: erick222 (small blind) folded before Flop
Seat 9: 23SmOkEr07 (big blind) folded before Flop





PokerStars Hand #155013455401:  Hold'em No Limit ($0.50/$1.00 USD) - 2016/06/21 13:31:33 CET [2016/06/21 7:31:33 ET]
Table 'Leo' 9-max Seat #7 is the button
Seat 1: fukumimi ($104.54 in chips) 
Seat 3: matiko09 ($100 in chips) 
Seat 4: phil_cheng ($107.33 in chips) 
Seat 5: Troll8989 ($103.52 in chips) 
Seat 6: Avtovo ($100 in chips) 
Seat 7: CoolFireX ($259.70 in chips) 
Seat 8: pyromid ($90.42 in chips) 
Seat 9: Wladimir205 ($122.62 in chips) 
pyromid: posts small blind $0.50
Wladimir205: posts big blind $1
mbk88: sits out 
*** HOLE CARDS ***
Dealt to matiko09 [5s 3c]
fukumimi: raises $2 to $3
matiko09: folds 
phil_cheng: folds 
Troll8989: folds 
Avtovo: folds 
CoolFireX: folds 
pyromid: folds 
Wladimir205: folds 
Uncalled bet ($2) returned to fukumimi
fukumimi collected $2.50 from pot
fukumimi: doesn't show hand 
*** SUMMARY ***
Total pot $2.50 | Rake $0 
Seat 1: fukumimi collected ($2.50)
Seat 3: matiko09 folded before Flop (didn't bet)
Seat 4: phil_cheng folded before Flop (didn't bet)
Seat 5: Troll8989 folded before Flop (didn't bet)
Seat 6: Avtovo folded before Flop (didn't bet)
Seat 7: CoolFireX (button) folded before Flop (didn't bet)
Seat 8: pyromid (small blind) folded before Flop
Seat 9: Wladimir205 (big blind) folded before Flop





PokerStars Hand #155013456373:  Hold'em No Limit ($0.50/$1.00 USD) - 2016/06/21 13:31:35 CET [2016/06/21 7:31:35 ET]
Table 'Rupertwildt' 9-max Seat #5 is the button
Seat 2: SharingaaN ($102.55 in chips) 
Seat 3: Troll8989 ($102.50 in chips) 
Seat 4: matiko09 ($143.18 in chips) 
Seat 5: pyromid ($85 in chips) 
Seat 6: phil_cheng ($121.34 in chips) 
Seat 7: Donetsk1y ($100 in chips) 
Seat 8: Gonzanary ($100 in chips) 
Seat 9: mbk88 ($100 in chips) 
phil_cheng: posts small blind $0.50
Donetsk1y: posts big blind $1
CoolFireX: sits out 
*** HOLE CARDS ***
Dealt to matiko09 [Jc Qd]
Gonzanary: folds 
mbk88: folds 
SharingaaN: folds 
Troll8989: raises $1.50 to $2.50
matiko09: folds 
pyromid: folds 
phil_cheng: folds 
Donetsk1y: calls $1.50
*** FLOP *** [3c 9d Ah]
Donetsk1y: checks 
Troll8989: bets $3
Donetsk1y: folds 
Uncalled bet ($3) returned to Troll8989
Troll8989 collected $5.22 from pot
Troll8989: doesn't show hand 
*** SUMMARY ***
Total pot $5.50 | Rake $0.28 
Board [3c 9d Ah]
Seat 2: SharingaaN folded before Flop (didn't bet)
Seat 3: Troll8989 collected ($5.22)
Seat 4: matiko09 folded before Flop (didn't bet)
Seat 5: pyromid (button) folded before Flop (didn't bet)
Seat 6: phil_cheng (small blind) folded before Flop
Seat 7: Donetsk1y (big blind) folded on the Flop
Seat 8: Gonzanary folded before Flop (didn't bet)
Seat 9: mbk88 folded before Flop (didn't bet)





PokerStars Hand #155013459002:  Hold'em No Limit ($0.50/$1.00 USD) - 2016/06/21 13:31:41 CET [2016/06/21 7:31:41 ET]
Table 'Chimay' 9-max Seat #4 is the button
Seat 1: phil_cheng ($100 in chips) 
Seat 2: pyromid ($141.48 in chips) 
Seat 4: fukumimi ($100 in chips) 
Seat 5: The Big Ape ($95.50 in chips) 
Seat 6: mbk88 ($148.47 in chips) 
Seat 7: matiko09 ($111.22 in chips) 
Seat 8: Eskimo Fox ($137.80 in chips) 
Seat 9: SharingaaN ($120.48 in chips) 
The Big Ape: posts small blind $0.50
mbk88: posts big blind $1
*** HOLE CARDS ***
Dealt to matiko09 [9d 9c]
matiko09: raises $2 to $3
Eskimo Fox: calls $3
SharingaaN: folds 
phil_cheng: folds 
pyromid: folds 
fukumimi: calls $3
The Big Ape: folds 
mbk88: folds 
*** FLOP *** [9h Ks Qh]
matiko09: bets $7
Eskimo Fox: folds 
fukumimi: folds 
Uncalled bet ($7) returned to matiko09
matiko09 collected $9.98 from pot
matiko09: doesn't show hand 
*** SUMMARY ***
Total pot $10.50 | Rake $0.52 
Board [9h Ks Qh]
Seat 1: phil_cheng folded before Flop (didn't bet)
Seat 2: pyromid folded before Flop (didn't bet)
Seat 4: fukumimi (button) folded on the Flop
Seat 5: The Big Ape (small blind) folded before Flop
Seat 6: mbk88 (big blind) folded before Flop
Seat 7: matiko09 collected ($9.98)
Seat 8: Eskimo Fox folded on the Flop
Seat 9: SharingaaN folded before Flop (didn't bet)





PokerStars Hand #155013460147:  Hold'em No Limit (€0.50/€1.00 EUR) - 2016/06/21 13:31:44 CET [2016/06/21 7:31:44 ET]
Table 'Alkes' 9-max Seat #1 is the button
Seat 1: Ping_Ping14 (€52.16 in chips) 
Seat 2: matiko09 (€100 in chips) 
Seat 3: erick222 (€100 in chips) 
Seat 4: 50CandyJoe (€106.02 in chips) 
Seat 5: CoolFireX (€100 in chips) 
Seat 6: Filojoes (€100 in chips) 
matiko09: posts small blind €0.50
erick222: posts big blind €1
ozone2003: sits out 
*** HOLE CARDS ***
Dealt to matiko09 [Kc 9h]
50CandyJoe: folds 
CoolFireX: folds 
Filojoes: folds 
Ping_Ping14: calls €1
matiko09: calls €0.50
erick222: checks 
*** FLOP *** [Js 7h 2d]
matiko09: checks 
erick222: checks 
Ping_Ping14: checks 
*** TURN *** [Js 7h 2d] [Ad]
matiko09: checks 
erick222: checks 
Ping_Ping14: bets €3
matiko09: folds 
erick222: folds 
Uncalled bet (€3) returned to Ping_Ping14
Ping_Ping14 collected €2.85 from pot
Ping_Ping14: doesn't show hand 
*** SUMMARY ***
Total pot €3 | Rake €0.15 
Board [Js 7h 2d Ad]
Seat 1: Ping_Ping14 (button) collected (€2.85)
Seat 2: matiko09 (small blind) folded on the Turn
Seat 3: erick222 (big blind) folded on the Turn
Seat 4: 50CandyJoe folded before Flop (didn't bet)
Seat 5: CoolFireX folded before Flop (didn't bet)
Seat 6: Filojoes folded before Flop (didn't bet)





PokerStars Hand #155013464102:  Hold'em No Limit ($0.50/$1.00 USD) - 2016/06/21 13:31:53 CET [2016/06/21 7:31:53 ET]
Table 'Moreau' 9-max Seat #3 is the button
Seat 1: ozone2003 ($130.49 in chips) 
Seat 2: Avtovo ($106 in chips) 
Seat 3: matiko09 ($108.38 in chips) 
Seat 4: SharingaaN ($100 in chips) 
Seat 6: Troll8989 ($100 in chips) 
Seat 7: PanKwn15 ($99.89 in chips) 
Seat 9: Toonersens ($112.92 in chips) 
SharingaaN: posts small blind $0.50
Troll8989: posts big blind $1
*** HOLE CARDS ***
Dealt to matiko09 [3d Th]
PanKwn15: folds 
Toonersens: calls $1
ozone2003: folds 
Avtovo: raises $3.50 to $4.50
matiko09: folds 
SharingaaN: folds 
Troll8989: folds 
Toonersens: folds 
Uncalled bet ($3.50) returned to Avtovo
Avtovo collected $3.50 from pot
Avtovo: doesn't show hand 
*** SUMMARY ***
Total pot $3.50 | Rake $0 
Seat 1: ozone2003 folded before Flop (didn't bet)
Seat 2: Avtovo collected ($3.50)
Seat 3: matiko09 (button) folded before Flop (didn't bet)
Seat 4: SharingaaN (small blind) folded before Flop
Seat 6: Troll8989 (big blind) folded before Flop
Seat 7: PanKwn15 folded before Flop (didn't bet)
Seat 9: Toonersens folded before Flop





PokerStars Hand #155013466633:  Hold'em No Limit ($0.50/$1.00 USD) - 2016/06/21 13:31:59 CET [2016/06/21 7:31:59 ET]
Table 'Leo' 9-max Seat #8 is the button
Seat 1: fukumimi ($106.04 in chips) 
Seat 3: matiko09 ($100 in chips) 
Seat 4: phil_cheng ($107.33 in chips) 
Seat 5: Troll8989 ($103.52 in chips) 
Seat 6: Avtovo ($100 in chips) 
Seat 7: CoolFireX ($259.70 in chips) 
Seat 8: pyromid ($89.92 in chips) 
Seat 9: Wladimir205 ($121.62 in chips) 
Wladimir205: posts small blind $0.50
fukumimi: posts big blind $1
mbk88: sits out 
*** HOLE CARDS ***
Dealt to matiko09 [4d 6h]
matiko09: folds 
phil_cheng: folds 
Troll8989: folds 
Avtovo: folds 
CoolFireX: folds 
pyromid: folds 
Wladimir205: raises $1 to $2
fukumimi: calls $1
*** FLOP *** [5h Kd Tc]
Wladimir205: checks 
fukumimi: checks 
*** TURN *** [5h Kd Tc] [Jc]
Wladimir205: checks 
fukumimi: checks 
*** RIVER *** [5h Kd Tc Jc] [4h]
Wladimir205: checks 
fukumimi: checks 
*** SHOW DOWN ***
Wladimir205: shows [3d 3h] (a pair of Threes)
fukumimi: shows [5s Ah] (a pair of Fives)
fukumimi collected $3.80 from pot
*** SUMMARY ***
Total pot $4 | Rake $0.20 
Board [5h Kd Tc Jc 4h]
Seat 1: fukumimi (big blind) showed [5s Ah] and won ($3.80) with a pair of Fives
Seat 3: matiko09 folded before Flop (didn't bet)
Seat 4: phil_cheng folded before Flop (didn't bet)
Seat 5: Troll8989 folded before Flop (didn't bet)
Seat 6: Avtovo folded before Flop (didn't bet)
Seat 7: CoolFireX folded before Flop (didn't bet)
Seat 8: pyromid (button) folded before Flop (didn't bet)
Seat 9: Wladimir205 (small blind) showed [3d 3h] and lost with a pair of Threes





PokerStars Hand #155013467495:  Hold'em No Limit ($0.50/$1.00 USD) - 2016/06/21 13:32:01 CET [2016/06/21 7:32:01 ET]
Table 'Carlova II' 9-max Seat #2 is the button
Seat 1: matiko09 ($106.30 in chips) 
Seat 2: mbk88 ($133.15 in chips) 
Seat 3: SharingaaN ($104.18 in chips) 
Seat 4: Dandy Monk ($87.48 in chips) 
Seat 5: ozone2003 ($109.05 in chips) 
Seat 6: phil_cheng ($100 in chips) 
Seat 7: mi$$I$Elena ($119.75 in chips) 
Seat 8: pyromid ($107.30 in chips) 
Seat 9: Troll8989 ($100 in chips) 
SharingaaN: posts small blind $0.50
Dandy Monk: posts big blind $1
*** HOLE CARDS ***
Dealt to matiko09 [2c 5c]
ozone2003: folds 
phil_cheng: folds 
mi$$I$Elena: folds 
pyromid: raises $1.50 to $2.50
Troll8989: calls $2.50
matiko09: folds 
mbk88: raises $9.50 to $12
SharingaaN: folds 
Dandy Monk: folds 
pyromid: folds 
Troll8989: folds 
Uncalled bet ($9.50) returned to mbk88
mbk88 collected $9 from pot
mbk88: doesn't show hand 
*** SUMMARY ***
Total pot $9 | Rake $0 
Seat 1: matiko09 folded before Flop (didn't bet)
Seat 2: mbk88 (button) collected ($9)
Seat 3: SharingaaN (small blind) folded before Flop
Seat 4: Dandy Monk (big blind) folded before Flop
Seat 5: ozone2003 folded before Flop (didn't bet)
Seat 6: phil_cheng folded before Flop (didn't bet)
Seat 7: mi$$I$Elena folded before Flop (didn't bet)
Seat 8: pyromid folded before Flop
Seat 9: Troll8989 folded before Flop





PokerStars Hand #155013473865:  Hold'em No Limit ($0.50/$1.00 USD) - 2016/06/21 13:32:16 CET [2016/06/21 7:32:16 ET]
Table 'Admete II' 9-max Seat #7 is the button
Seat 2: Eskimo Fox ($171.92 in chips) 
Seat 4: krustophsky ($72.40 in chips) 
Seat 5: mi$$I$Elena ($100 in chips) 
Seat 6: mbk88 ($253 in chips) 
Seat 7: matiko09 ($100 in chips) 
Seat 8: koutani7 ($92.50 in chips) 
Seat 9: CoolFireX ($100 in chips) 
koutani7: posts small blind $0.50
CoolFireX: posts big blind $1
*** HOLE CARDS ***
Dealt to matiko09 [7c 7d]
Eskimo Fox: folds 
krustophsky: raises $2.50 to $3.50
mi$$I$Elena: calls $3.50
mbk88: folds 
Troll8989 joins the table at seat #1 
matiko09: calls $3.50
koutani7: folds 
CoolFireX: calls $2.50
*** FLOP *** [3d Ad Kc]
CoolFireX: checks 
krustophsky: folds 
krustophsky leaves the table
23SmOkEr07 joins the table at seat #4 
mi$$I$Elena: checks 
matiko09: checks 
*** TURN *** [3d Ad Kc] [6s]
CoolFireX: checks 
mi$$I$Elena: bets $10
matiko09: folds 
CoolFireX: folds 
Uncalled bet ($10) returned to mi$$I$Elena
mi$$I$Elena collected $13.78 from pot
mi$$I$Elena: doesn't show hand 
*** SUMMARY ***
Total pot $14.50 | Rake $0.72 
Board [3d Ad Kc 6s]
Seat 2: Eskimo Fox folded before Flop (didn't bet)
Seat 4: krustophsky folded on the Flop
Seat 5: mi$$I$Elena collected ($13.78)
Seat 6: mbk88 folded before Flop (didn't bet)
Seat 7: matiko09 (button) folded on the Turn
Seat 8: koutani7 (small blind) folded before Flop
Seat 9: CoolFireX (big blind) folded on the Turn





PokerStars Hand #155013475058:  Hold'em No Limit ($0.50/$1.00 USD) - 2016/06/21 13:32:18 CET [2016/06/21 7:32:18 ET]
Table 'Rupertwildt' 9-max Seat #6 is the button
Seat 2: SharingaaN ($102.55 in chips) 
Seat 3: Troll8989 ($105.22 in chips) 
Seat 4: matiko09 ($143.18 in chips) 
Seat 5: pyromid ($85 in chips) 
Seat 6: phil_cheng ($120.84 in chips) 
Seat 7: Donetsk1y ($100 in chips) 
Seat 8: Gonzanary ($100 in chips) 
Seat 9: mbk88 ($100 in chips) 
Donetsk1y: posts small blind $0.50
Gonzanary: posts big blind $1
CoolFireX: sits out 
*** HOLE CARDS ***
Dealt to matiko09 [6c 4c]
mbk88: folds 
SharingaaN: folds 
Troll8989: folds 
Troll8989 leaves the table
23SmOkEr07 joins the table at seat #3 
matiko09: folds 
pyromid: folds 
phil_cheng: folds 
Donetsk1y: folds 
Uncalled bet ($0.50) returned to Gonzanary
Gonzanary collected $1 from pot
*** SUMMARY ***
Total pot $1 | Rake $0 
Seat 2: SharingaaN folded before Flop (didn't bet)
Seat 3: Troll8989 folded before Flop (didn't bet)
Seat 4: matiko09 folded before Flop (didn't bet)
Seat 5: pyromid folded before Flop (didn't bet)
Seat 6: phil_cheng (button) folded before Flop (didn't bet)
Seat 7: Donetsk1y (small blind) folded before Flop
Seat 8: Gonzanary (big blind) collected ($1)
Seat 9: mbk88 folded before Flop (didn't bet)





PokerStars Hand #155013476150:  Hold'em No Limit ($0.50/$1.00 USD) - 2016/06/21 13:32:21 CET [2016/06/21 7:32:21 ET]
Table 'Saldanha' 9-max Seat #8 is the button
Seat 2: matiko09 ($386.20 in chips) 
Seat 3: wisbc ($97 in chips) 
Seat 4: CoolFireX ($100 in chips) 
Seat 5: Michael Quan ($141.93 in chips) 
Seat 6: Donetsk1y ($100 in chips) 
Seat 7: ozone2003 ($120.20 in chips) 
Seat 8: erick222 ($100 in chips) 
Seat 9: 23SmOkEr07 ($100 in chips) 
23SmOkEr07: posts small blind $0.50
phil_cheng: is sitting out 
phil_cheng leaves the table
matiko09: posts big blind $1
matiko09: posts the ante $0.20
wisbc: posts the ante $0.20
CoolFireX: posts the ante $0.20
Michael Quan: posts the ante $0.20
Donetsk1y: posts the ante $0.20
ozone2003: posts the ante $0.20
erick222: posts the ante $0.20
23SmOkEr07: posts the ante $0.20
*** HOLE CARDS ***
Dealt to matiko09 [3d Jc]
wisbc: folds 
CoolFireX: folds 
Michael Quan: calls $1
stepan0605 joins the table at seat #1 
wisbc leaves the table
Donetsk1y: raises $3 to $4
ozone2003: folds 
erick222: folds 
23SmOkEr07: folds 
matiko09: folds 
Michael Quan: calls $3
*** FLOP *** [Ad 4c 9c]
Michael Quan: checks 
Donetsk1y: bets $7.90
Michael Quan: folds 
Uncalled bet ($7.90) returned to Donetsk1y
Donetsk1y collected $10.54 from pot
Donetsk1y: doesn't show hand 
*** SUMMARY ***
Total pot $11.10 | Rake $0.56 
Board [Ad 4c 9c]
Seat 2: matiko09 (big blind) folded before Flop
Seat 3: wisbc folded before Flop (didn't bet)
Seat 4: CoolFireX folded before Flop (didn't bet)
Seat 5: Michael Quan folded on the Flop
Seat 6: Donetsk1y collected ($10.54)
Seat 7: ozone2003 folded before Flop (didn't bet)
Seat 8: erick222 (button) folded before Flop (didn't bet)
Seat 9: 23SmOkEr07 (small blind) folded before Flop





PokerStars Hand #155013476359:  Hold'em No Limit ($0.50/$1.00 USD) - 2016/06/21 13:32:21 CET [2016/06/21 7:32:21 ET]
Table 'Moreau' 9-max Seat #4 is the button
Seat 1: ozone2003 ($130.49 in chips) 
Seat 2: Avtovo ($108.50 in chips) 
Seat 3: matiko09 ($108.38 in chips) 
Seat 4: SharingaaN ($99.50 in chips) 
Seat 6: Troll8989 ($100 in chips) 
Seat 7: PanKwn15 ($99.89 in chips) 
Seat 9: Toonersens ($111.92 in chips) 
Troll8989: posts small blind $0.50
PanKwn15: posts big blind $1
*** HOLE CARDS ***
Dealt to matiko09 [4c 7c]
Toonersens: raises $2 to $3
ozone2003: folds 
Avtovo: folds 
matiko09: folds 
SharingaaN: folds 
Troll8989: folds 
PanKwn15: folds 
Uncalled bet ($2) returned to Toonersens
Toonersens collected $2.50 from pot
*** SUMMARY ***
Total pot $2.50 | Rake $0 
Seat 1: ozone2003 folded before Flop (didn't bet)
Seat 2: Avtovo folded before Flop (didn't bet)
Seat 3: matiko09 folded before Flop (didn't bet)
Seat 4: SharingaaN (button) folded before Flop (didn't bet)
Seat 6: Troll8989 (small blind) folded before Flop
Seat 7: PanKwn15 (big blind) folded before Flop
Seat 9: Toonersens collected ($2.50)





PokerStars Hand #155013480341:  Hold'em No Limit (€0.25/€0.50 EUR) - 2016/06/21 13:32:30 CET [2016/06/21 7:32:30 ET]
Table 'Actor II' 6-max Seat #3 is the button
Seat 1: hmverlin (€103.58 in chips) 
Seat 2: alôha (€56.64 in chips) 
Seat 3: asmodej666 (€78.56 in chips) 
Seat 4: matiko09 (€64 in chips) 
Seat 5: Rybka1294 (€50 in chips) 
Seat 6: fanmtZ (€20 in chips) 
matiko09: posts small blind €0.25
Rybka1294: posts big blind €0.50
*** HOLE CARDS ***
Dealt to matiko09 [As 4c]
fanmtZ: raises €0.69 to €1.19
hmverlin: calls €1.19
alôha: folds 
asmodej666: folds 
matiko09: folds 
Rybka1294: folds 
*** FLOP *** [Qc Jd Ts]
fanmtZ: checks 
hmverlin: bets €1.50
fanmtZ: calls €1.50
*** TURN *** [Qc Jd Ts] [8h]
fanmtZ: checks 
hmverlin: checks 
*** RIVER *** [Qc Jd Ts 8h] [4h]
fanmtZ: checks 
hmverlin: checks 
*** SHOW DOWN ***
fanmtZ: shows [7s 7h] (a pair of Sevens)
hmverlin: shows [Jh Kc] (a pair of Jacks)
hmverlin collected €5.82 from pot
*** SUMMARY ***
Total pot €6.13 | Rake €0.31 
Board [Qc Jd Ts 8h 4h]
Seat 1: hmverlin showed [Jh Kc] and won (€5.82) with a pair of Jacks
Seat 2: alôha folded before Flop (didn't bet)
Seat 3: asmodej666 (button) folded before Flop (didn't bet)
Seat 4: matiko09 (small blind) folded before Flop
Seat 5: Rybka1294 (big blind) folded before Flop
Seat 6: fanmtZ showed [7s 7h] and lost with a pair of Sevens





PokerStars Hand #155013484431:  Hold'em No Limit ($0.50/$1.00 USD) - 2016/06/21 13:32:40 CET [2016/06/21 7:32:40 ET]
Table 'Lamberta II' 9-max Seat #7 is the button
Seat 1: mbk88 ($178 in chips) 
Seat 3: matiko09 ($100 in chips) 
Seat 4: Eskimo Fox ($116.41 in chips) 
Seat 5: mi$$I$Elena ($105.37 in chips) 
Seat 7: phil_cheng ($113.40 in chips) 
Seat 8: Troll8989 ($100 in chips) 
Seat 9: Sjtu_Michael ($111.44 in chips) 
Troll8989: posts small blind $0.50
Sjtu_Michael: posts big blind $1
Chen423: sits out 
*** HOLE CARDS ***
Dealt to matiko09 [8s 4d]
mbk88: folds 
matiko09: folds 
Eskimo Fox: raises $1.50 to $2.50
mi$$I$Elena: folds 
phil_cheng: folds 
Troll8989: folds 
Sjtu_Michael: folds 
Uncalled bet ($1.50) returned to Eskimo Fox
Eskimo Fox collected $2.50 from pot
Eskimo Fox: doesn't show hand 
*** SUMMARY ***
Total pot $2.50 | Rake $0 
Seat 1: mbk88 folded before Flop (didn't bet)
Seat 3: matiko09 folded before Flop (didn't bet)
Seat 4: Eskimo Fox collected ($2.50)
Seat 5: mi$$I$Elena folded before Flop (didn't bet)
Seat 7: phil_cheng (button) folded before Flop (didn't bet)
Seat 8: Troll8989 (small blind) folded before Flop
Seat 9: Sjtu_Michael (big blind) folded before Flop





PokerStars Hand #155013485042:  Hold'em No Limit ($0.50/$1.00 USD) - 2016/06/21 13:32:41 CET [2016/06/21 7:32:41 ET]
Table 'Chimay' 9-max Seat #5 is the button
Seat 1: phil_cheng ($100 in chips) 
Seat 2: pyromid ($141.48 in chips) 
Seat 4: fukumimi ($97 in chips) 
Seat 5: The Big Ape ($95 in chips) 
Seat 6: mbk88 ($147.47 in chips) 
Seat 7: matiko09 ($118.20 in chips) 
Seat 8: Eskimo Fox ($134.80 in chips) 
Seat 9: SharingaaN ($120.48 in chips) 
mbk88: posts small blind $0.50
matiko09: posts big blind $1
*** HOLE CARDS ***
Dealt to matiko09 [5s Ac]
Eskimo Fox: folds 
SharingaaN: folds 
phil_cheng: folds 
pyromid: folds 
fukumimi: folds 
The Big Ape: raises $1 to $2
mbk88: folds 
matiko09: calls $1
*** FLOP *** [Tc 2c 6s]
matiko09: checks 
The Big Ape: bets $5
matiko09: folds 
Uncalled bet ($5) returned to The Big Ape
The Big Ape collected $4.28 from pot
The Big Ape: doesn't show hand 
*** SUMMARY ***
Total pot $4.50 | Rake $0.22 
Board [Tc 2c 6s]
Seat 1: phil_cheng folded before Flop (didn't bet)
Seat 2: pyromid folded before Flop (didn't bet)
Seat 4: fukumimi folded before Flop (didn't bet)
Seat 5: The Big Ape (button) collected ($4.28)
Seat 6: mbk88 (small blind) folded before Flop
Seat 7: matiko09 (big blind) folded on the Flop
Seat 8: Eskimo Fox folded before Flop (didn't bet)
Seat 9: SharingaaN folded before Flop (didn't bet)





PokerStars Hand #155013488016:  Hold'em No Limit ($0.50/$1.00 USD) - 2016/06/21 13:32:48 CET [2016/06/21 7:32:48 ET]
Table 'Leo' 9-max Seat #9 is the button
Seat 1: fukumimi ($107.84 in chips) 
Seat 2: mbk88 ($126.65 in chips) 
Seat 3: matiko09 ($100 in chips) 
Seat 4: phil_cheng ($107.33 in chips) 
Seat 5: Troll8989 ($103.52 in chips) 
Seat 6: Avtovo ($100 in chips) 
Seat 7: CoolFireX ($259.70 in chips) 
Seat 8: pyromid ($89.92 in chips) 
Seat 9: Wladimir205 ($119.62 in chips) 
fukumimi: posts small blind $0.50
mbk88: posts big blind $1
*** HOLE CARDS ***
Dealt to matiko09 [7d 7h]
matiko09: raises $2 to $3
phil_cheng: folds 
Troll8989: folds 
Avtovo: folds 
CoolFireX: calls $3
pyromid: folds 
Wladimir205: folds 
fukumimi: folds 
mbk88: calls $2
*** FLOP *** [Jd 8h 2c]
mbk88: checks 
matiko09: checks 
CoolFireX: checks 
*** TURN *** [Jd 8h 2c] [3c]
mbk88: bets $6
matiko09: folds 
CoolFireX: calls $6
*** RIVER *** [Jd 8h 2c 3c] [5s]
mbk88: bets $20
CoolFireX: folds 
Uncalled bet ($20) returned to mbk88
mbk88 collected $20.42 from pot
mbk88: doesn't show hand 
*** SUMMARY ***
Total pot $21.50 | Rake $1.08 
Board [Jd 8h 2c 3c 5s]
Seat 1: fukumimi (small blind) folded before Flop
Seat 2: mbk88 (big blind) collected ($20.42)
Seat 3: matiko09 folded on the Turn
Seat 4: phil_cheng folded before Flop (didn't bet)
Seat 5: Troll8989 folded before Flop (didn't bet)
Seat 6: Avtovo folded before Flop (didn't bet)
Seat 7: CoolFireX folded on the River
Seat 8: pyromid folded before Flop (didn't bet)
Seat 9: Wladimir205 (button) folded before Flop (didn't bet)





PokerStars Hand #155013487875:  Hold'em No Limit ($0.50/$1.00 USD) - 2016/06/21 13:32:48 CET [2016/06/21 7:32:48 ET]
Table 'Carlova II' 9-max Seat #3 is the button
Seat 1: matiko09 ($106.30 in chips) 
Seat 2: mbk88 ($139.65 in chips) 
Seat 3: SharingaaN ($103.68 in chips) 
Seat 4: Dandy Monk ($86.48 in chips) 
Seat 5: ozone2003 ($109.05 in chips) 
Seat 6: phil_cheng ($100 in chips) 
Seat 7: mi$$I$Elena ($119.75 in chips) 
Seat 8: pyromid ($104.80 in chips) 
Seat 9: Troll8989 ($100 in chips) 
Dandy Monk: posts small blind $0.50
ozone2003: posts big blind $1
*** HOLE CARDS ***
Dealt to matiko09 [Th Tc]
phil_cheng: folds 
mi$$I$Elena: folds 
pyromid: folds 
Troll8989: folds 
matiko09: raises $2 to $3
mbk88: folds 
SharingaaN: folds 
Dandy Monk: folds 
ozone2003: folds 
Uncalled bet ($2) returned to matiko09
matiko09 collected $2.50 from pot
matiko09: doesn't show hand 
*** SUMMARY ***
Total pot $2.50 | Rake $0 
Seat 1: matiko09 collected ($2.50)
Seat 2: mbk88 folded before Flop (didn't bet)
Seat 3: SharingaaN (button) folded before Flop (didn't bet)
Seat 4: Dandy Monk (small blind) folded before Flop
Seat 5: ozone2003 (big blind) folded before Flop
Seat 6: phil_cheng folded before Flop (didn't bet)
Seat 7: mi$$I$Elena folded before Flop (didn't bet)
Seat 8: pyromid folded before Flop (didn't bet)
Seat 9: Troll8989 folded before Flop (didn't bet)





PokerStars Hand #155013490245:  Hold'em No Limit ($0.50/$1.00 USD) - 2016/06/21 13:32:53 CET [2016/06/21 7:32:53 ET]
Table 'Rupertwildt' 9-max Seat #7 is the button
Seat 2: SharingaaN ($102.55 in chips) 
Seat 4: matiko09 ($143.18 in chips) 
Seat 5: pyromid ($85 in chips) 
Seat 6: phil_cheng ($120.84 in chips) 
Seat 7: Donetsk1y ($100 in chips) 
Seat 8: Gonzanary ($100.50 in chips) 
Seat 9: mbk88 ($100 in chips) 
Gonzanary: posts small blind $0.50
mbk88: posts big blind $1
CoolFireX: sits out 
23SmOkEr07: sits out 
*** HOLE CARDS ***
Dealt to matiko09 [9d 4d]
SharingaaN: folds 
matiko09: folds 
pyromid: folds 
phil_cheng: folds 
Donetsk1y: raises $1.20 to $2.20
Gonzanary: folds 
mbk88: folds 
Uncalled bet ($1.20) returned to Donetsk1y
Donetsk1y collected $2.50 from pot
Donetsk1y: doesn't show hand 
*** SUMMARY ***
Total pot $2.50 | Rake $0 
Seat 2: SharingaaN folded before Flop (didn't bet)
Seat 4: matiko09 folded before Flop (didn't bet)
Seat 5: pyromid folded before Flop (didn't bet)
Seat 6: phil_cheng folded before Flop (didn't bet)
Seat 7: Donetsk1y (button) collected ($2.50)
Seat 8: Gonzanary (small blind) folded before Flop
Seat 9: mbk88 (big blind) folded before Flop





PokerStars Hand #155013492613:  Hold'em No Limit ($0.50/$1.00 USD) - 2016/06/21 13:32:58 CET [2016/06/21 7:32:58 ET]
Table 'Moreau' 9-max Seat #6 is the button
Seat 1: ozone2003 ($130.49 in chips) 
Seat 2: Avtovo ($108.50 in chips) 
Seat 3: matiko09 ($108.38 in chips) 
Seat 4: SharingaaN ($99.50 in chips) 
Seat 6: Troll8989 ($100 in chips) 
Seat 7: PanKwn15 ($98.89 in chips) 
Seat 9: Toonersens ($113.42 in chips) 
PanKwn15: posts small blind $0.50
Toonersens: posts big blind $1
*** HOLE CARDS ***
Dealt to matiko09 [3d Jd]
ozone2003: folds 
Avtovo: folds 
matiko09: folds 
SharingaaN: folds 
Troll8989: folds 
PanKwn15: folds 
Uncalled bet ($0.50) returned to Toonersens
Toonersens collected $1 from pot
*** SUMMARY ***
Total pot $1 | Rake $0 
Seat 1: ozone2003 folded before Flop (didn't bet)
Seat 2: Avtovo folded before Flop (didn't bet)
Seat 3: matiko09 folded before Flop (didn't bet)
Seat 4: SharingaaN folded before Flop (didn't bet)
Seat 6: Troll8989 (button) folded before Flop (didn't bet)
Seat 7: PanKwn15 (small blind) folded before Flop
Seat 9: Toonersens (big blind) collected ($1)





PokerStars Hand #155013497245:  Hold'em No Limit ($0.50/$1.00 USD) - 2016/06/21 13:33:09 CET [2016/06/21 7:33:09 ET]
Table 'Lamberta II' 9-max Seat #8 is the button
Seat 1: mbk88 ($178 in chips) 
Seat 3: matiko09 ($100 in chips) 
Seat 4: Eskimo Fox ($117.91 in chips) 
Seat 5: mi$$I$Elena ($105.37 in chips) 
Seat 7: phil_cheng ($113.40 in chips) 
Seat 8: Troll8989 ($100 in chips) 
Seat 9: Sjtu_Michael ($110.44 in chips) 
Sjtu_Michael: posts small blind $0.50
mbk88: posts big blind $1
Chen423: sits out 
*** HOLE CARDS ***
Dealt to matiko09 [9d 2d]
matiko09: folds 
Eskimo Fox: folds 
mi$$I$Elena: folds 
phil_cheng: raises $1 to $2
Troll8989: folds 
Sjtu_Michael: folds 
mbk88: folds 
Uncalled bet ($1) returned to phil_cheng
phil_cheng collected $2.50 from pot
phil_cheng: doesn't show hand 
*** SUMMARY ***
Total pot $2.50 | Rake $0 
Seat 1: mbk88 (big blind) folded before Flop
Seat 3: matiko09 folded before Flop (didn't bet)
Seat 4: Eskimo Fox folded before Flop (didn't bet)
Seat 5: mi$$I$Elena folded before Flop (didn't bet)
Seat 7: phil_cheng collected ($2.50)
Seat 8: Troll8989 (button) folded before Flop (didn't bet)
Seat 9: Sjtu_Michael (small blind) folded before Flop





PokerStars Hand #155013500964:  Hold'em No Limit ($0.50/$1.00 USD) - 2016/06/21 13:33:17 CET [2016/06/21 7:33:17 ET]
Table 'Carlova II' 9-max Seat #4 is the button
Seat 1: matiko09 ($107.80 in chips) 
Seat 2: mbk88 ($139.65 in chips) 
Seat 3: SharingaaN ($103.68 in chips) 
Seat 4: Dandy Monk ($85.98 in chips) 
Seat 5: ozone2003 ($108.05 in chips) 
Seat 7: mi$$I$Elena ($119.75 in chips) 
Seat 8: pyromid ($104.80 in chips) 
Seat 9: Troll8989 ($100 in chips) 
ozone2003: posts small blind $0.50
phil_cheng: is sitting out 
mi$$I$Elena: posts big blind $1
*** HOLE CARDS ***
Dealt to matiko09 [8s 4c]
phil_cheng leaves the table
pyromid: folds 
Donetsk1y joins the table at seat #6 
Troll8989: folds 
matiko09: folds 
mbk88: folds 
SharingaaN: folds 
Dandy Monk: raises $1 to $2
ozone2003: raises $6 to $8
mi$$I$Elena: folds 
Dandy Monk: folds 
Uncalled bet ($6) returned to ozone2003
ozone2003 collected $5 from pot
ozone2003: doesn't show hand 
*** SUMMARY ***
Total pot $5 | Rake $0 
Seat 1: matiko09 folded before Flop (didn't bet)
Seat 2: mbk88 folded before Flop (didn't bet)
Seat 3: SharingaaN folded before Flop (didn't bet)
Seat 4: Dandy Monk (button) folded before Flop
Seat 5: ozone2003 (small blind) collected ($5)
Seat 7: mi$$I$Elena (big blind) folded before Flop
Seat 8: pyromid folded before Flop (didn't bet)
Seat 9: Troll8989 folded before Flop (didn't bet)





PokerStars Hand #155013502235:  Hold'em No Limit ($0.50/$1.00 USD) - 2016/06/21 13:33:20 CET [2016/06/21 7:33:20 ET]
Table 'Rupertwildt' 9-max Seat #8 is the button
Seat 1: CoolFireX ($196.57 in chips) 
Seat 2: SharingaaN ($102.55 in chips) 
Seat 4: matiko09 ($143.18 in chips) 
Seat 5: pyromid ($85 in chips) 
Seat 6: phil_cheng ($120.84 in chips) 
Seat 7: Donetsk1y ($101.50 in chips) 
Seat 8: Gonzanary ($100 in chips) 
Seat 9: mbk88 ($100 in chips) 
mbk88: posts small blind $0.50
CoolFireX: posts big blind $1
23SmOkEr07: sits out 
*** HOLE CARDS ***
Dealt to matiko09 [Kh Ah]
SharingaaN: folds 
matiko09: raises $2 to $3
pyromid: folds 
phil_cheng: folds 
Donetsk1y: folds 
Gonzanary: folds 
mbk88: folds 
CoolFireX: folds 
Uncalled bet ($2) returned to matiko09
matiko09 collected $2.50 from pot
matiko09: doesn't show hand 
*** SUMMARY ***
Total pot $2.50 | Rake $0 
Seat 1: CoolFireX (big blind) folded before Flop
Seat 2: SharingaaN folded before Flop (didn't bet)
Seat 4: matiko09 collected ($2.50)
Seat 5: pyromid folded before Flop (didn't bet)
Seat 6: phil_cheng folded before Flop (didn't bet)
Seat 7: Donetsk1y folded before Flop (didn't bet)
Seat 8: Gonzanary (button) folded before Flop (didn't bet)
Seat 9: mbk88 (small blind) folded before Flop





PokerStars Hand #155013503602:  Hold'em No Limit ($0.50/$1.00 USD) - 2016/06/21 13:33:23 CET [2016/06/21 7:33:23 ET]
Table 'Chimay' 9-max Seat #6 is the button
Seat 1: phil_cheng ($100 in chips) 
Seat 2: pyromid ($141.48 in chips) 
Seat 4: fukumimi ($97 in chips) 
Seat 5: The Big Ape ($97.28 in chips) 
Seat 6: mbk88 ($146.97 in chips) 
Seat 7: matiko09 ($116.20 in chips) 
Seat 8: Eskimo Fox ($134.80 in chips) 
Seat 9: SharingaaN ($120.48 in chips) 
matiko09: posts small blind $0.50
Eskimo Fox: posts big blind $1
*** HOLE CARDS ***
Dealt to matiko09 [Th 4c]
SharingaaN: raises $2 to $3
phil_cheng: folds 
pyromid: calls $3
fukumimi: folds 
The Big Ape: calls $3
mbk88: folds 
matiko09: folds 
Eskimo Fox: folds 
*** FLOP *** [6s Qc 5s]
SharingaaN: checks 
pyromid: bets $4
The Big Ape: folds 
SharingaaN: folds 
Uncalled bet ($4) returned to pyromid
pyromid collected $9.98 from pot
pyromid: doesn't show hand 
*** SUMMARY ***
Total pot $10.50 | Rake $0.52 
Board [6s Qc 5s]
Seat 1: phil_cheng folded before Flop (didn't bet)
Seat 2: pyromid collected ($9.98)
Seat 4: fukumimi folded before Flop (didn't bet)
Seat 5: The Big Ape folded on the Flop
Seat 6: mbk88 (button) folded before Flop (didn't bet)
Seat 7: matiko09 (small blind) folded before Flop
Seat 8: Eskimo Fox (big blind) folded before Flop
Seat 9: SharingaaN folded on the Flop





PokerStars Hand #155013505012:  Hold'em No Limit ($0.50/$1.00 USD) - 2016/06/21 13:33:27 CET [2016/06/21 7:33:27 ET]
Table 'Moreau' 9-max Seat #7 is the button
Seat 1: ozone2003 ($130.49 in chips) 
Seat 2: Avtovo ($108.50 in chips) 
Seat 3: matiko09 ($108.38 in chips) 
Seat 4: SharingaaN ($99.50 in chips) 
Seat 6: Troll8989 ($100 in chips) 
Seat 7: PanKwn15 ($98.39 in chips) 
Seat 9: Toonersens ($113.92 in chips) 
Toonersens: posts small blind $0.50
ozone2003: posts big blind $1
*** HOLE CARDS ***
Dealt to matiko09 [3h 2h]
Avtovo: folds 
matiko09: folds 
SharingaaN: folds 
Troll8989: raises $1.50 to $2.50
PanKwn15: raises $4.50 to $7
Toonersens: folds 
ozone2003: folds 
Troll8989: folds 
Uncalled bet ($4.50) returned to PanKwn15
PanKwn15 collected $6.50 from pot
PanKwn15: doesn't show hand 
*** SUMMARY ***
Total pot $6.50 | Rake $0 
Seat 1: ozone2003 (big blind) folded before Flop
Seat 2: Avtovo folded before Flop (didn't bet)
Seat 3: matiko09 folded before Flop (didn't bet)
Seat 4: SharingaaN folded before Flop (didn't bet)
Seat 6: Troll8989 folded before Flop
Seat 7: PanKwn15 (button) collected ($6.50)
Seat 9: Toonersens (small blind) folded before Flop





PokerStars Hand #155013508185:  Hold'em No Limit (€0.50/€1.00 EUR) - 2016/06/21 13:33:34 CET [2016/06/21 7:33:34 ET]
Table 'Alkes' 9-max Seat #2 is the button
Seat 1: Ping_Ping14 (€54.01 in chips) 
Seat 2: matiko09 (€100 in chips) 
Seat 3: erick222 (€100 in chips) 
Seat 4: 50CandyJoe (€106.02 in chips) 
Seat 5: CoolFireX (€100 in chips) 
Seat 6: Filojoes (€100 in chips) 
erick222: posts small blind €0.50
50CandyJoe: posts big blind €1
el Fatto: sits out 
ozone2003: sits out 
*** HOLE CARDS ***
Dealt to matiko09 [6h 3h]
CoolFireX: folds 
Filojoes: folds 
Ping_Ping14: calls €1
el Fatto leaves the table
matiko09: folds 
erick222: folds 
50CandyJoe: checks 
*** FLOP *** [Kh 3s As]
50CandyJoe: checks 
Ping_Ping14: checks 
*** TURN *** [Kh 3s As] [2s]
50CandyJoe: checks 
Ping_Ping14: checks 
*** RIVER *** [Kh 3s As 2s] [Jh]
50CandyJoe: checks 
Ping_Ping14: bets €1
50CandyJoe: folds 
Uncalled bet (€1) returned to Ping_Ping14
Ping_Ping14 collected €2.38 from pot
Ping_Ping14: doesn't show hand 
*** SUMMARY ***
Total pot €2.50 | Rake €0.12 
Board [Kh 3s As 2s Jh]
Seat 1: Ping_Ping14 collected (€2.38)
Seat 2: matiko09 (button) folded before Flop (didn't bet)
Seat 3: erick222 (small blind) folded before Flop
Seat 4: 50CandyJoe (big blind) folded on the River
Seat 5: CoolFireX folded before Flop (didn't bet)
Seat 6: Filojoes folded before Flop (didn't bet)





PokerStars Hand #155013511114:  Hold'em No Limit ($0.50/$1.00 USD) - 2016/06/21 13:33:41 CET [2016/06/21 7:33:41 ET]
Table 'Rupertwildt' 9-max Seat #9 is the button
Seat 1: CoolFireX ($195.57 in chips) 
Seat 2: SharingaaN ($102.55 in chips) 
Seat 4: matiko09 ($144.68 in chips) 
Seat 5: pyromid ($85 in chips) 
Seat 6: phil_cheng ($120.84 in chips) 
Seat 7: Donetsk1y ($101.50 in chips) 
Seat 8: Gonzanary ($100 in chips) 
Seat 9: mbk88 ($100 in chips) 
CoolFireX: posts small blind $0.50
SharingaaN: posts big blind $1
23SmOkEr07: sits out 
*** HOLE CARDS ***
Dealt to matiko09 [Kh Ad]
matiko09: raises $2 to $3
pyromid: folds 
phil_cheng: calls $3
Donetsk1y: folds 
Gonzanary: folds 
mbk88: folds 
CoolFireX: folds 
SharingaaN: folds 
*** FLOP *** [Js 9c Ts]
matiko09: checks 
phil_cheng: bets $4.74
matiko09: folds 
Uncalled bet ($4.74) returned to phil_cheng
phil_cheng collected $7.12 from pot
phil_cheng: doesn't show hand 
*** SUMMARY ***
Total pot $7.50 | Rake $0.38 
Board [Js 9c Ts]
Seat 1: CoolFireX (small blind) folded before Flop
Seat 2: SharingaaN (big blind) folded before Flop
Seat 4: matiko09 folded on the Flop
Seat 5: pyromid folded before Flop (didn't bet)
Seat 6: phil_cheng collected ($7.12)
Seat 7: Donetsk1y folded before Flop (didn't bet)
Seat 8: Gonzanary folded before Flop (didn't bet)
Seat 9: mbk88 (button) folded before Flop (didn't bet)





PokerStars Hand #155013511595:  Hold'em No Limit ($0.50/$1.00 USD) - 2016/06/21 13:33:42 CET [2016/06/21 7:33:42 ET]
Table 'Saldanha' 9-max Seat #9 is the button
Seat 2: matiko09 ($385 in chips) 
Seat 4: CoolFireX ($100 in chips) 
Seat 5: Michael Quan ($137.73 in chips) 
Seat 6: Donetsk1y ($106.34 in chips) 
Seat 7: ozone2003 ($120 in chips) 
Seat 8: erick222 ($100 in chips) 
Seat 9: 23SmOkEr07 ($100 in chips) 
stepan0605 will be allowed to play after the button
matiko09: posts small blind $0.50
CoolFireX: posts big blind $1
matiko09: posts the ante $0.20
CoolFireX: posts the ante $0.20
Michael Quan: posts the ante $0.20
Donetsk1y: posts the ante $0.20
ozone2003: posts the ante $0.20
erick222: posts the ante $0.20
23SmOkEr07: posts the ante $0.20
*** HOLE CARDS ***
Dealt to matiko09 [Ac 2c]
Michael Quan: folds 
Donetsk1y: folds 
ozone2003: folds 
mbk88 joins the table at seat #3 
erick222: folds 
23SmOkEr07: folds 
matiko09: raises $2 to $3
CoolFireX: calls $2
*** FLOP *** [2h 5c 4c]
matiko09: bets $4.57
CoolFireX: calls $4.57
*** TURN *** [2h 5c 4c] [4h]
matiko09: checks 
CoolFireX: checks 
*** RIVER *** [2h 5c 4c 4h] [Kc]
matiko09: bets $8.16
CoolFireX: calls $8.16
*** SHOW DOWN ***
matiko09: shows [Ac 2c] (a flush, Ace high)
CoolFireX: mucks hand 
matiko09 collected $31.22 from pot
*** SUMMARY ***
Total pot $32.86 | Rake $1.64 
Board [2h 5c 4c 4h Kc]
Seat 2: matiko09 (small blind) showed [Ac 2c] and won ($31.22) with a flush, Ace high
Seat 4: CoolFireX (big blind) mucked [7s Ah]
Seat 5: Michael Quan folded before Flop (didn't bet)
Seat 6: Donetsk1y folded before Flop (didn't bet)
Seat 7: ozone2003 folded before Flop (didn't bet)
Seat 8: erick222 folded before Flop (didn't bet)
Seat 9: 23SmOkEr07 (button) folded before Flop (didn't bet)





PokerStars Hand #155013513333:  Hold'em No Limit ($0.50/$1.00 USD) - 2016/06/21 13:33:46 CET [2016/06/21 7:33:46 ET]
Table 'Admete II' 9-max Seat #8 is the button
Seat 1: Troll8989 ($100 in chips) 
Seat 2: Eskimo Fox ($171.92 in chips) 
Seat 5: mi$$I$Elena ($110.28 in chips) 
Seat 6: mbk88 ($253 in chips) 
Seat 7: matiko09 ($100 in chips) 
Seat 8: koutani7 ($92 in chips) 
Seat 9: CoolFireX ($100 in chips) 
CoolFireX: posts small blind $0.50
Troll8989: posts big blind $1
23SmOkEr07: sits out 
*** HOLE CARDS ***
Dealt to matiko09 [2c Ts]
Eskimo Fox: raises $2 to $3
mi$$I$Elena: folds 
mbk88: folds 
matiko09: folds 
koutani7: folds 
CoolFireX: folds 
Troll8989: folds 
Uncalled bet ($2) returned to Eskimo Fox
Eskimo Fox collected $2.50 from pot
Eskimo Fox: doesn't show hand 
*** SUMMARY ***
Total pot $2.50 | Rake $0 
Seat 1: Troll8989 (big blind) folded before Flop
Seat 2: Eskimo Fox collected ($2.50)
Seat 5: mi$$I$Elena folded before Flop (didn't bet)
Seat 6: mbk88 folded before Flop (didn't bet)
Seat 7: matiko09 folded before Flop (didn't bet)
Seat 8: koutani7 (button) folded before Flop (didn't bet)
Seat 9: CoolFireX (small blind) folded before Flop





PokerStars Hand #155013515352:  Hold'em No Limit (€0.25/€0.50 EUR) - 2016/06/21 13:33:50 CET [2016/06/21 7:33:50 ET]
Table 'Actor II' 6-max Seat #4 is the button
Seat 1: hmverlin (€106.71 in chips) 
Seat 2: alôha (€56.64 in chips) 
Seat 3: asmodej666 (€78.56 in chips) 
Seat 4: matiko09 (€63.75 in chips) 
Seat 5: Rybka1294 (€50 in chips) 
Seat 6: fanmtZ (€20 in chips) 
Rybka1294: posts small blind €0.25
fanmtZ: posts big blind €0.50
*** HOLE CARDS ***
Dealt to matiko09 [4h Ac]
hmverlin: folds 
alôha: folds 
asmodej666: raises €0.75 to €1.25
matiko09: folds 
Rybka1294: folds 
fanmtZ: folds 
Uncalled bet (€0.75) returned to asmodej666
asmodej666 collected €1.25 from pot
asmodej666: doesn't show hand 
*** SUMMARY ***
Total pot €1.25 | Rake €0 
Seat 1: hmverlin folded before Flop (didn't bet)
Seat 2: alôha folded before Flop (didn't bet)
Seat 3: asmodej666 collected (€1.25)
Seat 4: matiko09 (button) folded before Flop (didn't bet)
Seat 5: Rybka1294 (small blind) folded before Flop
Seat 6: fanmtZ (big blind) folded before Flop





PokerStars Hand #155013518114:  Hold'em No Limit ($0.50/$1.00 USD) - 2016/06/21 13:33:56 CET [2016/06/21 7:33:56 ET]
Table 'Carlova II' 9-max Seat #5 is the button
Seat 1: matiko09 ($107.80 in chips) 
Seat 2: mbk88 ($139.65 in chips) 
Seat 3: SharingaaN ($103.68 in chips) 
Seat 4: Dandy Monk ($83.98 in chips) 
Seat 5: ozone2003 ($111.05 in chips) 
Seat 7: mi$$I$Elena ($118.75 in chips) 
Seat 8: pyromid ($104.80 in chips) 
Seat 9: Troll8989 ($100 in chips) 
Donetsk1y will be allowed to play after the button
mi$$I$Elena: posts small blind $0.50
pyromid: posts big blind $1
*** HOLE CARDS ***
Dealt to matiko09 [3h 5s]
Troll8989: folds 
matiko09: folds 
mbk88: folds 
SharingaaN: raises $2 to $3
Dandy Monk: calls $3
ozone2003: folds 
mi$$I$Elena: calls $2.50
pyromid: folds 
*** FLOP *** [Qc Js 8h]
mi$$I$Elena: checks 
SharingaaN: checks 
Dandy Monk: bets $4
mi$$I$Elena: folds 
SharingaaN: calls $4
*** TURN *** [Qc Js 8h] [4s]
SharingaaN: checks 
Dandy Monk: checks 
*** RIVER *** [Qc Js 8h 4s] [6h]
SharingaaN: bets $8.55
Dandy Monk: folds 
Uncalled bet ($8.55) returned to SharingaaN
SharingaaN collected $17.10 from pot
SharingaaN: doesn't show hand 
*** SUMMARY ***
Total pot $18 | Rake $0.90 
Board [Qc Js 8h 4s 6h]
Seat 1: matiko09 folded before Flop (didn't bet)
Seat 2: mbk88 folded before Flop (didn't bet)
Seat 3: SharingaaN collected ($17.10)
Seat 4: Dandy Monk folded on the River
Seat 5: ozone2003 (button) folded before Flop (didn't bet)
Seat 7: mi$$I$Elena (small blind) folded on the Flop
Seat 8: pyromid (big blind) folded before Flop
Seat 9: Troll8989 folded before Flop (didn't bet)





PokerStars Hand #155013518246:  Hold'em No Limit ($0.50/$1.00 USD) - 2016/06/21 13:33:57 CET [2016/06/21 7:33:57 ET]
Table 'Chimay' 9-max Seat #7 is the button
Seat 2: pyromid ($148.46 in chips) 
Seat 4: fukumimi ($97 in chips) 
Seat 5: The Big Ape ($94.28 in chips) 
Seat 6: mbk88 ($146.97 in chips) 
Seat 7: matiko09 ($115.70 in chips) 
Seat 8: Eskimo Fox ($133.80 in chips) 
Eskimo Fox: posts small blind $0.50
SharingaaN: is sitting out 
phil_cheng: is sitting out 
pyromid: posts big blind $1
*** HOLE CARDS ***
Dealt to matiko09 [9c 6d]
phil_cheng leaves the table
Donetsk1y joins the table at seat #1 
fukumimi: raises $2 to $3
The Big Ape: folds 
Donetsk1y leaves the table
mbk88: folds 
matiko09: folds 
Eskimo Fox: folds 
pyromid: folds 
Uncalled bet ($2) returned to fukumimi
fukumimi collected $2.50 from pot
fukumimi: doesn't show hand 
*** SUMMARY ***
Total pot $2.50 | Rake $0 
Seat 2: pyromid (big blind) folded before Flop
Seat 4: fukumimi collected ($2.50)
Seat 5: The Big Ape folded before Flop (didn't bet)
Seat 6: mbk88 folded before Flop (didn't bet)
Seat 7: matiko09 (button) folded before Flop (didn't bet)
Seat 8: Eskimo Fox (small blind) folded before Flop





PokerStars Hand #155013519025:  Hold'em No Limit ($0.50/$1.00 USD) - 2016/06/21 13:33:59 CET [2016/06/21 7:33:59 ET]
Table 'Lamberta II' 9-max Seat #9 is the button
Seat 1: mbk88 ($177 in chips) 
Seat 3: matiko09 ($100 in chips) 
Seat 4: Eskimo Fox ($117.91 in chips) 
Seat 5: mi$$I$Elena ($105.37 in chips) 
Seat 7: phil_cheng ($114.90 in chips) 
Seat 8: Troll8989 ($100 in chips) 
Seat 9: Sjtu_Michael ($109.94 in chips) 
mbk88: posts small blind $0.50
matiko09: posts big blind $1
Chen423: sits out 
*** HOLE CARDS ***
Dealt to matiko09 [Jh Tc]
Eskimo Fox: folds 
mi$$I$Elena: raises $1.38 to $2.38
phil_cheng: folds 
Troll8989: folds 
Sjtu_Michael: folds 
mbk88: folds 
matiko09: folds 
Uncalled bet ($1.38) returned to mi$$I$Elena
mi$$I$Elena collected $2.50 from pot
mi$$I$Elena: doesn't show hand 
*** SUMMARY ***
Total pot $2.50 | Rake $0 
Seat 1: mbk88 (small blind) folded before Flop
Seat 3: matiko09 (big blind) folded before Flop
Seat 4: Eskimo Fox folded before Flop (didn't bet)
Seat 5: mi$$I$Elena collected ($2.50)
Seat 7: phil_cheng folded before Flop (didn't bet)
Seat 8: Troll8989 folded before Flop (didn't bet)
Seat 9: Sjtu_Michael (button) folded before Flop (didn't bet)





PokerStars Hand #155013524862:  Hold'em No Limit (€0.25/€0.50 EUR) - 2016/06/21 13:34:12 CET [2016/06/21 7:34:12 ET]
Table 'Actor II' 6-max Seat #5 is the button
Seat 1: hmverlin (€106.71 in chips) 
Seat 2: alôha (€56.64 in chips) 
Seat 3: asmodej666 (€79.31 in chips) 
Seat 4: matiko09 (€63.75 in chips) 
Seat 5: Rybka1294 (€50 in chips) 
Seat 6: fanmtZ (€20 in chips) 
fanmtZ: posts small blind €0.25
hmverlin: posts big blind €0.50
*** HOLE CARDS ***
Dealt to matiko09 [Jh 5h]
alôha: folds 
asmodej666: raises €1 to €1.50
matiko09: folds 
Rybka1294: folds 
fanmtZ: calls €1.25
hmverlin: calls €1
*** FLOP *** [2h 3c 3s]
fanmtZ: checks 
hmverlin: checks 
asmodej666: bets €2.50
fanmtZ: folds 
hmverlin: folds 
Uncalled bet (€2.50) returned to asmodej666
asmodej666 collected €4.28 from pot
asmodej666: doesn't show hand 
*** SUMMARY ***
Total pot €4.50 | Rake €0.22 
Board [2h 3c 3s]
Seat 1: hmverlin (big blind) folded on the Flop
Seat 2: alôha folded before Flop (didn't bet)
Seat 3: asmodej666 collected (€4.28)
Seat 4: matiko09 folded before Flop (didn't bet)
Seat 5: Rybka1294 (button) folded before Flop (didn't bet)
Seat 6: fanmtZ (small blind) folded on the Flop





PokerStars Hand #155013526503:  Hold'em No Limit ($0.50/$1.00 USD) - 2016/06/21 13:34:16 CET [2016/06/21 7:34:16 ET]
Table 'Moreau' 9-max Seat #9 is the button
Seat 1: ozone2003 ($129.49 in chips) 
Seat 2: Avtovo ($108.50 in chips) 
Seat 3: matiko09 ($108.38 in chips) 
Seat 4: SharingaaN ($99.50 in chips) 
Seat 6: Troll8989 ($100 in chips) 
Seat 7: PanKwn15 ($102.39 in chips) 
Seat 9: Toonersens ($113.42 in chips) 
ozone2003: posts small blind $0.50
Avtovo: posts big blind $1
*** HOLE CARDS ***
Dealt to matiko09 [Tc 6s]
matiko09: folds 
SharingaaN: folds 
Troll8989: folds 
PanKwn15: folds 
Toonersens: raises $1 to $2
ozone2003: folds 
Avtovo: folds 
Uncalled bet ($1) returned to Toonersens
Toonersens collected $2.50 from pot
DIMAN_324 was removed from the table for failing to post
*** SUMMARY ***
Total pot $2.50 | Rake $0 
Seat 1: ozone2003 (small blind) folded before Flop
Seat 2: Avtovo (big blind) folded before Flop
Seat 3: matiko09 folded before Flop (didn't bet)
Seat 4: SharingaaN folded before Flop (didn't bet)
Seat 6: Troll8989 folded before Flop (didn't bet)
Seat 7: PanKwn15 folded before Flop (didn't bet)
Seat 9: Toonersens (button) collected ($2.50)





PokerStars Hand #155013527310:  Hold'em No Limit (€0.50/€1.00 EUR) - 2016/06/21 13:34:18 CET [2016/06/21 7:34:18 ET]
Table 'Alkes' 9-max Seat #3 is the button
Seat 1: Ping_Ping14 (€55.39 in chips) 
Seat 2: matiko09 (€100 in chips) 
Seat 3: erick222 (€100 in chips) 
Seat 4: 50CandyJoe (€105.02 in chips) 
Seat 5: CoolFireX (€100 in chips) 
Seat 6: Filojoes (€100 in chips) 
50CandyJoe: posts small blind €0.50
CoolFireX: posts big blind €1
ozone2003: sits out 
*** HOLE CARDS ***
Dealt to matiko09 [Th Jd]
Filojoes: folds 
Ping_Ping14: calls €1
matiko09: raises €3 to €4
erick222: calls €4
50CandyJoe: folds 
hurtNCYDE joins the table at seat #7 
hurtNCYDE leaves the table
CoolFireX: folds 
Ping_Ping14: folds 
*** FLOP *** [3h Jh 5s]
matiko09: bets €5.18
erick222: calls €5.18
*** TURN *** [3h Jh 5s] [Jc]
matiko09: checks 
erick222: checks 
*** RIVER *** [3h Jh 5s Jc] [9d]
Donetsk1y joins the table at seat #7 
matiko09: bets €6.14
Donetsk1y leaves the table
Troll8989 joins the table at seat #7 
erick222: folds 
Uncalled bet (€6.14) returned to matiko09
matiko09 collected €19.82 from pot
matiko09: doesn't show hand 
*** SUMMARY ***
Total pot €20.86 | Rake €1.04 
Board [3h Jh 5s Jc 9d]
Seat 1: Ping_Ping14 folded before Flop
Seat 2: matiko09 collected (€19.82)
Seat 3: erick222 (button) folded on the River
Seat 4: 50CandyJoe (small blind) folded before Flop
Seat 5: CoolFireX (big blind) folded before Flop
Seat 6: Filojoes folded before Flop (didn't bet)





PokerStars Hand #155013529154:  Hold'em No Limit ($0.50/$1.00 USD) - 2016/06/21 13:34:22 CET [2016/06/21 7:34:22 ET]
Table 'Chimay' 9-max Seat #8 is the button
Seat 2: pyromid ($147.46 in chips) 
Seat 4: fukumimi ($98.50 in chips) 
Seat 5: The Big Ape ($94.28 in chips) 
Seat 6: mbk88 ($146.97 in chips) 
Seat 7: matiko09 ($115.70 in chips) 
Seat 8: Eskimo Fox ($133.30 in chips) 
pyromid: posts small blind $0.50
CoolFireX joins the table at seat #1 
fukumimi: posts big blind $1
*** HOLE CARDS ***
Dealt to matiko09 [4c 5s]
The Big Ape: folds 
mbk88: folds 
matiko09: folds 
SharingaaN leaves the table
Eskimo Fox: raises $1 to $2
pyromid: folds 
fukumimi: folds 
Uncalled bet ($1) returned to Eskimo Fox
Eskimo Fox collected $2.50 from pot
Eskimo Fox: doesn't show hand 
*** SUMMARY ***
Total pot $2.50 | Rake $0 
Seat 2: pyromid (small blind) folded before Flop
Seat 4: fukumimi (big blind) folded before Flop
Seat 5: The Big Ape folded before Flop (didn't bet)
Seat 6: mbk88 folded before Flop (didn't bet)
Seat 7: matiko09 folded before Flop (didn't bet)
Seat 8: Eskimo Fox (button) collected ($2.50)





PokerStars Hand #155013529715:  Hold'em No Limit ($0.50/$1.00 USD) - 2016/06/21 13:34:23 CET [2016/06/21 7:34:23 ET]
Table 'Lamberta II' 9-max Seat #1 is the button
Seat 1: mbk88 ($176.50 in chips) 
Seat 3: matiko09 ($100 in chips) 
Seat 4: Eskimo Fox ($117.91 in chips) 
Seat 5: mi$$I$Elena ($106.87 in chips) 
Seat 7: phil_cheng ($114.90 in chips) 
Seat 8: Troll8989 ($100 in chips) 
Seat 9: Sjtu_Michael ($109.94 in chips) 
matiko09: posts small blind $0.50
Eskimo Fox: posts big blind $1
Chen423: sits out 
*** HOLE CARDS ***
Dealt to matiko09 [7c Ks]
mi$$I$Elena: raises $1.38 to $2.38
phil_cheng: folds 
Troll8989: folds 
Sjtu_Michael: folds 
mbk88: calls $2.38
matiko09: folds 
Eskimo Fox: folds 
*** FLOP *** [7d 5s Js]
mi$$I$Elena: bets $4
mbk88: raises $8 to $12
mi$$I$Elena: folds 
Uncalled bet ($8) returned to mbk88
mbk88 collected $13.55 from pot
mbk88: doesn't show hand 
*** SUMMARY ***
Total pot $14.26 | Rake $0.71 
Board [7d 5s Js]
Seat 1: mbk88 (button) collected ($13.55)
Seat 3: matiko09 (small blind) folded before Flop
Seat 4: Eskimo Fox (big blind) folded before Flop
Seat 5: mi$$I$Elena folded on the Flop
Seat 7: phil_cheng folded before Flop (didn't bet)
Seat 8: Troll8989 folded before Flop (didn't bet)
Seat 9: Sjtu_Michael folded before Flop (didn't bet)





PokerStars Hand #155013532674:  Hold'em No Limit ($0.50/$1.00 USD) - 2016/06/21 13:34:30 CET [2016/06/21 7:34:30 ET]
Table 'Admete II' 9-max Seat #9 is the button
Seat 1: Troll8989 ($100 in chips) 
Seat 2: Eskimo Fox ($173.42 in chips) 
Seat 5: mi$$I$Elena ($110.28 in chips) 
Seat 6: mbk88 ($253 in chips) 
Seat 7: matiko09 ($100 in chips) 
Seat 8: koutani7 ($92 in chips) 
Seat 9: CoolFireX ($100 in chips) 
Troll8989: posts small blind $0.50
Eskimo Fox: posts big blind $1
23SmOkEr07: sits out 
*** HOLE CARDS ***
Dealt to matiko09 [4d 9s]
mi$$I$Elena: folds 
mbk88: folds 
matiko09: folds 
koutani7: folds 
CoolFireX: raises $1.50 to $2.50
Troll8989: folds 
Eskimo Fox: folds 
Uncalled bet ($1.50) returned to CoolFireX
CoolFireX collected $2.50 from pot
CoolFireX: doesn't show hand 
*** SUMMARY ***
Total pot $2.50 | Rake $0 
Seat 1: Troll8989 (small blind) folded before Flop
Seat 2: Eskimo Fox (big blind) folded before Flop
Seat 5: mi$$I$Elena folded before Flop (didn't bet)
Seat 6: mbk88 folded before Flop (didn't bet)
Seat 7: matiko09 folded before Flop (didn't bet)
Seat 8: koutani7 folded before Flop (didn't bet)
Seat 9: CoolFireX (button) collected ($2.50)





PokerStars Hand #155013534692:  Hold'em No Limit ($0.50/$1.00 USD) - 2016/06/21 13:34:35 CET [2016/06/21 7:34:35 ET]
Table 'Leo' 9-max Seat #1 is the button
Seat 1: fukumimi ($107.34 in chips) 
Seat 2: mbk88 ($138.07 in chips) 
Seat 3: matiko09 ($100 in chips) 
Seat 4: phil_cheng ($107.33 in chips) 
Seat 5: Troll8989 ($103.52 in chips) 
Seat 6: Avtovo ($100 in chips) 
Seat 7: CoolFireX ($250.70 in chips) 
Seat 8: pyromid ($89.92 in chips) 
Seat 9: Wladimir205 ($119.62 in chips) 
mbk88: posts small blind $0.50
matiko09: posts big blind $1
*** HOLE CARDS ***
Dealt to matiko09 [8c Jd]
phil_cheng: folds 
Troll8989: raises $1.50 to $2.50
Avtovo: folds 
CoolFireX: folds 
pyromid: folds 
Wladimir205: folds 
fukumimi: folds 
mbk88: folds 
matiko09: folds 
Uncalled bet ($1.50) returned to Troll8989
Troll8989 collected $2.50 from pot
Troll8989: doesn't show hand 
*** SUMMARY ***
Total pot $2.50 | Rake $0 
Seat 1: fukumimi (button) folded before Flop (didn't bet)
Seat 2: mbk88 (small blind) folded before Flop
Seat 3: matiko09 (big blind) folded before Flop
Seat 4: phil_cheng folded before Flop (didn't bet)
Seat 5: Troll8989 collected ($2.50)
Seat 6: Avtovo folded before Flop (didn't bet)
Seat 7: CoolFireX folded before Flop (didn't bet)
Seat 8: pyromid folded before Flop (didn't bet)
Seat 9: Wladimir205 folded before Flop (didn't bet)





PokerStars Hand #155013538501:  Hold'em No Limit ($0.50/$1.00 USD) - 2016/06/21 13:34:43 CET [2016/06/21 7:34:43 ET]
Table 'Moreau' 9-max Seat #1 is the button
Seat 1: ozone2003 ($128.99 in chips) 
Seat 2: Avtovo ($107.50 in chips) 
Seat 3: matiko09 ($108.38 in chips) 
Seat 4: SharingaaN ($99.50 in chips) 
Seat 6: Troll8989 ($100 in chips) 
Seat 7: PanKwn15 ($102.39 in chips) 
Seat 9: Toonersens ($114.92 in chips) 
Avtovo: posts small blind $0.50
matiko09: posts big blind $1
*** HOLE CARDS ***
Dealt to matiko09 [5c 3c]
Donetsk1y joins the table at seat #5 
SharingaaN: folds 
Donetsk1y leaves the table
CoolFireX joins the table at seat #5 
Troll8989: raises $1.50 to $2.50
PanKwn15: folds 
Toonersens: folds 
ozone2003: folds 
Avtovo: folds 
matiko09: folds 
Uncalled bet ($1.50) returned to Troll8989
Troll8989 collected $2.50 from pot
Troll8989: doesn't show hand 
*** SUMMARY ***
Total pot $2.50 | Rake $0 
Seat 1: ozone2003 (button) folded before Flop (didn't bet)
Seat 2: Avtovo (small blind) folded before Flop
Seat 3: matiko09 (big blind) folded before Flop
Seat 4: SharingaaN folded before Flop (didn't bet)
Seat 6: Troll8989 collected ($2.50)
Seat 7: PanKwn15 folded before Flop (didn't bet)
Seat 9: Toonersens folded before Flop (didn't bet)





PokerStars Hand #155013539158:  Hold'em No Limit ($0.50/$1.00 USD) - 2016/06/21 13:34:45 CET [2016/06/21 7:34:45 ET]
Table 'Rupertwildt' 9-max Seat #1 is the button
Seat 1: CoolFireX ($195.07 in chips) 
Seat 2: SharingaaN ($101.55 in chips) 
Seat 3: 23SmOkEr07 ($100 in chips) 
Seat 4: matiko09 ($141.68 in chips) 
Seat 5: pyromid ($85 in chips) 
Seat 6: phil_cheng ($124.96 in chips) 
Seat 7: Donetsk1y ($101.50 in chips) 
Seat 8: Gonzanary ($100 in chips) 
Seat 9: mbk88 ($100 in chips) 
SharingaaN: posts small blind $0.50
23SmOkEr07: posts big blind $1
*** HOLE CARDS ***
Dealt to matiko09 [7d 8d]
matiko09: raises $2 to $3
pyromid: folds 
phil_cheng: raises $6 to $9
Donetsk1y: folds 
Gonzanary: folds 
mbk88: folds 
CoolFireX: folds 
SharingaaN: folds 
23SmOkEr07: folds 
matiko09: folds 
Uncalled bet ($6) returned to phil_cheng
phil_cheng collected $7.50 from pot
phil_cheng: doesn't show hand 
*** SUMMARY ***
Total pot $7.50 | Rake $0 
Seat 1: CoolFireX (button) folded before Flop (didn't bet)
Seat 2: SharingaaN (small blind) folded before Flop
Seat 3: 23SmOkEr07 (big blind) folded before Flop
Seat 4: matiko09 folded before Flop
Seat 5: pyromid folded before Flop (didn't bet)
Seat 6: phil_cheng collected ($7.50)
Seat 7: Donetsk1y folded before Flop (didn't bet)
Seat 8: Gonzanary folded before Flop (didn't bet)
Seat 9: mbk88 folded before Flop (didn't bet)





PokerStars Hand #155013542233:  Hold'em No Limit ($0.50/$1.00 USD) - 2016/06/21 13:34:52 CET [2016/06/21 7:34:52 ET]
Table 'Chimay' 9-max Seat #2 is the button
Seat 2: pyromid ($146.96 in chips) 
Seat 4: fukumimi ($97.50 in chips) 
Seat 5: The Big Ape ($94.28 in chips) 
Seat 6: mbk88 ($146.97 in chips) 
Seat 7: matiko09 ($115.70 in chips) 
Seat 8: Eskimo Fox ($134.80 in chips) 
fukumimi: posts small blind $0.50
The Big Ape: posts big blind $1
CoolFireX: sits out 
*** HOLE CARDS ***
Dealt to matiko09 [5s Kc]
mbk88: folds 
matiko09: folds 
23SmOkEr07 joins the table at seat #9 
Eskimo Fox: folds 
pyromid: folds 
fukumimi: raises $2 to $3
The Big Ape: folds 
Uncalled bet ($2) returned to fukumimi
fukumimi collected $2 from pot
fukumimi: doesn't show hand 
*** SUMMARY ***
Total pot $2 | Rake $0 
Seat 2: pyromid (button) folded before Flop (didn't bet)
Seat 4: fukumimi (small blind) collected ($2)
Seat 5: The Big Ape (big blind) folded before Flop
Seat 6: mbk88 folded before Flop (didn't bet)
Seat 7: matiko09 folded before Flop (didn't bet)
Seat 8: Eskimo Fox folded before Flop (didn't bet)





PokerStars Hand #155013547490:  Hold'em No Limit ($0.50/$1.00 USD) - 2016/06/21 13:35:04 CET [2016/06/21 7:35:04 ET]
Table 'Carlova II' 9-max Seat #7 is the button
Seat 1: matiko09 ($107.80 in chips) 
Seat 2: mbk88 ($139.65 in chips) 
Seat 3: SharingaaN ($113.78 in chips) 
Seat 4: Dandy Monk ($76.98 in chips) 
Seat 5: ozone2003 ($111.05 in chips) 
Seat 7: mi$$I$Elena ($115.75 in chips) 
Seat 8: pyromid ($103.80 in chips) 
Seat 9: Troll8989 ($100 in chips) 
pyromid: posts small blind $0.50
Troll8989: posts big blind $1
Donetsk1y: sits out 
*** HOLE CARDS ***
Dealt to matiko09 [5h Td]
matiko09: folds 
mbk88: folds 
SharingaaN: folds 
Dandy Monk: folds 
ozone2003: folds 
mi$$I$Elena: raises $1 to $2
pyromid: folds 
Troll8989: calls $1
*** FLOP *** [Qh 9c 8h]
Troll8989: checks 
mi$$I$Elena: bets $3
Troll8989: calls $3
*** TURN *** [Qh 9c 8h] [2s]
Troll8989: checks 
mi$$I$Elena: checks 
*** RIVER *** [Qh 9c 8h 2s] [Kd]
Troll8989: bets $9.98
mi$$I$Elena: calls $9.98
*** SHOW DOWN ***
Troll8989: shows [Qs 9d] (two pair, Queens and Nines)
mi$$I$Elena: mucks hand 
Troll8989 collected $28.94 from pot
*** SUMMARY ***
Total pot $30.46 | Rake $1.52 
Board [Qh 9c 8h 2s Kd]
Seat 1: matiko09 folded before Flop (didn't bet)
Seat 2: mbk88 folded before Flop (didn't bet)
Seat 3: SharingaaN folded before Flop (didn't bet)
Seat 4: Dandy Monk folded before Flop (didn't bet)
Seat 5: ozone2003 folded before Flop (didn't bet)
Seat 7: mi$$I$Elena (button) mucked [Js Ks]
Seat 8: pyromid (small blind) folded before Flop
Seat 9: Troll8989 (big blind) showed [Qs 9d] and won ($28.94) with two pair, Queens and Nines





PokerStars Hand #155013552288:  Hold'em No Limit ($0.50/$1.00 USD) - 2016/06/21 13:35:15 CET [2016/06/21 7:35:15 ET]
Table 'Moreau' 9-max Seat #2 is the button
Seat 1: ozone2003 ($128.99 in chips) 
Seat 2: Avtovo ($107 in chips) 
Seat 3: matiko09 ($107.38 in chips) 
Seat 4: SharingaaN ($99.50 in chips) 
Seat 6: Troll8989 ($101.50 in chips) 
Seat 7: PanKwn15 ($102.39 in chips) 
Seat 9: Toonersens ($114.92 in chips) 
matiko09: posts small blind $0.50
SharingaaN: posts big blind $1
CoolFireX: sits out 
*** HOLE CARDS ***
Dealt to matiko09 [Qs 7h]
Troll8989: folds 
PanKwn15: folds 
Toonersens: folds 
ozone2003: folds 
Avtovo: raises $1.50 to $2.50
matiko09: folds 
SharingaaN: folds 
Uncalled bet ($1.50) returned to Avtovo
Avtovo collected $2.50 from pot
Avtovo: doesn't show hand 
*** SUMMARY ***
Total pot $2.50 | Rake $0 
Seat 1: ozone2003 folded before Flop (didn't bet)
Seat 2: Avtovo (button) collected ($2.50)
Seat 3: matiko09 (small blind) folded before Flop
Seat 4: SharingaaN (big blind) folded before Flop
Seat 6: Troll8989 folded before Flop (didn't bet)
Seat 7: PanKwn15 folded before Flop (didn't bet)
Seat 9: Toonersens folded before Flop (didn't bet)





PokerStars Hand #155013553082:  Hold'em No Limit ($0.50/$1.00 USD) - 2016/06/21 13:35:17 CET [2016/06/21 7:35:17 ET]
Table 'Admete II' 9-max Seat #1 is the button
Seat 1: Troll8989 ($100 in chips) 
Seat 2: Eskimo Fox ($172.42 in chips) 
Seat 4: 23SmOkEr07 ($100 in chips) 
Seat 5: mi$$I$Elena ($110.28 in chips) 
Seat 6: mbk88 ($253 in chips) 
Seat 7: matiko09 ($100 in chips) 
Seat 8: koutani7 ($92 in chips) 
Eskimo Fox: posts small blind $0.50
23SmOkEr07: posts big blind $1
*** HOLE CARDS ***
Dealt to matiko09 [8c Td]
mi$$I$Elena: folds 
mi$$I$Elena leaves the table
mbk88: raises $2 to $3
matiko09: folds 
koutani7: raises $6 to $9
hurtNCYDE joins the table at seat #5 
Troll8989: folds 
hurtNCYDE leaves the table
stepan0605 joins the table at seat #5 
Eskimo Fox: folds 
23SmOkEr07: folds 
mbk88: folds 
Uncalled bet ($6) returned to koutani7
koutani7 collected $7.50 from pot
koutani7: doesn't show hand 
*** SUMMARY ***
Total pot $7.50 | Rake $0 
Seat 1: Troll8989 (button) folded before Flop (didn't bet)
Seat 2: Eskimo Fox (small blind) folded before Flop
Seat 4: 23SmOkEr07 (big blind) folded before Flop
Seat 5: mi$$I$Elena folded before Flop (didn't bet)
Seat 6: mbk88 folded before Flop
Seat 7: matiko09 folded before Flop (didn't bet)
Seat 8: koutani7 collected ($7.50)





PokerStars Hand #155013553329:  Hold'em No Limit ($0.50/$1.00 USD) - 2016/06/21 13:35:17 CET [2016/06/21 7:35:17 ET]
Table 'Leo' 9-max Seat #2 is the button
Seat 1: fukumimi ($107.34 in chips) 
Seat 2: mbk88 ($137.57 in chips) 
Seat 3: matiko09 ($100 in chips) 
Seat 5: Troll8989 ($105.02 in chips) 
Seat 6: Avtovo ($100 in chips) 
Seat 8: pyromid ($89.92 in chips) 
Seat 9: Wladimir205 ($119.62 in chips) 
matiko09: posts small blind $0.50
phil_cheng: is sitting out 
Troll8989: posts big blind $1
*** HOLE CARDS ***
Dealt to matiko09 [5s 3s]
phil_cheng leaves the table
Avtovo: raises $1.50 to $2.50
pyromid: folds 
el Fatto joins the table at seat #4 
Wladimir205: folds 
fukumimi: folds 
mbk88: folds 
matiko09: folds 
Troll8989: folds 
Uncalled bet ($1.50) returned to Avtovo
Avtovo collected $2.50 from pot
Avtovo: doesn't show hand 
*** SUMMARY ***
Total pot $2.50 | Rake $0 
Seat 1: fukumimi folded before Flop (didn't bet)
Seat 2: mbk88 (button) folded before Flop (didn't bet)
Seat 3: matiko09 (small blind) folded before Flop
Seat 5: Troll8989 (big blind) folded before Flop
Seat 6: Avtovo collected ($2.50)
Seat 8: pyromid folded before Flop (didn't bet)
Seat 9: Wladimir205 folded before Flop (didn't bet)





PokerStars Hand #155013553446:  Hold'em No Limit ($0.50/$1.00 USD) - 2016/06/21 13:35:17 CET [2016/06/21 7:35:17 ET]
Table 'Lamberta II' 9-max Seat #3 is the button
Seat 1: mbk88 ($183.67 in chips) 
Seat 3: matiko09 ($100 in chips) 
Seat 4: Eskimo Fox ($116.91 in chips) 
Seat 6: Chen423 ($73 in chips) 
Seat 7: phil_cheng ($114.90 in chips) 
Seat 8: Troll8989 ($100 in chips) 
Seat 9: Sjtu_Michael ($109.94 in chips) 
Eskimo Fox: posts small blind $0.50
mi$$I$Elena: is sitting out 
Chen423: posts big blind $1
*** HOLE CARDS ***
Dealt to matiko09 [4s Kh]
mi$$I$Elena leaves the table
phil_cheng: folds 
Troll8989: folds 
Sjtu_Michael: folds 
mbk88: raises $2 to $3
matiko09: folds 
CoolFireX joins the table at seat #5 
Eskimo Fox: folds 
Chen423: folds 
Uncalled bet ($2) returned to mbk88
mbk88 collected $2.50 from pot
mbk88: doesn't show hand 
*** SUMMARY ***
Total pot $2.50 | Rake $0 
Seat 1: mbk88 collected ($2.50)
Seat 3: matiko09 (button) folded before Flop (didn't bet)
Seat 4: Eskimo Fox (small blind) folded before Flop
Seat 6: Chen423 (big blind) folded before Flop
Seat 7: phil_cheng folded before Flop (didn't bet)
Seat 8: Troll8989 folded before Flop (didn't bet)
Seat 9: Sjtu_Michael folded before Flop (didn't bet)





PokerStars Hand #155013553531:  Hold'em No Limit (€0.25/€0.50 EUR) - 2016/06/21 13:35:18 CET [2016/06/21 7:35:18 ET]
Table 'Actor II' 6-max Seat #6 is the button
Seat 1: hmverlin (€105.21 in chips) 
Seat 2: alôha (€56.64 in chips) 
Seat 3: asmodej666 (€82.09 in chips) 
Seat 4: matiko09 (€63.75 in chips) 
Seat 5: Rybka1294 (€50 in chips) 
Seat 6: fanmtZ (€20 in chips) 
hmverlin: posts small blind €0.25
alôha: posts big blind €0.50
*** HOLE CARDS ***
Dealt to matiko09 [2d 9h]
asmodej666: folds 
asmodej666 leaves the table
matiko09: folds 
Rybka1294: folds 
fanmtZ: folds 
hmverlin: raises €1 to €1.50
alôha: folds 
Uncalled bet (€1) returned to hmverlin
hmverlin collected €1 from pot
hmverlin: doesn't show hand 
*** SUMMARY ***
Total pot €1 | Rake €0 
Seat 1: hmverlin (small blind) collected (€1)
Seat 2: alôha (big blind) folded before Flop
Seat 3: asmodej666 folded before Flop (didn't bet)
Seat 4: matiko09 folded before Flop (didn't bet)
Seat 5: Rybka1294 folded before Flop (didn't bet)
Seat 6: fanmtZ (button) folded before Flop (didn't bet)





PokerStars Hand #155013554237:  Hold'em No Limit ($0.50/$1.00 USD) - 2016/06/21 13:35:19 CET [2016/06/21 7:35:19 ET]
Table 'Saldanha' 9-max Seat #2 is the button
Seat 2: matiko09 ($400.29 in chips) 
Seat 5: Michael Quan ($137.53 in chips) 
Seat 6: Donetsk1y ($106.14 in chips) 
Seat 7: ozone2003 ($119.80 in chips) 
Seat 8: erick222 ($100 in chips) 
Seat 9: 23SmOkEr07 ($100 in chips) 
mbk88 will be allowed to play after the button
Michael Quan: posts small blind $0.50
Donetsk1y: posts big blind $1
stepan0605: sits out 
matiko09: posts the ante $0.20
Michael Quan: posts the ante $0.20
Donetsk1y: posts the ante $0.20
ozone2003: posts the ante $0.20
erick222: posts the ante $0.20
23SmOkEr07: posts the ante $0.20
*** HOLE CARDS ***
Dealt to matiko09 [2h Td]
ozone2003: folds 
erick222: folds 
23SmOkEr07: folds 
matiko09: folds 
Michael Quan: calls $0.50
Donetsk1y: raises $3 to $4
Michael Quan: folds 
Uncalled bet ($3) returned to Donetsk1y
Donetsk1y collected $3.20 from pot
Donetsk1y: doesn't show hand 
*** SUMMARY ***
Total pot $3.20 | Rake $0 
Seat 2: matiko09 (button) folded before Flop (didn't bet)
Seat 5: Michael Quan (small blind) folded before Flop
Seat 6: Donetsk1y (big blind) collected ($3.20)
Seat 7: ozone2003 folded before Flop (didn't bet)
Seat 8: erick222 folded before Flop (didn't bet)
Seat 9: 23SmOkEr07 folded before Flop (didn't bet)





PokerStars Hand #155013555517:  Hold'em No Limit ($0.50/$1.00 USD) - 2016/06/21 13:35:22 CET [2016/06/21 7:35:22 ET]
Table 'Chimay' 9-max Seat #4 is the button
Seat 2: pyromid ($146.96 in chips) 
Seat 4: fukumimi ($98.50 in chips) 
Seat 5: The Big Ape ($93.28 in chips) 
Seat 6: mbk88 ($146.97 in chips) 
Seat 7: matiko09 ($115.70 in chips) 
Seat 8: Eskimo Fox ($134.80 in chips) 
The Big Ape: posts small blind $0.50
mbk88: posts big blind $1
23SmOkEr07: sits out 
CoolFireX: sits out 
*** HOLE CARDS ***
Dealt to matiko09 [Kh Jc]
matiko09: folds 
Eskimo Fox: raises $2 to $3
pyromid: folds 
fukumimi: folds 
The Big Ape: folds 
mbk88: folds 
Uncalled bet ($2) returned to Eskimo Fox
Eskimo Fox collected $2.50 from pot
Eskimo Fox: doesn't show hand 
*** SUMMARY ***
Total pot $2.50 | Rake $0 
Seat 2: pyromid folded before Flop (didn't bet)
Seat 4: fukumimi (button) folded before Flop (didn't bet)
Seat 5: The Big Ape (small blind) folded before Flop
Seat 6: mbk88 (big blind) folded before Flop
Seat 7: matiko09 folded before Flop (didn't bet)
Seat 8: Eskimo Fox collected ($2.50)





PokerStars Hand #155013563792:  Hold'em No Limit ($0.50/$1.00 USD) - 2016/06/21 13:35:41 CET [2016/06/21 7:35:41 ET]
Table 'Leo' 9-max Seat #3 is the button
Seat 1: fukumimi ($107.34 in chips) 
Seat 2: mbk88 ($137.57 in chips) 
Seat 3: matiko09 ($100 in chips) 
Seat 5: Troll8989 ($104.02 in chips) 
Seat 8: pyromid ($89.92 in chips) 
Seat 9: Wladimir205 ($119.62 in chips) 
Troll8989: posts small blind $0.50
Avtovo: is sitting out 
pyromid: posts big blind $1
*** HOLE CARDS ***
Dealt to matiko09 [7d As]
Avtovo leaves the table
hurtNCYDE joins the table at seat #6 
Wladimir205: folds 
hurtNCYDE leaves the table
fukumimi: folds 
stepan0605 joins the table at seat #6 
el Fatto leaves the table
mbk88: raises $1.02 to $2.02
Filojoes joins the table at seat #4 
Filojoes leaves the table
matiko09: folds 
chaps1988 joins the table at seat #4 
Troll8989: folds 
pyromid: folds 
Uncalled bet ($1.02) returned to mbk88
mbk88 collected $2.50 from pot
mbk88: doesn't show hand 
*** SUMMARY ***
Total pot $2.50 | Rake $0 
Seat 1: fukumimi folded before Flop (didn't bet)
Seat 2: mbk88 collected ($2.50)
Seat 3: matiko09 (button) folded before Flop (didn't bet)
Seat 5: Troll8989 (small blind) folded before Flop
Seat 8: pyromid (big blind) folded before Flop
Seat 9: Wladimir205 folded before Flop (didn't bet)





PokerStars Hand #155013564635:  Hold'em No Limit (€0.25/€0.50 EUR) - 2016/06/21 13:35:43 CET [2016/06/21 7:35:43 ET]
Table 'Actor II' 6-max Seat #1 is the button
Seat 1: hmverlin (€105.71 in chips) 
Seat 2: alôha (€56.14 in chips) 
Seat 4: matiko09 (€63.75 in chips) 
Seat 5: Rybka1294 (€50 in chips) 
Seat 6: fanmtZ (€20 in chips) 
alôha: posts small blind €0.25
matiko09: posts big blind €0.50
*** HOLE CARDS ***
Dealt to matiko09 [2h 3d]
Rybka1294: folds 
fanmtZ: folds 
hmverlin: folds 
alôha: raises €1 to €1.50
matiko09: folds 
Uncalled bet (€1) returned to alôha
alôha collected €1 from pot
alôha: doesn't show hand 
*** SUMMARY ***
Total pot €1 | Rake €0 
Seat 1: hmverlin (button) folded before Flop (didn't bet)
Seat 2: alôha (small blind) collected (€1)
Seat 4: matiko09 (big blind) folded before Flop
Seat 5: Rybka1294 folded before Flop (didn't bet)
Seat 6: fanmtZ folded before Flop (didn't bet)





PokerStars Hand #155013564532:  Hold'em No Limit (€0.50/€1.00 EUR) - 2016/06/21 13:35:43 CET [2016/06/21 7:35:43 ET]
Table 'Alkes' 9-max Seat #4 is the button
Seat 1: Ping_Ping14 (€54.39 in chips) 
Seat 2: matiko09 (€110.64 in chips) 
Seat 3: erick222 (€100 in chips) 
Seat 4: 50CandyJoe (€104.52 in chips) 
Seat 6: Filojoes (€100 in chips) 
Seat 8: ozone2003 (€100 in chips) 
Filojoes: posts small blind €0.50
ozone2003: posts big blind €1
*** HOLE CARDS ***
Dealt to matiko09 [4s Kd]
Troll8989 leaves the table
Ping_Ping14: calls €1
matiko09: folds 
chaps1988 joins the table at seat #7 
erick222: folds 
50CandyJoe: raises €3 to €4
Filojoes: folds 
ozone2003: folds 
Ping_Ping14: folds 
Uncalled bet (€3) returned to 50CandyJoe
50CandyJoe collected €3.50 from pot
50CandyJoe: doesn't show hand 
*** SUMMARY ***
Total pot €3.50 | Rake €0 
Seat 1: Ping_Ping14 folded before Flop
Seat 2: matiko09 folded before Flop (didn't bet)
Seat 3: erick222 folded before Flop (didn't bet)
Seat 4: 50CandyJoe (button) collected (€3.50)
Seat 6: Filojoes (small blind) folded before Flop
Seat 8: ozone2003 (big blind) folded before Flop





PokerStars Hand #155013570137:  Hold'em No Limit ($0.50/$1.00 USD) - 2016/06/21 13:35:55 CET [2016/06/21 7:35:55 ET]
Table 'Moreau' 9-max Seat #3 is the button
Seat 1: ozone2003 ($128.99 in chips) 
Seat 2: Avtovo ($108.50 in chips) 
Seat 3: matiko09 ($106.88 in chips) 
Seat 4: SharingaaN ($98.50 in chips) 
Seat 5: CoolFireX ($104 in chips) 
Seat 6: Troll8989 ($101.50 in chips) 
Seat 7: PanKwn15 ($102.39 in chips) 
Seat 9: Toonersens ($114.92 in chips) 
SharingaaN: posts small blind $0.50
CoolFireX: posts big blind $1
*** HOLE CARDS ***
Dealt to matiko09 [4c Kh]
Troll8989: raises $1.50 to $2.50
PanKwn15: folds 
Toonersens: folds 
ozone2003: folds 
Avtovo: folds 
matiko09: folds 
SharingaaN: folds 
CoolFireX: folds 
Uncalled bet ($1.50) returned to Troll8989
Troll8989 collected $2.50 from pot
Troll8989: doesn't show hand 
*** SUMMARY ***
Total pot $2.50 | Rake $0 
Seat 1: ozone2003 folded before Flop (didn't bet)
Seat 2: Avtovo folded before Flop (didn't bet)
Seat 3: matiko09 (button) folded before Flop (didn't bet)
Seat 4: SharingaaN (small blind) folded before Flop
Seat 5: CoolFireX (big blind) folded before Flop
Seat 6: Troll8989 collected ($2.50)
Seat 7: PanKwn15 folded before Flop (didn't bet)
Seat 9: Toonersens folded before Flop (didn't bet)





PokerStars Hand #155013571705:  Hold'em No Limit ($0.50/$1.00 USD) - 2016/06/21 13:35:59 CET [2016/06/21 7:35:59 ET]
Table 'Saldanha' 9-max Seat #5 is the button
Seat 2: matiko09 ($400.09 in chips) 
Seat 5: Michael Quan ($136.33 in chips) 
Seat 6: Donetsk1y ($108.14 in chips) 
Seat 7: ozone2003 ($119.60 in chips) 
Seat 8: erick222 ($100 in chips) 
Seat 9: 23SmOkEr07 ($100 in chips) 
Donetsk1y: posts small blind $0.50
ozone2003: posts big blind $1
stepan0605: sits out 
mbk88: sits out 
matiko09: posts the ante $0.20
Michael Quan: posts the ante $0.20
Donetsk1y: posts the ante $0.20
ozone2003: posts the ante $0.20
erick222: posts the ante $0.20
23SmOkEr07: posts the ante $0.20
*** HOLE CARDS ***
Dealt to matiko09 [Td 3d]
erick222: folds 
23SmOkEr07: folds 
matiko09: folds 
Michael Quan: raises $1 to $2
Donetsk1y: raises $6 to $8
ozone2003: folds 
Michael Quan: raises $18.20 to $26.20
Donetsk1y: raises $81.74 to $107.94 and is all-in
Michael Quan: folds 
Uncalled bet ($81.74) returned to Donetsk1y
Donetsk1y collected $54.60 from pot
Donetsk1y: doesn't show hand 
*** SUMMARY ***
Total pot $54.60 | Rake $0 
Seat 2: matiko09 folded before Flop (didn't bet)
Seat 5: Michael Quan (button) folded before Flop
Seat 6: Donetsk1y (small blind) collected ($54.60)
Seat 7: ozone2003 (big blind) folded before Flop
Seat 8: erick222 folded before Flop (didn't bet)
Seat 9: 23SmOkEr07 folded before Flop (didn't bet)





PokerStars Hand #155013575332:  Hold'em No Limit ($0.50/$1.00 USD) - 2016/06/21 13:36:07 CET [2016/06/21 7:36:07 ET]
Table 'Lamberta II' 9-max Seat #4 is the button
Seat 1: mbk88 ($185.17 in chips) 
Seat 3: matiko09 ($100 in chips) 
Seat 4: Eskimo Fox ($116.41 in chips) 
Seat 6: Chen423 ($72 in chips) 
Seat 8: Troll8989 ($100 in chips) 
Seat 9: Sjtu_Michael ($109.94 in chips) 
Chen423: posts small blind $0.50
phil_cheng: is sitting out 
Troll8989: posts big blind $1
*** HOLE CARDS ***
Dealt to matiko09 [6s 3d]
phil_cheng leaves the table
Sjtu_Michael: folds 
mbk88: folds 
matiko09: folds 
23SmOkEr07 joins the table at seat #7 
Eskimo Fox: raises $1 to $2
Chen423: folds 
Troll8989: calls $1
*** FLOP *** [8s 2h Tc]
Troll8989: checks 
Eskimo Fox: checks 
*** TURN *** [8s 2h Tc] [As]
Troll8989: bets $3
Eskimo Fox: calls $3
*** RIVER *** [8s 2h Tc As] [2c]
Troll8989: checks 
Eskimo Fox: checks 
*** SHOW DOWN ***
Troll8989: shows [Ks Qh] (a pair of Deuces)
Eskimo Fox: shows [5s Ah] (two pair, Aces and Deuces)
Eskimo Fox collected $9.98 from pot
*** SUMMARY ***
Total pot $10.50 | Rake $0.52 
Board [8s 2h Tc As 2c]
Seat 1: mbk88 folded before Flop (didn't bet)
Seat 3: matiko09 folded before Flop (didn't bet)
Seat 4: Eskimo Fox (button) showed [5s Ah] and won ($9.98) with two pair, Aces and Deuces
Seat 6: Chen423 (small blind) folded before Flop
Seat 8: Troll8989 (big blind) showed [Ks Qh] and lost with a pair of Deuces
Seat 9: Sjtu_Michael folded before Flop (didn't bet)





PokerStars Hand #155013575767:  Hold'em No Limit (€0.25/€0.50 EUR) - 2016/06/21 13:36:08 CET [2016/06/21 7:36:08 ET]
Table 'Actor II' 6-max Seat #2 is the button
Seat 1: hmverlin (€105.71 in chips) 
Seat 2: alôha (€56.64 in chips) 
Seat 4: matiko09 (€63.25 in chips) 
Seat 6: fanmtZ (€20 in chips) 
matiko09: posts small blind €0.25
Rybka1294: is sitting out 
fanmtZ: posts big blind €0.50
*** HOLE CARDS ***
Dealt to matiko09 [Qs Js]
Rybka1294 leaves the table
hmverlin: folds 
alôha: folds 
matiko09: raises €1 to €1.50
fanmtZ: folds 
Uncalled bet (€1) returned to matiko09
matiko09 collected €1 from pot
matiko09: doesn't show hand 
*** SUMMARY ***
Total pot €1 | Rake €0 
Seat 1: hmverlin folded before Flop (didn't bet)
Seat 2: alôha (button) folded before Flop (didn't bet)
Seat 4: matiko09 (small blind) collected (€1)
Seat 6: fanmtZ (big blind) folded before Flop





PokerStars Hand #155013576422:  Hold'em No Limit ($0.50/$1.00 USD) - 2016/06/21 13:36:09 CET [2016/06/21 7:36:09 ET]
Table 'Leo' 9-max Seat #5 is the button
Seat 1: fukumimi ($107.34 in chips) 
Seat 2: mbk88 ($139.07 in chips) 
Seat 3: matiko09 ($100 in chips) 
Seat 5: Troll8989 ($103.52 in chips) 
Seat 8: pyromid ($88.92 in chips) 
Seat 9: Wladimir205 ($119.62 in chips) 
stepan0605 will be allowed to play after the button
pyromid: posts small blind $0.50
Wladimir205: posts big blind $1
chaps1988: sits out 
*** HOLE CARDS ***
Dealt to matiko09 [Kh 8s]
fukumimi: raises $2 to $3
mbk88: folds 
matiko09: folds 
Troll8989: folds 
pyromid: folds 
Wladimir205: calls $2
*** FLOP *** [7d 5d Jd]
Wladimir205: checks 
fukumimi: checks 
*** TURN *** [7d 5d Jd] [5h]
Wladimir205: bets $3.09
fukumimi: calls $3.09
*** RIVER *** [7d 5d Jd 5h] [6d]
Wladimir205: checks 
fukumimi: checks 
*** SHOW DOWN ***
Wladimir205: shows [Jh Ah] (two pair, Jacks and Fives)
fukumimi: shows [3d 3h] (a flush, Jack high)
fukumimi collected $12.05 from pot
*** SUMMARY ***
Total pot $12.68 | Rake $0.63 
Board [7d 5d Jd 5h 6d]
Seat 1: fukumimi showed [3d 3h] and won ($12.05) with a flush, Jack high
Seat 2: mbk88 folded before Flop (didn't bet)
Seat 3: matiko09 folded before Flop (didn't bet)
Seat 5: Troll8989 (button) folded before Flop (didn't bet)
Seat 8: pyromid (small blind) folded before Flop
Seat 9: Wladimir205 (big blind) showed [Jh Ah] and lost with two pair, Jacks and Fives





PokerStars Hand #155013577151:  Hold'em No Limit (€0.50/€1.00 EUR) - 2016/06/21 13:36:11 CET [2016/06/21 7:36:11 ET]
Table 'Alkes' 9-max Seat #6 is the button
Seat 1: Ping_Ping14 (€53.39 in chips) 
Seat 2: matiko09 (€110.64 in chips) 
Seat 3: erick222 (€100 in chips) 
Seat 4: 50CandyJoe (€107.02 in chips) 
Seat 6: Filojoes (€100 in chips) 
Seat 8: ozone2003 (€100 in chips) 
chaps1988 will be allowed to play after the button
ozone2003: posts small blind €0.50
Ping_Ping14: posts big blind €1
*** HOLE CARDS ***
Dealt to matiko09 [4s 2d]
matiko09: folds 
erick222: folds 
50CandyJoe: folds 
Filojoes: raises €1 to €2
ozone2003: calls €1.50
Ping_Ping14: calls €1
*** FLOP *** [4d Jc 7h]
ozone2003: checks 
Ping_Ping14: checks 
Filojoes: bets €3.42
ozone2003: raises €9.15 to €12.57
Ping_Ping14: folds 
Filojoes: folds 
Uncalled bet (€9.15) returned to ozone2003
ozone2003 collected €12.20 from pot
ozone2003: doesn't show hand 
*** SUMMARY ***
Total pot €12.84 | Rake €0.64 
Board [4d Jc 7h]
Seat 1: Ping_Ping14 (big blind) folded on the Flop
Seat 2: matiko09 folded before Flop (didn't bet)
Seat 3: erick222 folded before Flop (didn't bet)
Seat 4: 50CandyJoe folded before Flop (didn't bet)
Seat 6: Filojoes (button) folded on the Flop
Seat 8: ozone2003 (small blind) collected (€12.20)





PokerStars Hand #155013581199:  Hold'em No Limit ($0.50/$1.00 USD) - 2016/06/21 13:36:20 CET [2016/06/21 7:36:20 ET]
Table 'Admete II' 9-max Seat #2 is the button
Seat 1: Troll8989 ($100 in chips) 
Seat 2: Eskimo Fox ($171.92 in chips) 
Seat 4: 23SmOkEr07 ($100 in chips) 
Seat 5: stepan0605 ($100 in chips) 
Seat 6: mbk88 ($250 in chips) 
Seat 7: matiko09 ($100 in chips) 
Seat 8: koutani7 ($96.50 in chips) 
23SmOkEr07: posts small blind $0.50
stepan0605: posts big blind $1
*** HOLE CARDS ***
Dealt to matiko09 [6c Ks]
mbk88: folds 
matiko09: folds 
koutani7: folds 
Troll8989: raises $1.50 to $2.50
Eskimo Fox: folds 
23SmOkEr07: folds 
stepan0605: folds 
Uncalled bet ($1.50) returned to Troll8989
Troll8989 collected $2.50 from pot
Troll8989: doesn't show hand 
*** SUMMARY ***
Total pot $2.50 | Rake $0 
Seat 1: Troll8989 collected ($2.50)
Seat 2: Eskimo Fox (button) folded before Flop (didn't bet)
Seat 4: 23SmOkEr07 (small blind) folded before Flop
Seat 5: stepan0605 (big blind) folded before Flop
Seat 6: mbk88 folded before Flop (didn't bet)
Seat 7: matiko09 folded before Flop (didn't bet)
Seat 8: koutani7 folded before Flop (didn't bet)





PokerStars Hand #155013583103:  Hold'em No Limit ($0.50/$1.00 USD) - 2016/06/21 13:36:25 CET [2016/06/21 7:36:25 ET]
Table 'Carlova II' 9-max Seat #8 is the button
Seat 1: matiko09 ($107.80 in chips) 
Seat 2: mbk88 ($139.65 in chips) 
Seat 3: SharingaaN ($113.78 in chips) 
Seat 4: Dandy Monk ($76.98 in chips) 
Seat 5: ozone2003 ($111.05 in chips) 
Seat 7: mi$$I$Elena ($100.77 in chips) 
Seat 8: pyromid ($103.30 in chips) 
Seat 9: Troll8989 ($113.96 in chips) 
Troll8989: posts small blind $0.50
matiko09: posts big blind $1
Donetsk1y: sits out 
*** HOLE CARDS ***
Dealt to matiko09 [9h 8d]
mbk88: folds 
SharingaaN: folds 
Dandy Monk: raises $2 to $3
ozone2003: calls $3
mi$$I$Elena: folds 
pyromid: folds 
Troll8989: folds 
matiko09: folds 
*** FLOP *** [Ts Js 7c]
Dandy Monk: bets $4
ozone2003: raises $15.83 to $19.83
Dandy Monk: calls $15.83
*** TURN *** [Ts Js 7c] [Ks]
Dandy Monk: checks 
ozone2003: bets $88.22 and is all-in
Dandy Monk: calls $54.15 and is all-in
Uncalled bet ($34.07) returned to ozone2003
*** RIVER *** [Ts Js 7c Ks] [6c]
*** SHOW DOWN ***
Dandy Monk: shows [As 7s] (a flush, Ace high)
ozone2003: shows [Jd Td] (two pair, Jacks and Tens)
Dandy Monk collected $152.96 from pot
*** SUMMARY ***
Total pot $155.46 | Rake $2.50 
Board [Ts Js 7c Ks 6c]
Seat 1: matiko09 (big blind) folded before Flop
Seat 2: mbk88 folded before Flop (didn't bet)
Seat 3: SharingaaN folded before Flop (didn't bet)
Seat 4: Dandy Monk showed [As 7s] and won ($152.96) with a flush, Ace high
Seat 5: ozone2003 showed [Jd Td] and lost with two pair, Jacks and Tens
Seat 7: mi$$I$Elena folded before Flop (didn't bet)
Seat 8: pyromid (button) folded before Flop (didn't bet)
Seat 9: Troll8989 (small blind) folded before Flop





PokerStars Hand #155013584497:  Hold'em No Limit ($0.50/$1.00 USD) - 2016/06/21 13:36:28 CET [2016/06/21 7:36:28 ET]
Table 'Moreau' 9-max Seat #4 is the button
Seat 1: ozone2003 ($128.99 in chips) 
Seat 2: Avtovo ($108.50 in chips) 
Seat 3: matiko09 ($106.88 in chips) 
Seat 4: SharingaaN ($98 in chips) 
Seat 6: Troll8989 ($103 in chips) 
Seat 7: PanKwn15 ($102.39 in chips) 
Seat 9: Toonersens ($114.92 in chips) 
Troll8989: posts small blind $0.50
PanKwn15: posts big blind $1
*** HOLE CARDS ***
Dealt to matiko09 [9h 8c]
Toonersens: folds 
ozone2003: folds 
Avtovo: folds 
matiko09: folds 
SharingaaN: raises $1 to $2
Troll8989: folds 
PanKwn15: calls $1
*** FLOP *** [7c 5d Ad]
PanKwn15: checks 
SharingaaN: bets $3.42
PanKwn15: folds 
Uncalled bet ($3.42) returned to SharingaaN
SharingaaN collected $4.28 from pot
SharingaaN: doesn't show hand 
*** SUMMARY ***
Total pot $4.50 | Rake $0.22 
Board [7c 5d Ad]
Seat 1: ozone2003 folded before Flop (didn't bet)
Seat 2: Avtovo folded before Flop (didn't bet)
Seat 3: matiko09 folded before Flop (didn't bet)
Seat 4: SharingaaN (button) collected ($4.28)
Seat 6: Troll8989 (small blind) folded before Flop
Seat 7: PanKwn15 (big blind) folded on the Flop
Seat 9: Toonersens folded before Flop (didn't bet)





PokerStars Hand #155013587784:  Hold'em No Limit (€0.25/€0.50 EUR) - 2016/06/21 13:36:36 CET [2016/06/21 7:36:36 ET]
Table 'Actor II' 6-max Seat #4 is the button
Seat 1: hmverlin (€105.71 in chips) 
Seat 2: alôha (€56.64 in chips) 
Seat 4: matiko09 (€63.75 in chips) 
Seat 6: fanmtZ (€20 in chips) 
fanmtZ: posts small blind €0.25
hmverlin: posts big blind €0.50
*** HOLE CARDS ***
Dealt to matiko09 [Kd Kc]
alôha: folds 
matiko09: raises €0.63 to €1.13
fanmtZ: raises €2.12 to €3.25
hmverlin: calls €2.75
AlexPles joins the table at seat #5 
matiko09: raises €6.25 to €9.50
fanmtZ: folds 
hmverlin: calls €6.25
*** FLOP *** [9d 2d Ac]
hmverlin: checks 
TopMo3UJlo joins the table at seat #3 
matiko09: checks 
*** TURN *** [9d 2d Ac] [Qd]
hmverlin: bets €3
matiko09: calls €3
*** RIVER *** [9d 2d Ac Qd] [5c]
hmverlin: bets €6
matiko09: calls €6
*** SHOW DOWN ***
hmverlin: shows [3h 3d] (a pair of Threes)
matiko09: shows [Kd Kc] (a pair of Kings)
matiko09 collected €39.55 from pot
*** SUMMARY ***
Total pot €40.25 | Rake €0.70 
Board [9d 2d Ac Qd 5c]
Seat 1: hmverlin (big blind) showed [3h 3d] and lost with a pair of Threes
Seat 2: alôha folded before Flop (didn't bet)
Seat 4: matiko09 (button) showed [Kd Kc] and won (€39.55) with a pair of Kings
Seat 6: fanmtZ (small blind) folded before Flop





PokerStars Hand #155013595997:  Hold'em No Limit ($0.50/$1.00 USD) - 2016/06/21 13:36:54 CET [2016/06/21 7:36:54 ET]
Table 'Admete II' 9-max Seat #4 is the button
Seat 1: Troll8989 ($101.50 in chips) 
Seat 2: Eskimo Fox ($171.92 in chips) 
Seat 4: 23SmOkEr07 ($100 in chips) 
Seat 5: stepan0605 ($100 in chips) 
Seat 6: mbk88 ($250 in chips) 
Seat 7: matiko09 ($100 in chips) 
Seat 8: koutani7 ($96.50 in chips) 
stepan0605: posts small blind $0.50
mbk88: posts big blind $1
*** HOLE CARDS ***
Dealt to matiko09 [Qh Ac]
matiko09: raises $2 to $3
koutani7: folds 
Troll8989: folds 
Eskimo Fox: folds 
23SmOkEr07: folds 
50CandyJoe leaves the table
stepan0605: folds 
mbk88: folds 
Uncalled bet ($2) returned to matiko09
matiko09 collected $2.50 from pot
matiko09: doesn't show hand 
*** SUMMARY ***
Total pot $2.50 | Rake $0 
Seat 1: Troll8989 folded before Flop (didn't bet)
Seat 2: Eskimo Fox folded before Flop (didn't bet)
Seat 4: 23SmOkEr07 (button) folded before Flop (didn't bet)
Seat 5: stepan0605 (small blind) folded before Flop
Seat 6: mbk88 (big blind) folded before Flop
Seat 7: matiko09 collected ($2.50)
Seat 8: koutani7 folded before Flop (didn't bet)





PokerStars Hand #155013597166:  Hold'em No Limit ($0.50/$1.00 USD) - 2016/06/21 13:36:57 CET [2016/06/21 7:36:57 ET]
Table 'Leo' 9-max Seat #8 is the button
Seat 1: fukumimi ($113.30 in chips) 
Seat 2: mbk88 ($139.07 in chips) 
Seat 3: matiko09 ($100 in chips) 
Seat 5: Troll8989 ($103.52 in chips) 
Seat 8: pyromid ($88.42 in chips) 
Seat 9: Wladimir205 ($113.53 in chips) 
Wladimir205: posts small blind $0.50
fukumimi: posts big blind $1
chaps1988: sits out 
stepan0605: sits out 
*** HOLE CARDS ***
Dealt to matiko09 [Tc 4h]
mbk88: raises $2 to $3
matiko09: folds 
Troll8989: folds 
pyromid: folds 
Wladimir205: folds 
fukumimi: calls $2
*** FLOP *** [5d 5h 2h]
fukumimi: checks 
mbk88: bets $4
fukumimi: folds 
Uncalled bet ($4) returned to mbk88
mbk88 collected $6.18 from pot
mbk88: doesn't show hand 
*** SUMMARY ***
Total pot $6.50 | Rake $0.32 
Board [5d 5h 2h]
Seat 1: fukumimi (big blind) folded on the Flop
Seat 2: mbk88 collected ($6.18)
Seat 3: matiko09 folded before Flop (didn't bet)
Seat 5: Troll8989 folded before Flop (didn't bet)
Seat 8: pyromid (button) folded before Flop (didn't bet)
Seat 9: Wladimir205 (small blind) folded before Flop





PokerStars Hand #155013603065:  Hold'em No Limit ($0.50/$1.00 USD) - 2016/06/21 13:37:10 CET [2016/06/21 7:37:10 ET]
Table 'Moreau' 9-max Seat #6 is the button
Seat 1: ozone2003 ($128.99 in chips) 
Seat 2: Avtovo ($108.50 in chips) 
Seat 3: matiko09 ($106.88 in chips) 
Seat 4: SharingaaN ($100.28 in chips) 
Seat 6: Troll8989 ($102.50 in chips) 
Seat 7: PanKwn15 ($100.39 in chips) 
Seat 9: Toonersens ($114.92 in chips) 
PanKwn15: posts small blind $0.50
Toonersens: posts big blind $1
*** HOLE CARDS ***
Dealt to matiko09 [Td 9d]
ozone2003: folds 
Avtovo: folds 
matiko09: raises $2 to $3
SharingaaN: folds 
Troll8989: folds 
PanKwn15: folds 
Toonersens: folds 
Uncalled bet ($2) returned to matiko09
matiko09 collected $2.50 from pot
matiko09: doesn't show hand 
*** SUMMARY ***
Total pot $2.50 | Rake $0 
Seat 1: ozone2003 folded before Flop (didn't bet)
Seat 2: Avtovo folded before Flop (didn't bet)
Seat 3: matiko09 collected ($2.50)
Seat 4: SharingaaN folded before Flop (didn't bet)
Seat 6: Troll8989 (button) folded before Flop (didn't bet)
Seat 7: PanKwn15 (small blind) folded before Flop
Seat 9: Toonersens (big blind) folded before Flop





PokerStars Hand #155013604139:  Hold'em No Limit (€0.50/€1.00 EUR) - 2016/06/21 13:37:13 CET [2016/06/21 7:37:13 ET]
Table 'Alkes' 9-max Seat #8 is the button
Seat 1: Ping_Ping14 (€51.39 in chips) 
Seat 2: matiko09 (€110.64 in chips) 
Seat 3: erick222 (€100 in chips) 
Seat 4: 50CandyJoe (€107.02 in chips) 
Seat 6: Filojoes (€100 in chips) 
Seat 8: ozone2003 (€106.78 in chips) 
Ping_Ping14: posts small blind €0.50
matiko09: posts big blind €1
chaps1988: sits out 
*** HOLE CARDS ***
Dealt to matiko09 [2h 5c]
erick222: folds 
50CandyJoe: folds 
Filojoes: raises €1.50 to €2.50
ozone2003: folds 
Ping_Ping14: folds 
matiko09: folds 
Uncalled bet (€1.50) returned to Filojoes
Filojoes collected €2.50 from pot
Filojoes: doesn't show hand 
*** SUMMARY ***
Total pot €2.50 | Rake €0 
Seat 1: Ping_Ping14 (small blind) folded before Flop
Seat 2: matiko09 (big blind) folded before Flop
Seat 3: erick222 folded before Flop (didn't bet)
Seat 4: 50CandyJoe folded before Flop (didn't bet)
Seat 6: Filojoes collected (€2.50)
Seat 8: ozone2003 (button) folded before Flop (didn't bet)





PokerStars Hand #155013607619:  Hold'em No Limit ($0.50/$1.00 USD) - 2016/06/21 13:37:21 CET [2016/06/21 7:37:21 ET]
Table 'Lamberta II' 9-max Seat #6 is the button
Seat 1: mbk88 ($185.17 in chips) 
Seat 2: mavin80 ($91.94 in chips) 
Seat 3: matiko09 ($100 in chips) 
Seat 4: Eskimo Fox ($121.39 in chips) 
Seat 6: Chen423 ($71.50 in chips) 
Seat 8: Troll8989 ($100 in chips) 
Seat 9: Sjtu_Michael ($109.94 in chips) 
23SmOkEr07 will be allowed to play after the button
Troll8989: posts small blind $0.50
Sjtu_Michael: posts big blind $1
mavin80: posts small & big blinds $1.50
*** HOLE CARDS ***
Dealt to matiko09 [As Jd]
mbk88: folds 
mavin80: raises $1.50 to $2.50
matiko09: raises $6.50 to $9
Eskimo Fox: folds 
Chen423: folds 
Troll8989: folds 
Sjtu_Michael: folds 
mavin80: folds 
Uncalled bet ($6.50) returned to matiko09
matiko09 collected $7 from pot
matiko09: doesn't show hand 
*** SUMMARY ***
Total pot $7 | Rake $0 
Seat 1: mbk88 folded before Flop (didn't bet)
Seat 2: mavin80 folded before Flop
Seat 3: matiko09 collected ($7)
Seat 4: Eskimo Fox folded before Flop (didn't bet)
Seat 6: Chen423 (button) folded before Flop (didn't bet)
Seat 8: Troll8989 (small blind) folded before Flop
Seat 9: Sjtu_Michael (big blind) folded before Flop





PokerStars Hand #155013611446:  Hold'em No Limit ($0.50/$1.00 USD) - 2016/06/21 13:37:30 CET [2016/06/21 7:37:30 ET]
Table 'Leo' 9-max Seat #9 is the button
Seat 1: fukumimi ($110.30 in chips) 
Seat 2: mbk88 ($142.25 in chips) 
Seat 3: matiko09 ($100 in chips) 
Seat 5: Troll8989 ($103.52 in chips) 
Seat 8: pyromid ($88.42 in chips) 
Seat 9: Wladimir205 ($113.03 in chips) 
fukumimi: posts small blind $0.50
mbk88: posts big blind $1
chaps1988: sits out 
stepan0605: sits out 
*** HOLE CARDS ***
Dealt to matiko09 [Ah 8c]
matiko09: folds 
Troll8989: folds 
pyromid: folds 
Wladimir205: folds 
fukumimi: folds 
Uncalled bet ($0.50) returned to mbk88
mbk88 collected $1 from pot
mbk88: doesn't show hand 
*** SUMMARY ***
Total pot $1 | Rake $0 
Seat 1: fukumimi (small blind) folded before Flop
Seat 2: mbk88 (big blind) collected ($1)
Seat 3: matiko09 folded before Flop (didn't bet)
Seat 5: Troll8989 folded before Flop (didn't bet)
Seat 8: pyromid folded before Flop (didn't bet)
Seat 9: Wladimir205 (button) folded before Flop (didn't bet)





PokerStars Hand #155013612996:  Hold'em No Limit (€0.50/€1.00 EUR) - 2016/06/21 13:37:33 CET [2016/06/21 7:37:33 ET]
Table 'Alkes' 9-max Seat #1 is the button
Seat 1: Ping_Ping14 (€50.89 in chips) 
Seat 2: matiko09 (€109.64 in chips) 
Seat 3: erick222 (€100 in chips) 
Seat 4: 50CandyJoe (€107.02 in chips) 
Seat 6: Filojoes (€101.50 in chips) 
Seat 8: ozone2003 (€106.78 in chips) 
matiko09: posts small blind €0.50
erick222: posts big blind €1
chaps1988: sits out 
*** HOLE CARDS ***
Dealt to matiko09 [Th 5d]
50CandyJoe: raises €2 to €3
Filojoes: folds 
ozone2003: folds 
Ping_Ping14: folds 
matiko09: folds 
erick222: folds 
Uncalled bet (€2) returned to 50CandyJoe
50CandyJoe collected €2.50 from pot
50CandyJoe: doesn't show hand 
*** SUMMARY ***
Total pot €2.50 | Rake €0 
Seat 1: Ping_Ping14 (button) folded before Flop (didn't bet)
Seat 2: matiko09 (small blind) folded before Flop
Seat 3: erick222 (big blind) folded before Flop
Seat 4: 50CandyJoe collected (€2.50)
Seat 6: Filojoes folded before Flop (didn't bet)
Seat 8: ozone2003 folded before Flop (didn't bet)





PokerStars Hand #155013617638:  Hold'em No Limit ($0.50/$1.00 USD) - 2016/06/21 13:37:44 CET [2016/06/21 7:37:44 ET]
Table 'Admete II' 9-max Seat #5 is the button
Seat 1: Troll8989 ($101.50 in chips) 
Seat 2: Eskimo Fox ($171.92 in chips) 
Seat 4: 23SmOkEr07 ($100 in chips) 
Seat 5: stepan0605 ($100 in chips) 
Seat 6: mbk88 ($249 in chips) 
Seat 7: matiko09 ($101.50 in chips) 
Seat 8: koutani7 ($96.50 in chips) 
mbk88: posts small blind $0.50
matiko09: posts big blind $1
*** HOLE CARDS ***
Dealt to matiko09 [9d 8d]
koutani7: raises $2 to $3
Troll8989: folds 
Eskimo Fox: folds 
23SmOkEr07: calls $3
Filojoes joins the table at seat #3 
stepan0605: folds 
Filojoes leaves the table
mbk88: folds 
chaps1988 joins the table at seat #3 
matiko09: calls $2
*** FLOP *** [9h Kd Ac]
matiko09: checks 
koutani7: bets $5
23SmOkEr07: folds 
matiko09: folds 
Uncalled bet ($5) returned to koutani7
koutani7 collected $9.02 from pot
koutani7: doesn't show hand 
*** SUMMARY ***
Total pot $9.50 | Rake $0.48 
Board [9h Kd Ac]
Seat 1: Troll8989 folded before Flop (didn't bet)
Seat 2: Eskimo Fox folded before Flop (didn't bet)
Seat 4: 23SmOkEr07 folded on the Flop
Seat 5: stepan0605 (button) folded before Flop (didn't bet)
Seat 6: mbk88 (small blind) folded before Flop
Seat 7: matiko09 (big blind) folded on the Flop
Seat 8: koutani7 collected ($9.02)





PokerStars Hand #155013618321:  Hold'em No Limit ($0.50/$1.00 USD) - 2016/06/21 13:37:45 CET [2016/06/21 7:37:45 ET]
Table 'Moreau' 9-max Seat #7 is the button
Seat 1: ozone2003 ($128.99 in chips) 
Seat 2: Avtovo ($108.50 in chips) 
Seat 3: matiko09 ($108.38 in chips) 
Seat 4: SharingaaN ($100.28 in chips) 
Seat 6: Troll8989 ($102.50 in chips) 
Seat 7: PanKwn15 ($99.89 in chips) 
Seat 9: Toonersens ($113.92 in chips) 
Toonersens: posts small blind $0.50
ozone2003: posts big blind $1
*** HOLE CARDS ***
Dealt to matiko09 [2s Td]
Avtovo: folds 
matiko09: folds 
SharingaaN: raises $1 to $2
Troll8989: folds 
PanKwn15: calls $2
Toonersens: calls $1.50
ozone2003: folds 
*** FLOP *** [5d Js 9h]
Toonersens: checks 
SharingaaN: bets $5.32
PanKwn15: folds 
Toonersens: calls $5.32
*** TURN *** [5d Js 9h] [Ad]
Toonersens: checks 
SharingaaN: bets $12
Toonersens: calls $12
*** RIVER *** [5d Js 9h Ad] [Jd]
Toonersens: bets $25
SharingaaN: folds 
Uncalled bet ($25) returned to Toonersens
Toonersens collected $39.56 from pot
*** SUMMARY ***
Total pot $41.64 | Rake $2.08 
Board [5d Js 9h Ad Jd]
Seat 1: ozone2003 (big blind) folded before Flop
Seat 2: Avtovo folded before Flop (didn't bet)
Seat 3: matiko09 folded before Flop (didn't bet)
Seat 4: SharingaaN folded on the River
Seat 6: Troll8989 folded before Flop (didn't bet)
Seat 7: PanKwn15 (button) folded on the Flop
Seat 9: Toonersens (small blind) collected ($39.56)





PokerStars Hand #155013618740:  Hold'em No Limit (€0.25/€0.50 EUR) - 2016/06/21 13:37:46 CET [2016/06/21 7:37:46 ET]
Table 'Actor II' 6-max Seat #6 is the button
Seat 1: hmverlin (€87.21 in chips) 
Seat 2: alôha (€56.64 in chips) 
Seat 4: matiko09 (€84.80 in chips) 
Seat 6: fanmtZ (€20 in chips) 
hmverlin: posts small blind €0.25
alôha: posts big blind €0.50
TopMo3UJlo: sits out 
AlexPles: sits out 
*** HOLE CARDS ***
Dealt to matiko09 [8c 6d]
matiko09: folds 
fanmtZ: raises €0.79 to €1.29
hmverlin: folds 
alôha: calls €0.79
*** FLOP *** [7d As 9c]
alôha: checks 
fanmtZ: bets €1.75
alôha: calls €1.75
*** TURN *** [7d As 9c] [2h]
alôha: checks 
fanmtZ: bets €4
alôha: folds 
Uncalled bet (€4) returned to fanmtZ
fanmtZ collected €6.01 from pot
fanmtZ: doesn't show hand 
*** SUMMARY ***
Total pot €6.33 | Rake €0.32 
Board [7d As 9c 2h]
Seat 1: hmverlin (small blind) folded before Flop
Seat 2: alôha (big blind) folded on the Turn
Seat 4: matiko09 folded before Flop (didn't bet)
Seat 6: fanmtZ (button) collected (€6.01)





PokerStars Hand #155013619818:  Hold'em No Limit ($0.50/$1.00 USD) - 2016/06/21 13:37:48 CET [2016/06/21 7:37:48 ET]
Table 'Saldanha' 9-max Seat #6 is the button
Seat 2: matiko09 ($399.89 in chips) 
Seat 5: Michael Quan ($109.93 in chips) 
Seat 6: Donetsk1y ($136.34 in chips) 
Seat 7: ozone2003 ($118.40 in chips) 
Seat 8: erick222 ($100 in chips) 
Seat 9: 23SmOkEr07 ($100 in chips) 
ozone2003: posts small blind $0.50
erick222: posts big blind $1
stepan0605: sits out 
mbk88: sits out 
matiko09: posts the ante $0.20
Michael Quan: posts the ante $0.20
Donetsk1y: posts the ante $0.20
ozone2003: posts the ante $0.20
erick222: posts the ante $0.20
23SmOkEr07: posts the ante $0.20
*** HOLE CARDS ***
Dealt to matiko09 [Ad 7d]
23SmOkEr07: folds 
matiko09: raises $2 to $3
Michael Quan: folds 
Donetsk1y: folds 
ozone2003: folds 
erick222: folds 
Uncalled bet ($2) returned to matiko09
matiko09 collected $3.70 from pot
matiko09: doesn't show hand 
*** SUMMARY ***
Total pot $3.70 | Rake $0 
Seat 2: matiko09 collected ($3.70)
Seat 5: Michael Quan folded before Flop (didn't bet)
Seat 6: Donetsk1y (button) folded before Flop (didn't bet)
Seat 7: ozone2003 (small blind) folded before Flop
Seat 8: erick222 (big blind) folded before Flop
Seat 9: 23SmOkEr07 folded before Flop (didn't bet)





PokerStars Hand #155013621780:  Hold'em No Limit ($0.50/$1.00 USD) - 2016/06/21 13:37:53 CET [2016/06/21 7:37:53 ET]
Table 'Umbriel II' 9-max Seat #7 is the button
Seat 1: matiko09 ($143.96 in chips) 
Seat 3: mxustin ($30.25 in chips) 
Seat 4: Eskimo Fox ($114.08 in chips) 
Seat 5: mbk88 ($100 in chips) 
Seat 7: Chen423 ($92.45 in chips) 
Seat 8: AXE705 ($115.20 in chips) 
AXE705: posts small blind $0.50
matiko09: posts big blind $1
mi$$I$Elena: sits out 
*** HOLE CARDS ***
Dealt to matiko09 [9d 7h]
mxustin: folds 
Eskimo Fox: raises $1.50 to $2.50
mbk88: folds 
Chen423: folds 
AXE705: raises $6 to $8.50
matiko09: folds 
Eskimo Fox: calls $6
*** FLOP *** [9h Ts 5h]
AXE705: bets $12
Eskimo Fox: calls $12
*** TURN *** [9h Ts 5h] [2h]
AXE705: bets $27
Eskimo Fox: folds 
Uncalled bet ($27) returned to AXE705
AXE705 collected $39.90 from pot
AXE705: doesn't show hand 
*** SUMMARY ***
Total pot $42 | Rake $2.10 
Board [9h Ts 5h 2h]
Seat 1: matiko09 (big blind) folded before Flop
Seat 3: mxustin folded before Flop (didn't bet)
Seat 4: Eskimo Fox folded on the Turn
Seat 5: mbk88 folded before Flop (didn't bet)
Seat 7: Chen423 (button) folded before Flop (didn't bet)
Seat 8: AXE705 (small blind) collected ($39.90)





PokerStars Hand #155013622668:  Hold'em No Limit (€0.50/€1.00 EUR) - 2016/06/21 13:37:55 CET [2016/06/21 7:37:55 ET]
Table 'Alkes' 9-max Seat #2 is the button
Seat 1: Ping_Ping14 (€50.89 in chips) 
Seat 2: matiko09 (€109.14 in chips) 
Seat 3: erick222 (€100 in chips) 
Seat 4: 50CandyJoe (€108.52 in chips) 
Seat 6: Filojoes (€101.50 in chips) 
Seat 8: ozone2003 (€106.78 in chips) 
erick222: posts small blind €0.50
50CandyJoe: posts big blind €1
chaps1988: sits out 
*** HOLE CARDS ***
Dealt to matiko09 [8h Js]
Filojoes: folds 
ozone2003: folds 
Ping_Ping14: folds 
Ping_Ping14 leaves the table
matiko09: raises €1.27 to €2.27
erick222: folds 
50CandyJoe: folds 
Uncalled bet (€1.27) returned to matiko09
matiko09 collected €2.50 from pot
matiko09: doesn't show hand 
*** SUMMARY ***
Total pot €2.50 | Rake €0 
Seat 1: Ping_Ping14 folded before Flop (didn't bet)
Seat 2: matiko09 (button) collected (€2.50)
Seat 3: erick222 (small blind) folded before Flop
Seat 4: 50CandyJoe (big blind) folded before Flop
Seat 6: Filojoes folded before Flop (didn't bet)
Seat 8: ozone2003 folded before Flop (didn't bet)





PokerStars Hand #155013623690:  Hold'em No Limit ($0.50/$1.00 USD) - 2016/06/21 13:37:57 CET [2016/06/21 7:37:57 ET]
Table 'Carlova II' 9-max Seat #9 is the button
Seat 1: matiko09 ($106.80 in chips) 
Seat 2: mbk88 ($139.65 in chips) 
Seat 3: SharingaaN ($113.78 in chips) 
Seat 4: Dandy Monk ($152.96 in chips) 
Seat 5: ozone2003 ($100 in chips) 
Seat 7: mi$$I$Elena ($100.77 in chips) 
Seat 8: pyromid ($103.30 in chips) 
Seat 9: Troll8989 ($113.46 in chips) 
matiko09: posts small blind $0.50
mbk88: posts big blind $1
Donetsk1y: sits out 
*** HOLE CARDS ***
Dealt to matiko09 [Qs 4c]
SharingaaN: folds 
Dandy Monk: folds 
ozone2003: folds 
mi$$I$Elena: folds 
pyromid: folds 
Troll8989: raises $1.50 to $2.50
matiko09: folds 
mbk88: folds 
Uncalled bet ($1.50) returned to Troll8989
Troll8989 collected $2.50 from pot
Troll8989: doesn't show hand 
*** SUMMARY ***
Total pot $2.50 | Rake $0 
Seat 1: matiko09 (small blind) folded before Flop
Seat 2: mbk88 (big blind) folded before Flop
Seat 3: SharingaaN folded before Flop (didn't bet)
Seat 4: Dandy Monk folded before Flop (didn't bet)
Seat 5: ozone2003 folded before Flop (didn't bet)
Seat 7: mi$$I$Elena folded before Flop (didn't bet)
Seat 8: pyromid folded before Flop (didn't bet)
Seat 9: Troll8989 (button) collected ($2.50)





PokerStars Hand #155013633844:  Hold'em No Limit ($0.50/$1.00 USD) - 2016/06/21 13:38:21 CET [2016/06/21 7:38:21 ET]
Table 'Lamberta II' 9-max Seat #8 is the button
Seat 1: mbk88 ($185.17 in chips) 
Seat 2: mavin80 ($88.94 in chips) 
Seat 3: matiko09 ($104.50 in chips) 
Seat 4: Eskimo Fox ($121.39 in chips) 
Seat 6: Chen423 ($71.50 in chips) 
Seat 8: Troll8989 ($100 in chips) 
Seat 9: Sjtu_Michael ($108.94 in chips) 
Sjtu_Michael: posts small blind $0.50
mbk88: posts big blind $1
23SmOkEr07: sits out 
*** HOLE CARDS ***
Dealt to matiko09 [Qs As]
mavin80: folds 
matiko09: raises $2 to $3
Eskimo Fox: folds 
Chen423: folds 
Troll8989: folds 
Sjtu_Michael: folds 
mbk88: calls $2
*** FLOP *** [4d 6d Ad]
mbk88: checks 
matiko09: checks 
*** TURN *** [4d 6d Ad] [8s]
mbk88: checks 
matiko09: bets $4.02
mbk88: folds 
Uncalled bet ($4.02) returned to matiko09
matiko09 collected $6.18 from pot
matiko09: doesn't show hand 
*** SUMMARY ***
Total pot $6.50 | Rake $0.32 
Board [4d 6d Ad 8s]
Seat 1: mbk88 (big blind) folded on the Turn
Seat 2: mavin80 folded before Flop (didn't bet)
Seat 3: matiko09 collected ($6.18)
Seat 4: Eskimo Fox folded before Flop (didn't bet)
Seat 6: Chen423 folded before Flop (didn't bet)
Seat 8: Troll8989 (button) folded before Flop (didn't bet)
Seat 9: Sjtu_Michael (small blind) folded before Flop





PokerStars Hand #155013636824:  Hold'em No Limit ($0.50/$1.00 USD) - 2016/06/21 13:38:27 CET [2016/06/21 7:38:27 ET]
Table 'Carlova II' 9-max Seat #1 is the button
Seat 1: matiko09 ($106.30 in chips) 
Seat 2: mbk88 ($138.65 in chips) 
Seat 3: SharingaaN ($113.78 in chips) 
Seat 4: Dandy Monk ($152.96 in chips) 
Seat 5: ozone2003 ($100 in chips) 
Seat 7: mi$$I$Elena ($100.77 in chips) 
Seat 8: pyromid ($103.30 in chips) 
Seat 9: Troll8989 ($114.96 in chips) 
mbk88: posts small blind $0.50
SharingaaN: posts big blind $1
Donetsk1y: sits out 
*** HOLE CARDS ***
Dealt to matiko09 [9s Qc]
Dandy Monk: raises $2 to $3
ozone2003: folds 
mi$$I$Elena: folds 
pyromid: folds 
Troll8989: folds 
matiko09: folds 
mbk88: folds 
SharingaaN: folds 
Uncalled bet ($2) returned to Dandy Monk
Dandy Monk collected $2.50 from pot
Dandy Monk: doesn't show hand 
*** SUMMARY ***
Total pot $2.50 | Rake $0 
Seat 1: matiko09 (button) folded before Flop (didn't bet)
Seat 2: mbk88 (small blind) folded before Flop
Seat 3: SharingaaN (big blind) folded before Flop
Seat 4: Dandy Monk collected ($2.50)
Seat 5: ozone2003 folded before Flop (didn't bet)
Seat 7: mi$$I$Elena folded before Flop (didn't bet)
Seat 8: pyromid folded before Flop (didn't bet)
Seat 9: Troll8989 folded before Flop (didn't bet)





PokerStars Hand #155013643369:  Hold'em No Limit (€0.25/€0.50 EUR) - 2016/06/21 13:38:42 CET [2016/06/21 7:38:42 ET]
Table 'Actor II' 6-max Seat #1 is the button
Seat 1: hmverlin (€86.96 in chips) 
Seat 2: alôha (€53.60 in chips) 
Seat 3: TopMo3UJlo (€50 in chips) 
Seat 4: matiko09 (€84.80 in chips) 
Seat 6: fanmtZ (€22.97 in chips) 
alôha: posts small blind €0.25
TopMo3UJlo: posts big blind €0.50
AlexPles: sits out 
*** HOLE CARDS ***
Dealt to matiko09 [7s Ah]
matiko09: folds 
fanmtZ: folds 
hmverlin: raises €1 to €1.50
alôha: folds 
TopMo3UJlo: folds 
Uncalled bet (€1) returned to hmverlin
hmverlin collected €1.25 from pot
hmverlin: doesn't show hand 
*** SUMMARY ***
Total pot €1.25 | Rake €0 
Seat 1: hmverlin (button) collected (€1.25)
Seat 2: alôha (small blind) folded before Flop
Seat 3: TopMo3UJlo (big blind) folded before Flop
Seat 4: matiko09 folded before Flop (didn't bet)
Seat 6: fanmtZ folded before Flop (didn't bet)





PokerStars Hand #155013643197:  Hold'em No Limit ($0.50/$1.00 USD) - 2016/06/21 13:38:42 CET [2016/06/21 7:38:42 ET]
Table 'Saldanha' 9-max Seat #7 is the button
Seat 2: matiko09 ($402.39 in chips) 
Seat 5: Michael Quan ($109.73 in chips) 
Seat 6: Donetsk1y ($136.14 in chips) 
Seat 7: ozone2003 ($117.70 in chips) 
Seat 8: erick222 ($100 in chips) 
Seat 9: 23SmOkEr07 ($100 in chips) 
erick222: posts small blind $0.50
23SmOkEr07: posts big blind $1
stepan0605: sits out 
mbk88: sits out 
matiko09: posts the ante $0.20
Michael Quan: posts the ante $0.20
Donetsk1y: posts the ante $0.20
ozone2003: posts the ante $0.20
erick222: posts the ante $0.20
23SmOkEr07: posts the ante $0.20
*** HOLE CARDS ***
Dealt to matiko09 [2c 6s]
matiko09: folds 
Michael Quan: calls $1
Donetsk1y: folds 
ozone2003: folds 
erick222: raises $3 to $4
23SmOkEr07: folds 
Michael Quan: calls $3
*** FLOP *** [9h Jd 8c]
erick222: bets $7.26
Michael Quan: raises $11.74 to $19
erick222: calls $11.74
*** TURN *** [9h Jd 8c] [6h]
erick222: checks 
Michael Quan: bets $23
erick222: calls $23
*** RIVER *** [9h Jd 8c 6h] [7c]
erick222: checks 
Michael Quan: bets $63.53 and is all-in
erick222: folds 
Uncalled bet ($63.53) returned to Michael Quan
Michael Quan collected $91.70 from pot
*** SUMMARY ***
Total pot $94.20 | Rake $2.50 
Board [9h Jd 8c 6h 7c]
Seat 2: matiko09 folded before Flop (didn't bet)
Seat 5: Michael Quan collected ($91.70)
Seat 6: Donetsk1y folded before Flop (didn't bet)
Seat 7: ozone2003 (button) folded before Flop (didn't bet)
Seat 8: erick222 (small blind) folded on the River
Seat 9: 23SmOkEr07 (big blind) folded before Flop





PokerStars Hand #155013645940:  Hold'em No Limit ($0.50/$1.00 USD) - 2016/06/21 13:38:48 CET [2016/06/21 7:38:48 ET]
Table 'Carlova II' 9-max Seat #2 is the button
Seat 1: matiko09 ($106.30 in chips) 
Seat 2: mbk88 ($138.15 in chips) 
Seat 3: SharingaaN ($112.78 in chips) 
Seat 4: Dandy Monk ($154.46 in chips) 
Seat 5: ozone2003 ($100 in chips) 
Seat 7: mi$$I$Elena ($100.77 in chips) 
Seat 8: pyromid ($103.30 in chips) 
Seat 9: Troll8989 ($114.96 in chips) 
SharingaaN: posts small blind $0.50
Dandy Monk: posts big blind $1
Donetsk1y: sits out 
*** HOLE CARDS ***
Dealt to matiko09 [Kd Kh]
ozone2003: folds 
mi$$I$Elena: folds 
pyromid: folds 
Troll8989: folds 
matiko09: raises $1.50 to $2.50
mbk88: folds 
SharingaaN: folds 
Dandy Monk: folds 
Uncalled bet ($1.50) returned to matiko09
matiko09 collected $2.50 from pot
matiko09: doesn't show hand 
*** SUMMARY ***
Total pot $2.50 | Rake $0 
Seat 1: matiko09 collected ($2.50)
Seat 2: mbk88 (button) folded before Flop (didn't bet)
Seat 3: SharingaaN (small blind) folded before Flop
Seat 4: Dandy Monk (big blind) folded before Flop
Seat 5: ozone2003 folded before Flop (didn't bet)
Seat 7: mi$$I$Elena folded before Flop (didn't bet)
Seat 8: pyromid folded before Flop (didn't bet)
Seat 9: Troll8989 folded before Flop (didn't bet)





PokerStars Hand #155013650012:  Hold'em No Limit (€0.25/€0.50 EUR) - 2016/06/21 13:38:57 CET [2016/06/21 7:38:57 ET]
Table 'Actor II' 6-max Seat #2 is the button
Seat 1: hmverlin (€87.71 in chips) 
Seat 2: alôha (€53.35 in chips) 
Seat 3: TopMo3UJlo (€50 in chips) 
Seat 4: matiko09 (€84.80 in chips) 
Seat 6: fanmtZ (€22.97 in chips) 
TopMo3UJlo: posts small blind €0.25
matiko09: posts big blind €0.50
AlexPles: sits out 
*** HOLE CARDS ***
Dealt to matiko09 [5c Jd]
fanmtZ: raises €0.69 to €1.19
hmverlin: folds 
alôha: folds 
TopMo3UJlo: folds 
matiko09: folds 
Uncalled bet (€0.69) returned to fanmtZ
fanmtZ collected €1.25 from pot
fanmtZ: doesn't show hand 
*** SUMMARY ***
Total pot €1.25 | Rake €0 
Seat 1: hmverlin folded before Flop (didn't bet)
Seat 2: alôha (button) folded before Flop (didn't bet)
Seat 3: TopMo3UJlo (small blind) folded before Flop
Seat 4: matiko09 (big blind) folded before Flop
Seat 6: fanmtZ collected (€1.25)





PokerStars Hand #155013652569:  Hold'em No Limit ($0.50/$1.00 USD) - 2016/06/21 13:39:03 CET [2016/06/21 7:39:03 ET]
Table 'Moreau' 9-max Seat #9 is the button
Seat 1: ozone2003 ($127.99 in chips) 
Seat 2: Avtovo ($108.50 in chips) 
Seat 3: matiko09 ($108.38 in chips) 
Seat 4: SharingaaN ($80.96 in chips) 
Seat 6: Troll8989 ($102.50 in chips) 
Seat 7: PanKwn15 ($97.89 in chips) 
Seat 9: Toonersens ($134.16 in chips) 
ozone2003: posts small blind $0.50
Avtovo: posts big blind $1
*** HOLE CARDS ***
Dealt to matiko09 [3h 2s]
matiko09: folds 
SharingaaN: folds 
Troll8989: folds 
PanKwn15: raises $1.50 to $2.50
Toonersens: folds 
ozone2003: raises $6.50 to $9
Avtovo: folds 
PanKwn15: folds 
Uncalled bet ($6.50) returned to ozone2003
ozone2003 collected $6 from pot
ozone2003: doesn't show hand 
*** SUMMARY ***
Total pot $6 | Rake $0 
Seat 1: ozone2003 (small blind) collected ($6)
Seat 2: Avtovo (big blind) folded before Flop
Seat 3: matiko09 folded before Flop (didn't bet)
Seat 4: SharingaaN folded before Flop (didn't bet)
Seat 6: Troll8989 folded before Flop (didn't bet)
Seat 7: PanKwn15 folded before Flop
Seat 9: Toonersens (button) folded before Flop (didn't bet)





PokerStars Hand #155013653888:  Hold'em No Limit ($0.50/$1.00 USD) - 2016/06/21 13:39:06 CET [2016/06/21 7:39:06 ET]
Table 'Lamberta II' 9-max Seat #9 is the button
Seat 1: mbk88 ($182.17 in chips) 
Seat 2: mavin80 ($88.94 in chips) 
Seat 3: matiko09 ($107.68 in chips) 
Seat 4: Eskimo Fox ($121.39 in chips) 
Seat 6: Chen423 ($71.50 in chips) 
Seat 8: Troll8989 ($100 in chips) 
Seat 9: Sjtu_Michael ($108.44 in chips) 
mbk88: posts small blind $0.50
mavin80: posts big blind $1
23SmOkEr07: sits out 
*** HOLE CARDS ***
Dealt to matiko09 [Jh 5h]
matiko09: folds 
Eskimo Fox: folds 
Chen423: raises $2 to $3
Troll8989: folds 
Sjtu_Michael: folds 
mbk88: folds 
mavin80: calls $2
*** FLOP *** [6d 2d 7c]
mavin80: bets $3
Chen423: calls $3
*** TURN *** [6d 2d 7c] [6h]
mavin80: bets $7
Chen423: folds 
Uncalled bet ($7) returned to mavin80
mavin80 collected $11.88 from pot
mavin80: doesn't show hand 
*** SUMMARY ***
Total pot $12.50 | Rake $0.62 
Board [6d 2d 7c 6h]
Seat 1: mbk88 (small blind) folded before Flop
Seat 2: mavin80 (big blind) collected ($11.88)
Seat 3: matiko09 folded before Flop (didn't bet)
Seat 4: Eskimo Fox folded before Flop (didn't bet)
Seat 6: Chen423 folded on the Turn
Seat 8: Troll8989 folded before Flop (didn't bet)
Seat 9: Sjtu_Michael (button) folded before Flop (didn't bet)





PokerStars Hand #155013655429:  Hold'em No Limit ($0.50/$1.00 USD) - 2016/06/21 13:39:10 CET [2016/06/21 7:39:10 ET]
Table 'Umbriel II' 9-max Seat #8 is the button
Seat 1: matiko09 ($142.96 in chips) 
Seat 2: mi$$I$Elena ($100 in chips) 
Seat 3: mxustin ($30.25 in chips) 
Seat 4: Eskimo Fox ($100 in chips) 
Seat 5: mbk88 ($100 in chips) 
Seat 7: Chen423 ($92.45 in chips) 
Seat 8: AXE705 ($134.60 in chips) 
matiko09: posts small blind $0.50
mi$$I$Elena: posts big blind $1
*** HOLE CARDS ***
Dealt to matiko09 [As 5d]
mxustin: folds 
Eskimo Fox: folds 
mbk88: folds 
Chen423: folds 
AXE705: raises $2 to $3
matiko09: folds 
mi$$I$Elena: folds 
Uncalled bet ($2) returned to AXE705
AXE705 collected $2.50 from pot
AXE705: doesn't show hand 
*** SUMMARY ***
Total pot $2.50 | Rake $0 
Seat 1: matiko09 (small blind) folded before Flop
Seat 2: mi$$I$Elena (big blind) folded before Flop
Seat 3: mxustin folded before Flop (didn't bet)
Seat 4: Eskimo Fox folded before Flop (didn't bet)
Seat 5: mbk88 folded before Flop (didn't bet)
Seat 7: Chen423 folded before Flop (didn't bet)
Seat 8: AXE705 (button) collected ($2.50)





PokerStars Hand #155013656220:  Hold'em No Limit ($0.50/$1.00 USD) - 2016/06/21 13:39:11 CET [2016/06/21 7:39:11 ET]
Table 'Admete II' 9-max Seat #6 is the button
Seat 1: Troll8989 ($101.50 in chips) 
Seat 2: Eskimo Fox ($171.92 in chips) 
Seat 4: 23SmOkEr07 ($100 in chips) 
Seat 5: stepan0605 ($100 in chips) 
Seat 6: mbk88 ($248.50 in chips) 
Seat 7: matiko09 ($100 in chips) 
Seat 8: koutani7 ($102.52 in chips) 
matiko09: posts small blind $0.50
koutani7: posts big blind $1
chaps1988: sits out 
*** HOLE CARDS ***
Dealt to matiko09 [6d 8h]
Troll8989: folds 
Eskimo Fox: folds 
23SmOkEr07: folds 
stepan0605: folds 
mbk88: folds 
matiko09: raises $2 to $3
koutani7: folds 
Uncalled bet ($2) returned to matiko09
matiko09 collected $2 from pot
matiko09: doesn't show hand 
*** SUMMARY ***
Total pot $2 | Rake $0 
Seat 1: Troll8989 folded before Flop (didn't bet)
Seat 2: Eskimo Fox folded before Flop (didn't bet)
Seat 4: 23SmOkEr07 folded before Flop (didn't bet)
Seat 5: stepan0605 folded before Flop (didn't bet)
Seat 6: mbk88 (button) folded before Flop (didn't bet)
Seat 7: matiko09 (small blind) collected ($2)
Seat 8: koutani7 (big blind) folded before Flop





PokerStars Hand #155013658706:  Hold'em No Limit (€0.25/€0.50 EUR) - 2016/06/21 13:39:17 CET [2016/06/21 7:39:17 ET]
Table 'Actor II' 6-max Seat #3 is the button
Seat 1: hmverlin (€87.71 in chips) 
Seat 2: alôha (€53.35 in chips) 
Seat 3: TopMo3UJlo (€50 in chips) 
Seat 4: matiko09 (€84.30 in chips) 
Seat 5: AlexPles (€50 in chips) 
Seat 6: fanmtZ (€23.72 in chips) 
matiko09: posts small blind €0.25
AlexPles: posts big blind €0.50
*** HOLE CARDS ***
Dealt to matiko09 [2d 8d]
fanmtZ: folds 
hmverlin: folds 
alôha: folds 
TopMo3UJlo: raises €0.60 to €1.10
matiko09: folds 
AlexPles: folds 
Uncalled bet (€0.60) returned to TopMo3UJlo
TopMo3UJlo collected €1.25 from pot
TopMo3UJlo: doesn't show hand 
*** SUMMARY ***
Total pot €1.25 | Rake €0 
Seat 1: hmverlin folded before Flop (didn't bet)
Seat 2: alôha folded before Flop (didn't bet)
Seat 3: TopMo3UJlo (button) collected (€1.25)
Seat 4: matiko09 (small blind) folded before Flop
Seat 5: AlexPles (big blind) folded before Flop
Seat 6: fanmtZ folded before Flop (didn't bet)





PokerStars Hand #155013666150:  Hold'em No Limit ($0.50/$1.00 USD) - 2016/06/21 13:39:34 CET [2016/06/21 7:39:34 ET]
Table 'Moreau' 9-max Seat #1 is the button
Seat 1: ozone2003 ($131.49 in chips) 
Seat 2: Avtovo ($107.50 in chips) 
Seat 3: matiko09 ($108.38 in chips) 
Seat 4: SharingaaN ($80.96 in chips) 
Seat 6: Troll8989 ($102.50 in chips) 
Seat 7: PanKwn15 ($95.39 in chips) 
Seat 9: Toonersens ($134.16 in chips) 
Avtovo: posts small blind $0.50
matiko09: posts big blind $1
*** HOLE CARDS ***
Dealt to matiko09 [9c 2h]
SharingaaN: folds 
Troll8989: folds 
PanKwn15: folds 
Toonersens: raises $1 to $2
ozone2003: folds 
Avtovo: folds 
matiko09: folds 
Uncalled bet ($1) returned to Toonersens
Toonersens collected $2.50 from pot
*** SUMMARY ***
Total pot $2.50 | Rake $0 
Seat 1: ozone2003 (button) folded before Flop (didn't bet)
Seat 2: Avtovo (small blind) folded before Flop
Seat 3: matiko09 (big blind) folded before Flop
Seat 4: SharingaaN folded before Flop (didn't bet)
Seat 6: Troll8989 folded before Flop (didn't bet)
Seat 7: PanKwn15 folded before Flop (didn't bet)
Seat 9: Toonersens collected ($2.50)





PokerStars Hand #155013671287:  Hold'em No Limit ($0.50/$1.00 USD) - 2016/06/21 13:39:46 CET [2016/06/21 7:39:46 ET]
Table 'Admete II' 9-max Seat #7 is the button
Seat 1: Troll8989 ($101.50 in chips) 
Seat 2: Eskimo Fox ($171.92 in chips) 
Seat 4: 23SmOkEr07 ($100 in chips) 
Seat 5: stepan0605 ($100 in chips) 
Seat 6: mbk88 ($248.50 in chips) 
Seat 7: matiko09 ($101 in chips) 
Seat 8: koutani7 ($101.52 in chips) 
koutani7: posts small blind $0.50
Troll8989: posts big blind $1
chaps1988: sits out 
*** HOLE CARDS ***
Dealt to matiko09 [8c 4s]
Eskimo Fox: folds 
23SmOkEr07: raises $1.50 to $2.50
stepan0605: folds 
mbk88: folds 
matiko09: folds 
koutani7: folds 
Troll8989: folds 
Uncalled bet ($1.50) returned to 23SmOkEr07
23SmOkEr07 collected $2.50 from pot
*** SUMMARY ***
Total pot $2.50 | Rake $0 
Seat 1: Troll8989 (big blind) folded before Flop
Seat 2: Eskimo Fox folded before Flop (didn't bet)
Seat 4: 23SmOkEr07 collected ($2.50)
Seat 5: stepan0605 folded before Flop (didn't bet)
Seat 6: mbk88 folded before Flop (didn't bet)
Seat 7: matiko09 (button) folded before Flop (didn't bet)
Seat 8: koutani7 (small blind) folded before Flop





PokerStars Hand #155013671707:  Hold'em No Limit (€0.25/€0.50 EUR) - 2016/06/21 13:39:47 CET [2016/06/21 7:39:47 ET]
Table 'Actor II' 6-max Seat #4 is the button
Seat 1: hmverlin (€87.71 in chips) 
Seat 2: alôha (€53.35 in chips) 
Seat 3: TopMo3UJlo (€50.75 in chips) 
Seat 4: matiko09 (€84.05 in chips) 
Seat 5: AlexPles (€50 in chips) 
Seat 6: fanmtZ (€23.72 in chips) 
AlexPles: posts small blind €0.25
fanmtZ: posts big blind €0.50
*** HOLE CARDS ***
Dealt to matiko09 [Tc 4c]
hmverlin: raises €1.25 to €1.75
alôha: calls €1.75
TopMo3UJlo: folds 
matiko09: folds 
AlexPles: folds 
fanmtZ: folds 
*** FLOP *** [Js 4h 7h]
hmverlin: bets €2
alôha: calls €2
*** TURN *** [Js 4h 7h] [5d]
hmverlin: bets €3
alôha: raises €3 to €6
hmverlin: calls €3
*** RIVER *** [Js 4h 7h 5d] [3c]
hmverlin: checks 
alôha: checks 
*** SHOW DOWN ***
hmverlin: shows [As Kc] (high card Ace)
alôha: shows [8c 8s] (a pair of Eights)
alôha collected €19.24 from pot
*** SUMMARY ***
Total pot €20.25 | Rake €1.01 
Board [Js 4h 7h 5d 3c]
Seat 1: hmverlin showed [As Kc] and lost with high card Ace
Seat 2: alôha showed [8c 8s] and won (€19.24) with a pair of Eights
Seat 3: TopMo3UJlo folded before Flop (didn't bet)
Seat 4: matiko09 (button) folded before Flop (didn't bet)
Seat 5: AlexPles (small blind) folded before Flop
Seat 6: fanmtZ (big blind) folded before Flop





PokerStars Hand #155013673768:  Hold'em No Limit ($0.50/$1.00 USD) - 2016/06/21 13:39:52 CET [2016/06/21 7:39:52 ET]
Table 'Carlova II' 9-max Seat #3 is the button
Seat 1: matiko09 ($107.80 in chips) 
Seat 2: mbk88 ($138.15 in chips) 
Seat 3: SharingaaN ($112.28 in chips) 
Seat 4: Dandy Monk ($153.46 in chips) 
Seat 5: ozone2003 ($100 in chips) 
Seat 7: mi$$I$Elena ($100.77 in chips) 
Seat 8: pyromid ($103.30 in chips) 
Seat 9: Troll8989 ($114.96 in chips) 
Dandy Monk: posts small blind $0.50
ozone2003: posts big blind $1
Donetsk1y: sits out 
*** HOLE CARDS ***
Dealt to matiko09 [8h Qs]
mi$$I$Elena: folds 
pyromid: folds 
Troll8989: folds 
matiko09: folds 
mbk88: folds 
SharingaaN: folds 
Dandy Monk: raises $2 to $3
ozone2003: calls $2
*** FLOP *** [Ah Jh 9h]
Dandy Monk: checks 
ozone2003: checks 
*** TURN *** [Ah Jh 9h] [6c]
Dandy Monk: bets $2
ozone2003: calls $2
*** RIVER *** [Ah Jh 9h 6c] [Jd]
Dandy Monk: bets $4
ozone2003: calls $4
*** SHOW DOWN ***
Dandy Monk: shows [Th Ts] (two pair, Jacks and Tens)
ozone2003: mucks hand 
Dandy Monk collected $17.10 from pot
*** SUMMARY ***
Total pot $18 | Rake $0.90 
Board [Ah Jh 9h 6c Jd]
Seat 1: matiko09 folded before Flop (didn't bet)
Seat 2: mbk88 folded before Flop (didn't bet)
Seat 3: SharingaaN (button) folded before Flop (didn't bet)
Seat 4: Dandy Monk (small blind) showed [Th Ts] and won ($17.10) with two pair, Jacks and Tens
Seat 5: ozone2003 (big blind) mucked [Qh 9d]
Seat 7: mi$$I$Elena folded before Flop (didn't bet)
Seat 8: pyromid folded before Flop (didn't bet)
Seat 9: Troll8989 folded before Flop (didn't bet)





PokerStars Hand #155013677927:  Hold'em No Limit ($0.50/$1.00 USD) - 2016/06/21 13:40:01 CET [2016/06/21 7:40:01 ET]
Table 'Moreau' 9-max Seat #2 is the button
Seat 1: ozone2003 ($131.49 in chips) 
Seat 2: Avtovo ($107 in chips) 
Seat 3: matiko09 ($107.38 in chips) 
Seat 4: SharingaaN ($80.96 in chips) 
Seat 6: Troll8989 ($102.50 in chips) 
Seat 7: PanKwn15 ($95.39 in chips) 
Seat 9: Toonersens ($135.66 in chips) 
matiko09: posts small blind $0.50
SharingaaN: posts big blind $1
*** HOLE CARDS ***
Dealt to matiko09 [2d Ks]
Troll8989: folds 
PanKwn15: folds 
Toonersens: folds 
ozone2003: folds 
Avtovo: raises $1.50 to $2.50
matiko09: folds 
SharingaaN: folds 
Uncalled bet ($1.50) returned to Avtovo
Avtovo collected $2.50 from pot
Avtovo: doesn't show hand 
*** SUMMARY ***
Total pot $2.50 | Rake $0 
Seat 1: ozone2003 folded before Flop (didn't bet)
Seat 2: Avtovo (button) collected ($2.50)
Seat 3: matiko09 (small blind) folded before Flop
Seat 4: SharingaaN (big blind) folded before Flop
Seat 6: Troll8989 folded before Flop (didn't bet)
Seat 7: PanKwn15 folded before Flop (didn't bet)
Seat 9: Toonersens folded before Flop (didn't bet)





PokerStars Hand #155013680305:  Hold'em No Limit ($0.50/$1.00 USD) - 2016/06/21 13:40:07 CET [2016/06/21 7:40:07 ET]
Table 'Umbriel II' 9-max Seat #1 is the button
Seat 1: matiko09 ($142.46 in chips) 
Seat 2: mi$$I$Elena ($100 in chips) 
Seat 3: mxustin ($30.25 in chips) 
Seat 4: Eskimo Fox ($100 in chips) 
Seat 5: mbk88 ($100 in chips) 
Seat 7: Chen423 ($92.45 in chips) 
Seat 8: AXE705 ($136.10 in chips) 
mi$$I$Elena: posts small blind $0.50
mxustin: posts big blind $1
*** HOLE CARDS ***
Dealt to matiko09 [Kd Qh]
Eskimo Fox: folds 
mbk88: folds 
Chen423: folds 
AXE705: raises $2 to $3
matiko09: raises $6 to $9
mi$$I$Elena: folds 
mxustin: folds 
AXE705: folds 
Uncalled bet ($6) returned to matiko09
matiko09 collected $7.50 from pot
matiko09: doesn't show hand 
*** SUMMARY ***
Total pot $7.50 | Rake $0 
Seat 1: matiko09 (button) collected ($7.50)
Seat 2: mi$$I$Elena (small blind) folded before Flop
Seat 3: mxustin (big blind) folded before Flop
Seat 4: Eskimo Fox folded before Flop (didn't bet)
Seat 5: mbk88 folded before Flop (didn't bet)
Seat 7: Chen423 folded before Flop (didn't bet)
Seat 8: AXE705 folded before Flop





PokerStars Hand #155013685978:  Hold'em No Limit ($0.50/$1.00 USD) - 2016/06/21 13:40:20 CET [2016/06/21 7:40:20 ET]
Table 'Moreau' 9-max Seat #3 is the button
Seat 1: ozone2003 ($131.49 in chips) 
Seat 2: Avtovo ($108.50 in chips) 
Seat 3: matiko09 ($106.88 in chips) 
Seat 4: SharingaaN ($79.96 in chips) 
Seat 6: Troll8989 ($102.50 in chips) 
Seat 7: PanKwn15 ($95.39 in chips) 
Seat 9: Toonersens ($135.66 in chips) 
SharingaaN: posts small blind $0.50
Troll8989: posts big blind $1
*** HOLE CARDS ***
Dealt to matiko09 [3d As]
maxxmeister leaves the table
PanKwn15: raises $1 to $2
Toonersens: folds 
ozone2003: folds 
Avtovo: folds 
matiko09: folds 
SharingaaN: folds 
Troll8989: folds 
Uncalled bet ($1) returned to PanKwn15
PanKwn15 collected $2.50 from pot
PanKwn15: doesn't show hand 
*** SUMMARY ***
Total pot $2.50 | Rake $0 
Seat 1: ozone2003 folded before Flop (didn't bet)
Seat 2: Avtovo folded before Flop (didn't bet)
Seat 3: matiko09 (button) folded before Flop (didn't bet)
Seat 4: SharingaaN (small blind) folded before Flop
Seat 6: Troll8989 (big blind) folded before Flop
Seat 7: PanKwn15 collected ($2.50)
Seat 9: Toonersens folded before Flop (didn't bet)





PokerStars Hand #155013689779:  Hold'em No Limit ($0.50/$1.00 USD) - 2016/06/21 13:40:29 CET [2016/06/21 7:40:29 ET]
Table 'Admete II' 9-max Seat #8 is the button
Seat 1: Troll8989 ($100.50 in chips) 
Seat 2: Eskimo Fox ($171.92 in chips) 
Seat 4: 23SmOkEr07 ($101.50 in chips) 
Seat 5: stepan0605 ($100 in chips) 
Seat 6: mbk88 ($248.50 in chips) 
Seat 7: matiko09 ($101 in chips) 
Seat 8: koutani7 ($101.02 in chips) 
Troll8989: posts small blind $0.50
Eskimo Fox: posts big blind $1
chaps1988: sits out 
*** HOLE CARDS ***
Dealt to matiko09 [9d 5c]
23SmOkEr07: folds 
stepan0605: raises $1 to $2
mbk88: folds 
matiko09: folds 
koutani7: folds 
Troll8989: folds 
Eskimo Fox: folds 
Uncalled bet ($1) returned to stepan0605
stepan0605 collected $2.50 from pot
stepan0605: doesn't show hand 
*** SUMMARY ***
Total pot $2.50 | Rake $0 
Seat 1: Troll8989 (small blind) folded before Flop
Seat 2: Eskimo Fox (big blind) folded before Flop
Seat 4: 23SmOkEr07 folded before Flop (didn't bet)
Seat 5: stepan0605 collected ($2.50)
Seat 6: mbk88 folded before Flop (didn't bet)
Seat 7: matiko09 folded before Flop (didn't bet)
Seat 8: koutani7 (button) folded before Flop (didn't bet)





PokerStars Hand #155013689697:  Hold'em No Limit ($0.50/$1.00 USD) - 2016/06/21 13:40:29 CET [2016/06/21 7:40:29 ET]
Table 'Umbriel II' 9-max Seat #2 is the button
Seat 1: matiko09 ($146.96 in chips) 
Seat 2: mi$$I$Elena ($100 in chips) 
Seat 3: mxustin ($29.25 in chips) 
Seat 4: Eskimo Fox ($100 in chips) 
Seat 5: mbk88 ($100 in chips) 
Seat 7: Chen423 ($92.45 in chips) 
Seat 8: AXE705 ($133.10 in chips) 
mxustin: posts small blind $0.50
Eskimo Fox: posts big blind $1
maxxmeister: sits out 
*** HOLE CARDS ***
Dealt to matiko09 [8c Ac]
mbk88: folds 
Chen423: folds 
AXE705: folds 
matiko09: raises $1.50 to $2.50
mi$$I$Elena: folds 
mxustin: folds 
Eskimo Fox: folds 
Uncalled bet ($1.50) returned to matiko09
matiko09 collected $2.50 from pot
matiko09: doesn't show hand 
*** SUMMARY ***
Total pot $2.50 | Rake $0 
Seat 1: matiko09 collected ($2.50)
Seat 2: mi$$I$Elena (button) folded before Flop (didn't bet)
Seat 3: mxustin (small blind) folded before Flop
Seat 4: Eskimo Fox (big blind) folded before Flop
Seat 5: mbk88 folded before Flop (didn't bet)
Seat 7: Chen423 folded before Flop (didn't bet)
Seat 8: AXE705 folded before Flop (didn't bet)





PokerStars Hand #155013699848:  Hold'em No Limit (€0.25/€0.50 EUR) - 2016/06/21 13:40:52 CET [2016/06/21 7:40:52 ET]
Table 'Actor II' 6-max Seat #5 is the button
Seat 1: hmverlin (€77.96 in chips) 
Seat 2: alôha (€62.84 in chips) 
Seat 3: TopMo3UJlo (€50.75 in chips) 
Seat 4: matiko09 (€84.05 in chips) 
Seat 5: AlexPles (€50 in chips) 
Seat 6: fanmtZ (€23.22 in chips) 
fanmtZ: posts small blind €0.25
hmverlin: posts big blind €0.50
*** HOLE CARDS ***
Dealt to matiko09 [2h Qd]
alôha: raises €0.75 to €1.25
TopMo3UJlo: folds 
matiko09: folds 
AlexPles: folds 
fanmtZ: folds 
hmverlin: folds 
Uncalled bet (€0.75) returned to alôha
alôha collected €1.25 from pot
alôha: doesn't show hand 
*** SUMMARY ***
Total pot €1.25 | Rake €0 
Seat 1: hmverlin (big blind) folded before Flop
Seat 2: alôha collected (€1.25)
Seat 3: TopMo3UJlo folded before Flop (didn't bet)
Seat 4: matiko09 folded before Flop (didn't bet)
Seat 5: AlexPles (button) folded before Flop (didn't bet)
Seat 6: fanmtZ (small blind) folded before Flop





PokerStars Hand #155013699944:  Hold'em No Limit ($0.50/$1.00 USD) - 2016/06/21 13:40:52 CET [2016/06/21 7:40:52 ET]
Table 'Moreau' 9-max Seat #4 is the button
Seat 1: ozone2003 ($131.49 in chips) 
Seat 2: Avtovo ($108.50 in chips) 
Seat 3: matiko09 ($106.88 in chips) 
Seat 4: SharingaaN ($79.46 in chips) 
Seat 6: Troll8989 ($101.50 in chips) 
Seat 7: PanKwn15 ($96.89 in chips) 
Seat 9: Toonersens ($135.66 in chips) 
Troll8989: posts small blind $0.50
PanKwn15: posts big blind $1
*** HOLE CARDS ***
Dealt to matiko09 [2s 5h]
Toonersens: folds 
ozone2003: raises $2 to $3
Avtovo: calls $3
mi$$I$Elena joins the table at seat #8 
matiko09: folds 
SharingaaN: folds 
Troll8989: raises $10.50 to $13.50
PanKwn15: folds 
ozone2003: calls $10.50
Avtovo: folds 
*** FLOP *** [9s 2d 5s]
Troll8989: checks 
ozone2003: checks 
*** TURN *** [9s 2d 5s] [4d]
Troll8989: checks 
ozone2003: bets $14.72
Troll8989: folds 
Uncalled bet ($14.72) returned to ozone2003
ozone2003 collected $29.45 from pot
ozone2003: doesn't show hand 
*** SUMMARY ***
Total pot $31 | Rake $1.55 
Board [9s 2d 5s 4d]
Seat 1: ozone2003 collected ($29.45)
Seat 2: Avtovo folded before Flop
Seat 3: matiko09 folded before Flop (didn't bet)
Seat 4: SharingaaN (button) folded before Flop (didn't bet)
Seat 6: Troll8989 (small blind) folded on the Turn
Seat 7: PanKwn15 (big blind) folded before Flop
Seat 9: Toonersens folded before Flop (didn't bet)





PokerStars Hand #155013704186:  Hold'em No Limit ($0.50/$1.00 USD) - 2016/06/21 13:41:02 CET [2016/06/21 7:41:02 ET]
Table 'Admete II' 9-max Seat #1 is the button
Seat 1: Troll8989 ($100 in chips) 
Seat 2: Eskimo Fox ($170.92 in chips) 
Seat 3: chaps1988 ($100 in chips) 
Seat 4: 23SmOkEr07 ($101.50 in chips) 
Seat 5: stepan0605 ($101.50 in chips) 
Seat 6: mbk88 ($248.50 in chips) 
Seat 7: matiko09 ($101 in chips) 
Seat 8: koutani7 ($101.02 in chips) 
Eskimo Fox: posts small blind $0.50
chaps1988: posts big blind $1
*** HOLE CARDS ***
Dealt to matiko09 [8c As]
23SmOkEr07: folds 
stepan0605: raises $1 to $2
mbk88: folds 
matiko09: folds 
koutani7: folds 
Troll8989: folds 
Eskimo Fox: calls $1.50
chaps1988: calls $1
*** FLOP *** [6d 8d 4h]
Eskimo Fox: checks 
chaps1988: bets $4
stepan0605: calls $4
Eskimo Fox: folds 
*** TURN *** [6d 8d 4h] [3c]
chaps1988: bets $12.97
stepan0605: calls $12.97
*** RIVER *** [6d 8d 4h 3c] [6s]
chaps1988: bets $40.44
stepan0605: folds 
Uncalled bet ($40.44) returned to chaps1988
chaps1988 collected $37.94 from pot
chaps1988: doesn't show hand 
*** SUMMARY ***
Total pot $39.94 | Rake $2 
Board [6d 8d 4h 3c 6s]
Seat 1: Troll8989 (button) folded before Flop (didn't bet)
Seat 2: Eskimo Fox (small blind) folded on the Flop
Seat 3: chaps1988 (big blind) collected ($37.94)
Seat 4: 23SmOkEr07 folded before Flop (didn't bet)
Seat 5: stepan0605 folded on the River
Seat 6: mbk88 folded before Flop (didn't bet)
Seat 7: matiko09 folded before Flop (didn't bet)
Seat 8: koutani7 folded before Flop (didn't bet)





PokerStars Hand #155013707093:  Hold'em No Limit ($0.50/$1.00 USD) - 2016/06/21 13:41:08 CET [2016/06/21 7:41:08 ET]
Table 'Carlova II' 9-max Seat #4 is the button
Seat 1: matiko09 ($107.80 in chips) 
Seat 2: mbk88 ($138.15 in chips) 
Seat 3: SharingaaN ($112.28 in chips) 
Seat 4: Dandy Monk ($161.56 in chips) 
Seat 5: ozone2003 ($100 in chips) 
Seat 6: Donetsk1y ($100 in chips) 
Seat 7: mi$$I$Elena ($100.77 in chips) 
Seat 8: pyromid ($103.30 in chips) 
Seat 9: Troll8989 ($114.96 in chips) 
ozone2003: posts small blind $0.50
Donetsk1y: posts big blind $1
*** HOLE CARDS ***
Dealt to matiko09 [9d 5d]
mi$$I$Elena: raises $2 to $3
pyromid: folds 
Troll8989: folds 
matiko09: folds 
mbk88: folds 
SharingaaN: folds 
Dandy Monk: folds 
ozone2003: folds 
Donetsk1y: calls $2
*** FLOP *** [Kd 4d 7c]
Donetsk1y: checks 
mi$$I$Elena: bets $4
Donetsk1y: folds 
Uncalled bet ($4) returned to mi$$I$Elena
mi$$I$Elena collected $6.18 from pot
mi$$I$Elena: doesn't show hand 
*** SUMMARY ***
Total pot $6.50 | Rake $0.32 
Board [Kd 4d 7c]
Seat 1: matiko09 folded before Flop (didn't bet)
Seat 2: mbk88 folded before Flop (didn't bet)
Seat 3: SharingaaN folded before Flop (didn't bet)
Seat 4: Dandy Monk (button) folded before Flop (didn't bet)
Seat 5: ozone2003 (small blind) folded before Flop
Seat 6: Donetsk1y (big blind) folded on the Flop
Seat 7: mi$$I$Elena collected ($6.18)
Seat 8: pyromid folded before Flop (didn't bet)
Seat 9: Troll8989 folded before Flop (didn't bet)





PokerStars Hand #155013709437:  Hold'em No Limit ($0.50/$1.00 USD) - 2016/06/21 13:41:14 CET [2016/06/21 7:41:14 ET]
Table 'Umbriel II' 9-max Seat #3 is the button
Seat 1: matiko09 ($148.46 in chips) 
Seat 2: mi$$I$Elena ($100 in chips) 
Seat 3: mxustin ($28.75 in chips) 
Seat 4: Eskimo Fox ($100 in chips) 
Seat 5: mbk88 ($100 in chips) 
Seat 7: Chen423 ($92.45 in chips) 
Seat 8: AXE705 ($133.10 in chips) 
Eskimo Fox: posts small blind $0.50
mbk88: posts big blind $1
maxxmeister: sits out 
*** HOLE CARDS ***
Dealt to matiko09 [Qh 2c]
Chen423: folds 
AXE705: folds 
matiko09: folds 
mi$$I$Elena: folds 
mxustin: folds 
Eskimo Fox: raises $1.50 to $2.50
mbk88: folds 
Uncalled bet ($1.50) returned to Eskimo Fox
Eskimo Fox collected $2 from pot
Eskimo Fox: doesn't show hand 
*** SUMMARY ***
Total pot $2 | Rake $0 
Seat 1: matiko09 folded before Flop (didn't bet)
Seat 2: mi$$I$Elena folded before Flop (didn't bet)
Seat 3: mxustin (button) folded before Flop (didn't bet)
Seat 4: Eskimo Fox (small blind) collected ($2)
Seat 5: mbk88 (big blind) folded before Flop
Seat 7: Chen423 folded before Flop (didn't bet)
Seat 8: AXE705 folded before Flop (didn't bet)





PokerStars Hand #155013712105:  Hold'em No Limit (€0.25/€0.50 EUR) - 2016/06/21 13:41:20 CET [2016/06/21 7:41:20 ET]
Table 'Actor II' 6-max Seat #6 is the button
Seat 1: hmverlin (€77.46 in chips) 
Seat 2: alôha (€63.59 in chips) 
Seat 3: TopMo3UJlo (€50.75 in chips) 
Seat 4: matiko09 (€84.05 in chips) 
Seat 5: AlexPles (€50 in chips) 
Seat 6: fanmtZ (€22.97 in chips) 
hmverlin: posts small blind €0.25
alôha: posts big blind €0.50
*** HOLE CARDS ***
Dealt to matiko09 [Qd 7s]
TopMo3UJlo: raises €1 to €1.50
matiko09: folds 
AlexPles: folds 
fanmtZ: folds 
hmverlin: raises €2 to €3.50
alôha: folds 
TopMo3UJlo: calls €2
*** FLOP *** [6d 9h 5c]
hmverlin: bets €3.50
TopMo3UJlo: folds 
Uncalled bet (€3.50) returned to hmverlin
hmverlin collected €7.12 from pot
hmverlin: doesn't show hand 
*** SUMMARY ***
Total pot €7.50 | Rake €0.38 
Board [6d 9h 5c]
Seat 1: hmverlin (small blind) collected (€7.12)
Seat 2: alôha (big blind) folded before Flop
Seat 3: TopMo3UJlo folded on the Flop
Seat 4: matiko09 folded before Flop (didn't bet)
Seat 5: AlexPles folded before Flop (didn't bet)
Seat 6: fanmtZ (button) folded before Flop (didn't bet)





PokerStars Hand #155013716361:  Hold'em No Limit ($0.50/$1.00 USD) - 2016/06/21 13:41:30 CET [2016/06/21 7:41:30 ET]
Table 'Saldanha' 9-max Seat #8 is the button
Seat 1: stepan0605 ($100 in chips) 
Seat 2: matiko09 ($402.19 in chips) 
Seat 5: Michael Quan ($155.23 in chips) 
Seat 6: Donetsk1y ($135.94 in chips) 
Seat 7: ozone2003 ($117.50 in chips) 
Seat 8: erick222 ($100 in chips) 
Seat 9: 23SmOkEr07 ($100 in chips) 
23SmOkEr07: posts small blind $0.50
stepan0605: posts big blind $1
mbk88: sits out 
stepan0605: posts the ante $0.20
matiko09: posts the ante $0.20
Michael Quan: posts the ante $0.20
Donetsk1y: posts the ante $0.20
ozone2003: posts the ante $0.20
erick222: posts the ante $0.20
23SmOkEr07: posts the ante $0.20
*** HOLE CARDS ***
Dealt to matiko09 [7h 8c]
matiko09: folds 
Michael Quan: folds 
Donetsk1y: folds 
ozone2003: raises $1.50 to $2.50
erick222: calls $2.50
23SmOkEr07: folds 
stepan0605: folds 
*** FLOP *** [Jc 2d 6s]
ozone2003: bets $4.88
erick222: calls $4.88
*** TURN *** [Jc 2d 6s] [5d]
ozone2003: bets $10.57
erick222: calls $10.57
*** RIVER *** [Jc 2d 6s 5d] [2h]
ozone2003: bets $22.90
erick222: folds 
Uncalled bet ($22.90) returned to ozone2003
ozone2003 collected $36.86 from pot
ozone2003: doesn't show hand 
*** SUMMARY ***
Total pot $38.80 | Rake $1.94 
Board [Jc 2d 6s 5d 2h]
Seat 1: stepan0605 (big blind) folded before Flop
Seat 2: matiko09 folded before Flop (didn't bet)
Seat 5: Michael Quan folded before Flop (didn't bet)
Seat 6: Donetsk1y folded before Flop (didn't bet)
Seat 7: ozone2003 collected ($36.86)
Seat 8: erick222 (button) folded on the River
Seat 9: 23SmOkEr07 (small blind) folded before Flop





PokerStars Hand #155013719099:  Hold'em No Limit ($0.50/$1.00 USD) - 2016/06/21 13:41:36 CET [2016/06/21 7:41:36 ET]
Table 'Umbriel II' 9-max Seat #4 is the button
Seat 1: matiko09 ($148.46 in chips) 
Seat 2: mi$$I$Elena ($100 in chips) 
Seat 3: mxustin ($28.75 in chips) 
Seat 4: Eskimo Fox ($101 in chips) 
Seat 5: mbk88 ($100 in chips) 
Seat 6: maxxmeister ($109.52 in chips) 
Seat 7: Chen423 ($92.45 in chips) 
Seat 8: AXE705 ($133.10 in chips) 
mbk88: posts small blind $0.50
maxxmeister: posts big blind $1
*** HOLE CARDS ***
Dealt to matiko09 [5s Ad]
Chen423: raises $2 to $3
AXE705: folds 
matiko09: folds 
mi$$I$Elena: folds 
mxustin: folds 
Eskimo Fox: folds 
mbk88: folds 
maxxmeister: folds 
Uncalled bet ($2) returned to Chen423
Chen423 collected $2.50 from pot
Chen423: doesn't show hand 
*** SUMMARY ***
Total pot $2.50 | Rake $0 
Seat 1: matiko09 folded before Flop (didn't bet)
Seat 2: mi$$I$Elena folded before Flop (didn't bet)
Seat 3: mxustin folded before Flop (didn't bet)
Seat 4: Eskimo Fox (button) folded before Flop (didn't bet)
Seat 5: mbk88 (small blind) folded before Flop
Seat 6: maxxmeister (big blind) folded before Flop
Seat 7: Chen423 collected ($2.50)
Seat 8: AXE705 folded before Flop (didn't bet)





PokerStars Hand #155013729853:  Hold'em No Limit ($0.50/$1.00 USD) - 2016/06/21 13:42:01 CET [2016/06/21 7:42:01 ET]
Table 'Moreau' 9-max Seat #6 is the button
Seat 1: ozone2003 ($147.44 in chips) 
Seat 2: Avtovo ($105.50 in chips) 
Seat 3: matiko09 ($106.88 in chips) 
Seat 4: SharingaaN ($79.46 in chips) 
Seat 6: Troll8989 ($100 in chips) 
Seat 7: PanKwn15 ($95.89 in chips) 
Seat 8: mi$$I$Elena ($100 in chips) 
Seat 9: Toonersens ($135.66 in chips) 
PanKwn15: posts small blind $0.50
mi$$I$Elena: posts big blind $1
*** HOLE CARDS ***
Dealt to matiko09 [7d Kc]
Toonersens: folds 
ozone2003: folds 
Avtovo: raises $1.50 to $2.50
matiko09: folds 
SharingaaN: folds 
Troll8989: folds 
PanKwn15: folds 
mi$$I$Elena: folds 
Uncalled bet ($1.50) returned to Avtovo
Avtovo collected $2.50 from pot
Avtovo: doesn't show hand 
*** SUMMARY ***
Total pot $2.50 | Rake $0 
Seat 1: ozone2003 folded before Flop (didn't bet)
Seat 2: Avtovo collected ($2.50)
Seat 3: matiko09 folded before Flop (didn't bet)
Seat 4: SharingaaN folded before Flop (didn't bet)
Seat 6: Troll8989 (button) folded before Flop (didn't bet)
Seat 7: PanKwn15 (small blind) folded before Flop
Seat 8: mi$$I$Elena (big blind) folded before Flop
Seat 9: Toonersens folded before Flop (didn't bet)





PokerStars Hand #155013731298:  Hold'em No Limit ($0.50/$1.00 USD) - 2016/06/21 13:42:04 CET [2016/06/21 7:42:04 ET]
Table 'Carlova II' 9-max Seat #5 is the button
Seat 1: matiko09 ($107.80 in chips) 
Seat 2: mbk88 ($138.15 in chips) 
Seat 3: SharingaaN ($112.28 in chips) 
Seat 4: Dandy Monk ($161.56 in chips) 
Seat 5: ozone2003 ($100 in chips) 
Seat 6: Donetsk1y ($100 in chips) 
Seat 7: mi$$I$Elena ($103.95 in chips) 
Seat 8: pyromid ($103.30 in chips) 
Seat 9: Troll8989 ($114.96 in chips) 
Donetsk1y: posts small blind $0.50
mi$$I$Elena: posts big blind $1
*** HOLE CARDS ***
Dealt to matiko09 [4s 5c]
pyromid: folds 
Troll8989: folds 
matiko09: folds 
mbk88: folds 
SharingaaN: folds 
Dandy Monk: raises $2 to $3
ozone2003: folds 
Donetsk1y: folds 
mi$$I$Elena: raises $8.50 to $11.50
Dandy Monk: folds 
Uncalled bet ($8.50) returned to mi$$I$Elena
mi$$I$Elena collected $6.50 from pot
mi$$I$Elena: doesn't show hand 
*** SUMMARY ***
Total pot $6.50 | Rake $0 
Seat 1: matiko09 folded before Flop (didn't bet)
Seat 2: mbk88 folded before Flop (didn't bet)
Seat 3: SharingaaN folded before Flop (didn't bet)
Seat 4: Dandy Monk folded before Flop
Seat 5: ozone2003 (button) folded before Flop (didn't bet)
Seat 6: Donetsk1y (small blind) folded before Flop
Seat 7: mi$$I$Elena (big blind) collected ($6.50)
Seat 8: pyromid folded before Flop (didn't bet)
Seat 9: Troll8989 folded before Flop (didn't bet)





PokerStars Hand #155013739145:  Hold'em No Limit (€0.25/€0.50 EUR) - 2016/06/21 13:42:22 CET [2016/06/21 7:42:22 ET]
Table 'Actor II' 6-max Seat #1 is the button
Seat 1: hmverlin (€81.08 in chips) 
Seat 2: alôha (€63.09 in chips) 
Seat 3: TopMo3UJlo (€50 in chips) 
Seat 4: matiko09 (€84.05 in chips) 
Seat 5: AlexPles (€50 in chips) 
Seat 6: fanmtZ (€22.97 in chips) 
alôha: posts small blind €0.25
TopMo3UJlo: posts big blind €0.50
*** HOLE CARDS ***
Dealt to matiko09 [Qh 9c]
matiko09: folds 
AlexPles: folds 
fanmtZ: folds 
hmverlin: raises €1 to €1.50
alôha: folds 
TopMo3UJlo: folds 
Uncalled bet (€1) returned to hmverlin
hmverlin collected €1.25 from pot
hmverlin: doesn't show hand 
*** SUMMARY ***
Total pot €1.25 | Rake €0 
Seat 1: hmverlin (button) collected (€1.25)
Seat 2: alôha (small blind) folded before Flop
Seat 3: TopMo3UJlo (big blind) folded before Flop
Seat 4: matiko09 folded before Flop (didn't bet)
Seat 5: AlexPles folded before Flop (didn't bet)
Seat 6: fanmtZ folded before Flop (didn't bet)





PokerStars Hand #155013745066:  Hold'em No Limit ($0.50/$1.00 USD) - 2016/06/21 13:42:36 CET [2016/06/21 7:42:36 ET]
Table 'Umbriel II' 9-max Seat #5 is the button
Seat 1: matiko09 ($148.46 in chips) 
Seat 2: mi$$I$Elena ($100 in chips) 
Seat 3: mxustin ($28.75 in chips) 
Seat 4: Eskimo Fox ($101 in chips) 
Seat 5: mbk88 ($100 in chips) 
Seat 6: maxxmeister ($108.52 in chips) 
Seat 7: Chen423 ($93.95 in chips) 
Seat 8: AXE705 ($133.10 in chips) 
maxxmeister: posts small blind $0.50
Chen423: posts big blind $1
*** HOLE CARDS ***
Dealt to matiko09 [9s Js]
AXE705: folds 
matiko09: folds 
mi$$I$Elena: folds 
mxustin: folds 
Eskimo Fox: raises $1.50 to $2.50
mbk88: folds 
maxxmeister: folds 
Chen423: folds 
Uncalled bet ($1.50) returned to Eskimo Fox
Eskimo Fox collected $2.50 from pot
Eskimo Fox: doesn't show hand 
*** SUMMARY ***
Total pot $2.50 | Rake $0 
Seat 1: matiko09 folded before Flop (didn't bet)
Seat 2: mi$$I$Elena folded before Flop (didn't bet)
Seat 3: mxustin folded before Flop (didn't bet)
Seat 4: Eskimo Fox collected ($2.50)
Seat 5: mbk88 (button) folded before Flop (didn't bet)
Seat 6: maxxmeister (small blind) folded before Flop
Seat 7: Chen423 (big blind) folded before Flop
Seat 8: AXE705 folded before Flop (didn't bet)





PokerStars Hand #155013745438:  Hold'em No Limit ($0.50/$1.00 USD) - 2016/06/21 13:42:36 CET [2016/06/21 7:42:36 ET]
Table 'Moreau' 9-max Seat #7 is the button
Seat 1: ozone2003 ($147.44 in chips) 
Seat 2: Avtovo ($107 in chips) 
Seat 3: matiko09 ($106.88 in chips) 
Seat 4: SharingaaN ($79.46 in chips) 
Seat 6: Troll8989 ($100 in chips) 
Seat 7: PanKwn15 ($95.39 in chips) 
Seat 8: mi$$I$Elena ($100 in chips) 
Seat 9: Toonersens ($135.66 in chips) 
mi$$I$Elena: posts small blind $0.50
Toonersens: posts big blind $1
*** HOLE CARDS ***
Dealt to matiko09 [Js 2h]
ozone2003: folds 
Avtovo: folds 
matiko09: folds 
SharingaaN: folds 
Troll8989: raises $1.50 to $2.50
PanKwn15: folds 
mi$$I$Elena: folds 
Toonersens: folds 
Uncalled bet ($1.50) returned to Troll8989
Troll8989 collected $2.50 from pot
Troll8989: doesn't show hand 
*** SUMMARY ***
Total pot $2.50 | Rake $0 
Seat 1: ozone2003 folded before Flop (didn't bet)
Seat 2: Avtovo folded before Flop (didn't bet)
Seat 3: matiko09 folded before Flop (didn't bet)
Seat 4: SharingaaN folded before Flop (didn't bet)
Seat 6: Troll8989 collected ($2.50)
Seat 7: PanKwn15 (button) folded before Flop (didn't bet)
Seat 8: mi$$I$Elena (small blind) folded before Flop
Seat 9: Toonersens (big blind) folded before Flop





PokerStars Hand #155013746105:  Hold'em No Limit ($0.50/$1.00 USD) - 2016/06/21 13:42:38 CET [2016/06/21 7:42:38 ET]
Table 'Megrez II' 9-max Seat #1 is the button
Seat 1: hurtNCYDE ($106 in chips) 
Seat 2: Filojoes ($113.45 in chips) 
Seat 4: matiko09 ($100 in chips) 
Seat 5: Avtovo ($128.68 in chips) 
Seat 6: stepan0605 ($100 in chips) 
Seat 8: Menno78 ($45.44 in chips) 
Seat 9: MarioDong ($120.31 in chips) 
Filojoes: posts small blind $0.50
mbk88: is sitting out 
matiko09: posts big blind $1
*** HOLE CARDS ***
Dealt to matiko09 [4s 5c]
Avtovo: folds 
stepan0605: folds 
Menno78: folds 
MarioDong: raises $2 to $3
hurtNCYDE: raises $5 to $8
Filojoes: folds 
matiko09: folds 
MarioDong: raises $14 to $22
hurtNCYDE: folds 
Uncalled bet ($14) returned to MarioDong
MarioDong collected $17.50 from pot
*** SUMMARY ***
Total pot $17.50 | Rake $0 
Seat 1: hurtNCYDE (button) folded before Flop
Seat 2: Filojoes (small blind) folded before Flop
Seat 4: matiko09 (big blind) folded before Flop
Seat 5: Avtovo folded before Flop (didn't bet)
Seat 6: stepan0605 folded before Flop (didn't bet)
Seat 8: Menno78 folded before Flop (didn't bet)
Seat 9: MarioDong collected ($17.50)





PokerStars Hand #155013751152:  Hold'em No Limit ($0.50/$1.00 USD) - 2016/06/21 13:42:50 CET [2016/06/21 7:42:50 ET]
Table 'Carlova II' 9-max Seat #6 is the button
Seat 1: matiko09 ($107.80 in chips) 
Seat 2: mbk88 ($138.15 in chips) 
Seat 3: SharingaaN ($112.28 in chips) 
Seat 4: Dandy Monk ($158.56 in chips) 
Seat 5: ozone2003 ($100 in chips) 
Seat 6: Donetsk1y ($100 in chips) 
Seat 7: mi$$I$Elena ($107.45 in chips) 
Seat 8: pyromid ($103.30 in chips) 
Seat 9: Troll8989 ($114.96 in chips) 
mi$$I$Elena: posts small blind $0.50
pyromid: posts big blind $1
*** HOLE CARDS ***
Dealt to matiko09 [9c 7s]
Troll8989: raises $1.50 to $2.50
matiko09: folds 
mbk88: folds 
SharingaaN: raises $5.50 to $8
Dandy Monk: folds 
ozone2003: folds 
Donetsk1y: folds 
mi$$I$Elena: folds 
pyromid: folds 
Troll8989: folds 
Uncalled bet ($5.50) returned to SharingaaN
SharingaaN collected $6.50 from pot
SharingaaN: doesn't show hand 
*** SUMMARY ***
Total pot $6.50 | Rake $0 
Seat 1: matiko09 folded before Flop (didn't bet)
Seat 2: mbk88 folded before Flop (didn't bet)
Seat 3: SharingaaN collected ($6.50)
Seat 4: Dandy Monk folded before Flop (didn't bet)
Seat 5: ozone2003 folded before Flop (didn't bet)
Seat 6: Donetsk1y (button) folded before Flop (didn't bet)
Seat 7: mi$$I$Elena (small blind) folded before Flop
Seat 8: pyromid (big blind) folded before Flop
Seat 9: Troll8989 folded before Flop





PokerStars Hand #155013755249:  Hold'em No Limit ($0.50/$1.00 USD) - 2016/06/21 13:42:59 CET [2016/06/21 7:42:59 ET]
Table 'Admete II' 9-max Seat #2 is the button
Seat 1: Troll8989 ($100 in chips) 
Seat 2: Eskimo Fox ($168.92 in chips) 
Seat 3: chaps1988 ($118.97 in chips) 
Seat 4: 23SmOkEr07 ($101.50 in chips) 
Seat 5: stepan0605 ($100 in chips) 
Seat 6: mbk88 ($248.50 in chips) 
Seat 7: matiko09 ($101 in chips) 
Seat 8: koutani7 ($101.02 in chips) 
chaps1988: posts small blind $0.50
23SmOkEr07: posts big blind $1
CoolFireX: sits out 
*** HOLE CARDS ***
Dealt to matiko09 [9s 4d]
stepan0605: raises $1 to $2
mbk88: folds 
matiko09: folds 
koutani7: folds 
Troll8989: folds 
Eskimo Fox: calls $2
chaps1988: folds 
23SmOkEr07: folds 
*** FLOP *** [5d Jd 9c]
stepan0605: checks 
Eskimo Fox: bets $4
stepan0605: folds 
Uncalled bet ($4) returned to Eskimo Fox
Eskimo Fox collected $5.22 from pot
Eskimo Fox: doesn't show hand 
*** SUMMARY ***
Total pot $5.50 | Rake $0.28 
Board [5d Jd 9c]
Seat 1: Troll8989 folded before Flop (didn't bet)
Seat 2: Eskimo Fox (button) collected ($5.22)
Seat 3: chaps1988 (small blind) folded before Flop
Seat 4: 23SmOkEr07 (big blind) folded before Flop
Seat 5: stepan0605 folded on the Flop
Seat 6: mbk88 folded before Flop (didn't bet)
Seat 7: matiko09 folded before Flop (didn't bet)
Seat 8: koutani7 folded before Flop (didn't bet)





PokerStars Hand #155013755181:  Hold'em No Limit (€0.25/€0.50 EUR) - 2016/06/21 13:42:59 CET [2016/06/21 7:42:59 ET]
Table 'Actor II' 6-max Seat #2 is the button
Seat 1: hmverlin (€81.83 in chips) 
Seat 2: alôha (€62.84 in chips) 
Seat 3: TopMo3UJlo (€50 in chips) 
Seat 4: matiko09 (€84.05 in chips) 
Seat 5: AlexPles (€50 in chips) 
Seat 6: fanmtZ (€22.97 in chips) 
TopMo3UJlo: posts small blind €0.25
matiko09: posts big blind €0.50
*** HOLE CARDS ***
Dealt to matiko09 [6c Qc]
AlexPles: folds 
fanmtZ: folds 
hmverlin: folds 
alôha: raises €0.50 to €1
TopMo3UJlo: folds 
matiko09: calls €0.50
*** FLOP *** [Ah Qh 3d]
matiko09: checks 
alôha: bets €1.50
matiko09: calls €1.50
*** TURN *** [Ah Qh 3d] [2h]
matiko09: checks 
alôha: bets €4
matiko09: folds 
Uncalled bet (€4) returned to alôha
alôha collected €4.99 from pot
alôha: doesn't show hand 
*** SUMMARY ***
Total pot €5.25 | Rake €0.26 
Board [Ah Qh 3d 2h]
Seat 1: hmverlin folded before Flop (didn't bet)
Seat 2: alôha (button) collected (€4.99)
Seat 3: TopMo3UJlo (small blind) folded before Flop
Seat 4: matiko09 (big blind) folded on the Turn
Seat 5: AlexPles folded before Flop (didn't bet)
Seat 6: fanmtZ folded before Flop (didn't bet)





PokerStars Hand #155013765087:  Hold'em No Limit ($0.50/$1.00 USD) - 2016/06/21 13:43:22 CET [2016/06/21 7:43:22 ET]
Table 'Moreau' 9-max Seat #8 is the button
Seat 1: ozone2003 ($147.44 in chips) 
Seat 2: Avtovo ($107 in chips) 
Seat 3: matiko09 ($106.88 in chips) 
Seat 4: SharingaaN ($79.46 in chips) 
Seat 6: Troll8989 ($101.50 in chips) 
Seat 7: PanKwn15 ($95.39 in chips) 
Seat 8: mi$$I$Elena ($100 in chips) 
Seat 9: Toonersens ($134.66 in chips) 
Toonersens: posts small blind $0.50
ozone2003: posts big blind $1
CoolFireX: sits out 
*** HOLE CARDS ***
Dealt to matiko09 [Ad Ks]
Avtovo: folds 
matiko09: raises $2 to $3
SharingaaN: folds 
Troll8989: folds 
PanKwn15: calls $3
mi$$I$Elena: calls $3
Toonersens: folds 
ozone2003: folds 
*** FLOP *** [Th 2s 4d]
matiko09: checks 
PanKwn15: checks 
mi$$I$Elena: checks 
*** TURN *** [Th 2s 4d] [Kh]
matiko09: bets $6.49
PanKwn15: calls $6.49
mi$$I$Elena: folds 
*** RIVER *** [Th 2s 4d Kh] [2c]
matiko09: checks 
PanKwn15: checks 
*** SHOW DOWN ***
matiko09: shows [Ad Ks] (two pair, Kings and Deuces)
PanKwn15: mucks hand 
matiko09 collected $22.31 from pot
*** SUMMARY ***
Total pot $23.48 | Rake $1.17 
Board [Th 2s 4d Kh 2c]
Seat 1: ozone2003 (big blind) folded before Flop
Seat 2: Avtovo folded before Flop (didn't bet)
Seat 3: matiko09 showed [Ad Ks] and won ($22.31) with two pair, Kings and Deuces
Seat 4: SharingaaN folded before Flop (didn't bet)
Seat 6: Troll8989 folded before Flop (didn't bet)
Seat 7: PanKwn15 mucked [Ah Qc]
Seat 8: mi$$I$Elena (button) folded on the Turn
Seat 9: Toonersens (small blind) folded before Flop





PokerStars Hand #155013766164:  Hold'em No Limit ($0.50/$1.00 USD) - 2016/06/21 13:43:25 CET [2016/06/21 7:43:25 ET]
Table 'Umbriel II' 9-max Seat #6 is the button
Seat 1: matiko09 ($148.46 in chips) 
Seat 2: mi$$I$Elena ($100 in chips) 
Seat 3: mxustin ($28.75 in chips) 
Seat 4: Eskimo Fox ($102.50 in chips) 
Seat 5: mbk88 ($100 in chips) 
Seat 6: maxxmeister ($108.02 in chips) 
Seat 7: Chen423 ($92.95 in chips) 
Seat 8: AXE705 ($133.10 in chips) 
Chen423: posts small blind $0.50
AXE705: posts big blind $1
CoolFireX: sits out 
*** HOLE CARDS ***
Dealt to matiko09 [5d 2h]
matiko09: folds 
mi$$I$Elena: folds 
mxustin: folds 
Eskimo Fox: folds 
mbk88: folds 
maxxmeister: raises $2.50 to $3.50
Chen423: folds 
AXE705: raises $6.50 to $10
maxxmeister: calls $6.50
*** FLOP *** [4d As 6d]
AXE705: bets $13
maxxmeister: folds 
Uncalled bet ($13) returned to AXE705
AXE705 collected $19.48 from pot
AXE705: doesn't show hand 
*** SUMMARY ***
Total pot $20.50 | Rake $1.02 
Board [4d As 6d]
Seat 1: matiko09 folded before Flop (didn't bet)
Seat 2: mi$$I$Elena folded before Flop (didn't bet)
Seat 3: mxustin folded before Flop (didn't bet)
Seat 4: Eskimo Fox folded before Flop (didn't bet)
Seat 5: mbk88 folded before Flop (didn't bet)
Seat 6: maxxmeister (button) folded on the Flop
Seat 7: Chen423 (small blind) folded before Flop
Seat 8: AXE705 (big blind) collected ($19.48)





PokerStars Hand #155013778583:  Hold'em No Limit ($0.50/$1.00 USD) - 2016/06/21 13:43:53 CET [2016/06/21 7:43:53 ET]
Table 'Megrez II' 9-max Seat #2 is the button
Seat 1: hurtNCYDE ($100 in chips) 
Seat 2: Filojoes ($112.95 in chips) 
Seat 4: matiko09 ($100 in chips) 
Seat 5: Avtovo ($128.68 in chips) 
Seat 6: stepan0605 ($100 in chips) 
Seat 8: Menno78 ($45.44 in chips) 
Seat 9: MarioDong ($129.81 in chips) 
matiko09: posts small blind $0.50
Avtovo: posts big blind $1
CoolFireX: sits out 
*** HOLE CARDS ***
Dealt to matiko09 [4c Td]
stepan0605: folds 
Menno78: folds 
MarioDong: folds 
hurtNCYDE: raises $1.50 to $2.50
Filojoes: folds 
matiko09: folds 
Avtovo: folds 
Uncalled bet ($1.50) returned to hurtNCYDE
hurtNCYDE collected $2.50 from pot
*** SUMMARY ***
Total pot $2.50 | Rake $0 
Seat 1: hurtNCYDE collected ($2.50)
Seat 2: Filojoes (button) folded before Flop (didn't bet)
Seat 4: matiko09 (small blind) folded before Flop
Seat 5: Avtovo (big blind) folded before Flop
Seat 6: stepan0605 folded before Flop (didn't bet)
Seat 8: Menno78 folded before Flop (didn't bet)
Seat 9: MarioDong folded before Flop (didn't bet)





PokerStars Hand #155013779176:  Hold'em No Limit (€0.25/€0.50 EUR) - 2016/06/21 13:43:54 CET [2016/06/21 7:43:54 ET]
Table 'Actor II' 6-max Seat #3 is the button
Seat 1: hmverlin (€81.83 in chips) 
Seat 2: alôha (€65.33 in chips) 
Seat 3: TopMo3UJlo (€50 in chips) 
Seat 4: matiko09 (€81.55 in chips) 
Seat 5: AlexPles (€50 in chips) 
Seat 6: fanmtZ (€22.97 in chips) 
matiko09: posts small blind €0.25
AlexPles: posts big blind €0.50
*** HOLE CARDS ***
Dealt to matiko09 [Td 6h]
fanmtZ: folds 
hmverlin: folds 
alôha: folds 
TopMo3UJlo: raises €0.60 to €1.10
matiko09: folds 
AlexPles: calls €0.60
*** FLOP *** [8d 5d 4s]
AlexPles: checks 
TopMo3UJlo: bets €1.56
AlexPles: folds 
Uncalled bet (€1.56) returned to TopMo3UJlo
TopMo3UJlo collected €2.33 from pot
TopMo3UJlo: doesn't show hand 
*** SUMMARY ***
Total pot €2.45 | Rake €0.12 
Board [8d 5d 4s]
Seat 1: hmverlin folded before Flop (didn't bet)
Seat 2: alôha folded before Flop (didn't bet)
Seat 3: TopMo3UJlo (button) collected (€2.33)
Seat 4: matiko09 (small blind) folded before Flop
Seat 5: AlexPles (big blind) folded on the Flop
Seat 6: fanmtZ folded before Flop (didn't bet)





PokerStars Hand #155013785247:  Hold'em No Limit ($0.50/$1.00 USD) - 2016/06/21 13:44:08 CET [2016/06/21 7:44:08 ET]
Table 'Carlova II' 9-max Seat #7 is the button
Seat 1: matiko09 ($107.80 in chips) 
Seat 2: mbk88 ($138.15 in chips) 
Seat 3: SharingaaN ($116.28 in chips) 
Seat 4: Dandy Monk ($158.56 in chips) 
Seat 5: ozone2003 ($100 in chips) 
Seat 6: Donetsk1y ($100 in chips) 
Seat 7: mi$$I$Elena ($106.95 in chips) 
Seat 8: pyromid ($102.30 in chips) 
Seat 9: Troll8989 ($112.46 in chips) 
pyromid: posts small blind $0.50
Troll8989: posts big blind $1
*** HOLE CARDS ***
Dealt to matiko09 [6c 3c]
matiko09: folds 
mbk88: folds 
SharingaaN: folds 
Dandy Monk: folds 
ozone2003: folds 
Donetsk1y: raises $1.50 to $2.50
mi$$I$Elena: folds 
pyromid: folds 
Troll8989: folds 
Uncalled bet ($1.50) returned to Donetsk1y
Donetsk1y collected $2.50 from pot
Donetsk1y: doesn't show hand 
*** SUMMARY ***
Total pot $2.50 | Rake $0 
Seat 1: matiko09 folded before Flop (didn't bet)
Seat 2: mbk88 folded before Flop (didn't bet)
Seat 3: SharingaaN folded before Flop (didn't bet)
Seat 4: Dandy Monk folded before Flop (didn't bet)
Seat 5: ozone2003 folded before Flop (didn't bet)
Seat 6: Donetsk1y collected ($2.50)
Seat 7: mi$$I$Elena (button) folded before Flop (didn't bet)
Seat 8: pyromid (small blind) folded before Flop
Seat 9: Troll8989 (big blind) folded before Flop





PokerStars Hand #155013789478:  Hold'em No Limit ($0.50/$1.00 USD) - 2016/06/21 13:44:18 CET [2016/06/21 7:44:18 ET]
Table 'Megrez II' 9-max Seat #4 is the button
Seat 1: hurtNCYDE ($101.50 in chips) 
Seat 2: Filojoes ($112.95 in chips) 
Seat 4: matiko09 ($100 in chips) 
Seat 5: Avtovo ($127.68 in chips) 
Seat 6: stepan0605 ($100 in chips) 
Seat 8: Menno78 ($45.44 in chips) 
Seat 9: MarioDong ($129.81 in chips) 
Avtovo: posts small blind $0.50
stepan0605: posts big blind $1
CoolFireX: sits out 
*** HOLE CARDS ***
Dealt to matiko09 [9d Ks]
Menno78: folds 
MarioDong: folds 
hurtNCYDE: folds 
Filojoes: folds 
matiko09: raises $1.27 to $2.27
Avtovo: folds 
stepan0605: calls $1.27
*** FLOP *** [3c Jc 6d]
stepan0605: checks 
matiko09: bets $3.11
stepan0605: calls $3.11
*** TURN *** [3c Jc 6d] [8d]
stepan0605: checks 
matiko09: checks 
*** RIVER *** [3c Jc 6d 8d] [As]
stepan0605: checks 
matiko09: checks 
*** SHOW DOWN ***
stepan0605: shows [Jd 9c] (a pair of Jacks)
matiko09: mucks hand 
stepan0605 collected $10.70 from pot
*** SUMMARY ***
Total pot $11.26 | Rake $0.56 
Board [3c Jc 6d 8d As]
Seat 1: hurtNCYDE folded before Flop (didn't bet)
Seat 2: Filojoes folded before Flop (didn't bet)
Seat 4: matiko09 (button) mucked [9d Ks]
Seat 5: Avtovo (small blind) folded before Flop
Seat 6: stepan0605 (big blind) showed [Jd 9c] and won ($10.70) with a pair of Jacks
Seat 8: Menno78 folded before Flop (didn't bet)
Seat 9: MarioDong folded before Flop (didn't bet)





PokerStars Hand #155013793340:  Hold'em No Limit ($0.50/$1.00 USD) - 2016/06/21 13:44:27 CET [2016/06/21 7:44:27 ET]
Table 'Moreau' 9-max Seat #9 is the button
Seat 1: ozone2003 ($146.44 in chips) 
Seat 2: Avtovo ($107 in chips) 
Seat 3: matiko09 ($119.70 in chips) 
Seat 4: SharingaaN ($79.46 in chips) 
Seat 6: Troll8989 ($101.50 in chips) 
Seat 7: PanKwn15 ($85.90 in chips) 
Seat 8: mi$$I$Elena ($100 in chips) 
Seat 9: Toonersens ($134.16 in chips) 
ozone2003: posts small blind $0.50
Avtovo: posts big blind $1
CoolFireX: sits out 
*** HOLE CARDS ***
Dealt to matiko09 [7s 5d]
matiko09: folds 
SharingaaN: folds 
Troll8989: folds 
PanKwn15: folds 
mi$$I$Elena: folds 
Toonersens: folds 
ozone2003: folds 
Uncalled bet ($0.50) returned to Avtovo
Avtovo collected $1 from pot
Avtovo: doesn't show hand 
*** SUMMARY ***
Total pot $1 | Rake $0 
Seat 1: ozone2003 (small blind) folded before Flop
Seat 2: Avtovo (big blind) collected ($1)
Seat 3: matiko09 folded before Flop (didn't bet)
Seat 4: SharingaaN folded before Flop (didn't bet)
Seat 6: Troll8989 folded before Flop (didn't bet)
Seat 7: PanKwn15 folded before Flop (didn't bet)
Seat 8: mi$$I$Elena folded before Flop (didn't bet)
Seat 9: Toonersens (button) folded before Flop (didn't bet)





PokerStars Hand #155013793876:  Hold'em No Limit ($0.50/$1.00 USD) - 2016/06/21 13:44:28 CET [2016/06/21 7:44:28 ET]
Table 'Admete II' 9-max Seat #3 is the button
Seat 1: Troll8989 ($100 in chips) 
Seat 2: Eskimo Fox ($172.14 in chips) 
Seat 3: chaps1988 ($118.47 in chips) 
Seat 4: 23SmOkEr07 ($100.50 in chips) 
Seat 6: mbk88 ($248.50 in chips) 
Seat 7: matiko09 ($101 in chips) 
Seat 8: koutani7 ($101.02 in chips) 
23SmOkEr07: posts small blind $0.50
stepan0605: is sitting out 
mbk88: posts big blind $1
stepan0605 leaves the table
CoolFireX: sits out 
*** HOLE CARDS ***
Dealt to matiko09 [Ts 4c]
matiko09: folds 
aceking00007 joins the table at seat #5 
koutani7: raises $2 to $3
Troll8989: folds 
Eskimo Fox: folds 
chaps1988: folds 
23SmOkEr07: folds 
mbk88: folds 
Uncalled bet ($2) returned to koutani7
koutani7 collected $2.50 from pot
koutani7: doesn't show hand 
*** SUMMARY ***
Total pot $2.50 | Rake $0 
Seat 1: Troll8989 folded before Flop (didn't bet)
Seat 2: Eskimo Fox folded before Flop (didn't bet)
Seat 3: chaps1988 (button) folded before Flop (didn't bet)
Seat 4: 23SmOkEr07 (small blind) folded before Flop
Seat 6: mbk88 (big blind) folded before Flop
Seat 7: matiko09 folded before Flop (didn't bet)
Seat 8: koutani7 collected ($2.50)





PokerStars Hand #155013799164:  Hold'em No Limit (€0.25/€0.50 EUR) - 2016/06/21 13:44:40 CET [2016/06/21 7:44:40 ET]
Table 'Actor II' 6-max Seat #4 is the button
Seat 1: hmverlin (€81.83 in chips) 
Seat 2: alôha (€65.33 in chips) 
Seat 3: TopMo3UJlo (€51.23 in chips) 
Seat 4: matiko09 (€81.30 in chips) 
Seat 5: AlexPles (€50 in chips) 
Seat 6: fanmtZ (€22.97 in chips) 
AlexPles: posts small blind €0.25
fanmtZ: posts big blind €0.50
*** HOLE CARDS ***
Dealt to matiko09 [5c Jc]
hmverlin: folds 
alôha: folds 
TopMo3UJlo: raises €0.75 to €1.25
matiko09: folds 
AlexPles: folds 
fanmtZ: calls €0.75
*** FLOP *** [Tc 7s 9h]
fanmtZ: checks 
TopMo3UJlo: bets €1.74
fanmtZ: folds 
Uncalled bet (€1.74) returned to TopMo3UJlo
TopMo3UJlo collected €2.61 from pot
TopMo3UJlo: doesn't show hand 
*** SUMMARY ***
Total pot €2.75 | Rake €0.14 
Board [Tc 7s 9h]
Seat 1: hmverlin folded before Flop (didn't bet)
Seat 2: alôha folded before Flop (didn't bet)
Seat 3: TopMo3UJlo collected (€2.61)
Seat 4: matiko09 (button) folded before Flop (didn't bet)
Seat 5: AlexPles (small blind) folded before Flop
Seat 6: fanmtZ (big blind) folded on the Flop





PokerStars Hand #155013802863:  Hold'em No Limit ($0.50/$1.00 USD) - 2016/06/21 13:44:48 CET [2016/06/21 7:44:48 ET]
Table 'Pemba' 9-max Seat #3 is the button
Seat 3: CoolFireX ($371.90 in chips) 
Seat 5: Troll8989 ($111.45 in chips) 
Seat 6: matiko09 ($100 in chips) 
Seat 7: Donetsk1y ($100 in chips) 
Seat 8: DomiVY ($82.90 in chips) 
Seat 9: Eskimo Fox ($100 in chips) 
Troll8989: posts small blind $0.50
matiko09: posts big blind $1
Filojoes: sits out 
*** HOLE CARDS ***
Dealt to matiko09 [3d 8d]
Donetsk1y: folds 
DomiVY: folds 
Donetsk1y leaves the table
Eskimo Fox: raises $1.50 to $2.50
CoolFireX: folds 
mi$$I$Elena joins the table at seat #7 
Troll8989: folds 
matiko09: folds 
Uncalled bet ($1.50) returned to Eskimo Fox
Eskimo Fox collected $2.50 from pot
Eskimo Fox: doesn't show hand 
*** SUMMARY ***
Total pot $2.50 | Rake $0 
Seat 3: CoolFireX (button) folded before Flop (didn't bet)
Seat 5: Troll8989 (small blind) folded before Flop
Seat 6: matiko09 (big blind) folded before Flop
Seat 7: Donetsk1y folded before Flop (didn't bet)
Seat 8: DomiVY folded before Flop (didn't bet)
Seat 9: Eskimo Fox collected ($2.50)





PokerStars Hand #155013809951:  Hold'em No Limit ($0.50/$1.00 USD) - 2016/06/21 13:45:05 CET [2016/06/21 7:45:05 ET]
Table 'Umbriel II' 9-max Seat #7 is the button
Seat 1: matiko09 ($148.46 in chips) 
Seat 2: mi$$I$Elena ($100 in chips) 
Seat 3: mxustin ($28.75 in chips) 
Seat 4: Eskimo Fox ($102.50 in chips) 
Seat 5: mbk88 ($100 in chips) 
Seat 6: maxxmeister ($100 in chips) 
Seat 7: Chen423 ($92.45 in chips) 
Seat 8: AXE705 ($142.58 in chips) 
Seat 9: CoolFireX ($126.84 in chips) 
AXE705: posts small blind $0.50
CoolFireX: posts big blind $1
*** HOLE CARDS ***
Dealt to matiko09 [Tc 6c]
matiko09: folds 
mi$$I$Elena: folds 
mxustin: folds 
Eskimo Fox: raises $2 to $3
mbk88: folds 
maxxmeister: folds 
Chen423: folds 
AXE705: folds 
CoolFireX: folds 
Uncalled bet ($2) returned to Eskimo Fox
Eskimo Fox collected $2.50 from pot
Eskimo Fox: doesn't show hand 
*** SUMMARY ***
Total pot $2.50 | Rake $0 
Seat 1: matiko09 folded before Flop (didn't bet)
Seat 2: mi$$I$Elena folded before Flop (didn't bet)
Seat 3: mxustin folded before Flop (didn't bet)
Seat 4: Eskimo Fox collected ($2.50)
Seat 5: mbk88 folded before Flop (didn't bet)
Seat 6: maxxmeister folded before Flop (didn't bet)
Seat 7: Chen423 (button) folded before Flop (didn't bet)
Seat 8: AXE705 (small blind) folded before Flop
Seat 9: CoolFireX (big blind) folded before Flop





PokerStars Hand #155013810227:  Hold'em No Limit ($0.50/$1.00 USD) - 2016/06/21 13:45:05 CET [2016/06/21 7:45:05 ET]
Table 'Admete II' 9-max Seat #4 is the button
Seat 1: Troll8989 ($100 in chips) 
Seat 2: Eskimo Fox ($172.14 in chips) 
Seat 3: chaps1988 ($118.47 in chips) 
Seat 4: 23SmOkEr07 ($100 in chips) 
Seat 6: mbk88 ($247.50 in chips) 
Seat 7: matiko09 ($101 in chips) 
Seat 8: koutani7 ($102.52 in chips) 
aceking00007 will be allowed to play after the button
mbk88: posts small blind $0.50
matiko09: posts big blind $1
CoolFireX: sits out 
*** HOLE CARDS ***
Dealt to matiko09 [Qs 5d]
koutani7: folds 
Troll8989: folds 
Eskimo Fox: folds 
chaps1988: folds 
23SmOkEr07: folds 
mbk88: calls $0.50
matiko09: checks 
*** FLOP *** [2d 7h 3s]
mbk88: bets $2
matiko09: folds 
Uncalled bet ($2) returned to mbk88
mbk88 collected $1.90 from pot
mbk88: doesn't show hand 
*** SUMMARY ***
Total pot $2 | Rake $0.10 
Board [2d 7h 3s]
Seat 1: Troll8989 folded before Flop (didn't bet)
Seat 2: Eskimo Fox folded before Flop (didn't bet)
Seat 3: chaps1988 folded before Flop (didn't bet)
Seat 4: 23SmOkEr07 (button) folded before Flop (didn't bet)
Seat 6: mbk88 (small blind) collected ($1.90)
Seat 7: matiko09 (big blind) folded on the Flop
Seat 8: koutani7 folded before Flop (didn't bet)





PokerStars Hand #155013810421:  Hold'em No Limit ($0.50/$1.00 USD) - 2016/06/21 13:45:06 CET [2016/06/21 7:45:06 ET]
Table 'Megrez II' 9-max Seat #5 is the button
Seat 1: hurtNCYDE ($101.50 in chips) 
Seat 2: Filojoes ($112.95 in chips) 
Seat 4: matiko09 ($100 in chips) 
Seat 5: Avtovo ($127.18 in chips) 
Seat 6: stepan0605 ($105.32 in chips) 
Seat 7: CoolFireX ($139.49 in chips) 
Seat 8: Menno78 ($45.44 in chips) 
Seat 9: MarioDong ($129.81 in chips) 
stepan0605: posts small blind $0.50
CoolFireX: posts big blind $1
*** HOLE CARDS ***
Dealt to matiko09 [7s Qs]
Menno78: calls $1
MarioDong: folds 
hurtNCYDE: folds 
Filojoes: folds 
matiko09: folds 
Avtovo: folds 
stepan0605: raises $4 to $5
CoolFireX: folds 
Menno78: calls $4
*** FLOP *** [Kd Jh 3h]
stepan0605: checks 
Menno78: bets $6
mbk88 leaves the table
stepan0605: folds 
Uncalled bet ($6) returned to Menno78
Menno78 collected $10.45 from pot
Menno78: doesn't show hand 
*** SUMMARY ***
Total pot $11 | Rake $0.55 
Board [Kd Jh 3h]
Seat 1: hurtNCYDE folded before Flop (didn't bet)
Seat 2: Filojoes folded before Flop (didn't bet)
Seat 4: matiko09 folded before Flop (didn't bet)
Seat 5: Avtovo (button) folded before Flop (didn't bet)
Seat 6: stepan0605 (small blind) folded on the Flop
Seat 7: CoolFireX (big blind) folded before Flop
Seat 8: Menno78 collected ($10.45)
Seat 9: MarioDong folded before Flop (didn't bet)





PokerStars Hand #155013815968:  Hold'em No Limit ($0.50/$1.00 USD) - 2016/06/21 13:45:18 CET [2016/06/21 7:45:18 ET]
Table 'Pemba' 9-max Seat #5 is the button
Seat 3: CoolFireX ($371.90 in chips) 
Seat 5: Troll8989 ($110.95 in chips) 
Seat 6: matiko09 ($100 in chips) 
Seat 9: Eskimo Fox ($101.50 in chips) 
matiko09: posts small blind $0.50
DomiVY: is sitting out 
Eskimo Fox: posts big blind $1
Filojoes: sits out 
*** HOLE CARDS ***
Dealt to matiko09 [Kh 6c]
CoolFireX: folds 
DomiVY leaves the table
Troll8989: raises $1.50 to $2.50
chaps1988 joins the table at seat #8 
matiko09: folds 
Eskimo Fox: folds 
Uncalled bet ($1.50) returned to Troll8989
Troll8989 collected $2.50 from pot
Troll8989: doesn't show hand 
*** SUMMARY ***
Total pot $2.50 | Rake $0 
Seat 3: CoolFireX folded before Flop (didn't bet)
Seat 5: Troll8989 (button) collected ($2.50)
Seat 6: matiko09 (small blind) folded before Flop
Seat 9: Eskimo Fox (big blind) folded before Flop





PokerStars Hand #155013816126:  Hold'em No Limit ($0.50/$1.00 USD) - 2016/06/21 13:45:19 CET [2016/06/21 7:45:19 ET]
Table 'Moreau' 9-max Seat #1 is the button
Seat 1: ozone2003 ($145.94 in chips) 
Seat 2: Avtovo ($107.50 in chips) 
Seat 3: matiko09 ($119.70 in chips) 
Seat 4: SharingaaN ($79.46 in chips) 
Seat 6: Troll8989 ($101.50 in chips) 
Seat 7: PanKwn15 ($85.90 in chips) 
Seat 8: mi$$I$Elena ($100 in chips) 
Seat 9: Toonersens ($134.16 in chips) 
Avtovo: posts small blind $0.50
matiko09: posts big blind $1
CoolFireX: sits out 
*** HOLE CARDS ***
Dealt to matiko09 [2d Qc]
SharingaaN: folds 
Troll8989: folds 
PanKwn15: folds 
mi$$I$Elena: raises $1.38 to $2.38
Toonersens: folds 
ozone2003: folds 
Avtovo: folds 
matiko09: folds 
Uncalled bet ($1.38) returned to mi$$I$Elena
mi$$I$Elena collected $2.50 from pot
mi$$I$Elena: doesn't show hand 
*** SUMMARY ***
Total pot $2.50 | Rake $0 
Seat 1: ozone2003 (button) folded before Flop (didn't bet)
Seat 2: Avtovo (small blind) folded before Flop
Seat 3: matiko09 (big blind) folded before Flop
Seat 4: SharingaaN folded before Flop (didn't bet)
Seat 6: Troll8989 folded before Flop (didn't bet)
Seat 7: PanKwn15 folded before Flop (didn't bet)
Seat 8: mi$$I$Elena collected ($2.50)
Seat 9: Toonersens folded before Flop (didn't bet)





PokerStars Hand #155013817004:  Hold'em No Limit ($0.50/$1.00 USD) - 2016/06/21 13:45:21 CET [2016/06/21 7:45:21 ET]
Table 'Carlova II' 9-max Seat #8 is the button
Seat 1: matiko09 ($107.80 in chips) 
Seat 2: mbk88 ($138.15 in chips) 
Seat 3: SharingaaN ($116.28 in chips) 
Seat 4: Dandy Monk ($158.56 in chips) 
Seat 5: ozone2003 ($100 in chips) 
Seat 6: Donetsk1y ($101.50 in chips) 
Seat 7: mi$$I$Elena ($106.95 in chips) 
Seat 8: pyromid ($101.80 in chips) 
Seat 9: Troll8989 ($111.46 in chips) 
Troll8989: posts small blind $0.50
matiko09: posts big blind $1
*** HOLE CARDS ***
Dealt to matiko09 [5d 9d]
mbk88: folds 
SharingaaN: folds 
Dandy Monk: folds 
ozone2003: folds 
Donetsk1y: folds 
mi$$I$Elena: folds 
pyromid: raises $1.50 to $2.50
Troll8989: folds 
matiko09: folds 
Uncalled bet ($1.50) returned to pyromid
pyromid collected $2.50 from pot
pyromid: doesn't show hand 
*** SUMMARY ***
Total pot $2.50 | Rake $0 
Seat 1: matiko09 (big blind) folded before Flop
Seat 2: mbk88 folded before Flop (didn't bet)
Seat 3: SharingaaN folded before Flop (didn't bet)
Seat 4: Dandy Monk folded before Flop (didn't bet)
Seat 5: ozone2003 folded before Flop (didn't bet)
Seat 6: Donetsk1y folded before Flop (didn't bet)
Seat 7: mi$$I$Elena folded before Flop (didn't bet)
Seat 8: pyromid (button) collected ($2.50)
Seat 9: Troll8989 (small blind) folded before Flop





PokerStars Hand #155013822107:  Hold'em No Limit ($0.50/$1.00 USD) - 2016/06/21 13:45:32 CET [2016/06/21 7:45:32 ET]
Table 'Pemba' 9-max Seat #6 is the button
Seat 1: Filojoes ($100 in chips) 
Seat 3: CoolFireX ($371.90 in chips) 
Seat 5: Troll8989 ($112.45 in chips) 
Seat 6: matiko09 ($100 in chips) 
Seat 9: Eskimo Fox ($100.50 in chips) 
chaps1988 will be allowed to play after the button
Eskimo Fox: posts small blind $0.50
Filojoes: posts big blind $1
*** HOLE CARDS ***
Dealt to matiko09 [7s 8h]
CoolFireX: raises $2 to $3
Troll8989: folds 
matiko09: folds 
Eskimo Fox: folds 
Filojoes: folds 
Uncalled bet ($2) returned to CoolFireX
CoolFireX collected $2.50 from pot
CoolFireX: doesn't show hand 
*** SUMMARY ***
Total pot $2.50 | Rake $0 
Seat 1: Filojoes (big blind) folded before Flop
Seat 3: CoolFireX collected ($2.50)
Seat 5: Troll8989 folded before Flop (didn't bet)
Seat 6: matiko09 (button) folded before Flop (didn't bet)
Seat 9: Eskimo Fox (small blind) folded before Flop





PokerStars Hand #155013823370:  Hold'em No Limit ($0.50/$1.00 USD) - 2016/06/21 13:45:35 CET [2016/06/21 7:45:35 ET]
Table 'Admete II' 9-max Seat #6 is the button
Seat 1: Troll8989 ($100 in chips) 
Seat 2: Eskimo Fox ($172.14 in chips) 
Seat 3: chaps1988 ($118.47 in chips) 
Seat 4: 23SmOkEr07 ($100 in chips) 
Seat 6: mbk88 ($248.40 in chips) 
Seat 7: matiko09 ($100 in chips) 
Seat 8: koutani7 ($102.52 in chips) 
matiko09: posts small blind $0.50
koutani7: posts big blind $1
CoolFireX: sits out 
aceking00007: sits out 
*** HOLE CARDS ***
Dealt to matiko09 [3s 6s]
Troll8989: folds 
Eskimo Fox: folds 
chaps1988: folds 
23SmOkEr07: raises $1.50 to $2.50
mbk88: folds 
matiko09: folds 
koutani7: folds 
Uncalled bet ($1.50) returned to 23SmOkEr07
23SmOkEr07 collected $2.50 from pot
23SmOkEr07: doesn't show hand 
*** SUMMARY ***
Total pot $2.50 | Rake $0 
Seat 1: Troll8989 folded before Flop (didn't bet)
Seat 2: Eskimo Fox folded before Flop (didn't bet)
Seat 3: chaps1988 folded before Flop (didn't bet)
Seat 4: 23SmOkEr07 collected ($2.50)
Seat 6: mbk88 (button) folded before Flop (didn't bet)
Seat 7: matiko09 (small blind) folded before Flop
Seat 8: koutani7 (big blind) folded before Flop





PokerStars Hand #155013828204:  Hold'em No Limit ($0.50/$1.00 USD) - 2016/06/21 13:45:46 CET [2016/06/21 7:45:46 ET]
Table 'Umbriel II' 9-max Seat #9 is the button
Seat 1: matiko09 ($148.46 in chips) 
Seat 2: mi$$I$Elena ($100 in chips) 
Seat 3: mxustin ($28.75 in chips) 
Seat 4: Eskimo Fox ($104 in chips) 
Seat 5: mbk88 ($100 in chips) 
Seat 6: maxxmeister ($100 in chips) 
Seat 7: Chen423 ($92.45 in chips) 
Seat 9: CoolFireX ($125.84 in chips) 
matiko09: posts small blind $0.50
mi$$I$Elena: posts big blind $1
*** HOLE CARDS ***
Dealt to matiko09 [3h 2c]
mxustin: folds 
Eskimo Fox: folds 
mbk88: folds 
maxxmeister: raises $2 to $3
Chen423: calls $3
CoolFireX: folds 
matiko09: folds 
mi$$I$Elena: folds 
*** FLOP *** [7c Ac 9c]
AXE705 leaves the table
maxxmeister: checks 
Kukuryzka joins the table at seat #8 
Chen423: checks 
*** TURN *** [7c Ac 9c] [9s]
Kukuryzka leaves the table
maxxmeister: bets $6
Chen423: folds 
Uncalled bet ($6) returned to maxxmeister
maxxmeister collected $7.12 from pot
maxxmeister: doesn't show hand 
*** SUMMARY ***
Total pot $7.50 | Rake $0.38 
Board [7c Ac 9c 9s]
Seat 1: matiko09 (small blind) folded before Flop
Seat 2: mi$$I$Elena (big blind) folded before Flop
Seat 3: mxustin folded before Flop (didn't bet)
Seat 4: Eskimo Fox folded before Flop (didn't bet)
Seat 5: mbk88 folded before Flop (didn't bet)
Seat 6: maxxmeister collected ($7.12)
Seat 7: Chen423 folded on the Turn
Seat 9: CoolFireX (button) folded before Flop (didn't bet)





PokerStars Hand #155013830307:  Hold'em No Limit (€0.25/€0.50 EUR) - 2016/06/21 13:45:51 CET [2016/06/21 7:45:51 ET]
Table 'Actor II' 6-max Seat #5 is the button
Seat 1: hmverlin (€81.83 in chips) 
Seat 2: alôha (€65.33 in chips) 
Seat 3: TopMo3UJlo (€52.59 in chips) 
Seat 4: matiko09 (€81.30 in chips) 
Seat 5: AlexPles (€50 in chips) 
Seat 6: fanmtZ (€21.72 in chips) 
fanmtZ: posts small blind €0.25
hmverlin: posts big blind €0.50
*** HOLE CARDS ***
Dealt to matiko09 [5h 3c]
alôha: raises €0.75 to €1.25
TopMo3UJlo: folds 
matiko09: folds 
AlexPles: folds 
fanmtZ: folds 
hmverlin: folds 
Uncalled bet (€0.75) returned to alôha
alôha collected €1.25 from pot
alôha: doesn't show hand 
*** SUMMARY ***
Total pot €1.25 | Rake €0 
Seat 1: hmverlin (big blind) folded before Flop
Seat 2: alôha collected (€1.25)
Seat 3: TopMo3UJlo folded before Flop (didn't bet)
Seat 4: matiko09 folded before Flop (didn't bet)
Seat 5: AlexPles (button) folded before Flop (didn't bet)
Seat 6: fanmtZ (small blind) folded before Flop





PokerStars Hand #155013830512:  Hold'em No Limit ($0.50/$1.00 USD) - 2016/06/21 13:45:52 CET [2016/06/21 7:45:52 ET]
Table 'Carlova II' 9-max Seat #9 is the button
Seat 1: matiko09 ($106.80 in chips) 
Seat 2: mbk88 ($138.15 in chips) 
Seat 3: SharingaaN ($116.28 in chips) 
Seat 4: Dandy Monk ($158.56 in chips) 
Seat 5: ozone2003 ($100 in chips) 
Seat 6: Donetsk1y ($101.50 in chips) 
Seat 7: mi$$I$Elena ($106.95 in chips) 
Seat 8: pyromid ($103.30 in chips) 
Seat 9: Troll8989 ($110.96 in chips) 
matiko09: posts small blind $0.50
mbk88: posts big blind $1
*** HOLE CARDS ***
Dealt to matiko09 [Ac 7h]
SharingaaN: folds 
Dandy Monk: folds 
ozone2003: folds 
Donetsk1y: raises $2 to $3
mi$$I$Elena: folds 
pyromid: folds 
Troll8989: folds 
matiko09: folds 
mbk88: folds 
Uncalled bet ($2) returned to Donetsk1y
Donetsk1y collected $2.50 from pot
Donetsk1y: doesn't show hand 
*** SUMMARY ***
Total pot $2.50 | Rake $0 
Seat 1: matiko09 (small blind) folded before Flop
Seat 2: mbk88 (big blind) folded before Flop
Seat 3: SharingaaN folded before Flop (didn't bet)
Seat 4: Dandy Monk folded before Flop (didn't bet)
Seat 5: ozone2003 folded before Flop (didn't bet)
Seat 6: Donetsk1y collected ($2.50)
Seat 7: mi$$I$Elena folded before Flop (didn't bet)
Seat 8: pyromid folded before Flop (didn't bet)
Seat 9: Troll8989 (button) folded before Flop (didn't bet)





PokerStars Hand #155013832977:  Hold'em No Limit ($0.50/$1.00 USD) - 2016/06/21 13:45:57 CET [2016/06/21 7:45:57 ET]
Table 'Moreau' 9-max Seat #2 is the button
Seat 1: ozone2003 ($145.94 in chips) 
Seat 2: Avtovo ($107 in chips) 
Seat 3: matiko09 ($118.70 in chips) 
Seat 4: SharingaaN ($79.46 in chips) 
Seat 6: Troll8989 ($101.50 in chips) 
Seat 7: PanKwn15 ($85.90 in chips) 
Seat 8: mi$$I$Elena ($101.50 in chips) 
Seat 9: Toonersens ($134.16 in chips) 
matiko09: posts small blind $0.50
SharingaaN: posts big blind $1
CoolFireX: sits out 
*** HOLE CARDS ***
Dealt to matiko09 [5d 6d]
Troll8989: folds 
PanKwn15 has timed out
PanKwn15: folds 
mi$$I$Elena: folds 
Toonersens: raises $2 to $3
ozone2003: folds 
Avtovo: folds 
matiko09: folds 
SharingaaN: calls $2
*** FLOP *** [9d As 9s]
SharingaaN: checks 
Toonersens: bets $4
SharingaaN: folds 
Uncalled bet ($4) returned to Toonersens
Toonersens collected $6.18 from pot
*** SUMMARY ***
Total pot $6.50 | Rake $0.32 
Board [9d As 9s]
Seat 1: ozone2003 folded before Flop (didn't bet)
Seat 2: Avtovo (button) folded before Flop (didn't bet)
Seat 3: matiko09 (small blind) folded before Flop
Seat 4: SharingaaN (big blind) folded on the Flop
Seat 6: Troll8989 folded before Flop (didn't bet)
Seat 7: PanKwn15 folded before Flop (didn't bet)
Seat 8: mi$$I$Elena folded before Flop (didn't bet)
Seat 9: Toonersens collected ($6.18)





PokerStars Hand #155013836608:  Hold'em No Limit ($0.50/$1.00 USD) - 2016/06/21 13:46:06 CET [2016/06/21 7:46:06 ET]
Table 'Admete II' 9-max Seat #7 is the button
Seat 1: Troll8989 ($100 in chips) 
Seat 2: Eskimo Fox ($172.14 in chips) 
Seat 3: chaps1988 ($118.47 in chips) 
Seat 4: 23SmOkEr07 ($101.50 in chips) 
Seat 6: mbk88 ($248.40 in chips) 
Seat 7: matiko09 ($100 in chips) 
Seat 8: koutani7 ($101.52 in chips) 
Seat 9: CoolFireX ($101.50 in chips) 
koutani7: posts small blind $0.50
CoolFireX: posts big blind $1
aceking00007: sits out 
*** HOLE CARDS ***
Dealt to matiko09 [8c 9d]
Troll8989: folds 
Eskimo Fox: raises $2 to $3
chaps1988: folds 
23SmOkEr07: raises $8.50 to $11.50
mbk88: folds 
matiko09: folds 
koutani7: folds 
CoolFireX: folds 
Eskimo Fox: folds 
Uncalled bet ($8.50) returned to 23SmOkEr07
23SmOkEr07 collected $7.50 from pot
23SmOkEr07: doesn't show hand 
*** SUMMARY ***
Total pot $7.50 | Rake $0 
Seat 1: Troll8989 folded before Flop (didn't bet)
Seat 2: Eskimo Fox folded before Flop
Seat 3: chaps1988 folded before Flop (didn't bet)
Seat 4: 23SmOkEr07 collected ($7.50)
Seat 6: mbk88 folded before Flop (didn't bet)
Seat 7: matiko09 (button) folded before Flop (didn't bet)
Seat 8: koutani7 (small blind) folded before Flop
Seat 9: CoolFireX (big blind) folded before Flop





PokerStars Hand #155013837537:  Hold'em No Limit ($0.50/$1.00 USD) - 2016/06/21 13:46:08 CET [2016/06/21 7:46:08 ET]
Table 'Pemba' 9-max Seat #9 is the button
Seat 1: Filojoes ($100 in chips) 
Seat 3: CoolFireX ($373.40 in chips) 
Seat 5: Troll8989 ($112.45 in chips) 
Seat 6: matiko09 ($100 in chips) 
Seat 9: Eskimo Fox ($100 in chips) 
Filojoes: posts small blind $0.50
CoolFireX: posts big blind $1
chaps1988: sits out 
*** HOLE CARDS ***
Dealt to matiko09 [Js 9c]
Troll8989: folds 
Troll8989 leaves the table
Avtovo joins the table at seat #5 
matiko09: folds 
Avtovo leaves the table
Eskimo Fox: folds 
djammusic joins the table at seat #5 
Filojoes: raises $1.50 to $2.50
CoolFireX: folds 
Uncalled bet ($1.50) returned to Filojoes
Filojoes collected $2 from pot
Filojoes: doesn't show hand 
*** SUMMARY ***
Total pot $2 | Rake $0 
Seat 1: Filojoes (small blind) collected ($2)
Seat 3: CoolFireX (big blind) folded before Flop
Seat 5: Troll8989 folded before Flop (didn't bet)
Seat 6: matiko09 folded before Flop (didn't bet)
Seat 9: Eskimo Fox (button) folded before Flop (didn't bet)





PokerStars Hand #155013839437:  Hold'em No Limit ($0.50/$1.00 USD) - 2016/06/21 13:46:12 CET [2016/06/21 7:46:12 ET]
Table 'Megrez II' 9-max Seat #6 is the button
Seat 1: hurtNCYDE ($101.50 in chips) 
Seat 2: Filojoes ($112.95 in chips) 
Seat 4: matiko09 ($100 in chips) 
Seat 5: Avtovo ($127.18 in chips) 
Seat 6: stepan0605 ($100.32 in chips) 
Seat 7: CoolFireX ($138.49 in chips) 
Seat 8: Menno78 ($50.89 in chips) 
Seat 9: MarioDong ($129.81 in chips) 
CoolFireX: posts small blind $0.50
Menno78: posts big blind $1
*** HOLE CARDS ***
Dealt to matiko09 [9d 6c]
MarioDong: folds 
hurtNCYDE: folds 
Filojoes: folds 
matiko09: folds 
Avtovo: folds 
Troll8989 joins the table at seat #3 
stepan0605: folds 
CoolFireX: folds 
Uncalled bet ($0.50) returned to Menno78
Menno78 collected $1 from pot
Menno78: doesn't show hand 
*** SUMMARY ***
Total pot $1 | Rake $0 
Seat 1: hurtNCYDE folded before Flop (didn't bet)
Seat 2: Filojoes folded before Flop (didn't bet)
Seat 4: matiko09 folded before Flop (didn't bet)
Seat 5: Avtovo folded before Flop (didn't bet)
Seat 6: stepan0605 (button) folded before Flop (didn't bet)
Seat 7: CoolFireX (small blind) folded before Flop
Seat 8: Menno78 (big blind) collected ($1)
Seat 9: MarioDong folded before Flop (didn't bet)





PokerStars Hand #155013843760:  Hold'em No Limit (€0.25/€0.50 EUR) - 2016/06/21 13:46:22 CET [2016/06/21 7:46:22 ET]
Table 'Actor II' 6-max Seat #6 is the button
Seat 1: hmverlin (€81.33 in chips) 
Seat 2: alôha (€66.08 in chips) 
Seat 3: TopMo3UJlo (€52.59 in chips) 
Seat 4: matiko09 (€81.30 in chips) 
Seat 5: AlexPles (€50 in chips) 
Seat 6: fanmtZ (€21.47 in chips) 
hmverlin: posts small blind €0.25
alôha: posts big blind €0.50
*** HOLE CARDS ***
Dealt to matiko09 [3s Ah]
TopMo3UJlo: folds 
matiko09: folds 
AlexPles: folds 
fanmtZ: raises €0.79 to €1.29
hmverlin: folds 
alôha: folds 
Uncalled bet (€0.79) returned to fanmtZ
fanmtZ collected €1.25 from pot
fanmtZ: doesn't show hand 
*** SUMMARY ***
Total pot €1.25 | Rake €0 
Seat 1: hmverlin (small blind) folded before Flop
Seat 2: alôha (big blind) folded before Flop
Seat 3: TopMo3UJlo folded before Flop (didn't bet)
Seat 4: matiko09 folded before Flop (didn't bet)
Seat 5: AlexPles folded before Flop (didn't bet)
Seat 6: fanmtZ (button) collected (€1.25)





PokerStars Hand #155013845939:  Hold'em No Limit ($0.50/$1.00 USD) - 2016/06/21 13:46:27 CET [2016/06/21 7:46:27 ET]
Table 'Carlova II' 9-max Seat #1 is the button
Seat 1: matiko09 ($106.30 in chips) 
Seat 2: mbk88 ($137.15 in chips) 
Seat 3: SharingaaN ($116.28 in chips) 
Seat 4: Dandy Monk ($158.56 in chips) 
Seat 5: ozone2003 ($100 in chips) 
Seat 6: Donetsk1y ($103 in chips) 
Seat 7: mi$$I$Elena ($106.95 in chips) 
Seat 8: pyromid ($103.30 in chips) 
Seat 9: Troll8989 ($110.96 in chips) 
mbk88: posts small blind $0.50
SharingaaN: posts big blind $1
*** HOLE CARDS ***
Dealt to matiko09 [8c Js]
Dandy Monk: raises $2 to $3
ozone2003: folds 
Donetsk1y: folds 
mi$$I$Elena: folds 
pyromid: calls $3
Troll8989: folds 
matiko09: folds 
mbk88: folds 
SharingaaN: folds 
*** FLOP *** [8s Jd Tc]
Dandy Monk: checks 
pyromid: bets $4
Dandy Monk: raises $4 to $8
pyromid: calls $4
*** TURN *** [8s Jd Tc] [Jh]
Dandy Monk: bets $7
pyromid: folds 
Uncalled bet ($7) returned to Dandy Monk
Dandy Monk collected $22.32 from pot
Dandy Monk: doesn't show hand 
*** SUMMARY ***
Total pot $23.50 | Rake $1.18 
Board [8s Jd Tc Jh]
Seat 1: matiko09 (button) folded before Flop (didn't bet)
Seat 2: mbk88 (small blind) folded before Flop
Seat 3: SharingaaN (big blind) folded before Flop
Seat 4: Dandy Monk collected ($22.32)
Seat 5: ozone2003 folded before Flop (didn't bet)
Seat 6: Donetsk1y folded before Flop (didn't bet)
Seat 7: mi$$I$Elena folded before Flop (didn't bet)
Seat 8: pyromid folded on the Turn
Seat 9: Troll8989 folded before Flop (didn't bet)





PokerStars Hand #155013849683:  Hold'em No Limit ($0.50/$1.00 USD) - 2016/06/21 13:46:35 CET [2016/06/21 7:46:35 ET]
Table 'Lamberta II' 9-max Seat #1 is the button
Seat 1: mbk88 ($178.67 in chips) 
Seat 2: mavin80 ($89.47 in chips) 
Seat 3: matiko09 ($107.68 in chips) 
Seat 4: Eskimo Fox ($121.39 in chips) 
Seat 6: Chen423 ($76 in chips) 
Seat 7: 23SmOkEr07 ($193.04 in chips) 
Seat 8: Troll8989 ($101.75 in chips) 
Seat 9: Sjtu_Michael ($105.44 in chips) 
mavin80: posts small blind $0.50
matiko09: posts big blind $1
CoolFireX: sits out 
*** HOLE CARDS ***
Dealt to matiko09 [8h 2s]
Eskimo Fox: raises $2 to $3
Chen423: folds 
23SmOkEr07: folds 
Troll8989: folds 
Sjtu_Michael: calls $3
mbk88: folds 
mavin80: raises $6 to $9
matiko09: folds 
Eskimo Fox: folds 
Sjtu_Michael: calls $6
*** FLOP *** [8s 4s 8c]
mavin80: bets $37.73
Sjtu_Michael: folds 
Uncalled bet ($37.73) returned to mavin80
mavin80 collected $20.90 from pot
mavin80: doesn't show hand 
*** SUMMARY ***
Total pot $22 | Rake $1.10 
Board [8s 4s 8c]
Seat 1: mbk88 (button) folded before Flop (didn't bet)
Seat 2: mavin80 (small blind) collected ($20.90)
Seat 3: matiko09 (big blind) folded before Flop
Seat 4: Eskimo Fox folded before Flop
Seat 6: Chen423 folded before Flop (didn't bet)
Seat 7: 23SmOkEr07 folded before Flop (didn't bet)
Seat 8: Troll8989 folded before Flop (didn't bet)
Seat 9: Sjtu_Michael folded on the Flop





PokerStars Hand #155013854531:  Hold'em No Limit ($0.50/$1.00 USD) - 2016/06/21 13:46:46 CET [2016/06/21 7:46:46 ET]
Table 'Megrez II' 9-max Seat #7 is the button
Seat 1: hurtNCYDE ($101.50 in chips) 
Seat 2: Filojoes ($112.95 in chips) 
Seat 4: matiko09 ($100 in chips) 
Seat 5: Avtovo ($127.18 in chips) 
Seat 6: stepan0605 ($100.32 in chips) 
Seat 7: CoolFireX ($137.99 in chips) 
Seat 8: Menno78 ($51.39 in chips) 
Seat 9: MarioDong ($129.81 in chips) 
Menno78: posts small blind $0.50
MarioDong: posts big blind $1
Troll8989: sits out 
*** HOLE CARDS ***
Dealt to matiko09 [8c Td]
hurtNCYDE: folds 
Filojoes: raises $2 to $3
matiko09: folds 
Avtovo: folds 
stepan0605: folds 
CoolFireX: folds 
Menno78: folds 
MarioDong: calls $2
*** FLOP *** [Tc 5h Jd]
MarioDong: checks 
Filojoes: bets $3.71
MarioDong: folds 
Uncalled bet ($3.71) returned to Filojoes
Filojoes collected $6.18 from pot
Filojoes: doesn't show hand 
*** SUMMARY ***
Total pot $6.50 | Rake $0.32 
Board [Tc 5h Jd]
Seat 1: hurtNCYDE folded before Flop (didn't bet)
Seat 2: Filojoes collected ($6.18)
Seat 4: matiko09 folded before Flop (didn't bet)
Seat 5: Avtovo folded before Flop (didn't bet)
Seat 6: stepan0605 folded before Flop (didn't bet)
Seat 7: CoolFireX (button) folded before Flop (didn't bet)
Seat 8: Menno78 (small blind) folded before Flop
Seat 9: MarioDong (big blind) folded on the Flop





PokerStars Hand #155013855460:  Hold'em No Limit ($0.50/$1.00 USD) - 2016/06/21 13:46:48 CET [2016/06/21 7:46:48 ET]
Table 'Pemba' 9-max Seat #1 is the button
Seat 1: Filojoes ($101 in chips) 
Seat 3: CoolFireX ($372.40 in chips) 
Seat 6: matiko09 ($100 in chips) 
Seat 9: Eskimo Fox ($100 in chips) 
CoolFireX: posts small blind $0.50
matiko09: posts big blind $1
chaps1988: sits out 
*** HOLE CARDS ***
Dealt to matiko09 [9s Ad]
Eskimo Fox: folds 
Filojoes: folds 
CoolFireX: folds 
Uncalled bet ($0.50) returned to matiko09
mbk88 leaves the table
matiko09 collected $1 from pot
matiko09: doesn't show hand 
*** SUMMARY ***
Total pot $1 | Rake $0 
Seat 1: Filojoes (button) folded before Flop (didn't bet)
Seat 3: CoolFireX (small blind) folded before Flop
Seat 6: matiko09 (big blind) collected ($1)
Seat 9: Eskimo Fox folded before Flop (didn't bet)





PokerStars Hand #155013857776:  Hold'em No Limit ($0.50/$1.00 USD) - 2016/06/21 13:46:54 CET [2016/06/21 7:46:54 ET]
Table 'Umbriel II' 9-max Seat #1 is the button
Seat 1: matiko09 ($147.96 in chips) 
Seat 2: mi$$I$Elena ($100 in chips) 
Seat 3: mxustin ($28.75 in chips) 
Seat 4: Eskimo Fox ($104 in chips) 
Seat 5: mbk88 ($100 in chips) 
Seat 6: maxxmeister ($104.12 in chips) 
Seat 7: Chen423 ($89.45 in chips) 
Seat 9: CoolFireX ($125.84 in chips) 
mi$$I$Elena: posts small blind $0.50
mxustin: posts big blind $1
*** HOLE CARDS ***
Dealt to matiko09 [8h 4h]
Eskimo Fox: raises $2 to $3
mbk88: folds 
maxxmeister: folds 
Chen423: folds 
CoolFireX: folds 
matiko09: folds 
mi$$I$Elena: folds 
mxustin: folds 
Uncalled bet ($2) returned to Eskimo Fox
Eskimo Fox collected $2.50 from pot
Eskimo Fox: doesn't show hand 
*** SUMMARY ***
Total pot $2.50 | Rake $0 
Seat 1: matiko09 (button) folded before Flop (didn't bet)
Seat 2: mi$$I$Elena (small blind) folded before Flop
Seat 3: mxustin (big blind) folded before Flop
Seat 4: Eskimo Fox collected ($2.50)
Seat 5: mbk88 folded before Flop (didn't bet)
Seat 6: maxxmeister folded before Flop (didn't bet)
Seat 7: Chen423 folded before Flop (didn't bet)
Seat 9: CoolFireX folded before Flop (didn't bet)





PokerStars Hand #155013857865:  Hold'em No Limit ($0.50/$1.00 USD) - 2016/06/21 13:46:54 CET [2016/06/21 7:46:54 ET]
Table 'Admete II' 9-max Seat #8 is the button
Seat 1: Troll8989 ($100 in chips) 
Seat 2: Eskimo Fox ($169.14 in chips) 
Seat 3: chaps1988 ($118.47 in chips) 
Seat 4: 23SmOkEr07 ($106 in chips) 
Seat 6: mbk88 ($248.40 in chips) 
Seat 7: matiko09 ($100 in chips) 
Seat 8: koutani7 ($101.02 in chips) 
Seat 9: CoolFireX ($100.50 in chips) 
CoolFireX: posts small blind $0.50
Troll8989: posts big blind $1
aceking00007: sits out 
*** HOLE CARDS ***
Dealt to matiko09 [6h Kc]
Eskimo Fox: folds 
chaps1988: folds 
23SmOkEr07: folds 
mbk88: folds 
matiko09: folds 
koutani7: folds 
CoolFireX: folds 
Uncalled bet ($0.50) returned to Troll8989
Troll8989 collected $1 from pot
Troll8989: doesn't show hand 
*** SUMMARY ***
Total pot $1 | Rake $0 
Seat 1: Troll8989 (big blind) collected ($1)
Seat 2: Eskimo Fox folded before Flop (didn't bet)
Seat 3: chaps1988 folded before Flop (didn't bet)
Seat 4: 23SmOkEr07 folded before Flop (didn't bet)
Seat 6: mbk88 folded before Flop (didn't bet)
Seat 7: matiko09 folded before Flop (didn't bet)
Seat 8: koutani7 (button) folded before Flop (didn't bet)
Seat 9: CoolFireX (small blind) folded before Flop





PokerStars Hand #155013860479:  Hold'em No Limit ($0.50/$1.00 USD) - 2016/06/21 13:47:00 CET [2016/06/21 7:47:00 ET]
Table 'Moreau' 9-max Seat #3 is the button
Seat 1: ozone2003 ($145.94 in chips) 
Seat 2: Avtovo ($107 in chips) 
Seat 3: matiko09 ($118.20 in chips) 
Seat 4: SharingaaN ($76.46 in chips) 
Seat 5: CoolFireX ($103 in chips) 
Seat 6: Troll8989 ($101.50 in chips) 
Seat 7: PanKwn15 ($85.90 in chips) 
Seat 8: mi$$I$Elena ($101.50 in chips) 
Seat 9: Toonersens ($137.34 in chips) 
SharingaaN: posts small blind $0.50
CoolFireX: posts big blind $1
*** HOLE CARDS ***
Dealt to matiko09 [5h 9h]
Troll8989: folds 
PanKwn15: folds 
mi$$I$Elena: folds 
Toonersens: folds 
ozone2003: folds 
Avtovo: folds 
matiko09: folds 
SharingaaN: folds 
Uncalled bet ($0.50) returned to CoolFireX
CoolFireX collected $1 from pot
CoolFireX: doesn't show hand 
*** SUMMARY ***
Total pot $1 | Rake $0 
Seat 1: ozone2003 folded before Flop (didn't bet)
Seat 2: Avtovo folded before Flop (didn't bet)
Seat 3: matiko09 (button) folded before Flop (didn't bet)
Seat 4: SharingaaN (small blind) folded before Flop
Seat 5: CoolFireX (big blind) collected ($1)
Seat 6: Troll8989 folded before Flop (didn't bet)
Seat 7: PanKwn15 folded before Flop (didn't bet)
Seat 8: mi$$I$Elena folded before Flop (didn't bet)
Seat 9: Toonersens folded before Flop (didn't bet)





PokerStars Hand #155013860599:  Hold'em No Limit (€0.25/€0.50 EUR) - 2016/06/21 13:47:00 CET [2016/06/21 7:47:00 ET]
Table 'Actor II' 6-max Seat #1 is the button
Seat 1: hmverlin (€81.08 in chips) 
Seat 2: alôha (€65.58 in chips) 
Seat 3: TopMo3UJlo (€52.59 in chips) 
Seat 4: matiko09 (€81.30 in chips) 
Seat 5: AlexPles (€50 in chips) 
Seat 6: fanmtZ (€22.22 in chips) 
alôha: posts small blind €0.25
TopMo3UJlo: posts big blind €0.50
*** HOLE CARDS ***
Dealt to matiko09 [7h 4s]
matiko09: folds 
AlexPles: raises €0.62 to €1.12
fanmtZ: folds 
hmverlin: calls €1.12
alôha: folds 
TopMo3UJlo: calls €0.62
*** FLOP *** [4c Jc 6s]
TopMo3UJlo: checks 
AlexPles: checks 
hmverlin: bets €1.50
TopMo3UJlo: folds 
AlexPles: folds 
Uncalled bet (€1.50) returned to hmverlin
hmverlin collected €3.43 from pot
hmverlin: doesn't show hand 
*** SUMMARY ***
Total pot €3.61 | Rake €0.18 
Board [4c Jc 6s]
Seat 1: hmverlin (button) collected (€3.43)
Seat 2: alôha (small blind) folded before Flop
Seat 3: TopMo3UJlo (big blind) folded on the Flop
Seat 4: matiko09 folded before Flop (didn't bet)
Seat 5: AlexPles folded on the Flop
Seat 6: fanmtZ folded before Flop (didn't bet)





PokerStars Hand #155013867228:  Hold'em No Limit ($0.50/$1.00 USD) - 2016/06/21 13:47:15 CET [2016/06/21 7:47:15 ET]
Table 'Pemba' 9-max Seat #3 is the button
Seat 1: Filojoes ($101 in chips) 
Seat 3: CoolFireX ($371.90 in chips) 
Seat 6: matiko09 ($100.50 in chips) 
Seat 8: chaps1988 ($100 in chips) 
Seat 9: Eskimo Fox ($100 in chips) 
matiko09: posts small blind $0.50
chaps1988: posts big blind $1
*** HOLE CARDS ***
Dealt to matiko09 [Th 8d]
stepan0605 joins the table at seat #2 
stepan0605 leaves the table
hurtNCYDE joins the table at seat #2 
hurtNCYDE leaves the table
Eskimo Fox: raises $2 to $3
Donetsk1y joins the table at seat #2 
Donetsk1y leaves the table
Filojoes: folds 
Dantist1122 joins the table at seat #2 
CoolFireX: calls $3
matiko09: folds 
chaps1988: folds 
*** FLOP *** [8c 2c 3d]
Eskimo Fox: checks 
CoolFireX: checks 
*** TURN *** [8c 2c 3d] [6h]
Eskimo Fox: bets $5
CoolFireX: folds 
Uncalled bet ($5) returned to Eskimo Fox
Eskimo Fox collected $7.12 from pot
Eskimo Fox: doesn't show hand 
*** SUMMARY ***
Total pot $7.50 | Rake $0.38 
Board [8c 2c 3d 6h]
Seat 1: Filojoes folded before Flop (didn't bet)
Seat 3: CoolFireX (button) folded on the Turn
Seat 6: matiko09 (small blind) folded before Flop
Seat 8: chaps1988 (big blind) folded before Flop
Seat 9: Eskimo Fox collected ($7.12)





PokerStars Hand #155013870452:  Hold'em No Limit ($0.50/$1.00 USD) - 2016/06/21 13:47:22 CET [2016/06/21 7:47:22 ET]
Table 'Umbriel II' 9-max Seat #2 is the button
Seat 1: matiko09 ($147.96 in chips) 
Seat 2: mi$$I$Elena ($100 in chips) 
Seat 3: mxustin ($27.75 in chips) 
Seat 4: Eskimo Fox ($105.50 in chips) 
Seat 5: mbk88 ($100 in chips) 
Seat 6: maxxmeister ($104.12 in chips) 
Seat 7: Chen423 ($89.45 in chips) 
Seat 9: CoolFireX ($125.84 in chips) 
mxustin: posts small blind $0.50
Eskimo Fox: posts big blind $1
*** HOLE CARDS ***
Dealt to matiko09 [Ks Qh]
mbk88: folds 
maxxmeister: folds 
Chen423: folds 
CoolFireX: folds 
Troll8989 joins the table at seat #8 
matiko09: raises $1.50 to $2.50
mi$$I$Elena: folds 
mxustin: folds 
Eskimo Fox: folds 
Uncalled bet ($1.50) returned to matiko09
matiko09 collected $2.50 from pot
matiko09: doesn't show hand 
*** SUMMARY ***
Total pot $2.50 | Rake $0 
Seat 1: matiko09 collected ($2.50)
Seat 2: mi$$I$Elena (button) folded before Flop (didn't bet)
Seat 3: mxustin (small blind) folded before Flop
Seat 4: Eskimo Fox (big blind) folded before Flop
Seat 5: mbk88 folded before Flop (didn't bet)
Seat 6: maxxmeister folded before Flop (didn't bet)
Seat 7: Chen423 folded before Flop (didn't bet)
Seat 9: CoolFireX folded before Flop (didn't bet)





PokerStars Hand #155013875254:  Hold'em No Limit ($0.50/$1.00 USD) - 2016/06/21 13:47:33 CET [2016/06/21 7:47:33 ET]
Table 'Admete II' 9-max Seat #9 is the button
Seat 1: Troll8989 ($100.50 in chips) 
Seat 2: Eskimo Fox ($169.14 in chips) 
Seat 3: chaps1988 ($118.47 in chips) 
Seat 4: 23SmOkEr07 ($106 in chips) 
Seat 6: mbk88 ($248.40 in chips) 
Seat 7: matiko09 ($100 in chips) 
Seat 8: koutani7 ($101.02 in chips) 
Seat 9: CoolFireX ($100 in chips) 
Troll8989: posts small blind $0.50
Eskimo Fox: posts big blind $1
aceking00007: sits out 
*** HOLE CARDS ***
Dealt to matiko09 [6c 2h]
chaps1988: folds 
23SmOkEr07: folds 
mbk88: folds 
matiko09: folds 
koutani7: folds 
CoolFireX: folds 
Troll8989: folds 
Uncalled bet ($0.50) returned to Eskimo Fox
Eskimo Fox collected $1 from pot
Eskimo Fox: doesn't show hand 
*** SUMMARY ***
Total pot $1 | Rake $0 
Seat 1: Troll8989 (small blind) folded before Flop
Seat 2: Eskimo Fox (big blind) collected ($1)
Seat 3: chaps1988 folded before Flop (didn't bet)
Seat 4: 23SmOkEr07 folded before Flop (didn't bet)
Seat 6: mbk88 folded before Flop (didn't bet)
Seat 7: matiko09 folded before Flop (didn't bet)
Seat 8: koutani7 folded before Flop (didn't bet)
Seat 9: CoolFireX (button) folded before Flop (didn't bet)





PokerStars Hand #155013881113:  Hold'em No Limit ($0.50/$1.00 USD) - 2016/06/21 13:47:46 CET [2016/06/21 7:47:46 ET]
Table 'Lamberta II' 9-max Seat #2 is the button
Seat 1: mbk88 ($178.67 in chips) 
Seat 2: mavin80 ($101.37 in chips) 
Seat 3: matiko09 ($106.68 in chips) 
Seat 4: Eskimo Fox ($118.39 in chips) 
Seat 6: Chen423 ($76 in chips) 
Seat 7: 23SmOkEr07 ($193.04 in chips) 
Seat 8: Troll8989 ($101.75 in chips) 
Seat 9: Sjtu_Michael ($96.44 in chips) 
matiko09: posts small blind $0.50
Eskimo Fox: posts big blind $1
CoolFireX: sits out 
*** HOLE CARDS ***
Dealt to matiko09 [7h 4d]
Chen423: raises $2 to $3
23SmOkEr07: folds 
Troll8989: folds 
Sjtu_Michael: calls $3
mbk88: folds 
mavin80: folds 
matiko09: folds 
Eskimo Fox: folds 
*** FLOP *** [3s 5h Qh]
Chen423: checks 
Sjtu_Michael: bets $3.56
Chen423: calls $3.56
*** TURN *** [3s 5h Qh] [Qs]
Chen423: checks 
Sjtu_Michael: bets $6.94
Chen423: calls $6.94
*** RIVER *** [3s 5h Qh Qs] [Qd]
Chen423: bets $13.54
Sjtu_Michael: folds 
Uncalled bet ($13.54) returned to Chen423
Chen423 collected $27.08 from pot
Chen423: doesn't show hand 
*** SUMMARY ***
Total pot $28.50 | Rake $1.42 
Board [3s 5h Qh Qs Qd]
Seat 1: mbk88 folded before Flop (didn't bet)
Seat 2: mavin80 (button) folded before Flop (didn't bet)
Seat 3: matiko09 (small blind) folded before Flop
Seat 4: Eskimo Fox (big blind) folded before Flop
Seat 6: Chen423 collected ($27.08)
Seat 7: 23SmOkEr07 folded before Flop (didn't bet)
Seat 8: Troll8989 folded before Flop (didn't bet)
Seat 9: Sjtu_Michael folded on the River





PokerStars Hand #155013881203:  Hold'em No Limit ($0.50/$1.00 USD) - 2016/06/21 13:47:47 CET [2016/06/21 7:47:47 ET]
Table 'Moreau' 9-max Seat #4 is the button
Seat 1: ozone2003 ($145.94 in chips) 
Seat 2: Avtovo ($107 in chips) 
Seat 3: matiko09 ($118.20 in chips) 
Seat 4: SharingaaN ($75.96 in chips) 
Seat 5: CoolFireX ($103.50 in chips) 
Seat 6: Troll8989 ($101.50 in chips) 
Seat 7: PanKwn15 ($85.90 in chips) 
Seat 8: mi$$I$Elena ($101.50 in chips) 
Seat 9: Toonersens ($137.34 in chips) 
CoolFireX: posts small blind $0.50
Troll8989: posts big blind $1
*** HOLE CARDS ***
Dealt to matiko09 [Kh 6c]
PanKwn15: folds 
mi$$I$Elena: raises $1.38 to $2.38
Toonersens: folds 
ozone2003: folds 
Avtovo: folds 
matiko09: folds 
SharingaaN: folds 
CoolFireX: folds 
Troll8989: folds 
Uncalled bet ($1.38) returned to mi$$I$Elena
mi$$I$Elena collected $2.50 from pot
mi$$I$Elena: doesn't show hand 
*** SUMMARY ***
Total pot $2.50 | Rake $0 
Seat 1: ozone2003 folded before Flop (didn't bet)
Seat 2: Avtovo folded before Flop (didn't bet)
Seat 3: matiko09 folded before Flop (didn't bet)
Seat 4: SharingaaN (button) folded before Flop (didn't bet)
Seat 5: CoolFireX (small blind) folded before Flop
Seat 6: Troll8989 (big blind) folded before Flop
Seat 7: PanKwn15 folded before Flop (didn't bet)
Seat 8: mi$$I$Elena collected ($2.50)
Seat 9: Toonersens folded before Flop (didn't bet)





PokerStars Hand #155013884483:  Hold'em No Limit ($0.50/$1.00 USD) - 2016/06/21 13:47:54 CET [2016/06/21 7:47:54 ET]
Table 'Carlova II' 9-max Seat #2 is the button
Seat 1: matiko09 ($106.30 in chips) 
Seat 2: mbk88 ($136.65 in chips) 
Seat 3: SharingaaN ($115.28 in chips) 
Seat 4: Dandy Monk ($169.88 in chips) 
Seat 5: ozone2003 ($100 in chips) 
Seat 6: Donetsk1y ($103 in chips) 
Seat 7: mi$$I$Elena ($106.95 in chips) 
Seat 8: pyromid ($92.30 in chips) 
Seat 9: Troll8989 ($110.96 in chips) 
SharingaaN: posts small blind $0.50
Dandy Monk: posts big blind $1
*** HOLE CARDS ***
Dealt to matiko09 [6d 9h]
ozone2003: raises $2 to $3
Donetsk1y: folds 
mi$$I$Elena: folds 
pyromid: folds 
Troll8989: folds 
matiko09: folds 
mbk88: folds 
SharingaaN: folds 
Dandy Monk: calls $2
*** FLOP *** [8c Qs Ks]
Dandy Monk: bets $6
ozone2003: raises $11.82 to $17.82
Dandy Monk: calls $11.82
*** TURN *** [8c Qs Ks] [2d]
Dandy Monk: checks 
ozone2003: bets $25.22
Dandy Monk: calls $25.22
*** RIVER *** [8c Qs Ks 2d] [Tc]
Dandy Monk: checks 
ozone2003: checks 
*** SHOW DOWN ***
Dandy Monk: shows [Kh Jh] (a pair of Kings)
ozone2003: shows [Kc Ah] (a pair of Kings - Ace kicker)
ozone2003 collected $90.08 from pot
*** SUMMARY ***
Total pot $92.58 | Rake $2.50 
Board [8c Qs Ks 2d Tc]
Seat 1: matiko09 folded before Flop (didn't bet)
Seat 2: mbk88 (button) folded before Flop (didn't bet)
Seat 3: SharingaaN (small blind) folded before Flop
Seat 4: Dandy Monk (big blind) showed [Kh Jh] and lost with a pair of Kings
Seat 5: ozone2003 showed [Kc Ah] and won ($90.08) with a pair of Kings
Seat 6: Donetsk1y folded before Flop (didn't bet)
Seat 7: mi$$I$Elena folded before Flop (didn't bet)
Seat 8: pyromid folded before Flop (didn't bet)
Seat 9: Troll8989 folded before Flop (didn't bet)





PokerStars Hand #155013886305:  Hold'em No Limit ($0.50/$1.00 USD) - 2016/06/21 13:47:58 CET [2016/06/21 7:47:58 ET]
Table 'Admete II' 9-max Seat #1 is the button
Seat 1: Troll8989 ($100 in chips) 
Seat 2: Eskimo Fox ($169.64 in chips) 
Seat 3: chaps1988 ($118.47 in chips) 
Seat 4: 23SmOkEr07 ($106 in chips) 
Seat 6: mbk88 ($248.40 in chips) 
Seat 7: matiko09 ($100 in chips) 
Seat 8: koutani7 ($101.02 in chips) 
Seat 9: CoolFireX ($100 in chips) 
Eskimo Fox: posts small blind $0.50
chaps1988: posts big blind $1
aceking00007: sits out 
*** HOLE CARDS ***
Dealt to matiko09 [8h Tc]
23SmOkEr07: folds 
mbk88: folds 
matiko09: folds 
koutani7: raises $2 to $3
CoolFireX: folds 
Troll8989: calls $3
Eskimo Fox: folds 
chaps1988: raises $9.50 to $12.50
koutani7: calls $9.50
Troll8989: raises $87.50 to $100 and is all-in
chaps1988: raises $18.47 to $118.47 and is all-in
koutani7: folds 
Uncalled bet ($18.47) returned to chaps1988
*** FIRST FLOP *** [8d 9h 7h]
*** FIRST TURN *** [8d 9h 7h] [4s]
*** FIRST RIVER *** [8d 9h 7h 4s] [9d]
*** SECOND FLOP *** [3c Ts 2h]
*** SECOND TURN *** [3c Ts 2h] [Jh]
*** SECOND RIVER *** [3c Ts 2h Jh] [Kh]
*** FIRST SHOW DOWN ***
chaps1988: shows [Jd Jc] (two pair, Jacks and Nines)
Troll8989: shows [As Ks] (a pair of Nines)
chaps1988 collected $105.25 from pot
*** SECOND SHOW DOWN ***
chaps1988: shows [Jd Jc] (three of a kind, Jacks)
Troll8989: shows [As Ks] (a pair of Kings)
chaps1988 collected $105.25 from pot
*** SUMMARY ***
Total pot $213 | Rake $2.50 
Hand was run twice
FIRST Board [8d 9h 7h 4s 9d]
SECOND Board [3c Ts 2h Jh Kh]
Seat 1: Troll8989 (button) showed [As Ks] and lost with a pair of Nines, and lost with a pair of Kings
Seat 2: Eskimo Fox (small blind) folded before Flop
Seat 3: chaps1988 (big blind) showed [Jd Jc] and won ($105.25) with two pair, Jacks and Nines, and won ($105.25) with three of a kind, Jacks
Seat 4: 23SmOkEr07 folded before Flop (didn't bet)
Seat 6: mbk88 folded before Flop (didn't bet)
Seat 7: matiko09 folded before Flop (didn't bet)
Seat 8: koutani7 folded before Flop
Seat 9: CoolFireX folded before Flop (didn't bet)





PokerStars Hand #155013886730:  Hold'em No Limit ($0.50/$1.00 USD) - 2016/06/21 13:47:59 CET [2016/06/21 7:47:59 ET]
Table 'Megrez II' 9-max Seat #8 is the button
Seat 1: hurtNCYDE ($101.50 in chips) 
Seat 2: Filojoes ($116.13 in chips) 
Seat 4: matiko09 ($100 in chips) 
Seat 5: Avtovo ($127.18 in chips) 
Seat 6: stepan0605 ($100.32 in chips) 
Seat 7: CoolFireX ($137.99 in chips) 
Seat 8: Menno78 ($50.89 in chips) 
Seat 9: MarioDong ($126.81 in chips) 
MarioDong: posts small blind $0.50
hurtNCYDE: posts big blind $1
Troll8989: sits out 
*** HOLE CARDS ***
Dealt to matiko09 [6d Th]
Filojoes: folds 
matiko09: folds 
Avtovo: folds 
stepan0605: folds 
CoolFireX: folds 
Menno78: folds 
MarioDong: folds 
Uncalled bet ($0.50) returned to hurtNCYDE
hurtNCYDE collected $1 from pot
*** SUMMARY ***
Total pot $1 | Rake $0 
Seat 1: hurtNCYDE (big blind) collected ($1)
Seat 2: Filojoes folded before Flop (didn't bet)
Seat 4: matiko09 folded before Flop (didn't bet)
Seat 5: Avtovo folded before Flop (didn't bet)
Seat 6: stepan0605 folded before Flop (didn't bet)
Seat 7: CoolFireX folded before Flop (didn't bet)
Seat 8: Menno78 (button) folded before Flop (didn't bet)
Seat 9: MarioDong (small blind) folded before Flop





PokerStars Hand #155013887610:  Hold'em No Limit ($0.50/$1.00 USD) - 2016/06/21 13:48:01 CET [2016/06/21 7:48:01 ET]
Table 'Schurer II' 9-max Seat #1 is the button
Seat 1: 50CandyJoe ($100 in chips) 
Seat 2: havenots88 ($99 in chips) 
Seat 3: matiko09 ($100 in chips) 
Seat 5: riggedsh** ($115.78 in chips) 
Seat 6: Dödi123 ($117.89 in chips) 
Seat 7: Avtovo ($101 in chips) 
Seat 8: ohneSenf66 ($80 in chips) 
Seat 9: ilaviiitech ($100 in chips) 
havenots88: posts small blind $0.50
matiko09: posts big blind $1
djammusic: sits out 
*** HOLE CARDS ***
Dealt to matiko09 [5s Qs]
riggedsh**: folds 
Dödi123: folds 
Avtovo: raises $1.50 to $2.50
ohneSenf66: folds 
ilaviiitech: calls $2.50
50CandyJoe: folds 
havenots88: folds 
matiko09: folds 
*** FLOP *** [7s 5h 9s]
Avtovo: checks 
ilaviiitech: bets $1
Avtovo: calls $1
*** TURN *** [7s 5h 9s] [Ts]
Avtovo: checks 
ilaviiitech: checks 
*** RIVER *** [7s 5h 9s Ts] [Kc]
Avtovo: checks 
ilaviiitech: checks 
*** SHOW DOWN ***
Avtovo: shows [8d 8c] (a pair of Eights)
ilaviiitech: mucks hand 
Avtovo collected $8.08 from pot
*** SUMMARY ***
Total pot $8.50 | Rake $0.42 
Board [7s 5h 9s Ts Kc]
Seat 1: 50CandyJoe (button) folded before Flop (didn't bet)
Seat 2: havenots88 (small blind) folded before Flop
Seat 3: matiko09 (big blind) folded before Flop
Seat 5: riggedsh** folded before Flop (didn't bet)
Seat 6: Dödi123 folded before Flop (didn't bet)
Seat 7: Avtovo showed [8d 8c] and won ($8.08) with a pair of Eights
Seat 8: ohneSenf66 folded before Flop (didn't bet)
Seat 9: ilaviiitech mucked [3d 3s]





PokerStars Hand #155013889974:  Hold'em No Limit (€0.25/€0.50 EUR) - 2016/06/21 13:48:07 CET [2016/06/21 7:48:07 ET]
Table 'Actor II' 6-max Seat #2 is the button
Seat 1: hmverlin (€83.39 in chips) 
Seat 2: alôha (€65.33 in chips) 
Seat 3: TopMo3UJlo (€51.47 in chips) 
Seat 4: matiko09 (€81.30 in chips) 
Seat 5: AlexPles (€50 in chips) 
Seat 6: fanmtZ (€22.22 in chips) 
TopMo3UJlo: posts small blind €0.25
matiko09: posts big blind €0.50
*** HOLE CARDS ***
Dealt to matiko09 [6d 9s]
AlexPles: folds 
fanmtZ: folds 
hmverlin: folds 
alôha: raises €0.50 to €1
TopMo3UJlo: raises €2.50 to €3.50
matiko09: folds 
alôha: raises €5 to €8.50
TopMo3UJlo: calls €5
*** FLOP *** [Th 8c Td]
TopMo3UJlo: checks 
alôha: bets €7
TopMo3UJlo: calls €7
*** TURN *** [Th 8c Td] [2s]
TopMo3UJlo: checks 
alôha: checks 
*** RIVER *** [Th 8c Td 2s] [Jc]
TopMo3UJlo: bets €20.04
alôha: raises €20.04 to €40.08
TopMo3UJlo: calls €15.93 and is all-in
Uncalled bet (€4.11) returned to alôha
*** SHOW DOWN ***
alôha: shows [Tc Ah] (three of a kind, Tens)
TopMo3UJlo: shows [As Ts] (three of a kind, Tens)
TopMo3UJlo collected €50.82 from pot
alôha collected €50.82 from pot
*** SUMMARY ***
Total pot €103.44 | Rake €1.80 
Board [Th 8c Td 2s Jc]
Seat 1: hmverlin folded before Flop (didn't bet)
Seat 2: alôha (button) showed [Tc Ah] and won (€50.82) with three of a kind, Tens
Seat 3: TopMo3UJlo (small blind) showed [As Ts] and won (€50.82) with three of a kind, Tens
Seat 4: matiko09 (big blind) folded before Flop
Seat 5: AlexPles folded before Flop (didn't bet)
Seat 6: fanmtZ folded before Flop (didn't bet)





PokerStars Hand #155013891357:  Hold'em No Limit ($0.50/$1.00 USD) - 2016/06/21 13:48:10 CET [2016/06/21 7:48:10 ET]
Table 'Umbriel II' 9-max Seat #3 is the button
Seat 1: matiko09 ($149.46 in chips) 
Seat 2: mi$$I$Elena ($100 in chips) 
Seat 3: mxustin ($27.25 in chips) 
Seat 4: Eskimo Fox ($104.50 in chips) 
Seat 5: mbk88 ($100 in chips) 
Seat 6: maxxmeister ($104.12 in chips) 
Seat 7: Chen423 ($89.45 in chips) 
Seat 9: CoolFireX ($125.84 in chips) 
Eskimo Fox: posts small blind $0.50
mbk88: posts big blind $1
Troll8989: sits out 
*** HOLE CARDS ***
Dealt to matiko09 [3c 7s]
maxxmeister: folds 
maxxmeister leaves the table
hurtNCYDE joins the table at seat #6 
hurtNCYDE leaves the table
stepan0605 joins the table at seat #6 
Chen423: folds 
CoolFireX: folds 
matiko09: folds 
mi$$I$Elena: folds 
mxustin: folds 
Eskimo Fox: raises $1.50 to $2.50
mbk88: calls $1.50
*** FLOP *** [2d 7h 4h]
Eskimo Fox: bets $3.32
mbk88: folds 
Uncalled bet ($3.32) returned to Eskimo Fox
Eskimo Fox collected $4.75 from pot
Eskimo Fox: doesn't show hand 
*** SUMMARY ***
Total pot $5 | Rake $0.25 
Board [2d 7h 4h]
Seat 1: matiko09 folded before Flop (didn't bet)
Seat 2: mi$$I$Elena folded before Flop (didn't bet)
Seat 3: mxustin (button) folded before Flop (didn't bet)
Seat 4: Eskimo Fox (small blind) collected ($4.75)
Seat 5: mbk88 (big blind) folded on the Flop
Seat 6: maxxmeister folded before Flop (didn't bet)
Seat 7: Chen423 folded before Flop (didn't bet)
Seat 9: CoolFireX folded before Flop (didn't bet)





PokerStars Hand #155013900038:  Hold'em No Limit ($0.50/$1.00 USD) - 2016/06/21 13:48:30 CET [2016/06/21 7:48:30 ET]
Table 'Pemba' 9-max Seat #6 is the button
Seat 1: Filojoes ($101 in chips) 
Seat 3: CoolFireX ($368.90 in chips) 
Seat 6: matiko09 ($100 in chips) 
Seat 8: chaps1988 ($100 in chips) 
Seat 9: Eskimo Fox ($104.12 in chips) 
chaps1988: posts small blind $0.50
Eskimo Fox: posts big blind $1
*** HOLE CARDS ***
Dealt to matiko09 [7c 6s]
Filojoes: folds 
CoolFireX: folds 
matiko09: folds 
chaps1988: folds 
Uncalled bet ($0.50) returned to Eskimo Fox
Eskimo Fox collected $1 from pot
Eskimo Fox: doesn't show hand 
*** SUMMARY ***
Total pot $1 | Rake $0 
Seat 1: Filojoes folded before Flop (didn't bet)
Seat 3: CoolFireX folded before Flop (didn't bet)
Seat 6: matiko09 (button) folded before Flop (didn't bet)
Seat 8: chaps1988 (small blind) folded before Flop
Seat 9: Eskimo Fox (big blind) collected ($1)





PokerStars Hand #155013901513:  Hold'em No Limit ($0.50/$1.00 USD) - 2016/06/21 13:48:33 CET [2016/06/21 7:48:33 ET]
Table 'Megrez II' 9-max Seat #9 is the button
Seat 1: hurtNCYDE ($102 in chips) 
Seat 2: Filojoes ($116.13 in chips) 
Seat 4: matiko09 ($100 in chips) 
Seat 5: Avtovo ($127.18 in chips) 
Seat 6: stepan0605 ($100.32 in chips) 
Seat 7: CoolFireX ($137.99 in chips) 
Seat 8: Menno78 ($50.89 in chips) 
Seat 9: MarioDong ($126.31 in chips) 
hurtNCYDE: posts small blind $0.50
Filojoes: posts big blind $1
Troll8989: sits out 
*** HOLE CARDS ***
Dealt to matiko09 [Th 7d]
matiko09: folds 
Avtovo: raises $1.50 to $2.50
stepan0605: calls $2.50
CoolFireX: folds 
Menno78: calls $2.50
MarioDong: calls $2.50
hurtNCYDE: folds 
Filojoes: folds 
*** FLOP *** [4d 8s Ts]
Avtovo: checks 
stepan0605: checks 
Menno78: bets $10.92
MarioDong: folds 
Avtovo: folds 
stepan0605: folds 
Uncalled bet ($10.92) returned to Menno78
Menno78 collected $10.92 from pot
Menno78: doesn't show hand 
*** SUMMARY ***
Total pot $11.50 | Rake $0.58 
Board [4d 8s Ts]
Seat 1: hurtNCYDE (small blind) folded before Flop
Seat 2: Filojoes (big blind) folded before Flop
Seat 4: matiko09 folded before Flop (didn't bet)
Seat 5: Avtovo folded on the Flop
Seat 6: stepan0605 folded on the Flop
Seat 7: CoolFireX folded before Flop (didn't bet)
Seat 8: Menno78 collected ($10.92)
Seat 9: MarioDong (button) folded on the Flop





PokerStars Hand #155013905578:  Hold'em No Limit ($0.50/$1.00 USD) - 2016/06/21 13:48:42 CET [2016/06/21 7:48:42 ET]
Table 'Moreau' 9-max Seat #5 is the button
Seat 1: ozone2003 ($145.94 in chips) 
Seat 2: Avtovo ($107 in chips) 
Seat 3: matiko09 ($118.20 in chips) 
Seat 4: SharingaaN ($75.96 in chips) 
Seat 5: CoolFireX ($103 in chips) 
Seat 6: Troll8989 ($100.50 in chips) 
Seat 7: PanKwn15 ($85.90 in chips) 
Seat 8: mi$$I$Elena ($103 in chips) 
Seat 9: Toonersens ($137.34 in chips) 
Troll8989: posts small blind $0.50
PanKwn15: posts big blind $1
*** HOLE CARDS ***
Dealt to matiko09 [Kc Ad]
mi$$I$Elena: raises $1.38 to $2.38
Toonersens: folds 
ozone2003: folds 
Avtovo: folds 
matiko09: calls $2.38
SharingaaN: calls $2.38
CoolFireX: raises $9.62 to $12
Troll8989: folds 
PanKwn15: folds 
mi$$I$Elena: folds 
matiko09: calls $9.62
SharingaaN: raises $63.96 to $75.96 and is all-in
CoolFireX: folds 
matiko09: calls $63.96
*** FLOP *** [7s Td 4s]
*** TURN *** [7s Td 4s] [5h]
*** RIVER *** [7s Td 4s 5h] [Js]
*** SHOW DOWN ***
matiko09: shows [Kc Ad] (high card Ace)
SharingaaN: shows [9d 9s] (a pair of Nines)
SharingaaN collected $165.30 from pot
*** SUMMARY ***
Total pot $167.80 | Rake $2.50 
Board [7s Td 4s 5h Js]
Seat 1: ozone2003 folded before Flop (didn't bet)
Seat 2: Avtovo folded before Flop (didn't bet)
Seat 3: matiko09 showed [Kc Ad] and lost with high card Ace
Seat 4: SharingaaN showed [9d 9s] and won ($165.30) with a pair of Nines
Seat 5: CoolFireX (button) folded before Flop
Seat 6: Troll8989 (small blind) folded before Flop
Seat 7: PanKwn15 (big blind) folded before Flop
Seat 8: mi$$I$Elena folded before Flop
Seat 9: Toonersens folded before Flop (didn't bet)





PokerStars Hand #155013907893:  Hold'em No Limit ($0.50/$1.00 USD) - 2016/06/21 13:48:47 CET [2016/06/21 7:48:47 ET]
Table 'Schurer II' 9-max Seat #2 is the button
Seat 1: 50CandyJoe ($100 in chips) 
Seat 2: havenots88 ($98.50 in chips) 
Seat 3: matiko09 ($100 in chips) 
Seat 4: djammusic ($40 in chips) 
Seat 5: riggedsh** ($115.78 in chips) 
Seat 6: Dödi123 ($117.89 in chips) 
Seat 7: Avtovo ($105.58 in chips) 
Seat 8: ohneSenf66 ($80 in chips) 
Seat 9: ilaviiitech ($100 in chips) 
matiko09: posts small blind $0.50
djammusic: posts big blind $1
*** HOLE CARDS ***
Dealt to matiko09 [Qs 4d]
riggedsh**: folds 
Dödi123: folds 
Avtovo: raises $1.50 to $2.50
ohneSenf66: folds 
ilaviiitech: folds 
50CandyJoe: folds 
havenots88: folds 
matiko09: folds 
djammusic: folds 
Uncalled bet ($1.50) returned to Avtovo
Avtovo collected $2.50 from pot
Avtovo: doesn't show hand 
*** SUMMARY ***
Total pot $2.50 | Rake $0 
Seat 1: 50CandyJoe folded before Flop (didn't bet)
Seat 2: havenots88 (button) folded before Flop (didn't bet)
Seat 3: matiko09 (small blind) folded before Flop
Seat 4: djammusic (big blind) folded before Flop
Seat 5: riggedsh** folded before Flop (didn't bet)
Seat 6: Dödi123 folded before Flop (didn't bet)
Seat 7: Avtovo collected ($2.50)
Seat 8: ohneSenf66 folded before Flop (didn't bet)
Seat 9: ilaviiitech folded before Flop (didn't bet)





PokerStars Hand #155013910421:  Hold'em No Limit ($0.50/$1.00 USD) - 2016/06/21 13:48:53 CET [2016/06/21 7:48:53 ET]
Table 'Lamberta II' 9-max Seat #3 is the button
Seat 1: mbk88 ($178.67 in chips) 
Seat 2: mavin80 ($101.37 in chips) 
Seat 3: matiko09 ($106.18 in chips) 
Seat 4: Eskimo Fox ($117.39 in chips) 
Seat 5: CoolFireX ($100 in chips) 
Seat 6: Chen423 ($89.58 in chips) 
Seat 7: 23SmOkEr07 ($193.04 in chips) 
Seat 8: Troll8989 ($101.75 in chips) 
Seat 9: Sjtu_Michael ($86.50 in chips) 
Eskimo Fox: posts small blind $0.50
CoolFireX: posts big blind $1
*** HOLE CARDS ***
Dealt to matiko09 [Tc Js]
Chen423: raises $2 to $3
23SmOkEr07: folds 
Troll8989: folds 
Sjtu_Michael: raises $6 to $9
mbk88: folds 
mavin80: raises $12 to $21
matiko09: folds 
Eskimo Fox: folds 
CoolFireX: folds 
Chen423: folds 
Sjtu_Michael: folds 
Uncalled bet ($12) returned to mavin80
mavin80 collected $22.50 from pot
mavin80: doesn't show hand 
*** SUMMARY ***
Total pot $22.50 | Rake $0 
Seat 1: mbk88 folded before Flop (didn't bet)
Seat 2: mavin80 collected ($22.50)
Seat 3: matiko09 (button) folded before Flop (didn't bet)
Seat 4: Eskimo Fox (small blind) folded before Flop
Seat 5: CoolFireX (big blind) folded before Flop
Seat 6: Chen423 folded before Flop
Seat 7: 23SmOkEr07 folded before Flop (didn't bet)
Seat 8: Troll8989 folded before Flop (didn't bet)
Seat 9: Sjtu_Michael folded before Flop





PokerStars Hand #155013915548:  Hold'em No Limit ($0.50/$1.00 USD) - 2016/06/21 13:49:05 CET [2016/06/21 7:49:05 ET]
Table 'Schurer II' 9-max Seat #3 is the button
Seat 1: 50CandyJoe ($100 in chips) 
Seat 2: havenots88 ($98.50 in chips) 
Seat 3: matiko09 ($100 in chips) 
Seat 4: djammusic ($39 in chips) 
Seat 5: riggedsh** ($115.78 in chips) 
Seat 6: Dödi123 ($117.89 in chips) 
Seat 7: Avtovo ($107.08 in chips) 
Seat 8: ohneSenf66 ($80 in chips) 
Seat 9: ilaviiitech ($100 in chips) 
djammusic: posts small blind $0.50
riggedsh**: posts big blind $1
*** HOLE CARDS ***
Dealt to matiko09 [7d 4c]
Dödi123: folds 
Avtovo: folds 
ohneSenf66: folds 
ilaviiitech: folds 
50CandyJoe: folds 
havenots88: raises $2 to $3
matiko09: folds 
djammusic: folds 
riggedsh**: folds 
Uncalled bet ($2) returned to havenots88
havenots88 collected $2.50 from pot
havenots88: doesn't show hand 
*** SUMMARY ***
Total pot $2.50 | Rake $0 
Seat 1: 50CandyJoe folded before Flop (didn't bet)
Seat 2: havenots88 collected ($2.50)
Seat 3: matiko09 (button) folded before Flop (didn't bet)
Seat 4: djammusic (small blind) folded before Flop
Seat 5: riggedsh** (big blind) folded before Flop
Seat 6: Dödi123 folded before Flop (didn't bet)
Seat 7: Avtovo folded before Flop (didn't bet)
Seat 8: ohneSenf66 folded before Flop (didn't bet)
Seat 9: ilaviiitech folded before Flop (didn't bet)





PokerStars Hand #155013917043:  Hold'em No Limit ($0.50/$1.00 USD) - 2016/06/21 13:49:08 CET [2016/06/21 7:49:08 ET]
Table 'Pemba' 9-max Seat #8 is the button
Seat 3: CoolFireX ($368.90 in chips) 
Seat 6: matiko09 ($100 in chips) 
Seat 8: chaps1988 ($100 in chips) 
Seat 9: Eskimo Fox ($104.62 in chips) 
Eskimo Fox: posts small blind $0.50
Filojoes: is sitting out 
CoolFireX: posts big blind $1
*** HOLE CARDS ***
Dealt to matiko09 [Qc Kh]
Filojoes leaves the table
matiko09: raises $1.50 to $2.50
chaps1988: folds 
Eskimo Fox: raises $6 to $8.50
CoolFireX: folds 
matiko09: calls $6
*** FLOP *** [5d 3c As]
Eskimo Fox: checks 
matiko09: checks 
*** TURN *** [5d 3c As] [8h]
Eskimo Fox: checks 
matiko09: checks 
*** RIVER *** [5d 3c As 8h] [6d]
pardama joins the table at seat #1 
Eskimo Fox: checks 
matiko09: checks 
*** SHOW DOWN ***
Eskimo Fox: shows [Jh Th] (high card Ace)
matiko09: shows [Qc Kh] (high card Ace - King kicker)
matiko09 collected $17.10 from pot
*** SUMMARY ***
Total pot $18 | Rake $0.90 
Board [5d 3c As 8h 6d]
Seat 3: CoolFireX (big blind) folded before Flop
Seat 6: matiko09 showed [Qc Kh] and won ($17.10) with high card Ace
Seat 8: chaps1988 (button) folded before Flop (didn't bet)
Seat 9: Eskimo Fox (small blind) showed [Jh Th] and lost with high card Ace





PokerStars Hand #155013921979:  Hold'em No Limit (€0.50/€1.00 EUR) - 2016/06/21 13:49:19 CET [2016/06/21 7:49:19 ET]
Table 'Tauris III' 6-max Seat #4 is the button
Seat 1: morc1us (€100 in chips) 
Seat 2: devil1964 (€95.23 in chips) 
Seat 4: Gigi201133 (€104.41 in chips) 
Seat 5: parraka_210 (€100.50 in chips) 
Seat 6: matiko09 (€100 in chips) 
parraka_210: posts small blind €0.50
matiko09: posts big blind €1
devil1964: posts big blind €1
BronKKAA: sits out 
*** HOLE CARDS ***
Dealt to matiko09 [3h 8s]
morc1us: raises €4 to €5
devil1964: calls €4
Gigi201133 has timed out
Gigi201133: folds 
parraka_210: folds 
matiko09: folds 
*** FLOP *** [8h 6s Kc]
morc1us: bets €4.50
devil1964: calls €4.50
*** TURN *** [8h 6s Kc] [4h]
morc1us: checks 
devil1964: bets €9.74
morc1us: calls €9.74
*** RIVER *** [8h 6s Kc 4h] [7h]
morc1us: checks 
devil1964: bets €37.98
morc1us: folds 
Uncalled bet (€37.98) returned to devil1964
devil1964 collected €37.98 from pot
devil1964: doesn't show hand 
*** SUMMARY ***
Total pot €39.98 | Rake €2 
Board [8h 6s Kc 4h 7h]
Seat 1: morc1us folded on the River
Seat 2: devil1964 collected (€37.98)
Seat 4: Gigi201133 (button) folded before Flop (didn't bet)
Seat 5: parraka_210 (small blind) folded before Flop
Seat 6: matiko09 (big blind) folded before Flop





PokerStars Hand #155013922820:  Hold'em No Limit ($0.50/$1.00 USD) - 2016/06/21 13:49:21 CET [2016/06/21 7:49:21 ET]
Table 'Carlova II' 9-max Seat #3 is the button
Seat 1: matiko09 ($106.30 in chips) 
Seat 2: mbk88 ($136.65 in chips) 
Seat 3: SharingaaN ($114.78 in chips) 
Seat 4: Dandy Monk ($123.84 in chips) 
Seat 5: ozone2003 ($144.04 in chips) 
Seat 6: Donetsk1y ($103 in chips) 
Seat 7: mi$$I$Elena ($106.95 in chips) 
Seat 8: pyromid ($92.30 in chips) 
Seat 9: Troll8989 ($110.96 in chips) 
Dandy Monk: posts small blind $0.50
ozone2003: posts big blind $1
*** HOLE CARDS ***
Dealt to matiko09 [Qh Kh]
Donetsk1y: folds 
mi$$I$Elena: folds 
pyromid: raises $1.50 to $2.50
Troll8989: folds 
matiko09: calls $2.50
mbk88: folds 
SharingaaN: calls $2.50
Dandy Monk: folds 
ozone2003: calls $1.50
*** FLOP *** [Qd 2s 4s]
ozone2003: checks 
pyromid: checks 
matiko09: bets $6
SharingaaN: folds 
ozone2003: raises $14.90 to $20.90
pyromid: folds 
matiko09: calls $14.90
*** TURN *** [Qd 2s 4s] [5c]
ozone2003: bets $37.37
matiko09: folds 
Uncalled bet ($37.37) returned to ozone2003
ozone2003 collected $49.80 from pot
ozone2003: doesn't show hand 
*** SUMMARY ***
Total pot $52.30 | Rake $2.50 
Board [Qd 2s 4s 5c]
Seat 1: matiko09 folded on the Turn
Seat 2: mbk88 folded before Flop (didn't bet)
Seat 3: SharingaaN (button) folded on the Flop
Seat 4: Dandy Monk (small blind) folded before Flop
Seat 5: ozone2003 (big blind) collected ($49.80)
Seat 6: Donetsk1y folded before Flop (didn't bet)
Seat 7: mi$$I$Elena folded before Flop (didn't bet)
Seat 8: pyromid folded on the Flop
Seat 9: Troll8989 folded before Flop (didn't bet)





PokerStars Hand #155013923955:  Hold'em No Limit ($0.50/$1.00 USD) - 2016/06/21 13:49:24 CET [2016/06/21 7:49:24 ET]
Table 'Schurer II' 9-max Seat #4 is the button
Seat 1: 50CandyJoe ($100 in chips) 
Seat 2: havenots88 ($100 in chips) 
Seat 3: matiko09 ($100 in chips) 
Seat 4: djammusic ($38.50 in chips) 
Seat 5: riggedsh** ($114.78 in chips) 
Seat 6: Dödi123 ($117.89 in chips) 
Seat 7: Avtovo ($107.08 in chips) 
Seat 8: ohneSenf66 ($80 in chips) 
Seat 9: ilaviiitech ($100 in chips) 
riggedsh**: posts small blind $0.50
Dödi123: posts big blind $1
*** HOLE CARDS ***
Dealt to matiko09 [7d Ts]
Avtovo: folds 
ohneSenf66: folds 
ilaviiitech: folds 
50CandyJoe: folds 
havenots88: folds 
matiko09: folds 
djammusic: folds 
riggedsh**: folds 
Uncalled bet ($0.50) returned to Dödi123
Dödi123 collected $1 from pot
Dödi123: doesn't show hand 
*** SUMMARY ***
Total pot $1 | Rake $0 
Seat 1: 50CandyJoe folded before Flop (didn't bet)
Seat 2: havenots88 folded before Flop (didn't bet)
Seat 3: matiko09 folded before Flop (didn't bet)
Seat 4: djammusic (button) folded before Flop (didn't bet)
Seat 5: riggedsh** (small blind) folded before Flop
Seat 6: Dödi123 (big blind) collected ($1)
Seat 7: Avtovo folded before Flop (didn't bet)
Seat 8: ohneSenf66 folded before Flop (didn't bet)
Seat 9: ilaviiitech folded before Flop (didn't bet)





PokerStars Hand #155013924364:  Hold'em No Limit ($0.50/$1.00 USD) - 2016/06/21 13:49:25 CET [2016/06/21 7:49:25 ET]
Table 'Admete II' 9-max Seat #2 is the button
Seat 1: Troll8989 ($100 in chips) 
Seat 2: Eskimo Fox ($169.14 in chips) 
Seat 3: chaps1988 ($228.97 in chips) 
Seat 4: 23SmOkEr07 ($106 in chips) 
Seat 6: mbk88 ($248.40 in chips) 
Seat 7: matiko09 ($100 in chips) 
Seat 8: koutani7 ($88.52 in chips) 
Seat 9: CoolFireX ($100 in chips) 
chaps1988: posts small blind $0.50
23SmOkEr07: posts big blind $1
aceking00007: sits out 
*** HOLE CARDS ***
Dealt to matiko09 [Js 4s]
mbk88: folds 
matiko09: folds 
koutani7: folds 
CoolFireX: raises $2 to $3
Troll8989: folds 
Eskimo Fox: calls $3
chaps1988: calls $2.50
23SmOkEr07: calls $2
*** FLOP *** [5d Ah Jc]
chaps1988: checks 
23SmOkEr07: checks 
CoolFireX: bets $6.50
Eskimo Fox: calls $6.50
chaps1988: folds 
23SmOkEr07: folds 
*** TURN *** [5d Ah Jc] [2c]
CoolFireX: bets $15.83
Eskimo Fox: folds 
Uncalled bet ($15.83) returned to CoolFireX
CoolFireX collected $23.75 from pot
CoolFireX: doesn't show hand 
*** SUMMARY ***
Total pot $25 | Rake $1.25 
Board [5d Ah Jc 2c]
Seat 1: Troll8989 folded before Flop (didn't bet)
Seat 2: Eskimo Fox (button) folded on the Turn
Seat 3: chaps1988 (small blind) folded on the Flop
Seat 4: 23SmOkEr07 (big blind) folded on the Flop
Seat 6: mbk88 folded before Flop (didn't bet)
Seat 7: matiko09 folded before Flop (didn't bet)
Seat 8: koutani7 folded before Flop (didn't bet)
Seat 9: CoolFireX collected ($23.75)





PokerStars Hand #155013925052:  Hold'em No Limit ($0.50/$1.00 USD) - 2016/06/21 13:49:27 CET [2016/06/21 7:49:27 ET]
Table 'Umbriel II' 9-max Seat #4 is the button
Seat 1: matiko09 ($149.46 in chips) 
Seat 2: mi$$I$Elena ($100 in chips) 
Seat 3: mxustin ($27.25 in chips) 
Seat 4: Eskimo Fox ($106.75 in chips) 
Seat 5: mbk88 ($100 in chips) 
Seat 6: stepan0605 ($100 in chips) 
Seat 7: Chen423 ($89.45 in chips) 
Seat 9: CoolFireX ($125.84 in chips) 
mbk88: posts small blind $0.50
stepan0605: posts big blind $1
Troll8989: sits out 
*** HOLE CARDS ***
Dealt to matiko09 [Qd 4s]
Chen423: folds 
CoolFireX: folds 
matiko09: folds 
mi$$I$Elena: folds 
mxustin: folds 
Eskimo Fox: folds 
mbk88: calls $0.50
stepan0605: checks 
*** FLOP *** [Qh Kc 4d]
mbk88: bets $2
stepan0605: folds 
Uncalled bet ($2) returned to mbk88
mbk88 collected $1.90 from pot
mbk88: doesn't show hand 
*** SUMMARY ***
Total pot $2 | Rake $0.10 
Board [Qh Kc 4d]
Seat 1: matiko09 folded before Flop (didn't bet)
Seat 2: mi$$I$Elena folded before Flop (didn't bet)
Seat 3: mxustin folded before Flop (didn't bet)
Seat 4: Eskimo Fox (button) folded before Flop (didn't bet)
Seat 5: mbk88 (small blind) collected ($1.90)
Seat 6: stepan0605 (big blind) folded on the Flop
Seat 7: Chen423 folded before Flop (didn't bet)
Seat 9: CoolFireX folded before Flop (didn't bet)





PokerStars Hand #155013932978:  Hold'em No Limit ($0.50/$1.00 USD) - 2016/06/21 13:49:45 CET [2016/06/21 7:49:45 ET]
Table 'Moreau' 9-max Seat #6 is the button
Seat 1: ozone2003 ($145.94 in chips) 
Seat 2: Avtovo ($107 in chips) 
Seat 3: matiko09 ($100 in chips) 
Seat 4: SharingaaN ($165.30 in chips) 
Seat 5: CoolFireX ($100 in chips) 
Seat 6: Troll8989 ($100 in chips) 
Seat 7: PanKwn15 ($84.90 in chips) 
Seat 8: mi$$I$Elena ($100.62 in chips) 
Seat 9: Toonersens ($137.34 in chips) 
PanKwn15: posts small blind $0.50
mi$$I$Elena: posts big blind $1
*** HOLE CARDS ***
Dealt to matiko09 [Jc 3d]
Toonersens: folds 
ozone2003: folds 
Avtovo: folds 
matiko09: folds 
SharingaaN: folds 
CoolFireX: raises $1.50 to $2.50
Troll8989: folds 
PanKwn15: calls $2
mi$$I$Elena: folds 
*** FLOP *** [2d 5d 4d]
PanKwn15: checks 
CoolFireX: checks 
*** TURN *** [2d 5d 4d] [4s]
PanKwn15: checks 
CoolFireX: checks 
*** RIVER *** [2d 5d 4d 4s] [6c]
PanKwn15: bets $5.70
CoolFireX: folds 
Uncalled bet ($5.70) returned to PanKwn15
PanKwn15 collected $5.70 from pot
PanKwn15: doesn't show hand 
*** SUMMARY ***
Total pot $6 | Rake $0.30 
Board [2d 5d 4d 4s 6c]
Seat 1: ozone2003 folded before Flop (didn't bet)
Seat 2: Avtovo folded before Flop (didn't bet)
Seat 3: matiko09 folded before Flop (didn't bet)
Seat 4: SharingaaN folded before Flop (didn't bet)
Seat 5: CoolFireX folded on the River
Seat 6: Troll8989 (button) folded before Flop (didn't bet)
Seat 7: PanKwn15 (small blind) collected ($5.70)
Seat 8: mi$$I$Elena (big blind) folded before Flop
Seat 9: Toonersens folded before Flop (didn't bet)





PokerStars Hand #155013938670:  Hold'em No Limit ($0.50/$1.00 USD) - 2016/06/21 13:49:57 CET [2016/06/21 7:49:57 ET]
Table 'Schurer II' 9-max Seat #5 is the button
Seat 1: 50CandyJoe ($100 in chips) 
Seat 2: havenots88 ($100 in chips) 
Seat 3: matiko09 ($100 in chips) 
Seat 4: djammusic ($38.50 in chips) 
Seat 5: riggedsh** ($114.28 in chips) 
Seat 6: Dödi123 ($118.39 in chips) 
Seat 7: Avtovo ($107.08 in chips) 
Seat 8: ohneSenf66 ($80 in chips) 
Seat 9: ilaviiitech ($100 in chips) 
Dödi123: posts small blind $0.50
Avtovo: posts big blind $1
*** HOLE CARDS ***
Dealt to matiko09 [Jc 6d]
ohneSenf66: folds 
ilaviiitech: folds 
50CandyJoe: raises $2 to $3
havenots88: folds 
matiko09: folds 
djammusic: folds 
riggedsh**: folds 
Dödi123: folds 
Avtovo: folds 
Uncalled bet ($2) returned to 50CandyJoe
50CandyJoe collected $2.50 from pot
50CandyJoe: doesn't show hand 
*** SUMMARY ***
Total pot $2.50 | Rake $0 
Seat 1: 50CandyJoe collected ($2.50)
Seat 2: havenots88 folded before Flop (didn't bet)
Seat 3: matiko09 folded before Flop (didn't bet)
Seat 4: djammusic folded before Flop (didn't bet)
Seat 5: riggedsh** (button) folded before Flop (didn't bet)
Seat 6: Dödi123 (small blind) folded before Flop
Seat 7: Avtovo (big blind) folded before Flop
Seat 8: ohneSenf66 folded before Flop (didn't bet)
Seat 9: ilaviiitech folded before Flop (didn't bet)





PokerStars Hand #155013940595:  Hold'em No Limit ($0.50/$1.00 USD) - 2016/06/21 13:50:02 CET [2016/06/21 7:50:02 ET]
Table 'Umbriel II' 9-max Seat #5 is the button
Seat 1: matiko09 ($149.46 in chips) 
Seat 2: mi$$I$Elena ($100 in chips) 
Seat 3: mxustin ($27.25 in chips) 
Seat 4: Eskimo Fox ($106.75 in chips) 
Seat 5: mbk88 ($100.90 in chips) 
Seat 6: stepan0605 ($100 in chips) 
Seat 7: Chen423 ($89.45 in chips) 
Seat 9: CoolFireX ($125.84 in chips) 
stepan0605: posts small blind $0.50
Chen423: posts big blind $1
Troll8989: sits out 
*** HOLE CARDS ***
Dealt to matiko09 [7s 2h]
CoolFireX: raises $2 to $3
matiko09: folds 
mi$$I$Elena: folds 
mxustin: folds 
Eskimo Fox: folds 
mbk88: folds 
stepan0605: folds 
Chen423: folds 
Uncalled bet ($2) returned to CoolFireX
CoolFireX collected $2.50 from pot
CoolFireX: doesn't show hand 
*** SUMMARY ***
Total pot $2.50 | Rake $0 
Seat 1: matiko09 folded before Flop (didn't bet)
Seat 2: mi$$I$Elena folded before Flop (didn't bet)
Seat 3: mxustin folded before Flop (didn't bet)
Seat 4: Eskimo Fox folded before Flop (didn't bet)
Seat 5: mbk88 (button) folded before Flop (didn't bet)
Seat 6: stepan0605 (small blind) folded before Flop
Seat 7: Chen423 (big blind) folded before Flop
Seat 9: CoolFireX collected ($2.50)





PokerStars Hand #155013942173:  Hold'em No Limit ($0.50/$1.00 USD) - 2016/06/21 13:50:05 CET [2016/06/21 7:50:05 ET]
Table 'Lamberta II' 9-max Seat #4 is the button
Seat 1: mbk88 ($178.67 in chips) 
Seat 2: mavin80 ($114.87 in chips) 
Seat 3: matiko09 ($106.18 in chips) 
Seat 4: Eskimo Fox ($116.89 in chips) 
Seat 5: CoolFireX ($100 in chips) 
Seat 6: Chen423 ($86.58 in chips) 
Seat 7: 23SmOkEr07 ($193.04 in chips) 
Seat 8: Troll8989 ($101.75 in chips) 
Seat 9: Sjtu_Michael ($91 in chips) 
CoolFireX: posts small blind $0.50
Chen423: posts big blind $1
*** HOLE CARDS ***
Dealt to matiko09 [2c 4h]
23SmOkEr07: folds 
Troll8989: folds 
Sjtu_Michael: folds 
mbk88: folds 
mavin80: folds 
matiko09: folds 
Eskimo Fox: raises $1 to $2
CoolFireX: folds 
Chen423: folds 
Uncalled bet ($1) returned to Eskimo Fox
Eskimo Fox collected $2.50 from pot
Eskimo Fox: doesn't show hand 
*** SUMMARY ***
Total pot $2.50 | Rake $0 
Seat 1: mbk88 folded before Flop (didn't bet)
Seat 2: mavin80 folded before Flop (didn't bet)
Seat 3: matiko09 folded before Flop (didn't bet)
Seat 4: Eskimo Fox (button) collected ($2.50)
Seat 5: CoolFireX (small blind) folded before Flop
Seat 6: Chen423 (big blind) folded before Flop
Seat 7: 23SmOkEr07 folded before Flop (didn't bet)
Seat 8: Troll8989 folded before Flop (didn't bet)
Seat 9: Sjtu_Michael folded before Flop (didn't bet)





PokerStars Hand #155013945965:  Hold'em No Limit ($0.50/$1.00 USD) - 2016/06/21 13:50:14 CET [2016/06/21 7:50:14 ET]
Table 'Schurer II' 9-max Seat #6 is the button
Seat 1: 50CandyJoe ($101.50 in chips) 
Seat 2: havenots88 ($100 in chips) 
Seat 3: matiko09 ($100 in chips) 
Seat 4: djammusic ($38.50 in chips) 
Seat 5: riggedsh** ($114.28 in chips) 
Seat 6: Dödi123 ($117.89 in chips) 
Seat 7: Avtovo ($106.08 in chips) 
Seat 8: ohneSenf66 ($80 in chips) 
Seat 9: ilaviiitech ($100 in chips) 
Avtovo: posts small blind $0.50
ohneSenf66: posts big blind $1
*** HOLE CARDS ***
Dealt to matiko09 [Kh Qc]
ilaviiitech: folds 
50CandyJoe: folds 
havenots88: folds 
matiko09: raises $2 to $3
djammusic: folds 
riggedsh**: folds 
Dödi123: folds 
Avtovo: raises $7.50 to $10.50
ohneSenf66: folds 
matiko09: folds 
Uncalled bet ($7.50) returned to Avtovo
Avtovo collected $7 from pot
Avtovo: doesn't show hand 
*** SUMMARY ***
Total pot $7 | Rake $0 
Seat 1: 50CandyJoe folded before Flop (didn't bet)
Seat 2: havenots88 folded before Flop (didn't bet)
Seat 3: matiko09 folded before Flop
Seat 4: djammusic folded before Flop (didn't bet)
Seat 5: riggedsh** folded before Flop (didn't bet)
Seat 6: Dödi123 (button) folded before Flop (didn't bet)
Seat 7: Avtovo (small blind) collected ($7)
Seat 8: ohneSenf66 (big blind) folded before Flop
Seat 9: ilaviiitech folded before Flop (didn't bet)





PokerStars Hand #155013947325:  Hold'em No Limit ($0.50/$1.00 USD) - 2016/06/21 13:50:17 CET [2016/06/21 7:50:17 ET]
Table 'Pemba' 9-max Seat #9 is the button
Seat 3: CoolFireX ($367.90 in chips) 
Seat 6: matiko09 ($108.60 in chips) 
Seat 8: chaps1988 ($100 in chips) 
Seat 9: Eskimo Fox ($100 in chips) 
pardama will be allowed to play after the button
CoolFireX: posts small blind $0.50
matiko09: posts big blind $1
*** HOLE CARDS ***
Dealt to matiko09 [3c Qd]
chaps1988: folds 
Eskimo Fox: folds 
CoolFireX: folds 
Uncalled bet ($0.50) returned to matiko09
matiko09 collected $1 from pot
matiko09: doesn't show hand 
*** SUMMARY ***
Total pot $1 | Rake $0 
Seat 3: CoolFireX (small blind) folded before Flop
Seat 6: matiko09 (big blind) collected ($1)
Seat 8: chaps1988 folded before Flop (didn't bet)
Seat 9: Eskimo Fox (button) folded before Flop (didn't bet)





PokerStars Hand #155013950095:  Hold'em No Limit ($0.50/$1.00 USD) - 2016/06/21 13:50:23 CET [2016/06/21 7:50:23 ET]
Table 'Megrez II' 9-max Seat #1 is the button
Seat 1: hurtNCYDE ($101.50 in chips) 
Seat 2: Filojoes ($115.13 in chips) 
Seat 3: Troll8989 ($100 in chips) 
Seat 4: matiko09 ($100 in chips) 
Seat 5: Avtovo ($124.68 in chips) 
Seat 6: stepan0605 ($100 in chips) 
Seat 7: CoolFireX ($137.99 in chips) 
Seat 8: Menno78 ($59.31 in chips) 
Seat 9: MarioDong ($123.81 in chips) 
Filojoes: posts small blind $0.50
Troll8989: posts big blind $1
*** HOLE CARDS ***
Dealt to matiko09 [6c 8d]
matiko09: folds 
Avtovo: folds 
stepan0605: folds 
CoolFireX: folds 
Menno78: folds 
MarioDong: folds 
hurtNCYDE: folds 
Filojoes: raises $1.50 to $2.50
Troll8989: calls $1.50
*** FLOP *** [2h 3s Ks]
Filojoes: bets $2.85
Troll8989: raises $5.65 to $8.50
Filojoes: calls $5.65
*** TURN *** [2h 3s Ks] [Ac]
Filojoes: checks 
Troll8989: bets $10.45
Filojoes: calls $10.45
*** RIVER *** [2h 3s Ks Ac] [Ts]
Filojoes: bets $30
Troll8989 said, "face[alm"
Troll8989: folds 
Uncalled bet ($30) returned to Filojoes
Filojoes collected $40.76 from pot
Filojoes: doesn't show hand 
*** SUMMARY ***
Total pot $42.90 | Rake $2.14 
Board [2h 3s Ks Ac Ts]
Seat 1: hurtNCYDE (button) folded before Flop (didn't bet)
Seat 2: Filojoes (small blind) collected ($40.76)
Seat 3: Troll8989 (big blind) folded on the River
Seat 4: matiko09 folded before Flop (didn't bet)
Seat 5: Avtovo folded before Flop (didn't bet)
Seat 6: stepan0605 folded before Flop (didn't bet)
Seat 7: CoolFireX folded before Flop (didn't bet)
Seat 8: Menno78 folded before Flop (didn't bet)
Seat 9: MarioDong folded before Flop (didn't bet)





PokerStars Hand #155013952467:  Hold'em No Limit ($0.50/$1.00 USD) - 2016/06/21 13:50:29 CET [2016/06/21 7:50:29 ET]
Table 'Umbriel II' 9-max Seat #6 is the button
Seat 1: matiko09 ($149.46 in chips) 
Seat 2: mi$$I$Elena ($100 in chips) 
Seat 3: mxustin ($27.25 in chips) 
Seat 4: Eskimo Fox ($106.75 in chips) 
Seat 5: mbk88 ($100.90 in chips) 
Seat 6: stepan0605 ($100 in chips) 
Seat 7: Chen423 ($88.45 in chips) 
Seat 8: Troll8989 ($101 in chips) 
Seat 9: CoolFireX ($127.34 in chips) 
Chen423: posts small blind $0.50
Troll8989: posts big blind $1
*** HOLE CARDS ***
Dealt to matiko09 [Qs Jh]
CoolFireX: folds 
matiko09: folds 
mi$$I$Elena: folds 
mxustin: folds 
Eskimo Fox: folds 
mbk88: folds 
stepan0605: folds 
Chen423: folds 
Uncalled bet ($0.50) returned to Troll8989
Troll8989 collected $1 from pot
Troll8989: doesn't show hand 
*** SUMMARY ***
Total pot $1 | Rake $0 
Seat 1: matiko09 folded before Flop (didn't bet)
Seat 2: mi$$I$Elena folded before Flop (didn't bet)
Seat 3: mxustin folded before Flop (didn't bet)
Seat 4: Eskimo Fox folded before Flop (didn't bet)
Seat 5: mbk88 folded before Flop (didn't bet)
Seat 6: stepan0605 (button) folded before Flop (didn't bet)
Seat 7: Chen423 (small blind) folded before Flop
Seat 8: Troll8989 (big blind) collected ($1)
Seat 9: CoolFireX folded before Flop (didn't bet)





PokerStars Hand #155013961439:  Hold'em No Limit ($0.50/$1.00 USD) - 2016/06/21 13:50:49 CET [2016/06/21 7:50:49 ET]
Table 'Pemba' 9-max Seat #3 is the button
Seat 3: CoolFireX ($367.40 in chips) 
Seat 6: matiko09 ($109.10 in chips) 
Seat 8: chaps1988 ($100 in chips) 
Seat 9: Eskimo Fox ($100 in chips) 
matiko09: posts small blind $0.50
chaps1988: posts big blind $1
pardama: sits out 
*** HOLE CARDS ***
Dealt to matiko09 [Ts Jd]
Eskimo Fox: folds 
CoolFireX: raises $1.50 to $2.50
matiko09: folds 
chaps1988: folds 
Uncalled bet ($1.50) returned to CoolFireX
CoolFireX collected $2.50 from pot
CoolFireX: doesn't show hand 
*** SUMMARY ***
Total pot $2.50 | Rake $0 
Seat 3: CoolFireX (button) collected ($2.50)
Seat 6: matiko09 (small blind) folded before Flop
Seat 8: chaps1988 (big blind) folded before Flop
Seat 9: Eskimo Fox folded before Flop (didn't bet)





PokerStars Hand #155013963814:  Hold'em No Limit ($0.50/$1.00 USD) - 2016/06/21 13:50:54 CET [2016/06/21 7:50:54 ET]
Table 'Schurer II' 9-max Seat #7 is the button
Seat 1: 50CandyJoe ($101.50 in chips) 
Seat 2: havenots88 ($100 in chips) 
Seat 3: matiko09 ($100 in chips) 
Seat 4: djammusic ($38.50 in chips) 
Seat 5: riggedsh** ($114.28 in chips) 
Seat 6: Dödi123 ($117.89 in chips) 
Seat 7: Avtovo ($110.08 in chips) 
Seat 8: ohneSenf66 ($79 in chips) 
Seat 9: ilaviiitech ($100 in chips) 
ohneSenf66: posts small blind $0.50
ilaviiitech: posts big blind $1
*** HOLE CARDS ***
Dealt to matiko09 [Ks 2d]
50CandyJoe: folds 
havenots88: folds 
matiko09: folds 
djammusic: raises $1.25 to $2.25
riggedsh**: folds 
Dödi123: folds 
Avtovo: folds 
ohneSenf66: folds 
ilaviiitech: raises $9.75 to $12
djammusic: folds 
Uncalled bet ($9.75) returned to ilaviiitech
ilaviiitech collected $5 from pot
ilaviiitech: doesn't show hand 
*** SUMMARY ***
Total pot $5 | Rake $0 
Seat 1: 50CandyJoe folded before Flop (didn't bet)
Seat 2: havenots88 folded before Flop (didn't bet)
Seat 3: matiko09 folded before Flop (didn't bet)
Seat 4: djammusic folded before Flop
Seat 5: riggedsh** folded before Flop (didn't bet)
Seat 6: Dödi123 folded before Flop (didn't bet)
Seat 7: Avtovo (button) folded before Flop (didn't bet)
Seat 8: ohneSenf66 (small blind) folded before Flop
Seat 9: ilaviiitech (big blind) collected ($5)





PokerStars Hand #155013965260:  Hold'em No Limit ($0.50/$1.00 USD) - 2016/06/21 13:50:57 CET [2016/06/21 7:50:57 ET]
Table 'Lamberta II' 9-max Seat #5 is the button
Seat 1: mbk88 ($178.67 in chips) 
Seat 2: mavin80 ($114.87 in chips) 
Seat 3: matiko09 ($106.18 in chips) 
Seat 4: Eskimo Fox ($118.39 in chips) 
Seat 5: CoolFireX ($100 in chips) 
Seat 6: Chen423 ($85.58 in chips) 
Seat 7: 23SmOkEr07 ($193.04 in chips) 
Seat 8: Troll8989 ($101.75 in chips) 
Seat 9: Sjtu_Michael ($100 in chips) 
Chen423: posts small blind $0.50
23SmOkEr07: posts big blind $1
*** HOLE CARDS ***
Dealt to matiko09 [Qs 7h]
Troll8989: folds 
Sjtu_Michael: folds 
mbk88: folds 
mavin80: folds 
matiko09: folds 
Eskimo Fox: folds 
CoolFireX: raises $1.50 to $2.50
Chen423: calls $2
23SmOkEr07: folds 
*** FLOP *** [6d 5h Kd]
Chen423: checks 
CoolFireX: bets $3.50
Chen423: folds 
Uncalled bet ($3.50) returned to CoolFireX
CoolFireX collected $5.70 from pot
CoolFireX: doesn't show hand 
*** SUMMARY ***
Total pot $6 | Rake $0.30 
Board [6d 5h Kd]
Seat 1: mbk88 folded before Flop (didn't bet)
Seat 2: mavin80 folded before Flop (didn't bet)
Seat 3: matiko09 folded before Flop (didn't bet)
Seat 4: Eskimo Fox folded before Flop (didn't bet)
Seat 5: CoolFireX (button) collected ($5.70)
Seat 6: Chen423 (small blind) folded on the Flop
Seat 7: 23SmOkEr07 (big blind) folded before Flop
Seat 8: Troll8989 folded before Flop (didn't bet)
Seat 9: Sjtu_Michael folded before Flop (didn't bet)





PokerStars Hand #155013965380:  Hold'em No Limit ($0.50/$1.00 USD) - 2016/06/21 13:50:58 CET [2016/06/21 7:50:58 ET]
Table 'Moreau' 9-max Seat #7 is the button
Seat 1: ozone2003 ($145.94 in chips) 
Seat 2: Avtovo ($107 in chips) 
Seat 3: matiko09 ($100 in chips) 
Seat 4: SharingaaN ($165.30 in chips) 
Seat 5: CoolFireX ($100 in chips) 
Seat 6: Troll8989 ($100 in chips) 
Seat 7: PanKwn15 ($88.10 in chips) 
Seat 8: mi$$I$Elena ($100 in chips) 
Seat 9: Toonersens ($137.34 in chips) 
mi$$I$Elena: posts small blind $0.50
Toonersens: posts big blind $1
*** HOLE CARDS ***
Dealt to matiko09 [5s Th]
ozone2003: folds 
Avtovo: folds 
ozone2003 leaves the table
matiko09: folds 
SharingaaN: raises $1 to $2
CoolFireX: folds 
Troll8989: folds 
PanKwn15: calls $2
mi$$I$Elena: raises $7 to $9
Toonersens: folds 
SharingaaN: folds 
PanKwn15: folds 
Uncalled bet ($7) returned to mi$$I$Elena
mi$$I$Elena collected $7 from pot
mi$$I$Elena: doesn't show hand 
*** SUMMARY ***
Total pot $7 | Rake $0 
Seat 1: ozone2003 folded before Flop (didn't bet)
Seat 2: Avtovo folded before Flop (didn't bet)
Seat 3: matiko09 folded before Flop (didn't bet)
Seat 4: SharingaaN folded before Flop
Seat 5: CoolFireX folded before Flop (didn't bet)
Seat 6: Troll8989 folded before Flop (didn't bet)
Seat 7: PanKwn15 (button) folded before Flop
Seat 8: mi$$I$Elena (small blind) collected ($7)
Seat 9: Toonersens (big blind) folded before Flop





PokerStars Hand #155013972826:  Hold'em No Limit ($0.50/$1.00 USD) - 2016/06/21 13:51:15 CET [2016/06/21 7:51:15 ET]
Table 'Umbriel II' 9-max Seat #7 is the button
Seat 1: matiko09 ($149.46 in chips) 
Seat 2: mi$$I$Elena ($100 in chips) 
Seat 3: mxustin ($27.25 in chips) 
Seat 4: Eskimo Fox ($106.75 in chips) 
Seat 5: mbk88 ($100.90 in chips) 
Seat 6: stepan0605 ($100 in chips) 
Seat 7: Chen423 ($87.95 in chips) 
Seat 8: Troll8989 ($101.50 in chips) 
Seat 9: CoolFireX ($127.34 in chips) 
Troll8989: posts small blind $0.50
CoolFireX: posts big blind $1
*** HOLE CARDS ***
Dealt to matiko09 [Jc Td]
matiko09: folds 
mi$$I$Elena: folds 
mxustin: folds 
Eskimo Fox: folds 
mbk88: raises $2 to $3
stepan0605: raises $6 to $9
Chen423: folds 
Troll8989: folds 
CoolFireX: folds 
mbk88: raises $18 to $27
stepan0605: folds 
Uncalled bet ($18) returned to mbk88
mbk88 collected $19.50 from pot
mbk88: doesn't show hand 
*** SUMMARY ***
Total pot $19.50 | Rake $0 
Seat 1: matiko09 folded before Flop (didn't bet)
Seat 2: mi$$I$Elena folded before Flop (didn't bet)
Seat 3: mxustin folded before Flop (didn't bet)
Seat 4: Eskimo Fox folded before Flop (didn't bet)
Seat 5: mbk88 collected ($19.50)
Seat 6: stepan0605 folded before Flop
Seat 7: Chen423 (button) folded before Flop (didn't bet)
Seat 8: Troll8989 (small blind) folded before Flop
Seat 9: CoolFireX (big blind) folded before Flop





PokerStars Hand #155013973859:  Hold'em No Limit (€0.50/€1.00 EUR) - 2016/06/21 13:51:17 CET [2016/06/21 7:51:17 ET]
Table 'Tauris III' 6-max Seat #5 is the button
Seat 1: morc1us (€100 in chips) 
Seat 2: devil1964 (€113.97 in chips) 
Seat 4: Gigi201133 (€104.41 in chips) 
Seat 5: parraka_210 (€100 in chips) 
Seat 6: matiko09 (€100 in chips) 
matiko09: posts small blind €0.50
morc1us: posts big blind €1
BronKKAA: sits out 
*** HOLE CARDS ***
Dealt to matiko09 [Kc 6c]
devil1964: calls €1
Gigi201133: calls €1
parraka_210: folds 
matiko09: calls €0.50
morc1us: checks 
*** FLOP *** [2s Qs 7c]
matiko09: checks 
morc1us: checks 
devil1964: checks 
Gigi201133: bets €2
matiko09: folds 
morc1us: folds 
devil1964: folds 
Uncalled bet (€2) returned to Gigi201133
Gigi201133 collected €3.80 from pot
*** SUMMARY ***
Total pot €4 | Rake €0.20 
Board [2s Qs 7c]
Seat 1: morc1us (big blind) folded on the Flop
Seat 2: devil1964 folded on the Flop
Seat 4: Gigi201133 collected (€3.80)
Seat 5: parraka_210 (button) folded before Flop (didn't bet)
Seat 6: matiko09 (small blind) folded on the Flop





PokerStars Hand #155013974224:  Hold'em No Limit ($0.50/$1.00 USD) - 2016/06/21 13:51:18 CET [2016/06/21 7:51:18 ET]
Table 'Admete II' 9-max Seat #3 is the button
Seat 1: Troll8989 ($100 in chips) 
Seat 2: Eskimo Fox ($159.64 in chips) 
Seat 3: chaps1988 ($225.97 in chips) 
Seat 4: 23SmOkEr07 ($103 in chips) 
Seat 5: aceking00007 ($80 in chips) 
Seat 6: mbk88 ($248.40 in chips) 
Seat 7: matiko09 ($100 in chips) 
Seat 8: koutani7 ($88.52 in chips) 
Seat 9: CoolFireX ($114.25 in chips) 
23SmOkEr07: posts small blind $0.50
aceking00007: posts big blind $1
*** HOLE CARDS ***
Dealt to matiko09 [4h 3c]
mbk88: folds 
matiko09: folds 
koutani7: folds 
CoolFireX: folds 
Troll8989: folds 
Eskimo Fox: raises $1.50 to $2.50
chaps1988: raises $7.50 to $10
23SmOkEr07: folds 
aceking00007: folds 
Eskimo Fox: folds 
Uncalled bet ($7.50) returned to chaps1988
chaps1988 collected $6.50 from pot
chaps1988: doesn't show hand 
*** SUMMARY ***
Total pot $6.50 | Rake $0 
Seat 1: Troll8989 folded before Flop (didn't bet)
Seat 2: Eskimo Fox folded before Flop
Seat 3: chaps1988 (button) collected ($6.50)
Seat 4: 23SmOkEr07 (small blind) folded before Flop
Seat 5: aceking00007 (big blind) folded before Flop
Seat 6: mbk88 folded before Flop (didn't bet)
Seat 7: matiko09 folded before Flop (didn't bet)
Seat 8: koutani7 folded before Flop (didn't bet)
Seat 9: CoolFireX folded before Flop (didn't bet)





PokerStars Hand #155013976577:  Hold'em No Limit ($0.50/$1.00 USD) - 2016/06/21 13:51:23 CET [2016/06/21 7:51:23 ET]
Table 'Carlova II' 9-max Seat #4 is the button
Seat 1: matiko09 ($100 in chips) 
Seat 2: mbk88 ($136.65 in chips) 
Seat 3: SharingaaN ($112.28 in chips) 
Seat 4: Dandy Monk ($123.34 in chips) 
Seat 5: ozone2003 ($170.44 in chips) 
Seat 6: Donetsk1y ($103 in chips) 
Seat 7: mi$$I$Elena ($106.95 in chips) 
Seat 8: pyromid ($89.80 in chips) 
Seat 9: Troll8989 ($110.96 in chips) 
ozone2003: posts small blind $0.50
Donetsk1y: posts big blind $1
*** HOLE CARDS ***
Dealt to matiko09 [8h 9c]
mi$$I$Elena: folds 
pyromid: raises $1.50 to $2.50
Troll8989: folds 
matiko09: folds 
mbk88: folds 
SharingaaN: calls $2.50
Dandy Monk: folds 
ozone2003: folds 
Donetsk1y: folds 
*** FLOP *** [6s 2s Jh]
Dandy Monk leaves the table
pyromid: bets $4
SharingaaN: folds 
Uncalled bet ($4) returned to pyromid
pyromid collected $6.18 from pot
pyromid: doesn't show hand 
*** SUMMARY ***
Total pot $6.50 | Rake $0.32 
Board [6s 2s Jh]
Seat 1: matiko09 folded before Flop (didn't bet)
Seat 2: mbk88 folded before Flop (didn't bet)
Seat 3: SharingaaN folded on the Flop
Seat 4: Dandy Monk (button) folded before Flop (didn't bet)
Seat 5: ozone2003 (small blind) folded before Flop
Seat 6: Donetsk1y (big blind) folded before Flop
Seat 7: mi$$I$Elena folded before Flop (didn't bet)
Seat 8: pyromid collected ($6.18)
Seat 9: Troll8989 folded before Flop (didn't bet)





PokerStars Hand #155013976998:  Hold'em No Limit ($0.50/$1.00 USD) - 2016/06/21 13:51:24 CET [2016/06/21 7:51:24 ET]
Table 'Schurer II' 9-max Seat #8 is the button
Seat 1: 50CandyJoe ($101.50 in chips) 
Seat 2: havenots88 ($100 in chips) 
Seat 3: matiko09 ($100 in chips) 
Seat 4: djammusic ($36.25 in chips) 
Seat 5: riggedsh** ($114.28 in chips) 
Seat 6: Dödi123 ($117.89 in chips) 
Seat 7: Avtovo ($110.08 in chips) 
Seat 8: ohneSenf66 ($78.50 in chips) 
Seat 9: ilaviiitech ($102.75 in chips) 
ilaviiitech: posts small blind $0.50
50CandyJoe: posts big blind $1
*** HOLE CARDS ***
Dealt to matiko09 [2c 8h]
havenots88: folds 
matiko09: folds 
djammusic: folds 
riggedsh**: raises $2 to $3
Dödi123: folds 
Avtovo: folds 
ohneSenf66: folds 
ilaviiitech: folds 
50CandyJoe: folds 
Uncalled bet ($2) returned to riggedsh**
riggedsh** collected $2.50 from pot
riggedsh**: doesn't show hand 
*** SUMMARY ***
Total pot $2.50 | Rake $0 
Seat 1: 50CandyJoe (big blind) folded before Flop
Seat 2: havenots88 folded before Flop (didn't bet)
Seat 3: matiko09 folded before Flop (didn't bet)
Seat 4: djammusic folded before Flop (didn't bet)
Seat 5: riggedsh** collected ($2.50)
Seat 6: Dödi123 folded before Flop (didn't bet)
Seat 7: Avtovo folded before Flop (didn't bet)
Seat 8: ohneSenf66 (button) folded before Flop (didn't bet)
Seat 9: ilaviiitech (small blind) folded before Flop





PokerStars Hand #155013977773:  Hold'em No Limit ($0.50/$1.00 USD) - 2016/06/21 13:51:26 CET [2016/06/21 7:51:26 ET]
Table 'Pemba' 9-max Seat #6 is the button
Seat 3: CoolFireX ($368.90 in chips) 
Seat 6: matiko09 ($108.60 in chips) 
Seat 8: chaps1988 ($100 in chips) 
Seat 9: Eskimo Fox ($100 in chips) 
chaps1988: posts small blind $0.50
Eskimo Fox: posts big blind $1
pardama: sits out 
*** HOLE CARDS ***
Dealt to matiko09 [Td Js]
CoolFireX: folds 
matiko09: raises $1.27 to $2.27
chaps1988: folds 
Eskimo Fox: folds 
Uncalled bet ($1.27) returned to matiko09
matiko09 collected $2.50 from pot
matiko09: doesn't show hand 
*** SUMMARY ***
Total pot $2.50 | Rake $0 
Seat 3: CoolFireX folded before Flop (didn't bet)
Seat 6: matiko09 (button) collected ($2.50)
Seat 8: chaps1988 (small blind) folded before Flop
Seat 9: Eskimo Fox (big blind) folded before Flop





PokerStars Hand #155013986867:  Hold'em No Limit (€0.25/€0.50 EUR) - 2016/06/21 13:51:46 CET [2016/06/21 7:51:46 ET]
Table 'Actor II' 6-max Seat #3 is the button
Seat 1: hmverlin (€83.39 in chips) 
Seat 2: alôha (€64.68 in chips) 
Seat 3: TopMo3UJlo (€50.82 in chips) 
Seat 4: matiko09 (€80.80 in chips) 
Seat 5: AlexPles (€50 in chips) 
Seat 6: fanmtZ (€22.22 in chips) 
matiko09: posts small blind €0.25
AlexPles: posts big blind €0.50
*** HOLE CARDS ***
Dealt to matiko09 [9h 8d]
fanmtZ: folds 
hmverlin: raises €1 to €1.50
alôha: folds 
TopMo3UJlo: folds 
matiko09: folds 
AlexPles: folds 
Uncalled bet (€1) returned to hmverlin
hmverlin collected €1.25 from pot
hmverlin: doesn't show hand 
*** SUMMARY ***
Total pot €1.25 | Rake €0 
Seat 1: hmverlin collected (€1.25)
Seat 2: alôha folded before Flop (didn't bet)
Seat 3: TopMo3UJlo (button) folded before Flop (didn't bet)
Seat 4: matiko09 (small blind) folded before Flop
Seat 5: AlexPles (big blind) folded before Flop
Seat 6: fanmtZ folded before Flop (didn't bet)





PokerStars Hand #155013988396:  Hold'em No Limit ($0.50/$1.00 USD) - 2016/06/21 13:51:50 CET [2016/06/21 7:51:50 ET]
Table 'Schurer II' 9-max Seat #9 is the button
Seat 1: 50CandyJoe ($100.50 in chips) 
Seat 2: havenots88 ($100 in chips) 
Seat 3: matiko09 ($100 in chips) 
Seat 4: djammusic ($36.25 in chips) 
Seat 5: riggedsh** ($115.78 in chips) 
Seat 6: Dödi123 ($117.89 in chips) 
Seat 7: Avtovo ($110.08 in chips) 
Seat 8: ohneSenf66 ($78.50 in chips) 
Seat 9: ilaviiitech ($102.25 in chips) 
50CandyJoe: posts small blind $0.50
havenots88: posts big blind $1
*** HOLE CARDS ***
Dealt to matiko09 [Qs Js]
matiko09: raises $2 to $3
djammusic: folds 
riggedsh**: folds 
Dödi123: folds 
Avtovo: folds 
ohneSenf66: folds 
ilaviiitech: folds 
50CandyJoe: folds 
havenots88: folds 
Uncalled bet ($2) returned to matiko09
matiko09 collected $2.50 from pot
matiko09: doesn't show hand 
*** SUMMARY ***
Total pot $2.50 | Rake $0 
Seat 1: 50CandyJoe (small blind) folded before Flop
Seat 2: havenots88 (big blind) folded before Flop
Seat 3: matiko09 collected ($2.50)
Seat 4: djammusic folded before Flop (didn't bet)
Seat 5: riggedsh** folded before Flop (didn't bet)
Seat 6: Dödi123 folded before Flop (didn't bet)
Seat 7: Avtovo folded before Flop (didn't bet)
Seat 8: ohneSenf66 folded before Flop (didn't bet)
Seat 9: ilaviiitech (button) folded before Flop (didn't bet)





PokerStars Hand #155013989184:  Hold'em No Limit ($0.50/$1.00 USD) - 2016/06/21 13:51:51 CET [2016/06/21 7:51:51 ET]
Table 'Pemba' 9-max Seat #8 is the button
Seat 1: pardama ($100 in chips) 
Seat 3: CoolFireX ($368.90 in chips) 
Seat 6: matiko09 ($110.10 in chips) 
Seat 8: chaps1988 ($100 in chips) 
Seat 9: Eskimo Fox ($100 in chips) 
Eskimo Fox: posts small blind $0.50
pardama: posts big blind $1
*** HOLE CARDS ***
Dealt to matiko09 [Kd Tc]
CoolFireX: folds 
matiko09: raises $1.50 to $2.50
chaps1988: folds 
Eskimo Fox: folds 
pardama: raises $7.50 to $10
matiko09: folds 
Uncalled bet ($7.50) returned to pardama
pardama collected $5.50 from pot
pardama: doesn't show hand 
*** SUMMARY ***
Total pot $5.50 | Rake $0 
Seat 1: pardama (big blind) collected ($5.50)
Seat 3: CoolFireX folded before Flop (didn't bet)
Seat 6: matiko09 folded before Flop
Seat 8: chaps1988 (button) folded before Flop (didn't bet)
Seat 9: Eskimo Fox (small blind) folded before Flop





PokerStars Hand #155013991159:  Hold'em No Limit ($0.50/$1.00 USD) - 2016/06/21 13:51:56 CET [2016/06/21 7:51:56 ET]
Table 'Lamberta II' 9-max Seat #6 is the button
Seat 1: mbk88 ($178.67 in chips) 
Seat 2: mavin80 ($114.87 in chips) 
Seat 3: matiko09 ($106.18 in chips) 
Seat 4: Eskimo Fox ($118.39 in chips) 
Seat 5: CoolFireX ($103.20 in chips) 
Seat 6: Chen423 ($83.08 in chips) 
Seat 7: 23SmOkEr07 ($192.04 in chips) 
Seat 8: Troll8989 ($101.75 in chips) 
Seat 9: Sjtu_Michael ($100 in chips) 
23SmOkEr07: posts small blind $0.50
Troll8989: posts big blind $1
*** HOLE CARDS ***
Dealt to matiko09 [Td Jd]
Sjtu_Michael: folds 
mbk88: folds 
mavin80: folds 
matiko09: raises $2 to $3
Eskimo Fox: folds 
CoolFireX: raises $6 to $9
Chen423: folds 
23SmOkEr07: folds 
Troll8989: folds 
matiko09: folds 
Uncalled bet ($6) returned to CoolFireX
CoolFireX collected $7.50 from pot
CoolFireX: doesn't show hand 
*** SUMMARY ***
Total pot $7.50 | Rake $0 
Seat 1: mbk88 folded before Flop (didn't bet)
Seat 2: mavin80 folded before Flop (didn't bet)
Seat 3: matiko09 folded before Flop
Seat 4: Eskimo Fox folded before Flop (didn't bet)
Seat 5: CoolFireX collected ($7.50)
Seat 6: Chen423 (button) folded before Flop (didn't bet)
Seat 7: 23SmOkEr07 (small blind) folded before Flop
Seat 8: Troll8989 (big blind) folded before Flop
Seat 9: Sjtu_Michael folded before Flop (didn't bet)





PokerStars Hand #155013992071:  Hold'em No Limit ($0.50/$1.00 USD) - 2016/06/21 13:51:58 CET [2016/06/21 7:51:58 ET]
Table 'Moreau' 9-max Seat #8 is the button
Seat 2: Avtovo ($107 in chips) 
Seat 3: matiko09 ($100 in chips) 
Seat 4: SharingaaN ($163.30 in chips) 
Seat 5: CoolFireX ($100 in chips) 
Seat 6: Troll8989 ($100 in chips) 
Seat 7: PanKwn15 ($86.10 in chips) 
Seat 8: mi$$I$Elena ($105 in chips) 
Seat 9: Toonersens ($136.34 in chips) 
Toonersens: posts small blind $0.50
Avtovo: posts big blind $1
*** HOLE CARDS ***
Dealt to matiko09 [6s 9d]
matiko09: folds 
SharingaaN: folds 
CoolFireX: folds 
Troll8989: folds 
PanKwn15: raises $1.50 to $2.50
hurtNCYDE joins the table at seat #1 
mi$$I$Elena: folds 
Toonersens: calls $2
Avtovo: folds 
*** FLOP *** [Qh Js Ac]
Toonersens: checks 
PanKwn15: checks 
*** TURN *** [Qh Js Ac] [9s]
Toonersens: bets $3
PanKwn15: raises $4 to $7
Toonersens: calls $4
*** RIVER *** [Qh Js Ac 9s] [Qd]
Toonersens: bets $12
PanKwn15: calls $12
*** SHOW DOWN ***
Toonersens: shows [Jh Td] (two pair, Queens and Jacks)
PanKwn15: shows [Th 8h] (a straight, Eight to Queen)
PanKwn15 collected $41.80 from pot
*** SUMMARY ***
Total pot $44 | Rake $2.20 
Board [Qh Js Ac 9s Qd]
Seat 2: Avtovo (big blind) folded before Flop
Seat 3: matiko09 folded before Flop (didn't bet)
Seat 4: SharingaaN folded before Flop (didn't bet)
Seat 5: CoolFireX folded before Flop (didn't bet)
Seat 6: Troll8989 folded before Flop (didn't bet)
Seat 7: PanKwn15 showed [Th 8h] and won ($41.80) with a straight, Eight to Queen
Seat 8: mi$$I$Elena (button) folded before Flop (didn't bet)
Seat 9: Toonersens (small blind) showed [Jh Td] and lost with two pair, Queens and Jacks





PokerStars Hand #155013992110:  Hold'em No Limit ($0.50/$1.00 USD) - 2016/06/21 13:51:58 CET [2016/06/21 7:51:58 ET]
Table 'Megrez II' 9-max Seat #2 is the button
Seat 1: hurtNCYDE ($101.50 in chips) 
Seat 2: Filojoes ($134.44 in chips) 
Seat 3: Troll8989 ($100 in chips) 
Seat 4: matiko09 ($100 in chips) 
Seat 5: Avtovo ($124.68 in chips) 
Seat 6: stepan0605 ($100 in chips) 
Seat 7: CoolFireX ($137.99 in chips) 
Seat 8: Menno78 ($59.31 in chips) 
Seat 9: MarioDong ($123.81 in chips) 
Troll8989: posts small blind $0.50
matiko09: posts big blind $1
*** HOLE CARDS ***
Dealt to matiko09 [5h Qc]
Avtovo: folds 
stepan0605: raises $1 to $2
Avtovo leaves the table
Donetsk1y joins the table at seat #5 
CoolFireX: folds 
Menno78: folds 
Donetsk1y leaves the table
MarioDong: folds 
hurtNCYDE: folds 
Filojoes: folds 
Troll8989: folds 
matiko09: folds 
Uncalled bet ($1) returned to stepan0605
stepan0605 collected $2.50 from pot
stepan0605: doesn't show hand 
*** SUMMARY ***
Total pot $2.50 | Rake $0 
Seat 1: hurtNCYDE folded before Flop (didn't bet)
Seat 2: Filojoes (button) folded before Flop (didn't bet)
Seat 3: Troll8989 (small blind) folded before Flop
Seat 4: matiko09 (big blind) folded before Flop
Seat 5: Avtovo folded before Flop (didn't bet)
Seat 6: stepan0605 collected ($2.50)
Seat 7: CoolFireX folded before Flop (didn't bet)
Seat 8: Menno78 folded before Flop (didn't bet)
Seat 9: MarioDong folded before Flop (didn't bet)





PokerStars Hand #155013992569:  Hold'em No Limit (€0.25/€0.50 EUR) - 2016/06/21 13:51:59 CET [2016/06/21 7:51:59 ET]
Table 'Actor II' 6-max Seat #4 is the button
Seat 1: hmverlin (€84.14 in chips) 
Seat 2: alôha (€64.68 in chips) 
Seat 3: TopMo3UJlo (€50.82 in chips) 
Seat 4: matiko09 (€80.55 in chips) 
Seat 5: AlexPles (€50 in chips) 
Seat 6: fanmtZ (€22.22 in chips) 
AlexPles: posts small blind €0.25
fanmtZ: posts big blind €0.50
*** HOLE CARDS ***
Dealt to matiko09 [8s 6s]
hmverlin: folds 
alôha: raises €0.75 to €1.25
TopMo3UJlo: folds 
matiko09: folds 
AlexPles: folds 
fanmtZ: folds 
Uncalled bet (€0.75) returned to alôha
alôha collected €1.25 from pot
alôha: doesn't show hand 
*** SUMMARY ***
Total pot €1.25 | Rake €0 
Seat 1: hmverlin folded before Flop (didn't bet)
Seat 2: alôha collected (€1.25)
Seat 3: TopMo3UJlo folded before Flop (didn't bet)
Seat 4: matiko09 (button) folded before Flop (didn't bet)
Seat 5: AlexPles (small blind) folded before Flop
Seat 6: fanmtZ (big blind) folded before Flop





PokerStars Hand #155013994659:  Hold'em No Limit (€0.50/€1.00 EUR) - 2016/06/21 13:52:04 CET [2016/06/21 7:52:04 ET]
Table 'Tauris III' 6-max Seat #6 is the button
Seat 1: morc1us (€100 in chips) 
Seat 2: devil1964 (€112.97 in chips) 
Seat 4: Gigi201133 (€107.21 in chips) 
Seat 5: parraka_210 (€100 in chips) 
Seat 6: matiko09 (€100 in chips) 
morc1us: posts small blind €0.50
devil1964: posts big blind €1
BronKKAA: sits out 
*** HOLE CARDS ***
Dealt to matiko09 [9s 9h]
Gigi201133: folds 
parraka_210: folds 
matiko09: raises €1.27 to €2.27
morc1us: folds 
devil1964: folds 
Uncalled bet (€1.27) returned to matiko09
matiko09 collected €2.50 from pot
matiko09: doesn't show hand 
*** SUMMARY ***
Total pot €2.50 | Rake €0 
Seat 1: morc1us (small blind) folded before Flop
Seat 2: devil1964 (big blind) folded before Flop
Seat 4: Gigi201133 folded before Flop (didn't bet)
Seat 5: parraka_210 folded before Flop (didn't bet)
Seat 6: matiko09 (button) collected (€2.50)





PokerStars Hand #155013999384:  Hold'em No Limit ($0.50/$1.00 USD) - 2016/06/21 13:52:14 CET [2016/06/21 7:52:14 ET]
Table 'Umbriel II' 9-max Seat #8 is the button
Seat 1: matiko09 ($149.46 in chips) 
Seat 2: mi$$I$Elena ($100 in chips) 
Seat 3: mxustin ($27.25 in chips) 
Seat 4: Eskimo Fox ($106.75 in chips) 
Seat 5: mbk88 ($111.40 in chips) 
Seat 6: stepan0605 ($100 in chips) 
Seat 7: Chen423 ($87.95 in chips) 
Seat 8: Troll8989 ($101 in chips) 
Seat 9: CoolFireX ($126.34 in chips) 
CoolFireX: posts small blind $0.50
matiko09: posts big blind $1
*** HOLE CARDS ***
Dealt to matiko09 [Ks 3s]
mi$$I$Elena: folds 
mxustin: folds 
mi$$I$Elena leaves the table
Eskimo Fox: folds 
mbk88: folds 
stepan0605: folds 
Chen423: raises $2 to $3
Troll8989: raises $6.50 to $9.50
CoolFireX: folds 
matiko09: folds 
Chen423: calls $6.50
*** FLOP *** [8c 4d 8d]
Chen423: checks 
Troll8989: checks 
*** TURN *** [8c 4d 8d] [Js]
Chen423: checks 
Troll8989: checks 
*** RIVER *** [8c 4d 8d Js] [5s]
Chen423: checks 
Troll8989: checks 
*** SHOW DOWN ***
Chen423: shows [7d 7c] (two pair, Eights and Sevens)
Troll8989: mucks hand 
Chen423 collected $19.48 from pot
*** SUMMARY ***
Total pot $20.50 | Rake $1.02 
Board [8c 4d 8d Js 5s]
Seat 1: matiko09 (big blind) folded before Flop
Seat 2: mi$$I$Elena folded before Flop (didn't bet)
Seat 3: mxustin folded before Flop (didn't bet)
Seat 4: Eskimo Fox folded before Flop (didn't bet)
Seat 5: mbk88 folded before Flop (didn't bet)
Seat 6: stepan0605 folded before Flop (didn't bet)
Seat 7: Chen423 showed [7d 7c] and won ($19.48) with two pair, Eights and Sevens
Seat 8: Troll8989 (button) mucked [Ah Kh]
Seat 9: CoolFireX (small blind) folded before Flop





PokerStars Hand #155013999177:  Hold'em No Limit ($0.50/$1.00 USD) - 2016/06/21 13:52:14 CET [2016/06/21 7:52:14 ET]
Table 'Schurer II' 9-max Seat #1 is the button
Seat 1: 50CandyJoe ($100 in chips) 
Seat 2: havenots88 ($99 in chips) 
Seat 3: matiko09 ($101.50 in chips) 
Seat 4: djammusic ($36.25 in chips) 
Seat 5: riggedsh** ($115.78 in chips) 
Seat 6: Dödi123 ($117.89 in chips) 
Seat 7: Avtovo ($110.08 in chips) 
Seat 8: ohneSenf66 ($78.50 in chips) 
Seat 9: ilaviiitech ($102.25 in chips) 
havenots88: posts small blind $0.50
matiko09: posts big blind $1
*** HOLE CARDS ***
Dealt to matiko09 [2s Js]
djammusic: folds 
riggedsh**: folds 
Dödi123: raises $2 to $3
Avtovo: folds 
ohneSenf66: folds 
ilaviiitech: folds 
50CandyJoe: folds 
havenots88: folds 
matiko09: folds 
Uncalled bet ($2) returned to Dödi123
Dödi123 collected $2.50 from pot
Dödi123: doesn't show hand 
*** SUMMARY ***
Total pot $2.50 | Rake $0 
Seat 1: 50CandyJoe (button) folded before Flop (didn't bet)
Seat 2: havenots88 (small blind) folded before Flop
Seat 3: matiko09 (big blind) folded before Flop
Seat 4: djammusic folded before Flop (didn't bet)
Seat 5: riggedsh** folded before Flop (didn't bet)
Seat 6: Dödi123 collected ($2.50)
Seat 7: Avtovo folded before Flop (didn't bet)
Seat 8: ohneSenf66 folded before Flop (didn't bet)
Seat 9: ilaviiitech folded before Flop (didn't bet)





PokerStars Hand #155014007197:  Hold'em No Limit ($0.50/$1.00 USD) - 2016/06/21 13:52:32 CET [2016/06/21 7:52:32 ET]
Table 'Carlova II' 9-max Seat #5 is the button
Seat 1: matiko09 ($100 in chips) 
Seat 2: mbk88 ($136.65 in chips) 
Seat 3: SharingaaN ($109.78 in chips) 
Seat 5: ozone2003 ($169.94 in chips) 
Seat 6: Donetsk1y ($102 in chips) 
Seat 7: mi$$I$Elena ($106.95 in chips) 
Seat 8: pyromid ($93.48 in chips) 
Seat 9: Troll8989 ($110.96 in chips) 
Donetsk1y: posts small blind $0.50
mi$$I$Elena: posts big blind $1
*** HOLE CARDS ***
Dealt to matiko09 [4s Jd]
pyromid: folds 
Troll8989: folds 
matiko09: folds 
mbk88: folds 
hurtNCYDE joins the table at seat #4 
hurtNCYDE leaves the table
stepan0605 joins the table at seat #4 
SharingaaN: raises $2 to $3
stepan0605 leaves the table
Avtovo joins the table at seat #4 
ozone2003: folds 
Donetsk1y: folds 
mi$$I$Elena: folds 
Uncalled bet ($2) returned to SharingaaN
SharingaaN collected $2.50 from pot
SharingaaN: doesn't show hand 
*** SUMMARY ***
Total pot $2.50 | Rake $0 
Seat 1: matiko09 folded before Flop (didn't bet)
Seat 2: mbk88 folded before Flop (didn't bet)
Seat 3: SharingaaN collected ($2.50)
Seat 5: ozone2003 (button) folded before Flop (didn't bet)
Seat 6: Donetsk1y (small blind) folded before Flop
Seat 7: mi$$I$Elena (big blind) folded before Flop
Seat 8: pyromid folded before Flop (didn't bet)
Seat 9: Troll8989 folded before Flop (didn't bet)





PokerStars Hand #155014007744:  Hold'em No Limit ($0.50/$1.00 USD) - 2016/06/21 13:52:33 CET [2016/06/21 7:52:33 ET]
Table 'Megrez II' 9-max Seat #3 is the button
Seat 1: hurtNCYDE ($101.50 in chips) 
Seat 2: Filojoes ($134.44 in chips) 
Seat 3: Troll8989 ($100 in chips) 
Seat 4: matiko09 ($100 in chips) 
Seat 6: stepan0605 ($101.50 in chips) 
Seat 7: CoolFireX ($137.99 in chips) 
Seat 8: Menno78 ($59.31 in chips) 
Seat 9: MarioDong ($123.81 in chips) 
matiko09: posts small blind $0.50
stepan0605: posts big blind $1
*** HOLE CARDS ***
Dealt to matiko09 [Qh 4d]
CoolFireX: raises $2 to $3
Menno78: folds 
MarioDong: folds 
hurtNCYDE: folds 
Filojoes: folds 
Troll8989: folds 
matiko09: folds 
stepan0605: folds 
Uncalled bet ($2) returned to CoolFireX
CoolFireX collected $2.50 from pot
*** SUMMARY ***
Total pot $2.50 | Rake $0 
Seat 1: hurtNCYDE folded before Flop (didn't bet)
Seat 2: Filojoes folded before Flop (didn't bet)
Seat 3: Troll8989 (button) folded before Flop (didn't bet)
Seat 4: matiko09 (small blind) folded before Flop
Seat 6: stepan0605 (big blind) folded before Flop
Seat 7: CoolFireX collected ($2.50)
Seat 8: Menno78 folded before Flop (didn't bet)
Seat 9: MarioDong folded before Flop (didn't bet)





PokerStars Hand #155014008457:  Hold'em No Limit ($0.50/$1.00 USD) - 2016/06/21 13:52:35 CET [2016/06/21 7:52:35 ET]
Table 'Gryphia' 9-max Seat #5 is the button
Seat 1: Klappspaten0 ($100 in chips) 
Seat 4: King Sixtus ($65.79 in chips) 
Seat 5: pardama ($100 in chips) 
Seat 7: solbi86 ($100.50 in chips) 
Seat 8: matiko09 ($100 in chips) 
Dandy Monk will be allowed to play after the button
solbi86: posts small blind $0.50
matiko09: posts big blind $1
stepan0605: sits out 
KovIFish89: sits out 
King Sixtus: posts big blind $1
*** HOLE CARDS ***
Dealt to matiko09 [8s Qh]
Klappspaten0: folds 
King Sixtus: checks 
pardama: folds 
solbi86: calls $0.50
matiko09: checks 
*** FLOP *** [8h Qc 8d]
solbi86: bets $2
matiko09: calls $2
King Sixtus: folds 
*** TURN *** [8h Qc 8d] [9s]
solbi86: checks 
matiko09: bets $3.45
solbi86: calls $3.45
*** RIVER *** [8h Qc 8d 9s] [5s]
solbi86: checks 
matiko09: bets $6.86
solbi86: calls $6.86
*** SHOW DOWN ***
matiko09: shows [8s Qh] (a full house, Eights full of Queens)
solbi86: mucks hand 
matiko09 collected $26.24 from pot
*** SUMMARY ***
Total pot $27.62 | Rake $1.38 
Board [8h Qc 8d 9s 5s]
Seat 1: Klappspaten0 folded before Flop (didn't bet)
Seat 4: King Sixtus folded on the Flop
Seat 5: pardama (button) folded before Flop (didn't bet)
Seat 7: solbi86 (small blind) mucked [Th Qs]
Seat 8: matiko09 (big blind) showed [8s Qh] and won ($26.24) with a full house, Eights full of Queens





PokerStars Hand #155014009437:  Hold'em No Limit ($0.50/$1.00 USD) - 2016/06/21 13:52:37 CET [2016/06/21 7:52:37 ET]
Table 'Schurer II' 9-max Seat #2 is the button
Seat 1: 50CandyJoe ($100 in chips) 
Seat 2: havenots88 ($98.50 in chips) 
Seat 3: matiko09 ($100.50 in chips) 
Seat 4: djammusic ($36.25 in chips) 
Seat 5: riggedsh** ($115.78 in chips) 
Seat 6: Dödi123 ($119.39 in chips) 
Seat 7: Avtovo ($110.08 in chips) 
Seat 8: ohneSenf66 ($78.50 in chips) 
Seat 9: ilaviiitech ($102.25 in chips) 
matiko09: posts small blind $0.50
djammusic: posts big blind $1
*** HOLE CARDS ***
Dealt to matiko09 [Qc Ks]
riggedsh**: folds 
Dödi123: folds 
Avtovo: folds 
ohneSenf66: raises $2 to $3
ilaviiitech: folds 
50CandyJoe: raises $6 to $9
havenots88: folds 
matiko09: folds 
djammusic: folds 
ohneSenf66: calls $6
*** FLOP *** [7s Tc Jh]
ohneSenf66: checks 
50CandyJoe: bets $13.89
ohneSenf66: calls $13.89
*** TURN *** [7s Tc Jh] [5s]
ohneSenf66: checks 
50CandyJoe: bets $22.46
ohneSenf66: calls $22.46
*** RIVER *** [7s Tc Jh 5s] [Ac]
ohneSenf66: bets $33.15 and is all-in
50CandyJoe: calls $33.15
*** SHOW DOWN ***
ohneSenf66: shows [Ah Qh] (a pair of Aces)
50CandyJoe: shows [Kc Kd] (a pair of Kings)
ohneSenf66 collected $156 from pot
*** SUMMARY ***
Total pot $158.50 | Rake $2.50 
Board [7s Tc Jh 5s Ac]
Seat 1: 50CandyJoe showed [Kc Kd] and lost with a pair of Kings
Seat 2: havenots88 (button) folded before Flop (didn't bet)
Seat 3: matiko09 (small blind) folded before Flop
Seat 4: djammusic (big blind) folded before Flop
Seat 5: riggedsh** folded before Flop (didn't bet)
Seat 6: Dödi123 folded before Flop (didn't bet)
Seat 7: Avtovo folded before Flop (didn't bet)
Seat 8: ohneSenf66 showed [Ah Qh] and won ($156) with a pair of Aces
Seat 9: ilaviiitech folded before Flop (didn't bet)





PokerStars Hand #155014013455:  Hold'em No Limit (€0.25/€0.50 EUR) - 2016/06/21 13:52:46 CET [2016/06/21 7:52:46 ET]
Table 'Actor II' 6-max Seat #5 is the button
Seat 1: hmverlin (€84.14 in chips) 
Seat 2: alôha (€65.43 in chips) 
Seat 3: TopMo3UJlo (€50.82 in chips) 
Seat 4: matiko09 (€80.55 in chips) 
Seat 5: AlexPles (€50 in chips) 
Seat 6: fanmtZ (€21.72 in chips) 
fanmtZ: posts small blind €0.25
hmverlin: posts big blind €0.50
*** HOLE CARDS ***
Dealt to matiko09 [Jc 6d]
alôha: folds 
TopMo3UJlo: folds 
matiko09: folds 
AlexPles: raises €0.62 to €1.12
fanmtZ: raises €2.13 to €3.25
hmverlin: folds 
AlexPles: folds 
Uncalled bet (€2.13) returned to fanmtZ
fanmtZ collected €2.74 from pot
fanmtZ: doesn't show hand 
*** SUMMARY ***
Total pot €2.74 | Rake €0 
Seat 1: hmverlin (big blind) folded before Flop
Seat 2: alôha folded before Flop (didn't bet)
Seat 3: TopMo3UJlo folded before Flop (didn't bet)
Seat 4: matiko09 folded before Flop (didn't bet)
Seat 5: AlexPles (button) folded before Flop
Seat 6: fanmtZ (small blind) collected (€2.74)





PokerStars Hand #155014016421:  Hold'em No Limit ($0.50/$1.00 USD) - 2016/06/21 13:52:53 CET [2016/06/21 7:52:53 ET]
Table 'Pemba' 9-max Seat #9 is the button
Seat 1: pardama ($103 in chips) 
Seat 2: Dantist1122 ($100 in chips) 
Seat 3: CoolFireX ($368.90 in chips) 
Seat 4: frut12 ($116.36 in chips) 
Seat 6: matiko09 ($107.60 in chips) 
Seat 8: chaps1988 ($100 in chips) 
Seat 9: Eskimo Fox ($100 in chips) 
pardama: posts small blind $0.50
Dantist1122: posts big blind $1
frut12: posts small & big blinds $1.50
mi$$I$Elena: sits out 
*** HOLE CARDS ***
Dealt to matiko09 [Kd Ad]
CoolFireX: folds 
frut12: checks 
matiko09: raises $3 to $4
chaps1988: folds 
Eskimo Fox: folds 
pardama: folds 
Dantist1122: folds 
frut12: folds 
Uncalled bet ($3) returned to matiko09
matiko09 collected $4 from pot
matiko09: doesn't show hand 
*** SUMMARY ***
Total pot $4 | Rake $0 
Seat 1: pardama (small blind) folded before Flop
Seat 2: Dantist1122 (big blind) folded before Flop
Seat 3: CoolFireX folded before Flop (didn't bet)
Seat 4: frut12 folded before Flop
Seat 6: matiko09 collected ($4)
Seat 8: chaps1988 folded before Flop (didn't bet)
Seat 9: Eskimo Fox (button) folded before Flop (didn't bet)





PokerStars Hand #155014018680:  Hold'em No Limit ($0.50/$1.00 USD) - 2016/06/21 13:52:58 CET [2016/06/21 7:52:58 ET]
Table 'Lamberta II' 9-max Seat #7 is the button
Seat 1: mbk88 ($178.67 in chips) 
Seat 2: mavin80 ($114.87 in chips) 
Seat 3: matiko09 ($103.18 in chips) 
Seat 4: Eskimo Fox ($118.39 in chips) 
Seat 5: CoolFireX ($107.70 in chips) 
Seat 6: Chen423 ($83.08 in chips) 
Seat 7: 23SmOkEr07 ($191.54 in chips) 
Seat 8: Troll8989 ($100.75 in chips) 
Seat 9: Sjtu_Michael ($100 in chips) 
Troll8989: posts small blind $0.50
Sjtu_Michael: posts big blind $1
*** HOLE CARDS ***
Dealt to matiko09 [Qs Ad]
mbk88: raises $2 to $3
mavin80: folds 
matiko09: raises $7 to $10
Eskimo Fox: folds 
CoolFireX: folds 
Chen423: folds 
23SmOkEr07: folds 
Troll8989: folds 
Sjtu_Michael: folds 
mbk88: folds 
Uncalled bet ($7) returned to matiko09
matiko09 collected $7.50 from pot
matiko09: doesn't show hand 
*** SUMMARY ***
Total pot $7.50 | Rake $0 
Seat 1: mbk88 folded before Flop
Seat 2: mavin80 folded before Flop (didn't bet)
Seat 3: matiko09 collected ($7.50)
Seat 4: Eskimo Fox folded before Flop (didn't bet)
Seat 5: CoolFireX folded before Flop (didn't bet)
Seat 6: Chen423 folded before Flop (didn't bet)
Seat 7: 23SmOkEr07 (button) folded before Flop (didn't bet)
Seat 8: Troll8989 (small blind) folded before Flop
Seat 9: Sjtu_Michael (big blind) folded before Flop





PokerStars Hand #155014026189:  Hold'em No Limit (€0.25/€0.50 EUR) - 2016/06/21 13:53:15 CET [2016/06/21 7:53:15 ET]
Table 'Actor II' 6-max Seat #6 is the button
Seat 1: hmverlin (€83.64 in chips) 
Seat 2: alôha (€65.43 in chips) 
Seat 3: TopMo3UJlo (€50.82 in chips) 
Seat 4: matiko09 (€80.55 in chips) 
Seat 5: AlexPles (€50 in chips) 
Seat 6: fanmtZ (€23.34 in chips) 
hmverlin: posts small blind €0.25
alôha: posts big blind €0.50
*** HOLE CARDS ***
Dealt to matiko09 [3d 8s]
TopMo3UJlo: folds 
matiko09: folds 
AlexPles: folds 
fanmtZ: raises €0.79 to €1.29
hmverlin: folds 
alôha: raises €2.21 to €3.50
fanmtZ: raises €4.25 to €7.75
alôha: raises €57.68 to €65.43 and is all-in
fanmtZ: folds 
Uncalled bet (€57.68) returned to alôha
alôha collected €15.75 from pot
alôha: doesn't show hand 
*** SUMMARY ***
Total pot €15.75 | Rake €0 
Seat 1: hmverlin (small blind) folded before Flop
Seat 2: alôha (big blind) collected (€15.75)
Seat 3: TopMo3UJlo folded before Flop (didn't bet)
Seat 4: matiko09 folded before Flop (didn't bet)
Seat 5: AlexPles folded before Flop (didn't bet)
Seat 6: fanmtZ (button) folded before Flop





PokerStars Hand #155014026518:  Hold'em No Limit (€0.50/€1.00 EUR) - 2016/06/21 13:53:16 CET [2016/06/21 7:53:16 ET]
Table 'Tauris III' 6-max Seat #1 is the button
Seat 1: morc1us (€100 in chips) 
Seat 2: devil1964 (€111.97 in chips) 
Seat 3: BronKKAA (€115.32 in chips) 
Seat 4: Gigi201133 (€107.21 in chips) 
Seat 5: parraka_210 (€100 in chips) 
Seat 6: matiko09 (€101.50 in chips) 
devil1964: posts small blind €0.50
BronKKAA: posts big blind €1
*** HOLE CARDS ***
Dealt to matiko09 [Th Kd]
Gigi201133: calls €1
parraka_210: raises €3 to €4
matiko09: folds 
morc1us: calls €4
devil1964: calls €3.50
BronKKAA: folds 
Gigi201133: calls €3
*** FLOP *** [6h Jd 4c]
devil1964: checks 
Gigi201133: bets €8
parraka_210: folds 
morc1us: folds 
devil1964: folds 
Uncalled bet (€8) returned to Gigi201133
Gigi201133 collected €16.15 from pot
*** SUMMARY ***
Total pot €17 | Rake €0.85 
Board [6h Jd 4c]
Seat 1: morc1us (button) folded on the Flop
Seat 2: devil1964 (small blind) folded on the Flop
Seat 3: BronKKAA (big blind) folded before Flop
Seat 4: Gigi201133 collected (€16.15)
Seat 5: parraka_210 folded on the Flop
Seat 6: matiko09 folded before Flop (didn't bet)





PokerStars Hand #155014027417:  Hold'em No Limit ($0.50/$1.00 USD) - 2016/06/21 13:53:18 CET [2016/06/21 7:53:18 ET]
Table 'Carlova II' 9-max Seat #6 is the button
Seat 1: matiko09 ($100 in chips) 
Seat 2: mbk88 ($136.65 in chips) 
Seat 3: SharingaaN ($111.28 in chips) 
Seat 5: ozone2003 ($169.94 in chips) 
Seat 6: Donetsk1y ($101.50 in chips) 
Seat 7: mi$$I$Elena ($105.95 in chips) 
Seat 8: pyromid ($100 in chips) 
Seat 9: Troll8989 ($110.96 in chips) 
mi$$I$Elena: posts small blind $0.50
pyromid: posts big blind $1
Avtovo: sits out 
*** HOLE CARDS ***
Dealt to matiko09 [9h 6c]
Troll8989: folds 
matiko09: folds 
Troll8989 leaves the table
mbk88: folds 
Filojoes joins the table at seat #9 
Filojoes leaves the table
SharingaaN: folds 
ozone2003: folds 
Donetsk1y: raises $1.20 to $2.20
mi$$I$Elena: folds 
pyromid: folds 
Uncalled bet ($1.20) returned to Donetsk1y
Donetsk1y collected $2.50 from pot
Donetsk1y: doesn't show hand 
*** SUMMARY ***
Total pot $2.50 | Rake $0 
Seat 1: matiko09 folded before Flop (didn't bet)
Seat 2: mbk88 folded before Flop (didn't bet)
Seat 3: SharingaaN folded before Flop (didn't bet)
Seat 5: ozone2003 folded before Flop (didn't bet)
Seat 6: Donetsk1y (button) collected ($2.50)
Seat 7: mi$$I$Elena (small blind) folded before Flop
Seat 8: pyromid (big blind) folded before Flop
Seat 9: Troll8989 folded before Flop (didn't bet)





PokerStars Hand #155014028444:  Hold'em No Limit ($0.50/$1.00 USD) - 2016/06/21 13:53:20 CET [2016/06/21 7:53:20 ET]
Table 'Pemba' 9-max Seat #1 is the button
Seat 1: pardama ($102.50 in chips) 
Seat 2: Dantist1122 ($100 in chips) 
Seat 3: CoolFireX ($368.90 in chips) 
Seat 4: frut12 ($114.86 in chips) 
Seat 6: matiko09 ($110.60 in chips) 
Seat 8: chaps1988 ($100 in chips) 
Seat 9: Eskimo Fox ($100 in chips) 
Dantist1122: posts small blind $0.50
CoolFireX: posts big blind $1
djammusic: sits out 
mi$$I$Elena: sits out 
*** HOLE CARDS ***
Dealt to matiko09 [2h Ac]
frut12: raises $1 to $2
matiko09: folds 
chaps1988: folds 
Eskimo Fox: folds 
pardama: folds 
Dantist1122: folds 
CoolFireX: folds 
Uncalled bet ($1) returned to frut12
frut12 collected $2.50 from pot
*** SUMMARY ***
Total pot $2.50 | Rake $0 
Seat 1: pardama (button) folded before Flop (didn't bet)
Seat 2: Dantist1122 (small blind) folded before Flop
Seat 3: CoolFireX (big blind) folded before Flop
Seat 4: frut12 collected ($2.50)
Seat 6: matiko09 folded before Flop (didn't bet)
Seat 8: chaps1988 folded before Flop (didn't bet)
Seat 9: Eskimo Fox folded before Flop (didn't bet)





PokerStars Hand #155014029845:  Hold'em No Limit ($0.50/$1.00 USD) - 2016/06/21 13:53:23 CET [2016/06/21 7:53:23 ET]
Table 'Umbriel II' 9-max Seat #9 is the button
Seat 1: matiko09 ($148.46 in chips) 
Seat 3: mxustin ($27.25 in chips) 
Seat 4: Eskimo Fox ($106.75 in chips) 
Seat 5: mbk88 ($111.40 in chips) 
Seat 6: stepan0605 ($100 in chips) 
Seat 7: Chen423 ($97.93 in chips) 
Seat 8: Troll8989 ($100 in chips) 
Seat 9: CoolFireX ($125.84 in chips) 
matiko09: posts small blind $0.50
mxustin: posts big blind $1
*** HOLE CARDS ***
Dealt to matiko09 [7s Kd]
Filojoes joins the table at seat #2 
Eskimo Fox: folds 
mbk88: folds 
stepan0605: raises $1 to $2
Chen423: folds 
Troll8989: folds 
CoolFireX: folds 
matiko09: folds 
mxustin: folds 
Uncalled bet ($1) returned to stepan0605
stepan0605 collected $2.50 from pot
stepan0605: doesn't show hand 
*** SUMMARY ***
Total pot $2.50 | Rake $0 
Seat 1: matiko09 (small blind) folded before Flop
Seat 3: mxustin (big blind) folded before Flop
Seat 4: Eskimo Fox folded before Flop (didn't bet)
Seat 5: mbk88 folded before Flop (didn't bet)
Seat 6: stepan0605 collected ($2.50)
Seat 7: Chen423 folded before Flop (didn't bet)
Seat 8: Troll8989 folded before Flop (didn't bet)
Seat 9: CoolFireX (button) folded before Flop (didn't bet)





PokerStars Hand #155014031463:  Hold'em No Limit ($0.50/$1.00 USD) - 2016/06/21 13:53:27 CET [2016/06/21 7:53:27 ET]
Table 'Gryphia' 9-max Seat #7 is the button
Seat 1: Klappspaten0 ($100 in chips) 
Seat 4: King Sixtus ($64.79 in chips) 
Seat 5: pardama ($100 in chips) 
Seat 6: Dandy Monk ($80 in chips) 
Seat 7: solbi86 ($100 in chips) 
Seat 8: matiko09 ($112.93 in chips) 
Seat 9: djammusic ($40 in chips) 
matiko09: posts small blind $0.50
djammusic: posts big blind $1
stepan0605: sits out 
KovIFish89: sits out 
Dandy Monk: posts big blind $1
*** HOLE CARDS ***
Dealt to matiko09 [Tc 3h]
Klappspaten0: folds 
King Sixtus: folds 
pardama: raises $3 to $4
Dandy Monk: folds 
solbi86: calls $4
matiko09: folds 
djammusic: folds 
*** FLOP *** [9s Qh 4s]
pardama: checks 
solbi86: bets $6
pardama: folds 
Uncalled bet ($6) returned to solbi86
solbi86 collected $9.98 from pot
solbi86: doesn't show hand 
*** SUMMARY ***
Total pot $10.50 | Rake $0.52 
Board [9s Qh 4s]
Seat 1: Klappspaten0 folded before Flop (didn't bet)
Seat 4: King Sixtus folded before Flop (didn't bet)
Seat 5: pardama folded on the Flop
Seat 6: Dandy Monk folded before Flop
Seat 7: solbi86 (button) collected ($9.98)
Seat 8: matiko09 (small blind) folded before Flop
Seat 9: djammusic (big blind) folded before Flop





PokerStars Hand #155014033410:  Hold'em No Limit ($0.50/$1.00 USD) - 2016/06/21 13:53:31 CET [2016/06/21 7:53:31 ET]
Table 'Megrez II' 9-max Seat #4 is the button
Seat 1: hurtNCYDE ($101.50 in chips) 
Seat 2: Filojoes ($134.44 in chips) 
Seat 3: Troll8989 ($100 in chips) 
Seat 4: matiko09 ($100 in chips) 
Seat 6: stepan0605 ($100.50 in chips) 
Seat 7: CoolFireX ($139.49 in chips) 
Seat 8: Menno78 ($59.31 in chips) 
Seat 9: MarioDong ($123.81 in chips) 
stepan0605: posts small blind $0.50
CoolFireX: posts big blind $1
*** HOLE CARDS ***
Dealt to matiko09 [5c 3s]
Menno78: folds 
MarioDong: folds 
hurtNCYDE: folds 
Filojoes: folds 
Troll8989: raises $1.50 to $2.50
matiko09: folds 
stepan0605: folds 
CoolFireX: calls $1.50
*** FLOP *** [Ac Kh Td]
pardama joins the table at seat #5 
CoolFireX: checks 
Troll8989: checks 
*** TURN *** [Ac Kh Td] [8c]
CoolFireX: checks 
Troll8989: checks 
*** RIVER *** [Ac Kh Td 8c] [As]
CoolFireX: checks 
Troll8989: bets $3.50
CoolFireX: folds 
Uncalled bet ($3.50) returned to Troll8989
Troll8989 collected $5.22 from pot
Troll8989: doesn't show hand 
*** SUMMARY ***
Total pot $5.50 | Rake $0.28 
Board [Ac Kh Td 8c As]
Seat 1: hurtNCYDE folded before Flop (didn't bet)
Seat 2: Filojoes folded before Flop (didn't bet)
Seat 3: Troll8989 collected ($5.22)
Seat 4: matiko09 (button) folded before Flop (didn't bet)
Seat 6: stepan0605 (small blind) folded before Flop
Seat 7: CoolFireX (big blind) folded on the River
Seat 8: Menno78 folded before Flop (didn't bet)
Seat 9: MarioDong folded before Flop (didn't bet)





PokerStars Hand #155014035045:  Hold'em No Limit ($0.50/$1.00 USD) - 2016/06/21 13:53:35 CET [2016/06/21 7:53:35 ET]
Table 'Lamberta II' 9-max Seat #8 is the button
Seat 1: mbk88 ($175.67 in chips) 
Seat 2: mavin80 ($114.87 in chips) 
Seat 3: matiko09 ($107.68 in chips) 
Seat 4: Eskimo Fox ($118.39 in chips) 
Seat 5: CoolFireX ($107.70 in chips) 
Seat 6: Chen423 ($83.08 in chips) 
Seat 7: 23SmOkEr07 ($191.54 in chips) 
Seat 8: Troll8989 ($100.25 in chips) 
Seat 9: Sjtu_Michael ($99 in chips) 
Sjtu_Michael: posts small blind $0.50
mbk88: posts big blind $1
*** HOLE CARDS ***
Dealt to matiko09 [3c 9c]
mavin80: raises $1.50 to $2.50
matiko09: folds 
Eskimo Fox: folds 
CoolFireX: raises $6.50 to $9
Chen423: folds 
23SmOkEr07: folds 
Troll8989: folds 
Sjtu_Michael: folds 
mbk88: folds 
mavin80: calls $6.50
*** FLOP *** [3s 8c 6d]
mavin80: checks 
CoolFireX: bets $12.50
mavin80: folds 
Uncalled bet ($12.50) returned to CoolFireX
CoolFireX collected $18.52 from pot
CoolFireX: doesn't show hand 
*** SUMMARY ***
Total pot $19.50 | Rake $0.98 
Board [3s 8c 6d]
Seat 1: mbk88 (big blind) folded before Flop
Seat 2: mavin80 folded on the Flop
Seat 3: matiko09 folded before Flop (didn't bet)
Seat 4: Eskimo Fox folded before Flop (didn't bet)
Seat 5: CoolFireX collected ($18.52)
Seat 6: Chen423 folded before Flop (didn't bet)
Seat 7: 23SmOkEr07 folded before Flop (didn't bet)
Seat 8: Troll8989 (button) folded before Flop (didn't bet)
Seat 9: Sjtu_Michael (small blind) folded before Flop





PokerStars Hand #155014038680:  Hold'em No Limit ($0.50/$1.00 USD) - 2016/06/21 13:53:43 CET [2016/06/21 7:53:43 ET]
Table 'Schurer II' 9-max Seat #3 is the button
Seat 1: 50CandyJoe ($100 in chips) 
Seat 2: havenots88 ($98.50 in chips) 
Seat 3: matiko09 ($100 in chips) 
Seat 4: djammusic ($35.25 in chips) 
Seat 5: riggedsh** ($115.78 in chips) 
Seat 6: Dödi123 ($119.39 in chips) 
Seat 7: Avtovo ($110.08 in chips) 
Seat 8: ohneSenf66 ($156 in chips) 
Seat 9: ilaviiitech ($102.25 in chips) 
djammusic: posts small blind $0.50
riggedsh**: posts big blind $1
*** HOLE CARDS ***
Dealt to matiko09 [Ac Kd]
Dödi123: raises $2 to $3
Avtovo: folds 
ohneSenf66: calls $3
ilaviiitech: folds 
50CandyJoe: folds 
havenots88: calls $3
matiko09: raises $10 to $13
djammusic: folds 
riggedsh**: folds 
Dödi123: raises $26 to $39
ohneSenf66: folds 
havenots88: folds 
matiko09: folds 
Uncalled bet ($26) returned to Dödi123
Dödi123 collected $33.50 from pot
Dödi123: doesn't show hand 
*** SUMMARY ***
Total pot $33.50 | Rake $0 
Seat 1: 50CandyJoe folded before Flop (didn't bet)
Seat 2: havenots88 folded before Flop
Seat 3: matiko09 (button) folded before Flop
Seat 4: djammusic (small blind) folded before Flop
Seat 5: riggedsh** (big blind) folded before Flop
Seat 6: Dödi123 collected ($33.50)
Seat 7: Avtovo folded before Flop (didn't bet)
Seat 8: ohneSenf66 folded before Flop
Seat 9: ilaviiitech folded before Flop (didn't bet)





PokerStars Hand #155014039747:  Hold'em No Limit ($0.50/$1.00 USD) - 2016/06/21 13:53:46 CET [2016/06/21 7:53:46 ET]
Table 'Pemba' 9-max Seat #2 is the button
Seat 1: pardama ($102.50 in chips) 
Seat 2: Dantist1122 ($100 in chips) 
Seat 3: CoolFireX ($367.90 in chips) 
Seat 4: frut12 ($116.36 in chips) 
Seat 6: matiko09 ($110.60 in chips) 
Seat 8: chaps1988 ($100 in chips) 
Seat 9: Eskimo Fox ($100 in chips) 
CoolFireX: posts small blind $0.50
frut12: posts big blind $1
djammusic: sits out 
mi$$I$Elena: sits out 
*** HOLE CARDS ***
Dealt to matiko09 [9h 5d]
matiko09: folds 
chaps1988: folds 
Eskimo Fox: folds 
pardama: folds 
Dantist1122: raises $2 to $3
CoolFireX: calls $2.50
frut12: folds 
*** FLOP *** [2s 4h 5h]
CoolFireX: checks 
Dantist1122: checks 
*** TURN *** [2s 4h 5h] [Tc]
CoolFireX: bets $4.50
Dantist1122: folds 
Uncalled bet ($4.50) returned to CoolFireX
CoolFireX collected $6.65 from pot
CoolFireX: doesn't show hand 
*** SUMMARY ***
Total pot $7 | Rake $0.35 
Board [2s 4h 5h Tc]
Seat 1: pardama folded before Flop (didn't bet)
Seat 2: Dantist1122 (button) folded on the Turn
Seat 3: CoolFireX (small blind) collected ($6.65)
Seat 4: frut12 (big blind) folded before Flop
Seat 6: matiko09 folded before Flop (didn't bet)
Seat 8: chaps1988 folded before Flop (didn't bet)
Seat 9: Eskimo Fox folded before Flop (didn't bet)





PokerStars Hand #155014042036:  Hold'em No Limit ($0.50/$1.00 USD) - 2016/06/21 13:53:51 CET [2016/06/21 7:53:51 ET]
Table 'Umbriel II' 9-max Seat #1 is the button
Seat 1: matiko09 ($147.96 in chips) 
Seat 3: mxustin ($26.25 in chips) 
Seat 4: Eskimo Fox ($106.75 in chips) 
Seat 5: mbk88 ($111.40 in chips) 
Seat 6: stepan0605 ($101.50 in chips) 
Seat 7: Chen423 ($97.93 in chips) 
Seat 8: Troll8989 ($100 in chips) 
Seat 9: CoolFireX ($125.84 in chips) 
Filojoes will be allowed to play after the button
mxustin: posts small blind $0.50
Eskimo Fox: posts big blind $1
*** HOLE CARDS ***
Dealt to matiko09 [Kh 7s]
mbk88: folds 
stepan0605: folds 
Chen423: raises $2 to $3
Troll8989: folds 
CoolFireX: folds 
matiko09: folds 
mxustin: folds 
Eskimo Fox: folds 
Uncalled bet ($2) returned to Chen423
Chen423 collected $2.50 from pot
Chen423: doesn't show hand 
*** SUMMARY ***
Total pot $2.50 | Rake $0 
Seat 1: matiko09 (button) folded before Flop (didn't bet)
Seat 3: mxustin (small blind) folded before Flop
Seat 4: Eskimo Fox (big blind) folded before Flop
Seat 5: mbk88 folded before Flop (didn't bet)
Seat 6: stepan0605 folded before Flop (didn't bet)
Seat 7: Chen423 collected ($2.50)
Seat 8: Troll8989 folded before Flop (didn't bet)
Seat 9: CoolFireX folded before Flop (didn't bet)





PokerStars Hand #155014044748:  Hold'em No Limit ($0.50/$1.00 USD) - 2016/06/21 13:53:57 CET [2016/06/21 7:53:57 ET]
Table 'Moreau' 9-max Seat #9 is the button
Seat 2: Avtovo ($106 in chips) 
Seat 3: matiko09 ($100 in chips) 
Seat 4: SharingaaN ($163.30 in chips) 
Seat 5: CoolFireX ($100 in chips) 
Seat 6: Troll8989 ($100 in chips) 
Seat 7: PanKwn15 ($106.40 in chips) 
Seat 8: mi$$I$Elena ($105 in chips) 
Seat 9: Toonersens ($114.84 in chips) 
hurtNCYDE will be allowed to play after the button
Avtovo: posts small blind $0.50
matiko09: posts big blind $1
*** HOLE CARDS ***
Dealt to matiko09 [7d 6d]
SharingaaN: folds 
CoolFireX: folds 
Troll8989: raises $1.50 to $2.50
PanKwn15: calls $2.50
mi$$I$Elena: folds 
Toonersens: folds 
Avtovo: folds 
matiko09: calls $1.50
*** FLOP *** [Jd Qs As]
matiko09: checks 
Troll8989: checks 
PanKwn15: checks 
*** TURN *** [Jd Qs As] [6s]
matiko09: checks 
Troll8989: bets $4
PanKwn15: folds 
matiko09: folds 
Uncalled bet ($4) returned to Troll8989
Troll8989 collected $7.60 from pot
Troll8989: doesn't show hand 
*** SUMMARY ***
Total pot $8 | Rake $0.40 
Board [Jd Qs As 6s]
Seat 2: Avtovo (small blind) folded before Flop
Seat 3: matiko09 (big blind) folded on the Turn
Seat 4: SharingaaN folded before Flop (didn't bet)
Seat 5: CoolFireX folded before Flop (didn't bet)
Seat 6: Troll8989 collected ($7.60)
Seat 7: PanKwn15 folded on the Turn
Seat 8: mi$$I$Elena folded before Flop (didn't bet)
Seat 9: Toonersens (button) folded before Flop (didn't bet)





PokerStars Hand #155014051625:  Hold'em No Limit ($0.50/$1.00 USD) - 2016/06/21 13:54:13 CET [2016/06/21 7:54:13 ET]
Table 'Gryphia' 9-max Seat #8 is the button
Seat 1: Klappspaten0 ($100 in chips) 
Seat 4: King Sixtus ($64.79 in chips) 
Seat 5: pardama ($100 in chips) 
Seat 6: Dandy Monk ($79 in chips) 
Seat 7: solbi86 ($105.98 in chips) 
Seat 8: matiko09 ($112.43 in chips) 
Seat 9: djammusic ($39 in chips) 
djammusic: posts small blind $0.50
Klappspaten0: posts big blind $1
stepan0605: sits out 
KovIFish89: sits out 
*** HOLE CARDS ***
Dealt to matiko09 [Kh 4h]
King Sixtus: raises $1.50 to $2.50
pardama: folds 
Dandy Monk: folds 
solbi86: folds 
matiko09: folds 
djammusic: folds 
Klappspaten0: calls $1.50
*** FLOP *** [Kd 3s Qd]
Klappspaten0: checks 
King Sixtus: bets $3.48
Klappspaten0: folds 
Uncalled bet ($3.48) returned to King Sixtus
King Sixtus collected $5.22 from pot
King Sixtus: doesn't show hand 
*** SUMMARY ***
Total pot $5.50 | Rake $0.28 
Board [Kd 3s Qd]
Seat 1: Klappspaten0 (big blind) folded on the Flop
Seat 4: King Sixtus collected ($5.22)
Seat 5: pardama folded before Flop (didn't bet)
Seat 6: Dandy Monk folded before Flop (didn't bet)
Seat 7: solbi86 folded before Flop (didn't bet)
Seat 8: matiko09 (button) folded before Flop (didn't bet)
Seat 9: djammusic (small blind) folded before Flop





PokerStars Hand #155014055414:  Hold'em No Limit ($0.50/$1.00 USD) - 2016/06/21 13:54:21 CET [2016/06/21 7:54:21 ET]
Table 'Schurer II' 9-max Seat #4 is the button
Seat 1: 50CandyJoe ($100 in chips) 
Seat 2: havenots88 ($95.50 in chips) 
Seat 3: matiko09 ($100 in chips) 
Seat 4: djammusic ($40 in chips) 
Seat 5: riggedsh** ($114.78 in chips) 
Seat 6: Dödi123 ($139.89 in chips) 
Seat 7: Avtovo ($110.08 in chips) 
Seat 8: ohneSenf66 ($153 in chips) 
Seat 9: ilaviiitech ($102.25 in chips) 
riggedsh**: posts small blind $0.50
Dödi123: posts big blind $1
*** HOLE CARDS ***
Dealt to matiko09 [Ts Kh]
Avtovo: folds 
ohneSenf66: folds 
ilaviiitech: folds 
50CandyJoe: folds 
havenots88: folds 
matiko09: raises $1.50 to $2.50
djammusic: folds 
riggedsh**: folds 
Dödi123: folds 
Uncalled bet ($1.50) returned to matiko09
matiko09 collected $2.50 from pot
matiko09: doesn't show hand 
*** SUMMARY ***
Total pot $2.50 | Rake $0 
Seat 1: 50CandyJoe folded before Flop (didn't bet)
Seat 2: havenots88 folded before Flop (didn't bet)
Seat 3: matiko09 collected ($2.50)
Seat 4: djammusic (button) folded before Flop (didn't bet)
Seat 5: riggedsh** (small blind) folded before Flop
Seat 6: Dödi123 (big blind) folded before Flop
Seat 7: Avtovo folded before Flop (didn't bet)
Seat 8: ohneSenf66 folded before Flop (didn't bet)
Seat 9: ilaviiitech folded before Flop (didn't bet)





PokerStars Hand #155014058028:  Hold'em No Limit ($0.50/$1.00 USD) - 2016/06/21 13:54:27 CET [2016/06/21 7:54:27 ET]
Table 'Umbriel II' 9-max Seat #3 is the button
Seat 1: matiko09 ($147.96 in chips) 
Seat 3: mxustin ($25.75 in chips) 
Seat 4: Eskimo Fox ($105.75 in chips) 
Seat 5: mbk88 ($111.40 in chips) 
Seat 6: stepan0605 ($101.50 in chips) 
Seat 7: Chen423 ($99.43 in chips) 
Seat 8: Troll8989 ($100 in chips) 
Seat 9: CoolFireX ($125.84 in chips) 
Eskimo Fox: posts small blind $0.50
mbk88: posts big blind $1
Filojoes: sits out 
*** HOLE CARDS ***
Dealt to matiko09 [Ts Qs]
stepan0605: folds 
Chen423: folds 
Troll8989: folds 
CoolFireX: folds 
matiko09: raises $1.50 to $2.50
mxustin: folds 
Eskimo Fox: folds 
mbk88: folds 
Uncalled bet ($1.50) returned to matiko09
matiko09 collected $2.50 from pot
matiko09: doesn't show hand 
*** SUMMARY ***
Total pot $2.50 | Rake $0 
Seat 1: matiko09 collected ($2.50)
Seat 3: mxustin (button) folded before Flop (didn't bet)
Seat 4: Eskimo Fox (small blind) folded before Flop
Seat 5: mbk88 (big blind) folded before Flop
Seat 6: stepan0605 folded before Flop (didn't bet)
Seat 7: Chen423 folded before Flop (didn't bet)
Seat 8: Troll8989 folded before Flop (didn't bet)
Seat 9: CoolFireX folded before Flop (didn't bet)





PokerStars Hand #155014063371:  Hold'em No Limit ($0.50/$1.00 USD) - 2016/06/21 13:54:39 CET [2016/06/21 7:54:39 ET]
Table 'Gryphia' 9-max Seat #9 is the button
Seat 1: Klappspaten0 ($100 in chips) 
Seat 2: stepan0605 ($100 in chips) 
Seat 4: King Sixtus ($67.51 in chips) 
Seat 5: pardama ($100 in chips) 
Seat 6: Dandy Monk ($79 in chips) 
Seat 7: solbi86 ($105.98 in chips) 
Seat 8: matiko09 ($112.43 in chips) 
Seat 9: djammusic ($38.50 in chips) 
Klappspaten0: posts small blind $0.50
stepan0605: posts big blind $1
KovIFish89: sits out 
*** HOLE CARDS ***
Dealt to matiko09 [6c Ks]
King Sixtus: folds 
pardama: folds 
Dandy Monk: raises $1.80 to $2.80
solbi86: folds 
matiko09: folds 
djammusic: raises $4.70 to $7.50
Klappspaten0: folds 
stepan0605: folds 
Dandy Monk: folds 
Uncalled bet ($4.70) returned to djammusic
djammusic collected $7.10 from pot
djammusic: doesn't show hand 
*** SUMMARY ***
Total pot $7.10 | Rake $0 
Seat 1: Klappspaten0 (small blind) folded before Flop
Seat 2: stepan0605 (big blind) folded before Flop
Seat 4: King Sixtus folded before Flop (didn't bet)
Seat 5: pardama folded before Flop (didn't bet)
Seat 6: Dandy Monk folded before Flop
Seat 7: solbi86 folded before Flop (didn't bet)
Seat 8: matiko09 folded before Flop (didn't bet)
Seat 9: djammusic (button) collected ($7.10)





PokerStars Hand #155014067663:  Hold'em No Limit ($0.50/$1.00 USD) - 2016/06/21 13:54:49 CET [2016/06/21 7:54:49 ET]
Table 'Schurer II' 9-max Seat #5 is the button
Seat 1: 50CandyJoe ($100 in chips) 
Seat 2: havenots88 ($95.50 in chips) 
Seat 3: matiko09 ($101.50 in chips) 
Seat 4: djammusic ($40 in chips) 
Seat 5: riggedsh** ($114.28 in chips) 
Seat 6: Dödi123 ($138.89 in chips) 
Seat 7: Avtovo ($110.08 in chips) 
Seat 8: ohneSenf66 ($153 in chips) 
Seat 9: ilaviiitech ($102.25 in chips) 
Dödi123: posts small blind $0.50
Avtovo: posts big blind $1
*** HOLE CARDS ***
Dealt to matiko09 [Qc 5d]
ohneSenf66: raises $2 to $3
ilaviiitech: folds 
50CandyJoe: folds 
havenots88: calls $3
matiko09: folds 
djammusic: folds 
riggedsh**: folds 
Dödi123: folds 
Avtovo: folds 
*** FLOP *** [8h 2s 2c]
ohneSenf66: checks 
havenots88: checks 
*** TURN *** [8h 2s 2c] [Qd]
ohneSenf66: bets $3.56
havenots88: folds 
Uncalled bet ($3.56) returned to ohneSenf66
ohneSenf66 collected $7.12 from pot
ohneSenf66: doesn't show hand 
*** SUMMARY ***
Total pot $7.50 | Rake $0.38 
Board [8h 2s 2c Qd]
Seat 1: 50CandyJoe folded before Flop (didn't bet)
Seat 2: havenots88 folded on the Turn
Seat 3: matiko09 folded before Flop (didn't bet)
Seat 4: djammusic folded before Flop (didn't bet)
Seat 5: riggedsh** (button) folded before Flop (didn't bet)
Seat 6: Dödi123 (small blind) folded before Flop
Seat 7: Avtovo (big blind) folded before Flop
Seat 8: ohneSenf66 collected ($7.12)
Seat 9: ilaviiitech folded before Flop (didn't bet)





PokerStars Hand #155014067848:  Hold'em No Limit (€0.50/€1.00 EUR) - 2016/06/21 13:54:50 CET [2016/06/21 7:54:50 ET]
Table 'Tauris III' 6-max Seat #2 is the button
Seat 1: morc1us (€100 in chips) 
Seat 2: devil1964 (€107.97 in chips) 
Seat 3: BronKKAA (€114.32 in chips) 
Seat 4: Gigi201133 (€119.36 in chips) 
Seat 5: parraka_210 (€100 in chips) 
Seat 6: matiko09 (€101.50 in chips) 
BronKKAA: posts small blind €0.50
Gigi201133: posts big blind €1
*** HOLE CARDS ***
Dealt to matiko09 [9c Kc]
parraka_210: folds 
matiko09: raises €2 to €3
morc1us: folds 
devil1964: folds 
BronKKAA: folds 
Gigi201133: folds 
Uncalled bet (€2) returned to matiko09
matiko09 collected €2.50 from pot
matiko09: doesn't show hand 
*** SUMMARY ***
Total pot €2.50 | Rake €0 
Seat 1: morc1us folded before Flop (didn't bet)
Seat 2: devil1964 (button) folded before Flop (didn't bet)
Seat 3: BronKKAA (small blind) folded before Flop
Seat 4: Gigi201133 (big blind) folded before Flop
Seat 5: parraka_210 folded before Flop (didn't bet)
Seat 6: matiko09 collected (€2.50)





PokerStars Hand #155014071407:  Hold'em No Limit ($0.50/$1.00 USD) - 2016/06/21 13:54:58 CET [2016/06/21 7:54:58 ET]
Table 'Moreau' 9-max Seat #2 is the button
Seat 2: Avtovo ($105.50 in chips) 
Seat 3: matiko09 ($100 in chips) 
Seat 4: SharingaaN ($163.30 in chips) 
Seat 5: CoolFireX ($100 in chips) 
Seat 6: Troll8989 ($105.10 in chips) 
Seat 7: PanKwn15 ($103.90 in chips) 
Seat 8: mi$$I$Elena ($105 in chips) 
Seat 9: Toonersens ($114.84 in chips) 
matiko09: posts small blind $0.50
SharingaaN: posts big blind $1
hurtNCYDE: sits out 
*** HOLE CARDS ***
Dealt to matiko09 [Td Jh]
CoolFireX: folds 
Troll8989: folds 
PanKwn15: raises $1 to $2
mi$$I$Elena: folds 
Toonersens: folds 
Avtovo: folds 
matiko09: folds 
SharingaaN: folds 
Uncalled bet ($1) returned to PanKwn15
PanKwn15 collected $2.50 from pot
PanKwn15: doesn't show hand 
*** SUMMARY ***
Total pot $2.50 | Rake $0 
Seat 2: Avtovo (button) folded before Flop (didn't bet)
Seat 3: matiko09 (small blind) folded before Flop
Seat 4: SharingaaN (big blind) folded before Flop
Seat 5: CoolFireX folded before Flop (didn't bet)
Seat 6: Troll8989 folded before Flop (didn't bet)
Seat 7: PanKwn15 collected ($2.50)
Seat 8: mi$$I$Elena folded before Flop (didn't bet)
Seat 9: Toonersens folded before Flop (didn't bet)





PokerStars Hand #155014074811:  Hold'em No Limit ($0.50/$1.00 USD) - 2016/06/21 13:55:05 CET [2016/06/21 7:55:05 ET]
Table 'Umbriel II' 9-max Seat #4 is the button
Seat 1: matiko09 ($149.46 in chips) 
Seat 3: mxustin ($25.75 in chips) 
Seat 4: Eskimo Fox ($105.25 in chips) 
Seat 5: mbk88 ($110.40 in chips) 
Seat 6: stepan0605 ($101.50 in chips) 
Seat 7: Chen423 ($99.43 in chips) 
Seat 8: Troll8989 ($100 in chips) 
Seat 9: CoolFireX ($125.84 in chips) 
mbk88: posts small blind $0.50
stepan0605: posts big blind $1
Filojoes: sits out 
*** HOLE CARDS ***
Dealt to matiko09 [8h 9h]
Chen423: folds 
Troll8989: folds 
CoolFireX: folds 
matiko09: raises $2 to $3
mxustin: folds 
Eskimo Fox: folds 
mbk88: folds 
stepan0605: raises $7 to $10
matiko09: folds 
Uncalled bet ($7) returned to stepan0605
stepan0605 collected $6.50 from pot
stepan0605: doesn't show hand 
*** SUMMARY ***
Total pot $6.50 | Rake $0 
Seat 1: matiko09 folded before Flop
Seat 3: mxustin folded before Flop (didn't bet)
Seat 4: Eskimo Fox (button) folded before Flop (didn't bet)
Seat 5: mbk88 (small blind) folded before Flop
Seat 6: stepan0605 (big blind) collected ($6.50)
Seat 7: Chen423 folded before Flop (didn't bet)
Seat 8: Troll8989 folded before Flop (didn't bet)
Seat 9: CoolFireX folded before Flop (didn't bet)





PokerStars Hand #155014075052:  Hold'em No Limit ($0.50/$1.00 USD) - 2016/06/21 13:55:06 CET [2016/06/21 7:55:06 ET]
Table 'Lamberta II' 9-max Seat #9 is the button
Seat 1: mbk88 ($174.67 in chips) 
Seat 2: mavin80 ($105.87 in chips) 
Seat 3: matiko09 ($107.68 in chips) 
Seat 4: Eskimo Fox ($118.39 in chips) 
Seat 5: CoolFireX ($117.22 in chips) 
Seat 6: Chen423 ($83.08 in chips) 
Seat 7: 23SmOkEr07 ($191.54 in chips) 
Seat 8: Troll8989 ($100.25 in chips) 
Seat 9: Sjtu_Michael ($98.50 in chips) 
mbk88: posts small blind $0.50
mavin80: posts big blind $1
*** HOLE CARDS ***
Dealt to matiko09 [5s 6s]
matiko09: folds 
Eskimo Fox: folds 
CoolFireX: raises $2 to $3
Chen423: calls $3
23SmOkEr07: raises $10 to $13
Troll8989: folds 
Sjtu_Michael is disconnected 
Sjtu_Michael is connected 
Sjtu_Michael has timed out
Sjtu_Michael: folds 
mbk88: folds 
mavin80: folds 
CoolFireX: folds 
Chen423: folds 
Uncalled bet ($10) returned to 23SmOkEr07
23SmOkEr07 collected $10.50 from pot
23SmOkEr07: doesn't show hand 
*** SUMMARY ***
Total pot $10.50 | Rake $0 
Seat 1: mbk88 (small blind) folded before Flop
Seat 2: mavin80 (big blind) folded before Flop
Seat 3: matiko09 folded before Flop (didn't bet)
Seat 4: Eskimo Fox folded before Flop (didn't bet)
Seat 5: CoolFireX folded before Flop
Seat 6: Chen423 folded before Flop
Seat 7: 23SmOkEr07 collected ($10.50)
Seat 8: Troll8989 folded before Flop (didn't bet)
Seat 9: Sjtu_Michael (button) folded before Flop (didn't bet)





PokerStars Hand #155014075465:  Hold'em No Limit ($0.50/$1.00 USD) - 2016/06/21 13:55:07 CET [2016/06/21 7:55:07 ET]
Table 'Pemba' 9-max Seat #3 is the button
Seat 1: pardama ($102.50 in chips) 
Seat 2: Dantist1122 ($100 in chips) 
Seat 3: CoolFireX ($371.55 in chips) 
Seat 4: frut12 ($115.36 in chips) 
Seat 5: djammusic ($40 in chips) 
Seat 6: matiko09 ($110.60 in chips) 
Seat 8: chaps1988 ($100 in chips) 
Seat 9: Eskimo Fox ($100 in chips) 
frut12: posts small blind $0.50
djammusic: posts big blind $1
mi$$I$Elena: sits out 
*** HOLE CARDS ***
Dealt to matiko09 [6d Kd]
matiko09: folds 
chaps1988: folds 
Eskimo Fox: folds 
pardama: folds 
Dantist1122: raises $1.70 to $2.70
CoolFireX: calls $2.70
frut12: folds 
djammusic: raises $7.30 to $10
Dantist1122: folds 
CoolFireX: folds 
Uncalled bet ($7.30) returned to djammusic
djammusic collected $8.60 from pot
djammusic: doesn't show hand 
*** SUMMARY ***
Total pot $8.60 | Rake $0 
Seat 1: pardama folded before Flop (didn't bet)
Seat 2: Dantist1122 folded before Flop
Seat 3: CoolFireX (button) folded before Flop
Seat 4: frut12 (small blind) folded before Flop
Seat 5: djammusic (big blind) collected ($8.60)
Seat 6: matiko09 folded before Flop (didn't bet)
Seat 8: chaps1988 folded before Flop (didn't bet)
Seat 9: Eskimo Fox folded before Flop (didn't bet)





PokerStars Hand #155014076078:  Hold'em No Limit (€0.25/€0.50 EUR) - 2016/06/21 13:55:08 CET [2016/06/21 7:55:08 ET]
Table 'Actor II' 6-max Seat #1 is the button
Seat 1: hmverlin (€83.39 in chips) 
Seat 2: alôha (€73.43 in chips) 
Seat 3: TopMo3UJlo (€50.82 in chips) 
Seat 4: matiko09 (€80.55 in chips) 
Seat 5: AlexPles (€50 in chips) 
Seat 6: fanmtZ (€20 in chips) 
alôha: posts small blind €0.25
TopMo3UJlo: posts big blind €0.50
*** HOLE CARDS ***
Dealt to matiko09 [7c 2d]
matiko09: folds 
AlexPles: folds 
fanmtZ: folds 
hmverlin: folds 
hmverlin leaves the table
alôha: raises €1 to €1.50
TopMo3UJlo: calls €1
*** FLOP *** [5s 8s 8c]
alôha: checks 
TopMo3UJlo: checks 
*** TURN *** [5s 8s 8c] [3d]
alôha: checks 
TopMo3UJlo: checks 
*** RIVER *** [5s 8s 8c 3d] [5d]
alôha: bets €1
TopMo3UJlo: calls €1
*** SHOW DOWN ***
alôha: shows [Ah Td] (two pair, Eights and Fives)
TopMo3UJlo: shows [Ac 2s] (two pair, Eights and Fives)
alôha collected €2.38 from pot
TopMo3UJlo collected €2.37 from pot
*** SUMMARY ***
Total pot €5 | Rake €0.25 
Board [5s 8s 8c 3d 5d]
Seat 1: hmverlin (button) folded before Flop (didn't bet)
Seat 2: alôha (small blind) showed [Ah Td] and won (€2.38) with two pair, Eights and Fives
Seat 3: TopMo3UJlo (big blind) showed [Ac 2s] and won (€2.37) with two pair, Eights and Fives
Seat 4: matiko09 folded before Flop (didn't bet)
Seat 5: AlexPles folded before Flop (didn't bet)
Seat 6: fanmtZ folded before Flop (didn't bet)





PokerStars Hand #155014078335:  Hold'em No Limit ($0.50/$1.00 USD) - 2016/06/21 13:55:14 CET [2016/06/21 7:55:14 ET]
Table 'Megrez II' 9-max Seat #6 is the button
Seat 1: hurtNCYDE ($101.50 in chips) 
Seat 2: Filojoes ($134.44 in chips) 
Seat 3: Troll8989 ($102.72 in chips) 
Seat 4: matiko09 ($100 in chips) 
Seat 6: stepan0605 ($100 in chips) 
Seat 7: CoolFireX ($136.99 in chips) 
Seat 8: Menno78 ($59.31 in chips) 
Seat 9: MarioDong ($123.81 in chips) 
CoolFireX: posts small blind $0.50
Menno78: posts big blind $1
pardama: sits out 
*** HOLE CARDS ***
Dealt to matiko09 [Ad Ks]
MarioDong: folds 
hurtNCYDE: raises $1.50 to $2.50
Filojoes: folds 
Troll8989: folds 
matiko09: raises $6.50 to $9
stepan0605: folds 
CoolFireX: folds 
Menno78: folds 
hurtNCYDE: calls $6.50
*** FLOP *** [9s 3s Td]
hurtNCYDE: checks 
matiko09: bets $10
hurtNCYDE: calls $10
*** TURN *** [9s 3s Td] [Jh]
hurtNCYDE: checks 
matiko09: checks 
*** RIVER *** [9s 3s Td Jh] [5d]
hurtNCYDE: bets $45.50
matiko09: folds 
Uncalled bet ($45.50) returned to hurtNCYDE
hurtNCYDE collected $37.52 from pot
*** SUMMARY ***
Total pot $39.50 | Rake $1.98 
Board [9s 3s Td Jh 5d]
Seat 1: hurtNCYDE collected ($37.52)
Seat 2: Filojoes folded before Flop (didn't bet)
Seat 3: Troll8989 folded before Flop (didn't bet)
Seat 4: matiko09 folded on the River
Seat 6: stepan0605 (button) folded before Flop (didn't bet)
Seat 7: CoolFireX (small blind) folded before Flop
Seat 8: Menno78 (big blind) folded before Flop
Seat 9: MarioDong folded before Flop (didn't bet)





PokerStars Hand #155014082257:  Hold'em No Limit ($0.50/$1.00 USD) - 2016/06/21 13:55:24 CET [2016/06/21 7:55:24 ET]
Table 'Schurer II' 9-max Seat #6 is the button
Seat 1: 50CandyJoe ($100 in chips) 
Seat 2: havenots88 ($92.50 in chips) 
Seat 3: matiko09 ($101.50 in chips) 
Seat 4: djammusic ($40 in chips) 
Seat 5: riggedsh** ($114.28 in chips) 
Seat 6: Dödi123 ($138.39 in chips) 
Seat 7: Avtovo ($109.08 in chips) 
Seat 8: ohneSenf66 ($157.12 in chips) 
Seat 9: ilaviiitech ($102.25 in chips) 
Avtovo: posts small blind $0.50
ohneSenf66: posts big blind $1
*** HOLE CARDS ***
Dealt to matiko09 [Ac Jd]
ilaviiitech: raises $2 to $3
50CandyJoe: calls $3
havenots88: folds 
matiko09: folds 
djammusic: folds 
riggedsh**: folds 
Dödi123: calls $3
Avtovo: folds 
ohneSenf66: calls $2
*** FLOP *** [3c Th 2d]
ohneSenf66: checks 
ilaviiitech: checks 
50CandyJoe: checks 
Dödi123: checks 
*** TURN *** [3c Th 2d] [3d]
ohneSenf66: bets $5.94
ilaviiitech: folds 
50CandyJoe: folds 
Dödi123: folds 
Uncalled bet ($5.94) returned to ohneSenf66
ohneSenf66 collected $11.88 from pot
ohneSenf66: doesn't show hand 
*** SUMMARY ***
Total pot $12.50 | Rake $0.62 
Board [3c Th 2d 3d]
Seat 1: 50CandyJoe folded on the Turn
Seat 2: havenots88 folded before Flop (didn't bet)
Seat 3: matiko09 folded before Flop (didn't bet)
Seat 4: djammusic folded before Flop (didn't bet)
Seat 5: riggedsh** folded before Flop (didn't bet)
Seat 6: Dödi123 (button) folded on the Turn
Seat 7: Avtovo (small blind) folded before Flop
Seat 8: ohneSenf66 (big blind) collected ($11.88)
Seat 9: ilaviiitech folded on the Turn





PokerStars Hand #155014084536:  Hold'em No Limit ($0.50/$1.00 USD) - 2016/06/21 13:55:30 CET [2016/06/21 7:55:30 ET]
Table 'Moreau' 9-max Seat #3 is the button
Seat 2: Avtovo ($105.50 in chips) 
Seat 3: matiko09 ($100 in chips) 
Seat 4: SharingaaN ($162.30 in chips) 
Seat 5: CoolFireX ($100 in chips) 
Seat 6: Troll8989 ($105.10 in chips) 
Seat 7: PanKwn15 ($105.40 in chips) 
Seat 8: mi$$I$Elena ($105 in chips) 
Seat 9: Toonersens ($114.84 in chips) 
SharingaaN: posts small blind $0.50
CoolFireX: posts big blind $1
hurtNCYDE: sits out 
*** HOLE CARDS ***
Dealt to matiko09 [8d 6c]
Troll8989: folds 
PanKwn15: folds 
mi$$I$Elena: folds 
Toonersens: folds 
Avtovo: folds 
matiko09: folds 
SharingaaN: raises $2 to $3
CoolFireX: folds 
Uncalled bet ($2) returned to SharingaaN
SharingaaN collected $2 from pot
SharingaaN: doesn't show hand 
*** SUMMARY ***
Total pot $2 | Rake $0 
Seat 2: Avtovo folded before Flop (didn't bet)
Seat 3: matiko09 (button) folded before Flop (didn't bet)
Seat 4: SharingaaN (small blind) collected ($2)
Seat 5: CoolFireX (big blind) folded before Flop
Seat 6: Troll8989 folded before Flop (didn't bet)
Seat 7: PanKwn15 folded before Flop (didn't bet)
Seat 8: mi$$I$Elena folded before Flop (didn't bet)
Seat 9: Toonersens folded before Flop (didn't bet)





PokerStars Hand #155014084753:  Hold'em No Limit ($0.50/$1.00 USD) - 2016/06/21 13:55:30 CET [2016/06/21 7:55:30 ET]
Table 'Gryphia' 9-max Seat #1 is the button
Seat 1: Klappspaten0 ($100 in chips) 
Seat 2: stepan0605 ($100 in chips) 
Seat 3: KovIFish89 ($100 in chips) 
Seat 4: King Sixtus ($67.51 in chips) 
Seat 5: pardama ($100 in chips) 
Seat 6: Dandy Monk ($76.20 in chips) 
Seat 7: solbi86 ($105.98 in chips) 
Seat 8: matiko09 ($112.43 in chips) 
Seat 9: djammusic ($42.80 in chips) 
stepan0605: posts small blind $0.50
KovIFish89: posts big blind $1
*** HOLE CARDS ***
Dealt to matiko09 [Qs Jh]
King Sixtus: folds 
pardama: raises $2 to $3
Dandy Monk: folds 
solbi86: folds 
matiko09: folds 
djammusic: folds 
Klappspaten0: calls $3
stepan0605: folds 
KovIFish89: folds 
*** FLOP *** [2c 2h Ac]
pardama: bets $3.85
Klappspaten0: calls $3.85
*** TURN *** [2c 2h Ac] [6c]
pardama: checks 
Klappspaten0: bets $10
pardama: folds 
Uncalled bet ($10) returned to Klappspaten0
Klappspaten0 collected $14.44 from pot
Klappspaten0: doesn't show hand 
*** SUMMARY ***
Total pot $15.20 | Rake $0.76 
Board [2c 2h Ac 6c]
Seat 1: Klappspaten0 (button) collected ($14.44)
Seat 2: stepan0605 (small blind) folded before Flop
Seat 3: KovIFish89 (big blind) folded before Flop
Seat 4: King Sixtus folded before Flop (didn't bet)
Seat 5: pardama folded on the Turn
Seat 6: Dandy Monk folded before Flop (didn't bet)
Seat 7: solbi86 folded before Flop (didn't bet)
Seat 8: matiko09 folded before Flop (didn't bet)
Seat 9: djammusic folded before Flop (didn't bet)





PokerStars Hand #155014085729:  Hold'em No Limit (€0.50/€1.00 EUR) - 2016/06/21 13:55:33 CET [2016/06/21 7:55:33 ET]
Table 'Tauris III' 6-max Seat #3 is the button
Seat 1: morc1us (€100 in chips) 
Seat 2: devil1964 (€107.97 in chips) 
Seat 3: BronKKAA (€113.82 in chips) 
Seat 4: Gigi201133 (€118.36 in chips) 
Seat 5: parraka_210 (€100 in chips) 
Seat 6: matiko09 (€103 in chips) 
Gigi201133: posts small blind €0.50
parraka_210: posts big blind €1
*** HOLE CARDS ***
Dealt to matiko09 [8s Ks]
matiko09: folds 
morc1us: folds 
devil1964: folds 
BronKKAA: raises €1.28 to €2.28
Gigi201133: folds 
parraka_210: raises €5.22 to €7.50
BronKKAA: folds 
Uncalled bet (€5.22) returned to parraka_210
parraka_210 collected €5.06 from pot
parraka_210: doesn't show hand 
*** SUMMARY ***
Total pot €5.06 | Rake €0 
Seat 1: morc1us folded before Flop (didn't bet)
Seat 2: devil1964 folded before Flop (didn't bet)
Seat 3: BronKKAA (button) folded before Flop
Seat 4: Gigi201133 (small blind) folded before Flop
Seat 5: parraka_210 (big blind) collected (€5.06)
Seat 6: matiko09 folded before Flop (didn't bet)





PokerStars Hand #155014092750:  Hold'em No Limit ($0.50/$1.00 USD) - 2016/06/21 13:55:51 CET [2016/06/21 7:55:51 ET]
Table 'Pemba' 9-max Seat #4 is the button
Seat 1: pardama ($102.50 in chips) 
Seat 2: Dantist1122 ($100 in chips) 
Seat 3: CoolFireX ($368.85 in chips) 
Seat 4: frut12 ($114.86 in chips) 
Seat 5: djammusic ($45.90 in chips) 
Seat 6: matiko09 ($110.60 in chips) 
Seat 8: chaps1988 ($100 in chips) 
Seat 9: Eskimo Fox ($100 in chips) 
djammusic: posts small blind $0.50
matiko09: posts big blind $1
mi$$I$Elena: sits out 
*** HOLE CARDS ***
Dealt to matiko09 [4d Jc]
chaps1988: folds 
Eskimo Fox: folds 
pardama: folds 
Dantist1122: folds 
CoolFireX: folds 
frut12: folds 
djammusic: raises $1.25 to $2.25
matiko09: folds 
Uncalled bet ($1.25) returned to djammusic
djammusic collected $2 from pot
djammusic: doesn't show hand 
*** SUMMARY ***
Total pot $2 | Rake $0 
Seat 1: pardama folded before Flop (didn't bet)
Seat 2: Dantist1122 folded before Flop (didn't bet)
Seat 3: CoolFireX folded before Flop (didn't bet)
Seat 4: frut12 (button) folded before Flop (didn't bet)
Seat 5: djammusic (small blind) collected ($2)
Seat 6: matiko09 (big blind) folded before Flop
Seat 8: chaps1988 folded before Flop (didn't bet)
Seat 9: Eskimo Fox folded before Flop (didn't bet)





PokerStars Hand #155014095525:  Hold'em No Limit ($0.50/$1.00 USD) - 2016/06/21 13:55:58 CET [2016/06/21 7:55:58 ET]
Table 'Umbriel II' 9-max Seat #5 is the button
Seat 1: matiko09 ($146.46 in chips) 
Seat 3: mxustin ($25.75 in chips) 
Seat 4: Eskimo Fox ($105.25 in chips) 
Seat 5: mbk88 ($109.90 in chips) 
Seat 6: stepan0605 ($105 in chips) 
Seat 7: Chen423 ($99.43 in chips) 
Seat 8: Troll8989 ($100 in chips) 
Seat 9: CoolFireX ($125.84 in chips) 
stepan0605: posts small blind $0.50
Chen423: posts big blind $1
Filojoes: sits out 
*** HOLE CARDS ***
Dealt to matiko09 [6h 4c]
Troll8989: folds 
CoolFireX: folds 
matiko09: folds 
mxustin: folds 
Eskimo Fox: folds 
mbk88: raises $1 to $2
stepan0605: folds 
Chen423: calls $1
*** FLOP *** [Ad 4s Qc]
Chen423: checks 
mbk88: checks 
*** TURN *** [Ad 4s Qc] [4h]
Chen423: checks 
mbk88: bets $2
Chen423: folds 
Uncalled bet ($2) returned to mbk88
mbk88 collected $4.28 from pot
mbk88: doesn't show hand 
*** SUMMARY ***
Total pot $4.50 | Rake $0.22 
Board [Ad 4s Qc 4h]
Seat 1: matiko09 folded before Flop (didn't bet)
Seat 3: mxustin folded before Flop (didn't bet)
Seat 4: Eskimo Fox folded before Flop (didn't bet)
Seat 5: mbk88 (button) collected ($4.28)
Seat 6: stepan0605 (small blind) folded before Flop
Seat 7: Chen423 (big blind) folded on the Turn
Seat 8: Troll8989 folded before Flop (didn't bet)
Seat 9: CoolFireX folded before Flop (didn't bet)





PokerStars Hand #155014095687:  Hold'em No Limit (€0.50/€1.00 EUR) - 2016/06/21 13:55:59 CET [2016/06/21 7:55:59 ET]
Table 'Tauris III' 6-max Seat #4 is the button
Seat 1: morc1us (€100 in chips) 
Seat 2: devil1964 (€107.97 in chips) 
Seat 3: BronKKAA (€111.54 in chips) 
Seat 4: Gigi201133 (€117.86 in chips) 
Seat 5: parraka_210 (€102.78 in chips) 
Seat 6: matiko09 (€103 in chips) 
parraka_210: posts small blind €0.50
matiko09: posts big blind €1
*** HOLE CARDS ***
Dealt to matiko09 [8d 9s]
morc1us: folds 
devil1964: folds 
BronKKAA: raises €1.50 to €2.50
Gigi201133: folds 
parraka_210: folds 
matiko09: folds 
Uncalled bet (€1.50) returned to BronKKAA
BronKKAA collected €2.50 from pot
BronKKAA: doesn't show hand 
*** SUMMARY ***
Total pot €2.50 | Rake €0 
Seat 1: morc1us folded before Flop (didn't bet)
Seat 2: devil1964 folded before Flop (didn't bet)
Seat 3: BronKKAA collected (€2.50)
Seat 4: Gigi201133 (button) folded before Flop (didn't bet)
Seat 5: parraka_210 (small blind) folded before Flop
Seat 6: matiko09 (big blind) folded before Flop





PokerStars Hand #155014098949:  Hold'em No Limit ($0.50/$1.00 USD) - 2016/06/21 13:56:07 CET [2016/06/21 7:56:07 ET]
Table 'Moreau' 9-max Seat #4 is the button
Seat 2: Avtovo ($105.50 in chips) 
Seat 3: matiko09 ($100 in chips) 
Seat 4: SharingaaN ($163.30 in chips) 
Seat 5: CoolFireX ($100 in chips) 
Seat 6: Troll8989 ($105.10 in chips) 
Seat 7: PanKwn15 ($105.40 in chips) 
Seat 8: mi$$I$Elena ($105 in chips) 
Seat 9: Toonersens ($114.84 in chips) 
CoolFireX: posts small blind $0.50
Troll8989: posts big blind $1
hurtNCYDE: sits out 
*** HOLE CARDS ***
Dealt to matiko09 [Qd 4d]
PanKwn15: folds 
mi$$I$Elena: folds 
Toonersens: folds 
Avtovo: raises $1.50 to $2.50
matiko09: folds 
SharingaaN: folds 
CoolFireX: folds 
Troll8989: folds 
Uncalled bet ($1.50) returned to Avtovo
Avtovo collected $2.50 from pot
Avtovo: doesn't show hand 
*** SUMMARY ***
Total pot $2.50 | Rake $0 
Seat 2: Avtovo collected ($2.50)
Seat 3: matiko09 folded before Flop (didn't bet)
Seat 4: SharingaaN (button) folded before Flop (didn't bet)
Seat 5: CoolFireX (small blind) folded before Flop
Seat 6: Troll8989 (big blind) folded before Flop
Seat 7: PanKwn15 folded before Flop (didn't bet)
Seat 8: mi$$I$Elena folded before Flop (didn't bet)
Seat 9: Toonersens folded before Flop (didn't bet)





PokerStars Hand #155014105341:  Hold'em No Limit ($0.50/$1.00 USD) - 2016/06/21 13:56:24 CET [2016/06/21 7:56:24 ET]
Table 'Pemba' 9-max Seat #5 is the button
Seat 1: pardama ($102.50 in chips) 
Seat 2: Dantist1122 ($100 in chips) 
Seat 3: CoolFireX ($368.85 in chips) 
Seat 4: frut12 ($114.86 in chips) 
Seat 5: djammusic ($46.90 in chips) 
Seat 6: matiko09 ($109.60 in chips) 
Seat 7: mi$$I$Elena ($100 in chips) 
Seat 8: chaps1988 ($100 in chips) 
Seat 9: Eskimo Fox ($100 in chips) 
matiko09: posts small blind $0.50
mi$$I$Elena: posts big blind $1
*** HOLE CARDS ***
Dealt to matiko09 [3s Th]
chaps1988: folds 
Eskimo Fox: folds 
pardama: folds 
Dantist1122: folds 
CoolFireX: folds 
frut12: folds 
djammusic: raises $1.02 to $2.02
matiko09: folds 
mi$$I$Elena: raises $3.98 to $6
djammusic: folds 
Uncalled bet ($3.98) returned to mi$$I$Elena
mi$$I$Elena collected $4.54 from pot
mi$$I$Elena: doesn't show hand 
*** SUMMARY ***
Total pot $4.54 | Rake $0 
Seat 1: pardama folded before Flop (didn't bet)
Seat 2: Dantist1122 folded before Flop (didn't bet)
Seat 3: CoolFireX folded before Flop (didn't bet)
Seat 4: frut12 folded before Flop (didn't bet)
Seat 5: djammusic (button) folded before Flop
Seat 6: matiko09 (small blind) folded before Flop
Seat 7: mi$$I$Elena (big blind) collected ($4.54)
Seat 8: chaps1988 folded before Flop (didn't bet)
Seat 9: Eskimo Fox folded before Flop (didn't bet)





PokerStars Hand #155014105696:  Hold'em No Limit (€0.50/€1.00 EUR) - 2016/06/21 13:56:25 CET [2016/06/21 7:56:25 ET]
Table 'Tauris III' 6-max Seat #5 is the button
Seat 1: morc1us (€100 in chips) 
Seat 2: devil1964 (€107.97 in chips) 
Seat 3: BronKKAA (€113.04 in chips) 
Seat 4: Gigi201133 (€117.86 in chips) 
Seat 5: parraka_210 (€102.28 in chips) 
Seat 6: matiko09 (€102 in chips) 
matiko09: posts small blind €0.50
morc1us: posts big blind €1
*** HOLE CARDS ***
Dealt to matiko09 [5d Jc]
devil1964: folds 
BronKKAA: raises €1.78 to €2.78
Gigi201133: calls €2.78
parraka_210: folds 
matiko09: folds 
morc1us: folds 
*** FLOP *** [2d 3c 9s]
BronKKAA: bets €3.35
Gigi201133: calls €3.35
*** TURN *** [2d 3c 9s] [Ts]
BronKKAA: bets €10.45
Gigi201133: folds 
Uncalled bet (€10.45) returned to BronKKAA
BronKKAA collected €13.07 from pot
BronKKAA: doesn't show hand 
*** SUMMARY ***
Total pot €13.76 | Rake €0.69 
Board [2d 3c 9s Ts]
Seat 1: morc1us (big blind) folded before Flop
Seat 2: devil1964 folded before Flop (didn't bet)
Seat 3: BronKKAA collected (€13.07)
Seat 4: Gigi201133 folded on the Turn
Seat 5: parraka_210 (button) folded before Flop (didn't bet)
Seat 6: matiko09 (small blind) folded before Flop





PokerStars Hand #155014106362:  Hold'em No Limit ($0.50/$1.00 USD) - 2016/06/21 13:56:26 CET [2016/06/21 7:56:26 ET]
Table 'Schurer II' 9-max Seat #7 is the button
Seat 1: 50CandyJoe ($100 in chips) 
Seat 2: havenots88 ($92.50 in chips) 
Seat 3: matiko09 ($101.50 in chips) 
Seat 4: djammusic ($40 in chips) 
Seat 5: riggedsh** ($114.28 in chips) 
Seat 6: Dödi123 ($135.39 in chips) 
Seat 7: Avtovo ($108.58 in chips) 
Seat 8: ohneSenf66 ($166 in chips) 
ohneSenf66: posts small blind $0.50
ilaviiitech: is sitting out 
50CandyJoe: posts big blind $1
*** HOLE CARDS ***
Dealt to matiko09 [Ac Kd]
havenots88: folds 
ilaviiitech leaves the table
matiko09: raises $2 to $3
djammusic: folds 
riggedsh**: folds 
Dödi123: folds 
Avtovo: folds 
ohneSenf66: calls $2.50
Donetsk1y joins the table at seat #9 
50CandyJoe: folds 
*** FLOP *** [Js 6c 8c]
ohneSenf66: checks 
matiko09: bets $4
ohneSenf66: folds 
Uncalled bet ($4) returned to matiko09
matiko09 collected $6.65 from pot
matiko09: doesn't show hand 
*** SUMMARY ***
Total pot $7 | Rake $0.35 
Board [Js 6c 8c]
Seat 1: 50CandyJoe (big blind) folded before Flop
Seat 2: havenots88 folded before Flop (didn't bet)
Seat 3: matiko09 collected ($6.65)
Seat 4: djammusic folded before Flop (didn't bet)
Seat 5: riggedsh** folded before Flop (didn't bet)
Seat 6: Dödi123 folded before Flop (didn't bet)
Seat 7: Avtovo (button) folded before Flop (didn't bet)
Seat 8: ohneSenf66 (small blind) folded on the Flop





PokerStars Hand #155014107185:  Hold'em No Limit (€0.25/€0.50 EUR) - 2016/06/21 13:56:29 CET [2016/06/21 7:56:29 ET]
Table 'Actor II' 6-max Seat #2 is the button
Seat 2: alôha (€73.31 in chips) 
Seat 3: TopMo3UJlo (€50.69 in chips) 
Seat 4: matiko09 (€80.55 in chips) 
Seat 5: AlexPles (€50 in chips) 
Seat 6: fanmtZ (€20 in chips) 
TopMo3UJlo: posts small blind €0.25
matiko09: posts big blind €0.50
*** HOLE CARDS ***
Dealt to matiko09 [Ah 9c]
AlexPles: folds 
fanmtZ: folds 
alôha: folds 
bustafc joins the table at seat #1 
TopMo3UJlo: folds 
Uncalled bet (€0.25) returned to matiko09
matiko09 collected €0.50 from pot
matiko09: doesn't show hand 
*** SUMMARY ***
Total pot €0.50 | Rake €0 
Seat 2: alôha (button) folded before Flop (didn't bet)
Seat 3: TopMo3UJlo (small blind) folded before Flop
Seat 4: matiko09 (big blind) collected (€0.50)
Seat 5: AlexPles folded before Flop (didn't bet)
Seat 6: fanmtZ folded before Flop (didn't bet)





PokerStars Hand #155014108713:  Hold'em No Limit ($0.50/$1.00 USD) - 2016/06/21 13:56:33 CET [2016/06/21 7:56:33 ET]
Table 'Gryphia' 9-max Seat #2 is the button
Seat 1: Klappspaten0 ($107.59 in chips) 
Seat 2: stepan0605 ($100 in chips) 
Seat 3: KovIFish89 ($100 in chips) 
Seat 4: King Sixtus ($67.51 in chips) 
Seat 5: pardama ($100 in chips) 
Seat 6: Dandy Monk ($76.20 in chips) 
Seat 7: solbi86 ($105.98 in chips) 
Seat 8: matiko09 ($112.43 in chips) 
Seat 9: djammusic ($42.80 in chips) 
KovIFish89: posts small blind $0.50
King Sixtus: posts big blind $1
*** HOLE CARDS ***
Dealt to matiko09 [Qh Js]
pardama: folds 
Dandy Monk: folds 
solbi86: folds 
matiko09: folds 
djammusic: folds 
Klappspaten0: raises $2 to $3
stepan0605: folds 
KovIFish89: raises $7.50 to $10.50
King Sixtus: folds 
Klappspaten0: calls $7.50
*** FLOP *** [7h 6c Kc]
KovIFish89: bets $10.50
Klappspaten0: folds 
Uncalled bet ($10.50) returned to KovIFish89
KovIFish89 collected $20.90 from pot
KovIFish89: doesn't show hand 
*** SUMMARY ***
Total pot $22 | Rake $1.10 
Board [7h 6c Kc]
Seat 1: Klappspaten0 folded on the Flop
Seat 2: stepan0605 (button) folded before Flop (didn't bet)
Seat 3: KovIFish89 (small blind) collected ($20.90)
Seat 4: King Sixtus (big blind) folded before Flop
Seat 5: pardama folded before Flop (didn't bet)
Seat 6: Dandy Monk folded before Flop (didn't bet)
Seat 7: solbi86 folded before Flop (didn't bet)
Seat 8: matiko09 folded before Flop (didn't bet)
Seat 9: djammusic folded before Flop (didn't bet)





PokerStars Hand #155014112626:  Hold'em No Limit ($0.50/$1.00 USD) - 2016/06/21 13:56:43 CET [2016/06/21 7:56:43 ET]
Table 'Lamberta II' 9-max Seat #1 is the button
Seat 1: mbk88 ($174.17 in chips) 
Seat 2: mavin80 ($104.87 in chips) 
Seat 3: matiko09 ($107.68 in chips) 
Seat 4: Eskimo Fox ($118.39 in chips) 
Seat 5: CoolFireX ($114.22 in chips) 
Seat 6: Chen423 ($80.08 in chips) 
Seat 7: 23SmOkEr07 ($199.04 in chips) 
Seat 8: Troll8989 ($100.25 in chips) 
mavin80: posts small blind $0.50
matiko09: posts big blind $1
*** HOLE CARDS ***
Dealt to matiko09 [6s 4c]
Eskimo Fox: folds 
CoolFireX: folds 
Chen423: raises $2 to $3
23SmOkEr07: folds 
Troll8989: folds 
mbk88: folds 
mavin80: calls $2.50
matiko09: folds 
*** FLOP *** [Td 9s 5d]
mavin80: bets $4
Chen423: calls $4
*** TURN *** [Td 9s 5d] [Qh]
mavin80: bets $9
Chen423: calls $9
*** RIVER *** [Td 9s 5d Qh] [5s]
mavin80: bets $18.24
Chen423: calls $18.24
*** SHOW DOWN ***
mavin80: shows [Js Th] (two pair, Tens and Fives)
Chen423: shows [Kd Qc] (two pair, Queens and Fives)
Chen423 collected $66.98 from pot
*** SUMMARY ***
Total pot $69.48 | Rake $2.50 
Board [Td 9s 5d Qh 5s]
Seat 1: mbk88 (button) folded before Flop (didn't bet)
Seat 2: mavin80 (small blind) showed [Js Th] and lost with two pair, Tens and Fives
Seat 3: matiko09 (big blind) folded before Flop
Seat 4: Eskimo Fox folded before Flop (didn't bet)
Seat 5: CoolFireX folded before Flop (didn't bet)
Seat 6: Chen423 showed [Kd Qc] and won ($66.98) with two pair, Queens and Fives
Seat 7: 23SmOkEr07 folded before Flop (didn't bet)
Seat 8: Troll8989 folded before Flop (didn't bet)





PokerStars Hand #155014115894:  Hold'em No Limit ($0.50/$1.00 USD) - 2016/06/21 13:56:51 CET [2016/06/21 7:56:51 ET]
Table 'Schurer II' 9-max Seat #8 is the button
Seat 1: 50CandyJoe ($100 in chips) 
Seat 2: havenots88 ($92.50 in chips) 
Seat 3: matiko09 ($105.15 in chips) 
Seat 4: djammusic ($40 in chips) 
Seat 5: riggedsh** ($114.28 in chips) 
Seat 6: Dödi123 ($135.39 in chips) 
Seat 7: Avtovo ($108.58 in chips) 
Seat 8: ohneSenf66 ($163 in chips) 
Donetsk1y will be allowed to play after the button
50CandyJoe: posts small blind $0.50
havenots88: posts big blind $1
*** HOLE CARDS ***
Dealt to matiko09 [Kc 8s]
matiko09: folds 
djammusic: folds 
riggedsh**: folds 
Dödi123: folds 
Avtovo: folds 
ohneSenf66: raises $2 to $3
50CandyJoe: folds 
havenots88: calls $2
*** FLOP *** [7h 6h 5h]
havenots88: checks 
ohneSenf66: bets $3.09
havenots88: folds 
Uncalled bet ($3.09) returned to ohneSenf66
ohneSenf66 collected $6.18 from pot
ohneSenf66: doesn't show hand 
*** SUMMARY ***
Total pot $6.50 | Rake $0.32 
Board [7h 6h 5h]
Seat 1: 50CandyJoe (small blind) folded before Flop
Seat 2: havenots88 (big blind) folded on the Flop
Seat 3: matiko09 folded before Flop (didn't bet)
Seat 4: djammusic folded before Flop (didn't bet)
Seat 5: riggedsh** folded before Flop (didn't bet)
Seat 6: Dödi123 folded before Flop (didn't bet)
Seat 7: Avtovo folded before Flop (didn't bet)
Seat 8: ohneSenf66 (button) collected ($6.18)





PokerStars Hand #155014116006:  Hold'em No Limit ($0.50/$1.00 USD) - 2016/06/21 13:56:51 CET [2016/06/21 7:56:51 ET]
Table 'Megrez II' 9-max Seat #7 is the button
Seat 1: hurtNCYDE ($120.02 in chips) 
Seat 2: Filojoes ($134.44 in chips) 
Seat 3: Troll8989 ($102.72 in chips) 
Seat 4: matiko09 ($100 in chips) 
Seat 6: stepan0605 ($100 in chips) 
Seat 7: CoolFireX ($136.49 in chips) 
Seat 8: Menno78 ($58.31 in chips) 
Seat 9: MarioDong ($123.81 in chips) 
Menno78: posts small blind $0.50
MarioDong: posts big blind $1
pardama: sits out 
*** HOLE CARDS ***
Dealt to matiko09 [Qc 7h]
hurtNCYDE: folds 
Filojoes: folds 
Troll8989: folds 
matiko09: folds 
stepan0605: raises $1.50 to $2.50
CoolFireX: folds 
Menno78: calls $2
MarioDong: calls $1.50
*** FLOP *** [7c 3s Ad]
Menno78: checks 
MarioDong: checks 
stepan0605: bets $4
Menno78: calls $4
MarioDong: folds 
*** TURN *** [7c 3s Ad] [2c]
Menno78: checks 
stepan0605: bets $10
Menno78: calls $10
*** RIVER *** [7c 3s Ad 2c] [8s]
Menno78: checks 
stepan0605: bets $16.86
Menno78: raises $24.95 to $41.81 and is all-in
stepan0605: folds 
Uncalled bet ($24.95) returned to Menno78
Menno78 collected $66.72 from pot
Menno78: doesn't show hand 
*** SUMMARY ***
Total pot $69.22 | Rake $2.50 
Board [7c 3s Ad 2c 8s]
Seat 1: hurtNCYDE folded before Flop (didn't bet)
Seat 2: Filojoes folded before Flop (didn't bet)
Seat 3: Troll8989 folded before Flop (didn't bet)
Seat 4: matiko09 folded before Flop (didn't bet)
Seat 6: stepan0605 folded on the River
Seat 7: CoolFireX (button) folded before Flop (didn't bet)
Seat 8: Menno78 (small blind) collected ($66.72)
Seat 9: MarioDong (big blind) folded on the Flop





PokerStars Hand #155014120238:  Hold'em No Limit ($0.50/$1.00 USD) - 2016/06/21 13:57:02 CET [2016/06/21 7:57:02 ET]
Table 'Umbriel II' 9-max Seat #6 is the button
Seat 1: matiko09 ($146.46 in chips) 
Seat 3: mxustin ($25.75 in chips) 
Seat 4: Eskimo Fox ($105.25 in chips) 
Seat 5: mbk88 ($112.18 in chips) 
Seat 6: stepan0605 ($104.50 in chips) 
Seat 7: Chen423 ($97.43 in chips) 
Seat 8: Troll8989 ($100 in chips) 
Seat 9: CoolFireX ($125.84 in chips) 
Chen423: posts small blind $0.50
Troll8989: posts big blind $1
Filojoes: sits out 
*** HOLE CARDS ***
Dealt to matiko09 [2h 4h]
CoolFireX: folds 
matiko09: folds 
mxustin: folds 
Eskimo Fox: raises $1.50 to $2.50
mbk88: folds 
stepan0605: folds 
Chen423: folds 
Troll8989: calls $1.50
*** FLOP *** [9h Js Ts]
Troll8989: checks 
Eskimo Fox: checks 
*** TURN *** [9h Js Ts] [3d]
Troll8989: bets $3.50
Eskimo Fox: raises $9.50 to $13
Troll8989: folds 
Uncalled bet ($9.50) returned to Eskimo Fox
Eskimo Fox collected $11.88 from pot
Eskimo Fox: doesn't show hand 
*** SUMMARY ***
Total pot $12.50 | Rake $0.62 
Board [9h Js Ts 3d]
Seat 1: matiko09 folded before Flop (didn't bet)
Seat 3: mxustin folded before Flop (didn't bet)
Seat 4: Eskimo Fox collected ($11.88)
Seat 5: mbk88 folded before Flop (didn't bet)
Seat 6: stepan0605 (button) folded before Flop (didn't bet)
Seat 7: Chen423 (small blind) folded before Flop
Seat 8: Troll8989 (big blind) folded on the Turn
Seat 9: CoolFireX folded before Flop (didn't bet)





PokerStars Hand #155014120257:  Hold'em No Limit (€0.25/€0.50 EUR) - 2016/06/21 13:57:02 CET [2016/06/21 7:57:02 ET]
Table 'Actor II' 6-max Seat #3 is the button
Seat 2: alôha (€73.31 in chips) 
Seat 3: TopMo3UJlo (€50.44 in chips) 
Seat 4: matiko09 (€80.80 in chips) 
Seat 5: AlexPles (€50 in chips) 
Seat 6: fanmtZ (€20 in chips) 
matiko09: posts small blind €0.25
AlexPles: posts big blind €0.50
bustafc: sits out 
*** HOLE CARDS ***
Dealt to matiko09 [Td 5d]
fanmtZ: folds 
alôha: folds 
TopMo3UJlo: folds 
matiko09: folds 
Uncalled bet (€0.25) returned to AlexPles
AlexPles collected €0.50 from pot
AlexPles: doesn't show hand 
*** SUMMARY ***
Total pot €0.50 | Rake €0 
Seat 2: alôha folded before Flop (didn't bet)
Seat 3: TopMo3UJlo (button) folded before Flop (didn't bet)
Seat 4: matiko09 (small blind) folded before Flop
Seat 5: AlexPles (big blind) collected (€0.50)
Seat 6: fanmtZ folded before Flop (didn't bet)





PokerStars Hand #155014120832:  Hold'em No Limit ($0.50/$1.00 USD) - 2016/06/21 13:57:04 CET [2016/06/21 7:57:04 ET]
Table 'Moreau' 9-max Seat #5 is the button
Seat 2: Avtovo ($107 in chips) 
Seat 3: matiko09 ($100 in chips) 
Seat 4: SharingaaN ($163.30 in chips) 
Seat 5: CoolFireX ($100 in chips) 
Seat 6: Troll8989 ($104.10 in chips) 
Seat 7: PanKwn15 ($105.40 in chips) 
Seat 8: mi$$I$Elena ($105 in chips) 
Seat 9: Toonersens ($114.84 in chips) 
Troll8989: posts small blind $0.50
PanKwn15: posts big blind $1
hurtNCYDE: sits out 
*** HOLE CARDS ***
Dealt to matiko09 [8s Ks]
mi$$I$Elena: raises $1.38 to $2.38
Toonersens: folds 
Avtovo: folds 
matiko09: folds 
SharingaaN: folds 
CoolFireX: folds 
Troll8989: folds 
PanKwn15: calls $1.38
*** FLOP *** [5d 2h 7c]
PanKwn15: checks 
mi$$I$Elena: bets $3.50
PanKwn15: folds 
Uncalled bet ($3.50) returned to mi$$I$Elena
mi$$I$Elena collected $5 from pot
mi$$I$Elena: doesn't show hand 
*** SUMMARY ***
Total pot $5.26 | Rake $0.26 
Board [5d 2h 7c]
Seat 2: Avtovo folded before Flop (didn't bet)
Seat 3: matiko09 folded before Flop (didn't bet)
Seat 4: SharingaaN folded before Flop (didn't bet)
Seat 5: CoolFireX (button) folded before Flop (didn't bet)
Seat 6: Troll8989 (small blind) folded before Flop
Seat 7: PanKwn15 (big blind) folded on the Flop
Seat 8: mi$$I$Elena collected ($5)
Seat 9: Toonersens folded before Flop (didn't bet)





PokerStars Hand #155014121876:  Hold'em No Limit ($0.50/$1.00 USD) - 2016/06/21 13:57:06 CET [2016/06/21 7:57:06 ET]
Table 'Pemba' 9-max Seat #6 is the button
Seat 1: pardama ($102.50 in chips) 
Seat 2: Dantist1122 ($100 in chips) 
Seat 3: CoolFireX ($368.85 in chips) 
Seat 4: frut12 ($114.86 in chips) 
Seat 5: djammusic ($44.88 in chips) 
Seat 6: matiko09 ($109.10 in chips) 
Seat 7: mi$$I$Elena ($102.52 in chips) 
Seat 8: chaps1988 ($100 in chips) 
Seat 9: Eskimo Fox ($100 in chips) 
mi$$I$Elena: posts small blind $0.50
chaps1988: posts big blind $1
*** HOLE CARDS ***
Dealt to matiko09 [5c 7d]
Eskimo Fox: raises $2 to $3
pardama: folds 
Dantist1122: folds 
CoolFireX: folds 
frut12: calls $3
djammusic: folds 
matiko09: folds 
mi$$I$Elena: folds 
chaps1988: folds 
*** FLOP *** [Ks 9c 5d]
Eskimo Fox: checks 
frut12: bets $5
Eskimo Fox: folds 
Uncalled bet ($5) returned to frut12
frut12 collected $7.12 from pot
*** SUMMARY ***
Total pot $7.50 | Rake $0.38 
Board [Ks 9c 5d]
Seat 1: pardama folded before Flop (didn't bet)
Seat 2: Dantist1122 folded before Flop (didn't bet)
Seat 3: CoolFireX folded before Flop (didn't bet)
Seat 4: frut12 collected ($7.12)
Seat 5: djammusic folded before Flop (didn't bet)
Seat 6: matiko09 (button) folded before Flop (didn't bet)
Seat 7: mi$$I$Elena (small blind) folded before Flop
Seat 8: chaps1988 (big blind) folded before Flop
Seat 9: Eskimo Fox folded on the Flop





PokerStars Hand #155014126598:  Hold'em No Limit ($0.50/$1.00 USD) - 2016/06/21 13:57:18 CET [2016/06/21 7:57:18 ET]
Table 'Amundsenia' 9-max Seat #1 is the button
Seat 1: 50CandyJoe ($136.78 in chips) 
Seat 2: Avtovo ($107.06 in chips) 
Seat 3: matiko09 ($100 in chips) 
Seat 4: typename27 ($20.29 in chips) 
Seat 6: King_ZéManel ($136.13 in chips) 
Seat 7: Eskimo Fox ($104 in chips) 
Seat 8: DomiVY ($49.32 in chips) 
Seat 9: MrSeymen ($48.36 in chips) 
Avtovo: posts small blind $0.50
matiko09: posts big blind $1
*** HOLE CARDS ***
Dealt to matiko09 [2h Jd]
typename27: folds 
King_ZéManel: folds 
Eskimo Fox: folds 
DomiVY: folds 
MrSeymen: folds 
50CandyJoe: folds 
Avtovo: raises $1.50 to $2.50
matiko09: folds 
Uncalled bet ($1.50) returned to Avtovo
Avtovo collected $2 from pot
Avtovo: doesn't show hand 
*** SUMMARY ***
Total pot $2 | Rake $0 
Seat 1: 50CandyJoe (button) folded before Flop (didn't bet)
Seat 2: Avtovo (small blind) collected ($2)
Seat 3: matiko09 (big blind) folded before Flop
Seat 4: typename27 folded before Flop (didn't bet)
Seat 6: King_ZéManel folded before Flop (didn't bet)
Seat 7: Eskimo Fox folded before Flop (didn't bet)
Seat 8: DomiVY folded before Flop (didn't bet)
Seat 9: MrSeymen folded before Flop (didn't bet)





PokerStars Hand #155014126976:  Hold'em No Limit ($0.50/$1.00 USD) - 2016/06/21 13:57:19 CET [2016/06/21 7:57:19 ET]
Table 'Schurer II' 9-max Seat #1 is the button
Seat 1: 50CandyJoe ($100 in chips) 
Seat 2: havenots88 ($89.50 in chips) 
Seat 3: matiko09 ($105.15 in chips) 
Seat 4: djammusic ($40 in chips) 
Seat 5: riggedsh** ($114.28 in chips) 
Seat 6: Dödi123 ($135.39 in chips) 
Seat 7: Avtovo ($108.58 in chips) 
Seat 8: ohneSenf66 ($166.18 in chips) 
havenots88: posts small blind $0.50
matiko09: posts big blind $1
Donetsk1y: sits out 
*** HOLE CARDS ***
Dealt to matiko09 [3h 6c]
djammusic: folds 
djammusic leaves the table
riggedsh**: folds 
Dödi123: folds 
Avtovo: folds 
ohneSenf66: folds 
50CandyJoe: raises $1 to $2
havenots88: folds 
matiko09: folds 
Uncalled bet ($1) returned to 50CandyJoe
50CandyJoe collected $2.50 from pot
50CandyJoe: doesn't show hand 
*** SUMMARY ***
Total pot $2.50 | Rake $0 
Seat 1: 50CandyJoe (button) collected ($2.50)
Seat 2: havenots88 (small blind) folded before Flop
Seat 3: matiko09 (big blind) folded before Flop
Seat 4: djammusic folded before Flop (didn't bet)
Seat 5: riggedsh** folded before Flop (didn't bet)
Seat 6: Dödi123 folded before Flop (didn't bet)
Seat 7: Avtovo folded before Flop (didn't bet)
Seat 8: ohneSenf66 folded before Flop (didn't bet)





PokerStars Hand #155014131841:  Hold'em No Limit (€0.25/€0.50 EUR) - 2016/06/21 13:57:32 CET [2016/06/21 7:57:32 ET]
Table 'Actor II' 6-max Seat #4 is the button
Seat 2: alôha (€73.31 in chips) 
Seat 3: TopMo3UJlo (€50.44 in chips) 
Seat 4: matiko09 (€80.55 in chips) 
Seat 5: AlexPles (€50.25 in chips) 
Seat 6: fanmtZ (€20 in chips) 
AlexPles: posts small blind €0.25
fanmtZ: posts big blind €0.50
bustafc: sits out 
*** HOLE CARDS ***
Dealt to matiko09 [9c Jh]
alôha: folds 
TopMo3UJlo: raises €0.75 to €1.25
matiko09: folds 
AlexPles: folds 
bustafc leaves the table
fanmtZ: calls €0.75
*** FLOP *** [5c 6h 8s]
fanmtZ: checks 
TopMo3UJlo: checks 
*** TURN *** [5c 6h 8s] [8h]
fanmtZ: checks 
TopMo3UJlo: checks 
*** RIVER *** [5c 6h 8s 8h] [5d]
NoHeroHUD joins the table at seat #1 
fanmtZ: bets €1.81
TopMo3UJlo: folds 
Uncalled bet (€1.81) returned to fanmtZ
fanmtZ collected €2.61 from pot
fanmtZ: doesn't show hand 
*** SUMMARY ***
Total pot €2.75 | Rake €0.14 
Board [5c 6h 8s 8h 5d]
Seat 2: alôha folded before Flop (didn't bet)
Seat 3: TopMo3UJlo folded on the River
Seat 4: matiko09 (button) folded before Flop (didn't bet)
Seat 5: AlexPles (small blind) folded before Flop
Seat 6: fanmtZ (big blind) collected (€2.61)





PokerStars Hand #155014134665:  Hold'em No Limit ($0.50/$1.00 USD) - 2016/06/21 13:57:39 CET [2016/06/21 7:57:39 ET]
Table 'Schurer II' 9-max Seat #2 is the button
Seat 1: 50CandyJoe ($101.50 in chips) 
Seat 2: havenots88 ($89 in chips) 
Seat 3: matiko09 ($104.15 in chips) 
Seat 5: riggedsh** ($114.28 in chips) 
Seat 6: Dödi123 ($135.39 in chips) 
Seat 7: Avtovo ($108.58 in chips) 
Seat 8: ohneSenf66 ($166.18 in chips) 
matiko09: posts small blind $0.50
riggedsh**: posts big blind $1
Donetsk1y: sits out 
*** HOLE CARDS ***
Dealt to matiko09 [Tc 7s]
Dödi123: folds 
Avtovo: folds 
ohneSenf66: folds 
50CandyJoe: folds 
havenots88: raises $2 to $3
matiko09: folds 
riggedsh**: folds 
Uncalled bet ($2) returned to havenots88
havenots88 collected $2.50 from pot
havenots88: doesn't show hand 
*** SUMMARY ***
Total pot $2.50 | Rake $0 
Seat 1: 50CandyJoe folded before Flop (didn't bet)
Seat 2: havenots88 (button) collected ($2.50)
Seat 3: matiko09 (small blind) folded before Flop
Seat 5: riggedsh** (big blind) folded before Flop
Seat 6: Dödi123 folded before Flop (didn't bet)
Seat 7: Avtovo folded before Flop (didn't bet)
Seat 8: ohneSenf66 folded before Flop (didn't bet)





PokerStars Hand #155014134714:  Hold'em No Limit ($0.50/$1.00 USD) - 2016/06/21 13:57:39 CET [2016/06/21 7:57:39 ET]
Table 'Gryphia' 9-max Seat #3 is the button
Seat 1: Klappspaten0 ($100 in chips) 
Seat 2: stepan0605 ($100 in chips) 
Seat 3: KovIFish89 ($110.40 in chips) 
Seat 4: King Sixtus ($66.51 in chips) 
Seat 5: pardama ($100 in chips) 
Seat 6: Dandy Monk ($76.20 in chips) 
Seat 7: solbi86 ($105.98 in chips) 
Seat 8: matiko09 ($112.43 in chips) 
Seat 9: djammusic ($42.80 in chips) 
King Sixtus: posts small blind $0.50
pardama: posts big blind $1
*** HOLE CARDS ***
Dealt to matiko09 [Jd 3h]
Dandy Monk: raises $3 to $4
solbi86: folds 
matiko09: folds 
djammusic: folds 
Klappspaten0: folds 
stepan0605: folds 
KovIFish89: folds 
King Sixtus: folds 
pardama: folds 
Uncalled bet ($3) returned to Dandy Monk
Dandy Monk collected $2.50 from pot
Dandy Monk: doesn't show hand 
*** SUMMARY ***
Total pot $2.50 | Rake $0 
Seat 1: Klappspaten0 folded before Flop (didn't bet)
Seat 2: stepan0605 folded before Flop (didn't bet)
Seat 3: KovIFish89 (button) folded before Flop (didn't bet)
Seat 4: King Sixtus (small blind) folded before Flop
Seat 5: pardama (big blind) folded before Flop
Seat 6: Dandy Monk collected ($2.50)
Seat 7: solbi86 folded before Flop (didn't bet)
Seat 8: matiko09 folded before Flop (didn't bet)
Seat 9: djammusic folded before Flop (didn't bet)





PokerStars Hand #155014134882:  Hold'em No Limit (€0.50/€1.00 EUR) - 2016/06/21 13:57:40 CET [2016/06/21 7:57:40 ET]
Table 'Tauris III' 6-max Seat #6 is the button
Seat 1: morc1us (€100 in chips) 
Seat 2: devil1964 (€107.97 in chips) 
Seat 3: BronKKAA (€119.98 in chips) 
Seat 4: Gigi201133 (€111.73 in chips) 
Seat 5: parraka_210 (€102.28 in chips) 
Seat 6: matiko09 (€101.50 in chips) 
morc1us: posts small blind €0.50
devil1964: posts big blind €1
*** HOLE CARDS ***
Dealt to matiko09 [6c Kc]
BronKKAA: folds 
Gigi201133: folds 
parraka_210: folds 
matiko09: raises €1.27 to €2.27
morc1us: folds 
devil1964: calls €1.27
*** FLOP *** [Ks 7d 6d]
devil1964: checks 
matiko09: bets €3.45
devil1964: folds 
Uncalled bet (€3.45) returned to matiko09
matiko09 collected €4.79 from pot
matiko09: doesn't show hand 
*** SUMMARY ***
Total pot €5.04 | Rake €0.25 
Board [Ks 7d 6d]
Seat 1: morc1us (small blind) folded before Flop
Seat 2: devil1964 (big blind) folded on the Flop
Seat 3: BronKKAA folded before Flop (didn't bet)
Seat 4: Gigi201133 folded before Flop (didn't bet)
Seat 5: parraka_210 folded before Flop (didn't bet)
Seat 6: matiko09 (button) collected (€4.79)





PokerStars Hand #155014136620:  Hold'em No Limit ($0.50/$1.00 USD) - 2016/06/21 13:57:44 CET [2016/06/21 7:57:44 ET]
Table 'Amundsenia' 9-max Seat #2 is the button
Seat 1: 50CandyJoe ($136.78 in chips) 
Seat 2: Avtovo ($108.06 in chips) 
Seat 3: matiko09 ($100 in chips) 
Seat 4: typename27 ($20.29 in chips) 
Seat 6: King_ZéManel ($136.13 in chips) 
Seat 7: Eskimo Fox ($104 in chips) 
Seat 8: DomiVY ($49.32 in chips) 
Seat 9: MrSeymen ($48.36 in chips) 
matiko09: posts small blind $0.50
typename27: posts big blind $1
*** HOLE CARDS ***
Dealt to matiko09 [8s 2c]
King_ZéManel: folds 
Eskimo Fox: folds 
DomiVY: folds 
MrSeymen: folds 
50CandyJoe: raises $1 to $2
Avtovo: folds 
matiko09: folds 
typename27: calls $1
*** FLOP *** [9h 9c 5c]
typename27: checks 
50CandyJoe: bets $2.14
typename27: folds 
Uncalled bet ($2.14) returned to 50CandyJoe
50CandyJoe collected $4.28 from pot
50CandyJoe: doesn't show hand 
*** SUMMARY ***
Total pot $4.50 | Rake $0.22 
Board [9h 9c 5c]
Seat 1: 50CandyJoe collected ($4.28)
Seat 2: Avtovo (button) folded before Flop (didn't bet)
Seat 3: matiko09 (small blind) folded before Flop
Seat 4: typename27 (big blind) folded on the Flop
Seat 6: King_ZéManel folded before Flop (didn't bet)
Seat 7: Eskimo Fox folded before Flop (didn't bet)
Seat 8: DomiVY folded before Flop (didn't bet)
Seat 9: MrSeymen folded before Flop (didn't bet)





PokerStars Hand #155014139891:  Hold'em No Limit ($0.50/$1.00 USD) - 2016/06/21 13:57:52 CET [2016/06/21 7:57:52 ET]
Table 'Moreau' 9-max Seat #6 is the button
Seat 2: Avtovo ($107 in chips) 
Seat 3: matiko09 ($100 in chips) 
Seat 4: SharingaaN ($163.30 in chips) 
Seat 5: CoolFireX ($100 in chips) 
Seat 6: Troll8989 ($103.60 in chips) 
Seat 7: PanKwn15 ($103.02 in chips) 
Seat 8: mi$$I$Elena ($107.62 in chips) 
Seat 9: Toonersens ($114.84 in chips) 
PanKwn15: posts small blind $0.50
mi$$I$Elena: posts big blind $1
hurtNCYDE: sits out 
*** HOLE CARDS ***
Dealt to matiko09 [3d Ks]
Toonersens: folds 
Avtovo: raises $1.50 to $2.50
matiko09: folds 
SharingaaN: folds 
CoolFireX: folds 
Troll8989: folds 
PanKwn15: folds 
mi$$I$Elena: folds 
Uncalled bet ($1.50) returned to Avtovo
Avtovo collected $2.50 from pot
*** SUMMARY ***
Total pot $2.50 | Rake $0 
Seat 2: Avtovo collected ($2.50)
Seat 3: matiko09 folded before Flop (didn't bet)
Seat 4: SharingaaN folded before Flop (didn't bet)
Seat 5: CoolFireX folded before Flop (didn't bet)
Seat 6: Troll8989 (button) folded before Flop (didn't bet)
Seat 7: PanKwn15 (small blind) folded before Flop
Seat 8: mi$$I$Elena (big blind) folded before Flop
Seat 9: Toonersens folded before Flop (didn't bet)





PokerStars Hand #155014139778:  Hold'em No Limit (€0.25/€0.50 EUR) - 2016/06/21 13:57:52 CET [2016/06/21 7:57:52 ET]
Table 'Lotis II' 6-max Seat #4 is the button
Seat 3: hmverlin (€54.24 in chips) 
Seat 4: IpMan13 (€50 in chips) 
Seat 5: KrishnaRadha (€50 in chips) 
Seat 6: matiko09 (€50 in chips) 
KrishnaRadha: posts small blind €0.25
matiko09: posts big blind €0.50
AlexPles: sits out 
*** HOLE CARDS ***
Dealt to matiko09 [Ts 2d]
hmverlin: folds 
NoHeroHUD joins the table at seat #2 
IpMan13: raises €0.50 to €1
KrishnaRadha: folds 
matiko09: folds 
Uncalled bet (€0.50) returned to IpMan13
IpMan13 collected €1.25 from pot
IpMan13: doesn't show hand 
*** SUMMARY ***
Total pot €1.25 | Rake €0 
Seat 3: hmverlin folded before Flop (didn't bet)
Seat 4: IpMan13 (button) collected (€1.25)
Seat 5: KrishnaRadha (small blind) folded before Flop
Seat 6: matiko09 (big blind) folded before Flop





PokerStars Hand #155014140549:  Hold'em No Limit ($0.50/$1.00 USD) - 2016/06/21 13:57:54 CET [2016/06/21 7:57:54 ET]
Table 'Pemba' 9-max Seat #7 is the button
Seat 1: pardama ($102.50 in chips) 
Seat 2: Dantist1122 ($100 in chips) 
Seat 3: CoolFireX ($368.85 in chips) 
Seat 4: frut12 ($118.98 in chips) 
Seat 5: djammusic ($44.88 in chips) 
Seat 6: matiko09 ($109.10 in chips) 
Seat 7: mi$$I$Elena ($102.02 in chips) 
Seat 8: chaps1988 ($100 in chips) 
Seat 9: Eskimo Fox ($100 in chips) 
chaps1988: posts small blind $0.50
Eskimo Fox: posts big blind $1
*** HOLE CARDS ***
Dealt to matiko09 [Ts Ad]
pardama: folds 
Dantist1122: folds 
CoolFireX: folds 
frut12: folds 
djammusic: folds 
matiko09: raises $1.50 to $2.50
mi$$I$Elena: folds 
chaps1988: folds 
Eskimo Fox: folds 
Uncalled bet ($1.50) returned to matiko09
matiko09 collected $2.50 from pot
matiko09: doesn't show hand 
*** SUMMARY ***
Total pot $2.50 | Rake $0 
Seat 1: pardama folded before Flop (didn't bet)
Seat 2: Dantist1122 folded before Flop (didn't bet)
Seat 3: CoolFireX folded before Flop (didn't bet)
Seat 4: frut12 folded before Flop (didn't bet)
Seat 5: djammusic folded before Flop (didn't bet)
Seat 6: matiko09 collected ($2.50)
Seat 7: mi$$I$Elena (button) folded before Flop (didn't bet)
Seat 8: chaps1988 (small blind) folded before Flop
Seat 9: Eskimo Fox (big blind) folded before Flop





PokerStars Hand #155014142435:  Hold'em No Limit ($0.50/$1.00 USD) - 2016/06/21 13:57:59 CET [2016/06/21 7:57:59 ET]
Table 'Gryphia' 9-max Seat #4 is the button
Seat 1: Klappspaten0 ($100 in chips) 
Seat 2: stepan0605 ($100 in chips) 
Seat 3: KovIFish89 ($110.40 in chips) 
Seat 4: King Sixtus ($66.01 in chips) 
Seat 5: pardama ($100 in chips) 
Seat 6: Dandy Monk ($77.70 in chips) 
Seat 7: solbi86 ($105.98 in chips) 
Seat 8: matiko09 ($112.43 in chips) 
Seat 9: djammusic ($42.80 in chips) 
pardama: posts small blind $0.50
Dandy Monk: posts big blind $1
*** HOLE CARDS ***
Dealt to matiko09 [9d Kh]
solbi86: folds 
matiko09: folds 
djammusic: raises $1.25 to $2.25
Klappspaten0: folds 
stepan0605: calls $2.25
KovIFish89: folds 
King Sixtus: folds 
pardama: folds 
Dandy Monk: raises $4.25 to $6.50
djammusic: folds 
stepan0605: raises $11.50 to $18
Dandy Monk: calls $11.50
*** FLOP *** [Tc 6s 3d]
Dandy Monk: checks 
stepan0605: bets $14
Dandy Monk: raises $16 to $30
stepan0605: calls $16
*** TURN *** [Tc 6s 3d] [2s]
Dandy Monk: checks 
stepan0605: bets $52 and is all-in
Dandy Monk: calls $29.70 and is all-in
Uncalled bet ($22.30) returned to stepan0605
*** RIVER *** [Tc 6s 3d 2s] [7c]
*** SHOW DOWN ***
Dandy Monk: shows [As Qs] (high card Ace)
stepan0605: shows [Jh Jc] (a pair of Jacks)
stepan0605 collected $155.65 from pot
*** SUMMARY ***
Total pot $158.15 | Rake $2.50 
Board [Tc 6s 3d 2s 7c]
Seat 1: Klappspaten0 folded before Flop (didn't bet)
Seat 2: stepan0605 showed [Jh Jc] and won ($155.65) with a pair of Jacks
Seat 3: KovIFish89 folded before Flop (didn't bet)
Seat 4: King Sixtus (button) folded before Flop (didn't bet)
Seat 5: pardama (small blind) folded before Flop
Seat 6: Dandy Monk (big blind) showed [As Qs] and lost with high card Ace
Seat 7: solbi86 folded before Flop (didn't bet)
Seat 8: matiko09 folded before Flop (didn't bet)
Seat 9: djammusic folded before Flop





PokerStars Hand #155014145589:  Hold'em No Limit ($0.50/$1.00 USD) - 2016/06/21 13:58:07 CET [2016/06/21 7:58:07 ET]
Table 'Schurer II' 9-max Seat #3 is the button
Seat 1: 50CandyJoe ($101.50 in chips) 
Seat 2: havenots88 ($90.50 in chips) 
Seat 3: matiko09 ($103.65 in chips) 
Seat 5: riggedsh** ($113.28 in chips) 
Seat 6: Dödi123 ($135.39 in chips) 
Seat 7: Avtovo ($108.58 in chips) 
Seat 8: ohneSenf66 ($166.18 in chips) 
riggedsh**: posts small blind $0.50
Dödi123: posts big blind $1
Donetsk1y: sits out 
*** HOLE CARDS ***
Dealt to matiko09 [Jc 9h]
Avtovo: folds 
ohneSenf66: folds 
50CandyJoe: folds 
havenots88: raises $2 to $3
matiko09: folds 
riggedsh**: folds 
Dödi123: folds 
Uncalled bet ($2) returned to havenots88
hurtNCYDE joins the table at seat #4 
havenots88 collected $2.50 from pot
*** SUMMARY ***
Total pot $2.50 | Rake $0 
Seat 1: 50CandyJoe folded before Flop (didn't bet)
Seat 2: havenots88 collected ($2.50)
Seat 3: matiko09 (button) folded before Flop (didn't bet)
Seat 5: riggedsh** (small blind) folded before Flop
Seat 6: Dödi123 (big blind) folded before Flop
Seat 7: Avtovo folded before Flop (didn't bet)
Seat 8: ohneSenf66 folded before Flop (didn't bet)





PokerStars Hand #155014146292:  Hold'em No Limit ($0.50/$1.00 USD) - 2016/06/21 13:58:09 CET [2016/06/21 7:58:09 ET]
Table 'Lamberta II' 9-max Seat #2 is the button
Seat 1: mbk88 ($174.17 in chips) 
Seat 2: mavin80 ($70.63 in chips) 
Seat 3: matiko09 ($106.68 in chips) 
Seat 4: Eskimo Fox ($118.39 in chips) 
Seat 5: CoolFireX ($114.22 in chips) 
Seat 6: Chen423 ($112.82 in chips) 
Seat 7: 23SmOkEr07 ($199.04 in chips) 
Seat 8: Troll8989 ($100.25 in chips) 
Seat 9: Sjtu_Michael ($98.50 in chips) 
matiko09: posts small blind $0.50
Eskimo Fox: posts big blind $1
*** HOLE CARDS ***
Dealt to matiko09 [3d 5s]
CoolFireX: folds 
Chen423: folds 
23SmOkEr07: folds 
Troll8989: folds 
Sjtu_Michael: folds 
mbk88: folds 
mavin80: folds 
matiko09: folds 
Uncalled bet ($0.50) returned to Eskimo Fox
Eskimo Fox collected $1 from pot
Eskimo Fox: doesn't show hand 
*** SUMMARY ***
Total pot $1 | Rake $0 
Seat 1: mbk88 folded before Flop (didn't bet)
Seat 2: mavin80 (button) folded before Flop (didn't bet)
Seat 3: matiko09 (small blind) folded before Flop
Seat 4: Eskimo Fox (big blind) collected ($1)
Seat 5: CoolFireX folded before Flop (didn't bet)
Seat 6: Chen423 folded before Flop (didn't bet)
Seat 7: 23SmOkEr07 folded before Flop (didn't bet)
Seat 8: Troll8989 folded before Flop (didn't bet)
Seat 9: Sjtu_Michael folded before Flop (didn't bet)





PokerStars Hand #155014147112:  Hold'em No Limit (€0.25/€0.50 EUR) - 2016/06/21 13:58:11 CET [2016/06/21 7:58:11 ET]
Table 'Lotis II' 6-max Seat #5 is the button
Seat 1: AlexPles (€50 in chips) 
Seat 3: hmverlin (€54.24 in chips) 
Seat 4: IpMan13 (€50.75 in chips) 
Seat 5: KrishnaRadha (€50 in chips) 
Seat 6: matiko09 (€50 in chips) 
matiko09: posts small blind €0.25
AlexPles: posts big blind €0.50
NoHeroHUD: sits out 
*** HOLE CARDS ***
Dealt to matiko09 [Jh 4s]
hmverlin: raises €1 to €1.50
IpMan13: raises €2.50 to €4
KrishnaRadha: folds 
matiko09: folds 
AlexPles: folds 
hmverlin: calls €2.50
*** FLOP *** [5c 6d Tc]
hmverlin: bets €4
IpMan13: folds 
Uncalled bet (€4) returned to hmverlin
hmverlin collected €8.31 from pot
hmverlin: doesn't show hand 
*** SUMMARY ***
Total pot €8.75 | Rake €0.44 
Board [5c 6d Tc]
Seat 1: AlexPles (big blind) folded before Flop
Seat 3: hmverlin collected (€8.31)
Seat 4: IpMan13 folded on the Flop
Seat 5: KrishnaRadha (button) folded before Flop (didn't bet)
Seat 6: matiko09 (small blind) folded before Flop





PokerStars Hand #155014150124:  Hold'em No Limit ($0.50/$1.00 USD) - 2016/06/21 13:58:19 CET [2016/06/21 7:58:19 ET]
Table 'Moreau' 9-max Seat #7 is the button
Seat 2: Avtovo ($108.50 in chips) 
Seat 3: matiko09 ($100 in chips) 
Seat 4: SharingaaN ($163.30 in chips) 
Seat 5: CoolFireX ($100 in chips) 
Seat 6: Troll8989 ($103.60 in chips) 
Seat 7: PanKwn15 ($102.52 in chips) 
Seat 8: mi$$I$Elena ($106.62 in chips) 
Seat 9: Toonersens ($114.84 in chips) 
mi$$I$Elena: posts small blind $0.50
Toonersens: posts big blind $1
hurtNCYDE: sits out 
*** HOLE CARDS ***
Dealt to matiko09 [5h 3c]
Avtovo: raises $1.50 to $2.50
matiko09: folds 
SharingaaN: folds 
CoolFireX: folds 
Troll8989: folds 
PanKwn15: calls $2.50
mi$$I$Elena: raises $9 to $11.50
Toonersens: folds 
Avtovo: folds 
PanKwn15: folds 
Uncalled bet ($9) returned to mi$$I$Elena
mi$$I$Elena collected $8.50 from pot
mi$$I$Elena: doesn't show hand 
*** SUMMARY ***
Total pot $8.50 | Rake $0 
Seat 2: Avtovo folded before Flop
Seat 3: matiko09 folded before Flop (didn't bet)
Seat 4: SharingaaN folded before Flop (didn't bet)
Seat 5: CoolFireX folded before Flop (didn't bet)
Seat 6: Troll8989 folded before Flop (didn't bet)
Seat 7: PanKwn15 (button) folded before Flop
Seat 8: mi$$I$Elena (small blind) collected ($8.50)
Seat 9: Toonersens (big blind) folded before Flop





PokerStars Hand #155014152903:  Hold'em No Limit ($0.50/$1.00 USD) - 2016/06/21 13:58:26 CET [2016/06/21 7:58:26 ET]
Table 'Schurer II' 9-max Seat #5 is the button
Seat 1: 50CandyJoe ($101.50 in chips) 
Seat 2: havenots88 ($92 in chips) 
Seat 3: matiko09 ($103.65 in chips) 
Seat 5: riggedsh** ($112.78 in chips) 
Seat 6: Dödi123 ($134.39 in chips) 
Seat 7: Avtovo ($108.58 in chips) 
Seat 8: ohneSenf66 ($166.18 in chips) 
Dödi123: posts small blind $0.50
Avtovo: posts big blind $1
Donetsk1y: sits out 
hurtNCYDE: sits out 
*** HOLE CARDS ***
Dealt to matiko09 [3s 2c]
ohneSenf66: folds 
ohneSenf66 leaves the table
stepan0605 joins the table at seat #8 
50CandyJoe: folds 
havenots88: folds 
matiko09: folds 
50CandyJoe leaves the table
Dantist1122 joins the table at seat #1 
riggedsh**: raises $1.50 to $2.50
Dödi123: folds 
Avtovo: calls $1.50
*** FLOP *** [9d Ah 4d]
Avtovo: checks 
riggedsh**: bets $2.61
Avtovo: folds 
Uncalled bet ($2.61) returned to riggedsh**
riggedsh** collected $5.22 from pot
riggedsh**: doesn't show hand 
*** SUMMARY ***
Total pot $5.50 | Rake $0.28 
Board [9d Ah 4d]
Seat 1: 50CandyJoe folded before Flop (didn't bet)
Seat 2: havenots88 folded before Flop (didn't bet)
Seat 3: matiko09 folded before Flop (didn't bet)
Seat 5: riggedsh** (button) collected ($5.22)
Seat 6: Dödi123 (small blind) folded before Flop
Seat 7: Avtovo (big blind) folded on the Flop
Seat 8: ohneSenf66 folded before Flop (didn't bet)





PokerStars Hand #155014155222:  Hold'em No Limit ($0.50/$1.00 USD) - 2016/06/21 13:58:32 CET [2016/06/21 7:58:32 ET]
Table 'Pemba' 9-max Seat #8 is the button
Seat 1: pardama ($102.50 in chips) 
Seat 2: Dantist1122 ($100 in chips) 
Seat 3: CoolFireX ($368.85 in chips) 
Seat 4: frut12 ($118.98 in chips) 
Seat 5: djammusic ($44.88 in chips) 
Seat 6: matiko09 ($110.60 in chips) 
Seat 7: mi$$I$Elena ($102.02 in chips) 
Seat 8: chaps1988 ($100 in chips) 
Seat 9: Eskimo Fox ($100 in chips) 
Eskimo Fox: posts small blind $0.50
pardama: posts big blind $1
*** HOLE CARDS ***
Dealt to matiko09 [6s Kh]
Dantist1122: folds 
CoolFireX: folds 
frut12: raises $4 to $5
djammusic: folds 
matiko09: folds 
mi$$I$Elena: folds 
chaps1988: folds 
Eskimo Fox: folds 
pardama: folds 
Uncalled bet ($4) returned to frut12
frut12 collected $2.50 from pot
*** SUMMARY ***
Total pot $2.50 | Rake $0 
Seat 1: pardama (big blind) folded before Flop
Seat 2: Dantist1122 folded before Flop (didn't bet)
Seat 3: CoolFireX folded before Flop (didn't bet)
Seat 4: frut12 collected ($2.50)
Seat 5: djammusic folded before Flop (didn't bet)
Seat 6: matiko09 folded before Flop (didn't bet)
Seat 7: mi$$I$Elena folded before Flop (didn't bet)
Seat 8: chaps1988 (button) folded before Flop (didn't bet)
Seat 9: Eskimo Fox (small blind) folded before Flop





PokerStars Hand #155014155580:  Hold'em No Limit ($0.50/$1.00 USD) - 2016/06/21 13:58:33 CET [2016/06/21 7:58:33 ET]
Table 'Amundsenia' 9-max Seat #3 is the button
Seat 1: 50CandyJoe ($139.06 in chips) 
Seat 2: Avtovo ($108.06 in chips) 
Seat 3: matiko09 ($100 in chips) 
Seat 4: typename27 ($18.29 in chips) 
Seat 6: King_ZéManel ($136.13 in chips) 
Seat 7: Eskimo Fox ($104 in chips) 
Seat 8: DomiVY ($49.32 in chips) 
Seat 9: MrSeymen ($48.36 in chips) 
typename27: posts small blind $0.50
King_ZéManel: posts big blind $1
*** HOLE CARDS ***
Dealt to matiko09 [6c Kd]
Eskimo Fox: folds 
DomiVY: raises $2 to $3
MrSeymen: folds 
50CandyJoe: folds 
Avtovo: folds 
matiko09: folds 
typename27: folds 
King_ZéManel: folds 
Uncalled bet ($2) returned to DomiVY
DomiVY collected $2.50 from pot
DomiVY: doesn't show hand 
*** SUMMARY ***
Total pot $2.50 | Rake $0 
Seat 1: 50CandyJoe folded before Flop (didn't bet)
Seat 2: Avtovo folded before Flop (didn't bet)
Seat 3: matiko09 (button) folded before Flop (didn't bet)
Seat 4: typename27 (small blind) folded before Flop
Seat 6: King_ZéManel (big blind) folded before Flop
Seat 7: Eskimo Fox folded before Flop (didn't bet)
Seat 8: DomiVY collected ($2.50)
Seat 9: MrSeymen folded before Flop (didn't bet)





PokerStars Hand #155014156379:  Hold'em No Limit ($0.50/$1.00 USD) - 2016/06/21 13:58:35 CET [2016/06/21 7:58:35 ET]
Table 'Lamberta II' 9-max Seat #3 is the button
Seat 1: mbk88 ($174.17 in chips) 
Seat 2: mavin80 ($70.63 in chips) 
Seat 3: matiko09 ($106.18 in chips) 
Seat 4: Eskimo Fox ($118.89 in chips) 
Seat 5: CoolFireX ($114.22 in chips) 
Seat 6: Chen423 ($112.82 in chips) 
Seat 7: 23SmOkEr07 ($199.04 in chips) 
Seat 8: Troll8989 ($100.25 in chips) 
Seat 9: Sjtu_Michael ($98.50 in chips) 
Eskimo Fox: posts small blind $0.50
CoolFireX: posts big blind $1
*** HOLE CARDS ***
Dealt to matiko09 [Tc 2c]
Chen423: folds 
23SmOkEr07: folds 
Troll8989: folds 
Sjtu_Michael: folds 
mbk88: raises $2 to $3
mavin80: raises $5 to $8
matiko09: folds 
Eskimo Fox: folds 
CoolFireX: folds 
mbk88: raises $14 to $22
mavin80: raises $35.25 to $57.25
mbk88: raises $35.25 to $92.50
mavin80: calls $13.38 and is all-in
Uncalled bet ($21.87) returned to mbk88
*** FLOP *** [Ah Kd Th]
*** TURN *** [Ah Kd Th] [4s]
*** RIVER *** [Ah Kd Th 4s] [Jc]
*** SHOW DOWN ***
mbk88: shows [Qs Qd] (a straight, Ten to Ace)
mavin80: shows [Kh Ks] (three of a kind, Kings)
mbk88 collected $140.26 from pot
*** SUMMARY ***
Total pot $142.76 | Rake $2.50 
Board [Ah Kd Th 4s Jc]
Seat 1: mbk88 showed [Qs Qd] and won ($140.26) with a straight, Ten to Ace
Seat 2: mavin80 showed [Kh Ks] and lost with three of a kind, Kings
Seat 3: matiko09 (button) folded before Flop (didn't bet)
Seat 4: Eskimo Fox (small blind) folded before Flop
Seat 5: CoolFireX (big blind) folded before Flop
Seat 6: Chen423 folded before Flop (didn't bet)
Seat 7: 23SmOkEr07 folded before Flop (didn't bet)
Seat 8: Troll8989 folded before Flop (didn't bet)
Seat 9: Sjtu_Michael folded before Flop (didn't bet)





PokerStars Hand #155014156686:  Hold'em No Limit (€0.50/€1.00 EUR) - 2016/06/21 13:58:36 CET [2016/06/21 7:58:36 ET]
Table 'Tauris III' 6-max Seat #1 is the button
Seat 1: morc1us (€100 in chips) 
Seat 2: devil1964 (€105.70 in chips) 
Seat 3: BronKKAA (€119.98 in chips) 
Seat 4: Gigi201133 (€111.73 in chips) 
Seat 5: parraka_210 (€102.28 in chips) 
Seat 6: matiko09 (€104.02 in chips) 
devil1964: posts small blind €0.50
BronKKAA: posts big blind €1
*** HOLE CARDS ***
Dealt to matiko09 [5h Tc]
Gigi201133: folds 
parraka_210: folds 
matiko09: folds 
morc1us: raises €1 to €2
devil1964: calls €1.50
BronKKAA: folds 
*** FLOP *** [Ts 2h 5d]
devil1964: checks 
morc1us: bets €2
devil1964: calls €2
*** TURN *** [Ts 2h 5d] [Ah]
devil1964: checks 
morc1us: checks 
*** RIVER *** [Ts 2h 5d Ah] [6h]
devil1964: bets €4.27
morc1us: raises €4.27 to €8.54
devil1964: calls €4.27
*** SHOW DOWN ***
morc1us: shows [6d As] (two pair, Aces and Sixes)
devil1964: mucks hand 
morc1us collected €24.78 from pot
*** SUMMARY ***
Total pot €26.08 | Rake €1.30 
Board [Ts 2h 5d Ah 6h]
Seat 1: morc1us (button) showed [6d As] and won (€24.78) with two pair, Aces and Sixes
Seat 2: devil1964 (small blind) mucked [Kc Ad]
Seat 3: BronKKAA (big blind) folded before Flop
Seat 4: Gigi201133 folded before Flop (didn't bet)
Seat 5: parraka_210 folded before Flop (didn't bet)
Seat 6: matiko09 folded before Flop (didn't bet)





PokerStars Hand #155014164889:  Hold'em No Limit ($0.50/$1.00 USD) - 2016/06/21 13:58:57 CET [2016/06/21 7:58:57 ET]
Table 'Pemba' 9-max Seat #9 is the button
Seat 1: pardama ($101.50 in chips) 
Seat 2: Dantist1122 ($100 in chips) 
Seat 3: CoolFireX ($368.85 in chips) 
Seat 4: frut12 ($120.48 in chips) 
Seat 5: djammusic ($44.88 in chips) 
Seat 6: matiko09 ($110.60 in chips) 
Seat 7: mi$$I$Elena ($102.02 in chips) 
Seat 8: chaps1988 ($100 in chips) 
Seat 9: Eskimo Fox ($100 in chips) 
pardama: posts small blind $0.50
Dantist1122: posts big blind $1
*** HOLE CARDS ***
Dealt to matiko09 [Ac Th]
CoolFireX: folds 
frut12: folds 
djammusic: folds 
matiko09: folds 
mi$$I$Elena: raises $1.38 to $2.38
chaps1988: folds 
Eskimo Fox: folds 
pardama: folds 
Dantist1122: folds 
Uncalled bet ($1.38) returned to mi$$I$Elena
mi$$I$Elena collected $2.50 from pot
mi$$I$Elena: doesn't show hand 
*** SUMMARY ***
Total pot $2.50 | Rake $0 
Seat 1: pardama (small blind) folded before Flop
Seat 2: Dantist1122 (big blind) folded before Flop
Seat 3: CoolFireX folded before Flop (didn't bet)
Seat 4: frut12 folded before Flop (didn't bet)
Seat 5: djammusic folded before Flop (didn't bet)
Seat 6: matiko09 folded before Flop (didn't bet)
Seat 7: mi$$I$Elena collected ($2.50)
Seat 8: chaps1988 folded before Flop (didn't bet)
Seat 9: Eskimo Fox (button) folded before Flop (didn't bet)





PokerStars Hand #155014165120:  Hold'em No Limit ($0.50/$1.00 USD) - 2016/06/21 13:58:57 CET [2016/06/21 7:58:57 ET]
Table 'Megrez II' 9-max Seat #8 is the button
Seat 1: hurtNCYDE ($120.02 in chips) 
Seat 2: Filojoes ($134.44 in chips) 
Seat 3: Troll8989 ($102.72 in chips) 
Seat 4: matiko09 ($100 in chips) 
Seat 6: stepan0605 ($79.98 in chips) 
Seat 7: CoolFireX ($136.49 in chips) 
Seat 8: Menno78 ($91.67 in chips) 
Seat 9: MarioDong ($121.31 in chips) 
MarioDong: posts small blind $0.50
hurtNCYDE: posts big blind $1
pardama: sits out 
*** HOLE CARDS ***
Dealt to matiko09 [9c 7d]
Filojoes: folds 
Troll8989: raises $1.50 to $2.50
matiko09: folds 
stepan0605: folds 
CoolFireX: folds 
Menno78: folds 
MarioDong: folds 
hurtNCYDE: folds 
Uncalled bet ($1.50) returned to Troll8989
Troll8989 collected $2.50 from pot
Troll8989: doesn't show hand 
*** SUMMARY ***
Total pot $2.50 | Rake $0 
Seat 1: hurtNCYDE (big blind) folded before Flop
Seat 2: Filojoes folded before Flop (didn't bet)
Seat 3: Troll8989 collected ($2.50)
Seat 4: matiko09 folded before Flop (didn't bet)
Seat 6: stepan0605 folded before Flop (didn't bet)
Seat 7: CoolFireX folded before Flop (didn't bet)
Seat 8: Menno78 (button) folded before Flop (didn't bet)
Seat 9: MarioDong (small blind) folded before Flop





PokerStars Hand #155014169125:  Hold'em No Limit (€0.25/€0.50 EUR) - 2016/06/21 13:59:07 CET [2016/06/21 7:59:07 ET]
Table 'Lotis II' 6-max Seat #6 is the button
Seat 1: AlexPles (€50 in chips) 
Seat 2: NoHeroHUD (€50 in chips) 
Seat 3: hmverlin (€58.55 in chips) 
Seat 4: IpMan13 (€50 in chips) 
Seat 5: KrishnaRadha (€50 in chips) 
Seat 6: matiko09 (€50 in chips) 
AlexPles: posts small blind €0.25
NoHeroHUD: posts big blind €0.50
*** HOLE CARDS ***
Dealt to matiko09 [Jc 7d]
hmverlin: folds 
IpMan13: folds 
KrishnaRadha: folds 
matiko09: folds 
AlexPles: raises €0.62 to €1.12
NoHeroHUD: calls €0.62
*** FLOP *** [Th 3d 4h]
AlexPles: bets €1.70
NoHeroHUD: folds 
Uncalled bet (€1.70) returned to AlexPles
AlexPles collected €2.13 from pot
AlexPles: doesn't show hand 
*** SUMMARY ***
Total pot €2.24 | Rake €0.11 
Board [Th 3d 4h]
Seat 1: AlexPles (small blind) collected (€2.13)
Seat 2: NoHeroHUD (big blind) folded on the Flop
Seat 3: hmverlin folded before Flop (didn't bet)
Seat 4: IpMan13 folded before Flop (didn't bet)
Seat 5: KrishnaRadha folded before Flop (didn't bet)
Seat 6: matiko09 (button) folded before Flop (didn't bet)





PokerStars Hand #155014169988:  Hold'em No Limit ($0.50/$1.00 USD) - 2016/06/21 13:59:10 CET [2016/06/21 7:59:10 ET]
Table 'Schurer II' 9-max Seat #6 is the button
Seat 2: havenots88 ($92 in chips) 
Seat 3: matiko09 ($103.65 in chips) 
Seat 5: riggedsh** ($115.50 in chips) 
Seat 6: Dödi123 ($133.89 in chips) 
Seat 7: Avtovo ($106.08 in chips) 
Seat 8: stepan0605 ($100 in chips) 
Avtovo: posts small blind $0.50
stepan0605: posts big blind $1
Donetsk1y: sits out 
Dantist1122: sits out 
hurtNCYDE: sits out 
*** HOLE CARDS ***
Dealt to matiko09 [Js 5d]
havenots88: folds 
matiko09: folds 
riggedsh**: folds 
Dödi123: raises $1 to $2
Avtovo: raises $6 to $8
stepan0605: folds 
Dödi123: folds 
Uncalled bet ($6) returned to Avtovo
Avtovo collected $5 from pot
Avtovo: doesn't show hand 
*** SUMMARY ***
Total pot $5 | Rake $0 
Seat 2: havenots88 folded before Flop (didn't bet)
Seat 3: matiko09 folded before Flop (didn't bet)
Seat 5: riggedsh** folded before Flop (didn't bet)
Seat 6: Dödi123 (button) folded before Flop
Seat 7: Avtovo (small blind) collected ($5)
Seat 8: stepan0605 (big blind) folded before Flop





PokerStars Hand #155014170198:  Hold'em No Limit ($0.50/$1.00 USD) - 2016/06/21 13:59:10 CET [2016/06/21 7:59:10 ET]
Table 'Amundsenia' 9-max Seat #4 is the button
Seat 1: 50CandyJoe ($139.06 in chips) 
Seat 2: Avtovo ($108.06 in chips) 
Seat 3: matiko09 ($100 in chips) 
Seat 4: typename27 ($17.79 in chips) 
Seat 6: King_ZéManel ($135.13 in chips) 
Seat 7: Eskimo Fox ($104 in chips) 
Seat 8: DomiVY ($50.82 in chips) 
Seat 9: MrSeymen ($48.36 in chips) 
King_ZéManel: posts small blind $0.50
Eskimo Fox: posts big blind $1
*** HOLE CARDS ***
Dealt to matiko09 [Jc 3d]
DomiVY: folds 
MrSeymen: folds 
50CandyJoe: folds 
Avtovo: folds 
matiko09: folds 
50CandyJoe leaves the table
typename27: folds 
King_ZéManel: folds 
Uncalled bet ($0.50) returned to Eskimo Fox
Eskimo Fox collected $1 from pot
Eskimo Fox: doesn't show hand 
*** SUMMARY ***
Total pot $1 | Rake $0 
Seat 1: 50CandyJoe folded before Flop (didn't bet)
Seat 2: Avtovo folded before Flop (didn't bet)
Seat 3: matiko09 folded before Flop (didn't bet)
Seat 4: typename27 (button) folded before Flop (didn't bet)
Seat 6: King_ZéManel (small blind) folded before Flop
Seat 7: Eskimo Fox (big blind) collected ($1)
Seat 8: DomiVY folded before Flop (didn't bet)
Seat 9: MrSeymen folded before Flop (didn't bet)





PokerStars Hand #155014171814:  Hold'em No Limit ($0.50/$1.00 USD) - 2016/06/21 13:59:14 CET [2016/06/21 7:59:14 ET]
Table 'Moreau' 9-max Seat #8 is the button
Seat 1: hurtNCYDE ($100 in chips) 
Seat 2: Avtovo ($106 in chips) 
Seat 3: matiko09 ($100 in chips) 
Seat 4: SharingaaN ($163.30 in chips) 
Seat 5: CoolFireX ($100 in chips) 
Seat 6: Troll8989 ($103.60 in chips) 
Seat 7: PanKwn15 ($100.02 in chips) 
Seat 8: mi$$I$Elena ($112.62 in chips) 
Seat 9: Toonersens ($113.84 in chips) 
Toonersens: posts small blind $0.50
hurtNCYDE: posts big blind $1
*** HOLE CARDS ***
Dealt to matiko09 [Td 7s]
Avtovo: folds 
matiko09: folds 
SharingaaN: folds 
CoolFireX: folds 
Troll8989: folds 
PanKwn15: raises $1.50 to $2.50
mi$$I$Elena: folds 
Toonersens: calls $2
hurtNCYDE: folds 
*** FLOP *** [9h 8c 6h]
Toonersens: bets $3
PanKwn15: raises $4 to $7
Toonersens: folds 
Uncalled bet ($4) returned to PanKwn15
PanKwn15 collected $11.40 from pot
PanKwn15: doesn't show hand 
*** SUMMARY ***
Total pot $12 | Rake $0.60 
Board [9h 8c 6h]
Seat 1: hurtNCYDE (big blind) folded before Flop
Seat 2: Avtovo folded before Flop (didn't bet)
Seat 3: matiko09 folded before Flop (didn't bet)
Seat 4: SharingaaN folded before Flop (didn't bet)
Seat 5: CoolFireX folded before Flop (didn't bet)
Seat 6: Troll8989 folded before Flop (didn't bet)
Seat 7: PanKwn15 collected ($11.40)
Seat 8: mi$$I$Elena (button) folded before Flop (didn't bet)
Seat 9: Toonersens (small blind) folded on the Flop





PokerStars Hand #155014177222:  Hold'em No Limit ($0.50/$1.00 USD) - 2016/06/21 13:59:28 CET [2016/06/21 7:59:28 ET]
Table 'Amundsenia' 9-max Seat #6 is the button
Seat 2: Avtovo ($108.06 in chips) 
Seat 3: matiko09 ($100 in chips) 
Seat 4: typename27 ($17.79 in chips) 
Seat 6: King_ZéManel ($134.63 in chips) 
Seat 7: Eskimo Fox ($104.50 in chips) 
Seat 8: DomiVY ($50.82 in chips) 
Seat 9: MrSeymen ($48.36 in chips) 
Eskimo Fox: posts small blind $0.50
DomiVY: posts big blind $1
*** HOLE CARDS ***
Dealt to matiko09 [2c 5s]
MrSeymen: raises $2 to $3
Avtovo: folds 
matiko09: folds 
typename27: folds 
CrazyLarryba was removed from the table for failing to post
Troll8989 joins the table at seat #1 
King_ZéManel: folds 
Eskimo Fox: folds 
DomiVY: folds 
Uncalled bet ($2) returned to MrSeymen
MrSeymen collected $2.50 from pot
*** SUMMARY ***
Total pot $2.50 | Rake $0 
Seat 2: Avtovo folded before Flop (didn't bet)
Seat 3: matiko09 folded before Flop (didn't bet)
Seat 4: typename27 folded before Flop (didn't bet)
Seat 6: King_ZéManel (button) folded before Flop (didn't bet)
Seat 7: Eskimo Fox (small blind) folded before Flop
Seat 8: DomiVY (big blind) folded before Flop
Seat 9: MrSeymen collected ($2.50)





PokerStars Hand #155014180488:  Hold'em No Limit ($0.50/$1.00 USD) - 2016/06/21 13:59:36 CET [2016/06/21 7:59:36 ET]
Table 'Megrez II' 9-max Seat #9 is the button
Seat 1: hurtNCYDE ($119.02 in chips) 
Seat 2: Filojoes ($134.44 in chips) 
Seat 3: Troll8989 ($104.22 in chips) 
Seat 4: matiko09 ($100 in chips) 
Seat 6: stepan0605 ($79.98 in chips) 
Seat 7: CoolFireX ($136.49 in chips) 
Seat 8: Menno78 ($91.67 in chips) 
Seat 9: MarioDong ($120.81 in chips) 
hurtNCYDE: posts small blind $0.50
Filojoes: posts big blind $1
pardama: sits out 
*** HOLE CARDS ***
Dealt to matiko09 [6d Tc]
Troll8989: folds 
matiko09: folds 
stepan0605: folds 
CoolFireX: folds 
Menno78: folds 
MarioDong: folds 
hurtNCYDE: raises $1.50 to $2.50
Filojoes: calls $1.50
*** FLOP *** [Qh 9d 6s]
hurtNCYDE: bets $1.61
Filojoes: raises $4.39 to $6
hurtNCYDE: folds 
Uncalled bet ($4.39) returned to Filojoes
Filojoes collected $7.81 from pot
Filojoes: doesn't show hand 
*** SUMMARY ***
Total pot $8.22 | Rake $0.41 
Board [Qh 9d 6s]
Seat 1: hurtNCYDE (small blind) folded on the Flop
Seat 2: Filojoes (big blind) collected ($7.81)
Seat 3: Troll8989 folded before Flop (didn't bet)
Seat 4: matiko09 folded before Flop (didn't bet)
Seat 6: stepan0605 folded before Flop (didn't bet)
Seat 7: CoolFireX folded before Flop (didn't bet)
Seat 8: Menno78 folded before Flop (didn't bet)
Seat 9: MarioDong (button) folded before Flop (didn't bet)





PokerStars Hand #155014180805:  Hold'em No Limit ($0.50/$1.00 USD) - 2016/06/21 13:59:37 CET [2016/06/21 7:59:37 ET]
Table 'Pemba' 9-max Seat #1 is the button
Seat 1: pardama ($101 in chips) 
Seat 2: Dantist1122 ($100 in chips) 
Seat 3: CoolFireX ($368.85 in chips) 
Seat 4: frut12 ($120.48 in chips) 
Seat 5: djammusic ($44.88 in chips) 
Seat 6: matiko09 ($110.60 in chips) 
Seat 7: mi$$I$Elena ($103.52 in chips) 
Seat 8: chaps1988 ($100 in chips) 
Seat 9: Eskimo Fox ($100 in chips) 
Dantist1122: posts small blind $0.50
CoolFireX: posts big blind $1
*** HOLE CARDS ***
Dealt to matiko09 [9s Ts]
frut12: folds 
frut12 leaves the table
djammusic: raises $1.25 to $2.25
hurtNCYDE joins the table at seat #4 
matiko09: folds 
hurtNCYDE leaves the table
mi$$I$Elena: folds 
chaps1988: folds 
Eskimo Fox: folds 
pardama: folds 
Dantist1122: folds 
CoolFireX: calls $1.25
*** FLOP *** [9d Jh 5s]
CoolFireX: checks 
djammusic: checks 
*** TURN *** [9d Jh 5s] [3h]
CoolFireX: checks 
djammusic: bets $3.56
Filojoes joins the table at seat #4 
CoolFireX: calls $3.56
*** RIVER *** [9d Jh 5s 3h] [Ac]
CoolFireX: checks 
djammusic: bets $8.50
CoolFireX: folds 
Uncalled bet ($8.50) returned to djammusic
djammusic collected $11.51 from pot
djammusic: doesn't show hand 
*** SUMMARY ***
Total pot $12.12 | Rake $0.61 
Board [9d Jh 5s 3h Ac]
Seat 1: pardama (button) folded before Flop (didn't bet)
Seat 2: Dantist1122 (small blind) folded before Flop
Seat 3: CoolFireX (big blind) folded on the River
Seat 4: frut12 folded before Flop (didn't bet)
Seat 5: djammusic collected ($11.51)
Seat 6: matiko09 folded before Flop (didn't bet)
Seat 7: mi$$I$Elena folded before Flop (didn't bet)
Seat 8: chaps1988 folded before Flop (didn't bet)
Seat 9: Eskimo Fox folded before Flop (didn't bet)





PokerStars Hand #155014183639:  Hold'em No Limit ($0.50/$1.00 USD) - 2016/06/21 13:59:44 CET [2016/06/21 7:59:44 ET]
Table 'Schurer II' 9-max Seat #7 is the button
Seat 2: havenots88 ($92 in chips) 
Seat 3: matiko09 ($103.65 in chips) 
Seat 5: riggedsh** ($115.50 in chips) 
Seat 6: Dödi123 ($131.89 in chips) 
Seat 7: Avtovo ($109.08 in chips) 
Seat 8: stepan0605 ($99 in chips) 
Seat 9: Donetsk1y ($100 in chips) 
stepan0605: posts small blind $0.50
Donetsk1y: posts big blind $1
Dantist1122: sits out 
hurtNCYDE: sits out 
*** HOLE CARDS ***
Dealt to matiko09 [6d 7d]
havenots88: folds 
matiko09: folds 
riggedsh**: raises $2 to $3
Dödi123: calls $3
Avtovo: folds 
stepan0605: folds 
Donetsk1y: folds 
*** FLOP *** [Kc Ts 3s]
riggedsh**: bets $4.77
Dödi123: folds 
Uncalled bet ($4.77) returned to riggedsh**
riggedsh** collected $7.12 from pot
riggedsh**: doesn't show hand 
*** SUMMARY ***
Total pot $7.50 | Rake $0.38 
Board [Kc Ts 3s]
Seat 2: havenots88 folded before Flop (didn't bet)
Seat 3: matiko09 folded before Flop (didn't bet)
Seat 5: riggedsh** collected ($7.12)
Seat 6: Dödi123 folded on the Flop
Seat 7: Avtovo (button) folded before Flop (didn't bet)
Seat 8: stepan0605 (small blind) folded before Flop
Seat 9: Donetsk1y (big blind) folded before Flop





PokerStars Hand #155014184083:  Hold'em No Limit (€0.25/€0.50 EUR) - 2016/06/21 13:59:45 CET [2016/06/21 7:59:45 ET]
Table 'Lotis II' 6-max Seat #1 is the button
Seat 1: AlexPles (€51.01 in chips) 
Seat 2: NoHeroHUD (€50 in chips) 
Seat 3: hmverlin (€58.55 in chips) 
Seat 4: IpMan13 (€50 in chips) 
Seat 5: KrishnaRadha (€50 in chips) 
Seat 6: matiko09 (€50 in chips) 
NoHeroHUD: posts small blind €0.25
hmverlin: posts big blind €0.50
*** HOLE CARDS ***
Dealt to matiko09 [5s 7c]
IpMan13: folds 
KrishnaRadha: folds 
matiko09: folds 
AlexPles: raises €0.62 to €1.12
NoHeroHUD: folds 
hmverlin: calls €0.62
*** FLOP *** [2c Qd 6c]
hmverlin: checks 
AlexPles: bets €1.75
hmverlin: raises €1.75 to €3.50
AlexPles: folds 
Uncalled bet (€1.75) returned to hmverlin
hmverlin collected €5.69 from pot
hmverlin: doesn't show hand 
*** SUMMARY ***
Total pot €5.99 | Rake €0.30 
Board [2c Qd 6c]
Seat 1: AlexPles (button) folded on the Flop
Seat 2: NoHeroHUD (small blind) folded before Flop
Seat 3: hmverlin (big blind) collected (€5.69)
Seat 4: IpMan13 folded before Flop (didn't bet)
Seat 5: KrishnaRadha folded before Flop (didn't bet)
Seat 6: matiko09 folded before Flop (didn't bet)





PokerStars Hand #155014184466:  Hold'em No Limit (€0.25/€0.50 EUR) - 2016/06/21 13:59:46 CET [2016/06/21 7:59:46 ET]
Table 'Actor II' 6-max Seat #5 is the button
Seat 1: NoHeroHUD (€50 in chips) 
Seat 2: alôha (€73.31 in chips) 
Seat 3: TopMo3UJlo (€50 in chips) 
Seat 4: matiko09 (€80.55 in chips) 
Seat 5: AlexPles (€50 in chips) 
Seat 6: fanmtZ (€21.36 in chips) 
fanmtZ: posts small blind €0.25
NoHeroHUD: posts big blind €0.50
*** HOLE CARDS ***
Dealt to matiko09 [2s Jh]
alôha: raises €0.75 to €1.25
TopMo3UJlo: folds 
matiko09: folds 
AlexPles: calls €1.25
fanmtZ: folds 
NoHeroHUD: folds 
*** FLOP *** [8h 7h Qd]
alôha: checks 
AlexPles: bets €2.25
alôha: raises €4.25 to €6.50
AlexPles: calls €4.25
*** TURN *** [8h 7h Qd] [6d]
alôha: checks 
AlexPles: bets €11.25
alôha: calls €11.25
*** RIVER *** [8h 7h Qd 6d] [Ts]
alôha: checks 
AlexPles: bets €31 and is all-in
alôha: folds 
Uncalled bet (€31) returned to AlexPles
AlexPles collected €36.95 from pot
AlexPles: doesn't show hand 
*** SUMMARY ***
Total pot €38.75 | Rake €1.80 
Board [8h 7h Qd 6d Ts]
Seat 1: NoHeroHUD (big blind) folded before Flop
Seat 2: alôha folded on the River
Seat 3: TopMo3UJlo folded before Flop (didn't bet)
Seat 4: matiko09 folded before Flop (didn't bet)
Seat 5: AlexPles (button) collected (€36.95)
Seat 6: fanmtZ (small blind) folded before Flop





PokerStars Hand #155014187826:  Hold'em No Limit ($0.50/$1.00 USD) - 2016/06/21 13:59:55 CET [2016/06/21 7:59:55 ET]
Table 'Amundsenia' 9-max Seat #7 is the button
Seat 2: Avtovo ($108.06 in chips) 
Seat 3: matiko09 ($100 in chips) 
Seat 4: typename27 ($17.79 in chips) 
Seat 6: King_ZéManel ($134.63 in chips) 
Seat 7: Eskimo Fox ($104 in chips) 
Seat 8: DomiVY ($49.82 in chips) 
Seat 9: MrSeymen ($49.86 in chips) 
Donetsk1y joins the table at seat #5 
DomiVY: posts small blind $0.50
MrSeymen: posts big blind $1
Troll8989: sits out 
*** HOLE CARDS ***
Dealt to matiko09 [9d 5s]
Avtovo: folds 
matiko09: folds 
typename27: calls $1
King_ZéManel: folds 
Eskimo Fox: folds 
DomiVY: folds 
MrSeymen: checks 
*** FLOP *** [2s Ks As]
MrSeymen: checks 
typename27: checks 
*** TURN *** [2s Ks As] [9s]
MrSeymen: checks 
typename27: checks 
*** RIVER *** [2s Ks As 9s] [Ah]
MrSeymen: checks 
typename27: checks 
*** SHOW DOWN ***
MrSeymen: shows [Tc 7c] (a pair of Aces)
typename27: shows [Qc Ac] (three of a kind, Aces)
typename27 collected $2.38 from pot
*** SUMMARY ***
Total pot $2.50 | Rake $0.12 
Board [2s Ks As 9s Ah]
Seat 2: Avtovo folded before Flop (didn't bet)
Seat 3: matiko09 folded before Flop (didn't bet)
Seat 4: typename27 showed [Qc Ac] and won ($2.38) with three of a kind, Aces
Seat 6: King_ZéManel folded before Flop (didn't bet)
Seat 7: Eskimo Fox (button) folded before Flop (didn't bet)
Seat 8: DomiVY (small blind) folded before Flop
Seat 9: MrSeymen (big blind) showed [Tc 7c] and lost with a pair of Aces





PokerStars Hand #155014188871:  Hold'em No Limit ($0.50/$1.00 USD) - 2016/06/21 13:59:57 CET [2016/06/21 7:59:57 ET]
Table 'Gryphia' 9-max Seat #5 is the button
Seat 1: Klappspaten0 ($100 in chips) 
Seat 2: stepan0605 ($177.95 in chips) 
Seat 3: KovIFish89 ($110.40 in chips) 
Seat 4: King Sixtus ($66.01 in chips) 
Seat 5: pardama ($100 in chips) 
Seat 7: solbi86 ($105.98 in chips) 
Seat 8: matiko09 ($112.43 in chips) 
Seat 9: djammusic ($40.55 in chips) 
solbi86: posts small blind $0.50
matiko09: posts big blind $1
*** HOLE CARDS ***
Dealt to matiko09 [6h 5s]
djammusic: folds 
Klappspaten0: calls $1
stepan0605: folds 
KovIFish89: folds 
King Sixtus: folds 
pardama: folds 
solbi86: folds 
matiko09: checks 
*** FLOP *** [2c 4c Jh]
matiko09: bets $1.55
Klappspaten0: calls $1.55
*** TURN *** [2c 4c Jh] [2d]
matiko09: checks 
Klappspaten0: bets $3
matiko09: folds 
Uncalled bet ($3) returned to Klappspaten0
Klappspaten0 collected $5.32 from pot
Klappspaten0: doesn't show hand 
*** SUMMARY ***
Total pot $5.60 | Rake $0.28 
Board [2c 4c Jh 2d]
Seat 1: Klappspaten0 collected ($5.32)
Seat 2: stepan0605 folded before Flop (didn't bet)
Seat 3: KovIFish89 folded before Flop (didn't bet)
Seat 4: King Sixtus folded before Flop (didn't bet)
Seat 5: pardama (button) folded before Flop (didn't bet)
Seat 7: solbi86 (small blind) folded before Flop
Seat 8: matiko09 (big blind) folded on the Turn
Seat 9: djammusic folded before Flop (didn't bet)





PokerStars Hand #155014189213:  Hold'em No Limit (€0.50/€1.00 EUR) - 2016/06/21 13:59:58 CET [2016/06/21 7:59:58 ET]
Table 'Tauris III' 6-max Seat #2 is the button
Seat 1: morc1us (€112.24 in chips) 
Seat 2: devil1964 (€93.16 in chips) 
Seat 3: BronKKAA (€118.98 in chips) 
Seat 4: Gigi201133 (€111.73 in chips) 
Seat 5: parraka_210 (€102.28 in chips) 
Seat 6: matiko09 (€104.02 in chips) 
BronKKAA: posts small blind €0.50
Gigi201133: posts big blind €1
*** HOLE CARDS ***
Dealt to matiko09 [4c Kc]
parraka_210: folds 
parraka_210 leaves the table
matiko09: folds 
morc1us: folds 
devil1964: calls €1
BronKKAA: calls €0.50
Gigi201133: checks 
*** FLOP *** [5h 7c 9c]
BronKKAA: checks 
Gigi201133: bets €1
devil1964: raises €2.42 to €3.42
BronKKAA: raises €10.69 to €14.11
janska.fi joins the table at seat #5 
Gigi201133: folds 
devil1964: folds 
Uncalled bet (€10.69) returned to BronKKAA
BronKKAA collected €10.30 from pot
BronKKAA: doesn't show hand 
*** SUMMARY ***
Total pot €10.84 | Rake €0.54 
Board [5h 7c 9c]
Seat 1: morc1us folded before Flop (didn't bet)
Seat 2: devil1964 (button) folded on the Flop
Seat 3: BronKKAA (small blind) collected (€10.30)
Seat 4: Gigi201133 (big blind) folded on the Flop
Seat 5: parraka_210 folded before Flop (didn't bet)
Seat 6: matiko09 folded before Flop (didn't bet)





PokerStars Hand #155014190291:  Hold'em No Limit ($0.50/$1.00 USD) - 2016/06/21 14:00:01 CET [2016/06/21 8:00:01 ET]
Table 'Lamberta II' 9-max Seat #4 is the button
Seat 1: mbk88 ($243.80 in chips) 
Seat 3: matiko09 ($106.18 in chips) 
Seat 4: Eskimo Fox ($118.39 in chips) 
Seat 5: CoolFireX ($113.22 in chips) 
Seat 6: Chen423 ($112.82 in chips) 
Seat 7: 23SmOkEr07 ($199.04 in chips) 
Seat 8: Troll8989 ($100.25 in chips) 
Seat 9: Sjtu_Michael ($98.50 in chips) 
CoolFireX: posts small blind $0.50
Chen423: posts big blind $1
*** HOLE CARDS ***
Dealt to matiko09 [Ad 4s]
23SmOkEr07: folds 
Troll8989: folds 
Sjtu_Michael: raises $2 to $3
mbk88: folds 
mavin80 said, "Such a bull ****"
matiko09: folds 
Eskimo Fox: folds 
CoolFireX: folds 
Chen423: calls $2
*** FLOP *** [As Th 3c]
mavin80 said, "Pokerstars lets idiots win over and over again??"
Chen423: checks 
Sjtu_Michael: bets $3.09
Chen423: calls $3.09
*** TURN *** [As Th 3c] [5h]
Chen423: checks 
Sjtu_Michael: bets $8
Chen423: calls $8
*** RIVER *** [As Th 3c 5h] [Ks]
Chen423: checks 
Sjtu_Michael: bets $20
Chen423: folds 
Uncalled bet ($20) returned to Sjtu_Michael
Sjtu_Michael collected $27.25 from pot
*** SUMMARY ***
Total pot $28.68 | Rake $1.43 
Board [As Th 3c 5h Ks]
Seat 1: mbk88 folded before Flop (didn't bet)
Seat 3: matiko09 folded before Flop (didn't bet)
Seat 4: Eskimo Fox (button) folded before Flop (didn't bet)
Seat 5: CoolFireX (small blind) folded before Flop
Seat 6: Chen423 (big blind) folded on the River
Seat 7: 23SmOkEr07 folded before Flop (didn't bet)
Seat 8: Troll8989 folded before Flop (didn't bet)
Seat 9: Sjtu_Michael collected ($27.25)





PokerStars Hand #155014197033:  Hold'em No Limit (€0.25/€0.50 EUR) - 2016/06/21 14:00:18 CET [2016/06/21 8:00:18 ET]
Table 'Lotis II' 6-max Seat #2 is the button
Seat 1: AlexPles (€50 in chips) 
Seat 2: NoHeroHUD (€50 in chips) 
Seat 3: hmverlin (€61.37 in chips) 
Seat 4: IpMan13 (€50 in chips) 
Seat 5: KrishnaRadha (€50 in chips) 
Seat 6: matiko09 (€50 in chips) 
hmverlin: posts small blind €0.25
IpMan13: posts big blind €0.50
*** HOLE CARDS ***
Dealt to matiko09 [5d 3d]
KrishnaRadha: folds 
matiko09: folds 
AlexPles: folds 
NoHeroHUD: raises €0.50 to €1
hmverlin: folds 
IpMan13: folds 
Uncalled bet (€0.50) returned to NoHeroHUD
NoHeroHUD collected €1.25 from pot
NoHeroHUD: doesn't show hand 
*** SUMMARY ***
Total pot €1.25 | Rake €0 
Seat 1: AlexPles folded before Flop (didn't bet)
Seat 2: NoHeroHUD (button) collected (€1.25)
Seat 3: hmverlin (small blind) folded before Flop
Seat 4: IpMan13 (big blind) folded before Flop
Seat 5: KrishnaRadha folded before Flop (didn't bet)
Seat 6: matiko09 folded before Flop (didn't bet)





PokerStars Hand #155014201413:  Hold'em No Limit ($0.50/$1.00 USD) - 2016/06/21 14:00:29 CET [2016/06/21 8:00:29 ET]
Table 'Schurer II' 9-max Seat #8 is the button
Seat 1: Dantist1122 ($100 in chips) 
Seat 2: havenots88 ($92 in chips) 
Seat 3: matiko09 ($103.65 in chips) 
Seat 5: riggedsh** ($119.62 in chips) 
Seat 6: Dödi123 ($128.89 in chips) 
Seat 7: Avtovo ($109.08 in chips) 
Seat 8: stepan0605 ($98.50 in chips) 
Seat 9: Donetsk1y ($100 in chips) 
Donetsk1y: posts small blind $0.50
Dantist1122: posts big blind $1
hurtNCYDE: sits out 
*** HOLE CARDS ***
Dealt to matiko09 [Kh Ah]
havenots88: folds 
matiko09: raises $2 to $3
riggedsh**: folds 
Dödi123: folds 
Avtovo: folds 
stepan0605: folds 
Donetsk1y: folds 
Dantist1122: folds 
Uncalled bet ($2) returned to matiko09
matiko09 collected $2.50 from pot
matiko09: doesn't show hand 
*** SUMMARY ***
Total pot $2.50 | Rake $0 
Seat 1: Dantist1122 (big blind) folded before Flop
Seat 2: havenots88 folded before Flop (didn't bet)
Seat 3: matiko09 collected ($2.50)
Seat 5: riggedsh** folded before Flop (didn't bet)
Seat 6: Dödi123 folded before Flop (didn't bet)
Seat 7: Avtovo folded before Flop (didn't bet)
Seat 8: stepan0605 (button) folded before Flop (didn't bet)
Seat 9: Donetsk1y (small blind) folded before Flop





PokerStars Hand #155014204496:  Hold'em No Limit ($0.50/$1.00 USD) - 2016/06/21 14:00:36 CET [2016/06/21 8:00:36 ET]
Table 'Megrez II' 9-max Seat #1 is the button
Seat 1: hurtNCYDE ($114.91 in chips) 
Seat 2: Filojoes ($138.14 in chips) 
Seat 3: Troll8989 ($104.22 in chips) 
Seat 4: matiko09 ($100 in chips) 
Seat 6: stepan0605 ($79.98 in chips) 
Seat 7: CoolFireX ($136.49 in chips) 
Seat 8: Menno78 ($91.67 in chips) 
Seat 9: MarioDong ($120.81 in chips) 
Filojoes: posts small blind $0.50
Troll8989: posts big blind $1
pardama: sits out 
*** HOLE CARDS ***
Dealt to matiko09 [6d 5c]
matiko09: folds 
stepan0605: folds 
CoolFireX: raises $2 to $3
Menno78: folds 
MarioDong: folds 
hurtNCYDE: folds 
Filojoes: calls $2.50
Troll8989: folds 
*** FLOP *** [2c 6c 9d]
Filojoes: checks 
CoolFireX: bets $4
Filojoes: calls $4
*** TURN *** [2c 6c 9d] [8s]
Filojoes: checks 
CoolFireX: checks 
*** RIVER *** [2c 6c 9d 8s] [Qc]
Filojoes: checks 
CoolFireX: checks 
*** SHOW DOWN ***
Filojoes: shows [Qh Ac] (a pair of Queens)
CoolFireX: mucks hand 
Filojoes collected $14.25 from pot
*** SUMMARY ***
Total pot $15 | Rake $0.75 
Board [2c 6c 9d 8s Qc]
Seat 1: hurtNCYDE (button) folded before Flop (didn't bet)
Seat 2: Filojoes (small blind) showed [Qh Ac] and won ($14.25) with a pair of Queens
Seat 3: Troll8989 (big blind) folded before Flop
Seat 4: matiko09 folded before Flop (didn't bet)
Seat 6: stepan0605 folded before Flop (didn't bet)
Seat 7: CoolFireX mucked [Ad 5d]
Seat 8: Menno78 folded before Flop (didn't bet)
Seat 9: MarioDong folded before Flop (didn't bet)





PokerStars Hand #155014207664:  Hold'em No Limit ($0.50/$1.00 USD) - 2016/06/21 14:00:44 CET [2016/06/21 8:00:44 ET]
Table 'Moreau' 9-max Seat #9 is the button
Seat 1: hurtNCYDE ($100 in chips) 
Seat 2: Avtovo ($106 in chips) 
Seat 3: matiko09 ($100 in chips) 
Seat 4: SharingaaN ($163.30 in chips) 
Seat 5: CoolFireX ($100 in chips) 
Seat 6: Troll8989 ($103.60 in chips) 
Seat 7: PanKwn15 ($105.92 in chips) 
Seat 8: mi$$I$Elena ($112.62 in chips) 
Seat 9: Toonersens ($108.34 in chips) 
hurtNCYDE: posts small blind $0.50
Avtovo: posts big blind $1
*** HOLE CARDS ***
Dealt to matiko09 [Ts 3s]
matiko09: folds 
SharingaaN: folds 
CoolFireX: folds 
Troll8989: folds 
PanKwn15: folds 
mi$$I$Elena: folds 
Toonersens: folds 
hurtNCYDE: folds 
Uncalled bet ($0.50) returned to Avtovo
Avtovo collected $1 from pot
Avtovo: doesn't show hand 
*** SUMMARY ***
Total pot $1 | Rake $0 
Seat 1: hurtNCYDE (small blind) folded before Flop
Seat 2: Avtovo (big blind) collected ($1)
Seat 3: matiko09 folded before Flop (didn't bet)
Seat 4: SharingaaN folded before Flop (didn't bet)
Seat 5: CoolFireX folded before Flop (didn't bet)
Seat 6: Troll8989 folded before Flop (didn't bet)
Seat 7: PanKwn15 folded before Flop (didn't bet)
Seat 8: mi$$I$Elena folded before Flop (didn't bet)
Seat 9: Toonersens (button) folded before Flop (didn't bet)





PokerStars Hand #155014209330:  Hold'em No Limit ($0.50/$1.00 USD) - 2016/06/21 14:00:48 CET [2016/06/21 8:00:48 ET]
Table 'Amundsenia' 9-max Seat #8 is the button
Seat 1: Troll8989 ($100 in chips) 
Seat 2: Avtovo ($108.06 in chips) 
Seat 3: matiko09 ($100 in chips) 
Seat 4: typename27 ($19.17 in chips) 
Seat 6: King_ZéManel ($134.63 in chips) 
Seat 7: Eskimo Fox ($104 in chips) 
Seat 8: DomiVY ($49.32 in chips) 
Seat 9: MrSeymen ($48.86 in chips) 
MrSeymen: posts small blind $0.50
Troll8989: posts big blind $1
*** HOLE CARDS ***
Dealt to matiko09 [5h 5d]
Avtovo: folds 
matiko09: raises $2 to $3
typename27: folds 
King_ZéManel: folds 
Eskimo Fox: folds 
DomiVY: folds 
MrSeymen: folds 
Troll8989: folds 
Uncalled bet ($2) returned to matiko09
matiko09 collected $2.50 from pot
matiko09: doesn't show hand 
*** SUMMARY ***
Total pot $2.50 | Rake $0 
Seat 1: Troll8989 (big blind) folded before Flop
Seat 2: Avtovo folded before Flop (didn't bet)
Seat 3: matiko09 collected ($2.50)
Seat 4: typename27 folded before Flop (didn't bet)
Seat 6: King_ZéManel folded before Flop (didn't bet)
Seat 7: Eskimo Fox folded before Flop (didn't bet)
Seat 8: DomiVY (button) folded before Flop (didn't bet)
Seat 9: MrSeymen (small blind) folded before Flop





PokerStars Hand #155014211228:  Hold'em No Limit (€0.25/€0.50 EUR) - 2016/06/21 14:00:52 CET [2016/06/21 8:00:52 ET]
Table 'Lotis II' 6-max Seat #3 is the button
Seat 1: AlexPles (€50 in chips) 
Seat 2: NoHeroHUD (€50.75 in chips) 
Seat 3: hmverlin (€61.12 in chips) 
Seat 4: IpMan13 (€50 in chips) 
Seat 5: KrishnaRadha (€50 in chips) 
Seat 6: matiko09 (€50 in chips) 
IpMan13: posts small blind €0.25
KrishnaRadha: posts big blind €0.50
*** HOLE CARDS ***
Dealt to matiko09 [2d 7s]
matiko09: folds 
AlexPles: folds 
NoHeroHUD: folds 
hmverlin: raises €1 to €1.50
IpMan13: raises €3.50 to €5
KrishnaRadha: folds 
hmverlin: calls €3.50
*** FLOP *** [Qh 3c 5h]
IpMan13: bets €5
hmverlin: calls €5
*** TURN *** [Qh 3c 5h] [Qc]
IpMan13: checks 
hmverlin: bets €6
IpMan13: calls €6
*** RIVER *** [Qh 3c 5h Qc] [Td]
IpMan13: checks 
hmverlin: checks 
*** SHOW DOWN ***
IpMan13: shows [Jd Jc] (two pair, Queens and Jacks)
hmverlin: mucks hand 
IpMan13 collected €30.88 from pot
*** SUMMARY ***
Total pot €32.50 | Rake €1.62 
Board [Qh 3c 5h Qc Td]
Seat 1: AlexPles folded before Flop (didn't bet)
Seat 2: NoHeroHUD folded before Flop (didn't bet)
Seat 3: hmverlin (button) mucked [4d 5d]
Seat 4: IpMan13 (small blind) showed [Jd Jc] and won (€30.88) with two pair, Queens and Jacks
Seat 5: KrishnaRadha (big blind) folded before Flop
Seat 6: matiko09 folded before Flop (didn't bet)





PokerStars Hand #155014213388:  Hold'em No Limit ($0.50/$1.00 USD) - 2016/06/21 14:00:57 CET [2016/06/21 8:00:57 ET]
Table 'Schurer II' 9-max Seat #9 is the button
Seat 1: Dantist1122 ($100 in chips) 
Seat 2: havenots88 ($92 in chips) 
Seat 3: matiko09 ($105.15 in chips) 
Seat 5: riggedsh** ($119.62 in chips) 
Seat 6: Dödi123 ($128.89 in chips) 
Seat 7: Avtovo ($109.08 in chips) 
Seat 8: stepan0605 ($98.50 in chips) 
Seat 9: Donetsk1y ($100 in chips) 
Dantist1122: posts small blind $0.50
havenots88: posts big blind $1
hurtNCYDE: sits out 
*** HOLE CARDS ***
Dealt to matiko09 [Th 7h]
matiko09: folds 
riggedsh**: folds 
Dödi123: folds 
Avtovo: folds 
stepan0605: raises $1 to $2
Donetsk1y: folds 
Dantist1122: folds 
havenots88: calls $1
*** FLOP *** [2c Jd 9h]
havenots88: checks 
stepan0605: bets $3
havenots88: folds 
Uncalled bet ($3) returned to stepan0605
stepan0605 collected $4.28 from pot
stepan0605: doesn't show hand 
*** SUMMARY ***
Total pot $4.50 | Rake $0.22 
Board [2c Jd 9h]
Seat 1: Dantist1122 (small blind) folded before Flop
Seat 2: havenots88 (big blind) folded on the Flop
Seat 3: matiko09 folded before Flop (didn't bet)
Seat 5: riggedsh** folded before Flop (didn't bet)
Seat 6: Dödi123 folded before Flop (didn't bet)
Seat 7: Avtovo folded before Flop (didn't bet)
Seat 8: stepan0605 collected ($4.28)
Seat 9: Donetsk1y (button) folded before Flop (didn't bet)





PokerStars Hand #155014217019:  Hold'em No Limit ($0.50/$1.00 USD) - 2016/06/21 14:01:06 CET [2016/06/21 8:01:06 ET]
Table 'Gryphia' 9-max Seat #7 is the button
Seat 1: Klappspaten0 ($102.77 in chips) 
Seat 2: stepan0605 ($177.95 in chips) 
Seat 3: KovIFish89 ($110.40 in chips) 
Seat 4: King Sixtus ($66.01 in chips) 
Seat 5: pardama ($100 in chips) 
Seat 6: Dandy Monk ($40.14 in chips) 
Seat 7: solbi86 ($105.48 in chips) 
Seat 8: matiko09 ($109.88 in chips) 
Seat 9: djammusic ($40.55 in chips) 
matiko09: posts small blind $0.50
djammusic: posts big blind $1
Dandy Monk: posts small blind $0.50
*** HOLE CARDS ***
Dealt to matiko09 [6c Ts]
Klappspaten0: folds 
stepan0605: folds 
KovIFish89: folds 
King Sixtus has timed out
King Sixtus: folds 
pardama: folds 
Dandy Monk: calls $1
solbi86: raises $3 to $4
matiko09: folds 
djammusic: raises $36.50 to $40.50
Dandy Monk: folds 
solbi86: folds 
Uncalled bet ($36.50) returned to djammusic
djammusic collected $10 from pot
djammusic: doesn't show hand 
*** SUMMARY ***
Total pot $10 | Rake $0 
Seat 1: Klappspaten0 folded before Flop (didn't bet)
Seat 2: stepan0605 folded before Flop (didn't bet)
Seat 3: KovIFish89 folded before Flop (didn't bet)
Seat 4: King Sixtus folded before Flop (didn't bet)
Seat 5: pardama folded before Flop (didn't bet)
Seat 6: Dandy Monk folded before Flop
Seat 7: solbi86 (button) folded before Flop
Seat 8: matiko09 (small blind) folded before Flop
Seat 9: djammusic (big blind) collected ($10)





PokerStars Hand #155014220086:  Hold'em No Limit ($0.50/$1.00 USD) - 2016/06/21 14:01:13 CET [2016/06/21 8:01:13 ET]
Table 'Amundsenia' 9-max Seat #9 is the button
Seat 1: Troll8989 ($100 in chips) 
Seat 2: Avtovo ($108.06 in chips) 
Seat 3: matiko09 ($101.50 in chips) 
Seat 4: typename27 ($19.17 in chips) 
Seat 6: King_ZéManel ($134.63 in chips) 
Seat 7: Eskimo Fox ($104 in chips) 
Seat 8: DomiVY ($49.32 in chips) 
Seat 9: MrSeymen ($48.36 in chips) 
Troll8989: posts small blind $0.50
Avtovo: posts big blind $1
*** HOLE CARDS ***
Dealt to matiko09 [3h 2c]
matiko09: folds 
typename27: folds 
King_ZéManel: folds 
Eskimo Fox: folds 
Donetsk1y leaves the table
ozone2003 joins the table at seat #5 
DomiVY: raises $2 to $3
MrSeymen: folds 
Troll8989: folds 
Avtovo: folds 
Uncalled bet ($2) returned to DomiVY
DomiVY collected $2.50 from pot
DomiVY: doesn't show hand 
*** SUMMARY ***
Total pot $2.50 | Rake $0 
Seat 1: Troll8989 (small blind) folded before Flop
Seat 2: Avtovo (big blind) folded before Flop
Seat 3: matiko09 folded before Flop (didn't bet)
Seat 4: typename27 folded before Flop (didn't bet)
Seat 6: King_ZéManel folded before Flop (didn't bet)
Seat 7: Eskimo Fox folded before Flop (didn't bet)
Seat 8: DomiVY collected ($2.50)
Seat 9: MrSeymen (button) folded before Flop (didn't bet)





PokerStars Hand #155014221263:  Hold'em No Limit ($0.50/$1.00 USD) - 2016/06/21 14:01:16 CET [2016/06/21 8:01:16 ET]
Table 'Pemba' 9-max Seat #2 is the button
Seat 1: pardama ($101 in chips) 
Seat 2: Dantist1122 ($100 in chips) 
Seat 3: CoolFireX ($363.04 in chips) 
Seat 4: Filojoes ($101 in chips) 
Seat 5: djammusic ($50.58 in chips) 
Seat 6: matiko09 ($110.60 in chips) 
Seat 7: mi$$I$Elena ($103.52 in chips) 
Seat 8: chaps1988 ($100 in chips) 
Seat 9: Eskimo Fox ($100 in chips) 
CoolFireX: posts small blind $0.50
Filojoes: posts big blind $1
*** HOLE CARDS ***
Dealt to matiko09 [2h Qd]
djammusic: folds 
matiko09: folds 
djammusic leaves the table
mi$$I$Elena: folds 
chaps1988: folds 
SharingaaN joins the table at seat #5 
Eskimo Fox: raises $1.50 to $2.50
pardama: raises $6.50 to $9
Dantist1122: folds 
CoolFireX: folds 
Filojoes: folds 
Eskimo Fox: raises $12 to $21
pardama: folds 
Uncalled bet ($12) returned to Eskimo Fox
Eskimo Fox collected $19.50 from pot
Eskimo Fox: doesn't show hand 
*** SUMMARY ***
Total pot $19.50 | Rake $0 
Seat 1: pardama folded before Flop
Seat 2: Dantist1122 (button) folded before Flop (didn't bet)
Seat 3: CoolFireX (small blind) folded before Flop
Seat 4: Filojoes (big blind) folded before Flop
Seat 5: djammusic folded before Flop (didn't bet)
Seat 6: matiko09 folded before Flop (didn't bet)
Seat 7: mi$$I$Elena folded before Flop (didn't bet)
Seat 8: chaps1988 folded before Flop (didn't bet)
Seat 9: Eskimo Fox collected ($19.50)





PokerStars Hand #155014222203:  Hold'em No Limit ($0.50/$1.00 USD) - 2016/06/21 14:01:18 CET [2016/06/21 8:01:18 ET]
Table 'Lamberta II' 9-max Seat #5 is the button
Seat 1: mbk88 ($243.80 in chips) 
Seat 3: matiko09 ($106.18 in chips) 
Seat 4: Eskimo Fox ($118.39 in chips) 
Seat 5: CoolFireX ($112.72 in chips) 
Seat 6: Chen423 ($98.73 in chips) 
Seat 7: 23SmOkEr07 ($199.04 in chips) 
Seat 8: Troll8989 ($100.25 in chips) 
Seat 9: Sjtu_Michael ($111.66 in chips) 
Chen423: posts small blind $0.50
23SmOkEr07: posts big blind $1
*** HOLE CARDS ***
Dealt to matiko09 [Tc Jh]
Troll8989: folds 
Sjtu_Michael: folds 
mbk88: raises $2 to $3
matiko09: folds 
mavin80 said, "Mbk88 u r just fu ck wit idiot"
Eskimo Fox: folds 
CoolFireX: folds 
Chen423: folds 
23SmOkEr07: folds 
Uncalled bet ($2) returned to mbk88
mbk88 collected $2.50 from pot
mbk88: doesn't show hand 
*** SUMMARY ***
Total pot $2.50 | Rake $0 
Seat 1: mbk88 collected ($2.50)
Seat 3: matiko09 folded before Flop (didn't bet)
Seat 4: Eskimo Fox folded before Flop (didn't bet)
Seat 5: CoolFireX (button) folded before Flop (didn't bet)
Seat 6: Chen423 (small blind) folded before Flop
Seat 7: 23SmOkEr07 (big blind) folded before Flop
Seat 8: Troll8989 folded before Flop (didn't bet)
Seat 9: Sjtu_Michael folded before Flop (didn't bet)





PokerStars Hand #155014222341:  Hold'em No Limit ($0.50/$1.00 USD) - 2016/06/21 14:01:18 CET [2016/06/21 8:01:18 ET]
Table 'Moreau' 9-max Seat #1 is the button
Seat 1: hurtNCYDE ($100 in chips) 
Seat 2: Avtovo ($106.50 in chips) 
Seat 3: matiko09 ($100 in chips) 
Seat 4: SharingaaN ($163.30 in chips) 
Seat 5: CoolFireX ($100 in chips) 
Seat 6: Troll8989 ($103.60 in chips) 
Seat 7: PanKwn15 ($105.92 in chips) 
Seat 8: mi$$I$Elena ($112.62 in chips) 
Seat 9: Toonersens ($108.34 in chips) 
Avtovo: posts small blind $0.50
matiko09: posts big blind $1
*** HOLE CARDS ***
Dealt to matiko09 [6d 4h]
SharingaaN: raises $1 to $2
CoolFireX: folds 
Troll8989: folds 
PanKwn15: folds 
mi$$I$Elena: folds 
Toonersens: folds 
hurtNCYDE: folds 
Avtovo: folds 
matiko09: folds 
Uncalled bet ($1) returned to SharingaaN
SharingaaN collected $2.50 from pot
SharingaaN: doesn't show hand 
*** SUMMARY ***
Total pot $2.50 | Rake $0 
Seat 1: hurtNCYDE (button) folded before Flop (didn't bet)
Seat 2: Avtovo (small blind) folded before Flop
Seat 3: matiko09 (big blind) folded before Flop
Seat 4: SharingaaN collected ($2.50)
Seat 5: CoolFireX folded before Flop (didn't bet)
Seat 6: Troll8989 folded before Flop (didn't bet)
Seat 7: PanKwn15 folded before Flop (didn't bet)
Seat 8: mi$$I$Elena folded before Flop (didn't bet)
Seat 9: Toonersens folded before Flop (didn't bet)





PokerStars Hand #155014231451:  Hold'em No Limit ($0.50/$1.00 USD) - 2016/06/21 14:01:39 CET [2016/06/21 8:01:39 ET]
Table 'Schurer II' 9-max Seat #1 is the button
Seat 1: Dantist1122 ($100 in chips) 
Seat 2: havenots88 ($90 in chips) 
Seat 3: matiko09 ($105.15 in chips) 
Seat 5: riggedsh** ($119.62 in chips) 
Seat 6: Dödi123 ($128.89 in chips) 
Seat 7: Avtovo ($109.08 in chips) 
Seat 8: stepan0605 ($100.78 in chips) 
Seat 9: Donetsk1y ($100 in chips) 
havenots88: posts small blind $0.50
matiko09: posts big blind $1
hurtNCYDE: sits out 
*** HOLE CARDS ***
Dealt to matiko09 [9c 2h]
riggedsh**: folds 
Dödi123: folds 
Avtovo: folds 
stepan0605: folds 
Donetsk1y: folds 
Dantist1122: folds 
havenots88: folds 
Uncalled bet ($0.50) returned to matiko09
matiko09 collected $1 from pot
matiko09: doesn't show hand 
*** SUMMARY ***
Total pot $1 | Rake $0 
Seat 1: Dantist1122 (button) folded before Flop (didn't bet)
Seat 2: havenots88 (small blind) folded before Flop
Seat 3: matiko09 (big blind) collected ($1)
Seat 5: riggedsh** folded before Flop (didn't bet)
Seat 6: Dödi123 folded before Flop (didn't bet)
Seat 7: Avtovo folded before Flop (didn't bet)
Seat 8: stepan0605 folded before Flop (didn't bet)
Seat 9: Donetsk1y folded before Flop (didn't bet)





PokerStars Hand #155014235150:  Hold'em No Limit ($0.50/$1.00 USD) - 2016/06/21 14:01:48 CET [2016/06/21 8:01:48 ET]
Table 'Moreau' 9-max Seat #2 is the button
Seat 1: hurtNCYDE ($100 in chips) 
Seat 2: Avtovo ($106 in chips) 
Seat 3: matiko09 ($100 in chips) 
Seat 5: CoolFireX ($100 in chips) 
Seat 6: Troll8989 ($103.60 in chips) 
Seat 7: PanKwn15 ($105.92 in chips) 
Seat 8: mi$$I$Elena ($112.62 in chips) 
Seat 9: Toonersens ($108.34 in chips) 
matiko09: posts small blind $0.50
SharingaaN: is sitting out 
CoolFireX: posts big blind $1
*** HOLE CARDS ***
Dealt to matiko09 [5d 5s]
Troll8989 has timed out
Troll8989: folds 
PanKwn15: folds 
mi$$I$Elena: folds 
Toonersens: raises $2 to $3
hurtNCYDE: folds 
Avtovo: folds 
matiko09: folds 
CoolFireX: calls $2
*** FLOP *** [7c 9s 5c]
CoolFireX: checks 
Toonersens: bets $4
CoolFireX: raises $14.18 to $18.18
Toonersens: folds 
Uncalled bet ($14.18) returned to CoolFireX
CoolFireX collected $13.78 from pot
CoolFireX: doesn't show hand 
*** SUMMARY ***
Total pot $14.50 | Rake $0.72 
Board [7c 9s 5c]
Seat 1: hurtNCYDE folded before Flop (didn't bet)
Seat 2: Avtovo (button) folded before Flop (didn't bet)
Seat 3: matiko09 (small blind) folded before Flop
Seat 5: CoolFireX (big blind) collected ($13.78)
Seat 6: Troll8989 folded before Flop (didn't bet)
Seat 7: PanKwn15 folded before Flop (didn't bet)
Seat 8: mi$$I$Elena folded before Flop (didn't bet)
Seat 9: Toonersens folded on the Flop





PokerStars Hand #155014237008:  Hold'em No Limit ($0.50/$1.00 USD) - 2016/06/21 14:01:52 CET [2016/06/21 8:01:52 ET]
Table 'Amundsenia' 9-max Seat #1 is the button
Seat 1: Troll8989 ($100 in chips) 
Seat 2: Avtovo ($107.06 in chips) 
Seat 3: matiko09 ($101.50 in chips) 
Seat 4: typename27 ($19.17 in chips) 
Seat 6: King_ZéManel ($134.63 in chips) 
Seat 7: Eskimo Fox ($104 in chips) 
Seat 8: DomiVY ($50.82 in chips) 
Seat 9: MrSeymen ($48.36 in chips) 
Avtovo: posts small blind $0.50
matiko09: posts big blind $1
ozone2003: sits out 
*** HOLE CARDS ***
Dealt to matiko09 [6d 4c]
typename27: calls $1
King_ZéManel: folds 
Eskimo Fox: folds 
DomiVY: folds 
MrSeymen: folds 
Troll8989: folds 
Avtovo: folds 
matiko09: checks 
*** FLOP *** [8h 2s Jh]
matiko09: checks 
typename27: bets $2.38
matiko09: folds 
Uncalled bet ($2.38) returned to typename27
typename27 collected $2.38 from pot
typename27: doesn't show hand 
*** SUMMARY ***
Total pot $2.50 | Rake $0.12 
Board [8h 2s Jh]
Seat 1: Troll8989 (button) folded before Flop (didn't bet)
Seat 2: Avtovo (small blind) folded before Flop
Seat 3: matiko09 (big blind) folded on the Flop
Seat 4: typename27 collected ($2.38)
Seat 6: King_ZéManel folded before Flop (didn't bet)
Seat 7: Eskimo Fox folded before Flop (didn't bet)
Seat 8: DomiVY folded before Flop (didn't bet)
Seat 9: MrSeymen folded before Flop (didn't bet)





PokerStars Hand #155014238040:  Hold'em No Limit ($0.50/$1.00 USD) - 2016/06/21 14:01:55 CET [2016/06/21 8:01:55 ET]
Table 'Pemba' 9-max Seat #3 is the button
Seat 1: pardama ($100 in chips) 
Seat 2: Dantist1122 ($100 in chips) 
Seat 3: CoolFireX ($362.54 in chips) 
Seat 4: Filojoes ($100 in chips) 
Seat 5: SharingaaN ($97.77 in chips) 
Seat 6: matiko09 ($110.60 in chips) 
Seat 7: mi$$I$Elena ($103.52 in chips) 
Seat 8: chaps1988 ($100 in chips) 
Seat 9: Eskimo Fox ($110.50 in chips) 
Filojoes: posts small blind $0.50
SharingaaN: posts big blind $1
*** HOLE CARDS ***
Dealt to matiko09 [Jh 6h]
matiko09: folds 
mi$$I$Elena: raises $1.38 to $2.38
chaps1988: folds 
Eskimo Fox: calls $2.38
pardama: folds 
Dantist1122: folds 
CoolFireX: calls $2.38
Filojoes: folds 
SharingaaN: folds 
*** FLOP *** [Qd As 8h]
mi$$I$Elena: checks 
Eskimo Fox: checks 
CoolFireX: checks 
*** TURN *** [Qd As 8h] [Jd]
mi$$I$Elena: bets $5
Eskimo Fox: folds 
CoolFireX: folds 
Uncalled bet ($5) returned to mi$$I$Elena
mi$$I$Elena collected $8.21 from pot
mi$$I$Elena: doesn't show hand 
*** SUMMARY ***
Total pot $8.64 | Rake $0.43 
Board [Qd As 8h Jd]
Seat 1: pardama folded before Flop (didn't bet)
Seat 2: Dantist1122 folded before Flop (didn't bet)
Seat 3: CoolFireX (button) folded on the Turn
Seat 4: Filojoes (small blind) folded before Flop
Seat 5: SharingaaN (big blind) folded before Flop
Seat 6: matiko09 folded before Flop (didn't bet)
Seat 7: mi$$I$Elena collected ($8.21)
Seat 8: chaps1988 folded before Flop (didn't bet)
Seat 9: Eskimo Fox folded on the Turn





PokerStars Hand #155014238734:  Hold'em No Limit (€0.25/€0.50 EUR) - 2016/06/21 14:01:56 CET [2016/06/21 8:01:56 ET]
Table 'Lotis II' 6-max Seat #4 is the button
Seat 1: AlexPles (€50 in chips) 
Seat 2: NoHeroHUD (€50.75 in chips) 
Seat 3: hmverlin (€45.12 in chips) 
Seat 4: IpMan13 (€64.88 in chips) 
Seat 5: KrishnaRadha (€50 in chips) 
Seat 6: matiko09 (€50 in chips) 
KrishnaRadha: posts small blind €0.25
matiko09: posts big blind €0.50
*** HOLE CARDS ***
Dealt to matiko09 [6h Th]
AlexPles: folds 
NoHeroHUD: raises €0.75 to €1.25
hmverlin: folds 
IpMan13: folds 
KrishnaRadha: folds 
matiko09: folds 
Uncalled bet (€0.75) returned to NoHeroHUD
NoHeroHUD collected €1.25 from pot
NoHeroHUD: doesn't show hand 
*** SUMMARY ***
Total pot €1.25 | Rake €0 
Seat 1: AlexPles folded before Flop (didn't bet)
Seat 2: NoHeroHUD collected (€1.25)
Seat 3: hmverlin folded before Flop (didn't bet)
Seat 4: IpMan13 (button) folded before Flop (didn't bet)
Seat 5: KrishnaRadha (small blind) folded before Flop
Seat 6: matiko09 (big blind) folded before Flop





PokerStars Hand #155014239006:  Hold'em No Limit ($0.50/$1.00 USD) - 2016/06/21 14:01:57 CET [2016/06/21 8:01:57 ET]
Table 'Schurer II' 9-max Seat #2 is the button
Seat 1: Dantist1122 ($100 in chips) 
Seat 2: havenots88 ($89.50 in chips) 
Seat 3: matiko09 ($105.65 in chips) 
Seat 4: hurtNCYDE ($100 in chips) 
Seat 5: riggedsh** ($119.62 in chips) 
Seat 6: Dödi123 ($128.89 in chips) 
Seat 7: Avtovo ($109.08 in chips) 
Seat 8: stepan0605 ($100.78 in chips) 
Seat 9: Donetsk1y ($100 in chips) 
matiko09: posts small blind $0.50
hurtNCYDE: posts big blind $1
*** HOLE CARDS ***
Dealt to matiko09 [Jc 7s]
riggedsh**: folds 
Dödi123: folds 
Avtovo: folds 
stepan0605: folds 
Donetsk1y: folds 
Dantist1122: folds 
havenots88: raises $2 to $3
matiko09: folds 
hurtNCYDE: folds 
Uncalled bet ($2) returned to havenots88
havenots88 collected $2.50 from pot
havenots88: doesn't show hand 
*** SUMMARY ***
Total pot $2.50 | Rake $0 
Seat 1: Dantist1122 folded before Flop (didn't bet)
Seat 2: havenots88 (button) collected ($2.50)
Seat 3: matiko09 (small blind) folded before Flop
Seat 4: hurtNCYDE (big blind) folded before Flop
Seat 5: riggedsh** folded before Flop (didn't bet)
Seat 6: Dödi123 folded before Flop (didn't bet)
Seat 7: Avtovo folded before Flop (didn't bet)
Seat 8: stepan0605 folded before Flop (didn't bet)
Seat 9: Donetsk1y folded before Flop (didn't bet)





PokerStars Hand #155014242981:  Hold'em No Limit (€0.50/€1.00 EUR) - 2016/06/21 14:02:06 CET [2016/06/21 8:02:06 ET]
Table 'Tauris III' 6-max Seat #3 is the button
Seat 1: morc1us (€112.24 in chips) 
Seat 2: devil1964 (€88.74 in chips) 
Seat 3: BronKKAA (€124.86 in chips) 
Seat 4: Gigi201133 (€109.73 in chips) 
Seat 6: matiko09 (€104.02 in chips) 
Gigi201133: posts small blind €0.50
matiko09: posts big blind €1
*** HOLE CARDS ***
Dealt to matiko09 [8d Th]
morc1us: folds 
devil1964: calls €1
BronKKAA: folds 
Gigi201133: calls €0.50
matiko09: checks 
*** FLOP *** [6c 3d 6d]
Gigi201133: bets €1
matiko09: folds 
devil1964: calls €1
*** TURN *** [6c 3d 6d] [As]
Gigi201133: bets €2
devil1964: calls €2
*** RIVER *** [6c 3d 6d As] [7d]
Gigi201133: bets €4
devil1964: folds 
Uncalled bet (€4) returned to Gigi201133
Gigi201133 collected €8.55 from pot
*** SUMMARY ***
Total pot €9 | Rake €0.45 
Board [6c 3d 6d As 7d]
Seat 1: morc1us folded before Flop (didn't bet)
Seat 2: devil1964 folded on the River
Seat 3: BronKKAA (button) folded before Flop (didn't bet)
Seat 4: Gigi201133 (small blind) collected (€8.55)
Seat 6: matiko09 (big blind) folded on the Flop





PokerStars Hand #155014243853:  Hold'em No Limit ($0.50/$1.00 USD) - 2016/06/21 14:02:08 CET [2016/06/21 8:02:08 ET]
Table 'Gryphia' 9-max Seat #8 is the button
Seat 1: Klappspaten0 ($102.77 in chips) 
Seat 2: stepan0605 ($177.95 in chips) 
Seat 3: KovIFish89 ($110.40 in chips) 
Seat 4: King Sixtus ($66.01 in chips) 
Seat 5: pardama ($100 in chips) 
Seat 6: Dandy Monk ($38.64 in chips) 
Seat 7: solbi86 ($101.48 in chips) 
Seat 8: matiko09 ($109.38 in chips) 
Seat 9: djammusic ($46.55 in chips) 
djammusic: posts small blind $0.50
Klappspaten0: posts big blind $1
*** HOLE CARDS ***
Dealt to matiko09 [2h 9d]
stepan0605: folds 
KovIFish89: folds 
King Sixtus: folds 
pardama: raises $1.50 to $2.50
Dandy Monk: folds 
solbi86: folds 
matiko09: folds 
djammusic: folds 
Klappspaten0: folds 
Uncalled bet ($1.50) returned to pardama
pardama collected $2.50 from pot
pardama: doesn't show hand 
*** SUMMARY ***
Total pot $2.50 | Rake $0 
Seat 1: Klappspaten0 (big blind) folded before Flop
Seat 2: stepan0605 folded before Flop (didn't bet)
Seat 3: KovIFish89 folded before Flop (didn't bet)
Seat 4: King Sixtus folded before Flop (didn't bet)
Seat 5: pardama collected ($2.50)
Seat 6: Dandy Monk folded before Flop (didn't bet)
Seat 7: solbi86 folded before Flop (didn't bet)
Seat 8: matiko09 (button) folded before Flop (didn't bet)
Seat 9: djammusic (small blind) folded before Flop





PokerStars Hand #155014245038:  Hold'em No Limit ($0.50/$1.00 USD) - 2016/06/21 14:02:11 CET [2016/06/21 8:02:11 ET]
Table 'Lamberta II' 9-max Seat #6 is the button
Seat 1: mbk88 ($245.30 in chips) 
Seat 3: matiko09 ($106.18 in chips) 
Seat 4: Eskimo Fox ($118.39 in chips) 
Seat 5: CoolFireX ($112.72 in chips) 
Seat 6: Chen423 ($98.23 in chips) 
Seat 7: 23SmOkEr07 ($198.04 in chips) 
Seat 8: Troll8989 ($100.25 in chips) 
Seat 9: Sjtu_Michael ($111.66 in chips) 
23SmOkEr07: posts small blind $0.50
Troll8989: posts big blind $1
*** HOLE CARDS ***
Dealt to matiko09 [3c Ts]
Sjtu_Michael: folds 
mbk88: folds 
mavin80 said, "Ur luck is just unreal"
matiko09: folds 
Eskimo Fox: folds 
CoolFireX: folds 
Chen423: folds 
23SmOkEr07: raises $1.50 to $2.50
Troll8989: calls $1.50
*** FLOP *** [Jh Qs Js]
23SmOkEr07: checks 
Troll8989: bets $3
23SmOkEr07: folds 
Uncalled bet ($3) returned to Troll8989
Troll8989 collected $4.75 from pot
Troll8989: doesn't show hand 
*** SUMMARY ***
Total pot $5 | Rake $0.25 
Board [Jh Qs Js]
Seat 1: mbk88 folded before Flop (didn't bet)
Seat 3: matiko09 folded before Flop (didn't bet)
Seat 4: Eskimo Fox folded before Flop (didn't bet)
Seat 5: CoolFireX folded before Flop (didn't bet)
Seat 6: Chen423 (button) folded before Flop (didn't bet)
Seat 7: 23SmOkEr07 (small blind) folded on the Flop
Seat 8: Troll8989 (big blind) collected ($4.75)
Seat 9: Sjtu_Michael folded before Flop (didn't bet)





PokerStars Hand #155014252045:  Hold'em No Limit (€0.25/€0.50 EUR) - 2016/06/21 14:02:27 CET [2016/06/21 8:02:27 ET]
Table 'Lotis II' 6-max Seat #5 is the button
Seat 1: AlexPles (€50 in chips) 
Seat 2: NoHeroHUD (€51.50 in chips) 
Seat 3: hmverlin (€45.12 in chips) 
Seat 4: IpMan13 (€64.88 in chips) 
Seat 5: KrishnaRadha (€50 in chips) 
Seat 6: matiko09 (€50 in chips) 
matiko09: posts small blind €0.25
AlexPles: posts big blind €0.50
*** HOLE CARDS ***
Dealt to matiko09 [Qh 4s]
NoHeroHUD: folds 
hmverlin: raises €1 to €1.50
IpMan13: raises €2.50 to €4
KrishnaRadha: folds 
matiko09: folds 
AlexPles: folds 
hmverlin: calls €2.50
*** FLOP *** [Ks 4d 7c]
hmverlin: bets €2.50
IpMan13: raises €3.50 to €6
hmverlin: calls €3.50
*** TURN *** [Ks 4d 7c] [7s]
hmverlin: bets €5
IpMan13: raises €6.50 to €11.50
hmverlin: folds 
Uncalled bet (€6.50) returned to IpMan13
IpMan13 collected €29.21 from pot
IpMan13: doesn't show hand 
*** SUMMARY ***
Total pot €30.75 | Rake €1.54 
Board [Ks 4d 7c 7s]
Seat 1: AlexPles (big blind) folded before Flop
Seat 2: NoHeroHUD folded before Flop (didn't bet)
Seat 3: hmverlin folded on the Turn
Seat 4: IpMan13 collected (€29.21)
Seat 5: KrishnaRadha (button) folded before Flop (didn't bet)
Seat 6: matiko09 (small blind) folded before Flop





PokerStars Hand #155014259907:  Hold'em No Limit ($0.50/$1.00 USD) - 2016/06/21 14:02:44 CET [2016/06/21 8:02:44 ET]
Table 'Gryphia' 9-max Seat #9 is the button
Seat 1: Klappspaten0 ($101.77 in chips) 
Seat 2: stepan0605 ($177.95 in chips) 
Seat 3: KovIFish89 ($110.40 in chips) 
Seat 4: King Sixtus ($66.01 in chips) 
Seat 5: pardama ($101.50 in chips) 
Seat 6: Dandy Monk ($38.64 in chips) 
Seat 7: solbi86 ($101.48 in chips) 
Seat 8: matiko09 ($109.38 in chips) 
Seat 9: djammusic ($46.05 in chips) 
Klappspaten0: posts small blind $0.50
stepan0605: posts big blind $1
*** HOLE CARDS ***
Dealt to matiko09 [2h 7c]
KovIFish89: folds 
King Sixtus: raises $1.50 to $2.50
pardama: folds 
Dandy Monk: calls $2.50
solbi86: folds 
matiko09: folds 
djammusic: folds 
Klappspaten0: folds 
stepan0605: folds 
*** FLOP *** [6h 4h Kh]
King Sixtus: bets $4.12
Dandy Monk: folds 
Uncalled bet ($4.12) returned to King Sixtus
King Sixtus collected $6.18 from pot
King Sixtus: doesn't show hand 
*** SUMMARY ***
Total pot $6.50 | Rake $0.32 
Board [6h 4h Kh]
Seat 1: Klappspaten0 (small blind) folded before Flop
Seat 2: stepan0605 (big blind) folded before Flop
Seat 3: KovIFish89 folded before Flop (didn't bet)
Seat 4: King Sixtus collected ($6.18)
Seat 5: pardama folded before Flop (didn't bet)
Seat 6: Dandy Monk folded on the Flop
Seat 7: solbi86 folded before Flop (didn't bet)
Seat 8: matiko09 folded before Flop (didn't bet)
Seat 9: djammusic (button) folded before Flop (didn't bet)





PokerStars Hand #155014261600:  Hold'em No Limit ($0.50/$1.00 USD) - 2016/06/21 14:02:48 CET [2016/06/21 8:02:48 ET]
Table 'Amundsenia' 9-max Seat #2 is the button
Seat 1: Troll8989 ($100 in chips) 
Seat 2: Avtovo ($106.56 in chips) 
Seat 3: matiko09 ($100.50 in chips) 
Seat 4: typename27 ($20.55 in chips) 
Seat 6: King_ZéManel ($134.63 in chips) 
Seat 7: Eskimo Fox ($104 in chips) 
Seat 8: DomiVY ($50.82 in chips) 
Seat 9: MrSeymen ($48.36 in chips) 
matiko09: posts small blind $0.50
typename27: posts big blind $1
ozone2003: sits out 
*** HOLE CARDS ***
Dealt to matiko09 [4c 8s]
King_ZéManel: folds 
Eskimo Fox: folds 
DomiVY: folds 
MrSeymen: folds 
Troll8989: folds 
Avtovo: raises $1.50 to $2.50
matiko09: folds 
typename27: calls $1.50
*** FLOP *** [5d Kd Jd]
typename27: checks 
Avtovo: bets $2.61
typename27: folds 
Uncalled bet ($2.61) returned to Avtovo
Avtovo collected $5.22 from pot
Avtovo: doesn't show hand 
*** SUMMARY ***
Total pot $5.50 | Rake $0.28 
Board [5d Kd Jd]
Seat 1: Troll8989 folded before Flop (didn't bet)
Seat 2: Avtovo (button) collected ($5.22)
Seat 3: matiko09 (small blind) folded before Flop
Seat 4: typename27 (big blind) folded on the Flop
Seat 6: King_ZéManel folded before Flop (didn't bet)
Seat 7: Eskimo Fox folded before Flop (didn't bet)
Seat 8: DomiVY folded before Flop (didn't bet)
Seat 9: MrSeymen folded before Flop (didn't bet)





PokerStars Hand #155014263308:  Hold'em No Limit ($0.50/$1.00 USD) - 2016/06/21 14:02:52 CET [2016/06/21 8:02:52 ET]
Table 'Schurer II' 9-max Seat #3 is the button
Seat 1: Dantist1122 ($100 in chips) 
Seat 2: havenots88 ($91 in chips) 
Seat 3: matiko09 ($105.15 in chips) 
Seat 4: hurtNCYDE ($100 in chips) 
Seat 5: riggedsh** ($119.62 in chips) 
Seat 6: Dödi123 ($128.89 in chips) 
Seat 7: Avtovo ($109.08 in chips) 
Seat 8: stepan0605 ($100.78 in chips) 
Seat 9: Donetsk1y ($100 in chips) 
hurtNCYDE: posts small blind $0.50
riggedsh**: posts big blind $1
*** HOLE CARDS ***
Dealt to matiko09 [Jh 3h]
Dödi123: folds 
Avtovo: folds 
stepan0605: folds 
Donetsk1y: raises $2 to $3
Dantist1122: folds 
havenots88: folds 
matiko09: folds 
hurtNCYDE: folds 
riggedsh**: folds 
Uncalled bet ($2) returned to Donetsk1y
Donetsk1y collected $2.50 from pot
Donetsk1y: doesn't show hand 
*** SUMMARY ***
Total pot $2.50 | Rake $0 
Seat 1: Dantist1122 folded before Flop (didn't bet)
Seat 2: havenots88 folded before Flop (didn't bet)
Seat 3: matiko09 (button) folded before Flop (didn't bet)
Seat 4: hurtNCYDE (small blind) folded before Flop
Seat 5: riggedsh** (big blind) folded before Flop
Seat 6: Dödi123 folded before Flop (didn't bet)
Seat 7: Avtovo folded before Flop (didn't bet)
Seat 8: stepan0605 folded before Flop (didn't bet)
Seat 9: Donetsk1y collected ($2.50)





PokerStars Hand #155014270714:  Hold'em No Limit ($0.50/$1.00 USD) - 2016/06/21 14:03:08 CET [2016/06/21 8:03:08 ET]
Table 'Schurer II' 9-max Seat #4 is the button
Seat 1: Dantist1122 ($100 in chips) 
Seat 2: havenots88 ($91 in chips) 
Seat 3: matiko09 ($105.15 in chips) 
Seat 4: hurtNCYDE ($100 in chips) 
Seat 5: riggedsh** ($118.62 in chips) 
Seat 7: Avtovo ($109.08 in chips) 
Seat 8: stepan0605 ($100.78 in chips) 
Seat 9: Donetsk1y ($101.50 in chips) 
riggedsh**: posts small blind $0.50
Dödi123: is sitting out 
Avtovo: posts big blind $1
*** HOLE CARDS ***
Dealt to matiko09 [4c 2c]
stepan0605: folds 
Donetsk1y: folds 
Dantist1122: folds 
havenots88: folds 
matiko09: folds 
hurtNCYDE: raises $1.50 to $2.50
riggedsh**: folds 
Avtovo: folds 
Uncalled bet ($1.50) returned to hurtNCYDE
hurtNCYDE collected $2.50 from pot
*** SUMMARY ***
Total pot $2.50 | Rake $0 
Seat 1: Dantist1122 folded before Flop (didn't bet)
Seat 2: havenots88 folded before Flop (didn't bet)
Seat 3: matiko09 folded before Flop (didn't bet)
Seat 4: hurtNCYDE (button) collected ($2.50)
Seat 5: riggedsh** (small blind) folded before Flop
Seat 7: Avtovo (big blind) folded before Flop
Seat 8: stepan0605 folded before Flop (didn't bet)
Seat 9: Donetsk1y folded before Flop (didn't bet)





PokerStars Hand #155014275684:  Hold'em No Limit (€0.50/€1.00 EUR) - 2016/06/21 14:03:19 CET [2016/06/21 8:03:19 ET]
Table 'Tauris III' 6-max Seat #4 is the button
Seat 1: morc1us (€112.24 in chips) 
Seat 2: devil1964 (€84.74 in chips) 
Seat 3: BronKKAA (€124.86 in chips) 
Seat 4: Gigi201133 (€114.28 in chips) 
Seat 6: matiko09 (€103.02 in chips) 
matiko09: posts small blind €0.50
morc1us: posts big blind €1
*** HOLE CARDS ***
Dealt to matiko09 [Ks Ad]
devil1964: raises €1 to €2
BronKKAA: folds 
Gigi201133: folds 
matiko09: raises €6 to €8
Gigi201133 leaves the table
Keitor28 joins the table at seat #4 
morc1us: folds 
devil1964: folds 
Uncalled bet (€6) returned to matiko09
matiko09 collected €5 from pot
matiko09: doesn't show hand 
*** SUMMARY ***
Total pot €5 | Rake €0 
Seat 1: morc1us (big blind) folded before Flop
Seat 2: devil1964 folded before Flop
Seat 3: BronKKAA folded before Flop (didn't bet)
Seat 4: Gigi201133 (button) folded before Flop (didn't bet)
Seat 6: matiko09 (small blind) collected (€5)





PokerStars Hand #155014276235:  Hold'em No Limit ($0.50/$1.00 USD) - 2016/06/21 14:03:20 CET [2016/06/21 8:03:20 ET]
Table 'Lamberta II' 9-max Seat #7 is the button
Seat 1: mbk88 ($245.30 in chips) 
Seat 3: matiko09 ($106.18 in chips) 
Seat 4: Eskimo Fox ($118.39 in chips) 
Seat 5: CoolFireX ($112.72 in chips) 
Seat 6: Chen423 ($98.23 in chips) 
Seat 7: 23SmOkEr07 ($195.54 in chips) 
Seat 8: Troll8989 ($102.50 in chips) 
Seat 9: Sjtu_Michael ($111.66 in chips) 
Troll8989: posts small blind $0.50
Sjtu_Michael: posts big blind $1
*** HOLE CARDS ***
Dealt to matiko09 [8s 5d]
mbk88: folds 
matiko09: folds 
Eskimo Fox: folds 
CoolFireX: folds 
Chen423: folds 
23SmOkEr07: raises $1.50 to $2.50
Troll8989: folds 
Sjtu_Michael: folds 
Uncalled bet ($1.50) returned to 23SmOkEr07
23SmOkEr07 collected $2.50 from pot
23SmOkEr07: doesn't show hand 
*** SUMMARY ***
Total pot $2.50 | Rake $0 
Seat 1: mbk88 folded before Flop (didn't bet)
Seat 3: matiko09 folded before Flop (didn't bet)
Seat 4: Eskimo Fox folded before Flop (didn't bet)
Seat 5: CoolFireX folded before Flop (didn't bet)
Seat 6: Chen423 folded before Flop (didn't bet)
Seat 7: 23SmOkEr07 (button) collected ($2.50)
Seat 8: Troll8989 (small blind) folded before Flop
Seat 9: Sjtu_Michael (big blind) folded before Flop





PokerStars Hand #155014276333:  Hold'em No Limit (€0.25/€0.50 EUR) - 2016/06/21 14:03:21 CET [2016/06/21 8:03:21 ET]
Table 'Lotis II' 6-max Seat #6 is the button
Seat 1: AlexPles (€50 in chips) 
Seat 2: NoHeroHUD (€51.50 in chips) 
Seat 3: hmverlin (€30.12 in chips) 
Seat 4: IpMan13 (€79.09 in chips) 
Seat 5: KrishnaRadha (€50 in chips) 
Seat 6: matiko09 (€50 in chips) 
AlexPles: posts small blind €0.25
NoHeroHUD: posts big blind €0.50
*** HOLE CARDS ***
Dealt to matiko09 [9d 2c]
hmverlin: calls €0.50
IpMan13: folds 
KrishnaRadha: folds 
matiko09: folds 
AlexPles: folds 
NoHeroHUD: checks 
*** FLOP *** [8s 7h 3s]
NoHeroHUD: checks 
hmverlin: bets €1
NoHeroHUD: folds 
Uncalled bet (€1) returned to hmverlin
hmverlin collected €1.19 from pot
hmverlin: doesn't show hand 
*** SUMMARY ***
Total pot €1.25 | Rake €0.06 
Board [8s 7h 3s]
Seat 1: AlexPles (small blind) folded before Flop
Seat 2: NoHeroHUD (big blind) folded on the Flop
Seat 3: hmverlin collected (€1.19)
Seat 4: IpMan13 folded before Flop (didn't bet)
Seat 5: KrishnaRadha folded before Flop (didn't bet)
Seat 6: matiko09 (button) folded before Flop (didn't bet)





PokerStars Hand #155014277517:  Hold'em No Limit ($0.50/$1.00 USD) - 2016/06/21 14:03:23 CET [2016/06/21 8:03:23 ET]
Table 'Gryphia' 9-max Seat #1 is the button
Seat 1: Klappspaten0 ($101.27 in chips) 
Seat 2: stepan0605 ($176.95 in chips) 
Seat 3: KovIFish89 ($110.40 in chips) 
Seat 4: King Sixtus ($69.69 in chips) 
Seat 5: pardama ($101.50 in chips) 
Seat 6: Dandy Monk ($36.14 in chips) 
Seat 7: solbi86 ($101.48 in chips) 
Seat 8: matiko09 ($109.38 in chips) 
Seat 9: djammusic ($46.05 in chips) 
stepan0605: posts small blind $0.50
KovIFish89: posts big blind $1
*** HOLE CARDS ***
Dealt to matiko09 [8d Jh]
King Sixtus: raises $1.50 to $2.50
pardama: folds 
Dandy Monk: folds 
solbi86: folds 
matiko09: folds 
djammusic: folds 
Klappspaten0: folds 
stepan0605: folds 
KovIFish89: folds 
Uncalled bet ($1.50) returned to King Sixtus
King Sixtus collected $2.50 from pot
King Sixtus: doesn't show hand 
*** SUMMARY ***
Total pot $2.50 | Rake $0 
Seat 1: Klappspaten0 (button) folded before Flop (didn't bet)
Seat 2: stepan0605 (small blind) folded before Flop
Seat 3: KovIFish89 (big blind) folded before Flop
Seat 4: King Sixtus collected ($2.50)
Seat 5: pardama folded before Flop (didn't bet)
Seat 6: Dandy Monk folded before Flop (didn't bet)
Seat 7: solbi86 folded before Flop (didn't bet)
Seat 8: matiko09 folded before Flop (didn't bet)
Seat 9: djammusic folded before Flop (didn't bet)





PokerStars Hand #155014283569:  Hold'em No Limit ($0.50/$1.00 USD) - 2016/06/21 14:03:36 CET [2016/06/21 8:03:36 ET]
Table 'Moreau' 9-max Seat #3 is the button
Seat 1: hurtNCYDE ($100 in chips) 
Seat 2: Avtovo ($106 in chips) 
Seat 3: matiko09 ($100 in chips) 
Seat 5: CoolFireX ($106.78 in chips) 
Seat 7: PanKwn15 ($105.92 in chips) 
Seat 8: mi$$I$Elena ($112.62 in chips) 
Seat 9: Toonersens ($101.34 in chips) 
CoolFireX: posts small blind $0.50
PanKwn15: posts big blind $1
*** HOLE CARDS ***
Dealt to matiko09 [8d 2d]
mi$$I$Elena: folds 
Toonersens: folds 
hurtNCYDE: folds 
Avtovo: folds 
matiko09: folds 
CoolFireX: raises $2 to $3
PanKwn15: raises $4 to $7
CoolFireX: calls $4
*** FLOP *** [8c 7d 5d]
CoolFireX: checks 
PanKwn15: bets $13.30
CoolFireX: calls $13.30
*** TURN *** [8c 7d 5d] [6s]
CoolFireX: bets $22.50
PanKwn15: folds [As Ah]
Uncalled bet ($22.50) returned to CoolFireX
CoolFireX collected $38.57 from pot
CoolFireX: doesn't show hand 
*** SUMMARY ***
Total pot $40.60 | Rake $2.03 
Board [8c 7d 5d 6s]
Seat 1: hurtNCYDE folded before Flop (didn't bet)
Seat 2: Avtovo folded before Flop (didn't bet)
Seat 3: matiko09 (button) folded before Flop (didn't bet)
Seat 5: CoolFireX (small blind) collected ($38.57)
Seat 7: PanKwn15 (big blind) folded on the Turn
Seat 8: mi$$I$Elena folded before Flop (didn't bet)
Seat 9: Toonersens folded before Flop (didn't bet)





PokerStars Hand #155014283716:  Hold'em No Limit ($0.50/$1.00 USD) - 2016/06/21 14:03:37 CET [2016/06/21 8:03:37 ET]
Table 'Schurer II' 9-max Seat #5 is the button
Seat 1: Dantist1122 ($100 in chips) 
Seat 2: havenots88 ($91 in chips) 
Seat 3: matiko09 ($105.15 in chips) 
Seat 4: hurtNCYDE ($101.50 in chips) 
Seat 5: riggedsh** ($118.12 in chips) 
Seat 7: Avtovo ($108.08 in chips) 
Seat 8: stepan0605 ($100.78 in chips) 
Seat 9: Donetsk1y ($101.50 in chips) 
Avtovo: posts small blind $0.50
stepan0605: posts big blind $1
*** HOLE CARDS ***
Dealt to matiko09 [4s Qs]
Donetsk1y: folds 
Dantist1122: folds 
havenots88: folds 
matiko09: folds 
hurtNCYDE: raises $1.50 to $2.50
riggedsh**: folds 
Avtovo: folds 
stepan0605: folds 
Uncalled bet ($1.50) returned to hurtNCYDE
hurtNCYDE collected $2.50 from pot
hurtNCYDE: doesn't show hand 
*** SUMMARY ***
Total pot $2.50 | Rake $0 
Seat 1: Dantist1122 folded before Flop (didn't bet)
Seat 2: havenots88 folded before Flop (didn't bet)
Seat 3: matiko09 folded before Flop (didn't bet)
Seat 4: hurtNCYDE collected ($2.50)
Seat 5: riggedsh** (button) folded before Flop (didn't bet)
Seat 7: Avtovo (small blind) folded before Flop
Seat 8: stepan0605 (big blind) folded before Flop
Seat 9: Donetsk1y folded before Flop (didn't bet)





PokerStars Hand #155014286080:  Hold'em No Limit (€0.50/€1.00 EUR) - 2016/06/21 14:03:42 CET [2016/06/21 8:03:42 ET]
Table 'Tauris III' 6-max Seat #6 is the button
Seat 1: morc1us (€111.24 in chips) 
Seat 2: devil1964 (€82.74 in chips) 
Seat 3: BronKKAA (€124.86 in chips) 
Seat 6: matiko09 (€106.02 in chips) 
morc1us: posts small blind €0.50
devil1964: posts big blind €1
Keitor28: sits out 
*** HOLE CARDS ***
Dealt to matiko09 [7c 2s]
BronKKAA: raises €1.50 to €2.50
matiko09: folds 
morc1us: folds 
devil1964: folds 
Uncalled bet (€1.50) returned to BronKKAA
BronKKAA collected €2.50 from pot
BronKKAA: doesn't show hand 
*** SUMMARY ***
Total pot €2.50 | Rake €0 
Seat 1: morc1us (small blind) folded before Flop
Seat 2: devil1964 (big blind) folded before Flop
Seat 3: BronKKAA collected (€2.50)
Seat 6: matiko09 (button) folded before Flop (didn't bet)





PokerStars Hand #155014291550:  Hold'em No Limit ($0.50/$1.00 USD) - 2016/06/21 14:03:54 CET [2016/06/21 8:03:54 ET]
Table 'Lamberta II' 9-max Seat #8 is the button
Seat 3: matiko09 ($106.18 in chips) 
Seat 4: Eskimo Fox ($118.39 in chips) 
Seat 5: CoolFireX ($112.72 in chips) 
Seat 6: Chen423 ($98.23 in chips) 
Seat 7: 23SmOkEr07 ($197.04 in chips) 
Seat 8: Troll8989 ($102 in chips) 
Seat 9: Sjtu_Michael ($110.66 in chips) 
Sjtu_Michael: posts small blind $0.50
mbk88: is sitting out 
mbk88 leaves the table
matiko09: posts big blind $1
*** HOLE CARDS ***
Dealt to matiko09 [Kc Jc]
Eskimo Fox: folds 
CoolFireX: folds 
Chen423: folds 
23SmOkEr07: folds 
Troll8989: raises $1.50 to $2.50
Sjtu_Michael: folds 
matiko09: calls $1.50
*** FLOP *** [4d 2d 9d]
matiko09: checks 
Troll8989: checks 
*** TURN *** [4d 2d 9d] [9c]
hurtNCYDE joins the table at seat #1 
hurtNCYDE leaves the table
matiko09: checks 
Avtovo joins the table at seat #1 
Chen423 is disconnected 
Troll8989: bets $3
matiko09: folds 
Uncalled bet ($3) returned to Troll8989
Troll8989 collected $5.22 from pot
Troll8989: doesn't show hand 
*** SUMMARY ***
Total pot $5.50 | Rake $0.28 
Board [4d 2d 9d 9c]
Seat 3: matiko09 (big blind) folded on the Turn
Seat 4: Eskimo Fox folded before Flop (didn't bet)
Seat 5: CoolFireX folded before Flop (didn't bet)
Seat 6: Chen423 folded before Flop (didn't bet)
Seat 7: 23SmOkEr07 folded before Flop (didn't bet)
Seat 8: Troll8989 (button) collected ($5.22)
Seat 9: Sjtu_Michael (small blind) folded before Flop





PokerStars Hand #155014292914:  Hold'em No Limit (€0.25/€0.50 EUR) - 2016/06/21 14:03:57 CET [2016/06/21 8:03:57 ET]
Table 'Lotis II' 6-max Seat #1 is the button
Seat 1: AlexPles (€50 in chips) 
Seat 2: NoHeroHUD (€51 in chips) 
Seat 3: hmverlin (€30.81 in chips) 
Seat 4: IpMan13 (€79.09 in chips) 
Seat 5: KrishnaRadha (€50 in chips) 
Seat 6: matiko09 (€50 in chips) 
NoHeroHUD: posts small blind €0.25
hmverlin: posts big blind €0.50
*** HOLE CARDS ***
Dealt to matiko09 [7h Qc]
IpMan13: raises €1 to €1.50
KrishnaRadha: folds 
matiko09: folds 
AlexPles: folds 
NoHeroHUD: folds 
hmverlin: folds 
Uncalled bet (€1) returned to IpMan13
IpMan13 collected €1.25 from pot
IpMan13: doesn't show hand 
*** SUMMARY ***
Total pot €1.25 | Rake €0 
Seat 1: AlexPles (button) folded before Flop (didn't bet)
Seat 2: NoHeroHUD (small blind) folded before Flop
Seat 3: hmverlin (big blind) folded before Flop
Seat 4: IpMan13 collected (€1.25)
Seat 5: KrishnaRadha folded before Flop (didn't bet)
Seat 6: matiko09 folded before Flop (didn't bet)





PokerStars Hand #155014294571:  Hold'em No Limit (€0.50/€1.00 EUR) - 2016/06/21 14:04:01 CET [2016/06/21 8:04:01 ET]
Table 'Tauris III' 6-max Seat #1 is the button
Seat 1: morc1us (€110.74 in chips) 
Seat 2: devil1964 (€81.74 in chips) 
Seat 3: BronKKAA (€126.36 in chips) 
Seat 6: matiko09 (€106.02 in chips) 
devil1964: posts small blind €0.50
BronKKAA: posts big blind €1
Keitor28: sits out 
*** HOLE CARDS ***
Dealt to matiko09 [7d 9d]
matiko09: raises €1.50 to €2.50
morc1us: folds 
devil1964: folds 
BronKKAA: raises €6.50 to €9
matiko09: folds 
Uncalled bet (€6.50) returned to BronKKAA
BronKKAA collected €5.50 from pot
*** SUMMARY ***
Total pot €5.50 | Rake €0 
Seat 1: morc1us (button) folded before Flop (didn't bet)
Seat 2: devil1964 (small blind) folded before Flop
Seat 3: BronKKAA (big blind) collected (€5.50)
Seat 6: matiko09 folded before Flop





PokerStars Hand #155014295123:  Hold'em No Limit ($0.50/$1.00 USD) - 2016/06/21 14:04:02 CET [2016/06/21 8:04:02 ET]
Table 'Gryphia' 9-max Seat #2 is the button
Seat 1: Klappspaten0 ($101.27 in chips) 
Seat 2: stepan0605 ($176.45 in chips) 
Seat 3: KovIFish89 ($109.40 in chips) 
Seat 4: King Sixtus ($71.19 in chips) 
Seat 5: pardama ($101.50 in chips) 
Seat 6: Dandy Monk ($36.14 in chips) 
Seat 7: solbi86 ($101.48 in chips) 
Seat 8: matiko09 ($109.38 in chips) 
Seat 9: djammusic ($46.05 in chips) 
KovIFish89: posts small blind $0.50
King Sixtus: posts big blind $1
*** HOLE CARDS ***
Dealt to matiko09 [3d 6c]
pardama: raises $2 to $3
Dandy Monk: folds 
solbi86: folds 
matiko09: folds 
djammusic: raises $4.50 to $7.50
Klappspaten0: folds 
stepan0605: folds 
KovIFish89: folds 
King Sixtus: folds 
pardama: folds 
Uncalled bet ($4.50) returned to djammusic
djammusic collected $7.50 from pot
djammusic: doesn't show hand 
*** SUMMARY ***
Total pot $7.50 | Rake $0 
Seat 1: Klappspaten0 folded before Flop (didn't bet)
Seat 2: stepan0605 (button) folded before Flop (didn't bet)
Seat 3: KovIFish89 (small blind) folded before Flop
Seat 4: King Sixtus (big blind) folded before Flop
Seat 5: pardama folded before Flop
Seat 6: Dandy Monk folded before Flop (didn't bet)
Seat 7: solbi86 folded before Flop (didn't bet)
Seat 8: matiko09 folded before Flop (didn't bet)
Seat 9: djammusic collected ($7.50)





PokerStars Hand #155014297942:  Hold'em No Limit ($0.50/$1.00 USD) - 2016/06/21 14:04:08 CET [2016/06/21 8:04:08 ET]
Table 'Amundsenia' 9-max Seat #3 is the button
Seat 1: Troll8989 ($100 in chips) 
Seat 2: Avtovo ($109.28 in chips) 
Seat 3: matiko09 ($100 in chips) 
Seat 4: typename27 ($18.05 in chips) 
Seat 5: ozone2003 ($100 in chips) 
Seat 6: King_ZéManel ($134.63 in chips) 
Seat 7: Eskimo Fox ($104 in chips) 
Seat 8: DomiVY ($50.82 in chips) 
Seat 9: MrSeymen ($48.36 in chips) 
typename27: posts small blind $0.50
ozone2003: posts big blind $1
*** HOLE CARDS ***
Dealt to matiko09 [Jh 2c]
King_ZéManel: folds 
Eskimo Fox: folds 
DomiVY: folds 
MrSeymen: folds 
Troll8989: raises $1.50 to $2.50
Avtovo: folds 
matiko09: folds 
typename27: folds 
ozone2003: folds 
Uncalled bet ($1.50) returned to Troll8989
Troll8989 collected $2.50 from pot
Troll8989: doesn't show hand 
*** SUMMARY ***
Total pot $2.50 | Rake $0 
Seat 1: Troll8989 collected ($2.50)
Seat 2: Avtovo folded before Flop (didn't bet)
Seat 3: matiko09 (button) folded before Flop (didn't bet)
Seat 4: typename27 (small blind) folded before Flop
Seat 5: ozone2003 (big blind) folded before Flop
Seat 6: King_ZéManel folded before Flop (didn't bet)
Seat 7: Eskimo Fox folded before Flop (didn't bet)
Seat 8: DomiVY folded before Flop (didn't bet)
Seat 9: MrSeymen folded before Flop (didn't bet)





PokerStars Hand #155014303239:  Hold'em No Limit ($0.50/$1.00 USD) - 2016/06/21 14:04:20 CET [2016/06/21 8:04:20 ET]
Table 'Schurer II' 9-max Seat #7 is the button
Seat 1: Dantist1122 ($100 in chips) 
Seat 2: havenots88 ($91 in chips) 
Seat 3: matiko09 ($105.15 in chips) 
Seat 4: hurtNCYDE ($103 in chips) 
Seat 5: riggedsh** ($118.12 in chips) 
Seat 7: Avtovo ($107.58 in chips) 
Seat 8: stepan0605 ($99.78 in chips) 
stepan0605: posts small blind $0.50
Donetsk1y: is sitting out 
Dantist1122: posts big blind $1
*** HOLE CARDS ***
Dealt to matiko09 [4s Tc]
Donetsk1y leaves the table
havenots88: folds 
matiko09: folds 
hurtNCYDE: folds 
ozone2003 joins the table at seat #9 
riggedsh**: folds 
Avtovo: folds 
stepan0605: calls $0.50
Dantist1122: checks 
*** FLOP *** [6h Qs Jc]
stepan0605: checks 
Dantist1122: checks 
*** TURN *** [6h Qs Jc] [Ad]
stepan0605: bets $1
Dantist1122: folds 
Uncalled bet ($1) returned to stepan0605
stepan0605 collected $1.90 from pot
stepan0605: doesn't show hand 
*** SUMMARY ***
Total pot $2 | Rake $0.10 
Board [6h Qs Jc Ad]
Seat 1: Dantist1122 (big blind) folded on the Turn
Seat 2: havenots88 folded before Flop (didn't bet)
Seat 3: matiko09 folded before Flop (didn't bet)
Seat 4: hurtNCYDE folded before Flop (didn't bet)
Seat 5: riggedsh** folded before Flop (didn't bet)
Seat 7: Avtovo (button) folded before Flop (didn't bet)
Seat 8: stepan0605 (small blind) collected ($1.90)





PokerStars Hand #155014306364:  Hold'em No Limit (€0.25/€0.50 EUR) - 2016/06/21 14:04:27 CET [2016/06/21 8:04:27 ET]
Table 'Lotis II' 6-max Seat #2 is the button
Seat 1: AlexPles (€50 in chips) 
Seat 2: NoHeroHUD (€50.75 in chips) 
Seat 3: hmverlin (€30.31 in chips) 
Seat 4: IpMan13 (€79.84 in chips) 
Seat 5: KrishnaRadha (€50 in chips) 
Seat 6: matiko09 (€50 in chips) 
hmverlin: posts small blind €0.25
IpMan13: posts big blind €0.50
*** HOLE CARDS ***
Dealt to matiko09 [As 9d]
KrishnaRadha: folds 
matiko09: folds 
AlexPles: folds 
NoHeroHUD: raises €0.50 to €1
hmverlin: calls €0.75
IpMan13: folds 
*** FLOP *** [2c 5d 8h]
hmverlin: bets €1.50
NoHeroHUD: calls €1.50
*** TURN *** [2c 5d 8h] [Td]
hmverlin: bets €2
NoHeroHUD: calls €2
*** RIVER *** [2c 5d 8h Td] [7c]
hmverlin: checks 
NoHeroHUD: checks 
*** SHOW DOWN ***
hmverlin: shows [8d Ah] (a pair of Eights)
NoHeroHUD: mucks hand 
hmverlin collected €9.02 from pot
*** SUMMARY ***
Total pot €9.50 | Rake €0.48 
Board [2c 5d 8h Td 7c]
Seat 1: AlexPles folded before Flop (didn't bet)
Seat 2: NoHeroHUD (button) mucked [8s Js]
Seat 3: hmverlin (small blind) showed [8d Ah] and won (€9.02) with a pair of Eights
Seat 4: IpMan13 (big blind) folded before Flop
Seat 5: KrishnaRadha folded before Flop (didn't bet)
Seat 6: matiko09 folded before Flop (didn't bet)





PokerStars Hand #155014311926:  Hold'em No Limit ($0.50/$1.00 USD) - 2016/06/21 14:04:39 CET [2016/06/21 8:04:39 ET]
Table 'Amundsenia' 9-max Seat #4 is the button
Seat 1: Troll8989 ($101.50 in chips) 
Seat 2: Avtovo ($109.28 in chips) 
Seat 3: matiko09 ($100 in chips) 
Seat 4: typename27 ($17.55 in chips) 
Seat 5: ozone2003 ($100 in chips) 
Seat 6: King_ZéManel ($134.63 in chips) 
Seat 7: Eskimo Fox ($104 in chips) 
Seat 8: DomiVY ($50.82 in chips) 
Seat 9: MrSeymen ($48.36 in chips) 
ozone2003: posts small blind $0.50
King_ZéManel: posts big blind $1
*** HOLE CARDS ***
Dealt to matiko09 [Ks 8c]
Eskimo Fox: folds 
DomiVY: folds 
MrSeymen: folds 
Troll8989: folds 
Avtovo: folds 
matiko09: folds 
typename27: raises $2.50 to $3.50
ozone2003: folds 
King_ZéManel: calls $2.50
*** FLOP *** [9h Ac 3d]
King_ZéManel: checks 
typename27: bets $14.05 and is all-in
King_ZéManel: folds 
Uncalled bet ($14.05) returned to typename27
typename27 collected $7.12 from pot
typename27: doesn't show hand 
*** SUMMARY ***
Total pot $7.50 | Rake $0.38 
Board [9h Ac 3d]
Seat 1: Troll8989 folded before Flop (didn't bet)
Seat 2: Avtovo folded before Flop (didn't bet)
Seat 3: matiko09 folded before Flop (didn't bet)
Seat 4: typename27 (button) collected ($7.12)
Seat 5: ozone2003 (small blind) folded before Flop
Seat 6: King_ZéManel (big blind) folded on the Flop
Seat 7: Eskimo Fox folded before Flop (didn't bet)
Seat 8: DomiVY folded before Flop (didn't bet)
Seat 9: MrSeymen folded before Flop (didn't bet)





PokerStars Hand #155014312540:  Hold'em No Limit ($0.50/$1.00 USD) - 2016/06/21 14:04:41 CET [2016/06/21 8:04:41 ET]
Table 'Gryphia' 9-max Seat #3 is the button
Seat 1: Klappspaten0 ($101.27 in chips) 
Seat 2: stepan0605 ($176.45 in chips) 
Seat 3: KovIFish89 ($108.90 in chips) 
Seat 4: King Sixtus ($70.19 in chips) 
Seat 5: pardama ($100 in chips) 
Seat 6: Dandy Monk ($36.14 in chips) 
Seat 7: solbi86 ($101.48 in chips) 
Seat 8: matiko09 ($109.38 in chips) 
Seat 9: djammusic ($50.55 in chips) 
King Sixtus: posts small blind $0.50
pardama: posts big blind $1
*** HOLE CARDS ***
Dealt to matiko09 [Tc 7s]
Dandy Monk: folds 
solbi86: folds 
matiko09: folds 
djammusic: folds 
Klappspaten0: folds 
stepan0605: raises $1 to $2
KovIFish89: folds 
King Sixtus: calls $1.50
pardama: folds 
*** FLOP *** [7c As 3h]
King Sixtus: checks 
stepan0605: bets $3
King Sixtus: folds 
Uncalled bet ($3) returned to stepan0605
stepan0605 collected $4.75 from pot
stepan0605: doesn't show hand 
*** SUMMARY ***
Total pot $5 | Rake $0.25 
Board [7c As 3h]
Seat 1: Klappspaten0 folded before Flop (didn't bet)
Seat 2: stepan0605 collected ($4.75)
Seat 3: KovIFish89 (button) folded before Flop (didn't bet)
Seat 4: King Sixtus (small blind) folded on the Flop
Seat 5: pardama (big blind) folded before Flop
Seat 6: Dandy Monk folded before Flop (didn't bet)
Seat 7: solbi86 folded before Flop (didn't bet)
Seat 8: matiko09 folded before Flop (didn't bet)
Seat 9: djammusic folded before Flop (didn't bet)





PokerStars Hand #155014327477:  Hold'em No Limit ($0.50/$1.00 USD) - 2016/06/21 14:05:14 CET [2016/06/21 8:05:14 ET]
Table 'Schurer II' 9-max Seat #8 is the button
Seat 1: Dantist1122 ($100 in chips) 
Seat 2: havenots88 ($91 in chips) 
Seat 3: matiko09 ($105.15 in chips) 
Seat 4: hurtNCYDE ($103 in chips) 
Seat 5: riggedsh** ($118.12 in chips) 
Seat 7: Avtovo ($107.58 in chips) 
Seat 8: stepan0605 ($100.68 in chips) 
ozone2003 will be allowed to play after the button
Dantist1122: posts small blind $0.50
havenots88: posts big blind $1
*** HOLE CARDS ***
Dealt to matiko09 [4h Js]
matiko09: folds 
hurtNCYDE: folds 
riggedsh**: raises $2 to $3
Avtovo: folds 
stepan0605: folds 
Dantist1122: folds 
havenots88: calls $2
*** FLOP *** [6d Kh 8c]
havenots88: checks 
riggedsh**: checks 
*** TURN *** [6d Kh 8c] [7s]
havenots88: checks 
riggedsh**: bets $4.14
havenots88: folds 
Uncalled bet ($4.14) returned to riggedsh**
riggedsh** collected $6.18 from pot
riggedsh**: doesn't show hand 
*** SUMMARY ***
Total pot $6.50 | Rake $0.32 
Board [6d Kh 8c 7s]
Seat 1: Dantist1122 (small blind) folded before Flop
Seat 2: havenots88 (big blind) folded on the Turn
Seat 3: matiko09 folded before Flop (didn't bet)
Seat 4: hurtNCYDE folded before Flop (didn't bet)
Seat 5: riggedsh** collected ($6.18)
Seat 7: Avtovo folded before Flop (didn't bet)
Seat 8: stepan0605 (button) folded before Flop (didn't bet)





PokerStars Hand #155014329455:  Hold'em No Limit ($0.50/$1.00 USD) - 2016/06/21 14:05:18 CET [2016/06/21 8:05:18 ET]
Table 'Lamberta II' 9-max Seat #9 is the button
Seat 3: matiko09 ($103.68 in chips) 
Seat 4: Eskimo Fox ($118.39 in chips) 
Seat 5: CoolFireX ($112.72 in chips) 
Seat 6: Chen423 ($98.23 in chips) 
Seat 7: 23SmOkEr07 ($197.04 in chips) 
Seat 8: Troll8989 ($104.72 in chips) 
Seat 9: Sjtu_Michael ($110.16 in chips) 
Avtovo will be allowed to play after the button
matiko09: posts small blind $0.50
Eskimo Fox: posts big blind $1
*** HOLE CARDS ***
Dealt to matiko09 [As 3d]
CoolFireX: folds 
Chen423: folds 
23SmOkEr07: folds 
Troll8989: folds 
Sjtu_Michael: raises $2 to $3
matiko09: folds 
Eskimo Fox: calls $2
*** FLOP *** [5s 6s 2s]
Eskimo Fox: checks 
Sjtu_Michael: bets $3.09
Eskimo Fox: folds 
Uncalled bet ($3.09) returned to Sjtu_Michael
Sjtu_Michael collected $6.18 from pot
Sjtu_Michael: doesn't show hand 
*** SUMMARY ***
Total pot $6.50 | Rake $0.32 
Board [5s 6s 2s]
Seat 3: matiko09 (small blind) folded before Flop
Seat 4: Eskimo Fox (big blind) folded on the Flop
Seat 5: CoolFireX folded before Flop (didn't bet)
Seat 6: Chen423 folded before Flop (didn't bet)
Seat 7: 23SmOkEr07 folded before Flop (didn't bet)
Seat 8: Troll8989 folded before Flop (didn't bet)
Seat 9: Sjtu_Michael (button) collected ($6.18)





PokerStars Hand #155014337150:  Hold'em No Limit ($0.50/$1.00 USD) - 2016/06/21 14:05:35 CET [2016/06/21 8:05:35 ET]
Table 'Gryphia' 9-max Seat #4 is the button
Seat 1: Klappspaten0 ($101.27 in chips) 
Seat 2: stepan0605 ($179.20 in chips) 
Seat 3: KovIFish89 ($108.90 in chips) 
Seat 4: King Sixtus ($68.19 in chips) 
Seat 5: pardama ($100 in chips) 
Seat 6: Dandy Monk ($36.14 in chips) 
Seat 7: solbi86 ($101.48 in chips) 
Seat 8: matiko09 ($109.38 in chips) 
Seat 9: djammusic ($50.55 in chips) 
pardama: posts small blind $0.50
Dandy Monk: posts big blind $1
*** HOLE CARDS ***
Dealt to matiko09 [2h 3s]
solbi86: folds 
matiko09: folds 
djammusic: folds 
Klappspaten0: folds 
stepan0605: folds 
KovIFish89: raises $1.50 to $2.50
King Sixtus: calls $2.50
pardama: folds 
Dandy Monk: calls $1.50
*** FLOP *** [Kd 6c Th]
Dandy Monk: bets $8
KovIFish89: folds 
King Sixtus: folds 
Uncalled bet ($8) returned to Dandy Monk
Dandy Monk collected $7.60 from pot
Dandy Monk: doesn't show hand 
*** SUMMARY ***
Total pot $8 | Rake $0.40 
Board [Kd 6c Th]
Seat 1: Klappspaten0 folded before Flop (didn't bet)
Seat 2: stepan0605 folded before Flop (didn't bet)
Seat 3: KovIFish89 folded on the Flop
Seat 4: King Sixtus (button) folded on the Flop
Seat 5: pardama (small blind) folded before Flop
Seat 6: Dandy Monk (big blind) collected ($7.60)
Seat 7: solbi86 folded before Flop (didn't bet)
Seat 8: matiko09 folded before Flop (didn't bet)
Seat 9: djammusic folded before Flop (didn't bet)





PokerStars Hand #155014339752:  Hold'em No Limit (€0.25/€0.50 EUR) - 2016/06/21 14:05:40 CET [2016/06/21 8:05:40 ET]
Table 'Lotis II' 6-max Seat #3 is the button
Seat 1: AlexPles (€50 in chips) 
Seat 2: NoHeroHUD (€50 in chips) 
Seat 3: hmverlin (€34.83 in chips) 
Seat 4: IpMan13 (€79.34 in chips) 
Seat 5: KrishnaRadha (€50 in chips) 
Seat 6: matiko09 (€50 in chips) 
IpMan13: posts small blind €0.25
KrishnaRadha: posts big blind €0.50
*** HOLE CARDS ***
Dealt to matiko09 [Kd Tc]
matiko09: folds 
AlexPles: raises €0.62 to €1.12
NoHeroHUD: folds 
hmverlin: calls €1.12
IpMan13: folds 
KrishnaRadha: folds 
*** FLOP *** [3h Js 2d]
AlexPles: checks 
hmverlin: bets €1.50
AlexPles: calls €1.50
*** TURN *** [3h Js 2d] [7s]
AlexPles: checks 
hmverlin: bets €3
AlexPles: calls €3
*** RIVER *** [3h Js 2d 7s] [Jc]
AlexPles: bets €5.69
hmverlin: calls €5.69
*** SHOW DOWN ***
AlexPles: shows [Td Ts] (two pair, Jacks and Tens)
hmverlin: mucks hand 
AlexPles collected €22.20 from pot
*** SUMMARY ***
Total pot €23.37 | Rake €1.17 
Board [3h Js 2d 7s Jc]
Seat 1: AlexPles showed [Td Ts] and won (€22.20) with two pair, Jacks and Tens
Seat 2: NoHeroHUD folded before Flop (didn't bet)
Seat 3: hmverlin (button) mucked [5s 3s]
Seat 4: IpMan13 (small blind) folded before Flop
Seat 5: KrishnaRadha (big blind) folded before Flop
Seat 6: matiko09 folded before Flop (didn't bet)





PokerStars Hand #155014344490:  Hold'em No Limit ($0.50/$1.00 USD) - 2016/06/21 14:05:51 CET [2016/06/21 8:05:51 ET]
Table 'Moreau' 9-max Seat #5 is the button
Seat 1: hurtNCYDE ($100 in chips) 
Seat 2: Avtovo ($106 in chips) 
Seat 3: matiko09 ($100 in chips) 
Seat 5: CoolFireX ($125.05 in chips) 
Seat 7: PanKwn15 ($85.62 in chips) 
Seat 8: mi$$I$Elena ($112.62 in chips) 
Seat 9: Toonersens ($101.34 in chips) 
Troll8989 will be allowed to play after the button
PanKwn15: posts small blind $0.50
mi$$I$Elena: posts big blind $1
*** HOLE CARDS ***
Dealt to matiko09 [Qs 8h]
Toonersens: folds 
hurtNCYDE: folds 
Avtovo: folds 
matiko09: folds 
CoolFireX: raises $1.50 to $2.50
PanKwn15: calls $2
mi$$I$Elena: folds 
*** FLOP *** [9d Jh 2h]
PanKwn15: checks 
CoolFireX: checks 
*** TURN *** [9d Jh 2h] [Jc]
PanKwn15: bets $2
CoolFireX: folds 
Uncalled bet ($2) returned to PanKwn15
PanKwn15 collected $5.70 from pot
PanKwn15: doesn't show hand 
*** SUMMARY ***
Total pot $6 | Rake $0.30 
Board [9d Jh 2h Jc]
Seat 1: hurtNCYDE folded before Flop (didn't bet)
Seat 2: Avtovo folded before Flop (didn't bet)
Seat 3: matiko09 folded before Flop (didn't bet)
Seat 5: CoolFireX (button) folded on the Turn
Seat 7: PanKwn15 (small blind) collected ($5.70)
Seat 8: mi$$I$Elena (big blind) folded before Flop
Seat 9: Toonersens folded before Flop (didn't bet)





PokerStars Hand #155014347252:  Hold'em No Limit ($0.50/$1.00 USD) - 2016/06/21 14:05:57 CET [2016/06/21 8:05:57 ET]
Table 'Amundsenia' 9-max Seat #5 is the button
Seat 1: Troll8989 ($101.50 in chips) 
Seat 2: Avtovo ($109.28 in chips) 
Seat 3: matiko09 ($100 in chips) 
Seat 4: typename27 ($21.17 in chips) 
Seat 5: ozone2003 ($100 in chips) 
Seat 6: King_ZéManel ($131.13 in chips) 
Seat 7: Eskimo Fox ($104 in chips) 
Seat 8: DomiVY ($50.82 in chips) 
Seat 9: MrSeymen ($48.36 in chips) 
King_ZéManel: posts small blind $0.50
Eskimo Fox: posts big blind $1
*** HOLE CARDS ***
Dealt to matiko09 [8d 9s]
DomiVY: folds 
MrSeymen: folds 
Troll8989: raises $1.50 to $2.50
Avtovo: folds 
matiko09: folds 
typename27: folds 
ozone2003: folds 
King_ZéManel: folds 
Eskimo Fox: folds 
Uncalled bet ($1.50) returned to Troll8989
Troll8989 collected $2.50 from pot
Troll8989: doesn't show hand 
*** SUMMARY ***
Total pot $2.50 | Rake $0 
Seat 1: Troll8989 collected ($2.50)
Seat 2: Avtovo folded before Flop (didn't bet)
Seat 3: matiko09 folded before Flop (didn't bet)
Seat 4: typename27 folded before Flop (didn't bet)
Seat 5: ozone2003 (button) folded before Flop (didn't bet)
Seat 6: King_ZéManel (small blind) folded before Flop
Seat 7: Eskimo Fox (big blind) folded before Flop
Seat 8: DomiVY folded before Flop (didn't bet)
Seat 9: MrSeymen folded before Flop (didn't bet)





PokerStars Hand #155014347650:  Hold'em No Limit ($0.50/$1.00 USD) - 2016/06/21 14:05:58 CET [2016/06/21 8:05:58 ET]
Table 'Schurer II' 9-max Seat #1 is the button
Seat 1: Dantist1122 ($100 in chips) 
Seat 2: havenots88 ($88 in chips) 
Seat 3: matiko09 ($105.15 in chips) 
Seat 4: hurtNCYDE ($103 in chips) 
Seat 5: riggedsh** ($121.30 in chips) 
Seat 7: Avtovo ($107.58 in chips) 
Seat 8: stepan0605 ($100.68 in chips) 
havenots88: posts small blind $0.50
matiko09: posts big blind $1
ozone2003: sits out 
*** HOLE CARDS ***
Dealt to matiko09 [8d 9s]
hurtNCYDE: raises $1.50 to $2.50
riggedsh**: folds 
Avtovo: folds 
stepan0605: folds 
Dantist1122: folds 
havenots88: folds 
matiko09: folds 
Uncalled bet ($1.50) returned to hurtNCYDE
hurtNCYDE collected $2.50 from pot
*** SUMMARY ***
Total pot $2.50 | Rake $0 
Seat 1: Dantist1122 (button) folded before Flop (didn't bet)
Seat 2: havenots88 (small blind) folded before Flop
Seat 3: matiko09 (big blind) folded before Flop
Seat 4: hurtNCYDE collected ($2.50)
Seat 5: riggedsh** folded before Flop (didn't bet)
Seat 7: Avtovo folded before Flop (didn't bet)
Seat 8: stepan0605 folded before Flop (didn't bet)





PokerStars Hand #155014357930:  Hold'em No Limit (€0.25/€0.50 EUR) - 2016/06/21 14:06:20 CET [2016/06/21 8:06:20 ET]
Table 'Lotis II' 6-max Seat #4 is the button
Seat 1: AlexPles (€60.89 in chips) 
Seat 2: NoHeroHUD (€50 in chips) 
Seat 3: hmverlin (€23.52 in chips) 
Seat 4: IpMan13 (€79.09 in chips) 
Seat 5: KrishnaRadha (€50 in chips) 
Seat 6: matiko09 (€50 in chips) 
KrishnaRadha: posts small blind €0.25
matiko09: posts big blind €0.50
*** HOLE CARDS ***
Dealt to matiko09 [9h 9s]
AlexPles: folds 
AlexPles leaves the table
NoHeroHUD: folds 
hmverlin: folds 
IpMan13: folds 
KrishnaRadha: raises €1 to €1.50
matiko09: calls €1
*** FLOP *** [7c Kd 4d]
KrishnaRadha: bets €1.56
matiko09: calls €1.56
*** TURN *** [7c Kd 4d] [Qc]
KrishnaRadha: checks 
matiko09: checks 
*** RIVER *** [7c Kd 4d Qc] [4h]
KrishnaRadha: checks 
matiko09: checks 
*** SHOW DOWN ***
KrishnaRadha: shows [Qh 7s] (two pair, Queens and Sevens)
matiko09: mucks hand 
KrishnaRadha collected €5.81 from pot
*** SUMMARY ***
Total pot €6.12 | Rake €0.31 
Board [7c Kd 4d Qc 4h]
Seat 1: AlexPles folded before Flop (didn't bet)
Seat 2: NoHeroHUD folded before Flop (didn't bet)
Seat 3: hmverlin folded before Flop (didn't bet)
Seat 4: IpMan13 (button) folded before Flop (didn't bet)
Seat 5: KrishnaRadha (small blind) showed [Qh 7s] and won (€5.81) with two pair, Queens and Sevens
Seat 6: matiko09 (big blind) mucked [9h 9s]





PokerStars Hand #155014357852:  Hold'em No Limit ($0.50/$1.00 USD) - 2016/06/21 14:06:20 CET [2016/06/21 8:06:20 ET]
Table 'Schurer II' 9-max Seat #2 is the button
Seat 1: Dantist1122 ($100 in chips) 
Seat 2: havenots88 ($87.50 in chips) 
Seat 3: matiko09 ($104.15 in chips) 
Seat 4: hurtNCYDE ($104.50 in chips) 
Seat 5: riggedsh** ($121.30 in chips) 
Seat 7: Avtovo ($107.58 in chips) 
Seat 8: stepan0605 ($100.68 in chips) 
matiko09: posts small blind $0.50
hurtNCYDE: posts big blind $1
ozone2003: sits out 
*** HOLE CARDS ***
Dealt to matiko09 [6h Td]
riggedsh**: folds 
Avtovo: folds 
stepan0605: folds 
Dantist1122: folds 
ozone2003 leaves the table
havenots88: raises $2 to $3
pardama joins the table at seat #9 
matiko09: folds 
hurtNCYDE: raises $6 to $9
havenots88: folds 
Uncalled bet ($6) returned to hurtNCYDE
hurtNCYDE collected $6.50 from pot
*** SUMMARY ***
Total pot $6.50 | Rake $0 
Seat 1: Dantist1122 folded before Flop (didn't bet)
Seat 2: havenots88 (button) folded before Flop
Seat 3: matiko09 (small blind) folded before Flop
Seat 4: hurtNCYDE (big blind) collected ($6.50)
Seat 5: riggedsh** folded before Flop (didn't bet)
Seat 7: Avtovo folded before Flop (didn't bet)
Seat 8: stepan0605 folded before Flop (didn't bet)





PokerStars Hand #155014360551:  Hold'em No Limit ($0.50/$1.00 USD) - 2016/06/21 14:06:26 CET [2016/06/21 8:06:26 ET]
Table 'Gryphia' 9-max Seat #5 is the button
Seat 1: Klappspaten0 ($101.27 in chips) 
Seat 2: stepan0605 ($179.20 in chips) 
Seat 3: KovIFish89 ($106.40 in chips) 
Seat 4: King Sixtus ($65.69 in chips) 
Seat 5: pardama ($100 in chips) 
Seat 6: Dandy Monk ($41.24 in chips) 
Seat 7: solbi86 ($101.48 in chips) 
Seat 8: matiko09 ($109.38 in chips) 
Seat 9: djammusic ($50.55 in chips) 
Dandy Monk: posts small blind $0.50
solbi86: posts big blind $1
*** HOLE CARDS ***
Dealt to matiko09 [8s 3c]
matiko09: folds 
djammusic: raises $1.25 to $2.25
Klappspaten0: calls $2.25
stepan0605: folds 
KovIFish89: folds 
King Sixtus: folds 
pardama: folds 
Dandy Monk: folds 
solbi86: folds 
*** FLOP *** [Kc Td 7c]
djammusic: checks 
Klappspaten0: bets $3
djammusic: folds 
Uncalled bet ($3) returned to Klappspaten0
Klappspaten0 collected $5.70 from pot
Klappspaten0: doesn't show hand 
*** SUMMARY ***
Total pot $6 | Rake $0.30 
Board [Kc Td 7c]
Seat 1: Klappspaten0 collected ($5.70)
Seat 2: stepan0605 folded before Flop (didn't bet)
Seat 3: KovIFish89 folded before Flop (didn't bet)
Seat 4: King Sixtus folded before Flop (didn't bet)
Seat 5: pardama (button) folded before Flop (didn't bet)
Seat 6: Dandy Monk (small blind) folded before Flop
Seat 7: solbi86 (big blind) folded before Flop
Seat 8: matiko09 folded before Flop (didn't bet)
Seat 9: djammusic folded on the Flop





PokerStars Hand #155014361344:  Hold'em No Limit ($0.50/$1.00 USD) - 2016/06/21 14:06:28 CET [2016/06/21 8:06:28 ET]
Table 'Lamberta II' 9-max Seat #3 is the button
Seat 3: matiko09 ($103.18 in chips) 
Seat 4: Eskimo Fox ($115.39 in chips) 
Seat 5: CoolFireX ($112.72 in chips) 
Seat 6: Chen423 ($98.23 in chips) 
Seat 7: 23SmOkEr07 ($197.04 in chips) 
Seat 8: Troll8989 ($104.72 in chips) 
Seat 9: Sjtu_Michael ($113.34 in chips) 
Eskimo Fox: posts small blind $0.50
CoolFireX: posts big blind $1
Avtovo: sits out 
*** HOLE CARDS ***
Dealt to matiko09 [4s Kh]
mavin80 is disconnected 
Chen423: folds 
23SmOkEr07: folds 
Troll8989: raises $1.50 to $2.50
Sjtu_Michael: folds 
matiko09: folds 
Eskimo Fox: folds 
CoolFireX: calls $1.50
*** FLOP *** [4c Kc Jc]
CoolFireX: checks 
Troll8989: checks 
*** TURN *** [4c Kc Jc] [6h]
CoolFireX: checks 
Troll8989: bets $3
CoolFireX: calls $3
*** RIVER *** [4c Kc Jc 6h] [Tc]
CoolFireX: bets $5.50
Troll8989: calls $5.50
*** SHOW DOWN ***
CoolFireX: shows [Td Ac] (a flush, Ace high)
Troll8989: mucks hand 
CoolFireX collected $21.38 from pot
*** SUMMARY ***
Total pot $22.50 | Rake $1.12 
Board [4c Kc Jc 6h Tc]
Seat 3: matiko09 (button) folded before Flop (didn't bet)
Seat 4: Eskimo Fox (small blind) folded before Flop
Seat 5: CoolFireX (big blind) showed [Td Ac] and won ($21.38) with a flush, Ace high
Seat 6: Chen423 folded before Flop (didn't bet)
Seat 7: 23SmOkEr07 folded before Flop (didn't bet)
Seat 8: Troll8989 mucked [Qc Jh]
Seat 9: Sjtu_Michael folded before Flop (didn't bet)





PokerStars Hand #155014363391:  Hold'em No Limit ($0.50/$1.00 USD) - 2016/06/21 14:06:33 CET [2016/06/21 8:06:33 ET]
Table 'Amundsenia' 9-max Seat #6 is the button
Seat 1: Troll8989 ($103 in chips) 
Seat 2: Avtovo ($109.28 in chips) 
Seat 3: matiko09 ($100 in chips) 
Seat 4: typename27 ($21.17 in chips) 
Seat 5: ozone2003 ($100 in chips) 
Seat 6: King_ZéManel ($130.63 in chips) 
Seat 7: Eskimo Fox ($103 in chips) 
Seat 8: DomiVY ($50.82 in chips) 
Seat 9: MrSeymen ($48.36 in chips) 
Eskimo Fox: posts small blind $0.50
DomiVY: posts big blind $1
*** HOLE CARDS ***
Dealt to matiko09 [Qh 5h]
MrSeymen: folds 
Troll8989: folds 
Avtovo: raises $1.50 to $2.50
matiko09: folds 
typename27: folds 
ozone2003: folds 
King_ZéManel: calls $2.50
Eskimo Fox: folds 
DomiVY: folds 
*** FLOP *** [Ts 7d 7h]
Avtovo: checks 
King_ZéManel: bets $3.09
Avtovo: folds 
Uncalled bet ($3.09) returned to King_ZéManel
King_ZéManel collected $6.18 from pot
King_ZéManel: doesn't show hand 
*** SUMMARY ***
Total pot $6.50 | Rake $0.32 
Board [Ts 7d 7h]
Seat 1: Troll8989 folded before Flop (didn't bet)
Seat 2: Avtovo folded on the Flop
Seat 3: matiko09 folded before Flop (didn't bet)
Seat 4: typename27 folded before Flop (didn't bet)
Seat 5: ozone2003 folded before Flop (didn't bet)
Seat 6: King_ZéManel (button) collected ($6.18)
Seat 7: Eskimo Fox (small blind) folded before Flop
Seat 8: DomiVY (big blind) folded before Flop
Seat 9: MrSeymen folded before Flop (didn't bet)





PokerStars Hand #155014365378:  Hold'em No Limit ($0.50/$1.00 USD) - 2016/06/21 14:06:37 CET [2016/06/21 8:06:37 ET]
Table 'Moreau' 9-max Seat #7 is the button
Seat 1: hurtNCYDE ($100 in chips) 
Seat 2: Avtovo ($106 in chips) 
Seat 3: matiko09 ($100 in chips) 
Seat 5: CoolFireX ($122.55 in chips) 
Seat 7: PanKwn15 ($88.82 in chips) 
Seat 8: mi$$I$Elena ($111.62 in chips) 
Seat 9: Toonersens ($101.34 in chips) 
mi$$I$Elena: posts small blind $0.50
Toonersens: posts big blind $1
Troll8989: sits out 
*** HOLE CARDS ***
Dealt to matiko09 [Jh Ts]
hurtNCYDE: folds 
Avtovo: folds 
matiko09: folds 
CoolFireX: raises $1.50 to $2.50
PanKwn15: folds 
mi$$I$Elena: folds 
Toonersens: calls $1.50
*** FLOP *** [5h 6d Qh]
Toonersens: checks 
CoolFireX: bets $3
Toonersens: calls $3
*** TURN *** [5h 6d Qh] [Ac]
Toonersens: checks 
CoolFireX: bets $7
Toonersens: calls $7
*** RIVER *** [5h 6d Qh Ac] [Th]
Toonersens: checks 
CoolFireX: checks 
*** SHOW DOWN ***
Toonersens: shows [5d As] (two pair, Aces and Fives)
CoolFireX: mucks hand 
Toonersens collected $24.22 from pot
*** SUMMARY ***
Total pot $25.50 | Rake $1.28 
Board [5h 6d Qh Ac Th]
Seat 1: hurtNCYDE folded before Flop (didn't bet)
Seat 2: Avtovo folded before Flop (didn't bet)
Seat 3: matiko09 folded before Flop (didn't bet)
Seat 5: CoolFireX mucked [4d Ad]
Seat 7: PanKwn15 (button) folded before Flop (didn't bet)
Seat 8: mi$$I$Elena (small blind) folded before Flop
Seat 9: Toonersens (big blind) showed [5d As] and won ($24.22) with two pair, Aces and Fives





PokerStars Hand #155014374579:  Hold'em No Limit ($0.50/$1.00 USD) - 2016/06/21 14:06:57 CET [2016/06/21 8:06:57 ET]
Table 'Schurer II' 9-max Seat #3 is the button
Seat 1: Dantist1122 ($100 in chips) 
Seat 2: havenots88 ($84.50 in chips) 
Seat 3: matiko09 ($103.65 in chips) 
Seat 4: hurtNCYDE ($108 in chips) 
Seat 5: riggedsh** ($121.30 in chips) 
Seat 7: Avtovo ($107.58 in chips) 
Seat 8: stepan0605 ($100.68 in chips) 
hurtNCYDE: posts small blind $0.50
riggedsh**: posts big blind $1
pardama: sits out 
*** HOLE CARDS ***
Dealt to matiko09 [2h 5s]
Avtovo: raises $1.50 to $2.50
stepan0605: folds 
Dantist1122: folds 
havenots88: calls $2.50
matiko09: folds 
hurtNCYDE: folds 
riggedsh**: calls $1.50
*** FLOP *** [5d Ac 3h]
riggedsh**: checks 
Avtovo: checks 
havenots88: bets $3.80
riggedsh**: folds 
Avtovo: folds 
Uncalled bet ($3.80) returned to havenots88
havenots88 collected $7.60 from pot
havenots88: doesn't show hand 
*** SUMMARY ***
Total pot $8 | Rake $0.40 
Board [5d Ac 3h]
Seat 1: Dantist1122 folded before Flop (didn't bet)
Seat 2: havenots88 collected ($7.60)
Seat 3: matiko09 (button) folded before Flop (didn't bet)
Seat 4: hurtNCYDE (small blind) folded before Flop
Seat 5: riggedsh** (big blind) folded on the Flop
Seat 7: Avtovo folded on the Flop
Seat 8: stepan0605 folded before Flop (didn't bet)





PokerStars Hand #155014377081:  Hold'em No Limit (€0.25/€0.50 EUR) - 2016/06/21 14:07:03 CET [2016/06/21 8:07:03 ET]
Table 'Lotis II' 6-max Seat #5 is the button
Seat 2: NoHeroHUD (€50 in chips) 
Seat 3: hmverlin (€23.52 in chips) 
Seat 4: IpMan13 (€79.09 in chips) 
Seat 5: KrishnaRadha (€52.75 in chips) 
Seat 6: matiko09 (€50 in chips) 
matiko09: posts small blind €0.25
NoHeroHUD: posts big blind €0.50
*** HOLE CARDS ***
Dealt to matiko09 [Jh Jd]
hmverlin: folds 
IpMan13: folds 
KrishnaRadha: folds 
matiko09: raises €1 to €1.50
NoHeroHUD: folds 
Uncalled bet (€1) returned to matiko09
matiko09 collected €1 from pot
matiko09: doesn't show hand 
*** SUMMARY ***
Total pot €1 | Rake €0 
Seat 2: NoHeroHUD (big blind) folded before Flop
Seat 3: hmverlin folded before Flop (didn't bet)
Seat 4: IpMan13 folded before Flop (didn't bet)
Seat 5: KrishnaRadha (button) folded before Flop (didn't bet)
Seat 6: matiko09 (small blind) collected (€1)





PokerStars Hand #155014385115:  Hold'em No Limit ($0.50/$1.00 USD) - 2016/06/21 14:07:20 CET [2016/06/21 8:07:20 ET]
Table 'Saldanha' 9-max Seat #1 is the button
Seat 1: KovIFish89 ($100 in chips) 
Seat 2: Avtovo ($111.04 in chips) 
Seat 3: matiko09 ($401.99 in chips) 
Seat 4: CoolFireX ($100 in chips) 
Seat 5: Troll8989 ($100 in chips) 
Seat 6: Juu2huu ($71.44 in chips) 
Seat 7: ozone2003 ($112.38 in chips) 
Seat 8: erick222 ($100 in chips) 
Seat 9: 23SmOkEr07 ($142.71 in chips) 
Avtovo: posts small blind $0.50
matiko09: posts big blind $1
KovIFish89: posts the ante $0.20
Avtovo: posts the ante $0.20
matiko09: posts the ante $0.20
CoolFireX: posts the ante $0.20
Troll8989: posts the ante $0.20
Juu2huu: posts the ante $0.20
ozone2003: posts the ante $0.20
erick222: posts the ante $0.20
23SmOkEr07: posts the ante $0.20
*** HOLE CARDS ***
Dealt to matiko09 [Jh Js]
CoolFireX: folds 
Troll8989: folds 
Juu2huu: folds 
ozone2003: folds 
erick222: raises $3 to $4
23SmOkEr07: calls $4
KovIFish89: folds 
Avtovo: raises $14 to $18
matiko09: folds 
erick222: calls $14
23SmOkEr07: folds 
*** FLOP *** [5c 6h 2c]
Avtovo: bets $20.33
erick222: raises $61.47 to $81.80 and is all-in
Avtovo: calls $61.47
*** TURN *** [5c 6h 2c] [5d]
*** RIVER *** [5c 6h 2c 5d] [9d]
*** SHOW DOWN ***
Avtovo: shows [Kc Ac] (a pair of Fives)
erick222: shows [Td Tc] (two pair, Tens and Fives)
erick222 collected $203.90 from pot
*** SUMMARY ***
Total pot $206.40 | Rake $2.50 
Board [5c 6h 2c 5d 9d]
Seat 1: KovIFish89 (button) folded before Flop (didn't bet)
Seat 2: Avtovo (small blind) showed [Kc Ac] and lost with a pair of Fives
Seat 3: matiko09 (big blind) folded before Flop
Seat 4: CoolFireX folded before Flop (didn't bet)
Seat 5: Troll8989 folded before Flop (didn't bet)
Seat 6: Juu2huu folded before Flop (didn't bet)
Seat 7: ozone2003 folded before Flop (didn't bet)
Seat 8: erick222 showed [Td Tc] and won ($203.90) with two pair, Tens and Fives
Seat 9: 23SmOkEr07 folded before Flop





PokerStars Hand #155014386441:  Hold'em No Limit ($0.50/$1.00 USD) - 2016/06/21 14:07:23 CET [2016/06/21 8:07:23 ET]
Table 'Amundsenia' 9-max Seat #7 is the button
Seat 1: Troll8989 ($103 in chips) 
Seat 2: Avtovo ($106.78 in chips) 
Seat 3: matiko09 ($100 in chips) 
Seat 4: typename27 ($21.17 in chips) 
Seat 5: ozone2003 ($100 in chips) 
Seat 6: King_ZéManel ($134.31 in chips) 
Seat 7: Eskimo Fox ($102.50 in chips) 
Seat 8: DomiVY ($49.82 in chips) 
Seat 9: MrSeymen ($48.36 in chips) 
DomiVY: posts small blind $0.50
MrSeymen: posts big blind $1
*** HOLE CARDS ***
Dealt to matiko09 [As 3c]
Troll8989: raises $1.50 to $2.50
Avtovo: folds 
matiko09: folds 
typename27: calls $2.50
ozone2003: folds 
King_ZéManel: calls $2.50
Eskimo Fox: folds 
DomiVY: folds 
MrSeymen: calls $1.50
*** FLOP *** [Kc Th Jd]
MrSeymen: checks 
Troll8989: checks 
typename27: checks 
King_ZéManel: checks 
*** TURN *** [Kc Th Jd] [4h]
MrSeymen: checks 
Troll8989: bets $5
typename27: folds 
King_ZéManel: folds 
MrSeymen: folds 
Uncalled bet ($5) returned to Troll8989
Troll8989 collected $9.98 from pot
Troll8989: doesn't show hand 
*** SUMMARY ***
Total pot $10.50 | Rake $0.52 
Board [Kc Th Jd 4h]
Seat 1: Troll8989 collected ($9.98)
Seat 2: Avtovo folded before Flop (didn't bet)
Seat 3: matiko09 folded before Flop (didn't bet)
Seat 4: typename27 folded on the Turn
Seat 5: ozone2003 folded before Flop (didn't bet)
Seat 6: King_ZéManel folded on the Turn
Seat 7: Eskimo Fox (button) folded before Flop (didn't bet)
Seat 8: DomiVY (small blind) folded before Flop
Seat 9: MrSeymen (big blind) folded on the Turn





PokerStars Hand #155014388511:  Hold'em No Limit (€0.25/€0.50 EUR) - 2016/06/21 14:07:28 CET [2016/06/21 8:07:28 ET]
Table 'Lotis II' 6-max Seat #6 is the button
Seat 2: NoHeroHUD (€50 in chips) 
Seat 3: hmverlin (€23.52 in chips) 
Seat 4: IpMan13 (€79.09 in chips) 
Seat 5: KrishnaRadha (€52.75 in chips) 
Seat 6: matiko09 (€50.50 in chips) 
NoHeroHUD: posts small blind €0.25
hmverlin: posts big blind €0.50
*** HOLE CARDS ***
Dealt to matiko09 [Tc Th]
IpMan13: folds 
KrishnaRadha: folds 
matiko09: raises €0.63 to €1.13
NoHeroHUD: raises €2.76 to €3.89
bustafc joins the table at seat #1 
hmverlin: folds 
matiko09: calls €2.76
*** FLOP *** [Qh Jh 8h]
NoHeroHUD: checks 
matiko09: checks 
*** TURN *** [Qh Jh 8h] [8d]
NoHeroHUD: bets €6.50
matiko09: folds 
Uncalled bet (€6.50) returned to NoHeroHUD
NoHeroHUD collected €7.87 from pot
NoHeroHUD: doesn't show hand 
*** SUMMARY ***
Total pot €8.28 | Rake €0.41 
Board [Qh Jh 8h 8d]
Seat 2: NoHeroHUD (small blind) collected (€7.87)
Seat 3: hmverlin (big blind) folded before Flop
Seat 4: IpMan13 folded before Flop (didn't bet)
Seat 5: KrishnaRadha folded before Flop (didn't bet)
Seat 6: matiko09 (button) folded on the Turn





PokerStars Hand #155014391849:  Hold'em No Limit ($0.50/$1.00 USD) - 2016/06/21 14:07:35 CET [2016/06/21 8:07:35 ET]
Table 'Gryphia' 9-max Seat #6 is the button
Seat 1: Klappspaten0 ($104.72 in chips) 
Seat 2: stepan0605 ($179.20 in chips) 
Seat 3: KovIFish89 ($106.40 in chips) 
Seat 4: King Sixtus ($65.69 in chips) 
Seat 5: pardama ($100 in chips) 
Seat 6: Dandy Monk ($40.74 in chips) 
Seat 7: solbi86 ($100.48 in chips) 
Seat 8: matiko09 ($109.38 in chips) 
Seat 9: djammusic ($48.30 in chips) 
solbi86: posts small blind $0.50
matiko09: posts big blind $1
*** HOLE CARDS ***
Dealt to matiko09 [Tc Jh]
djammusic: folds 
Klappspaten0: folds 
stepan0605: folds 
KovIFish89: folds 
King Sixtus: folds 
pardama: folds 
Dandy Monk: folds 
solbi86: folds 
Uncalled bet ($0.50) returned to matiko09
matiko09 collected $1 from pot
matiko09: doesn't show hand 
*** SUMMARY ***
Total pot $1 | Rake $0 
Seat 1: Klappspaten0 folded before Flop (didn't bet)
Seat 2: stepan0605 folded before Flop (didn't bet)
Seat 3: KovIFish89 folded before Flop (didn't bet)
Seat 4: King Sixtus folded before Flop (didn't bet)
Seat 5: pardama folded before Flop (didn't bet)
Seat 6: Dandy Monk (button) folded before Flop (didn't bet)
Seat 7: solbi86 (small blind) folded before Flop
Seat 8: matiko09 (big blind) collected ($1)
Seat 9: djammusic folded before Flop (didn't bet)





PokerStars Hand #155014398185:  Hold'em No Limit ($0.50/$1.00 USD) - 2016/06/21 14:07:49 CET [2016/06/21 8:07:49 ET]
Table 'Gryphia' 9-max Seat #7 is the button
Seat 1: Klappspaten0 ($104.72 in chips) 
Seat 2: stepan0605 ($179.20 in chips) 
Seat 3: KovIFish89 ($106.40 in chips) 
Seat 4: King Sixtus ($65.69 in chips) 
Seat 5: pardama ($100 in chips) 
Seat 6: Dandy Monk ($40.74 in chips) 
Seat 7: solbi86 ($100 in chips) 
Seat 8: matiko09 ($109.88 in chips) 
Seat 9: djammusic ($48.30 in chips) 
matiko09: posts small blind $0.50
djammusic: posts big blind $1
*** HOLE CARDS ***
Dealt to matiko09 [As 4h]
Klappspaten0: folds 
stepan0605: raises $1 to $2
KovIFish89: calls $2
King Sixtus: raises $7.50 to $9.50
pardama: folds 
Dandy Monk: calls $9.50
solbi86: folds 
matiko09: folds 
djammusic: folds 
stepan0605: folds 
KovIFish89: folds 
*** FLOP *** [4d Qc 2h]
King Sixtus: checks 
Dandy Monk: bets $31.24 and is all-in
King Sixtus: folds 
Uncalled bet ($31.24) returned to Dandy Monk
Dandy Monk collected $23.28 from pot
Dandy Monk: doesn't show hand 
*** SUMMARY ***
Total pot $24.50 | Rake $1.22 
Board [4d Qc 2h]
Seat 1: Klappspaten0 folded before Flop (didn't bet)
Seat 2: stepan0605 folded before Flop
Seat 3: KovIFish89 folded before Flop
Seat 4: King Sixtus folded on the Flop
Seat 5: pardama folded before Flop (didn't bet)
Seat 6: Dandy Monk collected ($23.28)
Seat 7: solbi86 (button) folded before Flop (didn't bet)
Seat 8: matiko09 (small blind) folded before Flop
Seat 9: djammusic (big blind) folded before Flop





PokerStars Hand #155014403178:  Hold'em No Limit ($0.50/$1.00 USD) - 2016/06/21 14:08:00 CET [2016/06/21 8:08:00 ET]
Table 'Lamberta II' 9-max Seat #4 is the button
Seat 3: matiko09 ($103.18 in chips) 
Seat 4: Eskimo Fox ($114.89 in chips) 
Seat 5: CoolFireX ($123.10 in chips) 
Seat 6: Chen423 ($98.23 in chips) 
Seat 7: 23SmOkEr07 ($197.04 in chips) 
Seat 8: Troll8989 ($100 in chips) 
Seat 9: Sjtu_Michael ($113.34 in chips) 
CoolFireX: posts small blind $0.50
Chen423: posts big blind $1
Avtovo: sits out 
*** HOLE CARDS ***
Dealt to matiko09 [4c 4h]
23SmOkEr07: folds 
Troll8989: folds 
Sjtu_Michael: raises $2 to $3
mavin80 leaves the table
matiko09: folds 
Eskimo Fox: folds 
CoolFireX: folds 
Chen423: calls $2
*** FLOP *** [9d 5s As]
Chen423: checks 
Sjtu_Michael: bets $3.09
pardama joins the table at seat #2 
Chen423: folds 
Uncalled bet ($3.09) returned to Sjtu_Michael
Sjtu_Michael collected $6.18 from pot
*** SUMMARY ***
Total pot $6.50 | Rake $0.32 
Board [9d 5s As]
Seat 3: matiko09 folded before Flop (didn't bet)
Seat 4: Eskimo Fox (button) folded before Flop (didn't bet)
Seat 5: CoolFireX (small blind) folded before Flop
Seat 6: Chen423 (big blind) folded on the Flop
Seat 7: 23SmOkEr07 folded before Flop (didn't bet)
Seat 8: Troll8989 folded before Flop (didn't bet)
Seat 9: Sjtu_Michael collected ($6.18)





PokerStars Hand #155014410739:  Hold'em No Limit ($0.50/$1.00 USD) - 2016/06/21 14:08:16 CET [2016/06/21 8:08:16 ET]
Table 'Schurer II' 9-max Seat #4 is the button
Seat 1: Dantist1122 ($100 in chips) 
Seat 2: havenots88 ($89.60 in chips) 
Seat 3: matiko09 ($103.65 in chips) 
Seat 4: hurtNCYDE ($107.50 in chips) 
Seat 5: riggedsh** ($118.80 in chips) 
Seat 7: Avtovo ($105.08 in chips) 
Seat 8: stepan0605 ($100.68 in chips) 
riggedsh**: posts small blind $0.50
Avtovo: posts big blind $1
pardama: sits out 
*** HOLE CARDS ***
Dealt to matiko09 [9d 2c]
stepan0605: folds 
Dantist1122: folds 
havenots88: raises $2 to $3
matiko09: folds 
hurtNCYDE: folds 
riggedsh**: folds 
Avtovo: folds 
Uncalled bet ($2) returned to havenots88
havenots88 collected $2.50 from pot
havenots88: doesn't show hand 
*** SUMMARY ***
Total pot $2.50 | Rake $0 
Seat 1: Dantist1122 folded before Flop (didn't bet)
Seat 2: havenots88 collected ($2.50)
Seat 3: matiko09 folded before Flop (didn't bet)
Seat 4: hurtNCYDE (button) folded before Flop (didn't bet)
Seat 5: riggedsh** (small blind) folded before Flop
Seat 7: Avtovo (big blind) folded before Flop
Seat 8: stepan0605 folded before Flop (didn't bet)





PokerStars Hand #155014419123:  Hold'em No Limit ($0.50/$1.00 USD) - 2016/06/21 14:08:35 CET [2016/06/21 8:08:35 ET]
Table 'Schurer II' 9-max Seat #5 is the button
Seat 1: Dantist1122 ($100 in chips) 
Seat 2: havenots88 ($91.10 in chips) 
Seat 3: matiko09 ($103.65 in chips) 
Seat 4: hurtNCYDE ($107.50 in chips) 
Seat 5: riggedsh** ($118.30 in chips) 
Seat 7: Avtovo ($104.08 in chips) 
Seat 8: stepan0605 ($100.68 in chips) 
Avtovo: posts small blind $0.50
stepan0605: posts big blind $1
pardama: sits out 
*** HOLE CARDS ***
Dealt to matiko09 [4c Qd]
Dantist1122: folds 
havenots88: folds 
matiko09: folds 
hurtNCYDE: folds 
riggedsh**: folds 
Avtovo: folds 
Uncalled bet ($0.50) returned to stepan0605
stepan0605 collected $1 from pot
stepan0605: doesn't show hand 
*** SUMMARY ***
Total pot $1 | Rake $0 
Seat 1: Dantist1122 folded before Flop (didn't bet)
Seat 2: havenots88 folded before Flop (didn't bet)
Seat 3: matiko09 folded before Flop (didn't bet)
Seat 4: hurtNCYDE folded before Flop (didn't bet)
Seat 5: riggedsh** (button) folded before Flop (didn't bet)
Seat 7: Avtovo (small blind) folded before Flop
Seat 8: stepan0605 (big blind) collected ($1)





PokerStars Hand #155014421585:  Hold'em No Limit ($0.50/$1.00 USD) - 2016/06/21 14:08:40 CET [2016/06/21 8:08:40 ET]
Table 'Moreau' 9-max Seat #8 is the button
Seat 1: hurtNCYDE ($100 in chips) 
Seat 2: Avtovo ($106 in chips) 
Seat 3: matiko09 ($100 in chips) 
Seat 5: CoolFireX ($110.05 in chips) 
Seat 7: PanKwn15 ($88.82 in chips) 
Seat 8: mi$$I$Elena ($111.12 in chips) 
Seat 9: Toonersens ($113.06 in chips) 
Toonersens: posts small blind $0.50
hurtNCYDE: posts big blind $1
Troll8989: sits out 
*** HOLE CARDS ***
Dealt to matiko09 [Jh Ts]
Avtovo: folds 
matiko09: folds 
CoolFireX: raises $2 to $3
PanKwn15: folds 
mi$$I$Elena: folds 
Toonersens: folds 
hurtNCYDE: folds 
Uncalled bet ($2) returned to CoolFireX
CoolFireX collected $2.50 from pot
CoolFireX: doesn't show hand 
*** SUMMARY ***
Total pot $2.50 | Rake $0 
Seat 1: hurtNCYDE (big blind) folded before Flop
Seat 2: Avtovo folded before Flop (didn't bet)
Seat 3: matiko09 folded before Flop (didn't bet)
Seat 5: CoolFireX collected ($2.50)
Seat 7: PanKwn15 folded before Flop (didn't bet)
Seat 8: mi$$I$Elena (button) folded before Flop (didn't bet)
Seat 9: Toonersens (small blind) folded before Flop





PokerStars Hand #155014421867:  Hold'em No Limit (€0.25/€0.50 EUR) - 2016/06/21 14:08:41 CET [2016/06/21 8:08:41 ET]
Table 'Lotis II' 6-max Seat #2 is the button
Seat 2: NoHeroHUD (€53.98 in chips) 
Seat 3: hmverlin (€23.02 in chips) 
Seat 4: IpMan13 (€79.09 in chips) 
Seat 5: KrishnaRadha (€52.75 in chips) 
Seat 6: matiko09 (€50 in chips) 
hmverlin: posts small blind €0.25
IpMan13: posts big blind €0.50
bustafc: sits out 
*** HOLE CARDS ***
Dealt to matiko09 [8h 8d]
KrishnaRadha: raises €1 to €1.50
matiko09: calls €1.50
NoHeroHUD: folds 
hmverlin: calls €1.25
IpMan13: raises €6 to €7.50
KrishnaRadha: folds 
matiko09: folds 
hmverlin: folds 
Uncalled bet (€6) returned to IpMan13
IpMan13 collected €6 from pot
IpMan13: doesn't show hand 
*** SUMMARY ***
Total pot €6 | Rake €0 
Seat 2: NoHeroHUD (button) folded before Flop (didn't bet)
Seat 3: hmverlin (small blind) folded before Flop
Seat 4: IpMan13 (big blind) collected (€6)
Seat 5: KrishnaRadha folded before Flop
Seat 6: matiko09 folded before Flop





PokerStars Hand #155014427304:  Hold'em No Limit ($0.50/$1.00 USD) - 2016/06/21 14:08:52 CET [2016/06/21 8:08:52 ET]
Table 'Schurer II' 9-max Seat #7 is the button
Seat 1: Dantist1122 ($100 in chips) 
Seat 2: havenots88 ($91.10 in chips) 
Seat 3: matiko09 ($103.65 in chips) 
Seat 4: hurtNCYDE ($107.50 in chips) 
Seat 5: riggedsh** ($118.30 in chips) 
Seat 7: Avtovo ($103.58 in chips) 
Seat 8: stepan0605 ($101.18 in chips) 
Seat 9: pardama ($100 in chips) 
stepan0605: posts small blind $0.50
pardama: posts big blind $1
*** HOLE CARDS ***
Dealt to matiko09 [2c 3h]
Dantist1122: folds 
havenots88: folds 
matiko09: folds 
hurtNCYDE: folds 
riggedsh**: folds 
Avtovo: raises $1.50 to $2.50
stepan0605: calls $2
pardama: folds 
*** FLOP *** [6c 8c 5d]
stepan0605: bets $3
Avtovo: raises $11.70 to $14.70
stepan0605: folds 
Uncalled bet ($11.70) returned to Avtovo
Avtovo collected $11.40 from pot
Avtovo: doesn't show hand 
*** SUMMARY ***
Total pot $12 | Rake $0.60 
Board [6c 8c 5d]
Seat 1: Dantist1122 folded before Flop (didn't bet)
Seat 2: havenots88 folded before Flop (didn't bet)
Seat 3: matiko09 folded before Flop (didn't bet)
Seat 4: hurtNCYDE folded before Flop (didn't bet)
Seat 5: riggedsh** folded before Flop (didn't bet)
Seat 7: Avtovo (button) collected ($11.40)
Seat 8: stepan0605 (small blind) folded on the Flop
Seat 9: pardama (big blind) folded before Flop





PokerStars Hand #155014427636:  Hold'em No Limit ($0.50/$1.00 USD) - 2016/06/21 14:08:53 CET [2016/06/21 8:08:53 ET]
Table 'Lamberta II' 9-max Seat #5 is the button
Seat 3: matiko09 ($103.18 in chips) 
Seat 4: Eskimo Fox ($114.89 in chips) 
Seat 5: CoolFireX ($122.60 in chips) 
Seat 6: Chen423 ($95.23 in chips) 
Seat 7: 23SmOkEr07 ($197.04 in chips) 
Seat 8: Troll8989 ($100 in chips) 
Seat 9: Sjtu_Michael ($116.52 in chips) 
Chen423: posts small blind $0.50
23SmOkEr07: posts big blind $1
Avtovo: sits out 
pardama: sits out 
*** HOLE CARDS ***
Dealt to matiko09 [4s 9s]
Troll8989: folds 
Sjtu_Michael: folds 
Troll8989 leaves the table
matiko09: folds 
Eskimo Fox: raises $1.50 to $2.50
CoolFireX: folds 
Chen423: calls $2
23SmOkEr07: folds 
*** FLOP *** [3s 3c 2d]
Chen423: checks 
Eskimo Fox: checks 
*** TURN *** [3s 3c 2d] [5s]
Chen423: bets $2.85
Eskimo Fox: calls $2.85
*** RIVER *** [3s 3c 2d 5s] [Jc]
Chen423: bets $11.12
Eskimo Fox: folds 
Uncalled bet ($11.12) returned to Chen423
Chen423 collected $11.12 from pot
*** SUMMARY ***
Total pot $11.70 | Rake $0.58 
Board [3s 3c 2d 5s Jc]
Seat 3: matiko09 folded before Flop (didn't bet)
Seat 4: Eskimo Fox folded on the River
Seat 5: CoolFireX (button) folded before Flop (didn't bet)
Seat 6: Chen423 (small blind) collected ($11.12)
Seat 7: 23SmOkEr07 (big blind) folded before Flop
Seat 8: Troll8989 folded before Flop (didn't bet)
Seat 9: Sjtu_Michael folded before Flop (didn't bet)





PokerStars Hand #155014427684:  Hold'em No Limit ($0.50/$1.00 USD) - 2016/06/21 14:08:53 CET [2016/06/21 8:08:53 ET]
Table 'Amundsenia' 9-max Seat #8 is the button
Seat 1: Troll8989 ($110.48 in chips) 
Seat 2: Avtovo ($106.78 in chips) 
Seat 3: matiko09 ($100 in chips) 
Seat 4: typename27 ($18.67 in chips) 
Seat 5: ozone2003 ($100 in chips) 
Seat 6: King_ZéManel ($131.81 in chips) 
Seat 7: Eskimo Fox ($102.50 in chips) 
Seat 8: DomiVY ($49.32 in chips) 
Seat 9: MrSeymen ($45.86 in chips) 
MrSeymen: posts small blind $0.50
Troll8989: posts big blind $1
*** HOLE CARDS ***
Dealt to matiko09 [Kh 6s]
Avtovo: folds 
matiko09: folds 
typename27: folds 
ozone2003: folds 
King_ZéManel: folds 
Eskimo Fox: raises $2 to $3
DomiVY: folds 
MrSeymen: calls $2.50
Troll8989: folds 
*** FLOP *** [9c 5d Js]
MrSeymen: checks 
Eskimo Fox: bets $4.65
MrSeymen: folds 
Uncalled bet ($4.65) returned to Eskimo Fox
Eskimo Fox collected $6.65 from pot
Eskimo Fox: doesn't show hand 
*** SUMMARY ***
Total pot $7 | Rake $0.35 
Board [9c 5d Js]
Seat 1: Troll8989 (big blind) folded before Flop
Seat 2: Avtovo folded before Flop (didn't bet)
Seat 3: matiko09 folded before Flop (didn't bet)
Seat 4: typename27 folded before Flop (didn't bet)
Seat 5: ozone2003 folded before Flop (didn't bet)
Seat 6: King_ZéManel folded before Flop (didn't bet)
Seat 7: Eskimo Fox collected ($6.65)
Seat 8: DomiVY (button) folded before Flop (didn't bet)
Seat 9: MrSeymen (small blind) folded on the Flop





PokerStars Hand #155014431174:  Hold'em No Limit ($0.50/$1.00 USD) - 2016/06/21 14:09:01 CET [2016/06/21 8:09:01 ET]
Table 'Gryphia' 9-max Seat #8 is the button
Seat 1: Klappspaten0 ($104.72 in chips) 
Seat 2: stepan0605 ($177.20 in chips) 
Seat 3: KovIFish89 ($104.40 in chips) 
Seat 4: King Sixtus ($56.19 in chips) 
Seat 5: pardama ($100 in chips) 
Seat 6: Dandy Monk ($54.52 in chips) 
Seat 7: solbi86 ($100 in chips) 
Seat 8: matiko09 ($109.38 in chips) 
Seat 9: djammusic ($47.30 in chips) 
djammusic: posts small blind $0.50
Klappspaten0: posts big blind $1
*** HOLE CARDS ***
Dealt to matiko09 [Qh 8s]
stepan0605: folds 
KovIFish89: folds 
King Sixtus: folds 
pardama: folds 
Dandy Monk: folds 
solbi86: folds 
matiko09: raises $1.27 to $2.27
djammusic: folds 
Klappspaten0: calls $1.27
*** FLOP *** [As Ac 3s]
Klappspaten0: checks 
matiko09: bets $2
Klappspaten0: calls $2
*** TURN *** [As Ac 3s] [7d]
Klappspaten0: checks 
matiko09: checks 
*** RIVER *** [As Ac 3s 7d] [Kh]
Klappspaten0: checks 
matiko09: checks 
*** SHOW DOWN ***
Klappspaten0: shows [9h 9c] (two pair, Aces and Nines)
matiko09: mucks hand 
Klappspaten0 collected $8.59 from pot
*** SUMMARY ***
Total pot $9.04 | Rake $0.45 
Board [As Ac 3s 7d Kh]
Seat 1: Klappspaten0 (big blind) showed [9h 9c] and won ($8.59) with two pair, Aces and Nines
Seat 2: stepan0605 folded before Flop (didn't bet)
Seat 3: KovIFish89 folded before Flop (didn't bet)
Seat 4: King Sixtus folded before Flop (didn't bet)
Seat 5: pardama folded before Flop (didn't bet)
Seat 6: Dandy Monk folded before Flop (didn't bet)
Seat 7: solbi86 folded before Flop (didn't bet)
Seat 8: matiko09 (button) mucked [Qh 8s]
Seat 9: djammusic (small blind) folded before Flop





PokerStars Hand #155014438249:  Hold'em No Limit ($0.50/$1.00 USD) - 2016/06/21 14:09:16 CET [2016/06/21 8:09:16 ET]
Table 'Moreau' 9-max Seat #9 is the button
Seat 1: hurtNCYDE ($100 in chips) 
Seat 2: Avtovo ($106 in chips) 
Seat 3: matiko09 ($100 in chips) 
Seat 5: CoolFireX ($111.55 in chips) 
Seat 7: PanKwn15 ($88.82 in chips) 
Seat 8: mi$$I$Elena ($111.12 in chips) 
Seat 9: Toonersens ($112.56 in chips) 
hurtNCYDE: posts small blind $0.50
Avtovo: posts big blind $1
SharingaaN: sits out 
Troll8989: sits out 
*** HOLE CARDS ***
Dealt to matiko09 [4s 7h]
matiko09: folds 
CoolFireX: raises $2 to $3
PanKwn15: folds 
mi$$I$Elena: folds 
Toonersens: folds 
hurtNCYDE: folds 
Avtovo: folds 
Uncalled bet ($2) returned to CoolFireX
CoolFireX collected $2.50 from pot
CoolFireX: doesn't show hand 
*** SUMMARY ***
Total pot $2.50 | Rake $0 
Seat 1: hurtNCYDE (small blind) folded before Flop
Seat 2: Avtovo (big blind) folded before Flop
Seat 3: matiko09 folded before Flop (didn't bet)
Seat 5: CoolFireX collected ($2.50)
Seat 7: PanKwn15 folded before Flop (didn't bet)
Seat 8: mi$$I$Elena folded before Flop (didn't bet)
Seat 9: Toonersens (button) folded before Flop (didn't bet)





PokerStars Hand #155014438892:  Hold'em No Limit ($0.50/$1.00 USD) - 2016/06/21 14:09:18 CET [2016/06/21 8:09:18 ET]
Table 'Saldanha' 9-max Seat #2 is the button
Seat 1: KovIFish89 ($100 in chips) 
Seat 2: Avtovo ($100 in chips) 
Seat 3: matiko09 ($400.79 in chips) 
Seat 4: CoolFireX ($100 in chips) 
Seat 5: Troll8989 ($100 in chips) 
Seat 6: Juu2huu ($71.24 in chips) 
Seat 7: ozone2003 ($112.18 in chips) 
Seat 8: erick222 ($203.90 in chips) 
Seat 9: 23SmOkEr07 ($138.51 in chips) 
matiko09: posts small blind $0.50
CoolFireX: posts big blind $1
KovIFish89: posts the ante $0.20
Avtovo: posts the ante $0.20
matiko09: posts the ante $0.20
CoolFireX: posts the ante $0.20
Troll8989: posts the ante $0.20
Juu2huu: posts the ante $0.20
ozone2003: posts the ante $0.20
erick222: posts the ante $0.20
23SmOkEr07: posts the ante $0.20
*** HOLE CARDS ***
Dealt to matiko09 [4s 5h]
Troll8989: folds 
Juu2huu: folds 
ozone2003: folds 
erick222: folds 
23SmOkEr07: folds 
KovIFish89: folds 
Avtovo: raises $1.50 to $2.50
matiko09: folds 
CoolFireX: folds 
Uncalled bet ($1.50) returned to Avtovo
Avtovo collected $4.30 from pot
Avtovo: doesn't show hand 
*** SUMMARY ***
Total pot $4.30 | Rake $0 
Seat 1: KovIFish89 folded before Flop (didn't bet)
Seat 2: Avtovo (button) collected ($4.30)
Seat 3: matiko09 (small blind) folded before Flop
Seat 4: CoolFireX (big blind) folded before Flop
Seat 5: Troll8989 folded before Flop (didn't bet)
Seat 6: Juu2huu folded before Flop (didn't bet)
Seat 7: ozone2003 folded before Flop (didn't bet)
Seat 8: erick222 folded before Flop (didn't bet)
Seat 9: 23SmOkEr07 folded before Flop (didn't bet)





PokerStars Hand #155014441487:  Hold'em No Limit (€0.25/€0.50 EUR) - 2016/06/21 14:09:23 CET [2016/06/21 8:09:23 ET]
Table 'Lotis II' 6-max Seat #3 is the button
Seat 2: NoHeroHUD (€53.98 in chips) 
Seat 3: hmverlin (€21.52 in chips) 
Seat 4: IpMan13 (€83.59 in chips) 
Seat 5: KrishnaRadha (€51.25 in chips) 
Seat 6: matiko09 (€50 in chips) 
IpMan13: posts small blind €0.25
KrishnaRadha: posts big blind €0.50
bustafc: sits out 
*** HOLE CARDS ***
Dealt to matiko09 [7h 8d]
matiko09: folds 
NoHeroHUD: raises €0.75 to €1.25
hmverlin: folds 
IpMan13: folds 
KrishnaRadha: folds 
Uncalled bet (€0.75) returned to NoHeroHUD
NoHeroHUD collected €1.25 from pot
NoHeroHUD: doesn't show hand 
*** SUMMARY ***
Total pot €1.25 | Rake €0 
Seat 2: NoHeroHUD collected (€1.25)
Seat 3: hmverlin (button) folded before Flop (didn't bet)
Seat 4: IpMan13 (small blind) folded before Flop
Seat 5: KrishnaRadha (big blind) folded before Flop
Seat 6: matiko09 folded before Flop (didn't bet)





PokerStars Hand #155014448164:  Hold'em No Limit ($0.50/$1.00 USD) - 2016/06/21 14:09:38 CET [2016/06/21 8:09:38 ET]
Table 'Moreau' 9-max Seat #1 is the button
Seat 1: hurtNCYDE ($100 in chips) 
Seat 2: Avtovo ($105 in chips) 
Seat 3: matiko09 ($100 in chips) 
Seat 5: CoolFireX ($113.05 in chips) 
Seat 7: PanKwn15 ($88.82 in chips) 
Seat 8: mi$$I$Elena ($111.12 in chips) 
Seat 9: Toonersens ($112.56 in chips) 
Avtovo: posts small blind $0.50
matiko09: posts big blind $1
SharingaaN: sits out 
Troll8989: sits out 
*** HOLE CARDS ***
Dealt to matiko09 [9h 7c]
CoolFireX: raises $2 to $3
PanKwn15: calls $3
mi$$I$Elena: folds 
Toonersens: folds 
hurtNCYDE: folds 
Avtovo: folds 
matiko09: folds 
*** FLOP *** [5h 2h 7d]
CoolFireX: bets $4.50
PanKwn15: raises $6 to $10.50
CoolFireX: calls $6
*** TURN *** [5h 2h 7d] [8s]
CoolFireX: checks 
PanKwn15: bets $21
CoolFireX: calls $21
*** RIVER *** [5h 2h 7d 8s] [Qs]
CoolFireX: checks 
PanKwn15: checks 
*** SHOW DOWN ***
CoolFireX: shows [Qh Kh] (a pair of Queens)
PanKwn15: mucks hand 
CoolFireX collected $68 from pot
*** SUMMARY ***
Total pot $70.50 | Rake $2.50 
Board [5h 2h 7d 8s Qs]
Seat 1: hurtNCYDE (button) folded before Flop (didn't bet)
Seat 2: Avtovo (small blind) folded before Flop
Seat 3: matiko09 (big blind) folded before Flop
Seat 5: CoolFireX showed [Qh Kh] and won ($68) with a pair of Queens
Seat 7: PanKwn15 mucked [Ts Kd]
Seat 8: mi$$I$Elena folded before Flop (didn't bet)
Seat 9: Toonersens folded before Flop (didn't bet)





PokerStars Hand #155014449021:  Hold'em No Limit ($0.50/$1.00 USD) - 2016/06/21 14:09:40 CET [2016/06/21 8:09:40 ET]
Table 'Saldanha' 9-max Seat #3 is the button
Seat 1: KovIFish89 ($100 in chips) 
Seat 2: Avtovo ($103.10 in chips) 
Seat 3: matiko09 ($400.09 in chips) 
Seat 4: CoolFireX ($100 in chips) 
Seat 5: Troll8989 ($100 in chips) 
Seat 6: Juu2huu ($71.04 in chips) 
Seat 7: ozone2003 ($111.98 in chips) 
Seat 8: erick222 ($203.70 in chips) 
Seat 9: 23SmOkEr07 ($138.31 in chips) 
CoolFireX: posts small blind $0.50
Troll8989: posts big blind $1
KovIFish89: posts the ante $0.20
Avtovo: posts the ante $0.20
matiko09: posts the ante $0.20
CoolFireX: posts the ante $0.20
Troll8989: posts the ante $0.20
Juu2huu: posts the ante $0.20
ozone2003: posts the ante $0.20
erick222: posts the ante $0.20
23SmOkEr07: posts the ante $0.20
*** HOLE CARDS ***
Dealt to matiko09 [4h 2d]
Juu2huu: folds 
ozone2003: folds 
erick222: folds 
23SmOkEr07: folds 
KovIFish89: folds 
Avtovo: folds 
matiko09: folds 
CoolFireX: raises $2 to $3
Troll8989: calls $2
*** FLOP *** [Js Kc 4s]
CoolFireX: bets $4.50
Troll8989: calls $4.50
*** TURN *** [Js Kc 4s] [8s]
CoolFireX: checks 
Troll8989: checks 
*** RIVER *** [Js Kc 4s 8s] [Kh]
CoolFireX: checks 
Troll8989: checks 
*** SHOW DOWN ***
CoolFireX: shows [3h Qh] (a pair of Kings)
Troll8989: shows [Jh 6h] (two pair, Kings and Jacks)
Troll8989 collected $15.96 from pot
*** SUMMARY ***
Total pot $16.80 | Rake $0.84 
Board [Js Kc 4s 8s Kh]
Seat 1: KovIFish89 folded before Flop (didn't bet)
Seat 2: Avtovo folded before Flop (didn't bet)
Seat 3: matiko09 (button) folded before Flop (didn't bet)
Seat 4: CoolFireX (small blind) showed [3h Qh] and lost with a pair of Kings
Seat 5: Troll8989 (big blind) showed [Jh 6h] and won ($15.96) with two pair, Kings and Jacks
Seat 6: Juu2huu folded before Flop (didn't bet)
Seat 7: ozone2003 folded before Flop (didn't bet)
Seat 8: erick222 folded before Flop (didn't bet)
Seat 9: 23SmOkEr07 folded before Flop (didn't bet)





PokerStars Hand #155014449426:  Hold'em No Limit (€0.25/€0.50 EUR) - 2016/06/21 14:09:41 CET [2016/06/21 8:09:41 ET]
Table 'Lotis II' 6-max Seat #4 is the button
Seat 2: NoHeroHUD (€54.73 in chips) 
Seat 3: hmverlin (€21.52 in chips) 
Seat 4: IpMan13 (€83.34 in chips) 
Seat 5: KrishnaRadha (€50.75 in chips) 
Seat 6: matiko09 (€50 in chips) 
KrishnaRadha: posts small blind €0.25
matiko09: posts big blind €0.50
bustafc: sits out 
*** HOLE CARDS ***
Dealt to matiko09 [Ah 8c]
NoHeroHUD: folds 
hmverlin: folds 
IpMan13: raises €0.50 to €1
KrishnaRadha: raises €3 to €4
matiko09: folds 
IpMan13: raises €5 to €9
KrishnaRadha: folds 
Uncalled bet (€5) returned to IpMan13
IpMan13 collected €8.50 from pot
IpMan13: doesn't show hand 
*** SUMMARY ***
Total pot €8.50 | Rake €0 
Seat 2: NoHeroHUD folded before Flop (didn't bet)
Seat 3: hmverlin folded before Flop (didn't bet)
Seat 4: IpMan13 (button) collected (€8.50)
Seat 5: KrishnaRadha (small blind) folded before Flop
Seat 6: matiko09 (big blind) folded before Flop





PokerStars Hand #155014454722:  Hold'em No Limit ($0.50/$1.00 USD) - 2016/06/21 14:09:52 CET [2016/06/21 8:09:52 ET]
Table 'Schurer II' 9-max Seat #8 is the button
Seat 1: Dantist1122 ($100 in chips) 
Seat 2: havenots88 ($91.10 in chips) 
Seat 3: matiko09 ($103.65 in chips) 
Seat 4: hurtNCYDE ($107.50 in chips) 
Seat 5: riggedsh** ($118.30 in chips) 
Seat 7: Avtovo ($109.48 in chips) 
Seat 8: stepan0605 ($100 in chips) 
Seat 9: pardama ($100 in chips) 
pardama: posts small blind $0.50
Dantist1122: posts big blind $1
Dödi123: sits out 
*** HOLE CARDS ***
Dealt to matiko09 [3c Tc]
havenots88: folds 
matiko09: folds 
hurtNCYDE: folds 
riggedsh**: folds 
Avtovo: folds 
stepan0605: raises $2 to $3
pardama: folds 
Dantist1122: folds 
Uncalled bet ($2) returned to stepan0605
stepan0605 collected $2.50 from pot
stepan0605: doesn't show hand 
*** SUMMARY ***
Total pot $2.50 | Rake $0 
Seat 1: Dantist1122 (big blind) folded before Flop
Seat 2: havenots88 folded before Flop (didn't bet)
Seat 3: matiko09 folded before Flop (didn't bet)
Seat 4: hurtNCYDE folded before Flop (didn't bet)
Seat 5: riggedsh** folded before Flop (didn't bet)
Seat 7: Avtovo folded before Flop (didn't bet)
Seat 8: stepan0605 (button) collected ($2.50)
Seat 9: pardama (small blind) folded before Flop





PokerStars Hand #155014455666:  Hold'em No Limit ($0.50/$1.00 USD) - 2016/06/21 14:09:55 CET [2016/06/21 8:09:55 ET]
Table 'Amundsenia' 9-max Seat #9 is the button
Seat 1: Troll8989 ($109.48 in chips) 
Seat 2: Avtovo ($106.78 in chips) 
Seat 3: matiko09 ($100 in chips) 
Seat 4: typename27 ($18.67 in chips) 
Seat 5: ozone2003 ($100 in chips) 
Seat 6: King_ZéManel ($131.81 in chips) 
Seat 7: Eskimo Fox ($106.15 in chips) 
Seat 8: DomiVY ($49.32 in chips) 
Seat 9: MrSeymen ($42.86 in chips) 
Troll8989: posts small blind $0.50
Avtovo: posts big blind $1
*** HOLE CARDS ***
Dealt to matiko09 [Kd Js]
matiko09: folds 
typename27: folds 
ozone2003: folds 
King_ZéManel: folds 
Eskimo Fox: folds 
DomiVY: folds 
MrSeymen: raises $2 to $3
Troll8989: folds 
Avtovo: raises $7.50 to $10.50
MrSeymen: calls $7.50
*** FLOP *** [Jh Qs 8h]
Avtovo: checks 
MrSeymen: checks 
*** TURN *** [Jh Qs 8h] [Qd]
Avtovo: checks 
MrSeymen: bets $10
Avtovo: folds 
Uncalled bet ($10) returned to MrSeymen
MrSeymen collected $20.42 from pot
*** SUMMARY ***
Total pot $21.50 | Rake $1.08 
Board [Jh Qs 8h Qd]
Seat 1: Troll8989 (small blind) folded before Flop
Seat 2: Avtovo (big blind) folded on the Turn
Seat 3: matiko09 folded before Flop (didn't bet)
Seat 4: typename27 folded before Flop (didn't bet)
Seat 5: ozone2003 folded before Flop (didn't bet)
Seat 6: King_ZéManel folded before Flop (didn't bet)
Seat 7: Eskimo Fox folded before Flop (didn't bet)
Seat 8: DomiVY folded before Flop (didn't bet)
Seat 9: MrSeymen (button) collected ($20.42)





PokerStars Hand #155014456313:  Hold'em No Limit ($0.50/$1.00 USD) - 2016/06/21 14:09:56 CET [2016/06/21 8:09:56 ET]
Table 'Lamberta II' 9-max Seat #6 is the button
Seat 3: matiko09 ($103.18 in chips) 
Seat 4: Eskimo Fox ($109.54 in chips) 
Seat 5: CoolFireX ($122.60 in chips) 
Seat 6: Chen423 ($101 in chips) 
Seat 7: 23SmOkEr07 ($196.04 in chips) 
Seat 9: Sjtu_Michael ($116.52 in chips) 
23SmOkEr07: posts small blind $0.50
Chen423 is disconnected 
Sjtu_Michael: posts big blind $1
Avtovo: sits out 
pardama: sits out 
*** HOLE CARDS ***
Dealt to matiko09 [4h Jh]
hurtNCYDE joins the table at seat #8 
hurtNCYDE leaves the table
stepan0605 joins the table at seat #8 
matiko09: folds 
Eskimo Fox: folds 
CoolFireX: raises $1.50 to $2.50
Chen423 has timed out while disconnected
Chen423: folds 
23SmOkEr07: folds 
Sjtu_Michael is disconnected 
Sjtu_Michael has timed out while disconnected
Sjtu_Michael: folds 
Uncalled bet ($1.50) returned to CoolFireX
CoolFireX collected $2.50 from pot
CoolFireX: doesn't show hand 
*** SUMMARY ***
Total pot $2.50 | Rake $0 
Seat 3: matiko09 folded before Flop (didn't bet)
Seat 4: Eskimo Fox folded before Flop (didn't bet)
Seat 5: CoolFireX collected ($2.50)
Seat 6: Chen423 (button) folded before Flop (didn't bet)
Seat 7: 23SmOkEr07 (small blind) folded before Flop
Seat 9: Sjtu_Michael (big blind) folded before Flop





PokerStars Hand #155014460153:  Hold'em No Limit ($0.50/$1.00 USD) - 2016/06/21 14:10:04 CET [2016/06/21 8:10:04 ET]
Table 'Gryphia' 9-max Seat #9 is the button
Seat 1: Klappspaten0 ($109.04 in chips) 
Seat 2: stepan0605 ($177.20 in chips) 
Seat 3: KovIFish89 ($104.40 in chips) 
Seat 4: King Sixtus ($56.19 in chips) 
Seat 5: pardama ($100 in chips) 
Seat 6: Dandy Monk ($54.52 in chips) 
Seat 7: solbi86 ($100 in chips) 
Seat 8: matiko09 ($105.11 in chips) 
Seat 9: djammusic ($46.80 in chips) 
Klappspaten0: posts small blind $0.50
stepan0605: posts big blind $1
*** HOLE CARDS ***
Dealt to matiko09 [9d Ad]
KovIFish89: folds 
King Sixtus: raises $1.50 to $2.50
pardama: folds 
Dandy Monk: calls $2.50
solbi86: raises $7.50 to $10
matiko09: folds 
djammusic: folds 
Klappspaten0: folds 
stepan0605: folds 
King Sixtus: folds 
Dandy Monk: folds 
Uncalled bet ($7.50) returned to solbi86
solbi86 collected $9 from pot
solbi86: doesn't show hand 
*** SUMMARY ***
Total pot $9 | Rake $0 
Seat 1: Klappspaten0 (small blind) folded before Flop
Seat 2: stepan0605 (big blind) folded before Flop
Seat 3: KovIFish89 folded before Flop (didn't bet)
Seat 4: King Sixtus folded before Flop
Seat 5: pardama folded before Flop (didn't bet)
Seat 6: Dandy Monk folded before Flop
Seat 7: solbi86 collected ($9)
Seat 8: matiko09 folded before Flop (didn't bet)
Seat 9: djammusic (button) folded before Flop (didn't bet)





PokerStars Hand #155014463552:  Hold'em No Limit ($0.50/$1.00 USD) - 2016/06/21 14:10:12 CET [2016/06/21 8:10:12 ET]
Table 'Schurer II' 9-max Seat #9 is the button
Seat 1: Dantist1122 ($100 in chips) 
Seat 2: havenots88 ($91.10 in chips) 
Seat 3: matiko09 ($103.65 in chips) 
Seat 4: hurtNCYDE ($107.50 in chips) 
Seat 5: riggedsh** ($118.30 in chips) 
Seat 7: Avtovo ($109.48 in chips) 
Seat 8: stepan0605 ($101.50 in chips) 
Seat 9: pardama ($100 in chips) 
Dantist1122: posts small blind $0.50
havenots88: posts big blind $1
Dödi123: sits out 
*** HOLE CARDS ***
Dealt to matiko09 [7c 3h]
matiko09: folds 
hurtNCYDE: folds 
riggedsh**: folds 
Avtovo: folds 
stepan0605: folds 
pardama: folds 
Dantist1122: folds 
Uncalled bet ($0.50) returned to havenots88
havenots88 collected $1 from pot
havenots88: doesn't show hand 
*** SUMMARY ***
Total pot $1 | Rake $0 
Seat 1: Dantist1122 (small blind) folded before Flop
Seat 2: havenots88 (big blind) collected ($1)
Seat 3: matiko09 folded before Flop (didn't bet)
Seat 4: hurtNCYDE folded before Flop (didn't bet)
Seat 5: riggedsh** folded before Flop (didn't bet)
Seat 7: Avtovo folded before Flop (didn't bet)
Seat 8: stepan0605 folded before Flop (didn't bet)
Seat 9: pardama (button) folded before Flop (didn't bet)





PokerStars Hand #155014472336:  Hold'em No Limit (€0.25/€0.50 EUR) - 2016/06/21 14:10:31 CET [2016/06/21 8:10:31 ET]
Table 'Lotis II' 6-max Seat #5 is the button
Seat 1: bustafc (€50 in chips) 
Seat 2: NoHeroHUD (€54.73 in chips) 
Seat 3: hmverlin (€21.52 in chips) 
Seat 4: IpMan13 (€87.84 in chips) 
Seat 5: KrishnaRadha (€50 in chips) 
Seat 6: matiko09 (€50 in chips) 
matiko09: posts small blind €0.25
bustafc: posts big blind €0.50
*** HOLE CARDS ***
Dealt to matiko09 [8c Kh]
NoHeroHUD: raises €1 to €1.50
hmverlin: calls €1.50
IpMan13: folds 
KrishnaRadha: folds 
matiko09: folds 
bustafc: folds 
*** FLOP *** [4c 7s 9s]
NoHeroHUD: bets €3
hmverlin: raises €3 to €6
NoHeroHUD: raises €15.56 to €21.56
hmverlin: folds 
Uncalled bet (€15.56) returned to NoHeroHUD
NoHeroHUD collected €14.96 from pot
NoHeroHUD: doesn't show hand 
*** SUMMARY ***
Total pot €15.75 | Rake €0.79 
Board [4c 7s 9s]
Seat 1: bustafc (big blind) folded before Flop
Seat 2: NoHeroHUD collected (€14.96)
Seat 3: hmverlin folded on the Flop
Seat 4: IpMan13 folded before Flop (didn't bet)
Seat 5: KrishnaRadha (button) folded before Flop (didn't bet)
Seat 6: matiko09 (small blind) folded before Flop





PokerStars Hand #155014482233:  Hold'em No Limit ($0.50/$1.00 USD) - 2016/06/21 14:10:53 CET [2016/06/21 8:10:53 ET]
Table 'Gryphia' 9-max Seat #1 is the button
Seat 1: Klappspaten0 ($108.54 in chips) 
Seat 2: stepan0605 ($176.20 in chips) 
Seat 3: KovIFish89 ($104.40 in chips) 
Seat 4: King Sixtus ($53.69 in chips) 
Seat 5: pardama ($100 in chips) 
Seat 6: Dandy Monk ($52.02 in chips) 
Seat 7: solbi86 ($106.50 in chips) 
Seat 8: matiko09 ($105.11 in chips) 
Seat 9: djammusic ($46.80 in chips) 
stepan0605: posts small blind $0.50
KovIFish89: posts big blind $1
*** HOLE CARDS ***
Dealt to matiko09 [5s 2s]
King Sixtus: folds 
pardama: folds 
Dandy Monk: folds 
solbi86: raises $2 to $3
matiko09: folds 
djammusic: folds 
Klappspaten0: calls $3
stepan0605: folds 
KovIFish89: folds 
*** FLOP *** [9d 2h Ks]
solbi86: checks 
Klappspaten0: bets $4
solbi86: folds 
Uncalled bet ($4) returned to Klappspaten0
Klappspaten0 collected $7.12 from pot
Klappspaten0: doesn't show hand 
*** SUMMARY ***
Total pot $7.50 | Rake $0.38 
Board [9d 2h Ks]
Seat 1: Klappspaten0 (button) collected ($7.12)
Seat 2: stepan0605 (small blind) folded before Flop
Seat 3: KovIFish89 (big blind) folded before Flop
Seat 4: King Sixtus folded before Flop (didn't bet)
Seat 5: pardama folded before Flop (didn't bet)
Seat 6: Dandy Monk folded before Flop (didn't bet)
Seat 7: solbi86 folded on the Flop
Seat 8: matiko09 folded before Flop (didn't bet)
Seat 9: djammusic folded before Flop (didn't bet)





PokerStars Hand #155014482802:  Hold'em No Limit ($0.50/$1.00 USD) - 2016/06/21 14:10:54 CET [2016/06/21 8:10:54 ET]
Table 'Saldanha' 9-max Seat #4 is the button
Seat 1: KovIFish89 ($100 in chips) 
Seat 2: Avtovo ($102.90 in chips) 
Seat 3: matiko09 ($399.89 in chips) 
Seat 4: CoolFireX ($100 in chips) 
Seat 5: Troll8989 ($108.26 in chips) 
Seat 6: Juu2huu ($70.84 in chips) 
Seat 7: ozone2003 ($111.78 in chips) 
Seat 8: erick222 ($203.50 in chips) 
Seat 9: 23SmOkEr07 ($138.11 in chips) 
Troll8989: posts small blind $0.50
Juu2huu: posts big blind $1
KovIFish89: posts the ante $0.20
Avtovo: posts the ante $0.20
matiko09: posts the ante $0.20
CoolFireX: posts the ante $0.20
Troll8989: posts the ante $0.20
Juu2huu: posts the ante $0.20
ozone2003: posts the ante $0.20
erick222: posts the ante $0.20
23SmOkEr07: posts the ante $0.20
*** HOLE CARDS ***
Dealt to matiko09 [3h 8s]
ozone2003: folds 
erick222: folds 
23SmOkEr07: raises $1.50 to $2.50
KovIFish89: folds 
Avtovo: folds 
matiko09: folds 
CoolFireX: folds 
Troll8989: calls $2
Juu2huu: calls $1.50
*** FLOP *** [5c 2d 9d]
Troll8989: checks 
Juu2huu: bets $2
23SmOkEr07: calls $2
Troll8989: raises $4 to $6
Juu2huu: calls $4
23SmOkEr07: folds 
*** TURN *** [5c 2d 9d] [Ah]
Troll8989: bets $12
Juu2huu: folds 
Uncalled bet ($12) returned to Troll8989
Troll8989 collected $22.14 from pot
Troll8989: doesn't show hand 
*** SUMMARY ***
Total pot $23.30 | Rake $1.16 
Board [5c 2d 9d Ah]
Seat 1: KovIFish89 folded before Flop (didn't bet)
Seat 2: Avtovo folded before Flop (didn't bet)
Seat 3: matiko09 folded before Flop (didn't bet)
Seat 4: CoolFireX (button) folded before Flop (didn't bet)
Seat 5: Troll8989 (small blind) collected ($22.14)
Seat 6: Juu2huu (big blind) folded on the Turn
Seat 7: ozone2003 folded before Flop (didn't bet)
Seat 8: erick222 folded before Flop (didn't bet)
Seat 9: 23SmOkEr07 folded on the Flop





PokerStars Hand #155014484995:  Hold'em No Limit ($0.50/$1.00 USD) - 2016/06/21 14:10:59 CET [2016/06/21 8:10:59 ET]
Table 'Amundsenia' 9-max Seat #1 is the button
Seat 1: Troll8989 ($108.98 in chips) 
Seat 2: Avtovo ($100 in chips) 
Seat 3: matiko09 ($100 in chips) 
Seat 4: typename27 ($18.67 in chips) 
Seat 5: ozone2003 ($100 in chips) 
Seat 6: King_ZéManel ($131.81 in chips) 
Seat 7: Eskimo Fox ($106.15 in chips) 
Seat 8: DomiVY ($49.32 in chips) 
Seat 9: MrSeymen ($52.78 in chips) 
Avtovo: posts small blind $0.50
matiko09: posts big blind $1
*** HOLE CARDS ***
Dealt to matiko09 [6c Kh]
typename27: folds 
ozone2003: folds 
King_ZéManel: folds 
Eskimo Fox: raises $1.50 to $2.50
DomiVY: folds 
MrSeymen: folds 
Troll8989: folds 
Avtovo: folds 
matiko09: folds 
Uncalled bet ($1.50) returned to Eskimo Fox
Eskimo Fox collected $2.50 from pot
Eskimo Fox: doesn't show hand 
*** SUMMARY ***
Total pot $2.50 | Rake $0 
Seat 1: Troll8989 (button) folded before Flop (didn't bet)
Seat 2: Avtovo (small blind) folded before Flop
Seat 3: matiko09 (big blind) folded before Flop
Seat 4: typename27 folded before Flop (didn't bet)
Seat 5: ozone2003 folded before Flop (didn't bet)
Seat 6: King_ZéManel folded before Flop (didn't bet)
Seat 7: Eskimo Fox collected ($2.50)
Seat 8: DomiVY folded before Flop (didn't bet)
Seat 9: MrSeymen folded before Flop (didn't bet)





PokerStars Hand #155014486553:  Hold'em No Limit ($0.50/$1.00 USD) - 2016/06/21 14:11:02 CET [2016/06/21 8:11:02 ET]
Table 'Schurer II' 9-max Seat #1 is the button
Seat 1: Dantist1122 ($100 in chips) 
Seat 2: havenots88 ($91.60 in chips) 
Seat 3: matiko09 ($103.65 in chips) 
Seat 4: hurtNCYDE ($107.50 in chips) 
Seat 5: riggedsh** ($118.30 in chips) 
Seat 7: Avtovo ($109.48 in chips) 
Seat 8: stepan0605 ($101.50 in chips) 
Seat 9: pardama ($100 in chips) 
havenots88: posts small blind $0.50
matiko09: posts big blind $1
Dödi123: sits out 
*** HOLE CARDS ***
Dealt to matiko09 [3d 8h]
hurtNCYDE: folds 
riggedsh**: raises $2 to $3
Avtovo: folds 
stepan0605: folds 
pardama: folds 
Dantist1122: folds 
havenots88: folds 
matiko09: folds 
Uncalled bet ($2) returned to riggedsh**
riggedsh** collected $2.50 from pot
riggedsh**: doesn't show hand 
*** SUMMARY ***
Total pot $2.50 | Rake $0 
Seat 1: Dantist1122 (button) folded before Flop (didn't bet)
Seat 2: havenots88 (small blind) folded before Flop
Seat 3: matiko09 (big blind) folded before Flop
Seat 4: hurtNCYDE folded before Flop (didn't bet)
Seat 5: riggedsh** collected ($2.50)
Seat 7: Avtovo folded before Flop (didn't bet)
Seat 8: stepan0605 folded before Flop (didn't bet)
Seat 9: pardama folded before Flop (didn't bet)





PokerStars Hand #155014495327:  Hold'em No Limit ($0.50/$1.00 USD) - 2016/06/21 14:11:22 CET [2016/06/21 8:11:22 ET]
Table 'Moreau' 9-max Seat #2 is the button
Seat 1: hurtNCYDE ($100 in chips) 
Seat 2: Avtovo ($104.50 in chips) 
Seat 3: matiko09 ($100 in chips) 
Seat 4: SharingaaN ($164.80 in chips) 
Seat 5: CoolFireX ($146.55 in chips) 
Seat 7: PanKwn15 ($54.32 in chips) 
Seat 8: mi$$I$Elena ($111.12 in chips) 
Seat 9: Toonersens ($112.56 in chips) 
matiko09: posts small blind $0.50
SharingaaN: posts big blind $1
Troll8989: sits out 
*** HOLE CARDS ***
Dealt to matiko09 [Ts Js]
CoolFireX: folds 
PanKwn15: folds 
mi$$I$Elena: folds 
Toonersens: folds 
hurtNCYDE: folds 
Avtovo: folds 
matiko09: raises $2 to $3
SharingaaN: raises $7 to $10
matiko09: folds 
Uncalled bet ($7) returned to SharingaaN
SharingaaN collected $6 from pot
SharingaaN: doesn't show hand 
*** SUMMARY ***
Total pot $6 | Rake $0 
Seat 1: hurtNCYDE folded before Flop (didn't bet)
Seat 2: Avtovo (button) folded before Flop (didn't bet)
Seat 3: matiko09 (small blind) folded before Flop
Seat 4: SharingaaN (big blind) collected ($6)
Seat 5: CoolFireX folded before Flop (didn't bet)
Seat 7: PanKwn15 folded before Flop (didn't bet)
Seat 8: mi$$I$Elena folded before Flop (didn't bet)
Seat 9: Toonersens folded before Flop (didn't bet)





PokerStars Hand #155014495285:  Hold'em No Limit (€0.25/€0.50 EUR) - 2016/06/21 14:11:22 CET [2016/06/21 8:11:22 ET]
Table 'Lotis II' 6-max Seat #6 is the button
Seat 1: bustafc (€50 in chips) 
Seat 3: hmverlin (€14.02 in chips) 
Seat 4: IpMan13 (€87.84 in chips) 
Seat 5: KrishnaRadha (€50 in chips) 
Seat 6: matiko09 (€50 in chips) 
bustafc: posts small blind €0.25
NoHeroHUD: is sitting out 
hmverlin: posts big blind €0.50
*** HOLE CARDS ***
Dealt to matiko09 [4h Qd]
NoHeroHUD leaves the table
IpMan13: folds 
tyoma_knp joins the table at seat #2 
KrishnaRadha: folds 
matiko09: folds 
bustafc: folds 
Uncalled bet (€0.25) returned to hmverlin
hmverlin collected €0.50 from pot
hmverlin: doesn't show hand 
*** SUMMARY ***
Total pot €0.50 | Rake €0 
Seat 1: bustafc (small blind) folded before Flop
Seat 3: hmverlin (big blind) collected (€0.50)
Seat 4: IpMan13 folded before Flop (didn't bet)
Seat 5: KrishnaRadha folded before Flop (didn't bet)
Seat 6: matiko09 (button) folded before Flop (didn't bet)





PokerStars Hand #155014497054:  Hold'em No Limit ($0.50/$1.00 USD) - 2016/06/21 14:11:25 CET [2016/06/21 8:11:25 ET]
Table 'Schurer II' 9-max Seat #2 is the button
Seat 1: Dantist1122 ($100 in chips) 
Seat 2: havenots88 ($91.10 in chips) 
Seat 3: matiko09 ($102.65 in chips) 
Seat 4: hurtNCYDE ($107.50 in chips) 
Seat 5: riggedsh** ($119.80 in chips) 
Seat 7: Avtovo ($109.48 in chips) 
Seat 8: stepan0605 ($101.50 in chips) 
Seat 9: pardama ($100 in chips) 
matiko09: posts small blind $0.50
hurtNCYDE: posts big blind $1
Dödi123: sits out 
*** HOLE CARDS ***
Dealt to matiko09 [4d 7h]
riggedsh**: folds 
Avtovo: folds 
stepan0605: folds 
pardama: folds 
Dantist1122: raises $1.70 to $2.70
havenots88: folds 
matiko09: folds 
hurtNCYDE: calls $1.70
*** FLOP *** [Jd Ac Kc]
hurtNCYDE: checks 
Dantist1122: checks 
*** TURN *** [Jd Ac Kc] [3h]
hurtNCYDE: bets $4.50
Dantist1122: folds 
Uncalled bet ($4.50) returned to hurtNCYDE
hurtNCYDE collected $5.60 from pot
*** SUMMARY ***
Total pot $5.90 | Rake $0.30 
Board [Jd Ac Kc 3h]
Seat 1: Dantist1122 folded on the Turn
Seat 2: havenots88 (button) folded before Flop (didn't bet)
Seat 3: matiko09 (small blind) folded before Flop
Seat 4: hurtNCYDE (big blind) collected ($5.60)
Seat 5: riggedsh** folded before Flop (didn't bet)
Seat 7: Avtovo folded before Flop (didn't bet)
Seat 8: stepan0605 folded before Flop (didn't bet)
Seat 9: pardama folded before Flop (didn't bet)





PokerStars Hand #155014501683:  Hold'em No Limit (€0.25/€0.50 EUR) - 2016/06/21 14:11:35 CET [2016/06/21 8:11:35 ET]
Table 'Lotis II' 6-max Seat #1 is the button
Seat 1: bustafc (€50 in chips) 
Seat 3: hmverlin (€14.27 in chips) 
Seat 4: IpMan13 (€87.84 in chips) 
Seat 5: KrishnaRadha (€50 in chips) 
Seat 6: matiko09 (€50 in chips) 
tyoma_knp will be allowed to play after the button
hmverlin: posts small blind €0.25
IpMan13: posts big blind €0.50
*** HOLE CARDS ***
Dealt to matiko09 [8d 4c]
KrishnaRadha: folds 
tyoma_knp leaves the table
matiko09: folds 
bustafc: raises €0.50 to €1
hmverlin: calls €0.75
IpMan13: calls €0.50
*** FLOP *** [Td 5s 3h]
hmverlin: bets €1.50
IpMan13: folds 
bustafc: folds 
Uncalled bet (€1.50) returned to hmverlin
hmverlin collected €2.85 from pot
hmverlin: doesn't show hand 
*** SUMMARY ***
Total pot €3 | Rake €0.15 
Board [Td 5s 3h]
Seat 1: bustafc (button) folded on the Flop
Seat 3: hmverlin (small blind) collected (€2.85)
Seat 4: IpMan13 (big blind) folded on the Flop
Seat 5: KrishnaRadha folded before Flop (didn't bet)
Seat 6: matiko09 folded before Flop (didn't bet)





PokerStars Hand #155014501643:  Hold'em No Limit ($0.50/$1.00 USD) - 2016/06/21 14:11:35 CET [2016/06/21 8:11:35 ET]
Table 'Chromios' 9-max Seat #8 is the button
Seat 1: matiko09 ($100 in chips) 
Seat 2: pardama ($100 in chips) 
Seat 3: ozone2003 ($101.50 in chips) 
Seat 4: Eskimo Fox ($103.96 in chips) 
Seat 5: Donetsk1y ($105.16 in chips) 
Seat 7: chaps1988 ($181.85 in chips) 
Seat 8: carlosdankha ($86.31 in chips) 
Seat 9: Filojoes ($224.12 in chips) 
Filojoes: posts small blind $0.50
matiko09: posts big blind $1
*** HOLE CARDS ***
Dealt to matiko09 [Jd 5h]
pardama: folds 
ozone2003: folds 
Eskimo Fox: raises $2 to $3
Donetsk1y: raises $6 to $9
chaps1988: folds 
carlosdankha: folds 
Filojoes: folds 
matiko09: folds 
Eskimo Fox: folds 
Uncalled bet ($6) returned to Donetsk1y
Donetsk1y collected $7.50 from pot
Donetsk1y: doesn't show hand 
*** SUMMARY ***
Total pot $7.50 | Rake $0 
Seat 1: matiko09 (big blind) folded before Flop
Seat 2: pardama folded before Flop (didn't bet)
Seat 3: ozone2003 folded before Flop (didn't bet)
Seat 4: Eskimo Fox folded before Flop
Seat 5: Donetsk1y collected ($7.50)
Seat 7: chaps1988 folded before Flop (didn't bet)
Seat 8: carlosdankha (button) folded before Flop (didn't bet)
Seat 9: Filojoes (small blind) folded before Flop





PokerStars Hand #155014503975:  Hold'em No Limit ($0.50/$1.00 USD) - 2016/06/21 14:11:40 CET [2016/06/21 8:11:40 ET]
Table 'Gryphia' 9-max Seat #2 is the button
Seat 1: Klappspaten0 ($112.66 in chips) 
Seat 2: stepan0605 ($175.70 in chips) 
Seat 3: KovIFish89 ($103.40 in chips) 
Seat 4: King Sixtus ($53.69 in chips) 
Seat 5: pardama ($100 in chips) 
Seat 6: Dandy Monk ($52.02 in chips) 
Seat 7: solbi86 ($103.50 in chips) 
Seat 8: matiko09 ($105.11 in chips) 
Seat 9: djammusic ($46.80 in chips) 
KovIFish89: posts small blind $0.50
King Sixtus: posts big blind $1
*** HOLE CARDS ***
Dealt to matiko09 [Td 3h]
pardama: folds 
Dandy Monk: raises $1 to $2
solbi86: folds 
matiko09: folds 
djammusic: folds 
Klappspaten0: folds 
stepan0605: folds 
KovIFish89: folds 
King Sixtus: calls $1
*** FLOP *** [Ks Qh Kd]
King Sixtus: checks 
Dandy Monk: bets $1
King Sixtus: raises $4.18 to $5.18
Dandy Monk: raises $44.84 to $50.02 and is all-in
King Sixtus: calls $44.84
*** TURN *** [Ks Qh Kd] [Ts]
*** RIVER *** [Ks Qh Kd Ts] [4d]
*** SHOW DOWN ***
King Sixtus: shows [Kh 7d] (three of a kind, Kings)
Dandy Monk: shows [Kc 5c] (three of a kind, Kings)
King Sixtus collected $51.02 from pot
Dandy Monk collected $51.02 from pot
*** SUMMARY ***
Total pot $104.54 | Rake $2.50 
Board [Ks Qh Kd Ts 4d]
Seat 1: Klappspaten0 folded before Flop (didn't bet)
Seat 2: stepan0605 (button) folded before Flop (didn't bet)
Seat 3: KovIFish89 (small blind) folded before Flop
Seat 4: King Sixtus (big blind) showed [Kh 7d] and won ($51.02) with three of a kind, Kings
Seat 5: pardama folded before Flop (didn't bet)
Seat 6: Dandy Monk showed [Kc 5c] and won ($51.02) with three of a kind, Kings
Seat 7: solbi86 folded before Flop (didn't bet)
Seat 8: matiko09 folded before Flop (didn't bet)
Seat 9: djammusic folded before Flop (didn't bet)





PokerStars Hand #155014503792:  Hold'em No Limit ($0.50/$1.00 USD) - 2016/06/21 14:11:40 CET [2016/06/21 8:11:40 ET]
Table 'Amundsenia' 9-max Seat #2 is the button
Seat 1: Troll8989 ($108.98 in chips) 
Seat 2: Avtovo ($100 in chips) 
Seat 3: matiko09 ($100 in chips) 
Seat 4: typename27 ($18.67 in chips) 
Seat 5: ozone2003 ($100 in chips) 
Seat 6: King_ZéManel ($131.81 in chips) 
Seat 7: Eskimo Fox ($107.65 in chips) 
Seat 8: DomiVY ($49.32 in chips) 
Seat 9: MrSeymen ($52.78 in chips) 
matiko09: posts small blind $0.50
typename27: posts big blind $1
*** HOLE CARDS ***
Dealt to matiko09 [9d Jh]
ozone2003: folds 
King_ZéManel: folds 
Eskimo Fox: folds 
DomiVY: raises $2 to $3
MrSeymen: calls $3
Troll8989: folds 
Avtovo: folds 
matiko09: folds 
typename27: folds 
*** FLOP *** [6s Ts Kd]
DomiVY: checks 
MrSeymen: bets $4
DomiVY: folds 
Uncalled bet ($4) returned to MrSeymen
MrSeymen collected $7.12 from pot
*** SUMMARY ***
Total pot $7.50 | Rake $0.38 
Board [6s Ts Kd]
Seat 1: Troll8989 folded before Flop (didn't bet)
Seat 2: Avtovo (button) folded before Flop (didn't bet)
Seat 3: matiko09 (small blind) folded before Flop
Seat 4: typename27 (big blind) folded before Flop
Seat 5: ozone2003 folded before Flop (didn't bet)
Seat 6: King_ZéManel folded before Flop (didn't bet)
Seat 7: Eskimo Fox folded before Flop (didn't bet)
Seat 8: DomiVY folded on the Flop
Seat 9: MrSeymen collected ($7.12)





PokerStars Hand #155014513211:  Hold'em No Limit ($0.50/$1.00 USD) - 2016/06/21 14:12:01 CET [2016/06/21 8:12:01 ET]
Table 'Schurer II' 9-max Seat #3 is the button
Seat 1: Dantist1122 ($100 in chips) 
Seat 2: havenots88 ($91.10 in chips) 
Seat 3: matiko09 ($102.15 in chips) 
Seat 4: hurtNCYDE ($110.40 in chips) 
Seat 5: riggedsh** ($119.80 in chips) 
Seat 7: Avtovo ($109.48 in chips) 
Seat 8: stepan0605 ($101.50 in chips) 
Seat 9: pardama ($100 in chips) 
hurtNCYDE: posts small blind $0.50
riggedsh**: posts big blind $1
Dödi123: sits out 
*** HOLE CARDS ***
Dealt to matiko09 [4h Ad]
Avtovo: folds 
stepan0605: folds 
pardama: folds 
Dantist1122: folds 
havenots88: raises $2 to $3
matiko09: folds 
hurtNCYDE: folds 
riggedsh**: folds 
Uncalled bet ($2) returned to havenots88
havenots88 collected $2.50 from pot
havenots88: doesn't show hand 
*** SUMMARY ***
Total pot $2.50 | Rake $0 
Seat 1: Dantist1122 folded before Flop (didn't bet)
Seat 2: havenots88 collected ($2.50)
Seat 3: matiko09 (button) folded before Flop (didn't bet)
Seat 4: hurtNCYDE (small blind) folded before Flop
Seat 5: riggedsh** (big blind) folded before Flop
Seat 7: Avtovo folded before Flop (didn't bet)
Seat 8: stepan0605 folded before Flop (didn't bet)
Seat 9: pardama folded before Flop (didn't bet)





PokerStars Hand #155014515703:  Hold'em No Limit (€0.25/€0.50 EUR) - 2016/06/21 14:12:06 CET [2016/06/21 8:12:06 ET]
Table 'Lotis II' 6-max Seat #3 is the button
Seat 1: bustafc (€50 in chips) 
Seat 3: hmverlin (€16.12 in chips) 
Seat 4: IpMan13 (€86.84 in chips) 
Seat 6: matiko09 (€50 in chips) 
IpMan13: posts small blind €0.25
KrishnaRadha: is sitting out 
matiko09: posts big blind €0.50
*** HOLE CARDS ***
Dealt to matiko09 [Qh Ad]
bustafc: raises €0.75 to €1.25
hmverlin: calls €1.25
IpMan13: folds 
matiko09: raises €4.25 to €5.50
bustafc: folds 
hmverlin: calls €4.25
*** FLOP *** [4h 8h 4s]
matiko09: bets €4.50
hmverlin: raises €6.12 to €10.62 and is all-in
matiko09: calls €6.12
*** TURN *** [4h 8h 4s] [6s]
*** RIVER *** [4h 8h 4s 6s] [9c]
*** SHOW DOWN ***
matiko09: shows [Qh Ad] (a pair of Fours)
hmverlin: shows [5d 4d] (three of a kind, Fours)
hmverlin collected €33.04 from pot
*** SUMMARY ***
Total pot €33.74 | Rake €0.70 
Board [4h 8h 4s 6s 9c]
Seat 1: bustafc folded before Flop
Seat 3: hmverlin (button) showed [5d 4d] and won (€33.04) with three of a kind, Fours
Seat 4: IpMan13 (small blind) folded before Flop
Seat 6: matiko09 (big blind) showed [Qh Ad] and lost with a pair of Fours





PokerStars Hand #155014520269:  Hold'em No Limit ($0.50/$1.00 USD) - 2016/06/21 14:12:16 CET [2016/06/21 8:12:16 ET]
Table 'Moreau' 9-max Seat #3 is the button
Seat 1: hurtNCYDE ($100 in chips) 
Seat 2: Avtovo ($104.50 in chips) 
Seat 3: matiko09 ($100 in chips) 
Seat 4: SharingaaN ($167.80 in chips) 
Seat 5: CoolFireX ($146.55 in chips) 
Seat 7: PanKwn15 ($54.32 in chips) 
Seat 8: mi$$I$Elena ($111.12 in chips) 
Seat 9: Toonersens ($112.56 in chips) 
SharingaaN: posts small blind $0.50
CoolFireX: posts big blind $1
Troll8989: sits out 
*** HOLE CARDS ***
Dealt to matiko09 [Td Kc]
PanKwn15: folds 
mi$$I$Elena: folds 
Toonersens: folds 
hurtNCYDE: folds 
Avtovo: folds 
matiko09: raises $1.27 to $2.27
SharingaaN: folds 
CoolFireX: folds 
Uncalled bet ($1.27) returned to matiko09
matiko09 collected $2.50 from pot
matiko09: doesn't show hand 
*** SUMMARY ***
Total pot $2.50 | Rake $0 
Seat 1: hurtNCYDE folded before Flop (didn't bet)
Seat 2: Avtovo folded before Flop (didn't bet)
Seat 3: matiko09 (button) collected ($2.50)
Seat 4: SharingaaN (small blind) folded before Flop
Seat 5: CoolFireX (big blind) folded before Flop
Seat 7: PanKwn15 folded before Flop (didn't bet)
Seat 8: mi$$I$Elena folded before Flop (didn't bet)
Seat 9: Toonersens folded before Flop (didn't bet)





PokerStars Hand #155014523451:  Hold'em No Limit ($0.50/$1.00 USD) - 2016/06/21 14:12:23 CET [2016/06/21 8:12:23 ET]
Table 'Saldanha' 9-max Seat #5 is the button
Seat 1: KovIFish89 ($100 in chips) 
Seat 2: Avtovo ($102.70 in chips) 
Seat 3: matiko09 ($399.69 in chips) 
Seat 4: CoolFireX ($100 in chips) 
Seat 5: Troll8989 ($121.70 in chips) 
Seat 6: Juu2huu ($62.14 in chips) 
Seat 7: ozone2003 ($111.58 in chips) 
Seat 8: erick222 ($203.30 in chips) 
Seat 9: 23SmOkEr07 ($133.41 in chips) 
Juu2huu: posts small blind $0.50
ozone2003: posts big blind $1
KovIFish89: posts the ante $0.20
Avtovo: posts the ante $0.20
matiko09: posts the ante $0.20
CoolFireX: posts the ante $0.20
Troll8989: posts the ante $0.20
Juu2huu: posts the ante $0.20
ozone2003: posts the ante $0.20
erick222: posts the ante $0.20
23SmOkEr07: posts the ante $0.20
*** HOLE CARDS ***
Dealt to matiko09 [5s As]
erick222: folds 
23SmOkEr07: raises $1.50 to $2.50
KovIFish89: folds 
Avtovo: calls $2.50
matiko09: folds 
CoolFireX: folds 
Troll8989: folds 
Juu2huu: calls $2
ozone2003: calls $1.50
*** FLOP *** [3h 2s Tc]
Juu2huu: checks 
ozone2003: bets $10.50
23SmOkEr07: folds 
Avtovo: folds 
Juu2huu: calls $10.50
*** TURN *** [3h 2s Tc] [9c]
Juu2huu: checks 
ozone2003: bets $8.21
Juu2huu: calls $8.21
*** RIVER *** [3h 2s Tc 9c] [Qs]
Juu2huu: bets $15
ozone2003: calls $15
*** SHOW DOWN ***
Juu2huu: shows [Ac 4h] (high card Ace)
ozone2003: shows [Jc Th] (a pair of Tens)
ozone2003 collected $76.72 from pot
*** SUMMARY ***
Total pot $79.22 | Rake $2.50 
Board [3h 2s Tc 9c Qs]
Seat 1: KovIFish89 folded before Flop (didn't bet)
Seat 2: Avtovo folded on the Flop
Seat 3: matiko09 folded before Flop (didn't bet)
Seat 4: CoolFireX folded before Flop (didn't bet)
Seat 5: Troll8989 (button) folded before Flop (didn't bet)
Seat 6: Juu2huu (small blind) showed [Ac 4h] and lost with high card Ace
Seat 7: ozone2003 (big blind) showed [Jc Th] and won ($76.72) with a pair of Tens
Seat 8: erick222 folded before Flop (didn't bet)
Seat 9: 23SmOkEr07 folded on the Flop





PokerStars Hand #155014526788:  Hold'em No Limit ($0.50/$1.00 USD) - 2016/06/21 14:12:30 CET [2016/06/21 8:12:30 ET]
Table 'Chromios' 9-max Seat #9 is the button
Seat 1: matiko09 ($100 in chips) 
Seat 2: pardama ($100 in chips) 
Seat 3: ozone2003 ($101.50 in chips) 
Seat 4: Eskimo Fox ($100.96 in chips) 
Seat 5: Donetsk1y ($109.66 in chips) 
Seat 7: chaps1988 ($181.85 in chips) 
Seat 8: carlosdankha ($86.31 in chips) 
Seat 9: Filojoes ($223.62 in chips) 
matiko09: posts small blind $0.50
pardama: posts big blind $1
Troll8989: sits out 
*** HOLE CARDS ***
Dealt to matiko09 [Js Ts]
ozone2003: folds 
Eskimo Fox: folds 
Donetsk1y: folds 
chaps1988: folds 
carlosdankha: calls $1
Filojoes: folds 
matiko09: raises $3.50 to $4.50
pardama: folds 
carlosdankha: calls $3.50
*** FLOP *** [4h 7c Jd]
matiko09: bets $6
carlosdankha: calls $6
*** TURN *** [4h 7c Jd] [4c]
matiko09: checks 
carlosdankha: bets $12
matiko09: calls $12
*** RIVER *** [4h 7c Jd 4c] [9d]
matiko09: checks 
carlosdankha: checks 
*** SHOW DOWN ***
matiko09: shows [Js Ts] (two pair, Jacks and Fours)
carlosdankha: mucks hand 
matiko09 collected $43.70 from pot
*** SUMMARY ***
Total pot $46 | Rake $2.30 
Board [4h 7c Jd 4c 9d]
Seat 1: matiko09 (small blind) showed [Js Ts] and won ($43.70) with two pair, Jacks and Fours
Seat 2: pardama (big blind) folded before Flop
Seat 3: ozone2003 folded before Flop (didn't bet)
Seat 4: Eskimo Fox folded before Flop (didn't bet)
Seat 5: Donetsk1y folded before Flop (didn't bet)
Seat 7: chaps1988 folded before Flop (didn't bet)
Seat 8: carlosdankha mucked [Kh 2h]
Seat 9: Filojoes (button) folded before Flop (didn't bet)





PokerStars Hand #155014528612:  Hold'em No Limit ($0.50/$1.00 USD) - 2016/06/21 14:12:34 CET [2016/06/21 8:12:34 ET]
Table 'Lamberta II' 9-max Seat #7 is the button
Seat 3: matiko09 ($103.18 in chips) 
Seat 4: Eskimo Fox ($109.54 in chips) 
Seat 5: CoolFireX ($124.10 in chips) 
Seat 7: 23SmOkEr07 ($195.54 in chips) 
stepan0605 will be allowed to play after the button
Avtovo will be allowed to play after the button
pardama will be allowed to play after the button
matiko09: posts small blind $0.50
Eskimo Fox: posts big blind $1
*** HOLE CARDS ***
Dealt to matiko09 [2d 2s]
CoolFireX: folds 
23SmOkEr07: folds 
matiko09: raises $2 to $3
Eskimo Fox: folds 
Uncalled bet ($2) returned to matiko09
matiko09 collected $2 from pot
matiko09: doesn't show hand 
*** SUMMARY ***
Total pot $2 | Rake $0 
Seat 3: matiko09 (small blind) collected ($2)
Seat 4: Eskimo Fox (big blind) folded before Flop
Seat 5: CoolFireX folded before Flop (didn't bet)
Seat 7: 23SmOkEr07 (button) folded before Flop (didn't bet)





PokerStars Hand #155014528963:  Hold'em No Limit ($0.50/$1.00 USD) - 2016/06/21 14:12:35 CET [2016/06/21 8:12:35 ET]
Table 'Schurer II' 9-max Seat #4 is the button
Seat 1: Dantist1122 ($100 in chips) 
Seat 2: havenots88 ($92.60 in chips) 
Seat 3: matiko09 ($102.15 in chips) 
Seat 4: hurtNCYDE ($109.90 in chips) 
Seat 5: riggedsh** ($118.80 in chips) 
Seat 6: Dödi123 ($128.89 in chips) 
Seat 7: Avtovo ($109.48 in chips) 
Seat 8: stepan0605 ($101.50 in chips) 
Seat 9: pardama ($100 in chips) 
riggedsh**: posts small blind $0.50
Dödi123: posts big blind $1
*** HOLE CARDS ***
Dealt to matiko09 [3s 4h]
Avtovo: folds 
stepan0605: folds 
pardama: folds 
Dantist1122: raises $2 to $3
havenots88: calls $3
matiko09: folds 
hurtNCYDE: folds 
riggedsh**: folds 
Dödi123: folds 
*** FLOP *** [9s Ts 2s]
Dantist1122: bets $5.48
havenots88: folds 
Uncalled bet ($5.48) returned to Dantist1122
Dantist1122 collected $7.12 from pot
Dantist1122: doesn't show hand 
*** SUMMARY ***
Total pot $7.50 | Rake $0.38 
Board [9s Ts 2s]
Seat 1: Dantist1122 collected ($7.12)
Seat 2: havenots88 folded on the Flop
Seat 3: matiko09 folded before Flop (didn't bet)
Seat 4: hurtNCYDE (button) folded before Flop (didn't bet)
Seat 5: riggedsh** (small blind) folded before Flop
Seat 6: Dödi123 (big blind) folded before Flop
Seat 7: Avtovo folded before Flop (didn't bet)
Seat 8: stepan0605 folded before Flop (didn't bet)
Seat 9: pardama folded before Flop (didn't bet)





PokerStars Hand #155014531351:  Hold'em No Limit (€0.25/€0.50 EUR) - 2016/06/21 14:12:40 CET [2016/06/21 8:12:40 ET]
Table 'Lotis II' 6-max Seat #4 is the button
Seat 1: bustafc (€50 in chips) 
Seat 3: hmverlin (€33.04 in chips) 
Seat 4: IpMan13 (€86.59 in chips) 
Seat 6: matiko09 (€50 in chips) 
KrishnaRadha will be allowed to play after the button
matiko09: posts small blind €0.25
bustafc: posts big blind €0.50
*** HOLE CARDS ***
Dealt to matiko09 [Qh 2c]
hmverlin: raises €1.25 to €1.75
IpMan13: folds 
MoganB0y joins the table at seat #2 
matiko09: folds 
bustafc: folds 
Uncalled bet (€1.25) returned to hmverlin
hmverlin collected €1.25 from pot
hmverlin: doesn't show hand 
*** SUMMARY ***
Total pot €1.25 | Rake €0 
Seat 1: bustafc (big blind) folded before Flop
Seat 3: hmverlin collected (€1.25)
Seat 4: IpMan13 (button) folded before Flop (didn't bet)
Seat 6: matiko09 (small blind) folded before Flop





PokerStars Hand #155014532430:  Hold'em No Limit ($0.50/$1.00 USD) - 2016/06/21 14:12:43 CET [2016/06/21 8:12:43 ET]
Table 'Amundsenia' 9-max Seat #3 is the button
Seat 1: Troll8989 ($108.98 in chips) 
Seat 2: Avtovo ($100 in chips) 
Seat 3: matiko09 ($100 in chips) 
Seat 4: typename27 ($17.67 in chips) 
Seat 5: ozone2003 ($100 in chips) 
Seat 6: King_ZéManel ($131.81 in chips) 
Seat 7: Eskimo Fox ($107.65 in chips) 
Seat 8: DomiVY ($46.32 in chips) 
Seat 9: MrSeymen ($56.90 in chips) 
typename27: posts small blind $0.50
ozone2003: posts big blind $1
*** HOLE CARDS ***
Dealt to matiko09 [4s Kc]
King_ZéManel: raises $2 to $3
Eskimo Fox: folds 
DomiVY: folds 
MrSeymen: calls $3
Troll8989: folds 
Avtovo: folds 
matiko09: folds 
typename27: folds 
ozone2003: folds 
*** FLOP *** [Jc 2h Jh]
King_ZéManel: checks 
MrSeymen: bets $3
King_ZéManel: folds 
Uncalled bet ($3) returned to MrSeymen
MrSeymen collected $7.12 from pot
*** SUMMARY ***
Total pot $7.50 | Rake $0.38 
Board [Jc 2h Jh]
Seat 1: Troll8989 folded before Flop (didn't bet)
Seat 2: Avtovo folded before Flop (didn't bet)
Seat 3: matiko09 (button) folded before Flop (didn't bet)
Seat 4: typename27 (small blind) folded before Flop
Seat 5: ozone2003 (big blind) folded before Flop
Seat 6: King_ZéManel folded on the Flop
Seat 7: Eskimo Fox folded before Flop (didn't bet)
Seat 8: DomiVY folded before Flop (didn't bet)
Seat 9: MrSeymen collected ($7.12)





PokerStars Hand #155014537393:  Hold'em No Limit (€0.25/€0.50 EUR) - 2016/06/21 14:12:54 CET [2016/06/21 8:12:54 ET]
Table 'Lotis II' 6-max Seat #6 is the button
Seat 1: bustafc (€50 in chips) 
Seat 2: MoganB0y (€50 in chips) 
Seat 3: hmverlin (€33.79 in chips) 
Seat 4: IpMan13 (€86.59 in chips) 
Seat 6: matiko09 (€50 in chips) 
bustafc: posts small blind €0.25
MoganB0y: posts big blind €0.50
KrishnaRadha: sits out 
*** HOLE CARDS ***
Dealt to matiko09 [Qh Ks]
hmverlin: raises €1 to €1.50
IpMan13: folds 
matiko09: raises €3 to €4.50
bustafc: folds 
MoganB0y: folds 
hmverlin: calls €3
*** FLOP *** [Th 3s 9d]
hmverlin: checks 
matiko09: checks 
*** TURN *** [Th 3s 9d] [Jd]
hmverlin: bets €2
matiko09: raises €5.50 to €7.50
hmverlin: folds 
Uncalled bet (€5.50) returned to matiko09
matiko09 collected €13.06 from pot
matiko09: doesn't show hand 
*** SUMMARY ***
Total pot €13.75 | Rake €0.69 
Board [Th 3s 9d Jd]
Seat 1: bustafc (small blind) folded before Flop
Seat 2: MoganB0y (big blind) folded before Flop
Seat 3: hmverlin folded on the Turn
Seat 4: IpMan13 folded before Flop (didn't bet)
Seat 6: matiko09 (button) collected (€13.06)





PokerStars Hand #155014537599:  Hold'em No Limit ($0.50/$1.00 USD) - 2016/06/21 14:12:54 CET [2016/06/21 8:12:54 ET]
Table 'Moreau' 9-max Seat #4 is the button
Seat 1: hurtNCYDE ($100 in chips) 
Seat 2: Avtovo ($104.50 in chips) 
Seat 3: matiko09 ($101.50 in chips) 
Seat 4: SharingaaN ($167.30 in chips) 
Seat 5: CoolFireX ($145.55 in chips) 
Seat 6: Troll8989 ($103.60 in chips) 
Seat 7: PanKwn15 ($54.32 in chips) 
Seat 8: mi$$I$Elena ($111.12 in chips) 
Seat 9: Toonersens ($112.56 in chips) 
CoolFireX: posts small blind $0.50
Troll8989: posts big blind $1
*** HOLE CARDS ***
Dealt to matiko09 [8s 8d]
PanKwn15: raises $1 to $2
mi$$I$Elena: folds 
Toonersens: folds 
hurtNCYDE: folds 
Avtovo: calls $2
matiko09: calls $2
SharingaaN: calls $2
CoolFireX: calls $1.50
Troll8989: folds 
*** FLOP *** [9c 9h 2c]
CoolFireX: checks 
PanKwn15: checks 
Avtovo: checks 
matiko09: bets $5.43
SharingaaN: folds 
CoolFireX: raises $14.20 to $19.63
PanKwn15: folds 
Avtovo: folds 
matiko09: folds 
Uncalled bet ($14.20) returned to CoolFireX
CoolFireX collected $20.77 from pot
CoolFireX: doesn't show hand 
*** SUMMARY ***
Total pot $21.86 | Rake $1.09 
Board [9c 9h 2c]
Seat 1: hurtNCYDE folded before Flop (didn't bet)
Seat 2: Avtovo folded on the Flop
Seat 3: matiko09 folded on the Flop
Seat 4: SharingaaN (button) folded on the Flop
Seat 5: CoolFireX (small blind) collected ($20.77)
Seat 6: Troll8989 (big blind) folded before Flop
Seat 7: PanKwn15 folded on the Flop
Seat 8: mi$$I$Elena folded before Flop (didn't bet)
Seat 9: Toonersens folded before Flop (didn't bet)





PokerStars Hand #155014539905:  Hold'em No Limit ($0.50/$1.00 USD) - 2016/06/21 14:12:59 CET [2016/06/21 8:12:59 ET]
Table 'Gryphia' 9-max Seat #3 is the button
Seat 1: Klappspaten0 ($112.66 in chips) 
Seat 2: stepan0605 ($175.70 in chips) 
Seat 3: KovIFish89 ($102.90 in chips) 
Seat 4: King Sixtus ($52.69 in chips) 
Seat 5: pardama ($100 in chips) 
Seat 6: Dandy Monk ($51.02 in chips) 
Seat 7: solbi86 ($103.50 in chips) 
Seat 8: matiko09 ($105.11 in chips) 
Seat 9: djammusic ($46.80 in chips) 
King Sixtus: posts small blind $0.50
pardama: posts big blind $1
*** HOLE CARDS ***
Dealt to matiko09 [Jh 7s]
Dandy Monk: calls $1
solbi86: folds 
matiko09: folds 
djammusic: folds 
Klappspaten0: folds 
stepan0605: raises $3 to $4
KovIFish89: calls $4
King Sixtus: folds 
pardama: folds 
Dandy Monk: calls $3
*** FLOP *** [Ts Qd 7d]
Dandy Monk: checks 
stepan0605: checks 
KovIFish89: checks 
*** TURN *** [Ts Qd 7d] [Ks]
Dandy Monk: bets $7
stepan0605: calls $7
KovIFish89: folds 
*** RIVER *** [Ts Qd 7d Ks] [Ac]
Dandy Monk: checks 
stepan0605: checks 
*** SHOW DOWN ***
Dandy Monk: shows [8c Td] (a pair of Tens)
stepan0605: shows [Kh Ah] (two pair, Aces and Kings)
stepan0605 collected $26.12 from pot
*** SUMMARY ***
Total pot $27.50 | Rake $1.38 
Board [Ts Qd 7d Ks Ac]
Seat 1: Klappspaten0 folded before Flop (didn't bet)
Seat 2: stepan0605 showed [Kh Ah] and won ($26.12) with two pair, Aces and Kings
Seat 3: KovIFish89 (button) folded on the Turn
Seat 4: King Sixtus (small blind) folded before Flop
Seat 5: pardama (big blind) folded before Flop
Seat 6: Dandy Monk showed [8c Td] and lost with a pair of Tens
Seat 7: solbi86 folded before Flop (didn't bet)
Seat 8: matiko09 folded before Flop (didn't bet)
Seat 9: djammusic folded before Flop (didn't bet)





PokerStars Hand #155014540992:  Hold'em No Limit ($0.50/$1.00 USD) - 2016/06/21 14:13:01 CET [2016/06/21 8:13:01 ET]
Table 'Lamberta II' 9-max Seat #3 is the button
Seat 3: matiko09 ($104.18 in chips) 
Seat 4: Eskimo Fox ($108.54 in chips) 
Seat 5: CoolFireX ($124.10 in chips) 
Seat 6: Chen423 ($101 in chips) 
Seat 7: 23SmOkEr07 ($195.54 in chips) 
Seat 9: Sjtu_Michael ($115.52 in chips) 
Eskimo Fox: posts small blind $0.50
CoolFireX: posts big blind $1
stepan0605: sits out 
Sjtu_Michael: posts small blind $0.50
Avtovo: sits out 
pardama: sits out 
*** HOLE CARDS ***
Dealt to matiko09 [8d 7h]
Chen423: folds 
23SmOkEr07: folds 
Sjtu_Michael: folds 
matiko09: folds 
Eskimo Fox: raises $2 to $3
CoolFireX: folds 
Uncalled bet ($2) returned to Eskimo Fox
Eskimo Fox collected $2.50 from pot
Eskimo Fox: doesn't show hand 
*** SUMMARY ***
Total pot $2.50 | Rake $0 
Seat 3: matiko09 (button) folded before Flop (didn't bet)
Seat 4: Eskimo Fox (small blind) collected ($2.50)
Seat 5: CoolFireX (big blind) folded before Flop
Seat 6: Chen423 folded before Flop (didn't bet)
Seat 7: 23SmOkEr07 folded before Flop (didn't bet)
Seat 9: Sjtu_Michael folded before Flop





PokerStars Hand #155014553509:  Hold'em No Limit (€0.25/€0.50 EUR) - 2016/06/21 14:13:29 CET [2016/06/21 8:13:29 ET]
Table 'Lotis II' 6-max Seat #1 is the button
Seat 1: bustafc (€50 in chips) 
Seat 2: MoganB0y (€50 in chips) 
Seat 3: hmverlin (€27.29 in chips) 
Seat 4: IpMan13 (€86.59 in chips) 
Seat 6: matiko09 (€56.56 in chips) 
MoganB0y: posts small blind €0.25
hmverlin: posts big blind €0.50
KrishnaRadha: sits out 
*** HOLE CARDS ***
Dealt to matiko09 [5c 9s]
IpMan13: folds 
matiko09: folds 
bustafc: folds 
MoganB0y: raises €1 to €1.50
hmverlin: calls €1
*** FLOP *** [8c 3s Ad]
MoganB0y: checks 
hmverlin: bets €1.50
MoganB0y: folds 
Uncalled bet (€1.50) returned to hmverlin
hmverlin collected €2.85 from pot
hmverlin: doesn't show hand 
*** SUMMARY ***
Total pot €3 | Rake €0.15 
Board [8c 3s Ad]
Seat 1: bustafc (button) folded before Flop (didn't bet)
Seat 2: MoganB0y (small blind) folded on the Flop
Seat 3: hmverlin (big blind) collected (€2.85)
Seat 4: IpMan13 folded before Flop (didn't bet)
Seat 6: matiko09 folded before Flop (didn't bet)





PokerStars Hand #155014558818:  Hold'em No Limit ($0.50/$1.00 USD) - 2016/06/21 14:13:41 CET [2016/06/21 8:13:41 ET]
Table 'Lamberta II' 9-max Seat #4 is the button
Seat 3: matiko09 ($104.18 in chips) 
Seat 4: Eskimo Fox ($110.04 in chips) 
Seat 5: CoolFireX ($123.10 in chips) 
Seat 6: Chen423 ($101 in chips) 
Seat 7: 23SmOkEr07 ($195.54 in chips) 
Seat 9: Sjtu_Michael ($115.02 in chips) 
CoolFireX: posts small blind $0.50
Chen423: posts big blind $1
stepan0605: sits out 
Avtovo: sits out 
pardama: sits out 
*** HOLE CARDS ***
Dealt to matiko09 [3d 8c]
23SmOkEr07: raises $1.50 to $2.50
Sjtu_Michael: folds 
matiko09: folds 
Eskimo Fox: calls $2.50
CoolFireX: folds 
Chen423: folds 
*** FLOP *** [Tc 9c Th]
23SmOkEr07: bets $3.46
Eskimo Fox: calls $3.46
*** TURN *** [Tc 9c Th] [9s]
23SmOkEr07: bets $7.14
Eskimo Fox: folds 
Uncalled bet ($7.14) returned to 23SmOkEr07
23SmOkEr07 collected $12.75 from pot
23SmOkEr07: doesn't show hand 
*** SUMMARY ***
Total pot $13.42 | Rake $0.67 
Board [Tc 9c Th 9s]
Seat 3: matiko09 folded before Flop (didn't bet)
Seat 4: Eskimo Fox (button) folded on the Turn
Seat 5: CoolFireX (small blind) folded before Flop
Seat 6: Chen423 (big blind) folded before Flop
Seat 7: 23SmOkEr07 collected ($12.75)
Seat 9: Sjtu_Michael folded before Flop (didn't bet)





PokerStars Hand #155014559554:  Hold'em No Limit ($0.50/$1.00 USD) - 2016/06/21 14:13:42 CET [2016/06/21 8:13:42 ET]
Table 'Schurer II' 9-max Seat #5 is the button
Seat 1: Dantist1122 ($104.12 in chips) 
Seat 2: havenots88 ($89.60 in chips) 
Seat 3: matiko09 ($102.15 in chips) 
Seat 4: hurtNCYDE ($109.90 in chips) 
Seat 5: riggedsh** ($118.30 in chips) 
Seat 6: Dödi123 ($127.89 in chips) 
Seat 7: Avtovo ($109.48 in chips) 
Seat 8: stepan0605 ($101.50 in chips) 
Seat 9: pardama ($100 in chips) 
Dödi123: posts small blind $0.50
Avtovo: posts big blind $1
*** HOLE CARDS ***
Dealt to matiko09 [Ad 5c]
stepan0605: folds 
pardama: folds 
Dantist1122: raises $2 to $3
havenots88: folds 
matiko09: folds 
hurtNCYDE: folds 
riggedsh**: folds 
Dödi123: folds 
Avtovo: folds 
Uncalled bet ($2) returned to Dantist1122
Dantist1122 collected $2.50 from pot
Dantist1122: doesn't show hand 
*** SUMMARY ***
Total pot $2.50 | Rake $0 
Seat 1: Dantist1122 collected ($2.50)
Seat 2: havenots88 folded before Flop (didn't bet)
Seat 3: matiko09 folded before Flop (didn't bet)
Seat 4: hurtNCYDE folded before Flop (didn't bet)
Seat 5: riggedsh** (button) folded before Flop (didn't bet)
Seat 6: Dödi123 (small blind) folded before Flop
Seat 7: Avtovo (big blind) folded before Flop
Seat 8: stepan0605 folded before Flop (didn't bet)
Seat 9: pardama folded before Flop (didn't bet)





PokerStars Hand #155014565052:  Hold'em No Limit (€0.25/€0.50 EUR) - 2016/06/21 14:13:54 CET [2016/06/21 8:13:54 ET]
Table 'Lotis II' 6-max Seat #2 is the button
Seat 1: bustafc (€50 in chips) 
Seat 2: MoganB0y (€50 in chips) 
Seat 3: hmverlin (€28.64 in chips) 
Seat 4: IpMan13 (€86.59 in chips) 
Seat 6: matiko09 (€56.56 in chips) 
hmverlin: posts small blind €0.25
IpMan13: posts big blind €0.50
KrishnaRadha: sits out 
*** HOLE CARDS ***
Dealt to matiko09 [Tc Ks]
matiko09: raises €1 to €1.50
bustafc: folds 
MoganB0y: folds 
hmverlin: folds 
IpMan13: folds 
Uncalled bet (€1) returned to matiko09
matiko09 collected €1.25 from pot
matiko09: doesn't show hand 
*** SUMMARY ***
Total pot €1.25 | Rake €0 
Seat 1: bustafc folded before Flop (didn't bet)
Seat 2: MoganB0y (button) folded before Flop (didn't bet)
Seat 3: hmverlin (small blind) folded before Flop
Seat 4: IpMan13 (big blind) folded before Flop
Seat 6: matiko09 collected (€1.25)





PokerStars Hand #155014566115:  Hold'em No Limit ($0.50/$1.00 USD) - 2016/06/21 14:13:57 CET [2016/06/21 8:13:57 ET]
Table 'Chromios' 9-max Seat #1 is the button
Seat 1: matiko09 ($121.20 in chips) 
Seat 2: pardama ($100 in chips) 
Seat 3: ozone2003 ($101.50 in chips) 
Seat 4: Eskimo Fox ($100.96 in chips) 
Seat 5: Donetsk1y ($109.66 in chips) 
Seat 7: chaps1988 ($181.85 in chips) 
Seat 8: carlosdankha ($63.81 in chips) 
Seat 9: Filojoes ($223.62 in chips) 
pardama: posts small blind $0.50
ozone2003: posts big blind $1
Troll8989: sits out 
*** HOLE CARDS ***
Dealt to matiko09 [6h Qc]
Eskimo Fox: folds 
Donetsk1y: folds 
chaps1988: folds 
carlosdankha: raises $2 to $3
Filojoes: raises $5 to $8
matiko09: folds 
pardama: folds 
ozone2003: folds 
carlosdankha: calls $5
*** FLOP *** [Tc 4c 2c]
carlosdankha: checks 
Filojoes: checks 
*** TURN *** [Tc 4c 2c] [9c]
carlosdankha: bets $3
Filojoes: folds 
Uncalled bet ($3) returned to carlosdankha
carlosdankha collected $16.62 from pot
carlosdankha: doesn't show hand 
*** SUMMARY ***
Total pot $17.50 | Rake $0.88 
Board [Tc 4c 2c 9c]
Seat 1: matiko09 (button) folded before Flop (didn't bet)
Seat 2: pardama (small blind) folded before Flop
Seat 3: ozone2003 (big blind) folded before Flop
Seat 4: Eskimo Fox folded before Flop (didn't bet)
Seat 5: Donetsk1y folded before Flop (didn't bet)
Seat 7: chaps1988 folded before Flop (didn't bet)
Seat 8: carlosdankha collected ($16.62)
Seat 9: Filojoes folded on the Turn





PokerStars Hand #155014567705:  Hold'em No Limit ($0.50/$1.00 USD) - 2016/06/21 14:14:00 CET [2016/06/21 8:14:00 ET]
Table 'Amundsenia' 9-max Seat #4 is the button
Seat 1: Troll8989 ($108.98 in chips) 
Seat 2: Avtovo ($100 in chips) 
Seat 3: matiko09 ($100 in chips) 
Seat 4: typename27 ($17.17 in chips) 
Seat 5: ozone2003 ($100 in chips) 
Seat 6: King_ZéManel ($128.81 in chips) 
Seat 7: Eskimo Fox ($107.65 in chips) 
Seat 8: DomiVY ($46.32 in chips) 
Seat 9: MrSeymen ($61.02 in chips) 
ozone2003: posts small blind $0.50
King_ZéManel: posts big blind $1
*** HOLE CARDS ***
Dealt to matiko09 [Ks 8s]
Eskimo Fox: raises $2 to $3
DomiVY: folds 
MrSeymen: folds 
Troll8989: folds 
Avtovo: folds 
matiko09: folds 
typename27: folds 
ozone2003: folds 
King_ZéManel: folds 
Uncalled bet ($2) returned to Eskimo Fox
Eskimo Fox collected $2.50 from pot
Eskimo Fox: doesn't show hand 
*** SUMMARY ***
Total pot $2.50 | Rake $0 
Seat 1: Troll8989 folded before Flop (didn't bet)
Seat 2: Avtovo folded before Flop (didn't bet)
Seat 3: matiko09 folded before Flop (didn't bet)
Seat 4: typename27 (button) folded before Flop (didn't bet)
Seat 5: ozone2003 (small blind) folded before Flop
Seat 6: King_ZéManel (big blind) folded before Flop
Seat 7: Eskimo Fox collected ($2.50)
Seat 8: DomiVY folded before Flop (didn't bet)
Seat 9: MrSeymen folded before Flop (didn't bet)





PokerStars Hand #155014572361:  Hold'em No Limit ($0.50/$1.00 USD) - 2016/06/21 14:14:10 CET [2016/06/21 8:14:10 ET]
Table 'Schurer II' 9-max Seat #6 is the button
Seat 1: Dantist1122 ($105.62 in chips) 
Seat 2: havenots88 ($89.60 in chips) 
Seat 3: matiko09 ($102.15 in chips) 
Seat 4: hurtNCYDE ($109.90 in chips) 
Seat 5: riggedsh** ($118.30 in chips) 
Seat 6: Dödi123 ($127.39 in chips) 
Seat 7: Avtovo ($108.48 in chips) 
Seat 8: stepan0605 ($101.50 in chips) 
Seat 9: pardama ($100 in chips) 
Avtovo: posts small blind $0.50
stepan0605: posts big blind $1
*** HOLE CARDS ***
Dealt to matiko09 [Ac Ad]
pardama: folds 
Dantist1122: folds 
havenots88: folds 
matiko09: raises $2 to $3
hurtNCYDE: folds 
riggedsh**: folds 
Dödi123: folds 
Avtovo: raises $7.50 to $10.50
stepan0605: folds 
matiko09: raises $12.50 to $23
Avtovo: folds 
Uncalled bet ($12.50) returned to matiko09
matiko09 collected $22 from pot
matiko09: doesn't show hand 
*** SUMMARY ***
Total pot $22 | Rake $0 
Seat 1: Dantist1122 folded before Flop (didn't bet)
Seat 2: havenots88 folded before Flop (didn't bet)
Seat 3: matiko09 collected ($22)
Seat 4: hurtNCYDE folded before Flop (didn't bet)
Seat 5: riggedsh** folded before Flop (didn't bet)
Seat 6: Dödi123 (button) folded before Flop (didn't bet)
Seat 7: Avtovo (small blind) folded before Flop
Seat 8: stepan0605 (big blind) folded before Flop
Seat 9: pardama folded before Flop (didn't bet)





PokerStars Hand #155014573996:  Hold'em No Limit (€0.25/€0.50 EUR) - 2016/06/21 14:14:14 CET [2016/06/21 8:14:14 ET]
Table 'Lotis II' 6-max Seat #3 is the button
Seat 1: bustafc (€50 in chips) 
Seat 2: MoganB0y (€50 in chips) 
Seat 3: hmverlin (€28.39 in chips) 
Seat 4: IpMan13 (€86.09 in chips) 
Seat 5: KrishnaRadha (€50 in chips) 
Seat 6: matiko09 (€57.31 in chips) 
IpMan13: posts small blind €0.25
KrishnaRadha: posts big blind €0.50
*** HOLE CARDS ***
Dealt to matiko09 [6s 2h]
matiko09: folds 
bustafc: folds 
MoganB0y: folds 
hmverlin: raises €1 to €1.50
IpMan13: folds 
KrishnaRadha: calls €1
*** FLOP *** [9s 3h 8s]
KrishnaRadha: checks 
hmverlin: bets €2.50
KrishnaRadha: folds 
Uncalled bet (€2.50) returned to hmverlin
hmverlin collected €3.09 from pot
hmverlin: doesn't show hand 
*** SUMMARY ***
Total pot €3.25 | Rake €0.16 
Board [9s 3h 8s]
Seat 1: bustafc folded before Flop (didn't bet)
Seat 2: MoganB0y folded before Flop (didn't bet)
Seat 3: hmverlin (button) collected (€3.09)
Seat 4: IpMan13 (small blind) folded before Flop
Seat 5: KrishnaRadha (big blind) folded on the Flop
Seat 6: matiko09 folded before Flop (didn't bet)





PokerStars Hand #155014578178:  Hold'em No Limit ($0.50/$1.00 USD) - 2016/06/21 14:14:23 CET [2016/06/21 8:14:23 ET]
Table 'Moreau' 9-max Seat #5 is the button
Seat 1: hurtNCYDE ($100 in chips) 
Seat 2: Avtovo ($102.50 in chips) 
Seat 3: matiko09 ($100 in chips) 
Seat 4: SharingaaN ($165.30 in chips) 
Seat 5: CoolFireX ($158.89 in chips) 
Seat 6: Troll8989 ($102.60 in chips) 
Seat 7: PanKwn15 ($52.32 in chips) 
Seat 8: mi$$I$Elena ($111.12 in chips) 
Seat 9: Toonersens ($112.56 in chips) 
Troll8989: posts small blind $0.50
PanKwn15: posts big blind $1
*** HOLE CARDS ***
Dealt to matiko09 [Td Ah]
mi$$I$Elena: folds 
Toonersens: folds 
hurtNCYDE: folds 
Avtovo: folds 
matiko09: raises $2 to $3
SharingaaN: folds 
CoolFireX: folds 
Troll8989: folds 
PanKwn15: calls $2
*** FLOP *** [5s Ts Jd]
PanKwn15: checks 
matiko09: bets $4
PanKwn15: folds 
Uncalled bet ($4) returned to matiko09
matiko09 collected $6.18 from pot
matiko09: doesn't show hand 
*** SUMMARY ***
Total pot $6.50 | Rake $0.32 
Board [5s Ts Jd]
Seat 1: hurtNCYDE folded before Flop (didn't bet)
Seat 2: Avtovo folded before Flop (didn't bet)
Seat 3: matiko09 collected ($6.18)
Seat 4: SharingaaN folded before Flop (didn't bet)
Seat 5: CoolFireX (button) folded before Flop (didn't bet)
Seat 6: Troll8989 (small blind) folded before Flop
Seat 7: PanKwn15 (big blind) folded on the Flop
Seat 8: mi$$I$Elena folded before Flop (didn't bet)
Seat 9: Toonersens folded before Flop (didn't bet)





PokerStars Hand #155014579117:  Hold'em No Limit ($0.50/$1.00 USD) - 2016/06/21 14:14:25 CET [2016/06/21 8:14:25 ET]
Table 'Gryphia' 9-max Seat #4 is the button
Seat 1: Klappspaten0 ($112.66 in chips) 
Seat 2: stepan0605 ($190.82 in chips) 
Seat 3: KovIFish89 ($100 in chips) 
Seat 4: King Sixtus ($52.19 in chips) 
Seat 5: pardama ($100 in chips) 
Seat 6: Dandy Monk ($40.02 in chips) 
Seat 7: solbi86 ($103.50 in chips) 
Seat 8: matiko09 ($105.11 in chips) 
Seat 9: djammusic ($46.80 in chips) 
pardama: posts small blind $0.50
Dandy Monk: posts big blind $1
*** HOLE CARDS ***
Dealt to matiko09 [7d Ad]
solbi86: folds 
matiko09: folds 
djammusic: folds 
Klappspaten0: folds 
stepan0605: folds 
KovIFish89: folds 
King Sixtus: folds 
pardama: folds 
Uncalled bet ($0.50) returned to Dandy Monk
Dandy Monk collected $1 from pot
Dandy Monk: doesn't show hand 
*** SUMMARY ***
Total pot $1 | Rake $0 
Seat 1: Klappspaten0 folded before Flop (didn't bet)
Seat 2: stepan0605 folded before Flop (didn't bet)
Seat 3: KovIFish89 folded before Flop (didn't bet)
Seat 4: King Sixtus (button) folded before Flop (didn't bet)
Seat 5: pardama (small blind) folded before Flop
Seat 6: Dandy Monk (big blind) collected ($1)
Seat 7: solbi86 folded before Flop (didn't bet)
Seat 8: matiko09 folded before Flop (didn't bet)
Seat 9: djammusic folded before Flop (didn't bet)





PokerStars Hand #155014581752:  Hold'em No Limit ($0.50/$1.00 USD) - 2016/06/21 14:14:30 CET [2016/06/21 8:14:30 ET]
Table 'Saldanha' 9-max Seat #6 is the button
Seat 1: KovIFish89 ($100 in chips) 
Seat 2: Avtovo ($100 in chips) 
Seat 3: matiko09 ($399.49 in chips) 
Seat 4: CoolFireX ($100 in chips) 
Seat 5: Troll8989 ($121.50 in chips) 
Seat 6: Juu2huu ($25.73 in chips) 
Seat 7: ozone2003 ($151.89 in chips) 
Seat 9: 23SmOkEr07 ($130.71 in chips) 
ozone2003: posts small blind $0.50
erick222: is sitting out 
23SmOkEr07: posts big blind $1
KovIFish89: posts the ante $0.20
Avtovo: posts the ante $0.20
matiko09: posts the ante $0.20
CoolFireX: posts the ante $0.20
Troll8989: posts the ante $0.20
Juu2huu: posts the ante $0.20
ozone2003: posts the ante $0.20
23SmOkEr07: posts the ante $0.20
*** HOLE CARDS ***
Dealt to matiko09 [Ac Ad]
KovIFish89: raises $2 to $3
Avtovo: folds 
matiko09: raises $7.50 to $10.50
CoolFireX: folds 
Troll8989: folds 
Juu2huu: folds 
ozone2003: folds 
23SmOkEr07: folds 
KovIFish89: folds 
Uncalled bet ($7.50) returned to matiko09
matiko09 collected $9.10 from pot
matiko09: doesn't show hand 
*** SUMMARY ***
Total pot $9.10 | Rake $0 
Seat 1: KovIFish89 folded before Flop
Seat 2: Avtovo folded before Flop (didn't bet)
Seat 3: matiko09 collected ($9.10)
Seat 4: CoolFireX folded before Flop (didn't bet)
Seat 5: Troll8989 folded before Flop (didn't bet)
Seat 6: Juu2huu (button) folded before Flop (didn't bet)
Seat 7: ozone2003 (small blind) folded before Flop
Seat 9: 23SmOkEr07 (big blind) folded before Flop





PokerStars Hand #155014585031:  Hold'em No Limit ($0.50/$1.00 USD) - 2016/06/21 14:14:38 CET [2016/06/21 8:14:38 ET]
Table 'Amundsenia' 9-max Seat #5 is the button
Seat 1: Troll8989 ($108.98 in chips) 
Seat 2: Avtovo ($100 in chips) 
Seat 3: matiko09 ($100 in chips) 
Seat 4: typename27 ($17.17 in chips) 
Seat 5: ozone2003 ($100 in chips) 
Seat 6: King_ZéManel ($127.81 in chips) 
Seat 7: Eskimo Fox ($109.15 in chips) 
Seat 8: DomiVY ($46.32 in chips) 
Seat 9: MrSeymen ($61.02 in chips) 
King_ZéManel: posts small blind $0.50
Eskimo Fox: posts big blind $1
*** HOLE CARDS ***
Dealt to matiko09 [Jc Kc]
DomiVY: folds 
MrSeymen: folds 
Troll8989: folds 
Avtovo: folds 
matiko09: raises $2 to $3
typename27: folds 
ozone2003: folds 
King_ZéManel: folds 
Eskimo Fox: folds 
Uncalled bet ($2) returned to matiko09
matiko09 collected $2.50 from pot
matiko09: doesn't show hand 
*** SUMMARY ***
Total pot $2.50 | Rake $0 
Seat 1: Troll8989 folded before Flop (didn't bet)
Seat 2: Avtovo folded before Flop (didn't bet)
Seat 3: matiko09 collected ($2.50)
Seat 4: typename27 folded before Flop (didn't bet)
Seat 5: ozone2003 (button) folded before Flop (didn't bet)
Seat 6: King_ZéManel (small blind) folded before Flop
Seat 7: Eskimo Fox (big blind) folded before Flop
Seat 8: DomiVY folded before Flop (didn't bet)
Seat 9: MrSeymen folded before Flop (didn't bet)





PokerStars Hand #155014590007:  Hold'em No Limit ($0.50/$1.00 USD) - 2016/06/21 14:14:48 CET [2016/06/21 8:14:48 ET]
Table 'Gryphia' 9-max Seat #5 is the button
Seat 1: Klappspaten0 ($112.66 in chips) 
Seat 2: stepan0605 ($190.82 in chips) 
Seat 3: KovIFish89 ($100 in chips) 
Seat 4: King Sixtus ($52.19 in chips) 
Seat 5: pardama ($100 in chips) 
Seat 6: Dandy Monk ($40.52 in chips) 
Seat 7: solbi86 ($103.50 in chips) 
Seat 8: matiko09 ($105.11 in chips) 
Seat 9: djammusic ($46.80 in chips) 
Dandy Monk: posts small blind $0.50
solbi86: posts big blind $1
*** HOLE CARDS ***
Dealt to matiko09 [2d 5d]
matiko09: folds 
djammusic: raises $1.25 to $2.25
Klappspaten0: folds 
stepan0605: folds 
KovIFish89: folds 
King Sixtus: folds 
pardama: folds 
Dandy Monk: folds 
solbi86: calls $1.25
*** FLOP *** [Tc 7c 5c]
Dandy Monk leaves the table
hurtNCYDE joins the table at seat #6 
solbi86: checks 
djammusic: bets $3.04
solbi86: calls $3.04
*** TURN *** [Tc 7c 5c] [Jh]
solbi86: checks 
djammusic: checks 
*** RIVER *** [Tc 7c 5c Jh] [6h]
solbi86: bets $5.79
djammusic: calls $5.79
*** SHOW DOWN ***
solbi86: shows [Kc Ad] (high card Ace)
djammusic: shows [Ac Jd] (a pair of Jacks)
djammusic collected $21.53 from pot
*** SUMMARY ***
Total pot $22.66 | Rake $1.13 
Board [Tc 7c 5c Jh 6h]
Seat 1: Klappspaten0 folded before Flop (didn't bet)
Seat 2: stepan0605 folded before Flop (didn't bet)
Seat 3: KovIFish89 folded before Flop (didn't bet)
Seat 4: King Sixtus folded before Flop (didn't bet)
Seat 5: pardama (button) folded before Flop (didn't bet)
Seat 6: Dandy Monk (small blind) folded before Flop
Seat 7: solbi86 (big blind) showed [Kc Ad] and lost with high card Ace
Seat 8: matiko09 folded before Flop (didn't bet)
Seat 9: djammusic showed [Ac Jd] and won ($21.53) with a pair of Jacks





PokerStars Hand #155014590525:  Hold'em No Limit (€0.25/€0.50 EUR) - 2016/06/21 14:14:49 CET [2016/06/21 8:14:49 ET]
Table 'Lotis II' 6-max Seat #4 is the button
Seat 1: bustafc (€50 in chips) 
Seat 2: MoganB0y (€50 in chips) 
Seat 3: hmverlin (€29.98 in chips) 
Seat 4: IpMan13 (€85.84 in chips) 
Seat 5: KrishnaRadha (€50 in chips) 
Seat 6: matiko09 (€57.31 in chips) 
KrishnaRadha: posts small blind €0.25
matiko09: posts big blind €0.50
*** HOLE CARDS ***
Dealt to matiko09 [7s 9d]
bustafc: folds 
MoganB0y: folds 
hmverlin: folds 
IpMan13: folds 
KrishnaRadha: folds 
Uncalled bet (€0.25) returned to matiko09
matiko09 collected €0.50 from pot
matiko09: doesn't show hand 
*** SUMMARY ***
Total pot €0.50 | Rake €0 
Seat 1: bustafc folded before Flop (didn't bet)
Seat 2: MoganB0y folded before Flop (didn't bet)
Seat 3: hmverlin folded before Flop (didn't bet)
Seat 4: IpMan13 (button) folded before Flop (didn't bet)
Seat 5: KrishnaRadha (small blind) folded before Flop
Seat 6: matiko09 (big blind) collected (€0.50)





PokerStars Hand #155014591208:  Hold'em No Limit ($0.50/$1.00 USD) - 2016/06/21 14:14:51 CET [2016/06/21 8:14:51 ET]
Table 'Lamberta II' 9-max Seat #5 is the button
Seat 3: matiko09 ($104.18 in chips) 
Seat 4: Eskimo Fox ($104.08 in chips) 
Seat 5: CoolFireX ($122.60 in chips) 
Seat 6: Chen423 ($100 in chips) 
Seat 7: 23SmOkEr07 ($202.33 in chips) 
Seat 9: Sjtu_Michael ($115.02 in chips) 
Chen423: posts small blind $0.50
23SmOkEr07: posts big blind $1
stepan0605: sits out 
Avtovo: sits out 
pardama: sits out 
*** HOLE CARDS ***
Dealt to matiko09 [7s 2s]
Sjtu_Michael: folds 
matiko09: folds 
Eskimo Fox: folds 
CoolFireX: folds 
Chen423: raises $1 to $2
23SmOkEr07: raises $8.50 to $10.50
Chen423: folds 
Uncalled bet ($8.50) returned to 23SmOkEr07
23SmOkEr07 collected $4 from pot
23SmOkEr07: doesn't show hand 
*** SUMMARY ***
Total pot $4 | Rake $0 
Seat 3: matiko09 folded before Flop (didn't bet)
Seat 4: Eskimo Fox folded before Flop (didn't bet)
Seat 5: CoolFireX (button) folded before Flop (didn't bet)
Seat 6: Chen423 (small blind) folded before Flop
Seat 7: 23SmOkEr07 (big blind) collected ($4)
Seat 9: Sjtu_Michael folded before Flop (didn't bet)





PokerStars Hand #155014595731:  Hold'em No Limit ($0.50/$1.00 USD) - 2016/06/21 14:15:01 CET [2016/06/21 8:15:01 ET]
Table 'Schurer II' 9-max Seat #7 is the button
Seat 1: Dantist1122 ($105.62 in chips) 
Seat 2: havenots88 ($89.60 in chips) 
Seat 3: matiko09 ($113.65 in chips) 
Seat 4: hurtNCYDE ($109.90 in chips) 
Seat 5: riggedsh** ($118.30 in chips) 
Seat 6: Dödi123 ($127.39 in chips) 
Seat 7: Avtovo ($100 in chips) 
Seat 8: stepan0605 ($100.50 in chips) 
Seat 9: pardama ($100 in chips) 
stepan0605: posts small blind $0.50
pardama: posts big blind $1
*** HOLE CARDS ***
Dealt to matiko09 [4c Kd]
Dantist1122: folds 
havenots88: folds 
matiko09: folds 
hurtNCYDE: folds 
riggedsh**: folds 
Dödi123: folds 
Avtovo: folds 
stepan0605: folds 
Uncalled bet ($0.50) returned to pardama
pardama collected $1 from pot
pardama: doesn't show hand 
*** SUMMARY ***
Total pot $1 | Rake $0 
Seat 1: Dantist1122 folded before Flop (didn't bet)
Seat 2: havenots88 folded before Flop (didn't bet)
Seat 3: matiko09 folded before Flop (didn't bet)
Seat 4: hurtNCYDE folded before Flop (didn't bet)
Seat 5: riggedsh** folded before Flop (didn't bet)
Seat 6: Dödi123 folded before Flop (didn't bet)
Seat 7: Avtovo (button) folded before Flop (didn't bet)
Seat 8: stepan0605 (small blind) folded before Flop
Seat 9: pardama (big blind) collected ($1)





PokerStars Hand #155014596834:  Hold'em No Limit (€0.25/€0.50 EUR) - 2016/06/21 14:15:03 CET [2016/06/21 8:15:03 ET]
Table 'Lotis II' 6-max Seat #5 is the button
Seat 1: bustafc (€50 in chips) 
Seat 2: MoganB0y (€50 in chips) 
Seat 3: hmverlin (€29.98 in chips) 
Seat 4: IpMan13 (€85.84 in chips) 
Seat 5: KrishnaRadha (€50 in chips) 
Seat 6: matiko09 (€57.56 in chips) 
matiko09: posts small blind €0.25
bustafc: posts big blind €0.50
*** HOLE CARDS ***
Dealt to matiko09 [7s 9d]
MoganB0y: folds 
hmverlin: folds 
IpMan13: raises €0.75 to €1.25
KrishnaRadha: folds 
matiko09: folds 
bustafc: calls €0.75
*** FLOP *** [Qc Qs 7d]
bustafc: checks 
IpMan13: bets €1.72
bustafc: folds 
Uncalled bet (€1.72) returned to IpMan13
IpMan13 collected €2.61 from pot
IpMan13: doesn't show hand 
*** SUMMARY ***
Total pot €2.75 | Rake €0.14 
Board [Qc Qs 7d]
Seat 1: bustafc (big blind) folded on the Flop
Seat 2: MoganB0y folded before Flop (didn't bet)
Seat 3: hmverlin folded before Flop (didn't bet)
Seat 4: IpMan13 collected (€2.61)
Seat 5: KrishnaRadha (button) folded before Flop (didn't bet)
Seat 6: matiko09 (small blind) folded before Flop





PokerStars Hand #155014604503:  Hold'em No Limit ($0.50/$1.00 USD) - 2016/06/21 14:15:20 CET [2016/06/21 8:15:20 ET]
Table 'Schurer II' 9-max Seat #8 is the button
Seat 1: Dantist1122 ($105.62 in chips) 
Seat 2: havenots88 ($89.60 in chips) 
Seat 3: matiko09 ($113.65 in chips) 
Seat 4: hurtNCYDE ($109.90 in chips) 
Seat 5: riggedsh** ($118.30 in chips) 
Seat 6: Dödi123 ($127.39 in chips) 
Seat 7: Avtovo ($100 in chips) 
Seat 8: stepan0605 ($100 in chips) 
Seat 9: pardama ($100.50 in chips) 
pardama: posts small blind $0.50
Dantist1122: posts big blind $1
*** HOLE CARDS ***
Dealt to matiko09 [Td 6h]
havenots88: folds 
matiko09: folds 
hurtNCYDE: folds 
riggedsh**: folds 
Dödi123: folds 
Avtovo: folds 
stepan0605: raises $2 to $3
pardama: folds 
Dantist1122: folds 
Uncalled bet ($2) returned to stepan0605
stepan0605 collected $2.50 from pot
stepan0605: doesn't show hand 
*** SUMMARY ***
Total pot $2.50 | Rake $0 
Seat 1: Dantist1122 (big blind) folded before Flop
Seat 2: havenots88 folded before Flop (didn't bet)
Seat 3: matiko09 folded before Flop (didn't bet)
Seat 4: hurtNCYDE folded before Flop (didn't bet)
Seat 5: riggedsh** folded before Flop (didn't bet)
Seat 6: Dödi123 folded before Flop (didn't bet)
Seat 7: Avtovo folded before Flop (didn't bet)
Seat 8: stepan0605 (button) collected ($2.50)
Seat 9: pardama (small blind) folded before Flop





PokerStars Hand #155014606419:  Hold'em No Limit ($0.50/$1.00 USD) - 2016/06/21 14:15:23 CET [2016/06/21 8:15:23 ET]
Table 'Chromios' 9-max Seat #2 is the button
Seat 1: matiko09 ($121.20 in chips) 
Seat 2: pardama ($100 in chips) 
Seat 3: ozone2003 ($100.50 in chips) 
Seat 4: Eskimo Fox ($100.96 in chips) 
Seat 5: Donetsk1y ($109.66 in chips) 
Seat 7: chaps1988 ($181.85 in chips) 
Seat 8: carlosdankha ($72.43 in chips) 
Seat 9: Filojoes ($215.62 in chips) 
ozone2003: posts small blind $0.50
Eskimo Fox: posts big blind $1
Troll8989: sits out 
*** HOLE CARDS ***
Dealt to matiko09 [Td Jc]
Donetsk1y: folds 
chaps1988: folds 
carlosdankha: folds 
Filojoes: raises $2 to $3
matiko09: folds 
pardama: folds 
ozone2003: folds 
Eskimo Fox: folds 
Uncalled bet ($2) returned to Filojoes
Filojoes collected $2.50 from pot
Filojoes: doesn't show hand 
*** SUMMARY ***
Total pot $2.50 | Rake $0 
Seat 1: matiko09 folded before Flop (didn't bet)
Seat 2: pardama (button) folded before Flop (didn't bet)
Seat 3: ozone2003 (small blind) folded before Flop
Seat 4: Eskimo Fox (big blind) folded before Flop
Seat 5: Donetsk1y folded before Flop (didn't bet)
Seat 7: chaps1988 folded before Flop (didn't bet)
Seat 8: carlosdankha folded before Flop (didn't bet)
Seat 9: Filojoes collected ($2.50)





PokerStars Hand #155014609022:  Hold'em No Limit ($0.50/$1.00 USD) - 2016/06/21 14:15:29 CET [2016/06/21 8:15:29 ET]
Table 'Moreau' 9-max Seat #6 is the button
Seat 1: hurtNCYDE ($100 in chips) 
Seat 2: Avtovo ($102.50 in chips) 
Seat 3: matiko09 ($103.18 in chips) 
Seat 4: SharingaaN ($165.30 in chips) 
Seat 5: CoolFireX ($158.89 in chips) 
Seat 6: Troll8989 ($102.10 in chips) 
Seat 7: PanKwn15 ($49.32 in chips) 
Seat 8: mi$$I$Elena ($111.12 in chips) 
Seat 9: Toonersens ($112.56 in chips) 
PanKwn15: posts small blind $0.50
mi$$I$Elena: posts big blind $1
*** HOLE CARDS ***
Dealt to matiko09 [8d 3h]
Toonersens: calls $1
hurtNCYDE: folds 
Avtovo: raises $2.50 to $3.50
matiko09: folds 
SharingaaN: folds 
CoolFireX: calls $3.50
Troll8989: folds 
PanKwn15: folds 
mi$$I$Elena: folds 
Toonersens is disconnected 
Toonersens is connected 
Toonersens: calls $2.50
*** FLOP *** [6h 4d 9d]
Toonersens: checks 
Avtovo: bets $6.50
CoolFireX: calls $6.50
Toonersens: folds 
*** TURN *** [6h 4d 9d] [Ah]
Avtovo: checks 
CoolFireX: checks 
*** RIVER *** [6h 4d 9d Ah] [Qd]
Avtovo: bets $11.87
CoolFireX: folds 
Uncalled bet ($11.87) returned to Avtovo
Avtovo collected $23.75 from pot
Avtovo: doesn't show hand 
*** SUMMARY ***
Total pot $25 | Rake $1.25 
Board [6h 4d 9d Ah Qd]
Seat 1: hurtNCYDE folded before Flop (didn't bet)
Seat 2: Avtovo collected ($23.75)
Seat 3: matiko09 folded before Flop (didn't bet)
Seat 4: SharingaaN folded before Flop (didn't bet)
Seat 5: CoolFireX folded on the River
Seat 6: Troll8989 (button) folded before Flop (didn't bet)
Seat 7: PanKwn15 (small blind) folded before Flop
Seat 8: mi$$I$Elena (big blind) folded before Flop
Seat 9: Toonersens folded on the Flop





PokerStars Hand #155014610029:  Hold'em No Limit ($0.50/$1.00 USD) - 2016/06/21 14:15:31 CET [2016/06/21 8:15:31 ET]
Table 'Amundsenia' 9-max Seat #6 is the button
Seat 1: Troll8989 ($108.98 in chips) 
Seat 2: Avtovo ($100 in chips) 
Seat 3: matiko09 ($101.50 in chips) 
Seat 4: typename27 ($17.17 in chips) 
Seat 5: ozone2003 ($100 in chips) 
Seat 6: King_ZéManel ($127.31 in chips) 
Seat 7: Eskimo Fox ($108.15 in chips) 
Seat 8: DomiVY ($46.32 in chips) 
Seat 9: MrSeymen ($61.02 in chips) 
Eskimo Fox: posts small blind $0.50
DomiVY: posts big blind $1
*** HOLE CARDS ***
Dealt to matiko09 [8d 4c]
MrSeymen has timed out
MrSeymen: folds 
Troll8989: folds 
Avtovo: folds 
matiko09: folds 
typename27: folds 
ozone2003: folds 
King_ZéManel: raises $1 to $2
Eskimo Fox: folds 
DomiVY: raises $4.50 to $6.50
King_ZéManel: folds 
Uncalled bet ($4.50) returned to DomiVY
DomiVY collected $4.50 from pot
DomiVY: doesn't show hand 
*** SUMMARY ***
Total pot $4.50 | Rake $0 
Seat 1: Troll8989 folded before Flop (didn't bet)
Seat 2: Avtovo folded before Flop (didn't bet)
Seat 3: matiko09 folded before Flop (didn't bet)
Seat 4: typename27 folded before Flop (didn't bet)
Seat 5: ozone2003 folded before Flop (didn't bet)
Seat 6: King_ZéManel (button) folded before Flop
Seat 7: Eskimo Fox (small blind) folded before Flop
Seat 8: DomiVY (big blind) collected ($4.50)
Seat 9: MrSeymen folded before Flop (didn't bet)





PokerStars Hand #155014611092:  Hold'em No Limit ($0.50/$1.00 USD) - 2016/06/21 14:15:33 CET [2016/06/21 8:15:33 ET]
Table 'Saldanha' 9-max Seat #7 is the button
Seat 1: KovIFish89 ($100 in chips) 
Seat 2: Avtovo ($100 in chips) 
Seat 3: matiko09 ($405.39 in chips) 
Seat 4: CoolFireX ($100 in chips) 
Seat 5: Troll8989 ($121.30 in chips) 
Seat 6: Juu2huu ($25.53 in chips) 
Seat 7: ozone2003 ($151.19 in chips) 
Seat 9: 23SmOkEr07 ($129.51 in chips) 
23SmOkEr07: posts small blind $0.50
KovIFish89: posts big blind $1
KovIFish89: posts the ante $0.20
Avtovo: posts the ante $0.20
matiko09: posts the ante $0.20
CoolFireX: posts the ante $0.20
Troll8989: posts the ante $0.20
Juu2huu: posts the ante $0.20
ozone2003: posts the ante $0.20
23SmOkEr07: posts the ante $0.20
*** HOLE CARDS ***
Dealt to matiko09 [Qs 5h]
Avtovo: folds 
matiko09: folds 
CoolFireX: folds 
Troll8989: raises $1.50 to $2.50
Juu2huu: folds 
ozone2003: folds 
23SmOkEr07: calls $2
KovIFish89: calls $1.50
*** FLOP *** [Td 5c Qh]
23SmOkEr07: checks 
KovIFish89: checks 
Troll8989: bets $5
23SmOkEr07: folds 
KovIFish89: calls $5
*** TURN *** [Td 5c Qh] [7c]
KovIFish89: checks 
Troll8989: checks 
*** RIVER *** [Td 5c Qh 7c] [9c]
KovIFish89: checks 
Troll8989: checks 
*** SHOW DOWN ***
KovIFish89: shows [5d Ad] (a pair of Fives)
Troll8989: shows [As Tc] (a pair of Tens)
Troll8989 collected $18.14 from pot
*** SUMMARY ***
Total pot $19.10 | Rake $0.96 
Board [Td 5c Qh 7c 9c]
Seat 1: KovIFish89 (big blind) showed [5d Ad] and lost with a pair of Fives
Seat 2: Avtovo folded before Flop (didn't bet)
Seat 3: matiko09 folded before Flop (didn't bet)
Seat 4: CoolFireX folded before Flop (didn't bet)
Seat 5: Troll8989 showed [As Tc] and won ($18.14) with a pair of Tens
Seat 6: Juu2huu folded before Flop (didn't bet)
Seat 7: ozone2003 (button) folded before Flop (didn't bet)
Seat 9: 23SmOkEr07 (small blind) folded on the Flop





PokerStars Hand #155014613314:  Hold'em No Limit ($0.50/$1.00 USD) - 2016/06/21 14:15:38 CET [2016/06/21 8:15:38 ET]
Table 'Lamberta II' 9-max Seat #6 is the button
Seat 3: matiko09 ($104.18 in chips) 
Seat 4: Eskimo Fox ($104.08 in chips) 
Seat 5: CoolFireX ($122.60 in chips) 
Seat 6: Chen423 ($98 in chips) 
Seat 7: 23SmOkEr07 ($204.33 in chips) 
Seat 8: stepan0605 ($100 in chips) 
Seat 9: Sjtu_Michael ($115.02 in chips) 
23SmOkEr07: posts small blind $0.50
stepan0605: posts big blind $1
Avtovo: sits out 
pardama: sits out 
*** HOLE CARDS ***
Dealt to matiko09 [Td Js]
Sjtu_Michael: folds 
matiko09: folds 
Eskimo Fox: raises $1.50 to $2.50
CoolFireX: calls $2.50
Chen423: folds 
23SmOkEr07: folds 
stepan0605: folds 
*** FLOP *** [Jh 2c 5c]
Eskimo Fox: checks 
CoolFireX: checks 
*** TURN *** [Jh 2c 5c] [Th]
Eskimo Fox: checks 
CoolFireX: checks 
*** RIVER *** [Jh 2c 5c Th] [Qd]
Eskimo Fox: checks 
CoolFireX: checks 
*** SHOW DOWN ***
Eskimo Fox: shows [8c Ad] (high card Ace)
CoolFireX: shows [3s 3c] (a pair of Threes)
CoolFireX collected $6.18 from pot
*** SUMMARY ***
Total pot $6.50 | Rake $0.32 
Board [Jh 2c 5c Th Qd]
Seat 3: matiko09 folded before Flop (didn't bet)
Seat 4: Eskimo Fox showed [8c Ad] and lost with high card Ace
Seat 5: CoolFireX showed [3s 3c] and won ($6.18) with a pair of Threes
Seat 6: Chen423 (button) folded before Flop (didn't bet)
Seat 7: 23SmOkEr07 (small blind) folded before Flop
Seat 8: stepan0605 (big blind) folded before Flop
Seat 9: Sjtu_Michael folded before Flop (didn't bet)





PokerStars Hand #155014618831:  Hold'em No Limit (€0.25/€0.50 EUR) - 2016/06/21 14:15:50 CET [2016/06/21 8:15:50 ET]
Table 'Lotis II' 6-max Seat #6 is the button
Seat 1: bustafc (€50 in chips) 
Seat 2: MoganB0y (€50 in chips) 
Seat 3: hmverlin (€29.98 in chips) 
Seat 4: IpMan13 (€87.20 in chips) 
Seat 5: KrishnaRadha (€50 in chips) 
Seat 6: matiko09 (€57.31 in chips) 
bustafc: posts small blind €0.25
MoganB0y: posts big blind €0.50
*** HOLE CARDS ***
Dealt to matiko09 [9d Ah]
hmverlin: raises €1 to €1.50
IpMan13: folds 
KrishnaRadha: folds 
matiko09: folds 
bustafc: raises €3.50 to €5
MoganB0y: folds 
hmverlin: calls €3.50
*** FLOP *** [9s 2c 4d]
bustafc: checks 
hmverlin: bets €4
bustafc: calls €4
*** TURN *** [9s 2c 4d] [8h]
bustafc: checks 
hmverlin: bets €5
bustafc: calls €5
*** RIVER *** [9s 2c 4d 8h] [Jd]
bustafc: checks 
hmverlin: bets €8
bustafc: calls €8
*** SHOW DOWN ***
hmverlin: shows [Tc 5c] (high card Jack)
bustafc: shows [Kc Ac] (high card Ace)
bustafc collected €42.70 from pot
*** SUMMARY ***
Total pot €44.50 | Rake €1.80 
Board [9s 2c 4d 8h Jd]
Seat 1: bustafc (small blind) showed [Kc Ac] and won (€42.70) with high card Ace
Seat 2: MoganB0y (big blind) folded before Flop
Seat 3: hmverlin showed [Tc 5c] and lost with high card Jack
Seat 4: IpMan13 folded before Flop (didn't bet)
Seat 5: KrishnaRadha folded before Flop (didn't bet)
Seat 6: matiko09 (button) folded before Flop (didn't bet)





PokerStars Hand #155014619386:  Hold'em No Limit ($0.50/$1.00 USD) - 2016/06/21 14:15:51 CET [2016/06/21 8:15:51 ET]
Table 'Schurer II' 9-max Seat #9 is the button
Seat 1: Dantist1122 ($104.62 in chips) 
Seat 2: havenots88 ($89.60 in chips) 
Seat 3: matiko09 ($113.65 in chips) 
Seat 4: hurtNCYDE ($109.90 in chips) 
Seat 5: riggedsh** ($118.30 in chips) 
Seat 6: Dödi123 ($127.39 in chips) 
Seat 7: Avtovo ($100 in chips) 
Seat 8: stepan0605 ($101.50 in chips) 
Seat 9: pardama ($100 in chips) 
Dantist1122: posts small blind $0.50
havenots88: posts big blind $1
*** HOLE CARDS ***
Dealt to matiko09 [2c Qc]
matiko09: folds 
hurtNCYDE: folds 
riggedsh**: folds 
Dödi123: folds 
Avtovo: folds 
stepan0605: folds 
pardama: folds 
Dantist1122: folds 
Uncalled bet ($0.50) returned to havenots88
havenots88 collected $1 from pot
havenots88: doesn't show hand 
*** SUMMARY ***
Total pot $1 | Rake $0 
Seat 1: Dantist1122 (small blind) folded before Flop
Seat 2: havenots88 (big blind) collected ($1)
Seat 3: matiko09 folded before Flop (didn't bet)
Seat 4: hurtNCYDE folded before Flop (didn't bet)
Seat 5: riggedsh** folded before Flop (didn't bet)
Seat 6: Dödi123 folded before Flop (didn't bet)
Seat 7: Avtovo folded before Flop (didn't bet)
Seat 8: stepan0605 folded before Flop (didn't bet)
Seat 9: pardama (button) folded before Flop (didn't bet)





PokerStars Hand #155014622522:  Hold'em No Limit ($0.50/$1.00 USD) - 2016/06/21 14:15:58 CET [2016/06/21 8:15:58 ET]
Table 'Gryphia' 9-max Seat #7 is the button
Seat 1: Klappspaten0 ($112.66 in chips) 
Seat 2: stepan0605 ($190.82 in chips) 
Seat 3: KovIFish89 ($100 in chips) 
Seat 4: King Sixtus ($52.19 in chips) 
Seat 5: pardama ($100 in chips) 
Seat 7: solbi86 ($100 in chips) 
Seat 8: matiko09 ($105.11 in chips) 
Seat 9: djammusic ($57.25 in chips) 
matiko09: posts small blind $0.50
djammusic: posts big blind $1
hurtNCYDE: sits out 
*** HOLE CARDS ***
Dealt to matiko09 [Ad 8h]
Klappspaten0: folds 
stepan0605: raises $1 to $2
KovIFish89: folds 
King Sixtus: folds 
pardama: folds 
solbi86: folds 
matiko09: folds 
djammusic: folds 
Uncalled bet ($1) returned to stepan0605
stepan0605 collected $2.50 from pot
stepan0605: doesn't show hand 
*** SUMMARY ***
Total pot $2.50 | Rake $0 
Seat 1: Klappspaten0 folded before Flop (didn't bet)
Seat 2: stepan0605 collected ($2.50)
Seat 3: KovIFish89 folded before Flop (didn't bet)
Seat 4: King Sixtus folded before Flop (didn't bet)
Seat 5: pardama folded before Flop (didn't bet)
Seat 7: solbi86 (button) folded before Flop (didn't bet)
Seat 8: matiko09 (small blind) folded before Flop
Seat 9: djammusic (big blind) folded before Flop





PokerStars Hand #155014631129:  Hold'em No Limit ($0.50/$1.00 USD) - 2016/06/21 14:16:16 CET [2016/06/21 8:16:16 ET]
Table 'Chromios' 9-max Seat #3 is the button
Seat 1: matiko09 ($121.20 in chips) 
Seat 2: pardama ($100 in chips) 
Seat 3: ozone2003 ($100 in chips) 
Seat 4: Eskimo Fox ($100 in chips) 
Seat 5: Donetsk1y ($109.66 in chips) 
Seat 7: chaps1988 ($181.85 in chips) 
Seat 8: carlosdankha ($72.43 in chips) 
Seat 9: Filojoes ($217.12 in chips) 
Eskimo Fox: posts small blind $0.50
Donetsk1y: posts big blind $1
Troll8989: sits out 
*** HOLE CARDS ***
Dealt to matiko09 [Kd 3d]
chaps1988: folds 
carlosdankha: folds 
Filojoes: folds 
matiko09: folds 
pardama: folds 
ozone2003: raises $1.20 to $2.20
Eskimo Fox: folds 
Donetsk1y: calls $1.20
*** FLOP *** [6s Qs Jc]
Donetsk1y: checks 
ozone2003: checks 
*** TURN *** [6s Qs Jc] [Th]
Donetsk1y: checks 
ozone2003: checks 
*** RIVER *** [6s Qs Jc Th] [8c]
Donetsk1y: bets $2.33
ozone2003: raises $7.92 to $10.25
Donetsk1y: calls $7.92
*** SHOW DOWN ***
ozone2003: shows [Ac 6d] (a pair of Sixes)
Donetsk1y: shows [9s Tc] (a straight, Eight to Queen)
Donetsk1y collected $24.13 from pot
*** SUMMARY ***
Total pot $25.40 | Rake $1.27 
Board [6s Qs Jc Th 8c]
Seat 1: matiko09 folded before Flop (didn't bet)
Seat 2: pardama folded before Flop (didn't bet)
Seat 3: ozone2003 (button) showed [Ac 6d] and lost with a pair of Sixes
Seat 4: Eskimo Fox (small blind) folded before Flop
Seat 5: Donetsk1y (big blind) showed [9s Tc] and won ($24.13) with a straight, Eight to Queen
Seat 7: chaps1988 folded before Flop (didn't bet)
Seat 8: carlosdankha folded before Flop (didn't bet)
Seat 9: Filojoes folded before Flop (didn't bet)





PokerStars Hand #155014633360:  Hold'em No Limit ($0.50/$1.00 USD) - 2016/06/21 14:16:21 CET [2016/06/21 8:16:21 ET]
Table 'Gryphia' 9-max Seat #8 is the button
Seat 1: Klappspaten0 ($112.66 in chips) 
Seat 2: stepan0605 ($192.32 in chips) 
Seat 3: KovIFish89 ($100 in chips) 
Seat 4: King Sixtus ($52.19 in chips) 
Seat 5: pardama ($100 in chips) 
Seat 7: solbi86 ($100 in chips) 
Seat 8: matiko09 ($104.61 in chips) 
Seat 9: djammusic ($56.25 in chips) 
djammusic: posts small blind $0.50
Klappspaten0: posts big blind $1
hurtNCYDE: sits out 
*** HOLE CARDS ***
Dealt to matiko09 [Tc Js]
stepan0605: raises $1 to $2
KovIFish89: folds 
King Sixtus: raises $5.50 to $7.50
pardama: folds 
solbi86: folds 
matiko09: folds 
djammusic: folds 
Klappspaten0: folds 
stepan0605: folds 
Uncalled bet ($5.50) returned to King Sixtus
King Sixtus collected $5.50 from pot
King Sixtus: doesn't show hand 
*** SUMMARY ***
Total pot $5.50 | Rake $0 
Seat 1: Klappspaten0 (big blind) folded before Flop
Seat 2: stepan0605 folded before Flop
Seat 3: KovIFish89 folded before Flop (didn't bet)
Seat 4: King Sixtus collected ($5.50)
Seat 5: pardama folded before Flop (didn't bet)
Seat 7: solbi86 folded before Flop (didn't bet)
Seat 8: matiko09 (button) folded before Flop (didn't bet)
Seat 9: djammusic (small blind) folded before Flop





PokerStars Hand #155014634062:  Hold'em No Limit ($0.50/$1.00 USD) - 2016/06/21 14:16:22 CET [2016/06/21 8:16:22 ET]
Table 'Schurer II' 9-max Seat #1 is the button
Seat 1: Dantist1122 ($104.12 in chips) 
Seat 2: havenots88 ($90.10 in chips) 
Seat 3: matiko09 ($113.65 in chips) 
Seat 4: hurtNCYDE ($109.90 in chips) 
Seat 5: riggedsh** ($118.30 in chips) 
Seat 6: Dödi123 ($127.39 in chips) 
Seat 7: Avtovo ($100 in chips) 
Seat 8: stepan0605 ($101.50 in chips) 
Seat 9: pardama ($100 in chips) 
havenots88: posts small blind $0.50
matiko09: posts big blind $1
*** HOLE CARDS ***
Dealt to matiko09 [Qc Ks]
hurtNCYDE: folds 
riggedsh**: folds 
Dödi123: raises $1.50 to $2.50
Avtovo: folds 
stepan0605: folds 
pardama: folds 
Dantist1122: folds 
havenots88: raises $6 to $8.50
matiko09: folds 
Dödi123: calls $6
*** FLOP *** [Jh Ac 4c]
havenots88: bets $8.55
Dödi123: folds 
Uncalled bet ($8.55) returned to havenots88
havenots88 collected $17.10 from pot
havenots88: doesn't show hand 
*** SUMMARY ***
Total pot $18 | Rake $0.90 
Board [Jh Ac 4c]
Seat 1: Dantist1122 (button) folded before Flop (didn't bet)
Seat 2: havenots88 (small blind) collected ($17.10)
Seat 3: matiko09 (big blind) folded before Flop
Seat 4: hurtNCYDE folded before Flop (didn't bet)
Seat 5: riggedsh** folded before Flop (didn't bet)
Seat 6: Dödi123 folded on the Flop
Seat 7: Avtovo folded before Flop (didn't bet)
Seat 8: stepan0605 folded before Flop (didn't bet)
Seat 9: pardama folded before Flop (didn't bet)





PokerStars Hand #155014634714:  Hold'em No Limit ($0.50/$1.00 USD) - 2016/06/21 14:16:24 CET [2016/06/21 8:16:24 ET]
Table 'Amundsenia' 9-max Seat #7 is the button
Seat 1: Troll8989 ($108.98 in chips) 
Seat 2: Avtovo ($100 in chips) 
Seat 3: matiko09 ($101.50 in chips) 
Seat 4: typename27 ($17.17 in chips) 
Seat 5: ozone2003 ($100 in chips) 
Seat 6: King_ZéManel ($125.31 in chips) 
Seat 7: Eskimo Fox ($107.65 in chips) 
Seat 8: DomiVY ($48.82 in chips) 
Seat 9: MrSeymen ($61.02 in chips) 
DomiVY: posts small blind $0.50
MrSeymen: posts big blind $1
*** HOLE CARDS ***
Dealt to matiko09 [7c Jc]
Troll8989: folds 
Avtovo: folds 
matiko09: folds 
typename27: calls $1
ozone2003: folds 
King_ZéManel: folds 
Eskimo Fox: folds 
DomiVY: folds 
MrSeymen: checks 
*** FLOP *** [Qc 7s 4h]
MrSeymen: checks 
typename27: bets $2.38
MrSeymen: folds 
Uncalled bet ($2.38) returned to typename27
typename27 collected $2.38 from pot
typename27: doesn't show hand 
*** SUMMARY ***
Total pot $2.50 | Rake $0.12 
Board [Qc 7s 4h]
Seat 1: Troll8989 folded before Flop (didn't bet)
Seat 2: Avtovo folded before Flop (didn't bet)
Seat 3: matiko09 folded before Flop (didn't bet)
Seat 4: typename27 collected ($2.38)
Seat 5: ozone2003 folded before Flop (didn't bet)
Seat 6: King_ZéManel folded before Flop (didn't bet)
Seat 7: Eskimo Fox (button) folded before Flop (didn't bet)
Seat 8: DomiVY (small blind) folded before Flop
Seat 9: MrSeymen (big blind) folded on the Flop





PokerStars Hand #155014644976:  Hold'em No Limit ($0.50/$1.00 USD) - 2016/06/21 14:16:46 CET [2016/06/21 8:16:46 ET]
Table 'Lamberta II' 9-max Seat #7 is the button
Seat 3: matiko09 ($104.18 in chips) 
Seat 4: Eskimo Fox ($101.58 in chips) 
Seat 5: CoolFireX ($126.28 in chips) 
Seat 6: Chen423 ($98 in chips) 
Seat 7: 23SmOkEr07 ($203.83 in chips) 
Seat 8: stepan0605 ($100 in chips) 
Seat 9: Sjtu_Michael ($115.02 in chips) 
stepan0605: posts small blind $0.50
Sjtu_Michael: posts big blind $1
Avtovo: sits out 
pardama: sits out 
*** HOLE CARDS ***
Dealt to matiko09 [9s Ks]
matiko09: folds 
Eskimo Fox: folds 
CoolFireX: folds 
Chen423: folds 
23SmOkEr07: folds 
stepan0605: folds 
Uncalled bet ($0.50) returned to Sjtu_Michael
Sjtu_Michael collected $1 from pot
Sjtu_Michael: doesn't show hand 
*** SUMMARY ***
Total pot $1 | Rake $0 
Seat 3: matiko09 folded before Flop (didn't bet)
Seat 4: Eskimo Fox folded before Flop (didn't bet)
Seat 5: CoolFireX folded before Flop (didn't bet)
Seat 6: Chen423 folded before Flop (didn't bet)
Seat 7: 23SmOkEr07 (button) folded before Flop (didn't bet)
Seat 8: stepan0605 (small blind) folded before Flop
Seat 9: Sjtu_Michael (big blind) collected ($1)





PokerStars Hand #155014652446:  Hold'em No Limit ($0.50/$1.00 USD) - 2016/06/21 14:17:02 CET [2016/06/21 8:17:02 ET]
Table 'Gryphia' 9-max Seat #9 is the button
Seat 1: Klappspaten0 ($111.66 in chips) 
Seat 2: stepan0605 ($190.32 in chips) 
Seat 3: KovIFish89 ($100 in chips) 
Seat 4: King Sixtus ($55.69 in chips) 
Seat 5: pardama ($100 in chips) 
Seat 7: solbi86 ($100 in chips) 
Seat 8: matiko09 ($104.61 in chips) 
Seat 9: djammusic ($55.75 in chips) 
Klappspaten0: posts small blind $0.50
stepan0605: posts big blind $1
hurtNCYDE: sits out 
*** HOLE CARDS ***
Dealt to matiko09 [Jh Ks]
KovIFish89: folds 
King Sixtus: folds 
pardama: folds 
solbi86: folds 
matiko09: raises $1.50 to $2.50
djammusic: folds 
Klappspaten0: folds 
stepan0605: folds 
Uncalled bet ($1.50) returned to matiko09
matiko09 collected $2.50 from pot
matiko09: doesn't show hand 
*** SUMMARY ***
Total pot $2.50 | Rake $0 
Seat 1: Klappspaten0 (small blind) folded before Flop
Seat 2: stepan0605 (big blind) folded before Flop
Seat 3: KovIFish89 folded before Flop (didn't bet)
Seat 4: King Sixtus folded before Flop (didn't bet)
Seat 5: pardama folded before Flop (didn't bet)
Seat 7: solbi86 folded before Flop (didn't bet)
Seat 8: matiko09 collected ($2.50)
Seat 9: djammusic (button) folded before Flop (didn't bet)





PokerStars Hand #155014655204:  Hold'em No Limit ($0.50/$1.00 USD) - 2016/06/21 14:17:08 CET [2016/06/21 8:17:08 ET]
Table 'Saldanha' 9-max Seat #9 is the button
Seat 1: KovIFish89 ($100 in chips) 
Seat 3: matiko09 ($405.19 in chips) 
Seat 4: CoolFireX ($100 in chips) 
Seat 5: Troll8989 ($131.74 in chips) 
Seat 6: Juu2huu ($25.33 in chips) 
Seat 7: ozone2003 ($150.99 in chips) 
Seat 9: 23SmOkEr07 ($126.81 in chips) 
KovIFish89: posts small blind $0.50
Avtovo: is sitting out 
matiko09: posts big blind $1
KovIFish89: posts the ante $0.20
matiko09: posts the ante $0.20
CoolFireX: posts the ante $0.20
Troll8989: posts the ante $0.20
Juu2huu: posts the ante $0.20
ozone2003: posts the ante $0.20
23SmOkEr07: posts the ante $0.20
*** HOLE CARDS ***
Dealt to matiko09 [Qh Jd]
Avtovo leaves the table
CoolFireX: folds 
Filojoes joins the table at seat #2 
Troll8989: folds 
Juu2huu: calls $1
ozone2003: folds 
23SmOkEr07: folds 
KovIFish89: calls $0.50
matiko09: checks 
*** FLOP *** [Td 7s 9c]
KovIFish89: checks 
matiko09: checks 
Juu2huu: checks 
*** TURN *** [Td 7s 9c] [6h]
KovIFish89: checks 
matiko09: bets $2.72
Juu2huu: folds 
KovIFish89: folds 
Uncalled bet ($2.72) returned to matiko09
matiko09 collected $4.18 from pot
matiko09: doesn't show hand 
*** SUMMARY ***
Total pot $4.40 | Rake $0.22 
Board [Td 7s 9c 6h]
Seat 1: KovIFish89 (small blind) folded on the Turn
Seat 3: matiko09 (big blind) collected ($4.18)
Seat 4: CoolFireX folded before Flop (didn't bet)
Seat 5: Troll8989 folded before Flop (didn't bet)
Seat 6: Juu2huu folded on the Turn
Seat 7: ozone2003 folded before Flop (didn't bet)
Seat 9: 23SmOkEr07 (button) folded before Flop (didn't bet)





PokerStars Hand #155014656599:  Hold'em No Limit ($0.50/$1.00 USD) - 2016/06/21 14:17:11 CET [2016/06/21 8:17:11 ET]
Table 'Lamberta II' 9-max Seat #8 is the button
Seat 1: Avtovo ($102.45 in chips) 
Seat 3: matiko09 ($104.18 in chips) 
Seat 4: Eskimo Fox ($101.58 in chips) 
Seat 5: CoolFireX ($126.28 in chips) 
Seat 6: Chen423 ($98 in chips) 
Seat 7: 23SmOkEr07 ($203.83 in chips) 
Seat 8: stepan0605 ($100 in chips) 
Seat 9: Sjtu_Michael ($115.52 in chips) 
Sjtu_Michael: posts small blind $0.50
Avtovo: posts big blind $1
pardama: sits out 
*** HOLE CARDS ***
Dealt to matiko09 [6h Jh]
matiko09: folds 
Eskimo Fox: folds 
CoolFireX: folds 
Chen423: raises $2 to $3
23SmOkEr07: folds 
stepan0605: folds 
Sjtu_Michael: calls $2.50
Avtovo: folds 
*** FLOP *** [Ad 3c Qd]
Sjtu_Michael: checks 
Chen423: checks 
*** TURN *** [Ad 3c Qd] [6c]
Sjtu_Michael: bets $3.32
Chen423: folds 
Uncalled bet ($3.32) returned to Sjtu_Michael
Sjtu_Michael collected $6.65 from pot
*** SUMMARY ***
Total pot $7 | Rake $0.35 
Board [Ad 3c Qd 6c]
Seat 1: Avtovo (big blind) folded before Flop
Seat 3: matiko09 folded before Flop (didn't bet)
Seat 4: Eskimo Fox folded before Flop (didn't bet)
Seat 5: CoolFireX folded before Flop (didn't bet)
Seat 6: Chen423 folded on the Turn
Seat 7: 23SmOkEr07 folded before Flop (didn't bet)
Seat 8: stepan0605 (button) folded before Flop (didn't bet)
Seat 9: Sjtu_Michael (small blind) collected ($6.65)





PokerStars Hand #155014661044:  Hold'em No Limit ($0.50/$1.00 USD) - 2016/06/21 14:17:20 CET [2016/06/21 8:17:20 ET]
Table 'Gryphia' 9-max Seat #1 is the button
Seat 1: Klappspaten0 ($111.16 in chips) 
Seat 2: stepan0605 ($189.32 in chips) 
Seat 3: KovIFish89 ($100 in chips) 
Seat 4: King Sixtus ($55.69 in chips) 
Seat 5: pardama ($100 in chips) 
Seat 7: solbi86 ($100 in chips) 
Seat 8: matiko09 ($106.11 in chips) 
Seat 9: djammusic ($55.75 in chips) 
stepan0605: posts small blind $0.50
KovIFish89: posts big blind $1
hurtNCYDE: sits out 
*** HOLE CARDS ***
Dealt to matiko09 [2s Ac]
King Sixtus: folds 
pardama: folds 
solbi86: folds 
matiko09: folds 
djammusic: folds 
Klappspaten0: raises $2 to $3
stepan0605: folds 
KovIFish89: folds 
Uncalled bet ($2) returned to Klappspaten0
Klappspaten0 collected $2.50 from pot
Klappspaten0: doesn't show hand 
*** SUMMARY ***
Total pot $2.50 | Rake $0 
Seat 1: Klappspaten0 (button) collected ($2.50)
Seat 2: stepan0605 (small blind) folded before Flop
Seat 3: KovIFish89 (big blind) folded before Flop
Seat 4: King Sixtus folded before Flop (didn't bet)
Seat 5: pardama folded before Flop (didn't bet)
Seat 7: solbi86 folded before Flop (didn't bet)
Seat 8: matiko09 folded before Flop (didn't bet)
Seat 9: djammusic folded before Flop (didn't bet)





PokerStars Hand #155014663580:  Hold'em No Limit ($0.50/$1.00 USD) - 2016/06/21 14:17:26 CET [2016/06/21 8:17:26 ET]
Table 'Amundsenia' 9-max Seat #8 is the button
Seat 1: Troll8989 ($108.98 in chips) 
Seat 2: Avtovo ($100 in chips) 
Seat 3: matiko09 ($101.50 in chips) 
Seat 4: typename27 ($18.55 in chips) 
Seat 5: ozone2003 ($100 in chips) 
Seat 6: King_ZéManel ($125.31 in chips) 
Seat 7: Eskimo Fox ($107.65 in chips) 
Seat 8: DomiVY ($48.32 in chips) 
Seat 9: MrSeymen ($60.02 in chips) 
MrSeymen: posts small blind $0.50
Troll8989: posts big blind $1
*** HOLE CARDS ***
Dealt to matiko09 [6h 9c]
Avtovo: folds 
matiko09: folds 
typename27: folds 
ozone2003: folds 
King_ZéManel: folds 
Eskimo Fox: folds 
DomiVY: folds 
MrSeymen: raises $2 to $3
Troll8989: calls $2
*** FLOP *** [Th 7c Jd]
MrSeymen: checks 
Troll8989: checks 
*** TURN *** [Th 7c Jd] [Kc]
MrSeymen: bets $3
Troll8989: folds 
Uncalled bet ($3) returned to MrSeymen
MrSeymen collected $5.70 from pot
*** SUMMARY ***
Total pot $6 | Rake $0.30 
Board [Th 7c Jd Kc]
Seat 1: Troll8989 (big blind) folded on the Turn
Seat 2: Avtovo folded before Flop (didn't bet)
Seat 3: matiko09 folded before Flop (didn't bet)
Seat 4: typename27 folded before Flop (didn't bet)
Seat 5: ozone2003 folded before Flop (didn't bet)
Seat 6: King_ZéManel folded before Flop (didn't bet)
Seat 7: Eskimo Fox folded before Flop (didn't bet)
Seat 8: DomiVY (button) folded before Flop (didn't bet)
Seat 9: MrSeymen (small blind) collected ($5.70)





PokerStars Hand #155014664716:  Hold'em No Limit ($0.50/$1.00 USD) - 2016/06/21 14:17:28 CET [2016/06/21 8:17:28 ET]
Table 'Schurer II' 9-max Seat #2 is the button
Seat 1: Dantist1122 ($104.12 in chips) 
Seat 2: havenots88 ($98.70 in chips) 
Seat 3: matiko09 ($112.65 in chips) 
Seat 4: hurtNCYDE ($109.90 in chips) 
Seat 5: riggedsh** ($118.30 in chips) 
Seat 6: Dödi123 ($118.89 in chips) 
Seat 7: Avtovo ($100 in chips) 
Seat 8: stepan0605 ($101.50 in chips) 
Seat 9: pardama ($100 in chips) 
matiko09: posts small blind $0.50
hurtNCYDE: posts big blind $1
*** HOLE CARDS ***
Dealt to matiko09 [Ah Qd]
riggedsh**: folds 
Dödi123: folds 
Avtovo: folds 
stepan0605: folds 
pardama: folds 
Dantist1122: folds 
havenots88: folds 
matiko09: raises $2 to $3
hurtNCYDE: calls $2
*** FLOP *** [Kc Ac Qh]
matiko09: bets $3.71
hurtNCYDE: folds 
Uncalled bet ($3.71) returned to matiko09
matiko09 collected $5.70 from pot
matiko09: doesn't show hand 
*** SUMMARY ***
Total pot $6 | Rake $0.30 
Board [Kc Ac Qh]
Seat 1: Dantist1122 folded before Flop (didn't bet)
Seat 2: havenots88 (button) folded before Flop (didn't bet)
Seat 3: matiko09 (small blind) collected ($5.70)
Seat 4: hurtNCYDE (big blind) folded on the Flop
Seat 5: riggedsh** folded before Flop (didn't bet)
Seat 6: Dödi123 folded before Flop (didn't bet)
Seat 7: Avtovo folded before Flop (didn't bet)
Seat 8: stepan0605 folded before Flop (didn't bet)
Seat 9: pardama folded before Flop (didn't bet)





PokerStars Hand #155014664933:  Hold'em No Limit (€0.25/€0.50 EUR) - 2016/06/21 14:17:29 CET [2016/06/21 8:17:29 ET]
Table 'Lotis II' 6-max Seat #1 is the button
Seat 1: bustafc (€70.70 in chips) 
Seat 2: MoganB0y (€50 in chips) 
Seat 3: hmverlin (€7.98 in chips) 
Seat 4: IpMan13 (€87.20 in chips) 
Seat 5: KrishnaRadha (€50 in chips) 
Seat 6: matiko09 (€57.31 in chips) 
MoganB0y: posts small blind €0.25
hmverlin: posts big blind €0.50
*** HOLE CARDS ***
Dealt to matiko09 [Qd 2d]
IpMan13: folds 
KrishnaRadha: folds 
matiko09: folds 
bustafc: raises €1 to €1.50
MoganB0y: folds 
hmverlin: folds 
Uncalled bet (€1) returned to bustafc
bustafc collected €1.25 from pot
bustafc: doesn't show hand 
*** SUMMARY ***
Total pot €1.25 | Rake €0 
Seat 1: bustafc (button) collected (€1.25)
Seat 2: MoganB0y (small blind) folded before Flop
Seat 3: hmverlin (big blind) folded before Flop
Seat 4: IpMan13 folded before Flop (didn't bet)
Seat 5: KrishnaRadha folded before Flop (didn't bet)
Seat 6: matiko09 folded before Flop (didn't bet)





PokerStars Hand #155014670771:  Hold'em No Limit (€0.25/€0.50 EUR) - 2016/06/21 14:17:41 CET [2016/06/21 8:17:41 ET]
Table 'Lotis II' 6-max Seat #2 is the button
Seat 1: bustafc (€71.45 in chips) 
Seat 2: MoganB0y (€50 in chips) 
Seat 3: hmverlin (€7.48 in chips) 
Seat 4: IpMan13 (€87.20 in chips) 
Seat 5: KrishnaRadha (€50 in chips) 
Seat 6: matiko09 (€57.31 in chips) 
hmverlin: posts small blind €0.25
IpMan13: posts big blind €0.50
*** HOLE CARDS ***
Dealt to matiko09 [2c Qh]
KrishnaRadha: folds 
matiko09: folds 
KrishnaRadha leaves the table
bustafc: folds 
heavyheight joins the table at seat #5 
MoganB0y: folds 
hmverlin: folds 
Uncalled bet (€0.25) returned to IpMan13
IpMan13 collected €0.50 from pot
IpMan13: doesn't show hand 
*** SUMMARY ***
Total pot €0.50 | Rake €0 
Seat 1: bustafc folded before Flop (didn't bet)
Seat 2: MoganB0y (button) folded before Flop (didn't bet)
Seat 3: hmverlin (small blind) folded before Flop
Seat 4: IpMan13 (big blind) collected (€0.50)
Seat 5: KrishnaRadha folded before Flop (didn't bet)
Seat 6: matiko09 folded before Flop (didn't bet)





PokerStars Hand #155014675475:  Hold'em No Limit ($0.50/$1.00 USD) - 2016/06/21 14:17:51 CET [2016/06/21 8:17:51 ET]
Table 'Gryphia' 9-max Seat #2 is the button
Seat 1: Klappspaten0 ($112.66 in chips) 
Seat 2: stepan0605 ($188.82 in chips) 
Seat 3: KovIFish89 ($100 in chips) 
Seat 4: King Sixtus ($55.69 in chips) 
Seat 5: pardama ($100 in chips) 
Seat 7: solbi86 ($100 in chips) 
Seat 8: matiko09 ($106.11 in chips) 
Seat 9: djammusic ($55.75 in chips) 
KovIFish89: posts small blind $0.50
King Sixtus: posts big blind $1
hurtNCYDE: sits out 
*** HOLE CARDS ***
Dealt to matiko09 [7h 5s]
pardama: folds 
solbi86: folds 
matiko09: folds 
djammusic: folds 
Klappspaten0: folds 
stepan0605: raises $2 to $3
KovIFish89: folds 
King Sixtus: calls $2
*** FLOP *** [4c 3h 5c]
King Sixtus: bets $4.12
stepan0605: folds 
Uncalled bet ($4.12) returned to King Sixtus
King Sixtus collected $6.18 from pot
King Sixtus: doesn't show hand 
*** SUMMARY ***
Total pot $6.50 | Rake $0.32 
Board [4c 3h 5c]
Seat 1: Klappspaten0 folded before Flop (didn't bet)
Seat 2: stepan0605 (button) folded on the Flop
Seat 3: KovIFish89 (small blind) folded before Flop
Seat 4: King Sixtus (big blind) collected ($6.18)
Seat 5: pardama folded before Flop (didn't bet)
Seat 7: solbi86 folded before Flop (didn't bet)
Seat 8: matiko09 folded before Flop (didn't bet)
Seat 9: djammusic folded before Flop (didn't bet)





PokerStars Hand #155014678013:  Hold'em No Limit ($0.50/$1.00 USD) - 2016/06/21 14:17:56 CET [2016/06/21 8:17:56 ET]
Table 'Chromios' 9-max Seat #4 is the button
Seat 1: matiko09 ($121.20 in chips) 
Seat 2: pardama ($100 in chips) 
Seat 3: ozone2003 ($100 in chips) 
Seat 4: Eskimo Fox ($100 in chips) 
Seat 5: Donetsk1y ($121.34 in chips) 
Seat 6: Troll8989 ($105.18 in chips) 
Seat 7: chaps1988 ($181.85 in chips) 
Seat 8: carlosdankha ($72.43 in chips) 
Seat 9: Filojoes ($217.12 in chips) 
Donetsk1y: posts small blind $0.50
Troll8989: posts big blind $1
*** HOLE CARDS ***
Dealt to matiko09 [3h Qh]
chaps1988: folds 
carlosdankha: folds 
Donetsk1y said, "<'))><"
Filojoes: folds 
matiko09: folds 
pardama: folds 
ozone2003: folds 
Eskimo Fox: raises $1 to $2
Donetsk1y: folds 
Troll8989: calls $1
*** FLOP *** [3c 4h 6s]
Troll8989: checks 
Eskimo Fox: bets $3
Troll8989: calls $3
*** TURN *** [3c 4h 6s] [Jd]
Troll8989: checks 
Eskimo Fox: checks 
*** RIVER *** [3c 4h 6s Jd] [Ks]
Troll8989: checks 
Eskimo Fox: checks 
*** SHOW DOWN ***
Troll8989: shows [6h 7h] (a pair of Sixes)
Eskimo Fox: mucks hand 
Troll8989 collected $9.98 from pot
*** SUMMARY ***
Total pot $10.50 | Rake $0.52 
Board [3c 4h 6s Jd Ks]
Seat 1: matiko09 folded before Flop (didn't bet)
Seat 2: pardama folded before Flop (didn't bet)
Seat 3: ozone2003 folded before Flop (didn't bet)
Seat 4: Eskimo Fox (button) mucked [4c Ah]
Seat 5: Donetsk1y (small blind) folded before Flop
Seat 6: Troll8989 (big blind) showed [6h 7h] and won ($9.98) with a pair of Sixes
Seat 7: chaps1988 folded before Flop (didn't bet)
Seat 8: carlosdankha folded before Flop (didn't bet)
Seat 9: Filojoes folded before Flop (didn't bet)





PokerStars Hand #155014682852:  Hold'em No Limit (€0.25/€0.50 EUR) - 2016/06/21 14:18:07 CET [2016/06/21 8:18:07 ET]
Table 'Lotis II' 6-max Seat #3 is the button
Seat 1: bustafc (€71.45 in chips) 
Seat 2: MoganB0y (€50 in chips) 
Seat 3: hmverlin (€7.23 in chips) 
Seat 4: IpMan13 (€87.45 in chips) 
Seat 5: heavyheight (€50 in chips) 
Seat 6: matiko09 (€57.31 in chips) 
IpMan13: posts small blind €0.25
heavyheight: posts big blind €0.50
*** HOLE CARDS ***
Dealt to matiko09 [4d 9h]
matiko09: folds 
bustafc: folds 
MoganB0y: raises €0.75 to €1.25
hmverlin: folds 
IpMan13: folds 
heavyheight: folds 
Uncalled bet (€0.75) returned to MoganB0y
MoganB0y collected €1.25 from pot
MoganB0y: doesn't show hand 
*** SUMMARY ***
Total pot €1.25 | Rake €0 
Seat 1: bustafc folded before Flop (didn't bet)
Seat 2: MoganB0y collected (€1.25)
Seat 3: hmverlin (button) folded before Flop (didn't bet)
Seat 4: IpMan13 (small blind) folded before Flop
Seat 5: heavyheight (big blind) folded before Flop
Seat 6: matiko09 folded before Flop (didn't bet)





PokerStars Hand #155014684528:  Hold'em No Limit ($0.50/$1.00 USD) - 2016/06/21 14:18:10 CET [2016/06/21 8:18:10 ET]
Table 'Moreau' 9-max Seat #7 is the button
Seat 1: hurtNCYDE ($100 in chips) 
Seat 2: Avtovo ($116.25 in chips) 
Seat 3: matiko09 ($103.18 in chips) 
Seat 4: SharingaaN ($165.30 in chips) 
Seat 5: CoolFireX ($148.89 in chips) 
Seat 6: Troll8989 ($102.10 in chips) 
Seat 7: PanKwn15 ($48.82 in chips) 
Seat 8: mi$$I$Elena ($110.12 in chips) 
Seat 9: Toonersens ($109.06 in chips) 
mi$$I$Elena: posts small blind $0.50
Toonersens: posts big blind $1
*** HOLE CARDS ***
Dealt to matiko09 [Qd 3d]
hurtNCYDE: raises $1.50 to $2.50
Avtovo: folds 
matiko09: folds 
SharingaaN: folds 
CoolFireX: folds 
Troll8989: folds 
PanKwn15: raises $4 to $6.50
mi$$I$Elena: folds 
Toonersens: calls $5.50
hurtNCYDE: raises $13 to $19.50
PanKwn15: folds 
Toonersens: calls $13
*** FLOP *** [7c 2h 7h]
Toonersens: checks 
hurtNCYDE: checks 
*** TURN *** [7c 2h 7h] [3s]
Toonersens: checks 
hurtNCYDE: bets $24.50
Toonersens: folds 
Uncalled bet ($24.50) returned to hurtNCYDE
hurtNCYDE collected $43.70 from pot
*** SUMMARY ***
Total pot $46 | Rake $2.30 
Board [7c 2h 7h 3s]
Seat 1: hurtNCYDE collected ($43.70)
Seat 2: Avtovo folded before Flop (didn't bet)
Seat 3: matiko09 folded before Flop (didn't bet)
Seat 4: SharingaaN folded before Flop (didn't bet)
Seat 5: CoolFireX folded before Flop (didn't bet)
Seat 6: Troll8989 folded before Flop (didn't bet)
Seat 7: PanKwn15 (button) folded before Flop
Seat 8: mi$$I$Elena (small blind) folded before Flop
Seat 9: Toonersens (big blind) folded on the Turn





PokerStars Hand #155014687220:  Hold'em No Limit ($0.50/$1.00 USD) - 2016/06/21 14:18:16 CET [2016/06/21 8:18:16 ET]
Table 'Schurer II' 9-max Seat #3 is the button
Seat 1: Dantist1122 ($104.12 in chips) 
Seat 2: havenots88 ($98.70 in chips) 
Seat 3: matiko09 ($115.35 in chips) 
Seat 4: hurtNCYDE ($106.90 in chips) 
Seat 5: riggedsh** ($118.30 in chips) 
Seat 6: Dödi123 ($118.89 in chips) 
Seat 7: Avtovo ($100 in chips) 
Seat 8: stepan0605 ($101.50 in chips) 
Seat 9: pardama ($100 in chips) 
hurtNCYDE: posts small blind $0.50
riggedsh**: posts big blind $1
*** HOLE CARDS ***
Dealt to matiko09 [Th 8c]
Dödi123: folds 
Avtovo: folds 
stepan0605: raises $1 to $2
pardama: folds 
Dantist1122: folds 
havenots88: folds 
matiko09: folds 
hurtNCYDE: folds 
riggedsh**: folds 
Uncalled bet ($1) returned to stepan0605
stepan0605 collected $2.50 from pot
stepan0605: doesn't show hand 
*** SUMMARY ***
Total pot $2.50 | Rake $0 
Seat 1: Dantist1122 folded before Flop (didn't bet)
Seat 2: havenots88 folded before Flop (didn't bet)
Seat 3: matiko09 (button) folded before Flop (didn't bet)
Seat 4: hurtNCYDE (small blind) folded before Flop
Seat 5: riggedsh** (big blind) folded before Flop
Seat 6: Dödi123 folded before Flop (didn't bet)
Seat 7: Avtovo folded before Flop (didn't bet)
Seat 8: stepan0605 collected ($2.50)
Seat 9: pardama folded before Flop (didn't bet)





PokerStars Hand #155014689187:  Hold'em No Limit ($0.50/$1.00 USD) - 2016/06/21 14:18:20 CET [2016/06/21 8:18:20 ET]
Table 'Amundsenia' 9-max Seat #9 is the button
Seat 1: Troll8989 ($105.98 in chips) 
Seat 2: Avtovo ($100 in chips) 
Seat 3: matiko09 ($101.50 in chips) 
Seat 4: typename27 ($18.55 in chips) 
Seat 5: ozone2003 ($100 in chips) 
Seat 6: King_ZéManel ($125.31 in chips) 
Seat 7: Eskimo Fox ($107.65 in chips) 
Seat 8: DomiVY ($48.32 in chips) 
Seat 9: MrSeymen ($62.72 in chips) 
Troll8989: posts small blind $0.50
Avtovo: posts big blind $1
*** HOLE CARDS ***
Dealt to matiko09 [7c Ad]
matiko09: folds 
typename27: folds 
ozone2003: folds 
King_ZéManel: folds 
Eskimo Fox: folds 
DomiVY: folds 
MrSeymen: folds 
Troll8989: raises $1.50 to $2.50
Avtovo: folds 
Uncalled bet ($1.50) returned to Troll8989
Troll8989 collected $2 from pot
Troll8989: doesn't show hand 
*** SUMMARY ***
Total pot $2 | Rake $0 
Seat 1: Troll8989 (small blind) collected ($2)
Seat 2: Avtovo (big blind) folded before Flop
Seat 3: matiko09 folded before Flop (didn't bet)
Seat 4: typename27 folded before Flop (didn't bet)
Seat 5: ozone2003 folded before Flop (didn't bet)
Seat 6: King_ZéManel folded before Flop (didn't bet)
Seat 7: Eskimo Fox folded before Flop (didn't bet)
Seat 8: DomiVY folded before Flop (didn't bet)
Seat 9: MrSeymen (button) folded before Flop (didn't bet)





PokerStars Hand #155014689572:  Hold'em No Limit ($0.50/$1.00 USD) - 2016/06/21 14:18:21 CET [2016/06/21 8:18:21 ET]
Table 'Lamberta II' 9-max Seat #9 is the button
Seat 1: Avtovo ($101.45 in chips) 
Seat 2: pardama ($100 in chips) 
Seat 3: matiko09 ($104.18 in chips) 
Seat 4: Eskimo Fox ($101.58 in chips) 
Seat 5: CoolFireX ($126.28 in chips) 
Seat 6: Chen423 ($95 in chips) 
Seat 7: 23SmOkEr07 ($203.83 in chips) 
Seat 8: stepan0605 ($100 in chips) 
Seat 9: Sjtu_Michael ($119.17 in chips) 
Avtovo: posts small blind $0.50
pardama: posts big blind $1
*** HOLE CARDS ***
Dealt to matiko09 [8h 8s]
matiko09: raises $2 to $3
Eskimo Fox: folds 
CoolFireX: folds 
Chen423 is disconnected 
Chen423 has timed out while disconnected
Chen423: folds 
23SmOkEr07: raises $10.50 to $13.50
stepan0605: folds 
Sjtu_Michael: folds 
Avtovo: folds 
pardama: folds 
matiko09: folds 
Uncalled bet ($10.50) returned to 23SmOkEr07
23SmOkEr07 collected $7.50 from pot
23SmOkEr07: doesn't show hand 
*** SUMMARY ***
Total pot $7.50 | Rake $0 
Seat 1: Avtovo (small blind) folded before Flop
Seat 2: pardama (big blind) folded before Flop
Seat 3: matiko09 folded before Flop
Seat 4: Eskimo Fox folded before Flop (didn't bet)
Seat 5: CoolFireX folded before Flop (didn't bet)
Seat 6: Chen423 folded before Flop (didn't bet)
Seat 7: 23SmOkEr07 collected ($7.50)
Seat 8: stepan0605 folded before Flop (didn't bet)
Seat 9: Sjtu_Michael (button) folded before Flop (didn't bet)





PokerStars Hand #155014691824:  Hold'em No Limit (€0.25/€0.50 EUR) - 2016/06/21 14:18:25 CET [2016/06/21 8:18:25 ET]
Table 'Lotis II' 6-max Seat #4 is the button
Seat 1: bustafc (€71.45 in chips) 
Seat 2: MoganB0y (€50.75 in chips) 
Seat 3: hmverlin (€45.54 in chips) 
Seat 4: IpMan13 (€87.20 in chips) 
Seat 5: heavyheight (€50 in chips) 
Seat 6: matiko09 (€57.31 in chips) 
heavyheight: posts small blind €0.25
matiko09: posts big blind €0.50
*** HOLE CARDS ***
Dealt to matiko09 [8h Th]
bustafc: folds 
MoganB0y: folds 
hmverlin: raises €1 to €1.50
IpMan13: folds 
heavyheight: folds 
matiko09: folds 
Uncalled bet (€1) returned to hmverlin
hmverlin collected €1.25 from pot
hmverlin: doesn't show hand 
*** SUMMARY ***
Total pot €1.25 | Rake €0 
Seat 1: bustafc folded before Flop (didn't bet)
Seat 2: MoganB0y folded before Flop (didn't bet)
Seat 3: hmverlin collected (€1.25)
Seat 4: IpMan13 (button) folded before Flop (didn't bet)
Seat 5: heavyheight (small blind) folded before Flop
Seat 6: matiko09 (big blind) folded before Flop





PokerStars Hand #155014691557:  Hold'em No Limit ($0.50/$1.00 USD) - 2016/06/21 14:18:25 CET [2016/06/21 8:18:25 ET]
Table 'Gryphia' 9-max Seat #3 is the button
Seat 1: Klappspaten0 ($112.66 in chips) 
Seat 2: stepan0605 ($185.82 in chips) 
Seat 3: KovIFish89 ($100 in chips) 
Seat 4: King Sixtus ($58.87 in chips) 
Seat 5: pardama ($100 in chips) 
Seat 7: solbi86 ($100 in chips) 
Seat 8: matiko09 ($106.11 in chips) 
Seat 9: djammusic ($55.75 in chips) 
King Sixtus: posts small blind $0.50
pardama: posts big blind $1
hurtNCYDE: sits out 
*** HOLE CARDS ***
Dealt to matiko09 [3h 4h]
solbi86: folds 
matiko09: folds 
djammusic: folds 
Klappspaten0: raises $2 to $3
stepan0605: folds 
KovIFish89: folds 
King Sixtus: folds 
pardama: folds 
Uncalled bet ($2) returned to Klappspaten0
Klappspaten0 collected $2.50 from pot
Klappspaten0: doesn't show hand 
*** SUMMARY ***
Total pot $2.50 | Rake $0 
Seat 1: Klappspaten0 collected ($2.50)
Seat 2: stepan0605 folded before Flop (didn't bet)
Seat 3: KovIFish89 (button) folded before Flop (didn't bet)
Seat 4: King Sixtus (small blind) folded before Flop
Seat 5: pardama (big blind) folded before Flop
Seat 7: solbi86 folded before Flop (didn't bet)
Seat 8: matiko09 folded before Flop (didn't bet)
Seat 9: djammusic folded before Flop (didn't bet)





PokerStars Hand #155014699064:  Hold'em No Limit (€0.25/€0.50 EUR) - 2016/06/21 14:18:41 CET [2016/06/21 8:18:41 ET]
Table 'Lotis II' 6-max Seat #5 is the button
Seat 1: bustafc (€71.45 in chips) 
Seat 2: MoganB0y (€50.75 in chips) 
Seat 3: hmverlin (€46.29 in chips) 
Seat 4: IpMan13 (€87.20 in chips) 
Seat 5: heavyheight (€50 in chips) 
Seat 6: matiko09 (€56.81 in chips) 
matiko09: posts small blind €0.25
bustafc: posts big blind €0.50
*** HOLE CARDS ***
Dealt to matiko09 [Ac Jd]
MoganB0y: folds 
hmverlin: raises €1 to €1.50
IpMan13: folds 
heavyheight: folds 
matiko09: raises €4 to €5.50
bustafc: folds 
hmverlin: calls €4
*** FLOP *** [Tc Td Th]
matiko09: bets €3
hmverlin: raises €3 to €6
matiko09: calls €3
*** TURN *** [Tc Td Th] [2d]
matiko09: checks 
hmverlin: bets €5.50
matiko09: calls €5.50
*** RIVER *** [Tc Td Th 2d] [6h]
matiko09: checks 
hmverlin: bets €16.50
matiko09: folds 
Uncalled bet (€16.50) returned to hmverlin
hmverlin collected €32.78 from pot
hmverlin: doesn't show hand 
*** SUMMARY ***
Total pot €34.50 | Rake €1.72 
Board [Tc Td Th 2d 6h]
Seat 1: bustafc (big blind) folded before Flop
Seat 2: MoganB0y folded before Flop (didn't bet)
Seat 3: hmverlin collected (€32.78)
Seat 4: IpMan13 folded before Flop (didn't bet)
Seat 5: heavyheight (button) folded before Flop (didn't bet)
Seat 6: matiko09 (small blind) folded on the River





PokerStars Hand #155014701899:  Hold'em No Limit ($0.50/$1.00 USD) - 2016/06/21 14:18:47 CET [2016/06/21 8:18:47 ET]
Table 'Amundsenia' 9-max Seat #1 is the button
Seat 1: Troll8989 ($106.98 in chips) 
Seat 2: Avtovo ($100 in chips) 
Seat 3: matiko09 ($101.50 in chips) 
Seat 4: typename27 ($18.55 in chips) 
Seat 5: ozone2003 ($100 in chips) 
Seat 6: King_ZéManel ($125.31 in chips) 
Seat 7: Eskimo Fox ($107.65 in chips) 
Seat 8: DomiVY ($48.32 in chips) 
Seat 9: MrSeymen ($62.72 in chips) 
Avtovo: posts small blind $0.50
matiko09: posts big blind $1
*** HOLE CARDS ***
Dealt to matiko09 [4d 2d]
typename27: calls $1
ozone2003: raises $3 to $4
King_ZéManel: folds 
Eskimo Fox: folds 
DomiVY: folds 
MrSeymen: folds 
Troll8989: folds 
Avtovo: folds 
matiko09: folds 
typename27: calls $3
*** FLOP *** [7d Td 8h]
typename27: checks 
ozone2003: bets $4.51
typename27: calls $4.51
*** TURN *** [7d Td 8h] [7h]
typename27: checks 
ozone2003: checks 
*** RIVER *** [7d Td 8h 7h] [6s]
typename27: checks 
ozone2003: checks 
*** SHOW DOWN ***
typename27: shows [9d Jd] (a straight, Seven to Jack)
ozone2003: mucks hand 
typename27 collected $17.59 from pot
*** SUMMARY ***
Total pot $18.52 | Rake $0.93 
Board [7d Td 8h 7h 6s]
Seat 1: Troll8989 (button) folded before Flop (didn't bet)
Seat 2: Avtovo (small blind) folded before Flop
Seat 3: matiko09 (big blind) folded before Flop
Seat 4: typename27 showed [9d Jd] and won ($17.59) with a straight, Seven to Jack
Seat 5: ozone2003 mucked [Ks Qc]
Seat 6: King_ZéManel folded before Flop (didn't bet)
Seat 7: Eskimo Fox folded before Flop (didn't bet)
Seat 8: DomiVY folded before Flop (didn't bet)
Seat 9: MrSeymen folded before Flop (didn't bet)





PokerStars Hand #155014702595:  Hold'em No Limit ($0.50/$1.00 USD) - 2016/06/21 14:18:48 CET [2016/06/21 8:18:48 ET]
Table 'Schurer II' 9-max Seat #4 is the button
Seat 1: Dantist1122 ($104.12 in chips) 
Seat 2: havenots88 ($98.70 in chips) 
Seat 3: matiko09 ($115.35 in chips) 
Seat 4: hurtNCYDE ($106.40 in chips) 
Seat 5: riggedsh** ($117.30 in chips) 
Seat 6: Dödi123 ($118.89 in chips) 
Seat 7: Avtovo ($100 in chips) 
Seat 8: stepan0605 ($103 in chips) 
Seat 9: pardama ($100 in chips) 
riggedsh**: posts small blind $0.50
Dödi123: posts big blind $1
*** HOLE CARDS ***
Dealt to matiko09 [6s Qc]
Avtovo: raises $1.50 to $2.50
stepan0605: folds 
pardama: folds 
Dantist1122: folds 
havenots88: folds 
matiko09: folds 
hurtNCYDE: folds 
riggedsh**: folds 
Dödi123: folds 
Uncalled bet ($1.50) returned to Avtovo
Avtovo collected $2.50 from pot
Avtovo: doesn't show hand 
*** SUMMARY ***
Total pot $2.50 | Rake $0 
Seat 1: Dantist1122 folded before Flop (didn't bet)
Seat 2: havenots88 folded before Flop (didn't bet)
Seat 3: matiko09 folded before Flop (didn't bet)
Seat 4: hurtNCYDE (button) folded before Flop (didn't bet)
Seat 5: riggedsh** (small blind) folded before Flop
Seat 6: Dödi123 (big blind) folded before Flop
Seat 7: Avtovo collected ($2.50)
Seat 8: stepan0605 folded before Flop (didn't bet)
Seat 9: pardama folded before Flop (didn't bet)





PokerStars Hand #155014704562:  Hold'em No Limit ($0.50/$1.00 USD) - 2016/06/21 14:18:52 CET [2016/06/21 8:18:52 ET]
Table 'Saldanha' 9-max Seat #1 is the button
Seat 1: KovIFish89 ($100 in chips) 
Seat 3: matiko09 ($408.17 in chips) 
Seat 4: CoolFireX ($100 in chips) 
Seat 5: Troll8989 ($131.54 in chips) 
Seat 6: Juu2huu ($98.80 in chips) 
Seat 7: ozone2003 ($150.79 in chips) 
Seat 9: 23SmOkEr07 ($126.61 in chips) 
Filojoes will be allowed to play after the button
matiko09: posts small blind $0.50
CoolFireX: posts big blind $1
KovIFish89: posts the ante $0.20
matiko09: posts the ante $0.20
CoolFireX: posts the ante $0.20
Troll8989: posts the ante $0.20
Juu2huu: posts the ante $0.20
ozone2003: posts the ante $0.20
23SmOkEr07: posts the ante $0.20
*** HOLE CARDS ***
Dealt to matiko09 [6c 3c]
Troll8989: folds 
Juu2huu: folds 
ozone2003: folds 
23SmOkEr07: folds 
KovIFish89: raises $1 to $2
matiko09: folds 
CoolFireX: calls $1
*** FLOP *** [As 9h 2s]
CoolFireX: checks 
KovIFish89: checks 
*** TURN *** [As 9h 2s] [Td]
CoolFireX: checks 
KovIFish89: checks 
*** RIVER *** [As 9h 2s Td] [Kh]
CoolFireX: checks 
KovIFish89: bets $3.73
CoolFireX: folds 
Uncalled bet ($3.73) returned to KovIFish89
KovIFish89 collected $5.60 from pot
KovIFish89: doesn't show hand 
*** SUMMARY ***
Total pot $5.90 | Rake $0.30 
Board [As 9h 2s Td Kh]
Seat 1: KovIFish89 (button) collected ($5.60)
Seat 3: matiko09 (small blind) folded before Flop
Seat 4: CoolFireX (big blind) folded on the River
Seat 5: Troll8989 folded before Flop (didn't bet)
Seat 6: Juu2huu folded before Flop (didn't bet)
Seat 7: ozone2003 folded before Flop (didn't bet)
Seat 9: 23SmOkEr07 folded before Flop (didn't bet)





PokerStars Hand #155014705771:  Hold'em No Limit ($0.50/$1.00 USD) - 2016/06/21 14:18:55 CET [2016/06/21 8:18:55 ET]
Table 'Gryphia' 9-max Seat #4 is the button
Seat 1: Klappspaten0 ($114.16 in chips) 
Seat 2: stepan0605 ($185.82 in chips) 
Seat 3: KovIFish89 ($100 in chips) 
Seat 4: King Sixtus ($58.37 in chips) 
Seat 5: pardama ($100 in chips) 
Seat 6: hurtNCYDE ($100 in chips) 
Seat 7: solbi86 ($100 in chips) 
Seat 8: matiko09 ($106.11 in chips) 
Seat 9: djammusic ($55.75 in chips) 
pardama: posts small blind $0.50
hurtNCYDE: posts big blind $1
*** HOLE CARDS ***
Dealt to matiko09 [9h Jd]
solbi86: raises $2 to $3
matiko09: folds 
djammusic: folds 
Klappspaten0: folds 
stepan0605: folds 
KovIFish89: folds 
King Sixtus: raises $7.50 to $10.50
pardama: folds 
hurtNCYDE: folds 
solbi86: folds 
Uncalled bet ($7.50) returned to King Sixtus
King Sixtus collected $7.50 from pot
King Sixtus: doesn't show hand 
*** SUMMARY ***
Total pot $7.50 | Rake $0 
Seat 1: Klappspaten0 folded before Flop (didn't bet)
Seat 2: stepan0605 folded before Flop (didn't bet)
Seat 3: KovIFish89 folded before Flop (didn't bet)
Seat 4: King Sixtus (button) collected ($7.50)
Seat 5: pardama (small blind) folded before Flop
Seat 6: hurtNCYDE (big blind) folded before Flop
Seat 7: solbi86 folded before Flop
Seat 8: matiko09 folded before Flop (didn't bet)
Seat 9: djammusic folded before Flop (didn't bet)





PokerStars Hand #155014712338:  Hold'em No Limit ($0.50/$1.00 USD) - 2016/06/21 14:19:09 CET [2016/06/21 8:19:09 ET]
Table 'Schurer II' 9-max Seat #5 is the button
Seat 1: Dantist1122 ($104.12 in chips) 
Seat 2: havenots88 ($98.70 in chips) 
Seat 3: matiko09 ($115.35 in chips) 
Seat 4: hurtNCYDE ($106.40 in chips) 
Seat 5: riggedsh** ($116.80 in chips) 
Seat 6: Dödi123 ($117.89 in chips) 
Seat 7: Avtovo ($101.50 in chips) 
Seat 8: stepan0605 ($103 in chips) 
Seat 9: pardama ($100 in chips) 
Dödi123: posts small blind $0.50
Avtovo: posts big blind $1
*** HOLE CARDS ***
Dealt to matiko09 [9s Ac]
stepan0605: folds 
pardama: folds 
Dantist1122: raises $2 to $3
havenots88: folds 
matiko09: folds 
hurtNCYDE: folds 
riggedsh**: folds 
Dödi123: folds 
Avtovo: raises $7.50 to $10.50
Dantist1122: folds 
Uncalled bet ($7.50) returned to Avtovo
Avtovo collected $6.50 from pot
Avtovo: doesn't show hand 
*** SUMMARY ***
Total pot $6.50 | Rake $0 
Seat 1: Dantist1122 folded before Flop
Seat 2: havenots88 folded before Flop (didn't bet)
Seat 3: matiko09 folded before Flop (didn't bet)
Seat 4: hurtNCYDE folded before Flop (didn't bet)
Seat 5: riggedsh** (button) folded before Flop (didn't bet)
Seat 6: Dödi123 (small blind) folded before Flop
Seat 7: Avtovo (big blind) collected ($6.50)
Seat 8: stepan0605 folded before Flop (didn't bet)
Seat 9: pardama folded before Flop (didn't bet)





PokerStars Hand #155014720634:  Hold'em No Limit ($0.50/$1.00 USD) - 2016/06/21 14:19:26 CET [2016/06/21 8:19:26 ET]
Table 'Gryphia' 9-max Seat #5 is the button
Seat 1: Klappspaten0 ($114.16 in chips) 
Seat 2: stepan0605 ($185.82 in chips) 
Seat 3: KovIFish89 ($100 in chips) 
Seat 4: King Sixtus ($62.87 in chips) 
Seat 5: pardama ($100 in chips) 
Seat 6: hurtNCYDE ($100 in chips) 
Seat 7: solbi86 ($100 in chips) 
Seat 8: matiko09 ($106.11 in chips) 
Seat 9: djammusic ($55.75 in chips) 
hurtNCYDE: posts small blind $0.50
solbi86: posts big blind $1
*** HOLE CARDS ***
Dealt to matiko09 [Kd As]
matiko09: raises $2 to $3
djammusic: folds 
Klappspaten0: folds 
stepan0605: folds 
KovIFish89: folds 
King Sixtus: folds 
pardama: folds 
hurtNCYDE: folds 
solbi86: calls $2
*** FLOP *** [7c 3s Qd]
solbi86: checks 
matiko09: bets $4.02
solbi86: calls $4.02
*** TURN *** [7c 3s Qd] [Kh]
solbi86: checks 
matiko09: checks 
*** RIVER *** [7c 3s Qd Kh] [5s]
solbi86: bets $11
matiko09: calls $11
*** SHOW DOWN ***
solbi86: shows [7d 7h] (three of a kind, Sevens)
matiko09: mucks hand 
solbi86 collected $34.71 from pot
*** SUMMARY ***
Total pot $36.54 | Rake $1.83 
Board [7c 3s Qd Kh 5s]
Seat 1: Klappspaten0 folded before Flop (didn't bet)
Seat 2: stepan0605 folded before Flop (didn't bet)
Seat 3: KovIFish89 folded before Flop (didn't bet)
Seat 4: King Sixtus folded before Flop (didn't bet)
Seat 5: pardama (button) folded before Flop (didn't bet)
Seat 6: hurtNCYDE (small blind) folded before Flop
Seat 7: solbi86 (big blind) showed [7d 7h] and won ($34.71) with three of a kind, Sevens
Seat 8: matiko09 mucked [Kd As]
Seat 9: djammusic folded before Flop (didn't bet)





PokerStars Hand #155014724895:  Hold'em No Limit ($0.50/$1.00 USD) - 2016/06/21 14:19:36 CET [2016/06/21 8:19:36 ET]
Table 'Chromios' 9-max Seat #5 is the button
Seat 1: matiko09 ($121.20 in chips) 
Seat 2: pardama ($100 in chips) 
Seat 3: ozone2003 ($100 in chips) 
Seat 4: Eskimo Fox ($100 in chips) 
Seat 5: Donetsk1y ($120.84 in chips) 
Seat 6: Troll8989 ($110.16 in chips) 
Seat 7: chaps1988 ($181.85 in chips) 
Seat 8: carlosdankha ($72.43 in chips) 
Seat 9: Filojoes ($217.12 in chips) 
Troll8989: posts small blind $0.50
chaps1988: posts big blind $1
*** HOLE CARDS ***
Dealt to matiko09 [Jd 9c]
carlosdankha: calls $1
Filojoes: folds 
matiko09: folds 
pardama: raises $3 to $4
ozone2003: calls $4
Eskimo Fox: folds 
Donetsk1y: folds 
Troll8989: folds 
chaps1988: folds 
carlosdankha: raises $11 to $15
pardama: folds 
ozone2003: raises $85 to $100 and is all-in
carlosdankha: calls $57.43 and is all-in
Uncalled bet ($27.57) returned to ozone2003
*** FLOP *** [Qh 7c 8d]
*** TURN *** [Qh 7c 8d] [8c]
*** RIVER *** [Qh 7c 8d 8c] [5d]
*** SHOW DOWN ***
carlosdankha: shows [Kd Ks] (two pair, Kings and Eights)
ozone2003: shows [Jc Js] (two pair, Jacks and Eights)
carlosdankha collected $147.86 from pot
*** SUMMARY ***
Total pot $150.36 | Rake $2.50 
Board [Qh 7c 8d 8c 5d]
Seat 1: matiko09 folded before Flop (didn't bet)
Seat 2: pardama folded before Flop
Seat 3: ozone2003 showed [Jc Js] and lost with two pair, Jacks and Eights
Seat 4: Eskimo Fox folded before Flop (didn't bet)
Seat 5: Donetsk1y (button) folded before Flop (didn't bet)
Seat 6: Troll8989 (small blind) folded before Flop
Seat 7: chaps1988 (big blind) folded before Flop
Seat 8: carlosdankha showed [Kd Ks] and won ($147.86) with two pair, Kings and Eights
Seat 9: Filojoes folded before Flop (didn't bet)





PokerStars Hand #155014728534:  Hold'em No Limit ($0.50/$1.00 USD) - 2016/06/21 14:19:43 CET [2016/06/21 8:19:43 ET]
Table 'Schurer II' 9-max Seat #6 is the button
Seat 1: Dantist1122 ($101.12 in chips) 
Seat 2: havenots88 ($98.70 in chips) 
Seat 3: matiko09 ($115.35 in chips) 
Seat 4: hurtNCYDE ($106.40 in chips) 
Seat 5: riggedsh** ($116.80 in chips) 
Seat 6: Dödi123 ($117.39 in chips) 
Seat 7: Avtovo ($105 in chips) 
Seat 8: stepan0605 ($103 in chips) 
Seat 9: pardama ($100 in chips) 
Avtovo: posts small blind $0.50
stepan0605: posts big blind $1
*** HOLE CARDS ***
Dealt to matiko09 [9h 6h]
pardama: folds 
Dantist1122: folds 
havenots88: folds 
matiko09: folds 
hurtNCYDE: folds 
riggedsh**: raises $1.50 to $2.50
Dödi123: folds 
Avtovo: raises $6.50 to $9
stepan0605: folds 
riggedsh**: raises $13 to $22
Avtovo: folds 
Uncalled bet ($13) returned to riggedsh**
riggedsh** collected $19 from pot
riggedsh**: doesn't show hand 
*** SUMMARY ***
Total pot $19 | Rake $0 
Seat 1: Dantist1122 folded before Flop (didn't bet)
Seat 2: havenots88 folded before Flop (didn't bet)
Seat 3: matiko09 folded before Flop (didn't bet)
Seat 4: hurtNCYDE folded before Flop (didn't bet)
Seat 5: riggedsh** collected ($19)
Seat 6: Dödi123 (button) folded before Flop (didn't bet)
Seat 7: Avtovo (small blind) folded before Flop
Seat 8: stepan0605 (big blind) folded before Flop
Seat 9: pardama folded before Flop (didn't bet)





PokerStars Hand #155014739866:  Hold'em No Limit ($0.50/$1.00 USD) - 2016/06/21 14:20:07 CET [2016/06/21 8:20:07 ET]
Table 'Saldanha' 9-max Seat #3 is the button
Seat 1: KovIFish89 ($103.40 in chips) 
Seat 3: matiko09 ($407.47 in chips) 
Seat 4: CoolFireX ($100 in chips) 
Seat 5: Troll8989 ($131.34 in chips) 
Seat 6: Juu2huu ($98.60 in chips) 
Seat 7: ozone2003 ($150.59 in chips) 
Seat 9: 23SmOkEr07 ($126.41 in chips) 
CoolFireX: posts small blind $0.50
Troll8989: posts big blind $1
Filojoes: sits out 
KovIFish89: posts the ante $0.20
matiko09: posts the ante $0.20
CoolFireX: posts the ante $0.20
Troll8989: posts the ante $0.20
Juu2huu: posts the ante $0.20
ozone2003: posts the ante $0.20
23SmOkEr07: posts the ante $0.20
*** HOLE CARDS ***
Dealt to matiko09 [Jd 8d]
Juu2huu: raises $2 to $3
ozone2003: raises $6 to $9
23SmOkEr07: calls $9
KovIFish89: folds 
matiko09: folds 
CoolFireX: folds 
Troll8989: folds 
Juu2huu: calls $6
*** FLOP *** [Kc Qd 2c]
Juu2huu: checks 
ozone2003: checks 
23SmOkEr07: bets $17.50
Juu2huu: calls $17.50
ozone2003: folds 
*** TURN *** [Kc Qd 2c] [5c]
Juu2huu: checks 
23SmOkEr07: bets $37.50
Juu2huu: raises $34.40 to $71.90 and is all-in
23SmOkEr07: calls $34.40
*** RIVER *** [Kc Qd 2c 5c] [6d]
*** SHOW DOWN ***
Juu2huu: shows [9c Ac] (a flush, Ace high)
23SmOkEr07: shows [Ks Kh] (three of a kind, Kings)
Juu2huu collected $206.20 from pot
*** SUMMARY ***
Total pot $208.70 | Rake $2.50 
Board [Kc Qd 2c 5c 6d]
Seat 1: KovIFish89 folded before Flop (didn't bet)
Seat 3: matiko09 (button) folded before Flop (didn't bet)
Seat 4: CoolFireX (small blind) folded before Flop
Seat 5: Troll8989 (big blind) folded before Flop
Seat 6: Juu2huu showed [9c Ac] and won ($206.20) with a flush, Ace high
Seat 7: ozone2003 folded on the Flop
Seat 9: 23SmOkEr07 showed [Ks Kh] and lost with three of a kind, Kings





PokerStars Hand #155014741149:  Hold'em No Limit ($0.50/$1.00 USD) - 2016/06/21 14:20:10 CET [2016/06/21 8:20:10 ET]
Table 'Amundsenia' 9-max Seat #2 is the button
Seat 1: Troll8989 ($106.98 in chips) 
Seat 2: Avtovo ($100 in chips) 
Seat 3: matiko09 ($100.50 in chips) 
Seat 4: typename27 ($27.63 in chips) 
Seat 5: ozone2003 ($100 in chips) 
Seat 6: King_ZéManel ($125.31 in chips) 
Seat 7: Eskimo Fox ($107.65 in chips) 
Seat 8: DomiVY ($48.32 in chips) 
Seat 9: MrSeymen ($62.72 in chips) 
matiko09: posts small blind $0.50
typename27: posts big blind $1
*** HOLE CARDS ***
Dealt to matiko09 [2s Th]
ozone2003: raises $2 to $3
King_ZéManel: folds 
Eskimo Fox: folds 
DomiVY: folds 
MrSeymen: calls $3
Troll8989: folds 
Avtovo: folds 
matiko09: folds 
Troll8989 leaves the table
typename27: folds 
*** FLOP *** [3c Kh 7c]
mi$$I$Elena joins the table at seat #1 
ozone2003: checks 
MrSeymen: bets $5
ozone2003: folds 
Uncalled bet ($5) returned to MrSeymen
MrSeymen collected $7.12 from pot
*** SUMMARY ***
Total pot $7.50 | Rake $0.38 
Board [3c Kh 7c]
Seat 1: Troll8989 folded before Flop (didn't bet)
Seat 2: Avtovo (button) folded before Flop (didn't bet)
Seat 3: matiko09 (small blind) folded before Flop
Seat 4: typename27 (big blind) folded before Flop
Seat 5: ozone2003 folded on the Flop
Seat 6: King_ZéManel folded before Flop (didn't bet)
Seat 7: Eskimo Fox folded before Flop (didn't bet)
Seat 8: DomiVY folded before Flop (didn't bet)
Seat 9: MrSeymen collected ($7.12)





PokerStars Hand #155014741870:  Hold'em No Limit (€0.25/€0.50 EUR) - 2016/06/21 14:20:12 CET [2016/06/21 8:20:12 ET]
Table 'Lotis II' 6-max Seat #6 is the button
Seat 1: bustafc (€70.95 in chips) 
Seat 2: MoganB0y (€50.75 in chips) 
Seat 3: hmverlin (€62.07 in chips) 
Seat 4: IpMan13 (€87.20 in chips) 
Seat 5: heavyheight (€50 in chips) 
Seat 6: matiko09 (€50 in chips) 
bustafc: posts small blind €0.25
MoganB0y: posts big blind €0.50
*** HOLE CARDS ***
Dealt to matiko09 [2h 9d]
hmverlin: raises €1 to €1.50
IpMan13: raises €3 to €4.50
heavyheight: folds 
matiko09: folds 
bustafc: folds 
MoganB0y: raises €6.75 to €11.25
hmverlin: folds 
IpMan13: folds 
Uncalled bet (€6.75) returned to MoganB0y
MoganB0y collected €10.75 from pot
MoganB0y: doesn't show hand 
*** SUMMARY ***
Total pot €10.75 | Rake €0 
Seat 1: bustafc (small blind) folded before Flop
Seat 2: MoganB0y (big blind) collected (€10.75)
Seat 3: hmverlin folded before Flop
Seat 4: IpMan13 folded before Flop
Seat 5: heavyheight folded before Flop (didn't bet)
Seat 6: matiko09 (button) folded before Flop (didn't bet)





PokerStars Hand #155014742527:  Hold'em No Limit ($0.50/$1.00 USD) - 2016/06/21 14:20:13 CET [2016/06/21 8:20:13 ET]
Table 'Lamberta II' 9-max Seat #1 is the button
Seat 1: Avtovo ($100.95 in chips) 
Seat 2: pardama ($100 in chips) 
Seat 3: matiko09 ($101.18 in chips) 
Seat 4: Eskimo Fox ($101.58 in chips) 
Seat 5: CoolFireX ($126.28 in chips) 
Seat 7: 23SmOkEr07 ($208.33 in chips) 
Seat 8: stepan0605 ($100 in chips) 
Seat 9: Sjtu_Michael ($119.17 in chips) 
pardama: posts small blind $0.50
matiko09: posts big blind $1
*** HOLE CARDS ***
Dealt to matiko09 [Ks Kh]
Eskimo Fox: raises $1.50 to $2.50
CoolFireX: folds 
23SmOkEr07: folds 
stepan0605: folds 
Sjtu_Michael is disconnected 
Sjtu_Michael has timed out while disconnected
Sjtu_Michael: folds 
Avtovo: folds 
pardama: folds 
matiko09: raises $7.50 to $10
Eskimo Fox: folds 
Uncalled bet ($7.50) returned to matiko09
matiko09 collected $5.50 from pot
matiko09: doesn't show hand 
*** SUMMARY ***
Total pot $5.50 | Rake $0 
Seat 1: Avtovo (button) folded before Flop (didn't bet)
Seat 2: pardama (small blind) folded before Flop
Seat 3: matiko09 (big blind) collected ($5.50)
Seat 4: Eskimo Fox folded before Flop
Seat 5: CoolFireX folded before Flop (didn't bet)
Seat 7: 23SmOkEr07 folded before Flop (didn't bet)
Seat 8: stepan0605 folded before Flop (didn't bet)
Seat 9: Sjtu_Michael folded before Flop (didn't bet)





PokerStars Hand #155014755022:  Hold'em No Limit ($0.50/$1.00 USD) - 2016/06/21 14:20:40 CET [2016/06/21 8:20:40 ET]
Table 'Schurer II' 9-max Seat #7 is the button
Seat 1: Dantist1122 ($101.12 in chips) 
Seat 2: havenots88 ($98.70 in chips) 
Seat 3: matiko09 ($115.35 in chips) 
Seat 4: hurtNCYDE ($106.40 in chips) 
Seat 5: riggedsh** ($126.80 in chips) 
Seat 6: Dödi123 ($117.39 in chips) 
Seat 7: Avtovo ($100 in chips) 
Seat 8: stepan0605 ($102 in chips) 
Seat 9: pardama ($100 in chips) 
stepan0605: posts small blind $0.50
pardama: posts big blind $1
*** HOLE CARDS ***
Dealt to matiko09 [8s Ah]
Dantist1122: folds 
havenots88: folds 
matiko09: folds 
hurtNCYDE: folds 
riggedsh**: raises $2 to $3
Dödi123: folds 
Avtovo: folds 
stepan0605: folds 
pardama: folds 
Uncalled bet ($2) returned to riggedsh**
riggedsh** collected $2.50 from pot
riggedsh**: doesn't show hand 
*** SUMMARY ***
Total pot $2.50 | Rake $0 
Seat 1: Dantist1122 folded before Flop (didn't bet)
Seat 2: havenots88 folded before Flop (didn't bet)
Seat 3: matiko09 folded before Flop (didn't bet)
Seat 4: hurtNCYDE folded before Flop (didn't bet)
Seat 5: riggedsh** collected ($2.50)
Seat 6: Dödi123 folded before Flop (didn't bet)
Seat 7: Avtovo (button) folded before Flop (didn't bet)
Seat 8: stepan0605 (small blind) folded before Flop
Seat 9: pardama (big blind) folded before Flop





PokerStars Hand #155014759034:  Hold'em No Limit (€0.25/€0.50 EUR) - 2016/06/21 14:20:48 CET [2016/06/21 8:20:48 ET]
Table 'Lotis II' 6-max Seat #1 is the button
Seat 1: bustafc (€70.70 in chips) 
Seat 2: MoganB0y (€57 in chips) 
Seat 3: hmverlin (€60.57 in chips) 
Seat 4: IpMan13 (€82.70 in chips) 
Seat 5: heavyheight (€50 in chips) 
Seat 6: matiko09 (€50 in chips) 
MoganB0y: posts small blind €0.25
hmverlin: posts big blind €0.50
*** HOLE CARDS ***
Dealt to matiko09 [3d Qs]
IpMan13: folds 
heavyheight: folds 
matiko09: folds 
bustafc: raises €0.50 to €1
MoganB0y: folds 
hmverlin: calls €0.50
*** FLOP *** [6h 6d 5d]
hmverlin: checks 
bustafc: bets €1.34
hmverlin: raises €1.34 to €2.68
bustafc: calls €1.34
*** TURN *** [6h 6d 5d] [3h]
hmverlin: bets €2
bustafc: calls €2
*** RIVER *** [6h 6d 5d 3h] [4c]
hmverlin: checks 
bustafc: checks 
*** SHOW DOWN ***
hmverlin: shows [3c 2s] (a straight, Deuce to Six)
bustafc: mucks hand 
hmverlin collected €11.03 from pot
*** SUMMARY ***
Total pot €11.61 | Rake €0.58 
Board [6h 6d 5d 3h 4c]
Seat 1: bustafc (button) mucked [As Kc]
Seat 2: MoganB0y (small blind) folded before Flop
Seat 3: hmverlin (big blind) showed [3c 2s] and won (€11.03) with a straight, Deuce to Six
Seat 4: IpMan13 folded before Flop (didn't bet)
Seat 5: heavyheight folded before Flop (didn't bet)
Seat 6: matiko09 folded before Flop (didn't bet)





PokerStars Hand #155014760630:  Hold'em No Limit ($0.50/$1.00 USD) - 2016/06/21 14:20:51 CET [2016/06/21 8:20:51 ET]
Table 'Moreau' 9-max Seat #8 is the button
Seat 1: hurtNCYDE ($124.20 in chips) 
Seat 2: Avtovo ($116.25 in chips) 
Seat 3: matiko09 ($103.18 in chips) 
Seat 4: SharingaaN ($165.30 in chips) 
Seat 5: CoolFireX ($148.89 in chips) 
Seat 6: Troll8989 ($102.10 in chips) 
Seat 7: PanKwn15 ($42.32 in chips) 
Seat 8: mi$$I$Elena ($109.62 in chips) 
Seat 9: Toonersens ($89.56 in chips) 
Toonersens: posts small blind $0.50
hurtNCYDE: posts big blind $1
*** HOLE CARDS ***
Dealt to matiko09 [Td 4c]
Avtovo: folds 
matiko09: folds 
SharingaaN: folds 
CoolFireX: folds 
Troll8989: folds 
PanKwn15: folds 
mi$$I$Elena: folds 
Toonersens: raises $1 to $2
hurtNCYDE: calls $1
*** FLOP *** [7c 2d Jd]
Toonersens: checks 
hurtNCYDE: bets $2.50
Toonersens: folds 
Uncalled bet ($2.50) returned to hurtNCYDE
hurtNCYDE collected $3.80 from pot
*** SUMMARY ***
Total pot $4 | Rake $0.20 
Board [7c 2d Jd]
Seat 1: hurtNCYDE (big blind) collected ($3.80)
Seat 2: Avtovo folded before Flop (didn't bet)
Seat 3: matiko09 folded before Flop (didn't bet)
Seat 4: SharingaaN folded before Flop (didn't bet)
Seat 5: CoolFireX folded before Flop (didn't bet)
Seat 6: Troll8989 folded before Flop (didn't bet)
Seat 7: PanKwn15 folded before Flop (didn't bet)
Seat 8: mi$$I$Elena (button) folded before Flop (didn't bet)
Seat 9: Toonersens (small blind) folded on the Flop





PokerStars Hand #155014775634:  Hold'em No Limit ($0.50/$1.00 USD) - 2016/06/21 14:21:24 CET [2016/06/21 8:21:24 ET]
Table 'Lamberta II' 9-max Seat #2 is the button
Seat 1: Avtovo ($100.95 in chips) 
Seat 2: pardama ($100 in chips) 
Seat 3: matiko09 ($104.18 in chips) 
Seat 4: Eskimo Fox ($100 in chips) 
Seat 5: CoolFireX ($126.28 in chips) 
Seat 7: 23SmOkEr07 ($208.33 in chips) 
Seat 8: stepan0605 ($100 in chips) 
Seat 9: Sjtu_Michael ($119.17 in chips) 
matiko09: posts small blind $0.50
Eskimo Fox: posts big blind $1
*** HOLE CARDS ***
Dealt to matiko09 [Jc 2c]
CoolFireX: folds 
23SmOkEr07: folds 
stepan0605: folds 
Sjtu_Michael is disconnected 
Sjtu_Michael has timed out while disconnected
Sjtu_Michael: folds 
Avtovo: folds 
pardama: folds 
matiko09: folds 
Uncalled bet ($0.50) returned to Eskimo Fox
Eskimo Fox collected $1 from pot
Eskimo Fox: doesn't show hand 
*** SUMMARY ***
Total pot $1 | Rake $0 
Seat 1: Avtovo folded before Flop (didn't bet)
Seat 2: pardama (button) folded before Flop (didn't bet)
Seat 3: matiko09 (small blind) folded before Flop
Seat 4: Eskimo Fox (big blind) collected ($1)
Seat 5: CoolFireX folded before Flop (didn't bet)
Seat 7: 23SmOkEr07 folded before Flop (didn't bet)
Seat 8: stepan0605 folded before Flop (didn't bet)
Seat 9: Sjtu_Michael folded before Flop (didn't bet)





PokerStars Hand #155014775847:  Hold'em No Limit ($0.50/$1.00 USD) - 2016/06/21 14:21:24 CET [2016/06/21 8:21:24 ET]
Table 'Schurer II' 9-max Seat #8 is the button
Seat 1: Dantist1122 ($101.12 in chips) 
Seat 2: havenots88 ($98.70 in chips) 
Seat 3: matiko09 ($115.35 in chips) 
Seat 4: hurtNCYDE ($106.40 in chips) 
Seat 5: riggedsh** ($128.30 in chips) 
Seat 6: Dödi123 ($117.39 in chips) 
Seat 7: Avtovo ($100 in chips) 
Seat 8: stepan0605 ($101.50 in chips) 
Seat 9: pardama ($100 in chips) 
pardama: posts small blind $0.50
Dantist1122: posts big blind $1
*** HOLE CARDS ***
Dealt to matiko09 [7s Tc]
havenots88: folds 
matiko09: folds 
hurtNCYDE: raises $1 to $2
riggedsh**: folds 
Dödi123: raises $5 to $7
Avtovo: folds 
stepan0605: folds 
pardama: folds 
Dantist1122: folds 
hurtNCYDE: calls $5
*** FLOP *** [3d Th 2c]
hurtNCYDE: checks 
Dödi123: bets $8
hurtNCYDE: calls $8
*** TURN *** [3d Th 2c] [6h]
hurtNCYDE: checks 
Dödi123: checks 
*** RIVER *** [3d Th 2c 6h] [Td]
hurtNCYDE: bets $20.64
Dödi123: folds 
Uncalled bet ($20.64) returned to hurtNCYDE
hurtNCYDE collected $29.92 from pot
*** SUMMARY ***
Total pot $31.50 | Rake $1.58 
Board [3d Th 2c 6h Td]
Seat 1: Dantist1122 (big blind) folded before Flop
Seat 2: havenots88 folded before Flop (didn't bet)
Seat 3: matiko09 folded before Flop (didn't bet)
Seat 4: hurtNCYDE collected ($29.92)
Seat 5: riggedsh** folded before Flop (didn't bet)
Seat 6: Dödi123 folded on the River
Seat 7: Avtovo folded before Flop (didn't bet)
Seat 8: stepan0605 (button) folded before Flop (didn't bet)
Seat 9: pardama (small blind) folded before Flop





PokerStars Hand #155014777192:  Hold'em No Limit ($0.50/$1.00 USD) - 2016/06/21 14:21:27 CET [2016/06/21 8:21:27 ET]
Table 'Amundsenia' 9-max Seat #3 is the button
Seat 2: Avtovo ($100 in chips) 
Seat 3: matiko09 ($100 in chips) 
Seat 4: typename27 ($26.63 in chips) 
Seat 5: ozone2003 ($100 in chips) 
Seat 6: King_ZéManel ($125.31 in chips) 
Seat 7: Eskimo Fox ($107.65 in chips) 
Seat 8: DomiVY ($48.32 in chips) 
Seat 9: MrSeymen ($66.84 in chips) 
typename27: posts small blind $0.50
ozone2003: posts big blind $1
mi$$I$Elena: sits out 
*** HOLE CARDS ***
Dealt to matiko09 [Tc Td]
King_ZéManel: folds 
Eskimo Fox: folds 
DomiVY: raises $2 to $3
MrSeymen: folds 
Avtovo: folds 
matiko09: calls $3
typename27: folds 
ozone2003: raises $9 to $12
DomiVY: folds 
matiko09: calls $9
*** FLOP *** [Js 3s Ad]
ozone2003: checks 
matiko09: checks 
*** TURN *** [Js 3s Ad] [3d]
ozone2003: bets $18.08
matiko09: folds 
Uncalled bet ($18.08) returned to ozone2003
ozone2003 collected $26.12 from pot
ozone2003: doesn't show hand 
*** SUMMARY ***
Total pot $27.50 | Rake $1.38 
Board [Js 3s Ad 3d]
Seat 2: Avtovo folded before Flop (didn't bet)
Seat 3: matiko09 (button) folded on the Turn
Seat 4: typename27 (small blind) folded before Flop
Seat 5: ozone2003 (big blind) collected ($26.12)
Seat 6: King_ZéManel folded before Flop (didn't bet)
Seat 7: Eskimo Fox folded before Flop (didn't bet)
Seat 8: DomiVY folded before Flop
Seat 9: MrSeymen folded before Flop (didn't bet)





PokerStars Hand #155014781712:  Hold'em No Limit ($0.50/$1.00 USD) - 2016/06/21 14:21:37 CET [2016/06/21 8:21:37 ET]
Table 'Chromios' 9-max Seat #6 is the button
Seat 1: matiko09 ($121.20 in chips) 
Seat 2: pardama ($100 in chips) 
Seat 3: ozone2003 ($100 in chips) 
Seat 4: Eskimo Fox ($100 in chips) 
Seat 5: Donetsk1y ($120.84 in chips) 
Seat 6: Troll8989 ($109.66 in chips) 
Seat 7: chaps1988 ($180.85 in chips) 
Seat 8: carlosdankha ($147.86 in chips) 
Seat 9: Filojoes ($217.12 in chips) 
chaps1988: posts small blind $0.50
carlosdankha: posts big blind $1
*** HOLE CARDS ***
Dealt to matiko09 [Ts 2h]
Filojoes: raises $2 to $3
matiko09: folds 
pardama: folds 
ozone2003: folds 
Eskimo Fox: calls $3
Donetsk1y: folds 
Troll8989: folds 
chaps1988: folds 
carlosdankha: calls $2
*** FLOP *** [Js Qc Jd]
carlosdankha: checks 
Filojoes: checks 
Eskimo Fox: checks 
*** TURN *** [Js Qc Jd] [3c]
carlosdankha: checks 
Filojoes: checks 
Eskimo Fox: bets $7
carlosdankha: folds 
Filojoes: folds 
Uncalled bet ($7) returned to Eskimo Fox
Eskimo Fox collected $9.02 from pot
Eskimo Fox: doesn't show hand 
*** SUMMARY ***
Total pot $9.50 | Rake $0.48 
Board [Js Qc Jd 3c]
Seat 1: matiko09 folded before Flop (didn't bet)
Seat 2: pardama folded before Flop (didn't bet)
Seat 3: ozone2003 folded before Flop (didn't bet)
Seat 4: Eskimo Fox collected ($9.02)
Seat 5: Donetsk1y folded before Flop (didn't bet)
Seat 6: Troll8989 (button) folded before Flop (didn't bet)
Seat 7: chaps1988 (small blind) folded before Flop
Seat 8: carlosdankha (big blind) folded on the Turn
Seat 9: Filojoes folded on the Turn





PokerStars Hand #155014781788:  Hold'em No Limit (€0.25/€0.50 EUR) - 2016/06/21 14:21:37 CET [2016/06/21 8:21:37 ET]
Table 'Lotis II' 6-max Seat #2 is the button
Seat 1: bustafc (€65.02 in chips) 
Seat 2: MoganB0y (€56.75 in chips) 
Seat 3: hmverlin (€65.92 in chips) 
Seat 4: IpMan13 (€82.70 in chips) 
Seat 5: heavyheight (€50 in chips) 
Seat 6: matiko09 (€50 in chips) 
hmverlin: posts small blind €0.25
IpMan13: posts big blind €0.50
*** HOLE CARDS ***
Dealt to matiko09 [4s Th]
heavyheight: folds 
matiko09: folds 
bustafc: folds 
MoganB0y: folds 
hmverlin: raises €1 to €1.50
IpMan13: folds 
Uncalled bet (€1) returned to hmverlin
hmverlin collected €1 from pot
hmverlin: doesn't show hand 
*** SUMMARY ***
Total pot €1 | Rake €0 
Seat 1: bustafc folded before Flop (didn't bet)
Seat 2: MoganB0y (button) folded before Flop (didn't bet)
Seat 3: hmverlin (small blind) collected (€1)
Seat 4: IpMan13 (big blind) folded before Flop
Seat 5: heavyheight folded before Flop (didn't bet)
Seat 6: matiko09 folded before Flop (didn't bet)





PokerStars Hand #155014783923:  Hold'em No Limit ($0.50/$1.00 USD) - 2016/06/21 14:21:41 CET [2016/06/21 8:21:41 ET]
Table 'Moreau' 9-max Seat #1 is the button
Seat 1: hurtNCYDE ($126 in chips) 
Seat 2: Avtovo ($116.25 in chips) 
Seat 3: matiko09 ($103.18 in chips) 
Seat 4: SharingaaN ($165.30 in chips) 
Seat 5: CoolFireX ($148.89 in chips) 
Seat 6: Troll8989 ($102.10 in chips) 
Seat 7: PanKwn15 ($42.32 in chips) 
Seat 8: mi$$I$Elena ($109.62 in chips) 
Avtovo: posts small blind $0.50
matiko09: posts big blind $1
*** HOLE CARDS ***
Dealt to matiko09 [6h 4s]
SharingaaN: folds 
CoolFireX: folds 
Troll8989: folds 
PanKwn15: raises $2 to $3
mi$$I$Elena: folds 
hurtNCYDE: folds 
Avtovo: folds 
matiko09: folds 
Uncalled bet ($2) returned to PanKwn15
PanKwn15 collected $2.50 from pot
PanKwn15: doesn't show hand 
*** SUMMARY ***
Total pot $2.50 | Rake $0 
Seat 1: hurtNCYDE (button) folded before Flop (didn't bet)
Seat 2: Avtovo (small blind) folded before Flop
Seat 3: matiko09 (big blind) folded before Flop
Seat 4: SharingaaN folded before Flop (didn't bet)
Seat 5: CoolFireX folded before Flop (didn't bet)
Seat 6: Troll8989 folded before Flop (didn't bet)
Seat 7: PanKwn15 collected ($2.50)
Seat 8: mi$$I$Elena folded before Flop (didn't bet)





PokerStars Hand #155014786421:  Hold'em No Limit ($0.50/$1.00 USD) - 2016/06/21 14:21:47 CET [2016/06/21 8:21:47 ET]
Table 'Saldanha' 9-max Seat #4 is the button
Seat 1: KovIFish89 ($103.20 in chips) 
Seat 3: matiko09 ($407.27 in chips) 
Seat 4: CoolFireX ($100 in chips) 
Seat 5: Troll8989 ($130.14 in chips) 
Seat 6: Juu2huu ($206.20 in chips) 
Seat 7: ozone2003 ($141.39 in chips) 
Seat 9: 23SmOkEr07 ($100 in chips) 
Troll8989: posts small blind $0.50
Juu2huu: posts big blind $1
Filojoes: sits out 
KovIFish89: posts the ante $0.20
matiko09: posts the ante $0.20
CoolFireX: posts the ante $0.20
Troll8989: posts the ante $0.20
Juu2huu: posts the ante $0.20
ozone2003: posts the ante $0.20
23SmOkEr07: posts the ante $0.20
*** HOLE CARDS ***
Dealt to matiko09 [7c 3h]
ozone2003: raises $2 to $3
23SmOkEr07: raises $8.50 to $11.50
KovIFish89: folds 
matiko09: folds 
CoolFireX: folds 
Troll8989: folds 
Juu2huu: folds 
ozone2003: calls $8.50
*** FLOP *** [2s 2d 9s]
ozone2003: checks 
23SmOkEr07: checks 
*** TURN *** [2s 2d 9s] [8c]
ozone2003: bets $13.50
23SmOkEr07: calls $13.50
*** RIVER *** [2s 2d 9s 8c] [Kh]
ozone2003: checks 
23SmOkEr07: bets $33
ozone2003: calls $33
*** SHOW DOWN ***
23SmOkEr07: shows [Qd Jd] (a pair of Deuces)
ozone2003: shows [4d 4h] (two pair, Fours and Deuces)
ozone2003 collected $116.40 from pot
*** SUMMARY ***
Total pot $118.90 | Rake $2.50 
Board [2s 2d 9s 8c Kh]
Seat 1: KovIFish89 folded before Flop (didn't bet)
Seat 3: matiko09 folded before Flop (didn't bet)
Seat 4: CoolFireX (button) folded before Flop (didn't bet)
Seat 5: Troll8989 (small blind) folded before Flop
Seat 6: Juu2huu (big blind) folded before Flop
Seat 7: ozone2003 showed [4d 4h] and won ($116.40) with two pair, Fours and Deuces
Seat 9: 23SmOkEr07 showed [Qd Jd] and lost with a pair of Deuces





PokerStars Hand #155014793889:  Hold'em No Limit (€0.25/€0.50 EUR) - 2016/06/21 14:22:02 CET [2016/06/21 8:22:02 ET]
Table 'Lotis II' 6-max Seat #3 is the button
Seat 1: bustafc (€65.02 in chips) 
Seat 2: MoganB0y (€56.75 in chips) 
Seat 3: hmverlin (€66.42 in chips) 
Seat 4: IpMan13 (€82.20 in chips) 
Seat 5: heavyheight (€50 in chips) 
Seat 6: matiko09 (€50 in chips) 
IpMan13: posts small blind €0.25
heavyheight: posts big blind €0.50
*** HOLE CARDS ***
Dealt to matiko09 [7s 5c]
matiko09: folds 
bustafc: folds 
MoganB0y: folds 
hmverlin: folds 
IpMan13: folds 
Uncalled bet (€0.25) returned to heavyheight
heavyheight collected €0.50 from pot
*** SUMMARY ***
Total pot €0.50 | Rake €0 
Seat 1: bustafc folded before Flop (didn't bet)
Seat 2: MoganB0y folded before Flop (didn't bet)
Seat 3: hmverlin (button) folded before Flop (didn't bet)
Seat 4: IpMan13 (small blind) folded before Flop
Seat 5: heavyheight (big blind) collected (€0.50)
Seat 6: matiko09 folded before Flop (didn't bet)





PokerStars Hand #155014798702:  Hold'em No Limit (€0.25/€0.50 EUR) - 2016/06/21 14:22:12 CET [2016/06/21 8:22:12 ET]
Table 'Lotis II' 6-max Seat #4 is the button
Seat 1: bustafc (€65.02 in chips) 
Seat 2: MoganB0y (€56.75 in chips) 
Seat 3: hmverlin (€66.42 in chips) 
Seat 4: IpMan13 (€81.95 in chips) 
Seat 5: heavyheight (€50.25 in chips) 
Seat 6: matiko09 (€50 in chips) 
heavyheight: posts small blind €0.25
matiko09: posts big blind €0.50
*** HOLE CARDS ***
Dealt to matiko09 [Qh Ad]
bustafc: folds 
MoganB0y: folds 
hmverlin: raises €1 to €1.50
IpMan13: folds 
heavyheight: folds 
matiko09: raises €4 to €5.50
hmverlin: folds 
Uncalled bet (€4) returned to matiko09
matiko09 collected €3.25 from pot
matiko09: doesn't show hand 
*** SUMMARY ***
Total pot €3.25 | Rake €0 
Seat 1: bustafc folded before Flop (didn't bet)
Seat 2: MoganB0y folded before Flop (didn't bet)
Seat 3: hmverlin folded before Flop
Seat 4: IpMan13 (button) folded before Flop (didn't bet)
Seat 5: heavyheight (small blind) folded before Flop
Seat 6: matiko09 (big blind) collected (€3.25)





PokerStars Hand #155014799128:  Hold'em No Limit ($0.50/$1.00 USD) - 2016/06/21 14:22:13 CET [2016/06/21 8:22:13 ET]
Table 'Moreau' 9-max Seat #2 is the button
Seat 1: hurtNCYDE ($126 in chips) 
Seat 2: Avtovo ($115.75 in chips) 
Seat 3: matiko09 ($102.18 in chips) 
Seat 4: SharingaaN ($165.30 in chips) 
Seat 5: CoolFireX ($148.89 in chips) 
Seat 6: Troll8989 ($102.10 in chips) 
Seat 7: PanKwn15 ($43.82 in chips) 
Seat 8: mi$$I$Elena ($109.62 in chips) 
matiko09: posts small blind $0.50
SharingaaN: posts big blind $1
*** HOLE CARDS ***
Dealt to matiko09 [3h 9c]
CoolFireX: folds 
Troll8989: folds 
PanKwn15: folds 
mi$$I$Elena: folds 
hurtNCYDE: folds 
Avtovo: folds 
matiko09: folds 
Uncalled bet ($0.50) returned to SharingaaN
SharingaaN collected $1 from pot
SharingaaN: doesn't show hand 
*** SUMMARY ***
Total pot $1 | Rake $0 
Seat 1: hurtNCYDE folded before Flop (didn't bet)
Seat 2: Avtovo (button) folded before Flop (didn't bet)
Seat 3: matiko09 (small blind) folded before Flop
Seat 4: SharingaaN (big blind) collected ($1)
Seat 5: CoolFireX folded before Flop (didn't bet)
Seat 6: Troll8989 folded before Flop (didn't bet)
Seat 7: PanKwn15 folded before Flop (didn't bet)
Seat 8: mi$$I$Elena folded before Flop (didn't bet)





PokerStars Hand #155014801425:  Hold'em No Limit ($0.50/$1.00 USD) - 2016/06/21 14:22:18 CET [2016/06/21 8:22:18 ET]
Table 'Lamberta II' 9-max Seat #3 is the button
Seat 1: Avtovo ($100.95 in chips) 
Seat 2: pardama ($100 in chips) 
Seat 3: matiko09 ($103.68 in chips) 
Seat 4: Eskimo Fox ($100.50 in chips) 
Seat 5: CoolFireX ($126.28 in chips) 
Seat 7: 23SmOkEr07 ($208.33 in chips) 
Seat 8: stepan0605 ($100 in chips) 
Eskimo Fox: posts small blind $0.50
CoolFireX: posts big blind $1
*** HOLE CARDS ***
Dealt to matiko09 [4d Jd]
23SmOkEr07: folds 
stepan0605: folds 
Avtovo: folds 
pardama: folds 
matiko09: folds 
Eskimo Fox: raises $1.50 to $2.50
CoolFireX: calls $1.50
*** FLOP *** [2c 3c 9h]
Eskimo Fox: checks 
CoolFireX: bets $3.16
Eskimo Fox: folds 
Uncalled bet ($3.16) returned to CoolFireX
CoolFireX collected $4.75 from pot
CoolFireX: doesn't show hand 
*** SUMMARY ***
Total pot $5 | Rake $0.25 
Board [2c 3c 9h]
Seat 1: Avtovo folded before Flop (didn't bet)
Seat 2: pardama folded before Flop (didn't bet)
Seat 3: matiko09 (button) folded before Flop (didn't bet)
Seat 4: Eskimo Fox (small blind) folded on the Flop
Seat 5: CoolFireX (big blind) collected ($4.75)
Seat 7: 23SmOkEr07 folded before Flop (didn't bet)
Seat 8: stepan0605 folded before Flop (didn't bet)





PokerStars Hand #155014809623:  Hold'em No Limit (€0.25/€0.50 EUR) - 2016/06/21 14:22:36 CET [2016/06/21 8:22:36 ET]
Table 'Lotis II' 6-max Seat #5 is the button
Seat 1: bustafc (€65.02 in chips) 
Seat 2: MoganB0y (€56.75 in chips) 
Seat 3: hmverlin (€64.92 in chips) 
Seat 4: IpMan13 (€81.95 in chips) 
Seat 5: heavyheight (€50 in chips) 
Seat 6: matiko09 (€51.75 in chips) 
matiko09: posts small blind €0.25
bustafc: posts big blind €0.50
*** HOLE CARDS ***
Dealt to matiko09 [Ks 6d]
MoganB0y: folds 
hmverlin: folds 
IpMan13: raises €0.75 to €1.25
heavyheight: folds 
matiko09: folds 
bustafc: folds 
Uncalled bet (€0.75) returned to IpMan13
IpMan13 collected €1.25 from pot
IpMan13: doesn't show hand 
*** SUMMARY ***
Total pot €1.25 | Rake €0 
Seat 1: bustafc (big blind) folded before Flop
Seat 2: MoganB0y folded before Flop (didn't bet)
Seat 3: hmverlin folded before Flop (didn't bet)
Seat 4: IpMan13 collected (€1.25)
Seat 5: heavyheight (button) folded before Flop (didn't bet)
Seat 6: matiko09 (small blind) folded before Flop





PokerStars Hand #155014811780:  Hold'em No Limit ($0.50/$1.00 USD) - 2016/06/21 14:22:40 CET [2016/06/21 8:22:40 ET]
Table 'Moreau' 9-max Seat #3 is the button
Seat 1: hurtNCYDE ($126 in chips) 
Seat 2: Avtovo ($115.75 in chips) 
Seat 3: matiko09 ($101.68 in chips) 
Seat 4: SharingaaN ($165.80 in chips) 
Seat 5: CoolFireX ($148.89 in chips) 
Seat 6: Troll8989 ($102.10 in chips) 
Seat 7: PanKwn15 ($43.82 in chips) 
Seat 8: mi$$I$Elena ($109.62 in chips) 
SharingaaN: posts small blind $0.50
CoolFireX: posts big blind $1
*** HOLE CARDS ***
Dealt to matiko09 [9c Ah]
Troll8989: folds 
PanKwn15: raises $1 to $2
mi$$I$Elena: folds 
hurtNCYDE: folds 
Avtovo: folds 
matiko09: folds 
SharingaaN: raises $8 to $10
CoolFireX: folds 
PanKwn15: calls $8
*** FLOP *** [9d 5s Jc]
SharingaaN: checks 
PanKwn15: bets $33.82 and is all-in
SharingaaN: calls $33.82
*** TURN *** [9d 5s Jc] [4h]
*** RIVER *** [9d 5s Jc 4h] [Kd]
*** SHOW DOWN ***
SharingaaN: shows [Kc As] (a pair of Kings)
PanKwn15: shows [8d 5d] (a pair of Fives)
SharingaaN collected $86.14 from pot
*** SUMMARY ***
Total pot $88.64 | Rake $2.50 
Board [9d 5s Jc 4h Kd]
Seat 1: hurtNCYDE folded before Flop (didn't bet)
Seat 2: Avtovo folded before Flop (didn't bet)
Seat 3: matiko09 (button) folded before Flop (didn't bet)
Seat 4: SharingaaN (small blind) showed [Kc As] and won ($86.14) with a pair of Kings
Seat 5: CoolFireX (big blind) folded before Flop
Seat 6: Troll8989 folded before Flop (didn't bet)
Seat 7: PanKwn15 showed [8d 5d] and lost with a pair of Fives
Seat 8: mi$$I$Elena folded before Flop (didn't bet)





PokerStars Hand #155014816702:  Hold'em No Limit ($0.50/$1.00 USD) - 2016/06/21 14:22:50 CET [2016/06/21 8:22:50 ET]
Table 'Amundsenia' 9-max Seat #4 is the button
Seat 2: Avtovo ($100 in chips) 
Seat 3: matiko09 ($100 in chips) 
Seat 4: typename27 ($26.13 in chips) 
Seat 5: ozone2003 ($114.12 in chips) 
Seat 6: King_ZéManel ($125.31 in chips) 
Seat 7: Eskimo Fox ($107.65 in chips) 
Seat 8: DomiVY ($45.32 in chips) 
Seat 9: MrSeymen ($66.84 in chips) 
ozone2003: posts small blind $0.50
King_ZéManel: posts big blind $1
mi$$I$Elena: sits out 
*** HOLE CARDS ***
Dealt to matiko09 [As 9s]
Eskimo Fox: raises $2 to $3
DomiVY: folds 
MrSeymen has timed out
MrSeymen: folds 
Avtovo: folds 
matiko09: folds 
typename27: folds 
ozone2003: folds 
King_ZéManel: folds 
Uncalled bet ($2) returned to Eskimo Fox
Eskimo Fox collected $2.50 from pot
Eskimo Fox: doesn't show hand 
*** SUMMARY ***
Total pot $2.50 | Rake $0 
Seat 2: Avtovo folded before Flop (didn't bet)
Seat 3: matiko09 folded before Flop (didn't bet)
Seat 4: typename27 (button) folded before Flop (didn't bet)
Seat 5: ozone2003 (small blind) folded before Flop
Seat 6: King_ZéManel (big blind) folded before Flop
Seat 7: Eskimo Fox collected ($2.50)
Seat 8: DomiVY folded before Flop (didn't bet)
Seat 9: MrSeymen folded before Flop (didn't bet)





PokerStars Hand #155014820131:  Hold'em No Limit ($0.50/$1.00 USD) - 2016/06/21 14:22:58 CET [2016/06/21 8:22:58 ET]
Table 'Chromios' 9-max Seat #7 is the button
Seat 1: matiko09 ($121.20 in chips) 
Seat 2: pardama ($100 in chips) 
Seat 3: ozone2003 ($100 in chips) 
Seat 4: Eskimo Fox ($106.02 in chips) 
Seat 5: Donetsk1y ($120.84 in chips) 
Seat 6: Troll8989 ($109.66 in chips) 
Seat 7: chaps1988 ($180.35 in chips) 
Seat 8: carlosdankha ($144.86 in chips) 
Seat 9: Filojoes ($214.12 in chips) 
carlosdankha: posts small blind $0.50
Filojoes: posts big blind $1
*** HOLE CARDS ***
Dealt to matiko09 [Js Qs]
matiko09: raises $2 to $3
pardama: folds 
ozone2003: folds 
Eskimo Fox: folds 
Donetsk1y: folds 
Troll8989: folds 
chaps1988: folds 
carlosdankha: folds 
Filojoes: folds 
Uncalled bet ($2) returned to matiko09
matiko09 collected $2.50 from pot
matiko09: doesn't show hand 
*** SUMMARY ***
Total pot $2.50 | Rake $0 
Seat 1: matiko09 collected ($2.50)
Seat 2: pardama folded before Flop (didn't bet)
Seat 3: ozone2003 folded before Flop (didn't bet)
Seat 4: Eskimo Fox folded before Flop (didn't bet)
Seat 5: Donetsk1y folded before Flop (didn't bet)
Seat 6: Troll8989 folded before Flop (didn't bet)
Seat 7: chaps1988 (button) folded before Flop (didn't bet)
Seat 8: carlosdankha (small blind) folded before Flop
Seat 9: Filojoes (big blind) folded before Flop





PokerStars Hand #155014822379:  Hold'em No Limit (€0.25/€0.50 EUR) - 2016/06/21 14:23:02 CET [2016/06/21 8:23:02 ET]
Table 'Lotis II' 6-max Seat #6 is the button
Seat 1: bustafc (€64.52 in chips) 
Seat 2: MoganB0y (€56.75 in chips) 
Seat 3: hmverlin (€64.92 in chips) 
Seat 4: IpMan13 (€82.70 in chips) 
Seat 5: heavyheight (€50 in chips) 
Seat 6: matiko09 (€51.50 in chips) 
bustafc: posts small blind €0.25
MoganB0y: posts big blind €0.50
*** HOLE CARDS ***
Dealt to matiko09 [3d 7d]
hmverlin: folds 
IpMan13: raises €1 to €1.50
heavyheight: calls €1.50
matiko09: folds 
bustafc: folds 
MoganB0y: folds 
*** FLOP *** [Js 6c 2h]
IpMan13: bets €2.50
heavyheight: calls €2.50
*** TURN *** [Js 6c 2h] [Jc]
IpMan13: checks 
heavyheight: checks 
*** RIVER *** [Js 6c 2h Jc] [8h]
IpMan13: checks 
heavyheight: bets €6
IpMan13: folds 
Uncalled bet (€6) returned to heavyheight
heavyheight collected €8.31 from pot
*** SUMMARY ***
Total pot €8.75 | Rake €0.44 
Board [Js 6c 2h Jc 8h]
Seat 1: bustafc (small blind) folded before Flop
Seat 2: MoganB0y (big blind) folded before Flop
Seat 3: hmverlin folded before Flop (didn't bet)
Seat 4: IpMan13 folded on the River
Seat 5: heavyheight collected (€8.31)
Seat 6: matiko09 (button) folded before Flop (didn't bet)





PokerStars Hand #155014823648:  Hold'em No Limit ($0.50/$1.00 USD) - 2016/06/21 14:23:05 CET [2016/06/21 8:23:05 ET]
Table 'Schurer II' 9-max Seat #9 is the button
Seat 1: Dantist1122 ($100.12 in chips) 
Seat 2: havenots88 ($98.70 in chips) 
Seat 3: matiko09 ($115.35 in chips) 
Seat 4: hurtNCYDE ($121.32 in chips) 
Seat 5: riggedsh** ($128.30 in chips) 
Seat 6: Dödi123 ($102.39 in chips) 
Seat 7: Avtovo ($100 in chips) 
Seat 8: stepan0605 ($101.50 in chips) 
Seat 9: pardama ($100 in chips) 
Dantist1122: posts small blind $0.50
havenots88: posts big blind $1
*** HOLE CARDS ***
Dealt to matiko09 [6s 3s]
matiko09: folds 
hurtNCYDE: folds 
riggedsh**: folds 
Dödi123: folds 
Avtovo: folds 
stepan0605: raises $1 to $2
pardama: folds 
Dantist1122: folds 
havenots88: calls $1
*** FLOP *** [Td Jh Js]
havenots88: checks 
stepan0605: checks 
*** TURN *** [Td Jh Js] [8c]
havenots88: checks 
stepan0605: checks 
*** RIVER *** [Td Jh Js 8c] [8h]
havenots88: bets $4.28
stepan0605: calls $4.28
*** SHOW DOWN ***
havenots88: shows [8s 5c] (a full house, Eights full of Jacks)
stepan0605: shows [8d 6d] (a full house, Eights full of Jacks)
havenots88 collected $6.21 from pot
stepan0605 collected $6.20 from pot
*** SUMMARY ***
Total pot $13.06 | Rake $0.65 
Board [Td Jh Js 8c 8h]
Seat 1: Dantist1122 (small blind) folded before Flop
Seat 2: havenots88 (big blind) showed [8s 5c] and won ($6.21) with a full house, Eights full of Jacks
Seat 3: matiko09 folded before Flop (didn't bet)
Seat 4: hurtNCYDE folded before Flop (didn't bet)
Seat 5: riggedsh** folded before Flop (didn't bet)
Seat 6: Dödi123 folded before Flop (didn't bet)
Seat 7: Avtovo folded before Flop (didn't bet)
Seat 8: stepan0605 showed [8d 6d] and won ($6.20) with a full house, Eights full of Jacks
Seat 9: pardama (button) folded before Flop (didn't bet)





PokerStars Hand #155014837069:  Hold'em No Limit ($0.50/$1.00 USD) - 2016/06/21 14:23:33 CET [2016/06/21 8:23:33 ET]
Table 'Chromios' 9-max Seat #8 is the button
Seat 1: matiko09 ($122.70 in chips) 
Seat 2: pardama ($100 in chips) 
Seat 3: ozone2003 ($100 in chips) 
Seat 4: Eskimo Fox ($106.02 in chips) 
Seat 5: Donetsk1y ($120.84 in chips) 
Seat 6: Troll8989 ($109.66 in chips) 
Seat 7: chaps1988 ($180.35 in chips) 
Seat 8: carlosdankha ($144.36 in chips) 
Seat 9: Filojoes ($213.12 in chips) 
Filojoes: posts small blind $0.50
matiko09: posts big blind $1
*** HOLE CARDS ***
Dealt to matiko09 [8c Ah]
pardama: folds 
ozone2003: folds 
Eskimo Fox: folds 
Donetsk1y: folds 
Troll8989: folds 
chaps1988: raises $1.06 to $2.06
carlosdankha: folds 
Filojoes: calls $1.56
matiko09: calls $1.06
*** FLOP *** [Kd Kh 2h]
Filojoes: checks 
matiko09: checks 
chaps1988: bets $3.91
Filojoes: folds 
matiko09: folds 
Uncalled bet ($3.91) returned to chaps1988
chaps1988 collected $5.87 from pot
chaps1988: doesn't show hand 
*** SUMMARY ***
Total pot $6.18 | Rake $0.31 
Board [Kd Kh 2h]
Seat 1: matiko09 (big blind) folded on the Flop
Seat 2: pardama folded before Flop (didn't bet)
Seat 3: ozone2003 folded before Flop (didn't bet)
Seat 4: Eskimo Fox folded before Flop (didn't bet)
Seat 5: Donetsk1y folded before Flop (didn't bet)
Seat 6: Troll8989 folded before Flop (didn't bet)
Seat 7: chaps1988 collected ($5.87)
Seat 8: carlosdankha (button) folded before Flop (didn't bet)
Seat 9: Filojoes (small blind) folded on the Flop





PokerStars Hand #155014837547:  Hold'em No Limit ($0.50/$1.00 USD) - 2016/06/21 14:23:34 CET [2016/06/21 8:23:34 ET]
Table 'Saldanha' 9-max Seat #5 is the button
Seat 1: KovIFish89 ($103 in chips) 
Seat 3: matiko09 ($407.07 in chips) 
Seat 4: CoolFireX ($100 in chips) 
Seat 5: Troll8989 ($129.44 in chips) 
Seat 6: Juu2huu ($205 in chips) 
Seat 7: ozone2003 ($199.59 in chips) 
Seat 9: 23SmOkEr07 ($100 in chips) 
Juu2huu: posts small blind $0.50
ozone2003: posts big blind $1
Filojoes: sits out 
KovIFish89: posts the ante $0.20
matiko09: posts the ante $0.20
CoolFireX: posts the ante $0.20
Troll8989: posts the ante $0.20
Juu2huu: posts the ante $0.20
ozone2003: posts the ante $0.20
23SmOkEr07: posts the ante $0.20
*** HOLE CARDS ***
Dealt to matiko09 [6s 7h]
23SmOkEr07: folds 
KovIFish89: folds 
matiko09: folds 
CoolFireX: raises $1.50 to $2.50
Troll8989: calls $2.50
Juu2huu: folds 
ozone2003: folds 
*** FLOP *** [Td 6c As]
CoolFireX: checks 
Troll8989: checks 
*** TURN *** [Td 6c As] [Kd]
CoolFireX: bets $5.50
Troll8989: folds 
Uncalled bet ($5.50) returned to CoolFireX
CoolFireX collected $7.50 from pot
CoolFireX: doesn't show hand 
*** SUMMARY ***
Total pot $7.90 | Rake $0.40 
Board [Td 6c As Kd]
Seat 1: KovIFish89 folded before Flop (didn't bet)
Seat 3: matiko09 folded before Flop (didn't bet)
Seat 4: CoolFireX collected ($7.50)
Seat 5: Troll8989 (button) folded on the Turn
Seat 6: Juu2huu (small blind) folded before Flop
Seat 7: ozone2003 (big blind) folded before Flop
Seat 9: 23SmOkEr07 folded before Flop (didn't bet)





PokerStars Hand #155014838287:  Hold'em No Limit (€0.25/€0.50 EUR) - 2016/06/21 14:23:36 CET [2016/06/21 8:23:36 ET]
Table 'Actor II' 6-max Seat #2 is the button
Seat 1: BNNJH (€62.07 in chips) 
Seat 2: po0hhh (€39.25 in chips) 
Seat 3: DaSshit (€58.61 in chips) 
Seat 4: matiko09 (€80.55 in chips) 
Seat 6: ooak182 (€50.75 in chips) 
DaSshit: posts small blind €0.25
matiko09: posts big blind €0.50
*** HOLE CARDS ***
Dealt to matiko09 [As Ks]
ooak182: folds 
BNNJH: folds 
po0hhh: folds 
DaSshit: raises €0.75 to €1.25
matiko09: raises €3.25 to €4.50
DaSshit: folds 
Uncalled bet (€3.25) returned to matiko09
matiko09 collected €2.50 from pot
matiko09: doesn't show hand 
*** SUMMARY ***
Total pot €2.50 | Rake €0 
Seat 1: BNNJH folded before Flop (didn't bet)
Seat 2: po0hhh (button) folded before Flop (didn't bet)
Seat 3: DaSshit (small blind) folded before Flop
Seat 4: matiko09 (big blind) collected (€2.50)
Seat 6: ooak182 folded before Flop (didn't bet)





PokerStars Hand #155014840716:  Hold'em No Limit ($0.50/$1.00 USD) - 2016/06/21 14:23:41 CET [2016/06/21 8:23:41 ET]
Table 'Amundsenia' 9-max Seat #5 is the button
Seat 2: Avtovo ($100 in chips) 
Seat 3: matiko09 ($100 in chips) 
Seat 4: typename27 ($26.13 in chips) 
Seat 5: ozone2003 ($113.62 in chips) 
Seat 6: King_ZéManel ($124.31 in chips) 
Seat 7: Eskimo Fox ($109.15 in chips) 
Seat 8: DomiVY ($45.32 in chips) 
Seat 9: MrSeymen ($66.84 in chips) 
King_ZéManel: posts small blind $0.50
Eskimo Fox: posts big blind $1
mi$$I$Elena: sits out 
*** HOLE CARDS ***
Dealt to matiko09 [2s 9c]
DomiVY: raises $2 to $3
MrSeymen has timed out
MrSeymen: folds 
Avtovo: folds 
matiko09: folds 
typename27: folds 
ozone2003: folds 
King_ZéManel: folds 
Eskimo Fox: calls $2
*** FLOP *** [Kd 7d 4s]
Eskimo Fox: checks 
DomiVY: bets $4.50
Eskimo Fox: folds 
Uncalled bet ($4.50) returned to DomiVY
DomiVY collected $6.18 from pot
DomiVY: doesn't show hand 
*** SUMMARY ***
Total pot $6.50 | Rake $0.32 
Board [Kd 7d 4s]
Seat 2: Avtovo folded before Flop (didn't bet)
Seat 3: matiko09 folded before Flop (didn't bet)
Seat 4: typename27 folded before Flop (didn't bet)
Seat 5: ozone2003 (button) folded before Flop (didn't bet)
Seat 6: King_ZéManel (small blind) folded before Flop
Seat 7: Eskimo Fox (big blind) folded on the Flop
Seat 8: DomiVY collected ($6.18)
Seat 9: MrSeymen folded before Flop (didn't bet)





PokerStars Hand #155014842303:  Hold'em No Limit ($0.50/$1.00 USD) - 2016/06/21 14:23:44 CET [2016/06/21 8:23:44 ET]
Table 'Moreau' 9-max Seat #4 is the button
Seat 1: hurtNCYDE ($126 in chips) 
Seat 2: Avtovo ($115.75 in chips) 
Seat 3: matiko09 ($101.68 in chips) 
Seat 4: SharingaaN ($208.12 in chips) 
Seat 5: CoolFireX ($147.89 in chips) 
Seat 6: Troll8989 ($102.10 in chips) 
Seat 8: mi$$I$Elena ($109.62 in chips) 
CoolFireX: posts small blind $0.50
Troll8989: posts big blind $1
*** HOLE CARDS ***
Dealt to matiko09 [6d 3s]
mi$$I$Elena: folds 
hurtNCYDE: raises $1.50 to $2.50
PanKwn15 leaves the table
chaps1988 joins the table at seat #7 
Avtovo: folds 
matiko09: folds 
SharingaaN: folds 
CoolFireX: folds 
Troll8989: folds 
Uncalled bet ($1.50) returned to hurtNCYDE
hurtNCYDE collected $2.50 from pot
*** SUMMARY ***
Total pot $2.50 | Rake $0 
Seat 1: hurtNCYDE collected ($2.50)
Seat 2: Avtovo folded before Flop (didn't bet)
Seat 3: matiko09 folded before Flop (didn't bet)
Seat 4: SharingaaN (button) folded before Flop (didn't bet)
Seat 5: CoolFireX (small blind) folded before Flop
Seat 6: Troll8989 (big blind) folded before Flop
Seat 8: mi$$I$Elena folded before Flop (didn't bet)





PokerStars Hand #155014844959:  Hold'em No Limit ($0.50/$1.00 USD) - 2016/06/21 14:23:50 CET [2016/06/21 8:23:50 ET]
Table 'Lamberta II' 9-max Seat #4 is the button
Seat 1: Avtovo ($100.95 in chips) 
Seat 2: pardama ($100 in chips) 
Seat 3: matiko09 ($103.68 in chips) 
Seat 4: Eskimo Fox ($100 in chips) 
Seat 5: CoolFireX ($128.53 in chips) 
Seat 7: 23SmOkEr07 ($208.33 in chips) 
Seat 8: stepan0605 ($100 in chips) 
CoolFireX: posts small blind $0.50
23SmOkEr07: posts big blind $1
*** HOLE CARDS ***
Dealt to matiko09 [9c 2h]
stepan0605: raises $1 to $2
Avtovo: folds 
pardama: folds 
matiko09: folds 
Eskimo Fox: folds 
CoolFireX: folds 
23SmOkEr07: calls $1
*** FLOP *** [7h 9d 7c]
23SmOkEr07: checks 
stepan0605: checks 
*** TURN *** [7h 9d 7c] [Jh]
23SmOkEr07: checks 
stepan0605: checks 
*** RIVER *** [7h 9d 7c Jh] [3h]
23SmOkEr07: checks 
stepan0605: checks 
*** SHOW DOWN ***
23SmOkEr07: shows [4c 2c] (a pair of Sevens)
stepan0605: shows [Qh Ad] (a pair of Sevens - Ace kicker)
stepan0605 collected $4.28 from pot
*** SUMMARY ***
Total pot $4.50 | Rake $0.22 
Board [7h 9d 7c Jh 3h]
Seat 1: Avtovo folded before Flop (didn't bet)
Seat 2: pardama folded before Flop (didn't bet)
Seat 3: matiko09 folded before Flop (didn't bet)
Seat 4: Eskimo Fox (button) folded before Flop (didn't bet)
Seat 5: CoolFireX (small blind) folded before Flop
Seat 7: 23SmOkEr07 (big blind) showed [4c 2c] and lost with a pair of Sevens
Seat 8: stepan0605 showed [Qh Ad] and won ($4.28) with a pair of Sevens





PokerStars Hand #155014848121:  Hold'em No Limit (€0.25/€0.50 EUR) - 2016/06/21 14:23:56 CET [2016/06/21 8:23:56 ET]
Table 'Actor II' 6-max Seat #3 is the button
Seat 1: BNNJH (€62.07 in chips) 
Seat 2: po0hhh (€39.25 in chips) 
Seat 3: DaSshit (€57.36 in chips) 
Seat 4: matiko09 (€81.80 in chips) 
Seat 6: ooak182 (€50.75 in chips) 
matiko09: posts small blind €0.25
ooak182: posts big blind €0.50
*** HOLE CARDS ***
Dealt to matiko09 [Th 4d]
BNNJH: folds 
po0hhh: raises €1 to €1.50
DaSshit: folds 
matiko09: folds 
ooak182: folds 
Uncalled bet (€1) returned to po0hhh
po0hhh collected €1.25 from pot
po0hhh: doesn't show hand 
*** SUMMARY ***
Total pot €1.25 | Rake €0 
Seat 1: BNNJH folded before Flop (didn't bet)
Seat 2: po0hhh collected (€1.25)
Seat 3: DaSshit (button) folded before Flop (didn't bet)
Seat 4: matiko09 (small blind) folded before Flop
Seat 6: ooak182 (big blind) folded before Flop





PokerStars Hand #155014852630:  Hold'em No Limit (€0.25/€0.50 EUR) - 2016/06/21 14:24:06 CET [2016/06/21 8:24:06 ET]
Table 'Lotis II' 6-max Seat #1 is the button
Seat 1: bustafc (€64.27 in chips) 
Seat 2: MoganB0y (€56.25 in chips) 
Seat 3: hmverlin (€64.92 in chips) 
Seat 4: IpMan13 (€78.70 in chips) 
Seat 5: heavyheight (€54.31 in chips) 
Seat 6: matiko09 (€51.50 in chips) 
MoganB0y: posts small blind €0.25
hmverlin: posts big blind €0.50
*** HOLE CARDS ***
Dealt to matiko09 [5s Ah]
IpMan13: folds 
heavyheight: folds 
matiko09: raises €1 to €1.50
bustafc: folds 
MoganB0y: folds 
hmverlin: calls €1
*** FLOP *** [3c Qs 7c]
hmverlin: checks 
matiko09: checks 
*** TURN *** [3c Qs 7c] [Kh]
hmverlin: bets €1.50
matiko09: folds 
Uncalled bet (€1.50) returned to hmverlin
hmverlin collected €3.09 from pot
hmverlin: doesn't show hand 
*** SUMMARY ***
Total pot €3.25 | Rake €0.16 
Board [3c Qs 7c Kh]
Seat 1: bustafc (button) folded before Flop (didn't bet)
Seat 2: MoganB0y (small blind) folded before Flop
Seat 3: hmverlin (big blind) collected (€3.09)
Seat 4: IpMan13 folded before Flop (didn't bet)
Seat 5: heavyheight folded before Flop (didn't bet)
Seat 6: matiko09 folded on the Turn





PokerStars Hand #155014853106:  Hold'em No Limit ($0.50/$1.00 USD) - 2016/06/21 14:24:07 CET [2016/06/21 8:24:07 ET]
Table 'Moreau' 9-max Seat #5 is the button
Seat 1: hurtNCYDE ($127.50 in chips) 
Seat 2: Avtovo ($115.75 in chips) 
Seat 3: matiko09 ($101.68 in chips) 
Seat 4: SharingaaN ($208.12 in chips) 
Seat 5: CoolFireX ($147.39 in chips) 
Seat 6: Troll8989 ($101.10 in chips) 
Seat 7: chaps1988 ($100 in chips) 
Seat 8: mi$$I$Elena ($109.62 in chips) 
Troll8989: posts small blind $0.50
chaps1988: posts big blind $1
*** HOLE CARDS ***
Dealt to matiko09 [Ah Qh]
mi$$I$Elena: raises $1.38 to $2.38
hurtNCYDE: folds 
Avtovo: folds 
matiko09: calls $2.38
SharingaaN: folds 
CoolFireX: folds 
Troll8989: folds 
chaps1988: calls $1.38
*** FLOP *** [3c 6d 4c]
Troll8989 leaves the table
chaps1988: checks 
Filojoes joins the table at seat #6 
Filojoes leaves the table
mi$$I$Elena: checks 
matiko09: checks 
*** TURN *** [3c 6d 4c] [5c]
chaps1988: checks 
mi$$I$Elena: checks 
matiko09: checks 
*** RIVER *** [3c 6d 4c 5c] [Kd]
chaps1988: bets $9.44
mi$$I$Elena: folds 
matiko09: folds 
Uncalled bet ($9.44) returned to chaps1988
chaps1988 collected $7.26 from pot
chaps1988: doesn't show hand 
*** SUMMARY ***
Total pot $7.64 | Rake $0.38 
Board [3c 6d 4c 5c Kd]
Seat 1: hurtNCYDE folded before Flop (didn't bet)
Seat 2: Avtovo folded before Flop (didn't bet)
Seat 3: matiko09 folded on the River
Seat 4: SharingaaN folded before Flop (didn't bet)
Seat 5: CoolFireX (button) folded before Flop (didn't bet)
Seat 6: Troll8989 (small blind) folded before Flop
Seat 7: chaps1988 (big blind) collected ($7.26)
Seat 8: mi$$I$Elena folded on the River





PokerStars Hand #155014853918:  Hold'em No Limit ($0.50/$1.00 USD) - 2016/06/21 14:24:08 CET [2016/06/21 8:24:08 ET]
Table 'Schurer II' 9-max Seat #1 is the button
Seat 1: Dantist1122 ($100 in chips) 
Seat 2: havenots88 ($98.63 in chips) 
Seat 3: matiko09 ($115.35 in chips) 
Seat 4: hurtNCYDE ($121.32 in chips) 
Seat 5: riggedsh** ($128.30 in chips) 
Seat 6: Dödi123 ($102.39 in chips) 
Seat 7: Avtovo ($100 in chips) 
Seat 8: stepan0605 ($101.42 in chips) 
Seat 9: pardama ($100 in chips) 
havenots88: posts small blind $0.50
matiko09: posts big blind $1
*** HOLE CARDS ***
Dealt to matiko09 [Js 4d]
hurtNCYDE: folds 
riggedsh**: folds 
Dödi123: folds 
Avtovo: folds 
stepan0605: folds 
pardama: folds 
Dantist1122: folds 
havenots88: folds 
Uncalled bet ($0.50) returned to matiko09
matiko09 collected $1 from pot
matiko09: doesn't show hand 
*** SUMMARY ***
Total pot $1 | Rake $0 
Seat 1: Dantist1122 (button) folded before Flop (didn't bet)
Seat 2: havenots88 (small blind) folded before Flop
Seat 3: matiko09 (big blind) collected ($1)
Seat 4: hurtNCYDE folded before Flop (didn't bet)
Seat 5: riggedsh** folded before Flop (didn't bet)
Seat 6: Dödi123 folded before Flop (didn't bet)
Seat 7: Avtovo folded before Flop (didn't bet)
Seat 8: stepan0605 folded before Flop (didn't bet)
Seat 9: pardama folded before Flop (didn't bet)





PokerStars Hand #155014855618:  Hold'em No Limit (€0.25/€0.50 EUR) - 2016/06/21 14:24:12 CET [2016/06/21 8:24:12 ET]
Table 'Actor II' 6-max Seat #4 is the button
Seat 1: BNNJH (€62.07 in chips) 
Seat 2: po0hhh (€40 in chips) 
Seat 3: DaSshit (€57.36 in chips) 
Seat 4: matiko09 (€81.55 in chips) 
Seat 6: ooak182 (€50.25 in chips) 
ooak182: posts small blind €0.25
BNNJH: posts big blind €0.50
*** HOLE CARDS ***
Dealt to matiko09 [Js 4h]
po0hhh: folds 
DaSshit: folds 
matiko09: folds 
ooak182: folds 
Uncalled bet (€0.25) returned to BNNJH
BNNJH collected €0.50 from pot
BNNJH: doesn't show hand 
*** SUMMARY ***
Total pot €0.50 | Rake €0 
Seat 1: BNNJH (big blind) collected (€0.50)
Seat 2: po0hhh folded before Flop (didn't bet)
Seat 3: DaSshit folded before Flop (didn't bet)
Seat 4: matiko09 (button) folded before Flop (didn't bet)
Seat 6: ooak182 (small blind) folded before Flop





PokerStars Hand #155014861586:  Hold'em No Limit (€0.25/€0.50 EUR) - 2016/06/21 14:24:25 CET [2016/06/21 8:24:25 ET]
Table 'Actor II' 6-max Seat #6 is the button
Seat 1: BNNJH (€62.32 in chips) 
Seat 2: po0hhh (€40 in chips) 
Seat 3: DaSshit (€57.36 in chips) 
Seat 4: matiko09 (€81.55 in chips) 
Seat 6: ooak182 (€50 in chips) 
BNNJH: posts small blind €0.25
po0hhh: posts big blind €0.50
*** HOLE CARDS ***
Dealt to matiko09 [Td 4s]
DaSshit: folds 
matiko09: folds 
ooak182: raises €0.62 to €1.12
BNNJH: folds 
po0hhh: folds 
Uncalled bet (€0.62) returned to ooak182
ooak182 collected €1.25 from pot
ooak182: doesn't show hand 
*** SUMMARY ***
Total pot €1.25 | Rake €0 
Seat 1: BNNJH (small blind) folded before Flop
Seat 2: po0hhh (big blind) folded before Flop
Seat 3: DaSshit folded before Flop (didn't bet)
Seat 4: matiko09 folded before Flop (didn't bet)
Seat 6: ooak182 (button) collected (€1.25)





PokerStars Hand #155014864825:  Hold'em No Limit (€0.25/€0.50 EUR) - 2016/06/21 14:24:32 CET [2016/06/21 8:24:32 ET]
Table 'Lotis II' 6-max Seat #2 is the button
Seat 1: bustafc (€64.27 in chips) 
Seat 2: MoganB0y (€56 in chips) 
Seat 3: hmverlin (€66.51 in chips) 
Seat 4: IpMan13 (€78.70 in chips) 
Seat 5: heavyheight (€54.31 in chips) 
Seat 6: matiko09 (€50 in chips) 
hmverlin: posts small blind €0.25
IpMan13: posts big blind €0.50
*** HOLE CARDS ***
Dealt to matiko09 [Kh Qs]
heavyheight: raises €1 to €1.50
matiko09: raises €3.50 to €5
bustafc: folds 
MoganB0y: folds 
hmverlin: folds 
IpMan13: folds 
heavyheight: folds 
Uncalled bet (€3.50) returned to matiko09
matiko09 collected €3.75 from pot
matiko09: doesn't show hand 
*** SUMMARY ***
Total pot €3.75 | Rake €0 
Seat 1: bustafc folded before Flop (didn't bet)
Seat 2: MoganB0y (button) folded before Flop (didn't bet)
Seat 3: hmverlin (small blind) folded before Flop
Seat 4: IpMan13 (big blind) folded before Flop
Seat 5: heavyheight folded before Flop
Seat 6: matiko09 collected (€3.75)





PokerStars Hand #155014870846:  Hold'em No Limit ($0.50/$1.00 USD) - 2016/06/21 14:24:44 CET [2016/06/21 8:24:44 ET]
Table 'Schurer II' 9-max Seat #2 is the button
Seat 1: Dantist1122 ($100 in chips) 
Seat 2: havenots88 ($98.13 in chips) 
Seat 3: matiko09 ($115.85 in chips) 
Seat 5: riggedsh** ($128.30 in chips) 
Seat 6: Dödi123 ($102.39 in chips) 
Seat 7: Avtovo ($100 in chips) 
Seat 8: stepan0605 ($101.42 in chips) 
Seat 9: pardama ($100 in chips) 
matiko09: posts small blind $0.50
hurtNCYDE: is sitting out 
hurtNCYDE leaves the table
riggedsh**: posts big blind $1
*** HOLE CARDS ***
Dealt to matiko09 [7s Jc]
Dödi123: raises $2 to $3
Avtovo: folds 
stepan0605: folds 
pardama: folds 
Dantist1122: folds 
havenots88: folds 
matiko09: folds 
riggedsh**: folds 
Uncalled bet ($2) returned to Dödi123
Dödi123 collected $2.50 from pot
Dödi123: doesn't show hand 
*** SUMMARY ***
Total pot $2.50 | Rake $0 
Seat 1: Dantist1122 folded before Flop (didn't bet)
Seat 2: havenots88 (button) folded before Flop (didn't bet)
Seat 3: matiko09 (small blind) folded before Flop
Seat 5: riggedsh** (big blind) folded before Flop
Seat 6: Dödi123 collected ($2.50)
Seat 7: Avtovo folded before Flop (didn't bet)
Seat 8: stepan0605 folded before Flop (didn't bet)
Seat 9: pardama folded before Flop (didn't bet)





PokerStars Hand #155014871714:  Hold'em No Limit ($0.50/$1.00 USD) - 2016/06/21 14:24:46 CET [2016/06/21 8:24:46 ET]
Table 'Lamberta II' 9-max Seat #5 is the button
Seat 2: pardama ($100 in chips) 
Seat 3: matiko09 ($103.68 in chips) 
Seat 4: Eskimo Fox ($100 in chips) 
Seat 5: CoolFireX ($128.03 in chips) 
Seat 7: 23SmOkEr07 ($206.33 in chips) 
23SmOkEr07: posts small blind $0.50
stepan0605: is sitting out 
stepan0605 leaves the table
Avtovo: is sitting out 
pardama: posts big blind $1
*** HOLE CARDS ***
Dealt to matiko09 [Jc Ad]
Avtovo leaves the table
matiko09: raises $2 to $3
Eskimo Fox: folds 
Chin41178 joins the table at seat #8 
CoolFireX: calls $3
23SmOkEr07: folds 
pardama: folds 
*** FLOP *** [Th 3h 2s]
matiko09: checks 
CoolFireX: bets $4
matiko09: folds 
Uncalled bet ($4) returned to CoolFireX
Szevasztopol joins the table at seat #1 
CoolFireX collected $7.12 from pot
CoolFireX: doesn't show hand 
*** SUMMARY ***
Total pot $7.50 | Rake $0.38 
Board [Th 3h 2s]
Seat 2: pardama (big blind) folded before Flop
Seat 3: matiko09 folded on the Flop
Seat 4: Eskimo Fox folded before Flop (didn't bet)
Seat 5: CoolFireX (button) collected ($7.12)
Seat 7: 23SmOkEr07 (small blind) folded before Flop





PokerStars Hand #155014873746:  Hold'em No Limit ($0.50/$1.00 USD) - 2016/06/21 14:24:50 CET [2016/06/21 8:24:50 ET]
Table 'Chromios' 9-max Seat #9 is the button
Seat 1: matiko09 ($120.64 in chips) 
Seat 2: pardama ($100 in chips) 
Seat 3: ozone2003 ($100 in chips) 
Seat 4: Eskimo Fox ($106.02 in chips) 
Seat 5: Donetsk1y ($120.84 in chips) 
Seat 6: Troll8989 ($109.66 in chips) 
Seat 7: chaps1988 ($184.16 in chips) 
Seat 8: carlosdankha ($144.36 in chips) 
Seat 9: Filojoes ($211.06 in chips) 
matiko09: posts small blind $0.50
pardama: posts big blind $1
*** HOLE CARDS ***
Dealt to matiko09 [4c 9h]
ozone2003: folds 
Eskimo Fox: folds 
Donetsk1y: folds 
Troll8989: folds 
chaps1988: folds 
carlosdankha: folds 
Filojoes: raises $1 to $2
matiko09: folds 
pardama: folds 
Uncalled bet ($1) returned to Filojoes
Filojoes collected $2.50 from pot
Filojoes: doesn't show hand 
*** SUMMARY ***
Total pot $2.50 | Rake $0 
Seat 1: matiko09 (small blind) folded before Flop
Seat 2: pardama (big blind) folded before Flop
Seat 3: ozone2003 folded before Flop (didn't bet)
Seat 4: Eskimo Fox folded before Flop (didn't bet)
Seat 5: Donetsk1y folded before Flop (didn't bet)
Seat 6: Troll8989 folded before Flop (didn't bet)
Seat 7: chaps1988 folded before Flop (didn't bet)
Seat 8: carlosdankha folded before Flop (didn't bet)
Seat 9: Filojoes (button) collected ($2.50)





PokerStars Hand #155014874187:  Hold'em No Limit (€0.25/€0.50 EUR) - 2016/06/21 14:24:51 CET [2016/06/21 8:24:51 ET]
Table 'Actor II' 6-max Seat #1 is the button
Seat 1: BNNJH (€62.07 in chips) 
Seat 2: po0hhh (€39.50 in chips) 
Seat 3: DaSshit (€57.36 in chips) 
Seat 4: matiko09 (€81.55 in chips) 
Seat 6: ooak182 (€50.75 in chips) 
po0hhh: posts small blind €0.25
DaSshit: posts big blind €0.50
*** HOLE CARDS ***
Dealt to matiko09 [Ac 4d]
matiko09: folds 
ooak182: folds 
BNNJH: raises €1 to €1.50
po0hhh: folds 
DaSshit: folds 
Uncalled bet (€1) returned to BNNJH
BNNJH collected €1.25 from pot
BNNJH: doesn't show hand 
*** SUMMARY ***
Total pot €1.25 | Rake €0 
Seat 1: BNNJH (button) collected (€1.25)
Seat 2: po0hhh (small blind) folded before Flop
Seat 3: DaSshit (big blind) folded before Flop
Seat 4: matiko09 folded before Flop (didn't bet)
Seat 6: ooak182 folded before Flop (didn't bet)





PokerStars Hand #155014874442:  Hold'em No Limit ($0.50/$1.00 USD) - 2016/06/21 14:24:52 CET [2016/06/21 8:24:52 ET]
Table 'Amundsenia' 9-max Seat #6 is the button
Seat 2: Avtovo ($100 in chips) 
Seat 3: matiko09 ($100 in chips) 
Seat 4: typename27 ($26.13 in chips) 
Seat 5: ozone2003 ($113.62 in chips) 
Seat 6: King_ZéManel ($123.81 in chips) 
Seat 7: Eskimo Fox ($106.15 in chips) 
Seat 8: DomiVY ($48.50 in chips) 
Seat 9: MrSeymen ($66.84 in chips) 
Eskimo Fox: posts small blind $0.50
DomiVY: posts big blind $1
mi$$I$Elena: sits out 
*** HOLE CARDS ***
Dealt to matiko09 [Js 2s]
MrSeymen: raises $2 to $3
Avtovo: folds 
matiko09: folds 
typename27: folds 
ozone2003: folds 
King_ZéManel: folds 
Eskimo Fox: folds 
DomiVY: folds 
Uncalled bet ($2) returned to MrSeymen
MrSeymen collected $2.50 from pot
*** SUMMARY ***
Total pot $2.50 | Rake $0 
Seat 2: Avtovo folded before Flop (didn't bet)
Seat 3: matiko09 folded before Flop (didn't bet)
Seat 4: typename27 folded before Flop (didn't bet)
Seat 5: ozone2003 folded before Flop (didn't bet)
Seat 6: King_ZéManel (button) folded before Flop (didn't bet)
Seat 7: Eskimo Fox (small blind) folded before Flop
Seat 8: DomiVY (big blind) folded before Flop
Seat 9: MrSeymen collected ($2.50)





PokerStars Hand #155014878951:  Hold'em No Limit ($0.50/$1.00 USD) - 2016/06/21 14:25:01 CET [2016/06/21 8:25:01 ET]
Table 'Schurer II' 9-max Seat #3 is the button
Seat 1: Dantist1122 ($100 in chips) 
Seat 2: havenots88 ($98.13 in chips) 
Seat 3: matiko09 ($115.35 in chips) 
Seat 5: riggedsh** ($127.30 in chips) 
Seat 6: Dödi123 ($103.89 in chips) 
Seat 7: Avtovo ($100 in chips) 
Seat 8: stepan0605 ($101.42 in chips) 
Seat 9: pardama ($100 in chips) 
riggedsh**: posts small blind $0.50
Dödi123: posts big blind $1
*** HOLE CARDS ***
Dealt to matiko09 [2s 2c]
Avtovo: folds 
stepan0605: folds 
pardama: folds 
Dantist1122: folds 
havenots88: raises $2 to $3
matiko09: calls $3
riggedsh**: folds 
Dödi123: folds 
*** FLOP *** [4d 6h Kd]
CoolFireX joins the table at seat #4 
havenots88: bets $4.74
matiko09: folds 
Uncalled bet ($4.74) returned to havenots88
havenots88 collected $7.12 from pot
havenots88: doesn't show hand 
*** SUMMARY ***
Total pot $7.50 | Rake $0.38 
Board [4d 6h Kd]
Seat 1: Dantist1122 folded before Flop (didn't bet)
Seat 2: havenots88 collected ($7.12)
Seat 3: matiko09 (button) folded on the Flop
Seat 5: riggedsh** (small blind) folded before Flop
Seat 6: Dödi123 (big blind) folded before Flop
Seat 7: Avtovo folded before Flop (didn't bet)
Seat 8: stepan0605 folded before Flop (didn't bet)
Seat 9: pardama folded before Flop (didn't bet)





PokerStars Hand #155014880436:  Hold'em No Limit ($0.50/$1.00 USD) - 2016/06/21 14:25:04 CET [2016/06/21 8:25:04 ET]
Table 'Saldanha' 9-max Seat #6 is the button
Seat 1: KovIFish89 ($102.80 in chips) 
Seat 3: matiko09 ($406.87 in chips) 
Seat 4: CoolFireX ($104.80 in chips) 
Seat 5: Troll8989 ($126.74 in chips) 
Seat 6: Juu2huu ($204.30 in chips) 
Seat 7: ozone2003 ($198.39 in chips) 
Seat 9: 23SmOkEr07 ($100 in chips) 
ozone2003: posts small blind $0.50
23SmOkEr07: posts big blind $1
Filojoes: sits out 
KovIFish89: posts the ante $0.20
matiko09: posts the ante $0.20
CoolFireX: posts the ante $0.20
Troll8989: posts the ante $0.20
Juu2huu: posts the ante $0.20
ozone2003: posts the ante $0.20
23SmOkEr07: posts the ante $0.20
*** HOLE CARDS ***
Dealt to matiko09 [2h 6c]
KovIFish89: folds 
matiko09: folds 
CoolFireX: folds 
Troll8989: folds 
Juu2huu: folds 
ozone2003: folds 
Uncalled bet ($0.50) returned to 23SmOkEr07
23SmOkEr07 collected $2.40 from pot
23SmOkEr07: doesn't show hand 
*** SUMMARY ***
Total pot $2.40 | Rake $0 
Seat 1: KovIFish89 folded before Flop (didn't bet)
Seat 3: matiko09 folded before Flop (didn't bet)
Seat 4: CoolFireX folded before Flop (didn't bet)
Seat 5: Troll8989 folded before Flop (didn't bet)
Seat 6: Juu2huu (button) folded before Flop (didn't bet)
Seat 7: ozone2003 (small blind) folded before Flop
Seat 9: 23SmOkEr07 (big blind) collected ($2.40)





PokerStars Hand #155014880403:  Hold'em No Limit (€0.25/€0.50 EUR) - 2016/06/21 14:25:04 CET [2016/06/21 8:25:04 ET]
Table 'Actor II' 6-max Seat #2 is the button
Seat 1: BNNJH (€62.82 in chips) 
Seat 2: po0hhh (€39.25 in chips) 
Seat 3: DaSshit (€56.86 in chips) 
Seat 4: matiko09 (€81.55 in chips) 
Seat 6: ooak182 (€50.75 in chips) 
DaSshit: posts small blind €0.25
matiko09: posts big blind €0.50
*** HOLE CARDS ***
Dealt to matiko09 [9h Qd]
ooak182: folds 
BNNJH: raises €1 to €1.50
po0hhh: folds 
DaSshit: folds 
matiko09: folds 
Uncalled bet (€1) returned to BNNJH
BNNJH collected €1.25 from pot
BNNJH: doesn't show hand 
*** SUMMARY ***
Total pot €1.25 | Rake €0 
Seat 1: BNNJH collected (€1.25)
Seat 2: po0hhh (button) folded before Flop (didn't bet)
Seat 3: DaSshit (small blind) folded before Flop
Seat 4: matiko09 (big blind) folded before Flop
Seat 6: ooak182 folded before Flop (didn't bet)





PokerStars Hand #155014882271:  Hold'em No Limit (€0.25/€0.50 EUR) - 2016/06/21 14:25:08 CET [2016/06/21 8:25:08 ET]
Table 'Lotis II' 6-max Seat #3 is the button
Seat 1: bustafc (€64.27 in chips) 
Seat 2: MoganB0y (€56 in chips) 
Seat 3: hmverlin (€66.26 in chips) 
Seat 4: IpMan13 (€78.20 in chips) 
Seat 5: heavyheight (€52.81 in chips) 
Seat 6: matiko09 (€52.25 in chips) 
IpMan13: posts small blind €0.25
heavyheight: posts big blind €0.50
*** HOLE CARDS ***
Dealt to matiko09 [5h 9s]
matiko09: folds 
bustafc: folds 
MoganB0y: raises €0.75 to €1.25
hmverlin: calls €1.25
IpMan13: folds 
heavyheight: folds 
*** FLOP *** [As 9c Js]
MoganB0y: checks 
hmverlin: bets €2
MoganB0y: calls €2
*** TURN *** [As 9c Js] [8d]
MoganB0y: checks 
hmverlin: bets €3.50
MoganB0y: raises €11.50 to €15
hmverlin: folds 
Uncalled bet (€11.50) returned to MoganB0y
MoganB0y collected €13.54 from pot
MoganB0y: doesn't show hand 
*** SUMMARY ***
Total pot €14.25 | Rake €0.71 
Board [As 9c Js 8d]
Seat 1: bustafc folded before Flop (didn't bet)
Seat 2: MoganB0y collected (€13.54)
Seat 3: hmverlin (button) folded on the Turn
Seat 4: IpMan13 (small blind) folded before Flop
Seat 5: heavyheight (big blind) folded before Flop
Seat 6: matiko09 folded before Flop (didn't bet)





PokerStars Hand #155014889762:  Hold'em No Limit (€0.25/€0.50 EUR) - 2016/06/21 14:25:24 CET [2016/06/21 8:25:24 ET]
Table 'Actor II' 6-max Seat #3 is the button
Seat 1: BNNJH (€63.57 in chips) 
Seat 2: po0hhh (€39.25 in chips) 
Seat 3: DaSshit (€56.61 in chips) 
Seat 4: matiko09 (€81.05 in chips) 
Seat 6: ooak182 (€50.75 in chips) 
matiko09: posts small blind €0.25
ooak182: posts big blind €0.50
*** HOLE CARDS ***
Dealt to matiko09 [Ac 2h]
BNNJH: raises €1 to €1.50
po0hhh: folds 
DaSshit: folds 
matiko09: folds 
ooak182: folds 
Uncalled bet (€1) returned to BNNJH
BNNJH collected €1.25 from pot
BNNJH: doesn't show hand 
*** SUMMARY ***
Total pot €1.25 | Rake €0 
Seat 1: BNNJH collected (€1.25)
Seat 2: po0hhh folded before Flop (didn't bet)
Seat 3: DaSshit (button) folded before Flop (didn't bet)
Seat 4: matiko09 (small blind) folded before Flop
Seat 6: ooak182 (big blind) folded before Flop





PokerStars Hand #155014891328:  Hold'em No Limit ($0.50/$1.00 USD) - 2016/06/21 14:25:27 CET [2016/06/21 8:25:27 ET]
Table 'Chromios' 9-max Seat #1 is the button
Seat 1: matiko09 ($120.14 in chips) 
Seat 2: pardama ($100 in chips) 
Seat 3: ozone2003 ($100 in chips) 
Seat 4: Eskimo Fox ($106.02 in chips) 
Seat 5: Donetsk1y ($120.84 in chips) 
Seat 6: Troll8989 ($109.66 in chips) 
Seat 7: chaps1988 ($184.16 in chips) 
Seat 8: carlosdankha ($144.36 in chips) 
Seat 9: Filojoes ($212.56 in chips) 
pardama: posts small blind $0.50
ozone2003: posts big blind $1
*** HOLE CARDS ***
Dealt to matiko09 [9h 6d]
Eskimo Fox: folds 
Donetsk1y: folds 
Troll8989: folds 
chaps1988: folds 
carlosdankha: folds 
Filojoes: folds 
matiko09: folds 
pardama: raises $2.50 to $3.50
ozone2003: calls $2.50
*** FLOP *** [Ah Tc 4s]
pardama: checks 
ozone2003: checks 
*** TURN *** [Ah Tc 4s] [2h]
pardama: checks 
ozone2003: checks 
*** RIVER *** [Ah Tc 4s 2h] [3d]
pardama: checks 
ozone2003: checks 
*** SHOW DOWN ***
pardama: shows [9s Ks] (high card Ace)
ozone2003: shows [6s 6h] (a pair of Sixes)
ozone2003 collected $6.65 from pot
*** SUMMARY ***
Total pot $7 | Rake $0.35 
Board [Ah Tc 4s 2h 3d]
Seat 1: matiko09 (button) folded before Flop (didn't bet)
Seat 2: pardama (small blind) showed [9s Ks] and lost with high card Ace
Seat 3: ozone2003 (big blind) showed [6s 6h] and won ($6.65) with a pair of Sixes
Seat 4: Eskimo Fox folded before Flop (didn't bet)
Seat 5: Donetsk1y folded before Flop (didn't bet)
Seat 6: Troll8989 folded before Flop (didn't bet)
Seat 7: chaps1988 folded before Flop (didn't bet)
Seat 8: carlosdankha folded before Flop (didn't bet)
Seat 9: Filojoes folded before Flop (didn't bet)





PokerStars Hand #155014891139:  Hold'em No Limit ($0.50/$1.00 USD) - 2016/06/21 14:25:27 CET [2016/06/21 8:25:27 ET]
Table 'Saldanha' 9-max Seat #7 is the button
Seat 1: KovIFish89 ($102.60 in chips) 
Seat 3: matiko09 ($406.67 in chips) 
Seat 4: CoolFireX ($104.60 in chips) 
Seat 5: Troll8989 ($126.54 in chips) 
Seat 6: Juu2huu ($204.10 in chips) 
Seat 7: ozone2003 ($197.69 in chips) 
Seat 9: 23SmOkEr07 ($101.70 in chips) 
23SmOkEr07: posts small blind $0.50
KovIFish89: posts big blind $1
Filojoes: sits out 
KovIFish89: posts the ante $0.20
matiko09: posts the ante $0.20
CoolFireX: posts the ante $0.20
Troll8989: posts the ante $0.20
Juu2huu: posts the ante $0.20
ozone2003: posts the ante $0.20
23SmOkEr07: posts the ante $0.20
*** HOLE CARDS ***
Dealt to matiko09 [Jh 5c]
matiko09: folds 
CoolFireX: folds 
Troll8989: folds 
Juu2huu: raises $3 to $4
ozone2003: folds 
23SmOkEr07: folds 
KovIFish89: folds 
Uncalled bet ($3) returned to Juu2huu
Juu2huu collected $3.90 from pot
Juu2huu: doesn't show hand 
*** SUMMARY ***
Total pot $3.90 | Rake $0 
Seat 1: KovIFish89 (big blind) folded before Flop
Seat 3: matiko09 folded before Flop (didn't bet)
Seat 4: CoolFireX folded before Flop (didn't bet)
Seat 5: Troll8989 folded before Flop (didn't bet)
Seat 6: Juu2huu collected ($3.90)
Seat 7: ozone2003 (button) folded before Flop (didn't bet)
Seat 9: 23SmOkEr07 (small blind) folded before Flop





PokerStars Hand #155014892284:  Hold'em No Limit ($0.50/$1.00 USD) - 2016/06/21 14:25:29 CET [2016/06/21 8:25:29 ET]
Table 'Lamberta II' 9-max Seat #7 is the button
Seat 2: pardama ($100 in chips) 
Seat 3: matiko09 ($100.68 in chips) 
Seat 4: Eskimo Fox ($100 in chips) 
Seat 5: CoolFireX ($132.15 in chips) 
Seat 7: 23SmOkEr07 ($205.83 in chips) 
Chin41178 will be allowed to play after the button
Sjtu_Michael will be allowed to play after the button
Szevasztopol will be allowed to play after the button
pardama: posts small blind $0.50
matiko09: posts big blind $1
*** HOLE CARDS ***
Dealt to matiko09 [7h Ah]
Eskimo Fox: folds 
Szevasztopol leaves the table
el Fatto joins the table at seat #1 
CoolFireX: raises $1.50 to $2.50
23SmOkEr07: calls $2.50
pardama: folds 
matiko09: folds 
*** FLOP *** [Kh 7s Ac]
Sjtu_Michael leaves the table
CoolFireX: checks 
23SmOkEr07: checks 
*** TURN *** [Kh 7s Ac] [Qd]
el Fatto leaves the table
CoolFireX: checks 
23SmOkEr07: checks 
*** RIVER *** [Kh 7s Ac Qd] [6d]
CoolFireX: checks 
23SmOkEr07: checks 
*** SHOW DOWN ***
CoolFireX: shows [Qh 9h] (a pair of Queens)
23SmOkEr07: mucks hand 
CoolFireX collected $6.18 from pot
*** SUMMARY ***
Total pot $6.50 | Rake $0.32 
Board [Kh 7s Ac Qd 6d]
Seat 2: pardama (small blind) folded before Flop
Seat 3: matiko09 (big blind) folded before Flop
Seat 4: Eskimo Fox folded before Flop (didn't bet)
Seat 5: CoolFireX showed [Qh 9h] and won ($6.18) with a pair of Queens
Seat 7: 23SmOkEr07 (button) mucked [4s 2s]





PokerStars Hand #155014895505:  Hold'em No Limit ($0.50/$1.00 USD) - 2016/06/21 14:25:36 CET [2016/06/21 8:25:36 ET]
Table 'Amundsenia' 9-max Seat #7 is the button
Seat 2: Avtovo ($100 in chips) 
Seat 3: matiko09 ($100 in chips) 
Seat 4: typename27 ($26.13 in chips) 
Seat 5: ozone2003 ($113.62 in chips) 
Seat 6: King_ZéManel ($123.81 in chips) 
Seat 7: Eskimo Fox ($105.65 in chips) 
Seat 8: DomiVY ($47.50 in chips) 
Seat 9: MrSeymen ($68.34 in chips) 
DomiVY: posts small blind $0.50
MrSeymen: posts big blind $1
mi$$I$Elena: sits out 
*** HOLE CARDS ***
Dealt to matiko09 [6c 7c]
Avtovo: folds 
matiko09: folds 
typename27: folds 
ozone2003: raises $2 to $3
King_ZéManel: calls $3
Eskimo Fox: folds 
DomiVY: folds 
MrSeymen: calls $2
*** FLOP *** [7h 8s Td]
MrSeymen: checks 
ozone2003: checks 
King_ZéManel: checks 
*** TURN *** [7h 8s Td] [Js]
MrSeymen: bets $4
ozone2003: folds 
King_ZéManel: folds 
Uncalled bet ($4) returned to MrSeymen
MrSeymen collected $9.02 from pot
*** SUMMARY ***
Total pot $9.50 | Rake $0.48 
Board [7h 8s Td Js]
Seat 2: Avtovo folded before Flop (didn't bet)
Seat 3: matiko09 folded before Flop (didn't bet)
Seat 4: typename27 folded before Flop (didn't bet)
Seat 5: ozone2003 folded on the Turn
Seat 6: King_ZéManel folded on the Turn
Seat 7: Eskimo Fox (button) folded before Flop (didn't bet)
Seat 8: DomiVY (small blind) folded before Flop
Seat 9: MrSeymen (big blind) collected ($9.02)





PokerStars Hand #155014895454:  Hold'em No Limit (€0.25/€0.50 EUR) - 2016/06/21 14:25:36 CET [2016/06/21 8:25:36 ET]
Table 'Actor II' 6-max Seat #4 is the button
Seat 1: BNNJH (€64.32 in chips) 
Seat 2: po0hhh (€39.25 in chips) 
Seat 3: DaSshit (€56.61 in chips) 
Seat 4: matiko09 (€80.80 in chips) 
Seat 6: ooak182 (€50.25 in chips) 
ooak182: posts small blind €0.25
BNNJH: posts big blind €0.50
*** HOLE CARDS ***
Dealt to matiko09 [Qh 8s]
po0hhh: folds 
DaSshit: folds 
matiko09: folds 
ooak182: folds 
Uncalled bet (€0.25) returned to BNNJH
BNNJH collected €0.50 from pot
BNNJH: doesn't show hand 
*** SUMMARY ***
Total pot €0.50 | Rake €0 
Seat 1: BNNJH (big blind) collected (€0.50)
Seat 2: po0hhh folded before Flop (didn't bet)
Seat 3: DaSshit folded before Flop (didn't bet)
Seat 4: matiko09 (button) folded before Flop (didn't bet)
Seat 6: ooak182 (small blind) folded before Flop





PokerStars Hand #155014896176:  Hold'em No Limit ($0.50/$1.00 USD) - 2016/06/21 14:25:37 CET [2016/06/21 8:25:37 ET]
Table 'Schurer II' 9-max Seat #5 is the button
Seat 1: Dantist1122 ($100 in chips) 
Seat 2: havenots88 ($102.25 in chips) 
Seat 3: matiko09 ($112.35 in chips) 
Seat 5: riggedsh** ($126.80 in chips) 
Seat 6: Dödi123 ($102.89 in chips) 
Seat 7: Avtovo ($100 in chips) 
Seat 8: stepan0605 ($101.42 in chips) 
Seat 9: pardama ($100 in chips) 
Dödi123: posts small blind $0.50
Avtovo: posts big blind $1
CoolFireX: sits out 
*** HOLE CARDS ***
Dealt to matiko09 [Tc 7s]
stepan0605: folds 
pardama: folds 
Dantist1122: folds 
havenots88: folds 
matiko09: folds 
riggedsh**: folds 
Dödi123: folds 
Uncalled bet ($0.50) returned to Avtovo
Avtovo collected $1 from pot
Avtovo: doesn't show hand 
*** SUMMARY ***
Total pot $1 | Rake $0 
Seat 1: Dantist1122 folded before Flop (didn't bet)
Seat 2: havenots88 folded before Flop (didn't bet)
Seat 3: matiko09 folded before Flop (didn't bet)
Seat 5: riggedsh** (button) folded before Flop (didn't bet)
Seat 6: Dödi123 (small blind) folded before Flop
Seat 7: Avtovo (big blind) collected ($1)
Seat 8: stepan0605 folded before Flop (didn't bet)
Seat 9: pardama folded before Flop (didn't bet)





PokerStars Hand #155014902392:  Hold'em No Limit (€0.25/€0.50 EUR) - 2016/06/21 14:25:50 CET [2016/06/21 8:25:50 ET]
Table 'Lotis II' 6-max Seat #4 is the button
Seat 1: bustafc (€64.27 in chips) 
Seat 2: MoganB0y (€62.79 in chips) 
Seat 3: hmverlin (€59.51 in chips) 
Seat 4: IpMan13 (€77.95 in chips) 
Seat 5: heavyheight (€52.31 in chips) 
Seat 6: matiko09 (€52.25 in chips) 
heavyheight: posts small blind €0.25
matiko09: posts big blind €0.50
*** HOLE CARDS ***
Dealt to matiko09 [Ts 9d]
bustafc: folds 
MoganB0y: raises €1 to €1.50
hmverlin: folds 
IpMan13: folds 
heavyheight: folds 
matiko09: folds 
Uncalled bet (€1) returned to MoganB0y
MoganB0y collected €1.25 from pot
MoganB0y: doesn't show hand 
*** SUMMARY ***
Total pot €1.25 | Rake €0 
Seat 1: bustafc folded before Flop (didn't bet)
Seat 2: MoganB0y collected (€1.25)
Seat 3: hmverlin folded before Flop (didn't bet)
Seat 4: IpMan13 (button) folded before Flop (didn't bet)
Seat 5: heavyheight (small blind) folded before Flop
Seat 6: matiko09 (big blind) folded before Flop





PokerStars Hand #155014903231:  Hold'em No Limit (€0.25/€0.50 EUR) - 2016/06/21 14:25:52 CET [2016/06/21 8:25:52 ET]
Table 'Actor II' 6-max Seat #6 is the button
Seat 1: BNNJH (€64.57 in chips) 
Seat 2: po0hhh (€39.25 in chips) 
Seat 3: DaSshit (€56.61 in chips) 
Seat 4: matiko09 (€80.80 in chips) 
Seat 6: ooak182 (€50 in chips) 
BNNJH: posts small blind €0.25
po0hhh: posts big blind €0.50
*** HOLE CARDS ***
Dealt to matiko09 [Kc Ks]
DaSshit: folds 
matiko09: raises €1 to €1.50
ooak182: folds 
BNNJH: calls €1.25
po0hhh: folds 
*** FLOP *** [Qd Jc 3h]
BNNJH: checks 
matiko09: bets €2
BNNJH: folds 
Uncalled bet (€2) returned to matiko09
matiko09 collected €3.32 from pot
matiko09: doesn't show hand 
*** SUMMARY ***
Total pot €3.50 | Rake €0.18 
Board [Qd Jc 3h]
Seat 1: BNNJH (small blind) folded on the Flop
Seat 2: po0hhh (big blind) folded before Flop
Seat 3: DaSshit folded before Flop (didn't bet)
Seat 4: matiko09 collected (€3.32)
Seat 6: ooak182 (button) folded before Flop (didn't bet)





PokerStars Hand #155014904095:  Hold'em No Limit ($0.50/$1.00 USD) - 2016/06/21 14:25:54 CET [2016/06/21 8:25:54 ET]
Table 'Schurer II' 9-max Seat #6 is the button
Seat 1: Dantist1122 ($100 in chips) 
Seat 2: havenots88 ($102.25 in chips) 
Seat 3: matiko09 ($112.35 in chips) 
Seat 5: riggedsh** ($126.80 in chips) 
Seat 6: Dödi123 ($102.39 in chips) 
Seat 7: Avtovo ($100.50 in chips) 
Seat 8: stepan0605 ($101.42 in chips) 
Seat 9: pardama ($100 in chips) 
Avtovo: posts small blind $0.50
stepan0605: posts big blind $1
CoolFireX: sits out 
*** HOLE CARDS ***
Dealt to matiko09 [5s Qc]
pardama: folds 
Dantist1122: folds 
havenots88: folds 
matiko09: folds 
riggedsh**: folds 
Dödi123: folds 
Avtovo: raises $1.50 to $2.50
stepan0605: folds 
Uncalled bet ($1.50) returned to Avtovo
Avtovo collected $2 from pot
Avtovo: doesn't show hand 
*** SUMMARY ***
Total pot $2 | Rake $0 
Seat 1: Dantist1122 folded before Flop (didn't bet)
Seat 2: havenots88 folded before Flop (didn't bet)
Seat 3: matiko09 folded before Flop (didn't bet)
Seat 5: riggedsh** folded before Flop (didn't bet)
Seat 6: Dödi123 (button) folded before Flop (didn't bet)
Seat 7: Avtovo (small blind) collected ($2)
Seat 8: stepan0605 (big blind) folded before Flop
Seat 9: pardama folded before Flop (didn't bet)





PokerStars Hand #155014910227:  Hold'em No Limit (€0.25/€0.50 EUR) - 2016/06/21 14:26:06 CET [2016/06/21 8:26:06 ET]
Table 'Lotis II' 6-max Seat #5 is the button
Seat 1: bustafc (€64.27 in chips) 
Seat 2: MoganB0y (€63.54 in chips) 
Seat 3: hmverlin (€59.51 in chips) 
Seat 4: IpMan13 (€77.95 in chips) 
Seat 5: heavyheight (€52.06 in chips) 
Seat 6: matiko09 (€51.75 in chips) 
matiko09: posts small blind €0.25
bustafc: posts big blind €0.50
*** HOLE CARDS ***
Dealt to matiko09 [Ts 4d]
MoganB0y: raises €1 to €1.50
hmverlin: folds 
IpMan13: raises €3 to €4.50
heavyheight: calls €4.50
matiko09: folds 
bustafc: folds 
MoganB0y: folds 
*** FLOP *** [9h 7d 9c]
IpMan13: checks 
heavyheight: bets €6.50
IpMan13: folds 
Uncalled bet (€6.50) returned to heavyheight
heavyheight collected €10.69 from pot
*** SUMMARY ***
Total pot €11.25 | Rake €0.56 
Board [9h 7d 9c]
Seat 1: bustafc (big blind) folded before Flop
Seat 2: MoganB0y folded before Flop
Seat 3: hmverlin folded before Flop (didn't bet)
Seat 4: IpMan13 folded on the Flop
Seat 5: heavyheight (button) collected (€10.69)
Seat 6: matiko09 (small blind) folded before Flop





PokerStars Hand #155014914102:  Hold'em No Limit ($0.50/$1.00 USD) - 2016/06/21 14:26:14 CET [2016/06/21 8:26:14 ET]
Table 'Schurer II' 9-max Seat #7 is the button
Seat 1: Dantist1122 ($100 in chips) 
Seat 2: havenots88 ($102.25 in chips) 
Seat 3: matiko09 ($112.35 in chips) 
Seat 5: riggedsh** ($126.80 in chips) 
Seat 6: Dödi123 ($102.39 in chips) 
Seat 7: Avtovo ($101.50 in chips) 
Seat 8: stepan0605 ($100.42 in chips) 
Seat 9: pardama ($100 in chips) 
stepan0605: posts small blind $0.50
pardama: posts big blind $1
CoolFireX: sits out 
*** HOLE CARDS ***
Dealt to matiko09 [Qd Ac]
Dantist1122: folds 
havenots88: folds 
matiko09: raises $2 to $3
riggedsh**: folds 
Dödi123: folds 
Avtovo: folds 
stepan0605: folds 
pardama: folds 
Uncalled bet ($2) returned to matiko09
matiko09 collected $2.50 from pot
matiko09: doesn't show hand 
*** SUMMARY ***
Total pot $2.50 | Rake $0 
Seat 1: Dantist1122 folded before Flop (didn't bet)
Seat 2: havenots88 folded before Flop (didn't bet)
Seat 3: matiko09 collected ($2.50)
Seat 5: riggedsh** folded before Flop (didn't bet)
Seat 6: Dödi123 folded before Flop (didn't bet)
Seat 7: Avtovo (button) folded before Flop (didn't bet)
Seat 8: stepan0605 (small blind) folded before Flop
Seat 9: pardama (big blind) folded before Flop





PokerStars Hand #155014914732:  Hold'em No Limit (€0.25/€0.50 EUR) - 2016/06/21 14:26:16 CET [2016/06/21 8:26:16 ET]
Table 'Actor II' 6-max Seat #1 is the button
Seat 1: BNNJH (€63.07 in chips) 
Seat 2: po0hhh (€38.75 in chips) 
Seat 3: DaSshit (€56.61 in chips) 
Seat 4: matiko09 (€82.62 in chips) 
Seat 6: ooak182 (€50 in chips) 
po0hhh: posts small blind €0.25
DaSshit: posts big blind €0.50
*** HOLE CARDS ***
Dealt to matiko09 [Kc 7s]
matiko09: folds 
ooak182: folds 
TopMo3UJlo joins the table at seat #5 
BNNJH: folds 
po0hhh: folds 
Uncalled bet (€0.25) returned to DaSshit
DaSshit collected €0.50 from pot
DaSshit: doesn't show hand 
*** SUMMARY ***
Total pot €0.50 | Rake €0 
Seat 1: BNNJH (button) folded before Flop (didn't bet)
Seat 2: po0hhh (small blind) folded before Flop
Seat 3: DaSshit (big blind) collected (€0.50)
Seat 4: matiko09 folded before Flop (didn't bet)
Seat 6: ooak182 folded before Flop (didn't bet)





PokerStars Hand #155014915585:  Hold'em No Limit ($0.50/$1.00 USD) - 2016/06/21 14:26:18 CET [2016/06/21 8:26:18 ET]
Table 'Saldanha' 9-max Seat #9 is the button
Seat 1: KovIFish89 ($101.40 in chips) 
Seat 2: Filojoes ($100 in chips) 
Seat 3: matiko09 ($406.47 in chips) 
Seat 4: CoolFireX ($104.40 in chips) 
Seat 5: Troll8989 ($126.34 in chips) 
Seat 6: Juu2huu ($206.80 in chips) 
Seat 7: ozone2003 ($197.49 in chips) 
Seat 9: 23SmOkEr07 ($101 in chips) 
KovIFish89: posts small blind $0.50
Filojoes: posts big blind $1
KovIFish89: posts the ante $0.20
Filojoes: posts the ante $0.20
matiko09: posts the ante $0.20
CoolFireX: posts the ante $0.20
Troll8989: posts the ante $0.20
Juu2huu: posts the ante $0.20
ozone2003: posts the ante $0.20
23SmOkEr07: posts the ante $0.20
*** HOLE CARDS ***
Dealt to matiko09 [6d Kh]
erick222 leaves the table
matiko09: folds 
stepan0605 joins the table at seat #8 
CoolFireX: folds 
Troll8989: folds 
Juu2huu: folds 
ozone2003: folds 
23SmOkEr07: raises $1.50 to $2.50
KovIFish89: folds 
Filojoes: folds 
Uncalled bet ($1.50) returned to 23SmOkEr07
23SmOkEr07 collected $4.10 from pot
23SmOkEr07: doesn't show hand 
*** SUMMARY ***
Total pot $4.10 | Rake $0 
Seat 1: KovIFish89 (small blind) folded before Flop
Seat 2: Filojoes (big blind) folded before Flop
Seat 3: matiko09 folded before Flop (didn't bet)
Seat 4: CoolFireX folded before Flop (didn't bet)
Seat 5: Troll8989 folded before Flop (didn't bet)
Seat 6: Juu2huu folded before Flop (didn't bet)
Seat 7: ozone2003 folded before Flop (didn't bet)
Seat 9: 23SmOkEr07 (button) collected ($4.10)





PokerStars Hand #155014916311:  Hold'em No Limit ($0.50/$1.00 USD) - 2016/06/21 14:26:19 CET [2016/06/21 8:26:19 ET]
Table 'Kalliope' 9-max Seat #4 is the button
Seat 1: chaps1988 ($117.22 in chips) 
Seat 2: stepan0605 ($205.90 in chips) 
Seat 3: SharingaaN ($84.39 in chips) 
Seat 4: Filojoes ($100 in chips) 
Seat 5: IdleJim0101 ($136 in chips) 
Seat 6: matiko09 ($184.42 in chips) 
Seat 7: CoolFireX ($116.87 in chips) 
Seat 8: 23SmOkEr07 ($100 in chips) 
Seat 9: Avtovo ($136.44 in chips) 
IdleJim0101: posts small blind $0.50
matiko09: posts big blind $1
*** HOLE CARDS ***
Dealt to matiko09 [8s 5d]
CoolFireX: folds 
23SmOkEr07: folds 
Avtovo: folds 
chaps1988: folds 
stepan0605: folds 
SharingaaN: folds 
Filojoes: raises $1 to $2
IdleJim0101: calls $1.50
matiko09: folds 
*** FLOP *** [Qs Ad Ah]
IdleJim0101: checks 
Filojoes: bets $2.85
IdleJim0101: calls $2.85
*** TURN *** [Qs Ad Ah] [Qd]
IdleJim0101: checks 
Filojoes: checks 
*** RIVER *** [Qs Ad Ah Qd] [8d]
IdleJim0101: bets $3
Filojoes: folds 
Uncalled bet ($3) returned to IdleJim0101
IdleJim0101 collected $10.16 from pot
IdleJim0101: doesn't show hand 
*** SUMMARY ***
Total pot $10.70 | Rake $0.54 
Board [Qs Ad Ah Qd 8d]
Seat 1: chaps1988 folded before Flop (didn't bet)
Seat 2: stepan0605 folded before Flop (didn't bet)
Seat 3: SharingaaN folded before Flop (didn't bet)
Seat 4: Filojoes (button) folded on the River
Seat 5: IdleJim0101 (small blind) collected ($10.16)
Seat 6: matiko09 (big blind) folded before Flop
Seat 7: CoolFireX folded before Flop (didn't bet)
Seat 8: 23SmOkEr07 folded before Flop (didn't bet)
Seat 9: Avtovo folded before Flop (didn't bet)





PokerStars Hand #155014925521:  Hold'em No Limit ($0.50/$1.00 USD) - 2016/06/21 14:26:38 CET [2016/06/21 8:26:38 ET]
Table 'Schurer II' 9-max Seat #8 is the button
Seat 1: Dantist1122 ($100 in chips) 
Seat 2: havenots88 ($102.25 in chips) 
Seat 3: matiko09 ($113.85 in chips) 
Seat 5: riggedsh** ($126.80 in chips) 
Seat 6: Dödi123 ($102.39 in chips) 
Seat 7: Avtovo ($101.50 in chips) 
Seat 8: stepan0605 ($100 in chips) 
Seat 9: pardama ($100 in chips) 
pardama: posts small blind $0.50
Dantist1122: posts big blind $1
CoolFireX: sits out 
*** HOLE CARDS ***
Dealt to matiko09 [Ks 3c]
havenots88: folds 
matiko09: folds 
riggedsh**: raises $2 to $3
Dödi123: folds 
Avtovo: folds 
stepan0605: folds 
pardama: folds 
Dantist1122: folds 
Uncalled bet ($2) returned to riggedsh**
riggedsh** collected $2.50 from pot
riggedsh**: doesn't show hand 
*** SUMMARY ***
Total pot $2.50 | Rake $0 
Seat 1: Dantist1122 (big blind) folded before Flop
Seat 2: havenots88 folded before Flop (didn't bet)
Seat 3: matiko09 folded before Flop (didn't bet)
Seat 5: riggedsh** collected ($2.50)
Seat 6: Dödi123 folded before Flop (didn't bet)
Seat 7: Avtovo folded before Flop (didn't bet)
Seat 8: stepan0605 (button) folded before Flop (didn't bet)
Seat 9: pardama (small blind) folded before Flop





