PokerStars Hand #150798609824:  Hold'em No Limit ($0.50/$1.00 USD) - 2016/03/23 13:04:18 CET [2016/03/23 8:04:18 ET]
Table 'Oljato' 9-max Seat #7 is the button
Seat 1: lumen21 ($100 in chips) 
Seat 2: Benixxx13 ($98.50 in chips) 
Seat 3: DUkalisUA ($100 in chips) 
Seat 4: jensky18 ($1.88 in chips) 
Seat 5: ryo728 ($85.75 in chips) 
Seat 6: WDW3 ($114.74 in chips) 
Seat 7: matiko09 ($148.24 in chips) 
Seat 8: Zeeshka ($213.90 in chips) 
Seat 9: Jimy Tiltman ($100 in chips) 
Zeeshka: posts small blind $0.50
Jimy Tiltman: posts big blind $1
*** HOLE CARDS ***
Dealt to matiko09 [7s Jh]
lumen21: raises $2 to $3
Benixxx13: folds 
DUkalisUA: folds 
jensky18: folds 
jensky18 leaves the table
Pvsx. joins the table at seat #4 
ryo728: folds 
WDW3: folds 
matiko09: folds 
Zeeshka: folds 
Jimy Tiltman: calls $2
*** FLOP *** [Js Kh Th]
Jimy Tiltman: checks 
lumen21: checks 
*** TURN *** [Js Kh Th] [4s]
Jimy Tiltman: checks 
lumen21: checks 
*** RIVER *** [Js Kh Th 4s] [Ks]
Jimy Tiltman: checks 
lumen21: checks 
*** SHOW DOWN ***
Jimy Tiltman: shows [Qc Tc] (two pair, Kings and Tens)
lumen21: shows [Qd Qh] (two pair, Kings and Queens)
lumen21 collected $6.21 from pot
*** SUMMARY ***
Total pot $6.50 | Rake $0.29 
Board [Js Kh Th 4s Ks]
Seat 1: lumen21 showed [Qd Qh] and won ($6.21) with two pair, Kings and Queens
Seat 2: Benixxx13 folded before Flop (didn't bet)
Seat 3: DUkalisUA folded before Flop (didn't bet)
Seat 4: jensky18 folded before Flop (didn't bet)
Seat 5: ryo728 folded before Flop (didn't bet)
Seat 6: WDW3 folded before Flop (didn't bet)
Seat 7: matiko09 (button) folded before Flop (didn't bet)
Seat 8: Zeeshka (small blind) folded before Flop
Seat 9: Jimy Tiltman (big blind) showed [Qc Tc] and lost with two pair, Kings and Tens





PokerStars Hand #150798610190:  Hold'em No Limit ($0.50/$1.00 USD) - 2016/03/23 13:04:19 CET [2016/03/23 8:04:19 ET]
Table 'Smiley' 9-max Seat #6 is the button
Seat 1: myatiy 96 ($104 in chips) 
Seat 2: YuriiSolodya ($38.50 in chips) 
Seat 3: matiko09 ($100 in chips) 
Seat 4: Zeeshka ($100 in chips) 
Seat 5: DUkalisUA ($100 in chips) 
Seat 6: blackmont111 ($77.50 in chips) 
Seat 7: drosan ($49 in chips) 
Seat 8: RICKA16 ($100 in chips) 
Seat 9: morosun ($81.96 in chips) 
drosan: posts small blind $0.50
RICKA16: posts big blind $1
*** HOLE CARDS ***
Dealt to matiko09 [5c 6c]
morosun: calls $1
myatiy 96: folds 
YuriiSolodya: folds 
matiko09: folds 
Zeeshka: folds 
DUkalisUA: folds 
blackmont111: folds 
drosan: calls $0.50
RICKA16: checks 
*** FLOP *** [4d Ad 6d]
drosan: bets $1
RICKA16: raises $4 to $5
morosun: calls $5
drosan: folds 
*** TURN *** [4d Ad 6d] [7c]
RICKA16: bets $9
morosun: calls $9
*** RIVER *** [4d Ad 6d 7c] [Th]
RICKA16: bets $20
morosun: folds 
Uncalled bet ($20) returned to RICKA16
RICKA16 collected $30.56 from pot
RICKA16: doesn't show hand 
*** SUMMARY ***
Total pot $32 | Rake $1.44 
Board [4d Ad 6d 7c Th]
Seat 1: myatiy 96 folded before Flop (didn't bet)
Seat 2: YuriiSolodya folded before Flop (didn't bet)
Seat 3: matiko09 folded before Flop (didn't bet)
Seat 4: Zeeshka folded before Flop (didn't bet)
Seat 5: DUkalisUA folded before Flop (didn't bet)
Seat 6: blackmont111 (button) folded before Flop (didn't bet)
Seat 7: drosan (small blind) folded on the Flop
Seat 8: RICKA16 (big blind) collected ($30.56)
Seat 9: morosun folded on the River





PokerStars Hand #150798610523:  Hold'em No Limit ($0.50/$1.00 USD) - 2016/03/23 13:04:20 CET [2016/03/23 8:04:20 ET]
Table 'Kippes' 9-max Seat #8 is the button
Seat 1: YuriiSolodya ($69.50 in chips) 
Seat 2: RICKA16 ($124.27 in chips) 
Seat 3: CAJUN890 ($106.87 in chips) 
Seat 4: matiko09 ($103.21 in chips) 
Seat 6: WDW3 ($101.50 in chips) 
Seat 7: lumen21 ($100 in chips) 
Seat 8: Zeeshka ($106.26 in chips) 
Seat 9: wang19790906 ($45.14 in chips) 
wang19790906: posts small blind $0.50
YuriiSolodya: posts big blind $1
*** HOLE CARDS ***
Dealt to matiko09 [Ad Qh]
RICKA16: folds 
CAJUN890: folds 
matiko09: raises $2 to $3
WDW3: folds 
lumen21: calls $3
Zeeshka: calls $3
wang19790906: folds 
YuriiSolodya: folds 
*** FLOP *** [Ac 7c 4s]
matiko09: bets $6.52
lumen21: calls $6.52
Zeeshka: folds 
*** TURN *** [Ac 7c 4s] [Kd]
matiko09: checks 
lumen21: checks 
*** RIVER *** [Ac 7c 4s Kd] [Qs]
matiko09: bets $11
lumen21: folds 
Uncalled bet ($11) returned to matiko09
matiko09 collected $22.48 from pot
matiko09: doesn't show hand 
*** SUMMARY ***
Total pot $23.54 | Rake $1.06 
Board [Ac 7c 4s Kd Qs]
Seat 1: YuriiSolodya (big blind) folded before Flop
Seat 2: RICKA16 folded before Flop (didn't bet)
Seat 3: CAJUN890 folded before Flop (didn't bet)
Seat 4: matiko09 collected ($22.48)
Seat 6: WDW3 folded before Flop (didn't bet)
Seat 7: lumen21 folded on the River
Seat 8: Zeeshka (button) folded on the Flop
Seat 9: wang19790906 (small blind) folded before Flop





PokerStars Hand #150798612791:  Hold'em No Limit ($1/$2 USD) - 2016/03/23 13:04:26 CET [2016/03/23 8:04:26 ET]
Table 'Herba II' 9-max Seat #1 is the button
Seat 1: matiko09 ($206.68 in chips) 
Seat 5: chippo boy ($201 in chips) 
Seat 6: WDW3 ($200 in chips) 
Seat 9: mrhighryza ($110.91 in chips) 
DUkalisUA joins the table at seat #4 
chippo boy: posts small blind $1
WDW3: posts big blind $2
InsomniaRU: sits out 
heisatur: sits out 
*** HOLE CARDS ***
Dealt to matiko09 [2c 2h]
mrhighryza: folds 
matiko09: raises $2.54 to $4.54
chippo boy: folds 
WDW3: calls $2.54
*** FLOP *** [3c Kh 6d]
WDW3: checks 
matiko09: checks 
*** TURN *** [3c Kh 6d] [Ks]
WDW3: checks 
matiko09: checks 
*** RIVER *** [3c Kh 6d Ks] [5h]
WDW3: checks 
matiko09: checks 
*** SHOW DOWN ***
WDW3: shows [Ah Tc] (a pair of Kings)
matiko09: shows [2c 2h] (two pair, Kings and Deuces)
matiko09 collected $9.63 from pot
*** SUMMARY ***
Total pot $10.08 | Rake $0.45 
Board [3c Kh 6d Ks 5h]
Seat 1: matiko09 (button) showed [2c 2h] and won ($9.63) with two pair, Kings and Deuces
Seat 5: chippo boy (small blind) folded before Flop
Seat 6: WDW3 (big blind) showed [Ah Tc] and lost with a pair of Kings
Seat 9: mrhighryza folded before Flop (didn't bet)





PokerStars Hand #150798613028:  Hold'em No Limit ($0.50/$1.00 USD) - 2016/03/23 13:04:27 CET [2016/03/23 8:04:27 ET]
Table 'Atlantis' 9-max Seat #4 is the button
Seat 1: xHourglass ($100 in chips) 
Seat 2: tffff2006 ($65.50 in chips) 
Seat 3: CAJUN890 ($98.50 in chips) 
Seat 4: matiko09 ($151.48 in chips) 
Seat 6: Jimy Tiltman ($113.12 in chips) 
Seat 7: Zeeshka ($100.21 in chips) 
Seat 8: lumen21 ($123.88 in chips) 
Seat 9: WDW3 ($130.37 in chips) 
Jimy Tiltman: posts small blind $0.50
Zeeshka: posts big blind $1
*** HOLE CARDS ***
Dealt to matiko09 [Kh Jh]
lumen21: folds 
WDW3: folds 
xHourglass: raises $2 to $3
tffff2006: calls $3
CAJUN890: folds 
matiko09: calls $3
Jimy Tiltman: calls $2.50
Zeeshka: folds 
*** FLOP *** [Qh 5d Td]
Jimy Tiltman: checks 
xHourglass: bets $9.31
tffff2006: folds 
matiko09: calls $9.31
Jimy Tiltman: folds 
*** TURN *** [Qh 5d Td] [4c]
xHourglass: checks 
matiko09: bets $17
xHourglass: calls $17
*** RIVER *** [Qh 5d Td 4c] [8h]
xHourglass: bets $47.50
matiko09: folds 
Uncalled bet ($47.50) returned to xHourglass
xHourglass collected $62.82 from pot
xHourglass: doesn't show hand 
*** SUMMARY ***
Total pot $65.62 | Rake $2.80 
Board [Qh 5d Td 4c 8h]
Seat 1: xHourglass collected ($62.82)
Seat 2: tffff2006 folded on the Flop
Seat 3: CAJUN890 folded before Flop (didn't bet)
Seat 4: matiko09 (button) folded on the River
Seat 6: Jimy Tiltman (small blind) folded on the Flop
Seat 7: Zeeshka (big blind) folded before Flop
Seat 8: lumen21 folded before Flop (didn't bet)
Seat 9: WDW3 folded before Flop (didn't bet)





PokerStars Hand #150798617228:  Hold'em No Limit ($1/$2 USD) - 2016/03/23 13:04:38 CET [2016/03/23 8:04:38 ET]
Table 'Kiess' 9-max Seat #6 is the button
Seat 1: ldwin8 ($200 in chips) 
Seat 2: DUkalisUA ($469.88 in chips) 
Seat 3: Divannn ($87.60 in chips) 
Seat 5: chippo boy ($199 in chips) 
Seat 6: matiko09 ($200 in chips) 
Seat 7: InsomniaRU ($234.41 in chips) 
Seat 8: WDW3 ($200 in chips) 
Seat 9: Fish4trips ($200 in chips) 
InsomniaRU: posts small blind $1
WDW3: posts big blind $2
*** HOLE CARDS ***
Dealt to matiko09 [3s 7h]
Fish4trips: folds 
ldwin8: folds 
DUkalisUA: raises $4 to $6
Divannn: folds 
chippo boy: calls $6
matiko09: folds 
InsomniaRU: folds 
WDW3: folds 
*** FLOP *** [4d 7c 8s]
DUkalisUA: bets $8
chippo boy: raises $8 to $16
DUkalisUA: calls $8
*** TURN *** [4d 7c 8s] [Ad]
DUkalisUA: checks 
chippo boy: checks 
*** RIVER *** [4d 7c 8s Ad] [5h]
DUkalisUA: bets $15
chippo boy: raises $15 to $30
DUkalisUA: calls $15
*** SHOW DOWN ***
chippo boy: shows [Ac 8c] (two pair, Aces and Eights)
DUkalisUA: shows [7d 6d] (a straight, Four to Eight)
DUkalisUA collected $104.20 from pot
*** SUMMARY ***
Total pot $107 | Rake $2.80 
Board [4d 7c 8s Ad 5h]
Seat 1: ldwin8 folded before Flop (didn't bet)
Seat 2: DUkalisUA showed [7d 6d] and won ($104.20) with a straight, Four to Eight
Seat 3: Divannn folded before Flop (didn't bet)
Seat 5: chippo boy showed [Ac 8c] and lost with two pair, Aces and Eights
Seat 6: matiko09 (button) folded before Flop (didn't bet)
Seat 7: InsomniaRU (small blind) folded before Flop
Seat 8: WDW3 (big blind) folded before Flop
Seat 9: Fish4trips folded before Flop (didn't bet)





PokerStars Hand #150798620005:  Hold'em No Limit ($0.25/$0.50 USD) - 2016/03/23 13:04:46 CET [2016/03/23 8:04:46 ET]
Table 'Wabash II' 9-max Seat #1 is the button
Seat 1: whalldo ($53.38 in chips) 
Seat 2: Zeeshka ($50.25 in chips) 
Seat 3: SupremeXS ($26.45 in chips) 
Seat 4: Bohne0815 ($50.28 in chips) 
Seat 5: hovora ($87.10 in chips) 
Seat 6: matiko09 ($52.84 in chips) 
Seat 7: jorazag ($44.24 in chips) 
Seat 8: fandorin2005 ($58.16 in chips) 
Seat 9: rooniy2000 ($50.68 in chips) 
Zeeshka: posts small blind $0.25
SupremeXS: posts big blind $0.50
*** HOLE CARDS ***
Dealt to matiko09 [Qc 7c]
Bohne0815: folds 
hovora: folds 
matiko09: folds 
jorazag: folds 
fandorin2005: folds 
rooniy2000: folds 
whalldo: raises $0.50 to $1
Zeeshka: folds 
SupremeXS: calls $0.50
*** FLOP *** [3s 4c 2d]
SupremeXS: checks 
whalldo: checks 
*** TURN *** [3s 4c 2d] [9h]
SupremeXS: bets $1.50
whalldo: folds 
Uncalled bet ($1.50) returned to SupremeXS
SupremeXS collected $2.15 from pot
SupremeXS: doesn't show hand 
*** SUMMARY ***
Total pot $2.25 | Rake $0.10 
Board [3s 4c 2d 9h]
Seat 1: whalldo (button) folded on the Turn
Seat 2: Zeeshka (small blind) folded before Flop
Seat 3: SupremeXS (big blind) collected ($2.15)
Seat 4: Bohne0815 folded before Flop (didn't bet)
Seat 5: hovora folded before Flop (didn't bet)
Seat 6: matiko09 folded before Flop (didn't bet)
Seat 7: jorazag folded before Flop (didn't bet)
Seat 8: fandorin2005 folded before Flop (didn't bet)
Seat 9: rooniy2000 folded before Flop (didn't bet)





PokerStars Hand #150798630010:  Hold'em No Limit ($0.50/$1.00 USD) - 2016/03/23 13:05:13 CET [2016/03/23 8:05:13 ET]
Table 'Lyot II' 9-max Seat #1 is the button
Seat 1: Zeeshka ($104.55 in chips) 
Seat 2: albert_ratza ($117.96 in chips) 
Seat 3: chauyeuba ($48.50 in chips) 
Seat 5: xHourglass ($102.44 in chips) 
Seat 6: ricardo2604 ($80.21 in chips) 
Seat 7: matiko09 ($102.33 in chips) 
Seat 8: yuminyumin1 ($118.52 in chips) 
Seat 9: pablos1922 ($26.18 in chips) 
albert_ratza: posts small blind $0.50
chauyeuba: posts big blind $1
Jimy Tiltman: sits out 
*** HOLE CARDS ***
Dealt to matiko09 [7h Th]
xHourglass: folds 
ricardo2604: folds 
matiko09: folds 
yuminyumin1: folds 
pablos1922: folds 
Zeeshka: folds 
albert_ratza: calls $0.50
chauyeuba: checks 
*** FLOP *** [9h 5h Jc]
albert_ratza: checks 
chauyeuba: checks 
*** TURN *** [9h 5h Jc] [Tc]
albert_ratza: checks 
chauyeuba: checks 
*** RIVER *** [9h 5h Jc Tc] [3h]
albert_ratza: bets $1
chauyeuba: folds 
Uncalled bet ($1) returned to albert_ratza
albert_ratza collected $1.91 from pot
albert_ratza: doesn't show hand 
*** SUMMARY ***
Total pot $2 | Rake $0.09 
Board [9h 5h Jc Tc 3h]
Seat 1: Zeeshka (button) folded before Flop (didn't bet)
Seat 2: albert_ratza (small blind) collected ($1.91)
Seat 3: chauyeuba (big blind) folded on the River
Seat 5: xHourglass folded before Flop (didn't bet)
Seat 6: ricardo2604 folded before Flop (didn't bet)
Seat 7: matiko09 folded before Flop (didn't bet)
Seat 8: yuminyumin1 folded before Flop (didn't bet)
Seat 9: pablos1922 folded before Flop (didn't bet)





PokerStars Hand #150798633900:  Hold'em No Limit ($1/$2 USD) - 2016/03/23 13:05:23 CET [2016/03/23 8:05:23 ET]
Table 'Herba II' 9-max Seat #5 is the button
Seat 1: matiko09 ($211.77 in chips) 
Seat 5: chippo boy ($200 in chips) 
Seat 6: WDW3 ($200 in chips) 
Seat 7: InsomniaRU ($200 in chips) 
Seat 9: mrhighryza ($110.91 in chips) 
WDW3: posts small blind $1
InsomniaRU: posts big blind $2
heisatur: sits out 
DUkalisUA: sits out 
*** HOLE CARDS ***
Dealt to matiko09 [3s 5h]
mrhighryza: folds 
matiko09: folds 
chippo boy: calls $2
WDW3: raises $6 to $8
InsomniaRU: folds 
chippo boy: calls $6
*** FLOP *** [Th 6d Js]
WDW3: checks 
chippo boy: bets $8
WDW3: calls $8
*** TURN *** [Th 6d Js] [Kd]
WDW3: checks 
chippo boy: checks 
*** RIVER *** [Th 6d Js Kd] [8h]
Daveguyaces joins the table at seat #3 
WDW3: bets $28
chippo boy: folds 
Uncalled bet ($28) returned to WDW3
Moszes360 joins the table at seat #2 
WDW3 collected $32.47 from pot
WDW3: doesn't show hand 
*** SUMMARY ***
Total pot $34 | Rake $1.53 
Board [Th 6d Js Kd 8h]
Seat 1: matiko09 folded before Flop (didn't bet)
Seat 5: chippo boy (button) folded on the River
Seat 6: WDW3 (small blind) collected ($32.47)
Seat 7: InsomniaRU (big blind) folded before Flop
Seat 9: mrhighryza folded before Flop (didn't bet)





PokerStars Hand #150798634298:  Hold'em No Limit ($0.50/$1.00 USD) - 2016/03/23 13:05:24 CET [2016/03/23 8:05:24 ET]
Table 'Oljato' 9-max Seat #8 is the button
Seat 2: Benixxx13 ($98.50 in chips) 
Seat 3: DUkalisUA ($100 in chips) 
Seat 5: ryo728 ($85.75 in chips) 
Seat 6: WDW3 ($114.74 in chips) 
Seat 7: matiko09 ($148.24 in chips) 
Seat 8: Zeeshka ($213.40 in chips) 
Seat 9: Jimy Tiltman ($100 in chips) 
Jimy Tiltman: posts small blind $0.50
lumen21: is sitting out 
Benixxx13: posts big blind $1
Pvsx.: sits out 
*** HOLE CARDS ***
Dealt to matiko09 [Qd 8c]
DUkalisUA: folds 
lumen21 leaves the table
ryo728: folds 
Pearl Jam87 joins the table at seat #1 
WDW3: raises $1.80 to $2.80
matiko09: folds 
Zeeshka: raises $6.20 to $9
Jimy Tiltman: folds 
Benixxx13: folds 
WDW3: folds 
Uncalled bet ($6.20) returned to Zeeshka
Zeeshka collected $7.10 from pot
Zeeshka: doesn't show hand 
*** SUMMARY ***
Total pot $7.10 | Rake $0 
Seat 2: Benixxx13 (big blind) folded before Flop
Seat 3: DUkalisUA folded before Flop (didn't bet)
Seat 5: ryo728 folded before Flop (didn't bet)
Seat 6: WDW3 folded before Flop
Seat 7: matiko09 folded before Flop (didn't bet)
Seat 8: Zeeshka (button) collected ($7.10)
Seat 9: Jimy Tiltman (small blind) folded before Flop





PokerStars Hand #150798636842:  Hold'em No Limit ($0.50/$1.00 USD) - 2016/03/23 13:05:31 CET [2016/03/23 8:05:31 ET]
Table 'Kippes' 9-max Seat #9 is the button
Seat 1: YuriiSolodya ($68.50 in chips) 
Seat 2: RICKA16 ($124.27 in chips) 
Seat 3: CAJUN890 ($106.87 in chips) 
Seat 4: matiko09 ($116.17 in chips) 
Seat 6: WDW3 ($101.50 in chips) 
Seat 7: lumen21 ($100 in chips) 
Seat 8: Zeeshka ($103.26 in chips) 
Seat 9: wang19790906 ($44.64 in chips) 
YuriiSolodya: posts small blind $0.50
RICKA16: posts big blind $1
*** HOLE CARDS ***
Dealt to matiko09 [7c 7d]
CAJUN890: folds 
matiko09: raises $2 to $3
WDW3: folds 
lumen21: folds 
Zeeshka: folds 
wang19790906: calls $3
YuriiSolodya: folds 
RICKA16: folds 
*** FLOP *** [7s 2h 4h]
matiko09: checks 
wang19790906: checks 
*** TURN *** [7s 2h 4h] [5h]
matiko09: bets $5
wang19790906: raises $9 to $14
matiko09: calls $9
*** RIVER *** [7s 2h 4h 5h] [Qh]
matiko09: checks 
wang19790906: bets $27.64 and is all-in
matiko09: folds 
Uncalled bet ($27.64) returned to wang19790906
wang19790906 collected $33.90 from pot
wang19790906: doesn't show hand 
*** SUMMARY ***
Total pot $35.50 | Rake $1.60 
Board [7s 2h 4h 5h Qh]
Seat 1: YuriiSolodya (small blind) folded before Flop
Seat 2: RICKA16 (big blind) folded before Flop
Seat 3: CAJUN890 folded before Flop (didn't bet)
Seat 4: matiko09 folded on the River
Seat 6: WDW3 folded before Flop (didn't bet)
Seat 7: lumen21 folded before Flop (didn't bet)
Seat 8: Zeeshka folded before Flop (didn't bet)
Seat 9: wang19790906 (button) collected ($33.90)





PokerStars Hand #150798638227:  Hold'em No Limit ($0.25/$0.50 USD) - 2016/03/23 13:05:34 CET [2016/03/23 8:05:34 ET]
Table 'Wabash II' 9-max Seat #2 is the button
Seat 1: whalldo ($52.38 in chips) 
Seat 2: Zeeshka ($50 in chips) 
Seat 3: SupremeXS ($27.60 in chips) 
Seat 4: Bohne0815 ($50.28 in chips) 
Seat 5: hovora ($87.10 in chips) 
Seat 6: matiko09 ($52.84 in chips) 
Seat 7: jorazag ($44.24 in chips) 
Seat 8: fandorin2005 ($58.16 in chips) 
Seat 9: rooniy2000 ($50.68 in chips) 
SupremeXS: posts small blind $0.25
Bohne0815: posts big blind $0.50
*** HOLE CARDS ***
Dealt to matiko09 [5s Ks]
hovora: folds 
matiko09: folds 
jorazag: raises $1 to $1.50
fandorin2005: folds 
rooniy2000: folds 
whalldo: folds 
Zeeshka: folds 
SupremeXS: folds 
Bohne0815: folds 
Uncalled bet ($1) returned to jorazag
jorazag collected $1.25 from pot
jorazag: doesn't show hand 
*** SUMMARY ***
Total pot $1.25 | Rake $0 
Seat 1: whalldo folded before Flop (didn't bet)
Seat 2: Zeeshka (button) folded before Flop (didn't bet)
Seat 3: SupremeXS (small blind) folded before Flop
Seat 4: Bohne0815 (big blind) folded before Flop
Seat 5: hovora folded before Flop (didn't bet)
Seat 6: matiko09 folded before Flop (didn't bet)
Seat 7: jorazag collected ($1.25)
Seat 8: fandorin2005 folded before Flop (didn't bet)
Seat 9: rooniy2000 folded before Flop (didn't bet)





PokerStars Hand #150798638660:  Hold'em No Limit ($0.25/$0.50 USD) - 2016/03/23 13:05:35 CET [2016/03/23 8:05:35 ET]
Table 'Pyrrhus' 9-max Seat #7 is the button
Seat 1: 1Maxx123 ($86.13 in chips) 
Seat 2: fandorin2005 ($50 in chips) 
Seat 4: Pokerlkl ($39.67 in chips) 
Seat 6: whalldo ($64.26 in chips) 
Seat 7: matiko09 ($73.02 in chips) 
Seat 8: RulingEmu ($31.42 in chips) 
Seat 9: Bohne0815 ($52.70 in chips) 
RulingEmu: posts small blind $0.25
Bohne0815: posts big blind $0.50
Ahangama: sits out 
*** HOLE CARDS ***
Dealt to matiko09 [2c 2d]
1Maxx123: folds 
fandorin2005: folds 
Pokerlkl: raises $1 to $1.50
whalldo: folds 
matiko09: calls $1.50
RulingEmu: calls $1.25
Bohne0815: folds 
*** FLOP *** [Qd Qs 6s]
RulingEmu: checks 
Pokerlkl: bets $8
matiko09: folds 
RulingEmu: folds 
Uncalled bet ($8) returned to Pokerlkl
Pokerlkl collected $4.78 from pot
*** SUMMARY ***
Total pot $5 | Rake $0.22 
Board [Qd Qs 6s]
Seat 1: 1Maxx123 folded before Flop (didn't bet)
Seat 2: fandorin2005 folded before Flop (didn't bet)
Seat 4: Pokerlkl collected ($4.78)
Seat 6: whalldo folded before Flop (didn't bet)
Seat 7: matiko09 (button) folded on the Flop
Seat 8: RulingEmu (small blind) folded on the Flop
Seat 9: Bohne0815 (big blind) folded before Flop





PokerStars Hand #150798639055:  Hold'em No Limit ($0.50/$1.00 USD) - 2016/03/23 13:05:36 CET [2016/03/23 8:05:36 ET]
Table 'Smiley' 9-max Seat #7 is the button
Seat 1: myatiy 96 ($104 in chips) 
Seat 2: YuriiSolodya ($38.50 in chips) 
Seat 3: matiko09 ($100 in chips) 
Seat 4: Zeeshka ($100 in chips) 
Seat 5: DUkalisUA ($100 in chips) 
Seat 6: blackmont111 ($77.50 in chips) 
Seat 7: drosan ($47 in chips) 
Seat 8: RICKA16 ($115.56 in chips) 
Seat 9: morosun ($66.96 in chips) 
RICKA16: posts small blind $0.50
morosun: posts big blind $1
*** HOLE CARDS ***
Dealt to matiko09 [5d 9s]
myatiy 96: folds 
YuriiSolodya: folds 
matiko09: folds 
Zeeshka: folds 
DUkalisUA: folds 
blackmont111: folds 
drosan: raises $2 to $3
RICKA16: folds 
morosun: folds 
Uncalled bet ($2) returned to drosan
drosan collected $2.50 from pot
drosan: doesn't show hand 
*** SUMMARY ***
Total pot $2.50 | Rake $0 
Seat 1: myatiy 96 folded before Flop (didn't bet)
Seat 2: YuriiSolodya folded before Flop (didn't bet)
Seat 3: matiko09 folded before Flop (didn't bet)
Seat 4: Zeeshka folded before Flop (didn't bet)
Seat 5: DUkalisUA folded before Flop (didn't bet)
Seat 6: blackmont111 folded before Flop (didn't bet)
Seat 7: drosan (button) collected ($2.50)
Seat 8: RICKA16 (small blind) folded before Flop
Seat 9: morosun (big blind) folded before Flop





PokerStars Hand #150798643985:  Hold'em No Limit ($1/$2 USD) - 2016/03/23 13:05:49 CET [2016/03/23 8:05:49 ET]
Table 'Kypria II' 9-max Seat #9 is the button
Seat 1: geldwolfje ($275.62 in chips) 
Seat 2: coinflip_si ($200 in chips) 
Seat 3: seouljam ($115.82 in chips) 
Seat 4: nailz83 ($65 in chips) 
Seat 5: Charity86 ($115.12 in chips) 
Seat 6: matiko09 ($215.60 in chips) 
Seat 7: ldwin8 ($325.16 in chips) 
Seat 8: Fish4trips ($200 in chips) 
Seat 9: WDW3 ($200 in chips) 
geldwolfje: posts small blind $1
coinflip_si: posts big blind $2
*** HOLE CARDS ***
Dealt to matiko09 [8h 6h]
seouljam: folds 
nailz83: calls $2
Charity86: folds 
matiko09: folds 
ldwin8: folds 
Fish4trips: folds 
WDW3: folds 
geldwolfje: calls $1
coinflip_si: checks 
*** FLOP *** [7h 6c Qc]
geldwolfje: checks 
coinflip_si: checks 
nailz83: checks 
*** TURN *** [7h 6c Qc] [5h]
geldwolfje: checks 
coinflip_si: bets $4.13
nailz83: calls $4.13
geldwolfje: folds 
*** RIVER *** [7h 6c Qc 5h] [Qh]
coinflip_si: bets $10.49
nailz83: folds 
Uncalled bet ($10.49) returned to coinflip_si
coinflip_si collected $13.62 from pot
coinflip_si: doesn't show hand 
*** SUMMARY ***
Total pot $14.26 | Rake $0.64 
Board [7h 6c Qc 5h Qh]
Seat 1: geldwolfje (small blind) folded on the Turn
Seat 2: coinflip_si (big blind) collected ($13.62)
Seat 3: seouljam folded before Flop (didn't bet)
Seat 4: nailz83 folded on the River
Seat 5: Charity86 folded before Flop (didn't bet)
Seat 6: matiko09 folded before Flop (didn't bet)
Seat 7: ldwin8 folded before Flop (didn't bet)
Seat 8: Fish4trips folded before Flop (didn't bet)
Seat 9: WDW3 (button) folded before Flop (didn't bet)





PokerStars Hand #150798645247:  Hold'em No Limit ($0.50/$1.00 USD) - 2016/03/23 13:05:52 CET [2016/03/23 8:05:52 ET]
Table 'Lyot II' 9-max Seat #2 is the button
Seat 1: Zeeshka ($104.55 in chips) 
Seat 2: albert_ratza ($118.87 in chips) 
Seat 3: chauyeuba ($47.50 in chips) 
Seat 4: Jimy Tiltman ($100 in chips) 
Seat 5: xHourglass ($102.44 in chips) 
Seat 6: ricardo2604 ($80.21 in chips) 
Seat 7: matiko09 ($102.33 in chips) 
Seat 8: yuminyumin1 ($118.52 in chips) 
Seat 9: pablos1922 ($26.18 in chips) 
chauyeuba: posts small blind $0.50
Jimy Tiltman: posts big blind $1
*** HOLE CARDS ***
Dealt to matiko09 [6h 8h]
xHourglass: folds 
ricardo2604: folds 
matiko09: folds 
yuminyumin1: raises $1 to $2
pablos1922: folds 
Zeeshka: folds 
albert_ratza: folds 
chauyeuba: raises $6 to $8
Jimy Tiltman: folds 
yuminyumin1: folds 
Uncalled bet ($6) returned to chauyeuba
chauyeuba collected $5 from pot
chauyeuba: doesn't show hand 
*** SUMMARY ***
Total pot $5 | Rake $0 
Seat 1: Zeeshka folded before Flop (didn't bet)
Seat 2: albert_ratza (button) folded before Flop (didn't bet)
Seat 3: chauyeuba (small blind) collected ($5)
Seat 4: Jimy Tiltman (big blind) folded before Flop
Seat 5: xHourglass folded before Flop (didn't bet)
Seat 6: ricardo2604 folded before Flop (didn't bet)
Seat 7: matiko09 folded before Flop (didn't bet)
Seat 8: yuminyumin1 folded before Flop
Seat 9: pablos1922 folded before Flop (didn't bet)





PokerStars Hand #150798645655:  Hold'em No Limit ($1/$2 USD) - 2016/03/23 13:05:54 CET [2016/03/23 8:05:54 ET]
Table 'Kiess' 9-max Seat #7 is the button
Seat 1: ldwin8 ($200 in chips) 
Seat 2: DUkalisUA ($522.08 in chips) 
Seat 3: Divannn ($87.60 in chips) 
Seat 5: chippo boy ($147 in chips) 
Seat 6: matiko09 ($200 in chips) 
Seat 7: InsomniaRU ($233.41 in chips) 
Seat 8: WDW3 ($200 in chips) 
Seat 9: Fish4trips ($200 in chips) 
WDW3: posts small blind $1
Fish4trips: posts big blind $2
*** HOLE CARDS ***
Dealt to matiko09 [3s Qs]
ldwin8: folds 
DUkalisUA: folds 
Divannn: folds 
chippo boy: raises $4 to $6
matiko09: folds 
InsomniaRU: folds 
WDW3: folds 
Fish4trips: folds 
Uncalled bet ($4) returned to chippo boy
chippo boy collected $5 from pot
*** SUMMARY ***
Total pot $5 | Rake $0 
Seat 1: ldwin8 folded before Flop (didn't bet)
Seat 2: DUkalisUA folded before Flop (didn't bet)
Seat 3: Divannn folded before Flop (didn't bet)
Seat 5: chippo boy collected ($5)
Seat 6: matiko09 folded before Flop (didn't bet)
Seat 7: InsomniaRU (button) folded before Flop (didn't bet)
Seat 8: WDW3 (small blind) folded before Flop
Seat 9: Fish4trips (big blind) folded before Flop





PokerStars Hand #150798647010:  Hold'em No Limit ($0.50/$1.00 USD) - 2016/03/23 13:05:57 CET [2016/03/23 8:05:57 ET]
Table 'Oljato' 9-max Seat #9 is the button
Seat 2: Benixxx13 ($97.50 in chips) 
Seat 3: DUkalisUA ($100 in chips) 
Seat 5: ryo728 ($85.75 in chips) 
Seat 6: WDW3 ($111.94 in chips) 
Seat 7: matiko09 ($148.24 in chips) 
Seat 8: Zeeshka ($217.70 in chips) 
Seat 9: Jimy Tiltman ($100 in chips) 
Pearl Jam87 will be allowed to play after the button
Benixxx13: posts small blind $0.50
DUkalisUA: posts big blind $1
Pvsx.: sits out 
*** HOLE CARDS ***
Dealt to matiko09 [9s As]
ryo728: folds 
WDW3: folds 
matiko09: raises $2 to $3
Zeeshka: folds 
Jimy Tiltman: calls $3
Benixxx13: folds 
DUkalisUA: folds 
*** FLOP *** [4s 2d 2h]
matiko09: bets $4.65
Jimy Tiltman: calls $4.65
*** TURN *** [4s 2d 2h] [7c]
matiko09: bets $10
Jimy Tiltman: calls $10
*** RIVER *** [4s 2d 2h 7c] [6h]
matiko09: bets $24
Jimy Tiltman: folds 
Uncalled bet ($24) returned to matiko09
matiko09 collected $35.14 from pot
matiko09: doesn't show hand 
*** SUMMARY ***
Total pot $36.80 | Rake $1.66 
Board [4s 2d 2h 7c 6h]
Seat 2: Benixxx13 (small blind) folded before Flop
Seat 3: DUkalisUA (big blind) folded before Flop
Seat 5: ryo728 folded before Flop (didn't bet)
Seat 6: WDW3 folded before Flop (didn't bet)
Seat 7: matiko09 collected ($35.14)
Seat 8: Zeeshka folded before Flop (didn't bet)
Seat 9: Jimy Tiltman (button) folded on the River





PokerStars Hand #150798647723:  Hold'em No Limit ($0.25/$0.50 USD) - 2016/03/23 13:05:59 CET [2016/03/23 8:05:59 ET]
Table 'Wabash II' 9-max Seat #3 is the button
Seat 1: whalldo ($52.38 in chips) 
Seat 2: Zeeshka ($50 in chips) 
Seat 3: SupremeXS ($27.35 in chips) 
Seat 4: Bohne0815 ($49.78 in chips) 
Seat 5: hovora ($87.10 in chips) 
Seat 6: matiko09 ($52.84 in chips) 
Seat 7: jorazag ($44.99 in chips) 
Seat 8: fandorin2005 ($58.16 in chips) 
Seat 9: rooniy2000 ($50.68 in chips) 
Bohne0815: posts small blind $0.25
hovora: posts big blind $0.50
*** HOLE CARDS ***
Dealt to matiko09 [2h Jd]
matiko09: folds 
jorazag: folds 
fandorin2005: folds 
rooniy2000: folds 
whalldo: folds 
Zeeshka: folds 
SupremeXS: folds 
Bohne0815: folds 
Uncalled bet ($0.25) returned to hovora
hovora collected $0.50 from pot
hovora: doesn't show hand 
*** SUMMARY ***
Total pot $0.50 | Rake $0 
Seat 1: whalldo folded before Flop (didn't bet)
Seat 2: Zeeshka folded before Flop (didn't bet)
Seat 3: SupremeXS (button) folded before Flop (didn't bet)
Seat 4: Bohne0815 (small blind) folded before Flop
Seat 5: hovora (big blind) collected ($0.50)
Seat 6: matiko09 folded before Flop (didn't bet)
Seat 7: jorazag folded before Flop (didn't bet)
Seat 8: fandorin2005 folded before Flop (didn't bet)
Seat 9: rooniy2000 folded before Flop (didn't bet)





PokerStars Hand #150798649869:  Hold'em No Limit ($0.50/$1.00 USD) - 2016/03/23 13:06:05 CET [2016/03/23 8:06:05 ET]
Table 'Smiley' 9-max Seat #8 is the button
Seat 2: YuriiSolodya ($38.50 in chips) 
Seat 3: matiko09 ($100 in chips) 
Seat 4: Zeeshka ($100 in chips) 
Seat 5: DUkalisUA ($100 in chips) 
Seat 6: blackmont111 ($77.50 in chips) 
Seat 7: drosan ($48.50 in chips) 
Seat 8: RICKA16 ($115.06 in chips) 
Seat 9: morosun ($65.96 in chips) 
morosun: posts small blind $0.50
myatiy 96: is sitting out 
YuriiSolodya: posts big blind $1
*** HOLE CARDS ***
Dealt to matiko09 [6c Jh]
myatiy 96 leaves the table
WDW3 joins the table at seat #1 
matiko09: folds 
Zeeshka: folds 
DUkalisUA: folds 
blackmont111: folds 
drosan: raises $2 to $3
RICKA16: folds 
morosun: calls $2.50
YuriiSolodya: folds 
*** FLOP *** [9s Ac 9h]
morosun: checks 
drosan: bets $6.68
morosun: folds 
Uncalled bet ($6.68) returned to drosan
drosan collected $6.68 from pot
drosan: doesn't show hand 
*** SUMMARY ***
Total pot $7 | Rake $0.32 
Board [9s Ac 9h]
Seat 2: YuriiSolodya (big blind) folded before Flop
Seat 3: matiko09 folded before Flop (didn't bet)
Seat 4: Zeeshka folded before Flop (didn't bet)
Seat 5: DUkalisUA folded before Flop (didn't bet)
Seat 6: blackmont111 folded before Flop (didn't bet)
Seat 7: drosan collected ($6.68)
Seat 8: RICKA16 (button) folded before Flop (didn't bet)
Seat 9: morosun (small blind) folded on the Flop





PokerStars Hand #150798651581:  Hold'em No Limit ($0.50/$1.00 USD) - 2016/03/23 13:06:09 CET [2016/03/23 8:06:09 ET]
Table 'Atlantis' 9-max Seat #6 is the button
Seat 1: xHourglass ($133.51 in chips) 
Seat 2: tffff2006 ($62.50 in chips) 
Seat 3: CAJUN890 ($98.50 in chips) 
Seat 4: matiko09 ($122.17 in chips) 
Seat 6: Jimy Tiltman ($110.12 in chips) 
Seat 7: Zeeshka ($100 in chips) 
Seat 8: lumen21 ($123.88 in chips) 
Seat 9: WDW3 ($130.37 in chips) 
Zeeshka: posts small blind $0.50
lumen21: posts big blind $1
*** HOLE CARDS ***
Dealt to matiko09 [Kd 8c]
WDW3: folds 
xHourglass: folds 
tffff2006: folds 
CAJUN890: folds 
matiko09: folds 
Jimy Tiltman: folds 
Zeeshka: folds 
Uncalled bet ($0.50) returned to lumen21
lumen21 collected $1 from pot
lumen21: doesn't show hand 
*** SUMMARY ***
Total pot $1 | Rake $0 
Seat 1: xHourglass folded before Flop (didn't bet)
Seat 2: tffff2006 folded before Flop (didn't bet)
Seat 3: CAJUN890 folded before Flop (didn't bet)
Seat 4: matiko09 folded before Flop (didn't bet)
Seat 6: Jimy Tiltman (button) folded before Flop (didn't bet)
Seat 7: Zeeshka (small blind) folded before Flop
Seat 8: lumen21 (big blind) collected ($1)
Seat 9: WDW3 folded before Flop (didn't bet)





PokerStars Hand #150798658316:  Hold'em No Limit ($0.25/$0.50 USD) - 2016/03/23 13:06:26 CET [2016/03/23 8:06:26 ET]
Table 'Wabash II' 9-max Seat #4 is the button
Seat 1: whalldo ($52.38 in chips) 
Seat 2: Zeeshka ($50 in chips) 
Seat 3: SupremeXS ($27.35 in chips) 
Seat 4: Bohne0815 ($49.53 in chips) 
Seat 5: hovora ($87.35 in chips) 
Seat 6: matiko09 ($52.84 in chips) 
Seat 7: jorazag ($44.99 in chips) 
Seat 8: fandorin2005 ($58.16 in chips) 
Seat 9: rooniy2000 ($50.68 in chips) 
hovora: posts small blind $0.25
matiko09: posts big blind $0.50
*** HOLE CARDS ***
Dealt to matiko09 [Jd 8h]
jorazag: folds 
fandorin2005: folds 
rooniy2000: raises $1 to $1.50
whalldo: folds 
Zeeshka: calls $1.50
SupremeXS: folds 
Bohne0815: calls $1.50
hovora: folds 
matiko09: folds 
*** FLOP *** [Jc Kh As]
rooniy2000: checks 
Zeeshka: checks 
Bohne0815: checks 
*** TURN *** [Jc Kh As] [9d]
rooniy2000: bets $3
Zeeshka: folds 
Bohne0815: folds 
Uncalled bet ($3) returned to rooniy2000
rooniy2000 collected $5.01 from pot
rooniy2000: doesn't show hand 
*** SUMMARY ***
Total pot $5.25 | Rake $0.24 
Board [Jc Kh As 9d]
Seat 1: whalldo folded before Flop (didn't bet)
Seat 2: Zeeshka folded on the Turn
Seat 3: SupremeXS folded before Flop (didn't bet)
Seat 4: Bohne0815 (button) folded on the Turn
Seat 5: hovora (small blind) folded before Flop
Seat 6: matiko09 (big blind) folded before Flop
Seat 7: jorazag folded before Flop (didn't bet)
Seat 8: fandorin2005 folded before Flop (didn't bet)
Seat 9: rooniy2000 collected ($5.01)





PokerStars Hand #150798659008:  Hold'em No Limit ($0.50/$1.00 USD) - 2016/03/23 13:06:28 CET [2016/03/23 8:06:28 ET]
Table 'Atlantis' 9-max Seat #7 is the button
Seat 1: xHourglass ($133.51 in chips) 
Seat 2: tffff2006 ($62.50 in chips) 
Seat 3: CAJUN890 ($98.50 in chips) 
Seat 4: matiko09 ($122.17 in chips) 
Seat 6: Jimy Tiltman ($110.12 in chips) 
Seat 7: Zeeshka ($100 in chips) 
Seat 8: lumen21 ($124.38 in chips) 
Seat 9: WDW3 ($130.37 in chips) 
lumen21: posts small blind $0.50
WDW3: posts big blind $1
*** HOLE CARDS ***
Dealt to matiko09 [6s Th]
xHourglass: folds 
tffff2006: calls $1
CAJUN890: folds 
matiko09: folds 
Jimy Tiltman: raises $2.50 to $3.50
Zeeshka: calls $3.50
lumen21: folds 
WDW3: folds 
tffff2006: calls $2.50
*** FLOP *** [Qs 4s As]
tffff2006: checks 
Jimy Tiltman: checks 
Zeeshka: bets $7.67
tffff2006: folds 
Jimy Tiltman: folds 
Uncalled bet ($7.67) returned to Zeeshka
Zeeshka collected $11.46 from pot
Zeeshka: doesn't show hand 
*** SUMMARY ***
Total pot $12 | Rake $0.54 
Board [Qs 4s As]
Seat 1: xHourglass folded before Flop (didn't bet)
Seat 2: tffff2006 folded on the Flop
Seat 3: CAJUN890 folded before Flop (didn't bet)
Seat 4: matiko09 folded before Flop (didn't bet)
Seat 6: Jimy Tiltman folded on the Flop
Seat 7: Zeeshka (button) collected ($11.46)
Seat 8: lumen21 (small blind) folded before Flop
Seat 9: WDW3 (big blind) folded before Flop





PokerStars Hand #150798660086:  Hold'em No Limit ($1/$2 USD) - 2016/03/23 13:06:30 CET [2016/03/23 8:06:30 ET]
Table 'Kiess' 9-max Seat #8 is the button
Seat 1: ldwin8 ($200 in chips) 
Seat 2: DUkalisUA ($522.08 in chips) 
Seat 3: Divannn ($87.60 in chips) 
Seat 5: chippo boy ($200 in chips) 
Seat 6: matiko09 ($200 in chips) 
Seat 7: InsomniaRU ($233.41 in chips) 
Seat 8: WDW3 ($200 in chips) 
Seat 9: Fish4trips ($200 in chips) 
Fish4trips: posts small blind $1
ldwin8: posts big blind $2
*** HOLE CARDS ***
Dealt to matiko09 [4c Ts]
DUkalisUA: folds 
Divannn: raises $2 to $4
chippo boy: folds 
matiko09: folds 
InsomniaRU: folds 
WDW3: folds 
Fish4trips: folds 
ldwin8: folds 
Uncalled bet ($2) returned to Divannn
Divannn collected $5 from pot
*** SUMMARY ***
Total pot $5 | Rake $0 
Seat 1: ldwin8 (big blind) folded before Flop
Seat 2: DUkalisUA folded before Flop (didn't bet)
Seat 3: Divannn collected ($5)
Seat 5: chippo boy folded before Flop (didn't bet)
Seat 6: matiko09 folded before Flop (didn't bet)
Seat 7: InsomniaRU folded before Flop (didn't bet)
Seat 8: WDW3 (button) folded before Flop (didn't bet)
Seat 9: Fish4trips (small blind) folded before Flop





PokerStars Hand #150798663709:  Hold'em No Limit ($0.50/$1.00 USD) - 2016/03/23 13:06:40 CET [2016/03/23 8:06:40 ET]
Table 'Lyot II' 9-max Seat #3 is the button
Seat 1: Zeeshka ($104.55 in chips) 
Seat 2: albert_ratza ($118.87 in chips) 
Seat 3: chauyeuba ($50.50 in chips) 
Seat 4: Jimy Tiltman ($100 in chips) 
Seat 5: xHourglass ($102.44 in chips) 
Seat 6: ricardo2604 ($80.21 in chips) 
Seat 7: matiko09 ($102.33 in chips) 
Seat 8: yuminyumin1 ($116.52 in chips) 
Seat 9: pablos1922 ($26.18 in chips) 
Jimy Tiltman: posts small blind $0.50
xHourglass: posts big blind $1
*** HOLE CARDS ***
Dealt to matiko09 [9s Ac]
ricardo2604: folds 
matiko09: folds 
yuminyumin1: calls $1
pablos1922: folds 
Zeeshka: folds 
albert_ratza: folds 
chauyeuba: folds 
Jimy Tiltman: raises $2.50 to $3.50
xHourglass: calls $2.50
ricardo2604 leaves the table
yuminyumin1: calls $2.50
*** FLOP *** [Qd 4d 3h]
Jimy Tiltman: bets $7
xHourglass: folds 
yuminyumin1: folds 
Uncalled bet ($7) returned to Jimy Tiltman
Jimy Tiltman collected $10.03 from pot
Jimy Tiltman: doesn't show hand 
*** SUMMARY ***
Total pot $10.50 | Rake $0.47 
Board [Qd 4d 3h]
Seat 1: Zeeshka folded before Flop (didn't bet)
Seat 2: albert_ratza folded before Flop (didn't bet)
Seat 3: chauyeuba (button) folded before Flop (didn't bet)
Seat 4: Jimy Tiltman (small blind) collected ($10.03)
Seat 5: xHourglass (big blind) folded on the Flop
Seat 6: ricardo2604 folded before Flop (didn't bet)
Seat 7: matiko09 folded before Flop (didn't bet)
Seat 8: yuminyumin1 folded on the Flop
Seat 9: pablos1922 folded before Flop (didn't bet)





PokerStars Hand #150798666139:  Hold'em No Limit ($0.25/$0.50 USD) - 2016/03/23 13:06:46 CET [2016/03/23 8:06:46 ET]
Table 'Pyrrhus' 9-max Seat #8 is the button
Seat 1: 1Maxx123 ($86.13 in chips) 
Seat 2: fandorin2005 ($50 in chips) 
Seat 4: Pokerlkl ($42.95 in chips) 
Seat 5: lengcunjuan ($50 in chips) 
Seat 6: whalldo ($64.26 in chips) 
Seat 7: matiko09 ($71.52 in chips) 
Seat 8: RulingEmu ($29.92 in chips) 
Seat 9: Bohne0815 ($52.20 in chips) 
Bohne0815: posts small blind $0.25
1Maxx123: posts big blind $0.50
Ahangama: sits out 
*** HOLE CARDS ***
Dealt to matiko09 [Qh 6s]
fandorin2005: folds 
Pokerlkl: folds 
lengcunjuan: raises $1 to $1.50
whalldo: folds 
matiko09: folds 
RulingEmu: folds 
Bohne0815: calls $1.25
1Maxx123: calls $1
*** FLOP *** [Td Jh 9d]
Bohne0815: checks 
1Maxx123: bets $1.50
lengcunjuan: calls $1.50
Bohne0815: folds 
*** TURN *** [Td Jh 9d] [Kh]
1Maxx123: checks 
lengcunjuan: bets $4.50
1Maxx123: calls $4.50
*** RIVER *** [Td Jh 9d Kh] [Jd]
1Maxx123: checks 
lengcunjuan: checks 
*** SHOW DOWN ***
1Maxx123: shows [Jc 8c] (three of a kind, Jacks)
lengcunjuan: shows [Js 3d] (three of a kind, Jacks)
1Maxx123 collected $7.88 from pot
lengcunjuan collected $7.88 from pot
*** SUMMARY ***
Total pot $16.50 | Rake $0.74 
Board [Td Jh 9d Kh Jd]
Seat 1: 1Maxx123 (big blind) showed [Jc 8c] and won ($7.88) with three of a kind, Jacks
Seat 2: fandorin2005 folded before Flop (didn't bet)
Seat 4: Pokerlkl folded before Flop (didn't bet)
Seat 5: lengcunjuan showed [Js 3d] and won ($7.88) with three of a kind, Jacks
Seat 6: whalldo folded before Flop (didn't bet)
Seat 7: matiko09 folded before Flop (didn't bet)
Seat 8: RulingEmu (button) folded before Flop (didn't bet)
Seat 9: Bohne0815 (small blind) folded on the Flop





PokerStars Hand #150798667488:  Hold'em No Limit ($0.50/$1.00 USD) - 2016/03/23 13:06:49 CET [2016/03/23 8:06:49 ET]
Table 'Smiley' 9-max Seat #9 is the button
Seat 2: YuriiSolodya ($37.50 in chips) 
Seat 3: matiko09 ($100 in chips) 
Seat 4: Zeeshka ($100 in chips) 
Seat 5: DUkalisUA ($100 in chips) 
Seat 6: blackmont111 ($77.50 in chips) 
Seat 7: drosan ($52.18 in chips) 
Seat 8: RICKA16 ($115.06 in chips) 
Seat 9: morosun ($62.96 in chips) 
WDW3 will be allowed to play after the button
YuriiSolodya: posts small blind $0.50
matiko09: posts big blind $1
*** HOLE CARDS ***
Dealt to matiko09 [Ks Ac]
Zeeshka: folds 
DUkalisUA: folds 
blackmont111: folds 
drosan: folds 
RICKA16: folds 
morosun: folds 
YuriiSolodya: raises $2 to $3
matiko09: raises $6.50 to $9.50
YuriiSolodya: raises $6.50 to $16
matiko09: raises $84 to $100 and is all-in
YuriiSolodya: calls $21.50 and is all-in
Uncalled bet ($62.50) returned to matiko09
*** FLOP *** [Qc Td 6d]
*** TURN *** [Qc Td 6d] [9h]
*** RIVER *** [Qc Td 6d 9h] [Ad]
*** SHOW DOWN ***
YuriiSolodya: shows [9d Kd] (a flush, Ace high)
matiko09: mucks hand 
YuriiSolodya collected $72.20 from pot
*** SUMMARY ***
Total pot $75 | Rake $2.80 
Board [Qc Td 6d 9h Ad]
Seat 2: YuriiSolodya (small blind) showed [9d Kd] and won ($72.20) with a flush, Ace high
Seat 3: matiko09 (big blind) mucked [Ks Ac]
Seat 4: Zeeshka folded before Flop (didn't bet)
Seat 5: DUkalisUA folded before Flop (didn't bet)
Seat 6: blackmont111 folded before Flop (didn't bet)
Seat 7: drosan folded before Flop (didn't bet)
Seat 8: RICKA16 folded before Flop (didn't bet)
Seat 9: morosun (button) folded before Flop (didn't bet)





PokerStars Hand #150798670252:  Hold'em No Limit ($1/$2 USD) - 2016/03/23 13:06:56 CET [2016/03/23 8:06:56 ET]
Table 'Kypria II' 9-max Seat #1 is the button
Seat 1: geldwolfje ($273.62 in chips) 
Seat 2: coinflip_si ($207.49 in chips) 
Seat 3: seouljam ($115.82 in chips) 
Seat 4: nailz83 ($58.87 in chips) 
Seat 5: Charity86 ($115.12 in chips) 
Seat 6: matiko09 ($215.60 in chips) 
Seat 7: ldwin8 ($325.16 in chips) 
Seat 8: Fish4trips ($200 in chips) 
Seat 9: WDW3 ($200 in chips) 
coinflip_si: posts small blind $1
seouljam: posts big blind $2
*** HOLE CARDS ***
Dealt to matiko09 [9h 5h]
nailz83: folds 
Charity86: raises $3 to $5
matiko09: folds 
ldwin8: folds 
Fish4trips: folds 
WDW3: folds 
geldwolfje: folds 
coinflip_si: calls $4
seouljam: calls $3
*** FLOP *** [5c 7h Ad]
coinflip_si: checks 
seouljam: checks 
Charity86: bets $8
coinflip_si: folds 
seouljam: folds 
Uncalled bet ($8) returned to Charity86
Charity86 collected $14.32 from pot
*** SUMMARY ***
Total pot $15 | Rake $0.68 
Board [5c 7h Ad]
Seat 1: geldwolfje (button) folded before Flop (didn't bet)
Seat 2: coinflip_si (small blind) folded on the Flop
Seat 3: seouljam (big blind) folded on the Flop
Seat 4: nailz83 folded before Flop (didn't bet)
Seat 5: Charity86 collected ($14.32)
Seat 6: matiko09 folded before Flop (didn't bet)
Seat 7: ldwin8 folded before Flop (didn't bet)
Seat 8: Fish4trips folded before Flop (didn't bet)
Seat 9: WDW3 folded before Flop (didn't bet)





PokerStars Hand #150798671046:  Hold'em No Limit ($1/$2 USD) - 2016/03/23 13:06:58 CET [2016/03/23 8:06:58 ET]
Table 'Herba II' 9-max Seat #6 is the button
Seat 1: matiko09 ($211.77 in chips) 
Seat 3: Daveguyaces ($80 in chips) 
Seat 5: chippo boy ($184 in chips) 
Seat 6: WDW3 ($216.47 in chips) 
Seat 7: InsomniaRU ($200 in chips) 
Seat 8: heisatur ($160 in chips) 
Seat 9: mrhighryza ($110.91 in chips) 
InsomniaRU: posts small blind $1
heisatur: posts big blind $2
Moszes360: sits out 
Daveguyaces: posts big blind $2
DUkalisUA: sits out 
*** HOLE CARDS ***
Dealt to matiko09 [Qc Js]
mrhighryza: folds 
matiko09: folds 
Daveguyaces: checks 
chippo boy: calls $2
WDW3: folds 
InsomniaRU: calls $1
heisatur: checks 
*** FLOP *** [Ks Ts 7c]
InsomniaRU: checks 
heisatur: checks 
Daveguyaces: bets $6
chippo boy: calls $6
InsomniaRU: folds 
heisatur: folds 
*** TURN *** [Ks Ts 7c] [Kh]
Daveguyaces: bets $20
chippo boy: calls $20
*** RIVER *** [Ks Ts 7c Kh] [3h]
Daveguyaces: checks 
chippo boy: checks 
*** SHOW DOWN ***
Daveguyaces: shows [Qh 8c] (a pair of Kings)
chippo boy: mucks hand 
Daveguyaces collected $57.30 from pot
*** SUMMARY ***
Total pot $60 | Rake $2.70 
Board [Ks Ts 7c Kh 3h]
Seat 1: matiko09 folded before Flop (didn't bet)
Seat 3: Daveguyaces showed [Qh 8c] and won ($57.30) with a pair of Kings
Seat 5: chippo boy mucked [Qs 6s]
Seat 6: WDW3 (button) folded before Flop (didn't bet)
Seat 7: InsomniaRU (small blind) folded on the Flop
Seat 8: heisatur (big blind) folded on the Flop
Seat 9: mrhighryza folded before Flop (didn't bet)





PokerStars Hand #150798672321:  Hold'em No Limit ($0.50/$1.00 USD) - 2016/03/23 13:07:02 CET [2016/03/23 8:07:02 ET]
Table 'Kippes' 9-max Seat #1 is the button
Seat 1: YuriiSolodya ($68 in chips) 
Seat 2: RICKA16 ($123.27 in chips) 
Seat 3: CAJUN890 ($106.87 in chips) 
Seat 4: matiko09 ($100 in chips) 
Seat 6: WDW3 ($101.50 in chips) 
Seat 7: lumen21 ($100 in chips) 
Seat 8: Zeeshka ($103.26 in chips) 
Seat 9: wang19790906 ($61.54 in chips) 
RICKA16: posts small blind $0.50
CAJUN890: posts big blind $1
*** HOLE CARDS ***
Dealt to matiko09 [5d 3c]
matiko09: folds 
WDW3: folds 
lumen21: folds 
Zeeshka: folds 
wang19790906: raises $3 to $4
YuriiSolodya: folds 
RICKA16: folds 
CAJUN890: folds 
Uncalled bet ($3) returned to wang19790906
wang19790906 collected $2.50 from pot
wang19790906: doesn't show hand 
*** SUMMARY ***
Total pot $2.50 | Rake $0 
Seat 1: YuriiSolodya (button) folded before Flop (didn't bet)
Seat 2: RICKA16 (small blind) folded before Flop
Seat 3: CAJUN890 (big blind) folded before Flop
Seat 4: matiko09 folded before Flop (didn't bet)
Seat 6: WDW3 folded before Flop (didn't bet)
Seat 7: lumen21 folded before Flop (didn't bet)
Seat 8: Zeeshka folded before Flop (didn't bet)
Seat 9: wang19790906 collected ($2.50)





PokerStars Hand #150798673318:  Hold'em No Limit ($1/$2 USD) - 2016/03/23 13:07:04 CET [2016/03/23 8:07:04 ET]
Table 'Kiess' 9-max Seat #9 is the button
Seat 1: ldwin8 ($198 in chips) 
Seat 2: DUkalisUA ($522.08 in chips) 
Seat 3: Divannn ($90.60 in chips) 
Seat 5: chippo boy ($200 in chips) 
Seat 6: matiko09 ($200 in chips) 
Seat 7: InsomniaRU ($233.41 in chips) 
Seat 8: WDW3 ($200 in chips) 
Seat 9: Fish4trips ($200 in chips) 
ldwin8: posts small blind $1
DUkalisUA: posts big blind $2
darren1031: sits out 
*** HOLE CARDS ***
Dealt to matiko09 [6d 7s]
Divannn: calls $2
chippo boy: folds 
matiko09: folds 
InsomniaRU: folds 
WDW3: folds 
Fish4trips: folds 
ldwin8: calls $1
DUkalisUA: checks 
*** FLOP *** [Th 6h Td]
ldwin8: checks 
DUkalisUA: checks 
Divannn: checks 
*** TURN *** [Th 6h Td] [7h]
ldwin8: checks 
DUkalisUA: checks 
Divannn: bets $6
ldwin8: calls $6
DUkalisUA: folds 
*** RIVER *** [Th 6h Td 7h] [2s]
ldwin8: checks 
Divannn: bets $8
ldwin8: calls $8
*** SHOW DOWN ***
Divannn: shows [Qc 8c] (a pair of Tens)
ldwin8: shows [Tc Ad] (three of a kind, Tens)
ldwin8 collected $32.47 from pot
*** SUMMARY ***
Total pot $34 | Rake $1.53 
Board [Th 6h Td 7h 2s]
Seat 1: ldwin8 (small blind) showed [Tc Ad] and won ($32.47) with three of a kind, Tens
Seat 2: DUkalisUA (big blind) folded on the Turn
Seat 3: Divannn showed [Qc 8c] and lost with a pair of Tens
Seat 5: chippo boy folded before Flop (didn't bet)
Seat 6: matiko09 folded before Flop (didn't bet)
Seat 7: InsomniaRU folded before Flop (didn't bet)
Seat 8: WDW3 folded before Flop (didn't bet)
Seat 9: Fish4trips (button) folded before Flop (didn't bet)





PokerStars Hand #150798684632:  Hold'em No Limit ($0.50/$1.00 USD) - 2016/03/23 13:07:33 CET [2016/03/23 8:07:33 ET]
Table 'Atlantis' 9-max Seat #8 is the button
Seat 1: xHourglass ($133.51 in chips) 
Seat 2: tffff2006 ($59 in chips) 
Seat 3: CAJUN890 ($98.50 in chips) 
Seat 4: matiko09 ($122.17 in chips) 
Seat 6: Jimy Tiltman ($106.62 in chips) 
Seat 7: Zeeshka ($107.96 in chips) 
Seat 8: lumen21 ($123.88 in chips) 
Seat 9: WDW3 ($129.37 in chips) 
WDW3: posts small blind $0.50
xHourglass: posts big blind $1
*** HOLE CARDS ***
Dealt to matiko09 [5h Tc]
tffff2006: calls $1
CAJUN890: folds 
matiko09: folds 
Jimy Tiltman: raises $2.50 to $3.50
Zeeshka: folds 
lumen21: folds 
WDW3: folds 
xHourglass: calls $2.50
tffff2006: calls $2.50
*** FLOP *** [7s 7h Jd]
xHourglass: bets $7.87
tffff2006: folds 
Jimy Tiltman: calls $7.87
*** TURN *** [7s 7h Jd] [6s]
xHourglass: checks 
Jimy Tiltman: checks 
*** RIVER *** [7s 7h Jd 6s] [2d]
xHourglass: bets $19.50
Jimy Tiltman: folds 
Uncalled bet ($19.50) returned to xHourglass
xHourglass collected $25.54 from pot
xHourglass: doesn't show hand 
*** SUMMARY ***
Total pot $26.74 | Rake $1.20 
Board [7s 7h Jd 6s 2d]
Seat 1: xHourglass (big blind) collected ($25.54)
Seat 2: tffff2006 folded on the Flop
Seat 3: CAJUN890 folded before Flop (didn't bet)
Seat 4: matiko09 folded before Flop (didn't bet)
Seat 6: Jimy Tiltman folded on the River
Seat 7: Zeeshka folded before Flop (didn't bet)
Seat 8: lumen21 (button) folded before Flop (didn't bet)
Seat 9: WDW3 (small blind) folded before Flop





PokerStars Hand #150798686612:  Hold'em No Limit ($0.50/$1.00 USD) - 2016/03/23 13:07:38 CET [2016/03/23 8:07:38 ET]
Table 'Lyot II' 9-max Seat #4 is the button
Seat 1: Zeeshka ($104.55 in chips) 
Seat 2: albert_ratza ($118.87 in chips) 
Seat 3: chauyeuba ($50.50 in chips) 
Seat 4: Jimy Tiltman ($106.53 in chips) 
Seat 5: xHourglass ($100 in chips) 
Seat 7: matiko09 ($102.33 in chips) 
Seat 8: yuminyumin1 ($113.02 in chips) 
Seat 9: pablos1922 ($26.18 in chips) 
xHourglass: posts small blind $0.50
matiko09: posts big blind $1
*** HOLE CARDS ***
Dealt to matiko09 [9d 2h]
yuminyumin1: raises $1 to $2
pablos1922: folds 
Zeeshka: folds 
albert_ratza: calls $2
chauyeuba: folds 
WDW3 joins the table at seat #6 
Jimy Tiltman: folds 
xHourglass: calls $1.50
matiko09: folds 
*** FLOP *** [2d Ah Td]
xHourglass: checks 
yuminyumin1: bets $3
albert_ratza: calls $3
xHourglass: folds 
*** TURN *** [2d Ah Td] [Jh]
yuminyumin1: checks 
albert_ratza: checks 
*** RIVER *** [2d Ah Td Jh] [5h]
yuminyumin1: bets $8
albert_ratza: folds 
Uncalled bet ($8) returned to yuminyumin1
yuminyumin1 collected $12.42 from pot
yuminyumin1: doesn't show hand 
*** SUMMARY ***
Total pot $13 | Rake $0.58 
Board [2d Ah Td Jh 5h]
Seat 1: Zeeshka folded before Flop (didn't bet)
Seat 2: albert_ratza folded on the River
Seat 3: chauyeuba folded before Flop (didn't bet)
Seat 4: Jimy Tiltman (button) folded before Flop (didn't bet)
Seat 5: xHourglass (small blind) folded on the Flop
Seat 7: matiko09 (big blind) folded before Flop
Seat 8: yuminyumin1 collected ($12.42)
Seat 9: pablos1922 folded before Flop (didn't bet)





PokerStars Hand #150798687140:  Hold'em No Limit ($0.25/$0.50 USD) - 2016/03/23 13:07:39 CET [2016/03/23 8:07:39 ET]
Table 'Wabash II' 9-max Seat #5 is the button
Seat 1: whalldo ($52.38 in chips) 
Seat 2: Zeeshka ($50 in chips) 
Seat 3: SupremeXS ($27.35 in chips) 
Seat 4: Bohne0815 ($48.03 in chips) 
Seat 5: hovora ($87.10 in chips) 
Seat 6: matiko09 ($52.34 in chips) 
Seat 7: jorazag ($44.99 in chips) 
Seat 8: fandorin2005 ($58.16 in chips) 
Seat 9: rooniy2000 ($54.19 in chips) 
matiko09: posts small blind $0.25
jorazag: posts big blind $0.50
*** HOLE CARDS ***
Dealt to matiko09 [3c Ts]
fandorin2005: folds 
rooniy2000: folds 
whalldo: folds 
Zeeshka: folds 
SupremeXS: folds 
Bohne0815: folds 
hovora: folds 
matiko09: folds 
Uncalled bet ($0.25) returned to jorazag
jorazag collected $0.50 from pot
jorazag: doesn't show hand 
*** SUMMARY ***
Total pot $0.50 | Rake $0 
Seat 1: whalldo folded before Flop (didn't bet)
Seat 2: Zeeshka folded before Flop (didn't bet)
Seat 3: SupremeXS folded before Flop (didn't bet)
Seat 4: Bohne0815 folded before Flop (didn't bet)
Seat 5: hovora (button) folded before Flop (didn't bet)
Seat 6: matiko09 (small blind) folded before Flop
Seat 7: jorazag (big blind) collected ($0.50)
Seat 8: fandorin2005 folded before Flop (didn't bet)
Seat 9: rooniy2000 folded before Flop (didn't bet)





PokerStars Hand #150798693532:  Hold'em No Limit ($0.25/$0.50 USD) - 2016/03/23 13:07:55 CET [2016/03/23 8:07:55 ET]
Table 'Pyrrhus' 9-max Seat #9 is the button
Seat 1: 1Maxx123 ($86.51 in chips) 
Seat 2: fandorin2005 ($50 in chips) 
Seat 4: Pokerlkl ($42.95 in chips) 
Seat 5: lengcunjuan ($50.38 in chips) 
Seat 6: whalldo ($64.26 in chips) 
Seat 7: matiko09 ($71.52 in chips) 
Seat 8: RulingEmu ($29.92 in chips) 
Seat 9: Bohne0815 ($50.70 in chips) 
1Maxx123: posts small blind $0.25
fandorin2005: posts big blind $0.50
Ahangama: sits out 
*** HOLE CARDS ***
Dealt to matiko09 [5c 2d]
Pokerlkl: calls $0.50
lengcunjuan: calls $0.50
whalldo: folds 
matiko09: folds 
RulingEmu: raises $1 to $1.50
Bohne0815: calls $1.50
1Maxx123: folds 
fandorin2005: folds 
Pokerlkl: calls $1
lengcunjuan: calls $1
*** FLOP *** [3d Ts 8c]
Pokerlkl: checks 
lengcunjuan: checks 
RulingEmu: bets $3
Bohne0815: folds 
Pokerlkl: folds 
lengcunjuan: folds 
Uncalled bet ($3) returned to RulingEmu
RulingEmu collected $6.45 from pot
RulingEmu: doesn't show hand 
*** SUMMARY ***
Total pot $6.75 | Rake $0.30 
Board [3d Ts 8c]
Seat 1: 1Maxx123 (small blind) folded before Flop
Seat 2: fandorin2005 (big blind) folded before Flop
Seat 4: Pokerlkl folded on the Flop
Seat 5: lengcunjuan folded on the Flop
Seat 6: whalldo folded before Flop (didn't bet)
Seat 7: matiko09 folded before Flop (didn't bet)
Seat 8: RulingEmu collected ($6.45)
Seat 9: Bohne0815 (button) folded on the Flop





PokerStars Hand #150798694548:  Hold'em No Limit ($0.25/$0.50 USD) - 2016/03/23 13:07:58 CET [2016/03/23 8:07:58 ET]
Table 'Wabash II' 9-max Seat #6 is the button
Seat 1: whalldo ($52.38 in chips) 
Seat 2: Zeeshka ($50 in chips) 
Seat 3: SupremeXS ($27.35 in chips) 
Seat 4: Bohne0815 ($48.03 in chips) 
Seat 5: hovora ($87.10 in chips) 
Seat 6: matiko09 ($52.09 in chips) 
Seat 7: jorazag ($45.24 in chips) 
Seat 8: fandorin2005 ($58.16 in chips) 
Seat 9: rooniy2000 ($54.19 in chips) 
jorazag: posts small blind $0.25
fandorin2005: posts big blind $0.50
*** HOLE CARDS ***
Dealt to matiko09 [Ah 3h]
rooniy2000: folds 
whalldo: folds 
Zeeshka: folds 
SupremeXS: raises $1 to $1.50
Bohne0815: calls $1.50
hovora: folds 
matiko09: folds 
jorazag: calls $1.25
fandorin2005: folds 
*** FLOP *** [8d Td 8c]
jorazag: checks 
SupremeXS: bets $2.50
Bohne0815: calls $2.50
jorazag: calls $2.50
*** TURN *** [8d Td 8c] [8s]
jorazag: checks 
SupremeXS: checks 
Bohne0815: checks 
*** RIVER *** [8d Td 8c 8s] [Kh]
jorazag: checks 
SupremeXS: bets $3.50
Bohne0815: folds 
jorazag: folds 
Uncalled bet ($3.50) returned to SupremeXS
SupremeXS collected $11.94 from pot
*** SUMMARY ***
Total pot $12.50 | Rake $0.56 
Board [8d Td 8c 8s Kh]
Seat 1: whalldo folded before Flop (didn't bet)
Seat 2: Zeeshka folded before Flop (didn't bet)
Seat 3: SupremeXS collected ($11.94)
Seat 4: Bohne0815 folded on the River
Seat 5: hovora folded before Flop (didn't bet)
Seat 6: matiko09 (button) folded before Flop (didn't bet)
Seat 7: jorazag (small blind) folded on the River
Seat 8: fandorin2005 (big blind) folded before Flop
Seat 9: rooniy2000 folded before Flop (didn't bet)





PokerStars Hand #150798695412:  Hold'em No Limit ($0.50/$1.00 USD) - 2016/03/23 13:08:00 CET [2016/03/23 8:08:00 ET]
Table 'Kippes' 9-max Seat #2 is the button
Seat 1: YuriiSolodya ($68 in chips) 
Seat 2: RICKA16 ($122.77 in chips) 
Seat 3: CAJUN890 ($105.87 in chips) 
Seat 4: matiko09 ($100 in chips) 
Seat 6: WDW3 ($101.50 in chips) 
Seat 7: lumen21 ($100 in chips) 
Seat 8: Zeeshka ($103.26 in chips) 
Seat 9: wang19790906 ($63.04 in chips) 
CAJUN890: posts small blind $0.50
matiko09: posts big blind $1
unequivocali: sits out 
*** HOLE CARDS ***
Dealt to matiko09 [7h 2s]
WDW3: folds 
lumen21: folds 
Zeeshka: folds 
wang19790906: folds 
YuriiSolodya: calls $1
RICKA16: folds 
CAJUN890: raises $2 to $3
matiko09: folds 
YuriiSolodya: calls $2
*** FLOP *** [4d 8d 6d]
CAJUN890: bets $4
YuriiSolodya: folds 
Uncalled bet ($4) returned to CAJUN890
CAJUN890 collected $6.68 from pot
CAJUN890: doesn't show hand 
*** SUMMARY ***
Total pot $7 | Rake $0.32 
Board [4d 8d 6d]
Seat 1: YuriiSolodya folded on the Flop
Seat 2: RICKA16 (button) folded before Flop (didn't bet)
Seat 3: CAJUN890 (small blind) collected ($6.68)
Seat 4: matiko09 (big blind) folded before Flop
Seat 6: WDW3 folded before Flop (didn't bet)
Seat 7: lumen21 folded before Flop (didn't bet)
Seat 8: Zeeshka folded before Flop (didn't bet)
Seat 9: wang19790906 folded before Flop (didn't bet)





PokerStars Hand #150798700201:  Hold'em No Limit ($1/$2 USD) - 2016/03/23 13:08:12 CET [2016/03/23 8:08:12 ET]
Table 'Kypria II' 9-max Seat #2 is the button
Seat 1: geldwolfje ($273.62 in chips) 
Seat 2: coinflip_si ($202.49 in chips) 
Seat 3: seouljam ($110.82 in chips) 
Seat 4: nailz83 ($58.87 in chips) 
Seat 5: Charity86 ($124.44 in chips) 
Seat 6: matiko09 ($215.60 in chips) 
Seat 7: ldwin8 ($325.16 in chips) 
Seat 8: Fish4trips ($200 in chips) 
Seat 9: WDW3 ($200 in chips) 
seouljam: posts small blind $1
nailz83: posts big blind $2
*** HOLE CARDS ***
Dealt to matiko09 [Qh Kd]
Charity86: folds 
matiko09: raises $3 to $5
ldwin8: folds 
Fish4trips: folds 
WDW3: folds 
geldwolfje: folds 
coinflip_si: calls $5
seouljam: calls $4
nailz83: calls $3
*** FLOP *** [5h Tc Js]
seouljam: checks 
nailz83: checks 
matiko09: bets $12
coinflip_si: calls $12
seouljam: folds 
nailz83: folds 
*** TURN *** [5h Tc Js] [6s]
matiko09: checks 
coinflip_si: checks 
*** RIVER *** [5h Tc Js 6s] [8h]
matiko09: checks 
coinflip_si: bets $7.86
matiko09: folds 
Uncalled bet ($7.86) returned to coinflip_si
coinflip_si collected $42.02 from pot
coinflip_si: doesn't show hand 
*** SUMMARY ***
Total pot $44 | Rake $1.98 
Board [5h Tc Js 6s 8h]
Seat 1: geldwolfje folded before Flop (didn't bet)
Seat 2: coinflip_si (button) collected ($42.02)
Seat 3: seouljam (small blind) folded on the Flop
Seat 4: nailz83 (big blind) folded on the Flop
Seat 5: Charity86 folded before Flop (didn't bet)
Seat 6: matiko09 folded on the River
Seat 7: ldwin8 folded before Flop (didn't bet)
Seat 8: Fish4trips folded before Flop (didn't bet)
Seat 9: WDW3 folded before Flop (didn't bet)





PokerStars Hand #150798700503:  Hold'em No Limit ($0.50/$1.00 USD) - 2016/03/23 13:08:13 CET [2016/03/23 8:08:13 ET]
Table 'Oljato' 9-max Seat #2 is the button
Seat 2: Benixxx13 ($97 in chips) 
Seat 3: DUkalisUA ($100 in chips) 
Seat 4: Pvsx. ($100 in chips) 
Seat 5: ryo728 ($85.75 in chips) 
Seat 6: WDW3 ($111.94 in chips) 
Seat 7: matiko09 ($165.73 in chips) 
Seat 8: Zeeshka ($217.70 in chips) 
Seat 9: Jimy Tiltman ($100 in chips) 
DUkalisUA: posts small blind $0.50
Pvsx.: posts big blind $1
Pearl Jam87: sits out 
*** HOLE CARDS ***
Dealt to matiko09 [5h 8d]
ryo728: folds 
WDW3: folds 
matiko09: folds 
Zeeshka: folds 
Jimy Tiltman: raises $2 to $3
Benixxx13: folds 
DUkalisUA: folds 
Pvsx.: folds 
Uncalled bet ($2) returned to Jimy Tiltman
Jimy Tiltman collected $2.50 from pot
Jimy Tiltman: doesn't show hand 
*** SUMMARY ***
Total pot $2.50 | Rake $0 
Seat 2: Benixxx13 (button) folded before Flop (didn't bet)
Seat 3: DUkalisUA (small blind) folded before Flop
Seat 4: Pvsx. (big blind) folded before Flop
Seat 5: ryo728 folded before Flop (didn't bet)
Seat 6: WDW3 folded before Flop (didn't bet)
Seat 7: matiko09 folded before Flop (didn't bet)
Seat 8: Zeeshka folded before Flop (didn't bet)
Seat 9: Jimy Tiltman collected ($2.50)





PokerStars Hand #150798705667:  Hold'em No Limit ($0.25/$0.50 USD) - 2016/03/23 13:08:26 CET [2016/03/23 8:08:26 ET]
Table 'Pyrrhus' 9-max Seat #1 is the button
Seat 1: 1Maxx123 ($86.26 in chips) 
Seat 2: fandorin2005 ($50 in chips) 
Seat 3: Ahangama ($50 in chips) 
Seat 4: Pokerlkl ($41.45 in chips) 
Seat 5: lengcunjuan ($48.88 in chips) 
Seat 6: whalldo ($64.26 in chips) 
Seat 7: matiko09 ($71.52 in chips) 
Seat 8: RulingEmu ($34.87 in chips) 
Seat 9: Bohne0815 ($49.20 in chips) 
fandorin2005: posts small blind $0.25
Ahangama: posts big blind $0.50
*** HOLE CARDS ***
Dealt to matiko09 [Ah Ac]
Pokerlkl: folds 
lengcunjuan: raises $1 to $1.50
whalldo: folds 
matiko09: raises $3.50 to $5
RulingEmu: folds 
Bohne0815: folds 
1Maxx123: folds 
fandorin2005: folds 
Ahangama: folds 
lengcunjuan: calls $3.50
*** FLOP *** [2d 5d 4s]
lengcunjuan: checks 
matiko09: bets $7
lengcunjuan: raises $7 to $14
matiko09: calls $7
*** TURN *** [2d 5d 4s] [Qs]
lengcunjuan: bets $29.88 and is all-in
matiko09: calls $29.88
*** RIVER *** [2d 5d 4s Qs] [8h]
*** SHOW DOWN ***
lengcunjuan: shows [3d 8d] (a pair of Eights)
matiko09: shows [Ah Ac] (a pair of Aces)
matiko09 collected $96.01 from pot
*** SUMMARY ***
Total pot $98.51 | Rake $2.50 
Board [2d 5d 4s Qs 8h]
Seat 1: 1Maxx123 (button) folded before Flop (didn't bet)
Seat 2: fandorin2005 (small blind) folded before Flop
Seat 3: Ahangama (big blind) folded before Flop
Seat 4: Pokerlkl folded before Flop (didn't bet)
Seat 5: lengcunjuan showed [3d 8d] and lost with a pair of Eights
Seat 6: whalldo folded before Flop (didn't bet)
Seat 7: matiko09 showed [Ah Ac] and won ($96.01) with a pair of Aces
Seat 8: RulingEmu folded before Flop (didn't bet)
Seat 9: Bohne0815 folded before Flop (didn't bet)





PokerStars Hand #150798710193:  Hold'em No Limit ($1/$2 USD) - 2016/03/23 13:08:36 CET [2016/03/23 8:08:36 ET]
Table 'Herba II' 9-max Seat #7 is the button
Seat 1: matiko09 ($211.77 in chips) 
Seat 3: Daveguyaces ($109.30 in chips) 
Seat 5: chippo boy ($200 in chips) 
Seat 6: WDW3 ($216.47 in chips) 
Seat 7: InsomniaRU ($200 in chips) 
Seat 8: heisatur ($158 in chips) 
Seat 9: mrhighryza ($110.91 in chips) 
heisatur: posts small blind $1
mrhighryza: posts big blind $2
Moszes360: sits out 
DUkalisUA: sits out 
*** HOLE CARDS ***
Dealt to matiko09 [Kd 5h]
matiko09: folds 
Daveguyaces: folds 
chippo boy: calls $2
WDW3: folds 
InsomniaRU: folds 
heisatur: folds 
mrhighryza: checks 
*** FLOP *** [5c 7d 8h]
mrhighryza: bets $4
chippo boy: calls $4
*** TURN *** [5c 7d 8h] [Ah]
mrhighryza: bets $4
chippo boy: calls $4
*** RIVER *** [5c 7d 8h Ah] [9d]
mrhighryza: bets $14
chippo boy: calls $14
*** SHOW DOWN ***
mrhighryza: shows [6d 7h] (a straight, Five to Nine)
chippo boy: mucks hand 
mrhighryza collected $46.80 from pot
*** SUMMARY ***
Total pot $49 | Rake $2.20 
Board [5c 7d 8h Ah 9d]
Seat 1: matiko09 folded before Flop (didn't bet)
Seat 3: Daveguyaces folded before Flop (didn't bet)
Seat 5: chippo boy mucked [9c Jd]
Seat 6: WDW3 folded before Flop (didn't bet)
Seat 7: InsomniaRU (button) folded before Flop (didn't bet)
Seat 8: heisatur (small blind) folded before Flop
Seat 9: mrhighryza (big blind) showed [6d 7h] and won ($46.80) with a straight, Five to Nine





PokerStars Hand #150798710896:  Hold'em No Limit ($0.50/$1.00 USD) - 2016/03/23 13:08:38 CET [2016/03/23 8:08:38 ET]
Table 'Smiley' 9-max Seat #2 is the button
Seat 2: YuriiSolodya ($72.20 in chips) 
Seat 3: matiko09 ($100 in chips) 
Seat 4: Zeeshka ($100 in chips) 
Seat 5: DUkalisUA ($100 in chips) 
Seat 6: blackmont111 ($77.50 in chips) 
Seat 7: drosan ($52.18 in chips) 
Seat 8: RICKA16 ($115.06 in chips) 
Seat 9: morosun ($62.96 in chips) 
matiko09: posts small blind $0.50
Zeeshka: posts big blind $1
WDW3: sits out 
*** HOLE CARDS ***
Dealt to matiko09 [3d 2c]
DUkalisUA: folds 
blackmont111: raises $2 to $3
drosan: folds 
RICKA16: folds 
morosun: folds 
YuriiSolodya: folds 
matiko09: folds 
Zeeshka: folds 
Uncalled bet ($2) returned to blackmont111
blackmont111 collected $2.50 from pot
*** SUMMARY ***
Total pot $2.50 | Rake $0 
Seat 2: YuriiSolodya (button) folded before Flop (didn't bet)
Seat 3: matiko09 (small blind) folded before Flop
Seat 4: Zeeshka (big blind) folded before Flop
Seat 5: DUkalisUA folded before Flop (didn't bet)
Seat 6: blackmont111 collected ($2.50)
Seat 7: drosan folded before Flop (didn't bet)
Seat 8: RICKA16 folded before Flop (didn't bet)
Seat 9: morosun folded before Flop (didn't bet)





PokerStars Hand #150798714156:  Hold'em No Limit ($1/$2 USD) - 2016/03/23 13:08:46 CET [2016/03/23 8:08:46 ET]
Table 'Kiess' 9-max Seat #1 is the button
Seat 1: ldwin8 ($214.47 in chips) 
Seat 2: DUkalisUA ($520.08 in chips) 
Seat 3: Divannn ($74.60 in chips) 
Seat 5: chippo boy ($200 in chips) 
Seat 6: matiko09 ($200 in chips) 
Seat 7: InsomniaRU ($233.41 in chips) 
Seat 8: WDW3 ($200 in chips) 
Seat 9: Fish4trips ($200 in chips) 
DUkalisUA: posts small blind $1
Divannn: posts big blind $2
darren1031: sits out 
*** HOLE CARDS ***
Dealt to matiko09 [Qd 8h]
chippo boy: folds 
matiko09: folds 
InsomniaRU: folds 
WDW3: folds 
Fish4trips: folds 
ldwin8: folds 
DUkalisUA: folds 
Uncalled bet ($1) returned to Divannn
Divannn collected $2 from pot
*** SUMMARY ***
Total pot $2 | Rake $0 
Seat 1: ldwin8 (button) folded before Flop (didn't bet)
Seat 2: DUkalisUA (small blind) folded before Flop
Seat 3: Divannn (big blind) collected ($2)
Seat 5: chippo boy folded before Flop (didn't bet)
Seat 6: matiko09 folded before Flop (didn't bet)
Seat 7: InsomniaRU folded before Flop (didn't bet)
Seat 8: WDW3 folded before Flop (didn't bet)
Seat 9: Fish4trips folded before Flop (didn't bet)





PokerStars Hand #150798714722:  Hold'em No Limit ($0.50/$1.00 USD) - 2016/03/23 13:08:47 CET [2016/03/23 8:08:47 ET]
Table 'Oljato' 9-max Seat #3 is the button
Seat 2: Benixxx13 ($97 in chips) 
Seat 3: DUkalisUA ($100 in chips) 
Seat 4: Pvsx. ($100 in chips) 
Seat 5: ryo728 ($85.75 in chips) 
Seat 6: WDW3 ($111.94 in chips) 
Seat 7: matiko09 ($165.73 in chips) 
Seat 8: Zeeshka ($217.70 in chips) 
Seat 9: Jimy Tiltman ($101.50 in chips) 
Pvsx.: posts small blind $0.50
ryo728: posts big blind $1
Pearl Jam87: sits out 
*** HOLE CARDS ***
Dealt to matiko09 [Kh 9h]
WDW3: folds 
matiko09: folds 
Zeeshka: folds 
Jimy Tiltman: folds 
Benixxx13: folds 
DUkalisUA: folds 
Pvsx.: raises $1.50 to $2.50
ryo728: calls $1.50
*** FLOP *** [9d 2c Ac]
Pvsx.: bets $2.39
ryo728: folds 
Uncalled bet ($2.39) returned to Pvsx.
Pvsx. collected $4.78 from pot
Pvsx.: doesn't show hand 
*** SUMMARY ***
Total pot $5 | Rake $0.22 
Board [9d 2c Ac]
Seat 2: Benixxx13 folded before Flop (didn't bet)
Seat 3: DUkalisUA (button) folded before Flop (didn't bet)
Seat 4: Pvsx. (small blind) collected ($4.78)
Seat 5: ryo728 (big blind) folded on the Flop
Seat 6: WDW3 folded before Flop (didn't bet)
Seat 7: matiko09 folded before Flop (didn't bet)
Seat 8: Zeeshka folded before Flop (didn't bet)
Seat 9: Jimy Tiltman folded before Flop (didn't bet)





PokerStars Hand #150798717697:  Hold'em No Limit ($0.50/$1.00 USD) - 2016/03/23 13:08:54 CET [2016/03/23 8:08:54 ET]
Table 'Kippes' 9-max Seat #3 is the button
Seat 1: YuriiSolodya ($65 in chips) 
Seat 2: RICKA16 ($122.77 in chips) 
Seat 3: CAJUN890 ($109.55 in chips) 
Seat 4: matiko09 ($100 in chips) 
Seat 5: unequivocali ($112.72 in chips) 
Seat 6: WDW3 ($101.50 in chips) 
Seat 7: lumen21 ($100 in chips) 
Seat 8: Zeeshka ($103.26 in chips) 
Seat 9: wang19790906 ($63.04 in chips) 
matiko09: posts small blind $0.50
unequivocali: posts big blind $1
*** HOLE CARDS ***
Dealt to matiko09 [6h Ac]
WDW3: folds 
lumen21: folds 
Zeeshka: folds 
wang19790906: folds 
YuriiSolodya: folds 
RICKA16: raises $2 to $3
CAJUN890: calls $3
matiko09: folds 
unequivocali: folds 
*** FLOP *** [Kd 5h 7h]
RICKA16: checks 
CAJUN890: bets $4.38
RICKA16: calls $4.38
*** TURN *** [Kd 5h 7h] [4c]
RICKA16: checks 
CAJUN890: checks 
*** RIVER *** [Kd 5h 7h 4c] [6d]
RICKA16: bets $5
CAJUN890: folds 
Uncalled bet ($5) returned to RICKA16
RICKA16 collected $15.53 from pot
RICKA16: doesn't show hand 
*** SUMMARY ***
Total pot $16.26 | Rake $0.73 
Board [Kd 5h 7h 4c 6d]
Seat 1: YuriiSolodya folded before Flop (didn't bet)
Seat 2: RICKA16 collected ($15.53)
Seat 3: CAJUN890 (button) folded on the River
Seat 4: matiko09 (small blind) folded before Flop
Seat 5: unequivocali (big blind) folded before Flop
Seat 6: WDW3 folded before Flop (didn't bet)
Seat 7: lumen21 folded before Flop (didn't bet)
Seat 8: Zeeshka folded before Flop (didn't bet)
Seat 9: wang19790906 folded before Flop (didn't bet)





PokerStars Hand #150798719142:  Hold'em No Limit ($0.50/$1.00 USD) - 2016/03/23 13:08:58 CET [2016/03/23 8:08:58 ET]
Table 'Atlantis' 9-max Seat #9 is the button
Seat 1: xHourglass ($147.68 in chips) 
Seat 2: tffff2006 ($55.50 in chips) 
Seat 3: CAJUN890 ($98.50 in chips) 
Seat 4: matiko09 ($122.17 in chips) 
Seat 6: Jimy Tiltman ($100 in chips) 
Seat 7: Zeeshka ($107.96 in chips) 
Seat 8: lumen21 ($123.88 in chips) 
Seat 9: WDW3 ($128.87 in chips) 
xHourglass: posts small blind $0.50
tffff2006: posts big blind $1
unequivocali: sits out 
*** HOLE CARDS ***
Dealt to matiko09 [Kd 8h]
CAJUN890: folds 
matiko09: folds 
Jimy Tiltman: raises $2 to $3
Zeeshka: folds 
lumen21: folds 
WDW3: folds 
xHourglass: raises $6 to $9
tffff2006: folds 
Jimy Tiltman: folds 
Uncalled bet ($6) returned to xHourglass
xHourglass collected $7 from pot
xHourglass: doesn't show hand 
*** SUMMARY ***
Total pot $7 | Rake $0 
Seat 1: xHourglass (small blind) collected ($7)
Seat 2: tffff2006 (big blind) folded before Flop
Seat 3: CAJUN890 folded before Flop (didn't bet)
Seat 4: matiko09 folded before Flop (didn't bet)
Seat 6: Jimy Tiltman folded before Flop
Seat 7: Zeeshka folded before Flop (didn't bet)
Seat 8: lumen21 folded before Flop (didn't bet)
Seat 9: WDW3 (button) folded before Flop (didn't bet)





PokerStars Hand #150798723213:  Hold'em No Limit ($1/$2 USD) - 2016/03/23 13:09:08 CET [2016/03/23 8:09:08 ET]
Table 'Kiess' 9-max Seat #2 is the button
Seat 1: ldwin8 ($214.47 in chips) 
Seat 2: DUkalisUA ($519.08 in chips) 
Seat 3: Divannn ($75.60 in chips) 
Seat 4: darren1031 ($200 in chips) 
Seat 5: chippo boy ($200 in chips) 
Seat 6: matiko09 ($200 in chips) 
Seat 7: InsomniaRU ($233.41 in chips) 
Seat 8: WDW3 ($200 in chips) 
Seat 9: Fish4trips ($200 in chips) 
Divannn: posts small blind $1
darren1031: posts big blind $2
*** HOLE CARDS ***
Dealt to matiko09 [Kh 3d]
chippo boy: folds 
matiko09: folds 
InsomniaRU: folds 
WDW3: raises $3.60 to $5.60
Fish4trips: folds 
ldwin8: raises $10.40 to $16
DUkalisUA: folds 
Divannn: folds 
darren1031: calls $14
WDW3: calls $10.40
*** FLOP *** [2c 6c 7h]
darren1031: checks 
WDW3: checks 
ldwin8: bets $30
darren1031: folds 
WDW3: raises $53 to $83
ldwin8: raises $115.47 to $198.47 and is all-in
WDW3: calls $101 and is all-in
Uncalled bet ($14.47) returned to ldwin8
*** TURN *** [2c 6c 7h] [Qh]
*** RIVER *** [2c 6c 7h Qh] [4h]
*** SHOW DOWN ***
WDW3: shows [6d 6h] (three of a kind, Sixes)
ldwin8: shows [Ac 4c] (a pair of Fours)
WDW3 collected $414.20 from pot
*** SUMMARY ***
Total pot $417 | Rake $2.80 
Board [2c 6c 7h Qh 4h]
Seat 1: ldwin8 showed [Ac 4c] and lost with a pair of Fours
Seat 2: DUkalisUA (button) folded before Flop (didn't bet)
Seat 3: Divannn (small blind) folded before Flop
Seat 4: darren1031 (big blind) folded on the Flop
Seat 5: chippo boy folded before Flop (didn't bet)
Seat 6: matiko09 folded before Flop (didn't bet)
Seat 7: InsomniaRU folded before Flop (didn't bet)
Seat 8: WDW3 showed [6d 6h] and won ($414.20) with three of a kind, Sixes
Seat 9: Fish4trips folded before Flop (didn't bet)





PokerStars Hand #150798723779:  Hold'em No Limit ($0.50/$1.00 USD) - 2016/03/23 13:09:10 CET [2016/03/23 8:09:10 ET]
Table 'Smiley' 9-max Seat #3 is the button
Seat 2: YuriiSolodya ($72.20 in chips) 
Seat 3: matiko09 ($100 in chips) 
Seat 4: Zeeshka ($100 in chips) 
Seat 5: DUkalisUA ($100 in chips) 
Seat 6: blackmont111 ($79 in chips) 
Seat 7: drosan ($52.18 in chips) 
Seat 8: RICKA16 ($115.06 in chips) 
Seat 9: morosun ($62.96 in chips) 
Zeeshka: posts small blind $0.50
DUkalisUA: posts big blind $1
WDW3: sits out 
*** HOLE CARDS ***
Dealt to matiko09 [9h Kd]
blackmont111: folds 
drosan: folds 
RICKA16: folds 
morosun: folds 
YuriiSolodya: folds 
matiko09: raises $1.27 to $2.27
Zeeshka: folds 
DUkalisUA: calls $1.27
*** FLOP *** [Ad 5s 3c]
DUkalisUA: checks 
matiko09: checks 
*** TURN *** [Ad 5s 3c] [Tc]
DUkalisUA: checks 
matiko09: checks 
*** RIVER *** [Ad 5s 3c Tc] [9d]
DUkalisUA: checks 
matiko09: checks 
*** SHOW DOWN ***
DUkalisUA: shows [Th Jc] (a pair of Tens)
matiko09: mucks hand 
DUkalisUA collected $4.81 from pot
*** SUMMARY ***
Total pot $5.04 | Rake $0.23 
Board [Ad 5s 3c Tc 9d]
Seat 2: YuriiSolodya folded before Flop (didn't bet)
Seat 3: matiko09 (button) mucked [9h Kd]
Seat 4: Zeeshka (small blind) folded before Flop
Seat 5: DUkalisUA (big blind) showed [Th Jc] and won ($4.81) with a pair of Tens
Seat 6: blackmont111 folded before Flop (didn't bet)
Seat 7: drosan folded before Flop (didn't bet)
Seat 8: RICKA16 folded before Flop (didn't bet)
Seat 9: morosun folded before Flop (didn't bet)





PokerStars Hand #150798727773:  Hold'em No Limit ($0.25/$0.50 USD) - 2016/03/23 13:09:19 CET [2016/03/23 8:09:19 ET]
Table 'Pyrrhus' 9-max Seat #2 is the button
Seat 1: 1Maxx123 ($86.26 in chips) 
Seat 2: fandorin2005 ($50 in chips) 
Seat 3: Ahangama ($50 in chips) 
Seat 4: Pokerlkl ($41.45 in chips) 
Seat 6: whalldo ($64.26 in chips) 
Seat 7: matiko09 ($118.65 in chips) 
Seat 8: RulingEmu ($34.87 in chips) 
Seat 9: Bohne0815 ($49.20 in chips) 
Ahangama: posts small blind $0.25
Pokerlkl: posts big blind $0.50
*** HOLE CARDS ***
Dealt to matiko09 [Th Jc]
whalldo: folds 
matiko09: folds 
RulingEmu: raises $1 to $1.50
Bohne0815: folds 
1Maxx123: folds 
fandorin2005: folds 
Ahangama: folds 
Pokerlkl: calls $1
*** FLOP *** [As 3c 3h]
Pokerlkl: checks 
RulingEmu: bets $1.50
Pokerlkl: calls $1.50
*** TURN *** [As 3c 3h] [7s]
Pokerlkl: checks 
RulingEmu: bets $3
Pokerlkl: calls $3
*** RIVER *** [As 3c 3h 7s] [Jd]
Pokerlkl: checks 
RulingEmu: bets $6
Pokerlkl: calls $6
*** SHOW DOWN ***
RulingEmu: shows [Qs 9s] (a pair of Threes)
Pokerlkl: shows [Ah 8d] (two pair, Aces and Threes)
Pokerlkl collected $23.16 from pot
*** SUMMARY ***
Total pot $24.25 | Rake $1.09 
Board [As 3c 3h 7s Jd]
Seat 1: 1Maxx123 folded before Flop (didn't bet)
Seat 2: fandorin2005 (button) folded before Flop (didn't bet)
Seat 3: Ahangama (small blind) folded before Flop
Seat 4: Pokerlkl (big blind) showed [Ah 8d] and won ($23.16) with two pair, Aces and Threes
Seat 6: whalldo folded before Flop (didn't bet)
Seat 7: matiko09 folded before Flop (didn't bet)
Seat 8: RulingEmu showed [Qs 9s] and lost with a pair of Threes
Seat 9: Bohne0815 folded before Flop (didn't bet)





PokerStars Hand #150798730439:  Hold'em No Limit ($0.50/$1.00 USD) - 2016/03/23 13:09:25 CET [2016/03/23 8:09:25 ET]
Table 'Oljato' 9-max Seat #4 is the button
Seat 2: Benixxx13 ($97 in chips) 
Seat 3: DUkalisUA ($100 in chips) 
Seat 4: Pvsx. ($102.28 in chips) 
Seat 5: ryo728 ($83.25 in chips) 
Seat 6: WDW3 ($111.94 in chips) 
Seat 7: matiko09 ($165.73 in chips) 
Seat 8: Zeeshka ($217.70 in chips) 
Seat 9: Jimy Tiltman ($101.50 in chips) 
ryo728: posts small blind $0.50
WDW3: posts big blind $1
Pearl Jam87: sits out 
*** HOLE CARDS ***
Dealt to matiko09 [8s 7h]
matiko09: folds 
Zeeshka: raises $2 to $3
Jimy Tiltman: folds 
Benixxx13: raises $6.40 to $9.40
DUkalisUA: raises $12.10 to $21.50
Pvsx.: folds 
ryo728: folds 
WDW3: folds 
Zeeshka: raises $196.20 to $217.70 and is all-in
Benixxx13: calls $87.60 and is all-in
DUkalisUA: folds 
Uncalled bet ($120.70) returned to Zeeshka
*** FLOP *** [Tc Ks Jc]
*** TURN *** [Tc Ks Jc] [5d]
*** RIVER *** [Tc Ks Jc 5d] [4d]
*** SHOW DOWN ***
Zeeshka: shows [Ah Kh] (a pair of Kings)
Benixxx13: mucks hand 
Zeeshka collected $214.20 from pot
*** SUMMARY ***
Total pot $217 | Rake $2.80 
Board [Tc Ks Jc 5d 4d]
Seat 2: Benixxx13 mucked [Qh Qd]
Seat 3: DUkalisUA folded before Flop
Seat 4: Pvsx. (button) folded before Flop (didn't bet)
Seat 5: ryo728 (small blind) folded before Flop
Seat 6: WDW3 (big blind) folded before Flop
Seat 7: matiko09 folded before Flop (didn't bet)
Seat 8: Zeeshka showed [Ah Kh] and won ($214.20) with a pair of Kings
Seat 9: Jimy Tiltman folded before Flop (didn't bet)





PokerStars Hand #150798733815:  Hold'em No Limit ($1/$2 USD) - 2016/03/23 13:09:34 CET [2016/03/23 8:09:34 ET]
Table 'Herba II' 9-max Seat #8 is the button
Seat 1: matiko09 ($211.77 in chips) 
Seat 3: Daveguyaces ($109.30 in chips) 
Seat 5: chippo boy ($176 in chips) 
Seat 6: WDW3 ($216.47 in chips) 
Seat 7: InsomniaRU ($200 in chips) 
Seat 8: heisatur ($157 in chips) 
Seat 9: mrhighryza ($133.71 in chips) 
mrhighryza: posts small blind $1
matiko09: posts big blind $2
Moszes360: sits out 
DUkalisUA: sits out 
*** HOLE CARDS ***
Dealt to matiko09 [As 2h]
Daveguyaces: folds 
chippo boy: folds 
WDW3: folds 
InsomniaRU: folds 
heisatur: folds 
mrhighryza: calls $1
matiko09: checks 
*** FLOP *** [Qc 4c 7d]
mrhighryza: checks 
matiko09: checks 
*** TURN *** [Qc 4c 7d] [4h]
mrhighryza: checks 
matiko09: checks 
*** RIVER *** [Qc 4c 7d 4h] [3d]
mrhighryza: checks 
matiko09: checks 
*** SHOW DOWN ***
mrhighryza: shows [Kc 2d] (a pair of Fours)
matiko09: shows [As 2h] (a pair of Fours - Ace kicker)
matiko09 collected $3.82 from pot
*** SUMMARY ***
Total pot $4 | Rake $0.18 
Board [Qc 4c 7d 4h 3d]
Seat 1: matiko09 (big blind) showed [As 2h] and won ($3.82) with a pair of Fours
Seat 3: Daveguyaces folded before Flop (didn't bet)
Seat 5: chippo boy folded before Flop (didn't bet)
Seat 6: WDW3 folded before Flop (didn't bet)
Seat 7: InsomniaRU folded before Flop (didn't bet)
Seat 8: heisatur (button) folded before Flop (didn't bet)
Seat 9: mrhighryza (small blind) showed [Kc 2d] and lost with a pair of Fours





PokerStars Hand #150798742235:  Hold'em No Limit ($1/$2 USD) - 2016/03/23 13:09:54 CET [2016/03/23 8:09:54 ET]
Table 'Kypria II' 9-max Seat #3 is the button
Seat 1: geldwolfje ($273.62 in chips) 
Seat 2: coinflip_si ($227.51 in chips) 
Seat 3: seouljam ($105.82 in chips) 
Seat 4: nailz83 ($53.87 in chips) 
Seat 5: Charity86 ($124.44 in chips) 
Seat 6: matiko09 ($200 in chips) 
Seat 7: ldwin8 ($325.16 in chips) 
Seat 8: Fish4trips ($200 in chips) 
Seat 9: WDW3 ($200 in chips) 
nailz83: posts small blind $1
Charity86: posts big blind $2
*** HOLE CARDS ***
Dealt to matiko09 [7h Ts]
matiko09: folds 
ldwin8: raises $4 to $6
Fish4trips: folds 
WDW3: folds 
geldwolfje: folds 
coinflip_si: folds 
seouljam: folds 
nailz83: folds 
Charity86: folds 
Uncalled bet ($4) returned to ldwin8
ldwin8 collected $5 from pot
*** SUMMARY ***
Total pot $5 | Rake $0 
Seat 1: geldwolfje folded before Flop (didn't bet)
Seat 2: coinflip_si folded before Flop (didn't bet)
Seat 3: seouljam (button) folded before Flop (didn't bet)
Seat 4: nailz83 (small blind) folded before Flop
Seat 5: Charity86 (big blind) folded before Flop
Seat 6: matiko09 folded before Flop (didn't bet)
Seat 7: ldwin8 collected ($5)
Seat 8: Fish4trips folded before Flop (didn't bet)
Seat 9: WDW3 folded before Flop (didn't bet)





PokerStars Hand #150798744475:  Hold'em No Limit ($0.50/$1.00 USD) - 2016/03/23 13:09:59 CET [2016/03/23 8:09:59 ET]
Table 'Smiley' 9-max Seat #4 is the button
Seat 2: YuriiSolodya ($72.20 in chips) 
Seat 3: matiko09 ($100 in chips) 
Seat 4: Zeeshka ($100 in chips) 
Seat 5: DUkalisUA ($102.54 in chips) 
Seat 6: blackmont111 ($79 in chips) 
Seat 7: drosan ($52.18 in chips) 
Seat 8: RICKA16 ($115.06 in chips) 
Seat 9: morosun ($62.96 in chips) 
DUkalisUA: posts small blind $0.50
blackmont111: posts big blind $1
WDW3: sits out 
*** HOLE CARDS ***
Dealt to matiko09 [Jc 3c]
drosan: folds 
RICKA16: folds 
morosun: folds 
YuriiSolodya: folds 
matiko09: folds 
Zeeshka: raises $1.50 to $2.50
DUkalisUA: folds 
blackmont111: folds 
Uncalled bet ($1.50) returned to Zeeshka
Zeeshka collected $2.50 from pot
Zeeshka: doesn't show hand 
*** SUMMARY ***
Total pot $2.50 | Rake $0 
Seat 2: YuriiSolodya folded before Flop (didn't bet)
Seat 3: matiko09 folded before Flop (didn't bet)
Seat 4: Zeeshka (button) collected ($2.50)
Seat 5: DUkalisUA (small blind) folded before Flop
Seat 6: blackmont111 (big blind) folded before Flop
Seat 7: drosan folded before Flop (didn't bet)
Seat 8: RICKA16 folded before Flop (didn't bet)
Seat 9: morosun folded before Flop (didn't bet)





PokerStars Hand #150798746502:  Hold'em No Limit ($0.50/$1.00 USD) - 2016/03/23 13:10:04 CET [2016/03/23 8:10:04 ET]
Table 'Atlantis' 9-max Seat #1 is the button
Seat 1: xHourglass ($151.68 in chips) 
Seat 2: tffff2006 ($54.50 in chips) 
Seat 3: CAJUN890 ($98.50 in chips) 
Seat 4: matiko09 ($122.17 in chips) 
Seat 6: Jimy Tiltman ($100 in chips) 
Seat 7: Zeeshka ($107.96 in chips) 
Seat 8: lumen21 ($123.88 in chips) 
Seat 9: WDW3 ($128.87 in chips) 
tffff2006: posts small blind $0.50
CAJUN890: posts big blind $1
unequivocali: sits out 
*** HOLE CARDS ***
Dealt to matiko09 [8c Ah]
matiko09: folds 
Jimy Tiltman: folds 
Zeeshka: folds 
lumen21: raises $2 to $3
WDW3: calls $3
xHourglass: calls $3
tffff2006: folds 
CAJUN890: folds 
*** FLOP *** [2s 6h Qc]
lumen21: checks 
WDW3: checks 
xHourglass: checks 
*** TURN *** [2s 6h Qc] [5h]
lumen21: checks 
WDW3: checks 
xHourglass: checks 
*** RIVER *** [2s 6h Qc 5h] [4s]
lumen21: checks 
WDW3: checks 
xHourglass: bets $7.52
lumen21: folds 
WDW3: folds 
Uncalled bet ($7.52) returned to xHourglass
xHourglass collected $10.03 from pot
xHourglass: doesn't show hand 
*** SUMMARY ***
Total pot $10.50 | Rake $0.47 
Board [2s 6h Qc 5h 4s]
Seat 1: xHourglass (button) collected ($10.03)
Seat 2: tffff2006 (small blind) folded before Flop
Seat 3: CAJUN890 (big blind) folded before Flop
Seat 4: matiko09 folded before Flop (didn't bet)
Seat 6: Jimy Tiltman folded before Flop (didn't bet)
Seat 7: Zeeshka folded before Flop (didn't bet)
Seat 8: lumen21 folded on the River
Seat 9: WDW3 folded on the River





PokerStars Hand #150798750003:  Hold'em No Limit ($1/$2 USD) - 2016/03/23 13:10:12 CET [2016/03/23 8:10:12 ET]
Table 'Herba II' 9-max Seat #9 is the button
Seat 1: matiko09 ($213.59 in chips) 
Seat 2: Moszes360 ($200 in chips) 
Seat 3: Daveguyaces ($109.30 in chips) 
Seat 5: chippo boy ($200 in chips) 
Seat 6: WDW3 ($216.47 in chips) 
Seat 7: InsomniaRU ($200 in chips) 
Seat 8: heisatur ($157 in chips) 
Seat 9: mrhighryza ($131.71 in chips) 
matiko09: posts small blind $1
Moszes360: posts big blind $2
DUkalisUA: sits out 
*** HOLE CARDS ***
Dealt to matiko09 [Ah Ad]
Daveguyaces: calls $2
chippo boy: calls $2
WDW3: raises $9 to $11
InsomniaRU: folds 
heisatur: folds 
mrhighryza: folds 
matiko09: calls $10
Moszes360: folds 
Daveguyaces: calls $9
chippo boy: calls $9
*** FLOP *** [3h 9c Qd]
matiko09: bets $28
Daveguyaces: folds 
chippo boy: folds 
WDW3: folds 
Uncalled bet ($28) returned to matiko09
matiko09 collected $43.93 from pot
matiko09: doesn't show hand 
*** SUMMARY ***
Total pot $46 | Rake $2.07 
Board [3h 9c Qd]
Seat 1: matiko09 (small blind) collected ($43.93)
Seat 2: Moszes360 (big blind) folded before Flop
Seat 3: Daveguyaces folded on the Flop
Seat 5: chippo boy folded on the Flop
Seat 6: WDW3 folded on the Flop
Seat 7: InsomniaRU folded before Flop (didn't bet)
Seat 8: heisatur folded before Flop (didn't bet)
Seat 9: mrhighryza (button) folded before Flop (didn't bet)





PokerStars Hand #150798751087:  Hold'em No Limit ($1/$2 USD) - 2016/03/23 13:10:15 CET [2016/03/23 8:10:15 ET]
Table 'Kypria II' 9-max Seat #4 is the button
Seat 1: geldwolfje ($273.62 in chips) 
Seat 2: coinflip_si ($227.51 in chips) 
Seat 3: seouljam ($105.82 in chips) 
Seat 4: nailz83 ($52.87 in chips) 
Seat 5: Charity86 ($122.44 in chips) 
Seat 6: matiko09 ($200 in chips) 
Seat 7: ldwin8 ($328.16 in chips) 
Seat 8: Fish4trips ($200 in chips) 
Seat 9: WDW3 ($200 in chips) 
Charity86: posts small blind $1
matiko09: posts big blind $2
*** HOLE CARDS ***
Dealt to matiko09 [Js Ad]
ldwin8: folds 
Fish4trips: folds 
WDW3: folds 
geldwolfje: folds 
coinflip_si: folds 
seouljam: raises $2.50 to $4.50
nailz83: calls $4.50
Charity86: folds 
matiko09: calls $2.50
*** FLOP *** [2h Jd 6d]
matiko09: bets $10
seouljam: folds 
nailz83: calls $10
*** TURN *** [2h Jd 6d] [Qs]
matiko09: bets $22
nailz83: raises $16.37 to $38.37 and is all-in
matiko09: calls $16.37
*** RIVER *** [2h Jd 6d Qs] [Ac]
*** SHOW DOWN ***
matiko09: shows [Js Ad] (two pair, Aces and Jacks)
nailz83: mucks hand 
matiko09 collected $108.44 from pot
*** SUMMARY ***
Total pot $111.24 | Rake $2.80 
Board [2h Jd 6d Qs Ac]
Seat 1: geldwolfje folded before Flop (didn't bet)
Seat 2: coinflip_si folded before Flop (didn't bet)
Seat 3: seouljam folded on the Flop
Seat 4: nailz83 (button) mucked [Jh 9s]
Seat 5: Charity86 (small blind) folded before Flop
Seat 6: matiko09 (big blind) showed [Js Ad] and won ($108.44) with two pair, Aces and Jacks
Seat 7: ldwin8 folded before Flop (didn't bet)
Seat 8: Fish4trips folded before Flop (didn't bet)
Seat 9: WDW3 folded before Flop (didn't bet)





PokerStars Hand #150798751455:  Hold'em No Limit ($0.50/$1.00 USD) - 2016/03/23 13:10:16 CET [2016/03/23 8:10:16 ET]
Table 'Smiley' 9-max Seat #5 is the button
Seat 2: YuriiSolodya ($72.20 in chips) 
Seat 3: matiko09 ($100 in chips) 
Seat 4: Zeeshka ($101.50 in chips) 
Seat 5: DUkalisUA ($102.04 in chips) 
Seat 6: blackmont111 ($78 in chips) 
Seat 7: drosan ($52.18 in chips) 
Seat 8: RICKA16 ($115.06 in chips) 
Seat 9: morosun ($62.96 in chips) 
blackmont111: posts small blind $0.50
drosan: posts big blind $1
WDW3: sits out 
*** HOLE CARDS ***
Dealt to matiko09 [7h Ks]
RICKA16: folds 
morosun: folds 
YuriiSolodya: folds 
matiko09: folds 
Zeeshka: raises $2 to $3
DUkalisUA: calls $3
blackmont111: folds 
drosan: folds 
*** FLOP *** [Jc 5h 3s]
Zeeshka: checks 
DUkalisUA: checks 
*** TURN *** [Jc 5h 3s] [Qc]
Zeeshka: checks 
DUkalisUA: bets $5.50
Zeeshka: folds 
Uncalled bet ($5.50) returned to DUkalisUA
DUkalisUA collected $7.16 from pot
DUkalisUA: doesn't show hand 
*** SUMMARY ***
Total pot $7.50 | Rake $0.34 
Board [Jc 5h 3s Qc]
Seat 2: YuriiSolodya folded before Flop (didn't bet)
Seat 3: matiko09 folded before Flop (didn't bet)
Seat 4: Zeeshka folded on the Turn
Seat 5: DUkalisUA (button) collected ($7.16)
Seat 6: blackmont111 (small blind) folded before Flop
Seat 7: drosan (big blind) folded before Flop
Seat 8: RICKA16 folded before Flop (didn't bet)
Seat 9: morosun folded before Flop (didn't bet)





PokerStars Hand #150798756057:  Hold'em No Limit ($0.25/$0.50 USD) - 2016/03/23 13:10:27 CET [2016/03/23 8:10:27 ET]
Table 'Pyrrhus' 9-max Seat #3 is the button
Seat 1: 1Maxx123 ($86.26 in chips) 
Seat 2: fandorin2005 ($50 in chips) 
Seat 3: Ahangama ($50 in chips) 
Seat 4: Pokerlkl ($52.61 in chips) 
Seat 6: whalldo ($64.26 in chips) 
Seat 7: matiko09 ($118.65 in chips) 
Seat 8: RulingEmu ($22.87 in chips) 
Seat 9: Bohne0815 ($49.20 in chips) 
Pokerlkl: posts small blind $0.25
whalldo: posts big blind $0.50
*** HOLE CARDS ***
Dealt to matiko09 [4h 5s]
matiko09: folds 
RulingEmu: raises $1 to $1.50
Bohne0815: folds 
1Maxx123: folds 
fandorin2005: folds 
Ahangama: folds 
Pokerlkl: calls $1.25
whalldo: calls $1
*** FLOP *** [2h Tc 7c]
Pokerlkl: checks 
whalldo: bets $2.15
RulingEmu: calls $2.15
Pokerlkl: calls $2.15
*** TURN *** [2h Tc 7c] [9s]
Pokerlkl: checks 
whalldo: checks 
RulingEmu: bets $5
Pokerlkl: calls $5
whalldo: folds 
*** RIVER *** [2h Tc 7c 9s] [3h]
Pokerlkl: bets $20.01
RulingEmu: folds 
Uncalled bet ($20.01) returned to Pokerlkl
Pokerlkl collected $20.01 from pot
*** SUMMARY ***
Total pot $20.95 | Rake $0.94 
Board [2h Tc 7c 9s 3h]
Seat 1: 1Maxx123 folded before Flop (didn't bet)
Seat 2: fandorin2005 folded before Flop (didn't bet)
Seat 3: Ahangama (button) folded before Flop (didn't bet)
Seat 4: Pokerlkl (small blind) collected ($20.01)
Seat 6: whalldo (big blind) folded on the Turn
Seat 7: matiko09 folded before Flop (didn't bet)
Seat 8: RulingEmu folded on the River
Seat 9: Bohne0815 folded before Flop (didn't bet)





PokerStars Hand #150798761523:  Hold'em No Limit ($0.50/$1.00 USD) - 2016/03/23 13:10:40 CET [2016/03/23 8:10:40 ET]
Table 'Kippes' 9-max Seat #4 is the button
Seat 1: YuriiSolodya ($65 in chips) 
Seat 2: RICKA16 ($130.92 in chips) 
Seat 3: CAJUN890 ($102.17 in chips) 
Seat 4: matiko09 ($100 in chips) 
Seat 5: unequivocali ($111.72 in chips) 
Seat 6: WDW3 ($101.50 in chips) 
Seat 7: lumen21 ($100 in chips) 
Seat 8: Zeeshka ($103.26 in chips) 
Seat 9: wang19790906 ($63.04 in chips) 
unequivocali: posts small blind $0.50
WDW3: posts big blind $1
*** HOLE CARDS ***
Dealt to matiko09 [2h As]
lumen21: folds 
Zeeshka: raises $2 to $3
wang19790906: folds 
YuriiSolodya: calls $3
RICKA16: folds 
CAJUN890: folds 
matiko09: folds 
unequivocali: calls $2.50
WDW3: folds 
*** FLOP *** [Ks 4s Ad]
unequivocali: checks 
Zeeshka: checks 
YuriiSolodya: checks 
*** TURN *** [Ks 4s Ad] [Qh]
unequivocali: checks 
Zeeshka: checks 
YuriiSolodya: checks 
*** RIVER *** [Ks 4s Ad Qh] [8c]
unequivocali: checks 
Zeeshka: checks 
YuriiSolodya: checks 
*** SHOW DOWN ***
unequivocali: shows [5s 5h] (a pair of Fives)
Zeeshka: shows [Jd Kd] (a pair of Kings)
YuriiSolodya: mucks hand 
Zeeshka collected $9.55 from pot
*** SUMMARY ***
Total pot $10 | Rake $0.45 
Board [Ks 4s Ad Qh 8c]
Seat 1: YuriiSolodya mucked [6c 6s]
Seat 2: RICKA16 folded before Flop (didn't bet)
Seat 3: CAJUN890 folded before Flop (didn't bet)
Seat 4: matiko09 (button) folded before Flop (didn't bet)
Seat 5: unequivocali (small blind) showed [5s 5h] and lost with a pair of Fives
Seat 6: WDW3 (big blind) folded before Flop
Seat 7: lumen21 folded before Flop (didn't bet)
Seat 8: Zeeshka showed [Jd Kd] and won ($9.55) with a pair of Kings
Seat 9: wang19790906 folded before Flop (didn't bet)





PokerStars Hand #150798762288:  Hold'em No Limit ($1/$2 USD) - 2016/03/23 13:10:41 CET [2016/03/23 8:10:41 ET]
Table 'Kiess' 9-max Seat #3 is the button
Seat 1: ldwin8 ($14.47 in chips) 
Seat 2: DUkalisUA ($519.08 in chips) 
Seat 3: Divannn ($74.60 in chips) 
Seat 4: darren1031 ($184 in chips) 
Seat 5: chippo boy ($200 in chips) 
Seat 6: matiko09 ($200 in chips) 
Seat 7: InsomniaRU ($233.41 in chips) 
Seat 8: WDW3 ($414.20 in chips) 
Seat 9: Fish4trips ($200 in chips) 
darren1031: posts small blind $1
chippo boy: posts big blind $2
*** HOLE CARDS ***
Dealt to matiko09 [6d 7d]
matiko09: raises $3 to $5
InsomniaRU: folds 
WDW3: folds 
Fish4trips: folds 
ldwin8: folds 
DUkalisUA: calls $5
Divannn: folds 
darren1031: calls $4
chippo boy: calls $3
*** FLOP *** [5c 9h 6h]
darren1031: checks 
chippo boy: bets $8
matiko09: calls $8
DUkalisUA: folds 
darren1031: raises $32 to $40
chippo boy: calls $32
matiko09: folds 
*** TURN *** [5c 9h 6h] [2h]
darren1031: bets $139 and is all-in
chippo boy: calls $139
*** RIVER *** [5c 9h 6h 2h] [9c]
*** SHOW DOWN ***
darren1031: shows [Kd Kc] (two pair, Kings and Nines)
chippo boy: shows [5h Th] (a flush, Ten high)
chippo boy collected $383.20 from pot
*** SUMMARY ***
Total pot $386 | Rake $2.80 
Board [5c 9h 6h 2h 9c]
Seat 1: ldwin8 folded before Flop (didn't bet)
Seat 2: DUkalisUA folded on the Flop
Seat 3: Divannn (button) folded before Flop (didn't bet)
Seat 4: darren1031 (small blind) showed [Kd Kc] and lost with two pair, Kings and Nines
Seat 5: chippo boy (big blind) showed [5h Th] and won ($383.20) with a flush, Ten high
Seat 6: matiko09 folded on the Flop
Seat 7: InsomniaRU folded before Flop (didn't bet)
Seat 8: WDW3 folded before Flop (didn't bet)
Seat 9: Fish4trips folded before Flop (didn't bet)





PokerStars Hand #150798769633:  Hold'em No Limit ($0.50/$1.00 USD) - 2016/03/23 13:10:59 CET [2016/03/23 8:10:59 ET]
Table 'Oljato' 9-max Seat #5 is the button
Seat 3: DUkalisUA ($100 in chips) 
Seat 4: Pvsx. ($102.28 in chips) 
Seat 5: ryo728 ($82.75 in chips) 
Seat 6: WDW3 ($110.94 in chips) 
Seat 7: matiko09 ($165.73 in chips) 
Seat 8: Zeeshka ($334.90 in chips) 
Seat 9: Jimy Tiltman ($101.50 in chips) 
WDW3: posts small blind $0.50
matiko09: posts big blind $1
Pearl Jam87: sits out 
*** HOLE CARDS ***
Dealt to matiko09 [Ac Qh]
Benixxx13 leaves the table
Zeeshka: folds 
Jimy Tiltman: raises $2 to $3
DUkalisUA: folds 
roman134679 joins the table at seat #2 
Pvsx.: folds 
ryo728: folds 
WDW3: raises $7 to $10
matiko09: folds 
Jimy Tiltman: calls $7
*** FLOP *** [Qs Qd Kc]
WDW3: checks 
Jimy Tiltman: checks 
*** TURN *** [Qs Qd Kc] [8s]
WDW3: checks 
Jimy Tiltman: checks 
*** RIVER *** [Qs Qd Kc 8s] [3d]
WDW3: bets $14
Jimy Tiltman: folds 
Uncalled bet ($14) returned to WDW3
WDW3 collected $20.06 from pot
WDW3: doesn't show hand 
*** SUMMARY ***
Total pot $21 | Rake $0.94 
Board [Qs Qd Kc 8s 3d]
Seat 3: DUkalisUA folded before Flop (didn't bet)
Seat 4: Pvsx. folded before Flop (didn't bet)
Seat 5: ryo728 (button) folded before Flop (didn't bet)
Seat 6: WDW3 (small blind) collected ($20.06)
Seat 7: matiko09 (big blind) folded before Flop
Seat 8: Zeeshka folded before Flop (didn't bet)
Seat 9: Jimy Tiltman folded on the River





PokerStars Hand #150798773920:  Hold'em No Limit ($1/$2 USD) - 2016/03/23 13:11:09 CET [2016/03/23 8:11:09 ET]
Table 'Herba II' 9-max Seat #1 is the button
Seat 1: matiko09 ($246.52 in chips) 
Seat 2: Moszes360 ($200 in chips) 
Seat 3: Daveguyaces ($98.30 in chips) 
Seat 5: chippo boy ($189 in chips) 
Seat 6: WDW3 ($205.47 in chips) 
Seat 7: InsomniaRU ($200 in chips) 
Seat 8: heisatur ($157 in chips) 
Seat 9: mrhighryza ($131.71 in chips) 
Moszes360: posts small blind $1
Daveguyaces: posts big blind $2
DUkalisUA: sits out 
*** HOLE CARDS ***
Dealt to matiko09 [2s 9h]
chippo boy: folds 
WDW3: folds 
InsomniaRU: raises $3 to $5
heisatur: folds 
mrhighryza: folds 
matiko09: folds 
Moszes360: raises $13 to $18
Daveguyaces: folds 
InsomniaRU: folds 
Uncalled bet ($13) returned to Moszes360
Moszes360 collected $12 from pot
Moszes360: doesn't show hand 
*** SUMMARY ***
Total pot $12 | Rake $0 
Seat 1: matiko09 (button) folded before Flop (didn't bet)
Seat 2: Moszes360 (small blind) collected ($12)
Seat 3: Daveguyaces (big blind) folded before Flop
Seat 5: chippo boy folded before Flop (didn't bet)
Seat 6: WDW3 folded before Flop (didn't bet)
Seat 7: InsomniaRU folded before Flop
Seat 8: heisatur folded before Flop (didn't bet)
Seat 9: mrhighryza folded before Flop (didn't bet)





PokerStars Hand #150798776357:  Hold'em No Limit ($0.50/$1.00 USD) - 2016/03/23 13:11:15 CET [2016/03/23 8:11:15 ET]
Table 'Smiley' 9-max Seat #6 is the button
Seat 2: YuriiSolodya ($72.20 in chips) 
Seat 3: matiko09 ($100 in chips) 
Seat 4: Zeeshka ($100 in chips) 
Seat 5: DUkalisUA ($106.20 in chips) 
Seat 6: blackmont111 ($77.50 in chips) 
Seat 7: drosan ($51.18 in chips) 
Seat 8: RICKA16 ($115.06 in chips) 
Seat 9: morosun ($62.96 in chips) 
drosan: posts small blind $0.50
RICKA16: posts big blind $1
WDW3: sits out 
*** HOLE CARDS ***
Dealt to matiko09 [3d Jd]
morosun: raises $1 to $2
YuriiSolodya: raises $5.50 to $7.50
matiko09: folds 
Zeeshka: folds 
DUkalisUA: folds 
blackmont111: folds 
drosan: folds 
RICKA16: folds 
morosun: calls $5.50
*** FLOP *** [3h Qc 2d]
morosun: checks 
YuriiSolodya: bets $15.76
morosun: calls $15.76
*** TURN *** [3h Qc 2d] [7c]
morosun: checks 
YuriiSolodya: bets $22.93
morosun: calls $22.93
*** RIVER *** [3h Qc 2d 7c] [9h]
morosun: checks 
YuriiSolodya: checks 
*** SHOW DOWN ***
morosun: shows [Ac 2c] (a pair of Deuces)
YuriiSolodya: shows [Qh Ah] (a pair of Queens)
YuriiSolodya collected $91.08 from pot
*** SUMMARY ***
Total pot $93.88 | Rake $2.80 
Board [3h Qc 2d 7c 9h]
Seat 2: YuriiSolodya showed [Qh Ah] and won ($91.08) with a pair of Queens
Seat 3: matiko09 folded before Flop (didn't bet)
Seat 4: Zeeshka folded before Flop (didn't bet)
Seat 5: DUkalisUA folded before Flop (didn't bet)
Seat 6: blackmont111 (button) folded before Flop (didn't bet)
Seat 7: drosan (small blind) folded before Flop
Seat 8: RICKA16 (big blind) folded before Flop
Seat 9: morosun showed [Ac 2c] and lost with a pair of Deuces





PokerStars Hand #150798777929:  Hold'em No Limit ($1/$2 USD) - 2016/03/23 13:11:18 CET [2016/03/23 8:11:18 ET]
Table 'Kypria II' 9-max Seat #5 is the button
Seat 1: geldwolfje ($273.62 in chips) 
Seat 2: coinflip_si ($227.51 in chips) 
Seat 3: seouljam ($101.32 in chips) 
Seat 5: Charity86 ($121.44 in chips) 
Seat 6: matiko09 ($255.57 in chips) 
Seat 7: ldwin8 ($328.16 in chips) 
Seat 8: Fish4trips ($200 in chips) 
Seat 9: WDW3 ($200 in chips) 
matiko09: posts small blind $1
ldwin8: posts big blind $2
*** HOLE CARDS ***
Dealt to matiko09 [Ac 9h]
Fish4trips: folds 
WDW3: folds 
geldwolfje: folds 
coinflip_si: raises $3 to $5
seouljam: folds 
Charity86: folds 
matiko09: folds 
ldwin8: folds 
Uncalled bet ($3) returned to coinflip_si
coinflip_si collected $5 from pot
coinflip_si: doesn't show hand 
*** SUMMARY ***
Total pot $5 | Rake $0 
Seat 1: geldwolfje folded before Flop (didn't bet)
Seat 2: coinflip_si collected ($5)
Seat 3: seouljam folded before Flop (didn't bet)
Seat 5: Charity86 (button) folded before Flop (didn't bet)
Seat 6: matiko09 (small blind) folded before Flop
Seat 7: ldwin8 (big blind) folded before Flop
Seat 8: Fish4trips folded before Flop (didn't bet)
Seat 9: WDW3 folded before Flop (didn't bet)





PokerStars Hand #150798782449:  Hold'em No Limit ($0.25/$0.50 USD) - 2016/03/23 13:11:29 CET [2016/03/23 8:11:29 ET]
Table 'Pyrrhus' 9-max Seat #4 is the button
Seat 1: 1Maxx123 ($86.26 in chips) 
Seat 2: fandorin2005 ($50 in chips) 
Seat 3: Ahangama ($50 in chips) 
Seat 4: Pokerlkl ($63.97 in chips) 
Seat 6: whalldo ($60.61 in chips) 
Seat 7: matiko09 ($118.65 in chips) 
Seat 8: RulingEmu ($14.22 in chips) 
Seat 9: Bohne0815 ($49.20 in chips) 
whalldo: posts small blind $0.25
matiko09: posts big blind $0.50
*** HOLE CARDS ***
Dealt to matiko09 [5d 9d]
RulingEmu: folds 
Bohne0815: raises $1 to $1.50
RulingEmu leaves the table
1Maxx123: calls $1.50
fandorin2005: folds 
Ahangama: folds 
Pokerlkl: calls $1.50
whalldo: folds 
matiko09: folds 
*** FLOP *** [7h Js Tc]
Bohne0815: checks 
1Maxx123: bets $2
Pokerlkl: calls $2
Bohne0815: calls $2
*** TURN *** [7h Js Tc] [Qd]
Bohne0815: checks 
1Maxx123: checks 
Pokerlkl: checks 
*** RIVER *** [7h Js Tc Qd] [2c]
Bohne0815: checks 
1Maxx123: checks 
Pokerlkl: bets $5.37
Bohne0815: calls $5.37
1Maxx123: folds 
*** SHOW DOWN ***
Pokerlkl: shows [Jc 8h] (a pair of Jacks)
Bohne0815: shows [Ah Qc] (a pair of Queens)
dndngod joins the table at seat #8 
Bohne0815 collected $21 from pot
*** SUMMARY ***
Total pot $21.99 | Rake $0.99 
Board [7h Js Tc Qd 2c]
Seat 1: 1Maxx123 folded on the River
Seat 2: fandorin2005 folded before Flop (didn't bet)
Seat 3: Ahangama folded before Flop (didn't bet)
Seat 4: Pokerlkl (button) showed [Jc 8h] and lost with a pair of Jacks
Seat 6: whalldo (small blind) folded before Flop
Seat 7: matiko09 (big blind) folded before Flop
Seat 8: RulingEmu folded before Flop (didn't bet)
Seat 9: Bohne0815 showed [Ah Qc] and won ($21) with a pair of Queens





PokerStars Hand #150798787923:  Hold'em No Limit ($0.50/$1.00 USD) - 2016/03/23 13:11:42 CET [2016/03/23 8:11:42 ET]
Table 'Atlantis' 9-max Seat #2 is the button
Seat 1: xHourglass ($158.71 in chips) 
Seat 2: tffff2006 ($54 in chips) 
Seat 3: CAJUN890 ($97.50 in chips) 
Seat 4: matiko09 ($122.17 in chips) 
Seat 6: Jimy Tiltman ($100 in chips) 
Seat 7: Zeeshka ($107.96 in chips) 
Seat 8: lumen21 ($120.88 in chips) 
Seat 9: WDW3 ($125.87 in chips) 
CAJUN890: posts small blind $0.50
matiko09: posts big blind $1
unequivocali: sits out 
*** HOLE CARDS ***
Dealt to matiko09 [9s 5s]
Jimy Tiltman: folds 
Zeeshka: folds 
lumen21: raises $2 to $3
WDW3: folds 
xHourglass: folds 
tffff2006: folds 
CAJUN890: folds 
matiko09: folds 
Uncalled bet ($2) returned to lumen21
lumen21 collected $2.50 from pot
lumen21: doesn't show hand 
*** SUMMARY ***
Total pot $2.50 | Rake $0 
Seat 1: xHourglass folded before Flop (didn't bet)
Seat 2: tffff2006 (button) folded before Flop (didn't bet)
Seat 3: CAJUN890 (small blind) folded before Flop
Seat 4: matiko09 (big blind) folded before Flop
Seat 6: Jimy Tiltman folded before Flop (didn't bet)
Seat 7: Zeeshka folded before Flop (didn't bet)
Seat 8: lumen21 collected ($2.50)
Seat 9: WDW3 folded before Flop (didn't bet)





PokerStars Hand #150798791611:  Hold'em No Limit ($1/$2 USD) - 2016/03/23 13:11:51 CET [2016/03/23 8:11:51 ET]
Table 'Kypria II' 9-max Seat #6 is the button
Seat 1: geldwolfje ($273.62 in chips) 
Seat 2: coinflip_si ($230.51 in chips) 
Seat 3: seouljam ($101.32 in chips) 
Seat 4: nailz83 ($80 in chips) 
Seat 5: Charity86 ($121.44 in chips) 
Seat 6: matiko09 ($254.57 in chips) 
Seat 7: ldwin8 ($326.16 in chips) 
Seat 8: Fish4trips ($200 in chips) 
Seat 9: WDW3 ($200 in chips) 
ldwin8: posts small blind $1
Fish4trips: posts big blind $2
*** HOLE CARDS ***
Dealt to matiko09 [2d 8s]
WDW3: folds 
geldwolfje: folds 
coinflip_si: folds 
seouljam: folds 
nailz83: raises $4 to $6
Charity86: folds 
matiko09: folds 
ldwin8: raises $12 to $18
Fish4trips: folds 
nailz83: calls $12
*** FLOP *** [Ts Ac Td]
ldwin8: checks 
nailz83: bets $18
ldwin8: calls $18
*** TURN *** [Ts Ac Td] [As]
ldwin8: checks 
nailz83: checks 
*** RIVER *** [Ts Ac Td As] [2h]
ldwin8: bets $71.20
nailz83: folds 
Uncalled bet ($71.20) returned to ldwin8
ldwin8 collected $71.20 from pot
*** SUMMARY ***
Total pot $74 | Rake $2.80 
Board [Ts Ac Td As 2h]
Seat 1: geldwolfje folded before Flop (didn't bet)
Seat 2: coinflip_si folded before Flop (didn't bet)
Seat 3: seouljam folded before Flop (didn't bet)
Seat 4: nailz83 folded on the River
Seat 5: Charity86 folded before Flop (didn't bet)
Seat 6: matiko09 (button) folded before Flop (didn't bet)
Seat 7: ldwin8 (small blind) collected ($71.20)
Seat 8: Fish4trips (big blind) folded before Flop
Seat 9: WDW3 folded before Flop (didn't bet)





PokerStars Hand #150798793345:  Hold'em No Limit ($1/$2 USD) - 2016/03/23 13:11:55 CET [2016/03/23 8:11:55 ET]
Table 'Herba II' 9-max Seat #2 is the button
Seat 1: matiko09 ($246.52 in chips) 
Seat 2: Moszes360 ($207 in chips) 
Seat 3: Daveguyaces ($96.30 in chips) 
Seat 4: DUkalisUA ($200 in chips) 
Seat 5: chippo boy ($189 in chips) 
Seat 6: WDW3 ($205.47 in chips) 
Seat 7: InsomniaRU ($200 in chips) 
Seat 8: heisatur ($157 in chips) 
Seat 9: mrhighryza ($131.71 in chips) 
Daveguyaces: posts small blind $1
DUkalisUA: posts big blind $2
*** HOLE CARDS ***
Dealt to matiko09 [5c 9d]
chippo boy: folds 
WDW3: folds 
InsomniaRU: folds 
heisatur: folds 
mrhighryza: folds 
matiko09: folds 
Moszes360: raises $2.20 to $4.20
Daveguyaces: folds 
DUkalisUA: raises $12.80 to $17
Moszes360: calls $12.80
*** FLOP *** [Qs 9s 4c]
DUkalisUA: bets $14
heisatur leaves the table
Moszes360: calls $14
*** TURN *** [Qs 9s 4c] [6h]
myatiy 96 joins the table at seat #8 
DUkalisUA: checks 
Moszes360: bets $39.73
DUkalisUA: folds 
Uncalled bet ($39.73) returned to Moszes360
Moszes360 collected $60.20 from pot
Moszes360: doesn't show hand 
*** SUMMARY ***
Total pot $63 | Rake $2.80 
Board [Qs 9s 4c 6h]
Seat 1: matiko09 folded before Flop (didn't bet)
Seat 2: Moszes360 (button) collected ($60.20)
Seat 3: Daveguyaces (small blind) folded before Flop
Seat 4: DUkalisUA (big blind) folded on the Turn
Seat 5: chippo boy folded before Flop (didn't bet)
Seat 6: WDW3 folded before Flop (didn't bet)
Seat 7: InsomniaRU folded before Flop (didn't bet)
Seat 8: heisatur folded before Flop (didn't bet)
Seat 9: mrhighryza folded before Flop (didn't bet)





PokerStars Hand #150798796790:  Hold'em No Limit ($0.50/$1.00 USD) - 2016/03/23 13:12:03 CET [2016/03/23 8:12:03 ET]
Table 'Smiley' 9-max Seat #7 is the button
Seat 2: YuriiSolodya ($117.09 in chips) 
Seat 3: matiko09 ($100 in chips) 
Seat 4: Zeeshka ($100 in chips) 
Seat 5: DUkalisUA ($106.20 in chips) 
Seat 6: blackmont111 ($77.50 in chips) 
Seat 7: drosan ($50.68 in chips) 
Seat 8: RICKA16 ($114.06 in chips) 
Seat 9: morosun ($16.77 in chips) 
RICKA16: posts small blind $0.50
morosun: posts big blind $1
WDW3: sits out 
*** HOLE CARDS ***
Dealt to matiko09 [8h Qs]
YuriiSolodya: folds 
matiko09: folds 
Zeeshka: folds 
DUkalisUA: folds 
blackmont111: raises $2 to $3
drosan: folds 
RICKA16: folds 
morosun: folds 
Uncalled bet ($2) returned to blackmont111
blackmont111 collected $2.50 from pot
blackmont111: doesn't show hand 
*** SUMMARY ***
Total pot $2.50 | Rake $0 
Seat 2: YuriiSolodya folded before Flop (didn't bet)
Seat 3: matiko09 folded before Flop (didn't bet)
Seat 4: Zeeshka folded before Flop (didn't bet)
Seat 5: DUkalisUA folded before Flop (didn't bet)
Seat 6: blackmont111 collected ($2.50)
Seat 7: drosan (button) folded before Flop (didn't bet)
Seat 8: RICKA16 (small blind) folded before Flop
Seat 9: morosun (big blind) folded before Flop





PokerStars Hand #150798800255:  Hold'em No Limit ($0.50/$1.00 USD) - 2016/03/23 13:12:11 CET [2016/03/23 8:12:11 ET]
Table 'Kippes' 9-max Seat #5 is the button
Seat 1: YuriiSolodya ($62 in chips) 
Seat 2: RICKA16 ($130.92 in chips) 
Seat 3: CAJUN890 ($102.17 in chips) 
Seat 4: matiko09 ($100 in chips) 
Seat 5: unequivocali ($108.72 in chips) 
Seat 6: WDW3 ($100.50 in chips) 
Seat 7: lumen21 ($100 in chips) 
Seat 8: Zeeshka ($109.81 in chips) 
Seat 9: wang19790906 ($63.04 in chips) 
WDW3: posts small blind $0.50
lumen21: posts big blind $1
*** HOLE CARDS ***
Dealt to matiko09 [7s 6h]
Zeeshka: folds 
wang19790906: folds 
YuriiSolodya: folds 
RICKA16: folds 
CAJUN890: folds 
matiko09: folds 
unequivocali: raises $1 to $2
WDW3: raises $6 to $8
lumen21: calls $7
unequivocali: folds 
*** FLOP *** [2d 4c 3d]
WDW3: checks 
lumen21: checks 
*** TURN *** [2d 4c 3d] [Tc]
WDW3: bets $13
lumen21: folds 
Uncalled bet ($13) returned to WDW3
WDW3 collected $17.19 from pot
WDW3: doesn't show hand 
*** SUMMARY ***
Total pot $18 | Rake $0.81 
Board [2d 4c 3d Tc]
Seat 1: YuriiSolodya folded before Flop (didn't bet)
Seat 2: RICKA16 folded before Flop (didn't bet)
Seat 3: CAJUN890 folded before Flop (didn't bet)
Seat 4: matiko09 folded before Flop (didn't bet)
Seat 5: unequivocali (button) folded before Flop
Seat 6: WDW3 (small blind) collected ($17.19)
Seat 7: lumen21 (big blind) folded on the Turn
Seat 8: Zeeshka folded before Flop (didn't bet)
Seat 9: wang19790906 folded before Flop (didn't bet)





PokerStars Hand #150798800978:  Hold'em No Limit ($0.50/$1.00 USD) - 2016/03/23 13:12:13 CET [2016/03/23 8:12:13 ET]
Table 'Atlantis' 9-max Seat #3 is the button
Seat 1: xHourglass ($158.71 in chips) 
Seat 2: tffff2006 ($54 in chips) 
Seat 3: CAJUN890 ($97 in chips) 
Seat 4: matiko09 ($121.17 in chips) 
Seat 5: unequivocali ($112.24 in chips) 
Seat 6: Jimy Tiltman ($100 in chips) 
Seat 7: Zeeshka ($107.96 in chips) 
Seat 8: lumen21 ($122.38 in chips) 
Seat 9: WDW3 ($125.87 in chips) 
matiko09: posts small blind $0.50
unequivocali: posts big blind $1
*** HOLE CARDS ***
Dealt to matiko09 [5h Td]
Jimy Tiltman: raises $2 to $3
Zeeshka: folds 
lumen21: folds 
WDW3: folds 
xHourglass: folds 
tffff2006: folds 
CAJUN890: folds 
matiko09: folds 
unequivocali: folds 
Uncalled bet ($2) returned to Jimy Tiltman
Jimy Tiltman collected $2.50 from pot
Jimy Tiltman: doesn't show hand 
*** SUMMARY ***
Total pot $2.50 | Rake $0 
Seat 1: xHourglass folded before Flop (didn't bet)
Seat 2: tffff2006 folded before Flop (didn't bet)
Seat 3: CAJUN890 (button) folded before Flop (didn't bet)
Seat 4: matiko09 (small blind) folded before Flop
Seat 5: unequivocali (big blind) folded before Flop
Seat 6: Jimy Tiltman collected ($2.50)
Seat 7: Zeeshka folded before Flop (didn't bet)
Seat 8: lumen21 folded before Flop (didn't bet)
Seat 9: WDW3 folded before Flop (didn't bet)





PokerStars Hand #150798807359:  Hold'em No Limit ($0.50/$1.00 USD) - 2016/03/23 13:12:28 CET [2016/03/23 8:12:28 ET]
Table 'Smiley' 9-max Seat #8 is the button
Seat 1: WDW3 ($100 in chips) 
Seat 2: YuriiSolodya ($117.09 in chips) 
Seat 3: matiko09 ($100 in chips) 
Seat 4: Zeeshka ($100 in chips) 
Seat 5: DUkalisUA ($106.20 in chips) 
Seat 6: blackmont111 ($79 in chips) 
Seat 7: drosan ($50.68 in chips) 
Seat 8: RICKA16 ($113.56 in chips) 
Seat 9: morosun ($15.77 in chips) 
morosun: posts small blind $0.50
WDW3: posts big blind $1
*** HOLE CARDS ***
Dealt to matiko09 [8d Qh]
YuriiSolodya: folds 
matiko09: folds 
Zeeshka: folds 
DUkalisUA: folds 
blackmont111: folds 
drosan: folds 
RICKA16: folds 
morosun: raises $14.77 to $15.77 and is all-in
WDW3: folds 
Uncalled bet ($14.77) returned to morosun
morosun collected $2 from pot
*** SUMMARY ***
Total pot $2 | Rake $0 
Seat 1: WDW3 (big blind) folded before Flop
Seat 2: YuriiSolodya folded before Flop (didn't bet)
Seat 3: matiko09 folded before Flop (didn't bet)
Seat 4: Zeeshka folded before Flop (didn't bet)
Seat 5: DUkalisUA folded before Flop (didn't bet)
Seat 6: blackmont111 folded before Flop (didn't bet)
Seat 7: drosan folded before Flop (didn't bet)
Seat 8: RICKA16 (button) folded before Flop (didn't bet)
Seat 9: morosun (small blind) collected ($2)





PokerStars Hand #150798810606:  Hold'em No Limit ($0.25/$0.50 USD) - 2016/03/23 13:12:36 CET [2016/03/23 8:12:36 ET]
Table 'Pyrrhus' 9-max Seat #6 is the button
Seat 1: 1Maxx123 ($82.76 in chips) 
Seat 2: fandorin2005 ($50 in chips) 
Seat 3: Ahangama ($50 in chips) 
Seat 4: Pokerlkl ($55.10 in chips) 
Seat 5: lengcunjuan ($30 in chips) 
Seat 6: whalldo ($60.36 in chips) 
Seat 7: matiko09 ($118.15 in chips) 
Seat 8: dndngod ($50 in chips) 
Seat 9: Bohne0815 ($61.33 in chips) 
matiko09: posts small blind $0.25
dndngod: posts big blind $0.50
lengcunjuan: posts small & big blinds $0.75
*** HOLE CARDS ***
Dealt to matiko09 [8h 9d]
Bohne0815: folds 
1Maxx123: folds 
fandorin2005: folds 
Ahangama: folds 
Bohne0815 leaves the table
Pokerlkl: calls $0.50
lengcunjuan: checks 
whalldo: folds 
matiko09: calls $0.25
dndngod: checks 
*** FLOP *** [Td 8c Ac]
matiko09: checks 
dndngod: checks 
Pokerlkl: bets $4
CvMCvMCvM joins the table at seat #9 
lengcunjuan: folds 
matiko09: folds 
dndngod: folds 
Uncalled bet ($4) returned to Pokerlkl
Pokerlkl collected $2.15 from pot
*** SUMMARY ***
Total pot $2.25 | Rake $0.10 
Board [Td 8c Ac]
Seat 1: 1Maxx123 folded before Flop (didn't bet)
Seat 2: fandorin2005 folded before Flop (didn't bet)
Seat 3: Ahangama folded before Flop (didn't bet)
Seat 4: Pokerlkl collected ($2.15)
Seat 5: lengcunjuan folded on the Flop
Seat 6: whalldo (button) folded before Flop (didn't bet)
Seat 7: matiko09 (small blind) folded on the Flop
Seat 8: dndngod (big blind) folded on the Flop
Seat 9: Bohne0815 folded before Flop (didn't bet)





PokerStars Hand #150798811309:  Hold'em No Limit ($0.50/$1.00 USD) - 2016/03/23 13:12:37 CET [2016/03/23 8:12:37 ET]
Table 'Oljato' 9-max Seat #6 is the button
Seat 3: DUkalisUA ($100 in chips) 
Seat 4: Pvsx. ($102.28 in chips) 
Seat 5: ryo728 ($82.75 in chips) 
Seat 6: WDW3 ($121 in chips) 
Seat 7: matiko09 ($164.73 in chips) 
Seat 8: Zeeshka ($334.90 in chips) 
Seat 9: Jimy Tiltman ($100 in chips) 
matiko09: posts small blind $0.50
Zeeshka: posts big blind $1
Pearl Jam87: sits out 
roman134679: sits out 
*** HOLE CARDS ***
Dealt to matiko09 [6d Ks]
Jimy Tiltman: folds 
DUkalisUA: raises $2 to $3
Pvsx.: folds 
ryo728: folds 
WDW3: folds 
matiko09: folds 
Zeeshka: raises $6.90 to $9.90
DUkalisUA: folds 
Uncalled bet ($6.90) returned to Zeeshka
Zeeshka collected $6.50 from pot
Zeeshka: doesn't show hand 
*** SUMMARY ***
Total pot $6.50 | Rake $0 
Seat 3: DUkalisUA folded before Flop
Seat 4: Pvsx. folded before Flop (didn't bet)
Seat 5: ryo728 folded before Flop (didn't bet)
Seat 6: WDW3 (button) folded before Flop (didn't bet)
Seat 7: matiko09 (small blind) folded before Flop
Seat 8: Zeeshka (big blind) collected ($6.50)
Seat 9: Jimy Tiltman folded before Flop (didn't bet)





PokerStars Hand #150798811705:  Hold'em No Limit ($1/$2 USD) - 2016/03/23 13:12:38 CET [2016/03/23 8:12:38 ET]
Table 'Kiess' 9-max Seat #5 is the button
Seat 1: ldwin8 ($200 in chips) 
Seat 2: DUkalisUA ($514.08 in chips) 
Seat 3: Divannn ($74.60 in chips) 
Seat 5: chippo boy ($399.20 in chips) 
Seat 6: matiko09 ($200 in chips) 
Seat 7: InsomniaRU ($233.41 in chips) 
Seat 8: WDW3 ($414.20 in chips) 
Seat 9: Fish4trips ($200 in chips) 
matiko09: posts small blind $1
InsomniaRU: posts big blind $2
*** HOLE CARDS ***
Dealt to matiko09 [5s Js]
WDW3: folds 
Fish4trips: folds 
ldwin8: folds 
DUkalisUA: folds 
Divannn: calls $2
chippo boy: calls $2
matiko09: folds 
InsomniaRU: checks 
*** FLOP *** [Tc Jc 8d]
InsomniaRU: checks 
Divannn: checks 
chippo boy: checks 
*** TURN *** [Tc Jc 8d] [5h]
InsomniaRU: checks 
Divannn: checks 
chippo boy: checks 
*** RIVER *** [Tc Jc 8d 5h] [6d]
InsomniaRU has timed out
InsomniaRU: checks 
Divannn: checks 
chippo boy: checks 
*** SHOW DOWN ***
InsomniaRU: shows [Kc 4d] (high card King)
Divannn: shows [As 7s] (high card Ace)
chippo boy: mucks hand 
Divannn collected $6.68 from pot
*** SUMMARY ***
Total pot $7 | Rake $0.32 
Board [Tc Jc 8d 5h 6d]
Seat 1: ldwin8 folded before Flop (didn't bet)
Seat 2: DUkalisUA folded before Flop (didn't bet)
Seat 3: Divannn showed [As 7s] and won ($6.68) with high card Ace
Seat 5: chippo boy (button) mucked [3h Qh]
Seat 6: matiko09 (small blind) folded before Flop
Seat 7: InsomniaRU (big blind) showed [Kc 4d] and lost with high card King
Seat 8: WDW3 folded before Flop (didn't bet)
Seat 9: Fish4trips folded before Flop (didn't bet)





PokerStars Hand #150798815850:  Hold'em No Limit ($1/$2 USD) - 2016/03/23 13:12:48 CET [2016/03/23 8:12:48 ET]
Table 'Kypria II' 9-max Seat #7 is the button
Seat 1: geldwolfje ($273.62 in chips) 
Seat 2: coinflip_si ($230.51 in chips) 
Seat 3: seouljam ($101.32 in chips) 
Seat 4: nailz83 ($44 in chips) 
Seat 5: Charity86 ($121.44 in chips) 
Seat 6: matiko09 ($254.57 in chips) 
Seat 7: ldwin8 ($361.36 in chips) 
Seat 8: Fish4trips ($200 in chips) 
Seat 9: WDW3 ($200 in chips) 
Fish4trips: posts small blind $1
WDW3: posts big blind $2
*** HOLE CARDS ***
Dealt to matiko09 [Kd 8s]
geldwolfje: folds 
coinflip_si: folds 
seouljam: raises $2.60 to $4.60
nailz83: folds 
Charity86: folds 
matiko09: folds 
ldwin8: folds 
Fish4trips: raises $10.40 to $15
WDW3: folds 
seouljam: calls $10.40
*** FLOP *** [5s 5h 8c]
Fish4trips: checks 
seouljam: checks 
*** TURN *** [5s 5h 8c] [Ks]
Fish4trips: bets $16.53
seouljam: calls $16.53
*** RIVER *** [5s 5h 8c Ks] [Ah]
Fish4trips: bets $39
seouljam: raises $30.79 to $69.79 and is all-in
Fish4trips: calls $30.79
*** SHOW DOWN ***
seouljam: shows [Jh As] (two pair, Aces and Fives)
Fish4trips: shows [Ac Kc] (two pair, Aces and Kings)
Fish4trips collected $201.84 from pot
*** SUMMARY ***
Total pot $204.64 | Rake $2.80 
Board [5s 5h 8c Ks Ah]
Seat 1: geldwolfje folded before Flop (didn't bet)
Seat 2: coinflip_si folded before Flop (didn't bet)
Seat 3: seouljam showed [Jh As] and lost with two pair, Aces and Fives
Seat 4: nailz83 folded before Flop (didn't bet)
Seat 5: Charity86 folded before Flop (didn't bet)
Seat 6: matiko09 folded before Flop (didn't bet)
Seat 7: ldwin8 (button) folded before Flop (didn't bet)
Seat 8: Fish4trips (small blind) showed [Ac Kc] and won ($201.84) with two pair, Aces and Kings
Seat 9: WDW3 (big blind) folded before Flop





PokerStars Hand #150798818328:  Hold'em No Limit ($0.50/$1.00 USD) - 2016/03/23 13:12:54 CET [2016/03/23 8:12:54 ET]
Table 'Smiley' 9-max Seat #9 is the button
Seat 1: WDW3 ($100 in chips) 
Seat 2: YuriiSolodya ($117.09 in chips) 
Seat 3: matiko09 ($100 in chips) 
Seat 4: Zeeshka ($100 in chips) 
Seat 5: DUkalisUA ($106.20 in chips) 
Seat 6: blackmont111 ($79 in chips) 
Seat 7: drosan ($50.68 in chips) 
Seat 8: RICKA16 ($113.56 in chips) 
Seat 9: morosun ($16.77 in chips) 
WDW3: posts small blind $0.50
YuriiSolodya: posts big blind $1
*** HOLE CARDS ***
Dealt to matiko09 [2c 7s]
matiko09: folds 
Zeeshka: folds 
DUkalisUA: folds 
blackmont111: folds 
drosan: folds 
RICKA16: folds 
morosun: folds 
WDW3: raises $1.80 to $2.80
YuriiSolodya: folds 
Uncalled bet ($1.80) returned to WDW3
WDW3 collected $2 from pot
WDW3: doesn't show hand 
*** SUMMARY ***
Total pot $2 | Rake $0 
Seat 1: WDW3 (small blind) collected ($2)
Seat 2: YuriiSolodya (big blind) folded before Flop
Seat 3: matiko09 folded before Flop (didn't bet)
Seat 4: Zeeshka folded before Flop (didn't bet)
Seat 5: DUkalisUA folded before Flop (didn't bet)
Seat 6: blackmont111 folded before Flop (didn't bet)
Seat 7: drosan folded before Flop (didn't bet)
Seat 8: RICKA16 folded before Flop (didn't bet)
Seat 9: morosun (button) folded before Flop (didn't bet)





PokerStars Hand #150798819639:  Hold'em No Limit ($0.50/$1.00 USD) - 2016/03/23 13:12:57 CET [2016/03/23 8:12:57 ET]
Table 'Atlantis' 9-max Seat #4 is the button
Seat 1: xHourglass ($158.71 in chips) 
Seat 2: tffff2006 ($54 in chips) 
Seat 3: CAJUN890 ($97 in chips) 
Seat 4: matiko09 ($120.67 in chips) 
Seat 5: unequivocali ($111.24 in chips) 
Seat 6: Jimy Tiltman ($101.50 in chips) 
Seat 7: Zeeshka ($107.96 in chips) 
Seat 8: lumen21 ($122.38 in chips) 
Seat 9: WDW3 ($125.87 in chips) 
unequivocali: posts small blind $0.50
Jimy Tiltman: posts big blind $1
*** HOLE CARDS ***
Dealt to matiko09 [2s 8h]
Zeeshka: folds 
lumen21: folds 
WDW3: folds 
xHourglass: folds 
tffff2006: folds 
CAJUN890: raises $3 to $4
matiko09: folds 
unequivocali: folds 
Jimy Tiltman: folds 
Uncalled bet ($3) returned to CAJUN890
CAJUN890 collected $2.50 from pot
CAJUN890: doesn't show hand 
*** SUMMARY ***
Total pot $2.50 | Rake $0 
Seat 1: xHourglass folded before Flop (didn't bet)
Seat 2: tffff2006 folded before Flop (didn't bet)
Seat 3: CAJUN890 collected ($2.50)
Seat 4: matiko09 (button) folded before Flop (didn't bet)
Seat 5: unequivocali (small blind) folded before Flop
Seat 6: Jimy Tiltman (big blind) folded before Flop
Seat 7: Zeeshka folded before Flop (didn't bet)
Seat 8: lumen21 folded before Flop (didn't bet)
Seat 9: WDW3 folded before Flop (didn't bet)





PokerStars Hand #150798823337:  Hold'em No Limit ($1/$2 USD) - 2016/03/23 13:13:06 CET [2016/03/23 8:13:06 ET]
Table 'Herba II' 9-max Seat #3 is the button
Seat 1: matiko09 ($246.52 in chips) 
Seat 2: Moszes360 ($236.20 in chips) 
Seat 3: Daveguyaces ($95.30 in chips) 
Seat 4: DUkalisUA ($200 in chips) 
Seat 5: chippo boy ($189 in chips) 
Seat 6: WDW3 ($205.47 in chips) 
Seat 7: InsomniaRU ($200 in chips) 
Seat 9: mrhighryza ($131.71 in chips) 
DUkalisUA: posts small blind $1
chippo boy: posts big blind $2
myatiy 96: sits out 
*** HOLE CARDS ***
Dealt to matiko09 [9c Ts]
WDW3: folds 
InsomniaRU: folds 
mrhighryza: folds 
matiko09: folds 
Moszes360: folds 
Daveguyaces: calls $2
DUkalisUA: folds 
chippo boy: checks 
*** FLOP *** [Jc As 6c]
chippo boy: checks 
Daveguyaces: checks 
*** TURN *** [Jc As 6c] [Qd]
chippo boy: checks 
Daveguyaces: bets $4
chippo boy: folds 
Uncalled bet ($4) returned to Daveguyaces
Daveguyaces collected $4.78 from pot
*** SUMMARY ***
Total pot $5 | Rake $0.22 
Board [Jc As 6c Qd]
Seat 1: matiko09 folded before Flop (didn't bet)
Seat 2: Moszes360 folded before Flop (didn't bet)
Seat 3: Daveguyaces (button) collected ($4.78)
Seat 4: DUkalisUA (small blind) folded before Flop
Seat 5: chippo boy (big blind) folded on the Turn
Seat 6: WDW3 folded before Flop (didn't bet)
Seat 7: InsomniaRU folded before Flop (didn't bet)
Seat 9: mrhighryza folded before Flop (didn't bet)





PokerStars Hand #150798827283:  Hold'em No Limit ($0.50/$1.00 USD) - 2016/03/23 13:13:15 CET [2016/03/23 8:13:15 ET]
Table 'Smiley' 9-max Seat #1 is the button
Seat 1: WDW3 ($101 in chips) 
Seat 2: YuriiSolodya ($116.09 in chips) 
Seat 3: matiko09 ($100 in chips) 
Seat 4: Zeeshka ($100 in chips) 
Seat 5: DUkalisUA ($106.20 in chips) 
Seat 6: blackmont111 ($79 in chips) 
Seat 7: drosan ($50.68 in chips) 
Seat 8: RICKA16 ($113.56 in chips) 
Seat 9: morosun ($16.77 in chips) 
YuriiSolodya: posts small blind $0.50
matiko09: posts big blind $1
*** HOLE CARDS ***
Dealt to matiko09 [Ts Ah]
Zeeshka: folds 
DUkalisUA: folds 
blackmont111: folds 
drosan: raises $2.50 to $3.50
RICKA16: folds 
morosun: calls $3.50
WDW3: folds 
YuriiSolodya: calls $3
matiko09: raises $8.50 to $12
drosan: calls $8.50
morosun: calls $8.50
YuriiSolodya: folds 
*** FLOP *** [2h Jc 3s]
matiko09: checks 
drosan: checks 
morosun: bets $4.77 and is all-in
matiko09: raises $7.23 to $12
drosan: folds 
Uncalled bet ($7.23) returned to matiko09
*** TURN *** [2h Jc 3s] [Ac]
*** RIVER *** [2h Jc 3s Ac] [4s]
*** SHOW DOWN ***
matiko09: shows [Ts Ah] (a pair of Aces)
morosun: mucks hand 
matiko09 collected $46.83 from pot
*** SUMMARY ***
Total pot $49.04 | Rake $2.21 
Board [2h Jc 3s Ac 4s]
Seat 1: WDW3 (button) folded before Flop (didn't bet)
Seat 2: YuriiSolodya (small blind) folded before Flop
Seat 3: matiko09 (big blind) showed [Ts Ah] and won ($46.83) with a pair of Aces
Seat 4: Zeeshka folded before Flop (didn't bet)
Seat 5: DUkalisUA folded before Flop (didn't bet)
Seat 6: blackmont111 folded before Flop (didn't bet)
Seat 7: drosan folded on the Flop
Seat 8: RICKA16 folded before Flop (didn't bet)
Seat 9: morosun mucked [9h Tc]





PokerStars Hand #150798831329:  Hold'em No Limit ($0.50/$1.00 USD) - 2016/03/23 13:13:25 CET [2016/03/23 8:13:25 ET]
Table 'Kippes' 9-max Seat #6 is the button
Seat 1: YuriiSolodya ($62 in chips) 
Seat 2: RICKA16 ($130.92 in chips) 
Seat 3: CAJUN890 ($102.17 in chips) 
Seat 4: matiko09 ($100 in chips) 
Seat 5: unequivocali ($106.72 in chips) 
Seat 6: WDW3 ($109.69 in chips) 
Seat 7: lumen21 ($100 in chips) 
Seat 8: Zeeshka ($109.81 in chips) 
Seat 9: wang19790906 ($63.04 in chips) 
lumen21: posts small blind $0.50
Zeeshka: posts big blind $1
*** HOLE CARDS ***
Dealt to matiko09 [8s 7c]
wang19790906: folds 
YuriiSolodya: raises $1 to $2
RICKA16: folds 
CAJUN890: calls $2
matiko09: folds 
unequivocali: folds 
WDW3: folds 
lumen21: calls $1.50
Zeeshka: calls $1
*** FLOP *** [Tc Td 3c]
lumen21: checks 
Zeeshka: checks 
YuriiSolodya: checks 
CAJUN890: bets $2.73
lumen21: folds 
Zeeshka: calls $2.73
YuriiSolodya: folds 
*** TURN *** [Tc Td 3c] [As]
Zeeshka: checks 
CAJUN890: bets $3
Zeeshka: calls $3
*** RIVER *** [Tc Td 3c As] [5s]
Zeeshka: checks 
CAJUN890: bets $11
Zeeshka: folds 
Uncalled bet ($11) returned to CAJUN890
CAJUN890 collected $18.58 from pot
CAJUN890: doesn't show hand 
*** SUMMARY ***
Total pot $19.46 | Rake $0.88 
Board [Tc Td 3c As 5s]
Seat 1: YuriiSolodya folded on the Flop
Seat 2: RICKA16 folded before Flop (didn't bet)
Seat 3: CAJUN890 collected ($18.58)
Seat 4: matiko09 folded before Flop (didn't bet)
Seat 5: unequivocali folded before Flop (didn't bet)
Seat 6: WDW3 (button) folded before Flop (didn't bet)
Seat 7: lumen21 (small blind) folded on the Flop
Seat 8: Zeeshka (big blind) folded on the River
Seat 9: wang19790906 folded before Flop (didn't bet)





PokerStars Hand #150798832710:  Hold'em No Limit ($0.25/$0.50 USD) - 2016/03/23 13:13:28 CET [2016/03/23 8:13:28 ET]
Table 'Pyrrhus' 9-max Seat #7 is the button
Seat 1: 1Maxx123 ($82.76 in chips) 
Seat 2: fandorin2005 ($50 in chips) 
Seat 3: Ahangama ($50 in chips) 
Seat 4: Pokerlkl ($56.75 in chips) 
Seat 5: lengcunjuan ($29.25 in chips) 
Seat 6: whalldo ($60.36 in chips) 
Seat 7: matiko09 ($117.65 in chips) 
Seat 8: dndngod ($50 in chips) 
Seat 9: CvMCvMCvM ($50 in chips) 
dndngod: posts small blind $0.25
CvMCvMCvM: posts big blind $0.50
*** HOLE CARDS ***
Dealt to matiko09 [6s Qh]
1Maxx123: folds 
fandorin2005: folds 
Ahangama: raises $0.75 to $1.25
Pokerlkl: calls $1.25
lengcunjuan: calls $1.25
whalldo: folds 
matiko09: folds 
dndngod: folds 
CvMCvMCvM: folds 
*** FLOP *** [Kh Ts 4h]
Ahangama: checks 
Pokerlkl: checks 
lengcunjuan: bets $2.15
Ahangama: calls $2.15
Pokerlkl: folds 
*** TURN *** [Kh Ts 4h] [2h]
Ahangama: checks 
lengcunjuan: checks 
*** RIVER *** [Kh Ts 4h 2h] [5h]
Ahangama: checks 
lengcunjuan: bets $6
Ahangama: folds 
Uncalled bet ($6) returned to lengcunjuan
lengcunjuan collected $8.40 from pot
lengcunjuan: doesn't show hand 
*** SUMMARY ***
Total pot $8.80 | Rake $0.40 
Board [Kh Ts 4h 2h 5h]
Seat 1: 1Maxx123 folded before Flop (didn't bet)
Seat 2: fandorin2005 folded before Flop (didn't bet)
Seat 3: Ahangama folded on the River
Seat 4: Pokerlkl folded on the Flop
Seat 5: lengcunjuan collected ($8.40)
Seat 6: whalldo folded before Flop (didn't bet)
Seat 7: matiko09 (button) folded before Flop (didn't bet)
Seat 8: dndngod (small blind) folded before Flop
Seat 9: CvMCvMCvM (big blind) folded before Flop





PokerStars Hand #150798834002:  Hold'em No Limit ($0.50/$1.00 USD) - 2016/03/23 13:13:31 CET [2016/03/23 8:13:31 ET]
Table 'Atlantis' 9-max Seat #5 is the button
Seat 1: xHourglass ($158.71 in chips) 
Seat 2: tffff2006 ($54 in chips) 
Seat 3: CAJUN890 ($98.50 in chips) 
Seat 4: matiko09 ($120.67 in chips) 
Seat 5: unequivocali ($110.74 in chips) 
Seat 6: Jimy Tiltman ($100.50 in chips) 
Seat 7: Zeeshka ($107.96 in chips) 
Seat 8: lumen21 ($122.38 in chips) 
Seat 9: WDW3 ($125.87 in chips) 
Jimy Tiltman: posts small blind $0.50
Zeeshka: posts big blind $1
*** HOLE CARDS ***
Dealt to matiko09 [Jh As]
lumen21: folds 
WDW3: folds 
xHourglass: raises $2 to $3
tffff2006: calls $3
CAJUN890: folds 
matiko09: raises $7 to $10
unequivocali: folds 
Jimy Tiltman: folds 
Zeeshka: folds 
xHourglass: folds 
tffff2006: folds 
Uncalled bet ($7) returned to matiko09
matiko09 collected $10.50 from pot
matiko09: doesn't show hand 
*** SUMMARY ***
Total pot $10.50 | Rake $0 
Seat 1: xHourglass folded before Flop
Seat 2: tffff2006 folded before Flop
Seat 3: CAJUN890 folded before Flop (didn't bet)
Seat 4: matiko09 collected ($10.50)
Seat 5: unequivocali (button) folded before Flop (didn't bet)
Seat 6: Jimy Tiltman (small blind) folded before Flop
Seat 7: Zeeshka (big blind) folded before Flop
Seat 8: lumen21 folded before Flop (didn't bet)
Seat 9: WDW3 folded before Flop (didn't bet)





PokerStars Hand #150798836392:  Hold'em No Limit ($0.50/$1.00 USD) - 2016/03/23 13:13:36 CET [2016/03/23 8:13:36 ET]
Table 'Oljato' 9-max Seat #7 is the button
Seat 2: roman134679 ($80 in chips) 
Seat 3: DUkalisUA ($100 in chips) 
Seat 4: Pvsx. ($102.28 in chips) 
Seat 5: ryo728 ($82.75 in chips) 
Seat 6: WDW3 ($121 in chips) 
Seat 7: matiko09 ($164.23 in chips) 
Seat 8: Zeeshka ($338.40 in chips) 
Seat 9: Jimy Tiltman ($100 in chips) 
Zeeshka: posts small blind $0.50
Jimy Tiltman: posts big blind $1
Pearl Jam87: sits out 
roman134679: posts big blind $1
*** HOLE CARDS ***
Dealt to matiko09 [2c Tc]
roman134679: checks 
DUkalisUA: folds 
Pvsx.: folds 
ryo728: folds 
WDW3: raises $3 to $4
matiko09: folds 
Zeeshka: folds 
Jimy Tiltman: folds 
roman134679: folds [Ad]
Uncalled bet ($3) returned to WDW3
WDW3 collected $3.50 from pot
WDW3: doesn't show hand 
*** SUMMARY ***
Total pot $3.50 | Rake $0 
Seat 2: roman134679 folded before Flop
Seat 3: DUkalisUA folded before Flop (didn't bet)
Seat 4: Pvsx. folded before Flop (didn't bet)
Seat 5: ryo728 folded before Flop (didn't bet)
Seat 6: WDW3 collected ($3.50)
Seat 7: matiko09 (button) folded before Flop (didn't bet)
Seat 8: Zeeshka (small blind) folded before Flop
Seat 9: Jimy Tiltman (big blind) folded before Flop





PokerStars Hand #150798944535:  Hold'em No Limit ($1/$2 USD) - 2016/03/23 13:17:44 CET [2016/03/23 8:17:44 ET]
Table 'Kypria II' 9-max Seat #2 is the button
Seat 1: geldwolfje ($266.62 in chips) 
Seat 2: coinflip_si ($200 in chips) 
Seat 4: nailz83 ($71.20 in chips) 
Seat 5: Charity86 ($135.54 in chips) 
Seat 6: matiko09 ($254.57 in chips) 
Seat 7: ldwin8 ($371.88 in chips) 
Seat 8: Fish4trips ($300.52 in chips) 
Seat 9: WDW3 ($200 in chips) 
nailz83: posts small blind $1
Charity86: posts big blind $2
*** HOLE CARDS ***
Dealt to matiko09 [Jd 7h]
matiko09: folds 
ldwin8: folds 
Fish4trips: folds 
WDW3: raises $3.60 to $5.60
geldwolfje: folds 
coinflip_si: folds 
nailz83: folds 
Charity86: folds 
Uncalled bet ($3.60) returned to WDW3
WDW3 collected $5 from pot
WDW3: doesn't show hand 
*** SUMMARY ***
Total pot $5 | Rake $0 
Seat 1: geldwolfje folded before Flop (didn't bet)
Seat 2: coinflip_si (button) folded before Flop (didn't bet)
Seat 4: nailz83 (small blind) folded before Flop
Seat 5: Charity86 (big blind) folded before Flop
Seat 6: matiko09 folded before Flop (didn't bet)
Seat 7: ldwin8 folded before Flop (didn't bet)
Seat 8: Fish4trips folded before Flop (didn't bet)
Seat 9: WDW3 collected ($5)





PokerStars Hand #150798947941:  Hold'em No Limit ($0.50/$1.00 USD) - 2016/03/23 13:17:52 CET [2016/03/23 8:17:52 ET]
Table 'Atlantis' 9-max Seat #1 is the button
Seat 1: xHourglass ($178.07 in chips) 
Seat 2: tffff2006 ($53.85 in chips) 
Seat 3: CAJUN890 ($100 in chips) 
Seat 4: matiko09 ($128.17 in chips) 
Seat 5: unequivocali ($101.74 in chips) 
Seat 6: Jimy Tiltman ($109.62 in chips) 
Seat 7: Zeeshka ($106.46 in chips) 
Seat 8: lumen21 ($122.38 in chips) 
Seat 9: WDW3 ($118.47 in chips) 
tffff2006: posts small blind $0.50
CAJUN890: posts big blind $1
*** HOLE CARDS ***
Dealt to matiko09 [9s 2c]
matiko09: folds 
unequivocali: folds 
Jimy Tiltman: folds 
Zeeshka: folds 
lumen21: folds 
WDW3: folds 
xHourglass: folds 
tffff2006: raises $1 to $2
CAJUN890: calls $1
*** FLOP *** [Kh Jd As]
tffff2006: bets $1.91
CAJUN890: raises $2.09 to $4
tffff2006: raises $3.50 to $7.50
CAJUN890: folds 
Uncalled bet ($3.50) returned to tffff2006
tffff2006 collected $11.46 from pot
tffff2006: doesn't show hand 
*** SUMMARY ***
Total pot $12 | Rake $0.54 
Board [Kh Jd As]
Seat 1: xHourglass (button) folded before Flop (didn't bet)
Seat 2: tffff2006 (small blind) collected ($11.46)
Seat 3: CAJUN890 (big blind) folded on the Flop
Seat 4: matiko09 folded before Flop (didn't bet)
Seat 5: unequivocali folded before Flop (didn't bet)
Seat 6: Jimy Tiltman folded before Flop (didn't bet)
Seat 7: Zeeshka folded before Flop (didn't bet)
Seat 8: lumen21 folded before Flop (didn't bet)
Seat 9: WDW3 folded before Flop (didn't bet)





PokerStars Hand #150798948561:  Hold'em No Limit ($1/$2 USD) - 2016/03/23 13:17:53 CET [2016/03/23 8:17:53 ET]
Table 'Herba II' 9-max Seat #8 is the button
Seat 1: matiko09 ($246.52 in chips) 
Seat 2: Moszes360 ($236.20 in chips) 
Seat 3: Daveguyaces ($203.92 in chips) 
Seat 4: DUkalisUA ($257.20 in chips) 
Seat 5: chippo boy ($198 in chips) 
Seat 6: WDW3 ($202.47 in chips) 
Seat 7: InsomniaRU ($200 in chips) 
Seat 8: myatiy 96 ($213.74 in chips) 
Seat 9: mrhighryza ($70.71 in chips) 
mrhighryza: posts small blind $1
matiko09: posts big blind $2
*** HOLE CARDS ***
Dealt to matiko09 [Qs 4h]
Moszes360: folds 
Daveguyaces: folds 
DUkalisUA: folds 
chippo boy: calls $2
WDW3: folds 
InsomniaRU: folds 
myatiy 96: folds 
mrhighryza: calls $1
matiko09: checks 
*** FLOP *** [Jc Ad 6h]
mrhighryza: checks 
matiko09: checks 
chippo boy: bets $4
mrhighryza: calls $4
matiko09: folds 
*** TURN *** [Jc Ad 6h] [2s]
mrhighryza: checks 
chippo boy: checks 
*** RIVER *** [Jc Ad 6h 2s] [8s]
mrhighryza: checks 
chippo boy: checks 
*** SHOW DOWN ***
mrhighryza: shows [5c 6c] (a pair of Sixes)
chippo boy: mucks hand 
mrhighryza collected $13.37 from pot
*** SUMMARY ***
Total pot $14 | Rake $0.63 
Board [Jc Ad 6h 2s 8s]
Seat 1: matiko09 (big blind) folded on the Flop
Seat 2: Moszes360 folded before Flop (didn't bet)
Seat 3: Daveguyaces folded before Flop (didn't bet)
Seat 4: DUkalisUA folded before Flop (didn't bet)
Seat 5: chippo boy mucked [Ks 5s]
Seat 6: WDW3 folded before Flop (didn't bet)
Seat 7: InsomniaRU folded before Flop (didn't bet)
Seat 8: myatiy 96 (button) folded before Flop (didn't bet)
Seat 9: mrhighryza (small blind) showed [5c 6c] and won ($13.37) with a pair of Sixes





PokerStars Hand #150798948581:  Hold'em No Limit ($0.25/$0.50 USD) - 2016/03/23 13:17:53 CET [2016/03/23 8:17:53 ET]
Table 'Pyrrhus' 9-max Seat #4 is the button
Seat 1: 1Maxx123 ($89.22 in chips) 
Seat 2: fandorin2005 ($50 in chips) 
Seat 4: Pokerlkl ($52 in chips) 
Seat 5: lengcunjuan ($28.97 in chips) 
Seat 6: whalldo ($111.61 in chips) 
Seat 7: matiko09 ($117.65 in chips) 
Seat 8: dndngod ($51.84 in chips) 
Seat 9: CvMCvMCvM ($50 in chips) 
lengcunjuan: posts small blind $0.25
whalldo: posts big blind $0.50
IvanUrgant: sits out 
*** HOLE CARDS ***
Dealt to matiko09 [5c 2d]
matiko09: folds 
dndngod: raises $1 to $1.50
CvMCvMCvM: folds 
1Maxx123: folds 
fandorin2005: folds 
Pokerlkl: calls $1.50
lengcunjuan: calls $1.25
whalldo: folds 
*** FLOP *** [Kc As 8h]
lengcunjuan: checks 
dndngod: checks 
Pokerlkl: checks 
*** TURN *** [Kc As 8h] [Ad]
lengcunjuan: checks 
dndngod: bets $2.50
Pokerlkl: folds 
Pokerlkl leaves the table
lengcunjuan: raises $2.50 to $5
dndngod: calls $2.50
*** RIVER *** [Kc As 8h Ad] [Ts]
GriffinBerg joins the table at seat #4 
lengcunjuan: bets $12
dndngod: calls $12
*** SHOW DOWN ***
lengcunjuan: shows [Td Ah] (a full house, Aces full of Tens)
dndngod: mucks hand 
lengcunjuan collected $37.24 from pot
*** SUMMARY ***
Total pot $39 | Rake $1.76 
Board [Kc As 8h Ad Ts]
Seat 1: 1Maxx123 folded before Flop (didn't bet)
Seat 2: fandorin2005 folded before Flop (didn't bet)
Seat 4: Pokerlkl (button) folded on the Turn
Seat 5: lengcunjuan (small blind) showed [Td Ah] and won ($37.24) with a full house, Aces full of Tens
Seat 6: whalldo (big blind) folded before Flop
Seat 7: matiko09 folded before Flop (didn't bet)
Seat 8: dndngod mucked [Qh Kd]
Seat 9: CvMCvMCvM folded before Flop (didn't bet)





PokerStars Hand #150798954009:  Hold'em No Limit ($0.50/$1.00 USD) - 2016/03/23 13:18:06 CET [2016/03/23 8:18:06 ET]
Table 'Oljato' 9-max Seat #2 is the button
Seat 1: Pearl Jam87 ($100 in chips) 
Seat 2: roman134679 ($87.86 in chips) 
Seat 3: DUkalisUA ($100 in chips) 
Seat 4: Pvsx. ($102.28 in chips) 
Seat 5: ryo728 ($77.69 in chips) 
Seat 6: WDW3 ($123.50 in chips) 
Seat 7: matiko09 ($164.23 in chips) 
Seat 8: Zeeshka ($356.14 in chips) 
Seat 9: Jimy Tiltman ($100 in chips) 
DUkalisUA: posts small blind $0.50
Pvsx.: posts big blind $1
*** HOLE CARDS ***
Dealt to matiko09 [2d 3d]
ryo728: raises $1 to $2
WDW3: folds 
matiko09: folds 
Zeeshka: folds 
Jimy Tiltman: folds 
Pearl Jam87: folds 
roman134679: folds 
DUkalisUA: folds 
Pvsx.: folds 
Uncalled bet ($1) returned to ryo728
ryo728 collected $2.50 from pot
ryo728: doesn't show hand 
*** SUMMARY ***
Total pot $2.50 | Rake $0 
Seat 1: Pearl Jam87 folded before Flop (didn't bet)
Seat 2: roman134679 (button) folded before Flop (didn't bet)
Seat 3: DUkalisUA (small blind) folded before Flop
Seat 4: Pvsx. (big blind) folded before Flop
Seat 5: ryo728 collected ($2.50)
Seat 6: WDW3 folded before Flop (didn't bet)
Seat 7: matiko09 folded before Flop (didn't bet)
Seat 8: Zeeshka folded before Flop (didn't bet)
Seat 9: Jimy Tiltman folded before Flop (didn't bet)





PokerStars Hand #150798959335:  Hold'em No Limit ($1/$2 USD) - 2016/03/23 13:18:18 CET [2016/03/23 8:18:18 ET]
Table 'Kypria II' 9-max Seat #4 is the button
Seat 1: geldwolfje ($266.62 in chips) 
Seat 2: coinflip_si ($200 in chips) 
Seat 3: seouljam ($110 in chips) 
Seat 4: nailz83 ($70.20 in chips) 
Seat 5: Charity86 ($133.54 in chips) 
Seat 6: matiko09 ($254.57 in chips) 
Seat 7: ldwin8 ($371.88 in chips) 
Seat 8: Fish4trips ($300.52 in chips) 
Seat 9: WDW3 ($203 in chips) 
Charity86: posts small blind $1
matiko09: posts big blind $2
seouljam: posts small & big blinds $3
*** HOLE CARDS ***
Dealt to matiko09 [4c 8d]
ldwin8: raises $4 to $6
Fish4trips: folds 
WDW3: folds 
geldwolfje: folds 
coinflip_si: folds 
seouljam: calls $4
nailz83: folds 
Charity86 is disconnected 
Charity86 has timed out while disconnected
Charity86: folds 
matiko09: folds 
*** FLOP *** [5d Qh 8s]
ldwin8: bets $10
seouljam: calls $10
*** TURN *** [5d Qh 8s] [Ks]
ldwin8: checks 
seouljam: bets $13
ldwin8: calls $13
*** RIVER *** [5d Qh 8s Ks] [Ad]
ldwin8: bets $36
seouljam: folds 
Uncalled bet ($36) returned to ldwin8
ldwin8 collected $59.21 from pot
*** SUMMARY ***
Total pot $62 | Rake $2.79 
Board [5d Qh 8s Ks Ad]
Seat 1: geldwolfje folded before Flop (didn't bet)
Seat 2: coinflip_si folded before Flop (didn't bet)
Seat 3: seouljam folded on the River
Seat 4: nailz83 (button) folded before Flop (didn't bet)
Seat 5: Charity86 (small blind) folded before Flop
Seat 6: matiko09 (big blind) folded before Flop
Seat 7: ldwin8 collected ($59.21)
Seat 8: Fish4trips folded before Flop (didn't bet)
Seat 9: WDW3 folded before Flop (didn't bet)





PokerStars Hand #150798964443:  Hold'em No Limit ($1/$2 USD) - 2016/03/23 13:18:30 CET [2016/03/23 8:18:30 ET]
Table 'Kiess' 9-max Seat #1 is the button
Seat 1: ldwin8 ($218.11 in chips) 
Seat 2: DUkalisUA ($512.08 in chips) 
Seat 3: The_red_area ($200 in chips) 
Seat 5: chippo boy ($367.20 in chips) 
Seat 6: matiko09 ($200 in chips) 
Seat 7: InsomniaRU ($320.89 in chips) 
Seat 8: WDW3 ($413.20 in chips) 
Seat 9: Fish4trips ($202 in chips) 
DUkalisUA: posts small blind $1
The_red_area: posts big blind $2
*** HOLE CARDS ***
Dealt to matiko09 [8d Ad]
chippo boy: folds 
matiko09: folds 
InsomniaRU: folds 
WDW3: folds 
Fish4trips: folds 
ldwin8: folds 
DUkalisUA: folds 
Uncalled bet ($1) returned to The_red_area
The_red_area collected $2 from pot
The_red_area: doesn't show hand 
*** SUMMARY ***
Total pot $2 | Rake $0 
Seat 1: ldwin8 (button) folded before Flop (didn't bet)
Seat 2: DUkalisUA (small blind) folded before Flop
Seat 3: The_red_area (big blind) collected ($2)
Seat 5: chippo boy folded before Flop (didn't bet)
Seat 6: matiko09 folded before Flop (didn't bet)
Seat 7: InsomniaRU folded before Flop (didn't bet)
Seat 8: WDW3 folded before Flop (didn't bet)
Seat 9: Fish4trips folded before Flop (didn't bet)





PokerStars Hand #150798970475:  Hold'em No Limit ($0.50/$1.00 USD) - 2016/03/23 13:18:44 CET [2016/03/23 8:18:44 ET]
Table 'Oljato' 9-max Seat #3 is the button
Seat 1: Pearl Jam87 ($100 in chips) 
Seat 2: roman134679 ($87.86 in chips) 
Seat 3: DUkalisUA ($100 in chips) 
Seat 4: Pvsx. ($101.28 in chips) 
Seat 5: ryo728 ($79.19 in chips) 
Seat 6: WDW3 ($123.50 in chips) 
Seat 7: matiko09 ($164.23 in chips) 
Seat 8: Zeeshka ($356.14 in chips) 
Seat 9: Jimy Tiltman ($100 in chips) 
Pvsx.: posts small blind $0.50
ryo728: posts big blind $1
*** HOLE CARDS ***
Dealt to matiko09 [Jc Kd]
WDW3: folds 
matiko09: folds 
Zeeshka: folds 
Jimy Tiltman: raises $2 to $3
Pearl Jam87: raises $6 to $9
roman134679: folds 
DUkalisUA: folds 
Pvsx.: folds 
ryo728: folds 
Jimy Tiltman: calls $6
*** FLOP *** [Ts Jd Ah]
Jimy Tiltman: checks 
Pearl Jam87: bets $15
Jimy Tiltman: calls $15
*** TURN *** [Ts Jd Ah] [5c]
Jimy Tiltman: checks 
Pearl Jam87: bets $37
Jimy Tiltman: raises $39 to $76 and is all-in
Pearl Jam87: calls $39 and is all-in
*** RIVER *** [Ts Jd Ah 5c] [3s]
*** SHOW DOWN ***
Jimy Tiltman: shows [As Kh] (a pair of Aces)
Pearl Jam87: shows [Js Jh] (three of a kind, Jacks)
Pearl Jam87 collected $198.70 from pot
*** SUMMARY ***
Total pot $201.50 | Rake $2.80 
Board [Ts Jd Ah 5c 3s]
Seat 1: Pearl Jam87 showed [Js Jh] and won ($198.70) with three of a kind, Jacks
Seat 2: roman134679 folded before Flop (didn't bet)
Seat 3: DUkalisUA (button) folded before Flop (didn't bet)
Seat 4: Pvsx. (small blind) folded before Flop
Seat 5: ryo728 (big blind) folded before Flop
Seat 6: WDW3 folded before Flop (didn't bet)
Seat 7: matiko09 folded before Flop (didn't bet)
Seat 8: Zeeshka folded before Flop (didn't bet)
Seat 9: Jimy Tiltman showed [As Kh] and lost with a pair of Aces





PokerStars Hand #150798972628:  Hold'em No Limit ($0.50/$1.00 USD) - 2016/03/23 13:18:49 CET [2016/03/23 8:18:49 ET]
Table 'Atlantis' 9-max Seat #2 is the button
Seat 1: xHourglass ($178.07 in chips) 
Seat 2: tffff2006 ($59.31 in chips) 
Seat 3: CAJUN890 ($94 in chips) 
Seat 4: matiko09 ($128.17 in chips) 
Seat 5: unequivocali ($101.74 in chips) 
Seat 6: Jimy Tiltman ($109.62 in chips) 
Seat 7: Zeeshka ($106.46 in chips) 
Seat 8: lumen21 ($122.38 in chips) 
Seat 9: WDW3 ($118.47 in chips) 
CAJUN890: posts small blind $0.50
matiko09: posts big blind $1
*** HOLE CARDS ***
Dealt to matiko09 [6h As]
unequivocali: calls $1
Jimy Tiltman: raises $2.50 to $3.50
Zeeshka: folds 
lumen21: folds 
WDW3: folds 
xHourglass: folds 
tffff2006: folds 
CAJUN890: folds 
matiko09: folds 
unequivocali: calls $2.50
*** FLOP *** [4h 3s 9d]
unequivocali: checks 
Jimy Tiltman: checks 
*** TURN *** [4h 3s 9d] [8c]
unequivocali: checks 
Jimy Tiltman: checks 
*** RIVER *** [4h 3s 9d 8c] [2d]
unequivocali: checks 
Jimy Tiltman: checks 
*** SHOW DOWN ***
unequivocali: shows [Td Kh] (high card King)
Jimy Tiltman: shows [Ad 7d] (high card Ace)
Jimy Tiltman collected $8.12 from pot
*** SUMMARY ***
Total pot $8.50 | Rake $0.38 
Board [4h 3s 9d 8c 2d]
Seat 1: xHourglass folded before Flop (didn't bet)
Seat 2: tffff2006 (button) folded before Flop (didn't bet)
Seat 3: CAJUN890 (small blind) folded before Flop
Seat 4: matiko09 (big blind) folded before Flop
Seat 5: unequivocali showed [Td Kh] and lost with high card King
Seat 6: Jimy Tiltman showed [Ad 7d] and won ($8.12) with high card Ace
Seat 7: Zeeshka folded before Flop (didn't bet)
Seat 8: lumen21 folded before Flop (didn't bet)
Seat 9: WDW3 folded before Flop (didn't bet)





PokerStars Hand #150798974612:  Hold'em No Limit ($1/$2 USD) - 2016/03/23 13:18:53 CET [2016/03/23 8:18:53 ET]
Table 'Kiess' 9-max Seat #2 is the button
Seat 1: ldwin8 ($218.11 in chips) 
Seat 2: DUkalisUA ($511.08 in chips) 
Seat 3: The_red_area ($201 in chips) 
Seat 5: chippo boy ($367.20 in chips) 
Seat 6: matiko09 ($200 in chips) 
Seat 7: InsomniaRU ($320.89 in chips) 
Seat 8: WDW3 ($413.20 in chips) 
Seat 9: Fish4trips ($202 in chips) 
The_red_area: posts small blind $1
chippo boy: posts big blind $2
*** HOLE CARDS ***
Dealt to matiko09 [Kh Tc]
matiko09: folds 
InsomniaRU: folds 
WDW3: folds 
Fish4trips: folds 
ldwin8: folds 
DUkalisUA: raises $2 to $4
The_red_area: folds 
chippo boy: calls $2
*** FLOP *** [7d Jd Ts]
chippo boy: checks 
DUkalisUA: bets $5.67
chippo boy: calls $5.67
*** TURN *** [7d Jd Ts] [5c]
chippo boy: checks 
DUkalisUA: bets $13
chippo boy: calls $13
*** RIVER *** [7d Jd Ts 5c] [9c]
chippo boy: checks 
DUkalisUA: checks 
*** SHOW DOWN ***
chippo boy: shows [7c 4d] (a pair of Sevens)
DUkalisUA: shows [Js 3s] (a pair of Jacks)
DUkalisUA collected $44.25 from pot
*** SUMMARY ***
Total pot $46.34 | Rake $2.09 
Board [7d Jd Ts 5c 9c]
Seat 1: ldwin8 folded before Flop (didn't bet)
Seat 2: DUkalisUA (button) showed [Js 3s] and won ($44.25) with a pair of Jacks
Seat 3: The_red_area (small blind) folded before Flop
Seat 5: chippo boy (big blind) showed [7c 4d] and lost with a pair of Sevens
Seat 6: matiko09 folded before Flop (didn't bet)
Seat 7: InsomniaRU folded before Flop (didn't bet)
Seat 8: WDW3 folded before Flop (didn't bet)
Seat 9: Fish4trips folded before Flop (didn't bet)





PokerStars Hand #150798976151:  Hold'em No Limit ($1/$2 USD) - 2016/03/23 13:18:57 CET [2016/03/23 8:18:57 ET]
Table 'Herba II' 9-max Seat #9 is the button
Seat 1: matiko09 ($244.52 in chips) 
Seat 2: Moszes360 ($236.20 in chips) 
Seat 3: Daveguyaces ($203.92 in chips) 
Seat 4: DUkalisUA ($257.20 in chips) 
Seat 5: chippo boy ($192 in chips) 
Seat 6: WDW3 ($202.47 in chips) 
Seat 7: InsomniaRU ($200 in chips) 
Seat 8: myatiy 96 ($213.74 in chips) 
Seat 9: mrhighryza ($78.08 in chips) 
matiko09: posts small blind $1
Moszes360: posts big blind $2
*** HOLE CARDS ***
Dealt to matiko09 [4s Th]
Daveguyaces: calls $2
DUkalisUA: folds 
chippo boy: folds 
WDW3: folds 
InsomniaRU: folds 
myatiy 96: raises $5 to $7
mrhighryza: folds 
matiko09: folds 
Moszes360: folds 
Daveguyaces: calls $5
*** FLOP *** [6h Ts 9d]
Daveguyaces: checks 
myatiy 96: checks 
*** TURN *** [6h Ts 9d] [Ad]
Daveguyaces: bets $16
myatiy 96: calls $16
*** RIVER *** [6h Ts 9d Ad] [9s]
Daveguyaces: bets $46
myatiy 96: calls $46
*** SHOW DOWN ***
Daveguyaces: shows [2s As] (two pair, Aces and Nines)
myatiy 96: shows [4c Ac] (two pair, Aces and Nines)
Daveguyaces collected $69.10 from pot
myatiy 96 collected $69.10 from pot
*** SUMMARY ***
Total pot $141 | Rake $2.80 
Board [6h Ts 9d Ad 9s]
Seat 1: matiko09 (small blind) folded before Flop
Seat 2: Moszes360 (big blind) folded before Flop
Seat 3: Daveguyaces showed [2s As] and won ($69.10) with two pair, Aces and Nines
Seat 4: DUkalisUA folded before Flop (didn't bet)
Seat 5: chippo boy folded before Flop (didn't bet)
Seat 6: WDW3 folded before Flop (didn't bet)
Seat 7: InsomniaRU folded before Flop (didn't bet)
Seat 8: myatiy 96 showed [4c Ac] and won ($69.10) with two pair, Aces and Nines
Seat 9: mrhighryza (button) folded before Flop (didn't bet)





PokerStars Hand #150798980486:  Hold'em No Limit ($0.25/$0.50 USD) - 2016/03/23 13:19:06 CET [2016/03/23 8:19:06 ET]
Table 'Pyrrhus' 9-max Seat #5 is the button
Seat 1: 1Maxx123 ($89.22 in chips) 
Seat 2: fandorin2005 ($50 in chips) 
Seat 5: lengcunjuan ($47.71 in chips) 
Seat 6: whalldo ($111.11 in chips) 
Seat 7: matiko09 ($117.65 in chips) 
Seat 8: dndngod ($50 in chips) 
Seat 9: CvMCvMCvM ($50 in chips) 
whalldo: posts small blind $0.25
matiko09: posts big blind $0.50
IvanUrgant: sits out 
GriffinBerg: sits out 
*** HOLE CARDS ***
Dealt to matiko09 [2s Jh]
dndngod: folds 
CvMCvMCvM: raises $0.57 to $1.07
1Maxx123: folds 
fandorin2005: folds 
lengcunjuan: folds 
whalldo: folds 
matiko09: folds 
Uncalled bet ($0.57) returned to CvMCvMCvM
CvMCvMCvM collected $1.25 from pot
CvMCvMCvM: doesn't show hand 
*** SUMMARY ***
Total pot $1.25 | Rake $0 
Seat 1: 1Maxx123 folded before Flop (didn't bet)
Seat 2: fandorin2005 folded before Flop (didn't bet)
Seat 5: lengcunjuan (button) folded before Flop (didn't bet)
Seat 6: whalldo (small blind) folded before Flop
Seat 7: matiko09 (big blind) folded before Flop
Seat 8: dndngod folded before Flop (didn't bet)
Seat 9: CvMCvMCvM collected ($1.25)





PokerStars Hand #150798989513:  Hold'em No Limit ($0.25/$0.50 USD) - 2016/03/23 13:19:26 CET [2016/03/23 8:19:26 ET]
Table 'Pyrrhus' 9-max Seat #6 is the button
Seat 1: 1Maxx123 ($89.22 in chips) 
Seat 2: fandorin2005 ($50 in chips) 
Seat 5: lengcunjuan ($47.71 in chips) 
Seat 6: whalldo ($110.86 in chips) 
Seat 7: matiko09 ($117.15 in chips) 
Seat 8: dndngod ($50 in chips) 
Seat 9: CvMCvMCvM ($50.75 in chips) 
matiko09: posts small blind $0.25
dndngod: posts big blind $0.50
IvanUrgant: sits out 
GriffinBerg: sits out 
*** HOLE CARDS ***
Dealt to matiko09 [3d 8c]
CvMCvMCvM: raises $0.57 to $1.07
1Maxx123: folds 
fandorin2005: folds 
lengcunjuan: raises $2.43 to $3.50
whalldo: folds 
matiko09: folds 
dndngod: folds 
CvMCvMCvM: calls $2.43
*** FLOP *** [9c Tc 8d]
CvMCvMCvM: checks 
lengcunjuan: bets $3.70
CvMCvMCvM: raises $7.30 to $11
lengcunjuan: calls $7.30
*** TURN *** [9c Tc 8d] [3c]
CvMCvMCvM: bets $36.25 and is all-in
lengcunjuan: folds 
Uncalled bet ($36.25) returned to CvMCvMCvM
CvMCvMCvM collected $28.41 from pot
CvMCvMCvM: doesn't show hand 
*** SUMMARY ***
Total pot $29.75 | Rake $1.34 
Board [9c Tc 8d 3c]
Seat 1: 1Maxx123 folded before Flop (didn't bet)
Seat 2: fandorin2005 folded before Flop (didn't bet)
Seat 5: lengcunjuan folded on the Turn
Seat 6: whalldo (button) folded before Flop (didn't bet)
Seat 7: matiko09 (small blind) folded before Flop
Seat 8: dndngod (big blind) folded before Flop
Seat 9: CvMCvMCvM collected ($28.41)





PokerStars Hand #150799001895:  Hold'em No Limit ($1/$2 USD) - 2016/03/23 13:19:52 CET [2016/03/23 8:19:52 ET]
Table 'Kiess' 9-max Seat #3 is the button
Seat 1: ldwin8 ($218.11 in chips) 
Seat 2: DUkalisUA ($532.66 in chips) 
Seat 3: The_red_area ($200 in chips) 
Seat 5: chippo boy ($344.53 in chips) 
Seat 6: matiko09 ($200 in chips) 
Seat 7: InsomniaRU ($320.89 in chips) 
Seat 8: WDW3 ($413.20 in chips) 
Seat 9: Fish4trips ($202 in chips) 
chippo boy: posts small blind $1
matiko09: posts big blind $2
*** HOLE CARDS ***
Dealt to matiko09 [4c 4h]
InsomniaRU: folds 
WDW3: raises $3.60 to $5.60
Fish4trips: folds 
ldwin8: folds 
DUkalisUA: folds 
The_red_area: folds 
chippo boy: calls $4.60
matiko09: calls $3.60
*** FLOP *** [Ts 4s 7h]
chippo boy: checks 
matiko09: bets $10
WDW3: folds 
chippo boy: folds 
Uncalled bet ($10) returned to matiko09
matiko09 collected $16.04 from pot
matiko09: doesn't show hand 
*** SUMMARY ***
Total pot $16.80 | Rake $0.76 
Board [Ts 4s 7h]
Seat 1: ldwin8 folded before Flop (didn't bet)
Seat 2: DUkalisUA folded before Flop (didn't bet)
Seat 3: The_red_area (button) folded before Flop (didn't bet)
Seat 5: chippo boy (small blind) folded on the Flop
Seat 6: matiko09 (big blind) collected ($16.04)
Seat 7: InsomniaRU folded before Flop (didn't bet)
Seat 8: WDW3 folded on the Flop
Seat 9: Fish4trips folded before Flop (didn't bet)





PokerStars Hand #150799008030:  Hold'em No Limit ($0.50/$1.00 USD) - 2016/03/23 13:20:05 CET [2016/03/23 8:20:05 ET]
Table 'Oljato' 9-max Seat #4 is the button
Seat 1: Pearl Jam87 ($198.70 in chips) 
Seat 2: roman134679 ($87.86 in chips) 
Seat 3: DUkalisUA ($100 in chips) 
Seat 4: Pvsx. ($100.78 in chips) 
Seat 5: ryo728 ($78.19 in chips) 
Seat 6: WDW3 ($123.50 in chips) 
Seat 7: matiko09 ($164.23 in chips) 
Seat 8: Zeeshka ($356.14 in chips) 
Seat 9: Jimy Tiltman ($100 in chips) 
ryo728: posts small blind $0.50
WDW3: posts big blind $1
*** HOLE CARDS ***
Dealt to matiko09 [2c 6c]
matiko09: folds 
Zeeshka: folds 
Jimy Tiltman: folds 
Pearl Jam87: raises $2 to $3
roman134679: folds 
DUkalisUA: folds 
Pvsx.: folds 
ryo728: calls $2.50
WDW3: calls $2
*** FLOP *** [Jh Ah 9h]
ryo728: checks 
WDW3: checks 
Pearl Jam87: checks 
*** TURN *** [Jh Ah 9h] [9c]
ryo728: checks 
WDW3: bets $6.50
Pearl Jam87: calls $6.50
ryo728: folds 
*** RIVER *** [Jh Ah 9h 9c] [Ad]
WDW3: checks 
Pearl Jam87: checks 
*** SHOW DOWN ***
WDW3: shows [8s 9s] (a full house, Nines full of Aces)
Pearl Jam87: mucks hand 
WDW3 collected $21.01 from pot
*** SUMMARY ***
Total pot $22 | Rake $0.99 
Board [Jh Ah 9h 9c Ad]
Seat 1: Pearl Jam87 mucked [Js Qh]
Seat 2: roman134679 folded before Flop (didn't bet)
Seat 3: DUkalisUA folded before Flop (didn't bet)
Seat 4: Pvsx. (button) folded before Flop (didn't bet)
Seat 5: ryo728 (small blind) folded on the Turn
Seat 6: WDW3 (big blind) showed [8s 9s] and won ($21.01) with a full house, Nines full of Aces
Seat 7: matiko09 folded before Flop (didn't bet)
Seat 8: Zeeshka folded before Flop (didn't bet)
Seat 9: Jimy Tiltman folded before Flop (didn't bet)





PokerStars Hand #150799008749:  Hold'em No Limit ($0.50/$1.00 USD) - 2016/03/23 13:20:07 CET [2016/03/23 8:20:07 ET]
Table 'Atlantis' 9-max Seat #3 is the button
Seat 1: xHourglass ($178.07 in chips) 
Seat 2: tffff2006 ($59.31 in chips) 
Seat 3: CAJUN890 ($93.50 in chips) 
Seat 4: matiko09 ($127.17 in chips) 
Seat 6: Jimy Tiltman ($114.24 in chips) 
Seat 7: Zeeshka ($106.46 in chips) 
Seat 8: lumen21 ($122.38 in chips) 
Seat 9: WDW3 ($118.47 in chips) 
matiko09: posts small blind $0.50
unequivocali: is sitting out 
Jimy Tiltman: posts big blind $1
*** HOLE CARDS ***
Dealt to matiko09 [Ac 2s]
Zeeshka: folds 
unequivocali leaves the table
lumen21: folds 
Pvsx. joins the table at seat #5 
WDW3: folds 
xHourglass: folds 
tffff2006: folds 
CAJUN890: raises $2 to $3
matiko09: folds 
Jimy Tiltman: folds 
Uncalled bet ($2) returned to CAJUN890
CAJUN890 collected $2.50 from pot
CAJUN890: doesn't show hand 
*** SUMMARY ***
Total pot $2.50 | Rake $0 
Seat 1: xHourglass folded before Flop (didn't bet)
Seat 2: tffff2006 folded before Flop (didn't bet)
Seat 3: CAJUN890 (button) collected ($2.50)
Seat 4: matiko09 (small blind) folded before Flop
Seat 6: Jimy Tiltman (big blind) folded before Flop
Seat 7: Zeeshka folded before Flop (didn't bet)
Seat 8: lumen21 folded before Flop (didn't bet)
Seat 9: WDW3 folded before Flop (didn't bet)





PokerStars Hand #150799017608:  Hold'em No Limit ($0.50/$1.00 USD) - 2016/03/23 13:20:26 CET [2016/03/23 8:20:26 ET]
Table 'Smiley' 9-max Seat #1 is the button
Seat 1: WDW3 ($102.35 in chips) 
Seat 2: Jimy Tiltman ($100 in chips) 
Seat 3: matiko09 ($130.06 in chips) 
Seat 4: Zeeshka ($100 in chips) 
Seat 5: DUkalisUA ($100 in chips) 
Seat 6: blackmont111 ($67.70 in chips) 
Seat 7: drosan ($45.62 in chips) 
Seat 8: RICKA16 ($110.56 in chips) 
Seat 9: morosun ($109.38 in chips) 
Jimy Tiltman: posts small blind $0.50
matiko09: posts big blind $1
*** HOLE CARDS ***
Dealt to matiko09 [3s 4h]
Zeeshka: folds 
DUkalisUA: folds 
blackmont111: folds 
drosan: raises $2 to $3
RICKA16: folds 
morosun: folds 
WDW3: folds 
Jimy Tiltman: raises $5 to $8
matiko09: folds 
drosan: folds 
Uncalled bet ($5) returned to Jimy Tiltman
Jimy Tiltman collected $7 from pot
Jimy Tiltman: doesn't show hand 
*** SUMMARY ***
Total pot $7 | Rake $0 
Seat 1: WDW3 (button) folded before Flop (didn't bet)
Seat 2: Jimy Tiltman (small blind) collected ($7)
Seat 3: matiko09 (big blind) folded before Flop
Seat 4: Zeeshka folded before Flop (didn't bet)
Seat 5: DUkalisUA folded before Flop (didn't bet)
Seat 6: blackmont111 folded before Flop (didn't bet)
Seat 7: drosan folded before Flop
Seat 8: RICKA16 folded before Flop (didn't bet)
Seat 9: morosun folded before Flop (didn't bet)





PokerStars Hand #150799020490:  Hold'em No Limit (€0.25/€0.50 EUR) - 2016/03/23 13:20:32 CET [2016/03/23 8:20:32 ET]
Table 'Hesperia II' 9-max Seat #5 is the button
Seat 5: d-master850 (€25.91 in chips) 
Seat 6: CvMCvMCvM (€50.25 in chips) 
Seat 7: matiko09 (€50 in chips) 
CvMCvMCvM: posts small blind €0.25
matiko09: posts big blind €0.50
*** HOLE CARDS ***
Dealt to matiko09 [4d 7d]
d-master850: raises €0.50 to €1
CvMCvMCvM: folds 
matiko09: folds 
Uncalled bet (€0.50) returned to d-master850
d-master850 collected €1.25 from pot
d-master850: doesn't show hand 
*** SUMMARY ***
Total pot €1.25 | Rake €0 
Seat 5: d-master850 (button) collected (€1.25)
Seat 6: CvMCvMCvM (small blind) folded before Flop
Seat 7: matiko09 (big blind) folded before Flop





PokerStars Hand #150799021035:  Hold'em No Limit ($0.50/$1.00 USD) - 2016/03/23 13:20:33 CET [2016/03/23 8:20:33 ET]
Table 'Atlantis' 9-max Seat #4 is the button
Seat 1: xHourglass ($178.07 in chips) 
Seat 2: tffff2006 ($59.31 in chips) 
Seat 3: CAJUN890 ($95 in chips) 
Seat 4: matiko09 ($126.67 in chips) 
Seat 6: Jimy Tiltman ($113.24 in chips) 
Seat 7: Zeeshka ($106.46 in chips) 
Seat 8: lumen21 ($122.38 in chips) 
Seat 9: WDW3 ($118.47 in chips) 
Pvsx. will be allowed to play after the button
Jimy Tiltman: posts small blind $0.50
Zeeshka: posts big blind $1
*** HOLE CARDS ***
Dealt to matiko09 [8h Tc]
lumen21: folds 
WDW3: folds 
xHourglass: folds 
tffff2006: calls $1
CAJUN890: calls $1
matiko09: folds 
Jimy Tiltman: folds 
Zeeshka: raises $3.50 to $4.50
tffff2006: calls $3.50
CAJUN890: calls $3.50
*** FLOP *** [Th Ah 5h]
Zeeshka: checks 
tffff2006: checks 
CAJUN890: bets $6
Zeeshka: calls $6
tffff2006: folds 
*** TURN *** [Th Ah 5h] [7c]
Zeeshka: checks 
CAJUN890: bets $15
Zeeshka: folds 
Uncalled bet ($15) returned to CAJUN890
CAJUN890 collected $24.83 from pot
CAJUN890: doesn't show hand 
*** SUMMARY ***
Total pot $26 | Rake $1.17 
Board [Th Ah 5h 7c]
Seat 1: xHourglass folded before Flop (didn't bet)
Seat 2: tffff2006 folded on the Flop
Seat 3: CAJUN890 collected ($24.83)
Seat 4: matiko09 (button) folded before Flop (didn't bet)
Seat 6: Jimy Tiltman (small blind) folded before Flop
Seat 7: Zeeshka (big blind) folded on the Turn
Seat 8: lumen21 folded before Flop (didn't bet)
Seat 9: WDW3 folded before Flop (didn't bet)





PokerStars Hand #150799023007:  Hold'em No Limit ($1/$2 USD) - 2016/03/23 13:20:37 CET [2016/03/23 8:20:37 ET]
Table 'Kiess' 9-max Seat #5 is the button
Seat 1: ldwin8 ($218.11 in chips) 
Seat 2: DUkalisUA ($532.66 in chips) 
Seat 3: The_red_area ($200 in chips) 
Seat 5: chippo boy ($338.93 in chips) 
Seat 6: matiko09 ($210.44 in chips) 
Seat 7: InsomniaRU ($320.89 in chips) 
Seat 8: WDW3 ($407.60 in chips) 
Seat 9: Fish4trips ($202 in chips) 
matiko09: posts small blind $1
InsomniaRU: posts big blind $2
*** HOLE CARDS ***
Dealt to matiko09 [7s 2s]
WDW3: folds 
Fish4trips: folds 
darren1031 leaves the table
Moszes360 joins the table at seat #4 
ldwin8: folds 
DUkalisUA: folds 
The_red_area: folds 
chippo boy: calls $2
matiko09: folds 
InsomniaRU: raises $6 to $8
chippo boy: calls $6
*** FLOP *** [4c 9d 4s]
InsomniaRU: bets $12.99
chippo boy: folds 
Uncalled bet ($12.99) returned to InsomniaRU
InsomniaRU collected $16.24 from pot
InsomniaRU: doesn't show hand 
*** SUMMARY ***
Total pot $17 | Rake $0.76 
Board [4c 9d 4s]
Seat 1: ldwin8 folded before Flop (didn't bet)
Seat 2: DUkalisUA folded before Flop (didn't bet)
Seat 3: The_red_area folded before Flop (didn't bet)
Seat 5: chippo boy (button) folded on the Flop
Seat 6: matiko09 (small blind) folded before Flop
Seat 7: InsomniaRU (big blind) collected ($16.24)
Seat 8: WDW3 folded before Flop (didn't bet)
Seat 9: Fish4trips folded before Flop (didn't bet)





PokerStars Hand #150799027447:  Hold'em No Limit (€0.25/€0.50 EUR) - 2016/03/23 13:20:46 CET [2016/03/23 8:20:46 ET]
Table 'Hesperia II' 9-max Seat #6 is the button
Seat 5: d-master850 (€26.66 in chips) 
Seat 6: CvMCvMCvM (€50 in chips) 
Seat 7: matiko09 (€50 in chips) 
matiko09: posts small blind €0.25
d-master850: posts big blind €0.50
*** HOLE CARDS ***
Dealt to matiko09 [Js 4s]
CvMCvMCvM: raises €0.76 to €1.26
matiko09: folds 
d-master850: folds 
Uncalled bet (€0.76) returned to CvMCvMCvM
CvMCvMCvM collected €1.25 from pot
CvMCvMCvM: doesn't show hand 
Zelenis joins the table at seat #4 
*** SUMMARY ***
Total pot €1.25 | Rake €0 
Seat 5: d-master850 (big blind) folded before Flop
Seat 6: CvMCvMCvM (button) collected (€1.25)
Seat 7: matiko09 (small blind) folded before Flop





PokerStars Hand #150799031289:  Hold'em No Limit ($0.50/$1.00 USD) - 2016/03/23 13:20:54 CET [2016/03/23 8:20:54 ET]
Table 'Smiley' 9-max Seat #2 is the button
Seat 1: WDW3 ($102.35 in chips) 
Seat 2: Jimy Tiltman ($104 in chips) 
Seat 3: matiko09 ($129.06 in chips) 
Seat 4: Zeeshka ($100 in chips) 
Seat 5: DUkalisUA ($100 in chips) 
Seat 6: blackmont111 ($67.70 in chips) 
Seat 7: drosan ($42.62 in chips) 
Seat 8: RICKA16 ($110.56 in chips) 
Seat 9: morosun ($109.38 in chips) 
matiko09: posts small blind $0.50
Zeeshka: posts big blind $1
*** HOLE CARDS ***
Dealt to matiko09 [7h Qc]
DUkalisUA: folds 
blackmont111: folds 
drosan: folds 
RICKA16: folds 
morosun: folds 
WDW3: folds 
Jimy Tiltman: folds 
matiko09: folds 
Uncalled bet ($0.50) returned to Zeeshka
Zeeshka collected $1 from pot
Zeeshka: doesn't show hand 
*** SUMMARY ***
Total pot $1 | Rake $0 
Seat 1: WDW3 folded before Flop (didn't bet)
Seat 2: Jimy Tiltman (button) folded before Flop (didn't bet)
Seat 3: matiko09 (small blind) folded before Flop
Seat 4: Zeeshka (big blind) collected ($1)
Seat 5: DUkalisUA folded before Flop (didn't bet)
Seat 6: blackmont111 folded before Flop (didn't bet)
Seat 7: drosan folded before Flop (didn't bet)
Seat 8: RICKA16 folded before Flop (didn't bet)
Seat 9: morosun folded before Flop (didn't bet)





PokerStars Hand #150799031783:  Hold'em No Limit (€0.25/€0.50 EUR) - 2016/03/23 13:20:55 CET [2016/03/23 8:20:55 ET]
Table 'Hesperia II' 9-max Seat #7 is the button
Seat 5: d-master850 (€26.16 in chips) 
Seat 6: CvMCvMCvM (€50.75 in chips) 
Seat 7: matiko09 (€50 in chips) 
Zelenis will be allowed to play after the button
d-master850: posts small blind €0.25
CvMCvMCvM: posts big blind €0.50
*** HOLE CARDS ***
Dealt to matiko09 [2c 5c]
matiko09: folds 
d-master850: folds 
Uncalled bet (€0.25) returned to CvMCvMCvM
CvMCvMCvM collected €0.50 from pot
CvMCvMCvM: doesn't show hand 
*** SUMMARY ***
Total pot €0.50 | Rake €0 
Seat 5: d-master850 (small blind) folded before Flop
Seat 6: CvMCvMCvM (big blind) collected (€0.50)
Seat 7: matiko09 (button) folded before Flop (didn't bet)





PokerStars Hand #150799031952:  Hold'em No Limit ($1/$2 USD) - 2016/03/23 13:20:55 CET [2016/03/23 8:20:55 ET]
Table 'Herba II' 9-max Seat #1 is the button
Seat 1: matiko09 ($243.52 in chips) 
Seat 2: Moszes360 ($234.20 in chips) 
Seat 3: Daveguyaces ($204.02 in chips) 
Seat 4: DUkalisUA ($257.20 in chips) 
Seat 5: chippo boy ($200 in chips) 
Seat 6: WDW3 ($202.47 in chips) 
Seat 7: InsomniaRU ($200 in chips) 
Seat 8: myatiy 96 ($213.84 in chips) 
Seat 9: mrhighryza ($78.08 in chips) 
Moszes360: posts small blind $1
Daveguyaces: posts big blind $2
*** HOLE CARDS ***
Dealt to matiko09 [7d 5d]
DUkalisUA: folds 
chippo boy: folds 
Daveguyaces said, "nice call"
WDW3: folds 
InsomniaRU: raises $3 to $5
myatiy 96: raises $11 to $16
mrhighryza: folds 
matiko09: folds 
Moszes360: folds 
Daveguyaces: calls $14
InsomniaRU: raises $32 to $48
myatiy 96: folds 
Daveguyaces: folds 
Uncalled bet ($32) returned to InsomniaRU
InsomniaRU collected $49 from pot
InsomniaRU: doesn't show hand 
*** SUMMARY ***
Total pot $49 | Rake $0 
Seat 1: matiko09 (button) folded before Flop (didn't bet)
Seat 2: Moszes360 (small blind) folded before Flop
Seat 3: Daveguyaces (big blind) folded before Flop
Seat 4: DUkalisUA folded before Flop (didn't bet)
Seat 5: chippo boy folded before Flop (didn't bet)
Seat 6: WDW3 folded before Flop (didn't bet)
Seat 7: InsomniaRU collected ($49)
Seat 8: myatiy 96 folded before Flop
Seat 9: mrhighryza folded before Flop (didn't bet)





PokerStars Hand #150799037258:  Hold'em No Limit ($0.25/$0.50 USD) - 2016/03/23 13:21:06 CET [2016/03/23 8:21:06 ET]
Table 'Pyrrhus' 9-max Seat #7 is the button
Seat 1: 1Maxx123 ($89.22 in chips) 
Seat 2: fandorin2005 ($50 in chips) 
Seat 5: lengcunjuan ($33.21 in chips) 
Seat 6: whalldo ($110.86 in chips) 
Seat 7: matiko09 ($116.90 in chips) 
Seat 8: dndngod ($50 in chips) 
Seat 9: CvMCvMCvM ($64.66 in chips) 
dndngod: posts small blind $0.25
CvMCvMCvM: posts big blind $0.50
IvanUrgant: sits out 
GriffinBerg: sits out 
*** HOLE CARDS ***
Dealt to matiko09 [5h 3h]
1Maxx123: folds 
fandorin2005: folds 
lengcunjuan: raises $1 to $1.50
whalldo: folds 
matiko09: folds 
dndngod: folds 
CvMCvMCvM: folds 
Uncalled bet ($1) returned to lengcunjuan
lengcunjuan collected $1.25 from pot
lengcunjuan: doesn't show hand 
*** SUMMARY ***
Total pot $1.25 | Rake $0 
Seat 1: 1Maxx123 folded before Flop (didn't bet)
Seat 2: fandorin2005 folded before Flop (didn't bet)
Seat 5: lengcunjuan collected ($1.25)
Seat 6: whalldo folded before Flop (didn't bet)
Seat 7: matiko09 (button) folded before Flop (didn't bet)
Seat 8: dndngod (small blind) folded before Flop
Seat 9: CvMCvMCvM (big blind) folded before Flop





PokerStars Hand #150799039227:  Hold'em No Limit (€0.25/€0.50 EUR) - 2016/03/23 13:21:10 CET [2016/03/23 8:21:10 ET]
Table 'Hesperia II' 9-max Seat #5 is the button
Seat 4: Zelenis (€20 in chips) 
Seat 5: d-master850 (€25.91 in chips) 
Seat 6: CvMCvMCvM (€51 in chips) 
Seat 7: matiko09 (€50 in chips) 
CvMCvMCvM: posts small blind €0.25
matiko09: posts big blind €0.50
Zelenis: posts big blind €0.50
*** HOLE CARDS ***
Dealt to matiko09 [Ad Jh]
Zelenis: checks 
d-master850: calls €0.50
CvMCvMCvM: folds 
matiko09: raises €2.50 to €3
Zelenis: folds 
d-master850: calls €2.50
*** FLOP *** [Kc Qs Td]
matiko09: bets €3.50
d-master850: calls €3.50
*** TURN *** [Kc Qs Td] [8c]
matiko09: bets €8.50
d-master850: folds 
Uncalled bet (€8.50) returned to matiko09
Ahangama joins the table at seat #8 
matiko09 collected €13.13 from pot
matiko09: doesn't show hand 
*** SUMMARY ***
Total pot €13.75 | Rake €0.62 
Board [Kc Qs Td 8c]
Seat 4: Zelenis folded before Flop
Seat 5: d-master850 (button) folded on the Turn
Seat 6: CvMCvMCvM (small blind) folded before Flop
Seat 7: matiko09 (big blind) collected (€13.13)





PokerStars Hand #150799039757:  Hold'em No Limit ($0.50/$1.00 USD) - 2016/03/23 13:21:11 CET [2016/03/23 8:21:11 ET]
Table 'Smiley' 9-max Seat #3 is the button
Seat 1: WDW3 ($102.35 in chips) 
Seat 2: Jimy Tiltman ($104 in chips) 
Seat 3: matiko09 ($128.56 in chips) 
Seat 4: Zeeshka ($100.50 in chips) 
Seat 5: DUkalisUA ($100 in chips) 
Seat 6: blackmont111 ($67.70 in chips) 
Seat 7: drosan ($42.62 in chips) 
Seat 8: RICKA16 ($110.56 in chips) 
Seat 9: morosun ($109.38 in chips) 
Zeeshka: posts small blind $0.50
DUkalisUA: posts big blind $1
*** HOLE CARDS ***
Dealt to matiko09 [4s 6s]
blackmont111: folds 
drosan: calls $1
RICKA16: folds 
morosun: folds 
WDW3: raises $3 to $4
Jimy Tiltman: calls $4
matiko09: folds 
Zeeshka: folds 
DUkalisUA: folds 
drosan: raises $38.62 to $42.62 and is all-in
WDW3: folds 
Jimy Tiltman: folds 
Uncalled bet ($38.62) returned to drosan
drosan collected $13.50 from pot
drosan: doesn't show hand 
*** SUMMARY ***
Total pot $13.50 | Rake $0 
Seat 1: WDW3 folded before Flop
Seat 2: Jimy Tiltman folded before Flop
Seat 3: matiko09 (button) folded before Flop (didn't bet)
Seat 4: Zeeshka (small blind) folded before Flop
Seat 5: DUkalisUA (big blind) folded before Flop
Seat 6: blackmont111 folded before Flop (didn't bet)
Seat 7: drosan collected ($13.50)
Seat 8: RICKA16 folded before Flop (didn't bet)
Seat 9: morosun folded before Flop (didn't bet)





PokerStars Hand #150799046347:  Hold'em No Limit ($0.50/$1.00 USD) - 2016/03/23 13:21:26 CET [2016/03/23 8:21:26 ET]
Table 'Oljato' 9-max Seat #5 is the button
Seat 1: Pearl Jam87 ($189.20 in chips) 
Seat 2: roman134679 ($87.86 in chips) 
Seat 3: DUkalisUA ($100 in chips) 
Seat 4: Pvsx. ($100.78 in chips) 
Seat 5: ryo728 ($75.19 in chips) 
Seat 6: WDW3 ($135.01 in chips) 
Seat 7: matiko09 ($164.23 in chips) 
Seat 8: Zeeshka ($356.14 in chips) 
Seat 9: Jimy Tiltman ($100 in chips) 
WDW3: posts small blind $0.50
matiko09: posts big blind $1
*** HOLE CARDS ***
Dealt to matiko09 [2d Ad]
Zeeshka: folds 
Jimy Tiltman: raises $2 to $3
Pearl Jam87: folds 
roman134679: raises $4.11 to $7.11
DUkalisUA: folds 
Pvsx.: folds 
ryo728: folds 
WDW3: folds 
matiko09: folds 
Jimy Tiltman: calls $4.11
*** FLOP *** [8c 9s 4h]
Jimy Tiltman: checks 
roman134679: checks 
*** TURN *** [8c 9s 4h] [Ks]
Jimy Tiltman: checks 
roman134679: checks 
*** RIVER *** [8c 9s 4h Ks] [7h]
Jimy Tiltman: checks 
roman134679: checks 
*** SHOW DOWN ***
Jimy Tiltman: shows [As 3s] (high card Ace)
roman134679: shows [8d 6h] (a pair of Eights)
roman134679 collected $15.01 from pot
*** SUMMARY ***
Total pot $15.72 | Rake $0.71 
Board [8c 9s 4h Ks 7h]
Seat 1: Pearl Jam87 folded before Flop (didn't bet)
Seat 2: roman134679 showed [8d 6h] and won ($15.01) with a pair of Eights
Seat 3: DUkalisUA folded before Flop (didn't bet)
Seat 4: Pvsx. folded before Flop (didn't bet)
Seat 5: ryo728 (button) folded before Flop (didn't bet)
Seat 6: WDW3 (small blind) folded before Flop
Seat 7: matiko09 (big blind) folded before Flop
Seat 8: Zeeshka folded before Flop (didn't bet)
Seat 9: Jimy Tiltman showed [As 3s] and lost with high card Ace





PokerStars Hand #150799049792:  Hold'em No Limit ($0.25/$0.50 USD) - 2016/03/23 13:21:33 CET [2016/03/23 8:21:33 ET]
Table 'Pyrrhus' 9-max Seat #8 is the button
Seat 1: 1Maxx123 ($89.22 in chips) 
Seat 2: fandorin2005 ($50 in chips) 
Seat 5: lengcunjuan ($33.96 in chips) 
Seat 6: whalldo ($110.86 in chips) 
Seat 7: matiko09 ($116.90 in chips) 
Seat 8: dndngod ($50 in chips) 
Seat 9: CvMCvMCvM ($64.16 in chips) 
CvMCvMCvM: posts small blind $0.25
1Maxx123: posts big blind $0.50
IvanUrgant: sits out 
GriffinBerg: sits out 
*** HOLE CARDS ***
Dealt to matiko09 [6c Th]
fandorin2005: folds 
lengcunjuan: raises $0.50 to $1
whalldo: raises $3 to $4
matiko09: folds 
dndngod: folds 
CvMCvMCvM: folds 
1Maxx123: calls $3.50
lengcunjuan: calls $3
*** FLOP *** [Qh 7c Jh]
1Maxx123: checks 
lengcunjuan: checks 
whalldo: bets $6
1Maxx123: calls $6
lengcunjuan: folds 
*** TURN *** [Qh 7c Jh] [Qc]
1Maxx123: checks 
whalldo: checks 
*** RIVER *** [Qh 7c Jh Qc] [Qs]
1Maxx123: checks 
whalldo: bets $16
1Maxx123: calls $16
*** SHOW DOWN ***
whalldo: shows [Qd Ac] (four of a kind, Queens)
1Maxx123: mucks hand 
whalldo collected $53.75 from pot
*** SUMMARY ***
Total pot $56.25 | Rake $2.50 
Board [Qh 7c Jh Qc Qs]
Seat 1: 1Maxx123 (big blind) mucked [9h 9s]
Seat 2: fandorin2005 folded before Flop (didn't bet)
Seat 5: lengcunjuan folded on the Flop
Seat 6: whalldo showed [Qd Ac] and won ($53.75) with four of a kind, Queens
Seat 7: matiko09 folded before Flop (didn't bet)
Seat 8: dndngod (button) folded before Flop (didn't bet)
Seat 9: CvMCvMCvM (small blind) folded before Flop





PokerStars Hand #150799053064:  Hold'em No Limit ($1/$2 USD) - 2016/03/23 13:21:39 CET [2016/03/23 8:21:39 ET]
Table 'Kypria II' 9-max Seat #6 is the button
Seat 1: geldwolfje ($266.62 in chips) 
Seat 2: coinflip_si ($200 in chips) 
Seat 3: seouljam ($80 in chips) 
Seat 4: nailz83 ($70.20 in chips) 
Seat 6: matiko09 ($252.57 in chips) 
Seat 7: ldwin8 ($402.09 in chips) 
Seat 8: Fish4trips ($300.52 in chips) 
Seat 9: WDW3 ($203 in chips) 
ldwin8: posts small blind $1
Fish4trips: posts big blind $2
*** HOLE CARDS ***
Dealt to matiko09 [6c Ad]
WDW3: folds 
seouljam said, "unbelievable riv"
geldwolfje: raises $4 to $6
coinflip_si: folds 
geldwolfje said, "hahaha seouljam what are you doiing"
seouljam: folds 
nailz83: folds 
seouljam said, "fu geld"
matiko09: folds 
ldwin8: folds 
Fish4trips: folds 
Uncalled bet ($4) returned to geldwolfje
geldwolfje collected $5 from pot
geldwolfje: doesn't show hand 
*** SUMMARY ***
Total pot $5 | Rake $0 
Seat 1: geldwolfje collected ($5)
Seat 2: coinflip_si folded before Flop (didn't bet)
Seat 3: seouljam folded before Flop (didn't bet)
Seat 4: nailz83 folded before Flop (didn't bet)
Seat 6: matiko09 (button) folded before Flop (didn't bet)
Seat 7: ldwin8 (small blind) folded before Flop
Seat 8: Fish4trips (big blind) folded before Flop
Seat 9: WDW3 folded before Flop (didn't bet)





PokerStars Hand #150799056033:  Hold'em No Limit ($1/$2 USD) - 2016/03/23 13:21:46 CET [2016/03/23 8:21:46 ET]
Table 'Kiess' 9-max Seat #6 is the button
Seat 1: ldwin8 ($218.11 in chips) 
Seat 2: DUkalisUA ($532.66 in chips) 
Seat 3: The_red_area ($200 in chips) 
Seat 5: chippo boy ($330.93 in chips) 
Seat 6: matiko09 ($209.44 in chips) 
Seat 7: InsomniaRU ($329.13 in chips) 
Seat 8: WDW3 ($407.60 in chips) 
Seat 9: Fish4trips ($202 in chips) 
InsomniaRU: posts small blind $1
WDW3: posts big blind $2
Moszes360: sits out 
*** HOLE CARDS ***
Dealt to matiko09 [Kd Tc]
Fish4trips: folds 
ldwin8: folds 
DUkalisUA: raises $4 to $6
The_red_area: folds 
chippo boy: calls $6
matiko09: folds 
InsomniaRU: folds 
WDW3: folds 
*** FLOP *** [7d 2c 5h]
DUkalisUA: bets $8
chippo boy: raises $10 to $18
DUkalisUA: folds 
Uncalled bet ($10) returned to chippo boy
chippo boy collected $29.60 from pot
*** SUMMARY ***
Total pot $31 | Rake $1.40 
Board [7d 2c 5h]
Seat 1: ldwin8 folded before Flop (didn't bet)
Seat 2: DUkalisUA folded on the Flop
Seat 3: The_red_area folded before Flop (didn't bet)
Seat 5: chippo boy collected ($29.60)
Seat 6: matiko09 (button) folded before Flop (didn't bet)
Seat 7: InsomniaRU (small blind) folded before Flop
Seat 8: WDW3 (big blind) folded before Flop
Seat 9: Fish4trips folded before Flop (didn't bet)





PokerStars Hand #150799059707:  Hold'em No Limit (€0.25/€0.50 EUR) - 2016/03/23 13:21:53 CET [2016/03/23 8:21:53 ET]
Table 'Hesperia II' 9-max Seat #6 is the button
Seat 4: Zelenis (€19.50 in chips) 
Seat 5: d-master850 (€19.41 in chips) 
Seat 6: CvMCvMCvM (€50.75 in chips) 
Seat 7: matiko09 (€56.63 in chips) 
Seat 8: Ahangama (€50 in chips) 
matiko09: posts small blind €0.25
Ahangama: posts big blind €0.50
*** HOLE CARDS ***
Dealt to matiko09 [Qs 5s]
Zelenis: raises €1 to €1.50
d-master850: raises €1.50 to €3
CvMCvMCvM: folds 
matiko09: folds 
Ahangama: folds 
Zelenis: calls €1.50
*** FLOP *** [Qd 7h 9d]
Zelenis: bets €3.22
d-master850: calls €3.22
*** TURN *** [Qd 7h 9d] [2c]
Zelenis: checks 
d-master850: bets €3
Zelenis: calls €3
*** RIVER *** [Qd 7h 9d 2c] [Jh]
Zelenis: checks 
d-master850: checks 
*** SHOW DOWN ***
Zelenis: shows [9c Kh] (a pair of Nines)
d-master850: shows [Td Tc] (a pair of Tens)
d-master850 collected €18.33 from pot
*** SUMMARY ***
Total pot €19.19 | Rake €0.86 
Board [Qd 7h 9d 2c Jh]
Seat 4: Zelenis showed [9c Kh] and lost with a pair of Nines
Seat 5: d-master850 showed [Td Tc] and won (€18.33) with a pair of Tens
Seat 6: CvMCvMCvM (button) folded before Flop (didn't bet)
Seat 7: matiko09 (small blind) folded before Flop
Seat 8: Ahangama (big blind) folded before Flop





PokerStars Hand #150799063697:  Hold'em No Limit ($0.50/$1.00 USD) - 2016/03/23 13:22:01 CET [2016/03/23 8:22:01 ET]
Table 'Smiley' 9-max Seat #4 is the button
Seat 1: WDW3 ($100 in chips) 
Seat 2: Jimy Tiltman ($100 in chips) 
Seat 3: matiko09 ($128.56 in chips) 
Seat 4: Zeeshka ($100 in chips) 
Seat 5: DUkalisUA ($100 in chips) 
Seat 6: blackmont111 ($67.70 in chips) 
Seat 7: drosan ($52.12 in chips) 
Seat 8: RICKA16 ($110.56 in chips) 
Seat 9: morosun ($109.38 in chips) 
DUkalisUA: posts small blind $0.50
blackmont111: posts big blind $1
*** HOLE CARDS ***
Dealt to matiko09 [Tc 8c]
drosan: folds 
RICKA16: folds 
morosun: folds 
WDW3: folds 
Jimy Tiltman: folds 
matiko09: raises $1.50 to $2.50
Zeeshka: folds 
DUkalisUA: folds 
blackmont111: calls $1.50
*** FLOP *** [6h 9s Qh]
blackmont111: checks 
matiko09: bets $3.41
blackmont111: calls $3.41
*** TURN *** [6h 9s Qh] [Th]
blackmont111: checks 
matiko09: checks 
*** RIVER *** [6h 9s Qh Th] [7d]
blackmont111: bets $4
matiko09: calls $4
*** SHOW DOWN ***
blackmont111: shows [9h 8s] (a straight, Six to Ten)
matiko09: shows [Tc 8c] (a straight, Six to Ten)
blackmont111 collected $9.71 from pot
matiko09 collected $9.70 from pot
*** SUMMARY ***
Total pot $20.32 | Rake $0.91 
Board [6h 9s Qh Th 7d]
Seat 1: WDW3 folded before Flop (didn't bet)
Seat 2: Jimy Tiltman folded before Flop (didn't bet)
Seat 3: matiko09 showed [Tc 8c] and won ($9.70) with a straight, Six to Ten
Seat 4: Zeeshka (button) folded before Flop (didn't bet)
Seat 5: DUkalisUA (small blind) folded before Flop
Seat 6: blackmont111 (big blind) showed [9h 8s] and won ($9.71) with a straight, Six to Ten
Seat 7: drosan folded before Flop (didn't bet)
Seat 8: RICKA16 folded before Flop (didn't bet)
Seat 9: morosun folded before Flop (didn't bet)





PokerStars Hand #150799064717:  Hold'em No Limit ($1/$2 USD) - 2016/03/23 13:22:03 CET [2016/03/23 8:22:03 ET]
Table 'Kypria II' 9-max Seat #7 is the button
Seat 1: geldwolfje ($269.62 in chips) 
Seat 2: coinflip_si ($200 in chips) 
Seat 3: seouljam ($80 in chips) 
Seat 4: nailz83 ($70.20 in chips) 
Seat 6: matiko09 ($252.57 in chips) 
Seat 7: ldwin8 ($401.09 in chips) 
Seat 8: Fish4trips ($298.52 in chips) 
Seat 9: WDW3 ($203 in chips) 
Fish4trips: posts small blind $1
WDW3: posts big blind $2
*** HOLE CARDS ***
Dealt to matiko09 [8h 4s]
geldwolfje: folds 
coinflip_si: raises $3 to $5
seouljam: folds 
nailz83: calls $5
geldwolfje said, "hahaha"
matiko09: folds 
ldwin8: folds 
Fish4trips: folds 
WDW3: folds 
*** FLOP *** [9h 8c 2c]
coinflip_si: checks 
nailz83: bets $6
coinflip_si: folds 
Uncalled bet ($6) returned to nailz83
nailz83 collected $12.42 from pot
nailz83: doesn't show hand 
*** SUMMARY ***
Total pot $13 | Rake $0.58 
Board [9h 8c 2c]
Seat 1: geldwolfje folded before Flop (didn't bet)
Seat 2: coinflip_si folded on the Flop
Seat 3: seouljam folded before Flop (didn't bet)
Seat 4: nailz83 collected ($12.42)
Seat 6: matiko09 folded before Flop (didn't bet)
Seat 7: ldwin8 (button) folded before Flop (didn't bet)
Seat 8: Fish4trips (small blind) folded before Flop
Seat 9: WDW3 (big blind) folded before Flop





PokerStars Hand #150799071983:  Hold'em No Limit ($0.50/$1.00 USD) - 2016/03/23 13:22:17 CET [2016/03/23 8:22:17 ET]
Table 'Atlantis' 9-max Seat #6 is the button
Seat 1: xHourglass ($178.07 in chips) 
Seat 2: tffff2006 ($54.81 in chips) 
Seat 3: CAJUN890 ($109.33 in chips) 
Seat 4: matiko09 ($126.67 in chips) 
Seat 6: Jimy Tiltman ($112.74 in chips) 
Seat 7: Zeeshka ($100 in chips) 
Seat 8: lumen21 ($122.38 in chips) 
Seat 9: WDW3 ($118.47 in chips) 
Zeeshka: posts small blind $0.50
lumen21: posts big blind $1
Pvsx.: sits out 
*** HOLE CARDS ***
Dealt to matiko09 [Ad Qd]
WDW3: folds 
xHourglass: folds 
tffff2006: calls $1
CAJUN890: folds 
matiko09: raises $3 to $4
Jimy Tiltman: folds 
Zeeshka: folds 
lumen21: folds 
tffff2006: calls $3
*** FLOP *** [6h 6d 3c]
tffff2006: checks 
matiko09: checks 
*** TURN *** [6h 6d 3c] [Kh]
tffff2006: bets $4.53
matiko09: folds 
Uncalled bet ($4.53) returned to tffff2006
tffff2006 collected $9.07 from pot
tffff2006: doesn't show hand 
*** SUMMARY ***
Total pot $9.50 | Rake $0.43 
Board [6h 6d 3c Kh]
Seat 1: xHourglass folded before Flop (didn't bet)
Seat 2: tffff2006 collected ($9.07)
Seat 3: CAJUN890 folded before Flop (didn't bet)
Seat 4: matiko09 folded on the Turn
Seat 6: Jimy Tiltman (button) folded before Flop (didn't bet)
Seat 7: Zeeshka (small blind) folded before Flop
Seat 8: lumen21 (big blind) folded before Flop
Seat 9: WDW3 folded before Flop (didn't bet)





PokerStars Hand #150799074413:  Hold'em No Limit ($0.50/$1.00 USD) - 2016/03/23 13:22:22 CET [2016/03/23 8:22:22 ET]
Table 'Oljato' 9-max Seat #6 is the button
Seat 1: Pearl Jam87 ($189.20 in chips) 
Seat 2: roman134679 ($95.76 in chips) 
Seat 3: DUkalisUA ($100 in chips) 
Seat 4: Pvsx. ($100.78 in chips) 
Seat 5: ryo728 ($75.19 in chips) 
Seat 6: WDW3 ($134.51 in chips) 
Seat 7: matiko09 ($163.23 in chips) 
Seat 8: Zeeshka ($356.14 in chips) 
Seat 9: Jimy Tiltman ($100 in chips) 
matiko09: posts small blind $0.50
Zeeshka: posts big blind $1
*** HOLE CARDS ***
Dealt to matiko09 [Jh 9h]
Jimy Tiltman: folds 
Pearl Jam87: folds 
roman134679: calls $1
DUkalisUA: folds 
Pvsx.: raises $3.50 to $4.50
ryo728: folds 
WDW3: folds 
matiko09: folds 
Zeeshka: folds 
roman134679: calls $3.50
*** FLOP *** [8h 3h 9s]
roman134679: checks 
Pvsx.: bets $5.01
roman134679: folds 
Uncalled bet ($5.01) returned to Pvsx.
Pvsx. collected $10.03 from pot
Pvsx.: doesn't show hand 
*** SUMMARY ***
Total pot $10.50 | Rake $0.47 
Board [8h 3h 9s]
Seat 1: Pearl Jam87 folded before Flop (didn't bet)
Seat 2: roman134679 folded on the Flop
Seat 3: DUkalisUA folded before Flop (didn't bet)
Seat 4: Pvsx. collected ($10.03)
Seat 5: ryo728 folded before Flop (didn't bet)
Seat 6: WDW3 (button) folded before Flop (didn't bet)
Seat 7: matiko09 (small blind) folded before Flop
Seat 8: Zeeshka (big blind) folded before Flop
Seat 9: Jimy Tiltman folded before Flop (didn't bet)





PokerStars Hand #150799079557:  Hold'em No Limit (€0.25/€0.50 EUR) - 2016/03/23 13:22:32 CET [2016/03/23 8:22:32 ET]
Table 'Hesperia II' 9-max Seat #7 is the button
Seat 4: Zelenis (€10.28 in chips) 
Seat 5: d-master850 (€28.52 in chips) 
Seat 6: CvMCvMCvM (€50.75 in chips) 
Seat 7: matiko09 (€56.38 in chips) 
Seat 8: Ahangama (€50 in chips) 
Ahangama: posts small blind €0.25
Zelenis: posts big blind €0.50
*** HOLE CARDS ***
Dealt to matiko09 [3h Kh]
d-master850: calls €0.50
CvMCvMCvM: folds 
matiko09: raises €1.50 to €2
Ahangama: raises €4.50 to €6.50
Zelenis: folds 
d-master850: folds 
matiko09: folds 
Uncalled bet (€4.50) returned to Ahangama
Ahangama collected €5 from pot
Ahangama: doesn't show hand 
*** SUMMARY ***
Total pot €5 | Rake €0 
Seat 4: Zelenis (big blind) folded before Flop
Seat 5: d-master850 folded before Flop
Seat 6: CvMCvMCvM folded before Flop (didn't bet)
Seat 7: matiko09 (button) folded before Flop
Seat 8: Ahangama (small blind) collected (€5)





PokerStars Hand #150799084311:  Hold'em No Limit ($1/$2 USD) - 2016/03/23 13:22:42 CET [2016/03/23 8:22:42 ET]
Table 'Kiess' 9-max Seat #7 is the button
Seat 1: ldwin8 ($218.11 in chips) 
Seat 2: DUkalisUA ($518.66 in chips) 
Seat 3: The_red_area ($200 in chips) 
Seat 5: chippo boy ($346.53 in chips) 
Seat 6: matiko09 ($209.44 in chips) 
Seat 7: InsomniaRU ($328.13 in chips) 
Seat 8: WDW3 ($405.60 in chips) 
Seat 9: Fish4trips ($202 in chips) 
WDW3: posts small blind $1
Fish4trips: posts big blind $2
Moszes360: sits out 
*** HOLE CARDS ***
Dealt to matiko09 [5s 4s]
ldwin8: folds 
DUkalisUA: folds 
The_red_area: folds 
chippo boy: calls $2
matiko09: raises $6 to $8
InsomniaRU: folds 
WDW3: folds 
Fish4trips: folds 
chippo boy: calls $6
*** FLOP *** [Ts 9s Kd]
chippo boy: checks 
matiko09: bets $10
chippo boy: calls $10
*** TURN *** [Ts 9s Kd] [Kc]
chippo boy: checks 
matiko09: checks 
*** RIVER *** [Ts 9s Kd Kc] [Js]
chippo boy: bets $24
matiko09: raises $38 to $62
chippo boy: folds 
Uncalled bet ($38) returned to matiko09
matiko09 collected $84.20 from pot
matiko09: doesn't show hand 
*** SUMMARY ***
Total pot $87 | Rake $2.80 
Board [Ts 9s Kd Kc Js]
Seat 1: ldwin8 folded before Flop (didn't bet)
Seat 2: DUkalisUA folded before Flop (didn't bet)
Seat 3: The_red_area folded before Flop (didn't bet)
Seat 5: chippo boy folded on the River
Seat 6: matiko09 collected ($84.20)
Seat 7: InsomniaRU (button) folded before Flop (didn't bet)
Seat 8: WDW3 (small blind) folded before Flop
Seat 9: Fish4trips (big blind) folded before Flop





PokerStars Hand #150799086056:  Hold'em No Limit ($1/$2 USD) - 2016/03/23 13:22:45 CET [2016/03/23 8:22:45 ET]
Table 'Kypria II' 9-max Seat #8 is the button
Seat 1: geldwolfje ($269.62 in chips) 
Seat 2: coinflip_si ($200 in chips) 
Seat 3: seouljam ($80 in chips) 
Seat 4: nailz83 ($77.62 in chips) 
Seat 6: matiko09 ($252.57 in chips) 
Seat 7: ldwin8 ($401.09 in chips) 
Seat 8: Fish4trips ($297.52 in chips) 
Seat 9: WDW3 ($201 in chips) 
WDW3: posts small blind $1
geldwolfje: posts big blind $2
*** HOLE CARDS ***
Dealt to matiko09 [Qs Jd]
coinflip_si: folds 
seouljam: folds 
nailz83: calls $2
matiko09: raises $6 to $8
ldwin8: folds 
Fish4trips: folds 
WDW3: folds 
geldwolfje: folds 
nailz83: calls $6
*** FLOP *** [9h Ts 7h]
nailz83: checks 
matiko09: checks 
*** TURN *** [9h Ts 7h] [2s]
nailz83: checks 
matiko09: checks 
*** RIVER *** [9h Ts 7h 2s] [3s]
nailz83: checks 
matiko09: checks 
*** SHOW DOWN ***
nailz83: shows [Jh Qd] (high card Queen)
matiko09: shows [Qs Jd] (high card Queen)
nailz83 collected $9.07 from pot
matiko09 collected $9.07 from pot
*** SUMMARY ***
Total pot $19 | Rake $0.86 
Board [9h Ts 7h 2s 3s]
Seat 1: geldwolfje (big blind) folded before Flop
Seat 2: coinflip_si folded before Flop (didn't bet)
Seat 3: seouljam folded before Flop (didn't bet)
Seat 4: nailz83 showed [Jh Qd] and won ($9.07) with high card Queen
Seat 6: matiko09 showed [Qs Jd] and won ($9.07) with high card Queen
Seat 7: ldwin8 folded before Flop (didn't bet)
Seat 8: Fish4trips (button) folded before Flop (didn't bet)
Seat 9: WDW3 (small blind) folded before Flop





PokerStars Hand #150799089681:  Hold'em No Limit ($0.50/$1.00 USD) - 2016/03/23 13:22:52 CET [2016/03/23 8:22:52 ET]
Table 'Atlantis' 9-max Seat #7 is the button
Seat 1: xHourglass ($178.07 in chips) 
Seat 2: tffff2006 ($59.88 in chips) 
Seat 3: CAJUN890 ($109.33 in chips) 
Seat 4: matiko09 ($122.67 in chips) 
Seat 6: Jimy Tiltman ($112.74 in chips) 
Seat 7: Zeeshka ($100 in chips) 
Seat 8: lumen21 ($121.38 in chips) 
Seat 9: WDW3 ($118.47 in chips) 
lumen21: posts small blind $0.50
WDW3: posts big blind $1
Pvsx.: sits out 
*** HOLE CARDS ***
Dealt to matiko09 [9d Td]
xHourglass: folds 
tffff2006: folds 
CAJUN890: folds 
matiko09: raises $2 to $3
Jimy Tiltman: folds 
Zeeshka: folds 
lumen21: raises $7 to $10
WDW3: folds 
matiko09: calls $7
*** FLOP *** [7d 6d 5d]
lumen21: checks 
matiko09: bets $10
lumen21: calls $10
*** TURN *** [7d 6d 5d] [Qd]
lumen21: checks 
matiko09: checks 
*** RIVER *** [7d 6d 5d Qd] [7c]
lumen21: bets $30.15
matiko09: folds 
Uncalled bet ($30.15) returned to lumen21
lumen21 collected $39.16 from pot
lumen21: doesn't show hand 
*** SUMMARY ***
Total pot $41 | Rake $1.84 
Board [7d 6d 5d Qd 7c]
Seat 1: xHourglass folded before Flop (didn't bet)
Seat 2: tffff2006 folded before Flop (didn't bet)
Seat 3: CAJUN890 folded before Flop (didn't bet)
Seat 4: matiko09 folded on the River
Seat 6: Jimy Tiltman folded before Flop (didn't bet)
Seat 7: Zeeshka (button) folded before Flop (didn't bet)
Seat 8: lumen21 (small blind) collected ($39.16)
Seat 9: WDW3 (big blind) folded before Flop





PokerStars Hand #150799091955:  Hold'em No Limit ($0.50/$1.00 USD) - 2016/03/23 13:22:56 CET [2016/03/23 8:22:56 ET]
Table 'Kippes' 9-max Seat #2 is the button
Seat 1: Pvsx. ($100 in chips) 
Seat 2: RICKA16 ($124.92 in chips) 
Seat 3: CAJUN890 ($113.99 in chips) 
Seat 4: matiko09 ($100 in chips) 
Seat 6: WDW3 ($100 in chips) 
Seat 7: lumen21 ($104 in chips) 
Seat 8: Zeeshka ($103.30 in chips) 
Seat 9: wang19790906 ($85.44 in chips) 
CAJUN890: posts small blind $0.50
matiko09: posts big blind $1
Jimy Tiltman: sits out 
*** HOLE CARDS ***
Dealt to matiko09 [5s Ah]
WDW3: folds 
lumen21: folds 
Zeeshka: folds 
wang19790906: folds 
Pvsx.: folds 
RICKA16: folds 
CAJUN890: raises $1 to $2
matiko09: calls $1
*** FLOP *** [7s 9d 6s]
CAJUN890: bets $2
matiko09: folds 
Uncalled bet ($2) returned to CAJUN890
CAJUN890 collected $3.82 from pot
CAJUN890: doesn't show hand 
*** SUMMARY ***
Total pot $4 | Rake $0.18 
Board [7s 9d 6s]
Seat 1: Pvsx. folded before Flop (didn't bet)
Seat 2: RICKA16 (button) folded before Flop (didn't bet)
Seat 3: CAJUN890 (small blind) collected ($3.82)
Seat 4: matiko09 (big blind) folded on the Flop
Seat 6: WDW3 folded before Flop (didn't bet)
Seat 7: lumen21 folded before Flop (didn't bet)
Seat 8: Zeeshka folded before Flop (didn't bet)
Seat 9: wang19790906 folded before Flop (didn't bet)





PokerStars Hand #150799092290:  Hold'em No Limit ($1/$2 USD) - 2016/03/23 13:22:57 CET [2016/03/23 8:22:57 ET]
Table 'Herba II' 9-max Seat #2 is the button
Seat 1: matiko09 ($243.52 in chips) 
Seat 2: Moszes360 ($233.20 in chips) 
Seat 3: Daveguyaces ($188.02 in chips) 
Seat 4: DUkalisUA ($257.20 in chips) 
Seat 5: chippo boy ($200 in chips) 
Seat 6: WDW3 ($202.47 in chips) 
Seat 7: InsomniaRU ($233 in chips) 
Seat 8: myatiy 96 ($200 in chips) 
Seat 9: mrhighryza ($78.08 in chips) 
Daveguyaces: posts small blind $1
DUkalisUA: posts big blind $2
*** HOLE CARDS ***
Dealt to matiko09 [As 7d]
chippo boy: folds 
WDW3: raises $3.60 to $5.60
InsomniaRU: folds 
myatiy 96: folds 
mrhighryza: folds 
matiko09: folds 
Moszes360: folds 
Daveguyaces: folds 
DUkalisUA: folds 
Uncalled bet ($3.60) returned to WDW3
Daveguyaces leaves the table
WDW3 collected $5 from pot
WDW3: doesn't show hand 
*** SUMMARY ***
Total pot $5 | Rake $0 
Seat 1: matiko09 folded before Flop (didn't bet)
Seat 2: Moszes360 (button) folded before Flop (didn't bet)
Seat 3: Daveguyaces (small blind) folded before Flop
Seat 4: DUkalisUA (big blind) folded before Flop
Seat 5: chippo boy folded before Flop (didn't bet)
Seat 6: WDW3 collected ($5)
Seat 7: InsomniaRU folded before Flop (didn't bet)
Seat 8: myatiy 96 folded before Flop (didn't bet)
Seat 9: mrhighryza folded before Flop (didn't bet)





PokerStars Hand #150799095024:  Hold'em No Limit ($0.25/$0.50 USD) - 2016/03/23 13:23:02 CET [2016/03/23 8:23:02 ET]
Table 'Pyrrhus' 9-max Seat #9 is the button
Seat 1: 1Maxx123 ($63.22 in chips) 
Seat 2: fandorin2005 ($50 in chips) 
Seat 5: lengcunjuan ($29.96 in chips) 
Seat 6: whalldo ($138.61 in chips) 
Seat 7: matiko09 ($116.90 in chips) 
Seat 8: dndngod ($50 in chips) 
Seat 9: CvMCvMCvM ($63.91 in chips) 
1Maxx123: posts small blind $0.25
fandorin2005: posts big blind $0.50
IvanUrgant: sits out 
GriffinBerg: sits out 
*** HOLE CARDS ***
Dealt to matiko09 [6s 9c]
lengcunjuan: folds 
whalldo: folds 
matiko09: folds 
dndngod: folds 
CvMCvMCvM: raises $0.76 to $1.26
1Maxx123: folds 
fandorin2005: folds 
Uncalled bet ($0.76) returned to CvMCvMCvM
CvMCvMCvM collected $1.25 from pot
CvMCvMCvM: doesn't show hand 
*** SUMMARY ***
Total pot $1.25 | Rake $0 
Seat 1: 1Maxx123 (small blind) folded before Flop
Seat 2: fandorin2005 (big blind) folded before Flop
Seat 5: lengcunjuan folded before Flop (didn't bet)
Seat 6: whalldo folded before Flop (didn't bet)
Seat 7: matiko09 folded before Flop (didn't bet)
Seat 8: dndngod folded before Flop (didn't bet)
Seat 9: CvMCvMCvM (button) collected ($1.25)





PokerStars Hand #150799095748:  Hold'em No Limit (€0.25/€0.50 EUR) - 2016/03/23 13:23:03 CET [2016/03/23 8:23:03 ET]
Table 'Hesperia II' 9-max Seat #8 is the button
Seat 4: Zelenis (€9.78 in chips) 
Seat 5: d-master850 (€28.02 in chips) 
Seat 6: CvMCvMCvM (€50.75 in chips) 
Seat 7: matiko09 (€54.38 in chips) 
Seat 8: Ahangama (€53 in chips) 
Zelenis: posts small blind €0.25
d-master850: posts big blind €0.50
*** HOLE CARDS ***
Dealt to matiko09 [7d Ah]
CvMCvMCvM: folds 
matiko09: folds 
Ahangama: raises €0.50 to €1
Zelenis: calls €0.75
d-master850: calls €0.50
*** FLOP *** [Jd Qs Td]
Zelenis: checks 
d-master850: checks 
IvanUrgant joins the table at seat #3 
Ahangama: checks 
*** TURN *** [Jd Qs Td] [6d]
Zelenis: bets €1.43
d-master850: folds 
Ahangama: folds 
Uncalled bet (€1.43) returned to Zelenis
Zelenis collected €2.86 from pot
Zelenis: doesn't show hand 
*** SUMMARY ***
Total pot €3 | Rake €0.14 
Board [Jd Qs Td 6d]
Seat 4: Zelenis (small blind) collected (€2.86)
Seat 5: d-master850 (big blind) folded on the Turn
Seat 6: CvMCvMCvM folded before Flop (didn't bet)
Seat 7: matiko09 folded before Flop (didn't bet)
Seat 8: Ahangama (button) folded on the Turn





PokerStars Hand #150799104897:  Hold'em No Limit ($0.25/$0.50 USD) - 2016/03/23 13:23:20 CET [2016/03/23 8:23:20 ET]
Table 'Pyrrhus' 9-max Seat #1 is the button
Seat 1: 1Maxx123 ($62.97 in chips) 
Seat 2: fandorin2005 ($50 in chips) 
Seat 3: IvanUrgant ($50 in chips) 
Seat 5: lengcunjuan ($29.96 in chips) 
Seat 6: whalldo ($138.61 in chips) 
Seat 7: matiko09 ($116.90 in chips) 
Seat 8: dndngod ($50 in chips) 
Seat 9: CvMCvMCvM ($64.66 in chips) 
fandorin2005: posts small blind $0.25
IvanUrgant: posts big blind $0.50
GriffinBerg: sits out 
*** HOLE CARDS ***
Dealt to matiko09 [Ts Ks]
lengcunjuan: folds 
whalldo: folds 
matiko09: raises $1 to $1.50
dndngod: raises $3.50 to $5
CvMCvMCvM: folds 
1Maxx123: calls $5
fandorin2005: folds 
IvanUrgant: folds 
matiko09: folds 
*** FLOP *** [8s Js 4s]
dndngod: checks 
1Maxx123: bets $5.50
dndngod: raises $39.50 to $45 and is all-in
1Maxx123: folds 
Uncalled bet ($39.50) returned to dndngod
dndngod collected $22.20 from pot
dndngod: doesn't show hand 
*** SUMMARY ***
Total pot $23.25 | Rake $1.05 
Board [8s Js 4s]
Seat 1: 1Maxx123 (button) folded on the Flop
Seat 2: fandorin2005 (small blind) folded before Flop
Seat 3: IvanUrgant (big blind) folded before Flop
Seat 5: lengcunjuan folded before Flop (didn't bet)
Seat 6: whalldo folded before Flop (didn't bet)
Seat 7: matiko09 folded before Flop
Seat 8: dndngod collected ($22.20)
Seat 9: CvMCvMCvM folded before Flop (didn't bet)





PokerStars Hand #150799106496:  Hold'em No Limit ($0.50/$1.00 USD) - 2016/03/23 13:23:23 CET [2016/03/23 8:23:23 ET]
Table 'Oljato' 9-max Seat #7 is the button
Seat 1: Pearl Jam87 ($189.20 in chips) 
Seat 2: roman134679 ($91.26 in chips) 
Seat 3: DUkalisUA ($100 in chips) 
Seat 4: Pvsx. ($106.31 in chips) 
Seat 5: ryo728 ($75.19 in chips) 
Seat 6: WDW3 ($134.51 in chips) 
Seat 7: matiko09 ($162.73 in chips) 
Seat 8: Zeeshka ($355.14 in chips) 
Seat 9: Jimy Tiltman ($100 in chips) 
Zeeshka: posts small blind $0.50
Jimy Tiltman: posts big blind $1
*** HOLE CARDS ***
Dealt to matiko09 [Ts 2c]
Pearl Jam87: raises $2 to $3
roman134679: calls $3
DUkalisUA: folds 
Pvsx.: folds 
ryo728: folds 
WDW3: folds 
matiko09: folds 
Zeeshka: folds 
Jimy Tiltman: folds 
*** FLOP *** [5h 8s 2s]
Pearl Jam87: checks 
roman134679: bets $1.03
Pearl Jam87: calls $1.03
*** TURN *** [5h 8s 2s] [Jc]
Pearl Jam87: checks 
roman134679: bets $10
Pearl Jam87: calls $10
*** RIVER *** [5h 8s 2s Jc] [7s]
Pearl Jam87: checks 
roman134679: checks 
*** SHOW DOWN ***
Pearl Jam87: shows [Ad Jh] (a pair of Jacks)
roman134679: mucks hand 
Pearl Jam87 collected $28.23 from pot
*** SUMMARY ***
Total pot $29.56 | Rake $1.33 
Board [5h 8s 2s Jc 7s]
Seat 1: Pearl Jam87 showed [Ad Jh] and won ($28.23) with a pair of Jacks
Seat 2: roman134679 mucked [5d 4d]
Seat 3: DUkalisUA folded before Flop (didn't bet)
Seat 4: Pvsx. folded before Flop (didn't bet)
Seat 5: ryo728 folded before Flop (didn't bet)
Seat 6: WDW3 folded before Flop (didn't bet)
Seat 7: matiko09 (button) folded before Flop (didn't bet)
Seat 8: Zeeshka (small blind) folded before Flop
Seat 9: Jimy Tiltman (big blind) folded before Flop





PokerStars Hand #150799105996:  Hold'em No Limit ($1/$2 USD) - 2016/03/23 13:23:23 CET [2016/03/23 8:23:23 ET]
Table 'Herba II' 9-max Seat #4 is the button
Seat 1: matiko09 ($243.52 in chips) 
Seat 2: Moszes360 ($233.20 in chips) 
Seat 4: DUkalisUA ($255.20 in chips) 
Seat 5: chippo boy ($200 in chips) 
Seat 6: WDW3 ($205.47 in chips) 
Seat 7: InsomniaRU ($233 in chips) 
Seat 8: myatiy 96 ($200 in chips) 
Seat 9: mrhighryza ($78.08 in chips) 
chippo boy: posts small blind $1
WDW3: posts big blind $2
*** HOLE CARDS ***
Dealt to matiko09 [7h Ah]
InsomniaRU: folds 
myatiy 96: folds 
Cirilico joins the table at seat #3 
mrhighryza: folds 
matiko09: raises $3 to $5
Moszes360: folds 
DUkalisUA: raises $12 to $17
chippo boy: folds 
WDW3: folds 
matiko09: folds 
Uncalled bet ($12) returned to DUkalisUA
DUkalisUA collected $13 from pot
DUkalisUA: doesn't show hand 
*** SUMMARY ***
Total pot $13 | Rake $0 
Seat 1: matiko09 folded before Flop
Seat 2: Moszes360 folded before Flop (didn't bet)
Seat 4: DUkalisUA (button) collected ($13)
Seat 5: chippo boy (small blind) folded before Flop
Seat 6: WDW3 (big blind) folded before Flop
Seat 7: InsomniaRU folded before Flop (didn't bet)
Seat 8: myatiy 96 folded before Flop (didn't bet)
Seat 9: mrhighryza folded before Flop (didn't bet)





PokerStars Hand #150799107730:  Hold'em No Limit ($0.50/$1.00 USD) - 2016/03/23 13:23:26 CET [2016/03/23 8:23:26 ET]
Table 'Smiley' 9-max Seat #5 is the button
Seat 1: WDW3 ($100 in chips) 
Seat 2: Jimy Tiltman ($100 in chips) 
Seat 3: matiko09 ($128.35 in chips) 
Seat 4: Zeeshka ($100 in chips) 
Seat 5: DUkalisUA ($100 in chips) 
Seat 6: blackmont111 ($67.50 in chips) 
Seat 7: drosan ($52.12 in chips) 
Seat 8: RICKA16 ($110.56 in chips) 
Seat 9: morosun ($109.38 in chips) 
blackmont111: posts small blind $0.50
drosan: posts big blind $1
*** HOLE CARDS ***
Dealt to matiko09 [Ac Qh]
RICKA16: folds 
morosun: folds 
WDW3: folds 
Jimy Tiltman: folds 
matiko09: raises $2 to $3
Zeeshka: folds 
DUkalisUA: raises $5.50 to $8.50
blackmont111: calls $8
drosan has timed out
drosan: folds 
matiko09: calls $5.50
*** FLOP *** [Jc Ah 6d]
blackmont111: checks 
matiko09: bets $14
DUkalisUA: folds 
blackmont111: folds 
Uncalled bet ($14) returned to matiko09
matiko09 collected $25.31 from pot
matiko09: doesn't show hand 
*** SUMMARY ***
Total pot $26.50 | Rake $1.19 
Board [Jc Ah 6d]
Seat 1: WDW3 folded before Flop (didn't bet)
Seat 2: Jimy Tiltman folded before Flop (didn't bet)
Seat 3: matiko09 collected ($25.31)
Seat 4: Zeeshka folded before Flop (didn't bet)
Seat 5: DUkalisUA (button) folded on the Flop
Seat 6: blackmont111 (small blind) folded on the Flop
Seat 7: drosan (big blind) folded before Flop
Seat 8: RICKA16 folded before Flop (didn't bet)
Seat 9: morosun folded before Flop (didn't bet)





PokerStars Hand #150799112618:  Hold'em No Limit ($1/$2 USD) - 2016/03/23 13:23:35 CET [2016/03/23 8:23:35 ET]
Table 'Kypria II' 9-max Seat #9 is the button
Seat 1: geldwolfje ($267.62 in chips) 
Seat 2: coinflip_si ($200 in chips) 
Seat 3: seouljam ($80 in chips) 
Seat 4: nailz83 ($78.69 in chips) 
Seat 6: matiko09 ($253.64 in chips) 
Seat 7: ldwin8 ($401.09 in chips) 
Seat 8: Fish4trips ($297.52 in chips) 
Seat 9: WDW3 ($200 in chips) 
geldwolfje: posts small blind $1
coinflip_si: posts big blind $2
*** HOLE CARDS ***
Dealt to matiko09 [Ks 9c]
seouljam: folds 
nailz83: calls $2
matiko09: folds 
ldwin8: folds 
Fish4trips: folds 
WDW3: folds 
geldwolfje: calls $1
coinflip_si: checks 
*** FLOP *** [5c 8d 8h]
geldwolfje: checks 
coinflip_si: checks 
nailz83: checks 
*** TURN *** [5c 8d 8h] [2c]
geldwolfje: checks 
coinflip_si: checks 
nailz83: checks 
*** RIVER *** [5c 8d 8h 2c] [4c]
geldwolfje: checks 
coinflip_si: checks 
nailz83: bets $4
geldwolfje: calls $4
coinflip_si: folds 
*** SHOW DOWN ***
nailz83: shows [4h 2h] (two pair, Eights and Fours)
geldwolfje: shows [7s 4s] (two pair, Eights and Fours - Seven kicker)
geldwolfje collected $13.37 from pot
*** SUMMARY ***
Total pot $14 | Rake $0.63 
Board [5c 8d 8h 2c 4c]
Seat 1: geldwolfje (small blind) showed [7s 4s] and won ($13.37) with two pair, Eights and Fours
Seat 2: coinflip_si (big blind) folded on the River
Seat 3: seouljam folded before Flop (didn't bet)
Seat 4: nailz83 showed [4h 2h] and lost with two pair, Eights and Fours
Seat 6: matiko09 folded before Flop (didn't bet)
Seat 7: ldwin8 folded before Flop (didn't bet)
Seat 8: Fish4trips folded before Flop (didn't bet)
Seat 9: WDW3 (button) folded before Flop (didn't bet)





PokerStars Hand #150799115116:  Hold'em No Limit (€0.25/€0.50 EUR) - 2016/03/23 13:23:40 CET [2016/03/23 8:23:40 ET]
Table 'Hesperia II' 9-max Seat #4 is the button
Seat 4: Zelenis (€11.64 in chips) 
Seat 5: d-master850 (€27.02 in chips) 
Seat 6: CvMCvMCvM (€50.75 in chips) 
Seat 7: matiko09 (€54.38 in chips) 
Seat 8: Ahangama (€52 in chips) 
d-master850: posts small blind €0.25
CvMCvMCvM: posts big blind €0.50
IvanUrgant: sits out 
*** HOLE CARDS ***
Dealt to matiko09 [Jc 7d]
matiko09: folds 
Ahangama: folds 
Zelenis: calls €0.50
d-master850: calls €0.25
CvMCvMCvM: checks 
*** FLOP *** [5h 5c Qh]
ZonTTT joins the table at seat #9 
d-master850: checks 
CvMCvMCvM: checks 
Zelenis: checks 
*** TURN *** [5h 5c Qh] [6h]
d-master850: bets €0.50
CvMCvMCvM: folds 
Zelenis: folds 
Uncalled bet (€0.50) returned to d-master850
d-master850 collected €1.43 from pot
d-master850: doesn't show hand 
*** SUMMARY ***
Total pot €1.50 | Rake €0.07 
Board [5h 5c Qh 6h]
Seat 4: Zelenis (button) folded on the Turn
Seat 5: d-master850 (small blind) collected (€1.43)
Seat 6: CvMCvMCvM (big blind) folded on the Turn
Seat 7: matiko09 folded before Flop (didn't bet)
Seat 8: Ahangama folded before Flop (didn't bet)





PokerStars Hand #150799123506:  Hold'em No Limit ($0.25/$0.50 USD) - 2016/03/23 13:23:55 CET [2016/03/23 8:23:55 ET]
Table 'Belnika' 9-max Seat #2 is the button
Seat 1: yellowfever0 ($47.37 in chips) 
Seat 2: NeverRegret7 ($64.81 in chips) 
Seat 3: ChiChioChi ($38.99 in chips) 
Seat 4: matiko09 ($50 in chips) 
Seat 5: fandorin2005 ($52.64 in chips) 
Seat 6: Ahangama ($50 in chips) 
Seat 7: Zeeshka ($50 in chips) 
Seat 8: lumen21 ($50 in chips) 
Seat 9: dndngod ($70.12 in chips) 
ChiChioChi: posts small blind $0.25
matiko09: posts big blind $0.50
*** HOLE CARDS ***
Dealt to matiko09 [7d As]
fandorin2005: raises $0.75 to $1.25
Ahangama: folds 
Zeeshka: folds 
lumen21: calls $1.25
dndngod: folds 
yellowfever0: calls $1.25
NeverRegret7: folds 
ChiChioChi: folds 
matiko09: folds 
*** FLOP *** [Ts 9d 8h]
fandorin2005: checks 
lumen21: bets $3.31
yellowfever0: calls $3.31
fandorin2005: folds 
*** TURN *** [Ts 9d 8h] [8d]
lumen21: checks 
yellowfever0: bets $7
lumen21: raises $8.75 to $15.75
yellowfever0: calls $8.75
*** RIVER *** [Ts 9d 8h 8d] [8c]
lumen21: checks 
yellowfever0: checks 
*** SHOW DOWN ***
lumen21: shows [Jh Qh] (a straight, Eight to Queen)
yellowfever0: mucks hand 
lumen21 collected $40.70 from pot
*** SUMMARY ***
Total pot $42.62 | Rake $1.92 
Board [Ts 9d 8h 8d 8c]
Seat 1: yellowfever0 mucked [6d 4d]
Seat 2: NeverRegret7 (button) folded before Flop (didn't bet)
Seat 3: ChiChioChi (small blind) folded before Flop
Seat 4: matiko09 (big blind) folded before Flop
Seat 5: fandorin2005 folded on the Flop
Seat 6: Ahangama folded before Flop (didn't bet)
Seat 7: Zeeshka folded before Flop (didn't bet)
Seat 8: lumen21 showed [Jh Qh] and won ($40.70) with a straight, Eight to Queen
Seat 9: dndngod folded before Flop (didn't bet)





PokerStars Hand #150799129748:  Hold'em No Limit ($1/$2 USD) - 2016/03/23 13:24:07 CET [2016/03/23 8:24:07 ET]
Table 'Herba II' 9-max Seat #5 is the button
Seat 1: matiko09 ($238.52 in chips) 
Seat 2: Moszes360 ($233.20 in chips) 
Seat 4: DUkalisUA ($263.20 in chips) 
Seat 5: chippo boy ($199 in chips) 
Seat 6: WDW3 ($203.47 in chips) 
Seat 7: InsomniaRU ($233 in chips) 
Seat 8: myatiy 96 ($200 in chips) 
Seat 9: mrhighryza ($78.08 in chips) 
WDW3: posts small blind $1
InsomniaRU: posts big blind $2
Cirilico: sits out 
*** HOLE CARDS ***
Dealt to matiko09 [8c 6h]
myatiy 96: folds 
mrhighryza: folds 
matiko09: folds 
Moszes360: folds 
DUkalisUA: folds 
chippo boy: folds 
WDW3: folds 
Uncalled bet ($1) returned to InsomniaRU
InsomniaRU collected $2 from pot
InsomniaRU: doesn't show hand 
*** SUMMARY ***
Total pot $2 | Rake $0 
Seat 1: matiko09 folded before Flop (didn't bet)
Seat 2: Moszes360 folded before Flop (didn't bet)
Seat 4: DUkalisUA folded before Flop (didn't bet)
Seat 5: chippo boy (button) folded before Flop (didn't bet)
Seat 6: WDW3 (small blind) folded before Flop
Seat 7: InsomniaRU (big blind) collected ($2)
Seat 8: myatiy 96 folded before Flop (didn't bet)
Seat 9: mrhighryza folded before Flop (didn't bet)





PokerStars Hand #150799130290:  Hold'em No Limit ($0.50/$1.00 USD) - 2016/03/23 13:24:08 CET [2016/03/23 8:24:08 ET]
Table 'Kippes' 9-max Seat #3 is the button
Seat 1: Pvsx. ($100 in chips) 
Seat 2: RICKA16 ($124.92 in chips) 
Seat 3: CAJUN890 ($115.81 in chips) 
Seat 4: matiko09 ($100 in chips) 
Seat 5: Jimy Tiltman ($100 in chips) 
Seat 6: WDW3 ($100 in chips) 
Seat 7: lumen21 ($104 in chips) 
Seat 8: Zeeshka ($103.30 in chips) 
Seat 9: wang19790906 ($85.44 in chips) 
matiko09: posts small blind $0.50
Jimy Tiltman: posts big blind $1
*** HOLE CARDS ***
Dealt to matiko09 [6c 4d]
WDW3: folds 
lumen21: folds 
Zeeshka: folds 
wang19790906: raises $3 to $4
Pvsx.: folds 
RICKA16: folds 
CAJUN890: folds 
matiko09: folds 
Jimy Tiltman: folds 
Uncalled bet ($3) returned to wang19790906
wang19790906 collected $2.50 from pot
wang19790906: doesn't show hand 
*** SUMMARY ***
Total pot $2.50 | Rake $0 
Seat 1: Pvsx. folded before Flop (didn't bet)
Seat 2: RICKA16 folded before Flop (didn't bet)
Seat 3: CAJUN890 (button) folded before Flop (didn't bet)
Seat 4: matiko09 (small blind) folded before Flop
Seat 5: Jimy Tiltman (big blind) folded before Flop
Seat 6: WDW3 folded before Flop (didn't bet)
Seat 7: lumen21 folded before Flop (didn't bet)
Seat 8: Zeeshka folded before Flop (didn't bet)
Seat 9: wang19790906 collected ($2.50)





PokerStars Hand #150799131474:  Hold'em No Limit (€0.25/€0.50 EUR) - 2016/03/23 13:24:10 CET [2016/03/23 8:24:10 ET]
Table 'Hesperia II' 9-max Seat #5 is the button
Seat 4: Zelenis (€11.14 in chips) 
Seat 5: d-master850 (€27.95 in chips) 
Seat 6: CvMCvMCvM (€50.25 in chips) 
Seat 7: matiko09 (€54.38 in chips) 
Seat 8: Ahangama (€52 in chips) 
CvMCvMCvM: posts small blind €0.25
matiko09: posts big blind €0.50
ZonTTT: sits out 
IvanUrgant: sits out 
*** HOLE CARDS ***
Dealt to matiko09 [Ac 3c]
Ahangama: folds 
Zelenis: raises €1 to €1.50
d-master850: folds 
CvMCvMCvM: folds 
matiko09: folds 
Uncalled bet (€1) returned to Zelenis
Zelenis collected €1.25 from pot
Zelenis: doesn't show hand 
*** SUMMARY ***
Total pot €1.25 | Rake €0 
Seat 4: Zelenis collected (€1.25)
Seat 5: d-master850 (button) folded before Flop (didn't bet)
Seat 6: CvMCvMCvM (small blind) folded before Flop
Seat 7: matiko09 (big blind) folded before Flop
Seat 8: Ahangama folded before Flop (didn't bet)





PokerStars Hand #150799133585:  Hold'em No Limit ($1/$2 USD) - 2016/03/23 13:24:14 CET [2016/03/23 8:24:14 ET]
Table 'Kiess' 9-max Seat #8 is the button
Seat 1: ldwin8 ($218.11 in chips) 
Seat 2: DUkalisUA ($518.66 in chips) 
Seat 3: The_red_area ($200 in chips) 
Seat 5: chippo boy ($304.53 in chips) 
Seat 6: matiko09 ($251.64 in chips) 
Seat 7: InsomniaRU ($328.13 in chips) 
Seat 8: WDW3 ($404.60 in chips) 
Seat 9: Fish4trips ($200 in chips) 
Fish4trips: posts small blind $1
ldwin8: posts big blind $2
Moszes360: sits out 
*** HOLE CARDS ***
Dealt to matiko09 [6s 6h]
DUkalisUA: raises $4 to $6
The_red_area: folds 
chippo boy: folds 
matiko09: folds 
InsomniaRU: folds 
WDW3: folds 
Fish4trips: calls $5
ldwin8: calls $4
*** FLOP *** [2h 9h Tc]
Fish4trips: checks 
ldwin8: checks 
DUkalisUA: checks 
*** TURN *** [2h 9h Tc] [6d]
Fish4trips: checks 
ldwin8: bets $16
DUkalisUA: folds 
Fish4trips: folds 
Uncalled bet ($16) returned to ldwin8
ldwin8 collected $17.19 from pot
*** SUMMARY ***
Total pot $18 | Rake $0.81 
Board [2h 9h Tc 6d]
Seat 1: ldwin8 (big blind) collected ($17.19)
Seat 2: DUkalisUA folded on the Turn
Seat 3: The_red_area folded before Flop (didn't bet)
Seat 5: chippo boy folded before Flop (didn't bet)
Seat 6: matiko09 folded before Flop (didn't bet)
Seat 7: InsomniaRU folded before Flop (didn't bet)
Seat 8: WDW3 (button) folded before Flop (didn't bet)
Seat 9: Fish4trips (small blind) folded on the Turn





PokerStars Hand #150799134297:  Hold'em No Limit ($0.50/$1.00 USD) - 2016/03/23 13:24:16 CET [2016/03/23 8:24:16 ET]
Table 'Atlantis' 9-max Seat #8 is the button
Seat 1: xHourglass ($178.07 in chips) 
Seat 2: tffff2006 ($59.88 in chips) 
Seat 3: CAJUN890 ($109.33 in chips) 
Seat 4: matiko09 ($102.67 in chips) 
Seat 6: Jimy Tiltman ($112.74 in chips) 
Seat 7: Zeeshka ($100 in chips) 
Seat 8: lumen21 ($140.54 in chips) 
Seat 9: WDW3 ($117.47 in chips) 
WDW3: posts small blind $0.50
xHourglass: posts big blind $1
Pvsx.: sits out 
*** HOLE CARDS ***
Dealt to matiko09 [Kh Qs]
tffff2006: folds 
CAJUN890: folds 
matiko09: raises $2 to $3
Jimy Tiltman: folds 
Zeeshka: folds 
lumen21: folds 
WDW3: folds 
xHourglass: calls $2
*** FLOP *** [4h 5h 7d]
xHourglass: bets $4.65
matiko09: folds 
Uncalled bet ($4.65) returned to xHourglass
xHourglass collected $6.21 from pot
xHourglass: doesn't show hand 
*** SUMMARY ***
Total pot $6.50 | Rake $0.29 
Board [4h 5h 7d]
Seat 1: xHourglass (big blind) collected ($6.21)
Seat 2: tffff2006 folded before Flop (didn't bet)
Seat 3: CAJUN890 folded before Flop (didn't bet)
Seat 4: matiko09 folded on the Flop
Seat 6: Jimy Tiltman folded before Flop (didn't bet)
Seat 7: Zeeshka folded before Flop (didn't bet)
Seat 8: lumen21 (button) folded before Flop (didn't bet)
Seat 9: WDW3 (small blind) folded before Flop





PokerStars Hand #150799139575:  Hold'em No Limit (€0.25/€0.50 EUR) - 2016/03/23 13:24:25 CET [2016/03/23 8:24:25 ET]
Table 'Hesperia II' 9-max Seat #6 is the button
Seat 4: Zelenis (€11.89 in chips) 
Seat 5: d-master850 (€27.95 in chips) 
Seat 6: CvMCvMCvM (€50 in chips) 
Seat 7: matiko09 (€53.88 in chips) 
Seat 8: Ahangama (€52 in chips) 
matiko09: posts small blind €0.25
Ahangama: posts big blind €0.50
ZonTTT: sits out 
IvanUrgant: sits out 
*** HOLE CARDS ***
Dealt to matiko09 [6h Ad]
Zelenis: folds 
d-master850: folds 
CvMCvMCvM: folds 
matiko09: raises €1 to €1.50
Ahangama: calls €1
*** FLOP *** [6d 3h 2d]
dndngod joins the table at seat #2 
matiko09: checks 
Ahangama: bets €2
matiko09: calls €2
*** TURN *** [6d 3h 2d] [5d]
matiko09: checks 
Ahangama: checks 
*** RIVER *** [6d 3h 2d 5d] [2c]
matiko09: checks 
Ahangama: checks 
*** SHOW DOWN ***
matiko09: shows [6h Ad] (two pair, Sixes and Deuces)
Ahangama: mucks hand 
matiko09 collected €6.68 from pot
*** SUMMARY ***
Total pot €7 | Rake €0.32 
Board [6d 3h 2d 5d 2c]
Seat 4: Zelenis folded before Flop (didn't bet)
Seat 5: d-master850 folded before Flop (didn't bet)
Seat 6: CvMCvMCvM (button) folded before Flop (didn't bet)
Seat 7: matiko09 (small blind) showed [6h Ad] and won (€6.68) with two pair, Sixes and Deuces
Seat 8: Ahangama (big blind) mucked [5h 7h]





PokerStars Hand #150799142741:  Hold'em No Limit ($0.25/$0.50 USD) - 2016/03/23 13:24:31 CET [2016/03/23 8:24:31 ET]
Table 'Pyrrhus' 9-max Seat #2 is the button
Seat 1: 1Maxx123 ($52.47 in chips) 
Seat 2: fandorin2005 ($50 in chips) 
Seat 3: IvanUrgant ($50 in chips) 
Seat 4: GriffinBerg ($50 in chips) 
Seat 5: lengcunjuan ($29.96 in chips) 
Seat 6: whalldo ($138.61 in chips) 
Seat 7: matiko09 ($115.40 in chips) 
Seat 8: dndngod ($61.70 in chips) 
Seat 9: CvMCvMCvM ($64.66 in chips) 
IvanUrgant: posts small blind $0.25
GriffinBerg: posts big blind $0.50
*** HOLE CARDS ***
Dealt to matiko09 [7d Qs]
lengcunjuan: folds 
whalldo: folds 
matiko09: folds 
dndngod: raises $1 to $1.50
CvMCvMCvM: folds 
1Maxx123: folds 
fandorin2005: folds 
IvanUrgant: folds 
GriffinBerg: calls $1
*** FLOP *** [Qd 2c 9c]
GriffinBerg: bets $1.55
dndngod: calls $1.55
*** TURN *** [Qd 2c 9c] [5h]
GriffinBerg: bets $3.03
dndngod: calls $3.03
*** RIVER *** [Qd 2c 9c 5h] [As]
GriffinBerg: checks 
dndngod: checks 
*** SHOW DOWN ***
GriffinBerg: shows [Jc 7c] (high card Ace)
dndngod: shows [Th Tc] (a pair of Tens)
dndngod collected $11.85 from pot
*** SUMMARY ***
Total pot $12.41 | Rake $0.56 
Board [Qd 2c 9c 5h As]
Seat 1: 1Maxx123 folded before Flop (didn't bet)
Seat 2: fandorin2005 (button) folded before Flop (didn't bet)
Seat 3: IvanUrgant (small blind) folded before Flop
Seat 4: GriffinBerg (big blind) showed [Jc 7c] and lost with high card Ace
Seat 5: lengcunjuan folded before Flop (didn't bet)
Seat 6: whalldo folded before Flop (didn't bet)
Seat 7: matiko09 folded before Flop (didn't bet)
Seat 8: dndngod showed [Th Tc] and won ($11.85) with a pair of Tens
Seat 9: CvMCvMCvM folded before Flop (didn't bet)





PokerStars Hand #150799142803:  Hold'em No Limit ($1/$2 USD) - 2016/03/23 13:24:32 CET [2016/03/23 8:24:32 ET]
Table 'Herba II' 9-max Seat #6 is the button
Seat 1: matiko09 ($238.52 in chips) 
Seat 2: Moszes360 ($233.20 in chips) 
Seat 4: DUkalisUA ($263.20 in chips) 
Seat 5: chippo boy ($199 in chips) 
Seat 6: WDW3 ($202.47 in chips) 
Seat 7: InsomniaRU ($234 in chips) 
Seat 9: mrhighryza ($78.08 in chips) 
InsomniaRU: posts small blind $1
myatiy 96: is sitting out 
mrhighryza: posts big blind $2
Cirilico: sits out 
*** HOLE CARDS ***
Dealt to matiko09 [Jd 8h]
matiko09: folds 
myatiy 96 leaves the table
Moszes360: folds 
DUkalisUA: folds 
The_red_area joins the table at seat #8 
chippo boy: calls $2
WDW3: folds 
InsomniaRU: folds 
mrhighryza: checks 
*** FLOP *** [Kc 5h 4s]
mrhighryza: checks 
chippo boy: checks 
*** TURN *** [Kc 5h 4s] [2d]
mrhighryza: checks 
chippo boy: checks 
*** RIVER *** [Kc 5h 4s 2d] [9c]
mrhighryza: checks 
chippo boy: checks 
*** SHOW DOWN ***
mrhighryza: shows [Tc 6s] (high card King)
chippo boy: shows [Ah 7s] (high card Ace)
chippo boy collected $4.78 from pot
*** SUMMARY ***
Total pot $5 | Rake $0.22 
Board [Kc 5h 4s 2d 9c]
Seat 1: matiko09 folded before Flop (didn't bet)
Seat 2: Moszes360 folded before Flop (didn't bet)
Seat 4: DUkalisUA folded before Flop (didn't bet)
Seat 5: chippo boy showed [Ah 7s] and won ($4.78) with high card Ace
Seat 6: WDW3 (button) folded before Flop (didn't bet)
Seat 7: InsomniaRU (small blind) folded before Flop
Seat 9: mrhighryza (big blind) showed [Tc 6s] and lost with high card King





PokerStars Hand #150799144641:  Hold'em No Limit ($0.50/$1.00 USD) - 2016/03/23 13:24:35 CET [2016/03/23 8:24:35 ET]
Table 'Kippes' 9-max Seat #4 is the button
Seat 1: Pvsx. ($100 in chips) 
Seat 2: RICKA16 ($124.92 in chips) 
Seat 3: CAJUN890 ($115.81 in chips) 
Seat 4: matiko09 ($100 in chips) 
Seat 5: Jimy Tiltman ($100 in chips) 
Seat 6: WDW3 ($100 in chips) 
Seat 7: lumen21 ($104 in chips) 
Seat 8: Zeeshka ($103.30 in chips) 
Seat 9: wang19790906 ($86.94 in chips) 
Jimy Tiltman: posts small blind $0.50
WDW3: posts big blind $1
*** HOLE CARDS ***
Dealt to matiko09 [9d 5d]
lumen21: folds 
Zeeshka: folds 
wang19790906: folds 
Pvsx.: raises $1.50 to $2.50
RICKA16: folds 
CAJUN890: folds 
matiko09: folds 
Jimy Tiltman: folds 
WDW3: calls $1.50
*** FLOP *** [5c Js 6h]
WDW3: checks 
Pvsx.: bets $2.62
WDW3: calls $2.62
*** TURN *** [5c Js 6h] [4h]
WDW3: checks 
Pvsx.: bets $6
WDW3: calls $6
*** RIVER *** [5c Js 6h 4h] [5h]
WDW3: checks 
Pvsx.: bets $15
WDW3: raises $73.88 to $88.88 and is all-in
Pvsx.: folds 
Uncalled bet ($73.88) returned to WDW3
WDW3 collected $50.37 from pot
WDW3: doesn't show hand 
*** SUMMARY ***
Total pot $52.74 | Rake $2.37 
Board [5c Js 6h 4h 5h]
Seat 1: Pvsx. folded on the River
Seat 2: RICKA16 folded before Flop (didn't bet)
Seat 3: CAJUN890 folded before Flop (didn't bet)
Seat 4: matiko09 (button) folded before Flop (didn't bet)
Seat 5: Jimy Tiltman (small blind) folded before Flop
Seat 6: WDW3 (big blind) collected ($50.37)
Seat 7: lumen21 folded before Flop (didn't bet)
Seat 8: Zeeshka folded before Flop (didn't bet)
Seat 9: wang19790906 folded before Flop (didn't bet)





PokerStars Hand #150799151148:  Hold'em No Limit ($0.50/$1.00 USD) - 2016/03/23 13:24:47 CET [2016/03/23 8:24:47 ET]
Table 'Oljato' 9-max Seat #8 is the button
Seat 1: Pearl Jam87 ($203.40 in chips) 
Seat 2: roman134679 ($77.23 in chips) 
Seat 3: DUkalisUA ($100 in chips) 
Seat 4: Pvsx. ($106.31 in chips) 
Seat 5: ryo728 ($75.19 in chips) 
Seat 6: WDW3 ($134.51 in chips) 
Seat 7: matiko09 ($162.73 in chips) 
Seat 8: Zeeshka ($354.64 in chips) 
Seat 9: Jimy Tiltman ($100 in chips) 
Jimy Tiltman: posts small blind $0.50
Pearl Jam87: posts big blind $1
*** HOLE CARDS ***
Dealt to matiko09 [Td 9d]
roman134679: calls $1
DUkalisUA: folds 
Pvsx.: folds 
ryo728: folds 
WDW3: folds 
matiko09: raises $3 to $4
Zeeshka: folds 
Jimy Tiltman: calls $3.50
Pearl Jam87: calls $3
roman134679: calls $3
*** FLOP *** [Ad 7h 8c]
Jimy Tiltman: bets $8
Pearl Jam87: folds 
roman134679: folds 
matiko09: calls $8
*** TURN *** [Ad 7h 8c] [Tc]
Jimy Tiltman: checks 
matiko09: checks 
*** RIVER *** [Ad 7h 8c Tc] [8d]
Jimy Tiltman: bets $16
matiko09: folds 
Uncalled bet ($16) returned to Jimy Tiltman
Jimy Tiltman collected $30.56 from pot
Jimy Tiltman: doesn't show hand 
*** SUMMARY ***
Total pot $32 | Rake $1.44 
Board [Ad 7h 8c Tc 8d]
Seat 1: Pearl Jam87 (big blind) folded on the Flop
Seat 2: roman134679 folded on the Flop
Seat 3: DUkalisUA folded before Flop (didn't bet)
Seat 4: Pvsx. folded before Flop (didn't bet)
Seat 5: ryo728 folded before Flop (didn't bet)
Seat 6: WDW3 folded before Flop (didn't bet)
Seat 7: matiko09 folded on the River
Seat 8: Zeeshka (button) folded before Flop (didn't bet)
Seat 9: Jimy Tiltman (small blind) collected ($30.56)





PokerStars Hand #150799156872:  Hold'em No Limit ($0.50/$1.00 USD) - 2016/03/23 13:24:58 CET [2016/03/23 8:24:58 ET]
Table 'Atlantis' 9-max Seat #9 is the button
Seat 1: xHourglass ($181.28 in chips) 
Seat 2: tffff2006 ($59.88 in chips) 
Seat 3: CAJUN890 ($109.33 in chips) 
Seat 4: matiko09 ($100 in chips) 
Seat 6: Jimy Tiltman ($112.74 in chips) 
Seat 7: Zeeshka ($100 in chips) 
Seat 8: lumen21 ($140.54 in chips) 
Seat 9: WDW3 ($116.97 in chips) 
xHourglass: posts small blind $0.50
tffff2006: posts big blind $1
Pvsx.: sits out 
*** HOLE CARDS ***
Dealt to matiko09 [Ad 6s]
CAJUN890: folds 
matiko09: folds 
Jimy Tiltman: folds 
Zeeshka: raises $2 to $3
lumen21: calls $3
WDW3: folds 
xHourglass: folds 
tffff2006: calls $2
*** FLOP *** [9s 7h 5s]
tffff2006: checks 
Zeeshka: bets $6.07
lumen21: folds 
tffff2006: calls $6.07
*** TURN *** [9s 7h 5s] [9d]
tffff2006: checks 
Zeeshka: checks 
*** RIVER *** [9s 7h 5s 9d] [Tc]
tffff2006: bets $11
Zeeshka: calls $11
*** SHOW DOWN ***
tffff2006: shows [2s 4s] (a pair of Nines)
Zeeshka: shows [Kd Kh] (two pair, Kings and Nines)
Zeeshka collected $41.68 from pot
*** SUMMARY ***
Total pot $43.64 | Rake $1.96 
Board [9s 7h 5s 9d Tc]
Seat 1: xHourglass (small blind) folded before Flop
Seat 2: tffff2006 (big blind) showed [2s 4s] and lost with a pair of Nines
Seat 3: CAJUN890 folded before Flop (didn't bet)
Seat 4: matiko09 folded before Flop (didn't bet)
Seat 6: Jimy Tiltman folded before Flop (didn't bet)
Seat 7: Zeeshka showed [Kd Kh] and won ($41.68) with two pair, Kings and Nines
Seat 8: lumen21 folded on the Flop
Seat 9: WDW3 (button) folded before Flop (didn't bet)





PokerStars Hand #150799157622:  Hold'em No Limit ($1/$2 USD) - 2016/03/23 13:25:00 CET [2016/03/23 8:25:00 ET]
Table 'Kypria II' 9-max Seat #1 is the button
Seat 1: geldwolfje ($274.99 in chips) 
Seat 2: coinflip_si ($200 in chips) 
Seat 3: seouljam ($80 in chips) 
Seat 4: nailz83 ($72.69 in chips) 
Seat 6: matiko09 ($253.64 in chips) 
Seat 7: ldwin8 ($401.09 in chips) 
Seat 8: Fish4trips ($297.52 in chips) 
Seat 9: WDW3 ($200 in chips) 
coinflip_si: posts small blind $1
seouljam: posts big blind $2
*** HOLE CARDS ***
Dealt to matiko09 [3c 5s]
nailz83: calls $2
matiko09: folds 
ldwin8: folds 
Fish4trips: raises $5 to $7
WDW3: calls $7
geldwolfje: calls $7
coinflip_si: folds 
seouljam: folds 
nailz83: calls $5
*** FLOP *** [3s 8c Ah]
nailz83: checks 
Fish4trips: bets $18.65
WDW3: folds 
geldwolfje: folds 
nailz83: folds 
Uncalled bet ($18.65) returned to Fish4trips
Fish4trips collected $29.60 from pot
Fish4trips: doesn't show hand 
*** SUMMARY ***
Total pot $31 | Rake $1.40 
Board [3s 8c Ah]
Seat 1: geldwolfje (button) folded on the Flop
Seat 2: coinflip_si (small blind) folded before Flop
Seat 3: seouljam (big blind) folded before Flop
Seat 4: nailz83 folded on the Flop
Seat 6: matiko09 folded before Flop (didn't bet)
Seat 7: ldwin8 folded before Flop (didn't bet)
Seat 8: Fish4trips collected ($29.60)
Seat 9: WDW3 folded on the Flop





PokerStars Hand #150799161061:  Hold'em No Limit ($1/$2 USD) - 2016/03/23 13:25:07 CET [2016/03/23 8:25:07 ET]
Table 'Herba II' 9-max Seat #7 is the button
Seat 1: matiko09 ($238.52 in chips) 
Seat 2: Moszes360 ($233.20 in chips) 
Seat 4: DUkalisUA ($263.20 in chips) 
Seat 5: chippo boy ($201.78 in chips) 
Seat 6: WDW3 ($202.47 in chips) 
Seat 7: InsomniaRU ($233 in chips) 
Seat 9: mrhighryza ($76.08 in chips) 
The_red_area will be allowed to play after the button
mrhighryza: posts small blind $1
matiko09: posts big blind $2
Cirilico: sits out 
*** HOLE CARDS ***
Dealt to matiko09 [2d Ah]
Moszes360: folds 
DUkalisUA: folds 
chippo boy: raises $4 to $6
WDW3: folds 
InsomniaRU: folds 
mrhighryza: calls $5
matiko09: folds 
*** FLOP *** [Kd 8s 5s]
mrhighryza: checks 
chippo boy: bets $6
mrhighryza: folds 
Uncalled bet ($6) returned to chippo boy
chippo boy collected $13.37 from pot
*** SUMMARY ***
Total pot $14 | Rake $0.63 
Board [Kd 8s 5s]
Seat 1: matiko09 (big blind) folded before Flop
Seat 2: Moszes360 folded before Flop (didn't bet)
Seat 4: DUkalisUA folded before Flop (didn't bet)
Seat 5: chippo boy collected ($13.37)
Seat 6: WDW3 folded before Flop (didn't bet)
Seat 7: InsomniaRU (button) folded before Flop (didn't bet)
Seat 9: mrhighryza (small blind) folded on the Flop





PokerStars Hand #150799172315:  Hold'em No Limit (€0.25/€0.50 EUR) - 2016/03/23 13:25:28 CET [2016/03/23 8:25:28 ET]
Table 'Hesperia II' 9-max Seat #7 is the button
Seat 4: Zelenis (€11.89 in chips) 
Seat 5: d-master850 (€27.95 in chips) 
Seat 6: CvMCvMCvM (€50 in chips) 
Seat 7: matiko09 (€57.06 in chips) 
Seat 8: Ahangama (€50 in chips) 
Seat 9: ZonTTT (€50 in chips) 
Ahangama: posts small blind €0.25
ZonTTT: posts big blind €0.50
dndngod: sits out 
IvanUrgant: sits out 
*** HOLE CARDS ***
Dealt to matiko09 [5d 4h]
Zelenis: folds 
d-master850: folds 
CvMCvMCvM: folds 
matiko09: folds 
Ahangama: folds 
Uncalled bet (€0.25) returned to ZonTTT
ZonTTT collected €0.50 from pot
ZonTTT: doesn't show hand 
*** SUMMARY ***
Total pot €0.50 | Rake €0 
Seat 4: Zelenis folded before Flop (didn't bet)
Seat 5: d-master850 folded before Flop (didn't bet)
Seat 6: CvMCvMCvM folded before Flop (didn't bet)
Seat 7: matiko09 (button) folded before Flop (didn't bet)
Seat 8: Ahangama (small blind) folded before Flop
Seat 9: ZonTTT (big blind) collected (€0.50)





PokerStars Hand #150799173592:  Hold'em No Limit ($0.25/$0.50 USD) - 2016/03/23 13:25:31 CET [2016/03/23 8:25:31 ET]
Table 'Pyrrhus' 9-max Seat #3 is the button
Seat 1: 1Maxx123 ($52.47 in chips) 
Seat 2: fandorin2005 ($50 in chips) 
Seat 3: IvanUrgant ($50 in chips) 
Seat 4: GriffinBerg ($43.92 in chips) 
Seat 5: lengcunjuan ($29.96 in chips) 
Seat 6: whalldo ($138.61 in chips) 
Seat 7: matiko09 ($115.40 in chips) 
Seat 8: dndngod ($67.47 in chips) 
Seat 9: CvMCvMCvM ($64.66 in chips) 
GriffinBerg: posts small blind $0.25
lengcunjuan: posts big blind $0.50
*** HOLE CARDS ***
Dealt to matiko09 [4d 6h]
whalldo: folds 
matiko09: folds 
dndngod: folds 
CvMCvMCvM: folds 
1Maxx123: folds 
fandorin2005: folds 
IvanUrgant: raises $0.50 to $1
GriffinBerg: folds 
lengcunjuan: raises $2.25 to $3.25
IvanUrgant: folds 
Uncalled bet ($2.25) returned to lengcunjuan
lengcunjuan collected $2.25 from pot
lengcunjuan: doesn't show hand 
*** SUMMARY ***
Total pot $2.25 | Rake $0 
Seat 1: 1Maxx123 folded before Flop (didn't bet)
Seat 2: fandorin2005 folded before Flop (didn't bet)
Seat 3: IvanUrgant (button) folded before Flop
Seat 4: GriffinBerg (small blind) folded before Flop
Seat 5: lengcunjuan (big blind) collected ($2.25)
Seat 6: whalldo folded before Flop (didn't bet)
Seat 7: matiko09 folded before Flop (didn't bet)
Seat 8: dndngod folded before Flop (didn't bet)
Seat 9: CvMCvMCvM folded before Flop (didn't bet)





PokerStars Hand #150799177089:  Hold'em No Limit ($1/$2 USD) - 2016/03/23 13:25:37 CET [2016/03/23 8:25:37 ET]
Table 'Kiess' 9-max Seat #9 is the button
Seat 1: ldwin8 ($229.30 in chips) 
Seat 2: DUkalisUA ($512.66 in chips) 
Seat 3: The_red_area ($200 in chips) 
Seat 5: chippo boy ($304.53 in chips) 
Seat 6: matiko09 ($251.64 in chips) 
Seat 7: InsomniaRU ($328.13 in chips) 
Seat 8: WDW3 ($404.60 in chips) 
Seat 9: Fish4trips ($200 in chips) 
ldwin8: posts small blind $1
DUkalisUA: posts big blind $2
Moszes360: sits out 
*** HOLE CARDS ***
Dealt to matiko09 [3s 4h]
The_red_area: folds 
chippo boy: folds 
matiko09: folds 
InsomniaRU: raises $3 to $5
WDW3: folds 
Fish4trips: raises $10 to $15
ldwin8: folds 
DUkalisUA: folds 
InsomniaRU: raises $27 to $42
Fish4trips: folds 
Uncalled bet ($27) returned to InsomniaRU
InsomniaRU collected $33 from pot
InsomniaRU: doesn't show hand 
*** SUMMARY ***
Total pot $33 | Rake $0 
Seat 1: ldwin8 (small blind) folded before Flop
Seat 2: DUkalisUA (big blind) folded before Flop
Seat 3: The_red_area folded before Flop (didn't bet)
Seat 5: chippo boy folded before Flop (didn't bet)
Seat 6: matiko09 folded before Flop (didn't bet)
Seat 7: InsomniaRU collected ($33)
Seat 8: WDW3 folded before Flop (didn't bet)
Seat 9: Fish4trips (button) folded before Flop





PokerStars Hand #150799178197:  Hold'em No Limit (€0.25/€0.50 EUR) - 2016/03/23 13:25:40 CET [2016/03/23 8:25:40 ET]
Table 'Hesperia II' 9-max Seat #8 is the button
Seat 2: dndngod (€50 in chips) 
Seat 4: Zelenis (€11.89 in chips) 
Seat 5: d-master850 (€27.95 in chips) 
Seat 6: CvMCvMCvM (€50 in chips) 
Seat 7: matiko09 (€57.06 in chips) 
Seat 8: Ahangama (€50 in chips) 
Seat 9: ZonTTT (€50.25 in chips) 
ZonTTT: posts small blind €0.25
dndngod: posts big blind €0.50
IvanUrgant: sits out 
*** HOLE CARDS ***
Dealt to matiko09 [Td 7c]
Zelenis: folds 
d-master850: folds 
CvMCvMCvM: folds 
matiko09: folds 
Ahangama: folds 
ZonTTT: folds 
Uncalled bet (€0.25) returned to dndngod
dndngod collected €0.50 from pot
dndngod: doesn't show hand 
*** SUMMARY ***
Total pot €0.50 | Rake €0 
Seat 2: dndngod (big blind) collected (€0.50)
Seat 4: Zelenis folded before Flop (didn't bet)
Seat 5: d-master850 folded before Flop (didn't bet)
Seat 6: CvMCvMCvM folded before Flop (didn't bet)
Seat 7: matiko09 folded before Flop (didn't bet)
Seat 8: Ahangama (button) folded before Flop (didn't bet)
Seat 9: ZonTTT (small blind) folded before Flop





PokerStars Hand #150799178544:  Hold'em No Limit ($0.50/$1.00 USD) - 2016/03/23 13:25:40 CET [2016/03/23 8:25:40 ET]
Table 'Smiley' 9-max Seat #6 is the button
Seat 1: WDW3 ($100 in chips) 
Seat 2: Jimy Tiltman ($100 in chips) 
Seat 3: matiko09 ($145.16 in chips) 
Seat 4: Zeeshka ($100 in chips) 
Seat 5: DUkalisUA ($100 in chips) 
Seat 6: blackmont111 ($59 in chips) 
Seat 8: RICKA16 ($110.56 in chips) 
Seat 9: morosun ($109.38 in chips) 
RICKA16: posts small blind $0.50
morosun: posts big blind $1
*** HOLE CARDS ***
Dealt to matiko09 [4s Ks]
WDW3: folds 
Jimy Tiltman: folds 
matiko09: folds 
Zeeshka: folds 
DUkalisUA: folds 
blackmont111: folds 
RICKA16: raises $2 to $3
morosun: calls $2
*** FLOP *** [Tc 9h 3s]
RICKA16: bets $2
morosun: folds 
Uncalled bet ($2) returned to RICKA16
RICKA16 collected $5.73 from pot
RICKA16: doesn't show hand 
*** SUMMARY ***
Total pot $6 | Rake $0.27 
Board [Tc 9h 3s]
Seat 1: WDW3 folded before Flop (didn't bet)
Seat 2: Jimy Tiltman folded before Flop (didn't bet)
Seat 3: matiko09 folded before Flop (didn't bet)
Seat 4: Zeeshka folded before Flop (didn't bet)
Seat 5: DUkalisUA folded before Flop (didn't bet)
Seat 6: blackmont111 (button) folded before Flop (didn't bet)
Seat 8: RICKA16 (small blind) collected ($5.73)
Seat 9: morosun (big blind) folded on the Flop





PokerStars Hand #150799179269:  Hold'em No Limit ($1/$2 USD) - 2016/03/23 13:25:42 CET [2016/03/23 8:25:42 ET]
Table 'Herba II' 9-max Seat #9 is the button
Seat 1: matiko09 ($236.52 in chips) 
Seat 2: Moszes360 ($233.20 in chips) 
Seat 4: DUkalisUA ($263.20 in chips) 
Seat 5: chippo boy ($209.15 in chips) 
Seat 6: WDW3 ($202.47 in chips) 
Seat 7: InsomniaRU ($233 in chips) 
Seat 9: mrhighryza ($70.08 in chips) 
matiko09: posts small blind $1
Moszes360: posts big blind $2
Cirilico: sits out 
The_red_area: sits out 
*** HOLE CARDS ***
Dealt to matiko09 [6d 4d]
DUkalisUA: raises $4 to $6
chippo boy: calls $6
WDW3: calls $6
InsomniaRU: folds 
mrhighryza: calls $6
matiko09: folds 
Moszes360: folds 
*** FLOP *** [Ac 2s Ah]
DUkalisUA: checks 
chippo boy: checks 
WDW3: checks 
mrhighryza: checks 
*** TURN *** [Ac 2s Ah] [8d]
DUkalisUA: checks 
chippo boy: checks 
WDW3: checks 
mrhighryza: bets $8
DUkalisUA: folds 
chippo boy: folds 
WDW3: folds 
Uncalled bet ($8) returned to mrhighryza
mrhighryza collected $25.78 from pot
*** SUMMARY ***
Total pot $27 | Rake $1.22 
Board [Ac 2s Ah 8d]
Seat 1: matiko09 (small blind) folded before Flop
Seat 2: Moszes360 (big blind) folded before Flop
Seat 4: DUkalisUA folded on the Turn
Seat 5: chippo boy folded on the Turn
Seat 6: WDW3 folded on the Turn
Seat 7: InsomniaRU folded before Flop (didn't bet)
Seat 9: mrhighryza (button) collected ($25.78)





PokerStars Hand #150799185235:  Hold'em No Limit ($0.25/$0.50 USD) - 2016/03/23 13:25:53 CET [2016/03/23 8:25:53 ET]
Table 'Pyrrhus' 9-max Seat #4 is the button
Seat 1: 1Maxx123 ($52.47 in chips) 
Seat 2: fandorin2005 ($50 in chips) 
Seat 3: IvanUrgant ($50 in chips) 
Seat 4: GriffinBerg ($43.67 in chips) 
Seat 5: lengcunjuan ($31.21 in chips) 
Seat 6: whalldo ($138.61 in chips) 
Seat 7: matiko09 ($115.40 in chips) 
Seat 8: dndngod ($67.47 in chips) 
Seat 9: CvMCvMCvM ($64.66 in chips) 
lengcunjuan: posts small blind $0.25
whalldo: posts big blind $0.50
*** HOLE CARDS ***
Dealt to matiko09 [9s 6d]
matiko09: folds 
dndngod: folds 
CvMCvMCvM: folds 
1Maxx123: folds 
fandorin2005: folds 
IvanUrgant: folds 
GriffinBerg: raises $1 to $1.50
lengcunjuan: calls $1.25
whalldo: raises $5 to $6.50
GriffinBerg: folds 
lengcunjuan: folds 
Uncalled bet ($5) returned to whalldo
whalldo collected $4.50 from pot
whalldo: doesn't show hand 
*** SUMMARY ***
Total pot $4.50 | Rake $0 
Seat 1: 1Maxx123 folded before Flop (didn't bet)
Seat 2: fandorin2005 folded before Flop (didn't bet)
Seat 3: IvanUrgant folded before Flop (didn't bet)
Seat 4: GriffinBerg (button) folded before Flop
Seat 5: lengcunjuan (small blind) folded before Flop
Seat 6: whalldo (big blind) collected ($4.50)
Seat 7: matiko09 folded before Flop (didn't bet)
Seat 8: dndngod folded before Flop (didn't bet)
Seat 9: CvMCvMCvM folded before Flop (didn't bet)





PokerStars Hand #150799186109:  Hold'em No Limit ($0.25/$0.50 USD) - 2016/03/23 13:25:55 CET [2016/03/23 8:25:55 ET]
Table 'Belnika' 9-max Seat #3 is the button
Seat 1: yellowfever0 ($27.06 in chips) 
Seat 2: NeverRegret7 ($64.81 in chips) 
Seat 3: ChiChioChi ($38.74 in chips) 
Seat 4: matiko09 ($50 in chips) 
Seat 5: fandorin2005 ($51.39 in chips) 
Seat 6: Ahangama ($50 in chips) 
Seat 7: Zeeshka ($50 in chips) 
Seat 8: lumen21 ($70.39 in chips) 
Seat 9: dndngod ($70.12 in chips) 
matiko09: posts small blind $0.25
fandorin2005: posts big blind $0.50
*** HOLE CARDS ***
Dealt to matiko09 [Ah Jd]
Ahangama: folds 
Zeeshka: folds 
lumen21: folds 
dndngod: raises $1.25 to $1.75
yellowfever0: calls $1.75
NeverRegret7: folds 
ChiChioChi: calls $1.75
matiko09: raises $6.25 to $8
fandorin2005: folds 
dndngod: folds 
yellowfever0: folds 
ChiChioChi: calls $6.25
*** FLOP *** [7d 6s 7h]
matiko09: checks 
ChiChioChi: checks 
*** TURN *** [7d 6s 7h] [8s]
matiko09: checks 
ChiChioChi: bets $6
matiko09: calls $6
*** RIVER *** [7d 6s 7h 8s] [Ad]
matiko09: checks 
ChiChioChi: checks 
*** SHOW DOWN ***
matiko09: shows [Ah Jd] (two pair, Aces and Sevens)
ChiChioChi: mucks hand 
matiko09 collected $30.56 from pot
*** SUMMARY ***
Total pot $32 | Rake $1.44 
Board [7d 6s 7h 8s Ad]
Seat 1: yellowfever0 folded before Flop
Seat 2: NeverRegret7 folded before Flop (didn't bet)
Seat 3: ChiChioChi (button) mucked [9c 8c]
Seat 4: matiko09 (small blind) showed [Ah Jd] and won ($30.56) with two pair, Aces and Sevens
Seat 5: fandorin2005 (big blind) folded before Flop
Seat 6: Ahangama folded before Flop (didn't bet)
Seat 7: Zeeshka folded before Flop (didn't bet)
Seat 8: lumen21 folded before Flop (didn't bet)
Seat 9: dndngod folded before Flop





PokerStars Hand #150799191811:  Hold'em No Limit (€0.25/€0.50 EUR) - 2016/03/23 13:26:06 CET [2016/03/23 8:26:06 ET]
Table 'Hesperia II' 9-max Seat #9 is the button
Seat 2: dndngod (€50.25 in chips) 
Seat 3: IvanUrgant (€50 in chips) 
Seat 4: Zelenis (€11.89 in chips) 
Seat 5: d-master850 (€27.95 in chips) 
Seat 6: CvMCvMCvM (€50 in chips) 
Seat 7: matiko09 (€57.06 in chips) 
Seat 8: Ahangama (€50 in chips) 
Seat 9: ZonTTT (€50 in chips) 
dndngod: posts small blind €0.25
IvanUrgant: posts big blind €0.50
*** HOLE CARDS ***
Dealt to matiko09 [6s Kd]
Zelenis: folds 
d-master850: raises €1 to €1.50
CvMCvMCvM: folds 
matiko09: folds 
Ahangama: folds 
ZonTTT: folds 
dndngod: folds 
IvanUrgant: folds 
Uncalled bet (€1) returned to d-master850
d-master850 collected €1.25 from pot
d-master850: doesn't show hand 
*** SUMMARY ***
Total pot €1.25 | Rake €0 
Seat 2: dndngod (small blind) folded before Flop
Seat 3: IvanUrgant (big blind) folded before Flop
Seat 4: Zelenis folded before Flop (didn't bet)
Seat 5: d-master850 collected (€1.25)
Seat 6: CvMCvMCvM folded before Flop (didn't bet)
Seat 7: matiko09 folded before Flop (didn't bet)
Seat 8: Ahangama folded before Flop (didn't bet)
Seat 9: ZonTTT (button) folded before Flop (didn't bet)





PokerStars Hand #150799192117:  Hold'em No Limit ($1/$2 USD) - 2016/03/23 13:26:07 CET [2016/03/23 8:26:07 ET]
Table 'Kypria II' 9-max Seat #2 is the button
Seat 1: geldwolfje ($267.99 in chips) 
Seat 2: coinflip_si ($200 in chips) 
Seat 3: seouljam ($78 in chips) 
Seat 4: nailz83 ($65.69 in chips) 
Seat 6: matiko09 ($253.64 in chips) 
Seat 7: ldwin8 ($401.09 in chips) 
Seat 8: Fish4trips ($320.12 in chips) 
Seat 9: WDW3 ($200 in chips) 
seouljam: posts small blind $1
nailz83: posts big blind $2
*** HOLE CARDS ***
Dealt to matiko09 [5s 7d]
matiko09: folds 
ldwin8: folds 
Fish4trips: folds 
WDW3: folds 
geldwolfje: calls $2
coinflip_si: folds 
seouljam: calls $1
nailz83: checks 
*** FLOP *** [Ks Ad Kd]
seouljam: checks 
nailz83: checks 
geldwolfje: bets $4
seouljam: calls $4
nailz83: folds 
*** TURN *** [Ks Ad Kd] [Kc]
seouljam: checks 
geldwolfje: bets $4
seouljam: calls $4
*** RIVER *** [Ks Ad Kd Kc] [8c]
seouljam: checks 
geldwolfje: checks 
*** SHOW DOWN ***
seouljam: shows [As 3s] (a full house, Kings full of Aces)
geldwolfje: mucks hand 
seouljam collected $21.01 from pot
*** SUMMARY ***
Total pot $22 | Rake $0.99 
Board [Ks Ad Kd Kc 8c]
Seat 1: geldwolfje mucked [5d Qd]
Seat 2: coinflip_si (button) folded before Flop (didn't bet)
Seat 3: seouljam (small blind) showed [As 3s] and won ($21.01) with a full house, Kings full of Aces
Seat 4: nailz83 (big blind) folded on the Flop
Seat 6: matiko09 folded before Flop (didn't bet)
Seat 7: ldwin8 folded before Flop (didn't bet)
Seat 8: Fish4trips folded before Flop (didn't bet)
Seat 9: WDW3 folded before Flop (didn't bet)





PokerStars Hand #150799197709:  Hold'em No Limit ($0.50/$1.00 USD) - 2016/03/23 13:26:18 CET [2016/03/23 8:26:18 ET]
Table 'Oljato' 9-max Seat #9 is the button
Seat 1: Pearl Jam87 ($199.40 in chips) 
Seat 2: roman134679 ($73.23 in chips) 
Seat 3: DUkalisUA ($100 in chips) 
Seat 4: Pvsx. ($106.31 in chips) 
Seat 5: ryo728 ($75.19 in chips) 
Seat 6: WDW3 ($134.51 in chips) 
Seat 7: matiko09 ($150.73 in chips) 
Seat 8: Zeeshka ($354.64 in chips) 
Seat 9: Jimy Tiltman ($118.56 in chips) 
Pearl Jam87: posts small blind $0.50
roman134679: posts big blind $1
*** HOLE CARDS ***
Dealt to matiko09 [Kh 8s]
DUkalisUA: folds 
Pvsx.: folds 
ryo728: raises $1 to $2
WDW3: raises $5 to $7
matiko09: folds 
Zeeshka: folds 
Jimy Tiltman: folds 
Pearl Jam87: folds 
roman134679: folds 
ryo728: calls $5
*** FLOP *** [8d Qh 5h]
ryo728: bets $7.40
WDW3: calls $7.40
*** TURN *** [8d Qh 5h] [3c]
ryo728: bets $14.47
WDW3: folds 
Uncalled bet ($14.47) returned to ryo728
ryo728 collected $28.94 from pot
ryo728: doesn't show hand 
*** SUMMARY ***
Total pot $30.30 | Rake $1.36 
Board [8d Qh 5h 3c]
Seat 1: Pearl Jam87 (small blind) folded before Flop
Seat 2: roman134679 (big blind) folded before Flop
Seat 3: DUkalisUA folded before Flop (didn't bet)
Seat 4: Pvsx. folded before Flop (didn't bet)
Seat 5: ryo728 collected ($28.94)
Seat 6: WDW3 folded on the Turn
Seat 7: matiko09 folded before Flop (didn't bet)
Seat 8: Zeeshka folded before Flop (didn't bet)
Seat 9: Jimy Tiltman (button) folded before Flop (didn't bet)





PokerStars Hand #150799199457:  Hold'em No Limit ($0.50/$1.00 USD) - 2016/03/23 13:26:21 CET [2016/03/23 8:26:21 ET]
Table 'Kippes' 9-max Seat #5 is the button
Seat 1: Pvsx. ($100 in chips) 
Seat 2: RICKA16 ($124.92 in chips) 
Seat 3: CAJUN890 ($115.81 in chips) 
Seat 4: matiko09 ($100 in chips) 
Seat 5: Jimy Tiltman ($100 in chips) 
Seat 6: WDW3 ($124.25 in chips) 
Seat 7: lumen21 ($104 in chips) 
Seat 8: Zeeshka ($103.30 in chips) 
Seat 9: wang19790906 ($86.94 in chips) 
WDW3: posts small blind $0.50
lumen21: posts big blind $1
*** HOLE CARDS ***
Dealt to matiko09 [Js Ad]
Zeeshka: folds 
wang19790906: calls $1
Pvsx.: folds 
RICKA16: folds 
CAJUN890: folds 
matiko09: raises $3 to $4
Jimy Tiltman: folds 
WDW3: folds 
lumen21: calls $3
wang19790906: calls $3
*** FLOP *** [5h Jd Tc]
lumen21: checks 
wang19790906: checks 
matiko09: bets $8
lumen21: calls $8
wang19790906: folds 
*** TURN *** [5h Jd Tc] [4d]
lumen21: checks 
matiko09: bets $16
lumen21: folds 
Uncalled bet ($16) returned to matiko09
matiko09 collected $27.22 from pot
matiko09: doesn't show hand 
*** SUMMARY ***
Total pot $28.50 | Rake $1.28 
Board [5h Jd Tc 4d]
Seat 1: Pvsx. folded before Flop (didn't bet)
Seat 2: RICKA16 folded before Flop (didn't bet)
Seat 3: CAJUN890 folded before Flop (didn't bet)
Seat 4: matiko09 collected ($27.22)
Seat 5: Jimy Tiltman (button) folded before Flop (didn't bet)
Seat 6: WDW3 (small blind) folded before Flop
Seat 7: lumen21 (big blind) folded on the Turn
Seat 8: Zeeshka folded before Flop (didn't bet)
Seat 9: wang19790906 folded on the Flop





PokerStars Hand #150799204557:  Hold'em No Limit ($1/$2 USD) - 2016/03/23 13:26:31 CET [2016/03/23 8:26:31 ET]
Table 'Kiess' 9-max Seat #1 is the button
Seat 1: ldwin8 ($228.30 in chips) 
Seat 2: DUkalisUA ($510.66 in chips) 
Seat 3: The_red_area ($200 in chips) 
Seat 5: chippo boy ($304.53 in chips) 
Seat 6: matiko09 ($251.64 in chips) 
Seat 7: InsomniaRU ($346.13 in chips) 
Seat 8: WDW3 ($404.60 in chips) 
Seat 9: Fish4trips ($200 in chips) 
DUkalisUA: posts small blind $1
The_red_area: posts big blind $2
Moszes360: sits out 
*** HOLE CARDS ***
Dealt to matiko09 [3s 8d]
chippo boy: folds 
matiko09: folds 
InsomniaRU: raises $3 to $5
WDW3: raises $11 to $16
Fish4trips: folds 
ldwin8: folds 
DUkalisUA: folds 
The_red_area: folds 
InsomniaRU: calls $11
*** FLOP *** [Ad 7d 2s]
InsomniaRU has timed out
InsomniaRU: checks 
WDW3: bets $22
InsomniaRU: folds 
Uncalled bet ($22) returned to WDW3
WDW3 collected $33.42 from pot
WDW3: doesn't show hand 
*** SUMMARY ***
Total pot $35 | Rake $1.58 
Board [Ad 7d 2s]
Seat 1: ldwin8 (button) folded before Flop (didn't bet)
Seat 2: DUkalisUA (small blind) folded before Flop
Seat 3: The_red_area (big blind) folded before Flop
Seat 5: chippo boy folded before Flop (didn't bet)
Seat 6: matiko09 folded before Flop (didn't bet)
Seat 7: InsomniaRU folded on the Flop
Seat 8: WDW3 collected ($33.42)
Seat 9: Fish4trips folded before Flop (didn't bet)





PokerStars Hand #150799207897:  Hold'em No Limit ($0.50/$1.00 USD) - 2016/03/23 13:26:38 CET [2016/03/23 8:26:38 ET]
Table 'Atlantis' 9-max Seat #1 is the button
Seat 1: xHourglass ($180.78 in chips) 
Seat 2: tffff2006 ($39.81 in chips) 
Seat 3: CAJUN890 ($109.33 in chips) 
Seat 4: matiko09 ($100 in chips) 
Seat 6: Jimy Tiltman ($112.74 in chips) 
Seat 7: Zeeshka ($121.61 in chips) 
Seat 8: lumen21 ($137.54 in chips) 
Seat 9: WDW3 ($116.97 in chips) 
tffff2006: posts small blind $0.50
CAJUN890: posts big blind $1
Pvsx.: sits out 
*** HOLE CARDS ***
Dealt to matiko09 [Ah Qh]
matiko09: raises $2 to $3
Jimy Tiltman: folds 
Zeeshka: folds 
lumen21: folds 
WDW3: folds 
xHourglass: folds 
tffff2006: folds 
CAJUN890: folds 
Uncalled bet ($2) returned to matiko09
matiko09 collected $2.50 from pot
matiko09: doesn't show hand 
*** SUMMARY ***
Total pot $2.50 | Rake $0 
Seat 1: xHourglass (button) folded before Flop (didn't bet)
Seat 2: tffff2006 (small blind) folded before Flop
Seat 3: CAJUN890 (big blind) folded before Flop
Seat 4: matiko09 collected ($2.50)
Seat 6: Jimy Tiltman folded before Flop (didn't bet)
Seat 7: Zeeshka folded before Flop (didn't bet)
Seat 8: lumen21 folded before Flop (didn't bet)
Seat 9: WDW3 folded before Flop (didn't bet)





PokerStars Hand #150799208896:  Hold'em No Limit ($0.50/$1.00 USD) - 2016/03/23 13:26:40 CET [2016/03/23 8:26:40 ET]
Table 'Smiley' 9-max Seat #8 is the button
Seat 1: WDW3 ($100 in chips) 
Seat 2: Jimy Tiltman ($100 in chips) 
Seat 3: matiko09 ($145.16 in chips) 
Seat 4: Zeeshka ($100 in chips) 
Seat 5: DUkalisUA ($100 in chips) 
Seat 6: blackmont111 ($59 in chips) 
Seat 8: RICKA16 ($113.29 in chips) 
Seat 9: morosun ($106.38 in chips) 
morosun: posts small blind $0.50
WDW3: posts big blind $1
*** HOLE CARDS ***
Dealt to matiko09 [6s 4c]
Jimy Tiltman: folds 
matiko09: folds 
Zeeshka: folds 
DUkalisUA: raises $2 to $3
blackmont111: folds 
RICKA16: folds 
morosun: calls $2.50
WDW3: folds 
*** FLOP *** [3c Jc 9h]
morosun: checks 
DUkalisUA: bets $4.50
morosun: folds 
Uncalled bet ($4.50) returned to DUkalisUA
DUkalisUA collected $6.68 from pot
DUkalisUA: doesn't show hand 
*** SUMMARY ***
Total pot $7 | Rake $0.32 
Board [3c Jc 9h]
Seat 1: WDW3 (big blind) folded before Flop
Seat 2: Jimy Tiltman folded before Flop (didn't bet)
Seat 3: matiko09 folded before Flop (didn't bet)
Seat 4: Zeeshka folded before Flop (didn't bet)
Seat 5: DUkalisUA collected ($6.68)
Seat 6: blackmont111 folded before Flop (didn't bet)
Seat 8: RICKA16 (button) folded before Flop (didn't bet)
Seat 9: morosun (small blind) folded on the Flop





PokerStars Hand #150799209233:  Hold'em No Limit ($0.25/$0.50 USD) - 2016/03/23 13:26:40 CET [2016/03/23 8:26:40 ET]
Table 'Pyrrhus' 9-max Seat #5 is the button
Seat 1: 1Maxx123 ($52.47 in chips) 
Seat 2: fandorin2005 ($50 in chips) 
Seat 3: IvanUrgant ($50 in chips) 
Seat 4: GriffinBerg ($42.17 in chips) 
Seat 5: lengcunjuan ($29.71 in chips) 
Seat 6: whalldo ($141.61 in chips) 
Seat 7: matiko09 ($115.40 in chips) 
Seat 8: dndngod ($67.47 in chips) 
Seat 9: CvMCvMCvM ($64.66 in chips) 
whalldo: posts small blind $0.25
matiko09: posts big blind $0.50
*** HOLE CARDS ***
Dealt to matiko09 [Kc Qc]
dndngod: folds 
CvMCvMCvM: folds 
1Maxx123: calls $0.50
fandorin2005: folds 
IvanUrgant: folds 
GriffinBerg: calls $0.50
lengcunjuan: folds 
whalldo: folds 
matiko09: raises $2.50 to $3
1Maxx123: folds 
GriffinBerg: folds 
Uncalled bet ($2.50) returned to matiko09
matiko09 collected $1.75 from pot
matiko09: doesn't show hand 
*** SUMMARY ***
Total pot $1.75 | Rake $0 
Seat 1: 1Maxx123 folded before Flop
Seat 2: fandorin2005 folded before Flop (didn't bet)
Seat 3: IvanUrgant folded before Flop (didn't bet)
Seat 4: GriffinBerg folded before Flop
Seat 5: lengcunjuan (button) folded before Flop (didn't bet)
Seat 6: whalldo (small blind) folded before Flop
Seat 7: matiko09 (big blind) collected ($1.75)
Seat 8: dndngod folded before Flop (didn't bet)
Seat 9: CvMCvMCvM folded before Flop (didn't bet)





PokerStars Hand #150799209689:  Hold'em No Limit (€0.25/€0.50 EUR) - 2016/03/23 13:26:41 CET [2016/03/23 8:26:41 ET]
Table 'Hesperia II' 9-max Seat #2 is the button
Seat 2: dndngod (€50 in chips) 
Seat 3: IvanUrgant (€50 in chips) 
Seat 4: Zelenis (€11.89 in chips) 
Seat 5: d-master850 (€48.70 in chips) 
Seat 6: CvMCvMCvM (€50 in chips) 
Seat 7: matiko09 (€57.06 in chips) 
Seat 8: Ahangama (€50 in chips) 
Seat 9: ZonTTT (€50 in chips) 
IvanUrgant: posts small blind €0.25
Zelenis: posts big blind €0.50
*** HOLE CARDS ***
Dealt to matiko09 [2c 8h]
d-master850: calls €0.50
CvMCvMCvM: folds 
matiko09: folds 
Ahangama: folds 
ZonTTT: raises €1.50 to €2
dndngod: folds 
IvanUrgant: folds 
Zelenis: folds 
d-master850: calls €1.50
*** FLOP *** [2h 4c 6s]
d-master850: bets €2
ZonTTT: raises €5 to €7
d-master850: raises €11 to €18
ZonTTT: calls €11
*** TURN *** [2h 4c 6s] [2s]
d-master850: bets €28.70 and is all-in
ZonTTT: calls €28.70
*** RIVER *** [2h 4c 6s 2s] [3c]
*** SHOW DOWN ***
d-master850: shows [4d 6d] (two pair, Sixes and Fours)
ZonTTT: shows [Jc Jh] (two pair, Jacks and Deuces)
ZonTTT collected €96.15 from pot
*** SUMMARY ***
Total pot €98.15 | Rake €2 
Board [2h 4c 6s 2s 3c]
Seat 2: dndngod (button) folded before Flop (didn't bet)
Seat 3: IvanUrgant (small blind) folded before Flop
Seat 4: Zelenis (big blind) folded before Flop
Seat 5: d-master850 showed [4d 6d] and lost with two pair, Sixes and Fours
Seat 6: CvMCvMCvM folded before Flop (didn't bet)
Seat 7: matiko09 folded before Flop (didn't bet)
Seat 8: Ahangama folded before Flop (didn't bet)
Seat 9: ZonTTT showed [Jc Jh] and won (€96.15) with two pair, Jacks and Deuces





PokerStars Hand #150799211082:  Hold'em No Limit ($1/$2 USD) - 2016/03/23 13:26:44 CET [2016/03/23 8:26:44 ET]
Table 'Herba II' 9-max Seat #1 is the button
Seat 1: matiko09 ($235.52 in chips) 
Seat 2: Moszes360 ($231.20 in chips) 
Seat 3: Cirilico ($160 in chips) 
Seat 4: DUkalisUA ($257.20 in chips) 
Seat 5: chippo boy ($203.15 in chips) 
Seat 6: WDW3 ($200 in chips) 
Seat 7: InsomniaRU ($233 in chips) 
Seat 9: mrhighryza ($89.86 in chips) 
Moszes360: posts small blind $1
Cirilico: posts big blind $2
The_red_area: sits out 
*** HOLE CARDS ***
Dealt to matiko09 [3d 8s]
DUkalisUA: folds 
chippo boy: raises $4 to $6
WDW3: folds 
InsomniaRU: folds 
mrhighryza: folds 
matiko09: folds 
Moszes360: folds 
Cirilico: folds 
Uncalled bet ($4) returned to chippo boy
chippo boy collected $5 from pot
*** SUMMARY ***
Total pot $5 | Rake $0 
Seat 1: matiko09 (button) folded before Flop (didn't bet)
Seat 2: Moszes360 (small blind) folded before Flop
Seat 3: Cirilico (big blind) folded before Flop
Seat 4: DUkalisUA folded before Flop (didn't bet)
Seat 5: chippo boy collected ($5)
Seat 6: WDW3 folded before Flop (didn't bet)
Seat 7: InsomniaRU folded before Flop (didn't bet)
Seat 9: mrhighryza folded before Flop (didn't bet)





PokerStars Hand #150799215882:  Hold'em No Limit ($1/$2 USD) - 2016/03/23 13:26:53 CET [2016/03/23 8:26:53 ET]
Table 'Kypria II' 9-max Seat #3 is the button
Seat 1: geldwolfje ($257.99 in chips) 
Seat 2: coinflip_si ($200 in chips) 
Seat 3: seouljam ($89.01 in chips) 
Seat 4: nailz83 ($63.69 in chips) 
Seat 6: matiko09 ($253.64 in chips) 
Seat 7: ldwin8 ($401.09 in chips) 
Seat 8: Fish4trips ($320.12 in chips) 
Seat 9: WDW3 ($200 in chips) 
nailz83: posts small blind $1
matiko09: posts big blind $2
*** HOLE CARDS ***
Dealt to matiko09 [3d Jh]
ldwin8: raises $4 to $6
Fish4trips: folds 
geldwolfje said, "nice"
WDW3: folds 
geldwolfje: calls $6
coinflip_si: folds 
seouljam: calls $6
nailz83: calls $5
matiko09: folds 
*** FLOP *** [As Th 8s]
nailz83: checks 
ldwin8: bets $16
geldwolfje: calls $16
seouljam: raises $67.01 to $83.01 and is all-in
nailz83: folds 
ldwin8: folds 
geldwolfje: folds 
Uncalled bet ($67.01) returned to seouljam
seouljam collected $71.20 from pot
seouljam said, "^^"
seouljam: doesn't show hand 
*** SUMMARY ***
Total pot $74 | Rake $2.80 
Board [As Th 8s]
Seat 1: geldwolfje folded on the Flop
Seat 2: coinflip_si folded before Flop (didn't bet)
Seat 3: seouljam (button) collected ($71.20)
Seat 4: nailz83 (small blind) folded on the Flop
Seat 6: matiko09 (big blind) folded before Flop
Seat 7: ldwin8 folded on the Flop
Seat 8: Fish4trips folded before Flop (didn't bet)
Seat 9: WDW3 folded before Flop (didn't bet)





PokerStars Hand #150799222131:  Hold'em No Limit (€0.25/€0.50 EUR) - 2016/03/23 13:27:06 CET [2016/03/23 8:27:06 ET]
Table 'Palma II' 9-max Seat #1 is the button
Seat 1: Ahangama (€50 in chips) 
Seat 2: matiko09 (€50 in chips) 
Seat 7: Wouter Des (€50 in chips) 
Seat 8: CvMCvMCvM (€50 in chips) 
Seat 9: ZonTTT (€50 in chips) 
matiko09: posts small blind €0.25
Wouter Des: posts big blind €0.50
*** HOLE CARDS ***
Dealt to matiko09 [5s 7c]
CvMCvMCvM: folds 
ZonTTT: raises €0.75 to €1.25
Ahangama: folds 
matiko09: folds 
Wouter Des: calls €0.75
*** FLOP *** [2s Qc Kc]
Wouter Des: bets €1.31
ZonTTT: folds 
Uncalled bet (€1.31) returned to Wouter Des
Wouter Des collected €2.63 from pot
Wouter Des: doesn't show hand 
*** SUMMARY ***
Total pot €2.75 | Rake €0.12 
Board [2s Qc Kc]
Seat 1: Ahangama (button) folded before Flop (didn't bet)
Seat 2: matiko09 (small blind) folded before Flop
Seat 7: Wouter Des (big blind) collected (€2.63)
Seat 8: CvMCvMCvM folded before Flop (didn't bet)
Seat 9: ZonTTT folded on the Flop





PokerStars Hand #150799225196:  Hold'em No Limit ($0.25/$0.50 USD) - 2016/03/23 13:27:12 CET [2016/03/23 8:27:12 ET]
Table 'Belnika' 9-max Seat #4 is the button
Seat 1: yellowfever0 ($25.31 in chips) 
Seat 2: NeverRegret7 ($64.81 in chips) 
Seat 3: ChiChioChi ($24.74 in chips) 
Seat 4: matiko09 ($66.56 in chips) 
Seat 5: fandorin2005 ($50.89 in chips) 
Seat 6: Ahangama ($50 in chips) 
Seat 7: Zeeshka ($50 in chips) 
Seat 8: lumen21 ($70.39 in chips) 
Seat 9: dndngod ($68.37 in chips) 
fandorin2005: posts small blind $0.25
Ahangama: posts big blind $0.50
*** HOLE CARDS ***
Dealt to matiko09 [Qs 3d]
Zeeshka: folds 
lumen21: folds 
dndngod: folds 
yellowfever0: folds 
NeverRegret7: folds 
ChiChioChi: calls $0.50
matiko09: folds 
fandorin2005: folds 
Ahangama: raises $1.50 to $2
ChiChioChi: calls $1.50
*** FLOP *** [3s Ks 5d]
Ahangama: bets $3
ChiChioChi: folds 
Uncalled bet ($3) returned to Ahangama
Ahangama collected $4.06 from pot
Ahangama: doesn't show hand 
*** SUMMARY ***
Total pot $4.25 | Rake $0.19 
Board [3s Ks 5d]
Seat 1: yellowfever0 folded before Flop (didn't bet)
Seat 2: NeverRegret7 folded before Flop (didn't bet)
Seat 3: ChiChioChi folded on the Flop
Seat 4: matiko09 (button) folded before Flop (didn't bet)
Seat 5: fandorin2005 (small blind) folded before Flop
Seat 6: Ahangama (big blind) collected ($4.06)
Seat 7: Zeeshka folded before Flop (didn't bet)
Seat 8: lumen21 folded before Flop (didn't bet)
Seat 9: dndngod folded before Flop (didn't bet)





PokerStars Hand #150799227898:  Hold'em No Limit ($0.50/$1.00 USD) - 2016/03/23 13:27:17 CET [2016/03/23 8:27:17 ET]
Table 'Oljato' 9-max Seat #1 is the button
Seat 1: Pearl Jam87 ($198.90 in chips) 
Seat 2: roman134679 ($72.23 in chips) 
Seat 3: DUkalisUA ($100 in chips) 
Seat 4: Pvsx. ($106.31 in chips) 
Seat 5: ryo728 ($89.73 in chips) 
Seat 6: WDW3 ($120.11 in chips) 
Seat 7: matiko09 ($150.73 in chips) 
Seat 8: Zeeshka ($354.64 in chips) 
Seat 9: Jimy Tiltman ($118.56 in chips) 
roman134679: posts small blind $0.50
DUkalisUA: posts big blind $1
*** HOLE CARDS ***
Dealt to matiko09 [7h Jc]
Pvsx.: raises $1.50 to $2.50
ryo728: folds 
WDW3: folds 
matiko09: folds 
Zeeshka: folds 
Jimy Tiltman: folds 
Pearl Jam87: folds 
roman134679: calls $2
DUkalisUA: calls $1.50
*** FLOP *** [6s 6c 3s]
roman134679: bets $1.30
DUkalisUA: folds 
Pvsx.: raises $4.70 to $6
roman134679: calls $4.70
*** TURN *** [6s 6c 3s] [Qc]
roman134679: bets $1.03
Pvsx.: calls $1.03
*** RIVER *** [6s 6c 3s Qc] [3d]
roman134679: checks 
Pvsx.: checks 
*** SHOW DOWN ***
roman134679: shows [4c 4s] (two pair, Sixes and Fours)
Pvsx.: mucks hand 
roman134679 collected $20.59 from pot
*** SUMMARY ***
Total pot $21.56 | Rake $0.97 
Board [6s 6c 3s Qc 3d]
Seat 1: Pearl Jam87 (button) folded before Flop (didn't bet)
Seat 2: roman134679 (small blind) showed [4c 4s] and won ($20.59) with two pair, Sixes and Fours
Seat 3: DUkalisUA (big blind) folded on the Flop
Seat 4: Pvsx. mucked [Ah Td]
Seat 5: ryo728 folded before Flop (didn't bet)
Seat 6: WDW3 folded before Flop (didn't bet)
Seat 7: matiko09 folded before Flop (didn't bet)
Seat 8: Zeeshka folded before Flop (didn't bet)
Seat 9: Jimy Tiltman folded before Flop (didn't bet)





PokerStars Hand #150799228497:  Hold'em No Limit ($0.50/$1.00 USD) - 2016/03/23 13:27:18 CET [2016/03/23 8:27:18 ET]
Table 'Smiley' 9-max Seat #9 is the button
Seat 1: WDW3 ($100 in chips) 
Seat 2: Jimy Tiltman ($100 in chips) 
Seat 3: matiko09 ($145.16 in chips) 
Seat 4: Zeeshka ($100 in chips) 
Seat 5: DUkalisUA ($103.68 in chips) 
Seat 6: blackmont111 ($59 in chips) 
Seat 8: RICKA16 ($113.29 in chips) 
Seat 9: morosun ($103.38 in chips) 
WDW3: posts small blind $0.50
Jimy Tiltman: posts big blind $1
*** HOLE CARDS ***
Dealt to matiko09 [4d Qh]
matiko09: folds 
Zeeshka: folds 
DUkalisUA: raises $2 to $3
blackmont111: folds 
RICKA16: raises $7 to $10
morosun: folds 
WDW3: folds 
Jimy Tiltman: folds 
DUkalisUA: calls $7
*** FLOP *** [Kh 4c 8s]
DUkalisUA: checks 
RICKA16: checks 
*** TURN *** [Kh 4c 8s] [3s]
DUkalisUA: checks 
RICKA16: checks 
*** RIVER *** [Kh 4c 8s 3s] [8d]
DUkalisUA: checks 
RICKA16: bets $18
DUkalisUA: folds 
Uncalled bet ($18) returned to RICKA16
RICKA16 collected $20.53 from pot
RICKA16: doesn't show hand 
*** SUMMARY ***
Total pot $21.50 | Rake $0.97 
Board [Kh 4c 8s 3s 8d]
Seat 1: WDW3 (small blind) folded before Flop
Seat 2: Jimy Tiltman (big blind) folded before Flop
Seat 3: matiko09 folded before Flop (didn't bet)
Seat 4: Zeeshka folded before Flop (didn't bet)
Seat 5: DUkalisUA folded on the River
Seat 6: blackmont111 folded before Flop (didn't bet)
Seat 8: RICKA16 collected ($20.53)
Seat 9: morosun (button) folded before Flop (didn't bet)





PokerStars Hand #150799228917:  Hold'em No Limit ($0.25/$0.50 USD) - 2016/03/23 13:27:19 CET [2016/03/23 8:27:19 ET]
Table 'Pyrrhus' 9-max Seat #6 is the button
Seat 1: 1Maxx123 ($51.97 in chips) 
Seat 2: fandorin2005 ($50 in chips) 
Seat 3: IvanUrgant ($50 in chips) 
Seat 4: GriffinBerg ($41.67 in chips) 
Seat 5: lengcunjuan ($29.71 in chips) 
Seat 6: whalldo ($141.36 in chips) 
Seat 7: matiko09 ($116.65 in chips) 
Seat 8: dndngod ($67.47 in chips) 
Seat 9: CvMCvMCvM ($64.66 in chips) 
matiko09: posts small blind $0.25
dndngod: posts big blind $0.50
*** HOLE CARDS ***
Dealt to matiko09 [6h Ad]
CvMCvMCvM: folds 
1Maxx123: folds 
fandorin2005: folds 
IvanUrgant: raises $1 to $1.50
GriffinBerg: folds 
lengcunjuan: folds 
whalldo: calls $1.50
matiko09: folds 
dndngod: folds 
*** FLOP *** [7c 8d 2h]
IvanUrgant: bets $2.40
whalldo: calls $2.40
*** TURN *** [7c 8d 2h] [Js]
IvanUrgant: checks 
whalldo: bets $4.50
IvanUrgant: calls $4.50
*** RIVER *** [7c 8d 2h Js] [3c]
IvanUrgant: checks 
whalldo: bets $13.50
IvanUrgant: folds 
Uncalled bet ($13.50) returned to whalldo
whalldo collected $16.76 from pot
whalldo: doesn't show hand 
*** SUMMARY ***
Total pot $17.55 | Rake $0.79 
Board [7c 8d 2h Js 3c]
Seat 1: 1Maxx123 folded before Flop (didn't bet)
Seat 2: fandorin2005 folded before Flop (didn't bet)
Seat 3: IvanUrgant folded on the River
Seat 4: GriffinBerg folded before Flop (didn't bet)
Seat 5: lengcunjuan folded before Flop (didn't bet)
Seat 6: whalldo (button) collected ($16.76)
Seat 7: matiko09 (small blind) folded before Flop
Seat 8: dndngod (big blind) folded before Flop
Seat 9: CvMCvMCvM folded before Flop (didn't bet)





PokerStars Hand #150799230224:  Hold'em No Limit ($1/$2 USD) - 2016/03/23 13:27:22 CET [2016/03/23 8:27:22 ET]
Table 'Herba II' 9-max Seat #2 is the button
Seat 1: matiko09 ($235.52 in chips) 
Seat 2: Moszes360 ($230.20 in chips) 
Seat 3: Cirilico ($160 in chips) 
Seat 4: DUkalisUA ($257.20 in chips) 
Seat 5: chippo boy ($206.15 in chips) 
Seat 6: WDW3 ($200 in chips) 
Seat 7: InsomniaRU ($233 in chips) 
Seat 9: mrhighryza ($89.86 in chips) 
Cirilico: posts small blind $1
DUkalisUA: posts big blind $2
The_red_area: sits out 
*** HOLE CARDS ***
Dealt to matiko09 [2d 9s]
chippo boy: calls $2
WDW3: folds 
InsomniaRU: folds 
mrhighryza: folds 
matiko09: folds 
Moszes360: folds 
Cirilico: folds 
DUkalisUA: checks 
*** FLOP *** [Js Ah Qd]
DUkalisUA: checks 
chippo boy: bets $2
DUkalisUA: folds 
Uncalled bet ($2) returned to chippo boy
chippo boy collected $4.78 from pot
*** SUMMARY ***
Total pot $5 | Rake $0.22 
Board [Js Ah Qd]
Seat 1: matiko09 folded before Flop (didn't bet)
Seat 2: Moszes360 (button) folded before Flop (didn't bet)
Seat 3: Cirilico (small blind) folded before Flop
Seat 4: DUkalisUA (big blind) folded on the Flop
Seat 5: chippo boy collected ($4.78)
Seat 6: WDW3 folded before Flop (didn't bet)
Seat 7: InsomniaRU folded before Flop (didn't bet)
Seat 9: mrhighryza folded before Flop (didn't bet)





PokerStars Hand #150799231462:  Hold'em No Limit ($0.50/$1.00 USD) - 2016/03/23 13:27:24 CET [2016/03/23 8:27:24 ET]
Table 'Atlantis' 9-max Seat #2 is the button
Seat 1: xHourglass ($180.78 in chips) 
Seat 2: tffff2006 ($39.31 in chips) 
Seat 3: CAJUN890 ($108.33 in chips) 
Seat 4: matiko09 ($101.50 in chips) 
Seat 6: Jimy Tiltman ($112.74 in chips) 
Seat 7: Zeeshka ($121.61 in chips) 
Seat 8: lumen21 ($137.54 in chips) 
Seat 9: WDW3 ($116.97 in chips) 
CAJUN890: posts small blind $0.50
matiko09: posts big blind $1
Pvsx.: sits out 
*** HOLE CARDS ***
Dealt to matiko09 [Qd 6h]
Jimy Tiltman: folds 
Zeeshka: folds 
lumen21: folds 
WDW3: folds 
xHourglass: folds 
tffff2006: calls $1
CAJUN890: calls $0.50
matiko09: checks 
*** FLOP *** [As Kd 8d]
CAJUN890: checks 
matiko09: checks 
tffff2006: checks 
*** TURN *** [As Kd 8d] [Jh]
CAJUN890: bets $2.86
matiko09: folds 
tffff2006: folds 
Uncalled bet ($2.86) returned to CAJUN890
CAJUN890 collected $2.86 from pot
CAJUN890: doesn't show hand 
*** SUMMARY ***
Total pot $3 | Rake $0.14 
Board [As Kd 8d Jh]
Seat 1: xHourglass folded before Flop (didn't bet)
Seat 2: tffff2006 (button) folded on the Turn
Seat 3: CAJUN890 (small blind) collected ($2.86)
Seat 4: matiko09 (big blind) folded on the Turn
Seat 6: Jimy Tiltman folded before Flop (didn't bet)
Seat 7: Zeeshka folded before Flop (didn't bet)
Seat 8: lumen21 folded before Flop (didn't bet)
Seat 9: WDW3 folded before Flop (didn't bet)





PokerStars Hand #150799235070:  Hold'em No Limit ($1/$2 USD) - 2016/03/23 13:27:31 CET [2016/03/23 8:27:31 ET]
Table 'Berbericia II' 9-max Seat #6 is the button
Seat 1: WDW3 ($245.48 in chips) 
Seat 2: Moszes360 ($216.15 in chips) 
Seat 3: Fish4trips ($202.32 in chips) 
Seat 4: bennetb77 ($108.86 in chips) 
Seat 5: Surxach ($98.09 in chips) 
Seat 6: coinflip_si ($200 in chips) 
Seat 7: niuquan ($81 in chips) 
Seat 8: matiko09 ($200 in chips) 
Seat 9: LVV-Bif ($157.56 in chips) 
niuquan: posts small blind $1
matiko09: posts big blind $2
*** HOLE CARDS ***
Dealt to matiko09 [Qc Jh]
LVV-Bif: folds 
WDW3: folds 
Moszes360: folds 
Fish4trips: folds 
bennetb77: folds 
Surxach: raises $2 to $4
coinflip_si: folds 
niuquan: folds 
matiko09: calls $2
*** FLOP *** [6d 5h 3s]
matiko09: checks 
Surxach: bets $4
matiko09: folds 
Uncalled bet ($4) returned to Surxach
Surxach collected $8.60 from pot
Surxach: doesn't show hand 
*** SUMMARY ***
Total pot $9 | Rake $0.40 
Board [6d 5h 3s]
Seat 1: WDW3 folded before Flop (didn't bet)
Seat 2: Moszes360 folded before Flop (didn't bet)
Seat 3: Fish4trips folded before Flop (didn't bet)
Seat 4: bennetb77 folded before Flop (didn't bet)
Seat 5: Surxach collected ($8.60)
Seat 6: coinflip_si (button) folded before Flop (didn't bet)
Seat 7: niuquan (small blind) folded before Flop
Seat 8: matiko09 (big blind) folded on the Flop
Seat 9: LVV-Bif folded before Flop (didn't bet)





PokerStars Hand #150799245088:  Hold'em No Limit (€0.25/€0.50 EUR) - 2016/03/23 13:27:51 CET [2016/03/23 8:27:51 ET]
Table 'Palma II' 9-max Seat #2 is the button
Seat 1: Ahangama (€50 in chips) 
Seat 2: matiko09 (€50 in chips) 
Seat 7: Wouter Des (€51.38 in chips) 
Seat 8: CvMCvMCvM (€50 in chips) 
Seat 9: ZonTTT (€50 in chips) 
Wouter Des: posts small blind €0.25
CvMCvMCvM: posts big blind €0.50
*** HOLE CARDS ***
Dealt to matiko09 [Td 4d]
ZonTTT: raises €1 to €1.50
Ahangama: folds 
ardo888 joins the table at seat #3 
matiko09: folds 
Wouter Des: folds 
CvMCvMCvM: folds 
Uncalled bet (€1) returned to ZonTTT
ZonTTT collected €1.25 from pot
ZonTTT: doesn't show hand 
*** SUMMARY ***
Total pot €1.25 | Rake €0 
Seat 1: Ahangama folded before Flop (didn't bet)
Seat 2: matiko09 (button) folded before Flop (didn't bet)
Seat 7: Wouter Des (small blind) folded before Flop
Seat 8: CvMCvMCvM (big blind) folded before Flop
Seat 9: ZonTTT collected (€1.25)





PokerStars Hand #150799245399:  Hold'em No Limit ($1/$2 USD) - 2016/03/23 13:27:52 CET [2016/03/23 8:27:52 ET]
Table 'Herba II' 9-max Seat #3 is the button
Seat 1: matiko09 ($235.52 in chips) 
Seat 2: Moszes360 ($230.20 in chips) 
Seat 3: Cirilico ($160 in chips) 
Seat 4: DUkalisUA ($255.20 in chips) 
Seat 5: chippo boy ($208.93 in chips) 
Seat 6: WDW3 ($200 in chips) 
Seat 7: InsomniaRU ($233 in chips) 
Seat 9: mrhighryza ($89.86 in chips) 
DUkalisUA: posts small blind $1
chippo boy: posts big blind $2
The_red_area: sits out 
*** HOLE CARDS ***
Dealt to matiko09 [7c 4s]
WDW3: folds 
InsomniaRU: folds 
mrhighryza: folds 
matiko09: folds 
Moszes360: folds 
Cirilico: raises $3 to $5
DUkalisUA: calls $4
chippo boy: calls $3
*** FLOP *** [Qs 4d 4c]
DUkalisUA: checks 
chippo boy: checks 
Cirilico: checks 
*** TURN *** [Qs 4d 4c] [Tc]
DUkalisUA: checks 
chippo boy: bets $8
Cirilico: raises $24 to $32
DUkalisUA: folds 
chippo boy: folds 
Uncalled bet ($24) returned to Cirilico
Cirilico collected $29.60 from pot
Cirilico: doesn't show hand 
*** SUMMARY ***
Total pot $31 | Rake $1.40 
Board [Qs 4d 4c Tc]
Seat 1: matiko09 folded before Flop (didn't bet)
Seat 2: Moszes360 folded before Flop (didn't bet)
Seat 3: Cirilico (button) collected ($29.60)
Seat 4: DUkalisUA (small blind) folded on the Turn
Seat 5: chippo boy (big blind) folded on the Turn
Seat 6: WDW3 folded before Flop (didn't bet)
Seat 7: InsomniaRU folded before Flop (didn't bet)
Seat 9: mrhighryza folded before Flop (didn't bet)





PokerStars Hand #150799247373:  Hold'em No Limit (€0.25/€0.50 EUR) - 2016/03/23 13:27:56 CET [2016/03/23 8:27:56 ET]
Table 'Hesperia II' 9-max Seat #3 is the button
Seat 2: dndngod (€50 in chips) 
Seat 3: IvanUrgant (€50 in chips) 
Seat 4: Zelenis (€11.39 in chips) 
Seat 6: CvMCvMCvM (€50 in chips) 
Seat 7: matiko09 (€57.06 in chips) 
Seat 8: Ahangama (€50 in chips) 
Seat 9: ZonTTT (€97.45 in chips) 
Zelenis: posts small blind €0.25
CvMCvMCvM: posts big blind €0.50
*** HOLE CARDS ***
Dealt to matiko09 [8h 9h]
CAJUN890 joins the table at seat #1 
Zelenis said, "lol"
matiko09: raises €1 to €1.50
Ahangama: folds 
ZonTTT: folds 
dndngod: folds 
IvanUrgant: folds 
Zelenis: folds 
CvMCvMCvM: folds 
Uncalled bet (€1) returned to matiko09
matiko09 collected €1.25 from pot
matiko09: doesn't show hand 
*** SUMMARY ***
Total pot €1.25 | Rake €0 
Seat 2: dndngod folded before Flop (didn't bet)
Seat 3: IvanUrgant (button) folded before Flop (didn't bet)
Seat 4: Zelenis (small blind) folded before Flop
Seat 6: CvMCvMCvM (big blind) folded before Flop
Seat 7: matiko09 collected (€1.25)
Seat 8: Ahangama folded before Flop (didn't bet)
Seat 9: ZonTTT folded before Flop (didn't bet)





PokerStars Hand #150799250799:  Hold'em No Limit ($0.50/$1.00 USD) - 2016/03/23 13:28:03 CET [2016/03/23 8:28:03 ET]
Table 'Kippes' 9-max Seat #6 is the button
Seat 1: Pvsx. ($100 in chips) 
Seat 2: RICKA16 ($124.92 in chips) 
Seat 3: CAJUN890 ($115.81 in chips) 
Seat 4: matiko09 ($115.22 in chips) 
Seat 5: Jimy Tiltman ($100 in chips) 
Seat 6: WDW3 ($123.75 in chips) 
Seat 7: lumen21 ($100 in chips) 
Seat 8: Zeeshka ($103.30 in chips) 
Seat 9: wang19790906 ($82.94 in chips) 
lumen21: posts small blind $0.50
Zeeshka: posts big blind $1
*** HOLE CARDS ***
Dealt to matiko09 [3c Ks]
wang19790906: folds 
Pvsx.: folds 
RICKA16: folds 
CAJUN890: raises $2 to $3
matiko09: folds 
Jimy Tiltman: folds 
WDW3: folds 
lumen21: folds 
Zeeshka: folds 
Uncalled bet ($2) returned to CAJUN890
CAJUN890 collected $2.50 from pot
CAJUN890: doesn't show hand 
*** SUMMARY ***
Total pot $2.50 | Rake $0 
Seat 1: Pvsx. folded before Flop (didn't bet)
Seat 2: RICKA16 folded before Flop (didn't bet)
Seat 3: CAJUN890 collected ($2.50)
Seat 4: matiko09 folded before Flop (didn't bet)
Seat 5: Jimy Tiltman folded before Flop (didn't bet)
Seat 6: WDW3 (button) folded before Flop (didn't bet)
Seat 7: lumen21 (small blind) folded before Flop
Seat 8: Zeeshka (big blind) folded before Flop
Seat 9: wang19790906 folded before Flop (didn't bet)





PokerStars Hand #150799252418:  Hold'em No Limit ($0.25/$0.50 USD) - 2016/03/23 13:28:06 CET [2016/03/23 8:28:06 ET]
Table 'Belnika' 9-max Seat #5 is the button
Seat 1: yellowfever0 ($25.31 in chips) 
Seat 2: NeverRegret7 ($64.81 in chips) 
Seat 3: ChiChioChi ($22.74 in chips) 
Seat 4: matiko09 ($66.56 in chips) 
Seat 5: fandorin2005 ($50.64 in chips) 
Seat 6: Ahangama ($52.06 in chips) 
Seat 7: Zeeshka ($50 in chips) 
Seat 8: lumen21 ($70.39 in chips) 
Seat 9: dndngod ($68.37 in chips) 
Ahangama: posts small blind $0.25
Zeeshka: posts big blind $0.50
*** HOLE CARDS ***
Dealt to matiko09 [Jh 7c]
lumen21: folds 
dndngod: folds 
yellowfever0: folds 
NeverRegret7: folds 
ChiChioChi: raises $0.50 to $1
matiko09: folds 
fandorin2005: folds 
Ahangama: folds 
Zeeshka: folds 
Uncalled bet ($0.50) returned to ChiChioChi
ChiChioChi collected $1.25 from pot
ChiChioChi: doesn't show hand 
*** SUMMARY ***
Total pot $1.25 | Rake $0 
Seat 1: yellowfever0 folded before Flop (didn't bet)
Seat 2: NeverRegret7 folded before Flop (didn't bet)
Seat 3: ChiChioChi collected ($1.25)
Seat 4: matiko09 folded before Flop (didn't bet)
Seat 5: fandorin2005 (button) folded before Flop (didn't bet)
Seat 6: Ahangama (small blind) folded before Flop
Seat 7: Zeeshka (big blind) folded before Flop
Seat 8: lumen21 folded before Flop (didn't bet)
Seat 9: dndngod folded before Flop (didn't bet)





PokerStars Hand #150799252811:  Hold'em No Limit ($1/$2 USD) - 2016/03/23 13:28:06 CET [2016/03/23 8:28:06 ET]
Table 'Kypria II' 9-max Seat #4 is the button
Seat 1: geldwolfje ($235.99 in chips) 
Seat 2: coinflip_si ($200 in chips) 
Seat 3: seouljam ($138.21 in chips) 
Seat 4: nailz83 ($57.69 in chips) 
Seat 6: matiko09 ($251.64 in chips) 
Seat 8: Fish4trips ($320.12 in chips) 
Seat 9: WDW3 ($200 in chips) 
matiko09: posts small blind $1
ldwin8: is sitting out 
Fish4trips: posts big blind $2
*** HOLE CARDS ***
Dealt to matiko09 [4c 6h]
seouljam said, "puss"
WDW3: raises $3.60 to $5.60
geldwolfje: calls $5.60
geldwolfje said, "enjoy"
coinflip_si: folds 
ldwin8 leaves the table
DUkalisUA joins the table at seat #7 
seouljam: folds 
nailz83: calls $5.60
matiko09: folds 
Fish4trips: folds 
*** FLOP *** [2c 6d Kd]
WDW3: bets $12
geldwolfje: calls $12
nailz83: folds 
*** TURN *** [2c 6d Kd] [Qs]
WDW3: checks 
geldwolfje: bets $16
WDW3: calls $16
*** RIVER *** [2c 6d Kd Qs] [3h]
WDW3: checks 
geldwolfje: checks 
*** SHOW DOWN ***
WDW3: shows [Jd Qd] (a pair of Queens)
geldwolfje: shows [Ks Jh] (a pair of Kings)
geldwolfje collected $73 from pot
*** SUMMARY ***
Total pot $75.80 | Rake $2.80 
Board [2c 6d Kd Qs 3h]
Seat 1: geldwolfje showed [Ks Jh] and won ($73) with a pair of Kings
Seat 2: coinflip_si folded before Flop (didn't bet)
Seat 3: seouljam folded before Flop (didn't bet)
Seat 4: nailz83 (button) folded on the Flop
Seat 6: matiko09 (small blind) folded before Flop
Seat 8: Fish4trips (big blind) folded before Flop
Seat 9: WDW3 showed [Jd Qd] and lost with a pair of Queens





PokerStars Hand #150799256342:  Hold'em No Limit ($1/$2 USD) - 2016/03/23 13:28:13 CET [2016/03/23 8:28:13 ET]
Table 'Berbericia II' 9-max Seat #7 is the button
Seat 1: WDW3 ($245.48 in chips) 
Seat 2: Moszes360 ($216.15 in chips) 
Seat 3: Fish4trips ($202.32 in chips) 
Seat 4: bennetb77 ($108.86 in chips) 
Seat 5: Surxach ($102.69 in chips) 
Seat 6: coinflip_si ($200 in chips) 
Seat 7: niuquan ($80 in chips) 
Seat 8: matiko09 ($200 in chips) 
Seat 9: LVV-Bif ($157.56 in chips) 
matiko09: posts small blind $1
LVV-Bif: posts big blind $2
*** HOLE CARDS ***
Dealt to matiko09 [4h 3s]
WDW3: folds 
Moszes360: folds 
Fish4trips: folds 
bennetb77: raises $2 to $4
Surxach: folds 
coinflip_si: folds 
niuquan: calls $4
matiko09: folds 
LVV-Bif: calls $2
*** FLOP *** [2h Jh 5c]
LVV-Bif: checks 
bennetb77: bets $8
niuquan: calls $8
LVV-Bif: folds 
*** TURN *** [2h Jh 5c] [5d]
bennetb77: bets $18
niuquan: calls $18
*** RIVER *** [2h Jh 5c 5d] [Th]
bennetb77: checks 
niuquan: bets $31.10
bennetb77: calls $31.10
*** SHOW DOWN ***
niuquan: shows [9d Jd] (two pair, Jacks and Fives)
bennetb77: shows [Kh Kc] (two pair, Kings and Fives)
bennetb77 collected $124.40 from pot
*** SUMMARY ***
Total pot $127.20 | Rake $2.80 
Board [2h Jh 5c 5d Th]
Seat 1: WDW3 folded before Flop (didn't bet)
Seat 2: Moszes360 folded before Flop (didn't bet)
Seat 3: Fish4trips folded before Flop (didn't bet)
Seat 4: bennetb77 showed [Kh Kc] and won ($124.40) with two pair, Kings and Fives
Seat 5: Surxach folded before Flop (didn't bet)
Seat 6: coinflip_si folded before Flop (didn't bet)
Seat 7: niuquan (button) showed [9d Jd] and lost with two pair, Jacks and Fives
Seat 8: matiko09 (small blind) folded before Flop
Seat 9: LVV-Bif (big blind) folded on the Flop





PokerStars Hand #150799256048:  Hold'em No Limit ($1/$2 USD) - 2016/03/23 13:28:13 CET [2016/03/23 8:28:13 ET]
Table 'Kiess' 9-max Seat #2 is the button
Seat 1: ldwin8 ($228.30 in chips) 
Seat 2: DUkalisUA ($509.66 in chips) 
Seat 3: The_red_area ($200 in chips) 
Seat 4: Moszes360 ($200 in chips) 
Seat 5: chippo boy ($304.53 in chips) 
Seat 6: matiko09 ($251.64 in chips) 
Seat 7: InsomniaRU ($330.13 in chips) 
Seat 8: WDW3 ($422.02 in chips) 
Seat 9: Fish4trips ($200 in chips) 
The_red_area: posts small blind $1
Moszes360: posts big blind $2
*** HOLE CARDS ***
Dealt to matiko09 [5s Kd]
chippo boy: calls $2
matiko09: folds 
InsomniaRU: folds 
WDW3: folds 
Fish4trips: raises $6 to $8
ldwin8: folds 
DUkalisUA: folds 
The_red_area: folds 
Moszes360: folds 
chippo boy: calls $6
*** FLOP *** [Qc Jd 3c]
chippo boy: checks 
Fish4trips: bets $11.43
chippo boy: calls $11.43
*** TURN *** [Qc Jd 3c] [4d]
chippo boy: checks 
Fish4trips: bets $35
chippo boy: folds 
Uncalled bet ($35) returned to Fish4trips
Fish4trips collected $39.98 from pot
Fish4trips: doesn't show hand 
*** SUMMARY ***
Total pot $41.86 | Rake $1.88 
Board [Qc Jd 3c 4d]
Seat 1: ldwin8 folded before Flop (didn't bet)
Seat 2: DUkalisUA (button) folded before Flop (didn't bet)
Seat 3: The_red_area (small blind) folded before Flop
Seat 4: Moszes360 (big blind) folded before Flop
Seat 5: chippo boy folded on the Turn
Seat 6: matiko09 folded before Flop (didn't bet)
Seat 7: InsomniaRU folded before Flop (didn't bet)
Seat 8: WDW3 folded before Flop (didn't bet)
Seat 9: Fish4trips collected ($39.98)





PokerStars Hand #150799256597:  Hold'em No Limit (€0.25/€0.50 EUR) - 2016/03/23 13:28:14 CET [2016/03/23 8:28:14 ET]
Table 'Palma II' 9-max Seat #7 is the button
Seat 1: Ahangama (€50 in chips) 
Seat 2: matiko09 (€50 in chips) 
Seat 7: Wouter Des (€51.13 in chips) 
Seat 8: CvMCvMCvM (€50 in chips) 
Seat 9: ZonTTT (€50.75 in chips) 
CvMCvMCvM: posts small blind €0.25
ZonTTT: posts big blind €0.50
ardo888: sits out 
*** HOLE CARDS ***
Dealt to matiko09 [5s 6h]
Ahangama: folds 
matiko09: folds 
Wouter Des: calls €0.50
dndngod joins the table at seat #4 
CvMCvMCvM: calls €0.25
ZonTTT: checks 
*** FLOP *** [4h 6s Ts]
CvMCvMCvM: checks 
ZonTTT: checks 
Wouter Des: bets €0.50
Red_Warning joins the table at seat #6 
CvMCvMCvM: calls €0.50
ZonTTT: folds 
*** TURN *** [4h 6s Ts] [4c]
CvMCvMCvM: checks 
SVFB13 joins the table at seat #5 
Wouter Des: bets €1
CvMCvMCvM: folds 
Uncalled bet (€1) returned to Wouter Des
Wouter Des collected €2.39 from pot
Wouter Des: doesn't show hand 
*** SUMMARY ***
Total pot €2.50 | Rake €0.11 
Board [4h 6s Ts 4c]
Seat 1: Ahangama folded before Flop (didn't bet)
Seat 2: matiko09 folded before Flop (didn't bet)
Seat 7: Wouter Des (button) collected (€2.39)
Seat 8: CvMCvMCvM (small blind) folded on the Turn
Seat 9: ZonTTT (big blind) folded on the Flop





PokerStars Hand #150799257628:  Hold'em No Limit ($0.50/$1.00 USD) - 2016/03/23 13:28:16 CET [2016/03/23 8:28:16 ET]
Table 'Atlantis' 9-max Seat #3 is the button
Seat 1: xHourglass ($180.78 in chips) 
Seat 2: tffff2006 ($38.31 in chips) 
Seat 3: CAJUN890 ($110.19 in chips) 
Seat 4: matiko09 ($100.50 in chips) 
Seat 5: Pvsx. ($100 in chips) 
Seat 6: Jimy Tiltman ($112.74 in chips) 
Seat 7: Zeeshka ($121.61 in chips) 
Seat 8: lumen21 ($137.54 in chips) 
Seat 9: WDW3 ($116.97 in chips) 
matiko09: posts small blind $0.50
Pvsx.: posts big blind $1
*** HOLE CARDS ***
Dealt to matiko09 [8d Td]
Jimy Tiltman: folds 
Zeeshka: folds 
lumen21: folds 
WDW3: folds 
xHourglass: folds 
tffff2006: folds 
CAJUN890: folds 
matiko09: raises $1.50 to $2.50
Pvsx.: calls $1.50
*** FLOP *** [9c 2c 4s]
matiko09: bets $3
Pvsx.: folds 
Uncalled bet ($3) returned to matiko09
matiko09 collected $4.78 from pot
matiko09: doesn't show hand 
*** SUMMARY ***
Total pot $5 | Rake $0.22 
Board [9c 2c 4s]
Seat 1: xHourglass folded before Flop (didn't bet)
Seat 2: tffff2006 folded before Flop (didn't bet)
Seat 3: CAJUN890 (button) folded before Flop (didn't bet)
Seat 4: matiko09 (small blind) collected ($4.78)
Seat 5: Pvsx. (big blind) folded on the Flop
Seat 6: Jimy Tiltman folded before Flop (didn't bet)
Seat 7: Zeeshka folded before Flop (didn't bet)
Seat 8: lumen21 folded before Flop (didn't bet)
Seat 9: WDW3 folded before Flop (didn't bet)





PokerStars Hand #150799260980:  Hold'em No Limit (€0.25/€0.50 EUR) - 2016/03/23 13:28:23 CET [2016/03/23 8:28:23 ET]
Table 'Hesperia II' 9-max Seat #4 is the button
Seat 2: dndngod (€50 in chips) 
Seat 3: IvanUrgant (€50 in chips) 
Seat 4: Zelenis (€11.14 in chips) 
Seat 6: CvMCvMCvM (€50 in chips) 
Seat 7: matiko09 (€57.81 in chips) 
Seat 8: Ahangama (€50 in chips) 
Seat 9: ZonTTT (€97.45 in chips) 
CvMCvMCvM: posts small blind €0.25
matiko09: posts big blind €0.50
CAJUN890: sits out 
*** HOLE CARDS ***
Dealt to matiko09 [Jd Jc]
Ahangama: folds 
ZonTTT: folds 
d-master850 leaves the table
dndngod: raises €1 to €1.50
IvanUrgant: folds 
Avrora-sp joins the table at seat #5 
Zelenis: folds 
CvMCvMCvM: folds 
matiko09: calls €1
*** FLOP *** [9h 2s 4c]
matiko09: checks 
dndngod: bets €2
matiko09: calls €2
*** TURN *** [9h 2s 4c] [4d]
matiko09: checks 
dndngod: checks 
*** RIVER *** [9h 2s 4c 4d] [Ts]
matiko09: bets €3.50
dndngod: folds 
Uncalled bet (€3.50) returned to matiko09
matiko09 collected €6.92 from pot
matiko09: doesn't show hand 
*** SUMMARY ***
Total pot €7.25 | Rake €0.33 
Board [9h 2s 4c 4d Ts]
Seat 2: dndngod folded on the River
Seat 3: IvanUrgant folded before Flop (didn't bet)
Seat 4: Zelenis (button) folded before Flop (didn't bet)
Seat 6: CvMCvMCvM (small blind) folded before Flop
Seat 7: matiko09 (big blind) collected (€6.92)
Seat 8: Ahangama folded before Flop (didn't bet)
Seat 9: ZonTTT folded before Flop (didn't bet)





PokerStars Hand #150799270518:  Hold'em No Limit ($0.50/$1.00 USD) - 2016/03/23 13:28:41 CET [2016/03/23 8:28:41 ET]
Table 'Smiley' 9-max Seat #1 is the button
Seat 1: WDW3 ($100 in chips) 
Seat 2: Jimy Tiltman ($100 in chips) 
Seat 3: matiko09 ($145.16 in chips) 
Seat 4: Zeeshka ($100 in chips) 
Seat 5: DUkalisUA ($100 in chips) 
Seat 6: blackmont111 ($59 in chips) 
Seat 8: RICKA16 ($123.82 in chips) 
Seat 9: morosun ($103.38 in chips) 
Jimy Tiltman: posts small blind $0.50
matiko09: posts big blind $1
*** HOLE CARDS ***
Dealt to matiko09 [Qh Ad]
Zeeshka: folds 
DUkalisUA: folds 
blackmont111: raises $2 to $3
RICKA16: folds 
morosun: folds 
WDW3: folds 
Jimy Tiltman: folds 
matiko09: calls $2
*** FLOP *** [7d Tc 5h]
matiko09: checks 
blackmont111: bets $3
matiko09: folds 
Uncalled bet ($3) returned to blackmont111
blackmont111 collected $6.21 from pot
*** SUMMARY ***
Total pot $6.50 | Rake $0.29 
Board [7d Tc 5h]
Seat 1: WDW3 (button) folded before Flop (didn't bet)
Seat 2: Jimy Tiltman (small blind) folded before Flop
Seat 3: matiko09 (big blind) folded on the Flop
Seat 4: Zeeshka folded before Flop (didn't bet)
Seat 5: DUkalisUA folded before Flop (didn't bet)
Seat 6: blackmont111 collected ($6.21)
Seat 8: RICKA16 folded before Flop (didn't bet)
Seat 9: morosun folded before Flop (didn't bet)





PokerStars Hand #150799271788:  Hold'em No Limit ($0.25/$0.50 USD) - 2016/03/23 13:28:43 CET [2016/03/23 8:28:43 ET]
Table 'Belnika' 9-max Seat #6 is the button
Seat 1: yellowfever0 ($25.31 in chips) 
Seat 2: NeverRegret7 ($64.81 in chips) 
Seat 3: ChiChioChi ($23.49 in chips) 
Seat 4: matiko09 ($66.56 in chips) 
Seat 5: fandorin2005 ($50.64 in chips) 
Seat 6: Ahangama ($51.81 in chips) 
Seat 7: Zeeshka ($50 in chips) 
Seat 8: lumen21 ($70.39 in chips) 
Seat 9: dndngod ($68.37 in chips) 
Zeeshka: posts small blind $0.25
lumen21: posts big blind $0.50
*** HOLE CARDS ***
Dealt to matiko09 [Jc 4s]
dndngod: folds 
yellowfever0: folds 
NeverRegret7: folds 
ChiChioChi: calls $0.50
matiko09: folds 
fandorin2005: folds 
Ahangama: folds 
Zeeshka: folds 
lumen21: checks 
*** FLOP *** [8d Td 2h]
lumen21: checks 
ChiChioChi: checks 
*** TURN *** [8d Td 2h] [Kc]
lumen21: checks 
ChiChioChi: bets $1
lumen21: folds 
Uncalled bet ($1) returned to ChiChioChi
ChiChioChi collected $1.19 from pot
ChiChioChi: doesn't show hand 
*** SUMMARY ***
Total pot $1.25 | Rake $0.06 
Board [8d Td 2h Kc]
Seat 1: yellowfever0 folded before Flop (didn't bet)
Seat 2: NeverRegret7 folded before Flop (didn't bet)
Seat 3: ChiChioChi collected ($1.19)
Seat 4: matiko09 folded before Flop (didn't bet)
Seat 5: fandorin2005 folded before Flop (didn't bet)
Seat 6: Ahangama (button) folded before Flop (didn't bet)
Seat 7: Zeeshka (small blind) folded before Flop
Seat 8: lumen21 (big blind) folded on the Turn
Seat 9: dndngod folded before Flop (didn't bet)





PokerStars Hand #150799272163:  Hold'em No Limit ($0.50/$1.00 USD) - 2016/03/23 13:28:44 CET [2016/03/23 8:28:44 ET]
Table 'Kippes' 9-max Seat #7 is the button
Seat 1: Pvsx. ($100 in chips) 
Seat 2: RICKA16 ($124.92 in chips) 
Seat 3: CAJUN890 ($117.31 in chips) 
Seat 4: matiko09 ($115.22 in chips) 
Seat 5: Jimy Tiltman ($100 in chips) 
Seat 6: WDW3 ($123.75 in chips) 
Seat 7: lumen21 ($100 in chips) 
Seat 8: Zeeshka ($102.30 in chips) 
Seat 9: wang19790906 ($82.94 in chips) 
Zeeshka: posts small blind $0.50
wang19790906: posts big blind $1
*** HOLE CARDS ***
Dealt to matiko09 [7s 3h]
Pvsx.: folds 
RICKA16: folds 
CAJUN890: folds 
matiko09: folds 
Jimy Tiltman: folds 
WDW3: folds 
lumen21: raises $1.50 to $2.50
Zeeshka: folds 
wang19790906: folds 
Uncalled bet ($1.50) returned to lumen21
lumen21 collected $2.50 from pot
lumen21: doesn't show hand 
*** SUMMARY ***
Total pot $2.50 | Rake $0 
Seat 1: Pvsx. folded before Flop (didn't bet)
Seat 2: RICKA16 folded before Flop (didn't bet)
Seat 3: CAJUN890 folded before Flop (didn't bet)
Seat 4: matiko09 folded before Flop (didn't bet)
Seat 5: Jimy Tiltman folded before Flop (didn't bet)
Seat 6: WDW3 folded before Flop (didn't bet)
Seat 7: lumen21 (button) collected ($2.50)
Seat 8: Zeeshka (small blind) folded before Flop
Seat 9: wang19790906 (big blind) folded before Flop





PokerStars Hand #150799274133:  Hold'em No Limit ($1/$2 USD) - 2016/03/23 13:28:48 CET [2016/03/23 8:28:48 ET]
Table 'Herba II' 9-max Seat #4 is the button
Seat 1: matiko09 ($235.52 in chips) 
Seat 2: Moszes360 ($230.20 in chips) 
Seat 3: Cirilico ($176.60 in chips) 
Seat 4: DUkalisUA ($250.20 in chips) 
Seat 5: chippo boy ($195.93 in chips) 
Seat 6: WDW3 ($200 in chips) 
Seat 7: InsomniaRU ($233 in chips) 
Seat 9: mrhighryza ($89.86 in chips) 
chippo boy: posts small blind $1
WDW3: posts big blind $2
The_red_area: sits out 
*** HOLE CARDS ***
Dealt to matiko09 [7c As]
InsomniaRU: folds 
mrhighryza: folds 
matiko09: folds 
Moszes360: raises $4 to $6
Cirilico: folds 
DUkalisUA: folds 
chippo boy: calls $5
WDW3: calls $4
*** FLOP *** [5c 3c Ad]
chippo boy: checks 
WDW3: checks 
Moszes360: checks 
*** TURN *** [5c 3c Ad] [8d]
chippo boy: bets $8
WDW3: folds 
Moszes360: calls $8
*** RIVER *** [5c 3c Ad 8d] [2c]
chippo boy: bets $16
Moszes360: folds 
Uncalled bet ($16) returned to chippo boy
chippo boy collected $32.47 from pot
*** SUMMARY ***
Total pot $34 | Rake $1.53 
Board [5c 3c Ad 8d 2c]
Seat 1: matiko09 folded before Flop (didn't bet)
Seat 2: Moszes360 folded on the River
Seat 3: Cirilico folded before Flop (didn't bet)
Seat 4: DUkalisUA (button) folded before Flop (didn't bet)
Seat 5: chippo boy (small blind) collected ($32.47)
Seat 6: WDW3 (big blind) folded on the Turn
Seat 7: InsomniaRU folded before Flop (didn't bet)
Seat 9: mrhighryza folded before Flop (didn't bet)





PokerStars Hand #150799277121:  Hold'em No Limit ($0.50/$1.00 USD) - 2016/03/23 13:28:54 CET [2016/03/23 8:28:54 ET]
Table 'Atlantis' 9-max Seat #4 is the button
Seat 1: xHourglass ($180.78 in chips) 
Seat 2: tffff2006 ($38.31 in chips) 
Seat 3: CAJUN890 ($110.19 in chips) 
Seat 4: matiko09 ($102.78 in chips) 
Seat 5: Pvsx. ($100 in chips) 
Seat 6: Jimy Tiltman ($112.74 in chips) 
Seat 7: Zeeshka ($121.61 in chips) 
Seat 8: lumen21 ($137.54 in chips) 
Seat 9: WDW3 ($116.97 in chips) 
Pvsx.: posts small blind $0.50
Jimy Tiltman: posts big blind $1
*** HOLE CARDS ***
Dealt to matiko09 [Ks 5d]
Zeeshka: folds 
lumen21: folds 
WDW3: folds 
xHourglass: folds 
tffff2006: folds 
CAJUN890: folds 
matiko09: folds 
Pvsx.: folds 
Uncalled bet ($0.50) returned to Jimy Tiltman
Jimy Tiltman collected $1 from pot
Jimy Tiltman: doesn't show hand 
*** SUMMARY ***
Total pot $1 | Rake $0 
Seat 1: xHourglass folded before Flop (didn't bet)
Seat 2: tffff2006 folded before Flop (didn't bet)
Seat 3: CAJUN890 folded before Flop (didn't bet)
Seat 4: matiko09 (button) folded before Flop (didn't bet)
Seat 5: Pvsx. (small blind) folded before Flop
Seat 6: Jimy Tiltman (big blind) collected ($1)
Seat 7: Zeeshka folded before Flop (didn't bet)
Seat 8: lumen21 folded before Flop (didn't bet)
Seat 9: WDW3 folded before Flop (didn't bet)





PokerStars Hand #150799279158:  Hold'em No Limit ($0.50/$1.00 USD) - 2016/03/23 13:28:58 CET [2016/03/23 8:28:58 ET]
Table 'Oljato' 9-max Seat #2 is the button
Seat 1: Pearl Jam87 ($198.90 in chips) 
Seat 2: roman134679 ($83.29 in chips) 
Seat 3: DUkalisUA ($100 in chips) 
Seat 4: Pvsx. ($100 in chips) 
Seat 5: ryo728 ($89.73 in chips) 
Seat 6: WDW3 ($120.11 in chips) 
Seat 7: matiko09 ($150.73 in chips) 
Seat 8: Zeeshka ($354.64 in chips) 
Seat 9: Jimy Tiltman ($118.56 in chips) 
DUkalisUA: posts small blind $0.50
Pvsx.: posts big blind $1
*** HOLE CARDS ***
Dealt to matiko09 [4h As]
ryo728: folds 
WDW3: folds 
matiko09: folds 
Zeeshka: folds 
Jimy Tiltman: folds 
Pearl Jam87: folds 
roman134679: folds 
DUkalisUA: folds 
Uncalled bet ($0.50) returned to Pvsx.
Pvsx. collected $1 from pot
Pvsx.: doesn't show hand 
*** SUMMARY ***
Total pot $1 | Rake $0 
Seat 1: Pearl Jam87 folded before Flop (didn't bet)
Seat 2: roman134679 (button) folded before Flop (didn't bet)
Seat 3: DUkalisUA (small blind) folded before Flop
Seat 4: Pvsx. (big blind) collected ($1)
Seat 5: ryo728 folded before Flop (didn't bet)
Seat 6: WDW3 folded before Flop (didn't bet)
Seat 7: matiko09 folded before Flop (didn't bet)
Seat 8: Zeeshka folded before Flop (didn't bet)
Seat 9: Jimy Tiltman folded before Flop (didn't bet)





PokerStars Hand #150799281142:  Hold'em No Limit ($0.25/$0.50 USD) - 2016/03/23 13:29:02 CET [2016/03/23 8:29:02 ET]
Table 'Pyrrhus' 9-max Seat #7 is the button
Seat 1: 1Maxx123 ($51.97 in chips) 
Seat 2: fandorin2005 ($50 in chips) 
Seat 3: IvanUrgant ($50 in chips) 
Seat 4: GriffinBerg ($41.67 in chips) 
Seat 5: lengcunjuan ($29.71 in chips) 
Seat 6: whalldo ($149.72 in chips) 
Seat 7: matiko09 ($116.40 in chips) 
Seat 8: dndngod ($66.97 in chips) 
Seat 9: CvMCvMCvM ($64.66 in chips) 
dndngod: posts small blind $0.25
CvMCvMCvM: posts big blind $0.50
*** HOLE CARDS ***
Dealt to matiko09 [Ts 2s]
1Maxx123: folds 
fandorin2005: raises $0.75 to $1.25
IvanUrgant: folds 
GriffinBerg: folds 
1Maxx123 leaves the table
lengcunjuan: folds 
whalldo: folds 
lumen21 joins the table at seat #1 
matiko09: folds 
dndngod: folds 
CvMCvMCvM: folds 
Uncalled bet ($0.75) returned to fandorin2005
fandorin2005 collected $1.25 from pot
fandorin2005: doesn't show hand 
*** SUMMARY ***
Total pot $1.25 | Rake $0 
Seat 1: 1Maxx123 folded before Flop (didn't bet)
Seat 2: fandorin2005 collected ($1.25)
Seat 3: IvanUrgant folded before Flop (didn't bet)
Seat 4: GriffinBerg folded before Flop (didn't bet)
Seat 5: lengcunjuan folded before Flop (didn't bet)
Seat 6: whalldo folded before Flop (didn't bet)
Seat 7: matiko09 (button) folded before Flop (didn't bet)
Seat 8: dndngod (small blind) folded before Flop
Seat 9: CvMCvMCvM (big blind) folded before Flop





PokerStars Hand #150799283452:  Hold'em No Limit ($0.50/$1.00 USD) - 2016/03/23 13:29:06 CET [2016/03/23 8:29:06 ET]
Table 'Kippes' 9-max Seat #8 is the button
Seat 1: Pvsx. ($100 in chips) 
Seat 2: RICKA16 ($124.92 in chips) 
Seat 3: CAJUN890 ($117.31 in chips) 
Seat 4: matiko09 ($115.22 in chips) 
Seat 5: Jimy Tiltman ($100 in chips) 
Seat 6: WDW3 ($123.75 in chips) 
Seat 7: lumen21 ($101.50 in chips) 
Seat 8: Zeeshka ($101.80 in chips) 
Seat 9: wang19790906 ($81.94 in chips) 
wang19790906: posts small blind $0.50
Pvsx.: posts big blind $1
*** HOLE CARDS ***
Dealt to matiko09 [5d Js]
RICKA16: folds 
CAJUN890 has timed out
CAJUN890: folds 
matiko09: folds 
Jimy Tiltman: folds 
WDW3: folds 
lumen21: folds 
Zeeshka: raises $1.50 to $2.50
wang19790906: folds 
Pvsx.: folds 
Uncalled bet ($1.50) returned to Zeeshka
Zeeshka collected $2.50 from pot
Zeeshka: doesn't show hand 
*** SUMMARY ***
Total pot $2.50 | Rake $0 
Seat 1: Pvsx. (big blind) folded before Flop
Seat 2: RICKA16 folded before Flop (didn't bet)
Seat 3: CAJUN890 folded before Flop (didn't bet)
Seat 4: matiko09 folded before Flop (didn't bet)
Seat 5: Jimy Tiltman folded before Flop (didn't bet)
Seat 6: WDW3 folded before Flop (didn't bet)
Seat 7: lumen21 folded before Flop (didn't bet)
Seat 8: Zeeshka (button) collected ($2.50)
Seat 9: wang19790906 (small blind) folded before Flop





PokerStars Hand #150799285974:  Hold'em No Limit ($1/$2 USD) - 2016/03/23 13:29:11 CET [2016/03/23 8:29:11 ET]
Table 'Kypria II' 9-max Seat #6 is the button
Seat 1: geldwolfje ($275.39 in chips) 
Seat 2: coinflip_si ($200 in chips) 
Seat 3: seouljam ($138.21 in chips) 
Seat 4: nailz83 ($52.09 in chips) 
Seat 6: matiko09 ($250.64 in chips) 
Seat 8: Fish4trips ($318.12 in chips) 
Seat 9: WDW3 ($200 in chips) 
DUkalisUA will be allowed to play after the button
Fish4trips: posts small blind $1
WDW3: posts big blind $2
*** HOLE CARDS ***
Dealt to matiko09 [3c 6d]
geldwolfje: folds 
coinflip_si: folds 
seouljam: raises $2.90 to $4.90
nailz83: calls $4.90
matiko09: folds 
Fish4trips: raises $17.10 to $22
WDW3: folds 
Charity86 was removed from the table for failing to post
seouljam: calls $17.10
nailz83: calls $17.10
*** FLOP *** [4h 3d Kc]
Fish4trips: bets $26.73
InsomniaRU joins the table at seat #5 
seouljam: calls $26.73
nailz83: folds 
*** TURN *** [4h 3d Kc] [4s]
Fish4trips: checks 
seouljam: bets $24
Fish4trips: folds 
Uncalled bet ($24) returned to seouljam
seouljam collected $118.66 from pot
seouljam: doesn't show hand 
*** SUMMARY ***
Total pot $121.46 | Rake $2.80 
Board [4h 3d Kc 4s]
Seat 1: geldwolfje folded before Flop (didn't bet)
Seat 2: coinflip_si folded before Flop (didn't bet)
Seat 3: seouljam collected ($118.66)
Seat 4: nailz83 folded on the Flop
Seat 6: matiko09 (button) folded before Flop (didn't bet)
Seat 8: Fish4trips (small blind) folded on the Turn
Seat 9: WDW3 (big blind) folded before Flop





PokerStars Hand #150799289001:  Hold'em No Limit ($0.50/$1.00 USD) - 2016/03/23 13:29:17 CET [2016/03/23 8:29:17 ET]
Table 'Smiley' 9-max Seat #2 is the button
Seat 1: WDW3 ($100 in chips) 
Seat 2: Jimy Tiltman ($100 in chips) 
Seat 3: matiko09 ($142.16 in chips) 
Seat 4: Zeeshka ($100 in chips) 
Seat 5: DUkalisUA ($100 in chips) 
Seat 6: blackmont111 ($62.21 in chips) 
Seat 8: RICKA16 ($123.82 in chips) 
Seat 9: morosun ($103.38 in chips) 
matiko09: posts small blind $0.50
Zeeshka: posts big blind $1
*** HOLE CARDS ***
Dealt to matiko09 [5s 6c]
DUkalisUA: folds 
blackmont111: folds 
RICKA16: folds 
morosun: folds 
WDW3: folds 
Jimy Tiltman: folds 
matiko09: folds 
Uncalled bet ($0.50) returned to Zeeshka
Zeeshka collected $1 from pot
Zeeshka: doesn't show hand 
*** SUMMARY ***
Total pot $1 | Rake $0 
Seat 1: WDW3 folded before Flop (didn't bet)
Seat 2: Jimy Tiltman (button) folded before Flop (didn't bet)
Seat 3: matiko09 (small blind) folded before Flop
Seat 4: Zeeshka (big blind) collected ($1)
Seat 5: DUkalisUA folded before Flop (didn't bet)
Seat 6: blackmont111 folded before Flop (didn't bet)
Seat 8: RICKA16 folded before Flop (didn't bet)
Seat 9: morosun folded before Flop (didn't bet)





PokerStars Hand #150799289754:  Hold'em No Limit ($0.50/$1.00 USD) - 2016/03/23 13:29:18 CET [2016/03/23 8:29:18 ET]
Table 'Oljato' 9-max Seat #3 is the button
Seat 1: Pearl Jam87 ($198.90 in chips) 
Seat 2: roman134679 ($83.29 in chips) 
Seat 3: DUkalisUA ($100 in chips) 
Seat 4: Pvsx. ($100.50 in chips) 
Seat 5: ryo728 ($89.73 in chips) 
Seat 6: WDW3 ($120.11 in chips) 
Seat 7: matiko09 ($150.73 in chips) 
Seat 8: Zeeshka ($354.64 in chips) 
Seat 9: Jimy Tiltman ($118.56 in chips) 
Pvsx.: posts small blind $0.50
ryo728: posts big blind $1
*** HOLE CARDS ***
Dealt to matiko09 [Ad 9s]
WDW3: folds 
matiko09: folds 
Zeeshka: folds 
Jimy Tiltman: raises $2 to $3
Pearl Jam87: folds 
roman134679: raises $4.13 to $7.13
DUkalisUA: calls $7.13
Pvsx.: folds 
ryo728: folds 
Jimy Tiltman: folds 
*** FLOP *** [Kh As 3d]
roman134679: bets $8.70
DUkalisUA: folds 
Uncalled bet ($8.70) returned to roman134679
roman134679 collected $17.92 from pot
roman134679: shows [5d 7s] (high card Ace)
*** SUMMARY ***
Total pot $18.76 | Rake $0.84 
Board [Kh As 3d]
Seat 1: Pearl Jam87 folded before Flop (didn't bet)
Seat 2: roman134679 collected ($17.92)
Seat 3: DUkalisUA (button) folded on the Flop
Seat 4: Pvsx. (small blind) folded before Flop
Seat 5: ryo728 (big blind) folded before Flop
Seat 6: WDW3 folded before Flop (didn't bet)
Seat 7: matiko09 folded before Flop (didn't bet)
Seat 8: Zeeshka folded before Flop (didn't bet)
Seat 9: Jimy Tiltman folded before Flop





PokerStars Hand #150799290715:  Hold'em No Limit ($0.50/$1.00 USD) - 2016/03/23 13:29:20 CET [2016/03/23 8:29:20 ET]
Table 'Atlantis' 9-max Seat #5 is the button
Seat 1: xHourglass ($180.78 in chips) 
Seat 2: tffff2006 ($38.31 in chips) 
Seat 3: CAJUN890 ($110.19 in chips) 
Seat 4: matiko09 ($102.78 in chips) 
Seat 5: Pvsx. ($100 in chips) 
Seat 6: Jimy Tiltman ($113.24 in chips) 
Seat 7: Zeeshka ($121.61 in chips) 
Seat 8: lumen21 ($137.54 in chips) 
Seat 9: WDW3 ($116.97 in chips) 
Jimy Tiltman: posts small blind $0.50
Zeeshka: posts big blind $1
*** HOLE CARDS ***
Dealt to matiko09 [4c 6s]
lumen21: folds 
WDW3: folds 
lumen21 leaves the table
xHourglass: folds 
tffff2006: raises $2 to $3
DUkalisUA joins the table at seat #8 
CAJUN890: folds 
matiko09: folds 
Pvsx.: folds 
Jimy Tiltman: folds 
Zeeshka: folds 
Uncalled bet ($2) returned to tffff2006
tffff2006 collected $2.50 from pot
tffff2006: doesn't show hand 
*** SUMMARY ***
Total pot $2.50 | Rake $0 
Seat 1: xHourglass folded before Flop (didn't bet)
Seat 2: tffff2006 collected ($2.50)
Seat 3: CAJUN890 folded before Flop (didn't bet)
Seat 4: matiko09 folded before Flop (didn't bet)
Seat 5: Pvsx. (button) folded before Flop (didn't bet)
Seat 6: Jimy Tiltman (small blind) folded before Flop
Seat 7: Zeeshka (big blind) folded before Flop
Seat 8: lumen21 folded before Flop (didn't bet)
Seat 9: WDW3 folded before Flop (didn't bet)





PokerStars Hand #150799292405:  Hold'em No Limit (€0.25/€0.50 EUR) - 2016/03/23 13:29:23 CET [2016/03/23 8:29:23 ET]
Table 'Palma II' 9-max Seat #8 is the button
Seat 1: Ahangama (€50 in chips) 
Seat 2: matiko09 (€50 in chips) 
Seat 7: Wouter Des (€52.52 in chips) 
Seat 8: CvMCvMCvM (€50 in chips) 
Seat 9: ZonTTT (€50.25 in chips) 
ZonTTT: posts small blind €0.25
Ahangama: posts big blind €0.50
ardo888: sits out 
dndngod: sits out 
SVFB13: sits out 
Red_Warning: sits out 
*** HOLE CARDS ***
Dealt to matiko09 [Jh Ks]
matiko09: raises €1 to €1.50
Wouter Des: folds 
CvMCvMCvM: folds 
ZonTTT: folds 
Ahangama: folds 
Uncalled bet (€1) returned to matiko09
matiko09 collected €1.25 from pot
matiko09: doesn't show hand 
*** SUMMARY ***
Total pot €1.25 | Rake €0 
Seat 1: Ahangama (big blind) folded before Flop
Seat 2: matiko09 collected (€1.25)
Seat 7: Wouter Des folded before Flop (didn't bet)
Seat 8: CvMCvMCvM (button) folded before Flop (didn't bet)
Seat 9: ZonTTT (small blind) folded before Flop





PokerStars Hand #150799294976:  Hold'em No Limit ($0.50/$1.00 USD) - 2016/03/23 13:29:28 CET [2016/03/23 8:29:28 ET]
Table 'Smiley' 9-max Seat #3 is the button
Seat 1: WDW3 ($100 in chips) 
Seat 2: Jimy Tiltman ($100 in chips) 
Seat 3: matiko09 ($141.66 in chips) 
Seat 4: Zeeshka ($100.50 in chips) 
Seat 5: DUkalisUA ($100 in chips) 
Seat 6: blackmont111 ($62.21 in chips) 
Seat 8: RICKA16 ($123.82 in chips) 
Seat 9: morosun ($103.38 in chips) 
Zeeshka: posts small blind $0.50
DUkalisUA: posts big blind $1
*** HOLE CARDS ***
Dealt to matiko09 [5s As]
blackmont111: folds 
RICKA16: raises $2 to $3
morosun: calls $3
WDW3: folds 
Jimy Tiltman: folds 
matiko09: folds 
Zeeshka: folds 
DUkalisUA: folds 
*** FLOP *** [7h 8d Jd]
RICKA16: checks 
morosun: bets $3
RICKA16: folds 
Uncalled bet ($3) returned to morosun
morosun collected $7.16 from pot
*** SUMMARY ***
Total pot $7.50 | Rake $0.34 
Board [7h 8d Jd]
Seat 1: WDW3 folded before Flop (didn't bet)
Seat 2: Jimy Tiltman folded before Flop (didn't bet)
Seat 3: matiko09 (button) folded before Flop (didn't bet)
Seat 4: Zeeshka (small blind) folded before Flop
Seat 5: DUkalisUA (big blind) folded before Flop
Seat 6: blackmont111 folded before Flop (didn't bet)
Seat 8: RICKA16 folded on the Flop
Seat 9: morosun collected ($7.16)





PokerStars Hand #150799295260:  Hold'em No Limit ($1/$2 USD) - 2016/03/23 13:29:29 CET [2016/03/23 8:29:29 ET]
Table 'Kiess' 9-max Seat #3 is the button
Seat 1: ldwin8 ($228.30 in chips) 
Seat 2: DUkalisUA ($509.66 in chips) 
Seat 3: The_red_area ($200 in chips) 
Seat 4: Moszes360 ($200 in chips) 
Seat 5: chippo boy ($285.10 in chips) 
Seat 6: matiko09 ($251.64 in chips) 
Seat 7: InsomniaRU ($330.13 in chips) 
Seat 8: WDW3 ($422.02 in chips) 
Seat 9: Fish4trips ($220.55 in chips) 
Moszes360: posts small blind $1
chippo boy: posts big blind $2
*** HOLE CARDS ***
Dealt to matiko09 [6h Ah]
matiko09: folds 
InsomniaRU: folds 
WDW3: raises $3.60 to $5.60
Fish4trips: folds 
ldwin8: raises $12.40 to $18
DUkalisUA: folds 
The_red_area: folds 
Moszes360: folds 
chippo boy: folds 
WDW3: folds 
Uncalled bet ($12.40) returned to ldwin8
ldwin8 collected $14.20 from pot
*** SUMMARY ***
Total pot $14.20 | Rake $0 
Seat 1: ldwin8 collected ($14.20)
Seat 2: DUkalisUA folded before Flop (didn't bet)
Seat 3: The_red_area (button) folded before Flop (didn't bet)
Seat 4: Moszes360 (small blind) folded before Flop
Seat 5: chippo boy (big blind) folded before Flop
Seat 6: matiko09 folded before Flop (didn't bet)
Seat 7: InsomniaRU folded before Flop (didn't bet)
Seat 8: WDW3 folded before Flop
Seat 9: Fish4trips folded before Flop (didn't bet)





PokerStars Hand #150799295858:  Hold'em No Limit ($0.25/$0.50 USD) - 2016/03/23 13:29:30 CET [2016/03/23 8:29:30 ET]
Table 'Belnika' 9-max Seat #7 is the button
Seat 1: yellowfever0 ($25.31 in chips) 
Seat 2: NeverRegret7 ($64.81 in chips) 
Seat 3: ChiChioChi ($24.18 in chips) 
Seat 4: matiko09 ($66.56 in chips) 
Seat 5: fandorin2005 ($50.64 in chips) 
Seat 6: Ahangama ($51.81 in chips) 
Seat 7: Zeeshka ($50 in chips) 
Seat 8: lumen21 ($69.89 in chips) 
Seat 9: dndngod ($68.37 in chips) 
lumen21: posts small blind $0.25
dndngod: posts big blind $0.50
*** HOLE CARDS ***
Dealt to matiko09 [Td Ah]
yellowfever0: folds 
NeverRegret7: folds 
ChiChioChi: raises $1 to $1.50
matiko09: folds 
fandorin2005: folds 
Ahangama: calls $1.50
Zeeshka: folds 
lumen21: folds 
dndngod: calls $1
*** FLOP *** [7d 7h 8c]
dndngod: checks 
ChiChioChi: checks 
Ahangama: checks 
*** TURN *** [7d 7h 8c] [5s]
dndngod: bets $3
ChiChioChi: calls $3
Ahangama: calls $3
*** RIVER *** [7d 7h 8c 5s] [Ad]
dndngod: checks 
ChiChioChi: checks 
Ahangama: checks 
*** SHOW DOWN ***
dndngod: shows [9h 9s] (two pair, Nines and Sevens)
ChiChioChi: shows [Js Jd] (two pair, Jacks and Sevens)
Ahangama: mucks hand 
ChiChioChi collected $13.13 from pot
*** SUMMARY ***
Total pot $13.75 | Rake $0.62 
Board [7d 7h 8c 5s Ad]
Seat 1: yellowfever0 folded before Flop (didn't bet)
Seat 2: NeverRegret7 folded before Flop (didn't bet)
Seat 3: ChiChioChi showed [Js Jd] and won ($13.13) with two pair, Jacks and Sevens
Seat 4: matiko09 folded before Flop (didn't bet)
Seat 5: fandorin2005 folded before Flop (didn't bet)
Seat 6: Ahangama mucked [6c 6h]
Seat 7: Zeeshka (button) folded before Flop (didn't bet)
Seat 8: lumen21 (small blind) folded before Flop
Seat 9: dndngod (big blind) showed [9h 9s] and lost with two pair, Nines and Sevens





PokerStars Hand #150799296434:  Hold'em No Limit ($0.25/$0.50 USD) - 2016/03/23 13:29:31 CET [2016/03/23 8:29:31 ET]
Table 'Pyrrhus' 9-max Seat #8 is the button
Seat 1: lumen21 ($50 in chips) 
Seat 2: fandorin2005 ($50.75 in chips) 
Seat 3: IvanUrgant ($50 in chips) 
Seat 4: GriffinBerg ($41.67 in chips) 
Seat 5: lengcunjuan ($29.71 in chips) 
Seat 6: whalldo ($149.72 in chips) 
Seat 7: matiko09 ($116.40 in chips) 
Seat 8: dndngod ($66.72 in chips) 
Seat 9: CvMCvMCvM ($64.16 in chips) 
CvMCvMCvM: posts small blind $0.25
lumen21: posts big blind $0.50
*** HOLE CARDS ***
Dealt to matiko09 [2c Ac]
fandorin2005: folds 
IvanUrgant: folds 
GriffinBerg: raises $1 to $1.50
lengcunjuan: calls $1.50
whalldo: folds 
matiko09: folds 
dndngod: folds 
CvMCvMCvM: raises $5 to $6.50
lumen21: folds 
GriffinBerg: folds 
lengcunjuan: folds 
Uncalled bet ($5) returned to CvMCvMCvM
CvMCvMCvM collected $5 from pot
CvMCvMCvM: doesn't show hand 
*** SUMMARY ***
Total pot $5 | Rake $0 
Seat 1: lumen21 (big blind) folded before Flop
Seat 2: fandorin2005 folded before Flop (didn't bet)
Seat 3: IvanUrgant folded before Flop (didn't bet)
Seat 4: GriffinBerg folded before Flop
Seat 5: lengcunjuan folded before Flop
Seat 6: whalldo folded before Flop (didn't bet)
Seat 7: matiko09 folded before Flop (didn't bet)
Seat 8: dndngod (button) folded before Flop (didn't bet)
Seat 9: CvMCvMCvM (small blind) collected ($5)





PokerStars Hand #150799298107:  Hold'em No Limit (€0.25/€0.50 EUR) - 2016/03/23 13:29:34 CET [2016/03/23 8:29:34 ET]
Table 'Hesperia II' 9-max Seat #6 is the button
Seat 2: dndngod (€50 in chips) 
Seat 3: IvanUrgant (€50 in chips) 
Seat 4: Zelenis (€11.14 in chips) 
Seat 6: CvMCvMCvM (€50 in chips) 
Seat 7: matiko09 (€61.23 in chips) 
Seat 8: Ahangama (€50 in chips) 
Seat 9: ZonTTT (€97.45 in chips) 
matiko09: posts small blind €0.25
Ahangama: posts big blind €0.50
CAJUN890: sits out 
Avrora-sp: sits out 
*** HOLE CARDS ***
Dealt to matiko09 [8h Ts]
ZonTTT: folds 
dndngod: folds 
IvanUrgant: folds 
Zelenis: folds 
CvMCvMCvM: folds 
matiko09: raises €1 to €1.50
Ahangama: folds 
Uncalled bet (€1) returned to matiko09
matiko09 collected €1 from pot
matiko09: doesn't show hand 
*** SUMMARY ***
Total pot €1 | Rake €0 
Seat 2: dndngod folded before Flop (didn't bet)
Seat 3: IvanUrgant folded before Flop (didn't bet)
Seat 4: Zelenis folded before Flop (didn't bet)
Seat 6: CvMCvMCvM (button) folded before Flop (didn't bet)
Seat 7: matiko09 (small blind) collected (€1)
Seat 8: Ahangama (big blind) folded before Flop
Seat 9: ZonTTT folded before Flop (didn't bet)





PokerStars Hand #150799301862:  Hold'em No Limit ($1/$2 USD) - 2016/03/23 13:29:42 CET [2016/03/23 8:29:42 ET]
Table 'Berbericia II' 9-max Seat #8 is the button
Seat 1: WDW3 ($245.48 in chips) 
Seat 2: Moszes360 ($216.15 in chips) 
Seat 3: Fish4trips ($202.32 in chips) 
Seat 4: bennetb77 ($172.16 in chips) 
Seat 5: Surxach ($102.69 in chips) 
Seat 6: coinflip_si ($200 in chips) 
Seat 7: niuquan ($18.90 in chips) 
Seat 8: matiko09 ($200 in chips) 
Seat 9: LVV-Bif ($153.56 in chips) 
LVV-Bif: posts small blind $1
WDW3: posts big blind $2
*** HOLE CARDS ***
Dealt to matiko09 [Qs Js]
Moszes360: folds 
Fish4trips: folds 
bennetb77: folds 
Surxach: folds 
coinflip_si: folds 
niuquan: folds 
matiko09: raises $2.54 to $4.54
LVV-Bif: raises $11.08 to $15.62
WDW3: folds 
matiko09: calls $11.08
*** FLOP *** [As 7c 8c]
LVV-Bif: checks 
matiko09: checks 
*** TURN *** [As 7c 8c] [6s]
LVV-Bif: checks 
matiko09: bets $18
LVV-Bif: calls $18
*** RIVER *** [As 7c 8c 6s] [5h]
LVV-Bif: bets $66
matiko09: folds 
Uncalled bet ($66) returned to LVV-Bif
LVV-Bif collected $66.44 from pot
LVV-Bif: doesn't show hand 
*** SUMMARY ***
Total pot $69.24 | Rake $2.80 
Board [As 7c 8c 6s 5h]
Seat 1: WDW3 (big blind) folded before Flop
Seat 2: Moszes360 folded before Flop (didn't bet)
Seat 3: Fish4trips folded before Flop (didn't bet)
Seat 4: bennetb77 folded before Flop (didn't bet)
Seat 5: Surxach folded before Flop (didn't bet)
Seat 6: coinflip_si folded before Flop (didn't bet)
Seat 7: niuquan folded before Flop (didn't bet)
Seat 8: matiko09 (button) folded on the River
Seat 9: LVV-Bif (small blind) collected ($66.44)





PokerStars Hand #150799307455:  Hold'em No Limit (€0.25/€0.50 EUR) - 2016/03/23 13:29:53 CET [2016/03/23 8:29:53 ET]
Table 'Palma II' 9-max Seat #9 is the button
Seat 1: Ahangama (€50 in chips) 
Seat 2: matiko09 (€50.75 in chips) 
Seat 7: Wouter Des (€52.52 in chips) 
Seat 8: CvMCvMCvM (€50 in chips) 
Seat 9: ZonTTT (€50 in chips) 
Ahangama: posts small blind €0.25
matiko09: posts big blind €0.50
ardo888: sits out 
dndngod: sits out 
SVFB13: sits out 
Red_Warning: sits out 
*** HOLE CARDS ***
Dealt to matiko09 [5h 5d]
Wouter Des: folds 
CvMCvMCvM: folds 
ZonTTT: folds 
Ahangama: folds 
Uncalled bet (€0.25) returned to matiko09
matiko09 collected €0.50 from pot
matiko09: doesn't show hand 
*** SUMMARY ***
Total pot €0.50 | Rake €0 
Seat 1: Ahangama (small blind) folded before Flop
Seat 2: matiko09 (big blind) collected (€0.50)
Seat 7: Wouter Des folded before Flop (didn't bet)
Seat 8: CvMCvMCvM folded before Flop (didn't bet)
Seat 9: ZonTTT (button) folded before Flop (didn't bet)





PokerStars Hand #150799308138:  Hold'em No Limit ($0.50/$1.00 USD) - 2016/03/23 13:29:54 CET [2016/03/23 8:29:54 ET]
Table 'Kippes' 9-max Seat #9 is the button
Seat 1: Pvsx. ($100 in chips) 
Seat 2: RICKA16 ($124.92 in chips) 
Seat 3: CAJUN890 ($117.31 in chips) 
Seat 4: matiko09 ($115.22 in chips) 
Seat 5: Jimy Tiltman ($100 in chips) 
Seat 6: WDW3 ($123.75 in chips) 
Seat 7: lumen21 ($101.50 in chips) 
Seat 8: Zeeshka ($103.30 in chips) 
Seat 9: wang19790906 ($81.44 in chips) 
Pvsx.: posts small blind $0.50
RICKA16: posts big blind $1
*** HOLE CARDS ***
Dealt to matiko09 [3d Qd]
CAJUN890: folds 
matiko09: folds 
Jimy Tiltman: folds 
WDW3: folds 
lumen21: folds 
Zeeshka: folds 
wang19790906: calls $1
Pvsx.: folds 
RICKA16: checks 
*** FLOP *** [9s Ad As]
RICKA16: bets $2
wang19790906: calls $2
*** TURN *** [9s Ad As] [7h]
RICKA16: bets $3
wang19790906: folds 
Uncalled bet ($3) returned to RICKA16
RICKA16 collected $6.21 from pot
RICKA16: doesn't show hand 
*** SUMMARY ***
Total pot $6.50 | Rake $0.29 
Board [9s Ad As 7h]
Seat 1: Pvsx. (small blind) folded before Flop
Seat 2: RICKA16 (big blind) collected ($6.21)
Seat 3: CAJUN890 folded before Flop (didn't bet)
Seat 4: matiko09 folded before Flop (didn't bet)
Seat 5: Jimy Tiltman folded before Flop (didn't bet)
Seat 6: WDW3 folded before Flop (didn't bet)
Seat 7: lumen21 folded before Flop (didn't bet)
Seat 8: Zeeshka folded before Flop (didn't bet)
Seat 9: wang19790906 (button) folded on the Turn





PokerStars Hand #150799309466:  Hold'em No Limit ($1/$2 USD) - 2016/03/23 13:29:56 CET [2016/03/23 8:29:56 ET]
Table 'Herba II' 9-max Seat #5 is the button
Seat 1: matiko09 ($235.52 in chips) 
Seat 2: Moszes360 ($216.20 in chips) 
Seat 3: Cirilico ($176.60 in chips) 
Seat 4: DUkalisUA ($250.20 in chips) 
Seat 5: chippo boy ($214.40 in chips) 
Seat 6: WDW3 ($200 in chips) 
Seat 7: InsomniaRU ($233 in chips) 
Seat 9: mrhighryza ($89.86 in chips) 
WDW3: posts small blind $1
InsomniaRU: posts big blind $2
The_red_area: sits out 
*** HOLE CARDS ***
Dealt to matiko09 [Qd 5s]
mrhighryza: folds 
matiko09: folds 
Moszes360: folds 
Cirilico: folds 
DUkalisUA: folds 
chippo boy: raises $4 to $6
WDW3: folds 
InsomniaRU: folds 
Uncalled bet ($4) returned to chippo boy
chippo boy collected $5 from pot
*** SUMMARY ***
Total pot $5 | Rake $0 
Seat 1: matiko09 folded before Flop (didn't bet)
Seat 2: Moszes360 folded before Flop (didn't bet)
Seat 3: Cirilico folded before Flop (didn't bet)
Seat 4: DUkalisUA folded before Flop (didn't bet)
Seat 5: chippo boy (button) collected ($5)
Seat 6: WDW3 (small blind) folded before Flop
Seat 7: InsomniaRU (big blind) folded before Flop
Seat 9: mrhighryza folded before Flop (didn't bet)





PokerStars Hand #150799309516:  Hold'em No Limit ($0.50/$1.00 USD) - 2016/03/23 13:29:56 CET [2016/03/23 8:29:56 ET]
Table 'Atlantis' 9-max Seat #6 is the button
Seat 1: xHourglass ($180.78 in chips) 
Seat 2: tffff2006 ($39.81 in chips) 
Seat 3: CAJUN890 ($110.19 in chips) 
Seat 4: matiko09 ($102.78 in chips) 
Seat 5: Pvsx. ($100 in chips) 
Seat 6: Jimy Tiltman ($112.74 in chips) 
Seat 7: Zeeshka ($120.61 in chips) 
Seat 8: DUkalisUA ($100 in chips) 
Seat 9: WDW3 ($116.97 in chips) 
Zeeshka: posts small blind $0.50
DUkalisUA: posts big blind $1
*** HOLE CARDS ***
Dealt to matiko09 [5c 7c]
WDW3: folds 
xHourglass: folds 
tffff2006: folds 
CAJUN890: folds 
matiko09: folds 
Pvsx.: folds 
Jimy Tiltman: raises $1 to $2
Zeeshka: folds 
DUkalisUA: raises $6.50 to $8.50
Jimy Tiltman: folds 
Uncalled bet ($6.50) returned to DUkalisUA
DUkalisUA collected $4.50 from pot
DUkalisUA: doesn't show hand 
*** SUMMARY ***
Total pot $4.50 | Rake $0 
Seat 1: xHourglass folded before Flop (didn't bet)
Seat 2: tffff2006 folded before Flop (didn't bet)
Seat 3: CAJUN890 folded before Flop (didn't bet)
Seat 4: matiko09 folded before Flop (didn't bet)
Seat 5: Pvsx. folded before Flop (didn't bet)
Seat 6: Jimy Tiltman (button) folded before Flop
Seat 7: Zeeshka (small blind) folded before Flop
Seat 8: DUkalisUA (big blind) collected ($4.50)
Seat 9: WDW3 folded before Flop (didn't bet)





PokerStars Hand #150799314332:  Hold'em No Limit ($0.50/$1.00 USD) - 2016/03/23 13:30:05 CET [2016/03/23 8:30:05 ET]
Table 'Smiley' 9-max Seat #4 is the button
Seat 1: WDW3 ($100 in chips) 
Seat 2: Jimy Tiltman ($100 in chips) 
Seat 3: matiko09 ($141.66 in chips) 
Seat 4: Zeeshka ($100 in chips) 
Seat 5: DUkalisUA ($100 in chips) 
Seat 6: blackmont111 ($62.21 in chips) 
Seat 8: RICKA16 ($120.82 in chips) 
Seat 9: morosun ($107.54 in chips) 
DUkalisUA: posts small blind $0.50
blackmont111: posts big blind $1
*** HOLE CARDS ***
Dealt to matiko09 [8c Qh]
RICKA16: folds 
morosun: raises $2 to $3
WDW3: folds 
Jimy Tiltman: folds 
matiko09: folds 
Zeeshka: folds 
DUkalisUA: folds 
blackmont111: calls $2
*** FLOP *** [Jc 4c 9c]
blackmont111: checks 
morosun: bets $2
blackmont111: calls $2
*** TURN *** [Jc 4c 9c] [5h]
blackmont111: checks 
morosun: bets $4
blackmont111: folds 
Uncalled bet ($4) returned to morosun
morosun collected $10.03 from pot
*** SUMMARY ***
Total pot $10.50 | Rake $0.47 
Board [Jc 4c 9c 5h]
Seat 1: WDW3 folded before Flop (didn't bet)
Seat 2: Jimy Tiltman folded before Flop (didn't bet)
Seat 3: matiko09 folded before Flop (didn't bet)
Seat 4: Zeeshka (button) folded before Flop (didn't bet)
Seat 5: DUkalisUA (small blind) folded before Flop
Seat 6: blackmont111 (big blind) folded on the Turn
Seat 8: RICKA16 folded before Flop (didn't bet)
Seat 9: morosun collected ($10.03)





PokerStars Hand #150799314415:  Hold'em No Limit (€0.25/€0.50 EUR) - 2016/03/23 13:30:05 CET [2016/03/23 8:30:05 ET]
Table 'Hesperia II' 9-max Seat #7 is the button
Seat 1: CAJUN890 (€50 in chips) 
Seat 2: dndngod (€50 in chips) 
Seat 3: IvanUrgant (€50 in chips) 
Seat 4: Zelenis (€11.14 in chips) 
Seat 6: CvMCvMCvM (€50 in chips) 
Seat 7: matiko09 (€61.73 in chips) 
Seat 8: Ahangama (€50 in chips) 
Ahangama: posts small blind €0.25
ZonTTT: is sitting out 
CAJUN890: posts big blind €0.50
Avrora-sp: sits out 
*** HOLE CARDS ***
Dealt to matiko09 [6s Qd]
dndngod: folds 
IvanUrgant: folds 
Zelenis: folds 
ZonTTT leaves the table
CvMCvMCvM: folds 
matiko09: folds 
Ahangama: raises €1 to €1.50
Red_Warning joins the table at seat #9 
CAJUN890: raises €2.50 to €4
Ahangama: raises €5.50 to €9.50
CAJUN890: calls €5.50
*** FLOP *** [Qs Ts 2s]
Ahangama: checks 
CAJUN890: bets €9.07
Ahangama: folds 
Uncalled bet (€9.07) returned to CAJUN890
CAJUN890 collected €18.14 from pot
CAJUN890: doesn't show hand 
*** SUMMARY ***
Total pot €19 | Rake €0.86 
Board [Qs Ts 2s]
Seat 1: CAJUN890 (big blind) collected (€18.14)
Seat 2: dndngod folded before Flop (didn't bet)
Seat 3: IvanUrgant folded before Flop (didn't bet)
Seat 4: Zelenis folded before Flop (didn't bet)
Seat 6: CvMCvMCvM folded before Flop (didn't bet)
Seat 7: matiko09 (button) folded before Flop (didn't bet)
Seat 8: Ahangama (small blind) folded on the Flop





PokerStars Hand #150799316453:  Hold'em No Limit ($1/$2 USD) - 2016/03/23 13:30:09 CET [2016/03/23 8:30:09 ET]
Table 'Kiess' 9-max Seat #4 is the button
Seat 1: ldwin8 ($236.90 in chips) 
Seat 2: DUkalisUA ($509.66 in chips) 
Seat 3: The_red_area ($200 in chips) 
Seat 4: Moszes360 ($200 in chips) 
Seat 5: chippo boy ($283.10 in chips) 
Seat 6: matiko09 ($251.64 in chips) 
Seat 7: InsomniaRU ($330.13 in chips) 
Seat 8: WDW3 ($416.42 in chips) 
Seat 9: Fish4trips ($220.55 in chips) 
chippo boy: posts small blind $1
matiko09: posts big blind $2
*** HOLE CARDS ***
Dealt to matiko09 [5h Qh]
InsomniaRU: folds 
WDW3: folds 
Fish4trips: folds 
ldwin8: folds 
DUkalisUA: folds 
The_red_area: folds 
Moszes360: folds 
chippo boy: folds 
Uncalled bet ($1) returned to matiko09
matiko09 collected $2 from pot
matiko09: doesn't show hand 
*** SUMMARY ***
Total pot $2 | Rake $0 
Seat 1: ldwin8 folded before Flop (didn't bet)
Seat 2: DUkalisUA folded before Flop (didn't bet)
Seat 3: The_red_area folded before Flop (didn't bet)
Seat 4: Moszes360 (button) folded before Flop (didn't bet)
Seat 5: chippo boy (small blind) folded before Flop
Seat 6: matiko09 (big blind) collected ($2)
Seat 7: InsomniaRU folded before Flop (didn't bet)
Seat 8: WDW3 folded before Flop (didn't bet)
Seat 9: Fish4trips folded before Flop (didn't bet)





PokerStars Hand #150799319930:  Hold'em No Limit ($1/$2 USD) - 2016/03/23 13:30:16 CET [2016/03/23 8:30:16 ET]
Table 'Herba II' 9-max Seat #6 is the button
Seat 1: matiko09 ($235.52 in chips) 
Seat 2: Moszes360 ($216.20 in chips) 
Seat 3: Cirilico ($176.60 in chips) 
Seat 4: DUkalisUA ($250.20 in chips) 
Seat 5: chippo boy ($217.40 in chips) 
Seat 6: WDW3 ($200 in chips) 
Seat 7: InsomniaRU ($231 in chips) 
Seat 8: The_red_area ($200 in chips) 
Seat 9: mrhighryza ($89.86 in chips) 
InsomniaRU: posts small blind $1
The_red_area: posts big blind $2
*** HOLE CARDS ***
Dealt to matiko09 [3d 8h]
mrhighryza: calls $2
matiko09: folds 
Moszes360: folds 
Cirilico: raises $4 to $6
DUkalisUA: folds 
chippo boy: folds 
WDW3: folds 
InsomniaRU: folds 
The_red_area: raises $15 to $21
mrhighryza: folds 
Cirilico: folds 
Uncalled bet ($15) returned to The_red_area
The_red_area collected $15 from pot
The_red_area: doesn't show hand 
*** SUMMARY ***
Total pot $15 | Rake $0 
Seat 1: matiko09 folded before Flop (didn't bet)
Seat 2: Moszes360 folded before Flop (didn't bet)
Seat 3: Cirilico folded before Flop
Seat 4: DUkalisUA folded before Flop (didn't bet)
Seat 5: chippo boy folded before Flop (didn't bet)
Seat 6: WDW3 (button) folded before Flop (didn't bet)
Seat 7: InsomniaRU (small blind) folded before Flop
Seat 8: The_red_area (big blind) collected ($15)
Seat 9: mrhighryza folded before Flop





PokerStars Hand #150799321652:  Hold'em No Limit (€0.25/€0.50 EUR) - 2016/03/23 13:30:19 CET [2016/03/23 8:30:19 ET]
Table 'Palma II' 9-max Seat #1 is the button
Seat 1: Ahangama (€50 in chips) 
Seat 2: matiko09 (€51 in chips) 
Seat 3: ardo888 (€50 in chips) 
Seat 7: Wouter Des (€52.52 in chips) 
Seat 8: CvMCvMCvM (€50 in chips) 
Seat 9: ZonTTT (€50 in chips) 
matiko09: posts small blind €0.25
ardo888: posts big blind €0.50
dndngod: sits out 
SVFB13: sits out 
Red_Warning: sits out 
*** HOLE CARDS ***
Dealt to matiko09 [5h 4s]
Wouter Des: folds 
CvMCvMCvM: folds 
ZonTTT: raises €0.75 to €1.25
Ahangama: folds 
matiko09: folds 
ardo888: folds 
Uncalled bet (€0.75) returned to ZonTTT
ZonTTT collected €1.25 from pot
ZonTTT: doesn't show hand 
*** SUMMARY ***
Total pot €1.25 | Rake €0 
Seat 1: Ahangama (button) folded before Flop (didn't bet)
Seat 2: matiko09 (small blind) folded before Flop
Seat 3: ardo888 (big blind) folded before Flop
Seat 7: Wouter Des folded before Flop (didn't bet)
Seat 8: CvMCvMCvM folded before Flop (didn't bet)
Seat 9: ZonTTT collected (€1.25)





PokerStars Hand #150799326417:  Hold'em No Limit ($0.25/$0.50 USD) - 2016/03/23 13:30:28 CET [2016/03/23 8:30:28 ET]
Table 'Pyrrhus' 9-max Seat #9 is the button
Seat 1: lumen21 ($50 in chips) 
Seat 2: fandorin2005 ($50.75 in chips) 
Seat 3: IvanUrgant ($50 in chips) 
Seat 4: GriffinBerg ($40.17 in chips) 
Seat 5: lengcunjuan ($28.21 in chips) 
Seat 6: whalldo ($149.72 in chips) 
Seat 7: matiko09 ($116.40 in chips) 
Seat 8: dndngod ($66.72 in chips) 
Seat 9: CvMCvMCvM ($67.66 in chips) 
lumen21: posts small blind $0.25
fandorin2005: posts big blind $0.50
*** HOLE CARDS ***
Dealt to matiko09 [Jd Qd]
IvanUrgant: folds 
GriffinBerg: folds 
lengcunjuan: folds 
whalldo: raises $1 to $1.50
matiko09: raises $2.50 to $4
dndngod: folds 
CvMCvMCvM: folds 
lumen21: folds 
fandorin2005: folds 
whalldo: calls $2.50
*** FLOP *** [4d Jh 3s]
whalldo: checks 
matiko09: bets $4.34
whalldo: calls $4.34
*** TURN *** [4d Jh 3s] [8c]
whalldo: checks 
matiko09: checks 
*** RIVER *** [4d Jh 3s 8c] [Tc]
whalldo: checks 
matiko09: bets $5.16
whalldo: raises $28.34 to $33.50
matiko09: folds 
Uncalled bet ($28.34) returned to whalldo
whalldo collected $26.50 from pot
whalldo: doesn't show hand 
*** SUMMARY ***
Total pot $27.75 | Rake $1.25 
Board [4d Jh 3s 8c Tc]
Seat 1: lumen21 (small blind) folded before Flop
Seat 2: fandorin2005 (big blind) folded before Flop
Seat 3: IvanUrgant folded before Flop (didn't bet)
Seat 4: GriffinBerg folded before Flop (didn't bet)
Seat 5: lengcunjuan folded before Flop (didn't bet)
Seat 6: whalldo collected ($26.50)
Seat 7: matiko09 folded on the River
Seat 8: dndngod folded before Flop (didn't bet)
Seat 9: CvMCvMCvM (button) folded before Flop (didn't bet)





PokerStars Hand #150799326322:  Hold'em No Limit ($0.50/$1.00 USD) - 2016/03/23 13:30:28 CET [2016/03/23 8:30:28 ET]
Table 'Atlantis' 9-max Seat #7 is the button
Seat 1: xHourglass ($180.78 in chips) 
Seat 2: tffff2006 ($39.81 in chips) 
Seat 3: CAJUN890 ($110.19 in chips) 
Seat 4: matiko09 ($102.78 in chips) 
Seat 5: Pvsx. ($100 in chips) 
Seat 6: Jimy Tiltman ($110.74 in chips) 
Seat 7: Zeeshka ($120.11 in chips) 
Seat 8: DUkalisUA ($102.50 in chips) 
Seat 9: WDW3 ($116.97 in chips) 
DUkalisUA: posts small blind $0.50
WDW3: posts big blind $1
*** HOLE CARDS ***
Dealt to matiko09 [8c 6d]
xHourglass: folds 
tffff2006: folds 
CAJUN890: folds 
matiko09: folds 
Pvsx.: folds 
Jimy Tiltman: raises $1 to $2
Zeeshka: folds 
DUkalisUA: folds 
WDW3: folds 
Uncalled bet ($1) returned to Jimy Tiltman
Jimy Tiltman collected $2.50 from pot
Jimy Tiltman: doesn't show hand 
*** SUMMARY ***
Total pot $2.50 | Rake $0 
Seat 1: xHourglass folded before Flop (didn't bet)
Seat 2: tffff2006 folded before Flop (didn't bet)
Seat 3: CAJUN890 folded before Flop (didn't bet)
Seat 4: matiko09 folded before Flop (didn't bet)
Seat 5: Pvsx. folded before Flop (didn't bet)
Seat 6: Jimy Tiltman collected ($2.50)
Seat 7: Zeeshka (button) folded before Flop (didn't bet)
Seat 8: DUkalisUA (small blind) folded before Flop
Seat 9: WDW3 (big blind) folded before Flop





PokerStars Hand #150799329609:  Hold'em No Limit ($0.50/$1.00 USD) - 2016/03/23 13:30:34 CET [2016/03/23 8:30:34 ET]
Table 'Oljato' 9-max Seat #4 is the button
Seat 1: Pearl Jam87 ($198.90 in chips) 
Seat 2: roman134679 ($94.08 in chips) 
Seat 3: DUkalisUA ($100 in chips) 
Seat 4: Pvsx. ($100 in chips) 
Seat 5: ryo728 ($88.73 in chips) 
Seat 6: WDW3 ($120.11 in chips) 
Seat 7: matiko09 ($150.73 in chips) 
Seat 8: Zeeshka ($354.64 in chips) 
Seat 9: Jimy Tiltman ($115.56 in chips) 
ryo728: posts small blind $0.50
WDW3: posts big blind $1
*** HOLE CARDS ***
Dealt to matiko09 [2d 4d]
matiko09: folds 
roman134679 said, "lol"
Zeeshka: folds 
Jimy Tiltman: folds 
Pearl Jam87: folds 
roman134679: raises $1.01 to $2.01
DUkalisUA: folds 
Pvsx.: raises $4.99 to $7
ryo728: folds 
WDW3: folds 
roman134679: raises $15 to $22
Pvsx.: calls $15
*** FLOP *** [9d 3s Jd]
roman134679: bets $28
Pvsx.: calls $28
*** TURN *** [9d 3s Jd] [Qd]
roman134679: checks 
Pvsx.: bets $50 and is all-in
roman134679 said, "nh"
roman134679: folds 
Uncalled bet ($50) returned to Pvsx.
Pvsx. collected $98.70 from pot
Pvsx.: doesn't show hand 
*** SUMMARY ***
Total pot $101.50 | Rake $2.80 
Board [9d 3s Jd Qd]
Seat 1: Pearl Jam87 folded before Flop (didn't bet)
Seat 2: roman134679 folded on the Turn
Seat 3: DUkalisUA folded before Flop (didn't bet)
Seat 4: Pvsx. (button) collected ($98.70)
Seat 5: ryo728 (small blind) folded before Flop
Seat 6: WDW3 (big blind) folded before Flop
Seat 7: matiko09 folded before Flop (didn't bet)
Seat 8: Zeeshka folded before Flop (didn't bet)
Seat 9: Jimy Tiltman folded before Flop (didn't bet)





PokerStars Hand #150799333934:  Hold'em No Limit ($1/$2 USD) - 2016/03/23 13:30:42 CET [2016/03/23 8:30:42 ET]
Table 'Kiess' 9-max Seat #5 is the button
Seat 1: ldwin8 ($236.90 in chips) 
Seat 2: DUkalisUA ($509.66 in chips) 
Seat 3: The_red_area ($200 in chips) 
Seat 4: Moszes360 ($200 in chips) 
Seat 5: chippo boy ($282.10 in chips) 
Seat 6: matiko09 ($252.64 in chips) 
Seat 7: InsomniaRU ($330.13 in chips) 
Seat 8: WDW3 ($416.42 in chips) 
Seat 9: Fish4trips ($220.55 in chips) 
matiko09: posts small blind $1
InsomniaRU: posts big blind $2
*** HOLE CARDS ***
Dealt to matiko09 [Jc Ah]
WDW3: folds 
Fish4trips: folds 
ldwin8: folds 
DUkalisUA: folds 
The_red_area: folds 
Moszes360: raises $4 to $6
chippo boy: folds 
matiko09: raises $14 to $20
InsomniaRU: folds 
Moszes360: folds 
Uncalled bet ($14) returned to matiko09
matiko09 collected $14 from pot
matiko09: doesn't show hand 
*** SUMMARY ***
Total pot $14 | Rake $0 
Seat 1: ldwin8 folded before Flop (didn't bet)
Seat 2: DUkalisUA folded before Flop (didn't bet)
Seat 3: The_red_area folded before Flop (didn't bet)
Seat 4: Moszes360 folded before Flop
Seat 5: chippo boy (button) folded before Flop (didn't bet)
Seat 6: matiko09 (small blind) collected ($14)
Seat 7: InsomniaRU (big blind) folded before Flop
Seat 8: WDW3 folded before Flop (didn't bet)
Seat 9: Fish4trips folded before Flop (didn't bet)





PokerStars Hand #150799339919:  Hold'em No Limit ($0.50/$1.00 USD) - 2016/03/23 13:30:53 CET [2016/03/23 8:30:53 ET]
Table 'Kippes' 9-max Seat #1 is the button
Seat 1: Pvsx. ($100 in chips) 
Seat 2: RICKA16 ($128.13 in chips) 
Seat 3: CAJUN890 ($117.31 in chips) 
Seat 4: matiko09 ($115.22 in chips) 
Seat 5: Jimy Tiltman ($100 in chips) 
Seat 6: WDW3 ($123.75 in chips) 
Seat 7: lumen21 ($101.50 in chips) 
Seat 8: Zeeshka ($103.30 in chips) 
Seat 9: wang19790906 ($78.44 in chips) 
RICKA16: posts small blind $0.50
CAJUN890: posts big blind $1
*** HOLE CARDS ***
Dealt to matiko09 [Jd Td]
matiko09: raises $2 to $3
Jimy Tiltman: folds 
WDW3: folds 
lumen21: folds 
Zeeshka: folds 
wang19790906: folds 
Pvsx.: folds 
RICKA16: folds 
CAJUN890: folds 
Uncalled bet ($2) returned to matiko09
matiko09 collected $2.50 from pot
matiko09: doesn't show hand 
*** SUMMARY ***
Total pot $2.50 | Rake $0 
Seat 1: Pvsx. (button) folded before Flop (didn't bet)
Seat 2: RICKA16 (small blind) folded before Flop
Seat 3: CAJUN890 (big blind) folded before Flop
Seat 4: matiko09 collected ($2.50)
Seat 5: Jimy Tiltman folded before Flop (didn't bet)
Seat 6: WDW3 folded before Flop (didn't bet)
Seat 7: lumen21 folded before Flop (didn't bet)
Seat 8: Zeeshka folded before Flop (didn't bet)
Seat 9: wang19790906 folded before Flop (didn't bet)





PokerStars Hand #150799339501:  Hold'em No Limit ($1/$2 USD) - 2016/03/23 13:30:53 CET [2016/03/23 8:30:53 ET]
Table 'Berbericia II' 9-max Seat #9 is the button
Seat 1: WDW3 ($243.48 in chips) 
Seat 2: Moszes360 ($216.15 in chips) 
Seat 3: Fish4trips ($202.32 in chips) 
Seat 4: bennetb77 ($172.16 in chips) 
Seat 5: Surxach ($102.69 in chips) 
Seat 6: coinflip_si ($200 in chips) 
Seat 7: niuquan ($18.90 in chips) 
Seat 8: matiko09 ($200 in chips) 
Seat 9: LVV-Bif ($186.38 in chips) 
WDW3: posts small blind $1
Moszes360: posts big blind $2
*** HOLE CARDS ***
Dealt to matiko09 [4s 4d]
Fish4trips: folds 
bennetb77: raises $2 to $4
Surxach: folds 
coinflip_si: folds 
niuquan: folds 
matiko09: calls $4
LVV-Bif: folds 
WDW3: folds 
Moszes360: folds 
*** FLOP *** [2h 5c 9s]
bennetb77: bets $5
matiko09: calls $5
*** TURN *** [2h 5c 9s] [2s]
bennetb77: checks 
matiko09: checks 
*** RIVER *** [2h 5c 9s 2s] [3c]
bennetb77: checks 
matiko09: bets $2
bennetb77: folds 
Uncalled bet ($2) returned to matiko09
matiko09 collected $20.06 from pot
matiko09: doesn't show hand 
*** SUMMARY ***
Total pot $21 | Rake $0.94 
Board [2h 5c 9s 2s 3c]
Seat 1: WDW3 (small blind) folded before Flop
Seat 2: Moszes360 (big blind) folded before Flop
Seat 3: Fish4trips folded before Flop (didn't bet)
Seat 4: bennetb77 folded on the River
Seat 5: Surxach folded before Flop (didn't bet)
Seat 6: coinflip_si folded before Flop (didn't bet)
Seat 7: niuquan folded before Flop (didn't bet)
Seat 8: matiko09 collected ($20.06)
Seat 9: LVV-Bif (button) folded before Flop (didn't bet)





PokerStars Hand #150799340765:  Hold'em No Limit ($0.50/$1.00 USD) - 2016/03/23 13:30:55 CET [2016/03/23 8:30:55 ET]
Table 'Atlantis' 9-max Seat #8 is the button
Seat 1: xHourglass ($180.78 in chips) 
Seat 2: tffff2006 ($39.81 in chips) 
Seat 3: CAJUN890 ($110.19 in chips) 
Seat 4: matiko09 ($102.78 in chips) 
Seat 5: Pvsx. ($100 in chips) 
Seat 6: Jimy Tiltman ($112.24 in chips) 
Seat 7: Zeeshka ($120.11 in chips) 
Seat 8: DUkalisUA ($102 in chips) 
Seat 9: WDW3 ($115.97 in chips) 
WDW3: posts small blind $0.50
xHourglass: posts big blind $1
*** HOLE CARDS ***
Dealt to matiko09 [7c 5h]
tffff2006: folds 
CAJUN890: folds 
matiko09: folds 
Pvsx.: folds 
Jimy Tiltman: raises $2 to $3
Zeeshka: folds 
DUkalisUA: folds 
WDW3: folds 
xHourglass: folds 
Uncalled bet ($2) returned to Jimy Tiltman
Jimy Tiltman collected $2.50 from pot
Jimy Tiltman: doesn't show hand 
*** SUMMARY ***
Total pot $2.50 | Rake $0 
Seat 1: xHourglass (big blind) folded before Flop
Seat 2: tffff2006 folded before Flop (didn't bet)
Seat 3: CAJUN890 folded before Flop (didn't bet)
Seat 4: matiko09 folded before Flop (didn't bet)
Seat 5: Pvsx. folded before Flop (didn't bet)
Seat 6: Jimy Tiltman collected ($2.50)
Seat 7: Zeeshka folded before Flop (didn't bet)
Seat 8: DUkalisUA (button) folded before Flop (didn't bet)
Seat 9: WDW3 (small blind) folded before Flop





PokerStars Hand #150799341055:  Hold'em No Limit ($1/$2 USD) - 2016/03/23 13:30:56 CET [2016/03/23 8:30:56 ET]
Table 'Herba II' 9-max Seat #7 is the button
Seat 1: matiko09 ($235.52 in chips) 
Seat 2: Moszes360 ($216.20 in chips) 
Seat 3: Cirilico ($170.60 in chips) 
Seat 4: DUkalisUA ($250.20 in chips) 
Seat 5: chippo boy ($217.40 in chips) 
Seat 6: WDW3 ($200 in chips) 
Seat 7: InsomniaRU ($230 in chips) 
Seat 8: The_red_area ($209 in chips) 
Seat 9: mrhighryza ($87.86 in chips) 
The_red_area: posts small blind $1
mrhighryza: posts big blind $2
*** HOLE CARDS ***
Dealt to matiko09 [Qc Ad]
matiko09: raises $3 to $5
Moszes360: folds 
Cirilico: folds 
DUkalisUA: folds 
chippo boy: calls $5
WDW3: raises $15 to $20
InsomniaRU: folds 
The_red_area: raises $52 to $72
mrhighryza: folds 
matiko09: folds 
chippo boy: folds 
WDW3: folds 
Uncalled bet ($52) returned to The_red_area
The_red_area collected $52 from pot
The_red_area: doesn't show hand 
*** SUMMARY ***
Total pot $52 | Rake $0 
Seat 1: matiko09 folded before Flop
Seat 2: Moszes360 folded before Flop (didn't bet)
Seat 3: Cirilico folded before Flop (didn't bet)
Seat 4: DUkalisUA folded before Flop (didn't bet)
Seat 5: chippo boy folded before Flop
Seat 6: WDW3 folded before Flop
Seat 7: InsomniaRU (button) folded before Flop (didn't bet)
Seat 8: The_red_area (small blind) collected ($52)
Seat 9: mrhighryza (big blind) folded before Flop





PokerStars Hand #150799342013:  Hold'em No Limit ($0.50/$1.00 USD) - 2016/03/23 13:30:57 CET [2016/03/23 8:30:57 ET]
Table 'Smiley' 9-max Seat #5 is the button
Seat 1: WDW3 ($100 in chips) 
Seat 2: Jimy Tiltman ($100 in chips) 
Seat 3: matiko09 ($141.66 in chips) 
Seat 4: Zeeshka ($100 in chips) 
Seat 5: DUkalisUA ($100 in chips) 
Seat 6: blackmont111 ($57.21 in chips) 
Seat 8: RICKA16 ($120.82 in chips) 
Seat 9: morosun ($112.57 in chips) 
blackmont111: posts small blind $0.50
RICKA16: posts big blind $1
*** HOLE CARDS ***
Dealt to matiko09 [9c 7c]
morosun: calls $1
WDW3: folds 
Jimy Tiltman: folds 
matiko09: raises $3 to $4
Zeeshka: folds 
DUkalisUA: folds 
blackmont111: calls $3.50
RICKA16: folds 
morosun: calls $3
*** FLOP *** [Td 3d 4s]
blackmont111: checks 
morosun: bets $3
matiko09: folds 
blackmont111: calls $3
*** TURN *** [Td 3d 4s] [5c]
blackmont111: checks 
morosun: bets $9.07
blackmont111: folds 
Uncalled bet ($9.07) returned to morosun
morosun collected $18.14 from pot
*** SUMMARY ***
Total pot $19 | Rake $0.86 
Board [Td 3d 4s 5c]
Seat 1: WDW3 folded before Flop (didn't bet)
Seat 2: Jimy Tiltman folded before Flop (didn't bet)
Seat 3: matiko09 folded on the Flop
Seat 4: Zeeshka folded before Flop (didn't bet)
Seat 5: DUkalisUA (button) folded before Flop (didn't bet)
Seat 6: blackmont111 (small blind) folded on the Turn
Seat 8: RICKA16 (big blind) folded before Flop
Seat 9: morosun collected ($18.14)





PokerStars Hand #150799343800:  Hold'em No Limit ($0.25/$0.50 USD) - 2016/03/23 13:31:01 CET [2016/03/23 8:31:01 ET]
Table 'Belnika' 9-max Seat #8 is the button
Seat 1: yellowfever0 ($25.31 in chips) 
Seat 2: NeverRegret7 ($64.81 in chips) 
Seat 3: ChiChioChi ($32.81 in chips) 
Seat 4: matiko09 ($66.56 in chips) 
Seat 5: fandorin2005 ($50.64 in chips) 
Seat 6: Ahangama ($50 in chips) 
Seat 7: Zeeshka ($50 in chips) 
Seat 8: lumen21 ($69.64 in chips) 
Seat 9: dndngod ($63.87 in chips) 
dndngod: posts small blind $0.25
yellowfever0: posts big blind $0.50
*** HOLE CARDS ***
Dealt to matiko09 [Jd 7c]
NeverRegret7: folds 
ChiChioChi: calls $0.50
matiko09: folds 
fandorin2005: folds 
Ahangama: raises $1.50 to $2
Zeeshka: folds 
lumen21: folds 
dndngod: folds 
yellowfever0: calls $1.50
ChiChioChi: calls $1.50
*** FLOP *** [7d 4h 5s]
yellowfever0: checks 
ChiChioChi: checks 
Ahangama: bets $4.50
yellowfever0: folds 
ChiChioChi: calls $4.50
*** TURN *** [7d 4h 5s] [Th]
ChiChioChi: checks 
Ahangama: bets $9
ChiChioChi: calls $9
*** RIVER *** [7d 4h 5s Th] [2d]
ChiChioChi: checks 
Ahangama: bets $18
ChiChioChi: folds 
Uncalled bet ($18) returned to Ahangama
Ahangama collected $31.75 from pot
Ahangama: doesn't show hand 
*** SUMMARY ***
Total pot $33.25 | Rake $1.50 
Board [7d 4h 5s Th 2d]
Seat 1: yellowfever0 (big blind) folded on the Flop
Seat 2: NeverRegret7 folded before Flop (didn't bet)
Seat 3: ChiChioChi folded on the River
Seat 4: matiko09 folded before Flop (didn't bet)
Seat 5: fandorin2005 folded before Flop (didn't bet)
Seat 6: Ahangama collected ($31.75)
Seat 7: Zeeshka folded before Flop (didn't bet)
Seat 8: lumen21 (button) folded before Flop (didn't bet)
Seat 9: dndngod (small blind) folded before Flop





PokerStars Hand #150799347509:  Hold'em No Limit (€0.25/€0.50 EUR) - 2016/03/23 13:31:08 CET [2016/03/23 8:31:08 ET]
Table 'Palma II' 9-max Seat #2 is the button
Seat 1: Ahangama (€50 in chips) 
Seat 2: matiko09 (€50.75 in chips) 
Seat 3: ardo888 (€50 in chips) 
Seat 4: dndngod (€50 in chips) 
Seat 7: Wouter Des (€52.52 in chips) 
Seat 8: CvMCvMCvM (€50 in chips) 
Seat 9: ZonTTT (€50.75 in chips) 
ardo888: posts small blind €0.25
dndngod: posts big blind €0.50
SVFB13: sits out 
Red_Warning: sits out 
*** HOLE CARDS ***
Dealt to matiko09 [2s Qd]
Wouter Des: calls €0.50
CvMCvMCvM: folds 
ZonTTT: folds 
Ahangama: folds 
matiko09: folds 
ardo888: calls €0.25
dndngod: checks 
*** FLOP *** [Kh As 3h]
ardo888: checks 
dndngod: bets €0.75
Wouter Des: calls €0.75
ardo888: folds 
*** TURN *** [Kh As 3h] [3c]
dndngod: bets €2
Wouter Des: calls €2
*** RIVER *** [Kh As 3h 3c] [4c]
dndngod: checks 
Wouter Des: bets €6.68
dndngod: folds 
Uncalled bet (€6.68) returned to Wouter Des
Wouter Des collected €6.68 from pot
Wouter Des: doesn't show hand 
*** SUMMARY ***
Total pot €7 | Rake €0.32 
Board [Kh As 3h 3c 4c]
Seat 1: Ahangama folded before Flop (didn't bet)
Seat 2: matiko09 (button) folded before Flop (didn't bet)
Seat 3: ardo888 (small blind) folded on the Flop
Seat 4: dndngod (big blind) folded on the River
Seat 7: Wouter Des collected (€6.68)
Seat 8: CvMCvMCvM folded before Flop (didn't bet)
Seat 9: ZonTTT folded before Flop (didn't bet)





PokerStars Hand #150799349996:  Hold'em No Limit (€0.25/€0.50 EUR) - 2016/03/23 13:31:12 CET [2016/03/23 8:31:12 ET]
Table 'Hesperia II' 9-max Seat #8 is the button
Seat 1: CAJUN890 (€58.64 in chips) 
Seat 2: dndngod (€50 in chips) 
Seat 3: IvanUrgant (€50 in chips) 
Seat 4: Zelenis (€11.14 in chips) 
Seat 6: CvMCvMCvM (€50 in chips) 
Seat 7: matiko09 (€61.73 in chips) 
Seat 8: Ahangama (€50 in chips) 
Red_Warning will be allowed to play after the button
CAJUN890: posts small blind €0.25
dndngod: posts big blind €0.50
Avrora-sp: sits out 
*** HOLE CARDS ***
Dealt to matiko09 [4d 2s]
IvanUrgant: folds 
Zelenis: folds 
CvMCvMCvM: folds 
matiko09: folds 
Ahangama: folds 
CAJUN890: calls €0.25
dndngod: checks 
*** FLOP *** [2h Jc 9h]
CAJUN890: bets €1
dndngod: folds 
Uncalled bet (€1) returned to CAJUN890
CAJUN890 collected €0.96 from pot
CAJUN890: doesn't show hand 
*** SUMMARY ***
Total pot €1 | Rake €0.04 
Board [2h Jc 9h]
Seat 1: CAJUN890 (small blind) collected (€0.96)
Seat 2: dndngod (big blind) folded on the Flop
Seat 3: IvanUrgant folded before Flop (didn't bet)
Seat 4: Zelenis folded before Flop (didn't bet)
Seat 6: CvMCvMCvM folded before Flop (didn't bet)
Seat 7: matiko09 folded before Flop (didn't bet)
Seat 8: Ahangama (button) folded before Flop (didn't bet)





PokerStars Hand #150799353350:  Hold'em No Limit ($1/$2 USD) - 2016/03/23 13:31:19 CET [2016/03/23 8:31:19 ET]
Table 'Kypria II' 9-max Seat #8 is the button
Seat 1: geldwolfje ($275.39 in chips) 
Seat 2: coinflip_si ($200 in chips) 
Seat 3: seouljam ($208.14 in chips) 
Seat 4: nailz83 ($105.09 in chips) 
Seat 6: matiko09 ($250.64 in chips) 
Seat 8: Fish4trips ($269.39 in chips) 
Seat 9: WDW3 ($200 in chips) 
WDW3: posts small blind $1
geldwolfje: posts big blind $2
InsomniaRU: sits out 
DUkalisUA: sits out 
*** HOLE CARDS ***
Dealt to matiko09 [Kd 4c]
coinflip_si: folds 
seouljam said, "lol"
seouljam: folds 
nailz83: folds 
matiko09: folds 
seouljam said, "AQ was good"
Fish4trips: raises $2 to $4
WDW3: folds 
geldwolfje: calls $2
*** FLOP *** [Jd 9c Ts]
geldwolfje: checks 
Fish4trips: checks 
*** TURN *** [Jd 9c Ts] [3c]
geldwolfje: bets $4
Fish4trips: calls $4
*** RIVER *** [Jd 9c Ts 3c] [9d]
geldwolfje: bets $8
Fish4trips: raises $26 to $34
geldwolfje: calls $26
*** SHOW DOWN ***
Fish4trips: shows [Ad 9s] (three of a kind, Nines)
geldwolfje: mucks hand 
Fish4trips collected $82.20 from pot
seouljam said, "^^"
*** SUMMARY ***
Total pot $85 | Rake $2.80 
Board [Jd 9c Ts 3c 9d]
Seat 1: geldwolfje (big blind) mucked [Js 8h]
Seat 2: coinflip_si folded before Flop (didn't bet)
Seat 3: seouljam folded before Flop (didn't bet)
Seat 4: nailz83 folded before Flop (didn't bet)
Seat 6: matiko09 folded before Flop (didn't bet)
Seat 8: Fish4trips (button) showed [Ad 9s] and won ($82.20) with three of a kind, Nines
Seat 9: WDW3 (small blind) folded before Flop





PokerStars Hand #150799357248:  Hold'em No Limit ($1/$2 USD) - 2016/03/23 13:31:26 CET [2016/03/23 8:31:26 ET]
Table 'Kiess' 9-max Seat #6 is the button
Seat 1: ldwin8 ($236.90 in chips) 
Seat 2: DUkalisUA ($509.66 in chips) 
Seat 3: The_red_area ($200 in chips) 
Seat 4: Moszes360 ($200 in chips) 
Seat 5: chippo boy ($282.10 in chips) 
Seat 6: matiko09 ($260.64 in chips) 
Seat 7: InsomniaRU ($328.13 in chips) 
Seat 8: WDW3 ($416.42 in chips) 
Seat 9: Fish4trips ($220.55 in chips) 
InsomniaRU: posts small blind $1
WDW3: posts big blind $2
*** HOLE CARDS ***
Dealt to matiko09 [7s 6d]
Fish4trips: folds 
ldwin8: folds 
DUkalisUA: folds 
The_red_area: folds 
Moszes360: folds 
chippo boy: folds 
matiko09: folds 
InsomniaRU: raises $4 to $6
WDW3: folds 
Uncalled bet ($4) returned to InsomniaRU
InsomniaRU collected $4 from pot
InsomniaRU: doesn't show hand 
*** SUMMARY ***
Total pot $4 | Rake $0 
Seat 1: ldwin8 folded before Flop (didn't bet)
Seat 2: DUkalisUA folded before Flop (didn't bet)
Seat 3: The_red_area folded before Flop (didn't bet)
Seat 4: Moszes360 folded before Flop (didn't bet)
Seat 5: chippo boy folded before Flop (didn't bet)
Seat 6: matiko09 (button) folded before Flop (didn't bet)
Seat 7: InsomniaRU (small blind) collected ($4)
Seat 8: WDW3 (big blind) folded before Flop
Seat 9: Fish4trips folded before Flop (didn't bet)





PokerStars Hand #150799359231:  Hold'em No Limit ($0.50/$1.00 USD) - 2016/03/23 13:31:30 CET [2016/03/23 8:31:30 ET]
Table 'Atlantis' 9-max Seat #9 is the button
Seat 1: xHourglass ($179.78 in chips) 
Seat 2: tffff2006 ($39.81 in chips) 
Seat 3: CAJUN890 ($110.19 in chips) 
Seat 4: matiko09 ($102.78 in chips) 
Seat 5: Pvsx. ($100 in chips) 
Seat 6: Jimy Tiltman ($113.74 in chips) 
Seat 7: Zeeshka ($120.11 in chips) 
Seat 8: DUkalisUA ($102 in chips) 
Seat 9: WDW3 ($115.47 in chips) 
xHourglass: posts small blind $0.50
tffff2006: posts big blind $1
*** HOLE CARDS ***
Dealt to matiko09 [Qh 3d]
CAJUN890: folds 
matiko09: folds 
Pvsx.: folds 
Jimy Tiltman: folds 
Zeeshka: raises $2 to $3
DUkalisUA: folds 
WDW3: calls $3
xHourglass: folds 
tffff2006: calls $2
*** FLOP *** [Ac 8c As]
tffff2006: checks 
Zeeshka: checks 
WDW3: checks 
*** TURN *** [Ac 8c As] [2s]
tffff2006: bets $4.53
Zeeshka: calls $4.53
WDW3: folds 
*** RIVER *** [Ac 8c As 2s] [Js]
tffff2006: bets $8.86
Zeeshka: calls $8.86
*** SHOW DOWN ***
tffff2006: shows [9h Jd] (two pair, Aces and Jacks)
Zeeshka: shows [Th Ad] (three of a kind, Aces)
Zeeshka collected $34.65 from pot
*** SUMMARY ***
Total pot $36.28 | Rake $1.63 
Board [Ac 8c As 2s Js]
Seat 1: xHourglass (small blind) folded before Flop
Seat 2: tffff2006 (big blind) showed [9h Jd] and lost with two pair, Aces and Jacks
Seat 3: CAJUN890 folded before Flop (didn't bet)
Seat 4: matiko09 folded before Flop (didn't bet)
Seat 5: Pvsx. folded before Flop (didn't bet)
Seat 6: Jimy Tiltman folded before Flop (didn't bet)
Seat 7: Zeeshka showed [Th Ad] and won ($34.65) with three of a kind, Aces
Seat 8: DUkalisUA folded before Flop (didn't bet)
Seat 9: WDW3 (button) folded on the Turn





PokerStars Hand #150799360499:  Hold'em No Limit ($0.50/$1.00 USD) - 2016/03/23 13:31:32 CET [2016/03/23 8:31:32 ET]
Table 'Kippes' 9-max Seat #2 is the button
Seat 1: Pvsx. ($100 in chips) 
Seat 2: RICKA16 ($127.63 in chips) 
Seat 3: CAJUN890 ($116.31 in chips) 
Seat 4: matiko09 ($116.72 in chips) 
Seat 5: Jimy Tiltman ($100 in chips) 
Seat 6: WDW3 ($123.75 in chips) 
Seat 7: lumen21 ($101.50 in chips) 
Seat 8: Zeeshka ($103.30 in chips) 
Seat 9: wang19790906 ($78.44 in chips) 
CAJUN890: posts small blind $0.50
matiko09: posts big blind $1
*** HOLE CARDS ***
Dealt to matiko09 [9s 8c]
Jimy Tiltman: folds 
WDW3: folds 
lumen21: folds 
Zeeshka: folds 
wang19790906: raises $3 to $4
Pvsx.: folds 
RICKA16: folds 
CAJUN890: folds 
matiko09: folds 
Uncalled bet ($3) returned to wang19790906
wang19790906 collected $2.50 from pot
wang19790906: doesn't show hand 
*** SUMMARY ***
Total pot $2.50 | Rake $0 
Seat 1: Pvsx. folded before Flop (didn't bet)
Seat 2: RICKA16 (button) folded before Flop (didn't bet)
Seat 3: CAJUN890 (small blind) folded before Flop
Seat 4: matiko09 (big blind) folded before Flop
Seat 5: Jimy Tiltman folded before Flop (didn't bet)
Seat 6: WDW3 folded before Flop (didn't bet)
Seat 7: lumen21 folded before Flop (didn't bet)
Seat 8: Zeeshka folded before Flop (didn't bet)
Seat 9: wang19790906 collected ($2.50)





PokerStars Hand #150799367473:  Hold'em No Limit (€0.25/€0.50 EUR) - 2016/03/23 13:31:45 CET [2016/03/23 8:31:45 ET]
Table 'Hesperia II' 9-max Seat #1 is the button
Seat 1: CAJUN890 (€59.10 in chips) 
Seat 2: dndngod (€50 in chips) 
Seat 3: IvanUrgant (€50 in chips) 
Seat 4: Zelenis (€11.14 in chips) 
Seat 6: CvMCvMCvM (€50 in chips) 
Seat 7: matiko09 (€61.73 in chips) 
Seat 8: Ahangama (€50 in chips) 
dndngod: posts small blind €0.25
IvanUrgant: posts big blind €0.50
Avrora-sp: sits out 
Red_Warning: sits out 
*** HOLE CARDS ***
Dealt to matiko09 [7d Qc]
Zelenis: folds 
CvMCvMCvM: folds 
matiko09: folds 
Ahangama: folds 
CAJUN890: folds 
dndngod: folds 
Uncalled bet (€0.25) returned to IvanUrgant
IvanUrgant collected €0.50 from pot
IvanUrgant: doesn't show hand 
*** SUMMARY ***
Total pot €0.50 | Rake €0 
Seat 1: CAJUN890 (button) folded before Flop (didn't bet)
Seat 2: dndngod (small blind) folded before Flop
Seat 3: IvanUrgant (big blind) collected (€0.50)
Seat 4: Zelenis folded before Flop (didn't bet)
Seat 6: CvMCvMCvM folded before Flop (didn't bet)
Seat 7: matiko09 folded before Flop (didn't bet)
Seat 8: Ahangama folded before Flop (didn't bet)





PokerStars Hand #150799368069:  Hold'em No Limit ($1/$2 USD) - 2016/03/23 13:31:46 CET [2016/03/23 8:31:46 ET]
Table 'Kiess' 9-max Seat #7 is the button
Seat 1: ldwin8 ($236.90 in chips) 
Seat 2: DUkalisUA ($509.66 in chips) 
Seat 3: The_red_area ($200 in chips) 
Seat 4: Moszes360 ($200 in chips) 
Seat 5: chippo boy ($282.10 in chips) 
Seat 6: matiko09 ($260.64 in chips) 
Seat 7: InsomniaRU ($330.13 in chips) 
Seat 8: WDW3 ($414.42 in chips) 
Seat 9: Fish4trips ($220.55 in chips) 
WDW3: posts small blind $1
Fish4trips: posts big blind $2
*** HOLE CARDS ***
Dealt to matiko09 [5s 7s]
ldwin8: raises $4 to $6
DUkalisUA: raises $11 to $17
The_red_area: folds 
Moszes360: folds 
chippo boy: folds 
matiko09: folds 
InsomniaRU: folds 
WDW3: folds 
Fish4trips: folds 
ldwin8: calls $11
*** FLOP *** [8s 3c 9h]
ldwin8: checks 
DUkalisUA: checks 
*** TURN *** [8s 3c 9h] [8d]
ldwin8: bets $35.34
DUkalisUA: calls $35.34
*** RIVER *** [8s 3c 9h 8d] [9s]
ldwin8: bets $104.88
DUkalisUA: calls $104.88
*** SHOW DOWN ***
ldwin8: shows [3s As] (two pair, Nines and Eights)
DUkalisUA: shows [Kd Ac] (two pair, Nines and Eights)
ldwin8 collected $157.32 from pot
DUkalisUA collected $157.32 from pot
*** SUMMARY ***
Total pot $317.44 | Rake $2.80 
Board [8s 3c 9h 8d 9s]
Seat 1: ldwin8 showed [3s As] and won ($157.32) with two pair, Nines and Eights
Seat 2: DUkalisUA showed [Kd Ac] and won ($157.32) with two pair, Nines and Eights
Seat 3: The_red_area folded before Flop (didn't bet)
Seat 4: Moszes360 folded before Flop (didn't bet)
Seat 5: chippo boy folded before Flop (didn't bet)
Seat 6: matiko09 folded before Flop (didn't bet)
Seat 7: InsomniaRU (button) folded before Flop (didn't bet)
Seat 8: WDW3 (small blind) folded before Flop
Seat 9: Fish4trips (big blind) folded before Flop





PokerStars Hand #150799380692:  Hold'em No Limit (€0.25/€0.50 EUR) - 2016/03/23 13:32:10 CET [2016/03/23 8:32:10 ET]
Table 'Palma II' 9-max Seat #3 is the button
Seat 1: Ahangama (€50 in chips) 
Seat 2: matiko09 (€50.75 in chips) 
Seat 3: ardo888 (€50 in chips) 
Seat 4: dndngod (€50 in chips) 
Seat 5: SVFB13 (€50 in chips) 
Seat 7: Wouter Des (€55.95 in chips) 
Seat 8: CvMCvMCvM (€50 in chips) 
Seat 9: ZonTTT (€50.75 in chips) 
dndngod: posts small blind €0.25
SVFB13: posts big blind €0.50
Red_Warning: sits out 
*** HOLE CARDS ***
Dealt to matiko09 [Qs 6c]
Wouter Des: folds 
CvMCvMCvM: raises €0.57 to €1.07
ZonTTT: calls €1.07
Ahangama: folds 
matiko09: folds 
ardo888: calls €1.07
dndngod: calls €0.82
SVFB13: folds 
*** FLOP *** [9c Js 7s]
dndngod: checks 
CvMCvMCvM: checks 
ZonTTT: checks 
ardo888: checks 
*** TURN *** [9c Js 7s] [4d]
dndngod: bets €3
CvMCvMCvM: folds 
ZonTTT: folds 
ardo888: folds 
Uncalled bet (€3) returned to dndngod
dndngod collected €4.56 from pot
dndngod: doesn't show hand 
*** SUMMARY ***
Total pot €4.78 | Rake €0.22 
Board [9c Js 7s 4d]
Seat 1: Ahangama folded before Flop (didn't bet)
Seat 2: matiko09 folded before Flop (didn't bet)
Seat 3: ardo888 (button) folded on the Turn
Seat 4: dndngod (small blind) collected (€4.56)
Seat 5: SVFB13 (big blind) folded before Flop
Seat 7: Wouter Des folded before Flop (didn't bet)
Seat 8: CvMCvMCvM folded on the Turn
Seat 9: ZonTTT folded on the Turn





PokerStars Hand #150799380394:  Hold'em No Limit ($0.50/$1.00 USD) - 2016/03/23 13:32:10 CET [2016/03/23 8:32:10 ET]
Table 'Kippes' 9-max Seat #3 is the button
Seat 1: Pvsx. ($100 in chips) 
Seat 2: RICKA16 ($127.63 in chips) 
Seat 3: CAJUN890 ($115.81 in chips) 
Seat 4: matiko09 ($115.72 in chips) 
Seat 5: Jimy Tiltman ($100 in chips) 
Seat 6: WDW3 ($123.75 in chips) 
Seat 7: lumen21 ($101.50 in chips) 
Seat 8: Zeeshka ($103.30 in chips) 
Seat 9: wang19790906 ($79.94 in chips) 
matiko09: posts small blind $0.50
Jimy Tiltman: posts big blind $1
*** HOLE CARDS ***
Dealt to matiko09 [7c 2h]
WDW3: folds 
lumen21: folds 
Zeeshka: folds 
wang19790906: folds 
Pvsx.: folds 
RICKA16: folds 
CAJUN890: folds 
matiko09: folds 
Uncalled bet ($0.50) returned to Jimy Tiltman
Jimy Tiltman collected $1 from pot
Jimy Tiltman: doesn't show hand 
*** SUMMARY ***
Total pot $1 | Rake $0 
Seat 1: Pvsx. folded before Flop (didn't bet)
Seat 2: RICKA16 folded before Flop (didn't bet)
Seat 3: CAJUN890 (button) folded before Flop (didn't bet)
Seat 4: matiko09 (small blind) folded before Flop
Seat 5: Jimy Tiltman (big blind) collected ($1)
Seat 6: WDW3 folded before Flop (didn't bet)
Seat 7: lumen21 folded before Flop (didn't bet)
Seat 8: Zeeshka folded before Flop (didn't bet)
Seat 9: wang19790906 folded before Flop (didn't bet)





PokerStars Hand #150799380393:  Hold'em No Limit (€0.25/€0.50 EUR) - 2016/03/23 13:32:10 CET [2016/03/23 8:32:10 ET]
Table 'Hesperia II' 9-max Seat #2 is the button
Seat 1: CAJUN890 (€59.10 in chips) 
Seat 2: dndngod (€50 in chips) 
Seat 3: IvanUrgant (€50.25 in chips) 
Seat 4: Zelenis (€11.14 in chips) 
Seat 6: CvMCvMCvM (€50 in chips) 
Seat 7: matiko09 (€61.73 in chips) 
Seat 8: Ahangama (€50 in chips) 
IvanUrgant: posts small blind €0.25
Zelenis: posts big blind €0.50
Avrora-sp: sits out 
Red_Warning: sits out 
*** HOLE CARDS ***
Dealt to matiko09 [9d Ks]
CvMCvMCvM: folds 
matiko09: folds 
Ahangama: folds 
CAJUN890: raises €1.50 to €2
dndngod: folds 
IvanUrgant: folds 
Zelenis: calls €1.50
*** FLOP *** [8h 2c 8s]
Zelenis: checks 
CAJUN890: bets €3
Zelenis: calls €3
*** TURN *** [8h 2c 8s] [5c]
Zelenis: checks 
CAJUN890: bets €9.79
Zelenis: calls €6.14 and is all-in
Uncalled bet (€3.65) returned to CAJUN890
*** RIVER *** [8h 2c 8s 5c] [3h]
*** SHOW DOWN ***
Zelenis: shows [8d 8c] (four of a kind, Eights)
CAJUN890: shows [Jc Jh] (two pair, Jacks and Eights)
Zelenis collected €21.52 from pot
*** SUMMARY ***
Total pot €22.53 | Rake €1.01 
Board [8h 2c 8s 5c 3h]
Seat 1: CAJUN890 showed [Jc Jh] and lost with two pair, Jacks and Eights
Seat 2: dndngod (button) folded before Flop (didn't bet)
Seat 3: IvanUrgant (small blind) folded before Flop
Seat 4: Zelenis (big blind) showed [8d 8c] and won (€21.52) with four of a kind, Eights
Seat 6: CvMCvMCvM folded before Flop (didn't bet)
Seat 7: matiko09 folded before Flop (didn't bet)
Seat 8: Ahangama folded before Flop (didn't bet)





PokerStars Hand #150799381777:  Hold'em No Limit ($1/$2 USD) - 2016/03/23 13:32:12 CET [2016/03/23 8:32:12 ET]
Table 'Herba II' 9-max Seat #8 is the button
Seat 1: matiko09 ($230.52 in chips) 
Seat 2: Moszes360 ($216.20 in chips) 
Seat 3: Cirilico ($170.60 in chips) 
Seat 4: DUkalisUA ($250.20 in chips) 
Seat 5: chippo boy ($212.40 in chips) 
Seat 6: WDW3 ($200 in chips) 
Seat 7: InsomniaRU ($230 in chips) 
Seat 8: The_red_area ($241 in chips) 
Seat 9: mrhighryza ($85.86 in chips) 
mrhighryza: posts small blind $1
matiko09: posts big blind $2
*** HOLE CARDS ***
Dealt to matiko09 [7s Qd]
Moszes360: folds 
Cirilico: folds 
DUkalisUA: folds 
chippo boy: folds 
WDW3: folds 
InsomniaRU: raises $3 to $5
The_red_area: calls $5
mrhighryza: calls $4
matiko09: folds 
*** FLOP *** [7h 3s Kh]
mrhighryza: checks 
InsomniaRU: checks 
The_red_area: checks 
*** TURN *** [7h 3s Kh] [5c]
mrhighryza: bets $8
InsomniaRU: calls $8
The_red_area: calls $8
*** RIVER *** [7h 3s Kh 5c] [6s]
mrhighryza: checks 
InsomniaRU: checks 
The_red_area: checks 
*** SHOW DOWN ***
mrhighryza: shows [Ts Tc] (a pair of Tens)
InsomniaRU: shows [Jc Jh] (a pair of Jacks)
The_red_area: mucks hand 
InsomniaRU collected $39.16 from pot
*** SUMMARY ***
Total pot $41 | Rake $1.84 
Board [7h 3s Kh 5c 6s]
Seat 1: matiko09 (big blind) folded before Flop
Seat 2: Moszes360 folded before Flop (didn't bet)
Seat 3: Cirilico folded before Flop (didn't bet)
Seat 4: DUkalisUA folded before Flop (didn't bet)
Seat 5: chippo boy folded before Flop (didn't bet)
Seat 6: WDW3 folded before Flop (didn't bet)
Seat 7: InsomniaRU showed [Jc Jh] and won ($39.16) with a pair of Jacks
Seat 8: The_red_area (button) mucked [9c 9s]
Seat 9: mrhighryza (small blind) showed [Ts Tc] and lost with a pair of Tens





PokerStars Hand #150799382230:  Hold'em No Limit ($0.50/$1.00 USD) - 2016/03/23 13:32:13 CET [2016/03/23 8:32:13 ET]
Table 'Smiley' 9-max Seat #6 is the button
Seat 1: WDW3 ($100 in chips) 
Seat 2: Jimy Tiltman ($100 in chips) 
Seat 3: matiko09 ($137.66 in chips) 
Seat 4: Zeeshka ($100 in chips) 
Seat 5: DUkalisUA ($100 in chips) 
Seat 6: blackmont111 ($50.21 in chips) 
Seat 8: RICKA16 ($119.82 in chips) 
Seat 9: morosun ($123.71 in chips) 
RICKA16: posts small blind $0.50
morosun: posts big blind $1
*** HOLE CARDS ***
Dealt to matiko09 [6d Td]
WDW3: folds 
Jimy Tiltman: folds 
matiko09: folds 
Zeeshka: folds 
DUkalisUA: raises $2 to $3
blackmont111: calls $3
RICKA16: folds 
morosun: folds 
*** FLOP *** [Jd 9d 2h]
DUkalisUA: bets $3.50
blackmont111: raises $14.16 to $17.66
DUkalisUA: folds 
Uncalled bet ($14.16) returned to blackmont111
blackmont111 collected $13.85 from pot
blackmont111: doesn't show hand 
*** SUMMARY ***
Total pot $14.50 | Rake $0.65 
Board [Jd 9d 2h]
Seat 1: WDW3 folded before Flop (didn't bet)
Seat 2: Jimy Tiltman folded before Flop (didn't bet)
Seat 3: matiko09 folded before Flop (didn't bet)
Seat 4: Zeeshka folded before Flop (didn't bet)
Seat 5: DUkalisUA folded on the Flop
Seat 6: blackmont111 (button) collected ($13.85)
Seat 8: RICKA16 (small blind) folded before Flop
Seat 9: morosun (big blind) folded before Flop





PokerStars Hand #150799388218:  Hold'em No Limit ($1/$2 USD) - 2016/03/23 13:32:24 CET [2016/03/23 8:32:24 ET]
Table 'Berbericia II' 9-max Seat #1 is the button
Seat 1: WDW3 ($242.48 in chips) 
Seat 2: Moszes360 ($214.15 in chips) 
Seat 3: Fish4trips ($202.32 in chips) 
Seat 4: bennetb77 ($163.16 in chips) 
Seat 5: Surxach ($102.69 in chips) 
Seat 6: coinflip_si ($200 in chips) 
Seat 7: niuquan ($18.90 in chips) 
Seat 8: matiko09 ($211.06 in chips) 
Seat 9: LVV-Bif ($186.38 in chips) 
Moszes360: posts small blind $1
Fish4trips: posts big blind $2
*** HOLE CARDS ***
Dealt to matiko09 [Th 4d]
bennetb77: folds 
Surxach: folds 
coinflip_si: folds 
niuquan: folds 
matiko09: folds 
LVV-Bif: raises $4 to $6
WDW3: folds 
Moszes360: calls $5
Fish4trips: folds 
*** FLOP *** [6h Td Tc]
Moszes360: checks 
LVV-Bif: checks 
*** TURN *** [6h Td Tc] [7c]
Moszes360: bets $6.95
LVV-Bif: folds 
Uncalled bet ($6.95) returned to Moszes360
Moszes360 collected $13.37 from pot
Moszes360: doesn't show hand 
*** SUMMARY ***
Total pot $14 | Rake $0.63 
Board [6h Td Tc 7c]
Seat 1: WDW3 (button) folded before Flop (didn't bet)
Seat 2: Moszes360 (small blind) collected ($13.37)
Seat 3: Fish4trips (big blind) folded before Flop
Seat 4: bennetb77 folded before Flop (didn't bet)
Seat 5: Surxach folded before Flop (didn't bet)
Seat 6: coinflip_si folded before Flop (didn't bet)
Seat 7: niuquan folded before Flop (didn't bet)
Seat 8: matiko09 folded before Flop (didn't bet)
Seat 9: LVV-Bif folded on the Turn





PokerStars Hand #150799392937:  Hold'em No Limit ($1/$2 USD) - 2016/03/23 13:32:33 CET [2016/03/23 8:32:33 ET]
Table 'Kypria II' 9-max Seat #9 is the button
Seat 1: geldwolfje ($233.39 in chips) 
Seat 2: coinflip_si ($200 in chips) 
Seat 3: seouljam ($208.14 in chips) 
Seat 4: nailz83 ($105.09 in chips) 
Seat 6: matiko09 ($250.64 in chips) 
Seat 8: Fish4trips ($309.59 in chips) 
Seat 9: WDW3 ($200 in chips) 
geldwolfje: posts small blind $1
coinflip_si: posts big blind $2
InsomniaRU: sits out 
DUkalisUA: sits out 
*** HOLE CARDS ***
Dealt to matiko09 [5d 9h]
geldwolfje said, "bye byenice"
seouljam: folds 
nailz83: folds 
matiko09: folds 
seouljam said, "^^"
Fish4trips: folds 
WDW3: raises $2.80 to $4.80
geldwolfje: calls $3.80
coinflip_si: calls $2.80
*** FLOP *** [7c Kh 4d]
geldwolfje: checks 
seouljam said, "bye bye calling station"
coinflip_si: bets $8.53
seouljam said, "dum donk"
WDW3: folds 
geldwolfje: folds 
Uncalled bet ($8.53) returned to coinflip_si
coinflip_si collected $13.75 from pot
coinflip_si: doesn't show hand 
*** SUMMARY ***
Total pot $14.40 | Rake $0.65 
Board [7c Kh 4d]
Seat 1: geldwolfje (small blind) folded on the Flop
Seat 2: coinflip_si (big blind) collected ($13.75)
Seat 3: seouljam folded before Flop (didn't bet)
Seat 4: nailz83 folded before Flop (didn't bet)
Seat 6: matiko09 folded before Flop (didn't bet)
Seat 8: Fish4trips folded before Flop (didn't bet)
Seat 9: WDW3 (button) folded on the Flop





PokerStars Hand #150799394419:  Hold'em No Limit ($0.25/$0.50 USD) - 2016/03/23 13:32:36 CET [2016/03/23 8:32:36 ET]
Table 'Pyrrhus' 9-max Seat #1 is the button
Seat 1: lumen21 ($50 in chips) 
Seat 2: fandorin2005 ($50.25 in chips) 
Seat 3: IvanUrgant ($50 in chips) 
Seat 4: GriffinBerg ($40.17 in chips) 
Seat 5: lengcunjuan ($28.21 in chips) 
Seat 6: whalldo ($162.72 in chips) 
Seat 7: matiko09 ($102.90 in chips) 
Seat 8: dndngod ($66.72 in chips) 
Seat 9: CvMCvMCvM ($67.66 in chips) 
fandorin2005: posts small blind $0.25
IvanUrgant: posts big blind $0.50
*** HOLE CARDS ***
Dealt to matiko09 [7s 2h]
GriffinBerg: folds 
lengcunjuan: raises $1 to $1.50
whalldo: folds 
matiko09: folds 
dndngod: folds 
CvMCvMCvM: calls $1.50
lumen21: calls $1.50
fandorin2005: folds 
IvanUrgant: raises $6 to $7.50
lengcunjuan: calls $6
CvMCvMCvM: folds 
lumen21: folds 
*** FLOP *** [6d 2d 9h]
IvanUrgant: bets $21.10
lengcunjuan: calls $20.71 and is all-in
Uncalled bet ($0.39) returned to IvanUrgant
*** TURN *** [6d 2d 9h] [5s]
*** RIVER *** [6d 2d 9h 5s] [Ac]
*** SHOW DOWN ***
IvanUrgant: shows [Th Ts] (a pair of Tens)
lengcunjuan: mucks hand 
IvanUrgant collected $57.17 from pot
*** SUMMARY ***
Total pot $59.67 | Rake $2.50 
Board [6d 2d 9h 5s Ac]
Seat 1: lumen21 (button) folded before Flop
Seat 2: fandorin2005 (small blind) folded before Flop
Seat 3: IvanUrgant (big blind) showed [Th Ts] and won ($57.17) with a pair of Tens
Seat 4: GriffinBerg folded before Flop (didn't bet)
Seat 5: lengcunjuan mucked [Jc 6c]
Seat 6: whalldo folded before Flop (didn't bet)
Seat 7: matiko09 folded before Flop (didn't bet)
Seat 8: dndngod folded before Flop (didn't bet)
Seat 9: CvMCvMCvM folded before Flop





PokerStars Hand #150799397006:  Hold'em No Limit ($0.50/$1.00 USD) - 2016/03/23 13:32:41 CET [2016/03/23 8:32:41 ET]
Table 'Atlantis' 9-max Seat #1 is the button
Seat 1: xHourglass ($179.28 in chips) 
Seat 2: tffff2006 ($23.42 in chips) 
Seat 3: CAJUN890 ($110.19 in chips) 
Seat 4: matiko09 ($102.78 in chips) 
Seat 5: Pvsx. ($100 in chips) 
Seat 6: Jimy Tiltman ($113.74 in chips) 
Seat 7: Zeeshka ($138.37 in chips) 
Seat 8: DUkalisUA ($102 in chips) 
Seat 9: WDW3 ($112.47 in chips) 
tffff2006: posts small blind $0.50
CAJUN890: posts big blind $1
*** HOLE CARDS ***
Dealt to matiko09 [4h Th]
matiko09: folds 
Pvsx.: folds 
Jimy Tiltman: folds 
Zeeshka: folds 
DUkalisUA: folds 
WDW3: folds 
xHourglass: folds 
tffff2006: folds 
Uncalled bet ($0.50) returned to CAJUN890
CAJUN890 collected $1 from pot
CAJUN890: doesn't show hand 
*** SUMMARY ***
Total pot $1 | Rake $0 
Seat 1: xHourglass (button) folded before Flop (didn't bet)
Seat 2: tffff2006 (small blind) folded before Flop
Seat 3: CAJUN890 (big blind) collected ($1)
Seat 4: matiko09 folded before Flop (didn't bet)
Seat 5: Pvsx. folded before Flop (didn't bet)
Seat 6: Jimy Tiltman folded before Flop (didn't bet)
Seat 7: Zeeshka folded before Flop (didn't bet)
Seat 8: DUkalisUA folded before Flop (didn't bet)
Seat 9: WDW3 folded before Flop (didn't bet)





PokerStars Hand #150799400085:  Hold'em No Limit (€0.25/€0.50 EUR) - 2016/03/23 13:32:47 CET [2016/03/23 8:32:47 ET]
Table 'Hesperia II' 9-max Seat #3 is the button
Seat 1: CAJUN890 (€47.96 in chips) 
Seat 2: dndngod (€50 in chips) 
Seat 3: IvanUrgant (€50 in chips) 
Seat 4: Zelenis (€21.52 in chips) 
Seat 5: Avrora-sp (€50 in chips) 
Seat 6: CvMCvMCvM (€50 in chips) 
Seat 7: matiko09 (€61.73 in chips) 
Seat 8: Ahangama (€50 in chips) 
Zelenis: posts small blind €0.25
Avrora-sp: posts big blind €0.50
Red_Warning: sits out 
*** HOLE CARDS ***
Dealt to matiko09 [Jh Ts]
CvMCvMCvM: folds 
matiko09: folds 
Ahangama: folds 
CAJUN890: folds 
dndngod: raises €0.75 to €1.25
IvanUrgant: folds 
Zelenis: calls €1
Avrora-sp: folds 
*** FLOP *** [6s Ks 3c]
Zelenis: checks 
dndngod: bets €2
Zelenis: folds 
Uncalled bet (€2) returned to dndngod
dndngod collected €2.86 from pot
dndngod: doesn't show hand 
*** SUMMARY ***
Total pot €3 | Rake €0.14 
Board [6s Ks 3c]
Seat 1: CAJUN890 folded before Flop (didn't bet)
Seat 2: dndngod collected (€2.86)
Seat 3: IvanUrgant (button) folded before Flop (didn't bet)
Seat 4: Zelenis (small blind) folded on the Flop
Seat 5: Avrora-sp (big blind) folded before Flop
Seat 6: CvMCvMCvM folded before Flop (didn't bet)
Seat 7: matiko09 folded before Flop (didn't bet)
Seat 8: Ahangama folded before Flop (didn't bet)





PokerStars Hand #150799402021:  Hold'em No Limit ($0.25/$0.50 USD) - 2016/03/23 13:32:50 CET [2016/03/23 8:32:50 ET]
Table 'Belnika' 9-max Seat #9 is the button
Seat 1: yellowfever0 ($23.31 in chips) 
Seat 2: NeverRegret7 ($64.81 in chips) 
Seat 3: ChiChioChi ($17.31 in chips) 
Seat 4: matiko09 ($66.56 in chips) 
Seat 5: fandorin2005 ($50.64 in chips) 
Seat 6: Ahangama ($66.25 in chips) 
Seat 7: Zeeshka ($50 in chips) 
Seat 8: lumen21 ($69.64 in chips) 
Seat 9: dndngod ($63.62 in chips) 
yellowfever0: posts small blind $0.25
NeverRegret7: posts big blind $0.50
*** HOLE CARDS ***
Dealt to matiko09 [3d 9h]
ChiChioChi: folds 
matiko09: folds 
fandorin2005: folds 
Ahangama: folds 
Zeeshka: folds 
lumen21: folds 
dndngod: raises $0.50 to $1
yellowfever0: calls $0.75
NeverRegret7: calls $0.50
*** FLOP *** [Ad 5h 2h]
yellowfever0: checks 
NeverRegret7: checks 
dndngod: bets $2.25
yellowfever0: folds 
NeverRegret7: folds 
Uncalled bet ($2.25) returned to dndngod
dndngod collected $2.86 from pot
dndngod: doesn't show hand 
*** SUMMARY ***
Total pot $3 | Rake $0.14 
Board [Ad 5h 2h]
Seat 1: yellowfever0 (small blind) folded on the Flop
Seat 2: NeverRegret7 (big blind) folded on the Flop
Seat 3: ChiChioChi folded before Flop (didn't bet)
Seat 4: matiko09 folded before Flop (didn't bet)
Seat 5: fandorin2005 folded before Flop (didn't bet)
Seat 6: Ahangama folded before Flop (didn't bet)
Seat 7: Zeeshka folded before Flop (didn't bet)
Seat 8: lumen21 folded before Flop (didn't bet)
Seat 9: dndngod (button) collected ($2.86)





PokerStars Hand #150799404976:  Hold'em No Limit ($0.50/$1.00 USD) - 2016/03/23 13:32:56 CET [2016/03/23 8:32:56 ET]
Table 'Kippes' 9-max Seat #4 is the button
Seat 1: Pvsx. ($100 in chips) 
Seat 2: RICKA16 ($127.63 in chips) 
Seat 3: CAJUN890 ($115.81 in chips) 
Seat 4: matiko09 ($115.22 in chips) 
Seat 5: Jimy Tiltman ($100.50 in chips) 
Seat 6: WDW3 ($123.75 in chips) 
Seat 7: lumen21 ($101.50 in chips) 
Seat 8: Zeeshka ($103.30 in chips) 
Seat 9: wang19790906 ($79.94 in chips) 
Jimy Tiltman: posts small blind $0.50
WDW3: posts big blind $1
*** HOLE CARDS ***
Dealt to matiko09 [Qc 7h]
lumen21: folds 
Zeeshka: folds 
wang19790906: folds 
Pvsx.: folds 
RICKA16: folds 
CAJUN890: raises $2 to $3
matiko09: folds 
Jimy Tiltman: folds 
WDW3: folds 
Uncalled bet ($2) returned to CAJUN890
CAJUN890 collected $2.50 from pot
CAJUN890: doesn't show hand 
*** SUMMARY ***
Total pot $2.50 | Rake $0 
Seat 1: Pvsx. folded before Flop (didn't bet)
Seat 2: RICKA16 folded before Flop (didn't bet)
Seat 3: CAJUN890 collected ($2.50)
Seat 4: matiko09 (button) folded before Flop (didn't bet)
Seat 5: Jimy Tiltman (small blind) folded before Flop
Seat 6: WDW3 (big blind) folded before Flop
Seat 7: lumen21 folded before Flop (didn't bet)
Seat 8: Zeeshka folded before Flop (didn't bet)
Seat 9: wang19790906 folded before Flop (didn't bet)





PokerStars Hand #150799405811:  Hold'em No Limit ($0.50/$1.00 USD) - 2016/03/23 13:32:58 CET [2016/03/23 8:32:58 ET]
Table 'Oljato' 9-max Seat #5 is the button
Seat 1: Pearl Jam87 ($198.90 in chips) 
Seat 2: roman134679 ($44.08 in chips) 
Seat 3: DUkalisUA ($100 in chips) 
Seat 4: Pvsx. ($148.70 in chips) 
Seat 5: ryo728 ($88.23 in chips) 
Seat 6: WDW3 ($119.11 in chips) 
Seat 7: matiko09 ($150.73 in chips) 
Seat 8: Zeeshka ($354.64 in chips) 
Seat 9: Jimy Tiltman ($115.56 in chips) 
WDW3: posts small blind $0.50
matiko09: posts big blind $1
*** HOLE CARDS ***
Dealt to matiko09 [Jc Kh]
Zeeshka: folds 
Jimy Tiltman: folds 
Pearl Jam87: folds 
roman134679: raises $1 to $2
DUkalisUA: folds 
Pvsx.: calls $2
ryo728: folds 
WDW3: folds 
matiko09: calls $1
*** FLOP *** [6c Jh Qs]
matiko09: checks 
roman134679: checks 
Pvsx.: checks 
*** TURN *** [6c Jh Qs] [7s]
matiko09: checks 
roman134679: bets $6.21
Pvsx.: folds 
matiko09: calls $6.21
*** RIVER *** [6c Jh Qs 7s] [Qd]
matiko09: checks 
roman134679: checks 
*** SHOW DOWN ***
matiko09: shows [Jc Kh] (two pair, Queens and Jacks)
roman134679: mucks hand 
matiko09 collected $18.07 from pot
*** SUMMARY ***
Total pot $18.92 | Rake $0.85 
Board [6c Jh Qs 7s Qd]
Seat 1: Pearl Jam87 folded before Flop (didn't bet)
Seat 2: roman134679 mucked [9s 7d]
Seat 3: DUkalisUA folded before Flop (didn't bet)
Seat 4: Pvsx. folded on the Turn
Seat 5: ryo728 (button) folded before Flop (didn't bet)
Seat 6: WDW3 (small blind) folded before Flop
Seat 7: matiko09 (big blind) showed [Jc Kh] and won ($18.07) with two pair, Queens and Jacks
Seat 8: Zeeshka folded before Flop (didn't bet)
Seat 9: Jimy Tiltman folded before Flop (didn't bet)





PokerStars Hand #150799410351:  Hold'em No Limit ($1/$2 USD) - 2016/03/23 13:33:06 CET [2016/03/23 8:33:06 ET]
Table 'Kiess' 9-max Seat #8 is the button
Seat 2: DUkalisUA ($509.76 in chips) 
Seat 3: The_red_area ($200 in chips) 
Seat 4: Moszes360 ($200 in chips) 
Seat 5: chippo boy ($282.10 in chips) 
Seat 6: matiko09 ($260.64 in chips) 
Seat 7: InsomniaRU ($330.13 in chips) 
Seat 8: WDW3 ($413.42 in chips) 
Seat 9: Fish4trips ($218.55 in chips) 
Fish4trips: posts small blind $1
ldwin8: is sitting out 
DUkalisUA: posts big blind $2
*** HOLE CARDS ***
Dealt to matiko09 [6d 4c]
The_red_area: raises $4 to $6
Moszes360: folds 
chippo boy: calls $6
matiko09: folds 
InsomniaRU: folds 
ldwin8 leaves the table
WDW3: raises $18 to $24
Fish4trips: folds 
Cirilico joins the table at seat #1 
DUkalisUA: folds 
The_red_area: calls $18
chippo boy: calls $18
*** FLOP *** [9d 6h 6c]
The_red_area: checks 
chippo boy: checks 
WDW3: checks 
*** TURN *** [9d 6h 6c] [7c]
The_red_area: bets $50
chippo boy: folds 
WDW3: folds 
Uncalled bet ($50) returned to The_red_area
The_red_area collected $72.20 from pot
The_red_area: doesn't show hand 
*** SUMMARY ***
Total pot $75 | Rake $2.80 
Board [9d 6h 6c 7c]
Seat 2: DUkalisUA (big blind) folded before Flop
Seat 3: The_red_area collected ($72.20)
Seat 4: Moszes360 folded before Flop (didn't bet)
Seat 5: chippo boy folded on the Turn
Seat 6: matiko09 folded before Flop (didn't bet)
Seat 7: InsomniaRU folded before Flop (didn't bet)
Seat 8: WDW3 (button) folded on the Turn
Seat 9: Fish4trips (small blind) folded before Flop





PokerStars Hand #150799412256:  Hold'em No Limit ($0.50/$1.00 USD) - 2016/03/23 13:33:10 CET [2016/03/23 8:33:10 ET]
Table 'Atlantis' 9-max Seat #2 is the button
Seat 1: xHourglass ($179.28 in chips) 
Seat 2: tffff2006 ($22.92 in chips) 
Seat 3: CAJUN890 ($110.69 in chips) 
Seat 4: matiko09 ($102.78 in chips) 
Seat 5: Pvsx. ($100 in chips) 
Seat 6: Jimy Tiltman ($113.74 in chips) 
Seat 7: Zeeshka ($138.37 in chips) 
Seat 8: DUkalisUA ($102 in chips) 
Seat 9: WDW3 ($112.47 in chips) 
CAJUN890: posts small blind $0.50
matiko09: posts big blind $1
*** HOLE CARDS ***
Dealt to matiko09 [5s Qc]
Pvsx.: folds 
Jimy Tiltman: folds 
Zeeshka: folds 
DUkalisUA: raises $2 to $3
WDW3: folds 
xHourglass: calls $3
tffff2006: raises $6 to $9
CAJUN890: folds 
matiko09: folds 
DUkalisUA: folds 
xHourglass: folds 
Uncalled bet ($6) returned to tffff2006
tffff2006 collected $10.50 from pot
tffff2006: doesn't show hand 
*** SUMMARY ***
Total pot $10.50 | Rake $0 
Seat 1: xHourglass folded before Flop
Seat 2: tffff2006 (button) collected ($10.50)
Seat 3: CAJUN890 (small blind) folded before Flop
Seat 4: matiko09 (big blind) folded before Flop
Seat 5: Pvsx. folded before Flop (didn't bet)
Seat 6: Jimy Tiltman folded before Flop (didn't bet)
Seat 7: Zeeshka folded before Flop (didn't bet)
Seat 8: DUkalisUA folded before Flop
Seat 9: WDW3 folded before Flop (didn't bet)





PokerStars Hand #150799417565:  Hold'em No Limit ($1/$2 USD) - 2016/03/23 13:33:20 CET [2016/03/23 8:33:20 ET]
Table 'Berbericia II' 9-max Seat #2 is the button
Seat 1: WDW3 ($242.48 in chips) 
Seat 2: Moszes360 ($221.52 in chips) 
Seat 3: Fish4trips ($200.32 in chips) 
Seat 4: bennetb77 ($163.16 in chips) 
Seat 5: Surxach ($102.69 in chips) 
Seat 6: coinflip_si ($200 in chips) 
Seat 7: niuquan ($18.90 in chips) 
Seat 8: matiko09 ($211.06 in chips) 
Seat 9: LVV-Bif ($180.38 in chips) 
Fish4trips: posts small blind $1
bennetb77: posts big blind $2
*** HOLE CARDS ***
Dealt to matiko09 [7c Td]
Surxach: folds 
coinflip_si: folds 
niuquan: calls $2
matiko09: folds 
LVV-Bif: raises $4 to $6
WDW3: folds 
Moszes360: folds 
Fish4trips: folds 
bennetb77: folds 
niuquan: calls $4
*** FLOP *** [Kd 9s Qc]
niuquan: checks 
LVV-Bif: checks 
*** TURN *** [Kd 9s Qc] [Ad]
niuquan: checks 
LVV-Bif: checks 
*** RIVER *** [Kd 9s Qc Ad] [Kh]
niuquan: checks 
LVV-Bif: bets $14
niuquan: folds 
Uncalled bet ($14) returned to LVV-Bif
LVV-Bif collected $14.32 from pot
LVV-Bif: doesn't show hand 
*** SUMMARY ***
Total pot $15 | Rake $0.68 
Board [Kd 9s Qc Ad Kh]
Seat 1: WDW3 folded before Flop (didn't bet)
Seat 2: Moszes360 (button) folded before Flop (didn't bet)
Seat 3: Fish4trips (small blind) folded before Flop
Seat 4: bennetb77 (big blind) folded before Flop
Seat 5: Surxach folded before Flop (didn't bet)
Seat 6: coinflip_si folded before Flop (didn't bet)
Seat 7: niuquan folded on the River
Seat 8: matiko09 folded before Flop (didn't bet)
Seat 9: LVV-Bif collected ($14.32)





PokerStars Hand #150799417593:  Hold'em No Limit ($1/$2 USD) - 2016/03/23 13:33:20 CET [2016/03/23 8:33:20 ET]
Table 'Kypria II' 9-max Seat #1 is the button
Seat 1: geldwolfje ($228.59 in chips) 
Seat 2: coinflip_si ($208.95 in chips) 
Seat 3: seouljam ($208.14 in chips) 
Seat 4: nailz83 ($105.09 in chips) 
Seat 6: matiko09 ($250.64 in chips) 
Seat 8: Fish4trips ($309.59 in chips) 
Seat 9: WDW3 ($200 in chips) 
coinflip_si: posts small blind $1
seouljam: posts big blind $2
InsomniaRU: sits out 
DUkalisUA: sits out 
*** HOLE CARDS ***
Dealt to matiko09 [Tc 8d]
nailz83: folds 
matiko09: folds 
Fish4trips: raises $3 to $5
WDW3: folds 
geldwolfje: raises $5 to $10
coinflip_si: folds 
seouljam: folds 
Fish4trips: calls $5
*** FLOP *** [Ac 4h 2h]
Fish4trips: checks 
geldwolfje: bets $10
Fish4trips: folds 
Uncalled bet ($10) returned to geldwolfje
geldwolfje collected $21.96 from pot
geldwolfje: doesn't show hand 
*** SUMMARY ***
Total pot $23 | Rake $1.04 
Board [Ac 4h 2h]
Seat 1: geldwolfje (button) collected ($21.96)
Seat 2: coinflip_si (small blind) folded before Flop
Seat 3: seouljam (big blind) folded before Flop
Seat 4: nailz83 folded before Flop (didn't bet)
Seat 6: matiko09 folded before Flop (didn't bet)
Seat 8: Fish4trips folded on the Flop
Seat 9: WDW3 folded before Flop (didn't bet)





PokerStars Hand #150799420116:  Hold'em No Limit ($1/$2 USD) - 2016/03/23 13:33:24 CET [2016/03/23 8:33:24 ET]
Table 'Herba II' 9-max Seat #9 is the button
Seat 1: matiko09 ($228.52 in chips) 
Seat 2: Moszes360 ($216.20 in chips) 
Seat 3: Cirilico ($170.60 in chips) 
Seat 4: DUkalisUA ($250.20 in chips) 
Seat 5: chippo boy ($212.40 in chips) 
Seat 6: WDW3 ($200 in chips) 
Seat 7: InsomniaRU ($256.16 in chips) 
Seat 8: The_red_area ($228 in chips) 
Seat 9: mrhighryza ($72.86 in chips) 
matiko09: posts small blind $1
Moszes360: posts big blind $2
*** HOLE CARDS ***
Dealt to matiko09 [7h 9c]
Cirilico: raises $4 to $6
DUkalisUA: folds 
chippo boy: folds 
WDW3: folds 
InsomniaRU: folds 
The_red_area: folds 
mrhighryza: folds 
matiko09: folds 
Moszes360: folds 
Uncalled bet ($4) returned to Cirilico
Cirilico collected $5 from pot
Cirilico: doesn't show hand 
*** SUMMARY ***
Total pot $5 | Rake $0 
Seat 1: matiko09 (small blind) folded before Flop
Seat 2: Moszes360 (big blind) folded before Flop
Seat 3: Cirilico collected ($5)
Seat 4: DUkalisUA folded before Flop (didn't bet)
Seat 5: chippo boy folded before Flop (didn't bet)
Seat 6: WDW3 folded before Flop (didn't bet)
Seat 7: InsomniaRU folded before Flop (didn't bet)
Seat 8: The_red_area folded before Flop (didn't bet)
Seat 9: mrhighryza (button) folded before Flop (didn't bet)





PokerStars Hand #150799420774:  Hold'em No Limit ($0.50/$1.00 USD) - 2016/03/23 13:33:25 CET [2016/03/23 8:33:25 ET]
Table 'Smiley' 9-max Seat #8 is the button
Seat 1: WDW3 ($100 in chips) 
Seat 2: Jimy Tiltman ($100 in chips) 
Seat 3: matiko09 ($137.66 in chips) 
Seat 4: Zeeshka ($100 in chips) 
Seat 5: DUkalisUA ($100 in chips) 
Seat 6: blackmont111 ($57.56 in chips) 
Seat 8: RICKA16 ($119.32 in chips) 
Seat 9: morosun ($122.71 in chips) 
morosun: posts small blind $0.50
WDW3: posts big blind $1
*** HOLE CARDS ***
Dealt to matiko09 [5c Qd]
Jimy Tiltman: folds 
matiko09: folds 
Zeeshka: folds 
DUkalisUA: folds 
blackmont111: folds 
RICKA16: raises $1 to $2
morosun: calls $1.50
WDW3: calls $1
*** FLOP *** [Ks Qs 7d]
morosun: bets $1
WDW3: folds 
RICKA16: calls $1
*** TURN *** [Ks Qs 7d] [9c]
morosun: bets $3.82
RICKA16: calls $3.82
*** RIVER *** [Ks Qs 7d 9c] [Ac]
morosun: bets $7.47
RICKA16: folds 
Uncalled bet ($7.47) returned to morosun
morosun collected $14.94 from pot
*** SUMMARY ***
Total pot $15.64 | Rake $0.70 
Board [Ks Qs 7d 9c Ac]
Seat 1: WDW3 (big blind) folded on the Flop
Seat 2: Jimy Tiltman folded before Flop (didn't bet)
Seat 3: matiko09 folded before Flop (didn't bet)
Seat 4: Zeeshka folded before Flop (didn't bet)
Seat 5: DUkalisUA folded before Flop (didn't bet)
Seat 6: blackmont111 folded before Flop (didn't bet)
Seat 8: RICKA16 (button) folded on the River
Seat 9: morosun (small blind) collected ($14.94)





PokerStars Hand #150799421031:  Hold'em No Limit (€0.25/€0.50 EUR) - 2016/03/23 13:33:26 CET [2016/03/23 8:33:26 ET]
Table 'Hesperia II' 9-max Seat #4 is the button
Seat 1: CAJUN890 (€47.96 in chips) 
Seat 2: dndngod (€51.61 in chips) 
Seat 3: IvanUrgant (€50 in chips) 
Seat 4: Zelenis (€20.27 in chips) 
Seat 5: Avrora-sp (€50 in chips) 
Seat 6: CvMCvMCvM (€50 in chips) 
Seat 7: matiko09 (€61.73 in chips) 
Seat 8: Ahangama (€50 in chips) 
Avrora-sp: posts small blind €0.25
CvMCvMCvM: posts big blind €0.50
Red_Warning: sits out 
*** HOLE CARDS ***
Dealt to matiko09 [2s Qc]
matiko09: folds 
Ahangama: raises €0.75 to €1.25
CAJUN890: calls €1.25
dndngod: folds 
IvanUrgant: calls €1.25
Zelenis: calls €1.25
Avrora-sp: folds 
CvMCvMCvM: folds 
*** FLOP *** [Qd 7s 8d]
Ahangama: checks 
CAJUN890: checks 
IvanUrgant: bets €3.90
Zelenis: folds 
Ahangama: folds 
CAJUN890: folds 
Uncalled bet (€3.90) returned to IvanUrgant
IvanUrgant collected €5.49 from pot
IvanUrgant: doesn't show hand 
*** SUMMARY ***
Total pot €5.75 | Rake €0.26 
Board [Qd 7s 8d]
Seat 1: CAJUN890 folded on the Flop
Seat 2: dndngod folded before Flop (didn't bet)
Seat 3: IvanUrgant collected (€5.49)
Seat 4: Zelenis (button) folded on the Flop
Seat 5: Avrora-sp (small blind) folded before Flop
Seat 6: CvMCvMCvM (big blind) folded before Flop
Seat 7: matiko09 folded before Flop (didn't bet)
Seat 8: Ahangama folded on the Flop





PokerStars Hand #150799422859:  Hold'em No Limit (€0.25/€0.50 EUR) - 2016/03/23 13:33:29 CET [2016/03/23 8:33:29 ET]
Table 'Palma II' 9-max Seat #4 is the button
Seat 1: Ahangama (€50 in chips) 
Seat 2: matiko09 (€50.75 in chips) 
Seat 3: ardo888 (€50 in chips) 
Seat 4: dndngod (€53.49 in chips) 
Seat 5: SVFB13 (€49.50 in chips) 
Seat 6: Red_Warning (€50 in chips) 
Seat 7: Wouter Des (€55.95 in chips) 
Seat 8: CvMCvMCvM (€50 in chips) 
Seat 9: ZonTTT (€50 in chips) 
SVFB13: posts small blind €0.25
Red_Warning: posts big blind €0.50
*** HOLE CARDS ***
Dealt to matiko09 [5h 4d]
Wouter Des: calls €0.50
CvMCvMCvM: folds 
ZonTTT: folds 
Ahangama: folds 
matiko09: folds 
ardo888: raises €1.50 to €2
dndngod: folds 
SVFB13: folds 
Red_Warning: folds 
Wouter Des: calls €1.50
*** FLOP *** [Qh 5s 9d]
Wouter Des: checks 
ardo888: bets €2.50
Wouter Des: folds 
Uncalled bet (€2.50) returned to ardo888
ardo888 collected €4.54 from pot
ardo888: doesn't show hand 
*** SUMMARY ***
Total pot €4.75 | Rake €0.21 
Board [Qh 5s 9d]
Seat 1: Ahangama folded before Flop (didn't bet)
Seat 2: matiko09 folded before Flop (didn't bet)
Seat 3: ardo888 collected (€4.54)
Seat 4: dndngod (button) folded before Flop (didn't bet)
Seat 5: SVFB13 (small blind) folded before Flop
Seat 6: Red_Warning (big blind) folded before Flop
Seat 7: Wouter Des folded on the Flop
Seat 8: CvMCvMCvM folded before Flop (didn't bet)
Seat 9: ZonTTT folded before Flop (didn't bet)





PokerStars Hand #150799429087:  Hold'em No Limit ($0.50/$1.00 USD) - 2016/03/23 13:33:41 CET [2016/03/23 8:33:41 ET]
Table 'Kippes' 9-max Seat #5 is the button
Seat 1: Pvsx. ($100 in chips) 
Seat 2: RICKA16 ($127.63 in chips) 
Seat 3: CAJUN890 ($117.31 in chips) 
Seat 4: matiko09 ($115.22 in chips) 
Seat 5: Jimy Tiltman ($100 in chips) 
Seat 6: WDW3 ($122.75 in chips) 
Seat 7: lumen21 ($101.50 in chips) 
Seat 8: Zeeshka ($103.30 in chips) 
Seat 9: wang19790906 ($79.94 in chips) 
WDW3: posts small blind $0.50
lumen21: posts big blind $1
*** HOLE CARDS ***
Dealt to matiko09 [2c Tc]
Zeeshka: folds 
wang19790906: folds 
Pvsx.: folds 
RICKA16: folds 
CAJUN890: folds 
matiko09: folds 
Jimy Tiltman: raises $1 to $2
WDW3: folds 
lumen21: raises $6 to $8
Jimy Tiltman: calls $6
*** FLOP *** [3d 9c 4s]
lumen21: bets $10
Jimy Tiltman: calls $10
*** TURN *** [3d 9c 4s] [8c]
lumen21: checks 
Jimy Tiltman: bets $22
lumen21: folds 
Uncalled bet ($22) returned to Jimy Tiltman
Jimy Tiltman collected $34.86 from pot
Jimy Tiltman: doesn't show hand 
*** SUMMARY ***
Total pot $36.50 | Rake $1.64 
Board [3d 9c 4s 8c]
Seat 1: Pvsx. folded before Flop (didn't bet)
Seat 2: RICKA16 folded before Flop (didn't bet)
Seat 3: CAJUN890 folded before Flop (didn't bet)
Seat 4: matiko09 folded before Flop (didn't bet)
Seat 5: Jimy Tiltman (button) collected ($34.86)
Seat 6: WDW3 (small blind) folded before Flop
Seat 7: lumen21 (big blind) folded on the Turn
Seat 8: Zeeshka folded before Flop (didn't bet)
Seat 9: wang19790906 folded before Flop (didn't bet)





PokerStars Hand #150799433745:  Hold'em No Limit ($0.50/$1.00 USD) - 2016/03/23 13:33:50 CET [2016/03/23 8:33:50 ET]
Table 'Oljato' 9-max Seat #6 is the button
Seat 1: Pearl Jam87 ($198.90 in chips) 
Seat 2: roman134679 ($35.87 in chips) 
Seat 3: DUkalisUA ($100 in chips) 
Seat 4: Pvsx. ($146.70 in chips) 
Seat 5: ryo728 ($88.23 in chips) 
Seat 6: WDW3 ($118.61 in chips) 
Seat 7: matiko09 ($160.59 in chips) 
Seat 8: Zeeshka ($354.64 in chips) 
Seat 9: Jimy Tiltman ($115.56 in chips) 
matiko09: posts small blind $0.50
Zeeshka: posts big blind $1
*** HOLE CARDS ***
Dealt to matiko09 [Tc Ah]
Jimy Tiltman: folds 
Pearl Jam87: raises $2 to $3
roman134679: folds 
DUkalisUA: folds 
Pvsx.: folds 
ryo728: folds 
WDW3: folds 
matiko09: folds 
Zeeshka: folds 
Uncalled bet ($2) returned to Pearl Jam87
Pearl Jam87 collected $2.50 from pot
*** SUMMARY ***
Total pot $2.50 | Rake $0 
Seat 1: Pearl Jam87 collected ($2.50)
Seat 2: roman134679 folded before Flop (didn't bet)
Seat 3: DUkalisUA folded before Flop (didn't bet)
Seat 4: Pvsx. folded before Flop (didn't bet)
Seat 5: ryo728 folded before Flop (didn't bet)
Seat 6: WDW3 (button) folded before Flop (didn't bet)
Seat 7: matiko09 (small blind) folded before Flop
Seat 8: Zeeshka (big blind) folded before Flop
Seat 9: Jimy Tiltman folded before Flop (didn't bet)





PokerStars Hand #150799436242:  Hold'em No Limit ($1/$2 USD) - 2016/03/23 13:33:54 CET [2016/03/23 8:33:54 ET]
Table 'Herba II' 9-max Seat #1 is the button
Seat 1: matiko09 ($227.52 in chips) 
Seat 2: Moszes360 ($214.20 in chips) 
Seat 3: Cirilico ($173.60 in chips) 
Seat 4: DUkalisUA ($250.20 in chips) 
Seat 5: chippo boy ($212.40 in chips) 
Seat 6: WDW3 ($200 in chips) 
Seat 7: InsomniaRU ($256.16 in chips) 
Seat 8: The_red_area ($228 in chips) 
Seat 9: mrhighryza ($72.86 in chips) 
Moszes360: posts small blind $1
Cirilico: posts big blind $2
*** HOLE CARDS ***
Dealt to matiko09 [9h 7c]
DUkalisUA: folds 
chippo boy: folds 
WDW3: folds 
InsomniaRU: raises $3 to $5
The_red_area: folds 
mrhighryza: folds 
matiko09: folds 
Moszes360: folds 
Cirilico: folds 
Uncalled bet ($3) returned to InsomniaRU
InsomniaRU collected $5 from pot
InsomniaRU: doesn't show hand 
*** SUMMARY ***
Total pot $5 | Rake $0 
Seat 1: matiko09 (button) folded before Flop (didn't bet)
Seat 2: Moszes360 (small blind) folded before Flop
Seat 3: Cirilico (big blind) folded before Flop
Seat 4: DUkalisUA folded before Flop (didn't bet)
Seat 5: chippo boy folded before Flop (didn't bet)
Seat 6: WDW3 folded before Flop (didn't bet)
Seat 7: InsomniaRU collected ($5)
Seat 8: The_red_area folded before Flop (didn't bet)
Seat 9: mrhighryza folded before Flop (didn't bet)





PokerStars Hand #150799438351:  Hold'em No Limit ($0.25/$0.50 USD) - 2016/03/23 13:33:58 CET [2016/03/23 8:33:58 ET]
Table 'Belnika' 9-max Seat #1 is the button
Seat 1: yellowfever0 ($22.31 in chips) 
Seat 2: NeverRegret7 ($63.81 in chips) 
Seat 3: ChiChioChi ($17.31 in chips) 
Seat 4: matiko09 ($66.56 in chips) 
Seat 5: fandorin2005 ($50.64 in chips) 
Seat 6: Ahangama ($66.25 in chips) 
Seat 7: Zeeshka ($50 in chips) 
Seat 8: lumen21 ($69.64 in chips) 
Seat 9: dndngod ($65.48 in chips) 
NeverRegret7: posts small blind $0.25
ChiChioChi: posts big blind $0.50
*** HOLE CARDS ***
Dealt to matiko09 [2d Js]
matiko09: folds 
fandorin2005: folds 
Ahangama: folds 
Zeeshka: folds 
lumen21: folds 
dndngod: raises $0.75 to $1.25
yellowfever0: calls $1.25
NeverRegret7: calls $1
ChiChioChi: raises $3.25 to $4.50
dndngod: folds 
yellowfever0: calls $3.25
NeverRegret7: folds 
*** FLOP *** [5h 2c 4d]
ChiChioChi: bets $7
yellowfever0: folds 
Uncalled bet ($7) returned to ChiChioChi
ChiChioChi collected $10.98 from pot
ChiChioChi: doesn't show hand 
*** SUMMARY ***
Total pot $11.50 | Rake $0.52 
Board [5h 2c 4d]
Seat 1: yellowfever0 (button) folded on the Flop
Seat 2: NeverRegret7 (small blind) folded before Flop
Seat 3: ChiChioChi (big blind) collected ($10.98)
Seat 4: matiko09 folded before Flop (didn't bet)
Seat 5: fandorin2005 folded before Flop (didn't bet)
Seat 6: Ahangama folded before Flop (didn't bet)
Seat 7: Zeeshka folded before Flop (didn't bet)
Seat 8: lumen21 folded before Flop (didn't bet)
Seat 9: dndngod folded before Flop





PokerStars Hand #150799438848:  Hold'em No Limit ($0.50/$1.00 USD) - 2016/03/23 13:33:59 CET [2016/03/23 8:33:59 ET]
Table 'Atlantis' 9-max Seat #3 is the button
Seat 1: xHourglass ($176.28 in chips) 
Seat 2: tffff2006 ($30.42 in chips) 
Seat 3: CAJUN890 ($110.19 in chips) 
Seat 4: matiko09 ($101.78 in chips) 
Seat 5: Pvsx. ($100 in chips) 
Seat 6: Jimy Tiltman ($113.74 in chips) 
Seat 7: Zeeshka ($138.37 in chips) 
Seat 8: DUkalisUA ($100 in chips) 
Seat 9: WDW3 ($112.47 in chips) 
matiko09: posts small blind $0.50
Pvsx.: posts big blind $1
*** HOLE CARDS ***
Dealt to matiko09 [7h Jd]
Jimy Tiltman: raises $1.50 to $2.50
Zeeshka: folds 
DUkalisUA: folds 
WDW3: folds 
xHourglass: folds 
tffff2006: folds 
CAJUN890: folds 
matiko09: folds 
Pvsx.: folds 
Uncalled bet ($1.50) returned to Jimy Tiltman
Jimy Tiltman collected $2.50 from pot
Jimy Tiltman: doesn't show hand 
*** SUMMARY ***
Total pot $2.50 | Rake $0 
Seat 1: xHourglass folded before Flop (didn't bet)
Seat 2: tffff2006 folded before Flop (didn't bet)
Seat 3: CAJUN890 (button) folded before Flop (didn't bet)
Seat 4: matiko09 (small blind) folded before Flop
Seat 5: Pvsx. (big blind) folded before Flop
Seat 6: Jimy Tiltman collected ($2.50)
Seat 7: Zeeshka folded before Flop (didn't bet)
Seat 8: DUkalisUA folded before Flop (didn't bet)
Seat 9: WDW3 folded before Flop (didn't bet)





PokerStars Hand #150799445582:  Hold'em No Limit (€0.25/€0.50 EUR) - 2016/03/23 13:34:12 CET [2016/03/23 8:34:12 ET]
Table 'Palma II' 9-max Seat #5 is the button
Seat 1: Ahangama (€50 in chips) 
Seat 2: matiko09 (€50.75 in chips) 
Seat 3: ardo888 (€52.54 in chips) 
Seat 4: dndngod (€53.49 in chips) 
Seat 5: SVFB13 (€49.25 in chips) 
Seat 6: Red_Warning (€50 in chips) 
Seat 7: Wouter Des (€53.95 in chips) 
Seat 8: CvMCvMCvM (€50 in chips) 
Seat 9: ZonTTT (€50 in chips) 
Red_Warning: posts small blind €0.25
Wouter Des: posts big blind €0.50
*** HOLE CARDS ***
Dealt to matiko09 [2c 5c]
CvMCvMCvM: folds 
ZonTTT: folds 
Ahangama: folds 
matiko09: folds 
ardo888: folds 
dndngod: folds 
SVFB13: folds 
Red_Warning: raises €1 to €1.50
Wouter Des: raises €1 to €2.50
Red_Warning: calls €1
*** FLOP *** [5h Qc As]
Red_Warning: checks 
Wouter Des: bets €4.78
Red_Warning: folds 
Uncalled bet (€4.78) returned to Wouter Des
Wouter Des collected €4.78 from pot
Wouter Des: doesn't show hand 
*** SUMMARY ***
Total pot €5 | Rake €0.22 
Board [5h Qc As]
Seat 1: Ahangama folded before Flop (didn't bet)
Seat 2: matiko09 folded before Flop (didn't bet)
Seat 3: ardo888 folded before Flop (didn't bet)
Seat 4: dndngod folded before Flop (didn't bet)
Seat 5: SVFB13 (button) folded before Flop (didn't bet)
Seat 6: Red_Warning (small blind) folded on the Flop
Seat 7: Wouter Des (big blind) collected (€4.78)
Seat 8: CvMCvMCvM folded before Flop (didn't bet)
Seat 9: ZonTTT folded before Flop (didn't bet)





PokerStars Hand #150799445486:  Hold'em No Limit ($1/$2 USD) - 2016/03/23 13:34:12 CET [2016/03/23 8:34:12 ET]
Table 'Berbericia II' 9-max Seat #3 is the button
Seat 1: WDW3 ($242.48 in chips) 
Seat 2: Moszes360 ($221.52 in chips) 
Seat 3: Fish4trips ($200 in chips) 
Seat 4: bennetb77 ($161.16 in chips) 
Seat 5: Surxach ($102.69 in chips) 
Seat 6: coinflip_si ($200 in chips) 
Seat 7: niuquan ($12.90 in chips) 
Seat 8: matiko09 ($211.06 in chips) 
Seat 9: LVV-Bif ($188.70 in chips) 
bennetb77: posts small blind $1
Surxach: posts big blind $2
*** HOLE CARDS ***
Dealt to matiko09 [Qd As]
coinflip_si: folds 
niuquan: raises $10.90 to $12.90 and is all-in
matiko09: raises $11.10 to $24
LVV-Bif: folds 
WDW3: folds 
Moszes360: folds 
Fish4trips: folds 
bennetb77: folds 
Surxach: raises $78.69 to $102.69 and is all-in
matiko09: calls $78.69
*** FLOP *** [9s 4d 5d]
*** TURN *** [9s 4d 5d] [6d]
*** RIVER *** [9s 4d 5d 6d] [3s]
*** SHOW DOWN ***
Surxach: shows [Tc Ac] (high card Ace)
matiko09: shows [Qd As] (high card Ace - Queen kicker)
matiko09 collected $178.57 from side pot
niuquan: mucks hand 
matiko09 collected $37.91 from main pot
*** SUMMARY ***
Total pot $219.28 Main pot $37.91. Side pot $178.57. | Rake $2.80 
Board [9s 4d 5d 6d 3s]
Seat 1: WDW3 folded before Flop (didn't bet)
Seat 2: Moszes360 folded before Flop (didn't bet)
Seat 3: Fish4trips (button) folded before Flop (didn't bet)
Seat 4: bennetb77 (small blind) folded before Flop
Seat 5: Surxach (big blind) showed [Tc Ac] and lost with high card Ace
Seat 6: coinflip_si folded before Flop (didn't bet)
Seat 7: niuquan mucked [Ah 8h]
Seat 8: matiko09 showed [Qd As] and won ($216.48) with high card Ace
Seat 9: LVV-Bif folded before Flop (didn't bet)





PokerStars Hand #150799446380:  Hold'em No Limit ($1/$2 USD) - 2016/03/23 13:34:13 CET [2016/03/23 8:34:13 ET]
Table 'Kypria II' 9-max Seat #2 is the button
Seat 1: geldwolfje ($240.55 in chips) 
Seat 2: coinflip_si ($207.95 in chips) 
Seat 3: seouljam ($206.14 in chips) 
Seat 4: nailz83 ($105.09 in chips) 
Seat 6: matiko09 ($250.64 in chips) 
Seat 8: Fish4trips ($299.59 in chips) 
Seat 9: WDW3 ($200 in chips) 
seouljam: posts small blind $1
nailz83: posts big blind $2
InsomniaRU: sits out 
DUkalisUA: sits out 
*** HOLE CARDS ***
Dealt to matiko09 [Qh Th]
matiko09: raises $3 to $5
Fish4trips: folds 
WDW3: folds 
geldwolfje: folds 
coinflip_si: folds 
seouljam: folds 
nailz83: calls $3
*** FLOP *** [2h 4c 4s]
nailz83: checks 
matiko09: bets $6
nailz83: calls $6
*** TURN *** [2h 4c 4s] [6d]
nailz83: checks 
matiko09: checks 
*** RIVER *** [2h 4c 4s 6d] [Jc]
nailz83: bets $10
matiko09: folds 
Uncalled bet ($10) returned to nailz83
nailz83 collected $21.96 from pot
nailz83: doesn't show hand 
*** SUMMARY ***
Total pot $23 | Rake $1.04 
Board [2h 4c 4s 6d Jc]
Seat 1: geldwolfje folded before Flop (didn't bet)
Seat 2: coinflip_si (button) folded before Flop (didn't bet)
Seat 3: seouljam (small blind) folded before Flop
Seat 4: nailz83 (big blind) collected ($21.96)
Seat 6: matiko09 folded on the River
Seat 8: Fish4trips folded before Flop (didn't bet)
Seat 9: WDW3 folded before Flop (didn't bet)





PokerStars Hand #150799448333:  Hold'em No Limit ($0.25/$0.50 USD) - 2016/03/23 13:34:17 CET [2016/03/23 8:34:17 ET]
Table 'Pyrrhus' 9-max Seat #2 is the button
Seat 1: lumen21 ($50 in chips) 
Seat 2: fandorin2005 ($50 in chips) 
Seat 3: IvanUrgant ($78.96 in chips) 
Seat 4: GriffinBerg ($40.17 in chips) 
Seat 6: whalldo ($162.72 in chips) 
Seat 7: matiko09 ($102.90 in chips) 
Seat 8: dndngod ($66.72 in chips) 
Seat 9: CvMCvMCvM ($66.16 in chips) 
IvanUrgant: posts small blind $0.25
GriffinBerg: posts big blind $0.50
*** HOLE CARDS ***
Dealt to matiko09 [Kh 6c]
whalldo: folds 
lengcunjuan leaves the table
matiko09: folds 
dndngod: folds 
Moszes360 joins the table at seat #5 
CvMCvMCvM: raises $0.57 to $1.07
lumen21: folds 
fandorin2005: folds 
IvanUrgant: folds 
GriffinBerg: raises $1.43 to $2.50
CvMCvMCvM: calls $1.43
*** FLOP *** [4d 4c Th]
GriffinBerg: checks 
CvMCvMCvM: checks 
*** TURN *** [4d 4c Th] [9d]
GriffinBerg: checks 
CvMCvMCvM: checks 
*** RIVER *** [4d 4c Th 9d] [Kc]
GriffinBerg: bets $5.01
CvMCvMCvM: folds 
Uncalled bet ($5.01) returned to GriffinBerg
GriffinBerg collected $5.01 from pot
*** SUMMARY ***
Total pot $5.25 | Rake $0.24 
Board [4d 4c Th 9d Kc]
Seat 1: lumen21 folded before Flop (didn't bet)
Seat 2: fandorin2005 (button) folded before Flop (didn't bet)
Seat 3: IvanUrgant (small blind) folded before Flop
Seat 4: GriffinBerg (big blind) collected ($5.01)
Seat 6: whalldo folded before Flop (didn't bet)
Seat 7: matiko09 folded before Flop (didn't bet)
Seat 8: dndngod folded before Flop (didn't bet)
Seat 9: CvMCvMCvM folded on the River





PokerStars Hand #150799450510:  Hold'em No Limit ($1/$2 USD) - 2016/03/23 13:34:21 CET [2016/03/23 8:34:21 ET]
Table 'Herba II' 9-max Seat #2 is the button
Seat 1: matiko09 ($227.52 in chips) 
Seat 2: Moszes360 ($213.20 in chips) 
Seat 3: Cirilico ($171.60 in chips) 
Seat 4: DUkalisUA ($250.20 in chips) 
Seat 5: chippo boy ($212.40 in chips) 
Seat 6: WDW3 ($200 in chips) 
Seat 7: InsomniaRU ($259.16 in chips) 
Seat 8: The_red_area ($228 in chips) 
Seat 9: mrhighryza ($72.86 in chips) 
Cirilico: posts small blind $1
DUkalisUA: posts big blind $2
*** HOLE CARDS ***
Dealt to matiko09 [Qs Js]
chippo boy: folds 
WDW3: raises $3.60 to $5.60
InsomniaRU: folds 
The_red_area: folds 
mrhighryza: folds 
matiko09: calls $5.60
Moszes360: folds 
Cirilico: folds 
DUkalisUA: folds 
*** FLOP *** [5s 5h Td]
WDW3: checks 
matiko09: checks 
*** TURN *** [5s 5h Td] [Kc]
WDW3: checks 
matiko09: bets $8.81
WDW3: folds 
Uncalled bet ($8.81) returned to matiko09
matiko09 collected $13.56 from pot
matiko09: doesn't show hand 
*** SUMMARY ***
Total pot $14.20 | Rake $0.64 
Board [5s 5h Td Kc]
Seat 1: matiko09 collected ($13.56)
Seat 2: Moszes360 (button) folded before Flop (didn't bet)
Seat 3: Cirilico (small blind) folded before Flop
Seat 4: DUkalisUA (big blind) folded before Flop
Seat 5: chippo boy folded before Flop (didn't bet)
Seat 6: WDW3 folded on the Turn
Seat 7: InsomniaRU folded before Flop (didn't bet)
Seat 8: The_red_area folded before Flop (didn't bet)
Seat 9: mrhighryza folded before Flop (didn't bet)





PokerStars Hand #150799451125:  Hold'em No Limit ($0.50/$1.00 USD) - 2016/03/23 13:34:22 CET [2016/03/23 8:34:22 ET]
Table 'Atlantis' 9-max Seat #4 is the button
Seat 1: xHourglass ($176.28 in chips) 
Seat 2: tffff2006 ($30.42 in chips) 
Seat 3: CAJUN890 ($110.19 in chips) 
Seat 4: matiko09 ($101.28 in chips) 
Seat 5: Pvsx. ($100 in chips) 
Seat 6: Jimy Tiltman ($115.24 in chips) 
Seat 7: Zeeshka ($138.37 in chips) 
Seat 8: DUkalisUA ($100 in chips) 
Seat 9: WDW3 ($112.47 in chips) 
Pvsx.: posts small blind $0.50
Jimy Tiltman: posts big blind $1
*** HOLE CARDS ***
Dealt to matiko09 [Kc Ts]
Zeeshka: folds 
DUkalisUA: raises $2 to $3
WDW3: folds 
xHourglass: folds 
tffff2006: folds 
CAJUN890: folds 
matiko09: folds 
Pvsx.: folds 
Jimy Tiltman: calls $2
*** FLOP *** [7d Kh 8h]
Jimy Tiltman: checks 
DUkalisUA: checks 
*** TURN *** [7d Kh 8h] [Qs]
Jimy Tiltman: checks 
DUkalisUA: bets $4
Jimy Tiltman: folds 
Uncalled bet ($4) returned to DUkalisUA
DUkalisUA collected $6.21 from pot
DUkalisUA: doesn't show hand 
*** SUMMARY ***
Total pot $6.50 | Rake $0.29 
Board [7d Kh 8h Qs]
Seat 1: xHourglass folded before Flop (didn't bet)
Seat 2: tffff2006 folded before Flop (didn't bet)
Seat 3: CAJUN890 folded before Flop (didn't bet)
Seat 4: matiko09 (button) folded before Flop (didn't bet)
Seat 5: Pvsx. (small blind) folded before Flop
Seat 6: Jimy Tiltman (big blind) folded on the Turn
Seat 7: Zeeshka folded before Flop (didn't bet)
Seat 8: DUkalisUA collected ($6.21)
Seat 9: WDW3 folded before Flop (didn't bet)





PokerStars Hand #150799451807:  Hold'em No Limit (€0.25/€0.50 EUR) - 2016/03/23 13:34:24 CET [2016/03/23 8:34:24 ET]
Table 'Hesperia II' 9-max Seat #5 is the button
Seat 1: CAJUN890 (€46.71 in chips) 
Seat 2: dndngod (€51.61 in chips) 
Seat 3: IvanUrgant (€54.24 in chips) 
Seat 4: Zelenis (€19.02 in chips) 
Seat 5: Avrora-sp (€50 in chips) 
Seat 6: CvMCvMCvM (€50 in chips) 
Seat 7: matiko09 (€61.73 in chips) 
Seat 8: Ahangama (€50 in chips) 
CvMCvMCvM: posts small blind €0.25
matiko09: posts big blind €0.50
Red_Warning: sits out 
*** HOLE CARDS ***
Dealt to matiko09 [4c Th]
Ahangama: folds 
CAJUN890: folds 
dndngod: folds 
IvanUrgant: folds 
Zelenis: calls €0.50
Avrora-sp: folds 
CvMCvMCvM: folds 
matiko09: checks 
*** FLOP *** [5d Qc 8s]
matiko09: checks 
Zelenis: bets €0.50
matiko09: folds 
Uncalled bet (€0.50) returned to Zelenis
Zelenis collected €1.19 from pot
Zelenis: doesn't show hand 
*** SUMMARY ***
Total pot €1.25 | Rake €0.06 
Board [5d Qc 8s]
Seat 1: CAJUN890 folded before Flop (didn't bet)
Seat 2: dndngod folded before Flop (didn't bet)
Seat 3: IvanUrgant folded before Flop (didn't bet)
Seat 4: Zelenis collected (€1.19)
Seat 5: Avrora-sp (button) folded before Flop (didn't bet)
Seat 6: CvMCvMCvM (small blind) folded before Flop
Seat 7: matiko09 (big blind) folded on the Flop
Seat 8: Ahangama folded before Flop (didn't bet)





PokerStars Hand #150799453173:  Hold'em No Limit ($0.50/$1.00 USD) - 2016/03/23 13:34:26 CET [2016/03/23 8:34:26 ET]
Table 'Oljato' 9-max Seat #7 is the button
Seat 1: Pearl Jam87 ($200.40 in chips) 
Seat 2: roman134679 ($35.87 in chips) 
Seat 3: DUkalisUA ($100 in chips) 
Seat 4: Pvsx. ($146.70 in chips) 
Seat 5: ryo728 ($88.23 in chips) 
Seat 6: WDW3 ($118.61 in chips) 
Seat 7: matiko09 ($160.09 in chips) 
Seat 8: Zeeshka ($353.64 in chips) 
Seat 9: Jimy Tiltman ($115.56 in chips) 
Zeeshka: posts small blind $0.50
Jimy Tiltman: posts big blind $1
*** HOLE CARDS ***
Dealt to matiko09 [Kd 9h]
Pearl Jam87: folds 
roman134679: raises $2.50 to $3.50
DUkalisUA: folds 
Pvsx.: folds 
Pearl Jam87 leaves the table
ryo728: folds 
WDW3: folds 
matiko09: folds 
Zeeshka: folds 
myatiy 96 joins the table at seat #1 
Jimy Tiltman: folds 
Uncalled bet ($2.50) returned to roman134679
roman134679 collected $2.50 from pot
*** SUMMARY ***
Total pot $2.50 | Rake $0 
Seat 1: Pearl Jam87 folded before Flop (didn't bet)
Seat 2: roman134679 collected ($2.50)
Seat 3: DUkalisUA folded before Flop (didn't bet)
Seat 4: Pvsx. folded before Flop (didn't bet)
Seat 5: ryo728 folded before Flop (didn't bet)
Seat 6: WDW3 folded before Flop (didn't bet)
Seat 7: matiko09 (button) folded before Flop (didn't bet)
Seat 8: Zeeshka (small blind) folded before Flop
Seat 9: Jimy Tiltman (big blind) folded before Flop





PokerStars Hand #150799462481:  Hold'em No Limit ($0.50/$1.00 USD) - 2016/03/23 13:34:43 CET [2016/03/23 8:34:43 ET]
Table 'Smiley' 9-max Seat #9 is the button
Seat 1: WDW3 ($100 in chips) 
Seat 2: Jimy Tiltman ($100 in chips) 
Seat 3: matiko09 ($137.66 in chips) 
Seat 4: Zeeshka ($100 in chips) 
Seat 5: DUkalisUA ($100 in chips) 
Seat 6: blackmont111 ($57.56 in chips) 
Seat 8: RICKA16 ($112.50 in chips) 
Seat 9: morosun ($130.83 in chips) 
WDW3: posts small blind $0.50
Jimy Tiltman: posts big blind $1
*** HOLE CARDS ***
Dealt to matiko09 [Qd 4c]
matiko09: folds 
Zeeshka: folds 
DUkalisUA: folds 
blackmont111: folds 
RICKA16: folds 
morosun: raises $1 to $2
WDW3: folds 
Jimy Tiltman: calls $1
*** FLOP *** [2c 4h 6h]
Jimy Tiltman: checks 
morosun: checks 
*** TURN *** [2c 4h 6h] [6c]
Jimy Tiltman: checks 
morosun: checks 
*** RIVER *** [2c 4h 6h 6c] [3h]
Jimy Tiltman: checks 
morosun: checks 
*** SHOW DOWN ***
Jimy Tiltman: shows [8s Th] (a pair of Sixes)
morosun: shows [7d Kd] (a pair of Sixes - King kicker)
morosun collected $4.30 from pot
*** SUMMARY ***
Total pot $4.50 | Rake $0.20 
Board [2c 4h 6h 6c 3h]
Seat 1: WDW3 (small blind) folded before Flop
Seat 2: Jimy Tiltman (big blind) showed [8s Th] and lost with a pair of Sixes
Seat 3: matiko09 folded before Flop (didn't bet)
Seat 4: Zeeshka folded before Flop (didn't bet)
Seat 5: DUkalisUA folded before Flop (didn't bet)
Seat 6: blackmont111 folded before Flop (didn't bet)
Seat 8: RICKA16 folded before Flop (didn't bet)
Seat 9: morosun (button) showed [7d Kd] and won ($4.30) with a pair of Sixes





PokerStars Hand #150799464225:  Hold'em No Limit ($1/$2 USD) - 2016/03/23 13:34:47 CET [2016/03/23 8:34:47 ET]
Table 'Kiess' 9-max Seat #9 is the button
Seat 2: DUkalisUA ($507.76 in chips) 
Seat 3: The_red_area ($248.20 in chips) 
Seat 4: Moszes360 ($200 in chips) 
Seat 5: chippo boy ($258.10 in chips) 
Seat 6: matiko09 ($260.64 in chips) 
Seat 7: InsomniaRU ($330.13 in chips) 
Seat 8: WDW3 ($389.42 in chips) 
Seat 9: Fish4trips ($217.55 in chips) 
Cirilico will be allowed to play after the button
DUkalisUA: posts small blind $1
The_red_area: posts big blind $2
*** HOLE CARDS ***
Dealt to matiko09 [5s Jh]
Moszes360: folds 
chippo boy: calls $2
matiko09: folds 
InsomniaRU: folds 
WDW3: folds 
Fish4trips: folds 
DUkalisUA: folds 
The_red_area: checks 
*** FLOP *** [6c 2d Tc]
The_red_area: checks 
chippo boy: bets $4
The_red_area: calls $4
*** TURN *** [6c 2d Tc] [Ac]
The_red_area: checks 
chippo boy: checks 
*** RIVER *** [6c 2d Tc Ac] [9h]
The_red_area: bets $12.42
chippo boy: folds 
Uncalled bet ($12.42) returned to The_red_area
The_red_area collected $12.42 from pot
The_red_area: doesn't show hand 
*** SUMMARY ***
Total pot $13 | Rake $0.58 
Board [6c 2d Tc Ac 9h]
Seat 2: DUkalisUA (small blind) folded before Flop
Seat 3: The_red_area (big blind) collected ($12.42)
Seat 4: Moszes360 folded before Flop (didn't bet)
Seat 5: chippo boy folded on the River
Seat 6: matiko09 folded before Flop (didn't bet)
Seat 7: InsomniaRU folded before Flop (didn't bet)
Seat 8: WDW3 folded before Flop (didn't bet)
Seat 9: Fish4trips (button) folded before Flop (didn't bet)





PokerStars Hand #150799474713:  Hold'em No Limit ($0.25/$0.50 USD) - 2016/03/23 13:35:06 CET [2016/03/23 8:35:06 ET]
Table 'Belnika' 9-max Seat #2 is the button
Seat 1: yellowfever0 ($17.81 in chips) 
Seat 2: NeverRegret7 ($62.56 in chips) 
Seat 3: ChiChioChi ($23.79 in chips) 
Seat 4: matiko09 ($66.56 in chips) 
Seat 5: fandorin2005 ($50.64 in chips) 
Seat 6: Ahangama ($66.25 in chips) 
Seat 7: Zeeshka ($50 in chips) 
Seat 8: lumen21 ($69.64 in chips) 
Seat 9: dndngod ($64.23 in chips) 
ChiChioChi: posts small blind $0.25
matiko09: posts big blind $0.50
*** HOLE CARDS ***
Dealt to matiko09 [6d 4c]
fandorin2005: folds 
Ahangama: folds 
Zeeshka: folds 
lumen21: folds 
dndngod: raises $1 to $1.50
yellowfever0: calls $1.50
NeverRegret7: calls $1.50
ChiChioChi: folds 
matiko09: folds 
*** FLOP *** [7s 8d 2d]
dndngod: bets $3.50
yellowfever0: calls $3.50
NeverRegret7: folds 
*** TURN *** [7s 8d 2d] [7h]
dndngod: bets $21
yellowfever0: calls $12.81 and is all-in
Uncalled bet ($8.19) returned to dndngod
*** RIVER *** [7s 8d 2d 7h] [Qh]
*** SHOW DOWN ***
dndngod: shows [9h 9s] (two pair, Nines and Sevens)
yellowfever0: mucks hand 
dndngod collected $36.17 from pot
*** SUMMARY ***
Total pot $37.87 | Rake $1.70 
Board [7s 8d 2d 7h Qh]
Seat 1: yellowfever0 mucked [Jc 8c]
Seat 2: NeverRegret7 (button) folded on the Flop
Seat 3: ChiChioChi (small blind) folded before Flop
Seat 4: matiko09 (big blind) folded before Flop
Seat 5: fandorin2005 folded before Flop (didn't bet)
Seat 6: Ahangama folded before Flop (didn't bet)
Seat 7: Zeeshka folded before Flop (didn't bet)
Seat 8: lumen21 folded before Flop (didn't bet)
Seat 9: dndngod showed [9h 9s] and won ($36.17) with two pair, Nines and Sevens





PokerStars Hand #150799475312:  Hold'em No Limit (€0.25/€0.50 EUR) - 2016/03/23 13:35:07 CET [2016/03/23 8:35:07 ET]
Table 'Palma II' 9-max Seat #6 is the button
Seat 1: Ahangama (€50 in chips) 
Seat 2: matiko09 (€50.75 in chips) 
Seat 3: ardo888 (€52.54 in chips) 
Seat 4: dndngod (€53.49 in chips) 
Seat 5: SVFB13 (€49.25 in chips) 
Seat 6: Red_Warning (€50 in chips) 
Seat 7: Wouter Des (€56.23 in chips) 
Seat 8: CvMCvMCvM (€50 in chips) 
Seat 9: ZonTTT (€50 in chips) 
Wouter Des: posts small blind €0.25
CvMCvMCvM: posts big blind €0.50
*** HOLE CARDS ***
Dealt to matiko09 [5s 6h]
ZonTTT: folds 
Ahangama: folds 
matiko09: folds 
ardo888: folds 
dndngod: folds 
SVFB13: folds 
Red_Warning: raises €0.50 to €1
Wouter Des: calls €0.75
CvMCvMCvM: folds 
*** FLOP *** [9h 2c 3h]
Wouter Des: checks 
Red_Warning: checks 
*** TURN *** [9h 2c 3h] [Ks]
Wouter Des: checks 
Red_Warning: checks 
*** RIVER *** [9h 2c 3h Ks] [7h]
Wouter Des: checks 
Red_Warning: checks 
*** SHOW DOWN ***
Wouter Des: shows [As Jd] (high card Ace)
Red_Warning: shows [8c 7c] (a pair of Sevens)
Red_Warning collected €2.39 from pot
*** SUMMARY ***
Total pot €2.50 | Rake €0.11 
Board [9h 2c 3h Ks 7h]
Seat 1: Ahangama folded before Flop (didn't bet)
Seat 2: matiko09 folded before Flop (didn't bet)
Seat 3: ardo888 folded before Flop (didn't bet)
Seat 4: dndngod folded before Flop (didn't bet)
Seat 5: SVFB13 folded before Flop (didn't bet)
Seat 6: Red_Warning (button) showed [8c 7c] and won (€2.39) with a pair of Sevens
Seat 7: Wouter Des (small blind) showed [As Jd] and lost with high card Ace
Seat 8: CvMCvMCvM (big blind) folded before Flop
Seat 9: ZonTTT folded before Flop (didn't bet)





PokerStars Hand #150799475918:  Hold'em No Limit (€0.25/€0.50 EUR) - 2016/03/23 13:35:08 CET [2016/03/23 8:35:08 ET]
Table 'Hesperia II' 9-max Seat #6 is the button
Seat 1: CAJUN890 (€46.71 in chips) 
Seat 2: dndngod (€51.61 in chips) 
Seat 3: IvanUrgant (€54.24 in chips) 
Seat 4: Zelenis (€19.71 in chips) 
Seat 5: Avrora-sp (€50 in chips) 
Seat 6: CvMCvMCvM (€50 in chips) 
Seat 7: matiko09 (€61.23 in chips) 
Seat 8: Ahangama (€50 in chips) 
matiko09: posts small blind €0.25
Ahangama: posts big blind €0.50
Red_Warning: sits out 
*** HOLE CARDS ***
Dealt to matiko09 [4s Ks]
CAJUN890: folds 
dndngod: raises €1 to €1.50
IvanUrgant: folds 
Zelenis: folds 
Avrora-sp: folds 
CvMCvMCvM: calls €1.50
matiko09: folds 
Ahangama: folds 
*** FLOP *** [Qd 8c 5d]
dndngod: bets €2.50
CvMCvMCvM: folds 
Uncalled bet (€2.50) returned to dndngod
dndngod collected €3.58 from pot
*** SUMMARY ***
Total pot €3.75 | Rake €0.17 
Board [Qd 8c 5d]
Seat 1: CAJUN890 folded before Flop (didn't bet)
Seat 2: dndngod collected (€3.58)
Seat 3: IvanUrgant folded before Flop (didn't bet)
Seat 4: Zelenis folded before Flop (didn't bet)
Seat 5: Avrora-sp folded before Flop (didn't bet)
Seat 6: CvMCvMCvM (button) folded on the Flop
Seat 7: matiko09 (small blind) folded before Flop
Seat 8: Ahangama (big blind) folded before Flop





PokerStars Hand #150799477119:  Hold'em No Limit ($0.50/$1.00 USD) - 2016/03/23 13:35:10 CET [2016/03/23 8:35:10 ET]
Table 'Oljato' 9-max Seat #8 is the button
Seat 1: myatiy 96 ($100 in chips) 
Seat 2: roman134679 ($37.37 in chips) 
Seat 3: DUkalisUA ($100 in chips) 
Seat 4: Pvsx. ($146.70 in chips) 
Seat 5: ryo728 ($88.23 in chips) 
Seat 6: WDW3 ($118.61 in chips) 
Seat 7: matiko09 ($160.09 in chips) 
Seat 8: Zeeshka ($353.14 in chips) 
Seat 9: Jimy Tiltman ($114.56 in chips) 
Jimy Tiltman: posts small blind $0.50
myatiy 96: posts big blind $1
*** HOLE CARDS ***
Dealt to matiko09 [Qc 2s]
roman134679: folds 
DUkalisUA: folds 
Pvsx.: folds 
ryo728: folds 
WDW3: folds 
matiko09: folds 
Zeeshka: folds 
Jimy Tiltman: raises $2 to $3
myatiy 96: raises $6 to $9
Jimy Tiltman: folds 
Uncalled bet ($6) returned to myatiy 96
myatiy 96 collected $6 from pot
myatiy 96: doesn't show hand 
*** SUMMARY ***
Total pot $6 | Rake $0 
Seat 1: myatiy 96 (big blind) collected ($6)
Seat 2: roman134679 folded before Flop (didn't bet)
Seat 3: DUkalisUA folded before Flop (didn't bet)
Seat 4: Pvsx. folded before Flop (didn't bet)
Seat 5: ryo728 folded before Flop (didn't bet)
Seat 6: WDW3 folded before Flop (didn't bet)
Seat 7: matiko09 folded before Flop (didn't bet)
Seat 8: Zeeshka (button) folded before Flop (didn't bet)
Seat 9: Jimy Tiltman (small blind) folded before Flop





PokerStars Hand #150799477239:  Hold'em No Limit ($0.50/$1.00 USD) - 2016/03/23 13:35:11 CET [2016/03/23 8:35:11 ET]
Table 'Kippes' 9-max Seat #6 is the button
Seat 1: Pvsx. ($100 in chips) 
Seat 2: RICKA16 ($127.63 in chips) 
Seat 3: CAJUN890 ($117.31 in chips) 
Seat 4: matiko09 ($115.22 in chips) 
Seat 5: Jimy Tiltman ($116.86 in chips) 
Seat 6: WDW3 ($122.25 in chips) 
Seat 7: lumen21 ($100 in chips) 
Seat 8: Zeeshka ($103.30 in chips) 
Seat 9: wang19790906 ($79.94 in chips) 
lumen21: posts small blind $0.50
Zeeshka: posts big blind $1
*** HOLE CARDS ***
Dealt to matiko09 [5h 3h]
wang19790906: folds 
Pvsx.: folds 
RICKA16: folds 
CAJUN890: folds 
matiko09: folds 
Jimy Tiltman: folds 
WDW3: raises $1.40 to $2.40
lumen21: folds 
Zeeshka: raises $6.60 to $9
WDW3: calls $6.60
*** FLOP *** [3c 4d Kh]
Zeeshka: bets $9.71
WDW3: calls $9.71
*** TURN *** [3c 4d Kh] [Js]
Zeeshka: bets $18
WDW3: folds 
Uncalled bet ($18) returned to Zeeshka
Zeeshka collected $36.21 from pot
Zeeshka: doesn't show hand 
*** SUMMARY ***
Total pot $37.92 | Rake $1.71 
Board [3c 4d Kh Js]
Seat 1: Pvsx. folded before Flop (didn't bet)
Seat 2: RICKA16 folded before Flop (didn't bet)
Seat 3: CAJUN890 folded before Flop (didn't bet)
Seat 4: matiko09 folded before Flop (didn't bet)
Seat 5: Jimy Tiltman folded before Flop (didn't bet)
Seat 6: WDW3 (button) folded on the Turn
Seat 7: lumen21 (small blind) folded before Flop
Seat 8: Zeeshka (big blind) collected ($36.21)
Seat 9: wang19790906 folded before Flop (didn't bet)





PokerStars Hand #150799478055:  Hold'em No Limit ($1/$2 USD) - 2016/03/23 13:35:12 CET [2016/03/23 8:35:12 ET]
Table 'Kypria II' 9-max Seat #3 is the button
Seat 1: geldwolfje ($240.55 in chips) 
Seat 2: coinflip_si ($207.95 in chips) 
Seat 3: seouljam ($205.14 in chips) 
Seat 4: nailz83 ($116.05 in chips) 
Seat 5: InsomniaRU ($203 in chips) 
Seat 6: matiko09 ($239.64 in chips) 
Seat 8: Fish4trips ($299.59 in chips) 
Seat 9: WDW3 ($200 in chips) 
nailz83: posts small blind $1
InsomniaRU: posts big blind $2
DUkalisUA: sits out 
*** HOLE CARDS ***
Dealt to matiko09 [Js Kh]
matiko09: folds 
Fish4trips: folds 
WDW3: folds 
geldwolfje: folds 
coinflip_si: folds 
seouljam: folds 
nailz83: folds 
Uncalled bet ($1) returned to InsomniaRU
InsomniaRU collected $2 from pot
InsomniaRU: doesn't show hand 
*** SUMMARY ***
Total pot $2 | Rake $0 
Seat 1: geldwolfje folded before Flop (didn't bet)
Seat 2: coinflip_si folded before Flop (didn't bet)
Seat 3: seouljam (button) folded before Flop (didn't bet)
Seat 4: nailz83 (small blind) folded before Flop
Seat 5: InsomniaRU (big blind) collected ($2)
Seat 6: matiko09 folded before Flop (didn't bet)
Seat 8: Fish4trips folded before Flop (didn't bet)
Seat 9: WDW3 folded before Flop (didn't bet)





PokerStars Hand #150799479739:  Hold'em No Limit ($1/$2 USD) - 2016/03/23 13:35:15 CET [2016/03/23 8:35:15 ET]
Table 'Herba II' 9-max Seat #3 is the button
Seat 1: matiko09 ($235.48 in chips) 
Seat 2: Moszes360 ($213.20 in chips) 
Seat 3: Cirilico ($170.60 in chips) 
Seat 4: DUkalisUA ($248.20 in chips) 
Seat 5: chippo boy ($212.40 in chips) 
Seat 6: WDW3 ($200 in chips) 
Seat 7: InsomniaRU ($259.16 in chips) 
Seat 8: The_red_area ($228 in chips) 
Seat 9: mrhighryza ($72.86 in chips) 
DUkalisUA: posts small blind $1
chippo boy: posts big blind $2
*** HOLE CARDS ***
Dealt to matiko09 [Th 7s]
WDW3: folds 
InsomniaRU: folds 
The_red_area: folds 
mrhighryza: folds 
matiko09: folds 
Moszes360: folds 
Cirilico: raises $3 to $5
DUkalisUA: calls $4
chippo boy: calls $3
*** FLOP *** [8h Jh 8c]
DUkalisUA: bets $8
chippo boy: folds 
Cirilico: folds 
Uncalled bet ($8) returned to DUkalisUA
DUkalisUA collected $14.32 from pot
DUkalisUA: doesn't show hand 
*** SUMMARY ***
Total pot $15 | Rake $0.68 
Board [8h Jh 8c]
Seat 1: matiko09 folded before Flop (didn't bet)
Seat 2: Moszes360 folded before Flop (didn't bet)
Seat 3: Cirilico (button) folded on the Flop
Seat 4: DUkalisUA (small blind) collected ($14.32)
Seat 5: chippo boy (big blind) folded on the Flop
Seat 6: WDW3 folded before Flop (didn't bet)
Seat 7: InsomniaRU folded before Flop (didn't bet)
Seat 8: The_red_area folded before Flop (didn't bet)
Seat 9: mrhighryza folded before Flop (didn't bet)





PokerStars Hand #150799484853:  Hold'em No Limit ($0.50/$1.00 USD) - 2016/03/23 13:35:25 CET [2016/03/23 8:35:25 ET]
Table 'Atlantis' 9-max Seat #5 is the button
Seat 1: xHourglass ($176.28 in chips) 
Seat 2: tffff2006 ($30.42 in chips) 
Seat 3: CAJUN890 ($110.19 in chips) 
Seat 4: matiko09 ($101.28 in chips) 
Seat 5: Pvsx. ($100 in chips) 
Seat 6: Jimy Tiltman ($112.24 in chips) 
Seat 7: Zeeshka ($138.37 in chips) 
Seat 8: DUkalisUA ($103.21 in chips) 
Seat 9: WDW3 ($112.47 in chips) 
Jimy Tiltman: posts small blind $0.50
Zeeshka: posts big blind $1
*** HOLE CARDS ***
Dealt to matiko09 [Kd 4s]
DUkalisUA: folds 
WDW3: folds 
xHourglass: raises $2 to $3
tffff2006: folds 
CAJUN890: calls $3
matiko09: folds 
Pvsx.: folds 
Jimy Tiltman: folds 
Zeeshka: folds 
*** FLOP *** [Kh Qh 7s]
xHourglass: checks 
CAJUN890: bets $3.58
xHourglass: folds 
Uncalled bet ($3.58) returned to CAJUN890
CAJUN890 collected $7.16 from pot
CAJUN890: doesn't show hand 
*** SUMMARY ***
Total pot $7.50 | Rake $0.34 
Board [Kh Qh 7s]
Seat 1: xHourglass folded on the Flop
Seat 2: tffff2006 folded before Flop (didn't bet)
Seat 3: CAJUN890 collected ($7.16)
Seat 4: matiko09 folded before Flop (didn't bet)
Seat 5: Pvsx. (button) folded before Flop (didn't bet)
Seat 6: Jimy Tiltman (small blind) folded before Flop
Seat 7: Zeeshka (big blind) folded before Flop
Seat 8: DUkalisUA folded before Flop (didn't bet)
Seat 9: WDW3 folded before Flop (didn't bet)





PokerStars Hand #150799486165:  Hold'em No Limit ($0.25/$0.50 USD) - 2016/03/23 13:35:27 CET [2016/03/23 8:35:27 ET]
Table 'Pyrrhus' 9-max Seat #3 is the button
Seat 1: lumen21 ($50 in chips) 
Seat 2: fandorin2005 ($50 in chips) 
Seat 3: IvanUrgant ($78.71 in chips) 
Seat 4: GriffinBerg ($42.68 in chips) 
Seat 5: Moszes360 ($50 in chips) 
Seat 6: whalldo ($162.72 in chips) 
Seat 7: matiko09 ($102.90 in chips) 
Seat 8: dndngod ($66.72 in chips) 
Seat 9: CvMCvMCvM ($63.66 in chips) 
GriffinBerg: posts small blind $0.25
Moszes360: posts big blind $0.50
*** HOLE CARDS ***
Dealt to matiko09 [3c As]
whalldo has timed out
whalldo: folds 
matiko09: folds 
dndngod: folds 
CvMCvMCvM: folds 
lumen21: folds 
fandorin2005: raises $0.75 to $1.25
IvanUrgant: folds 
GriffinBerg: folds 
Moszes360: folds 
Uncalled bet ($0.75) returned to fandorin2005
fandorin2005 collected $1.25 from pot
fandorin2005: doesn't show hand 
*** SUMMARY ***
Total pot $1.25 | Rake $0 
Seat 1: lumen21 folded before Flop (didn't bet)
Seat 2: fandorin2005 collected ($1.25)
Seat 3: IvanUrgant (button) folded before Flop (didn't bet)
Seat 4: GriffinBerg (small blind) folded before Flop
Seat 5: Moszes360 (big blind) folded before Flop
Seat 6: whalldo folded before Flop (didn't bet)
Seat 7: matiko09 folded before Flop (didn't bet)
Seat 8: dndngod folded before Flop (didn't bet)
Seat 9: CvMCvMCvM folded before Flop (didn't bet)





PokerStars Hand #150799489194:  Hold'em No Limit ($1/$2 USD) - 2016/03/23 13:35:33 CET [2016/03/23 8:35:33 ET]
Table 'Kypria II' 9-max Seat #4 is the button
Seat 1: geldwolfje ($240.55 in chips) 
Seat 2: coinflip_si ($207.95 in chips) 
Seat 3: seouljam ($205.14 in chips) 
Seat 4: nailz83 ($115.05 in chips) 
Seat 5: InsomniaRU ($204 in chips) 
Seat 6: matiko09 ($239.64 in chips) 
Seat 8: Fish4trips ($299.59 in chips) 
Seat 9: WDW3 ($200 in chips) 
InsomniaRU: posts small blind $1
matiko09: posts big blind $2
DUkalisUA: sits out 
*** HOLE CARDS ***
Dealt to matiko09 [7d Qs]
Fish4trips: folds 
WDW3: folds 
geldwolfje: folds 
coinflip_si: folds 
seouljam: raises $2.70 to $4.70
nailz83: calls $4.70
InsomniaRU: folds 
matiko09: folds 
*** FLOP *** [Qd 4h 6s]
seouljam: checks 
nailz83: checks 
*** TURN *** [Qd 4h 6s] [Ts]
seouljam: bets $6
nailz83: calls $6
*** RIVER *** [Qd 4h 6s Ts] [6d]
seouljam: bets $8
nailz83: calls $8
*** SHOW DOWN ***
seouljam: shows [Ks Tc] (two pair, Tens and Sixes)
nailz83: shows [Kh Th] (two pair, Tens and Sixes)
seouljam collected $19.29 from pot
nailz83 collected $19.29 from pot
*** SUMMARY ***
Total pot $40.40 | Rake $1.82 
Board [Qd 4h 6s Ts 6d]
Seat 1: geldwolfje folded before Flop (didn't bet)
Seat 2: coinflip_si folded before Flop (didn't bet)
Seat 3: seouljam showed [Ks Tc] and won ($19.29) with two pair, Tens and Sixes
Seat 4: nailz83 (button) showed [Kh Th] and won ($19.29) with two pair, Tens and Sixes
Seat 5: InsomniaRU (small blind) folded before Flop
Seat 6: matiko09 (big blind) folded before Flop
Seat 8: Fish4trips folded before Flop (didn't bet)
Seat 9: WDW3 folded before Flop (didn't bet)





PokerStars Hand #150799490944:  Hold'em No Limit ($1/$2 USD) - 2016/03/23 13:35:36 CET [2016/03/23 8:35:36 ET]
Table 'Kiess' 9-max Seat #2 is the button
Seat 2: DUkalisUA ($506.76 in chips) 
Seat 3: The_red_area ($254.62 in chips) 
Seat 4: Moszes360 ($200 in chips) 
Seat 5: chippo boy ($252.10 in chips) 
Seat 6: matiko09 ($260.64 in chips) 
Seat 7: InsomniaRU ($330.13 in chips) 
Seat 8: WDW3 ($389.42 in chips) 
Seat 9: Fish4trips ($217.55 in chips) 
The_red_area: posts small blind $1
Moszes360: posts big blind $2
Cirilico: sits out 
*** HOLE CARDS ***
Dealt to matiko09 [4d 9h]
chippo boy: calls $2
matiko09: folds 
InsomniaRU: folds 
WDW3: raises $6 to $8
Fish4trips: folds 
DUkalisUA: folds 
The_red_area: calls $7
Moszes360: raises $22 to $30
chippo boy: folds 
WDW3: folds 
The_red_area: calls $22
*** FLOP *** [6s Kc 2h]
The_red_area: checks 
Moszes360: bets $18
The_red_area: raises $20 to $38
Moszes360: calls $20
*** TURN *** [6s Kc 2h] [8d]
The_red_area: checks 
Moszes360: bets $50
The_red_area: raises $50 to $100
Moszes360: folds 
Uncalled bet ($50) returned to The_red_area
The_red_area collected $243.20 from pot
The_red_area: doesn't show hand 
*** SUMMARY ***
Total pot $246 | Rake $2.80 
Board [6s Kc 2h 8d]
Seat 2: DUkalisUA (button) folded before Flop (didn't bet)
Seat 3: The_red_area (small blind) collected ($243.20)
Seat 4: Moszes360 (big blind) folded on the Turn
Seat 5: chippo boy folded before Flop
Seat 6: matiko09 folded before Flop (didn't bet)
Seat 7: InsomniaRU folded before Flop (didn't bet)
Seat 8: WDW3 folded before Flop
Seat 9: Fish4trips folded before Flop (didn't bet)





PokerStars Hand #150799492854:  Hold'em No Limit ($1/$2 USD) - 2016/03/23 13:35:40 CET [2016/03/23 8:35:40 ET]
Table 'Berbericia II' 9-max Seat #4 is the button
Seat 1: WDW3 ($242.48 in chips) 
Seat 2: Moszes360 ($221.52 in chips) 
Seat 3: Fish4trips ($200 in chips) 
Seat 4: bennetb77 ($160.16 in chips) 
Seat 6: coinflip_si ($200 in chips) 
Seat 8: matiko09 ($324.85 in chips) 
Seat 9: LVV-Bif ($188.70 in chips) 
coinflip_si: posts small blind $1
matiko09: posts big blind $2
*** HOLE CARDS ***
Dealt to matiko09 [4c As]
LVV-Bif: folds 
WDW3: folds 
Moszes360: folds 
Fish4trips: folds 
bennetb77: folds 
Surxach leaves the table
coinflip_si: raises $3 to $5
matiko09: calls $3
*** FLOP *** [7s 7h Ks]
coinflip_si: bets $5.34
matiko09: calls $5.34
*** TURN *** [7s 7h Ks] [5h]
coinflip_si: bets $14
InsomniaRU joins the table at seat #5 
matiko09: folds 
Uncalled bet ($14) returned to coinflip_si
coinflip_si collected $19.75 from pot
coinflip_si: doesn't show hand 
*** SUMMARY ***
Total pot $20.68 | Rake $0.93 
Board [7s 7h Ks 5h]
Seat 1: WDW3 folded before Flop (didn't bet)
Seat 2: Moszes360 folded before Flop (didn't bet)
Seat 3: Fish4trips folded before Flop (didn't bet)
Seat 4: bennetb77 (button) folded before Flop (didn't bet)
Seat 6: coinflip_si (small blind) collected ($19.75)
Seat 8: matiko09 (big blind) folded on the Turn
Seat 9: LVV-Bif folded before Flop (didn't bet)





PokerStars Hand #150799506129:  Hold'em No Limit (€0.25/€0.50 EUR) - 2016/03/23 13:36:04 CET [2016/03/23 8:36:04 ET]
Table 'Hesperia II' 9-max Seat #7 is the button
Seat 1: CAJUN890 (€46.71 in chips) 
Seat 2: dndngod (€53.69 in chips) 
Seat 3: IvanUrgant (€54.24 in chips) 
Seat 4: Zelenis (€19.71 in chips) 
Seat 5: Avrora-sp (€50 in chips) 
Seat 6: CvMCvMCvM (€50 in chips) 
Seat 7: matiko09 (€60.98 in chips) 
Seat 8: Ahangama (€50 in chips) 
Seat 9: Red_Warning (€50 in chips) 
Ahangama: posts small blind €0.25
Red_Warning: posts big blind €0.50
*** HOLE CARDS ***
Dealt to matiko09 [Ts 8c]
CAJUN890: folds 
dndngod: folds 
IvanUrgant: raises €1 to €1.50
Zelenis: folds 
Avrora-sp: folds 
CvMCvMCvM: folds 
matiko09: folds 
Ahangama: folds 
Red_Warning: folds 
Uncalled bet (€1) returned to IvanUrgant
IvanUrgant collected €1.25 from pot
IvanUrgant: doesn't show hand 
*** SUMMARY ***
Total pot €1.25 | Rake €0 
Seat 1: CAJUN890 folded before Flop (didn't bet)
Seat 2: dndngod folded before Flop (didn't bet)
Seat 3: IvanUrgant collected (€1.25)
Seat 4: Zelenis folded before Flop (didn't bet)
Seat 5: Avrora-sp folded before Flop (didn't bet)
Seat 6: CvMCvMCvM folded before Flop (didn't bet)
Seat 7: matiko09 (button) folded before Flop (didn't bet)
Seat 8: Ahangama (small blind) folded before Flop
Seat 9: Red_Warning (big blind) folded before Flop





PokerStars Hand #150799507203:  Hold'em No Limit ($1/$2 USD) - 2016/03/23 13:36:06 CET [2016/03/23 8:36:06 ET]
Table 'Herba II' 9-max Seat #4 is the button
Seat 1: matiko09 ($235.48 in chips) 
Seat 2: Moszes360 ($213.20 in chips) 
Seat 3: Cirilico ($165.60 in chips) 
Seat 4: DUkalisUA ($257.52 in chips) 
Seat 5: chippo boy ($207.40 in chips) 
Seat 6: WDW3 ($200 in chips) 
Seat 7: InsomniaRU ($259.16 in chips) 
Seat 8: The_red_area ($228 in chips) 
Seat 9: mrhighryza ($72.86 in chips) 
chippo boy: posts small blind $1
WDW3: posts big blind $2
*** HOLE CARDS ***
Dealt to matiko09 [4d 5d]
InsomniaRU: folds 
The_red_area: folds 
mrhighryza: folds 
matiko09: folds 
Moszes360: folds 
Cirilico: folds 
DUkalisUA: folds 
chippo boy: folds 
Uncalled bet ($1) returned to WDW3
WDW3 collected $2 from pot
WDW3: doesn't show hand 
*** SUMMARY ***
Total pot $2 | Rake $0 
Seat 1: matiko09 folded before Flop (didn't bet)
Seat 2: Moszes360 folded before Flop (didn't bet)
Seat 3: Cirilico folded before Flop (didn't bet)
Seat 4: DUkalisUA (button) folded before Flop (didn't bet)
Seat 5: chippo boy (small blind) folded before Flop
Seat 6: WDW3 (big blind) collected ($2)
Seat 7: InsomniaRU folded before Flop (didn't bet)
Seat 8: The_red_area folded before Flop (didn't bet)
Seat 9: mrhighryza folded before Flop (didn't bet)





PokerStars Hand #150799510816:  Hold'em No Limit ($0.50/$1.00 USD) - 2016/03/23 13:36:13 CET [2016/03/23 8:36:13 ET]
Table 'Smiley' 9-max Seat #1 is the button
Seat 1: WDW3 ($100 in chips) 
Seat 2: Jimy Tiltman ($100 in chips) 
Seat 3: matiko09 ($137.66 in chips) 
Seat 4: Zeeshka ($100 in chips) 
Seat 5: DUkalisUA ($100 in chips) 
Seat 6: blackmont111 ($57.56 in chips) 
Seat 8: RICKA16 ($112.50 in chips) 
Seat 9: morosun ($133.13 in chips) 
Jimy Tiltman: posts small blind $0.50
matiko09: posts big blind $1
*** HOLE CARDS ***
Dealt to matiko09 [Qc Ac]
Zeeshka: folds 
DUkalisUA: raises $2 to $3
blackmont111: folds 
RICKA16: folds 
morosun: calls $3
WDW3: folds 
Jimy Tiltman: folds 
matiko09: raises $11 to $14
DUkalisUA: folds 
morosun: calls $11
*** FLOP *** [2s Ks 9d]
matiko09: bets $15
morosun: raises $60.08 to $75.08
matiko09: folds 
Uncalled bet ($60.08) returned to morosun
morosun collected $58.73 from pot
*** SUMMARY ***
Total pot $61.50 | Rake $2.77 
Board [2s Ks 9d]
Seat 1: WDW3 (button) folded before Flop (didn't bet)
Seat 2: Jimy Tiltman (small blind) folded before Flop
Seat 3: matiko09 (big blind) folded on the Flop
Seat 4: Zeeshka folded before Flop (didn't bet)
Seat 5: DUkalisUA folded before Flop
Seat 6: blackmont111 folded before Flop (didn't bet)
Seat 8: RICKA16 folded before Flop (didn't bet)
Seat 9: morosun collected ($58.73)





PokerStars Hand #150799511820:  Hold'em No Limit ($1/$2 USD) - 2016/03/23 13:36:15 CET [2016/03/23 8:36:15 ET]
Table 'Kypria II' 9-max Seat #5 is the button
Seat 1: geldwolfje ($240.55 in chips) 
Seat 2: coinflip_si ($207.95 in chips) 
Seat 3: seouljam ($205.73 in chips) 
Seat 4: nailz83 ($115.64 in chips) 
Seat 5: InsomniaRU ($203 in chips) 
Seat 6: matiko09 ($237.64 in chips) 
Seat 7: DUkalisUA ($200 in chips) 
Seat 8: Fish4trips ($299.59 in chips) 
Seat 9: WDW3 ($200 in chips) 
matiko09: posts small blind $1
DUkalisUA: posts big blind $2
*** HOLE CARDS ***
Dealt to matiko09 [Tc Qh]
Fish4trips: folds 
WDW3: folds 
geldwolfje: folds 
coinflip_si: folds 
seouljam: raises $2.70 to $4.70
nailz83: folds 
InsomniaRU: folds 
matiko09: folds 
DUkalisUA: folds 
Uncalled bet ($2.70) returned to seouljam
seouljam collected $5 from pot
seouljam: doesn't show hand 
*** SUMMARY ***
Total pot $5 | Rake $0 
Seat 1: geldwolfje folded before Flop (didn't bet)
Seat 2: coinflip_si folded before Flop (didn't bet)
Seat 3: seouljam collected ($5)
Seat 4: nailz83 folded before Flop (didn't bet)
Seat 5: InsomniaRU (button) folded before Flop (didn't bet)
Seat 6: matiko09 (small blind) folded before Flop
Seat 7: DUkalisUA (big blind) folded before Flop
Seat 8: Fish4trips folded before Flop (didn't bet)
Seat 9: WDW3 folded before Flop (didn't bet)





PokerStars Hand #150799511805:  Hold'em No Limit (€0.25/€0.50 EUR) - 2016/03/23 13:36:15 CET [2016/03/23 8:36:15 ET]
Table 'Palma II' 9-max Seat #7 is the button
Seat 1: Ahangama (€50 in chips) 
Seat 2: matiko09 (€50.75 in chips) 
Seat 3: ardo888 (€52.54 in chips) 
Seat 4: dndngod (€53.49 in chips) 
Seat 5: SVFB13 (€49.25 in chips) 
Seat 6: Red_Warning (€51.39 in chips) 
Seat 7: Wouter Des (€55.23 in chips) 
Seat 8: CvMCvMCvM (€50 in chips) 
Seat 9: ZonTTT (€50 in chips) 
CvMCvMCvM: posts small blind €0.25
ZonTTT: posts big blind €0.50
*** HOLE CARDS ***
Dealt to matiko09 [4c 3h]
Ahangama: folds 
matiko09: folds 
ardo888: folds 
dndngod: folds 
SVFB13: folds 
Red_Warning: raises €1 to €1.50
Wouter Des: calls €1.50
CvMCvMCvM: calls €1.25
ZonTTT: folds 
*** FLOP *** [2d 6c Td]
CvMCvMCvM: checks 
Red_Warning: bets €3.05
Wouter Des: folds 
CvMCvMCvM: raises €4.95 to €8
Red_Warning: calls €4.95
*** TURN *** [2d 6c Td] [7s]
CvMCvMCvM: bets €11.50
Red_Warning: calls €11.50
*** RIVER *** [2d 6c Td 7s] [Jc]
CvMCvMCvM: bets €29 and is all-in
Red_Warning: folds 
Uncalled bet (€29) returned to CvMCvMCvM
CvMCvMCvM collected €42.02 from pot
CvMCvMCvM: doesn't show hand 
*** SUMMARY ***
Total pot €44 | Rake €1.98 
Board [2d 6c Td 7s Jc]
Seat 1: Ahangama folded before Flop (didn't bet)
Seat 2: matiko09 folded before Flop (didn't bet)
Seat 3: ardo888 folded before Flop (didn't bet)
Seat 4: dndngod folded before Flop (didn't bet)
Seat 5: SVFB13 folded before Flop (didn't bet)
Seat 6: Red_Warning folded on the River
Seat 7: Wouter Des (button) folded on the Flop
Seat 8: CvMCvMCvM (small blind) collected (€42.02)
Seat 9: ZonTTT (big blind) folded before Flop





PokerStars Hand #150799512457:  Hold'em No Limit ($0.25/$0.50 USD) - 2016/03/23 13:36:16 CET [2016/03/23 8:36:16 ET]
Table 'Pyrrhus' 9-max Seat #4 is the button
Seat 1: lumen21 ($50 in chips) 
Seat 2: fandorin2005 ($50.75 in chips) 
Seat 3: IvanUrgant ($78.71 in chips) 
Seat 4: GriffinBerg ($42.43 in chips) 
Seat 5: Moszes360 ($50 in chips) 
Seat 7: matiko09 ($102.90 in chips) 
Seat 8: dndngod ($66.72 in chips) 
Seat 9: CvMCvMCvM ($63.66 in chips) 
Moszes360: posts small blind $0.25
matiko09: posts big blind $0.50
*** HOLE CARDS ***
Dealt to matiko09 [9d 6d]
dndngod: folds 
CvMCvMCvM: folds 
lumen21: folds 
fandorin2005: folds 
IvanUrgant: folds 
GriffinBerg: folds 
Moszes360: folds 
Uncalled bet ($0.25) returned to matiko09
matiko09 collected $0.50 from pot
matiko09: doesn't show hand 
*** SUMMARY ***
Total pot $0.50 | Rake $0 
Seat 1: lumen21 folded before Flop (didn't bet)
Seat 2: fandorin2005 folded before Flop (didn't bet)
Seat 3: IvanUrgant folded before Flop (didn't bet)
Seat 4: GriffinBerg (button) folded before Flop (didn't bet)
Seat 5: Moszes360 (small blind) folded before Flop
Seat 7: matiko09 (big blind) collected ($0.50)
Seat 8: dndngod folded before Flop (didn't bet)
Seat 9: CvMCvMCvM folded before Flop (didn't bet)





PokerStars Hand #150799512502:  Hold'em No Limit ($0.50/$1.00 USD) - 2016/03/23 13:36:16 CET [2016/03/23 8:36:16 ET]
Table 'Oljato' 9-max Seat #9 is the button
Seat 1: myatiy 96 ($103 in chips) 
Seat 2: roman134679 ($37.37 in chips) 
Seat 3: DUkalisUA ($100 in chips) 
Seat 4: Pvsx. ($146.70 in chips) 
Seat 5: ryo728 ($88.23 in chips) 
Seat 6: WDW3 ($118.61 in chips) 
Seat 7: matiko09 ($160.09 in chips) 
Seat 8: Zeeshka ($353.14 in chips) 
Seat 9: Jimy Tiltman ($111.56 in chips) 
myatiy 96: posts small blind $0.50
roman134679: posts big blind $1
*** HOLE CARDS ***
Dealt to matiko09 [2c 2s]
DUkalisUA: raises $2 to $3
Pvsx.: folds 
ryo728: folds 
WDW3: folds 
matiko09: folds 
Zeeshka: folds 
Jimy Tiltman: folds 
myatiy 96: folds 
roman134679: calls $2
*** FLOP *** [As 5d Qh]
roman134679: checks 
DUkalisUA: checks 
*** TURN *** [As 5d Qh] [Jh]
roman134679: bets $2
DUkalisUA: folds 
Uncalled bet ($2) returned to roman134679
roman134679 collected $6.21 from pot
*** SUMMARY ***
Total pot $6.50 | Rake $0.29 
Board [As 5d Qh Jh]
Seat 1: myatiy 96 (small blind) folded before Flop
Seat 2: roman134679 (big blind) collected ($6.21)
Seat 3: DUkalisUA folded on the Turn
Seat 4: Pvsx. folded before Flop (didn't bet)
Seat 5: ryo728 folded before Flop (didn't bet)
Seat 6: WDW3 folded before Flop (didn't bet)
Seat 7: matiko09 folded before Flop (didn't bet)
Seat 8: Zeeshka folded before Flop (didn't bet)
Seat 9: Jimy Tiltman (button) folded before Flop (didn't bet)





PokerStars Hand #150799514554:  Hold'em No Limit ($0.25/$0.50 USD) - 2016/03/23 13:36:20 CET [2016/03/23 8:36:20 ET]
Table 'Belnika' 9-max Seat #3 is the button
Seat 2: NeverRegret7 ($61.06 in chips) 
Seat 3: ChiChioChi ($23.54 in chips) 
Seat 4: matiko09 ($66.06 in chips) 
Seat 6: Ahangama ($66.25 in chips) 
Seat 7: Zeeshka ($50 in chips) 
Seat 8: lumen21 ($69.64 in chips) 
Seat 9: dndngod ($82.59 in chips) 
matiko09: posts small blind $0.25
fandorin2005: is sitting out 
Ahangama: posts big blind $0.50
*** HOLE CARDS ***
Dealt to matiko09 [9h Jd]
fandorin2005 leaves the table
Zeeshka: raises $1 to $1.50
lumen21: folds 
dndngod: folds 
NeverRegret7: calls $1.50
ChiChioChi: folds 
IvanUrgant joins the table at seat #5 
matiko09: folds 
Ahangama: folds 
*** FLOP *** [Qh 6c 7d]
Zeeshka: bets $2.39
NeverRegret7: folds 
Uncalled bet ($2.39) returned to Zeeshka
Zeeshka collected $3.58 from pot
Zeeshka: doesn't show hand 
*** SUMMARY ***
Total pot $3.75 | Rake $0.17 
Board [Qh 6c 7d]
Seat 2: NeverRegret7 folded on the Flop
Seat 3: ChiChioChi (button) folded before Flop (didn't bet)
Seat 4: matiko09 (small blind) folded before Flop
Seat 6: Ahangama (big blind) folded before Flop
Seat 7: Zeeshka collected ($3.58)
Seat 8: lumen21 folded before Flop (didn't bet)
Seat 9: dndngod folded before Flop (didn't bet)





PokerStars Hand #150799516428:  Hold'em No Limit ($1/$2 USD) - 2016/03/23 13:36:23 CET [2016/03/23 8:36:23 ET]
Table 'Berbericia II' 9-max Seat #6 is the button
Seat 1: WDW3 ($242.48 in chips) 
Seat 2: Moszes360 ($221.52 in chips) 
Seat 3: Fish4trips ($200 in chips) 
Seat 4: bennetb77 ($160.16 in chips) 
Seat 6: coinflip_si ($209.41 in chips) 
Seat 8: matiko09 ($314.51 in chips) 
Seat 9: LVV-Bif ($188.70 in chips) 
niuquan will be allowed to play after the button
matiko09: posts small blind $1
LVV-Bif: posts big blind $2
InsomniaRU: sits out 
*** HOLE CARDS ***
Dealt to matiko09 [Jh 4s]
WDW3: folds 
Moszes360: folds 
Fish4trips: folds 
bennetb77: folds 
coinflip_si: folds 
niuquan leaves the table
myatiy 96 joins the table at seat #7 
myatiy 96 leaves the table
DUkalisUA joins the table at seat #7 
matiko09: folds 
Uncalled bet ($1) returned to LVV-Bif
DUkalisUA leaves the table
LVV-Bif collected $2 from pot
LVV-Bif: doesn't show hand 
*** SUMMARY ***
Total pot $2 | Rake $0 
Seat 1: WDW3 folded before Flop (didn't bet)
Seat 2: Moszes360 folded before Flop (didn't bet)
Seat 3: Fish4trips folded before Flop (didn't bet)
Seat 4: bennetb77 folded before Flop (didn't bet)
Seat 6: coinflip_si (button) folded before Flop (didn't bet)
Seat 8: matiko09 (small blind) folded before Flop
Seat 9: LVV-Bif (big blind) collected ($2)





PokerStars Hand #150799522746:  Hold'em No Limit ($0.50/$1.00 USD) - 2016/03/23 13:36:35 CET [2016/03/23 8:36:35 ET]
Table 'Atlantis' 9-max Seat #6 is the button
Seat 1: xHourglass ($173.28 in chips) 
Seat 2: tffff2006 ($30.42 in chips) 
Seat 3: CAJUN890 ($114.35 in chips) 
Seat 4: matiko09 ($101.28 in chips) 
Seat 5: Pvsx. ($100 in chips) 
Seat 6: Jimy Tiltman ($111.74 in chips) 
Seat 7: Zeeshka ($137.37 in chips) 
Seat 8: DUkalisUA ($103.21 in chips) 
Seat 9: WDW3 ($112.47 in chips) 
Zeeshka: posts small blind $0.50
DUkalisUA: posts big blind $1
*** HOLE CARDS ***
Dealt to matiko09 [3c 3h]
WDW3: folds 
xHourglass: folds 
tffff2006: folds 
CAJUN890: calls $1
matiko09: raises $2 to $3
Pvsx.: folds 
Jimy Tiltman: folds 
Zeeshka: folds 
DUkalisUA: calls $2
CAJUN890: calls $2
*** FLOP *** [7s 6d 7d]
DUkalisUA: checks 
CAJUN890: bets $5
matiko09: folds 
DUkalisUA: folds 
Uncalled bet ($5) returned to CAJUN890
CAJUN890 collected $9.07 from pot
CAJUN890: doesn't show hand 
*** SUMMARY ***
Total pot $9.50 | Rake $0.43 
Board [7s 6d 7d]
Seat 1: xHourglass folded before Flop (didn't bet)
Seat 2: tffff2006 folded before Flop (didn't bet)
Seat 3: CAJUN890 collected ($9.07)
Seat 4: matiko09 folded on the Flop
Seat 5: Pvsx. folded before Flop (didn't bet)
Seat 6: Jimy Tiltman (button) folded before Flop (didn't bet)
Seat 7: Zeeshka (small blind) folded before Flop
Seat 8: DUkalisUA (big blind) folded on the Flop
Seat 9: WDW3 folded before Flop (didn't bet)





PokerStars Hand #150799523845:  Hold'em No Limit ($0.25/$0.50 USD) - 2016/03/23 13:36:37 CET [2016/03/23 8:36:37 ET]
Table 'Pyrrhus' 9-max Seat #5 is the button
Seat 1: lumen21 ($50 in chips) 
Seat 2: fandorin2005 ($50.75 in chips) 
Seat 3: IvanUrgant ($78.71 in chips) 
Seat 4: GriffinBerg ($42.43 in chips) 
Seat 5: Moszes360 ($50 in chips) 
Seat 7: matiko09 ($103.15 in chips) 
Seat 8: dndngod ($66.72 in chips) 
Seat 9: CvMCvMCvM ($63.66 in chips) 
matiko09: posts small blind $0.25
dndngod: posts big blind $0.50
*** HOLE CARDS ***
Dealt to matiko09 [8d 3d]
CvMCvMCvM: folds 
lumen21: raises $1 to $1.50
fandorin2005: folds 
IvanUrgant: folds 
GriffinBerg: folds 
Moszes360: folds 
matiko09: folds 
dndngod: folds 
Uncalled bet ($1) returned to lumen21
lumen21 collected $1.25 from pot
lumen21: doesn't show hand 
*** SUMMARY ***
Total pot $1.25 | Rake $0 
Seat 1: lumen21 collected ($1.25)
Seat 2: fandorin2005 folded before Flop (didn't bet)
Seat 3: IvanUrgant folded before Flop (didn't bet)
Seat 4: GriffinBerg folded before Flop (didn't bet)
Seat 5: Moszes360 (button) folded before Flop (didn't bet)
Seat 7: matiko09 (small blind) folded before Flop
Seat 8: dndngod (big blind) folded before Flop
Seat 9: CvMCvMCvM folded before Flop (didn't bet)





PokerStars Hand #150799526979:  Hold'em No Limit (€0.25/€0.50 EUR) - 2016/03/23 13:36:43 CET [2016/03/23 8:36:43 ET]
Table 'Hesperia II' 9-max Seat #8 is the button
Seat 1: CAJUN890 (€46.71 in chips) 
Seat 2: dndngod (€53.69 in chips) 
Seat 3: IvanUrgant (€54.99 in chips) 
Seat 4: Zelenis (€19.71 in chips) 
Seat 5: Avrora-sp (€50 in chips) 
Seat 6: CvMCvMCvM (€50 in chips) 
Seat 7: matiko09 (€60.98 in chips) 
Seat 8: Ahangama (€50 in chips) 
Seat 9: Red_Warning (€50 in chips) 
Red_Warning: posts small blind €0.25
CAJUN890: posts big blind €0.50
*** HOLE CARDS ***
Dealt to matiko09 [5d 4s]
dndngod: raises €1 to €1.50
IvanUrgant: folds 
Zelenis: folds 
Avrora-sp: folds 
CvMCvMCvM: folds 
matiko09: folds 
Ahangama: calls €1.50
Red_Warning: folds 
CAJUN890: calls €1
*** FLOP *** [3c 9d Jc]
CAJUN890: checks 
dndngod: checks 
Ahangama: checks 
*** TURN *** [3c 9d Jc] [Kd]
CAJUN890: bets €2.27
dndngod: folds 
Ahangama: folds 
Uncalled bet (€2.27) returned to CAJUN890
CAJUN890 collected €4.54 from pot
CAJUN890: doesn't show hand 
*** SUMMARY ***
Total pot €4.75 | Rake €0.21 
Board [3c 9d Jc Kd]
Seat 1: CAJUN890 (big blind) collected (€4.54)
Seat 2: dndngod folded on the Turn
Seat 3: IvanUrgant folded before Flop (didn't bet)
Seat 4: Zelenis folded before Flop (didn't bet)
Seat 5: Avrora-sp folded before Flop (didn't bet)
Seat 6: CvMCvMCvM folded before Flop (didn't bet)
Seat 7: matiko09 folded before Flop (didn't bet)
Seat 8: Ahangama (button) folded on the Turn
Seat 9: Red_Warning (small blind) folded before Flop





PokerStars Hand #150799527735:  Hold'em No Limit ($1/$2 USD) - 2016/03/23 13:36:44 CET [2016/03/23 8:36:44 ET]
Table 'Kypria II' 9-max Seat #6 is the button
Seat 1: geldwolfje ($240.55 in chips) 
Seat 2: coinflip_si ($207.95 in chips) 
Seat 3: seouljam ($208.73 in chips) 
Seat 4: nailz83 ($115.64 in chips) 
Seat 5: InsomniaRU ($203 in chips) 
Seat 6: matiko09 ($236.64 in chips) 
Seat 7: DUkalisUA ($200 in chips) 
Seat 8: Fish4trips ($299.59 in chips) 
Seat 9: WDW3 ($200 in chips) 
DUkalisUA: posts small blind $1
Fish4trips: posts big blind $2
*** HOLE CARDS ***
Dealt to matiko09 [7h Td]
WDW3: folds 
geldwolfje: folds 
coinflip_si: raises $3 to $5
seouljam: folds 
nailz83: calls $5
InsomniaRU: folds 
matiko09: folds 
DUkalisUA: folds 
Fish4trips: calls $3
*** FLOP *** [2c Qs 6s]
Fish4trips: checks 
coinflip_si: checks 
nailz83: bets $8
Fish4trips: folds 
coinflip_si: folds 
Uncalled bet ($8) returned to nailz83
nailz83 collected $15.28 from pot
nailz83: doesn't show hand 
*** SUMMARY ***
Total pot $16 | Rake $0.72 
Board [2c Qs 6s]
Seat 1: geldwolfje folded before Flop (didn't bet)
Seat 2: coinflip_si folded on the Flop
Seat 3: seouljam folded before Flop (didn't bet)
Seat 4: nailz83 collected ($15.28)
Seat 5: InsomniaRU folded before Flop (didn't bet)
Seat 6: matiko09 (button) folded before Flop (didn't bet)
Seat 7: DUkalisUA (small blind) folded before Flop
Seat 8: Fish4trips (big blind) folded on the Flop
Seat 9: WDW3 folded before Flop (didn't bet)





PokerStars Hand #150799528465:  Hold'em No Limit ($1/$2 USD) - 2016/03/23 13:36:45 CET [2016/03/23 8:36:45 ET]
Table 'Herba II' 9-max Seat #5 is the button
Seat 1: matiko09 ($235.48 in chips) 
Seat 2: Moszes360 ($213.20 in chips) 
Seat 3: Cirilico ($165.60 in chips) 
Seat 4: DUkalisUA ($257.52 in chips) 
Seat 5: chippo boy ($206.40 in chips) 
Seat 6: WDW3 ($201 in chips) 
Seat 7: InsomniaRU ($259.16 in chips) 
Seat 8: The_red_area ($228 in chips) 
Seat 9: mrhighryza ($72.86 in chips) 
WDW3: posts small blind $1
InsomniaRU: posts big blind $2
*** HOLE CARDS ***
Dealt to matiko09 [8h Qd]
The_red_area: folds 
mrhighryza: calls $2
matiko09: folds 
Moszes360: folds 
Cirilico: folds 
DUkalisUA: raises $5 to $7
chippo boy: folds 
WDW3: folds 
InsomniaRU: folds 
mrhighryza: calls $5
*** FLOP *** [Jh 8d Qc]
mrhighryza: checks 
DUkalisUA: bets $12
mrhighryza: calls $12
*** TURN *** [Jh 8d Qc] [As]
mrhighryza: checks 
DUkalisUA: checks 
*** RIVER *** [Jh 8d Qc As] [Ks]
mrhighryza: checks 
DUkalisUA: bets $10
mrhighryza: calls $10
*** SHOW DOWN ***
DUkalisUA: shows [Qs Ts] (a straight, Ten to Ace)
mrhighryza: mucks hand 
DUkalisUA collected $58.26 from pot
*** SUMMARY ***
Total pot $61 | Rake $2.74 
Board [Jh 8d Qc As Ks]
Seat 1: matiko09 folded before Flop (didn't bet)
Seat 2: Moszes360 folded before Flop (didn't bet)
Seat 3: Cirilico folded before Flop (didn't bet)
Seat 4: DUkalisUA showed [Qs Ts] and won ($58.26) with a straight, Ten to Ace
Seat 5: chippo boy (button) folded before Flop (didn't bet)
Seat 6: WDW3 (small blind) folded before Flop
Seat 7: InsomniaRU (big blind) folded before Flop
Seat 8: The_red_area folded before Flop (didn't bet)
Seat 9: mrhighryza mucked [Jd Kd]





PokerStars Hand #150799532776:  Hold'em No Limit ($0.50/$1.00 USD) - 2016/03/23 13:36:53 CET [2016/03/23 8:36:53 ET]
Table 'Oljato' 9-max Seat #1 is the button
Seat 1: myatiy 96 ($102.50 in chips) 
Seat 2: roman134679 ($40.58 in chips) 
Seat 3: DUkalisUA ($100 in chips) 
Seat 4: Pvsx. ($146.70 in chips) 
Seat 5: ryo728 ($88.23 in chips) 
Seat 6: WDW3 ($118.61 in chips) 
Seat 7: matiko09 ($160.09 in chips) 
Seat 8: Zeeshka ($353.14 in chips) 
Seat 9: Jimy Tiltman ($111.56 in chips) 
roman134679: posts small blind $0.50
DUkalisUA: posts big blind $1
*** HOLE CARDS ***
Dealt to matiko09 [3h 4d]
Pvsx.: folds 
ryo728: raises $1 to $2
WDW3: folds 
matiko09: folds 
Zeeshka: folds 
Jimy Tiltman: folds 
myatiy 96: folds 
roman134679: folds 
DUkalisUA: folds 
Uncalled bet ($1) returned to ryo728
ryo728 collected $2.50 from pot
ryo728: doesn't show hand 
*** SUMMARY ***
Total pot $2.50 | Rake $0 
Seat 1: myatiy 96 (button) folded before Flop (didn't bet)
Seat 2: roman134679 (small blind) folded before Flop
Seat 3: DUkalisUA (big blind) folded before Flop
Seat 4: Pvsx. folded before Flop (didn't bet)
Seat 5: ryo728 collected ($2.50)
Seat 6: WDW3 folded before Flop (didn't bet)
Seat 7: matiko09 folded before Flop (didn't bet)
Seat 8: Zeeshka folded before Flop (didn't bet)
Seat 9: Jimy Tiltman folded before Flop (didn't bet)





PokerStars Hand #150799534105:  Hold'em No Limit ($1/$2 USD) - 2016/03/23 13:36:56 CET [2016/03/23 8:36:56 ET]
Table 'Berbericia II' 9-max Seat #8 is the button
Seat 1: WDW3 ($242.48 in chips) 
Seat 2: Moszes360 ($221.52 in chips) 
Seat 3: Fish4trips ($200 in chips) 
Seat 4: bennetb77 ($160.16 in chips) 
Seat 6: coinflip_si ($209.41 in chips) 
Seat 8: matiko09 ($313.51 in chips) 
Seat 9: LVV-Bif ($189.70 in chips) 
LVV-Bif: posts small blind $1
WDW3: posts big blind $2
InsomniaRU: sits out 
*** HOLE CARDS ***
Dealt to matiko09 [6d 8h]
Moszes360: folds 
Fish4trips: folds 
bennetb77: raises $4 to $6
$-Twackle-$ joins the table at seat #7 
coinflip_si: folds 
coinflip_si leaves the table
matiko09: folds 
LVV-Bif: calls $5
WDW3: raises $18 to $24
bennetb77: calls $18
LVV-Bif: calls $18
*** FLOP *** [Tc 4s Ad]
LVV-Bif: checks 
WDW3: bets $35
bennetb77: calls $35
LVV-Bif: calls $35
*** TURN *** [Tc 4s Ad] [9h]
LVV-Bif: bets $130.70 and is all-in
WDW3: folds 
bennetb77 said, "??"
bennetb77: folds 
Uncalled bet ($130.70) returned to LVV-Bif
LVV-Bif collected $174.20 from pot
LVV-Bif: doesn't show hand 
*** SUMMARY ***
Total pot $177 | Rake $2.80 
Board [Tc 4s Ad 9h]
Seat 1: WDW3 (big blind) folded on the Turn
Seat 2: Moszes360 folded before Flop (didn't bet)
Seat 3: Fish4trips folded before Flop (didn't bet)
Seat 4: bennetb77 folded on the Turn
Seat 6: coinflip_si folded before Flop (didn't bet)
Seat 8: matiko09 (button) folded before Flop (didn't bet)
Seat 9: LVV-Bif (small blind) collected ($174.20)





PokerStars Hand #150799537122:  Hold'em No Limit ($0.25/$0.50 USD) - 2016/03/23 13:37:01 CET [2016/03/23 8:37:01 ET]
Table 'Pyrrhus' 9-max Seat #7 is the button
Seat 1: lumen21 ($50.75 in chips) 
Seat 2: fandorin2005 ($50.75 in chips) 
Seat 3: IvanUrgant ($78.71 in chips) 
Seat 4: GriffinBerg ($42.43 in chips) 
Seat 5: Moszes360 ($50 in chips) 
Seat 7: matiko09 ($102.90 in chips) 
Seat 8: dndngod ($66.22 in chips) 
Seat 9: CvMCvMCvM ($63.66 in chips) 
dndngod: posts small blind $0.25
CvMCvMCvM: posts big blind $0.50
*** HOLE CARDS ***
Dealt to matiko09 [8s 4d]
lumen21: folds 
fandorin2005: folds 
IvanUrgant: folds 
GriffinBerg: folds 
Moszes360: raises $0.75 to $1.25
matiko09: folds 
dndngod: folds 
CvMCvMCvM: raises $3.25 to $4.50
Moszes360: calls $3.25
*** FLOP *** [2d Ks 7h]
CvMCvMCvM: bets $3
Moszes360: calls $3
*** TURN *** [2d Ks 7h] [8d]
CvMCvMCvM: bets $10
Moszes360: calls $10
*** RIVER *** [2d Ks 7h 8d] [2c]
CvMCvMCvM: bets $46.16 and is all-in
Moszes360: calls $32.50 and is all-in
Uncalled bet ($13.66) returned to CvMCvMCvM
*** SHOW DOWN ***
CvMCvMCvM: shows [Ac Ad] (two pair, Aces and Deuces)
Moszes360: shows [Qc Kh] (two pair, Kings and Deuces)
CvMCvMCvM collected $97.75 from pot
*** SUMMARY ***
Total pot $100.25 | Rake $2.50 
Board [2d Ks 7h 8d 2c]
Seat 1: lumen21 folded before Flop (didn't bet)
Seat 2: fandorin2005 folded before Flop (didn't bet)
Seat 3: IvanUrgant folded before Flop (didn't bet)
Seat 4: GriffinBerg folded before Flop (didn't bet)
Seat 5: Moszes360 showed [Qc Kh] and lost with two pair, Kings and Deuces
Seat 7: matiko09 (button) folded before Flop (didn't bet)
Seat 8: dndngod (small blind) folded before Flop
Seat 9: CvMCvMCvM (big blind) showed [Ac Ad] and won ($97.75) with two pair, Aces and Deuces





PokerStars Hand #150799539366:  Hold'em No Limit ($0.50/$1.00 USD) - 2016/03/23 13:37:06 CET [2016/03/23 8:37:06 ET]
Table 'Kippes' 9-max Seat #7 is the button
Seat 1: Pvsx. ($100 in chips) 
Seat 2: RICKA16 ($127.63 in chips) 
Seat 3: CAJUN890 ($117.31 in chips) 
Seat 4: matiko09 ($115.22 in chips) 
Seat 5: Jimy Tiltman ($116.86 in chips) 
Seat 6: WDW3 ($103.54 in chips) 
Seat 7: lumen21 ($100 in chips) 
Seat 8: Zeeshka ($120.80 in chips) 
Seat 9: wang19790906 ($79.94 in chips) 
Zeeshka: posts small blind $0.50
wang19790906: posts big blind $1
*** HOLE CARDS ***
Dealt to matiko09 [Qd Jh]
Pvsx.: folds 
RICKA16: folds 
CAJUN890: folds 
matiko09: folds 
Jimy Tiltman: folds 
WDW3: folds 
lumen21: folds 
Zeeshka: raises $2 to $3
wang19790906: calls $2
*** FLOP *** [3d 7d 9d]
Zeeshka: checks 
wang19790906: checks 
*** TURN *** [3d 7d 9d] [Td]
Zeeshka: checks 
wang19790906: checks 
*** RIVER *** [3d 7d 9d Td] [9c]
Zeeshka: checks 
wang19790906: checks 
*** SHOW DOWN ***
Zeeshka: shows [Ah Qc] (a pair of Nines)
wang19790906: shows [7h 6h] (two pair, Nines and Sevens)
wang19790906 collected $5.73 from pot
*** SUMMARY ***
Total pot $6 | Rake $0.27 
Board [3d 7d 9d Td 9c]
Seat 1: Pvsx. folded before Flop (didn't bet)
Seat 2: RICKA16 folded before Flop (didn't bet)
Seat 3: CAJUN890 folded before Flop (didn't bet)
Seat 4: matiko09 folded before Flop (didn't bet)
Seat 5: Jimy Tiltman folded before Flop (didn't bet)
Seat 6: WDW3 folded before Flop (didn't bet)
Seat 7: lumen21 (button) folded before Flop (didn't bet)
Seat 8: Zeeshka (small blind) showed [Ah Qc] and lost with a pair of Nines
Seat 9: wang19790906 (big blind) showed [7h 6h] and won ($5.73) with two pair, Nines and Sevens





PokerStars Hand #150799541015:  Hold'em No Limit ($0.25/$0.50 USD) - 2016/03/23 13:37:09 CET [2016/03/23 8:37:09 ET]
Table 'Belnika' 9-max Seat #4 is the button
Seat 1: yellowfever0 ($23.23 in chips) 
Seat 2: NeverRegret7 ($59.56 in chips) 
Seat 3: ChiChioChi ($23.54 in chips) 
Seat 4: matiko09 ($65.81 in chips) 
Seat 6: Ahangama ($65.75 in chips) 
Seat 7: Zeeshka ($52.08 in chips) 
Seat 8: lumen21 ($69.64 in chips) 
Seat 9: dndngod ($82.59 in chips) 
IvanUrgant will be allowed to play after the button
Ahangama: posts small blind $0.25
Zeeshka: posts big blind $0.50
*** HOLE CARDS ***
Dealt to matiko09 [8h Ah]
lumen21: folds 
dndngod: folds 
yellowfever0: calls $0.50
NeverRegret7: folds 
ChiChioChi: calls $0.50
matiko09: calls $0.50
Ahangama: folds 
Zeeshka: raises $2 to $2.50
yellowfever0: calls $2
ChiChioChi: calls $2
matiko09: calls $2
*** FLOP *** [8s 2c 5c]
Zeeshka: checks 
yellowfever0: checks 
ChiChioChi: checks 
matiko09: bets $6
Zeeshka: folds 
yellowfever0: folds 
ChiChioChi: folds 
Uncalled bet ($6) returned to matiko09
matiko09 collected $9.79 from pot
matiko09: doesn't show hand 
*** SUMMARY ***
Total pot $10.25 | Rake $0.46 
Board [8s 2c 5c]
Seat 1: yellowfever0 folded on the Flop
Seat 2: NeverRegret7 folded before Flop (didn't bet)
Seat 3: ChiChioChi folded on the Flop
Seat 4: matiko09 (button) collected ($9.79)
Seat 6: Ahangama (small blind) folded before Flop
Seat 7: Zeeshka (big blind) folded on the Flop
Seat 8: lumen21 folded before Flop (didn't bet)
Seat 9: dndngod folded before Flop (didn't bet)





PokerStars Hand #150799542242:  Hold'em No Limit ($1/$2 USD) - 2016/03/23 13:37:11 CET [2016/03/23 8:37:11 ET]
Table 'Kiess' 9-max Seat #3 is the button
Seat 2: DUkalisUA ($506.76 in chips) 
Seat 3: The_red_area ($379.82 in chips) 
Seat 4: Moszes360 ($200 in chips) 
Seat 5: chippo boy ($250.10 in chips) 
Seat 6: matiko09 ($260.64 in chips) 
Seat 7: InsomniaRU ($330.13 in chips) 
Seat 8: WDW3 ($381.42 in chips) 
Seat 9: Fish4trips ($217.55 in chips) 
Moszes360: posts small blind $1
chippo boy: posts big blind $2
Cirilico: sits out 
*** HOLE CARDS ***
Dealt to matiko09 [2d 8s]
matiko09: folds 
InsomniaRU: raises $3 to $5
WDW3: folds 
Fish4trips: folds 
DUkalisUA: folds 
The_red_area: folds 
Moszes360: folds 
chippo boy: calls $3
*** FLOP *** [Ad Qh Js]
chippo boy: checks 
InsomniaRU: bets $7.04
chippo boy: calls $7.04
*** TURN *** [Ad Qh Js] [7h]
chippo boy: checks 
InsomniaRU: bets $15.96
chippo boy: raises $21.96 to $37.92
InsomniaRU: calls $21.96
*** RIVER *** [Ad Qh Js 7h] [Jc]
chippo boy: bets $98
InsomniaRU: folds 
Uncalled bet ($98) returned to chippo boy
chippo boy collected $98.12 from pot
*** SUMMARY ***
Total pot $100.92 | Rake $2.80 
Board [Ad Qh Js 7h Jc]
Seat 2: DUkalisUA folded before Flop (didn't bet)
Seat 3: The_red_area (button) folded before Flop (didn't bet)
Seat 4: Moszes360 (small blind) folded before Flop
Seat 5: chippo boy (big blind) collected ($98.12)
Seat 6: matiko09 folded before Flop (didn't bet)
Seat 7: InsomniaRU folded on the River
Seat 8: WDW3 folded before Flop (didn't bet)
Seat 9: Fish4trips folded before Flop (didn't bet)





PokerStars Hand #150799546801:  Hold'em No Limit ($0.50/$1.00 USD) - 2016/03/23 13:37:19 CET [2016/03/23 8:37:19 ET]
Table 'Smiley' 9-max Seat #2 is the button
Seat 1: WDW3 ($100 in chips) 
Seat 2: Jimy Tiltman ($100 in chips) 
Seat 3: matiko09 ($108.66 in chips) 
Seat 4: Zeeshka ($100 in chips) 
Seat 5: DUkalisUA ($100 in chips) 
Seat 6: blackmont111 ($57.56 in chips) 
Seat 8: RICKA16 ($112.50 in chips) 
Seat 9: morosun ($162.86 in chips) 
matiko09: posts small blind $0.50
Zeeshka: posts big blind $1
*** HOLE CARDS ***
Dealt to matiko09 [2d 4c]
DUkalisUA: folds 
blackmont111: folds 
RICKA16: folds 
morosun: folds 
WDW3: raises $1.80 to $2.80
Jimy Tiltman: calls $2.80
matiko09: folds 
morosun said, "set"
Zeeshka: folds 
*** FLOP *** [Tc 8d As]
WDW3: checks 
Jimy Tiltman: bets $5.08
WDW3: folds 
Uncalled bet ($5.08) returned to Jimy Tiltman
Jimy Tiltman collected $6.78 from pot
Jimy Tiltman: doesn't show hand 
*** SUMMARY ***
Total pot $7.10 | Rake $0.32 
Board [Tc 8d As]
Seat 1: WDW3 folded on the Flop
Seat 2: Jimy Tiltman (button) collected ($6.78)
Seat 3: matiko09 (small blind) folded before Flop
Seat 4: Zeeshka (big blind) folded before Flop
Seat 5: DUkalisUA folded before Flop (didn't bet)
Seat 6: blackmont111 folded before Flop (didn't bet)
Seat 8: RICKA16 folded before Flop (didn't bet)
Seat 9: morosun folded before Flop (didn't bet)





PokerStars Hand #150799552519:  Hold'em No Limit ($0.50/$1.00 USD) - 2016/03/23 13:37:30 CET [2016/03/23 8:37:30 ET]
Table 'Oljato' 9-max Seat #2 is the button
Seat 1: myatiy 96 ($102.50 in chips) 
Seat 2: roman134679 ($40.08 in chips) 
Seat 3: DUkalisUA ($100 in chips) 
Seat 4: Pvsx. ($146.70 in chips) 
Seat 5: ryo728 ($89.73 in chips) 
Seat 6: WDW3 ($118.61 in chips) 
Seat 7: matiko09 ($160.09 in chips) 
Seat 8: Zeeshka ($353.14 in chips) 
Seat 9: Jimy Tiltman ($111.56 in chips) 
DUkalisUA: posts small blind $0.50
Pvsx.: posts big blind $1
*** HOLE CARDS ***
Dealt to matiko09 [5s 7c]
ryo728: folds 
WDW3: folds 
matiko09: folds 
Zeeshka: folds 
Jimy Tiltman: folds 
myatiy 96: folds 
roman134679: folds 
DUkalisUA: folds 
Uncalled bet ($0.50) returned to Pvsx.
Pvsx. collected $1 from pot
Pvsx.: doesn't show hand 
*** SUMMARY ***
Total pot $1 | Rake $0 
Seat 1: myatiy 96 folded before Flop (didn't bet)
Seat 2: roman134679 (button) folded before Flop (didn't bet)
Seat 3: DUkalisUA (small blind) folded before Flop
Seat 4: Pvsx. (big blind) collected ($1)
Seat 5: ryo728 folded before Flop (didn't bet)
Seat 6: WDW3 folded before Flop (didn't bet)
Seat 7: matiko09 folded before Flop (didn't bet)
Seat 8: Zeeshka folded before Flop (didn't bet)
Seat 9: Jimy Tiltman folded before Flop (didn't bet)





PokerStars Hand #150799555300:  Hold'em No Limit ($1/$2 USD) - 2016/03/23 13:37:35 CET [2016/03/23 8:37:35 ET]
Table 'Kypria II' 9-max Seat #7 is the button
Seat 1: geldwolfje ($240.55 in chips) 
Seat 2: coinflip_si ($202.95 in chips) 
Seat 3: seouljam ($208.73 in chips) 
Seat 4: nailz83 ($125.92 in chips) 
Seat 5: InsomniaRU ($203 in chips) 
Seat 6: matiko09 ($236.64 in chips) 
Seat 7: DUkalisUA ($200 in chips) 
Seat 8: Fish4trips ($294.59 in chips) 
Seat 9: WDW3 ($200 in chips) 
Fish4trips: posts small blind $1
WDW3: posts big blind $2
*** HOLE CARDS ***
Dealt to matiko09 [As 8d]
geldwolfje: raises $4 to $6
coinflip_si: folds 
seouljam: folds 
nailz83: folds 
InsomniaRU: folds 
matiko09: folds 
DUkalisUA: folds 
Fish4trips: folds 
WDW3: calls $4
*** FLOP *** [Jh Jc 2d]
WDW3: checks 
geldwolfje: checks 
*** TURN *** [Jh Jc 2d] [Jd]
WDW3: checks 
geldwolfje: checks 
*** RIVER *** [Jh Jc 2d Jd] [9d]
WDW3: checks 
geldwolfje: checks 
*** SHOW DOWN ***
WDW3: shows [Ac 7c] (three of a kind, Jacks)
geldwolfje: mucks hand 
WDW3 collected $12.42 from pot
*** SUMMARY ***
Total pot $13 | Rake $0.58 
Board [Jh Jc 2d Jd 9d]
Seat 1: geldwolfje mucked [Kc Qd]
Seat 2: coinflip_si folded before Flop (didn't bet)
Seat 3: seouljam folded before Flop (didn't bet)
Seat 4: nailz83 folded before Flop (didn't bet)
Seat 5: InsomniaRU folded before Flop (didn't bet)
Seat 6: matiko09 folded before Flop (didn't bet)
Seat 7: DUkalisUA (button) folded before Flop (didn't bet)
Seat 8: Fish4trips (small blind) folded before Flop
Seat 9: WDW3 (big blind) showed [Ac 7c] and won ($12.42) with three of a kind, Jacks





PokerStars Hand #150799558862:  Hold'em No Limit ($0.50/$1.00 USD) - 2016/03/23 13:37:41 CET [2016/03/23 8:37:41 ET]
Table 'Atlantis' 9-max Seat #7 is the button
Seat 1: xHourglass ($173.28 in chips) 
Seat 2: tffff2006 ($30.42 in chips) 
Seat 3: CAJUN890 ($120.42 in chips) 
Seat 4: matiko09 ($100 in chips) 
Seat 5: Pvsx. ($100 in chips) 
Seat 6: Jimy Tiltman ($111.74 in chips) 
Seat 7: Zeeshka ($136.87 in chips) 
Seat 8: DUkalisUA ($100.21 in chips) 
Seat 9: WDW3 ($112.47 in chips) 
DUkalisUA: posts small blind $0.50
WDW3: posts big blind $1
*** HOLE CARDS ***
Dealt to matiko09 [7d 4s]
xHourglass: folds 
tffff2006: folds 
CAJUN890: calls $1
matiko09: folds 
Pvsx.: folds 
Jimy Tiltman: folds 
Zeeshka: raises $3 to $4
DUkalisUA: folds 
WDW3: folds 
CAJUN890: calls $3
*** FLOP *** [Jh Ts Jd]
CAJUN890: checks 
Zeeshka: bets $4.98
CAJUN890: calls $4.98
*** TURN *** [Jh Ts Jd] [2h]
CAJUN890: checks 
Zeeshka: checks 
*** RIVER *** [Jh Ts Jd 2h] [Ac]
CAJUN890: checks 
Zeeshka: checks 
*** SHOW DOWN ***
CAJUN890: shows [Tc Qd] (two pair, Jacks and Tens)
Zeeshka: shows [9h Th] (two pair, Jacks and Tens)
CAJUN890 collected $9.29 from pot
Zeeshka collected $9.29 from pot
*** SUMMARY ***
Total pot $19.46 | Rake $0.88 
Board [Jh Ts Jd 2h Ac]
Seat 1: xHourglass folded before Flop (didn't bet)
Seat 2: tffff2006 folded before Flop (didn't bet)
Seat 3: CAJUN890 showed [Tc Qd] and won ($9.29) with two pair, Jacks and Tens
Seat 4: matiko09 folded before Flop (didn't bet)
Seat 5: Pvsx. folded before Flop (didn't bet)
Seat 6: Jimy Tiltman folded before Flop (didn't bet)
Seat 7: Zeeshka (button) showed [9h Th] and won ($9.29) with two pair, Jacks and Tens
Seat 8: DUkalisUA (small blind) folded before Flop
Seat 9: WDW3 (big blind) folded before Flop





PokerStars Hand #150799567214:  Hold'em No Limit ($0.50/$1.00 USD) - 2016/03/23 13:37:57 CET [2016/03/23 8:37:57 ET]
Table 'Oljato' 9-max Seat #3 is the button
Seat 1: myatiy 96 ($102.50 in chips) 
Seat 2: roman134679 ($40.08 in chips) 
Seat 3: DUkalisUA ($100 in chips) 
Seat 4: Pvsx. ($147.20 in chips) 
Seat 5: ryo728 ($89.73 in chips) 
Seat 6: WDW3 ($118.61 in chips) 
Seat 7: matiko09 ($160.09 in chips) 
Seat 8: Zeeshka ($353.14 in chips) 
Seat 9: Jimy Tiltman ($111.56 in chips) 
Pvsx.: posts small blind $0.50
ryo728: posts big blind $1
*** HOLE CARDS ***
Dealt to matiko09 [6d Qs]
WDW3: folds 
matiko09: folds 
Zeeshka: folds 
Jimy Tiltman: folds 
myatiy 96: folds 
roman134679: folds 
DUkalisUA: folds 
Pvsx.: folds 
Uncalled bet ($0.50) returned to ryo728
ryo728 collected $1 from pot
ryo728: doesn't show hand 
*** SUMMARY ***
Total pot $1 | Rake $0 
Seat 1: myatiy 96 folded before Flop (didn't bet)
Seat 2: roman134679 folded before Flop (didn't bet)
Seat 3: DUkalisUA (button) folded before Flop (didn't bet)
Seat 4: Pvsx. (small blind) folded before Flop
Seat 5: ryo728 (big blind) collected ($1)
Seat 6: WDW3 folded before Flop (didn't bet)
Seat 7: matiko09 folded before Flop (didn't bet)
Seat 8: Zeeshka folded before Flop (didn't bet)
Seat 9: Jimy Tiltman folded before Flop (didn't bet)





PokerStars Hand #150799567535:  Hold'em No Limit ($1/$2 USD) - 2016/03/23 13:37:57 CET [2016/03/23 8:37:57 ET]
Table 'Herba II' 9-max Seat #6 is the button
Seat 1: matiko09 ($235.48 in chips) 
Seat 2: Moszes360 ($213.20 in chips) 
Seat 3: Cirilico ($165.60 in chips) 
Seat 4: DUkalisUA ($286.78 in chips) 
Seat 5: chippo boy ($206.40 in chips) 
Seat 6: WDW3 ($200 in chips) 
Seat 7: InsomniaRU ($257.16 in chips) 
Seat 8: The_red_area ($228 in chips) 
Seat 9: mrhighryza ($43.86 in chips) 
InsomniaRU: posts small blind $1
The_red_area: posts big blind $2
*** HOLE CARDS ***
Dealt to matiko09 [5h 7s]
mrhighryza: folds 
matiko09: folds 
Moszes360: folds 
Cirilico: folds 
DUkalisUA: folds 
chippo boy: calls $2
WDW3: folds 
InsomniaRU: calls $1
The_red_area: checks 
*** FLOP *** [5c 7d 6c]
InsomniaRU: checks 
The_red_area: bets $5.73
chippo boy: calls $5.73
InsomniaRU: calls $5.73
*** TURN *** [5c 7d 6c] [Th]
InsomniaRU: checks 
The_red_area: bets $22.15
chippo boy: calls $22.15
InsomniaRU: folds 
*** RIVER *** [5c 7d 6c Th] [Qh]
The_red_area: bets $64.69
chippo boy: raises $64.69 to $129.38
The_red_area: raises $68.74 to $198.12 and is all-in
chippo boy: calls $47.14 and is all-in
Uncalled bet ($21.60) returned to The_red_area
*** SHOW DOWN ***
The_red_area: shows [8h 4s] (a straight, Four to Eight)
chippo boy: shows [Td Qd] (two pair, Queens and Tens)
The_red_area collected $417.73 from pot
*** SUMMARY ***
Total pot $420.53 | Rake $2.80 
Board [5c 7d 6c Th Qh]
Seat 1: matiko09 folded before Flop (didn't bet)
Seat 2: Moszes360 folded before Flop (didn't bet)
Seat 3: Cirilico folded before Flop (didn't bet)
Seat 4: DUkalisUA folded before Flop (didn't bet)
Seat 5: chippo boy showed [Td Qd] and lost with two pair, Queens and Tens
Seat 6: WDW3 (button) folded before Flop (didn't bet)
Seat 7: InsomniaRU (small blind) folded on the Turn
Seat 8: The_red_area (big blind) showed [8h 4s] and won ($417.73) with a straight, Four to Eight
Seat 9: mrhighryza folded before Flop (didn't bet)





PokerStars Hand #150799573299:  Hold'em No Limit (€0.25/€0.50 EUR) - 2016/03/23 13:38:08 CET [2016/03/23 8:38:08 ET]
Table 'Hesperia II' 9-max Seat #9 is the button
Seat 1: CAJUN890 (€49.75 in chips) 
Seat 2: dndngod (€52.19 in chips) 
Seat 3: IvanUrgant (€54.99 in chips) 
Seat 4: Zelenis (€19.71 in chips) 
Seat 5: Avrora-sp (€50 in chips) 
Seat 6: CvMCvMCvM (€50 in chips) 
Seat 7: matiko09 (€60.98 in chips) 
Seat 8: Ahangama (€50 in chips) 
Seat 9: Red_Warning (€50 in chips) 
CAJUN890: posts small blind €0.25
dndngod: posts big blind €0.50
*** HOLE CARDS ***
Dealt to matiko09 [3d Kh]
IvanUrgant: folds 
Zelenis: raises €1 to €1.50
Avrora-sp: folds 
CvMCvMCvM: folds 
matiko09: folds 
Ahangama: folds 
Red_Warning: folds 
CAJUN890: folds 
dndngod: folds 
Uncalled bet (€1) returned to Zelenis
Zelenis collected €1.25 from pot
Zelenis: doesn't show hand 
*** SUMMARY ***
Total pot €1.25 | Rake €0 
Seat 1: CAJUN890 (small blind) folded before Flop
Seat 2: dndngod (big blind) folded before Flop
Seat 3: IvanUrgant folded before Flop (didn't bet)
Seat 4: Zelenis collected (€1.25)
Seat 5: Avrora-sp folded before Flop (didn't bet)
Seat 6: CvMCvMCvM folded before Flop (didn't bet)
Seat 7: matiko09 folded before Flop (didn't bet)
Seat 8: Ahangama folded before Flop (didn't bet)
Seat 9: Red_Warning (button) folded before Flop (didn't bet)





PokerStars Hand #150799578331:  Hold'em No Limit ($0.50/$1.00 USD) - 2016/03/23 13:38:17 CET [2016/03/23 8:38:17 ET]
Table 'Smiley' 9-max Seat #3 is the button
Seat 1: WDW3 ($100 in chips) 
Seat 2: Jimy Tiltman ($103.98 in chips) 
Seat 3: matiko09 ($108.16 in chips) 
Seat 4: Zeeshka ($100 in chips) 
Seat 5: DUkalisUA ($100 in chips) 
Seat 6: blackmont111 ($57.56 in chips) 
Seat 8: RICKA16 ($112.50 in chips) 
Seat 9: morosun ($162.86 in chips) 
Zeeshka: posts small blind $0.50
DUkalisUA: posts big blind $1
*** HOLE CARDS ***
Dealt to matiko09 [Jc 3h]
blackmont111: folds 
RICKA16: folds 
morosun: folds 
WDW3: folds 
Jimy Tiltman: folds 
matiko09: folds 
Zeeshka: folds 
Uncalled bet ($0.50) returned to DUkalisUA
DUkalisUA collected $1 from pot
DUkalisUA: doesn't show hand 
*** SUMMARY ***
Total pot $1 | Rake $0 
Seat 1: WDW3 folded before Flop (didn't bet)
Seat 2: Jimy Tiltman folded before Flop (didn't bet)
Seat 3: matiko09 (button) folded before Flop (didn't bet)
Seat 4: Zeeshka (small blind) folded before Flop
Seat 5: DUkalisUA (big blind) collected ($1)
Seat 6: blackmont111 folded before Flop (didn't bet)
Seat 8: RICKA16 folded before Flop (didn't bet)
Seat 9: morosun folded before Flop (didn't bet)





PokerStars Hand #150799581506:  Hold'em No Limit ($0.50/$1.00 USD) - 2016/03/23 13:38:23 CET [2016/03/23 8:38:23 ET]
Table 'Oljato' 9-max Seat #4 is the button
Seat 1: myatiy 96 ($102.50 in chips) 
Seat 2: roman134679 ($40.08 in chips) 
Seat 3: DUkalisUA ($100 in chips) 
Seat 4: Pvsx. ($146.70 in chips) 
Seat 5: ryo728 ($90.23 in chips) 
Seat 6: WDW3 ($118.61 in chips) 
Seat 7: matiko09 ($160.09 in chips) 
Seat 8: Zeeshka ($353.14 in chips) 
Seat 9: Jimy Tiltman ($111.56 in chips) 
ryo728: posts small blind $0.50
WDW3: posts big blind $1
*** HOLE CARDS ***
Dealt to matiko09 [Qh 2c]
matiko09: folds 
Zeeshka: folds 
Jimy Tiltman: folds 
myatiy 96: raises $2 to $3
roman134679: folds 
DUkalisUA: folds 
Pvsx.: folds 
ryo728: folds 
WDW3: folds 
Uncalled bet ($2) returned to myatiy 96
myatiy 96 collected $2.50 from pot
myatiy 96: doesn't show hand 
*** SUMMARY ***
Total pot $2.50 | Rake $0 
Seat 1: myatiy 96 collected ($2.50)
Seat 2: roman134679 folded before Flop (didn't bet)
Seat 3: DUkalisUA folded before Flop (didn't bet)
Seat 4: Pvsx. (button) folded before Flop (didn't bet)
Seat 5: ryo728 (small blind) folded before Flop
Seat 6: WDW3 (big blind) folded before Flop
Seat 7: matiko09 folded before Flop (didn't bet)
Seat 8: Zeeshka folded before Flop (didn't bet)
Seat 9: Jimy Tiltman folded before Flop (didn't bet)





PokerStars Hand #150799582464:  Hold'em No Limit ($1/$2 USD) - 2016/03/23 13:38:25 CET [2016/03/23 8:38:25 ET]
Table 'Kypria II' 9-max Seat #8 is the button
Seat 1: geldwolfje ($234.55 in chips) 
Seat 2: coinflip_si ($202.95 in chips) 
Seat 3: seouljam ($208.73 in chips) 
Seat 4: nailz83 ($125.92 in chips) 
Seat 5: InsomniaRU ($203 in chips) 
Seat 6: matiko09 ($236.64 in chips) 
Seat 7: DUkalisUA ($200 in chips) 
Seat 8: Fish4trips ($293.59 in chips) 
Seat 9: WDW3 ($206.42 in chips) 
WDW3: posts small blind $1
geldwolfje: posts big blind $2
*** HOLE CARDS ***
Dealt to matiko09 [Ah 3s]
coinflip_si: folds 
seouljam: folds 
nailz83: folds 
InsomniaRU: folds 
matiko09: folds 
DUkalisUA: folds 
Fish4trips: folds 
WDW3: folds 
Uncalled bet ($1) returned to geldwolfje
geldwolfje collected $2 from pot
geldwolfje: doesn't show hand 
*** SUMMARY ***
Total pot $2 | Rake $0 
Seat 1: geldwolfje (big blind) collected ($2)
Seat 2: coinflip_si folded before Flop (didn't bet)
Seat 3: seouljam folded before Flop (didn't bet)
Seat 4: nailz83 folded before Flop (didn't bet)
Seat 5: InsomniaRU folded before Flop (didn't bet)
Seat 6: matiko09 folded before Flop (didn't bet)
Seat 7: DUkalisUA folded before Flop (didn't bet)
Seat 8: Fish4trips (button) folded before Flop (didn't bet)
Seat 9: WDW3 (small blind) folded before Flop





PokerStars Hand #150799582898:  Hold'em No Limit ($0.50/$1.00 USD) - 2016/03/23 13:38:26 CET [2016/03/23 8:38:26 ET]
Table 'Kippes' 9-max Seat #8 is the button
Seat 1: Pvsx. ($100 in chips) 
Seat 2: RICKA16 ($127.63 in chips) 
Seat 3: CAJUN890 ($117.31 in chips) 
Seat 4: matiko09 ($115.22 in chips) 
Seat 5: Jimy Tiltman ($116.86 in chips) 
Seat 6: WDW3 ($103.54 in chips) 
Seat 7: lumen21 ($100 in chips) 
Seat 8: Zeeshka ($117.80 in chips) 
Seat 9: wang19790906 ($82.67 in chips) 
wang19790906: posts small blind $0.50
Pvsx.: posts big blind $1
*** HOLE CARDS ***
Dealt to matiko09 [9h Qc]
RICKA16: folds 
CAJUN890: folds 
matiko09: folds 
Jimy Tiltman: folds 
WDW3: raises $1.80 to $2.80
lumen21: folds 
Zeeshka: folds 
wang19790906: folds 
Pvsx.: folds 
Uncalled bet ($1.80) returned to WDW3
WDW3 collected $2.50 from pot
WDW3: doesn't show hand 
*** SUMMARY ***
Total pot $2.50 | Rake $0 
Seat 1: Pvsx. (big blind) folded before Flop
Seat 2: RICKA16 folded before Flop (didn't bet)
Seat 3: CAJUN890 folded before Flop (didn't bet)
Seat 4: matiko09 folded before Flop (didn't bet)
Seat 5: Jimy Tiltman folded before Flop (didn't bet)
Seat 6: WDW3 collected ($2.50)
Seat 7: lumen21 folded before Flop (didn't bet)
Seat 8: Zeeshka (button) folded before Flop (didn't bet)
Seat 9: wang19790906 (small blind) folded before Flop





PokerStars Hand #150799583709:  Hold'em No Limit (€0.25/€0.50 EUR) - 2016/03/23 13:38:27 CET [2016/03/23 8:38:27 ET]
Table 'Palma II' 9-max Seat #8 is the button
Seat 1: Ahangama (€50 in chips) 
Seat 2: matiko09 (€50.75 in chips) 
Seat 3: ardo888 (€52.54 in chips) 
Seat 4: dndngod (€53.49 in chips) 
Seat 5: SVFB13 (€50 in chips) 
Seat 6: Red_Warning (€50 in chips) 
Seat 7: Wouter Des (€53.73 in chips) 
Seat 8: CvMCvMCvM (€71.02 in chips) 
Seat 9: ZonTTT (€50 in chips) 
ZonTTT: posts small blind €0.25
Ahangama: posts big blind €0.50
*** HOLE CARDS ***
Dealt to matiko09 [8h Qc]
matiko09: folds 
ardo888: folds 
dndngod: folds 
SVFB13: folds 
Red_Warning: folds 
Wouter Des: folds 
CvMCvMCvM: folds 
ZonTTT: folds 
Uncalled bet (€0.25) returned to Ahangama
Ahangama collected €0.50 from pot
Ahangama: doesn't show hand 
*** SUMMARY ***
Total pot €0.50 | Rake €0 
Seat 1: Ahangama (big blind) collected (€0.50)
Seat 2: matiko09 folded before Flop (didn't bet)
Seat 3: ardo888 folded before Flop (didn't bet)
Seat 4: dndngod folded before Flop (didn't bet)
Seat 5: SVFB13 folded before Flop (didn't bet)
Seat 6: Red_Warning folded before Flop (didn't bet)
Seat 7: Wouter Des folded before Flop (didn't bet)
Seat 8: CvMCvMCvM (button) folded before Flop (didn't bet)
Seat 9: ZonTTT (small blind) folded before Flop





PokerStars Hand #150799589873:  Hold'em No Limit ($0.50/$1.00 USD) - 2016/03/23 13:38:38 CET [2016/03/23 8:38:38 ET]
Table 'Smiley' 9-max Seat #4 is the button
Seat 1: WDW3 ($100 in chips) 
Seat 2: Jimy Tiltman ($103.98 in chips) 
Seat 3: matiko09 ($108.16 in chips) 
Seat 4: Zeeshka ($100 in chips) 
Seat 5: DUkalisUA ($100.50 in chips) 
Seat 6: blackmont111 ($57.56 in chips) 
Seat 8: RICKA16 ($112.50 in chips) 
Seat 9: morosun ($162.86 in chips) 
DUkalisUA: posts small blind $0.50
blackmont111: posts big blind $1
*** HOLE CARDS ***
Dealt to matiko09 [Ah Ad]
RICKA16: folds 
morosun: folds 
WDW3: folds 
Jimy Tiltman: folds 
matiko09: raises $1.50 to $2.50
Zeeshka: calls $2.50
DUkalisUA: folds 
blackmont111: calls $1.50
*** FLOP *** [5h 4h 3d]
blackmont111: checks 
matiko09: bets $4.97
Zeeshka: calls $4.97
blackmont111: folds 
*** TURN *** [5h 4h 3d] [Qs]
matiko09: checks 
Zeeshka: bets $12.84
matiko09: calls $12.84
*** RIVER *** [5h 4h 3d Qs] [Jd]
matiko09: checks 
Zeeshka: bets $27.91
matiko09: calls $27.91
*** SHOW DOWN ***
Zeeshka: shows [5s 5d] (three of a kind, Fives)
matiko09: mucks hand 
Zeeshka collected $96.64 from pot
*** SUMMARY ***
Total pot $99.44 | Rake $2.80 
Board [5h 4h 3d Qs Jd]
Seat 1: WDW3 folded before Flop (didn't bet)
Seat 2: Jimy Tiltman folded before Flop (didn't bet)
Seat 3: matiko09 mucked [Ah Ad]
Seat 4: Zeeshka (button) showed [5s 5d] and won ($96.64) with three of a kind, Fives
Seat 5: DUkalisUA (small blind) folded before Flop
Seat 6: blackmont111 (big blind) folded on the Flop
Seat 8: RICKA16 folded before Flop (didn't bet)
Seat 9: morosun folded before Flop (didn't bet)





PokerStars Hand #150799590706:  Hold'em No Limit ($1/$2 USD) - 2016/03/23 13:38:40 CET [2016/03/23 8:38:40 ET]
Table 'Kiess' 9-max Seat #4 is the button
Seat 2: DUkalisUA ($506.76 in chips) 
Seat 3: The_red_area ($379.82 in chips) 
Seat 4: Moszes360 ($200 in chips) 
Seat 5: chippo boy ($298.26 in chips) 
Seat 6: matiko09 ($260.64 in chips) 
Seat 7: InsomniaRU ($280.17 in chips) 
Seat 8: WDW3 ($381.42 in chips) 
Seat 9: Fish4trips ($217.55 in chips) 
chippo boy: posts small blind $1
matiko09: posts big blind $2
Cirilico: sits out 
*** HOLE CARDS ***
Dealt to matiko09 [4d Kd]
InsomniaRU: raises $3 to $5
WDW3: folds 
Fish4trips: folds 
DUkalisUA: folds 
The_red_area: folds 
Moszes360: folds 
chippo boy: folds 
matiko09: folds 
Uncalled bet ($3) returned to InsomniaRU
InsomniaRU collected $5 from pot
InsomniaRU: doesn't show hand 
*** SUMMARY ***
Total pot $5 | Rake $0 
Seat 2: DUkalisUA folded before Flop (didn't bet)
Seat 3: The_red_area folded before Flop (didn't bet)
Seat 4: Moszes360 (button) folded before Flop (didn't bet)
Seat 5: chippo boy (small blind) folded before Flop
Seat 6: matiko09 (big blind) folded before Flop
Seat 7: InsomniaRU collected ($5)
Seat 8: WDW3 folded before Flop (didn't bet)
Seat 9: Fish4trips folded before Flop (didn't bet)





PokerStars Hand #150799593476:  Hold'em No Limit ($1/$2 USD) - 2016/03/23 13:38:45 CET [2016/03/23 8:38:45 ET]
Table 'Kypria II' 9-max Seat #9 is the button
Seat 1: geldwolfje ($235.55 in chips) 
Seat 2: coinflip_si ($202.95 in chips) 
Seat 3: seouljam ($208.73 in chips) 
Seat 4: nailz83 ($125.92 in chips) 
Seat 5: InsomniaRU ($203 in chips) 
Seat 6: matiko09 ($236.64 in chips) 
Seat 7: DUkalisUA ($200 in chips) 
Seat 8: Fish4trips ($293.59 in chips) 
Seat 9: WDW3 ($205.42 in chips) 
geldwolfje: posts small blind $1
coinflip_si: posts big blind $2
*** HOLE CARDS ***
Dealt to matiko09 [7h Qs]
seouljam: folds 
nailz83: folds 
InsomniaRU: folds 
matiko09: folds 
DUkalisUA: folds 
Fish4trips: folds 
WDW3: folds 
geldwolfje: raises $2 to $4
coinflip_si: folds 
Uncalled bet ($2) returned to geldwolfje
geldwolfje collected $4 from pot
geldwolfje: doesn't show hand 
*** SUMMARY ***
Total pot $4 | Rake $0 
Seat 1: geldwolfje (small blind) collected ($4)
Seat 2: coinflip_si (big blind) folded before Flop
Seat 3: seouljam folded before Flop (didn't bet)
Seat 4: nailz83 folded before Flop (didn't bet)
Seat 5: InsomniaRU folded before Flop (didn't bet)
Seat 6: matiko09 folded before Flop (didn't bet)
Seat 7: DUkalisUA folded before Flop (didn't bet)
Seat 8: Fish4trips folded before Flop (didn't bet)
Seat 9: WDW3 (button) folded before Flop (didn't bet)





PokerStars Hand #150799598029:  Hold'em No Limit ($0.25/$0.50 USD) - 2016/03/23 13:38:53 CET [2016/03/23 8:38:53 ET]
Table 'Pyrrhus' 9-max Seat #8 is the button
Seat 1: lumen21 ($50.75 in chips) 
Seat 2: fandorin2005 ($50.75 in chips) 
Seat 3: IvanUrgant ($78.71 in chips) 
Seat 4: GriffinBerg ($42.43 in chips) 
Seat 5: Moszes360 ($50 in chips) 
Seat 7: matiko09 ($102.90 in chips) 
Seat 8: dndngod ($65.97 in chips) 
Seat 9: CvMCvMCvM ($111.41 in chips) 
CvMCvMCvM: posts small blind $0.25
lumen21: posts big blind $0.50
*** HOLE CARDS ***
Dealt to matiko09 [Qd Qh]
fandorin2005: folds 
IvanUrgant: folds 
GriffinBerg: calls $0.50
Moszes360: folds 
matiko09: raises $2 to $2.50
dndngod: folds 
CvMCvMCvM: folds 
lumen21: folds 
GriffinBerg: calls $2
*** FLOP *** [7c 8h Ac]
GriffinBerg: checks 
matiko09: checks 
*** TURN *** [7c 8h Ac] [Qc]
GriffinBerg: checks 
matiko09: bets $4
GriffinBerg: folds 
Uncalled bet ($4) returned to matiko09
matiko09 collected $5.49 from pot
matiko09: doesn't show hand 
*** SUMMARY ***
Total pot $5.75 | Rake $0.26 
Board [7c 8h Ac Qc]
Seat 1: lumen21 (big blind) folded before Flop
Seat 2: fandorin2005 folded before Flop (didn't bet)
Seat 3: IvanUrgant folded before Flop (didn't bet)
Seat 4: GriffinBerg folded on the Turn
Seat 5: Moszes360 folded before Flop (didn't bet)
Seat 7: matiko09 collected ($5.49)
Seat 8: dndngod (button) folded before Flop (didn't bet)
Seat 9: CvMCvMCvM (small blind) folded before Flop





PokerStars Hand #150799598229:  Hold'em No Limit (€0.25/€0.50 EUR) - 2016/03/23 13:38:54 CET [2016/03/23 8:38:54 ET]
Table 'Hesperia II' 9-max Seat #1 is the button
Seat 1: CAJUN890 (€49.50 in chips) 
Seat 2: dndngod (€51.69 in chips) 
Seat 3: IvanUrgant (€54.99 in chips) 
Seat 4: Zelenis (€20.46 in chips) 
Seat 5: Avrora-sp (€50 in chips) 
Seat 6: CvMCvMCvM (€50 in chips) 
Seat 7: matiko09 (€60.98 in chips) 
Seat 8: Ahangama (€50 in chips) 
Seat 9: Red_Warning (€50 in chips) 
dndngod: posts small blind €0.25
IvanUrgant: posts big blind €0.50
*** HOLE CARDS ***
Dealt to matiko09 [5s 8s]
Zelenis: calls €0.50
Avrora-sp: folds 
CvMCvMCvM: folds 
matiko09: folds 
Ahangama: folds 
Red_Warning: folds 
CAJUN890: folds 
dndngod: folds 
IvanUrgant: checks 
*** FLOP *** [2d Ts 6s]
IvanUrgant: checks 
Zelenis: checks 
*** TURN *** [2d Ts 6s] [As]
IvanUrgant: checks 
Zelenis: bets €0.50
IvanUrgant: folds 
Uncalled bet (€0.50) returned to Zelenis
Zelenis collected €1.19 from pot
Zelenis: doesn't show hand 
*** SUMMARY ***
Total pot €1.25 | Rake €0.06 
Board [2d Ts 6s As]
Seat 1: CAJUN890 (button) folded before Flop (didn't bet)
Seat 2: dndngod (small blind) folded before Flop
Seat 3: IvanUrgant (big blind) folded on the Turn
Seat 4: Zelenis collected (€1.19)
Seat 5: Avrora-sp folded before Flop (didn't bet)
Seat 6: CvMCvMCvM folded before Flop (didn't bet)
Seat 7: matiko09 folded before Flop (didn't bet)
Seat 8: Ahangama folded before Flop (didn't bet)
Seat 9: Red_Warning folded before Flop (didn't bet)





PokerStars Hand #150799599959:  Hold'em No Limit ($0.50/$1.00 USD) - 2016/03/23 13:38:57 CET [2016/03/23 8:38:57 ET]
Table 'Kippes' 9-max Seat #9 is the button
Seat 1: Pvsx. ($100 in chips) 
Seat 2: RICKA16 ($127.63 in chips) 
Seat 3: CAJUN890 ($117.31 in chips) 
Seat 4: matiko09 ($115.22 in chips) 
Seat 5: Jimy Tiltman ($116.86 in chips) 
Seat 6: WDW3 ($105.04 in chips) 
Seat 7: lumen21 ($100 in chips) 
Seat 8: Zeeshka ($117.80 in chips) 
Seat 9: wang19790906 ($82.17 in chips) 
Pvsx.: posts small blind $0.50
RICKA16: posts big blind $1
*** HOLE CARDS ***
Dealt to matiko09 [8s Ts]
CAJUN890: folds 
matiko09: folds 
Jimy Tiltman: folds 
WDW3: folds 
lumen21: folds 
Zeeshka: folds 
wang19790906: folds 
Pvsx.: folds 
Uncalled bet ($0.50) returned to RICKA16
RICKA16 collected $1 from pot
RICKA16: doesn't show hand 
*** SUMMARY ***
Total pot $1 | Rake $0 
Seat 1: Pvsx. (small blind) folded before Flop
Seat 2: RICKA16 (big blind) collected ($1)
Seat 3: CAJUN890 folded before Flop (didn't bet)
Seat 4: matiko09 folded before Flop (didn't bet)
Seat 5: Jimy Tiltman folded before Flop (didn't bet)
Seat 6: WDW3 folded before Flop (didn't bet)
Seat 7: lumen21 folded before Flop (didn't bet)
Seat 8: Zeeshka folded before Flop (didn't bet)
Seat 9: wang19790906 (button) folded before Flop (didn't bet)





PokerStars Hand #150799599957:  Hold'em No Limit ($0.50/$1.00 USD) - 2016/03/23 13:38:57 CET [2016/03/23 8:38:57 ET]
Table 'Oljato' 9-max Seat #5 is the button
Seat 1: myatiy 96 ($104 in chips) 
Seat 2: roman134679 ($40.08 in chips) 
Seat 3: DUkalisUA ($100 in chips) 
Seat 4: Pvsx. ($146.70 in chips) 
Seat 5: ryo728 ($89.73 in chips) 
Seat 6: WDW3 ($117.61 in chips) 
Seat 7: matiko09 ($160.09 in chips) 
Seat 8: Zeeshka ($353.14 in chips) 
Seat 9: Jimy Tiltman ($111.56 in chips) 
WDW3: posts small blind $0.50
matiko09: posts big blind $1
*** HOLE CARDS ***
Dealt to matiko09 [7s 2h]
Zeeshka: folds 
Jimy Tiltman: folds 
myatiy 96: folds 
roman134679: folds 
DUkalisUA: folds 
Pvsx.: raises $1.50 to $2.50
ryo728: calls $2.50
WDW3: folds 
matiko09: folds 
*** FLOP *** [Th 8s 4d]
Pvsx.: bets $3.10
ryo728: calls $3.10
*** TURN *** [Th 8s 4d] [Qd]
Pvsx.: checks 
ryo728: checks 
*** RIVER *** [Th 8s 4d Qd] [4h]
Pvsx.: checks 
ryo728: bets $6.06
Pvsx.: folds 
Uncalled bet ($6.06) returned to ryo728
ryo728 collected $12.13 from pot
ryo728: doesn't show hand 
*** SUMMARY ***
Total pot $12.70 | Rake $0.57 
Board [Th 8s 4d Qd 4h]
Seat 1: myatiy 96 folded before Flop (didn't bet)
Seat 2: roman134679 folded before Flop (didn't bet)
Seat 3: DUkalisUA folded before Flop (didn't bet)
Seat 4: Pvsx. folded on the River
Seat 5: ryo728 (button) collected ($12.13)
Seat 6: WDW3 (small blind) folded before Flop
Seat 7: matiko09 (big blind) folded before Flop
Seat 8: Zeeshka folded before Flop (didn't bet)
Seat 9: Jimy Tiltman folded before Flop (didn't bet)





PokerStars Hand #150799601536:  Hold'em No Limit ($0.50/$1.00 USD) - 2016/03/23 13:39:00 CET [2016/03/23 8:39:00 ET]
Table 'Atlantis' 9-max Seat #8 is the button
Seat 1: xHourglass ($173.28 in chips) 
Seat 2: tffff2006 ($30.42 in chips) 
Seat 3: CAJUN890 ($120.73 in chips) 
Seat 4: matiko09 ($100 in chips) 
Seat 5: Pvsx. ($100 in chips) 
Seat 6: Jimy Tiltman ($111.74 in chips) 
Seat 7: Zeeshka ($137.18 in chips) 
Seat 8: DUkalisUA ($100 in chips) 
Seat 9: WDW3 ($111.47 in chips) 
WDW3: posts small blind $0.50
xHourglass: posts big blind $1
*** HOLE CARDS ***
Dealt to matiko09 [Ks 5s]
tffff2006: folds 
CAJUN890: raises $3 to $4
matiko09: folds 
Pvsx.: folds 
Jimy Tiltman: folds 
Zeeshka: folds 
DUkalisUA: folds 
WDW3: folds 
xHourglass: calls $3
*** FLOP *** [Th 9h 5h]
xHourglass: checks 
CAJUN890: bets $5
xHourglass: calls $5
*** TURN *** [Th 9h 5h] [5c]
xHourglass: checks 
CAJUN890: checks 
*** RIVER *** [Th 9h 5h 5c] [Kh]
xHourglass: checks 
CAJUN890: checks 
*** SHOW DOWN ***
xHourglass: shows [9d As] (two pair, Nines and Fives)
CAJUN890: shows [Ad Kc] (two pair, Kings and Fives)
CAJUN890 collected $17.67 from pot
*** SUMMARY ***
Total pot $18.50 | Rake $0.83 
Board [Th 9h 5h 5c Kh]
Seat 1: xHourglass (big blind) showed [9d As] and lost with two pair, Nines and Fives
Seat 2: tffff2006 folded before Flop (didn't bet)
Seat 3: CAJUN890 showed [Ad Kc] and won ($17.67) with two pair, Kings and Fives
Seat 4: matiko09 folded before Flop (didn't bet)
Seat 5: Pvsx. folded before Flop (didn't bet)
Seat 6: Jimy Tiltman folded before Flop (didn't bet)
Seat 7: Zeeshka folded before Flop (didn't bet)
Seat 8: DUkalisUA (button) folded before Flop (didn't bet)
Seat 9: WDW3 (small blind) folded before Flop





PokerStars Hand #150799601615:  Hold'em No Limit (€0.25/€0.50 EUR) - 2016/03/23 13:39:00 CET [2016/03/23 8:39:00 ET]
Table 'Palma II' 9-max Seat #9 is the button
Seat 1: Ahangama (€50.25 in chips) 
Seat 2: matiko09 (€50.75 in chips) 
Seat 3: ardo888 (€52.54 in chips) 
Seat 4: dndngod (€53.49 in chips) 
Seat 5: SVFB13 (€50 in chips) 
Seat 6: Red_Warning (€50 in chips) 
Seat 7: Wouter Des (€53.73 in chips) 
Seat 8: CvMCvMCvM (€71.02 in chips) 
Seat 9: ZonTTT (€50 in chips) 
Ahangama: posts small blind €0.25
matiko09: posts big blind €0.50
*** HOLE CARDS ***
Dealt to matiko09 [Qs 6d]
ardo888: folds 
dndngod: folds 
SVFB13: folds 
Red_Warning: folds 
Wouter Des: folds 
CvMCvMCvM: raises €0.57 to €1.07
ZonTTT: folds 
Ahangama: folds 
matiko09: folds 
Uncalled bet (€0.57) returned to CvMCvMCvM
CvMCvMCvM collected €1.25 from pot
CvMCvMCvM: doesn't show hand 
*** SUMMARY ***
Total pot €1.25 | Rake €0 
Seat 1: Ahangama (small blind) folded before Flop
Seat 2: matiko09 (big blind) folded before Flop
Seat 3: ardo888 folded before Flop (didn't bet)
Seat 4: dndngod folded before Flop (didn't bet)
Seat 5: SVFB13 folded before Flop (didn't bet)
Seat 6: Red_Warning folded before Flop (didn't bet)
Seat 7: Wouter Des folded before Flop (didn't bet)
Seat 8: CvMCvMCvM collected (€1.25)
Seat 9: ZonTTT (button) folded before Flop (didn't bet)





PokerStars Hand #150799602358:  Hold'em No Limit ($1/$2 USD) - 2016/03/23 13:39:01 CET [2016/03/23 8:39:01 ET]
Table 'Kiess' 9-max Seat #5 is the button
Seat 2: DUkalisUA ($506.76 in chips) 
Seat 3: The_red_area ($379.82 in chips) 
Seat 4: Moszes360 ($200 in chips) 
Seat 5: chippo boy ($297.26 in chips) 
Seat 6: matiko09 ($258.64 in chips) 
Seat 7: InsomniaRU ($283.17 in chips) 
Seat 8: WDW3 ($381.42 in chips) 
Seat 9: Fish4trips ($217.55 in chips) 
matiko09: posts small blind $1
InsomniaRU: posts big blind $2
Cirilico: sits out 
*** HOLE CARDS ***
Dealt to matiko09 [Ad Jh]
WDW3: folds 
Fish4trips: folds 
DUkalisUA: folds 
The_red_area: folds 
Moszes360: folds 
chippo boy: raises $4 to $6
matiko09: raises $14 to $20
InsomniaRU: folds 
chippo boy: calls $14
*** FLOP *** [Jd 7c 8h]
matiko09: bets $20
chippo boy: calls $20
*** TURN *** [Jd 7c 8h] [8c]
matiko09: bets $44
chippo boy: folds 
Uncalled bet ($44) returned to matiko09
matiko09 collected $79.20 from pot
matiko09: doesn't show hand 
*** SUMMARY ***
Total pot $82 | Rake $2.80 
Board [Jd 7c 8h 8c]
Seat 2: DUkalisUA folded before Flop (didn't bet)
Seat 3: The_red_area folded before Flop (didn't bet)
Seat 4: Moszes360 folded before Flop (didn't bet)
Seat 5: chippo boy (button) folded on the Turn
Seat 6: matiko09 (small blind) collected ($79.20)
Seat 7: InsomniaRU (big blind) folded before Flop
Seat 8: WDW3 folded before Flop (didn't bet)
Seat 9: Fish4trips folded before Flop (didn't bet)





PokerStars Hand #150799603364:  Hold'em No Limit ($1/$2 USD) - 2016/03/23 13:39:03 CET [2016/03/23 8:39:03 ET]
Table 'Kypria II' 9-max Seat #1 is the button
Seat 1: geldwolfje ($237.55 in chips) 
Seat 2: coinflip_si ($200.95 in chips) 
Seat 3: seouljam ($208.73 in chips) 
Seat 4: nailz83 ($125.92 in chips) 
Seat 5: InsomniaRU ($203 in chips) 
Seat 6: matiko09 ($236.64 in chips) 
Seat 7: DUkalisUA ($200 in chips) 
Seat 8: Fish4trips ($293.59 in chips) 
Seat 9: WDW3 ($205.42 in chips) 
coinflip_si: posts small blind $1
seouljam: posts big blind $2
*** HOLE CARDS ***
Dealt to matiko09 [6c Th]
nailz83: folds 
InsomniaRU: raises $3 to $5
matiko09: folds 
DUkalisUA: folds 
Fish4trips: folds 
WDW3: calls $5
geldwolfje: folds 
coinflip_si: folds 
seouljam: folds 
*** FLOP *** [9c 9h 7d]
InsomniaRU: bets $8.32
WDW3: folds 
Uncalled bet ($8.32) returned to InsomniaRU
InsomniaRU collected $12.42 from pot
InsomniaRU: doesn't show hand 
*** SUMMARY ***
Total pot $13 | Rake $0.58 
Board [9c 9h 7d]
Seat 1: geldwolfje (button) folded before Flop (didn't bet)
Seat 2: coinflip_si (small blind) folded before Flop
Seat 3: seouljam (big blind) folded before Flop
Seat 4: nailz83 folded before Flop (didn't bet)
Seat 5: InsomniaRU collected ($12.42)
Seat 6: matiko09 folded before Flop (didn't bet)
Seat 7: DUkalisUA folded before Flop (didn't bet)
Seat 8: Fish4trips folded before Flop (didn't bet)
Seat 9: WDW3 folded on the Flop





PokerStars Hand #150799605403:  Hold'em No Limit ($0.25/$0.50 USD) - 2016/03/23 13:39:07 CET [2016/03/23 8:39:07 ET]
Table 'Belnika' 9-max Seat #6 is the button
Seat 1: yellowfever0 ($20.73 in chips) 
Seat 2: NeverRegret7 ($59.56 in chips) 
Seat 3: ChiChioChi ($21.04 in chips) 
Seat 4: matiko09 ($73.10 in chips) 
Seat 6: Ahangama ($65.50 in chips) 
Seat 7: Zeeshka ($50 in chips) 
Seat 8: lumen21 ($69.64 in chips) 
Seat 9: dndngod ($82.59 in chips) 
Zeeshka: posts small blind $0.25
lumen21: posts big blind $0.50
IvanUrgant: sits out 
*** HOLE CARDS ***
Dealt to matiko09 [8d 7d]
dndngod: folds 
yellowfever0: calls $0.50
NeverRegret7: calls $0.50
ChiChioChi: folds 
matiko09: calls $0.50
Ahangama: folds 
Zeeshka: folds 
lumen21: checks 
*** FLOP *** [Qh 4c Jd]
lumen21: checks 
yellowfever0: checks 
NeverRegret7: bets $1.07
matiko09: folds 
lumen21: folds 
yellowfever0: calls $1.07
*** TURN *** [Qh 4c Jd] [3d]
yellowfever0: checks 
NeverRegret7: checks 
*** RIVER *** [Qh 4c Jd 3d] [8c]
yellowfever0: bets $2.09
NeverRegret7: folds 
Uncalled bet ($2.09) returned to yellowfever0
yellowfever0 collected $4.19 from pot
*** SUMMARY ***
Total pot $4.39 | Rake $0.20 
Board [Qh 4c Jd 3d 8c]
Seat 1: yellowfever0 collected ($4.19)
Seat 2: NeverRegret7 folded on the River
Seat 3: ChiChioChi folded before Flop (didn't bet)
Seat 4: matiko09 folded on the Flop
Seat 6: Ahangama (button) folded before Flop (didn't bet)
Seat 7: Zeeshka (small blind) folded before Flop
Seat 8: lumen21 (big blind) folded on the Flop
Seat 9: dndngod folded before Flop (didn't bet)





PokerStars Hand #150799613383:  Hold'em No Limit ($0.50/$1.00 USD) - 2016/03/23 13:39:22 CET [2016/03/23 8:39:22 ET]
Table 'Kippes' 9-max Seat #1 is the button
Seat 1: Pvsx. ($100 in chips) 
Seat 2: RICKA16 ($128.13 in chips) 
Seat 3: CAJUN890 ($117.31 in chips) 
Seat 4: matiko09 ($115.22 in chips) 
Seat 5: Jimy Tiltman ($116.86 in chips) 
Seat 6: WDW3 ($105.04 in chips) 
Seat 7: lumen21 ($100 in chips) 
Seat 8: Zeeshka ($117.80 in chips) 
Seat 9: wang19790906 ($82.17 in chips) 
RICKA16: posts small blind $0.50
CAJUN890: posts big blind $1
*** HOLE CARDS ***
Dealt to matiko09 [6s Jd]
matiko09: folds 
Jimy Tiltman: folds 
WDW3: folds 
lumen21: folds 
Zeeshka: folds 
wang19790906: folds 
Pvsx.: raises $1.50 to $2.50
RICKA16: folds 
CAJUN890: folds 
Uncalled bet ($1.50) returned to Pvsx.
Pvsx. collected $2.50 from pot
Pvsx.: doesn't show hand 
*** SUMMARY ***
Total pot $2.50 | Rake $0 
Seat 1: Pvsx. (button) collected ($2.50)
Seat 2: RICKA16 (small blind) folded before Flop
Seat 3: CAJUN890 (big blind) folded before Flop
Seat 4: matiko09 folded before Flop (didn't bet)
Seat 5: Jimy Tiltman folded before Flop (didn't bet)
Seat 6: WDW3 folded before Flop (didn't bet)
Seat 7: lumen21 folded before Flop (didn't bet)
Seat 8: Zeeshka folded before Flop (didn't bet)
Seat 9: wang19790906 folded before Flop (didn't bet)





PokerStars Hand #150799622983:  Hold'em No Limit ($1/$2 USD) - 2016/03/23 13:39:40 CET [2016/03/23 8:39:40 ET]
Table 'Kypria II' 9-max Seat #2 is the button
Seat 1: geldwolfje ($237.55 in chips) 
Seat 2: coinflip_si ($200 in chips) 
Seat 3: seouljam ($206.73 in chips) 
Seat 4: nailz83 ($125.92 in chips) 
Seat 5: InsomniaRU ($210.42 in chips) 
Seat 6: matiko09 ($236.64 in chips) 
Seat 7: DUkalisUA ($200 in chips) 
Seat 8: Fish4trips ($293.59 in chips) 
Seat 9: WDW3 ($200.42 in chips) 
seouljam: posts small blind $1
nailz83: posts big blind $2
*** HOLE CARDS ***
Dealt to matiko09 [Ts Jd]
InsomniaRU: folds 
matiko09: folds 
DUkalisUA: folds 
Fish4trips: folds 
WDW3: folds 
geldwolfje: folds 
coinflip_si: folds 
seouljam: folds 
Uncalled bet ($1) returned to nailz83
nailz83 collected $2 from pot
nailz83: doesn't show hand 
*** SUMMARY ***
Total pot $2 | Rake $0 
Seat 1: geldwolfje folded before Flop (didn't bet)
Seat 2: coinflip_si (button) folded before Flop (didn't bet)
Seat 3: seouljam (small blind) folded before Flop
Seat 4: nailz83 (big blind) collected ($2)
Seat 5: InsomniaRU folded before Flop (didn't bet)
Seat 6: matiko09 folded before Flop (didn't bet)
Seat 7: DUkalisUA folded before Flop (didn't bet)
Seat 8: Fish4trips folded before Flop (didn't bet)
Seat 9: WDW3 folded before Flop (didn't bet)





PokerStars Hand #150799626332:  Hold'em No Limit ($1/$2 USD) - 2016/03/23 13:39:46 CET [2016/03/23 8:39:46 ET]
Table 'Berbericia II' 9-max Seat #9 is the button
Seat 1: WDW3 ($200 in chips) 
Seat 2: Moszes360 ($221.52 in chips) 
Seat 3: Fish4trips ($200 in chips) 
Seat 4: bennetb77 ($101.16 in chips) 
Seat 8: matiko09 ($313.51 in chips) 
Seat 9: LVV-Bif ($304.90 in chips) 
WDW3: posts small blind $1
Moszes360: posts big blind $2
InsomniaRU: sits out 
*** HOLE CARDS ***
Dealt to matiko09 [9c Ah]
Fish4trips: folds 
bennetb77: folds 
matiko09: raises $3 to $5
LVV-Bif: folds 
WDW3: folds 
Moszes360: folds 
Uncalled bet ($3) returned to matiko09
matiko09 collected $5 from pot
matiko09: doesn't show hand 
erick222 joins the table at seat #6 
*** SUMMARY ***
Total pot $5 | Rake $0 
Seat 1: WDW3 (small blind) folded before Flop
Seat 2: Moszes360 (big blind) folded before Flop
Seat 3: Fish4trips folded before Flop (didn't bet)
Seat 4: bennetb77 folded before Flop (didn't bet)
Seat 8: matiko09 collected ($5)
Seat 9: LVV-Bif (button) folded before Flop (didn't bet)





PokerStars Hand #150799630242:  Hold'em No Limit (€0.25/€0.50 EUR) - 2016/03/23 13:39:53 CET [2016/03/23 8:39:53 ET]
Table 'Palma II' 9-max Seat #1 is the button
Seat 1: Ahangama (€50 in chips) 
Seat 2: matiko09 (€50.25 in chips) 
Seat 3: ardo888 (€52.54 in chips) 
Seat 4: dndngod (€53.49 in chips) 
Seat 5: SVFB13 (€50 in chips) 
Seat 6: Red_Warning (€50 in chips) 
Seat 7: Wouter Des (€53.73 in chips) 
Seat 8: CvMCvMCvM (€71.77 in chips) 
Seat 9: ZonTTT (€50 in chips) 
matiko09: posts small blind €0.25
ardo888: posts big blind €0.50
*** HOLE CARDS ***
Dealt to matiko09 [2d Qs]
dndngod: folds 
SVFB13: folds 
Red_Warning: folds 
Wouter Des: folds 
CvMCvMCvM: folds 
ZonTTT: folds 
Ahangama: raises €0.50 to €1
matiko09: folds 
ardo888: folds 
Uncalled bet (€0.50) returned to Ahangama
Ahangama collected €1.25 from pot
Ahangama: doesn't show hand 
*** SUMMARY ***
Total pot €1.25 | Rake €0 
Seat 1: Ahangama (button) collected (€1.25)
Seat 2: matiko09 (small blind) folded before Flop
Seat 3: ardo888 (big blind) folded before Flop
Seat 4: dndngod folded before Flop (didn't bet)
Seat 5: SVFB13 folded before Flop (didn't bet)
Seat 6: Red_Warning folded before Flop (didn't bet)
Seat 7: Wouter Des folded before Flop (didn't bet)
Seat 8: CvMCvMCvM folded before Flop (didn't bet)
Seat 9: ZonTTT folded before Flop (didn't bet)





PokerStars Hand #150799634212:  Hold'em No Limit (€0.25/€0.50 EUR) - 2016/03/23 13:40:00 CET [2016/03/23 8:40:00 ET]
Table 'Hesperia II' 9-max Seat #2 is the button
Seat 1: CAJUN890 (€49.50 in chips) 
Seat 2: dndngod (€51.44 in chips) 
Seat 3: IvanUrgant (€54.49 in chips) 
Seat 4: Zelenis (€21.15 in chips) 
Seat 5: Avrora-sp (€50 in chips) 
Seat 6: CvMCvMCvM (€50 in chips) 
Seat 7: matiko09 (€60.98 in chips) 
Seat 8: Ahangama (€50 in chips) 
Seat 9: Red_Warning (€50 in chips) 
IvanUrgant: posts small blind €0.25
Zelenis: posts big blind €0.50
*** HOLE CARDS ***
Dealt to matiko09 [7d Qs]
Avrora-sp: folds 
CvMCvMCvM: folds 
matiko09: folds 
Ahangama: folds 
Red_Warning: folds 
CAJUN890: folds 
dndngod: folds 
IvanUrgant: folds 
Uncalled bet (€0.25) returned to Zelenis
Zelenis collected €0.50 from pot
Zelenis: doesn't show hand 
*** SUMMARY ***
Total pot €0.50 | Rake €0 
Seat 1: CAJUN890 folded before Flop (didn't bet)
Seat 2: dndngod (button) folded before Flop (didn't bet)
Seat 3: IvanUrgant (small blind) folded before Flop
Seat 4: Zelenis (big blind) collected (€0.50)
Seat 5: Avrora-sp folded before Flop (didn't bet)
Seat 6: CvMCvMCvM folded before Flop (didn't bet)
Seat 7: matiko09 folded before Flop (didn't bet)
Seat 8: Ahangama folded before Flop (didn't bet)
Seat 9: Red_Warning folded before Flop (didn't bet)





PokerStars Hand #150799634345:  Hold'em No Limit ($0.50/$1.00 USD) - 2016/03/23 13:40:01 CET [2016/03/23 8:40:01 ET]
Table 'Kippes' 9-max Seat #2 is the button
Seat 1: Pvsx. ($101.50 in chips) 
Seat 2: RICKA16 ($127.63 in chips) 
Seat 3: CAJUN890 ($116.31 in chips) 
Seat 4: matiko09 ($115.22 in chips) 
Seat 5: Jimy Tiltman ($116.86 in chips) 
Seat 6: WDW3 ($105.04 in chips) 
Seat 7: lumen21 ($100 in chips) 
Seat 8: Zeeshka ($117.80 in chips) 
Seat 9: wang19790906 ($82.17 in chips) 
CAJUN890: posts small blind $0.50
matiko09: posts big blind $1
*** HOLE CARDS ***
Dealt to matiko09 [5d 3d]
Jimy Tiltman: raises $2 to $3
WDW3: folds 
lumen21: raises $6 to $9
Zeeshka: folds 
wang19790906: folds 
Pvsx.: folds 
RICKA16: folds 
CAJUN890: raises $22 to $31
matiko09: folds 
Jimy Tiltman: folds 
lumen21: folds 
Uncalled bet ($22) returned to CAJUN890
CAJUN890 collected $22 from pot
CAJUN890: doesn't show hand 
*** SUMMARY ***
Total pot $22 | Rake $0 
Seat 1: Pvsx. folded before Flop (didn't bet)
Seat 2: RICKA16 (button) folded before Flop (didn't bet)
Seat 3: CAJUN890 (small blind) collected ($22)
Seat 4: matiko09 (big blind) folded before Flop
Seat 5: Jimy Tiltman folded before Flop
Seat 6: WDW3 folded before Flop (didn't bet)
Seat 7: lumen21 folded before Flop
Seat 8: Zeeshka folded before Flop (didn't bet)
Seat 9: wang19790906 folded before Flop (didn't bet)





PokerStars Hand #150799635420:  Hold'em No Limit ($1/$2 USD) - 2016/03/23 13:40:03 CET [2016/03/23 8:40:03 ET]
Table 'Herba II' 9-max Seat #7 is the button
Seat 1: matiko09 ($235.48 in chips) 
Seat 2: Moszes360 ($213.20 in chips) 
Seat 3: Cirilico ($165.60 in chips) 
Seat 4: DUkalisUA ($286.78 in chips) 
Seat 6: WDW3 ($200 in chips) 
Seat 7: InsomniaRU ($249.43 in chips) 
Seat 8: The_red_area ($439.33 in chips) 
Seat 9: mrhighryza ($43.86 in chips) 
The_red_area: posts small blind $1
mrhighryza: posts big blind $2
*** HOLE CARDS ***
Dealt to matiko09 [9h 2c]
matiko09: folds 
Moszes360: folds 
Cirilico: folds 
DUkalisUA: raises $4 to $6
WDW3: folds 
InsomniaRU: folds 
The_red_area: folds 
mrhighryza: folds 
Uncalled bet ($4) returned to DUkalisUA
DUkalisUA collected $5 from pot
DUkalisUA: doesn't show hand 
*** SUMMARY ***
Total pot $5 | Rake $0 
Seat 1: matiko09 folded before Flop (didn't bet)
Seat 2: Moszes360 folded before Flop (didn't bet)
Seat 3: Cirilico folded before Flop (didn't bet)
Seat 4: DUkalisUA collected ($5)
Seat 6: WDW3 folded before Flop (didn't bet)
Seat 7: InsomniaRU (button) folded before Flop (didn't bet)
Seat 8: The_red_area (small blind) folded before Flop
Seat 9: mrhighryza (big blind) folded before Flop





PokerStars Hand #150799636041:  Hold'em No Limit ($1/$2 USD) - 2016/03/23 13:40:04 CET [2016/03/23 8:40:04 ET]
Table 'Berbericia II' 9-max Seat #1 is the button
Seat 1: WDW3 ($200 in chips) 
Seat 2: Moszes360 ($219.52 in chips) 
Seat 3: Fish4trips ($200 in chips) 
Seat 4: bennetb77 ($101.16 in chips) 
Seat 8: matiko09 ($316.51 in chips) 
Seat 9: LVV-Bif ($304.90 in chips) 
Moszes360: posts small blind $1
Fish4trips: posts big blind $2
InsomniaRU: sits out 
erick222: sits out 
*** HOLE CARDS ***
Dealt to matiko09 [8s Qc]
bennetb77: folds 
matiko09: folds 
LVV-Bif: folds 
WDW3: folds 
Moszes360: raises $4 to $6
bennetb77 said, "what did you have"
Fish4trips: folds 
Uncalled bet ($4) returned to Moszes360
Moszes360 collected $4 from pot
Moszes360: doesn't show hand 
InsomniaRU leaves the table
*** SUMMARY ***
Total pot $4 | Rake $0 
Seat 1: WDW3 (button) folded before Flop (didn't bet)
Seat 2: Moszes360 (small blind) collected ($4)
Seat 3: Fish4trips (big blind) folded before Flop
Seat 4: bennetb77 folded before Flop (didn't bet)
Seat 8: matiko09 folded before Flop (didn't bet)
Seat 9: LVV-Bif folded before Flop (didn't bet)





PokerStars Hand #150799636381:  Hold'em No Limit ($1/$2 USD) - 2016/03/23 13:40:05 CET [2016/03/23 8:40:05 ET]
Table 'Kypria II' 9-max Seat #3 is the button
Seat 1: geldwolfje ($237.55 in chips) 
Seat 2: coinflip_si ($200 in chips) 
Seat 3: seouljam ($205.73 in chips) 
Seat 4: nailz83 ($126.92 in chips) 
Seat 5: InsomniaRU ($210.42 in chips) 
Seat 6: matiko09 ($236.64 in chips) 
Seat 7: DUkalisUA ($200 in chips) 
Seat 8: Fish4trips ($293.59 in chips) 
Seat 9: WDW3 ($200.42 in chips) 
nailz83: posts small blind $1
InsomniaRU: posts big blind $2
*** HOLE CARDS ***
Dealt to matiko09 [5s 2d]
nailz83 said, "lol"
matiko09: folds 
DUkalisUA: folds 
Fish4trips: folds 
WDW3: folds 
geldwolfje: raises $2 to $4
coinflip_si: folds 
seouljam: folds 
nailz83: folds 
InsomniaRU: calls $2
*** FLOP *** [8h 9d Th]
InsomniaRU: checks 
geldwolfje: bets $6
InsomniaRU: folds 
Uncalled bet ($6) returned to geldwolfje
geldwolfje collected $8.60 from pot
geldwolfje: doesn't show hand 
*** SUMMARY ***
Total pot $9 | Rake $0.40 
Board [8h 9d Th]
Seat 1: geldwolfje collected ($8.60)
Seat 2: coinflip_si folded before Flop (didn't bet)
Seat 3: seouljam (button) folded before Flop (didn't bet)
Seat 4: nailz83 (small blind) folded before Flop
Seat 5: InsomniaRU (big blind) folded on the Flop
Seat 6: matiko09 folded before Flop (didn't bet)
Seat 7: DUkalisUA folded before Flop (didn't bet)
Seat 8: Fish4trips folded before Flop (didn't bet)
Seat 9: WDW3 folded before Flop (didn't bet)





PokerStars Hand #150799639963:  Hold'em No Limit ($0.50/$1.00 USD) - 2016/03/23 13:40:11 CET [2016/03/23 8:40:11 ET]
Table 'Atlantis' 9-max Seat #9 is the button
Seat 1: xHourglass ($164.28 in chips) 
Seat 2: tffff2006 ($30.42 in chips) 
Seat 3: CAJUN890 ($129.40 in chips) 
Seat 4: matiko09 ($100 in chips) 
Seat 5: Pvsx. ($100 in chips) 
Seat 6: Jimy Tiltman ($111.74 in chips) 
Seat 7: Zeeshka ($137.18 in chips) 
Seat 8: DUkalisUA ($100 in chips) 
Seat 9: WDW3 ($110.97 in chips) 
xHourglass: posts small blind $0.50
tffff2006: posts big blind $1
*** HOLE CARDS ***
Dealt to matiko09 [Js Ts]
CAJUN890: calls $1
matiko09: raises $3 to $4
Pvsx.: folds 
Jimy Tiltman: folds 
Zeeshka: folds 
DUkalisUA: folds 
WDW3: folds 
xHourglass: calls $3.50
tffff2006: folds 
CAJUN890: calls $3
*** FLOP *** [Ks Kd 9s]
xHourglass: checks 
CAJUN890: bets $3
matiko09: raises $7 to $10
xHourglass: folds 
CAJUN890: folds 
Uncalled bet ($7) returned to matiko09
matiko09 collected $18.14 from pot
matiko09: doesn't show hand 
*** SUMMARY ***
Total pot $19 | Rake $0.86 
Board [Ks Kd 9s]
Seat 1: xHourglass (small blind) folded on the Flop
Seat 2: tffff2006 (big blind) folded before Flop
Seat 3: CAJUN890 folded on the Flop
Seat 4: matiko09 collected ($18.14)
Seat 5: Pvsx. folded before Flop (didn't bet)
Seat 6: Jimy Tiltman folded before Flop (didn't bet)
Seat 7: Zeeshka folded before Flop (didn't bet)
Seat 8: DUkalisUA folded before Flop (didn't bet)
Seat 9: WDW3 (button) folded before Flop (didn't bet)





PokerStars Hand #150799640203:  Hold'em No Limit ($0.50/$1.00 USD) - 2016/03/23 13:40:12 CET [2016/03/23 8:40:12 ET]
Table 'Oljato' 9-max Seat #6 is the button
Seat 1: myatiy 96 ($104 in chips) 
Seat 2: roman134679 ($40.08 in chips) 
Seat 3: DUkalisUA ($100 in chips) 
Seat 4: Pvsx. ($141.10 in chips) 
Seat 5: ryo728 ($96.26 in chips) 
Seat 6: WDW3 ($117.11 in chips) 
Seat 7: matiko09 ($159.09 in chips) 
Seat 8: Zeeshka ($353.14 in chips) 
Seat 9: Jimy Tiltman ($111.56 in chips) 
matiko09: posts small blind $0.50
Zeeshka: posts big blind $1
*** HOLE CARDS ***
Dealt to matiko09 [5c 8d]
Jimy Tiltman: folds 
myatiy 96: folds 
roman134679: folds 
DUkalisUA: folds 
Pvsx.: folds 
ryo728: calls $1
WDW3: folds 
matiko09: folds 
Zeeshka: checks 
*** FLOP *** [Kh 9s 5s]
Zeeshka: checks 
ryo728: checks 
*** TURN *** [Kh 9s 5s] [Ts]
Zeeshka: checks 
ryo728: checks 
*** RIVER *** [Kh 9s 5s Ts] [Qh]
Zeeshka: checks 
ryo728: checks 
*** SHOW DOWN ***
Zeeshka: shows [4c As] (high card Ace)
ryo728: shows [3h Ac] (high card Ace)
Zeeshka collected $1.20 from pot
ryo728 collected $1.19 from pot
*** SUMMARY ***
Total pot $2.50 | Rake $0.11 
Board [Kh 9s 5s Ts Qh]
Seat 1: myatiy 96 folded before Flop (didn't bet)
Seat 2: roman134679 folded before Flop (didn't bet)
Seat 3: DUkalisUA folded before Flop (didn't bet)
Seat 4: Pvsx. folded before Flop (didn't bet)
Seat 5: ryo728 showed [3h Ac] and won ($1.19) with high card Ace
Seat 6: WDW3 (button) folded before Flop (didn't bet)
Seat 7: matiko09 (small blind) folded before Flop
Seat 8: Zeeshka (big blind) showed [4c As] and won ($1.20) with high card Ace
Seat 9: Jimy Tiltman folded before Flop (didn't bet)





PokerStars Hand #150799642271:  Hold'em No Limit ($0.25/$0.50 USD) - 2016/03/23 13:40:16 CET [2016/03/23 8:40:16 ET]
Table 'Pyrrhus' 9-max Seat #9 is the button
Seat 1: lumen21 ($50.25 in chips) 
Seat 3: IvanUrgant ($78.71 in chips) 
Seat 4: GriffinBerg ($39.93 in chips) 
Seat 5: Moszes360 ($50 in chips) 
Seat 7: matiko09 ($105.89 in chips) 
Seat 8: dndngod ($65.97 in chips) 
Seat 9: CvMCvMCvM ($111.16 in chips) 
lumen21: posts small blind $0.25
fandorin2005: is sitting out 
fandorin2005 leaves the table
IvanUrgant: posts big blind $0.50
*** HOLE CARDS ***
Dealt to matiko09 [4c 5s]
GriffinBerg: folds 
Moszes360: folds 
matiko09: folds 
dndngod: raises $0.75 to $1.25
CvMCvMCvM: folds 
lumen21: folds 
IvanUrgant: calls $0.75
*** FLOP *** [4h 2c Kc]
IvanUrgant: checks 
dndngod: bets $1.75
IvanUrgant: calls $1.75
*** TURN *** [4h 2c Kc] [Ad]
IvanUrgant: checks 
Red_Warning joins the table at seat #2 
dndngod: bets $4
IvanUrgant: calls $4
*** RIVER *** [4h 2c Kc Ad] [3h]
Red_Warning leaves the table
Zeeshka joins the table at seat #2 
IvanUrgant: bets $7.75
dndngod: folds 
Uncalled bet ($7.75) returned to IvanUrgant
IvanUrgant collected $13.61 from pot
IvanUrgant: doesn't show hand 
*** SUMMARY ***
Total pot $14.25 | Rake $0.64 
Board [4h 2c Kc Ad 3h]
Seat 1: lumen21 (small blind) folded before Flop
Seat 3: IvanUrgant (big blind) collected ($13.61)
Seat 4: GriffinBerg folded before Flop (didn't bet)
Seat 5: Moszes360 folded before Flop (didn't bet)
Seat 7: matiko09 folded before Flop (didn't bet)
Seat 8: dndngod folded on the River
Seat 9: CvMCvMCvM (button) folded before Flop (didn't bet)





PokerStars Hand #150799643342:  Hold'em No Limit ($0.25/$0.50 USD) - 2016/03/23 13:40:18 CET [2016/03/23 8:40:18 ET]
Table 'Belnika' 9-max Seat #7 is the button
Seat 1: yellowfever0 ($23.35 in chips) 
Seat 2: NeverRegret7 ($57.99 in chips) 
Seat 3: ChiChioChi ($21.04 in chips) 
Seat 4: matiko09 ($72.60 in chips) 
Seat 6: Ahangama ($65.50 in chips) 
Seat 7: Zeeshka ($50 in chips) 
Seat 8: lumen21 ($69.14 in chips) 
Seat 9: dndngod ($82.59 in chips) 
lumen21: posts small blind $0.25
dndngod: posts big blind $0.50
IvanUrgant: sits out 
*** HOLE CARDS ***
Dealt to matiko09 [9c Js]
yellowfever0: raises $1 to $1.50
NeverRegret7: calls $1.50
ChiChioChi: folds 
matiko09: folds 
Ahangama: folds 
Zeeshka: folds 
lumen21: folds 
dndngod: folds 
*** FLOP *** [Tc Kc 9d]
yellowfever0: checks 
NeverRegret7: checks 
*** TURN *** [Tc Kc 9d] [Ts]
yellowfever0: checks 
NeverRegret7: checks 
*** RIVER *** [Tc Kc 9d Ts] [3s]
yellowfever0: bets $1.79
NeverRegret7: folds 
Uncalled bet ($1.79) returned to yellowfever0
yellowfever0 collected $3.58 from pot
yellowfever0: doesn't show hand 
*** SUMMARY ***
Total pot $3.75 | Rake $0.17 
Board [Tc Kc 9d Ts 3s]
Seat 1: yellowfever0 collected ($3.58)
Seat 2: NeverRegret7 folded on the River
Seat 3: ChiChioChi folded before Flop (didn't bet)
Seat 4: matiko09 folded before Flop (didn't bet)
Seat 6: Ahangama folded before Flop (didn't bet)
Seat 7: Zeeshka (button) folded before Flop (didn't bet)
Seat 8: lumen21 (small blind) folded before Flop
Seat 9: dndngod (big blind) folded before Flop





PokerStars Hand #150799646548:  Hold'em No Limit ($1/$2 USD) - 2016/03/23 13:40:24 CET [2016/03/23 8:40:24 ET]
Table 'Berbericia II' 9-max Seat #2 is the button
Seat 1: WDW3 ($200 in chips) 
Seat 2: Moszes360 ($221.52 in chips) 
Seat 3: Fish4trips ($200 in chips) 
Seat 4: bennetb77 ($101.16 in chips) 
Seat 8: matiko09 ($316.51 in chips) 
Seat 9: LVV-Bif ($304.90 in chips) 
Fish4trips: posts small blind $1
bennetb77: posts big blind $2
erick222: sits out 
*** HOLE CARDS ***
Dealt to matiko09 [6s 8s]
LVV-Bif said, "A9"
matiko09: folds 
LVV-Bif: folds 
WDW3: raises $3.60 to $5.60
Moszes360: folds 
Fish4trips: folds 
darren1031 joins the table at seat #5 
bennetb77 said, "nh"
bennetb77: calls $3.60
*** FLOP *** [8c 2s 9s]
erick222 leaves the table
InsomniaRU joins the table at seat #6 
bennetb77: checks 
InsomniaRU leaves the table
WDW3: bets $9
Charity86 joins the table at seat #6 
bennetb77: folds 
Uncalled bet ($9) returned to WDW3
WDW3 collected $11.65 from pot
WDW3: doesn't show hand 
*** SUMMARY ***
Total pot $12.20 | Rake $0.55 
Board [8c 2s 9s]
Seat 1: WDW3 collected ($11.65)
Seat 2: Moszes360 (button) folded before Flop (didn't bet)
Seat 3: Fish4trips (small blind) folded before Flop
Seat 4: bennetb77 (big blind) folded on the Flop
Seat 8: matiko09 folded before Flop (didn't bet)
Seat 9: LVV-Bif folded before Flop (didn't bet)





PokerStars Hand #150799650690:  Hold'em No Limit ($1/$2 USD) - 2016/03/23 13:40:32 CET [2016/03/23 8:40:32 ET]
Table 'Herba II' 9-max Seat #8 is the button
Seat 1: matiko09 ($235.48 in chips) 
Seat 2: Moszes360 ($213.20 in chips) 
Seat 3: Cirilico ($165.60 in chips) 
Seat 4: DUkalisUA ($289.78 in chips) 
Seat 5: chippo boy ($200 in chips) 
Seat 6: WDW3 ($200 in chips) 
Seat 7: InsomniaRU ($249.43 in chips) 
Seat 8: The_red_area ($438.33 in chips) 
Seat 9: mrhighryza ($41.86 in chips) 
mrhighryza: posts small blind $1
matiko09: posts big blind $2
*** HOLE CARDS ***
Dealt to matiko09 [Ks 5c]
Moszes360: folds 
Cirilico: folds 
DUkalisUA: folds 
chippo boy: raises $4 to $6
WDW3: folds 
InsomniaRU: folds 
The_red_area: folds 
mrhighryza: folds 
matiko09: folds 
Uncalled bet ($4) returned to chippo boy
chippo boy collected $5 from pot
*** SUMMARY ***
Total pot $5 | Rake $0 
Seat 1: matiko09 (big blind) folded before Flop
Seat 2: Moszes360 folded before Flop (didn't bet)
Seat 3: Cirilico folded before Flop (didn't bet)
Seat 4: DUkalisUA folded before Flop (didn't bet)
Seat 5: chippo boy collected ($5)
Seat 6: WDW3 folded before Flop (didn't bet)
Seat 7: InsomniaRU folded before Flop (didn't bet)
Seat 8: The_red_area (button) folded before Flop (didn't bet)
Seat 9: mrhighryza (small blind) folded before Flop





PokerStars Hand #150799653246:  Hold'em No Limit ($0.50/$1.00 USD) - 2016/03/23 13:40:37 CET [2016/03/23 8:40:37 ET]
Table 'Smiley' 9-max Seat #5 is the button
Seat 1: WDW3 ($100 in chips) 
Seat 2: Jimy Tiltman ($103.98 in chips) 
Seat 3: matiko09 ($100 in chips) 
Seat 4: Zeeshka ($148.42 in chips) 
Seat 5: DUkalisUA ($100 in chips) 
Seat 6: blackmont111 ($55.06 in chips) 
Seat 8: RICKA16 ($112.50 in chips) 
Seat 9: morosun ($162.86 in chips) 
blackmont111: posts small blind $0.50
RICKA16: posts big blind $1
*** HOLE CARDS ***
Dealt to matiko09 [8d Ah]
morosun: folds 
WDW3: folds 
Jimy Tiltman: raises $2 to $3
matiko09: folds 
Zeeshka: folds 
DUkalisUA: folds 
drosan leaves the table
blackmont111: folds 
RICKA16: folds 
Uncalled bet ($2) returned to Jimy Tiltman
Jimy Tiltman collected $2.50 from pot
Jimy Tiltman: doesn't show hand 
*** SUMMARY ***
Total pot $2.50 | Rake $0 
Seat 1: WDW3 folded before Flop (didn't bet)
Seat 2: Jimy Tiltman collected ($2.50)
Seat 3: matiko09 folded before Flop (didn't bet)
Seat 4: Zeeshka folded before Flop (didn't bet)
Seat 5: DUkalisUA (button) folded before Flop (didn't bet)
Seat 6: blackmont111 (small blind) folded before Flop
Seat 8: RICKA16 (big blind) folded before Flop
Seat 9: morosun folded before Flop (didn't bet)





PokerStars Hand #150799653364:  Hold'em No Limit ($1/$2 USD) - 2016/03/23 13:40:37 CET [2016/03/23 8:40:37 ET]
Table 'Kiess' 9-max Seat #6 is the button
Seat 2: DUkalisUA ($506.76 in chips) 
Seat 3: The_red_area ($379.82 in chips) 
Seat 4: Moszes360 ($200 in chips) 
Seat 5: chippo boy ($257.26 in chips) 
Seat 6: matiko09 ($297.84 in chips) 
Seat 7: InsomniaRU ($281.17 in chips) 
Seat 8: WDW3 ($381.42 in chips) 
Seat 9: Fish4trips ($217.55 in chips) 
InsomniaRU: posts small blind $1
WDW3: posts big blind $2
Cirilico: sits out 
*** HOLE CARDS ***
Dealt to matiko09 [Ah Ac]
Fish4trips: folds 
DUkalisUA: folds 
The_red_area: folds 
Moszes360: folds 
chippo boy: folds 
matiko09: raises $2.54 to $4.54
InsomniaRU: folds 
WDW3: folds 
Uncalled bet ($2.54) returned to matiko09
matiko09 collected $5 from pot
matiko09: doesn't show hand 
*** SUMMARY ***
Total pot $5 | Rake $0 
Seat 2: DUkalisUA folded before Flop (didn't bet)
Seat 3: The_red_area folded before Flop (didn't bet)
Seat 4: Moszes360 folded before Flop (didn't bet)
Seat 5: chippo boy folded before Flop (didn't bet)
Seat 6: matiko09 (button) collected ($5)
Seat 7: InsomniaRU (small blind) folded before Flop
Seat 8: WDW3 (big blind) folded before Flop
Seat 9: Fish4trips folded before Flop (didn't bet)





PokerStars Hand #150799654815:  Hold'em No Limit (€0.25/€0.50 EUR) - 2016/03/23 13:40:40 CET [2016/03/23 8:40:40 ET]
Table 'Palma II' 9-max Seat #2 is the button
Seat 1: Ahangama (€50.75 in chips) 
Seat 2: matiko09 (€50 in chips) 
Seat 3: ardo888 (€52.04 in chips) 
Seat 4: dndngod (€53.49 in chips) 
Seat 5: SVFB13 (€50 in chips) 
Seat 6: Red_Warning (€50 in chips) 
Seat 7: Wouter Des (€53.73 in chips) 
Seat 8: CvMCvMCvM (€71.77 in chips) 
Seat 9: ZonTTT (€50 in chips) 
ardo888: posts small blind €0.25
dndngod: posts big blind €0.50
*** HOLE CARDS ***
Dealt to matiko09 [9s 4c]
SVFB13: folds 
Red_Warning: folds 
Wouter Des: calls €0.50
CvMCvMCvM: calls €0.50
ZonTTT: folds 
Ahangama: folds 
matiko09: folds 
ardo888: folds 
dndngod: raises €2.50 to €3
Wouter Des: folds 
CvMCvMCvM: calls €2.50
*** FLOP *** [5h 6h 2d]
Wouter Des leaves the table
dndngod: bets €5
CvMCvMCvM: calls €5
*** TURN *** [5h 6h 2d] [3s]
dndngod: checks 
Kuca :P joins the table at seat #7 
CvMCvMCvM: bets €8
dndngod: calls €8
*** RIVER *** [5h 6h 2d 3s] [6d]
dndngod: checks 
CvMCvMCvM: checks 
*** SHOW DOWN ***
dndngod: shows [Ac As] (two pair, Aces and Sixes)
CvMCvMCvM: mucks hand 
dndngod collected €31.28 from pot
*** SUMMARY ***
Total pot €32.75 | Rake €1.47 
Board [5h 6h 2d 3s 6d]
Seat 1: Ahangama folded before Flop (didn't bet)
Seat 2: matiko09 (button) folded before Flop (didn't bet)
Seat 3: ardo888 (small blind) folded before Flop
Seat 4: dndngod (big blind) showed [Ac As] and won (€31.28) with two pair, Aces and Sixes
Seat 5: SVFB13 folded before Flop (didn't bet)
Seat 6: Red_Warning folded before Flop (didn't bet)
Seat 7: Wouter Des folded before Flop
Seat 8: CvMCvMCvM mucked [Kh Kc]
Seat 9: ZonTTT folded before Flop (didn't bet)





PokerStars Hand #150799656952:  Hold'em No Limit ($1/$2 USD) - 2016/03/23 13:40:43 CET [2016/03/23 8:40:43 ET]
Table 'Kypria II' 9-max Seat #4 is the button
Seat 1: geldwolfje ($242.15 in chips) 
Seat 2: coinflip_si ($200 in chips) 
Seat 3: seouljam ($205.73 in chips) 
Seat 4: nailz83 ($125.92 in chips) 
Seat 5: InsomniaRU ($206.42 in chips) 
Seat 6: matiko09 ($236.64 in chips) 
Seat 7: DUkalisUA ($200 in chips) 
Seat 8: Fish4trips ($293.59 in chips) 
Seat 9: WDW3 ($200.42 in chips) 
InsomniaRU: posts small blind $1
matiko09: posts big blind $2
*** HOLE CARDS ***
Dealt to matiko09 [Qd 6d]
DUkalisUA: raises $4 to $6
Fish4trips: folds 
WDW3: folds 
geldwolfje: folds 
coinflip_si: folds 
seouljam: folds 
nailz83: calls $6
InsomniaRU: folds 
matiko09: folds 
*** FLOP *** [6s 8s 5s]
DUkalisUA: checks 
nailz83: bets $8
DUkalisUA: calls $8
*** TURN *** [6s 8s 5s] [5h]
DUkalisUA: checks 
nailz83: bets $14
DUkalisUA: calls $14
*** RIVER *** [6s 8s 5s 5h] [Th]
DUkalisUA: checks 
nailz83: checks 
*** SHOW DOWN ***
DUkalisUA: shows [7d 8d] (two pair, Eights and Fives)
nailz83: shows [8h 7s] (two pair, Eights and Fives)
DUkalisUA collected $28.17 from pot
nailz83 collected $28.17 from pot
*** SUMMARY ***
Total pot $59 | Rake $2.66 
Board [6s 8s 5s 5h Th]
Seat 1: geldwolfje folded before Flop (didn't bet)
Seat 2: coinflip_si folded before Flop (didn't bet)
Seat 3: seouljam folded before Flop (didn't bet)
Seat 4: nailz83 (button) showed [8h 7s] and won ($28.17) with two pair, Eights and Fives
Seat 5: InsomniaRU (small blind) folded before Flop
Seat 6: matiko09 (big blind) folded before Flop
Seat 7: DUkalisUA showed [7d 8d] and won ($28.17) with two pair, Eights and Fives
Seat 8: Fish4trips folded before Flop (didn't bet)
Seat 9: WDW3 folded before Flop (didn't bet)





PokerStars Hand #150799661627:  Hold'em No Limit (€0.25/€0.50 EUR) - 2016/03/23 13:40:52 CET [2016/03/23 8:40:52 ET]
Table 'Hesperia II' 9-max Seat #3 is the button
Seat 1: CAJUN890 (€49.50 in chips) 
Seat 2: dndngod (€51.44 in chips) 
Seat 3: IvanUrgant (€54.24 in chips) 
Seat 4: Zelenis (€21.40 in chips) 
Seat 5: Avrora-sp (€50 in chips) 
Seat 6: CvMCvMCvM (€50 in chips) 
Seat 7: matiko09 (€60.98 in chips) 
Seat 8: Ahangama (€50 in chips) 
Seat 9: Red_Warning (€50 in chips) 
Zelenis: posts small blind €0.25
Avrora-sp: posts big blind €0.50
*** HOLE CARDS ***
Dealt to matiko09 [Kc 6s]
CvMCvMCvM: folds 
matiko09: folds 
Ahangama: folds 
Red_Warning: raises €1 to €1.50
CAJUN890: calls €1.50
dndngod: folds 
IvanUrgant: folds 
Zelenis: folds 
Avrora-sp: folds 
*** FLOP *** [Tc 8c Jd]
Red_Warning: checks 
CAJUN890: checks 
*** TURN *** [Tc 8c Jd] [Ts]
Red_Warning: checks 
CAJUN890: bets €2
Red_Warning: calls €2
*** RIVER *** [Tc 8c Jd Ts] [7d]
Red_Warning: checks 
CAJUN890: bets €7.40
Red_Warning: folds 
Uncalled bet (€7.40) returned to CAJUN890
CAJUN890 collected €7.40 from pot
CAJUN890: doesn't show hand 
*** SUMMARY ***
Total pot €7.75 | Rake €0.35 
Board [Tc 8c Jd Ts 7d]
Seat 1: CAJUN890 collected (€7.40)
Seat 2: dndngod folded before Flop (didn't bet)
Seat 3: IvanUrgant (button) folded before Flop (didn't bet)
Seat 4: Zelenis (small blind) folded before Flop
Seat 5: Avrora-sp (big blind) folded before Flop
Seat 6: CvMCvMCvM folded before Flop (didn't bet)
Seat 7: matiko09 folded before Flop (didn't bet)
Seat 8: Ahangama folded before Flop (didn't bet)
Seat 9: Red_Warning folded on the River





PokerStars Hand #150799664114:  Hold'em No Limit ($1/$2 USD) - 2016/03/23 13:40:57 CET [2016/03/23 8:40:57 ET]
Table 'Herba II' 9-max Seat #9 is the button
Seat 1: matiko09 ($233.48 in chips) 
Seat 2: Moszes360 ($213.20 in chips) 
Seat 3: Cirilico ($165.60 in chips) 
Seat 4: DUkalisUA ($289.78 in chips) 
Seat 5: chippo boy ($203 in chips) 
Seat 6: WDW3 ($200 in chips) 
Seat 7: InsomniaRU ($249.43 in chips) 
Seat 8: The_red_area ($438.33 in chips) 
Seat 9: mrhighryza ($40.86 in chips) 
matiko09: posts small blind $1
Moszes360: posts big blind $2
*** HOLE CARDS ***
Dealt to matiko09 [6d 7h]
Cirilico: folds 
DUkalisUA: folds 
chippo boy: calls $2
WDW3: folds 
InsomniaRU: raises $6 to $8
The_red_area: folds 
mrhighryza: folds 
matiko09: folds 
Moszes360: folds 
chippo boy: calls $6
*** FLOP *** [Th 3h 9c]
chippo boy: checks 
InsomniaRU: bets $12.15
chippo boy: calls $12.15
*** TURN *** [Th 3h 9c] [As]
chippo boy: checks 
InsomniaRU: bets $27.56
chippo boy: calls $27.56
*** RIVER *** [Th 3h 9c As] [7d]
chippo boy: checks 
InsomniaRU: checks 
*** SHOW DOWN ***
chippo boy: shows [Ts Kc] (a pair of Tens)
InsomniaRU: mucks hand 
chippo boy collected $95.62 from pot
*** SUMMARY ***
Total pot $98.42 | Rake $2.80 
Board [Th 3h 9c As 7d]
Seat 1: matiko09 (small blind) folded before Flop
Seat 2: Moszes360 (big blind) folded before Flop
Seat 3: Cirilico folded before Flop (didn't bet)
Seat 4: DUkalisUA folded before Flop (didn't bet)
Seat 5: chippo boy showed [Ts Kc] and won ($95.62) with a pair of Tens
Seat 6: WDW3 folded before Flop (didn't bet)
Seat 7: InsomniaRU mucked [Ks Qc]
Seat 8: The_red_area folded before Flop (didn't bet)
Seat 9: mrhighryza (button) folded before Flop (didn't bet)





PokerStars Hand #150799664573:  Hold'em No Limit ($1/$2 USD) - 2016/03/23 13:40:58 CET [2016/03/23 8:40:58 ET]
Table 'Kiess' 9-max Seat #7 is the button
Seat 2: DUkalisUA ($506.76 in chips) 
Seat 3: The_red_area ($379.82 in chips) 
Seat 4: Moszes360 ($200 in chips) 
Seat 5: chippo boy ($257.26 in chips) 
Seat 6: matiko09 ($300.84 in chips) 
Seat 7: InsomniaRU ($280.17 in chips) 
Seat 8: WDW3 ($379.42 in chips) 
Seat 9: Fish4trips ($217.55 in chips) 
WDW3: posts small blind $1
Fish4trips: posts big blind $2
Cirilico: sits out 
*** HOLE CARDS ***
Dealt to matiko09 [7c 8s]
DUkalisUA: folds 
The_red_area: folds 
Moszes360: folds 
chippo boy: folds 
matiko09: folds 
InsomniaRU: raises $3 to $5
WDW3: folds 
Fish4trips: folds 
Uncalled bet ($3) returned to InsomniaRU
InsomniaRU collected $5 from pot
InsomniaRU: doesn't show hand 
*** SUMMARY ***
Total pot $5 | Rake $0 
Seat 2: DUkalisUA folded before Flop (didn't bet)
Seat 3: The_red_area folded before Flop (didn't bet)
Seat 4: Moszes360 folded before Flop (didn't bet)
Seat 5: chippo boy folded before Flop (didn't bet)
Seat 6: matiko09 folded before Flop (didn't bet)
Seat 7: InsomniaRU (button) collected ($5)
Seat 8: WDW3 (small blind) folded before Flop
Seat 9: Fish4trips (big blind) folded before Flop





PokerStars Hand #150799667219:  Hold'em No Limit ($0.50/$1.00 USD) - 2016/03/23 13:41:02 CET [2016/03/23 8:41:02 ET]
Table 'Smiley' 9-max Seat #6 is the button
Seat 1: WDW3 ($100 in chips) 
Seat 2: Jimy Tiltman ($105.48 in chips) 
Seat 3: matiko09 ($100 in chips) 
Seat 4: Zeeshka ($148.42 in chips) 
Seat 5: DUkalisUA ($100 in chips) 
Seat 6: blackmont111 ($54.56 in chips) 
Seat 8: RICKA16 ($111.50 in chips) 
Seat 9: morosun ($162.86 in chips) 
RICKA16: posts small blind $0.50
morosun: posts big blind $1
*** HOLE CARDS ***
Dealt to matiko09 [9c 5s]
Moszes360 joins the table at seat #7 
WDW3: folds 
Jimy Tiltman: folds 
matiko09: folds 
Zeeshka: folds 
DUkalisUA: raises $2 to $3
blackmont111: raises $4 to $7
RICKA16: folds 
morosun: folds 
DUkalisUA: calls $4
*** FLOP *** [6s As 9h]
DUkalisUA: checks 
blackmont111: checks 
*** TURN *** [6s As 9h] [5d]
DUkalisUA: checks 
blackmont111: bets $7.40
DUkalisUA: folds 
Uncalled bet ($7.40) returned to blackmont111
blackmont111 collected $14.80 from pot
*** SUMMARY ***
Total pot $15.50 | Rake $0.70 
Board [6s As 9h 5d]
Seat 1: WDW3 folded before Flop (didn't bet)
Seat 2: Jimy Tiltman folded before Flop (didn't bet)
Seat 3: matiko09 folded before Flop (didn't bet)
Seat 4: Zeeshka folded before Flop (didn't bet)
Seat 5: DUkalisUA folded on the Turn
Seat 6: blackmont111 (button) collected ($14.80)
Seat 8: RICKA16 (small blind) folded before Flop
Seat 9: morosun (big blind) folded before Flop





PokerStars Hand #150799669544:  Hold'em No Limit ($0.50/$1.00 USD) - 2016/03/23 13:41:07 CET [2016/03/23 8:41:07 ET]
Table 'Kippes' 9-max Seat #3 is the button
Seat 1: Pvsx. ($101.50 in chips) 
Seat 2: RICKA16 ($127.63 in chips) 
Seat 3: CAJUN890 ($129.31 in chips) 
Seat 4: matiko09 ($114.22 in chips) 
Seat 5: Jimy Tiltman ($113.86 in chips) 
Seat 6: WDW3 ($105.04 in chips) 
Seat 7: lumen21 ($100 in chips) 
Seat 8: Zeeshka ($117.80 in chips) 
Seat 9: wang19790906 ($82.17 in chips) 
matiko09: posts small blind $0.50
Jimy Tiltman: posts big blind $1
*** HOLE CARDS ***
Dealt to matiko09 [Kc 8c]
WDW3: raises $1.80 to $2.80
lumen21: folds 
Zeeshka: folds 
wang19790906: folds 
Pvsx.: folds 
RICKA16: folds 
CAJUN890: folds 
matiko09: folds 
Jimy Tiltman: folds 
Uncalled bet ($1.80) returned to WDW3
WDW3 collected $2.50 from pot
WDW3: doesn't show hand 
*** SUMMARY ***
Total pot $2.50 | Rake $0 
Seat 1: Pvsx. folded before Flop (didn't bet)
Seat 2: RICKA16 folded before Flop (didn't bet)
Seat 3: CAJUN890 (button) folded before Flop (didn't bet)
Seat 4: matiko09 (small blind) folded before Flop
Seat 5: Jimy Tiltman (big blind) folded before Flop
Seat 6: WDW3 collected ($2.50)
Seat 7: lumen21 folded before Flop (didn't bet)
Seat 8: Zeeshka folded before Flop (didn't bet)
Seat 9: wang19790906 folded before Flop (didn't bet)





PokerStars Hand #150799670862:  Hold'em No Limit ($1/$2 USD) - 2016/03/23 13:41:09 CET [2016/03/23 8:41:09 ET]
Table 'Berbericia II' 9-max Seat #3 is the button
Seat 1: WDW3 ($206.05 in chips) 
Seat 2: Moszes360 ($221.52 in chips) 
Seat 3: Fish4trips ($200 in chips) 
Seat 4: bennetb77 ($95.56 in chips) 
Seat 5: darren1031 ($160 in chips) 
Seat 8: matiko09 ($316.51 in chips) 
Seat 9: LVV-Bif ($304.90 in chips) 
bennetb77: posts small blind $1
darren1031: posts big blind $2
Charity86: sits out 
*** HOLE CARDS ***
Dealt to matiko09 [Jc 9s]
matiko09: folds 
LVV-Bif: folds 
WDW3: raises $3.60 to $5.60
Moszes360: folds 
Fish4trips: folds 
bennetb77: folds 
darren1031: folds 
Uncalled bet ($3.60) returned to WDW3
WDW3 collected $5 from pot
WDW3: doesn't show hand 
*** SUMMARY ***
Total pot $5 | Rake $0 
Seat 1: WDW3 collected ($5)
Seat 2: Moszes360 folded before Flop (didn't bet)
Seat 3: Fish4trips (button) folded before Flop (didn't bet)
Seat 4: bennetb77 (small blind) folded before Flop
Seat 5: darren1031 (big blind) folded before Flop
Seat 8: matiko09 folded before Flop (didn't bet)
Seat 9: LVV-Bif folded before Flop (didn't bet)





PokerStars Hand #150799679653:  Hold'em No Limit ($0.50/$1.00 USD) - 2016/03/23 13:41:25 CET [2016/03/23 8:41:25 ET]
Table 'Oljato' 9-max Seat #7 is the button
Seat 1: myatiy 96 ($104 in chips) 
Seat 2: roman134679 ($40.08 in chips) 
Seat 3: DUkalisUA ($100 in chips) 
Seat 4: Pvsx. ($141.10 in chips) 
Seat 5: ryo728 ($96.45 in chips) 
Seat 6: WDW3 ($117.11 in chips) 
Seat 7: matiko09 ($158.59 in chips) 
Seat 8: Zeeshka ($353.34 in chips) 
Seat 9: Jimy Tiltman ($111.56 in chips) 
Zeeshka: posts small blind $0.50
Jimy Tiltman: posts big blind $1
*** HOLE CARDS ***
Dealt to matiko09 [Ts Jc]
myatiy 96: folds 
myatiy 96 leaves the table
roman134679: raises $1 to $2
xHourglass joins the table at seat #1 
DUkalisUA: folds 
Pvsx.: folds 
ryo728: folds 
WDW3: folds 
matiko09: folds 
Zeeshka: folds 
Jimy Tiltman: folds 
Uncalled bet ($1) returned to roman134679
roman134679 collected $2.50 from pot
*** SUMMARY ***
Total pot $2.50 | Rake $0 
Seat 1: myatiy 96 folded before Flop (didn't bet)
Seat 2: roman134679 collected ($2.50)
Seat 3: DUkalisUA folded before Flop (didn't bet)
Seat 4: Pvsx. folded before Flop (didn't bet)
Seat 5: ryo728 folded before Flop (didn't bet)
Seat 6: WDW3 folded before Flop (didn't bet)
Seat 7: matiko09 (button) folded before Flop (didn't bet)
Seat 8: Zeeshka (small blind) folded before Flop
Seat 9: Jimy Tiltman (big blind) folded before Flop





PokerStars Hand #150799681358:  Hold'em No Limit ($0.50/$1.00 USD) - 2016/03/23 13:41:28 CET [2016/03/23 8:41:28 ET]
Table 'Kippes' 9-max Seat #4 is the button
Seat 1: Pvsx. ($101.50 in chips) 
Seat 2: RICKA16 ($127.63 in chips) 
Seat 3: CAJUN890 ($129.31 in chips) 
Seat 4: matiko09 ($113.72 in chips) 
Seat 5: Jimy Tiltman ($112.86 in chips) 
Seat 6: WDW3 ($106.54 in chips) 
Seat 7: lumen21 ($100 in chips) 
Seat 8: Zeeshka ($117.80 in chips) 
Seat 9: wang19790906 ($82.17 in chips) 
Jimy Tiltman: posts small blind $0.50
WDW3: posts big blind $1
*** HOLE CARDS ***
Dealt to matiko09 [7h 9s]
lumen21: folds 
Zeeshka: folds 
wang19790906: folds 
Pvsx.: folds 
RICKA16: folds 
CAJUN890: folds 
matiko09: folds 
Jimy Tiltman: folds 
Uncalled bet ($0.50) returned to WDW3
WDW3 collected $1 from pot
WDW3: doesn't show hand 
*** SUMMARY ***
Total pot $1 | Rake $0 
Seat 1: Pvsx. folded before Flop (didn't bet)
Seat 2: RICKA16 folded before Flop (didn't bet)
Seat 3: CAJUN890 folded before Flop (didn't bet)
Seat 4: matiko09 (button) folded before Flop (didn't bet)
Seat 5: Jimy Tiltman (small blind) folded before Flop
Seat 6: WDW3 (big blind) collected ($1)
Seat 7: lumen21 folded before Flop (didn't bet)
Seat 8: Zeeshka folded before Flop (didn't bet)
Seat 9: wang19790906 folded before Flop (didn't bet)





PokerStars Hand #150799681939:  Hold'em No Limit ($0.25/$0.50 USD) - 2016/03/23 13:41:29 CET [2016/03/23 8:41:29 ET]
Table 'Belnika' 9-max Seat #8 is the button
Seat 1: yellowfever0 ($25.43 in chips) 
Seat 2: NeverRegret7 ($56.49 in chips) 
Seat 3: ChiChioChi ($21.04 in chips) 
Seat 4: matiko09 ($72.60 in chips) 
Seat 6: Ahangama ($65.50 in chips) 
Seat 7: Zeeshka ($50 in chips) 
Seat 8: lumen21 ($68.89 in chips) 
Seat 9: dndngod ($82.09 in chips) 
dndngod: posts small blind $0.25
yellowfever0: posts big blind $0.50
IvanUrgant: sits out 
*** HOLE CARDS ***
Dealt to matiko09 [7d 7h]
NeverRegret7: folds 
ChiChioChi: folds 
matiko09: raises $1 to $1.50
Ahangama: folds 
Zeeshka: folds 
lumen21: calls $1.50
dndngod: calls $1.25
yellowfever0: calls $1
*** FLOP *** [8h Jd 2d]
dndngod: checks 
yellowfever0: checks 
matiko09: checks 
lumen21: checks 
*** TURN *** [8h Jd 2d] [Kd]
dndngod: checks 
yellowfever0: checks 
matiko09: checks 
lumen21: checks 
*** RIVER *** [8h Jd 2d Kd] [6c]
dndngod: checks 
yellowfever0: bets $2.86
matiko09: folds 
lumen21: folds 
dndngod: folds 
Uncalled bet ($2.86) returned to yellowfever0
yellowfever0 collected $5.73 from pot
yellowfever0: doesn't show hand 
*** SUMMARY ***
Total pot $6 | Rake $0.27 
Board [8h Jd 2d Kd 6c]
Seat 1: yellowfever0 (big blind) collected ($5.73)
Seat 2: NeverRegret7 folded before Flop (didn't bet)
Seat 3: ChiChioChi folded before Flop (didn't bet)
Seat 4: matiko09 folded on the River
Seat 6: Ahangama folded before Flop (didn't bet)
Seat 7: Zeeshka folded before Flop (didn't bet)
Seat 8: lumen21 (button) folded on the River
Seat 9: dndngod (small blind) folded on the River





PokerStars Hand #150799683086:  Hold'em No Limit ($1/$2 USD) - 2016/03/23 13:41:31 CET [2016/03/23 8:41:31 ET]
Table 'Kiess' 9-max Seat #8 is the button
Seat 1: Cirilico ($160 in chips) 
Seat 2: DUkalisUA ($506.76 in chips) 
Seat 3: The_red_area ($379.82 in chips) 
Seat 4: Moszes360 ($200 in chips) 
Seat 5: chippo boy ($257.26 in chips) 
Seat 6: matiko09 ($300.84 in chips) 
Seat 7: InsomniaRU ($283.17 in chips) 
Seat 8: WDW3 ($378.42 in chips) 
Seat 9: Fish4trips ($215.55 in chips) 
Fish4trips: posts small blind $1
Cirilico: posts big blind $2
*** HOLE CARDS ***
Dealt to matiko09 [2s Qc]
DUkalisUA: folds 
The_red_area: folds 
Moszes360: folds 
chippo boy: calls $2
matiko09: folds 
InsomniaRU: folds 
WDW3: folds 
Fish4trips: folds 
Cirilico: checks 
*** FLOP *** [6c Td 5h]
Cirilico: checks 
chippo boy: checks 
*** TURN *** [6c Td 5h] [4c]
Cirilico: bets $10
chippo boy: folds 
Uncalled bet ($10) returned to Cirilico
Cirilico collected $4.78 from pot
Cirilico: doesn't show hand 
*** SUMMARY ***
Total pot $5 | Rake $0.22 
Board [6c Td 5h 4c]
Seat 1: Cirilico (big blind) collected ($4.78)
Seat 2: DUkalisUA folded before Flop (didn't bet)
Seat 3: The_red_area folded before Flop (didn't bet)
Seat 4: Moszes360 folded before Flop (didn't bet)
Seat 5: chippo boy folded on the Turn
Seat 6: matiko09 folded before Flop (didn't bet)
Seat 7: InsomniaRU folded before Flop (didn't bet)
Seat 8: WDW3 (button) folded before Flop (didn't bet)
Seat 9: Fish4trips (small blind) folded before Flop





PokerStars Hand #150799693005:  Hold'em No Limit ($0.50/$1.00 USD) - 2016/03/23 13:41:49 CET [2016/03/23 8:41:49 ET]
Table 'Atlantis' 9-max Seat #1 is the button
Seat 1: xHourglass ($160.28 in chips) 
Seat 2: tffff2006 ($29.42 in chips) 
Seat 3: CAJUN890 ($122.40 in chips) 
Seat 4: matiko09 ($111.14 in chips) 
Seat 5: Pvsx. ($100 in chips) 
Seat 6: Jimy Tiltman ($111.74 in chips) 
Seat 7: Zeeshka ($137.18 in chips) 
Seat 8: DUkalisUA ($100 in chips) 
Seat 9: WDW3 ($110.97 in chips) 
tffff2006: posts small blind $0.50
CAJUN890: posts big blind $1
*** HOLE CARDS ***
Dealt to matiko09 [8s 5c]
matiko09: folds 
Pvsx.: raises $1.50 to $2.50
Jimy Tiltman: folds 
Zeeshka: folds 
DUkalisUA: folds 
WDW3: calls $2.50
xHourglass: folds 
tffff2006: calls $2
CAJUN890: folds 
*** FLOP *** [3h 6h Ts]
tffff2006: bets $4.06
Pvsx.: folds 
WDW3: raises $104.41 to $108.47 and is all-in
tffff2006: folds 
Uncalled bet ($104.41) returned to WDW3
WDW3 collected $15.87 from pot
WDW3: doesn't show hand 
*** SUMMARY ***
Total pot $16.62 | Rake $0.75 
Board [3h 6h Ts]
Seat 1: xHourglass (button) folded before Flop (didn't bet)
Seat 2: tffff2006 (small blind) folded on the Flop
Seat 3: CAJUN890 (big blind) folded before Flop
Seat 4: matiko09 folded before Flop (didn't bet)
Seat 5: Pvsx. folded on the Flop
Seat 6: Jimy Tiltman folded before Flop (didn't bet)
Seat 7: Zeeshka folded before Flop (didn't bet)
Seat 8: DUkalisUA folded before Flop (didn't bet)
Seat 9: WDW3 collected ($15.87)





PokerStars Hand #150799696264:  Hold'em No Limit ($1/$2 USD) - 2016/03/23 13:41:55 CET [2016/03/23 8:41:55 ET]
Table 'Berbericia II' 9-max Seat #4 is the button
Seat 1: WDW3 ($209.05 in chips) 
Seat 2: Moszes360 ($221.52 in chips) 
Seat 3: Fish4trips ($200 in chips) 
Seat 4: bennetb77 ($94.56 in chips) 
Seat 5: darren1031 ($158 in chips) 
Seat 6: Charity86 ($160 in chips) 
Seat 8: matiko09 ($316.51 in chips) 
Seat 9: LVV-Bif ($304.90 in chips) 
darren1031: posts small blind $1
Charity86: posts big blind $2
*** HOLE CARDS ***
Dealt to matiko09 [7s Qs]
matiko09: folds 
LVV-Bif: folds 
WDW3: folds 
Moszes360: folds 
Fish4trips: raises $3 to $5
bennetb77: folds 
darren1031: calls $4
Charity86: folds 
*** FLOP *** [5h 6d Ts]
darren1031: checks 
Fish4trips: bets $7.22
darren1031: raises $8.78 to $16
Fish4trips: raises $36 to $52
darren1031: folds 
Uncalled bet ($36) returned to Fish4trips
Fish4trips collected $42.02 from pot
Fish4trips: doesn't show hand 
*** SUMMARY ***
Total pot $44 | Rake $1.98 
Board [5h 6d Ts]
Seat 1: WDW3 folded before Flop (didn't bet)
Seat 2: Moszes360 folded before Flop (didn't bet)
Seat 3: Fish4trips collected ($42.02)
Seat 4: bennetb77 (button) folded before Flop (didn't bet)
Seat 5: darren1031 (small blind) folded on the Flop
Seat 6: Charity86 (big blind) folded before Flop
Seat 8: matiko09 folded before Flop (didn't bet)
Seat 9: LVV-Bif folded before Flop (didn't bet)





PokerStars Hand #150799696713:  Hold'em No Limit ($0.50/$1.00 USD) - 2016/03/23 13:41:56 CET [2016/03/23 8:41:56 ET]
Table 'Kippes' 9-max Seat #5 is the button
Seat 1: Pvsx. ($101.50 in chips) 
Seat 2: RICKA16 ($127.63 in chips) 
Seat 3: CAJUN890 ($129.31 in chips) 
Seat 4: matiko09 ($113.72 in chips) 
Seat 5: Jimy Tiltman ($112.36 in chips) 
Seat 6: WDW3 ($107.04 in chips) 
Seat 7: lumen21 ($100 in chips) 
Seat 8: Zeeshka ($117.80 in chips) 
Seat 9: wang19790906 ($82.17 in chips) 
WDW3: posts small blind $0.50
lumen21: posts big blind $1
*** HOLE CARDS ***
Dealt to matiko09 [Th Kh]
Zeeshka: folds 
wang19790906: folds 
Pvsx.: raises $1.50 to $2.50
RICKA16: folds 
CAJUN890: folds 
matiko09: folds 
Jimy Tiltman: folds 
WDW3: folds 
lumen21: folds 
Uncalled bet ($1.50) returned to Pvsx.
Pvsx. collected $2.50 from pot
Pvsx.: doesn't show hand 
*** SUMMARY ***
Total pot $2.50 | Rake $0 
Seat 1: Pvsx. collected ($2.50)
Seat 2: RICKA16 folded before Flop (didn't bet)
Seat 3: CAJUN890 folded before Flop (didn't bet)
Seat 4: matiko09 folded before Flop (didn't bet)
Seat 5: Jimy Tiltman (button) folded before Flop (didn't bet)
Seat 6: WDW3 (small blind) folded before Flop
Seat 7: lumen21 (big blind) folded before Flop
Seat 8: Zeeshka folded before Flop (didn't bet)
Seat 9: wang19790906 folded before Flop (didn't bet)





PokerStars Hand #150799698223:  Hold'em No Limit ($1/$2 USD) - 2016/03/23 13:41:58 CET [2016/03/23 8:41:58 ET]
Table 'Kypria II' 9-max Seat #5 is the button
Seat 1: geldwolfje ($242.15 in chips) 
Seat 2: coinflip_si ($200 in chips) 
Seat 3: seouljam ($205.73 in chips) 
Seat 4: nailz83 ($126.09 in chips) 
Seat 5: InsomniaRU ($205.42 in chips) 
Seat 6: matiko09 ($234.64 in chips) 
Seat 7: DUkalisUA ($200.17 in chips) 
Seat 8: Fish4trips ($293.59 in chips) 
Seat 9: WDW3 ($200.42 in chips) 
matiko09: posts small blind $1
DUkalisUA: posts big blind $2
*** HOLE CARDS ***
Dealt to matiko09 [Qs As]
Fish4trips: folds 
WDW3: folds 
geldwolfje: folds 
coinflip_si: raises $3 to $5
seouljam: folds 
nailz83: folds 
InsomniaRU: calls $5
matiko09: raises $18 to $23
DUkalisUA: folds 
coinflip_si: folds 
InsomniaRU: calls $18
*** FLOP *** [Jd 2s 6c]
matiko09: bets $20
InsomniaRU: calls $20
*** TURN *** [Jd 2s 6c] [5d]
matiko09: bets $46
InsomniaRU: calls $46
*** RIVER *** [Jd 2s 6c 5d] [Jh]
matiko09: bets $50
InsomniaRU: raises $66.42 to $116.42 and is all-in
matiko09: folds 
Uncalled bet ($66.42) returned to InsomniaRU
InsomniaRU collected $282.20 from pot
InsomniaRU: doesn't show hand 
*** SUMMARY ***
Total pot $285 | Rake $2.80 
Board [Jd 2s 6c 5d Jh]
Seat 1: geldwolfje folded before Flop (didn't bet)
Seat 2: coinflip_si folded before Flop
Seat 3: seouljam folded before Flop (didn't bet)
Seat 4: nailz83 folded before Flop (didn't bet)
Seat 5: InsomniaRU (button) collected ($282.20)
Seat 6: matiko09 (small blind) folded on the River
Seat 7: DUkalisUA (big blind) folded before Flop
Seat 8: Fish4trips folded before Flop (didn't bet)
Seat 9: WDW3 folded before Flop (didn't bet)





PokerStars Hand #150799701540:  Hold'em No Limit ($0.25/$0.50 USD) - 2016/03/23 13:42:04 CET [2016/03/23 8:42:04 ET]
Table 'Pyrrhus' 9-max Seat #1 is the button
Seat 1: lumen21 ($50 in chips) 
Seat 3: IvanUrgant ($85.32 in chips) 
Seat 4: GriffinBerg ($39.93 in chips) 
Seat 5: Moszes360 ($50 in chips) 
Seat 7: matiko09 ($105.89 in chips) 
Seat 8: dndngod ($58.97 in chips) 
Seat 9: CvMCvMCvM ($111.16 in chips) 
Zeeshka will be allowed to play after the button
IvanUrgant: posts small blind $0.25
GriffinBerg: posts big blind $0.50
whalldo: sits out 
*** HOLE CARDS ***
Dealt to matiko09 [Jc Tc]
Moszes360: folds 
matiko09: raises $1 to $1.50
dndngod: folds 
CvMCvMCvM: folds 
lumen21: folds 
IvanUrgant: folds 
GriffinBerg: calls $1
*** FLOP *** [Td 3d Jh]
GriffinBerg: checks 
matiko09: bets $2.02
GriffinBerg: calls $2.02
*** TURN *** [Td 3d Jh] [Qc]
GriffinBerg: checks 
matiko09: bets $4.50
GriffinBerg: raises $4.50 to $9
matiko09: calls $4.50
*** RIVER *** [Td 3d Jh Qc] [5c]
GriffinBerg: bets $12.07
matiko09: calls $12.07
*** SHOW DOWN ***
GriffinBerg: shows [Jd Ad] (a pair of Jacks)
matiko09: shows [Jc Tc] (two pair, Jacks and Tens)
matiko09 collected $47.21 from pot
*** SUMMARY ***
Total pot $49.43 | Rake $2.22 
Board [Td 3d Jh Qc 5c]
Seat 1: lumen21 (button) folded before Flop (didn't bet)
Seat 3: IvanUrgant (small blind) folded before Flop
Seat 4: GriffinBerg (big blind) showed [Jd Ad] and lost with a pair of Jacks
Seat 5: Moszes360 folded before Flop (didn't bet)
Seat 7: matiko09 showed [Jc Tc] and won ($47.21) with two pair, Jacks and Tens
Seat 8: dndngod folded before Flop (didn't bet)
Seat 9: CvMCvMCvM folded before Flop (didn't bet)





PokerStars Hand #150799706488:  Hold'em No Limit ($0.50/$1.00 USD) - 2016/03/23 13:42:13 CET [2016/03/23 8:42:13 ET]
Table 'Smiley' 9-max Seat #8 is the button
Seat 1: WDW3 ($100 in chips) 
Seat 2: Jimy Tiltman ($105.48 in chips) 
Seat 3: matiko09 ($100 in chips) 
Seat 4: Zeeshka ($148.42 in chips) 
Seat 5: DUkalisUA ($100 in chips) 
Seat 6: blackmont111 ($62.36 in chips) 
Seat 8: RICKA16 ($111 in chips) 
Seat 9: morosun ($161.86 in chips) 
morosun: posts small blind $0.50
WDW3: posts big blind $1
Moszes360: sits out 
*** HOLE CARDS ***
Dealt to matiko09 [Ts Ks]
Jimy Tiltman: folds 
matiko09: raises $2 to $3
Zeeshka: folds 
DUkalisUA: folds 
blackmont111: calls $3
RICKA16: folds 
morosun: folds 
WDW3: folds 
*** FLOP *** [6d Kc Qh]
matiko09: checks 
blackmont111: bets $2
matiko09: calls $2
*** TURN *** [6d Kc Qh] [9h]
matiko09: checks 
blackmont111: checks 
*** RIVER *** [6d Kc Qh 9h] [Th]
matiko09: bets $3.40
blackmont111: folds 
Uncalled bet ($3.40) returned to matiko09
matiko09 collected $10.98 from pot
matiko09: doesn't show hand 
*** SUMMARY ***
Total pot $11.50 | Rake $0.52 
Board [6d Kc Qh 9h Th]
Seat 1: WDW3 (big blind) folded before Flop
Seat 2: Jimy Tiltman folded before Flop (didn't bet)
Seat 3: matiko09 collected ($10.98)
Seat 4: Zeeshka folded before Flop (didn't bet)
Seat 5: DUkalisUA folded before Flop (didn't bet)
Seat 6: blackmont111 folded on the River
Seat 8: RICKA16 (button) folded before Flop (didn't bet)
Seat 9: morosun (small blind) folded before Flop





PokerStars Hand #150799707307:  Hold'em No Limit ($0.50/$1.00 USD) - 2016/03/23 13:42:15 CET [2016/03/23 8:42:15 ET]
Table 'Oljato' 9-max Seat #8 is the button
Seat 1: xHourglass ($100 in chips) 
Seat 2: roman134679 ($41.58 in chips) 
Seat 3: DUkalisUA ($100 in chips) 
Seat 4: Pvsx. ($141.10 in chips) 
Seat 5: ryo728 ($96.45 in chips) 
Seat 6: WDW3 ($117.11 in chips) 
Seat 7: matiko09 ($158.59 in chips) 
Seat 8: Zeeshka ($352.84 in chips) 
Seat 9: Jimy Tiltman ($110.56 in chips) 
Jimy Tiltman: posts small blind $0.50
xHourglass: posts big blind $1
*** HOLE CARDS ***
Dealt to matiko09 [3d Th]
roman134679: folds 
DUkalisUA: folds 
Pvsx.: folds 
ryo728: calls $1
WDW3: folds 
matiko09: folds 
Zeeshka: raises $3 to $4
Jimy Tiltman: folds 
xHourglass: calls $3
ryo728: calls $3
*** FLOP *** [Ks 9h 7s]
xHourglass: checks 
ryo728: checks 
Zeeshka: checks 
*** TURN *** [Ks 9h 7s] [Td]
xHourglass: bets $7.50
ryo728: folds 
Zeeshka: calls $7.50
*** RIVER *** [Ks 9h 7s Td] [5s]
xHourglass: bets $17.75
Zeeshka: folds 
Uncalled bet ($17.75) returned to xHourglass
xHourglass collected $26.26 from pot
xHourglass: doesn't show hand 
*** SUMMARY ***
Total pot $27.50 | Rake $1.24 
Board [Ks 9h 7s Td 5s]
Seat 1: xHourglass (big blind) collected ($26.26)
Seat 2: roman134679 folded before Flop (didn't bet)
Seat 3: DUkalisUA folded before Flop (didn't bet)
Seat 4: Pvsx. folded before Flop (didn't bet)
Seat 5: ryo728 folded on the Turn
Seat 6: WDW3 folded before Flop (didn't bet)
Seat 7: matiko09 folded before Flop (didn't bet)
Seat 8: Zeeshka (button) folded on the River
Seat 9: Jimy Tiltman (small blind) folded before Flop





PokerStars Hand #150799707951:  Hold'em No Limit ($1/$2 USD) - 2016/03/23 13:42:16 CET [2016/03/23 8:42:16 ET]
Table 'Kiess' 9-max Seat #9 is the button
Seat 1: Cirilico ($162.78 in chips) 
Seat 2: DUkalisUA ($506.76 in chips) 
Seat 3: The_red_area ($379.82 in chips) 
Seat 4: Moszes360 ($200 in chips) 
Seat 5: chippo boy ($255.26 in chips) 
Seat 6: matiko09 ($300.84 in chips) 
Seat 7: InsomniaRU ($283.17 in chips) 
Seat 8: WDW3 ($378.42 in chips) 
Seat 9: Fish4trips ($214.55 in chips) 
Cirilico: posts small blind $1
DUkalisUA: posts big blind $2
*** HOLE CARDS ***
Dealt to matiko09 [3c 7c]
The_red_area: folds 
Moszes360: raises $4 to $6
chippo boy: folds 
matiko09: folds 
InsomniaRU: folds 
WDW3: folds 
Fish4trips: folds 
Cirilico: folds 
DUkalisUA: folds 
Uncalled bet ($4) returned to Moszes360
Moszes360 collected $5 from pot
Moszes360: doesn't show hand 
*** SUMMARY ***
Total pot $5 | Rake $0 
Seat 1: Cirilico (small blind) folded before Flop
Seat 2: DUkalisUA (big blind) folded before Flop
Seat 3: The_red_area folded before Flop (didn't bet)
Seat 4: Moszes360 collected ($5)
Seat 5: chippo boy folded before Flop (didn't bet)
Seat 6: matiko09 folded before Flop (didn't bet)
Seat 7: InsomniaRU folded before Flop (didn't bet)
Seat 8: WDW3 folded before Flop (didn't bet)
Seat 9: Fish4trips (button) folded before Flop (didn't bet)





PokerStars Hand #150799709616:  Hold'em No Limit (€0.25/€0.50 EUR) - 2016/03/23 13:42:19 CET [2016/03/23 8:42:19 ET]
Table 'Hesperia II' 9-max Seat #4 is the button
Seat 1: CAJUN890 (€53.40 in chips) 
Seat 2: dndngod (€51.44 in chips) 
Seat 3: IvanUrgant (€54.24 in chips) 
Seat 4: Zelenis (€21.15 in chips) 
Seat 5: Avrora-sp (€50 in chips) 
Seat 6: CvMCvMCvM (€50 in chips) 
Seat 7: matiko09 (€60.98 in chips) 
Seat 8: Ahangama (€50 in chips) 
Seat 9: Red_Warning (€50 in chips) 
Avrora-sp: posts small blind €0.25
CvMCvMCvM: posts big blind €0.50
*** HOLE CARDS ***
Dealt to matiko09 [7h 3s]
matiko09: folds 
Ahangama: folds 
Red_Warning: folds 
CAJUN890: calls €0.50
dndngod: folds 
IvanUrgant: folds 
Zelenis: folds 
Avrora-sp: folds 
CvMCvMCvM: checks 
*** FLOP *** [4d 7d Tc]
CvMCvMCvM: checks 
CAJUN890: bets €1.19
CvMCvMCvM: folds 
Uncalled bet (€1.19) returned to CAJUN890
CAJUN890 collected €1.19 from pot
CAJUN890: doesn't show hand 
*** SUMMARY ***
Total pot €1.25 | Rake €0.06 
Board [4d 7d Tc]
Seat 1: CAJUN890 collected (€1.19)
Seat 2: dndngod folded before Flop (didn't bet)
Seat 3: IvanUrgant folded before Flop (didn't bet)
Seat 4: Zelenis (button) folded before Flop (didn't bet)
Seat 5: Avrora-sp (small blind) folded before Flop
Seat 6: CvMCvMCvM (big blind) folded on the Flop
Seat 7: matiko09 folded before Flop (didn't bet)
Seat 8: Ahangama folded before Flop (didn't bet)
Seat 9: Red_Warning folded before Flop (didn't bet)





PokerStars Hand #150799712586:  Hold'em No Limit ($1/$2 USD) - 2016/03/23 13:42:24 CET [2016/03/23 8:42:24 ET]
Table 'Herba II' 9-max Seat #1 is the button
Seat 1: matiko09 ($232.48 in chips) 
Seat 2: Moszes360 ($211.20 in chips) 
Seat 3: Cirilico ($165.60 in chips) 
Seat 4: DUkalisUA ($289.78 in chips) 
Seat 5: chippo boy ($250.91 in chips) 
Seat 6: WDW3 ($200 in chips) 
Seat 7: InsomniaRU ($201.72 in chips) 
Seat 8: The_red_area ($438.33 in chips) 
Seat 9: mrhighryza ($40.86 in chips) 
Moszes360: posts small blind $1
Cirilico: posts big blind $2
*** HOLE CARDS ***
Dealt to matiko09 [3d 6c]
DUkalisUA: folds 
chippo boy: folds 
WDW3: folds 
InsomniaRU: raises $3 to $5
The_red_area: folds 
mrhighryza: calls $5
matiko09: folds 
Moszes360: folds 
Cirilico: folds 
*** FLOP *** [Kh 5c 4d]
InsomniaRU: checks 
mrhighryza: checks 
*** TURN *** [Kh 5c 4d] [9h]
InsomniaRU: checks 
mrhighryza: bets $8
InsomniaRU: calls $8
*** RIVER *** [Kh 5c 4d 9h] [9s]
InsomniaRU: checks 
mrhighryza: checks 
*** SHOW DOWN ***
InsomniaRU: shows [Td Kd] (two pair, Kings and Nines)
mrhighryza: mucks hand 
InsomniaRU collected $27.70 from pot
*** SUMMARY ***
Total pot $29 | Rake $1.30 
Board [Kh 5c 4d 9h 9s]
Seat 1: matiko09 (button) folded before Flop (didn't bet)
Seat 2: Moszes360 (small blind) folded before Flop
Seat 3: Cirilico (big blind) folded before Flop
Seat 4: DUkalisUA folded before Flop (didn't bet)
Seat 5: chippo boy folded before Flop (didn't bet)
Seat 6: WDW3 folded before Flop (didn't bet)
Seat 7: InsomniaRU showed [Td Kd] and won ($27.70) with two pair, Kings and Nines
Seat 8: The_red_area folded before Flop (didn't bet)
Seat 9: mrhighryza mucked [Jd Qh]





PokerStars Hand #150799718034:  Hold'em No Limit (€0.25/€0.50 EUR) - 2016/03/23 13:42:34 CET [2016/03/23 8:42:34 ET]
Table 'Palma II' 9-max Seat #3 is the button
Seat 1: Ahangama (€50.75 in chips) 
Seat 2: matiko09 (€50 in chips) 
Seat 3: ardo888 (€51.79 in chips) 
Seat 4: dndngod (€68.77 in chips) 
Seat 5: SVFB13 (€50 in chips) 
Seat 6: Red_Warning (€50 in chips) 
Seat 8: CvMCvMCvM (€55.77 in chips) 
Seat 9: ZonTTT (€50 in chips) 
dndngod: posts small blind €0.25
SVFB13: posts big blind €0.50
Kuca :P: sits out 
*** HOLE CARDS ***
Dealt to matiko09 [Kh 5s]
Red_Warning: folds 
CvMCvMCvM: raises €0.57 to €1.07
ZonTTT: folds 
Ahangama: raises €2.93 to €4
matiko09: folds 
ardo888: folds 
dndngod: folds 
SVFB13: folds 
CvMCvMCvM: calls €2.93
*** FLOP *** [Th Qc Ts]
CvMCvMCvM: checks 
Ahangama: bets €4
CvMCvMCvM: folds 
Uncalled bet (€4) returned to Ahangama
Ahangama collected €8.36 from pot
Ahangama: doesn't show hand 
*** SUMMARY ***
Total pot €8.75 | Rake €0.39 
Board [Th Qc Ts]
Seat 1: Ahangama collected (€8.36)
Seat 2: matiko09 folded before Flop (didn't bet)
Seat 3: ardo888 (button) folded before Flop (didn't bet)
Seat 4: dndngod (small blind) folded before Flop
Seat 5: SVFB13 (big blind) folded before Flop
Seat 6: Red_Warning folded before Flop (didn't bet)
Seat 8: CvMCvMCvM folded on the Flop
Seat 9: ZonTTT folded before Flop (didn't bet)





PokerStars Hand #150799720892:  Hold'em No Limit ($1/$2 USD) - 2016/03/23 13:42:39 CET [2016/03/23 8:42:39 ET]
Table 'Kiess' 9-max Seat #1 is the button
Seat 1: Cirilico ($161.78 in chips) 
Seat 2: DUkalisUA ($504.76 in chips) 
Seat 3: The_red_area ($379.82 in chips) 
Seat 4: Moszes360 ($203 in chips) 
Seat 5: chippo boy ($255.26 in chips) 
Seat 6: matiko09 ($300.84 in chips) 
Seat 7: InsomniaRU ($283.17 in chips) 
Seat 8: WDW3 ($378.42 in chips) 
Seat 9: Fish4trips ($214.55 in chips) 
DUkalisUA: posts small blind $1
The_red_area: posts big blind $2
*** HOLE CARDS ***
Dealt to matiko09 [Ac 5d]
Moszes360: raises $4 to $6
chippo boy: folds 
matiko09: folds 
InsomniaRU: folds 
WDW3: folds 
Fish4trips: folds 
Cirilico: folds 
DUkalisUA: folds 
The_red_area: folds 
Uncalled bet ($4) returned to Moszes360
Moszes360 collected $5 from pot
Moszes360: doesn't show hand 
*** SUMMARY ***
Total pot $5 | Rake $0 
Seat 1: Cirilico (button) folded before Flop (didn't bet)
Seat 2: DUkalisUA (small blind) folded before Flop
Seat 3: The_red_area (big blind) folded before Flop
Seat 4: Moszes360 collected ($5)
Seat 5: chippo boy folded before Flop (didn't bet)
Seat 6: matiko09 folded before Flop (didn't bet)
Seat 7: InsomniaRU folded before Flop (didn't bet)
Seat 8: WDW3 folded before Flop (didn't bet)
Seat 9: Fish4trips folded before Flop (didn't bet)





PokerStars Hand #150799721479:  Hold'em No Limit ($0.50/$1.00 USD) - 2016/03/23 13:42:40 CET [2016/03/23 8:42:40 ET]
Table 'Kippes' 9-max Seat #6 is the button
Seat 1: Pvsx. ($103 in chips) 
Seat 2: RICKA16 ($127.63 in chips) 
Seat 3: CAJUN890 ($129.31 in chips) 
Seat 4: matiko09 ($113.72 in chips) 
Seat 5: Jimy Tiltman ($112.36 in chips) 
Seat 6: WDW3 ($106.54 in chips) 
Seat 7: lumen21 ($100 in chips) 
Seat 8: Zeeshka ($117.80 in chips) 
Seat 9: wang19790906 ($82.17 in chips) 
lumen21: posts small blind $0.50
Zeeshka: posts big blind $1
*** HOLE CARDS ***
Dealt to matiko09 [5s Ad]
wang19790906: folds 
Pvsx.: folds 
RICKA16: folds 
CAJUN890: folds 
matiko09: folds 
Jimy Tiltman: folds 
WDW3: folds 
lumen21: folds 
Uncalled bet ($0.50) returned to Zeeshka
Zeeshka collected $1 from pot
Zeeshka: doesn't show hand 
*** SUMMARY ***
Total pot $1 | Rake $0 
Seat 1: Pvsx. folded before Flop (didn't bet)
Seat 2: RICKA16 folded before Flop (didn't bet)
Seat 3: CAJUN890 folded before Flop (didn't bet)
Seat 4: matiko09 folded before Flop (didn't bet)
Seat 5: Jimy Tiltman folded before Flop (didn't bet)
Seat 6: WDW3 (button) folded before Flop (didn't bet)
Seat 7: lumen21 (small blind) folded before Flop
Seat 8: Zeeshka (big blind) collected ($1)
Seat 9: wang19790906 folded before Flop (didn't bet)





PokerStars Hand #150799721451:  Hold'em No Limit ($0.50/$1.00 USD) - 2016/03/23 13:42:40 CET [2016/03/23 8:42:40 ET]
Table 'Merope II' 9-max Seat #4 is the button
Seat 1: Jimy Tiltman ($100 in chips) 
Seat 2: Zeeshka ($100 in chips) 
Seat 3: Sherlockplay ($100 in chips) 
Seat 4: YuriiSolodya ($40 in chips) 
Seat 5: DUkalisUA ($100 in chips) 
Seat 6: rebelTC ($80 in chips) 
Seat 7: matiko09 ($100 in chips) 
Seat 8: titentei ($100 in chips) 
Seat 9: RICKA16 ($100 in chips) 
DUkalisUA: posts small blind $0.50
rebelTC: posts big blind $1
*** HOLE CARDS ***
Dealt to matiko09 [3c 4s]
matiko09: folds 
titentei: folds 
RICKA16: folds 
Jimy Tiltman: folds 
Zeeshka: folds 
Sherlockplay: folds 
YuriiSolodya: raises $2 to $3
DUkalisUA: raises $6.50 to $9.50
rebelTC: folds 
YuriiSolodya: calls $6.50
*** FLOP *** [3h 2h 7h]
DUkalisUA: bets $10.50
YuriiSolodya: folds 
Uncalled bet ($10.50) returned to DUkalisUA
DUkalisUA collected $19.10 from pot
DUkalisUA: doesn't show hand 
*** SUMMARY ***
Total pot $20 | Rake $0.90 
Board [3h 2h 7h]
Seat 1: Jimy Tiltman folded before Flop (didn't bet)
Seat 2: Zeeshka folded before Flop (didn't bet)
Seat 3: Sherlockplay folded before Flop (didn't bet)
Seat 4: YuriiSolodya (button) folded on the Flop
Seat 5: DUkalisUA (small blind) collected ($19.10)
Seat 6: rebelTC (big blind) folded before Flop
Seat 7: matiko09 folded before Flop (didn't bet)
Seat 8: titentei folded before Flop (didn't bet)
Seat 9: RICKA16 folded before Flop (didn't bet)





PokerStars Hand #150799724478:  Hold'em No Limit ($0.50/$1.00 USD) - 2016/03/23 13:42:46 CET [2016/03/23 8:42:46 ET]
Table 'Atlantis' 9-max Seat #2 is the button
Seat 1: xHourglass ($160.28 in chips) 
Seat 2: tffff2006 ($22.86 in chips) 
Seat 3: CAJUN890 ($121.40 in chips) 
Seat 4: matiko09 ($111.14 in chips) 
Seat 5: Pvsx. ($100 in chips) 
Seat 6: Jimy Tiltman ($111.74 in chips) 
Seat 7: Zeeshka ($137.18 in chips) 
Seat 8: DUkalisUA ($100 in chips) 
Seat 9: WDW3 ($120.28 in chips) 
CAJUN890: posts small blind $0.50
matiko09: posts big blind $1
*** HOLE CARDS ***
Dealt to matiko09 [4s Tc]
Pvsx.: raises $1.50 to $2.50
Jimy Tiltman: folds 
Zeeshka: folds 
DUkalisUA: folds 
WDW3: folds 
xHourglass: folds 
tffff2006: folds 
CAJUN890: folds 
matiko09: folds 
Uncalled bet ($1.50) returned to Pvsx.
Pvsx. collected $2.50 from pot
Pvsx.: doesn't show hand 
*** SUMMARY ***
Total pot $2.50 | Rake $0 
Seat 1: xHourglass folded before Flop (didn't bet)
Seat 2: tffff2006 (button) folded before Flop (didn't bet)
Seat 3: CAJUN890 (small blind) folded before Flop
Seat 4: matiko09 (big blind) folded before Flop
Seat 5: Pvsx. collected ($2.50)
Seat 6: Jimy Tiltman folded before Flop (didn't bet)
Seat 7: Zeeshka folded before Flop (didn't bet)
Seat 8: DUkalisUA folded before Flop (didn't bet)
Seat 9: WDW3 folded before Flop (didn't bet)





PokerStars Hand #150799732012:  Hold'em No Limit ($0.25/$0.50 USD) - 2016/03/23 13:42:59 CET [2016/03/23 8:42:59 ET]
Table 'Belnika' 9-max Seat #9 is the button
Seat 1: yellowfever0 ($29.66 in chips) 
Seat 2: NeverRegret7 ($56.49 in chips) 
Seat 3: ChiChioChi ($21.04 in chips) 
Seat 4: matiko09 ($71.10 in chips) 
Seat 6: Ahangama ($65.50 in chips) 
Seat 7: Zeeshka ($50 in chips) 
Seat 8: lumen21 ($67.39 in chips) 
Seat 9: dndngod ($80.59 in chips) 
yellowfever0: posts small blind $0.25
NeverRegret7: posts big blind $0.50
IvanUrgant: sits out 
*** HOLE CARDS ***
Dealt to matiko09 [9s 4h]
ChiChioChi: folds 
matiko09: folds 
Ahangama: folds 
Zeeshka: folds 
lumen21: folds 
dndngod: raises $0.50 to $1
yellowfever0: calls $0.75
NeverRegret7: calls $0.50
*** FLOP *** [Jc Qs 6d]
yellowfever0: checks 
NeverRegret7: checks 
dndngod: checks 
*** TURN *** [Jc Qs 6d] [3d]
yellowfever0: checks 
NeverRegret7: checks 
dndngod: bets $2
yellowfever0: folds 
NeverRegret7: folds 
Uncalled bet ($2) returned to dndngod
dndngod collected $2.86 from pot
dndngod: doesn't show hand 
*** SUMMARY ***
Total pot $3 | Rake $0.14 
Board [Jc Qs 6d 3d]
Seat 1: yellowfever0 (small blind) folded on the Turn
Seat 2: NeverRegret7 (big blind) folded on the Turn
Seat 3: ChiChioChi folded before Flop (didn't bet)
Seat 4: matiko09 folded before Flop (didn't bet)
Seat 6: Ahangama folded before Flop (didn't bet)
Seat 7: Zeeshka folded before Flop (didn't bet)
Seat 8: lumen21 folded before Flop (didn't bet)
Seat 9: dndngod (button) collected ($2.86)





PokerStars Hand #150799732952:  Hold'em No Limit ($1/$2 USD) - 2016/03/23 13:43:01 CET [2016/03/23 8:43:01 ET]
Table 'Kiess' 9-max Seat #2 is the button
Seat 1: Cirilico ($161.78 in chips) 
Seat 2: DUkalisUA ($503.76 in chips) 
Seat 3: The_red_area ($377.82 in chips) 
Seat 4: Moszes360 ($206 in chips) 
Seat 5: chippo boy ($255.26 in chips) 
Seat 6: matiko09 ($300.84 in chips) 
Seat 7: InsomniaRU ($283.17 in chips) 
Seat 8: WDW3 ($378.42 in chips) 
Seat 9: Fish4trips ($214.55 in chips) 
The_red_area: posts small blind $1
Moszes360: posts big blind $2
*** HOLE CARDS ***
Dealt to matiko09 [Tc 6h]
chippo boy: calls $2
matiko09: folds 
InsomniaRU: raises $5 to $7
WDW3: folds 
Fish4trips: folds 
Cirilico: folds 
DUkalisUA: calls $7
The_red_area: folds 
Moszes360: folds 
chippo boy: calls $5
*** FLOP *** [Ah 5h 6c]
chippo boy: checks 
InsomniaRU: checks 
DUkalisUA: bets $17.19
chippo boy: calls $17.19
InsomniaRU: folds 
*** TURN *** [Ah 5h 6c] [8h]
chippo boy: bets $28
DUkalisUA: folds 
Uncalled bet ($28) returned to chippo boy
chippo boy collected $55.75 from pot
*** SUMMARY ***
Total pot $58.38 | Rake $2.63 
Board [Ah 5h 6c 8h]
Seat 1: Cirilico folded before Flop (didn't bet)
Seat 2: DUkalisUA (button) folded on the Turn
Seat 3: The_red_area (small blind) folded before Flop
Seat 4: Moszes360 (big blind) folded before Flop
Seat 5: chippo boy collected ($55.75)
Seat 6: matiko09 folded before Flop (didn't bet)
Seat 7: InsomniaRU folded on the Flop
Seat 8: WDW3 folded before Flop (didn't bet)
Seat 9: Fish4trips folded before Flop (didn't bet)





PokerStars Hand #150799739554:  Hold'em No Limit ($0.50/$1.00 USD) - 2016/03/23 13:43:13 CET [2016/03/23 8:43:13 ET]
Table 'Atlantis' 9-max Seat #3 is the button
Seat 1: xHourglass ($160.28 in chips) 
Seat 2: tffff2006 ($22.86 in chips) 
Seat 3: CAJUN890 ($120.90 in chips) 
Seat 4: matiko09 ($110.14 in chips) 
Seat 5: Pvsx. ($101.50 in chips) 
Seat 6: Jimy Tiltman ($111.74 in chips) 
Seat 7: Zeeshka ($137.18 in chips) 
Seat 8: DUkalisUA ($100 in chips) 
Seat 9: WDW3 ($120.28 in chips) 
matiko09: posts small blind $0.50
Pvsx.: posts big blind $1
*** HOLE CARDS ***
Dealt to matiko09 [4h 5s]
Jimy Tiltman: folds 
Zeeshka: folds 
DUkalisUA: folds 
WDW3: raises $1.80 to $2.80
xHourglass: folds 
tffff2006: folds 
CAJUN890: calls $2.80
matiko09: folds 
Pvsx.: folds 
*** FLOP *** [Ad Ac 4d]
WDW3: bets $4
CAJUN890: folds 
Uncalled bet ($4) returned to WDW3
WDW3 collected $6.78 from pot
WDW3: doesn't show hand 
*** SUMMARY ***
Total pot $7.10 | Rake $0.32 
Board [Ad Ac 4d]
Seat 1: xHourglass folded before Flop (didn't bet)
Seat 2: tffff2006 folded before Flop (didn't bet)
Seat 3: CAJUN890 (button) folded on the Flop
Seat 4: matiko09 (small blind) folded before Flop
Seat 5: Pvsx. (big blind) folded before Flop
Seat 6: Jimy Tiltman folded before Flop (didn't bet)
Seat 7: Zeeshka folded before Flop (didn't bet)
Seat 8: DUkalisUA folded before Flop (didn't bet)
Seat 9: WDW3 collected ($6.78)





PokerStars Hand #150799740208:  Hold'em No Limit ($0.50/$1.00 USD) - 2016/03/23 13:43:14 CET [2016/03/23 8:43:14 ET]
Table 'Kippes' 9-max Seat #7 is the button
Seat 1: Pvsx. ($103 in chips) 
Seat 2: RICKA16 ($127.63 in chips) 
Seat 3: CAJUN890 ($129.31 in chips) 
Seat 4: matiko09 ($113.72 in chips) 
Seat 5: Jimy Tiltman ($112.36 in chips) 
Seat 6: WDW3 ($106.54 in chips) 
Seat 7: lumen21 ($100 in chips) 
Seat 8: Zeeshka ($118.30 in chips) 
Seat 9: wang19790906 ($82.17 in chips) 
Zeeshka: posts small blind $0.50
wang19790906: posts big blind $1
*** HOLE CARDS ***
Dealt to matiko09 [Jd As]
Pvsx.: folds 
RICKA16: raises $2 to $3
CAJUN890: folds 
matiko09: raises $6.50 to $9.50
Jimy Tiltman: folds 
WDW3: folds 
lumen21: folds 
Zeeshka: folds 
wang19790906: folds 
RICKA16: folds 
Uncalled bet ($6.50) returned to matiko09
matiko09 collected $7.50 from pot
matiko09: doesn't show hand 
*** SUMMARY ***
Total pot $7.50 | Rake $0 
Seat 1: Pvsx. folded before Flop (didn't bet)
Seat 2: RICKA16 folded before Flop
Seat 3: CAJUN890 folded before Flop (didn't bet)
Seat 4: matiko09 collected ($7.50)
Seat 5: Jimy Tiltman folded before Flop (didn't bet)
Seat 6: WDW3 folded before Flop (didn't bet)
Seat 7: lumen21 (button) folded before Flop (didn't bet)
Seat 8: Zeeshka (small blind) folded before Flop
Seat 9: wang19790906 (big blind) folded before Flop





PokerStars Hand #150799740082:  Hold'em No Limit ($1/$2 USD) - 2016/03/23 13:43:14 CET [2016/03/23 8:43:14 ET]
Table 'Berbericia II' 9-max Seat #5 is the button
Seat 1: WDW3 ($209.05 in chips) 
Seat 2: Moszes360 ($221.52 in chips) 
Seat 3: Fish4trips ($221.02 in chips) 
Seat 4: bennetb77 ($94.56 in chips) 
Seat 5: darren1031 ($137 in chips) 
Seat 6: Charity86 ($158 in chips) 
Seat 8: matiko09 ($316.51 in chips) 
Seat 9: LVV-Bif ($304.90 in chips) 
Charity86: posts small blind $1
matiko09: posts big blind $2
*** HOLE CARDS ***
Dealt to matiko09 [3c 7c]
LVV-Bif: folds 
WDW3: folds 
Moszes360: folds 
Fish4trips: folds 
bennetb77: folds 
darren1031: folds 
Charity86: raises $3 to $5
matiko09: folds 
Uncalled bet ($3) returned to Charity86
Charity86 collected $4 from pot
*** SUMMARY ***
Total pot $4 | Rake $0 
Seat 1: WDW3 folded before Flop (didn't bet)
Seat 2: Moszes360 folded before Flop (didn't bet)
Seat 3: Fish4trips folded before Flop (didn't bet)
Seat 4: bennetb77 folded before Flop (didn't bet)
Seat 5: darren1031 (button) folded before Flop (didn't bet)
Seat 6: Charity86 (small blind) collected ($4)
Seat 8: matiko09 (big blind) folded before Flop
Seat 9: LVV-Bif folded before Flop (didn't bet)





PokerStars Hand #150799741394:  Hold'em No Limit (€0.25/€0.50 EUR) - 2016/03/23 13:43:16 CET [2016/03/23 8:43:16 ET]
Table 'Hesperia II' 9-max Seat #5 is the button
Seat 1: CAJUN890 (€54.09 in chips) 
Seat 2: dndngod (€51.44 in chips) 
Seat 3: IvanUrgant (€54.24 in chips) 
Seat 4: Zelenis (€21.15 in chips) 
Seat 5: Avrora-sp (€50 in chips) 
Seat 6: CvMCvMCvM (€50 in chips) 
Seat 7: matiko09 (€60.98 in chips) 
Seat 8: Ahangama (€50 in chips) 
Seat 9: Red_Warning (€50 in chips) 
CvMCvMCvM: posts small blind €0.25
matiko09: posts big blind €0.50
*** HOLE CARDS ***
Dealt to matiko09 [Js 8c]
Ahangama: folds 
Red_Warning: folds 
CAJUN890: folds 
dndngod: folds 
IvanUrgant: folds 
Zelenis: folds 
Avrora-sp: folds 
CvMCvMCvM: folds 
Uncalled bet (€0.25) returned to matiko09
matiko09 collected €0.50 from pot
matiko09: doesn't show hand 
*** SUMMARY ***
Total pot €0.50 | Rake €0 
Seat 1: CAJUN890 folded before Flop (didn't bet)
Seat 2: dndngod folded before Flop (didn't bet)
Seat 3: IvanUrgant folded before Flop (didn't bet)
Seat 4: Zelenis folded before Flop (didn't bet)
Seat 5: Avrora-sp (button) folded before Flop (didn't bet)
Seat 6: CvMCvMCvM (small blind) folded before Flop
Seat 7: matiko09 (big blind) collected (€0.50)
Seat 8: Ahangama folded before Flop (didn't bet)
Seat 9: Red_Warning folded before Flop (didn't bet)





PokerStars Hand #150799751311:  Hold'em No Limit ($1/$2 USD) - 2016/03/23 13:43:34 CET [2016/03/23 8:43:34 ET]
Table 'Herba II' 9-max Seat #2 is the button
Seat 1: matiko09 ($232.48 in chips) 
Seat 2: Moszes360 ($210.20 in chips) 
Seat 3: Cirilico ($163.60 in chips) 
Seat 4: DUkalisUA ($289.78 in chips) 
Seat 5: chippo boy ($250.91 in chips) 
Seat 6: WDW3 ($200 in chips) 
Seat 7: InsomniaRU ($216.42 in chips) 
Seat 8: The_red_area ($438.33 in chips) 
Seat 9: mrhighryza ($27.86 in chips) 
Cirilico: posts small blind $1
DUkalisUA: posts big blind $2
*** HOLE CARDS ***
Dealt to matiko09 [8c Ac]
chippo boy: folds 
WDW3: raises $3.60 to $5.60
InsomniaRU: folds 
The_red_area: calls $5.60
mrhighryza: calls $5.60
matiko09: folds 
Moszes360: folds 
Cirilico: folds 
DUkalisUA: folds 
*** FLOP *** [5h 8h Kd]
WDW3: checks 
The_red_area: checks 
mrhighryza: bets $22.26 and is all-in
WDW3: folds 
The_red_area: folds 
Uncalled bet ($22.26) returned to mrhighryza
mrhighryza collected $18.91 from pot
*** SUMMARY ***
Total pot $19.80 | Rake $0.89 
Board [5h 8h Kd]
Seat 1: matiko09 folded before Flop (didn't bet)
Seat 2: Moszes360 (button) folded before Flop (didn't bet)
Seat 3: Cirilico (small blind) folded before Flop
Seat 4: DUkalisUA (big blind) folded before Flop
Seat 5: chippo boy folded before Flop (didn't bet)
Seat 6: WDW3 folded on the Flop
Seat 7: InsomniaRU folded before Flop (didn't bet)
Seat 8: The_red_area folded on the Flop
Seat 9: mrhighryza collected ($18.91)





PokerStars Hand #150799755396:  Hold'em No Limit (€0.25/€0.50 EUR) - 2016/03/23 13:43:41 CET [2016/03/23 8:43:41 ET]
Table 'Palma II' 9-max Seat #4 is the button
Seat 1: Ahangama (€55.11 in chips) 
Seat 2: matiko09 (€50 in chips) 
Seat 3: ardo888 (€51.79 in chips) 
Seat 4: dndngod (€68.52 in chips) 
Seat 5: SVFB13 (€49.50 in chips) 
Seat 7: Kuca :P (€50 in chips) 
Seat 8: CvMCvMCvM (€51.77 in chips) 
Seat 9: ZonTTT (€50 in chips) 
SVFB13: posts small blind €0.25
Red_Warning: is sitting out 
Kuca :P: posts big blind €0.50
*** HOLE CARDS ***
Dealt to matiko09 [4d Td]
Red_Warning leaves the table
CvMCvMCvM: folds 
ZonTTT: folds 
Ahangama: folds 
CAJUN890 joins the table at seat #6 
matiko09: folds 
ardo888: folds 
dndngod: raises €0.50 to €1
SVFB13: folds 
Kuca :P: folds 
Uncalled bet (€0.50) returned to dndngod
dndngod collected €1.25 from pot
dndngod: doesn't show hand 
*** SUMMARY ***
Total pot €1.25 | Rake €0 
Seat 1: Ahangama folded before Flop (didn't bet)
Seat 2: matiko09 folded before Flop (didn't bet)
Seat 3: ardo888 folded before Flop (didn't bet)
Seat 4: dndngod (button) collected (€1.25)
Seat 5: SVFB13 (small blind) folded before Flop
Seat 7: Kuca :P (big blind) folded before Flop
Seat 8: CvMCvMCvM folded before Flop (didn't bet)
Seat 9: ZonTTT folded before Flop (didn't bet)





PokerStars Hand #150799759606:  Hold'em No Limit (€0.25/€0.50 EUR) - 2016/03/23 13:43:49 CET [2016/03/23 8:43:49 ET]
Table 'Hesperia II' 9-max Seat #6 is the button
Seat 1: CAJUN890 (€54.09 in chips) 
Seat 2: dndngod (€51.44 in chips) 
Seat 3: IvanUrgant (€54.24 in chips) 
Seat 4: Zelenis (€21.15 in chips) 
Seat 5: Avrora-sp (€50 in chips) 
Seat 6: CvMCvMCvM (€50 in chips) 
Seat 7: matiko09 (€61.23 in chips) 
Seat 8: Ahangama (€50 in chips) 
Seat 9: Red_Warning (€50 in chips) 
matiko09: posts small blind €0.25
Ahangama: posts big blind €0.50
*** HOLE CARDS ***
Dealt to matiko09 [8h 9d]
Red_Warning: folds 
CAJUN890: raises €1.50 to €2
dndngod: folds 
IvanUrgant: folds 
Zelenis: folds 
Avrora-sp: folds 
CvMCvMCvM: folds 
matiko09: folds 
Ahangama: folds 
Uncalled bet (€1.50) returned to CAJUN890
CAJUN890 collected €1.25 from pot
CAJUN890: doesn't show hand 
*** SUMMARY ***
Total pot €1.25 | Rake €0 
Seat 1: CAJUN890 collected (€1.25)
Seat 2: dndngod folded before Flop (didn't bet)
Seat 3: IvanUrgant folded before Flop (didn't bet)
Seat 4: Zelenis folded before Flop (didn't bet)
Seat 5: Avrora-sp folded before Flop (didn't bet)
Seat 6: CvMCvMCvM (button) folded before Flop (didn't bet)
Seat 7: matiko09 (small blind) folded before Flop
Seat 8: Ahangama (big blind) folded before Flop
Seat 9: Red_Warning folded before Flop (didn't bet)





PokerStars Hand #150799759888:  Hold'em No Limit ($1/$2 USD) - 2016/03/23 13:43:50 CET [2016/03/23 8:43:50 ET]
Table 'Berbericia II' 9-max Seat #6 is the button
Seat 1: WDW3 ($209.05 in chips) 
Seat 2: Moszes360 ($221.52 in chips) 
Seat 3: Fish4trips ($221.02 in chips) 
Seat 4: bennetb77 ($94.56 in chips) 
Seat 5: darren1031 ($137 in chips) 
Seat 6: Charity86 ($160 in chips) 
Seat 8: matiko09 ($314.51 in chips) 
Seat 9: LVV-Bif ($304.90 in chips) 
matiko09: posts small blind $1
LVV-Bif: posts big blind $2
*** HOLE CARDS ***
Dealt to matiko09 [Ks 3d]
WDW3: folds 
Moszes360: folds 
Fish4trips: folds 
bennetb77: folds 
darren1031: calls $2
Charity86: raises $6 to $8
matiko09: folds 
LVV-Bif: calls $6
darren1031: calls $6
*** FLOP *** [Qc 5h 3s]
LVV-Bif: checks 
darren1031: checks 
Charity86: checks 
*** TURN *** [Qc 5h 3s] [7h]
LVV-Bif: checks 
darren1031: checks 
Charity86: bets $16
LVV-Bif: folds 
darren1031: folds 
Uncalled bet ($16) returned to Charity86
Charity86 collected $23.88 from pot
*** SUMMARY ***
Total pot $25 | Rake $1.12 
Board [Qc 5h 3s 7h]
Seat 1: WDW3 folded before Flop (didn't bet)
Seat 2: Moszes360 folded before Flop (didn't bet)
Seat 3: Fish4trips folded before Flop (didn't bet)
Seat 4: bennetb77 folded before Flop (didn't bet)
Seat 5: darren1031 folded on the Turn
Seat 6: Charity86 (button) collected ($23.88)
Seat 8: matiko09 (small blind) folded before Flop
Seat 9: LVV-Bif (big blind) folded on the Turn





PokerStars Hand #150799760234:  Hold'em No Limit ($0.50/$1.00 USD) - 2016/03/23 13:43:50 CET [2016/03/23 8:43:50 ET]
Table 'Smiley' 9-max Seat #9 is the button
Seat 1: WDW3 ($100 in chips) 
Seat 2: Jimy Tiltman ($105.48 in chips) 
Seat 3: matiko09 ($105.98 in chips) 
Seat 4: Zeeshka ($148.42 in chips) 
Seat 5: DUkalisUA ($100 in chips) 
Seat 6: blackmont111 ($57.36 in chips) 
Seat 8: RICKA16 ($111 in chips) 
Seat 9: morosun ($161.36 in chips) 
WDW3: posts small blind $0.50
Jimy Tiltman: posts big blind $1
Moszes360: sits out 
*** HOLE CARDS ***
Dealt to matiko09 [Td 6h]
matiko09 has timed out
matiko09: folds 
Zeeshka: folds 
DUkalisUA: folds 
blackmont111: folds 
RICKA16: raises $2 to $3
morosun: folds 
WDW3: raises $7 to $10
Jimy Tiltman: calls $9
RICKA16: folds 
*** FLOP *** [Kh 7d 8h]
WDW3: bets $11
Jimy Tiltman: folds 
Uncalled bet ($11) returned to WDW3
WDW3 collected $21.96 from pot
WDW3: doesn't show hand 
*** SUMMARY ***
Total pot $23 | Rake $1.04 
Board [Kh 7d 8h]
Seat 1: WDW3 (small blind) collected ($21.96)
Seat 2: Jimy Tiltman (big blind) folded on the Flop
Seat 3: matiko09 folded before Flop (didn't bet)
Seat 4: Zeeshka folded before Flop (didn't bet)
Seat 5: DUkalisUA folded before Flop (didn't bet)
Seat 6: blackmont111 folded before Flop (didn't bet)
Seat 8: RICKA16 folded before Flop
Seat 9: morosun (button) folded before Flop (didn't bet)





PokerStars Hand #150799764146:  Hold'em No Limit ($0.50/$1.00 USD) - 2016/03/23 13:43:57 CET [2016/03/23 8:43:57 ET]
Table 'Oljato' 9-max Seat #9 is the button
Seat 1: xHourglass ($114.76 in chips) 
Seat 2: roman134679 ($41.58 in chips) 
Seat 3: DUkalisUA ($100 in chips) 
Seat 4: Pvsx. ($141.10 in chips) 
Seat 5: ryo728 ($92.45 in chips) 
Seat 6: WDW3 ($117.11 in chips) 
Seat 7: matiko09 ($158.59 in chips) 
Seat 8: Zeeshka ($341.34 in chips) 
Seat 9: Jimy Tiltman ($110.06 in chips) 
xHourglass: posts small blind $0.50
roman134679: posts big blind $1
*** HOLE CARDS ***
Dealt to matiko09 [4d Ac]
DUkalisUA: folds 
Pvsx.: folds 
ryo728: folds 
WDW3: folds 
matiko09: folds 
Zeeshka: folds 
Jimy Tiltman: folds 
xHourglass: folds 
Uncalled bet ($0.50) returned to roman134679
roman134679 collected $1 from pot
*** SUMMARY ***
Total pot $1 | Rake $0 
Seat 1: xHourglass (small blind) folded before Flop
Seat 2: roman134679 (big blind) collected ($1)
Seat 3: DUkalisUA folded before Flop (didn't bet)
Seat 4: Pvsx. folded before Flop (didn't bet)
Seat 5: ryo728 folded before Flop (didn't bet)
Seat 6: WDW3 folded before Flop (didn't bet)
Seat 7: matiko09 folded before Flop (didn't bet)
Seat 8: Zeeshka folded before Flop (didn't bet)
Seat 9: Jimy Tiltman (button) folded before Flop (didn't bet)





PokerStars Hand #150799764364:  Hold'em No Limit ($0.50/$1.00 USD) - 2016/03/23 13:43:58 CET [2016/03/23 8:43:58 ET]
Table 'Kippes' 9-max Seat #8 is the button
Seat 1: Pvsx. ($103 in chips) 
Seat 2: RICKA16 ($124.63 in chips) 
Seat 3: CAJUN890 ($129.31 in chips) 
Seat 4: matiko09 ($118.22 in chips) 
Seat 5: Jimy Tiltman ($112.36 in chips) 
Seat 6: WDW3 ($106.54 in chips) 
Seat 7: lumen21 ($100 in chips) 
Seat 8: Zeeshka ($117.80 in chips) 
Seat 9: wang19790906 ($81.17 in chips) 
wang19790906: posts small blind $0.50
Pvsx.: posts big blind $1
*** HOLE CARDS ***
Dealt to matiko09 [3d Qc]
RICKA16: folds 
CAJUN890: folds 
matiko09: folds 
Jimy Tiltman: folds 
WDW3: folds 
lumen21: folds 
Zeeshka: folds 
wang19790906: raises $2 to $3
Pvsx.: folds 
Uncalled bet ($2) returned to wang19790906
wang19790906 collected $2 from pot
*** SUMMARY ***
Total pot $2 | Rake $0 
Seat 1: Pvsx. (big blind) folded before Flop
Seat 2: RICKA16 folded before Flop (didn't bet)
Seat 3: CAJUN890 folded before Flop (didn't bet)
Seat 4: matiko09 folded before Flop (didn't bet)
Seat 5: Jimy Tiltman folded before Flop (didn't bet)
Seat 6: WDW3 folded before Flop (didn't bet)
Seat 7: lumen21 folded before Flop (didn't bet)
Seat 8: Zeeshka (button) folded before Flop (didn't bet)
Seat 9: wang19790906 (small blind) collected ($2)





PokerStars Hand #150799765138:  Hold'em No Limit ($0.25/$0.50 USD) - 2016/03/23 13:43:59 CET [2016/03/23 8:43:59 ET]
Table 'Belnika' 9-max Seat #1 is the button
Seat 1: yellowfever0 ($28.66 in chips) 
Seat 2: NeverRegret7 ($55.49 in chips) 
Seat 3: ChiChioChi ($21.04 in chips) 
Seat 4: matiko09 ($71.10 in chips) 
Seat 6: Ahangama ($65.50 in chips) 
Seat 7: Zeeshka ($50 in chips) 
Seat 8: lumen21 ($67.39 in chips) 
Seat 9: dndngod ($82.45 in chips) 
NeverRegret7: posts small blind $0.25
ChiChioChi: posts big blind $0.50
IvanUrgant: sits out 
*** HOLE CARDS ***
Dealt to matiko09 [Td Kd]
matiko09: raises $1 to $1.50
Ahangama: calls $1.50
Zeeshka: folds 
lumen21: folds 
dndngod: folds 
yellowfever0: calls $1.50
NeverRegret7: folds 
ChiChioChi: folds 
*** FLOP *** [7d 8s Qs]
matiko09: checks 
Ahangama: checks 
yellowfever0: bets $2.50
matiko09: folds 
Ahangama: folds 
Uncalled bet ($2.50) returned to yellowfever0
yellowfever0 collected $5.01 from pot
*** SUMMARY ***
Total pot $5.25 | Rake $0.24 
Board [7d 8s Qs]
Seat 1: yellowfever0 (button) collected ($5.01)
Seat 2: NeverRegret7 (small blind) folded before Flop
Seat 3: ChiChioChi (big blind) folded before Flop
Seat 4: matiko09 folded on the Flop
Seat 6: Ahangama folded on the Flop
Seat 7: Zeeshka folded before Flop (didn't bet)
Seat 8: lumen21 folded before Flop (didn't bet)
Seat 9: dndngod folded before Flop (didn't bet)





PokerStars Hand #150799772815:  Hold'em No Limit ($0.50/$1.00 USD) - 2016/03/23 13:44:13 CET [2016/03/23 8:44:13 ET]
Table 'Atlantis' 9-max Seat #4 is the button
Seat 1: xHourglass ($160.28 in chips) 
Seat 2: tffff2006 ($22.86 in chips) 
Seat 3: CAJUN890 ($118.10 in chips) 
Seat 4: matiko09 ($109.64 in chips) 
Seat 5: Pvsx. ($100.50 in chips) 
Seat 6: Jimy Tiltman ($111.74 in chips) 
Seat 7: Zeeshka ($137.18 in chips) 
Seat 8: DUkalisUA ($100 in chips) 
Seat 9: WDW3 ($124.26 in chips) 
Pvsx.: posts small blind $0.50
Jimy Tiltman: posts big blind $1
*** HOLE CARDS ***
Dealt to matiko09 [Ah As]
Zeeshka: folds 
DUkalisUA: raises $2 to $3
WDW3: folds 
xHourglass: folds 
tffff2006: folds 
CAJUN890: calls $3
matiko09: raises $8 to $11
Pvsx.: folds 
Jimy Tiltman: folds 
DUkalisUA: folds 
CAJUN890: calls $8
*** FLOP *** [8h 9s 2c]
CAJUN890: checks 
matiko09: bets $14
CAJUN890: folds 
Uncalled bet ($14) returned to matiko09
matiko09 collected $25.31 from pot
matiko09: doesn't show hand 
*** SUMMARY ***
Total pot $26.50 | Rake $1.19 
Board [8h 9s 2c]
Seat 1: xHourglass folded before Flop (didn't bet)
Seat 2: tffff2006 folded before Flop (didn't bet)
Seat 3: CAJUN890 folded on the Flop
Seat 4: matiko09 (button) collected ($25.31)
Seat 5: Pvsx. (small blind) folded before Flop
Seat 6: Jimy Tiltman (big blind) folded before Flop
Seat 7: Zeeshka folded before Flop (didn't bet)
Seat 8: DUkalisUA folded before Flop
Seat 9: WDW3 folded before Flop (didn't bet)





PokerStars Hand #150799778797:  Hold'em No Limit ($0.50/$1.00 USD) - 2016/03/23 13:44:24 CET [2016/03/23 8:44:24 ET]
Table 'Oljato' 9-max Seat #1 is the button
Seat 1: xHourglass ($114.26 in chips) 
Seat 2: roman134679 ($42.08 in chips) 
Seat 3: DUkalisUA ($100 in chips) 
Seat 4: Pvsx. ($141.10 in chips) 
Seat 5: ryo728 ($92.45 in chips) 
Seat 6: WDW3 ($117.11 in chips) 
Seat 7: matiko09 ($158.59 in chips) 
Seat 8: Zeeshka ($341.34 in chips) 
Seat 9: Jimy Tiltman ($110.06 in chips) 
roman134679: posts small blind $0.50
DUkalisUA: posts big blind $1
*** HOLE CARDS ***
Dealt to matiko09 [As 3d]
Pvsx.: folds 
ryo728: folds 
WDW3: folds 
matiko09: folds 
Zeeshka: folds 
Jimy Tiltman: folds 
xHourglass: raises $1.50 to $2.50
roman134679: calls $2
DUkalisUA: calls $1.50
*** FLOP *** [4s 7s Kc]
roman134679: bets $1.03
DUkalisUA: raises $4.47 to $5.50
xHourglass: folds 
roman134679: calls $4.47
*** TURN *** [4s 7s Kc] [Qs]
roman134679: bets $1.03
DUkalisUA: raises $5.47 to $6.50
roman134679: calls $5.47
*** RIVER *** [4s 7s Kc Qs] [2h]
roman134679: bets $4.33
DUkalisUA: calls $4.33
*** SHOW DOWN ***
roman134679: shows [2c 4c] (two pair, Fours and Deuces)
DUkalisUA: mucks hand 
roman134679 collected $38.35 from pot
*** SUMMARY ***
Total pot $40.16 | Rake $1.81 
Board [4s 7s Kc Qs 2h]
Seat 1: xHourglass (button) folded on the Flop
Seat 2: roman134679 (small blind) showed [2c 4c] and won ($38.35) with two pair, Fours and Deuces
Seat 3: DUkalisUA (big blind) mucked [Jc Kd]
Seat 4: Pvsx. folded before Flop (didn't bet)
Seat 5: ryo728 folded before Flop (didn't bet)
Seat 6: WDW3 folded before Flop (didn't bet)
Seat 7: matiko09 folded before Flop (didn't bet)
Seat 8: Zeeshka folded before Flop (didn't bet)
Seat 9: Jimy Tiltman folded before Flop (didn't bet)





PokerStars Hand #150799780693:  Hold'em No Limit (€0.25/€0.50 EUR) - 2016/03/23 13:44:27 CET [2016/03/23 8:44:27 ET]
Table 'Hesperia II' 9-max Seat #7 is the button
Seat 1: CAJUN890 (€54.84 in chips) 
Seat 2: dndngod (€51.44 in chips) 
Seat 3: IvanUrgant (€54.24 in chips) 
Seat 4: Zelenis (€21.15 in chips) 
Seat 5: Avrora-sp (€50 in chips) 
Seat 6: CvMCvMCvM (€50 in chips) 
Seat 7: matiko09 (€60.98 in chips) 
Seat 8: Ahangama (€50 in chips) 
Seat 9: Red_Warning (€50 in chips) 
Ahangama: posts small blind €0.25
Red_Warning: posts big blind €0.50
*** HOLE CARDS ***
Dealt to matiko09 [Ad 8d]
CAJUN890: raises €2.50 to €3
dndngod: folds 
IvanUrgant: folds 
Zelenis: folds 
Avrora-sp: folds 
CvMCvMCvM: folds 
matiko09: folds 
Ahangama: folds 
Red_Warning: folds 
Uncalled bet (€2.50) returned to CAJUN890
CAJUN890 collected €1.25 from pot
CAJUN890: doesn't show hand 
*** SUMMARY ***
Total pot €1.25 | Rake €0 
Seat 1: CAJUN890 collected (€1.25)
Seat 2: dndngod folded before Flop (didn't bet)
Seat 3: IvanUrgant folded before Flop (didn't bet)
Seat 4: Zelenis folded before Flop (didn't bet)
Seat 5: Avrora-sp folded before Flop (didn't bet)
Seat 6: CvMCvMCvM folded before Flop (didn't bet)
Seat 7: matiko09 (button) folded before Flop (didn't bet)
Seat 8: Ahangama (small blind) folded before Flop
Seat 9: Red_Warning (big blind) folded before Flop





PokerStars Hand #150799782647:  Hold'em No Limit ($1/$2 USD) - 2016/03/23 13:44:31 CET [2016/03/23 8:44:31 ET]
Table 'Kiess' 9-max Seat #3 is the button
Seat 1: Cirilico ($161.78 in chips) 
Seat 2: DUkalisUA ($479.57 in chips) 
Seat 3: The_red_area ($376.82 in chips) 
Seat 4: Moszes360 ($204 in chips) 
Seat 5: chippo boy ($286.82 in chips) 
Seat 6: matiko09 ($300.84 in chips) 
Seat 7: InsomniaRU ($276.17 in chips) 
Seat 8: WDW3 ($378.42 in chips) 
Seat 9: Fish4trips ($214.55 in chips) 
Moszes360: posts small blind $1
chippo boy: posts big blind $2
*** HOLE CARDS ***
Dealt to matiko09 [4d Tc]
matiko09: folds 
InsomniaRU: folds 
WDW3: folds 
Fish4trips: folds 
Cirilico: folds 
DUkalisUA: folds 
The_red_area: folds 
Moszes360: folds 
Uncalled bet ($1) returned to chippo boy
chippo boy collected $2 from pot
*** SUMMARY ***
Total pot $2 | Rake $0 
Seat 1: Cirilico folded before Flop (didn't bet)
Seat 2: DUkalisUA folded before Flop (didn't bet)
Seat 3: The_red_area (button) folded before Flop (didn't bet)
Seat 4: Moszes360 (small blind) folded before Flop
Seat 5: chippo boy (big blind) collected ($2)
Seat 6: matiko09 folded before Flop (didn't bet)
Seat 7: InsomniaRU folded before Flop (didn't bet)
Seat 8: WDW3 folded before Flop (didn't bet)
Seat 9: Fish4trips folded before Flop (didn't bet)





PokerStars Hand #150799784879:  Hold'em No Limit ($0.25/$0.50 USD) - 2016/03/23 13:44:35 CET [2016/03/23 8:44:35 ET]
Table 'Pyrrhus' 9-max Seat #3 is the button
Seat 1: lumen21 ($50 in chips) 
Seat 3: IvanUrgant ($85.07 in chips) 
Seat 4: GriffinBerg ($15.34 in chips) 
Seat 5: Moszes360 ($50 in chips) 
Seat 7: matiko09 ($128.51 in chips) 
Seat 8: dndngod ($58.97 in chips) 
Seat 9: CvMCvMCvM ($111.16 in chips) 
GriffinBerg: posts small blind $0.25
Moszes360: posts big blind $0.50
whalldo: sits out 
Zeeshka: sits out 
*** HOLE CARDS ***
Dealt to matiko09 [Qd 7d]
matiko09: folds 
dndngod: folds 
CvMCvMCvM: folds 
lumen21: raises $0.75 to $1.25
IvanUrgant: folds 
GriffinBerg: calls $1
Moszes360: raises $3.75 to $5
lumen21: folds 
GriffinBerg: folds 
Uncalled bet ($3.75) returned to Moszes360
Moszes360 collected $3.75 from pot
Moszes360: doesn't show hand 
*** SUMMARY ***
Total pot $3.75 | Rake $0 
Seat 1: lumen21 folded before Flop
Seat 3: IvanUrgant (button) folded before Flop (didn't bet)
Seat 4: GriffinBerg (small blind) folded before Flop
Seat 5: Moszes360 (big blind) collected ($3.75)
Seat 7: matiko09 folded before Flop (didn't bet)
Seat 8: dndngod folded before Flop (didn't bet)
Seat 9: CvMCvMCvM folded before Flop (didn't bet)





PokerStars Hand #150799787977:  Hold'em No Limit ($1/$2 USD) - 2016/03/23 13:44:40 CET [2016/03/23 8:44:40 ET]
Table 'Kypria II' 9-max Seat #6 is the button
Seat 1: geldwolfje ($242.15 in chips) 
Seat 2: coinflip_si ($200 in chips) 
Seat 3: seouljam ($205.73 in chips) 
Seat 4: nailz83 ($126.09 in chips) 
Seat 5: InsomniaRU ($348.62 in chips) 
Seat 6: matiko09 ($200 in chips) 
Seat 7: DUkalisUA ($200 in chips) 
Seat 8: Fish4trips ($293.59 in chips) 
Seat 9: WDW3 ($200.42 in chips) 
DUkalisUA: posts small blind $1
Fish4trips: posts big blind $2
*** HOLE CARDS ***
Dealt to matiko09 [5h 6c]
WDW3: folds 
geldwolfje: folds 
coinflip_si: folds 
seouljam: folds 
nailz83: raises $4 to $6
InsomniaRU: folds 
matiko09: folds 
DUkalisUA: folds 
Fish4trips: calls $4
*** FLOP *** [4c Tc 2h]
Fish4trips: checks 
nailz83: bets $8
Fish4trips: calls $8
*** TURN *** [4c Tc 2h] [Ad]
Fish4trips: checks 
nailz83: bets $14
Fish4trips: raises $28 to $42
nailz83: calls $28
*** RIVER *** [4c Tc 2h Ad] [Qd]
Fish4trips: bets $237.59 and is all-in
nailz83: folds [Ah]
Uncalled bet ($237.59) returned to Fish4trips
Fish4trips collected $110.20 from pot
Fish4trips: doesn't show hand 
*** SUMMARY ***
Total pot $113 | Rake $2.80 
Board [4c Tc 2h Ad Qd]
Seat 1: geldwolfje folded before Flop (didn't bet)
Seat 2: coinflip_si folded before Flop (didn't bet)
Seat 3: seouljam folded before Flop (didn't bet)
Seat 4: nailz83 folded on the River
Seat 5: InsomniaRU folded before Flop (didn't bet)
Seat 6: matiko09 (button) folded before Flop (didn't bet)
Seat 7: DUkalisUA (small blind) folded before Flop
Seat 8: Fish4trips (big blind) collected ($110.20)
Seat 9: WDW3 folded before Flop (didn't bet)





PokerStars Hand #150799788694:  Hold'em No Limit ($1/$2 USD) - 2016/03/23 13:44:41 CET [2016/03/23 8:44:41 ET]
Table 'Herba II' 9-max Seat #3 is the button
Seat 1: matiko09 ($232.48 in chips) 
Seat 2: Moszes360 ($210.20 in chips) 
Seat 3: Cirilico ($162.60 in chips) 
Seat 4: DUkalisUA ($287.78 in chips) 
Seat 5: chippo boy ($250.91 in chips) 
Seat 6: WDW3 ($200 in chips) 
Seat 7: InsomniaRU ($216.42 in chips) 
Seat 8: The_red_area ($432.73 in chips) 
Seat 9: mrhighryza ($41.17 in chips) 
DUkalisUA: posts small blind $1
chippo boy: posts big blind $2
*** HOLE CARDS ***
Dealt to matiko09 [Jc Ah]
WDW3: raises $3.60 to $5.60
InsomniaRU: folds 
The_red_area: folds 
mrhighryza: folds 
matiko09: folds 
Moszes360: folds 
Cirilico: folds 
DUkalisUA: folds 
chippo boy: calls $3.60
*** FLOP *** [Td 9h 6d]
chippo boy: checks 
WDW3: bets $8
chippo boy: calls $8
*** TURN *** [Td 9h 6d] [Qc]
chippo boy: checks 
WDW3: bets $20
chippo boy: folds 
Uncalled bet ($20) returned to WDW3
WDW3 collected $26.93 from pot
WDW3: doesn't show hand 
*** SUMMARY ***
Total pot $28.20 | Rake $1.27 
Board [Td 9h 6d Qc]
Seat 1: matiko09 folded before Flop (didn't bet)
Seat 2: Moszes360 folded before Flop (didn't bet)
Seat 3: Cirilico (button) folded before Flop (didn't bet)
Seat 4: DUkalisUA (small blind) folded before Flop
Seat 5: chippo boy (big blind) folded on the Turn
Seat 6: WDW3 collected ($26.93)
Seat 7: InsomniaRU folded before Flop (didn't bet)
Seat 8: The_red_area folded before Flop (didn't bet)
Seat 9: mrhighryza folded before Flop (didn't bet)





PokerStars Hand #150799791496:  Hold'em No Limit (€0.25/€0.50 EUR) - 2016/03/23 13:44:46 CET [2016/03/23 8:44:46 ET]
Table 'Palma II' 9-max Seat #5 is the button
Seat 2: matiko09 (€50 in chips) 
Seat 3: ardo888 (€51.79 in chips) 
Seat 4: dndngod (€69.27 in chips) 
Seat 5: SVFB13 (€49.25 in chips) 
Seat 7: Kuca :P (€50 in chips) 
CAJUN890 will be allowed to play after the button
Kuca :P: posts small blind €0.25
CvMCvMCvM: is sitting out 
ZonTTT: is sitting out 
Ahangama: is sitting out 
matiko09: posts big blind €0.50
*** HOLE CARDS ***
Dealt to matiko09 [Jd 5d]
ardo888: folds 
ZonTTT leaves the table
Ahangama leaves the table
dndngod: raises €0.75 to €1.25
Red_Warning joins the table at seat #9 
SVFB13: folds 
Kuca :P: folds 
matiko09: folds 
Uncalled bet (€0.75) returned to dndngod
dndngod collected €1.25 from pot
*** SUMMARY ***
Total pot €1.25 | Rake €0 
Seat 2: matiko09 (big blind) folded before Flop
Seat 3: ardo888 folded before Flop (didn't bet)
Seat 4: dndngod collected (€1.25)
Seat 5: SVFB13 (button) folded before Flop (didn't bet)
Seat 7: Kuca :P (small blind) folded before Flop





PokerStars Hand #150799799573:  Hold'em No Limit ($0.50/$1.00 USD) - 2016/03/23 13:45:01 CET [2016/03/23 8:45:01 ET]
Table 'Kippes' 9-max Seat #9 is the button
Seat 1: Pvsx. ($102 in chips) 
Seat 2: RICKA16 ($124.63 in chips) 
Seat 3: CAJUN890 ($129.31 in chips) 
Seat 4: matiko09 ($118.22 in chips) 
Seat 5: Jimy Tiltman ($112.36 in chips) 
Seat 6: WDW3 ($106.54 in chips) 
Seat 7: lumen21 ($100 in chips) 
Seat 8: Zeeshka ($117.80 in chips) 
Seat 9: wang19790906 ($82.17 in chips) 
Pvsx.: posts small blind $0.50
RICKA16: posts big blind $1
*** HOLE CARDS ***
Dealt to matiko09 [Jd Kh]
CAJUN890: folds 
matiko09: folds 
Jimy Tiltman: folds 
WDW3: folds 
lumen21: folds 
Zeeshka: folds 
wang19790906: folds 
Pvsx.: folds 
Uncalled bet ($0.50) returned to RICKA16
RICKA16 collected $1 from pot
RICKA16: doesn't show hand 
*** SUMMARY ***
Total pot $1 | Rake $0 
Seat 1: Pvsx. (small blind) folded before Flop
Seat 2: RICKA16 (big blind) collected ($1)
Seat 3: CAJUN890 folded before Flop (didn't bet)
Seat 4: matiko09 folded before Flop (didn't bet)
Seat 5: Jimy Tiltman folded before Flop (didn't bet)
Seat 6: WDW3 folded before Flop (didn't bet)
Seat 7: lumen21 folded before Flop (didn't bet)
Seat 8: Zeeshka folded before Flop (didn't bet)
Seat 9: wang19790906 (button) folded before Flop (didn't bet)





PokerStars Hand #150799799508:  Hold'em No Limit ($0.50/$1.00 USD) - 2016/03/23 13:45:01 CET [2016/03/23 8:45:01 ET]
Table 'Merope II' 9-max Seat #5 is the button
Seat 1: Jimy Tiltman ($100 in chips) 
Seat 2: Zeeshka ($100 in chips) 
Seat 3: Sherlockplay ($100 in chips) 
Seat 4: YuriiSolodya ($30.50 in chips) 
Seat 5: DUkalisUA ($109.60 in chips) 
Seat 6: rebelTC ($79 in chips) 
Seat 7: matiko09 ($100 in chips) 
Seat 8: titentei ($100 in chips) 
Seat 9: RICKA16 ($100 in chips) 
rebelTC: posts small blind $0.50
matiko09: posts big blind $1
*** HOLE CARDS ***
Dealt to matiko09 [4h Jh]
titentei: folds 
RICKA16: folds 
Jimy Tiltman: folds 
Zeeshka: raises $2 to $3
Sherlockplay: folds 
YuriiSolodya: folds 
DUkalisUA: folds 
rebelTC: folds 
matiko09: folds 
Uncalled bet ($2) returned to Zeeshka
Zeeshka collected $2.50 from pot
Zeeshka: doesn't show hand 
*** SUMMARY ***
Total pot $2.50 | Rake $0 
Seat 1: Jimy Tiltman folded before Flop (didn't bet)
Seat 2: Zeeshka collected ($2.50)
Seat 3: Sherlockplay folded before Flop (didn't bet)
Seat 4: YuriiSolodya folded before Flop (didn't bet)
Seat 5: DUkalisUA (button) folded before Flop (didn't bet)
Seat 6: rebelTC (small blind) folded before Flop
Seat 7: matiko09 (big blind) folded before Flop
Seat 8: titentei folded before Flop (didn't bet)
Seat 9: RICKA16 folded before Flop (didn't bet)





PokerStars Hand #150799800414:  Hold'em No Limit ($1/$2 USD) - 2016/03/23 13:45:02 CET [2016/03/23 8:45:02 ET]
Table 'Kiess' 9-max Seat #4 is the button
Seat 1: Cirilico ($161.78 in chips) 
Seat 2: DUkalisUA ($479.57 in chips) 
Seat 3: The_red_area ($376.82 in chips) 
Seat 4: Moszes360 ($203 in chips) 
Seat 5: chippo boy ($287.82 in chips) 
Seat 6: matiko09 ($300.84 in chips) 
Seat 7: InsomniaRU ($276.17 in chips) 
Seat 8: WDW3 ($378.42 in chips) 
Seat 9: Fish4trips ($214.55 in chips) 
chippo boy: posts small blind $1
matiko09: posts big blind $2
*** HOLE CARDS ***
Dealt to matiko09 [7h Tc]
InsomniaRU: folds 
WDW3: folds 
Fish4trips: folds 
Cirilico: folds 
DUkalisUA: folds 
The_red_area: folds 
Moszes360: raises $4 to $6
chippo boy: calls $5
matiko09: folds 
*** FLOP *** [Qd 9d Ah]
chippo boy: checks 
Moszes360: checks 
*** TURN *** [Qd 9d Ah] [4h]
chippo boy: bets $6
Moszes360: calls $6
*** RIVER *** [Qd 9d Ah 4h] [3s]
chippo boy: bets $14
Moszes360: calls $14
*** SHOW DOWN ***
chippo boy: shows [5s 2s] (a straight, Ace to Five)
Moszes360: mucks hand 
chippo boy collected $51.57 from pot
*** SUMMARY ***
Total pot $54 | Rake $2.43 
Board [Qd 9d Ah 4h 3s]
Seat 1: Cirilico folded before Flop (didn't bet)
Seat 2: DUkalisUA folded before Flop (didn't bet)
Seat 3: The_red_area folded before Flop (didn't bet)
Seat 4: Moszes360 (button) mucked [Jh Qc]
Seat 5: chippo boy (small blind) showed [5s 2s] and won ($51.57) with a straight, Ace to Five
Seat 6: matiko09 (big blind) folded before Flop
Seat 7: InsomniaRU folded before Flop (didn't bet)
Seat 8: WDW3 folded before Flop (didn't bet)
Seat 9: Fish4trips folded before Flop (didn't bet)





PokerStars Hand #150799801648:  Hold'em No Limit ($0.25/$0.50 USD) - 2016/03/23 13:45:05 CET [2016/03/23 8:45:05 ET]
Table 'Belnika' 9-max Seat #2 is the button
Seat 1: yellowfever0 ($32.17 in chips) 
Seat 2: NeverRegret7 ($55.24 in chips) 
Seat 3: ChiChioChi ($20.54 in chips) 
Seat 4: matiko09 ($69.60 in chips) 
Seat 6: Ahangama ($64 in chips) 
Seat 7: Zeeshka ($50 in chips) 
Seat 8: lumen21 ($67.39 in chips) 
Seat 9: dndngod ($82.45 in chips) 
ChiChioChi: posts small blind $0.25
matiko09: posts big blind $0.50
IvanUrgant: sits out 
*** HOLE CARDS ***
Dealt to matiko09 [2d 3s]
Ahangama: folds 
Zeeshka: folds 
lumen21: folds 
dndngod: raises $1 to $1.50
yellowfever0: calls $1.50
NeverRegret7: folds 
ChiChioChi: calls $1.25
matiko09: folds 
*** FLOP *** [Th 8s 5h]
ChiChioChi: checks 
dndngod: checks 
yellowfever0: checks 
*** TURN *** [Th 8s 5h] [5c]
ChiChioChi: checks 
dndngod: bets $3
yellowfever0: folds 
ChiChioChi: calls $3
*** RIVER *** [Th 8s 5h 5c] [6s]
ChiChioChi: checks 
dndngod: bets $45.50
ChiChioChi: calls $16.04 and is all-in
Uncalled bet ($29.46) returned to dndngod
*** SHOW DOWN ***
dndngod: shows [9d 7d] (a straight, Six to Ten)
ChiChioChi: shows [Ts Tc] (a full house, Tens full of Fives)
ChiChioChi collected $41.14 from pot
*** SUMMARY ***
Total pot $43.08 | Rake $1.94 
Board [Th 8s 5h 5c 6s]
Seat 1: yellowfever0 folded on the Turn
Seat 2: NeverRegret7 (button) folded before Flop (didn't bet)
Seat 3: ChiChioChi (small blind) showed [Ts Tc] and won ($41.14) with a full house, Tens full of Fives
Seat 4: matiko09 (big blind) folded before Flop
Seat 6: Ahangama folded before Flop (didn't bet)
Seat 7: Zeeshka folded before Flop (didn't bet)
Seat 8: lumen21 folded before Flop (didn't bet)
Seat 9: dndngod showed [9d 7d] and lost with a straight, Six to Ten





PokerStars Hand #150799807731:  Hold'em No Limit ($0.50/$1.00 USD) - 2016/03/23 13:45:16 CET [2016/03/23 8:45:16 ET]
Table 'Smiley' 9-max Seat #1 is the button
Seat 1: WDW3 ($111.96 in chips) 
Seat 2: Jimy Tiltman ($100 in chips) 
Seat 3: matiko09 ($105.98 in chips) 
Seat 4: Zeeshka ($148.42 in chips) 
Seat 5: DUkalisUA ($100 in chips) 
Seat 6: blackmont111 ($57.36 in chips) 
Seat 8: RICKA16 ($108 in chips) 
Seat 9: morosun ($161.36 in chips) 
Jimy Tiltman: posts small blind $0.50
matiko09: posts big blind $1
Moszes360: sits out 
*** HOLE CARDS ***
Dealt to matiko09 [8h 9d]
Zeeshka: folds 
DUkalisUA has timed out
DUkalisUA: folds 
blackmont111: folds 
RICKA16: folds 
morosun: raises $2 to $3
WDW3: calls $3
morosun said, "zeeshka privet"
Jimy Tiltman: folds 
matiko09: folds 
*** FLOP *** [Ah Js 8c]
morosun: bets $3
WDW3: calls $3
*** TURN *** [Ah Js 8c] [Jd]
morosun: bets $3
WDW3: raises $15 to $18
morosun: folds 
Uncalled bet ($15) returned to WDW3
WDW3 collected $18.62 from pot
WDW3: doesn't show hand 
*** SUMMARY ***
Total pot $19.50 | Rake $0.88 
Board [Ah Js 8c Jd]
Seat 1: WDW3 (button) collected ($18.62)
Seat 2: Jimy Tiltman (small blind) folded before Flop
Seat 3: matiko09 (big blind) folded before Flop
Seat 4: Zeeshka folded before Flop (didn't bet)
Seat 5: DUkalisUA folded before Flop (didn't bet)
Seat 6: blackmont111 folded before Flop (didn't bet)
Seat 8: RICKA16 folded before Flop (didn't bet)
Seat 9: morosun folded on the Turn





PokerStars Hand #150799808867:  Hold'em No Limit (€0.25/€0.50 EUR) - 2016/03/23 13:45:18 CET [2016/03/23 8:45:18 ET]
Table 'Hesperia II' 9-max Seat #8 is the button
Seat 1: CAJUN890 (€55.59 in chips) 
Seat 2: dndngod (€51.44 in chips) 
Seat 3: IvanUrgant (€54.24 in chips) 
Seat 4: Zelenis (€21.15 in chips) 
Seat 5: Avrora-sp (€50 in chips) 
Seat 6: CvMCvMCvM (€50 in chips) 
Seat 7: matiko09 (€60.98 in chips) 
Seat 8: Ahangama (€50 in chips) 
Seat 9: Red_Warning (€50 in chips) 
Red_Warning: posts small blind €0.25
CAJUN890: posts big blind €0.50
*** HOLE CARDS ***
Dealt to matiko09 [6h 4d]
dndngod: folds 
IvanUrgant: raises €1 to €1.50
Zelenis: folds 
Avrora-sp: folds 
CvMCvMCvM: folds 
matiko09: folds 
Ahangama: raises €3 to €4.50
Red_Warning: folds 
CAJUN890: folds 
IvanUrgant: calls €3
*** FLOP *** [8c 9c 6s]
IvanUrgant: checks 
Ahangama: checks 
*** TURN *** [8c 9c 6s] [4h]
IvanUrgant: bets €5.20
Ahangama: folds 
Uncalled bet (€5.20) returned to IvanUrgant
IvanUrgant collected €9.31 from pot
IvanUrgant: doesn't show hand 
*** SUMMARY ***
Total pot €9.75 | Rake €0.44 
Board [8c 9c 6s 4h]
Seat 1: CAJUN890 (big blind) folded before Flop
Seat 2: dndngod folded before Flop (didn't bet)
Seat 3: IvanUrgant collected (€9.31)
Seat 4: Zelenis folded before Flop (didn't bet)
Seat 5: Avrora-sp folded before Flop (didn't bet)
Seat 6: CvMCvMCvM folded before Flop (didn't bet)
Seat 7: matiko09 folded before Flop (didn't bet)
Seat 8: Ahangama (button) folded on the Turn
Seat 9: Red_Warning (small blind) folded before Flop





PokerStars Hand #150799808951:  Hold'em No Limit (€0.25/€0.50 EUR) - 2016/03/23 13:45:18 CET [2016/03/23 8:45:18 ET]
Table 'Palma II' 9-max Seat #7 is the button
Seat 2: matiko09 (€50 in chips) 
Seat 3: ardo888 (€51.79 in chips) 
Seat 4: dndngod (€70.02 in chips) 
Seat 5: SVFB13 (€49.25 in chips) 
Seat 7: Kuca :P (€50 in chips) 
Red_Warning will be allowed to play after the button
matiko09: posts small blind €0.25
ardo888: posts big blind €0.50
CAJUN890: sits out 
*** HOLE CARDS ***
Dealt to matiko09 [7s 8d]
dndngod: folds 
SVFB13: folds 
Kuca :P: folds 
matiko09: folds 
Uncalled bet (€0.25) returned to ardo888
ardo888 collected €0.50 from pot
ardo888: doesn't show hand 
*** SUMMARY ***
Total pot €0.50 | Rake €0 
Seat 2: matiko09 (small blind) folded before Flop
Seat 3: ardo888 (big blind) collected (€0.50)
Seat 4: dndngod folded before Flop (didn't bet)
Seat 5: SVFB13 folded before Flop (didn't bet)
Seat 7: Kuca :P (button) folded before Flop (didn't bet)





PokerStars Hand #150799809600:  Hold'em No Limit ($0.25/$0.50 USD) - 2016/03/23 13:45:19 CET [2016/03/23 8:45:19 ET]
Table 'Pyrrhus' 9-max Seat #4 is the button
Seat 1: lumen21 ($50 in chips) 
Seat 3: IvanUrgant ($85.07 in chips) 
Seat 4: GriffinBerg ($14.09 in chips) 
Seat 5: Moszes360 ($52.50 in chips) 
Seat 6: whalldo ($162.72 in chips) 
Seat 7: matiko09 ($128.51 in chips) 
Seat 8: dndngod ($58.97 in chips) 
Seat 9: CvMCvMCvM ($111.16 in chips) 
Moszes360: posts small blind $0.25
whalldo: posts big blind $0.50
Zeeshka: sits out 
*** HOLE CARDS ***
Dealt to matiko09 [Ks Jd]
matiko09: folds 
dndngod: folds 
CvMCvMCvM: folds 
lumen21: folds 
IvanUrgant: raises $0.70 to $1.20
GriffinBerg: calls $1.20
Moszes360: folds 
whalldo: raises $4.80 to $6
IvanUrgant: folds 
GriffinBerg: folds 
Uncalled bet ($4.80) returned to whalldo
whalldo collected $3.85 from pot
whalldo: doesn't show hand 
*** SUMMARY ***
Total pot $3.85 | Rake $0 
Seat 1: lumen21 folded before Flop (didn't bet)
Seat 3: IvanUrgant folded before Flop
Seat 4: GriffinBerg (button) folded before Flop
Seat 5: Moszes360 (small blind) folded before Flop
Seat 6: whalldo (big blind) collected ($3.85)
Seat 7: matiko09 folded before Flop (didn't bet)
Seat 8: dndngod folded before Flop (didn't bet)
Seat 9: CvMCvMCvM folded before Flop (didn't bet)





PokerStars Hand #150799810701:  Hold'em No Limit ($0.50/$1.00 USD) - 2016/03/23 13:45:21 CET [2016/03/23 8:45:21 ET]
Table 'Atlantis' 9-max Seat #5 is the button
Seat 1: xHourglass ($160.28 in chips) 
Seat 2: tffff2006 ($22.86 in chips) 
Seat 3: CAJUN890 ($107.10 in chips) 
Seat 4: matiko09 ($123.95 in chips) 
Seat 5: Pvsx. ($100 in chips) 
Seat 6: Jimy Tiltman ($110.74 in chips) 
Seat 7: Zeeshka ($137.18 in chips) 
Seat 8: DUkalisUA ($100 in chips) 
Seat 9: WDW3 ($124.26 in chips) 
Jimy Tiltman: posts small blind $0.50
Zeeshka: posts big blind $1
*** HOLE CARDS ***
Dealt to matiko09 [3h 8s]
DUkalisUA: folds 
WDW3: folds 
xHourglass: folds 
tffff2006: calls $1
CAJUN890: folds 
matiko09: folds 
Pvsx.: folds 
Jimy Tiltman: raises $3.50 to $4.50
Zeeshka: raises $9.50 to $14
tffff2006: raises $8.86 to $22.86 and is all-in
Jimy Tiltman: folds 
Zeeshka: calls $8.86
*** FLOP *** [Th 5d Kh]
*** TURN *** [Th 5d Kh] [5h]
*** RIVER *** [Th 5d Kh 5h] [Js]
*** SHOW DOWN ***
Zeeshka: shows [As Qs] (a straight, Ten to Ace)
tffff2006: shows [Kc Ks] (a full house, Kings full of Fives)
tffff2006 collected $47.96 from pot
*** SUMMARY ***
Total pot $50.22 | Rake $2.26 
Board [Th 5d Kh 5h Js]
Seat 1: xHourglass folded before Flop (didn't bet)
Seat 2: tffff2006 showed [Kc Ks] and won ($47.96) with a full house, Kings full of Fives
Seat 3: CAJUN890 folded before Flop (didn't bet)
Seat 4: matiko09 folded before Flop (didn't bet)
Seat 5: Pvsx. (button) folded before Flop (didn't bet)
Seat 6: Jimy Tiltman (small blind) folded before Flop
Seat 7: Zeeshka (big blind) showed [As Qs] and lost with a straight, Ten to Ace
Seat 8: DUkalisUA folded before Flop (didn't bet)
Seat 9: WDW3 folded before Flop (didn't bet)





PokerStars Hand #150799813674:  Hold'em No Limit ($0.50/$1.00 USD) - 2016/03/23 13:45:26 CET [2016/03/23 8:45:26 ET]
Table 'Merope II' 9-max Seat #6 is the button
Seat 1: Jimy Tiltman ($100 in chips) 
Seat 2: Zeeshka ($101.50 in chips) 
Seat 3: Sherlockplay ($100 in chips) 
Seat 4: YuriiSolodya ($30.50 in chips) 
Seat 5: DUkalisUA ($109.60 in chips) 
Seat 6: rebelTC ($78.50 in chips) 
Seat 7: matiko09 ($100 in chips) 
Seat 8: titentei ($100 in chips) 
Seat 9: RICKA16 ($100 in chips) 
matiko09: posts small blind $0.50
titentei: posts big blind $1
*** HOLE CARDS ***
Dealt to matiko09 [6s 8h]
RICKA16: folds 
Jimy Tiltman: folds 
Zeeshka: folds 
Sherlockplay: folds 
YuriiSolodya: folds 
DUkalisUA: folds 
rebelTC: raises $1 to $2
matiko09: folds 
titentei: calls $1
*** FLOP *** [3d Ac 7s]
titentei: checks 
rebelTC: checks 
*** TURN *** [3d Ac 7s] [6h]
titentei: checks 
rebelTC: checks 
*** RIVER *** [3d Ac 7s 6h] [7h]
titentei: bets $1
rebelTC: calls $1
*** SHOW DOWN ***
titentei: shows [4c 8c] (a pair of Sevens)
rebelTC: shows [Qc Jh] (a pair of Sevens - Ace+Queen kicker)
rebelTC collected $6.21 from pot
*** SUMMARY ***
Total pot $6.50 | Rake $0.29 
Board [3d Ac 7s 6h 7h]
Seat 1: Jimy Tiltman folded before Flop (didn't bet)
Seat 2: Zeeshka folded before Flop (didn't bet)
Seat 3: Sherlockplay folded before Flop (didn't bet)
Seat 4: YuriiSolodya folded before Flop (didn't bet)
Seat 5: DUkalisUA folded before Flop (didn't bet)
Seat 6: rebelTC (button) showed [Qc Jh] and won ($6.21) with a pair of Sevens
Seat 7: matiko09 (small blind) folded before Flop
Seat 8: titentei (big blind) showed [4c 8c] and lost with a pair of Sevens
Seat 9: RICKA16 folded before Flop (didn't bet)





PokerStars Hand #150799819943:  Hold'em No Limit ($0.50/$1.00 USD) - 2016/03/23 13:45:38 CET [2016/03/23 8:45:38 ET]
Table 'Kippes' 9-max Seat #1 is the button
Seat 1: Pvsx. ($101.50 in chips) 
Seat 2: RICKA16 ($125.13 in chips) 
Seat 3: CAJUN890 ($129.31 in chips) 
Seat 4: matiko09 ($118.22 in chips) 
Seat 5: Jimy Tiltman ($112.36 in chips) 
Seat 6: WDW3 ($106.54 in chips) 
Seat 7: lumen21 ($100 in chips) 
Seat 8: Zeeshka ($117.80 in chips) 
Seat 9: wang19790906 ($82.17 in chips) 
RICKA16: posts small blind $0.50
CAJUN890: posts big blind $1
*** HOLE CARDS ***
Dealt to matiko09 [Kh Kc]
matiko09: raises $2 to $3
Jimy Tiltman: folds 
WDW3: calls $3
lumen21: folds 
Zeeshka: folds 
wang19790906: folds 
Pvsx.: folds 
RICKA16: folds 
CAJUN890: calls $2
*** FLOP *** [8d 2d 3h]
CAJUN890: checks 
matiko09: bets $6
WDW3: calls $6
CAJUN890: folds 
*** TURN *** [8d 2d 3h] [Ah]
matiko09: checks 
WDW3: bets $15.50
matiko09: folds 
Uncalled bet ($15.50) returned to WDW3
WDW3 collected $20.53 from pot
WDW3: doesn't show hand 
*** SUMMARY ***
Total pot $21.50 | Rake $0.97 
Board [8d 2d 3h Ah]
Seat 1: Pvsx. (button) folded before Flop (didn't bet)
Seat 2: RICKA16 (small blind) folded before Flop
Seat 3: CAJUN890 (big blind) folded on the Flop
Seat 4: matiko09 folded on the Turn
Seat 5: Jimy Tiltman folded before Flop (didn't bet)
Seat 6: WDW3 collected ($20.53)
Seat 7: lumen21 folded before Flop (didn't bet)
Seat 8: Zeeshka folded before Flop (didn't bet)
Seat 9: wang19790906 folded before Flop (didn't bet)





PokerStars Hand #150799822685:  Hold'em No Limit (€0.25/€0.50 EUR) - 2016/03/23 13:45:43 CET [2016/03/23 8:45:43 ET]
Table 'Palma II' 9-max Seat #2 is the button
Seat 2: matiko09 (€50 in chips) 
Seat 3: ardo888 (€52.04 in chips) 
Seat 4: dndngod (€70.02 in chips) 
Seat 5: SVFB13 (€49.25 in chips) 
Seat 7: Kuca :P (€50 in chips) 
ardo888: posts small blind €0.25
dndngod: posts big blind €0.50
CAJUN890: sits out 
Red_Warning: sits out 
*** HOLE CARDS ***
Dealt to matiko09 [6s 5d]
SVFB13: folds 
CvMCvMCvM leaves the table
Kuca :P: folds 
Effort92 joins the table at seat #8 
matiko09: folds 
ardo888: folds 
Uncalled bet (€0.25) returned to dndngod
dndngod collected €0.50 from pot
*** SUMMARY ***
Total pot €0.50 | Rake €0 
Seat 2: matiko09 (button) folded before Flop (didn't bet)
Seat 3: ardo888 (small blind) folded before Flop
Seat 4: dndngod (big blind) collected (€0.50)
Seat 5: SVFB13 folded before Flop (didn't bet)
Seat 7: Kuca :P folded before Flop (didn't bet)





PokerStars Hand #150799824054:  Hold'em No Limit ($1/$2 USD) - 2016/03/23 13:45:45 CET [2016/03/23 8:45:45 ET]
Table 'Herba II' 9-max Seat #4 is the button
Seat 1: matiko09 ($232.48 in chips) 
Seat 2: Moszes360 ($210.20 in chips) 
Seat 3: Cirilico ($162.60 in chips) 
Seat 4: DUkalisUA ($286.78 in chips) 
Seat 5: chippo boy ($237.31 in chips) 
Seat 6: WDW3 ($213.33 in chips) 
Seat 7: InsomniaRU ($216.42 in chips) 
Seat 8: The_red_area ($432.73 in chips) 
Seat 9: mrhighryza ($41.17 in chips) 
chippo boy: posts small blind $1
WDW3: posts big blind $2
*** HOLE CARDS ***
Dealt to matiko09 [8d 5h]
InsomniaRU: folds 
The_red_area: folds 
mrhighryza: calls $2
matiko09: folds 
Moszes360: folds 
Cirilico: folds 
DUkalisUA: folds 
chippo boy: calls $1
WDW3: checks 
*** FLOP *** [Kh 2c Qs]
chippo boy: bets $4
WDW3: folds 
mrhighryza: folds 
Uncalled bet ($4) returned to chippo boy
chippo boy collected $5.73 from pot
*** SUMMARY ***
Total pot $6 | Rake $0.27 
Board [Kh 2c Qs]
Seat 1: matiko09 folded before Flop (didn't bet)
Seat 2: Moszes360 folded before Flop (didn't bet)
Seat 3: Cirilico folded before Flop (didn't bet)
Seat 4: DUkalisUA (button) folded before Flop (didn't bet)
Seat 5: chippo boy (small blind) collected ($5.73)
Seat 6: WDW3 (big blind) folded on the Flop
Seat 7: InsomniaRU folded before Flop (didn't bet)
Seat 8: The_red_area folded before Flop (didn't bet)
Seat 9: mrhighryza folded on the Flop





PokerStars Hand #150799829168:  Hold'em No Limit ($1/$2 USD) - 2016/03/23 13:45:54 CET [2016/03/23 8:45:54 ET]
Table 'Berbericia II' 9-max Seat #8 is the button
Seat 1: WDW3 ($209.05 in chips) 
Seat 2: Moszes360 ($221.52 in chips) 
Seat 3: Fish4trips ($221.02 in chips) 
Seat 4: bennetb77 ($94.56 in chips) 
Seat 5: darren1031 ($200 in chips) 
Seat 6: Charity86 ($175.88 in chips) 
Seat 8: matiko09 ($313.51 in chips) 
Seat 9: LVV-Bif ($296.90 in chips) 
LVV-Bif: posts small blind $1
WDW3: posts big blind $2
*** HOLE CARDS ***
Dealt to matiko09 [6s 3c]
Moszes360: folds 
Fish4trips: folds 
bennetb77: calls $2
darren1031: folds 
Charity86: folds 
matiko09: folds 
LVV-Bif: folds 
WDW3: checks 
*** FLOP *** [2s 6c 2d]
WDW3: checks 
bennetb77: bets $4
WDW3: folds 
Uncalled bet ($4) returned to bennetb77
bennetb77 collected $4.78 from pot
bennetb77: doesn't show hand 
*** SUMMARY ***
Total pot $5 | Rake $0.22 
Board [2s 6c 2d]
Seat 1: WDW3 (big blind) folded on the Flop
Seat 2: Moszes360 folded before Flop (didn't bet)
Seat 3: Fish4trips folded before Flop (didn't bet)
Seat 4: bennetb77 collected ($4.78)
Seat 5: darren1031 folded before Flop (didn't bet)
Seat 6: Charity86 folded before Flop (didn't bet)
Seat 8: matiko09 (button) folded before Flop (didn't bet)
Seat 9: LVV-Bif (small blind) folded before Flop





PokerStars Hand #150799833975:  Hold'em No Limit (€0.25/€0.50 EUR) - 2016/03/23 13:46:02 CET [2016/03/23 8:46:02 ET]
Table 'Palma II' 9-max Seat #3 is the button
Seat 2: matiko09 (€50 in chips) 
Seat 3: ardo888 (€51.79 in chips) 
Seat 4: dndngod (€70.27 in chips) 
Seat 5: SVFB13 (€49.25 in chips) 
Seat 7: Kuca :P (€50 in chips) 
dndngod: posts small blind €0.25
SVFB13: posts big blind €0.50
CAJUN890: sits out 
Effort92: sits out 
Red_Warning: sits out 
*** HOLE CARDS ***
Dealt to matiko09 [Th 9h]
Kuca :P: folds 
matiko09: raises €1 to €1.50
ardo888: folds 
dndngod: folds 
SVFB13: calls €1
*** FLOP *** [Jd 6c 3s]
Aalleekks joins the table at seat #1 
SVFB13: checks 
matiko09: bets €2.02
SVFB13: folds 
Uncalled bet (€2.02) returned to matiko09
matiko09 collected €3.10 from pot
matiko09: doesn't show hand 
*** SUMMARY ***
Total pot €3.25 | Rake €0.15 
Board [Jd 6c 3s]
Seat 2: matiko09 collected (€3.10)
Seat 3: ardo888 (button) folded before Flop (didn't bet)
Seat 4: dndngod (small blind) folded before Flop
Seat 5: SVFB13 (big blind) folded on the Flop
Seat 7: Kuca :P folded before Flop (didn't bet)





PokerStars Hand #150799833671:  Hold'em No Limit ($0.50/$1.00 USD) - 2016/03/23 13:46:02 CET [2016/03/23 8:46:02 ET]
Table 'Oljato' 9-max Seat #2 is the button
Seat 1: xHourglass ($111.76 in chips) 
Seat 2: roman134679 ($61.60 in chips) 
Seat 3: DUkalisUA ($100 in chips) 
Seat 4: Pvsx. ($141.10 in chips) 
Seat 5: ryo728 ($92.45 in chips) 
Seat 6: WDW3 ($117.11 in chips) 
Seat 7: matiko09 ($158.59 in chips) 
Seat 8: Zeeshka ($341.34 in chips) 
Seat 9: Jimy Tiltman ($110.06 in chips) 
DUkalisUA: posts small blind $0.50
Pvsx.: posts big blind $1
*** HOLE CARDS ***
Dealt to matiko09 [Tc 9c]
ryo728: folds 
WDW3: folds 
matiko09: raises $2 to $3
Zeeshka: folds 
Jimy Tiltman: folds 
xHourglass: folds 
roman134679: raises $2.71 to $5.71
DUkalisUA: folds 
Pvsx.: folds 
matiko09: folds 
Uncalled bet ($2.71) returned to roman134679
roman134679 collected $7.50 from pot
*** SUMMARY ***
Total pot $7.50 | Rake $0 
Seat 1: xHourglass folded before Flop (didn't bet)
Seat 2: roman134679 (button) collected ($7.50)
Seat 3: DUkalisUA (small blind) folded before Flop
Seat 4: Pvsx. (big blind) folded before Flop
Seat 5: ryo728 folded before Flop (didn't bet)
Seat 6: WDW3 folded before Flop (didn't bet)
Seat 7: matiko09 folded before Flop
Seat 8: Zeeshka folded before Flop (didn't bet)
Seat 9: Jimy Tiltman folded before Flop (didn't bet)





PokerStars Hand #150799837286:  Hold'em No Limit ($1/$2 USD) - 2016/03/23 13:46:08 CET [2016/03/23 8:46:08 ET]
Table 'Kiess' 9-max Seat #5 is the button
Seat 1: Cirilico ($161.78 in chips) 
Seat 2: DUkalisUA ($479.57 in chips) 
Seat 3: The_red_area ($376.82 in chips) 
Seat 4: Moszes360 ($200 in chips) 
Seat 5: chippo boy ($313.39 in chips) 
Seat 6: matiko09 ($298.84 in chips) 
Seat 7: InsomniaRU ($276.17 in chips) 
Seat 8: WDW3 ($378.42 in chips) 
Seat 9: Fish4trips ($214.55 in chips) 
matiko09: posts small blind $1
InsomniaRU: posts big blind $2
*** HOLE CARDS ***
Dealt to matiko09 [2h 7h]
WDW3: raises $3.60 to $5.60
Fish4trips: folds 
Cirilico: folds 
DUkalisUA: folds 
The_red_area: folds 
Moszes360: raises $12.40 to $18
chippo boy: folds 
matiko09: folds 
InsomniaRU: folds 
WDW3: folds 
Uncalled bet ($12.40) returned to Moszes360
Moszes360 collected $14.20 from pot
Moszes360: doesn't show hand 
*** SUMMARY ***
Total pot $14.20 | Rake $0 
Seat 1: Cirilico folded before Flop (didn't bet)
Seat 2: DUkalisUA folded before Flop (didn't bet)
Seat 3: The_red_area folded before Flop (didn't bet)
Seat 4: Moszes360 collected ($14.20)
Seat 5: chippo boy (button) folded before Flop (didn't bet)
Seat 6: matiko09 (small blind) folded before Flop
Seat 7: InsomniaRU (big blind) folded before Flop
Seat 8: WDW3 folded before Flop
Seat 9: Fish4trips folded before Flop (didn't bet)





PokerStars Hand #150799839297:  Hold'em No Limit ($0.25/$0.50 USD) - 2016/03/23 13:46:12 CET [2016/03/23 8:46:12 ET]
Table 'Pyrrhus' 9-max Seat #5 is the button
Seat 1: lumen21 ($50 in chips) 
Seat 3: IvanUrgant ($83.87 in chips) 
Seat 4: GriffinBerg ($12.89 in chips) 
Seat 5: Moszes360 ($52.25 in chips) 
Seat 6: whalldo ($165.37 in chips) 
Seat 7: matiko09 ($128.51 in chips) 
Seat 8: dndngod ($58.97 in chips) 
Seat 9: CvMCvMCvM ($111.16 in chips) 
whalldo: posts small blind $0.25
matiko09: posts big blind $0.50
Zeeshka: sits out 
*** HOLE CARDS ***
Dealt to matiko09 [Ad 5s]
dndngod: folds 
CvMCvMCvM: folds 
lumen21: folds 
IvanUrgant: folds 
GriffinBerg: folds 
Moszes360: raises $0.55 to $1.05
whalldo: folds 
matiko09: folds 
Uncalled bet ($0.55) returned to Moszes360
Moszes360 collected $1.25 from pot
Moszes360: doesn't show hand 
*** SUMMARY ***
Total pot $1.25 | Rake $0 
Seat 1: lumen21 folded before Flop (didn't bet)
Seat 3: IvanUrgant folded before Flop (didn't bet)
Seat 4: GriffinBerg folded before Flop (didn't bet)
Seat 5: Moszes360 (button) collected ($1.25)
Seat 6: whalldo (small blind) folded before Flop
Seat 7: matiko09 (big blind) folded before Flop
Seat 8: dndngod folded before Flop (didn't bet)
Seat 9: CvMCvMCvM folded before Flop (didn't bet)





PokerStars Hand #150799839784:  Hold'em No Limit ($0.50/$1.00 USD) - 2016/03/23 13:46:13 CET [2016/03/23 8:46:13 ET]
Table 'Atlantis' 9-max Seat #6 is the button
Seat 1: xHourglass ($160.28 in chips) 
Seat 2: tffff2006 ($47.96 in chips) 
Seat 3: CAJUN890 ($107.10 in chips) 
Seat 4: matiko09 ($123.95 in chips) 
Seat 5: Pvsx. ($100 in chips) 
Seat 6: Jimy Tiltman ($106.24 in chips) 
Seat 7: Zeeshka ($114.32 in chips) 
Seat 8: DUkalisUA ($100 in chips) 
Seat 9: WDW3 ($124.26 in chips) 
Zeeshka: posts small blind $0.50
DUkalisUA: posts big blind $1
*** HOLE CARDS ***
Dealt to matiko09 [7d Qd]
tffff2006 said, "big fish"
WDW3: folds 
xHourglass: folds 
tffff2006: folds 
CAJUN890: folds 
matiko09: folds 
Pvsx.: folds 
Jimy Tiltman: raises $1 to $2
Zeeshka: raises $6 to $8
DUkalisUA: raises $12.50 to $20.50
Jimy Tiltman: raises $85.74 to $106.24 and is all-in
Zeeshka: folds 
DUkalisUA: folds 
Uncalled bet ($85.74) returned to Jimy Tiltman
Jimy Tiltman collected $49 from pot
Jimy Tiltman: doesn't show hand 
*** SUMMARY ***
Total pot $49 | Rake $0 
Seat 1: xHourglass folded before Flop (didn't bet)
Seat 2: tffff2006 folded before Flop (didn't bet)
Seat 3: CAJUN890 folded before Flop (didn't bet)
Seat 4: matiko09 folded before Flop (didn't bet)
Seat 5: Pvsx. folded before Flop (didn't bet)
Seat 6: Jimy Tiltman (button) collected ($49)
Seat 7: Zeeshka (small blind) folded before Flop
Seat 8: DUkalisUA (big blind) folded before Flop
Seat 9: WDW3 folded before Flop (didn't bet)





PokerStars Hand #150799844709:  Hold'em No Limit ($0.25/$0.50 USD) - 2016/03/23 13:46:21 CET [2016/03/23 8:46:21 ET]
Table 'Belnika' 9-max Seat #3 is the button
Seat 1: yellowfever0 ($30.67 in chips) 
Seat 2: NeverRegret7 ($55.24 in chips) 
Seat 3: ChiChioChi ($41.14 in chips) 
Seat 4: matiko09 ($69.10 in chips) 
Seat 5: IvanUrgant ($50 in chips) 
Seat 6: Ahangama ($64 in chips) 
Seat 7: Zeeshka ($50 in chips) 
Seat 8: lumen21 ($67.39 in chips) 
Seat 9: dndngod ($61.91 in chips) 
matiko09: posts small blind $0.25
IvanUrgant: posts big blind $0.50
*** HOLE CARDS ***
Dealt to matiko09 [Jd As]
Ahangama: folds 
Zeeshka: folds 
lumen21: folds 
dndngod: folds 
yellowfever0: calls $0.50
NeverRegret7: folds 
ChiChioChi: folds 
matiko09: raises $2.50 to $3
IvanUrgant: folds 
yellowfever0: calls $2.50
*** FLOP *** [Kc 4c 5c]
matiko09: checks 
yellowfever0: checks 
*** TURN *** [Kc 4c 5c] [3d]
matiko09: checks 
yellowfever0: bets $3.10
matiko09: folds 
Uncalled bet ($3.10) returned to yellowfever0
yellowfever0 collected $6.21 from pot
yellowfever0: doesn't show hand 
*** SUMMARY ***
Total pot $6.50 | Rake $0.29 
Board [Kc 4c 5c 3d]
Seat 1: yellowfever0 collected ($6.21)
Seat 2: NeverRegret7 folded before Flop (didn't bet)
Seat 3: ChiChioChi (button) folded before Flop (didn't bet)
Seat 4: matiko09 (small blind) folded on the Turn
Seat 5: IvanUrgant (big blind) folded before Flop
Seat 6: Ahangama folded before Flop (didn't bet)
Seat 7: Zeeshka folded before Flop (didn't bet)
Seat 8: lumen21 folded before Flop (didn't bet)
Seat 9: dndngod folded before Flop (didn't bet)





PokerStars Hand #150799845576:  Hold'em No Limit ($0.50/$1.00 USD) - 2016/03/23 13:46:23 CET [2016/03/23 8:46:23 ET]
Table 'Smiley' 9-max Seat #2 is the button
Seat 1: WDW3 ($121.58 in chips) 
Seat 2: Jimy Tiltman ($100 in chips) 
Seat 3: matiko09 ($104.98 in chips) 
Seat 4: Zeeshka ($148.42 in chips) 
Seat 5: DUkalisUA ($100 in chips) 
Seat 6: blackmont111 ($57.36 in chips) 
Seat 8: RICKA16 ($108 in chips) 
Seat 9: morosun ($152.36 in chips) 
matiko09: posts small blind $0.50
Zeeshka: posts big blind $1
Moszes360: sits out 
*** HOLE CARDS ***
Dealt to matiko09 [Tc 3s]
DUkalisUA: folds 
blackmont111: folds 
RICKA16: raises $2 to $3
morosun: calls $3
WDW3: calls $3
Jimy Tiltman: folds 
matiko09: folds 
Zeeshka: folds 
*** FLOP *** [8h 2c Qd]
RICKA16: checks 
morosun: bets $5.01
WDW3: folds 
RICKA16: calls $5.01
*** TURN *** [8h 2c Qd] [Kd]
RICKA16: checks 
morosun: bets $9.80
RICKA16: folds 
Uncalled bet ($9.80) returned to morosun
morosun collected $19.60 from pot
*** SUMMARY ***
Total pot $20.52 | Rake $0.92 
Board [8h 2c Qd Kd]
Seat 1: WDW3 folded on the Flop
Seat 2: Jimy Tiltman (button) folded before Flop (didn't bet)
Seat 3: matiko09 (small blind) folded before Flop
Seat 4: Zeeshka (big blind) folded before Flop
Seat 5: DUkalisUA folded before Flop (didn't bet)
Seat 6: blackmont111 folded before Flop (didn't bet)
Seat 8: RICKA16 folded on the Turn
Seat 9: morosun collected ($19.60)





PokerStars Hand #150799850473:  Hold'em No Limit ($1/$2 USD) - 2016/03/23 13:46:32 CET [2016/03/23 8:46:32 ET]
Table 'Herba II' 9-max Seat #5 is the button
Seat 1: matiko09 ($232.48 in chips) 
Seat 2: Moszes360 ($210.20 in chips) 
Seat 3: Cirilico ($162.60 in chips) 
Seat 4: DUkalisUA ($286.78 in chips) 
Seat 5: chippo boy ($241.04 in chips) 
Seat 6: WDW3 ($211.33 in chips) 
Seat 7: InsomniaRU ($216.42 in chips) 
Seat 8: The_red_area ($432.73 in chips) 
Seat 9: mrhighryza ($39.17 in chips) 
WDW3: posts small blind $1
InsomniaRU: posts big blind $2
*** HOLE CARDS ***
Dealt to matiko09 [6h 3c]
The_red_area: folds 
mrhighryza: calls $2
matiko09: folds 
Moszes360: folds 
Cirilico: folds 
DUkalisUA: folds 
chippo boy: calls $2
WDW3: folds 
InsomniaRU: checks 
*** FLOP *** [Td Kd 2s]
InsomniaRU: checks 
mrhighryza: bets $4
chippo boy: calls $4
InsomniaRU: folds 
*** TURN *** [Td Kd 2s] [8c]
mrhighryza: bets $4
chippo boy: calls $4
*** RIVER *** [Td Kd 2s 8c] [Ts]
mrhighryza: checks 
chippo boy: checks 
*** SHOW DOWN ***
mrhighryza: shows [9c 9s] (two pair, Tens and Nines)
chippo boy: mucks hand 
mrhighryza collected $21.96 from pot
*** SUMMARY ***
Total pot $23 | Rake $1.04 
Board [Td Kd 2s 8c Ts]
Seat 1: matiko09 folded before Flop (didn't bet)
Seat 2: Moszes360 folded before Flop (didn't bet)
Seat 3: Cirilico folded before Flop (didn't bet)
Seat 4: DUkalisUA folded before Flop (didn't bet)
Seat 5: chippo boy (button) mucked [7d 8d]
Seat 6: WDW3 (small blind) folded before Flop
Seat 7: InsomniaRU (big blind) folded on the Flop
Seat 8: The_red_area folded before Flop (didn't bet)
Seat 9: mrhighryza showed [9c 9s] and won ($21.96) with two pair, Tens and Nines





PokerStars Hand #150799850460:  Hold'em No Limit ($1/$2 USD) - 2016/03/23 13:46:32 CET [2016/03/23 8:46:32 ET]
Table 'Berbericia II' 9-max Seat #9 is the button
Seat 1: WDW3 ($207.05 in chips) 
Seat 2: Moszes360 ($221.52 in chips) 
Seat 3: Fish4trips ($221.02 in chips) 
Seat 4: bennetb77 ($97.34 in chips) 
Seat 5: darren1031 ($200 in chips) 
Seat 6: Charity86 ($175.88 in chips) 
Seat 8: matiko09 ($313.51 in chips) 
Seat 9: LVV-Bif ($295.90 in chips) 
WDW3: posts small blind $1
Moszes360: posts big blind $2
*** HOLE CARDS ***
Dealt to matiko09 [4c 9h]
Fish4trips: folds 
bennetb77: folds 
darren1031: folds 
Charity86: folds 
matiko09: folds 
LVV-Bif: folds 
WDW3: folds 
Uncalled bet ($1) returned to Moszes360
Moszes360 collected $2 from pot
Moszes360: doesn't show hand 
*** SUMMARY ***
Total pot $2 | Rake $0 
Seat 1: WDW3 (small blind) folded before Flop
Seat 2: Moszes360 (big blind) collected ($2)
Seat 3: Fish4trips folded before Flop (didn't bet)
Seat 4: bennetb77 folded before Flop (didn't bet)
Seat 5: darren1031 folded before Flop (didn't bet)
Seat 6: Charity86 folded before Flop (didn't bet)
Seat 8: matiko09 folded before Flop (didn't bet)
Seat 9: LVV-Bif (button) folded before Flop (didn't bet)





PokerStars Hand #150799853105:  Hold'em No Limit ($0.25/$0.50 USD) - 2016/03/23 13:46:36 CET [2016/03/23 8:46:36 ET]
Table 'Pyrrhus' 9-max Seat #6 is the button
Seat 1: lumen21 ($50 in chips) 
Seat 3: IvanUrgant ($83.87 in chips) 
Seat 4: GriffinBerg ($12.89 in chips) 
Seat 5: Moszes360 ($53 in chips) 
Seat 6: whalldo ($165.12 in chips) 
Seat 7: matiko09 ($128.01 in chips) 
Seat 8: dndngod ($58.97 in chips) 
Seat 9: CvMCvMCvM ($111.16 in chips) 
matiko09: posts small blind $0.25
dndngod: posts big blind $0.50
Zeeshka: sits out 
*** HOLE CARDS ***
Dealt to matiko09 [5s Jc]
CvMCvMCvM: raises $0.76 to $1.26
lumen21: folds 
IvanUrgant: folds 
GriffinBerg: folds 
Moszes360: folds 
whalldo: folds 
matiko09: folds 
dndngod: raises $4.24 to $5.50
CvMCvMCvM: folds 
Uncalled bet ($4.24) returned to dndngod
dndngod collected $2.77 from pot
dndngod: doesn't show hand 
*** SUMMARY ***
Total pot $2.77 | Rake $0 
Seat 1: lumen21 folded before Flop (didn't bet)
Seat 3: IvanUrgant folded before Flop (didn't bet)
Seat 4: GriffinBerg folded before Flop (didn't bet)
Seat 5: Moszes360 folded before Flop (didn't bet)
Seat 6: whalldo (button) folded before Flop (didn't bet)
Seat 7: matiko09 (small blind) folded before Flop
Seat 8: dndngod (big blind) collected ($2.77)
Seat 9: CvMCvMCvM folded before Flop





PokerStars Hand #150799853998:  Hold'em No Limit ($1/$2 USD) - 2016/03/23 13:46:38 CET [2016/03/23 8:46:38 ET]
Table 'Kypria II' 9-max Seat #7 is the button
Seat 1: geldwolfje ($242.15 in chips) 
Seat 2: coinflip_si ($200 in chips) 
Seat 3: seouljam ($205.73 in chips) 
Seat 4: nailz83 ($70.09 in chips) 
Seat 5: InsomniaRU ($348.62 in chips) 
Seat 6: matiko09 ($200 in chips) 
Seat 7: DUkalisUA ($200 in chips) 
Seat 8: Fish4trips ($347.79 in chips) 
Seat 9: WDW3 ($200.42 in chips) 
Fish4trips: posts small blind $1
WDW3: posts big blind $2
*** HOLE CARDS ***
Dealt to matiko09 [Jd Js]
geldwolfje: calls $2
coinflip_si: folds 
seouljam: folds 
nailz83: calls $2
InsomniaRU: folds 
matiko09: raises $8 to $10
DUkalisUA: folds 
Fish4trips: folds 
WDW3: folds 
geldwolfje: calls $8
nailz83: calls $8
*** FLOP *** [5d Jh Kd]
geldwolfje: checks 
nailz83: checks 
matiko09: bets $20.49
geldwolfje: calls $20.49
nailz83: folds 
*** TURN *** [5d Jh Kd] [2c]
geldwolfje: checks 
matiko09: bets $48
geldwolfje: calls $48
*** RIVER *** [5d Jh Kd 2c] [Td]
geldwolfje: checks 
matiko09: checks 
*** SHOW DOWN ***
geldwolfje: shows [Kh 4h] (a pair of Kings)
matiko09: shows [Jd Js] (three of a kind, Jacks)
matiko09 collected $167.18 from pot
*** SUMMARY ***
Total pot $169.98 | Rake $2.80 
Board [5d Jh Kd 2c Td]
Seat 1: geldwolfje showed [Kh 4h] and lost with a pair of Kings
Seat 2: coinflip_si folded before Flop (didn't bet)
Seat 3: seouljam folded before Flop (didn't bet)
Seat 4: nailz83 folded on the Flop
Seat 5: InsomniaRU folded before Flop (didn't bet)
Seat 6: matiko09 showed [Jd Js] and won ($167.18) with three of a kind, Jacks
Seat 7: DUkalisUA (button) folded before Flop (didn't bet)
Seat 8: Fish4trips (small blind) folded before Flop
Seat 9: WDW3 (big blind) folded before Flop





PokerStars Hand #150799857386:  Hold'em No Limit ($0.50/$1.00 USD) - 2016/03/23 13:46:44 CET [2016/03/23 8:46:44 ET]
Table 'Oljato' 9-max Seat #3 is the button
Seat 1: xHourglass ($111.76 in chips) 
Seat 2: roman134679 ($66.10 in chips) 
Seat 3: DUkalisUA ($100 in chips) 
Seat 4: Pvsx. ($140.10 in chips) 
Seat 5: ryo728 ($92.45 in chips) 
Seat 6: WDW3 ($117.11 in chips) 
Seat 7: matiko09 ($155.59 in chips) 
Seat 8: Zeeshka ($341.34 in chips) 
Seat 9: Jimy Tiltman ($110.06 in chips) 
Pvsx.: posts small blind $0.50
ryo728: posts big blind $1
*** HOLE CARDS ***
Dealt to matiko09 [Kh 9c]
WDW3: folds 
matiko09: folds 
Zeeshka: folds 
Jimy Tiltman: folds 
xHourglass: folds 
roman134679: folds 
DUkalisUA: folds 
Pvsx.: folds 
Uncalled bet ($0.50) returned to ryo728
ryo728 collected $1 from pot
ryo728: doesn't show hand 
*** SUMMARY ***
Total pot $1 | Rake $0 
Seat 1: xHourglass folded before Flop (didn't bet)
Seat 2: roman134679 folded before Flop (didn't bet)
Seat 3: DUkalisUA (button) folded before Flop (didn't bet)
Seat 4: Pvsx. (small blind) folded before Flop
Seat 5: ryo728 (big blind) collected ($1)
Seat 6: WDW3 folded before Flop (didn't bet)
Seat 7: matiko09 folded before Flop (didn't bet)
Seat 8: Zeeshka folded before Flop (didn't bet)
Seat 9: Jimy Tiltman folded before Flop (didn't bet)





PokerStars Hand #150799859075:  Hold'em No Limit ($0.50/$1.00 USD) - 2016/03/23 13:46:47 CET [2016/03/23 8:46:47 ET]
Table 'Merope II' 9-max Seat #7 is the button
Seat 1: Jimy Tiltman ($100 in chips) 
Seat 2: Zeeshka ($101.50 in chips) 
Seat 3: Sherlockplay ($100 in chips) 
Seat 4: YuriiSolodya ($30.50 in chips) 
Seat 5: DUkalisUA ($109.60 in chips) 
Seat 6: rebelTC ($81.71 in chips) 
Seat 7: matiko09 ($100 in chips) 
Seat 8: titentei ($97 in chips) 
Seat 9: RICKA16 ($100 in chips) 
titentei: posts small blind $0.50
RICKA16: posts big blind $1
*** HOLE CARDS ***
Dealt to matiko09 [Ks Ad]
Jimy Tiltman: folds 
Zeeshka: folds 
Sherlockplay: folds 
YuriiSolodya: folds 
DUkalisUA: folds 
rebelTC: folds 
matiko09: raises $1.27 to $2.27
titentei: folds 
RICKA16: folds 
Uncalled bet ($1.27) returned to matiko09
matiko09 collected $2.50 from pot
matiko09: doesn't show hand 
*** SUMMARY ***
Total pot $2.50 | Rake $0 
Seat 1: Jimy Tiltman folded before Flop (didn't bet)
Seat 2: Zeeshka folded before Flop (didn't bet)
Seat 3: Sherlockplay folded before Flop (didn't bet)
Seat 4: YuriiSolodya folded before Flop (didn't bet)
Seat 5: DUkalisUA folded before Flop (didn't bet)
Seat 6: rebelTC folded before Flop (didn't bet)
Seat 7: matiko09 (button) collected ($2.50)
Seat 8: titentei (small blind) folded before Flop
Seat 9: RICKA16 (big blind) folded before Flop





PokerStars Hand #150799860737:  Hold'em No Limit ($1/$2 USD) - 2016/03/23 13:46:50 CET [2016/03/23 8:46:50 ET]
Table 'Berbericia II' 9-max Seat #1 is the button
Seat 1: WDW3 ($206.05 in chips) 
Seat 2: Moszes360 ($222.52 in chips) 
Seat 3: Fish4trips ($221.02 in chips) 
Seat 4: bennetb77 ($97.34 in chips) 
Seat 5: darren1031 ($200 in chips) 
Seat 6: Charity86 ($175.88 in chips) 
Seat 8: matiko09 ($313.51 in chips) 
Seat 9: LVV-Bif ($295.90 in chips) 
Moszes360: posts small blind $1
Fish4trips: posts big blind $2
*** HOLE CARDS ***
Dealt to matiko09 [Qh Jd]
bennetb77: folds 
darren1031: folds 
Charity86: raises $3 to $5
matiko09: folds 
LVV-Bif: folds 
WDW3: folds 
Moszes360: folds 
Fish4trips: folds 
Uncalled bet ($3) returned to Charity86
Charity86 collected $5 from pot
*** SUMMARY ***
Total pot $5 | Rake $0 
Seat 1: WDW3 (button) folded before Flop (didn't bet)
Seat 2: Moszes360 (small blind) folded before Flop
Seat 3: Fish4trips (big blind) folded before Flop
Seat 4: bennetb77 folded before Flop (didn't bet)
Seat 5: darren1031 folded before Flop (didn't bet)
Seat 6: Charity86 collected ($5)
Seat 8: matiko09 folded before Flop (didn't bet)
Seat 9: LVV-Bif folded before Flop (didn't bet)





PokerStars Hand #150799863635:  Hold'em No Limit (€0.25/€0.50 EUR) - 2016/03/23 13:46:55 CET [2016/03/23 8:46:55 ET]
Table 'Hesperia II' 9-max Seat #9 is the button
Seat 1: CAJUN890 (€55.09 in chips) 
Seat 2: dndngod (€51.44 in chips) 
Seat 3: IvanUrgant (€59.05 in chips) 
Seat 4: Zelenis (€21.15 in chips) 
Seat 5: Avrora-sp (€50 in chips) 
Seat 6: CvMCvMCvM (€50 in chips) 
Seat 7: matiko09 (€60.98 in chips) 
Seat 8: Ahangama (€50 in chips) 
Seat 9: Red_Warning (€50 in chips) 
CAJUN890: posts small blind €0.25
dndngod: posts big blind €0.50
*** HOLE CARDS ***
Dealt to matiko09 [9c 7c]
IvanUrgant: folds 
Zelenis: folds 
Avrora-sp: folds 
CvMCvMCvM: folds 
matiko09: folds 
Ahangama: folds 
Red_Warning: folds 
CAJUN890: calls €0.25
dndngod: checks 
*** FLOP *** [7s Td 8h]
CAJUN890: bets €1.50
dndngod: folds 
Uncalled bet (€1.50) returned to CAJUN890
CAJUN890 collected €0.96 from pot
CAJUN890: doesn't show hand 
*** SUMMARY ***
Total pot €1 | Rake €0.04 
Board [7s Td 8h]
Seat 1: CAJUN890 (small blind) collected (€0.96)
Seat 2: dndngod (big blind) folded on the Flop
Seat 3: IvanUrgant folded before Flop (didn't bet)
Seat 4: Zelenis folded before Flop (didn't bet)
Seat 5: Avrora-sp folded before Flop (didn't bet)
Seat 6: CvMCvMCvM folded before Flop (didn't bet)
Seat 7: matiko09 folded before Flop (didn't bet)
Seat 8: Ahangama folded before Flop (didn't bet)
Seat 9: Red_Warning (button) folded before Flop (didn't bet)





PokerStars Hand #150799866139:  Hold'em No Limit ($1/$2 USD) - 2016/03/23 13:46:59 CET [2016/03/23 8:46:59 ET]
Table 'Kiess' 9-max Seat #6 is the button
Seat 1: Cirilico ($161.78 in chips) 
Seat 2: DUkalisUA ($479.57 in chips) 
Seat 3: The_red_area ($376.82 in chips) 
Seat 4: Moszes360 ($208.60 in chips) 
Seat 5: chippo boy ($313.39 in chips) 
Seat 6: matiko09 ($297.84 in chips) 
Seat 7: InsomniaRU ($274.17 in chips) 
Seat 8: WDW3 ($372.82 in chips) 
Seat 9: Fish4trips ($214.55 in chips) 
InsomniaRU: posts small blind $1
WDW3: posts big blind $2
*** HOLE CARDS ***
Dealt to matiko09 [2d 8c]
Fish4trips: raises $3 to $5
Cirilico: folds 
DUkalisUA: folds 
The_red_area: folds 
Moszes360: folds 
chippo boy: folds 
matiko09: folds 
InsomniaRU: folds 
WDW3: folds 
Uncalled bet ($3) returned to Fish4trips
Fish4trips collected $5 from pot
Fish4trips: doesn't show hand 
*** SUMMARY ***
Total pot $5 | Rake $0 
Seat 1: Cirilico folded before Flop (didn't bet)
Seat 2: DUkalisUA folded before Flop (didn't bet)
Seat 3: The_red_area folded before Flop (didn't bet)
Seat 4: Moszes360 folded before Flop (didn't bet)
Seat 5: chippo boy folded before Flop (didn't bet)
Seat 6: matiko09 (button) folded before Flop (didn't bet)
Seat 7: InsomniaRU (small blind) folded before Flop
Seat 8: WDW3 (big blind) folded before Flop
Seat 9: Fish4trips collected ($5)





PokerStars Hand #150799866516:  Hold'em No Limit (€0.25/€0.50 EUR) - 2016/03/23 13:47:00 CET [2016/03/23 8:47:00 ET]
Table 'Palma II' 9-max Seat #4 is the button
Seat 2: matiko09 (€51.60 in chips) 
Seat 3: ardo888 (€51.79 in chips) 
Seat 4: dndngod (€70.02 in chips) 
Seat 5: SVFB13 (€50 in chips) 
Seat 6: CAJUN890 (€50 in chips) 
Seat 7: Kuca :P (€50 in chips) 
SVFB13: posts small blind €0.25
CAJUN890: posts big blind €0.50
Effort92: sits out 
Red_Warning: sits out 
Aalleekks: sits out 
*** HOLE CARDS ***
Dealt to matiko09 [6d Ah]
Kuca :P: folds 
matiko09: folds 
ardo888: folds 
dndngod: raises €0.50 to €1
SVFB13: folds 
CAJUN890: folds 
Uncalled bet (€0.50) returned to dndngod
dndngod collected €1.25 from pot
dndngod: doesn't show hand 
*** SUMMARY ***
Total pot €1.25 | Rake €0 
Seat 2: matiko09 folded before Flop (didn't bet)
Seat 3: ardo888 folded before Flop (didn't bet)
Seat 4: dndngod (button) collected (€1.25)
Seat 5: SVFB13 (small blind) folded before Flop
Seat 6: CAJUN890 (big blind) folded before Flop
Seat 7: Kuca :P folded before Flop (didn't bet)





PokerStars Hand #150799868292:  Hold'em No Limit ($0.50/$1.00 USD) - 2016/03/23 13:47:03 CET [2016/03/23 8:47:03 ET]
Table 'Atlantis' 9-max Seat #7 is the button
Seat 1: xHourglass ($160.28 in chips) 
Seat 2: tffff2006 ($47.96 in chips) 
Seat 3: CAJUN890 ($107.10 in chips) 
Seat 4: matiko09 ($123.95 in chips) 
Seat 5: Pvsx. ($100 in chips) 
Seat 6: Jimy Tiltman ($134.74 in chips) 
Seat 7: Zeeshka ($106.32 in chips) 
Seat 8: DUkalisUA ($100 in chips) 
Seat 9: WDW3 ($124.26 in chips) 
DUkalisUA: posts small blind $0.50
WDW3: posts big blind $1
*** HOLE CARDS ***
Dealt to matiko09 [Qc 4d]
xHourglass: folds 
tffff2006: folds 
CAJUN890: calls $1
matiko09: folds 
Pvsx.: folds 
Jimy Tiltman: folds 
Zeeshka: folds 
DUkalisUA: calls $0.50
WDW3: checks 
*** FLOP *** [6c 7s Kh]
DUkalisUA: checks 
WDW3: checks 
CAJUN890: bets $2.86
DUkalisUA: folds 
WDW3: folds 
Uncalled bet ($2.86) returned to CAJUN890
CAJUN890 collected $2.86 from pot
CAJUN890: doesn't show hand 
*** SUMMARY ***
Total pot $3 | Rake $0.14 
Board [6c 7s Kh]
Seat 1: xHourglass folded before Flop (didn't bet)
Seat 2: tffff2006 folded before Flop (didn't bet)
Seat 3: CAJUN890 collected ($2.86)
Seat 4: matiko09 folded before Flop (didn't bet)
Seat 5: Pvsx. folded before Flop (didn't bet)
Seat 6: Jimy Tiltman folded before Flop (didn't bet)
Seat 7: Zeeshka (button) folded before Flop (didn't bet)
Seat 8: DUkalisUA (small blind) folded on the Flop
Seat 9: WDW3 (big blind) folded on the Flop





PokerStars Hand #150799869084:  Hold'em No Limit ($0.50/$1.00 USD) - 2016/03/23 13:47:05 CET [2016/03/23 8:47:05 ET]
Table 'Oljato' 9-max Seat #4 is the button
Seat 1: xHourglass ($111.76 in chips) 
Seat 2: roman134679 ($66.10 in chips) 
Seat 3: DUkalisUA ($100 in chips) 
Seat 4: Pvsx. ($139.60 in chips) 
Seat 5: ryo728 ($92.95 in chips) 
Seat 6: WDW3 ($117.11 in chips) 
Seat 7: matiko09 ($155.59 in chips) 
Seat 8: Zeeshka ($341.34 in chips) 
Seat 9: Jimy Tiltman ($110.06 in chips) 
ryo728: posts small blind $0.50
WDW3: posts big blind $1
*** HOLE CARDS ***
Dealt to matiko09 [8c 4c]
matiko09: folds 
Zeeshka: folds 
Jimy Tiltman: folds 
xHourglass: folds 
roman134679: raises $1.03 to $2.03
DUkalisUA: folds 
Pvsx.: folds 
ryo728: folds 
WDW3: calls $1.03
*** FLOP *** [Qc 6s 9s]
WDW3: checks 
roman134679: checks 
*** TURN *** [Qc 6s 9s] [7h]
WDW3: checks 
roman134679: bets $1.03
WDW3: folds 
Uncalled bet ($1.03) returned to roman134679
roman134679 collected $4.35 from pot
*** SUMMARY ***
Total pot $4.56 | Rake $0.21 
Board [Qc 6s 9s 7h]
Seat 1: xHourglass folded before Flop (didn't bet)
Seat 2: roman134679 collected ($4.35)
Seat 3: DUkalisUA folded before Flop (didn't bet)
Seat 4: Pvsx. (button) folded before Flop (didn't bet)
Seat 5: ryo728 (small blind) folded before Flop
Seat 6: WDW3 (big blind) folded on the Turn
Seat 7: matiko09 folded before Flop (didn't bet)
Seat 8: Zeeshka folded before Flop (didn't bet)
Seat 9: Jimy Tiltman folded before Flop (didn't bet)





PokerStars Hand #150799874693:  Hold'em No Limit ($0.50/$1.00 USD) - 2016/03/23 13:47:15 CET [2016/03/23 8:47:15 ET]
Table 'Merope II' 9-max Seat #8 is the button
Seat 1: Jimy Tiltman ($100 in chips) 
Seat 2: Zeeshka ($101.50 in chips) 
Seat 3: Sherlockplay ($100 in chips) 
Seat 4: YuriiSolodya ($30.50 in chips) 
Seat 5: DUkalisUA ($109.60 in chips) 
Seat 6: rebelTC ($81.71 in chips) 
Seat 7: matiko09 ($101.50 in chips) 
Seat 8: titentei ($96.50 in chips) 
Seat 9: RICKA16 ($99 in chips) 
RICKA16: posts small blind $0.50
Jimy Tiltman: posts big blind $1
*** HOLE CARDS ***
Dealt to matiko09 [4s 6h]
Zeeshka: folds 
Sherlockplay: folds 
YuriiSolodya: folds 
DUkalisUA: folds 
rebelTC: folds 
matiko09: folds 
titentei: folds 
RICKA16: folds 
Uncalled bet ($0.50) returned to Jimy Tiltman
Jimy Tiltman collected $1 from pot
Jimy Tiltman: doesn't show hand 
*** SUMMARY ***
Total pot $1 | Rake $0 
Seat 1: Jimy Tiltman (big blind) collected ($1)
Seat 2: Zeeshka folded before Flop (didn't bet)
Seat 3: Sherlockplay folded before Flop (didn't bet)
Seat 4: YuriiSolodya folded before Flop (didn't bet)
Seat 5: DUkalisUA folded before Flop (didn't bet)
Seat 6: rebelTC folded before Flop (didn't bet)
Seat 7: matiko09 folded before Flop (didn't bet)
Seat 8: titentei (button) folded before Flop (didn't bet)
Seat 9: RICKA16 (small blind) folded before Flop





PokerStars Hand #150799879523:  Hold'em No Limit ($1/$2 USD) - 2016/03/23 13:47:23 CET [2016/03/23 8:47:23 ET]
Table 'Kiess' 9-max Seat #7 is the button
Seat 1: Cirilico ($161.78 in chips) 
Seat 2: DUkalisUA ($479.57 in chips) 
Seat 3: The_red_area ($376.82 in chips) 
Seat 4: Moszes360 ($208.60 in chips) 
Seat 5: chippo boy ($313.39 in chips) 
Seat 6: matiko09 ($297.84 in chips) 
Seat 7: InsomniaRU ($273.17 in chips) 
Seat 8: WDW3 ($370.82 in chips) 
Seat 9: Fish4trips ($217.55 in chips) 
WDW3: posts small blind $1
Fish4trips: posts big blind $2
*** HOLE CARDS ***
Dealt to matiko09 [Tc 7c]
Cirilico: folds 
DUkalisUA: folds 
The_red_area: folds 
Moszes360: folds 
chippo boy: folds 
matiko09: folds 
InsomniaRU: raises $3 to $5
WDW3: folds 
Fish4trips: folds 
Uncalled bet ($3) returned to InsomniaRU
InsomniaRU collected $5 from pot
InsomniaRU: doesn't show hand 
*** SUMMARY ***
Total pot $5 | Rake $0 
Seat 1: Cirilico folded before Flop (didn't bet)
Seat 2: DUkalisUA folded before Flop (didn't bet)
Seat 3: The_red_area folded before Flop (didn't bet)
Seat 4: Moszes360 folded before Flop (didn't bet)
Seat 5: chippo boy folded before Flop (didn't bet)
Seat 6: matiko09 folded before Flop (didn't bet)
Seat 7: InsomniaRU (button) collected ($5)
Seat 8: WDW3 (small blind) folded before Flop
Seat 9: Fish4trips (big blind) folded before Flop





PokerStars Hand #150799883023:  Hold'em No Limit ($1/$2 USD) - 2016/03/23 13:47:29 CET [2016/03/23 8:47:29 ET]
Table 'Berbericia II' 9-max Seat #2 is the button
Seat 1: WDW3 ($206.05 in chips) 
Seat 2: Moszes360 ($221.52 in chips) 
Seat 3: Fish4trips ($219.02 in chips) 
Seat 4: bennetb77 ($97.34 in chips) 
Seat 5: darren1031 ($200 in chips) 
Seat 6: Charity86 ($178.88 in chips) 
Seat 8: matiko09 ($313.51 in chips) 
Seat 9: LVV-Bif ($295.90 in chips) 
Fish4trips: posts small blind $1
bennetb77: posts big blind $2
*** HOLE CARDS ***
Dealt to matiko09 [Ah Js]
darren1031: folds 
Charity86: folds 
matiko09: raises $3 to $5
LVV-Bif: folds 
WDW3: folds 
Moszes360: raises $11 to $16
Fish4trips: folds 
bennetb77: folds 
matiko09: folds 
Uncalled bet ($11) returned to Moszes360
Moszes360 collected $13 from pot
Moszes360: doesn't show hand 
*** SUMMARY ***
Total pot $13 | Rake $0 
Seat 1: WDW3 folded before Flop (didn't bet)
Seat 2: Moszes360 (button) collected ($13)
Seat 3: Fish4trips (small blind) folded before Flop
Seat 4: bennetb77 (big blind) folded before Flop
Seat 5: darren1031 folded before Flop (didn't bet)
Seat 6: Charity86 folded before Flop (didn't bet)
Seat 8: matiko09 folded before Flop
Seat 9: LVV-Bif folded before Flop (didn't bet)





PokerStars Hand #150799883527:  Hold'em No Limit ($0.25/$0.50 USD) - 2016/03/23 13:47:30 CET [2016/03/23 8:47:30 ET]
Table 'Pyrrhus' 9-max Seat #7 is the button
Seat 1: lumen21 ($50 in chips) 
Seat 3: IvanUrgant ($83.87 in chips) 
Seat 4: GriffinBerg ($12.89 in chips) 
Seat 5: Moszes360 ($53 in chips) 
Seat 6: whalldo ($165.12 in chips) 
Seat 7: matiko09 ($127.76 in chips) 
Seat 8: dndngod ($60.48 in chips) 
Seat 9: CvMCvMCvM ($109.90 in chips) 
dndngod: posts small blind $0.25
CvMCvMCvM: posts big blind $0.50
Zeeshka: sits out 
*** HOLE CARDS ***
Dealt to matiko09 [7c 3s]
lumen21: folds 
IvanUrgant: folds 
GriffinBerg: folds 
Moszes360: raises $1 to $1.50
whalldo: folds 
matiko09: folds 
dndngod: folds 
CvMCvMCvM: calls $1
*** FLOP *** [9h 3d Jh]
CvMCvMCvM: checks 
Moszes360: bets $2.04
CvMCvMCvM: calls $2.04
*** TURN *** [9h 3d Jh] [Qh]
CvMCvMCvM: checks 
Moszes360: checks 
*** RIVER *** [9h 3d Jh Qh] [Ad]
CvMCvMCvM: checks 
Moszes360: checks 
*** SHOW DOWN ***
CvMCvMCvM: shows [Td Qd] (a pair of Queens)
Moszes360: mucks hand 
CvMCvMCvM collected $7 from pot
*** SUMMARY ***
Total pot $7.33 | Rake $0.33 
Board [9h 3d Jh Qh Ad]
Seat 1: lumen21 folded before Flop (didn't bet)
Seat 3: IvanUrgant folded before Flop (didn't bet)
Seat 4: GriffinBerg folded before Flop (didn't bet)
Seat 5: Moszes360 mucked [8c 8h]
Seat 6: whalldo folded before Flop (didn't bet)
Seat 7: matiko09 (button) folded before Flop (didn't bet)
Seat 8: dndngod (small blind) folded before Flop
Seat 9: CvMCvMCvM (big blind) showed [Td Qd] and won ($7) with a pair of Queens





PokerStars Hand #150799884474:  Hold'em No Limit ($0.50/$1.00 USD) - 2016/03/23 13:47:32 CET [2016/03/23 8:47:32 ET]
Table 'Smiley' 9-max Seat #3 is the button
Seat 1: WDW3 ($118.58 in chips) 
Seat 2: Jimy Tiltman ($100 in chips) 
Seat 3: matiko09 ($104.48 in chips) 
Seat 4: Zeeshka ($147.42 in chips) 
Seat 5: DUkalisUA ($100 in chips) 
Seat 6: blackmont111 ($57.36 in chips) 
Seat 8: RICKA16 ($100 in chips) 
Seat 9: morosun ($163.95 in chips) 
Zeeshka: posts small blind $0.50
DUkalisUA: posts big blind $1
Moszes360: sits out 
*** HOLE CARDS ***
Dealt to matiko09 [Tc 5d]
blackmont111: raises $2 to $3
RICKA16: folds 
morosun: raises $2 to $5
WDW3: raises $7 to $12
Jimy Tiltman: folds 
matiko09: folds 
Zeeshka: folds 
DUkalisUA: folds 
blackmont111: raises $45.36 to $57.36 and is all-in
morosun: calls $52.36
WDW3: folds 
*** FLOP *** [8s Qd 5s]
*** TURN *** [8s Qd 5s] [3c]
*** RIVER *** [8s Qd 5s 3c] [8c]
*** SHOW DOWN ***
blackmont111: shows [Jd Jc] (two pair, Jacks and Eights)
morosun: shows [Kc Ac] (a pair of Eights)
blackmont111 collected $125.42 from pot
*** SUMMARY ***
Total pot $128.22 | Rake $2.80 
Board [8s Qd 5s 3c 8c]
Seat 1: WDW3 folded before Flop
Seat 2: Jimy Tiltman folded before Flop (didn't bet)
Seat 3: matiko09 (button) folded before Flop (didn't bet)
Seat 4: Zeeshka (small blind) folded before Flop
Seat 5: DUkalisUA (big blind) folded before Flop
Seat 6: blackmont111 showed [Jd Jc] and won ($125.42) with two pair, Jacks and Eights
Seat 8: RICKA16 folded before Flop (didn't bet)
Seat 9: morosun showed [Kc Ac] and lost with a pair of Eights





PokerStars Hand #150799884962:  Hold'em No Limit ($0.25/$0.50 USD) - 2016/03/23 13:47:33 CET [2016/03/23 8:47:33 ET]
Table 'Belnika' 9-max Seat #4 is the button
Seat 1: yellowfever0 ($33.88 in chips) 
Seat 2: NeverRegret7 ($55.24 in chips) 
Seat 3: ChiChioChi ($41.14 in chips) 
Seat 4: matiko09 ($66.10 in chips) 
Seat 5: IvanUrgant ($50 in chips) 
Seat 6: Ahangama ($64 in chips) 
Seat 7: Zeeshka ($50 in chips) 
Seat 8: lumen21 ($67.39 in chips) 
Seat 9: dndngod ($61.91 in chips) 
IvanUrgant: posts small blind $0.25
Ahangama: posts big blind $0.50
*** HOLE CARDS ***
Dealt to matiko09 [Qd 3d]
Zeeshka: folds 
lumen21: raises $1 to $1.50
dndngod: folds 
yellowfever0: calls $1.50
NeverRegret7: calls $1.50
ChiChioChi: folds 
matiko09: folds 
IvanUrgant: folds 
Ahangama: folds 
*** FLOP *** [6c Ts 4c]
lumen21: checks 
yellowfever0: bets $2.50
NeverRegret7: calls $2.50
lumen21: calls $2.50
*** TURN *** [6c Ts 4c] [2d]
lumen21: checks 
yellowfever0: bets $7
NeverRegret7: folds 
lumen21: folds 
Uncalled bet ($7) returned to yellowfever0
yellowfever0 collected $12.18 from pot
yellowfever0: doesn't show hand 
*** SUMMARY ***
Total pot $12.75 | Rake $0.57 
Board [6c Ts 4c 2d]
Seat 1: yellowfever0 collected ($12.18)
Seat 2: NeverRegret7 folded on the Turn
Seat 3: ChiChioChi folded before Flop (didn't bet)
Seat 4: matiko09 (button) folded before Flop (didn't bet)
Seat 5: IvanUrgant (small blind) folded before Flop
Seat 6: Ahangama (big blind) folded before Flop
Seat 7: Zeeshka folded before Flop (didn't bet)
Seat 8: lumen21 folded on the Turn
Seat 9: dndngod folded before Flop (didn't bet)





PokerStars Hand #150799887291:  Hold'em No Limit ($0.50/$1.00 USD) - 2016/03/23 13:47:37 CET [2016/03/23 8:47:37 ET]
Table 'Kippes' 9-max Seat #2 is the button
Seat 1: Pvsx. ($101.50 in chips) 
Seat 2: RICKA16 ($124.63 in chips) 
Seat 3: CAJUN890 ($126.31 in chips) 
Seat 4: matiko09 ($109.22 in chips) 
Seat 5: Jimy Tiltman ($112.36 in chips) 
Seat 6: WDW3 ($118.07 in chips) 
Seat 7: lumen21 ($100 in chips) 
Seat 8: Zeeshka ($117.80 in chips) 
Seat 9: wang19790906 ($82.17 in chips) 
CAJUN890: posts small blind $0.50
matiko09: posts big blind $1
*** HOLE CARDS ***
Dealt to matiko09 [Ks 8c]
Jimy Tiltman: folds 
WDW3: folds 
lumen21 has timed out
lumen21: folds 
Zeeshka: folds 
wang19790906: raises $3 to $4
Pvsx.: folds 
RICKA16: folds 
CAJUN890: folds 
matiko09: folds 
Uncalled bet ($3) returned to wang19790906
wang19790906 collected $2.50 from pot
wang19790906: doesn't show hand 
*** SUMMARY ***
Total pot $2.50 | Rake $0 
Seat 1: Pvsx. folded before Flop (didn't bet)
Seat 2: RICKA16 (button) folded before Flop (didn't bet)
Seat 3: CAJUN890 (small blind) folded before Flop
Seat 4: matiko09 (big blind) folded before Flop
Seat 5: Jimy Tiltman folded before Flop (didn't bet)
Seat 6: WDW3 folded before Flop (didn't bet)
Seat 7: lumen21 folded before Flop (didn't bet)
Seat 8: Zeeshka folded before Flop (didn't bet)
Seat 9: wang19790906 collected ($2.50)





PokerStars Hand #150799888168:  Hold'em No Limit (€0.25/€0.50 EUR) - 2016/03/23 13:47:39 CET [2016/03/23 8:47:39 ET]
Table 'Palma II' 9-max Seat #5 is the button
Seat 2: matiko09 (€51.60 in chips) 
Seat 3: ardo888 (€51.79 in chips) 
Seat 4: dndngod (€70.77 in chips) 
Seat 5: SVFB13 (€49.75 in chips) 
Seat 6: CAJUN890 (€49.50 in chips) 
Seat 7: Kuca :P (€50 in chips) 
CAJUN890: posts small blind €0.25
Kuca :P: posts big blind €0.50
Effort92: sits out 
Red_Warning: sits out 
Aalleekks: sits out 
*** HOLE CARDS ***
Dealt to matiko09 [5h 4d]
matiko09: folds 
ardo888: folds 
dndngod: raises €0.75 to €1.25
SVFB13: raises €3.25 to €4.50
CAJUN890: folds 
Kuca :P: folds 
dndngod: folds 
Uncalled bet (€3.25) returned to SVFB13
SVFB13 collected €3.25 from pot
SVFB13: doesn't show hand 
*** SUMMARY ***
Total pot €3.25 | Rake €0 
Seat 2: matiko09 folded before Flop (didn't bet)
Seat 3: ardo888 folded before Flop (didn't bet)
Seat 4: dndngod folded before Flop
Seat 5: SVFB13 (button) collected (€3.25)
Seat 6: CAJUN890 (small blind) folded before Flop
Seat 7: Kuca :P (big blind) folded before Flop





PokerStars Hand #150799889905:  Hold'em No Limit ($1/$2 USD) - 2016/03/23 13:47:42 CET [2016/03/23 8:47:42 ET]
Table 'Herba II' 9-max Seat #6 is the button
Seat 1: matiko09 ($232.48 in chips) 
Seat 2: Moszes360 ($210.20 in chips) 
Seat 3: Cirilico ($162.60 in chips) 
Seat 4: DUkalisUA ($286.78 in chips) 
Seat 5: chippo boy ($231.04 in chips) 
Seat 6: WDW3 ($210.33 in chips) 
Seat 7: InsomniaRU ($214.42 in chips) 
Seat 8: The_red_area ($432.73 in chips) 
Seat 9: mrhighryza ($51.13 in chips) 
InsomniaRU: posts small blind $1
The_red_area: posts big blind $2
*** HOLE CARDS ***
Dealt to matiko09 [Kc Jh]
mrhighryza: folds 
matiko09: folds 
Moszes360: folds 
Cirilico: folds 
DUkalisUA: folds 
chippo boy: folds 
WDW3: folds 
InsomniaRU: raises $4 to $6
The_red_area: folds 
Uncalled bet ($4) returned to InsomniaRU
InsomniaRU collected $4 from pot
InsomniaRU: doesn't show hand 
*** SUMMARY ***
Total pot $4 | Rake $0 
Seat 1: matiko09 folded before Flop (didn't bet)
Seat 2: Moszes360 folded before Flop (didn't bet)
Seat 3: Cirilico folded before Flop (didn't bet)
Seat 4: DUkalisUA folded before Flop (didn't bet)
Seat 5: chippo boy folded before Flop (didn't bet)
Seat 6: WDW3 (button) folded before Flop (didn't bet)
Seat 7: InsomniaRU (small blind) collected ($4)
Seat 8: The_red_area (big blind) folded before Flop
Seat 9: mrhighryza folded before Flop (didn't bet)





PokerStars Hand #150799890556:  Hold'em No Limit ($0.50/$1.00 USD) - 2016/03/23 13:47:43 CET [2016/03/23 8:47:43 ET]
Table 'Merope II' 9-max Seat #9 is the button
Seat 1: Jimy Tiltman ($100.50 in chips) 
Seat 2: Zeeshka ($101.50 in chips) 
Seat 3: Sherlockplay ($100 in chips) 
Seat 4: YuriiSolodya ($30.50 in chips) 
Seat 5: DUkalisUA ($109.60 in chips) 
Seat 6: rebelTC ($81.71 in chips) 
Seat 7: matiko09 ($101.50 in chips) 
Seat 8: titentei ($96.50 in chips) 
Seat 9: RICKA16 ($98.50 in chips) 
Jimy Tiltman: posts small blind $0.50
Zeeshka: posts big blind $1
*** HOLE CARDS ***
Dealt to matiko09 [4c 8h]
Sherlockplay: folds 
YuriiSolodya: raises $1 to $2
DUkalisUA: folds 
rebelTC: folds 
matiko09: folds 
titentei: folds 
RICKA16: folds 
Jimy Tiltman: folds 
Zeeshka: folds 
Uncalled bet ($1) returned to YuriiSolodya
YuriiSolodya collected $2.50 from pot
YuriiSolodya: doesn't show hand 
*** SUMMARY ***
Total pot $2.50 | Rake $0 
Seat 1: Jimy Tiltman (small blind) folded before Flop
Seat 2: Zeeshka (big blind) folded before Flop
Seat 3: Sherlockplay folded before Flop (didn't bet)
Seat 4: YuriiSolodya collected ($2.50)
Seat 5: DUkalisUA folded before Flop (didn't bet)
Seat 6: rebelTC folded before Flop (didn't bet)
Seat 7: matiko09 folded before Flop (didn't bet)
Seat 8: titentei folded before Flop (didn't bet)
Seat 9: RICKA16 (button) folded before Flop (didn't bet)





PokerStars Hand #150799892812:  Hold'em No Limit ($0.50/$1.00 USD) - 2016/03/23 13:47:47 CET [2016/03/23 8:47:47 ET]
Table 'Atlantis' 9-max Seat #8 is the button
Seat 1: xHourglass ($160.28 in chips) 
Seat 2: tffff2006 ($47.96 in chips) 
Seat 3: CAJUN890 ($108.96 in chips) 
Seat 4: matiko09 ($123.95 in chips) 
Seat 5: Pvsx. ($100 in chips) 
Seat 6: Jimy Tiltman ($134.74 in chips) 
Seat 7: Zeeshka ($106.32 in chips) 
Seat 8: DUkalisUA ($100 in chips) 
Seat 9: WDW3 ($123.26 in chips) 
WDW3: posts small blind $0.50
xHourglass: posts big blind $1
*** HOLE CARDS ***
Dealt to matiko09 [2s 9d]
tffff2006: folds 
CAJUN890: folds 
matiko09: folds 
Pvsx.: folds 
Jimy Tiltman: folds 
Zeeshka: folds 
DUkalisUA: raises $1 to $2
WDW3: folds 
xHourglass: folds 
Uncalled bet ($1) returned to DUkalisUA
DUkalisUA collected $2.50 from pot
DUkalisUA: doesn't show hand 
*** SUMMARY ***
Total pot $2.50 | Rake $0 
Seat 1: xHourglass (big blind) folded before Flop
Seat 2: tffff2006 folded before Flop (didn't bet)
Seat 3: CAJUN890 folded before Flop (didn't bet)
Seat 4: matiko09 folded before Flop (didn't bet)
Seat 5: Pvsx. folded before Flop (didn't bet)
Seat 6: Jimy Tiltman folded before Flop (didn't bet)
Seat 7: Zeeshka folded before Flop (didn't bet)
Seat 8: DUkalisUA (button) collected ($2.50)
Seat 9: WDW3 (small blind) folded before Flop





PokerStars Hand #150799894272:  Hold'em No Limit (€0.25/€0.50 EUR) - 2016/03/23 13:47:49 CET [2016/03/23 8:47:49 ET]
Table 'Hesperia II' 9-max Seat #1 is the button
Seat 1: CAJUN890 (€55.55 in chips) 
Seat 2: dndngod (€50.94 in chips) 
Seat 3: IvanUrgant (€59.05 in chips) 
Seat 4: Zelenis (€21.15 in chips) 
Seat 5: Avrora-sp (€50 in chips) 
Seat 6: CvMCvMCvM (€50 in chips) 
Seat 7: matiko09 (€60.98 in chips) 
Seat 8: Ahangama (€50 in chips) 
Seat 9: Red_Warning (€50 in chips) 
dndngod: posts small blind €0.25
IvanUrgant: posts big blind €0.50
*** HOLE CARDS ***
Dealt to matiko09 [Kc 6d]
Zelenis: raises €1 to €1.50
Avrora-sp: folds 
CvMCvMCvM: folds 
matiko09: folds 
Ahangama: folds 
Red_Warning: folds 
CAJUN890: folds 
dndngod: folds 
IvanUrgant: folds 
Uncalled bet (€1) returned to Zelenis
Zelenis collected €1.25 from pot
Zelenis: doesn't show hand 
*** SUMMARY ***
Total pot €1.25 | Rake €0 
Seat 1: CAJUN890 (button) folded before Flop (didn't bet)
Seat 2: dndngod (small blind) folded before Flop
Seat 3: IvanUrgant (big blind) folded before Flop
Seat 4: Zelenis collected (€1.25)
Seat 5: Avrora-sp folded before Flop (didn't bet)
Seat 6: CvMCvMCvM folded before Flop (didn't bet)
Seat 7: matiko09 folded before Flop (didn't bet)
Seat 8: Ahangama folded before Flop (didn't bet)
Seat 9: Red_Warning folded before Flop (didn't bet)





PokerStars Hand #150799898520:  Hold'em No Limit ($1/$2 USD) - 2016/03/23 13:47:57 CET [2016/03/23 8:47:57 ET]
Table 'Kiess' 9-max Seat #8 is the button
Seat 1: Cirilico ($161.78 in chips) 
Seat 2: DUkalisUA ($479.57 in chips) 
Seat 3: The_red_area ($376.82 in chips) 
Seat 4: Moszes360 ($208.60 in chips) 
Seat 5: chippo boy ($313.39 in chips) 
Seat 6: matiko09 ($297.84 in chips) 
Seat 7: InsomniaRU ($276.17 in chips) 
Seat 8: WDW3 ($369.82 in chips) 
Seat 9: Fish4trips ($215.55 in chips) 
Fish4trips: posts small blind $1
Cirilico: posts big blind $2
*** HOLE CARDS ***
Dealt to matiko09 [5c 6d]
DUkalisUA: folds 
The_red_area: folds 
Moszes360: folds 
chippo boy: calls $2
matiko09: folds 
InsomniaRU: folds 
WDW3: folds 
Fish4trips: folds 
Cirilico: checks 
*** FLOP *** [Kd Js 9s]
Cirilico: checks 
chippo boy: checks 
*** TURN *** [Kd Js 9s] [Qs]
Cirilico: checks 
chippo boy: checks 
*** RIVER *** [Kd Js 9s Qs] [3s]
Cirilico: checks 
chippo boy: checks 
*** SHOW DOWN ***
Cirilico: shows [6s 5h] (a flush, Queen high)
chippo boy: mucks hand 
Cirilico collected $4.78 from pot
*** SUMMARY ***
Total pot $5 | Rake $0.22 
Board [Kd Js 9s Qs 3s]
Seat 1: Cirilico (big blind) showed [6s 5h] and won ($4.78) with a flush, Queen high
Seat 2: DUkalisUA folded before Flop (didn't bet)
Seat 3: The_red_area folded before Flop (didn't bet)
Seat 4: Moszes360 folded before Flop (didn't bet)
Seat 5: chippo boy mucked [5d Ah]
Seat 6: matiko09 folded before Flop (didn't bet)
Seat 7: InsomniaRU folded before Flop (didn't bet)
Seat 8: WDW3 (button) folded before Flop (didn't bet)
Seat 9: Fish4trips (small blind) folded before Flop





PokerStars Hand #150799899960:  Hold'em No Limit ($0.50/$1.00 USD) - 2016/03/23 13:47:59 CET [2016/03/23 8:47:59 ET]
Table 'Oljato' 9-max Seat #5 is the button
Seat 1: xHourglass ($111.76 in chips) 
Seat 2: roman134679 ($68.42 in chips) 
Seat 3: DUkalisUA ($100 in chips) 
Seat 4: Pvsx. ($139.60 in chips) 
Seat 5: ryo728 ($92.45 in chips) 
Seat 6: WDW3 ($115.08 in chips) 
Seat 7: matiko09 ($155.59 in chips) 
Seat 8: Zeeshka ($341.34 in chips) 
Seat 9: Jimy Tiltman ($110.06 in chips) 
WDW3: posts small blind $0.50
matiko09: posts big blind $1
*** HOLE CARDS ***
Dealt to matiko09 [Qd Th]
Zeeshka: folds 
Jimy Tiltman: folds 
xHourglass: raises $2 to $3
roman134679: folds 
DUkalisUA: folds 
Pvsx.: folds 
ryo728 is disconnected 
ryo728 has timed out while disconnected
ryo728: folds 
WDW3: folds 
matiko09: folds 
Uncalled bet ($2) returned to xHourglass
xHourglass collected $2.50 from pot
xHourglass: doesn't show hand 
*** SUMMARY ***
Total pot $2.50 | Rake $0 
Seat 1: xHourglass collected ($2.50)
Seat 2: roman134679 folded before Flop (didn't bet)
Seat 3: DUkalisUA folded before Flop (didn't bet)
Seat 4: Pvsx. folded before Flop (didn't bet)
Seat 5: ryo728 (button) folded before Flop (didn't bet)
Seat 6: WDW3 (small blind) folded before Flop
Seat 7: matiko09 (big blind) folded before Flop
Seat 8: Zeeshka folded before Flop (didn't bet)
Seat 9: Jimy Tiltman folded before Flop (didn't bet)





PokerStars Hand #150799909570:  Hold'em No Limit (€0.25/€0.50 EUR) - 2016/03/23 13:48:16 CET [2016/03/23 8:48:16 ET]
Table 'Palma II' 9-max Seat #6 is the button
Seat 2: matiko09 (€51.60 in chips) 
Seat 3: ardo888 (€51.79 in chips) 
Seat 4: dndngod (€69.52 in chips) 
Seat 5: SVFB13 (€51.75 in chips) 
Seat 6: CAJUN890 (€49.25 in chips) 
Seat 7: Kuca :P (€50 in chips) 
Seat 8: Effort92 (€50 in chips) 
Kuca :P: posts small blind €0.25
Effort92: posts big blind €0.50
Red_Warning: sits out 
Aalleekks: sits out 
*** HOLE CARDS ***
Dealt to matiko09 [4c 5d]
matiko09: folds 
ardo888: raises €1 to €1.50
dndngod: folds 
SVFB13: folds 
CAJUN890: calls €1.50
Kuca :P: folds 
Effort92: folds 
*** FLOP *** [5c 2d 5s]
ardo888: checks 
CAJUN890: bets €2
ardo888: calls €2
*** TURN *** [5c 2d 5s] [7h]
ardo888: checks 
CAJUN890: checks 
*** RIVER *** [5c 2d 5s 7h] [Kd]
ardo888: checks 
CAJUN890: checks 
*** SHOW DOWN ***
ardo888: shows [Ah Qd] (a pair of Fives)
CAJUN890: mucks hand 
ardo888 collected €7.40 from pot
*** SUMMARY ***
Total pot €7.75 | Rake €0.35 
Board [5c 2d 5s 7h Kd]
Seat 2: matiko09 folded before Flop (didn't bet)
Seat 3: ardo888 showed [Ah Qd] and won (€7.40) with a pair of Fives
Seat 4: dndngod folded before Flop (didn't bet)
Seat 5: SVFB13 folded before Flop (didn't bet)
Seat 6: CAJUN890 (button) mucked [Qh Jc]
Seat 7: Kuca :P (small blind) folded before Flop
Seat 8: Effort92 (big blind) folded before Flop





PokerStars Hand #150799910991:  Hold'em No Limit ($1/$2 USD) - 2016/03/23 13:48:19 CET [2016/03/23 8:48:19 ET]
Table 'Herba II' 9-max Seat #7 is the button
Seat 1: matiko09 ($232.48 in chips) 
Seat 2: Moszes360 ($210.20 in chips) 
Seat 3: Cirilico ($162.60 in chips) 
Seat 4: DUkalisUA ($286.78 in chips) 
Seat 5: chippo boy ($231.04 in chips) 
Seat 6: WDW3 ($210.33 in chips) 
Seat 7: InsomniaRU ($216.42 in chips) 
Seat 8: The_red_area ($430.73 in chips) 
Seat 9: mrhighryza ($51.13 in chips) 
The_red_area: posts small blind $1
mrhighryza: posts big blind $2
*** HOLE CARDS ***
Dealt to matiko09 [3h Jc]
matiko09: folds 
Moszes360: folds 
Cirilico: folds 
DUkalisUA: folds 
chippo boy: raises $4 to $6
WDW3: folds 
InsomniaRU: folds 
The_red_area: raises $14 to $20
mrhighryza: folds 
chippo boy: calls $14
*** FLOP *** [5d Jd 8c]
The_red_area: bets $40.11
chippo boy: folds 
Uncalled bet ($40.11) returned to The_red_area
The_red_area collected $40.11 from pot
The_red_area: doesn't show hand 
*** SUMMARY ***
Total pot $42 | Rake $1.89 
Board [5d Jd 8c]
Seat 1: matiko09 folded before Flop (didn't bet)
Seat 2: Moszes360 folded before Flop (didn't bet)
Seat 3: Cirilico folded before Flop (didn't bet)
Seat 4: DUkalisUA folded before Flop (didn't bet)
Seat 5: chippo boy folded on the Flop
Seat 6: WDW3 folded before Flop (didn't bet)
Seat 7: InsomniaRU (button) folded before Flop (didn't bet)
Seat 8: The_red_area (small blind) collected ($40.11)
Seat 9: mrhighryza (big blind) folded before Flop





PokerStars Hand #150799912928:  Hold'em No Limit ($0.50/$1.00 USD) - 2016/03/23 13:48:22 CET [2016/03/23 8:48:22 ET]
Table 'Atlantis' 9-max Seat #9 is the button
Seat 1: xHourglass ($159.28 in chips) 
Seat 2: tffff2006 ($47.96 in chips) 
Seat 3: CAJUN890 ($108.96 in chips) 
Seat 4: matiko09 ($123.95 in chips) 
Seat 5: Pvsx. ($100 in chips) 
Seat 6: Jimy Tiltman ($134.74 in chips) 
Seat 7: Zeeshka ($106.32 in chips) 
Seat 8: DUkalisUA ($101.50 in chips) 
Seat 9: WDW3 ($122.76 in chips) 
xHourglass: posts small blind $0.50
tffff2006: posts big blind $1
*** HOLE CARDS ***
Dealt to matiko09 [5d Ks]
CAJUN890: folds 
matiko09: folds 
Pvsx.: folds 
Jimy Tiltman: folds 
Zeeshka: folds 
DUkalisUA: folds 
WDW3: folds 
xHourglass: calls $0.50
tffff2006: raises $1 to $2
xHourglass: calls $1
*** FLOP *** [2c 8h Tc]
xHourglass: checks 
tffff2006: bets $1.91
xHourglass: folds 
Uncalled bet ($1.91) returned to tffff2006
tffff2006 collected $3.82 from pot
*** SUMMARY ***
Total pot $4 | Rake $0.18 
Board [2c 8h Tc]
Seat 1: xHourglass (small blind) folded on the Flop
Seat 2: tffff2006 (big blind) collected ($3.82)
Seat 3: CAJUN890 folded before Flop (didn't bet)
Seat 4: matiko09 folded before Flop (didn't bet)
Seat 5: Pvsx. folded before Flop (didn't bet)
Seat 6: Jimy Tiltman folded before Flop (didn't bet)
Seat 7: Zeeshka folded before Flop (didn't bet)
Seat 8: DUkalisUA folded before Flop (didn't bet)
Seat 9: WDW3 (button) folded before Flop (didn't bet)





PokerStars Hand #150799913687:  Hold'em No Limit ($1/$2 USD) - 2016/03/23 13:48:24 CET [2016/03/23 8:48:24 ET]
Table 'Berbericia II' 9-max Seat #3 is the button
Seat 1: WDW3 ($206.05 in chips) 
Seat 2: Moszes360 ($229.52 in chips) 
Seat 3: Fish4trips ($218.02 in chips) 
Seat 4: bennetb77 ($95.34 in chips) 
Seat 5: darren1031 ($200 in chips) 
Seat 6: Charity86 ($178.88 in chips) 
Seat 8: matiko09 ($308.51 in chips) 
Seat 9: LVV-Bif ($295.90 in chips) 
bennetb77: posts small blind $1
darren1031: posts big blind $2
*** HOLE CARDS ***
Dealt to matiko09 [8h 9h]
Charity86: folds 
matiko09: raises $3 to $5
LVV-Bif: folds 
WDW3: folds 
Moszes360: folds 
Fish4trips: raises $10 to $15
bennetb77: folds 
darren1031: folds 
matiko09: folds 
Uncalled bet ($10) returned to Fish4trips
Fish4trips collected $13 from pot
Fish4trips: doesn't show hand 
*** SUMMARY ***
Total pot $13 | Rake $0 
Seat 1: WDW3 folded before Flop (didn't bet)
Seat 2: Moszes360 folded before Flop (didn't bet)
Seat 3: Fish4trips (button) collected ($13)
Seat 4: bennetb77 (small blind) folded before Flop
Seat 5: darren1031 (big blind) folded before Flop
Seat 6: Charity86 folded before Flop (didn't bet)
Seat 8: matiko09 folded before Flop
Seat 9: LVV-Bif folded before Flop (didn't bet)





PokerStars Hand #150799916898:  Hold'em No Limit ($1/$2 USD) - 2016/03/23 13:48:29 CET [2016/03/23 8:48:29 ET]
Table 'Kypria II' 9-max Seat #8 is the button
Seat 1: geldwolfje ($163.66 in chips) 
Seat 2: coinflip_si ($200 in chips) 
Seat 3: seouljam ($205.73 in chips) 
Seat 4: nailz83 ($60.09 in chips) 
Seat 5: InsomniaRU ($348.62 in chips) 
Seat 6: matiko09 ($288.69 in chips) 
Seat 7: DUkalisUA ($200 in chips) 
Seat 8: Fish4trips ($346.79 in chips) 
Seat 9: WDW3 ($200 in chips) 
WDW3: posts small blind $1
geldwolfje: posts big blind $2
*** HOLE CARDS ***
Dealt to matiko09 [2s Ts]
seouljam said, "^^"
geldwolfje said, "nice"
coinflip_si: folds 
seouljam: folds 
nailz83: folds 
InsomniaRU: folds 
matiko09: folds 
DUkalisUA: raises $4 to $6
Fish4trips: folds 
WDW3: calls $5
geldwolfje: calls $4
*** FLOP *** [Ac Ah 6s]
WDW3: checks 
geldwolfje: checks 
DUkalisUA: checks 
*** TURN *** [Ac Ah 6s] [2c]
WDW3: checks 
geldwolfje: checks 
DUkalisUA: checks 
*** RIVER *** [Ac Ah 6s 2c] [Th]
WDW3: checks 
geldwolfje: checks 
DUkalisUA: checks 
*** SHOW DOWN ***
WDW3: shows [Tc Qh] (two pair, Aces and Tens)
geldwolfje: mucks hand 
DUkalisUA: mucks hand 
WDW3 collected $17.19 from pot
*** SUMMARY ***
Total pot $18 | Rake $0.81 
Board [Ac Ah 6s 2c Th]
Seat 1: geldwolfje (big blind) mucked [Qd 3c]
Seat 2: coinflip_si folded before Flop (didn't bet)
Seat 3: seouljam folded before Flop (didn't bet)
Seat 4: nailz83 folded before Flop (didn't bet)
Seat 5: InsomniaRU folded before Flop (didn't bet)
Seat 6: matiko09 folded before Flop (didn't bet)
Seat 7: DUkalisUA mucked [Kh Jh]
Seat 8: Fish4trips (button) folded before Flop (didn't bet)
Seat 9: WDW3 (small blind) showed [Tc Qh] and won ($17.19) with two pair, Aces and Tens





PokerStars Hand #150799922197:  Hold'em No Limit ($0.50/$1.00 USD) - 2016/03/23 13:48:39 CET [2016/03/23 8:48:39 ET]
Table 'Oljato' 9-max Seat #6 is the button
Seat 1: xHourglass ($113.26 in chips) 
Seat 2: roman134679 ($68.42 in chips) 
Seat 3: DUkalisUA ($100 in chips) 
Seat 4: Pvsx. ($139.60 in chips) 
Seat 6: WDW3 ($114.58 in chips) 
Seat 7: matiko09 ($154.59 in chips) 
Seat 8: Zeeshka ($341.34 in chips) 
Seat 9: Jimy Tiltman ($110.06 in chips) 
matiko09: posts small blind $0.50
Zeeshka: posts big blind $1
*** HOLE CARDS ***
Dealt to matiko09 [7d Kh]
Jimy Tiltman: folds 
xHourglass: raises $2 to $3
roman134679: raises $2.70 to $5.70
DUkalisUA: folds 
Pvsx.: folds 
WDW3: folds 
matiko09: folds 
Zeeshka: folds 
xHourglass: calls $2.70
*** FLOP *** [Qs Ks 3c]
xHourglass: bets $7.50
roman134679: folds 
Uncalled bet ($7.50) returned to xHourglass
xHourglass collected $12.32 from pot
xHourglass: doesn't show hand 
*** SUMMARY ***
Total pot $12.90 | Rake $0.58 
Board [Qs Ks 3c]
Seat 1: xHourglass collected ($12.32)
Seat 2: roman134679 folded on the Flop
Seat 3: DUkalisUA folded before Flop (didn't bet)
Seat 4: Pvsx. folded before Flop (didn't bet)
Seat 6: WDW3 (button) folded before Flop (didn't bet)
Seat 7: matiko09 (small blind) folded before Flop
Seat 8: Zeeshka (big blind) folded before Flop
Seat 9: Jimy Tiltman folded before Flop (didn't bet)





PokerStars Hand #150799922778:  Hold'em No Limit ($0.50/$1.00 USD) - 2016/03/23 13:48:40 CET [2016/03/23 8:48:40 ET]
Table 'Kippes' 9-max Seat #3 is the button
Seat 1: Pvsx. ($101.50 in chips) 
Seat 2: RICKA16 ($124.63 in chips) 
Seat 3: CAJUN890 ($125.81 in chips) 
Seat 4: matiko09 ($108.22 in chips) 
Seat 5: Jimy Tiltman ($112.36 in chips) 
Seat 6: WDW3 ($118.07 in chips) 
Seat 7: lumen21 ($100 in chips) 
Seat 8: Zeeshka ($117.80 in chips) 
Seat 9: wang19790906 ($83.67 in chips) 
matiko09: posts small blind $0.50
Jimy Tiltman: posts big blind $1
*** HOLE CARDS ***
Dealt to matiko09 [3c 4h]
WDW3: folds 
lumen21: folds 
Zeeshka: folds 
wang19790906: folds 
Pvsx.: raises $1.50 to $2.50
RICKA16: raises $7.50 to $10
CAJUN890: folds 
matiko09: folds 
Jimy Tiltman: folds 
Pvsx.: folds 
Uncalled bet ($7.50) returned to RICKA16
RICKA16 collected $6.50 from pot
RICKA16: doesn't show hand 
*** SUMMARY ***
Total pot $6.50 | Rake $0 
Seat 1: Pvsx. folded before Flop
Seat 2: RICKA16 collected ($6.50)
Seat 3: CAJUN890 (button) folded before Flop (didn't bet)
Seat 4: matiko09 (small blind) folded before Flop
Seat 5: Jimy Tiltman (big blind) folded before Flop
Seat 6: WDW3 folded before Flop (didn't bet)
Seat 7: lumen21 folded before Flop (didn't bet)
Seat 8: Zeeshka folded before Flop (didn't bet)
Seat 9: wang19790906 folded before Flop (didn't bet)





PokerStars Hand #150799925328:  Hold'em No Limit (€0.25/€0.50 EUR) - 2016/03/23 13:48:44 CET [2016/03/23 8:48:44 ET]
Table 'Hesperia II' 9-max Seat #2 is the button
Seat 1: CAJUN890 (€55.55 in chips) 
Seat 2: dndngod (€50.69 in chips) 
Seat 3: IvanUrgant (€58.55 in chips) 
Seat 4: Zelenis (€21.90 in chips) 
Seat 5: Avrora-sp (€50 in chips) 
Seat 6: CvMCvMCvM (€50 in chips) 
Seat 7: matiko09 (€60.98 in chips) 
Seat 8: Ahangama (€50 in chips) 
Seat 9: Red_Warning (€50 in chips) 
IvanUrgant: posts small blind €0.25
Zelenis: posts big blind €0.50
*** HOLE CARDS ***
Dealt to matiko09 [Ks 7c]
Avrora-sp: folds 
CvMCvMCvM: folds 
matiko09: folds 
Ahangama: folds 
Red_Warning: raises €1 to €1.50
CAJUN890: calls €1.50
dndngod: folds 
IvanUrgant: calls €1.25
Zelenis: folds 
*** FLOP *** [7d Tc 7s]
IvanUrgant: checks 
Red_Warning: checks 
CAJUN890: bets €4.78
IvanUrgant: folds 
Red_Warning: folds 
Uncalled bet (€4.78) returned to CAJUN890
CAJUN890 collected €4.78 from pot
CAJUN890: doesn't show hand 
*** SUMMARY ***
Total pot €5 | Rake €0.22 
Board [7d Tc 7s]
Seat 1: CAJUN890 collected (€4.78)
Seat 2: dndngod (button) folded before Flop (didn't bet)
Seat 3: IvanUrgant (small blind) folded on the Flop
Seat 4: Zelenis (big blind) folded before Flop
Seat 5: Avrora-sp folded before Flop (didn't bet)
Seat 6: CvMCvMCvM folded before Flop (didn't bet)
Seat 7: matiko09 folded before Flop (didn't bet)
Seat 8: Ahangama folded before Flop (didn't bet)
Seat 9: Red_Warning folded on the Flop





PokerStars Hand #150799926357:  Hold'em No Limit ($0.50/$1.00 USD) - 2016/03/23 13:48:46 CET [2016/03/23 8:48:46 ET]
Table 'Smiley' 9-max Seat #4 is the button
Seat 1: WDW3 ($106.58 in chips) 
Seat 2: Jimy Tiltman ($100 in chips) 
Seat 3: matiko09 ($104.48 in chips) 
Seat 4: Zeeshka ($146.92 in chips) 
Seat 5: DUkalisUA ($100 in chips) 
Seat 6: blackmont111 ($125.42 in chips) 
Seat 8: RICKA16 ($100 in chips) 
Seat 9: morosun ($106.59 in chips) 
DUkalisUA: posts small blind $0.50
blackmont111: posts big blind $1
Moszes360: sits out 
*** HOLE CARDS ***
Dealt to matiko09 [Ad 5d]
RICKA16: folds 
morosun: folds 
WDW3: folds 
Jimy Tiltman: folds 
matiko09: raises $1.50 to $2.50
Zeeshka: folds 
DUkalisUA: folds 
blackmont111: calls $1.50
*** FLOP *** [Qh 2h 9c]
blackmont111: checks 
matiko09: checks 
*** TURN *** [Qh 2h 9c] [Ks]
blackmont111: bets $2
matiko09: folds 
Uncalled bet ($2) returned to blackmont111
blackmont111 collected $5.25 from pot
blackmont111: doesn't show hand 
*** SUMMARY ***
Total pot $5.50 | Rake $0.25 
Board [Qh 2h 9c Ks]
Seat 1: WDW3 folded before Flop (didn't bet)
Seat 2: Jimy Tiltman folded before Flop (didn't bet)
Seat 3: matiko09 folded on the Turn
Seat 4: Zeeshka (button) folded before Flop (didn't bet)
Seat 5: DUkalisUA (small blind) folded before Flop
Seat 6: blackmont111 (big blind) collected ($5.25)
Seat 8: RICKA16 folded before Flop (didn't bet)
Seat 9: morosun folded before Flop (didn't bet)





PokerStars Hand #150799928675:  Hold'em No Limit ($0.50/$1.00 USD) - 2016/03/23 13:48:50 CET [2016/03/23 8:48:50 ET]
Table 'Donar II' 9-max Seat #3 is the button
Seat 2: nobrunobru1 ($76.27 in chips) 
Seat 3: st-germ30 ($97.61 in chips) 
Seat 4: DUkalisUA ($103.80 in chips) 
Seat 5: matiko09 ($100 in chips) 
Seat 6: ardo888 ($114.69 in chips) 
Seat 7: hammerwife ($102.30 in chips) 
Seat 9: WDW3 ($126.02 in chips) 
DUkalisUA: posts small blind $0.50
matiko09: posts big blind $1
Effort92: sits out 
nobrunobru1: posts the ante $0.20
st-germ30: posts the ante $0.20
DUkalisUA: posts the ante $0.20
matiko09: posts the ante $0.20
ardo888: posts the ante $0.20
hammerwife: posts the ante $0.20
WDW3: posts the ante $0.20
*** HOLE CARDS ***
Dealt to matiko09 [7c 9d]
ardo888: raises $2 to $3
hammerwife: calls $3
WDW3: folds 
nobrunobru1: folds 
st-germ30: folds 
DUkalisUA: folds 
matiko09: folds 
*** FLOP *** [Ac Kc Tc]
ardo888: bets $6.20
hammerwife: folds 
Uncalled bet ($6.20) returned to ardo888
ardo888 collected $8.50 from pot
ardo888: doesn't show hand 
*** SUMMARY ***
Total pot $8.90 | Rake $0.40 
Board [Ac Kc Tc]
Seat 2: nobrunobru1 folded before Flop (didn't bet)
Seat 3: st-germ30 (button) folded before Flop (didn't bet)
Seat 4: DUkalisUA (small blind) folded before Flop
Seat 5: matiko09 (big blind) folded before Flop
Seat 6: ardo888 collected ($8.50)
Seat 7: hammerwife folded on the Flop
Seat 9: WDW3 folded before Flop (didn't bet)





PokerStars Hand #150799928329:  Hold'em No Limit ($1/$2 USD) - 2016/03/23 13:48:50 CET [2016/03/23 8:48:50 ET]
Table 'Kiess' 9-max Seat #9 is the button
Seat 1: Cirilico ($164.56 in chips) 
Seat 2: DUkalisUA ($479.57 in chips) 
Seat 3: The_red_area ($376.82 in chips) 
Seat 4: Moszes360 ($208.60 in chips) 
Seat 5: chippo boy ($311.39 in chips) 
Seat 6: matiko09 ($297.84 in chips) 
Seat 7: InsomniaRU ($276.17 in chips) 
Seat 8: WDW3 ($369.82 in chips) 
Seat 9: Fish4trips ($214.55 in chips) 
Cirilico: posts small blind $1
DUkalisUA: posts big blind $2
*** HOLE CARDS ***
Dealt to matiko09 [4s 7c]
The_red_area: folds 
Moszes360: raises $4 to $6
chippo boy: calls $6
matiko09: folds 
InsomniaRU: folds 
WDW3: folds 
Fish4trips: folds 
Cirilico: folds 
DUkalisUA: calls $4
*** FLOP *** [Ac 9d 6d]
DUkalisUA: checks 
Moszes360: bets $15.41
chippo boy: calls $15.41
DUkalisUA: folds 
*** TURN *** [Ac 9d 6d] [Js]
Moszes360: bets $40.44
chippo boy: folds 
Uncalled bet ($40.44) returned to Moszes360
Moszes360 collected $47.58 from pot
Moszes360: doesn't show hand 
*** SUMMARY ***
Total pot $49.82 | Rake $2.24 
Board [Ac 9d 6d Js]
Seat 1: Cirilico (small blind) folded before Flop
Seat 2: DUkalisUA (big blind) folded on the Flop
Seat 3: The_red_area folded before Flop (didn't bet)
Seat 4: Moszes360 collected ($47.58)
Seat 5: chippo boy folded on the Turn
Seat 6: matiko09 folded before Flop (didn't bet)
Seat 7: InsomniaRU folded before Flop (didn't bet)
Seat 8: WDW3 folded before Flop (didn't bet)
Seat 9: Fish4trips (button) folded before Flop (didn't bet)





PokerStars Hand #150799931636:  Hold'em No Limit ($1/$2 USD) - 2016/03/23 13:48:55 CET [2016/03/23 8:48:55 ET]
Table 'Berbericia II' 9-max Seat #4 is the button
Seat 1: WDW3 ($206.05 in chips) 
Seat 2: Moszes360 ($229.52 in chips) 
Seat 3: Fish4trips ($226.02 in chips) 
Seat 4: bennetb77 ($94.34 in chips) 
Seat 5: darren1031 ($198 in chips) 
Seat 6: Charity86 ($178.88 in chips) 
Seat 8: matiko09 ($303.51 in chips) 
Seat 9: LVV-Bif ($295.90 in chips) 
darren1031: posts small blind $1
Charity86: posts big blind $2
*** HOLE CARDS ***
Dealt to matiko09 [9d Qc]
matiko09: folds 
LVV-Bif: folds 
WDW3: folds 
Moszes360: raises $4 to $6
Fish4trips: folds 
bennetb77: folds 
darren1031: raises $10 to $16
Charity86: folds 
Moszes360: calls $10
*** FLOP *** [5h 5c Jh]
darren1031: bets $32.47
Moszes360: folds 
Uncalled bet ($32.47) returned to darren1031
darren1031 collected $32.47 from pot
*** SUMMARY ***
Total pot $34 | Rake $1.53 
Board [5h 5c Jh]
Seat 1: WDW3 folded before Flop (didn't bet)
Seat 2: Moszes360 folded on the Flop
Seat 3: Fish4trips folded before Flop (didn't bet)
Seat 4: bennetb77 (button) folded before Flop (didn't bet)
Seat 5: darren1031 (small blind) collected ($32.47)
Seat 6: Charity86 (big blind) folded before Flop
Seat 8: matiko09 folded before Flop (didn't bet)
Seat 9: LVV-Bif folded before Flop (didn't bet)





PokerStars Hand #150799932400:  Hold'em No Limit ($0.50/$1.00 USD) - 2016/03/23 13:48:57 CET [2016/03/23 8:48:57 ET]
Table 'Merope II' 9-max Seat #1 is the button
Seat 1: Jimy Tiltman ($100 in chips) 
Seat 2: Zeeshka ($100.50 in chips) 
Seat 3: Sherlockplay ($100 in chips) 
Seat 4: YuriiSolodya ($32 in chips) 
Seat 5: DUkalisUA ($109.60 in chips) 
Seat 6: rebelTC ($81.71 in chips) 
Seat 7: matiko09 ($101.50 in chips) 
Seat 8: titentei ($96.50 in chips) 
Seat 9: RICKA16 ($100 in chips) 
Zeeshka: posts small blind $0.50
Sherlockplay: posts big blind $1
*** HOLE CARDS ***
Dealt to matiko09 [Js 6s]
YuriiSolodya: folds 
DUkalisUA: raises $2 to $3
rebelTC: calls $3
matiko09: folds 
titentei: folds 
RICKA16: folds 
Jimy Tiltman: folds 
Zeeshka: folds 
Sherlockplay: calls $2
*** FLOP *** [3d 5s 2s]
Sherlockplay: checks 
DUkalisUA: checks 
rebelTC: bets $2
Sherlockplay: folds 
DUkalisUA: folds 
Uncalled bet ($2) returned to rebelTC
rebelTC collected $9.07 from pot
*** SUMMARY ***
Total pot $9.50 | Rake $0.43 
Board [3d 5s 2s]
Seat 1: Jimy Tiltman (button) folded before Flop (didn't bet)
Seat 2: Zeeshka (small blind) folded before Flop
Seat 3: Sherlockplay (big blind) folded on the Flop
Seat 4: YuriiSolodya folded before Flop (didn't bet)
Seat 5: DUkalisUA folded on the Flop
Seat 6: rebelTC collected ($9.07)
Seat 7: matiko09 folded before Flop (didn't bet)
Seat 8: titentei folded before Flop (didn't bet)
Seat 9: RICKA16 folded before Flop (didn't bet)





PokerStars Hand #150799933451:  Hold'em No Limit ($0.25/$0.50 USD) - 2016/03/23 13:48:59 CET [2016/03/23 8:48:59 ET]
Table 'Belnika' 9-max Seat #5 is the button
Seat 1: yellowfever0 ($42.06 in chips) 
Seat 2: NeverRegret7 ($51.24 in chips) 
Seat 3: ChiChioChi ($41.14 in chips) 
Seat 4: matiko09 ($66.10 in chips) 
Seat 5: IvanUrgant ($50 in chips) 
Seat 6: Ahangama ($63.50 in chips) 
Seat 7: Zeeshka ($50 in chips) 
Seat 8: lumen21 ($63.39 in chips) 
Seat 9: dndngod ($61.91 in chips) 
Ahangama: posts small blind $0.25
Zeeshka: posts big blind $0.50
*** HOLE CARDS ***
Dealt to matiko09 [9h Td]
lumen21: folds 
dndngod: folds 
yellowfever0: folds 
NeverRegret7: raises $0.75 to $1.25
ChiChioChi: folds 
matiko09: folds 
IvanUrgant: folds 
Ahangama: folds 
Zeeshka: folds 
Uncalled bet ($0.75) returned to NeverRegret7
NeverRegret7 collected $1.25 from pot
NeverRegret7: doesn't show hand 
*** SUMMARY ***
Total pot $1.25 | Rake $0 
Seat 1: yellowfever0 folded before Flop (didn't bet)
Seat 2: NeverRegret7 collected ($1.25)
Seat 3: ChiChioChi folded before Flop (didn't bet)
Seat 4: matiko09 folded before Flop (didn't bet)
Seat 5: IvanUrgant (button) folded before Flop (didn't bet)
Seat 6: Ahangama (small blind) folded before Flop
Seat 7: Zeeshka (big blind) folded before Flop
Seat 8: lumen21 folded before Flop (didn't bet)
Seat 9: dndngod folded before Flop (didn't bet)





PokerStars Hand #150799940434:  Hold'em No Limit ($0.50/$1.00 USD) - 2016/03/23 13:49:11 CET [2016/03/23 8:49:11 ET]
Table 'Kippes' 9-max Seat #4 is the button
Seat 1: Pvsx. ($100 in chips) 
Seat 2: RICKA16 ($128.63 in chips) 
Seat 3: CAJUN890 ($125.81 in chips) 
Seat 4: matiko09 ($107.72 in chips) 
Seat 5: Jimy Tiltman ($111.36 in chips) 
Seat 6: WDW3 ($118.07 in chips) 
Seat 7: lumen21 ($100 in chips) 
Seat 8: Zeeshka ($117.80 in chips) 
Seat 9: wang19790906 ($83.67 in chips) 
Jimy Tiltman: posts small blind $0.50
WDW3: posts big blind $1
*** HOLE CARDS ***
Dealt to matiko09 [5h 2c]
lumen21: folds 
Zeeshka: raises $2 to $3
wang19790906: folds 
Pvsx.: folds 
RICKA16: folds 
CAJUN890: calls $3
matiko09: folds 
Jimy Tiltman: folds 
WDW3: folds 
*** FLOP *** [2d Td 8d]
Zeeshka: checks 
CAJUN890: checks 
*** TURN *** [2d Td 8d] [Tc]
Zeeshka: checks 
CAJUN890: bets $4
Zeeshka: folds 
Uncalled bet ($4) returned to CAJUN890
CAJUN890 collected $7.16 from pot
CAJUN890: doesn't show hand 
*** SUMMARY ***
Total pot $7.50 | Rake $0.34 
Board [2d Td 8d Tc]
Seat 1: Pvsx. folded before Flop (didn't bet)
Seat 2: RICKA16 folded before Flop (didn't bet)
Seat 3: CAJUN890 collected ($7.16)
Seat 4: matiko09 (button) folded before Flop (didn't bet)
Seat 5: Jimy Tiltman (small blind) folded before Flop
Seat 6: WDW3 (big blind) folded before Flop
Seat 7: lumen21 folded before Flop (didn't bet)
Seat 8: Zeeshka folded on the Turn
Seat 9: wang19790906 folded before Flop (didn't bet)





PokerStars Hand #150799946759:  Hold'em No Limit ($0.25/$0.50 USD) - 2016/03/23 13:49:22 CET [2016/03/23 8:49:22 ET]
Table 'Pyrrhus' 9-max Seat #8 is the button
Seat 1: lumen21 ($50 in chips) 
Seat 3: IvanUrgant ($83.87 in chips) 
Seat 4: GriffinBerg ($12.89 in chips) 
Seat 5: Moszes360 ($50 in chips) 
Seat 6: whalldo ($165.12 in chips) 
Seat 7: matiko09 ($127.76 in chips) 
Seat 8: dndngod ($60.23 in chips) 
Seat 9: CvMCvMCvM ($113.36 in chips) 
CvMCvMCvM: posts small blind $0.25
lumen21: posts big blind $0.50
Zeeshka: sits out 
*** HOLE CARDS ***
Dealt to matiko09 [Jh 4h]
IvanUrgant: folds 
GriffinBerg: folds 
Moszes360: folds 
whalldo: folds 
matiko09: folds 
dndngod: folds 
CvMCvMCvM: folds 
Uncalled bet ($0.25) returned to lumen21
lumen21 collected $0.50 from pot
lumen21: doesn't show hand 
*** SUMMARY ***
Total pot $0.50 | Rake $0 
Seat 1: lumen21 (big blind) collected ($0.50)
Seat 3: IvanUrgant folded before Flop (didn't bet)
Seat 4: GriffinBerg folded before Flop (didn't bet)
Seat 5: Moszes360 folded before Flop (didn't bet)
Seat 6: whalldo folded before Flop (didn't bet)
Seat 7: matiko09 folded before Flop (didn't bet)
Seat 8: dndngod (button) folded before Flop (didn't bet)
Seat 9: CvMCvMCvM (small blind) folded before Flop





PokerStars Hand #150799947051:  Hold'em No Limit ($1/$2 USD) - 2016/03/23 13:49:23 CET [2016/03/23 8:49:23 ET]
Table 'Herba II' 9-max Seat #8 is the button
Seat 1: matiko09 ($232.48 in chips) 
Seat 2: Moszes360 ($210.20 in chips) 
Seat 3: Cirilico ($162.60 in chips) 
Seat 4: DUkalisUA ($286.78 in chips) 
Seat 5: chippo boy ($211.04 in chips) 
Seat 6: WDW3 ($210.33 in chips) 
Seat 7: InsomniaRU ($216.42 in chips) 
Seat 8: The_red_area ($450.84 in chips) 
Seat 9: mrhighryza ($49.13 in chips) 
mrhighryza: posts small blind $1
matiko09: posts big blind $2
*** HOLE CARDS ***
Dealt to matiko09 [3s 2s]
Moszes360: raises $4 to $6
Cirilico: folds 
DUkalisUA: folds 
chippo boy: folds 
WDW3: folds 
InsomniaRU: calls $6
The_red_area: folds 
mrhighryza: calls $5
matiko09: folds 
*** FLOP *** [5c 7c Td]
mrhighryza: checks 
Moszes360: checks 
InsomniaRU: checks 
*** TURN *** [5c 7c Td] [6s]
mrhighryza: bets $43.13 and is all-in
Moszes360: folds 
InsomniaRU: folds 
Uncalled bet ($43.13) returned to mrhighryza
mrhighryza collected $19.10 from pot
*** SUMMARY ***
Total pot $20 | Rake $0.90 
Board [5c 7c Td 6s]
Seat 1: matiko09 (big blind) folded before Flop
Seat 2: Moszes360 folded on the Turn
Seat 3: Cirilico folded before Flop (didn't bet)
Seat 4: DUkalisUA folded before Flop (didn't bet)
Seat 5: chippo boy folded before Flop (didn't bet)
Seat 6: WDW3 folded before Flop (didn't bet)
Seat 7: InsomniaRU folded on the Turn
Seat 8: The_red_area (button) folded before Flop (didn't bet)
Seat 9: mrhighryza (small blind) collected ($19.10)





PokerStars Hand #150799953201:  Hold'em No Limit ($1/$2 USD) - 2016/03/23 13:49:34 CET [2016/03/23 8:49:34 ET]
Table 'Kypria II' 9-max Seat #9 is the button
Seat 1: geldwolfje ($157.66 in chips) 
Seat 2: coinflip_si ($200 in chips) 
Seat 3: seouljam ($205.73 in chips) 
Seat 4: nailz83 ($60.09 in chips) 
Seat 5: InsomniaRU ($348.62 in chips) 
Seat 6: matiko09 ($288.69 in chips) 
Seat 7: DUkalisUA ($200 in chips) 
Seat 8: Fish4trips ($346.79 in chips) 
Seat 9: WDW3 ($211.19 in chips) 
geldwolfje: posts small blind $1
coinflip_si: posts big blind $2
*** HOLE CARDS ***
Dealt to matiko09 [8d 3h]
seouljam: folds 
nailz83: calls $2
InsomniaRU: folds 
matiko09: folds 
DUkalisUA: folds 
Fish4trips: folds 
WDW3: folds 
geldwolfje: calls $1
coinflip_si: checks 
*** FLOP *** [Kc Jc 5s]
geldwolfje: checks 
coinflip_si: checks 
nailz83: bets $6
geldwolfje: folds 
coinflip_si: folds 
Uncalled bet ($6) returned to nailz83
nailz83 collected $5.73 from pot
nailz83: doesn't show hand 
*** SUMMARY ***
Total pot $6 | Rake $0.27 
Board [Kc Jc 5s]
Seat 1: geldwolfje (small blind) folded on the Flop
Seat 2: coinflip_si (big blind) folded on the Flop
Seat 3: seouljam folded before Flop (didn't bet)
Seat 4: nailz83 collected ($5.73)
Seat 5: InsomniaRU folded before Flop (didn't bet)
Seat 6: matiko09 folded before Flop (didn't bet)
Seat 7: DUkalisUA folded before Flop (didn't bet)
Seat 8: Fish4trips folded before Flop (didn't bet)
Seat 9: WDW3 (button) folded before Flop (didn't bet)





PokerStars Hand #150799953701:  Hold'em No Limit ($0.50/$1.00 USD) - 2016/03/23 13:49:35 CET [2016/03/23 8:49:35 ET]
Table 'Atlantis' 9-max Seat #1 is the button
Seat 1: xHourglass ($157.28 in chips) 
Seat 2: tffff2006 ($49.78 in chips) 
Seat 3: CAJUN890 ($108.96 in chips) 
Seat 4: matiko09 ($123.95 in chips) 
Seat 5: Pvsx. ($100 in chips) 
Seat 6: Jimy Tiltman ($134.74 in chips) 
Seat 7: Zeeshka ($106.32 in chips) 
Seat 8: DUkalisUA ($101.50 in chips) 
Seat 9: WDW3 ($122.76 in chips) 
tffff2006: posts small blind $0.50
CAJUN890: posts big blind $1
*** HOLE CARDS ***
Dealt to matiko09 [9s 3d]
matiko09: folds 
Pvsx.: folds 
Jimy Tiltman: raises $2 to $3
Zeeshka: folds 
DUkalisUA: folds 
WDW3: calls $3
xHourglass: folds 
tffff2006: folds 
CAJUN890: folds 
*** FLOP *** [Ad 9d Ts]
Jimy Tiltman: bets $4
WDW3: calls $4
*** TURN *** [Ad 9d Ts] [Ah]
Jimy Tiltman: checks 
WDW3: checks 
*** RIVER *** [Ad 9d Ts Ah] [7d]
Jimy Tiltman: checks 
WDW3: checks 
*** SHOW DOWN ***
Jimy Tiltman: shows [Kh Jc] (a pair of Aces)
WDW3: shows [Jd Jh] (two pair, Aces and Jacks)
WDW3 collected $14.80 from pot
*** SUMMARY ***
Total pot $15.50 | Rake $0.70 
Board [Ad 9d Ts Ah 7d]
Seat 1: xHourglass (button) folded before Flop (didn't bet)
Seat 2: tffff2006 (small blind) folded before Flop
Seat 3: CAJUN890 (big blind) folded before Flop
Seat 4: matiko09 folded before Flop (didn't bet)
Seat 5: Pvsx. folded before Flop (didn't bet)
Seat 6: Jimy Tiltman showed [Kh Jc] and lost with a pair of Aces
Seat 7: Zeeshka folded before Flop (didn't bet)
Seat 8: DUkalisUA folded before Flop (didn't bet)
Seat 9: WDW3 showed [Jd Jh] and won ($14.80) with two pair, Aces and Jacks





PokerStars Hand #150799957275:  Hold'em No Limit ($0.50/$1.00 USD) - 2016/03/23 13:49:41 CET [2016/03/23 8:49:41 ET]
Table 'Donar II' 9-max Seat #4 is the button
Seat 2: nobrunobru1 ($76.07 in chips) 
Seat 3: st-germ30 ($97.41 in chips) 
Seat 4: DUkalisUA ($103.10 in chips) 
Seat 5: matiko09 ($100 in chips) 
Seat 6: ardo888 ($119.99 in chips) 
Seat 7: hammerwife ($100 in chips) 
Seat 9: WDW3 ($125.82 in chips) 
matiko09: posts small blind $0.50
ardo888: posts big blind $1
Effort92: sits out 
nobrunobru1: posts the ante $0.20
st-germ30: posts the ante $0.20
DUkalisUA: posts the ante $0.20
matiko09: posts the ante $0.20
ardo888: posts the ante $0.20
hammerwife: posts the ante $0.20
WDW3: posts the ante $0.20
*** HOLE CARDS ***
Dealt to matiko09 [Jc Qh]
hammerwife: folds 
WDW3: folds 
nobrunobru1: folds 
st-germ30: folds 
DUkalisUA: folds 
matiko09: raises $2 to $3
ardo888: folds 
Uncalled bet ($2) returned to matiko09
matiko09 collected $3.40 from pot
matiko09: doesn't show hand 
*** SUMMARY ***
Total pot $3.40 | Rake $0 
Seat 2: nobrunobru1 folded before Flop (didn't bet)
Seat 3: st-germ30 folded before Flop (didn't bet)
Seat 4: DUkalisUA (button) folded before Flop (didn't bet)
Seat 5: matiko09 (small blind) collected ($3.40)
Seat 6: ardo888 (big blind) folded before Flop
Seat 7: hammerwife folded before Flop (didn't bet)
Seat 9: WDW3 folded before Flop (didn't bet)





PokerStars Hand #150799958187:  Hold'em No Limit ($0.50/$1.00 USD) - 2016/03/23 13:49:42 CET [2016/03/23 8:49:42 ET]
Table 'Smiley' 9-max Seat #5 is the button
Seat 1: WDW3 ($106.58 in chips) 
Seat 2: Jimy Tiltman ($100 in chips) 
Seat 3: matiko09 ($101.98 in chips) 
Seat 4: Zeeshka ($146.92 in chips) 
Seat 5: DUkalisUA ($100 in chips) 
Seat 6: blackmont111 ($128.17 in chips) 
Seat 7: Moszes360 ($100 in chips) 
Seat 8: RICKA16 ($100 in chips) 
Seat 9: morosun ($106.59 in chips) 
blackmont111: posts small blind $0.50
Moszes360: posts big blind $1
*** HOLE CARDS ***
Dealt to matiko09 [Kh 3d]
RICKA16: folds 
morosun: folds 
WDW3: folds 
Jimy Tiltman: folds 
matiko09: folds 
Zeeshka: folds 
DUkalisUA: folds 
blackmont111: folds 
Uncalled bet ($0.50) returned to Moszes360
Moszes360 collected $1 from pot
Moszes360: doesn't show hand 
*** SUMMARY ***
Total pot $1 | Rake $0 
Seat 1: WDW3 folded before Flop (didn't bet)
Seat 2: Jimy Tiltman folded before Flop (didn't bet)
Seat 3: matiko09 folded before Flop (didn't bet)
Seat 4: Zeeshka folded before Flop (didn't bet)
Seat 5: DUkalisUA (button) folded before Flop (didn't bet)
Seat 6: blackmont111 (small blind) folded before Flop
Seat 7: Moszes360 (big blind) collected ($1)
Seat 8: RICKA16 folded before Flop (didn't bet)
Seat 9: morosun folded before Flop (didn't bet)





PokerStars Hand #150799961426:  Hold'em No Limit ($0.50/$1.00 USD) - 2016/03/23 13:49:48 CET [2016/03/23 8:49:48 ET]
Table 'Oljato' 9-max Seat #7 is the button
Seat 1: xHourglass ($119.88 in chips) 
Seat 2: roman134679 ($62.72 in chips) 
Seat 3: DUkalisUA ($100 in chips) 
Seat 4: Pvsx. ($139.60 in chips) 
Seat 6: WDW3 ($114.58 in chips) 
Seat 7: matiko09 ($154.09 in chips) 
Seat 8: Zeeshka ($340.34 in chips) 
Seat 9: Jimy Tiltman ($110.06 in chips) 
Zeeshka: posts small blind $0.50
Jimy Tiltman: posts big blind $1
*** HOLE CARDS ***
Dealt to matiko09 [Ah 6s]
xHourglass: raises $2 to $3
roman134679: folds 
DUkalisUA: folds 
Pvsx.: folds 
WDW3: folds 
matiko09: folds 
Zeeshka: folds 
Jimy Tiltman: calls $2
*** FLOP *** [2c 8s 6h]
Jimy Tiltman: checks 
xHourglass: checks 
*** TURN *** [2c 8s 6h] [3c]
Jimy Tiltman: bets $4.65
xHourglass: folds 
Uncalled bet ($4.65) returned to Jimy Tiltman
Jimy Tiltman collected $6.21 from pot
Jimy Tiltman: doesn't show hand 
*** SUMMARY ***
Total pot $6.50 | Rake $0.29 
Board [2c 8s 6h 3c]
Seat 1: xHourglass folded on the Turn
Seat 2: roman134679 folded before Flop (didn't bet)
Seat 3: DUkalisUA folded before Flop (didn't bet)
Seat 4: Pvsx. folded before Flop (didn't bet)
Seat 6: WDW3 folded before Flop (didn't bet)
Seat 7: matiko09 (button) folded before Flop (didn't bet)
Seat 8: Zeeshka (small blind) folded before Flop
Seat 9: Jimy Tiltman (big blind) collected ($6.21)





PokerStars Hand #150799962965:  Hold'em No Limit ($0.25/$0.50 USD) - 2016/03/23 13:49:51 CET [2016/03/23 8:49:51 ET]
Table 'Belnika' 9-max Seat #6 is the button
Seat 1: yellowfever0 ($42.06 in chips) 
Seat 2: NeverRegret7 ($51.99 in chips) 
Seat 3: ChiChioChi ($41.14 in chips) 
Seat 4: matiko09 ($66.10 in chips) 
Seat 5: IvanUrgant ($50 in chips) 
Seat 6: Ahangama ($63.25 in chips) 
Seat 7: Zeeshka ($50 in chips) 
Seat 8: lumen21 ($63.39 in chips) 
Seat 9: dndngod ($61.91 in chips) 
Zeeshka: posts small blind $0.25
lumen21: posts big blind $0.50
*** HOLE CARDS ***
Dealt to matiko09 [3d 4h]
dndngod: folds 
yellowfever0: folds 
NeverRegret7: folds 
ChiChioChi: calls $0.50
matiko09: folds 
IvanUrgant: folds 
Ahangama: folds 
Zeeshka: raises $1.48 to $1.98
lumen21: calls $1.48
ChiChioChi: calls $1.48
*** FLOP *** [6c 6h 6s]
Zeeshka: bets $3.50
lumen21: folds 
ChiChioChi: calls $3.50
*** TURN *** [6c 6h 6s] [3c]
Zeeshka: bets $7.50
ChiChioChi: calls $7.50
*** RIVER *** [6c 6h 6s 3c] [6d]
Zeeshka: bets $0.50
ChiChioChi: calls $0.50
*** SHOW DOWN ***
Zeeshka: shows [Td Tc] (four of a kind, Sixes)
ChiChioChi: shows [Ac 4d] (four of a kind, Sixes - Ace kicker)
ChiChioChi collected $27.64 from pot
*** SUMMARY ***
Total pot $28.94 | Rake $1.30 
Board [6c 6h 6s 3c 6d]
Seat 1: yellowfever0 folded before Flop (didn't bet)
Seat 2: NeverRegret7 folded before Flop (didn't bet)
Seat 3: ChiChioChi showed [Ac 4d] and won ($27.64) with four of a kind, Sixes
Seat 4: matiko09 folded before Flop (didn't bet)
Seat 5: IvanUrgant folded before Flop (didn't bet)
Seat 6: Ahangama (button) folded before Flop (didn't bet)
Seat 7: Zeeshka (small blind) showed [Td Tc] and lost with four of a kind, Sixes
Seat 8: lumen21 (big blind) folded on the Flop
Seat 9: dndngod folded before Flop (didn't bet)





PokerStars Hand #150799963456:  Hold'em No Limit (€0.25/€0.50 EUR) - 2016/03/23 13:49:52 CET [2016/03/23 8:49:52 ET]
Table 'Palma II' 9-max Seat #7 is the button
Seat 2: matiko09 (€51.60 in chips) 
Seat 3: ardo888 (€55.69 in chips) 
Seat 4: dndngod (€69.52 in chips) 
Seat 5: SVFB13 (€51.75 in chips) 
Seat 6: CAJUN890 (€45.75 in chips) 
Seat 7: Kuca :P (€50 in chips) 
Seat 8: Effort92 (€50 in chips) 
Seat 9: Red_Warning (€50 in chips) 
Effort92: posts small blind €0.25
Red_Warning: posts big blind €0.50
Aalleekks: sits out 
*** HOLE CARDS ***
Dealt to matiko09 [Ac Ah]
matiko09: raises €1 to €1.50
ardo888: folds 
dndngod: folds 
SVFB13: folds 
CAJUN890: folds 
Kuca :P: folds 
Effort92: folds 
Red_Warning: folds 
Uncalled bet (€1) returned to matiko09
matiko09 collected €1.25 from pot
matiko09: doesn't show hand 
*** SUMMARY ***
Total pot €1.25 | Rake €0 
Seat 2: matiko09 collected (€1.25)
Seat 3: ardo888 folded before Flop (didn't bet)
Seat 4: dndngod folded before Flop (didn't bet)
Seat 5: SVFB13 folded before Flop (didn't bet)
Seat 6: CAJUN890 folded before Flop (didn't bet)
Seat 7: Kuca :P (button) folded before Flop (didn't bet)
Seat 8: Effort92 (small blind) folded before Flop
Seat 9: Red_Warning (big blind) folded before Flop





PokerStars Hand #150799964317:  Hold'em No Limit ($1/$2 USD) - 2016/03/23 13:49:53 CET [2016/03/23 8:49:53 ET]
Table 'Berbericia II' 9-max Seat #5 is the button
Seat 1: WDW3 ($206.05 in chips) 
Seat 2: Moszes360 ($213.52 in chips) 
Seat 3: Fish4trips ($226.02 in chips) 
Seat 4: bennetb77 ($94.34 in chips) 
Seat 5: darren1031 ($214.47 in chips) 
Seat 6: Charity86 ($176.88 in chips) 
Seat 8: matiko09 ($303.51 in chips) 
Seat 9: LVV-Bif ($295.90 in chips) 
Charity86: posts small blind $1
matiko09: posts big blind $2
*** HOLE CARDS ***
Dealt to matiko09 [Qd 7h]
LVV-Bif: folds 
WDW3: raises $3.60 to $5.60
Moszes360: folds 
Fish4trips: folds 
bennetb77: folds 
darren1031: folds 
Charity86: folds 
matiko09: folds 
Uncalled bet ($3.60) returned to WDW3
WDW3 collected $5 from pot
WDW3: doesn't show hand 
*** SUMMARY ***
Total pot $5 | Rake $0 
Seat 1: WDW3 collected ($5)
Seat 2: Moszes360 folded before Flop (didn't bet)
Seat 3: Fish4trips folded before Flop (didn't bet)
Seat 4: bennetb77 folded before Flop (didn't bet)
Seat 5: darren1031 (button) folded before Flop (didn't bet)
Seat 6: Charity86 (small blind) folded before Flop
Seat 8: matiko09 (big blind) folded before Flop
Seat 9: LVV-Bif folded before Flop (didn't bet)





PokerStars Hand #150799963974:  Hold'em No Limit ($1/$2 USD) - 2016/03/23 13:49:53 CET [2016/03/23 8:49:53 ET]
Table 'Kiess' 9-max Seat #1 is the button
Seat 1: Cirilico ($163.56 in chips) 
Seat 2: DUkalisUA ($473.57 in chips) 
Seat 3: The_red_area ($376.82 in chips) 
Seat 4: Moszes360 ($234.77 in chips) 
Seat 5: chippo boy ($289.98 in chips) 
Seat 6: matiko09 ($297.84 in chips) 
Seat 7: InsomniaRU ($276.17 in chips) 
Seat 8: WDW3 ($369.82 in chips) 
Seat 9: Fish4trips ($214.55 in chips) 
DUkalisUA: posts small blind $1
The_red_area: posts big blind $2
*** HOLE CARDS ***
Dealt to matiko09 [7s 7d]
Moszes360: raises $4 to $6
chippo boy: calls $6
matiko09: calls $6
InsomniaRU: folds 
WDW3: folds 
Fish4trips: folds 
Cirilico: folds 
DUkalisUA: folds 
The_red_area: calls $4
*** FLOP *** [Ts 5d 9c]
The_red_area: checks 
Moszes360: checks 
chippo boy: checks 
matiko09: checks 
*** TURN *** [Ts 5d 9c] [Ks]
The_red_area: checks 
Moszes360: checks 
chippo boy: bets $14
matiko09: folds 
The_red_area: folds 
Moszes360: folds 
Uncalled bet ($14) returned to chippo boy
chippo boy collected $23.88 from pot
*** SUMMARY ***
Total pot $25 | Rake $1.12 
Board [Ts 5d 9c Ks]
Seat 1: Cirilico (button) folded before Flop (didn't bet)
Seat 2: DUkalisUA (small blind) folded before Flop
Seat 3: The_red_area (big blind) folded on the Turn
Seat 4: Moszes360 folded on the Turn
Seat 5: chippo boy collected ($23.88)
Seat 6: matiko09 folded on the Turn
Seat 7: InsomniaRU folded before Flop (didn't bet)
Seat 8: WDW3 folded before Flop (didn't bet)
Seat 9: Fish4trips folded before Flop (didn't bet)





PokerStars Hand #150799964529:  Hold'em No Limit ($0.50/$1.00 USD) - 2016/03/23 13:49:54 CET [2016/03/23 8:49:54 ET]
Table 'Merope II' 9-max Seat #2 is the button
Seat 1: Jimy Tiltman ($100 in chips) 
Seat 2: Zeeshka ($100 in chips) 
Seat 3: Sherlockplay ($100 in chips) 
Seat 4: YuriiSolodya ($32 in chips) 
Seat 5: DUkalisUA ($106.60 in chips) 
Seat 6: rebelTC ($87.78 in chips) 
Seat 7: matiko09 ($101.50 in chips) 
Seat 8: titentei ($96.50 in chips) 
Seat 9: RICKA16 ($100 in chips) 
Sherlockplay: posts small blind $0.50
YuriiSolodya: posts big blind $1
*** HOLE CARDS ***
Dealt to matiko09 [7s Ac]
DUkalisUA: folds 
rebelTC: folds 
matiko09: folds 
titentei: folds 
RICKA16: raises $2 to $3
Jimy Tiltman: calls $3
Zeeshka: folds 
Sherlockplay: folds 
YuriiSolodya: folds 
*** FLOP *** [9h 5h 4h]
RICKA16: bets $5
Jimy Tiltman: raises $9 to $14
RICKA16: folds 
Uncalled bet ($9) returned to Jimy Tiltman
Jimy Tiltman collected $16.71 from pot
Jimy Tiltman: doesn't show hand 
*** SUMMARY ***
Total pot $17.50 | Rake $0.79 
Board [9h 5h 4h]
Seat 1: Jimy Tiltman collected ($16.71)
Seat 2: Zeeshka (button) folded before Flop (didn't bet)
Seat 3: Sherlockplay (small blind) folded before Flop
Seat 4: YuriiSolodya (big blind) folded before Flop
Seat 5: DUkalisUA folded before Flop (didn't bet)
Seat 6: rebelTC folded before Flop (didn't bet)
Seat 7: matiko09 folded before Flop (didn't bet)
Seat 8: titentei folded before Flop (didn't bet)
Seat 9: RICKA16 folded on the Flop





PokerStars Hand #150799968454:  Hold'em No Limit ($0.25/$0.50 USD) - 2016/03/23 13:50:01 CET [2016/03/23 8:50:01 ET]
Table 'Pyrrhus' 9-max Seat #9 is the button
Seat 1: lumen21 ($50.25 in chips) 
Seat 2: Zeeshka ($50 in chips) 
Seat 3: IvanUrgant ($83.87 in chips) 
Seat 4: GriffinBerg ($12.89 in chips) 
Seat 5: Moszes360 ($50 in chips) 
Seat 6: whalldo ($165.12 in chips) 
Seat 7: matiko09 ($127.76 in chips) 
Seat 8: dndngod ($60.23 in chips) 
Seat 9: CvMCvMCvM ($113.11 in chips) 
lumen21: posts small blind $0.25
Zeeshka: posts big blind $0.50
*** HOLE CARDS ***
Dealt to matiko09 [Kc Ts]
IvanUrgant: folds 
GriffinBerg: folds 
Moszes360: folds 
whalldo: folds 
matiko09: folds 
dndngod: folds 
CvMCvMCvM: folds 
lumen21: raises $0.75 to $1.25
Zeeshka: folds 
Uncalled bet ($0.75) returned to lumen21
lumen21 collected $1 from pot
lumen21: doesn't show hand 
*** SUMMARY ***
Total pot $1 | Rake $0 
Seat 1: lumen21 (small blind) collected ($1)
Seat 2: Zeeshka (big blind) folded before Flop
Seat 3: IvanUrgant folded before Flop (didn't bet)
Seat 4: GriffinBerg folded before Flop (didn't bet)
Seat 5: Moszes360 folded before Flop (didn't bet)
Seat 6: whalldo folded before Flop (didn't bet)
Seat 7: matiko09 folded before Flop (didn't bet)
Seat 8: dndngod folded before Flop (didn't bet)
Seat 9: CvMCvMCvM (button) folded before Flop (didn't bet)





PokerStars Hand #150799969832:  Hold'em No Limit ($0.50/$1.00 USD) - 2016/03/23 13:50:03 CET [2016/03/23 8:50:03 ET]
Table 'Kippes' 9-max Seat #5 is the button
Seat 1: Pvsx. ($100 in chips) 
Seat 2: RICKA16 ($128.63 in chips) 
Seat 3: CAJUN890 ($129.97 in chips) 
Seat 4: matiko09 ($107.72 in chips) 
Seat 5: Jimy Tiltman ($110.86 in chips) 
Seat 6: WDW3 ($117.07 in chips) 
Seat 7: lumen21 ($100 in chips) 
Seat 8: Zeeshka ($114.80 in chips) 
Seat 9: wang19790906 ($83.67 in chips) 
WDW3: posts small blind $0.50
lumen21: posts big blind $1
*** HOLE CARDS ***
Dealt to matiko09 [Ad 4s]
Zeeshka: raises $2 to $3
wang19790906: folds 
Pvsx.: folds 
RICKA16: folds 
CAJUN890: calls $3
matiko09: folds 
Jimy Tiltman: raises $9 to $12
WDW3: folds 
lumen21: folds 
Zeeshka: folds 
CAJUN890: folds 
Uncalled bet ($9) returned to Jimy Tiltman
Jimy Tiltman collected $10.50 from pot
Jimy Tiltman: doesn't show hand 
*** SUMMARY ***
Total pot $10.50 | Rake $0 
Seat 1: Pvsx. folded before Flop (didn't bet)
Seat 2: RICKA16 folded before Flop (didn't bet)
Seat 3: CAJUN890 folded before Flop
Seat 4: matiko09 folded before Flop (didn't bet)
Seat 5: Jimy Tiltman (button) collected ($10.50)
Seat 6: WDW3 (small blind) folded before Flop
Seat 7: lumen21 (big blind) folded before Flop
Seat 8: Zeeshka folded before Flop
Seat 9: wang19790906 folded before Flop (didn't bet)





PokerStars Hand #150799970122:  Hold'em No Limit ($0.50/$1.00 USD) - 2016/03/23 13:50:04 CET [2016/03/23 8:50:04 ET]
Table 'Donar II' 9-max Seat #5 is the button
Seat 2: nobrunobru1 ($75.87 in chips) 
Seat 3: st-germ30 ($97.21 in chips) 
Seat 4: DUkalisUA ($102.90 in chips) 
Seat 5: matiko09 ($102.20 in chips) 
Seat 6: ardo888 ($118.79 in chips) 
Seat 7: hammerwife ($100 in chips) 
Seat 9: WDW3 ($125.62 in chips) 
ardo888: posts small blind $0.50
hammerwife: posts big blind $1
Effort92: sits out 
nobrunobru1: posts the ante $0.20
st-germ30: posts the ante $0.20
DUkalisUA: posts the ante $0.20
matiko09: posts the ante $0.20
ardo888: posts the ante $0.20
hammerwife: posts the ante $0.20
WDW3: posts the ante $0.20
*** HOLE CARDS ***
Dealt to matiko09 [2c 2d]
WDW3: folds 
nobrunobru1: raises $2 to $3
st-germ30: folds 
DUkalisUA: raises $5.50 to $8.50
matiko09: folds 
ardo888: folds 
hammerwife: folds 
nobrunobru1: folds 
Uncalled bet ($5.50) returned to DUkalisUA
DUkalisUA collected $8.90 from pot
DUkalisUA: doesn't show hand 
*** SUMMARY ***
Total pot $8.90 | Rake $0 
Seat 2: nobrunobru1 folded before Flop
Seat 3: st-germ30 folded before Flop (didn't bet)
Seat 4: DUkalisUA collected ($8.90)
Seat 5: matiko09 (button) folded before Flop (didn't bet)
Seat 6: ardo888 (small blind) folded before Flop
Seat 7: hammerwife (big blind) folded before Flop
Seat 9: WDW3 folded before Flop (didn't bet)





PokerStars Hand #150799971186:  Hold'em No Limit (€0.25/€0.50 EUR) - 2016/03/23 13:50:06 CET [2016/03/23 8:50:06 ET]
Table 'Hesperia II' 9-max Seat #3 is the button
Seat 1: CAJUN890 (€58.83 in chips) 
Seat 2: dndngod (€50.69 in chips) 
Seat 3: IvanUrgant (€57.05 in chips) 
Seat 4: Zelenis (€21.40 in chips) 
Seat 5: Avrora-sp (€50 in chips) 
Seat 6: CvMCvMCvM (€50 in chips) 
Seat 7: matiko09 (€60.98 in chips) 
Seat 8: Ahangama (€50 in chips) 
Seat 9: Red_Warning (€50 in chips) 
Zelenis: posts small blind €0.25
Avrora-sp: posts big blind €0.50
*** HOLE CARDS ***
Dealt to matiko09 [6s Tc]
CvMCvMCvM: folds 
matiko09: folds 
Ahangama: folds 
Red_Warning: folds 
CAJUN890: calls €0.50
dndngod: raises €2.50 to €3
IvanUrgant: folds 
Zelenis: folds 
Avrora-sp: folds 
CAJUN890: calls €2.50
*** FLOP *** [4c 6h Jd]
CAJUN890: checks 
dndngod: bets €4.50
CAJUN890: folds 
Uncalled bet (€4.50) returned to dndngod
dndngod collected €6.45 from pot
dndngod: doesn't show hand 
*** SUMMARY ***
Total pot €6.75 | Rake €0.30 
Board [4c 6h Jd]
Seat 1: CAJUN890 folded on the Flop
Seat 2: dndngod collected (€6.45)
Seat 3: IvanUrgant (button) folded before Flop (didn't bet)
Seat 4: Zelenis (small blind) folded before Flop
Seat 5: Avrora-sp (big blind) folded before Flop
Seat 6: CvMCvMCvM folded before Flop (didn't bet)
Seat 7: matiko09 folded before Flop (didn't bet)
Seat 8: Ahangama folded before Flop (didn't bet)
Seat 9: Red_Warning folded before Flop (didn't bet)





PokerStars Hand #150799973936:  Hold'em No Limit ($0.50/$1.00 USD) - 2016/03/23 13:50:11 CET [2016/03/23 8:50:11 ET]
Table 'Smiley' 9-max Seat #6 is the button
Seat 1: WDW3 ($106.58 in chips) 
Seat 2: Jimy Tiltman ($100 in chips) 
Seat 3: matiko09 ($101.98 in chips) 
Seat 4: Zeeshka ($146.92 in chips) 
Seat 5: DUkalisUA ($100 in chips) 
Seat 6: blackmont111 ($127.67 in chips) 
Seat 7: Moszes360 ($100.50 in chips) 
Seat 8: RICKA16 ($100 in chips) 
Seat 9: morosun ($106.59 in chips) 
Moszes360: posts small blind $0.50
RICKA16: posts big blind $1
*** HOLE CARDS ***
Dealt to matiko09 [As 2c]
morosun: raises $2 to $3
WDW3: calls $3
Jimy Tiltman: folds 
matiko09: folds 
Zeeshka: folds 
DUkalisUA: calls $3
blackmont111: calls $3
Moszes360: folds 
RICKA16: folds 
*** FLOP *** [Jd 3h 6h]
morosun: bets $12.89
WDW3: folds 
DUkalisUA: raises $21.11 to $34
blackmont111: folds 
morosun: calls $21.11
*** TURN *** [Jd 3h 6h] [8s]
morosun: checks 
DUkalisUA: bets $63 and is all-in
morosun: calls $63
*** RIVER *** [Jd 3h 6h 8s] [7c]
*** SHOW DOWN ***
morosun: shows [Jc Tc] (a pair of Jacks)
DUkalisUA: shows [6s 6c] (three of a kind, Sixes)
DUkalisUA collected $204.70 from pot
*** SUMMARY ***
Total pot $207.50 | Rake $2.80 
Board [Jd 3h 6h 8s 7c]
Seat 1: WDW3 folded on the Flop
Seat 2: Jimy Tiltman folded before Flop (didn't bet)
Seat 3: matiko09 folded before Flop (didn't bet)
Seat 4: Zeeshka folded before Flop (didn't bet)
Seat 5: DUkalisUA showed [6s 6c] and won ($204.70) with three of a kind, Sixes
Seat 6: blackmont111 (button) folded on the Flop
Seat 7: Moszes360 (small blind) folded before Flop
Seat 8: RICKA16 (big blind) folded before Flop
Seat 9: morosun showed [Jc Tc] and lost with a pair of Jacks





PokerStars Hand #150799975094:  Hold'em No Limit ($1/$2 USD) - 2016/03/23 13:50:13 CET [2016/03/23 8:50:13 ET]
Table 'Berbericia II' 9-max Seat #6 is the button
Seat 1: WDW3 ($209.05 in chips) 
Seat 2: Moszes360 ($213.52 in chips) 
Seat 3: Fish4trips ($226.02 in chips) 
Seat 4: bennetb77 ($94.34 in chips) 
Seat 5: darren1031 ($214.47 in chips) 
Seat 6: Charity86 ($175.88 in chips) 
Seat 8: matiko09 ($301.51 in chips) 
Seat 9: LVV-Bif ($295.90 in chips) 
matiko09: posts small blind $1
LVV-Bif: posts big blind $2
*** HOLE CARDS ***
Dealt to matiko09 [8h As]
WDW3: raises $3.60 to $5.60
Moszes360: folds 
Fish4trips: folds 
bennetb77: folds 
darren1031: folds 
Charity86: folds 
matiko09: folds 
LVV-Bif: folds 
Uncalled bet ($3.60) returned to WDW3
WDW3 collected $5 from pot
WDW3: doesn't show hand 
*** SUMMARY ***
Total pot $5 | Rake $0 
Seat 1: WDW3 collected ($5)
Seat 2: Moszes360 folded before Flop (didn't bet)
Seat 3: Fish4trips folded before Flop (didn't bet)
Seat 4: bennetb77 folded before Flop (didn't bet)
Seat 5: darren1031 folded before Flop (didn't bet)
Seat 6: Charity86 (button) folded before Flop (didn't bet)
Seat 8: matiko09 (small blind) folded before Flop
Seat 9: LVV-Bif (big blind) folded before Flop





PokerStars Hand #150799976812:  Hold'em No Limit ($1/$2 USD) - 2016/03/23 13:50:16 CET [2016/03/23 8:50:16 ET]
Table 'Kypria II' 9-max Seat #1 is the button
Seat 1: geldwolfje ($155.66 in chips) 
Seat 2: coinflip_si ($200 in chips) 
Seat 3: seouljam ($205.73 in chips) 
Seat 4: nailz83 ($63.82 in chips) 
Seat 5: InsomniaRU ($348.62 in chips) 
Seat 6: matiko09 ($288.69 in chips) 
Seat 7: DUkalisUA ($200 in chips) 
Seat 8: Fish4trips ($346.79 in chips) 
Seat 9: WDW3 ($211.19 in chips) 
coinflip_si: posts small blind $1
seouljam: posts big blind $2
*** HOLE CARDS ***
Dealt to matiko09 [9h 5c]
nailz83: raises $4 to $6
InsomniaRU: folds 
matiko09: folds 
DUkalisUA: folds 
Fish4trips: folds 
WDW3: folds 
geldwolfje: calls $6
coinflip_si: folds 
seouljam: folds 
*** FLOP *** [Ah 3c 3h]
nailz83: checks 
geldwolfje: checks 
*** TURN *** [Ah 3c 3h] [2c]
nailz83: bets $8
geldwolfje: folds 
Uncalled bet ($8) returned to nailz83
nailz83 collected $14.32 from pot
nailz83: doesn't show hand 
*** SUMMARY ***
Total pot $15 | Rake $0.68 
Board [Ah 3c 3h 2c]
Seat 1: geldwolfje (button) folded on the Turn
Seat 2: coinflip_si (small blind) folded before Flop
Seat 3: seouljam (big blind) folded before Flop
Seat 4: nailz83 collected ($14.32)
Seat 5: InsomniaRU folded before Flop (didn't bet)
Seat 6: matiko09 folded before Flop (didn't bet)
Seat 7: DUkalisUA folded before Flop (didn't bet)
Seat 8: Fish4trips folded before Flop (didn't bet)
Seat 9: WDW3 folded before Flop (didn't bet)





PokerStars Hand #150799984935:  Hold'em No Limit (€0.25/€0.50 EUR) - 2016/03/23 13:50:30 CET [2016/03/23 8:50:30 ET]
Table 'Palma II' 9-max Seat #8 is the button
Seat 1: Aalleekks (€50 in chips) 
Seat 2: matiko09 (€52.35 in chips) 
Seat 3: ardo888 (€55.69 in chips) 
Seat 4: dndngod (€69.52 in chips) 
Seat 5: SVFB13 (€51.75 in chips) 
Seat 6: CAJUN890 (€45.75 in chips) 
Seat 7: Kuca :P (€50 in chips) 
Seat 8: Effort92 (€50 in chips) 
Seat 9: Red_Warning (€50 in chips) 
Red_Warning: posts small blind €0.25
Aalleekks: posts big blind €0.50
*** HOLE CARDS ***
Dealt to matiko09 [Jh Ks]
matiko09: folds 
ardo888: folds 
dndngod: folds 
SVFB13: folds 
CAJUN890: calls €0.50
Kuca :P: folds 
Effort92: raises €1 to €1.50
Red_Warning: folds 
Aalleekks: folds 
CAJUN890: calls €1
*** FLOP *** [3h Kc Qs]
CAJUN890: checks 
Effort92: bets €1.50
CAJUN890: folds 
Uncalled bet (€1.50) returned to Effort92
Effort92 collected €3.58 from pot
Effort92: doesn't show hand 
*** SUMMARY ***
Total pot €3.75 | Rake €0.17 
Board [3h Kc Qs]
Seat 1: Aalleekks (big blind) folded before Flop
Seat 2: matiko09 folded before Flop (didn't bet)
Seat 3: ardo888 folded before Flop (didn't bet)
Seat 4: dndngod folded before Flop (didn't bet)
Seat 5: SVFB13 folded before Flop (didn't bet)
Seat 6: CAJUN890 folded on the Flop
Seat 7: Kuca :P folded before Flop (didn't bet)
Seat 8: Effort92 (button) collected (€3.58)
Seat 9: Red_Warning (small blind) folded before Flop





PokerStars Hand #150799985588:  Hold'em No Limit ($0.50/$1.00 USD) - 2016/03/23 13:50:32 CET [2016/03/23 8:50:32 ET]
Table 'Oljato' 9-max Seat #8 is the button
Seat 1: xHourglass ($116.88 in chips) 
Seat 2: roman134679 ($62.72 in chips) 
Seat 3: DUkalisUA ($100 in chips) 
Seat 4: Pvsx. ($139.60 in chips) 
Seat 6: WDW3 ($114.58 in chips) 
Seat 7: matiko09 ($154.09 in chips) 
Seat 8: Zeeshka ($339.84 in chips) 
Seat 9: Jimy Tiltman ($113.27 in chips) 
Jimy Tiltman: posts small blind $0.50
xHourglass: posts big blind $1
*** HOLE CARDS ***
Dealt to matiko09 [6s Kc]
roman134679: raises $1.03 to $2.03
DUkalisUA: folds 
Pvsx.: calls $2.03
WDW3: folds 
matiko09: folds 
Zeeshka: raises $10.97 to $13
Jimy Tiltman: folds 
xHourglass: folds 
roman134679: calls $10.97
Pvsx.: folds 
*** FLOP *** [3s Td 7c]
roman134679: checks 
Zeeshka: bets $14.50
roman134679: raises $15.40 to $29.90
ryo728 leaves the table
lumen21 joins the table at seat #5 
Zeeshka: raises $88 to $117.90
roman134679: calls $19.82 and is all-in
Uncalled bet ($68.18) returned to Zeeshka
*** FIRST TURN *** [3s Td 7c] [5h]
*** FIRST RIVER *** [3s Td 7c 5h] [6c]
*** SECOND TURN *** [3s Td 7c] [5s]
*** SECOND RIVER *** [3s Td 7c 5s] [Js]
*** FIRST SHOW DOWN ***
roman134679: shows [7d 9h] (a pair of Sevens)
Zeeshka: shows [9s 9c] (a pair of Nines)
Zeeshka collected $63.09 from pot
*** SECOND SHOW DOWN ***
roman134679: shows [7d 9h] (a pair of Sevens)
Zeeshka: shows [9s 9c] (a pair of Nines)
Zeeshka collected $63.08 from pot
*** SUMMARY ***
Total pot $128.97 | Rake $2.80 
Hand was run twice
FIRST Board [3s Td 7c 5h 6c]
SECOND Board [3s Td 7c 5s Js]
Seat 1: xHourglass (big blind) folded before Flop
Seat 2: roman134679 showed [7d 9h] and lost with a pair of Sevens, and lost with a pair of Sevens
Seat 3: DUkalisUA folded before Flop (didn't bet)
Seat 4: Pvsx. folded before Flop
Seat 6: WDW3 folded before Flop (didn't bet)
Seat 7: matiko09 folded before Flop (didn't bet)
Seat 8: Zeeshka (button) showed [9s 9c] and won ($63.09) with a pair of Nines, and won ($63.08) with a pair of Nines
Seat 9: Jimy Tiltman (small blind) folded before Flop





PokerStars Hand #150799986256:  Hold'em No Limit ($0.50/$1.00 USD) - 2016/03/23 13:50:33 CET [2016/03/23 8:50:33 ET]
Table 'Donar II' 9-max Seat #6 is the button
Seat 1: Effort92 ($100 in chips) 
Seat 2: nobrunobru1 ($72.67 in chips) 
Seat 3: st-germ30 ($97.01 in chips) 
Seat 4: DUkalisUA ($108.60 in chips) 
Seat 5: matiko09 ($102 in chips) 
Seat 6: ardo888 ($118.09 in chips) 
Seat 7: hammerwife ($100 in chips) 
hammerwife: posts small blind $0.50
WDW3: is sitting out 
Effort92: posts big blind $1
Effort92: posts the ante $0.20
nobrunobru1: posts the ante $0.20
st-germ30: posts the ante $0.20
DUkalisUA: posts the ante $0.20
matiko09: posts the ante $0.20
ardo888: posts the ante $0.20
hammerwife: posts the ante $0.20
*** HOLE CARDS ***
Dealt to matiko09 [3c 9h]
WDW3 leaves the table
myatiy 96 joins the table at seat #9 
myatiy 96 leaves the table
nobrunobru1: calls $1
st-germ30: folds 
DUkalisUA: folds 
matiko09: folds 
ardo888: folds 
hammerwife: raises $4 to $5
Effort92: folds 
nobrunobru1: calls $4
*** FLOP *** [7h 2d Ac]
hammerwife: checks 
nobrunobru1: bets $3
hammerwife: calls $3
*** TURN *** [7h 2d Ac] [Kc]
hammerwife: checks 
nobrunobru1: bets $5
hammerwife: folds 
Uncalled bet ($5) returned to nobrunobru1
nobrunobru1 collected $17.57 from pot
nobrunobru1: doesn't show hand 
*** SUMMARY ***
Total pot $18.40 | Rake $0.83 
Board [7h 2d Ac Kc]
Seat 1: Effort92 (big blind) folded before Flop
Seat 2: nobrunobru1 collected ($17.57)
Seat 3: st-germ30 folded before Flop (didn't bet)
Seat 4: DUkalisUA folded before Flop (didn't bet)
Seat 5: matiko09 folded before Flop (didn't bet)
Seat 6: ardo888 (button) folded before Flop (didn't bet)
Seat 7: hammerwife (small blind) folded on the Turn





PokerStars Hand #150799990176:  Hold'em No Limit ($1/$2 USD) - 2016/03/23 13:50:40 CET [2016/03/23 8:50:40 ET]
Table 'Berbericia II' 9-max Seat #8 is the button
Seat 2: Moszes360 ($213.52 in chips) 
Seat 3: Fish4trips ($226.02 in chips) 
Seat 4: bennetb77 ($94.34 in chips) 
Seat 5: darren1031 ($214.47 in chips) 
Seat 6: Charity86 ($175.88 in chips) 
Seat 8: matiko09 ($300.51 in chips) 
Seat 9: LVV-Bif ($293.90 in chips) 
LVV-Bif: posts small blind $1
WDW3: is sitting out 
WDW3 leaves the table
Moszes360: posts big blind $2
*** HOLE CARDS ***
Dealt to matiko09 [Qd 4c]
Fish4trips: folds 
bennetb77: calls $2
darren1031: folds 
Charity86: folds 
matiko09: folds 
LVV-Bif: folds 
Moszes360: checks 
*** FLOP *** [6h 3s Qc]
Moszes360: checks 
bennetb77: bets $2.43
Moszes360: folds 
Uncalled bet ($2.43) returned to bennetb77
bennetb77 collected $4.78 from pot
bennetb77: doesn't show hand 
*** SUMMARY ***
Total pot $5 | Rake $0.22 
Board [6h 3s Qc]
Seat 2: Moszes360 (big blind) folded on the Flop
Seat 3: Fish4trips folded before Flop (didn't bet)
Seat 4: bennetb77 collected ($4.78)
Seat 5: darren1031 folded before Flop (didn't bet)
Seat 6: Charity86 folded before Flop (didn't bet)
Seat 8: matiko09 (button) folded before Flop (didn't bet)
Seat 9: LVV-Bif (small blind) folded before Flop





PokerStars Hand #150799992164:  Hold'em No Limit ($0.25/$0.50 USD) - 2016/03/23 13:50:43 CET [2016/03/23 8:50:43 ET]
Table 'Pyrrhus' 9-max Seat #1 is the button
Seat 1: lumen21 ($50.75 in chips) 
Seat 2: Zeeshka ($50 in chips) 
Seat 3: IvanUrgant ($83.87 in chips) 
Seat 4: GriffinBerg ($12.89 in chips) 
Seat 5: Moszes360 ($50 in chips) 
Seat 6: whalldo ($165.12 in chips) 
Seat 7: matiko09 ($127.76 in chips) 
Seat 8: dndngod ($60.23 in chips) 
Seat 9: CvMCvMCvM ($113.11 in chips) 
Zeeshka: posts small blind $0.25
IvanUrgant: posts big blind $0.50
*** HOLE CARDS ***
Dealt to matiko09 [Qc Kh]
GriffinBerg: raises $1 to $1.50
Moszes360: folds 
whalldo: folds 
matiko09: calls $1.50
dndngod: folds 
CvMCvMCvM: folds 
lumen21: folds 
Zeeshka: folds 
IvanUrgant: folds 
*** FLOP *** [5h 4s 3s]
GriffinBerg: checks 
matiko09: checks 
*** TURN *** [5h 4s 3s] [3h]
GriffinBerg: checks 
matiko09: checks 
*** RIVER *** [5h 4s 3s 3h] [Qd]
GriffinBerg: bets $1.30
matiko09: calls $1.30
*** SHOW DOWN ***
GriffinBerg: shows [Ts Ad] (a pair of Threes)
matiko09: shows [Qc Kh] (two pair, Queens and Threes)
matiko09 collected $6.06 from pot
*** SUMMARY ***
Total pot $6.35 | Rake $0.29 
Board [5h 4s 3s 3h Qd]
Seat 1: lumen21 (button) folded before Flop (didn't bet)
Seat 2: Zeeshka (small blind) folded before Flop
Seat 3: IvanUrgant (big blind) folded before Flop
Seat 4: GriffinBerg showed [Ts Ad] and lost with a pair of Threes
Seat 5: Moszes360 folded before Flop (didn't bet)
Seat 6: whalldo folded before Flop (didn't bet)
Seat 7: matiko09 showed [Qc Kh] and won ($6.06) with two pair, Queens and Threes
Seat 8: dndngod folded before Flop (didn't bet)
Seat 9: CvMCvMCvM folded before Flop (didn't bet)





PokerStars Hand #150799991824:  Hold'em No Limit ($1/$2 USD) - 2016/03/23 13:50:43 CET [2016/03/23 8:50:43 ET]
Table 'Herba II' 9-max Seat #9 is the button
Seat 1: matiko09 ($230.48 in chips) 
Seat 2: Moszes360 ($204.20 in chips) 
Seat 3: Cirilico ($162.60 in chips) 
Seat 4: DUkalisUA ($286.78 in chips) 
Seat 5: chippo boy ($211.04 in chips) 
Seat 6: WDW3 ($210.33 in chips) 
Seat 7: InsomniaRU ($210.42 in chips) 
Seat 8: The_red_area ($450.84 in chips) 
Seat 9: mrhighryza ($62.23 in chips) 
matiko09: posts small blind $1
Moszes360: posts big blind $2
*** HOLE CARDS ***
Dealt to matiko09 [Jh 7s]
Cirilico: folds 
DUkalisUA: folds 
chippo boy: folds 
WDW3: folds 
InsomniaRU: raises $3 to $5
The_red_area: folds 
mrhighryza: folds 
matiko09: folds 
Moszes360: folds 
Uncalled bet ($3) returned to InsomniaRU
InsomniaRU collected $5 from pot
InsomniaRU: doesn't show hand 
*** SUMMARY ***
Total pot $5 | Rake $0 
Seat 1: matiko09 (small blind) folded before Flop
Seat 2: Moszes360 (big blind) folded before Flop
Seat 3: Cirilico folded before Flop (didn't bet)
Seat 4: DUkalisUA folded before Flop (didn't bet)
Seat 5: chippo boy folded before Flop (didn't bet)
Seat 6: WDW3 folded before Flop (didn't bet)
Seat 7: InsomniaRU collected ($5)
Seat 8: The_red_area folded before Flop (didn't bet)
Seat 9: mrhighryza (button) folded before Flop (didn't bet)





PokerStars Hand #150799994699:  Hold'em No Limit ($1/$2 USD) - 2016/03/23 13:50:48 CET [2016/03/23 8:50:48 ET]
Table 'Kiess' 9-max Seat #2 is the button
Seat 1: Cirilico ($163.56 in chips) 
Seat 2: DUkalisUA ($472.57 in chips) 
Seat 3: The_red_area ($370.82 in chips) 
Seat 4: Moszes360 ($228.77 in chips) 
Seat 5: chippo boy ($307.86 in chips) 
Seat 6: matiko09 ($291.84 in chips) 
Seat 7: InsomniaRU ($276.17 in chips) 
Seat 8: WDW3 ($369.82 in chips) 
Seat 9: Fish4trips ($214.55 in chips) 
The_red_area: posts small blind $1
Moszes360: posts big blind $2
*** HOLE CARDS ***
Dealt to matiko09 [8c Ad]
chippo boy: folds 
matiko09: folds 
InsomniaRU: folds 
WDW3: folds 
Fish4trips: folds 
Cirilico: folds 
DUkalisUA: raises $2 to $4
The_red_area: folds 
Moszes360: folds 
Uncalled bet ($2) returned to DUkalisUA
DUkalisUA collected $5 from pot
DUkalisUA: doesn't show hand 
*** SUMMARY ***
Total pot $5 | Rake $0 
Seat 1: Cirilico folded before Flop (didn't bet)
Seat 2: DUkalisUA (button) collected ($5)
Seat 3: The_red_area (small blind) folded before Flop
Seat 4: Moszes360 (big blind) folded before Flop
Seat 5: chippo boy folded before Flop (didn't bet)
Seat 6: matiko09 folded before Flop (didn't bet)
Seat 7: InsomniaRU folded before Flop (didn't bet)
Seat 8: WDW3 folded before Flop (didn't bet)
Seat 9: Fish4trips folded before Flop (didn't bet)





PokerStars Hand #150799999779:  Hold'em No Limit ($0.50/$1.00 USD) - 2016/03/23 13:50:57 CET [2016/03/23 8:50:57 ET]
Table 'Atlantis' 9-max Seat #2 is the button
Seat 1: xHourglass ($157.28 in chips) 
Seat 2: tffff2006 ($49.28 in chips) 
Seat 3: CAJUN890 ($107.96 in chips) 
Seat 4: matiko09 ($123.95 in chips) 
Seat 5: Pvsx. ($100 in chips) 
Seat 6: Jimy Tiltman ($127.74 in chips) 
Seat 7: Zeeshka ($106.32 in chips) 
Seat 8: DUkalisUA ($101.50 in chips) 
Seat 9: WDW3 ($130.56 in chips) 
CAJUN890: posts small blind $0.50
matiko09: posts big blind $1
*** HOLE CARDS ***
Dealt to matiko09 [6c 5c]
Pvsx.: folds 
Jimy Tiltman: folds 
Zeeshka: folds 
DUkalisUA: folds 
WDW3: folds 
xHourglass: folds 
tffff2006: raises $1 to $2
CAJUN890: calls $1.50
matiko09: calls $1
*** FLOP *** [5h Qd 7h]
CAJUN890: checks 
matiko09: checks 
tffff2006: bets $2.86
CAJUN890: raises $4.14 to $7
matiko09: folds 
tffff2006: folds [Jc]
Uncalled bet ($4.14) returned to CAJUN890
CAJUN890 collected $11.19 from pot
CAJUN890: doesn't show hand 
*** SUMMARY ***
Total pot $11.72 | Rake $0.53 
Board [5h Qd 7h]
Seat 1: xHourglass folded before Flop (didn't bet)
Seat 2: tffff2006 (button) folded on the Flop
Seat 3: CAJUN890 (small blind) collected ($11.19)
Seat 4: matiko09 (big blind) folded on the Flop
Seat 5: Pvsx. folded before Flop (didn't bet)
Seat 6: Jimy Tiltman folded before Flop (didn't bet)
Seat 7: Zeeshka folded before Flop (didn't bet)
Seat 8: DUkalisUA folded before Flop (didn't bet)
Seat 9: WDW3 folded before Flop (didn't bet)





PokerStars Hand #150800002147:  Hold'em No Limit ($1/$2 USD) - 2016/03/23 13:51:01 CET [2016/03/23 8:51:01 ET]
Table 'Berbericia II' 9-max Seat #9 is the button
Seat 2: Moszes360 ($211.52 in chips) 
Seat 3: Fish4trips ($226.02 in chips) 
Seat 4: bennetb77 ($97.12 in chips) 
Seat 5: darren1031 ($214.47 in chips) 
Seat 6: Charity86 ($175.88 in chips) 
Seat 8: matiko09 ($300.51 in chips) 
Seat 9: LVV-Bif ($292.90 in chips) 
Moszes360: posts small blind $1
Fish4trips: posts big blind $2
*** HOLE CARDS ***
Dealt to matiko09 [4h Td]
bennetb77: folds 
darren1031: folds 
Charity86: folds 
matiko09: folds 
LVV-Bif: folds 
LVV-Bif leaves the table
Moszes360: folds 
Uncalled bet ($1) returned to Fish4trips
myatiy 96 joins the table at seat #9 
myatiy 96 leaves the table
Fish4trips collected $2 from pot
Fish4trips: doesn't show hand 
*** SUMMARY ***
Total pot $2 | Rake $0 
Seat 2: Moszes360 (small blind) folded before Flop
Seat 3: Fish4trips (big blind) collected ($2)
Seat 4: bennetb77 folded before Flop (didn't bet)
Seat 5: darren1031 folded before Flop (didn't bet)
Seat 6: Charity86 folded before Flop (didn't bet)
Seat 8: matiko09 folded before Flop (didn't bet)
Seat 9: LVV-Bif (button) folded before Flop (didn't bet)





PokerStars Hand #150800004530:  Hold'em No Limit ($1/$2 USD) - 2016/03/23 13:51:05 CET [2016/03/23 8:51:05 ET]
Table 'Kypria II' 9-max Seat #2 is the button
Seat 1: geldwolfje ($149.66 in chips) 
Seat 2: coinflip_si ($200 in chips) 
Seat 3: seouljam ($203.73 in chips) 
Seat 4: nailz83 ($72.14 in chips) 
Seat 5: InsomniaRU ($348.62 in chips) 
Seat 6: matiko09 ($288.69 in chips) 
Seat 7: DUkalisUA ($200 in chips) 
Seat 8: Fish4trips ($346.79 in chips) 
Seat 9: WDW3 ($211.19 in chips) 
seouljam: posts small blind $1
nailz83: posts big blind $2
*** HOLE CARDS ***
Dealt to matiko09 [3h 6h]
InsomniaRU: folds 
matiko09: folds 
DUkalisUA: folds 
Fish4trips: folds 
WDW3: folds 
geldwolfje: raises $4 to $6
coinflip_si: folds 
seouljam: folds 
nailz83: folds 
Uncalled bet ($4) returned to geldwolfje
geldwolfje collected $5 from pot
geldwolfje: doesn't show hand 
*** SUMMARY ***
Total pot $5 | Rake $0 
Seat 1: geldwolfje collected ($5)
Seat 2: coinflip_si (button) folded before Flop (didn't bet)
Seat 3: seouljam (small blind) folded before Flop
Seat 4: nailz83 (big blind) folded before Flop
Seat 5: InsomniaRU folded before Flop (didn't bet)
Seat 6: matiko09 folded before Flop (didn't bet)
Seat 7: DUkalisUA folded before Flop (didn't bet)
Seat 8: Fish4trips folded before Flop (didn't bet)
Seat 9: WDW3 folded before Flop (didn't bet)





PokerStars Hand #150800005051:  Hold'em No Limit ($0.50/$1.00 USD) - 2016/03/23 13:51:06 CET [2016/03/23 8:51:06 ET]
Table 'Kippes' 9-max Seat #6 is the button
Seat 1: Pvsx. ($100 in chips) 
Seat 2: RICKA16 ($128.63 in chips) 
Seat 3: CAJUN890 ($126.97 in chips) 
Seat 4: matiko09 ($107.72 in chips) 
Seat 5: Jimy Tiltman ($118.36 in chips) 
Seat 6: WDW3 ($116.57 in chips) 
Seat 7: lumen21 ($100 in chips) 
Seat 8: Zeeshka ($111.80 in chips) 
Seat 9: wang19790906 ($83.67 in chips) 
lumen21: posts small blind $0.50
Zeeshka: posts big blind $1
*** HOLE CARDS ***
Dealt to matiko09 [Ac Td]
wang19790906: calls $1
Pvsx.: folds 
RICKA16: folds 
CAJUN890: folds 
matiko09: raises $3 to $4
Jimy Tiltman: folds 
WDW3: folds 
lumen21: calls $3.50
Zeeshka: folds 
wang19790906: calls $3
*** FLOP *** [Tc 2c Qh]
lumen21: checks 
wang19790906: checks 
matiko09: checks 
*** TURN *** [Tc 2c Qh] [Jc]
lumen21: bets $10
wang19790906: folds 
matiko09: calls $10
*** RIVER *** [Tc 2c Qh Jc] [5h]
lumen21: bets $24.27
matiko09: folds 
Uncalled bet ($24.27) returned to lumen21
lumen21 collected $31.52 from pot
lumen21: doesn't show hand 
*** SUMMARY ***
Total pot $33 | Rake $1.48 
Board [Tc 2c Qh Jc 5h]
Seat 1: Pvsx. folded before Flop (didn't bet)
Seat 2: RICKA16 folded before Flop (didn't bet)
Seat 3: CAJUN890 folded before Flop (didn't bet)
Seat 4: matiko09 folded on the River
Seat 5: Jimy Tiltman folded before Flop (didn't bet)
Seat 6: WDW3 (button) folded before Flop (didn't bet)
Seat 7: lumen21 (small blind) collected ($31.52)
Seat 8: Zeeshka (big blind) folded before Flop
Seat 9: wang19790906 folded on the Turn





PokerStars Hand #150800010146:  Hold'em No Limit (€0.25/€0.50 EUR) - 2016/03/23 13:51:15 CET [2016/03/23 8:51:15 ET]
Table 'Hesperia II' 9-max Seat #4 is the button
Seat 1: CAJUN890 (€55.83 in chips) 
Seat 2: dndngod (€54.14 in chips) 
Seat 3: IvanUrgant (€57.05 in chips) 
Seat 4: Zelenis (€21.15 in chips) 
Seat 5: Avrora-sp (€50 in chips) 
Seat 6: CvMCvMCvM (€50 in chips) 
Seat 7: matiko09 (€60.98 in chips) 
Seat 8: Ahangama (€50 in chips) 
Seat 9: Red_Warning (€50 in chips) 
Avrora-sp: posts small blind €0.25
CvMCvMCvM: posts big blind €0.50
*** HOLE CARDS ***
Dealt to matiko09 [8c Ad]
matiko09: folds 
Ahangama: folds 
Red_Warning: folds 
CAJUN890: folds 
dndngod: folds 
IvanUrgant: folds 
Zelenis: folds 
Avrora-sp: raises €0.75 to €1.25
CvMCvMCvM: folds 
Uncalled bet (€0.75) returned to Avrora-sp
Avrora-sp collected €1 from pot
Avrora-sp: doesn't show hand 
*** SUMMARY ***
Total pot €1 | Rake €0 
Seat 1: CAJUN890 folded before Flop (didn't bet)
Seat 2: dndngod folded before Flop (didn't bet)
Seat 3: IvanUrgant folded before Flop (didn't bet)
Seat 4: Zelenis (button) folded before Flop (didn't bet)
Seat 5: Avrora-sp (small blind) collected (€1)
Seat 6: CvMCvMCvM (big blind) folded before Flop
Seat 7: matiko09 folded before Flop (didn't bet)
Seat 8: Ahangama folded before Flop (didn't bet)
Seat 9: Red_Warning folded before Flop (didn't bet)





PokerStars Hand #150800010848:  Hold'em No Limit ($1/$2 USD) - 2016/03/23 13:51:16 CET [2016/03/23 8:51:16 ET]
Table 'Berbericia II' 9-max Seat #2 is the button
Seat 2: Moszes360 ($210.52 in chips) 
Seat 3: Fish4trips ($227.02 in chips) 
Seat 4: bennetb77 ($97.12 in chips) 
Seat 5: darren1031 ($214.47 in chips) 
Seat 6: Charity86 ($175.88 in chips) 
Seat 8: matiko09 ($300.51 in chips) 
Fish4trips: posts small blind $1
bennetb77: posts big blind $2
*** HOLE CARDS ***
Dealt to matiko09 [9s 4d]
darren1031: folds 
Charity86: folds 
InsomniaRU joins the table at seat #9 
InsomniaRU leaves the table
matiko09: folds 
Moszes360: raises $2.20 to $4.20
Fish4trips: raises $10.80 to $15
bennetb77: folds 
B@ngel joins the table at seat #9 
Moszes360: raises $27 to $42
Fish4trips: folds 
Uncalled bet ($27) returned to Moszes360
Moszes360 collected $32 from pot
Moszes360: doesn't show hand 
*** SUMMARY ***
Total pot $32 | Rake $0 
Seat 2: Moszes360 (button) collected ($32)
Seat 3: Fish4trips (small blind) folded before Flop
Seat 4: bennetb77 (big blind) folded before Flop
Seat 5: darren1031 folded before Flop (didn't bet)
Seat 6: Charity86 folded before Flop (didn't bet)
Seat 8: matiko09 folded before Flop (didn't bet)





PokerStars Hand #150800010620:  Hold'em No Limit ($0.25/$0.50 USD) - 2016/03/23 13:51:16 CET [2016/03/23 8:51:16 ET]
Table 'Belnika' 9-max Seat #7 is the button
Seat 1: yellowfever0 ($42.06 in chips) 
Seat 2: NeverRegret7 ($51.99 in chips) 
Seat 3: ChiChioChi ($55.30 in chips) 
Seat 4: matiko09 ($66.10 in chips) 
Seat 5: IvanUrgant ($50 in chips) 
Seat 6: Ahangama ($63.25 in chips) 
Seat 7: Zeeshka ($50 in chips) 
Seat 8: lumen21 ($61.41 in chips) 
Seat 9: dndngod ($61.91 in chips) 
lumen21: posts small blind $0.25
dndngod: posts big blind $0.50
*** HOLE CARDS ***
Dealt to matiko09 [6h 4c]
yellowfever0: calls $0.50
NeverRegret7: folds 
ChiChioChi: calls $0.50
matiko09: folds 
IvanUrgant: folds 
Ahangama: raises $2 to $2.50
Zeeshka: folds 
lumen21: folds 
dndngod: folds 
yellowfever0: calls $2
ChiChioChi: calls $2
*** FLOP *** [6s Jh 6d]
yellowfever0: bets $4
ChiChioChi: calls $4
Ahangama: calls $4
*** TURN *** [6s Jh 6d] [8d]
yellowfever0: bets $11
ChiChioChi: calls $11
Ahangama: folds 
*** RIVER *** [6s Jh 6d 8d] [Kd]
yellowfever0: checks 
ChiChioChi: checks 
*** SHOW DOWN ***
yellowfever0: shows [9h Js] (two pair, Jacks and Sixes)
ChiChioChi: shows [Jc 8c] (two pair, Jacks and Eights)
ChiChioChi collected $40.35 from pot
*** SUMMARY ***
Total pot $42.25 | Rake $1.90 
Board [6s Jh 6d 8d Kd]
Seat 1: yellowfever0 showed [9h Js] and lost with two pair, Jacks and Sixes
Seat 2: NeverRegret7 folded before Flop (didn't bet)
Seat 3: ChiChioChi showed [Jc 8c] and won ($40.35) with two pair, Jacks and Eights
Seat 4: matiko09 folded before Flop (didn't bet)
Seat 5: IvanUrgant folded before Flop (didn't bet)
Seat 6: Ahangama folded on the Turn
Seat 7: Zeeshka (button) folded before Flop (didn't bet)
Seat 8: lumen21 (small blind) folded before Flop
Seat 9: dndngod (big blind) folded before Flop





PokerStars Hand #150800011186:  Hold'em No Limit ($1/$2 USD) - 2016/03/23 13:51:17 CET [2016/03/23 8:51:17 ET]
Table 'Herba II' 9-max Seat #1 is the button
Seat 1: matiko09 ($229.48 in chips) 
Seat 2: Moszes360 ($202.20 in chips) 
Seat 3: Cirilico ($162.60 in chips) 
Seat 4: DUkalisUA ($286.78 in chips) 
Seat 5: chippo boy ($211.04 in chips) 
Seat 6: WDW3 ($210.33 in chips) 
Seat 7: InsomniaRU ($213.42 in chips) 
Seat 8: The_red_area ($450.84 in chips) 
Seat 9: mrhighryza ($62.23 in chips) 
Moszes360: posts small blind $1
Cirilico: posts big blind $2
*** HOLE CARDS ***
Dealt to matiko09 [9d 8s]
DUkalisUA: folds 
chippo boy: folds 
WDW3: raises $3.60 to $5.60
InsomniaRU: folds 
The_red_area: folds 
mrhighryza: folds 
matiko09: folds 
Moszes360: folds 
Cirilico: calls $3.60
*** FLOP *** [9s Qh 2c]
Cirilico: checks 
WDW3: bets $8
Cirilico: folds 
Uncalled bet ($8) returned to WDW3
WDW3 collected $11.65 from pot
WDW3: doesn't show hand 
*** SUMMARY ***
Total pot $12.20 | Rake $0.55 
Board [9s Qh 2c]
Seat 1: matiko09 (button) folded before Flop (didn't bet)
Seat 2: Moszes360 (small blind) folded before Flop
Seat 3: Cirilico (big blind) folded on the Flop
Seat 4: DUkalisUA folded before Flop (didn't bet)
Seat 5: chippo boy folded before Flop (didn't bet)
Seat 6: WDW3 collected ($11.65)
Seat 7: InsomniaRU folded before Flop (didn't bet)
Seat 8: The_red_area folded before Flop (didn't bet)
Seat 9: mrhighryza folded before Flop (didn't bet)





PokerStars Hand #150800015053:  Hold'em No Limit ($0.50/$1.00 USD) - 2016/03/23 13:51:24 CET [2016/03/23 8:51:24 ET]
Table 'Merope II' 9-max Seat #3 is the button
Seat 1: Jimy Tiltman ($108.71 in chips) 
Seat 2: Zeeshka ($100 in chips) 
Seat 3: Sherlockplay ($100 in chips) 
Seat 4: YuriiSolodya ($31 in chips) 
Seat 5: DUkalisUA ($106.60 in chips) 
Seat 6: rebelTC ($87.78 in chips) 
Seat 7: matiko09 ($101.50 in chips) 
Seat 8: titentei ($96.50 in chips) 
Seat 9: RICKA16 ($100 in chips) 
YuriiSolodya: posts small blind $0.50
DUkalisUA: posts big blind $1
*** HOLE CARDS ***
Dealt to matiko09 [6d Kh]
rebelTC: raises $1 to $2
matiko09: folds 
titentei: folds 
RICKA16: folds 
Jimy Tiltman: folds 
Zeeshka: folds 
Sherlockplay: folds 
YuriiSolodya: folds 
DUkalisUA: folds 
Uncalled bet ($1) returned to rebelTC
rebelTC collected $2.50 from pot
rebelTC: doesn't show hand 
*** SUMMARY ***
Total pot $2.50 | Rake $0 
Seat 1: Jimy Tiltman folded before Flop (didn't bet)
Seat 2: Zeeshka folded before Flop (didn't bet)
Seat 3: Sherlockplay (button) folded before Flop (didn't bet)
Seat 4: YuriiSolodya (small blind) folded before Flop
Seat 5: DUkalisUA (big blind) folded before Flop
Seat 6: rebelTC collected ($2.50)
Seat 7: matiko09 folded before Flop (didn't bet)
Seat 8: titentei folded before Flop (didn't bet)
Seat 9: RICKA16 folded before Flop (didn't bet)





PokerStars Hand #150800017179:  Hold'em No Limit ($1/$2 USD) - 2016/03/23 13:51:27 CET [2016/03/23 8:51:27 ET]
Table 'Kiess' 9-max Seat #3 is the button
Seat 1: Cirilico ($163.56 in chips) 
Seat 2: DUkalisUA ($475.57 in chips) 
Seat 3: The_red_area ($369.82 in chips) 
Seat 4: Moszes360 ($226.77 in chips) 
Seat 5: chippo boy ($307.86 in chips) 
Seat 6: matiko09 ($291.84 in chips) 
Seat 7: InsomniaRU ($276.17 in chips) 
Seat 8: WDW3 ($369.82 in chips) 
Seat 9: Fish4trips ($214.55 in chips) 
Moszes360: posts small blind $1
chippo boy: posts big blind $2
*** HOLE CARDS ***
Dealt to matiko09 [9d Qs]
matiko09: folds 
InsomniaRU: folds 
WDW3: folds 
Fish4trips: folds 
Cirilico: folds 
DUkalisUA: folds 
The_red_area: folds 
Moszes360: raises $4 to $6
chippo boy: calls $4
*** FLOP *** [2h Qd Ah]
Moszes360: checks 
chippo boy: checks 
*** TURN *** [2h Qd Ah] [4s]
Moszes360: checks 
chippo boy: bets $6
Moszes360: calls $6
*** RIVER *** [2h Qd Ah 4s] [7c]
Moszes360: checks 
chippo boy: bets $10
Moszes360: calls $10
*** SHOW DOWN ***
chippo boy: shows [8c Qc] (a pair of Queens)
Moszes360: mucks hand 
chippo boy collected $42.02 from pot
*** SUMMARY ***
Total pot $44 | Rake $1.98 
Board [2h Qd Ah 4s 7c]
Seat 1: Cirilico folded before Flop (didn't bet)
Seat 2: DUkalisUA folded before Flop (didn't bet)
Seat 3: The_red_area (button) folded before Flop (didn't bet)
Seat 4: Moszes360 (small blind) mucked [Ts Th]
Seat 5: chippo boy (big blind) showed [8c Qc] and won ($42.02) with a pair of Queens
Seat 6: matiko09 folded before Flop (didn't bet)
Seat 7: InsomniaRU folded before Flop (didn't bet)
Seat 8: WDW3 folded before Flop (didn't bet)
Seat 9: Fish4trips folded before Flop (didn't bet)





PokerStars Hand #150800018078:  Hold'em No Limit ($0.50/$1.00 USD) - 2016/03/23 13:51:29 CET [2016/03/23 8:51:29 ET]
Table 'Smiley' 9-max Seat #7 is the button
Seat 1: WDW3 ($103.58 in chips) 
Seat 2: Jimy Tiltman ($100 in chips) 
Seat 3: matiko09 ($101.98 in chips) 
Seat 4: Zeeshka ($146.92 in chips) 
Seat 5: DUkalisUA ($204.70 in chips) 
Seat 6: blackmont111 ($124.67 in chips) 
Seat 7: Moszes360 ($100 in chips) 
Seat 8: RICKA16 ($99 in chips) 
Seat 9: morosun ($6.59 in chips) 
RICKA16: posts small blind $0.50
morosun: posts big blind $1
*** HOLE CARDS ***
Dealt to matiko09 [6h Td]
WDW3: raises $1.80 to $2.80
Jimy Tiltman: calls $2.80
matiko09: folds 
Zeeshka: folds 
DUkalisUA: folds 
blackmont111: folds 
Moszes360: folds 
RICKA16: folds 
morosun: raises $3.79 to $6.59 and is all-in
WDW3: calls $3.79
Jimy Tiltman: raises $11.41 to $18
WDW3: folds 
Uncalled bet ($11.41) returned to Jimy Tiltman
*** FLOP *** [8h 8c 9c]
*** TURN *** [8h 8c 9c] [Ah]
*** RIVER *** [8h 8c 9c Ah] [Kd]
*** SHOW DOWN ***
morosun: shows [As 5h] (two pair, Aces and Eights)
Jimy Tiltman: shows [Tc Ts] (two pair, Tens and Eights)
morosun collected $19.36 from pot
*** SUMMARY ***
Total pot $20.27 | Rake $0.91 
Board [8h 8c 9c Ah Kd]
Seat 1: WDW3 folded before Flop
Seat 2: Jimy Tiltman showed [Tc Ts] and lost with two pair, Tens and Eights
Seat 3: matiko09 folded before Flop (didn't bet)
Seat 4: Zeeshka folded before Flop (didn't bet)
Seat 5: DUkalisUA folded before Flop (didn't bet)
Seat 6: blackmont111 folded before Flop (didn't bet)
Seat 7: Moszes360 (button) folded before Flop (didn't bet)
Seat 8: RICKA16 (small blind) folded before Flop
Seat 9: morosun (big blind) showed [As 5h] and won ($19.36) with two pair, Aces and Eights





PokerStars Hand #150800021889:  Hold'em No Limit ($0.50/$1.00 USD) - 2016/03/23 13:51:35 CET [2016/03/23 8:51:35 ET]
Table 'Donar II' 9-max Seat #7 is the button
Seat 1: Effort92 ($100 in chips) 
Seat 2: nobrunobru1 ($82.04 in chips) 
Seat 3: st-germ30 ($96.81 in chips) 
Seat 4: DUkalisUA ($108.40 in chips) 
Seat 5: matiko09 ($101.80 in chips) 
Seat 6: ardo888 ($117.89 in chips) 
Seat 7: hammerwife ($100 in chips) 
Effort92: posts small blind $0.50
nobrunobru1: posts big blind $1
Effort92: posts the ante $0.20
nobrunobru1: posts the ante $0.20
st-germ30: posts the ante $0.20
DUkalisUA: posts the ante $0.20
matiko09: posts the ante $0.20
ardo888: posts the ante $0.20
hammerwife: posts the ante $0.20
*** HOLE CARDS ***
Dealt to matiko09 [Qs 2s]
st-germ30: folds 
DUkalisUA: folds 
matiko09: folds 
ardo888: raises $1.50 to $2.50
oxfordtenzin joins the table at seat #9 
hammerwife: folds 
Effort92: folds 
nobrunobru1: folds 
Uncalled bet ($1.50) returned to ardo888
ardo888 collected $3.90 from pot
ardo888: doesn't show hand 
*** SUMMARY ***
Total pot $3.90 | Rake $0 
Seat 1: Effort92 (small blind) folded before Flop
Seat 2: nobrunobru1 (big blind) folded before Flop
Seat 3: st-germ30 folded before Flop (didn't bet)
Seat 4: DUkalisUA folded before Flop (didn't bet)
Seat 5: matiko09 folded before Flop (didn't bet)
Seat 6: ardo888 collected ($3.90)
Seat 7: hammerwife (button) folded before Flop (didn't bet)





PokerStars Hand #150800024294:  Hold'em No Limit ($1/$2 USD) - 2016/03/23 13:51:40 CET [2016/03/23 8:51:40 ET]
Table 'Kypria II' 9-max Seat #3 is the button
Seat 1: geldwolfje ($152.66 in chips) 
Seat 2: coinflip_si ($200 in chips) 
Seat 3: seouljam ($202.73 in chips) 
Seat 4: nailz83 ($70.14 in chips) 
Seat 5: InsomniaRU ($348.62 in chips) 
Seat 6: matiko09 ($288.69 in chips) 
Seat 7: DUkalisUA ($200 in chips) 
Seat 8: Fish4trips ($346.79 in chips) 
Seat 9: WDW3 ($211.19 in chips) 
nailz83: posts small blind $1
InsomniaRU: posts big blind $2
*** HOLE CARDS ***
Dealt to matiko09 [Th 7s]
matiko09: folds 
DUkalisUA: raises $4 to $6
Fish4trips: folds 
WDW3: folds 
geldwolfje: folds 
coinflip_si: folds 
seouljam: folds 
nailz83: folds 
InsomniaRU: folds 
Uncalled bet ($4) returned to DUkalisUA
DUkalisUA collected $5 from pot
DUkalisUA: doesn't show hand 
*** SUMMARY ***
Total pot $5 | Rake $0 
Seat 1: geldwolfje folded before Flop (didn't bet)
Seat 2: coinflip_si folded before Flop (didn't bet)
Seat 3: seouljam (button) folded before Flop (didn't bet)
Seat 4: nailz83 (small blind) folded before Flop
Seat 5: InsomniaRU (big blind) folded before Flop
Seat 6: matiko09 folded before Flop (didn't bet)
Seat 7: DUkalisUA collected ($5)
Seat 8: Fish4trips folded before Flop (didn't bet)
Seat 9: WDW3 folded before Flop (didn't bet)





PokerStars Hand #150800028786:  Hold'em No Limit (€0.25/€0.50 EUR) - 2016/03/23 13:51:48 CET [2016/03/23 8:51:48 ET]
Table 'Hesperia II' 9-max Seat #5 is the button
Seat 1: CAJUN890 (€55.83 in chips) 
Seat 2: dndngod (€54.14 in chips) 
Seat 3: IvanUrgant (€57.05 in chips) 
Seat 4: Zelenis (€21.15 in chips) 
Seat 5: Avrora-sp (€50.50 in chips) 
Seat 6: CvMCvMCvM (€50 in chips) 
Seat 7: matiko09 (€60.98 in chips) 
Seat 8: Ahangama (€50 in chips) 
Seat 9: Red_Warning (€50 in chips) 
CvMCvMCvM: posts small blind €0.25
matiko09: posts big blind €0.50
*** HOLE CARDS ***
Dealt to matiko09 [2c Jc]
Ahangama: folds 
Red_Warning: folds 
CAJUN890: folds 
dndngod: folds 
IvanUrgant: folds 
Zelenis: folds 
Avrora-sp: raises €0.75 to €1.25
CvMCvMCvM: folds 
matiko09: folds 
Uncalled bet (€0.75) returned to Avrora-sp
Avrora-sp collected €1.25 from pot
Avrora-sp: doesn't show hand 
*** SUMMARY ***
Total pot €1.25 | Rake €0 
Seat 1: CAJUN890 folded before Flop (didn't bet)
Seat 2: dndngod folded before Flop (didn't bet)
Seat 3: IvanUrgant folded before Flop (didn't bet)
Seat 4: Zelenis folded before Flop (didn't bet)
Seat 5: Avrora-sp (button) collected (€1.25)
Seat 6: CvMCvMCvM (small blind) folded before Flop
Seat 7: matiko09 (big blind) folded before Flop
Seat 8: Ahangama folded before Flop (didn't bet)
Seat 9: Red_Warning folded before Flop (didn't bet)





PokerStars Hand #150800033603:  Hold'em No Limit ($1/$2 USD) - 2016/03/23 13:51:56 CET [2016/03/23 8:51:56 ET]
Table 'Berbericia II' 9-max Seat #3 is the button
Seat 2: Moszes360 ($227.52 in chips) 
Seat 3: Fish4trips ($212.02 in chips) 
Seat 4: bennetb77 ($95.12 in chips) 
Seat 5: darren1031 ($214.47 in chips) 
Seat 6: Charity86 ($175.88 in chips) 
Seat 8: matiko09 ($300.51 in chips) 
bennetb77: posts small blind $1
darren1031: posts big blind $2
B@ngel: sits out 
*** HOLE CARDS ***
Dealt to matiko09 [2s 5s]
Charity86: raises $3 to $5
matiko09: folds 
Moszes360: folds 
Fish4trips: folds 
bennetb77: folds 
darren1031: calls $3
*** FLOP *** [6s 5c Ad]
darren1031: checks 
Charity86: bets $6
darren1031: folds 
Uncalled bet ($6) returned to Charity86
Charity86 collected $10.50 from pot
*** SUMMARY ***
Total pot $11 | Rake $0.50 
Board [6s 5c Ad]
Seat 2: Moszes360 folded before Flop (didn't bet)
Seat 3: Fish4trips (button) folded before Flop (didn't bet)
Seat 4: bennetb77 (small blind) folded before Flop
Seat 5: darren1031 (big blind) folded on the Flop
Seat 6: Charity86 collected ($10.50)
Seat 8: matiko09 folded before Flop (didn't bet)





PokerStars Hand #150800034607:  Hold'em No Limit ($0.50/$1.00 USD) - 2016/03/23 13:51:58 CET [2016/03/23 8:51:58 ET]
Table 'Donar II' 9-max Seat #1 is the button
Seat 1: Effort92 ($100 in chips) 
Seat 2: nobrunobru1 ($80.84 in chips) 
Seat 3: st-germ30 ($96.61 in chips) 
Seat 4: DUkalisUA ($108.20 in chips) 
Seat 5: matiko09 ($101.60 in chips) 
Seat 6: ardo888 ($120.59 in chips) 
Seat 7: hammerwife ($100 in chips) 
nobrunobru1: posts small blind $0.50
st-germ30: posts big blind $1
oxfordtenzin: sits out 
Effort92: posts the ante $0.20
nobrunobru1: posts the ante $0.20
st-germ30: posts the ante $0.20
DUkalisUA: posts the ante $0.20
matiko09: posts the ante $0.20
ardo888: posts the ante $0.20
hammerwife: posts the ante $0.20
*** HOLE CARDS ***
Dealt to matiko09 [3s 8c]
DUkalisUA: folds 
matiko09: folds 
ardo888: raises $2 to $3
hammerwife: folds 
Effort92: folds 
nobrunobru1: calls $2.50
st-germ30: calls $2
*** FLOP *** [As 5d Qd]
nobrunobru1: checks 
st-germ30: checks 
ardo888: bets $7.24
nobrunobru1: folds 
st-germ30: folds 
Uncalled bet ($7.24) returned to ardo888
ardo888 collected $9.93 from pot
ardo888: doesn't show hand 
*** SUMMARY ***
Total pot $10.40 | Rake $0.47 
Board [As 5d Qd]
Seat 1: Effort92 (button) folded before Flop (didn't bet)
Seat 2: nobrunobru1 (small blind) folded on the Flop
Seat 3: st-germ30 (big blind) folded on the Flop
Seat 4: DUkalisUA folded before Flop (didn't bet)
Seat 5: matiko09 folded before Flop (didn't bet)
Seat 6: ardo888 collected ($9.93)
Seat 7: hammerwife folded before Flop (didn't bet)





PokerStars Hand #150800036327:  Hold'em No Limit ($1/$2 USD) - 2016/03/23 13:52:01 CET [2016/03/23 8:52:01 ET]
Table 'Herba II' 9-max Seat #2 is the button
Seat 1: matiko09 ($229.48 in chips) 
Seat 2: Moszes360 ($201.20 in chips) 
Seat 3: Cirilico ($160 in chips) 
Seat 4: DUkalisUA ($286.78 in chips) 
Seat 5: chippo boy ($211.04 in chips) 
Seat 6: WDW3 ($216.38 in chips) 
Seat 7: InsomniaRU ($213.42 in chips) 
Seat 8: The_red_area ($450.84 in chips) 
Seat 9: mrhighryza ($62.23 in chips) 
Cirilico: posts small blind $1
DUkalisUA: posts big blind $2
*** HOLE CARDS ***
Dealt to matiko09 [As 9c]
chippo boy: folds 
WDW3: folds 
InsomniaRU: folds 
The_red_area: calls $2
mrhighryza: folds 
matiko09: raises $6 to $8
Moszes360: folds 
Cirilico: folds 
DUkalisUA: folds 
The_red_area: calls $6
*** FLOP *** [8c 8d 5c]
The_red_area: checks 
matiko09: checks 
*** TURN *** [8c 8d 5c] [Ts]
The_red_area: checks 
matiko09: checks 
*** RIVER *** [8c 8d 5c Ts] [Qs]
The_red_area: checks 
matiko09: checks 
*** SHOW DOWN ***
The_red_area: shows [2c 2d] (two pair, Eights and Deuces)
matiko09: mucks hand 
The_red_area collected $18.14 from pot
*** SUMMARY ***
Total pot $19 | Rake $0.86 
Board [8c 8d 5c Ts Qs]
Seat 1: matiko09 mucked [As 9c]
Seat 2: Moszes360 (button) folded before Flop (didn't bet)
Seat 3: Cirilico (small blind) folded before Flop
Seat 4: DUkalisUA (big blind) folded before Flop
Seat 5: chippo boy folded before Flop (didn't bet)
Seat 6: WDW3 folded before Flop (didn't bet)
Seat 7: InsomniaRU folded before Flop (didn't bet)
Seat 8: The_red_area showed [2c 2d] and won ($18.14) with two pair, Eights and Deuces
Seat 9: mrhighryza folded before Flop (didn't bet)





PokerStars Hand #150800037539:  Hold'em No Limit ($0.50/$1.00 USD) - 2016/03/23 13:52:03 CET [2016/03/23 8:52:03 ET]
Table 'Atlantis' 9-max Seat #3 is the button
Seat 1: xHourglass ($157.28 in chips) 
Seat 2: tffff2006 ($44.42 in chips) 
Seat 3: CAJUN890 ($114.29 in chips) 
Seat 4: matiko09 ($121.95 in chips) 
Seat 5: Pvsx. ($100 in chips) 
Seat 6: Jimy Tiltman ($127.74 in chips) 
Seat 7: Zeeshka ($106.32 in chips) 
Seat 8: DUkalisUA ($101.50 in chips) 
Seat 9: WDW3 ($130.56 in chips) 
matiko09: posts small blind $0.50
Pvsx.: posts big blind $1
*** HOLE CARDS ***
Dealt to matiko09 [Td 2d]
Jimy Tiltman: raises $2 to $3
Zeeshka: folds 
DUkalisUA: calls $3
WDW3: folds 
xHourglass: folds 
tffff2006: folds 
CAJUN890: folds 
matiko09: folds 
Pvsx.: calls $2
*** FLOP *** [7h 8d Js]
Pvsx.: checks 
Jimy Tiltman: bets $6.80
DUkalisUA: folds 
Pvsx.: folds 
Uncalled bet ($6.80) returned to Jimy Tiltman
Jimy Tiltman collected $9.07 from pot
Jimy Tiltman: doesn't show hand 
*** SUMMARY ***
Total pot $9.50 | Rake $0.43 
Board [7h 8d Js]
Seat 1: xHourglass folded before Flop (didn't bet)
Seat 2: tffff2006 folded before Flop (didn't bet)
Seat 3: CAJUN890 (button) folded before Flop (didn't bet)
Seat 4: matiko09 (small blind) folded before Flop
Seat 5: Pvsx. (big blind) folded on the Flop
Seat 6: Jimy Tiltman collected ($9.07)
Seat 7: Zeeshka folded before Flop (didn't bet)
Seat 8: DUkalisUA folded on the Flop
Seat 9: WDW3 folded before Flop (didn't bet)





PokerStars Hand #150800038537:  Hold'em No Limit (€0.25/€0.50 EUR) - 2016/03/23 13:52:05 CET [2016/03/23 8:52:05 ET]
Table 'Hesperia II' 9-max Seat #6 is the button
Seat 1: CAJUN890 (€55.83 in chips) 
Seat 2: dndngod (€54.14 in chips) 
Seat 3: IvanUrgant (€57.05 in chips) 
Seat 4: Zelenis (€21.15 in chips) 
Seat 5: Avrora-sp (€51.25 in chips) 
Seat 6: CvMCvMCvM (€50 in chips) 
Seat 7: matiko09 (€60.48 in chips) 
Seat 8: Ahangama (€50 in chips) 
Seat 9: Red_Warning (€50 in chips) 
matiko09: posts small blind €0.25
Ahangama: posts big blind €0.50
*** HOLE CARDS ***
Dealt to matiko09 [5d Jc]
Red_Warning: folds 
CAJUN890: folds 
dndngod: folds 
IvanUrgant: folds 
Zelenis: folds 
Avrora-sp: raises €0.75 to €1.25
CvMCvMCvM: folds 
matiko09: folds 
Ahangama: folds 
Uncalled bet (€0.75) returned to Avrora-sp
Avrora-sp collected €1.25 from pot
Avrora-sp: doesn't show hand 
*** SUMMARY ***
Total pot €1.25 | Rake €0 
Seat 1: CAJUN890 folded before Flop (didn't bet)
Seat 2: dndngod folded before Flop (didn't bet)
Seat 3: IvanUrgant folded before Flop (didn't bet)
Seat 4: Zelenis folded before Flop (didn't bet)
Seat 5: Avrora-sp collected (€1.25)
Seat 6: CvMCvMCvM (button) folded before Flop (didn't bet)
Seat 7: matiko09 (small blind) folded before Flop
Seat 8: Ahangama (big blind) folded before Flop
Seat 9: Red_Warning folded before Flop (didn't bet)





PokerStars Hand #150800039781:  Hold'em No Limit ($1/$2 USD) - 2016/03/23 13:52:07 CET [2016/03/23 8:52:07 ET]
Table 'Kypria II' 9-max Seat #4 is the button
Seat 1: geldwolfje ($152.66 in chips) 
Seat 2: coinflip_si ($200 in chips) 
Seat 3: seouljam ($202.73 in chips) 
Seat 4: nailz83 ($69.14 in chips) 
Seat 5: InsomniaRU ($346.62 in chips) 
Seat 6: matiko09 ($288.69 in chips) 
Seat 7: DUkalisUA ($203 in chips) 
Seat 8: Fish4trips ($346.79 in chips) 
Seat 9: WDW3 ($211.19 in chips) 
InsomniaRU: posts small blind $1
matiko09: posts big blind $2
*** HOLE CARDS ***
Dealt to matiko09 [Js 6h]
DUkalisUA: raises $4 to $6
Fish4trips: calls $6
WDW3: calls $6
geldwolfje: folds 
coinflip_si: folds 
seouljam: folds 
nailz83: calls $6
InsomniaRU: raises $26 to $32
matiko09: folds 
DUkalisUA: folds 
Fish4trips: folds 
WDW3: folds 
nailz83: folds 
Uncalled bet ($26) returned to InsomniaRU
InsomniaRU collected $32 from pot
InsomniaRU: doesn't show hand 
*** SUMMARY ***
Total pot $32 | Rake $0 
Seat 1: geldwolfje folded before Flop (didn't bet)
Seat 2: coinflip_si folded before Flop (didn't bet)
Seat 3: seouljam folded before Flop (didn't bet)
Seat 4: nailz83 (button) folded before Flop
Seat 5: InsomniaRU (small blind) collected ($32)
Seat 6: matiko09 (big blind) folded before Flop
Seat 7: DUkalisUA folded before Flop
Seat 8: Fish4trips folded before Flop
Seat 9: WDW3 folded before Flop





PokerStars Hand #150800041799:  Hold'em No Limit ($0.25/$0.50 USD) - 2016/03/23 13:52:10 CET [2016/03/23 8:52:10 ET]
Table 'Pyrrhus' 9-max Seat #2 is the button
Seat 1: lumen21 ($50.75 in chips) 
Seat 2: Zeeshka ($50 in chips) 
Seat 3: IvanUrgant ($83.37 in chips) 
Seat 4: GriffinBerg ($10.09 in chips) 
Seat 5: Moszes360 ($50 in chips) 
Seat 6: whalldo ($165.12 in chips) 
Seat 7: matiko09 ($131.02 in chips) 
Seat 8: dndngod ($60.23 in chips) 
Seat 9: CvMCvMCvM ($113.11 in chips) 
IvanUrgant: posts small blind $0.25
GriffinBerg: posts big blind $0.50
*** HOLE CARDS ***
Dealt to matiko09 [3s Qs]
Moszes360: folds 
whalldo: folds 
matiko09: folds 
dndngod: folds 
CvMCvMCvM: folds 
lumen21: raises $0.75 to $1.25
Zeeshka: folds 
IvanUrgant: folds 
GriffinBerg: raises $8.84 to $10.09 and is all-in
lumen21: folds 
Uncalled bet ($8.84) returned to GriffinBerg
GriffinBerg collected $2.75 from pot
*** SUMMARY ***
Total pot $2.75 | Rake $0 
Seat 1: lumen21 folded before Flop
Seat 2: Zeeshka (button) folded before Flop (didn't bet)
Seat 3: IvanUrgant (small blind) folded before Flop
Seat 4: GriffinBerg (big blind) collected ($2.75)
Seat 5: Moszes360 folded before Flop (didn't bet)
Seat 6: whalldo folded before Flop (didn't bet)
Seat 7: matiko09 folded before Flop (didn't bet)
Seat 8: dndngod folded before Flop (didn't bet)
Seat 9: CvMCvMCvM folded before Flop (didn't bet)





PokerStars Hand #150800046528:  Hold'em No Limit ($0.50/$1.00 USD) - 2016/03/23 13:52:19 CET [2016/03/23 8:52:19 ET]
Table 'Oljato' 9-max Seat #9 is the button
Seat 1: xHourglass ($115.88 in chips) 
Seat 3: DUkalisUA ($100 in chips) 
Seat 4: Pvsx. ($137.57 in chips) 
Seat 6: WDW3 ($114.58 in chips) 
Seat 7: matiko09 ($154.09 in chips) 
Seat 8: Zeeshka ($403.29 in chips) 
Seat 9: Jimy Tiltman ($112.77 in chips) 
xHourglass: posts small blind $0.50
DUkalisUA: posts big blind $1
lumen21: sits out 
*** HOLE CARDS ***
Dealt to matiko09 [Jd 8s]
Pvsx.: folds 
WDW3: folds 
matiko09: folds 
Zeeshka: folds 
Jimy Tiltman: raises $1 to $2
xHourglass: calls $1.50
DUkalisUA: folds 
*** FLOP *** [3d Th Ac]
xHourglass: checks 
roman134679 leaves the table
Jimy Tiltman: bets $2.65
xHourglass: calls $2.65
*** TURN *** [3d Th Ac] [5d]
xHourglass: checks 
Jimy Tiltman: checks 
*** RIVER *** [3d Th Ac 5d] [6h]
xHourglass: bets $6
Jimy Tiltman: folds 
Uncalled bet ($6) returned to xHourglass
xHourglass collected $9.84 from pot
xHourglass: doesn't show hand 
*** SUMMARY ***
Total pot $10.30 | Rake $0.46 
Board [3d Th Ac 5d 6h]
Seat 1: xHourglass (small blind) collected ($9.84)
Seat 3: DUkalisUA (big blind) folded before Flop
Seat 4: Pvsx. folded before Flop (didn't bet)
Seat 6: WDW3 folded before Flop (didn't bet)
Seat 7: matiko09 folded before Flop (didn't bet)
Seat 8: Zeeshka folded before Flop (didn't bet)
Seat 9: Jimy Tiltman (button) folded on the River





PokerStars Hand #150800046891:  Hold'em No Limit ($1/$2 USD) - 2016/03/23 13:52:19 CET [2016/03/23 8:52:19 ET]
Table 'Kiess' 9-max Seat #4 is the button
Seat 1: Cirilico ($163.56 in chips) 
Seat 2: DUkalisUA ($475.57 in chips) 
Seat 3: The_red_area ($369.82 in chips) 
Seat 4: Moszes360 ($204.77 in chips) 
Seat 5: chippo boy ($327.88 in chips) 
Seat 6: matiko09 ($291.84 in chips) 
Seat 7: InsomniaRU ($276.17 in chips) 
Seat 8: WDW3 ($369.82 in chips) 
Seat 9: Fish4trips ($214.55 in chips) 
chippo boy: posts small blind $1
matiko09: posts big blind $2
*** HOLE CARDS ***
Dealt to matiko09 [Kc 5s]
InsomniaRU: folds 
WDW3: folds 
Fish4trips: raises $3 to $5
Cirilico: folds 
DUkalisUA: folds 
The_red_area: folds 
Moszes360: folds 
chippo boy: folds 
matiko09: folds 
Uncalled bet ($3) returned to Fish4trips
Fish4trips collected $5 from pot
Fish4trips: doesn't show hand 
*** SUMMARY ***
Total pot $5 | Rake $0 
Seat 1: Cirilico folded before Flop (didn't bet)
Seat 2: DUkalisUA folded before Flop (didn't bet)
Seat 3: The_red_area folded before Flop (didn't bet)
Seat 4: Moszes360 (button) folded before Flop (didn't bet)
Seat 5: chippo boy (small blind) folded before Flop
Seat 6: matiko09 (big blind) folded before Flop
Seat 7: InsomniaRU folded before Flop (didn't bet)
Seat 8: WDW3 folded before Flop (didn't bet)
Seat 9: Fish4trips collected ($5)





PokerStars Hand #150800050471:  Hold'em No Limit ($0.50/$1.00 USD) - 2016/03/23 13:52:26 CET [2016/03/23 8:52:26 ET]
Table 'Merope II' 9-max Seat #4 is the button
Seat 1: Jimy Tiltman ($108.71 in chips) 
Seat 2: Zeeshka ($100 in chips) 
Seat 3: Sherlockplay ($100 in chips) 
Seat 4: YuriiSolodya ($30.50 in chips) 
Seat 5: DUkalisUA ($105.60 in chips) 
Seat 6: rebelTC ($89.28 in chips) 
Seat 7: matiko09 ($101.50 in chips) 
Seat 8: titentei ($96.50 in chips) 
Seat 9: RICKA16 ($100 in chips) 
DUkalisUA: posts small blind $0.50
rebelTC: posts big blind $1
*** HOLE CARDS ***
Dealt to matiko09 [2d 8c]
matiko09: folds 
titentei: folds 
RICKA16: folds 
Jimy Tiltman: folds 
Zeeshka: folds 
Sherlockplay: folds 
YuriiSolodya: folds 
DUkalisUA: folds 
Uncalled bet ($0.50) returned to rebelTC
rebelTC collected $1 from pot
rebelTC: doesn't show hand 
*** SUMMARY ***
Total pot $1 | Rake $0 
Seat 1: Jimy Tiltman folded before Flop (didn't bet)
Seat 2: Zeeshka folded before Flop (didn't bet)
Seat 3: Sherlockplay folded before Flop (didn't bet)
Seat 4: YuriiSolodya (button) folded before Flop (didn't bet)
Seat 5: DUkalisUA (small blind) folded before Flop
Seat 6: rebelTC (big blind) collected ($1)
Seat 7: matiko09 folded before Flop (didn't bet)
Seat 8: titentei folded before Flop (didn't bet)
Seat 9: RICKA16 folded before Flop (didn't bet)





PokerStars Hand #150800052620:  Hold'em No Limit (€0.25/€0.50 EUR) - 2016/03/23 13:52:30 CET [2016/03/23 8:52:30 ET]
Table 'Hesperia II' 9-max Seat #7 is the button
Seat 1: CAJUN890 (€55.83 in chips) 
Seat 2: dndngod (€54.14 in chips) 
Seat 3: IvanUrgant (€57.05 in chips) 
Seat 4: Zelenis (€21.15 in chips) 
Seat 5: Avrora-sp (€52 in chips) 
Seat 6: CvMCvMCvM (€50 in chips) 
Seat 7: matiko09 (€60.23 in chips) 
Seat 8: Ahangama (€50 in chips) 
Seat 9: Red_Warning (€50 in chips) 
Ahangama: posts small blind €0.25
Red_Warning: posts big blind €0.50
*** HOLE CARDS ***
Dealt to matiko09 [7c Qs]
CAJUN890: folds 
dndngod: raises €1 to €1.50
IvanUrgant: folds 
Zelenis: folds 
Avrora-sp: folds 
CvMCvMCvM: folds 
matiko09: folds 
Ahangama: folds 
Red_Warning: folds 
Uncalled bet (€1) returned to dndngod
dndngod collected €1.25 from pot
dndngod: doesn't show hand 
*** SUMMARY ***
Total pot €1.25 | Rake €0 
Seat 1: CAJUN890 folded before Flop (didn't bet)
Seat 2: dndngod collected (€1.25)
Seat 3: IvanUrgant folded before Flop (didn't bet)
Seat 4: Zelenis folded before Flop (didn't bet)
Seat 5: Avrora-sp folded before Flop (didn't bet)
Seat 6: CvMCvMCvM folded before Flop (didn't bet)
Seat 7: matiko09 (button) folded before Flop (didn't bet)
Seat 8: Ahangama (small blind) folded before Flop
Seat 9: Red_Warning (big blind) folded before Flop





PokerStars Hand #150800058379:  Hold'em No Limit ($0.50/$1.00 USD) - 2016/03/23 13:52:40 CET [2016/03/23 8:52:40 ET]
Table 'Kippes' 9-max Seat #7 is the button
Seat 1: Pvsx. ($100 in chips) 
Seat 2: RICKA16 ($128.63 in chips) 
Seat 3: CAJUN890 ($126.97 in chips) 
Seat 4: matiko09 ($100 in chips) 
Seat 5: Jimy Tiltman ($118.36 in chips) 
Seat 6: WDW3 ($116.57 in chips) 
Seat 7: lumen21 ($117.52 in chips) 
Seat 8: Zeeshka ($110.80 in chips) 
Seat 9: wang19790906 ($79.67 in chips) 
Zeeshka: posts small blind $0.50
wang19790906: posts big blind $1
*** HOLE CARDS ***
Dealt to matiko09 [7h Jc]
Pvsx.: folds 
RICKA16: folds 
CAJUN890: folds 
matiko09: folds 
Jimy Tiltman: folds 
WDW3: folds 
lumen21: raises $1.50 to $2.50
Zeeshka: folds 
wang19790906: calls $1.50
*** FLOP *** [Kd Jh 9s]
wang19790906: bets $4
lumen21: folds 
Uncalled bet ($4) returned to wang19790906
wang19790906 collected $5.25 from pot
wang19790906: doesn't show hand 
*** SUMMARY ***
Total pot $5.50 | Rake $0.25 
Board [Kd Jh 9s]
Seat 1: Pvsx. folded before Flop (didn't bet)
Seat 2: RICKA16 folded before Flop (didn't bet)
Seat 3: CAJUN890 folded before Flop (didn't bet)
Seat 4: matiko09 folded before Flop (didn't bet)
Seat 5: Jimy Tiltman folded before Flop (didn't bet)
Seat 6: WDW3 folded before Flop (didn't bet)
Seat 7: lumen21 (button) folded on the Flop
Seat 8: Zeeshka (small blind) folded before Flop
Seat 9: wang19790906 (big blind) collected ($5.25)





PokerStars Hand #150800059852:  Hold'em No Limit ($0.50/$1.00 USD) - 2016/03/23 13:52:42 CET [2016/03/23 8:52:42 ET]
Table 'Donar II' 9-max Seat #2 is the button
Seat 1: Effort92 ($100 in chips) 
Seat 2: nobrunobru1 ($77.64 in chips) 
Seat 3: st-germ30 ($93.41 in chips) 
Seat 4: DUkalisUA ($108 in chips) 
Seat 5: matiko09 ($101.40 in chips) 
Seat 6: ardo888 ($127.32 in chips) 
Seat 7: hammerwife ($100 in chips) 
st-germ30: posts small blind $0.50
DUkalisUA: posts big blind $1
oxfordtenzin: sits out 
Effort92: posts the ante $0.20
nobrunobru1: posts the ante $0.20
st-germ30: posts the ante $0.20
DUkalisUA: posts the ante $0.20
matiko09: posts the ante $0.20
ardo888: posts the ante $0.20
hammerwife: posts the ante $0.20
*** HOLE CARDS ***
Dealt to matiko09 [7h Td]
matiko09: folds 
ardo888: folds 
hammerwife: folds 
Effort92: folds 
nobrunobru1: raises $1 to $2
st-germ30: folds 
DUkalisUA: calls $1
*** FLOP *** [Qh Ts Ah]
DUkalisUA: checks 
nobrunobru1: bets $2
DUkalisUA: calls $2
*** TURN *** [Qh Ts Ah] [Ks]
DUkalisUA: checks 
nobrunobru1: bets $3
DUkalisUA: folds 
Uncalled bet ($3) returned to nobrunobru1
nobrunobru1 collected $9.45 from pot
nobrunobru1: doesn't show hand 
*** SUMMARY ***
Total pot $9.90 | Rake $0.45 
Board [Qh Ts Ah Ks]
Seat 1: Effort92 folded before Flop (didn't bet)
Seat 2: nobrunobru1 (button) collected ($9.45)
Seat 3: st-germ30 (small blind) folded before Flop
Seat 4: DUkalisUA (big blind) folded on the Turn
Seat 5: matiko09 folded before Flop (didn't bet)
Seat 6: ardo888 folded before Flop (didn't bet)
Seat 7: hammerwife folded before Flop (didn't bet)





PokerStars Hand #150800060903:  Hold'em No Limit ($0.25/$0.50 USD) - 2016/03/23 13:52:44 CET [2016/03/23 8:52:44 ET]
Table 'Pyrrhus' 9-max Seat #3 is the button
Seat 1: lumen21 ($50 in chips) 
Seat 2: Zeeshka ($50 in chips) 
Seat 3: IvanUrgant ($83.12 in chips) 
Seat 4: GriffinBerg ($11.59 in chips) 
Seat 5: Moszes360 ($50 in chips) 
Seat 6: whalldo ($165.12 in chips) 
Seat 7: matiko09 ($131.02 in chips) 
Seat 8: dndngod ($60.23 in chips) 
Seat 9: CvMCvMCvM ($113.11 in chips) 
GriffinBerg: posts small blind $0.25
Moszes360: posts big blind $0.50
*** HOLE CARDS ***
Dealt to matiko09 [Qd 3h]
whalldo: folds 
matiko09: folds 
dndngod: folds 
CvMCvMCvM: folds 
lumen21: folds 
Zeeshka: raises $1 to $1.50
IvanUrgant: folds 
GriffinBerg: folds 
Moszes360: raises $3.50 to $5
Zeeshka: raises $6 to $11
Moszes360: raises $39 to $50 and is all-in
Zeeshka: folds 
Uncalled bet ($39) returned to Moszes360
Moszes360 collected $22.25 from pot
Moszes360: doesn't show hand 
*** SUMMARY ***
Total pot $22.25 | Rake $0 
Seat 1: lumen21 folded before Flop (didn't bet)
Seat 2: Zeeshka folded before Flop
Seat 3: IvanUrgant (button) folded before Flop (didn't bet)
Seat 4: GriffinBerg (small blind) folded before Flop
Seat 5: Moszes360 (big blind) collected ($22.25)
Seat 6: whalldo folded before Flop (didn't bet)
Seat 7: matiko09 folded before Flop (didn't bet)
Seat 8: dndngod folded before Flop (didn't bet)
Seat 9: CvMCvMCvM folded before Flop (didn't bet)





PokerStars Hand #150800063847:  Hold'em No Limit ($1/$2 USD) - 2016/03/23 13:52:50 CET [2016/03/23 8:52:50 ET]
Table 'Berbericia II' 9-max Seat #4 is the button
Seat 2: Moszes360 ($227.52 in chips) 
Seat 3: Fish4trips ($212.02 in chips) 
Seat 4: bennetb77 ($94.12 in chips) 
Seat 5: darren1031 ($209.47 in chips) 
Seat 6: Charity86 ($181.38 in chips) 
Seat 8: matiko09 ($300.51 in chips) 
darren1031: posts small blind $1
Charity86: posts big blind $2
B@ngel: sits out 
*** HOLE CARDS ***
Dealt to matiko09 [Th 2c]
matiko09: folds 
Moszes360: raises $4 to $6
Fish4trips: folds 
bennetb77: folds 
darren1031: folds 
Charity86: folds 
Uncalled bet ($4) returned to Moszes360
Moszes360 collected $5 from pot
Moszes360: doesn't show hand 
*** SUMMARY ***
Total pot $5 | Rake $0 
Seat 2: Moszes360 collected ($5)
Seat 3: Fish4trips folded before Flop (didn't bet)
Seat 4: bennetb77 (button) folded before Flop (didn't bet)
Seat 5: darren1031 (small blind) folded before Flop
Seat 6: Charity86 (big blind) folded before Flop
Seat 8: matiko09 folded before Flop (didn't bet)





PokerStars Hand #150800065298:  Hold'em No Limit ($1/$2 USD) - 2016/03/23 13:52:52 CET [2016/03/23 8:52:52 ET]
Table 'Kiess' 9-max Seat #5 is the button
Seat 1: Cirilico ($163.56 in chips) 
Seat 2: DUkalisUA ($475.57 in chips) 
Seat 3: The_red_area ($369.82 in chips) 
Seat 4: Moszes360 ($204.77 in chips) 
Seat 5: chippo boy ($326.88 in chips) 
Seat 6: matiko09 ($289.84 in chips) 
Seat 7: InsomniaRU ($276.17 in chips) 
Seat 8: WDW3 ($369.82 in chips) 
Seat 9: Fish4trips ($217.55 in chips) 
matiko09: posts small blind $1
InsomniaRU: posts big blind $2
*** HOLE CARDS ***
Dealt to matiko09 [6h 3d]
WDW3: folds 
Fish4trips: folds 
Cirilico: folds 
DUkalisUA: folds 
The_red_area: raises $4 to $6
Moszes360: folds 
chippo boy: calls $6
matiko09: folds 
InsomniaRU: folds 
*** FLOP *** [Ad 4c Ac]
The_red_area: bets $14.32
chippo boy: folds 
Uncalled bet ($14.32) returned to The_red_area
The_red_area collected $14.32 from pot
The_red_area: doesn't show hand 
*** SUMMARY ***
Total pot $15 | Rake $0.68 
Board [Ad 4c Ac]
Seat 1: Cirilico folded before Flop (didn't bet)
Seat 2: DUkalisUA folded before Flop (didn't bet)
Seat 3: The_red_area collected ($14.32)
Seat 4: Moszes360 folded before Flop (didn't bet)
Seat 5: chippo boy (button) folded on the Flop
Seat 6: matiko09 (small blind) folded before Flop
Seat 7: InsomniaRU (big blind) folded before Flop
Seat 8: WDW3 folded before Flop (didn't bet)
Seat 9: Fish4trips folded before Flop (didn't bet)





PokerStars Hand #150800065189:  Hold'em No Limit ($0.25/$0.50 USD) - 2016/03/23 13:52:52 CET [2016/03/23 8:52:52 ET]
Table 'Belnika' 9-max Seat #8 is the button
Seat 1: yellowfever0 ($24.56 in chips) 
Seat 2: NeverRegret7 ($51.99 in chips) 
Seat 3: ChiChioChi ($78.15 in chips) 
Seat 4: matiko09 ($66.10 in chips) 
Seat 5: IvanUrgant ($50 in chips) 
Seat 6: Ahangama ($56.75 in chips) 
Seat 7: Zeeshka ($50 in chips) 
Seat 8: lumen21 ($61.16 in chips) 
Seat 9: dndngod ($61.41 in chips) 
dndngod: posts small blind $0.25
yellowfever0: posts big blind $0.50
*** HOLE CARDS ***
Dealt to matiko09 [Kh 7c]
NeverRegret7: folds 
ChiChioChi: folds 
matiko09: folds 
IvanUrgant: folds 
Ahangama: folds 
Zeeshka: folds 
lumen21: raises $0.62 to $1.12
dndngod: folds 
yellowfever0: calls $0.62
*** FLOP *** [6d 9d 4d]
yellowfever0: bets $1.19
lumen21: raises $3.81 to $5
yellowfever0: calls $3.81
*** TURN *** [6d 9d 4d] [Kc]
yellowfever0: checks 
lumen21: bets $7
yellowfever0: folds 
Uncalled bet ($7) returned to lumen21
lumen21 collected $11.93 from pot
lumen21: doesn't show hand 
*** SUMMARY ***
Total pot $12.49 | Rake $0.56 
Board [6d 9d 4d Kc]
Seat 1: yellowfever0 (big blind) folded on the Turn
Seat 2: NeverRegret7 folded before Flop (didn't bet)
Seat 3: ChiChioChi folded before Flop (didn't bet)
Seat 4: matiko09 folded before Flop (didn't bet)
Seat 5: IvanUrgant folded before Flop (didn't bet)
Seat 6: Ahangama folded before Flop (didn't bet)
Seat 7: Zeeshka folded before Flop (didn't bet)
Seat 8: lumen21 (button) collected ($11.93)
Seat 9: dndngod (small blind) folded before Flop





PokerStars Hand #150800065654:  Hold'em No Limit ($0.50/$1.00 USD) - 2016/03/23 13:52:53 CET [2016/03/23 8:52:53 ET]
Table 'Smiley' 9-max Seat #8 is the button
Seat 2: Jimy Tiltman ($100 in chips) 
Seat 3: matiko09 ($101.98 in chips) 
Seat 4: Zeeshka ($146.92 in chips) 
Seat 5: DUkalisUA ($204.70 in chips) 
Seat 6: blackmont111 ($124.67 in chips) 
Seat 7: Moszes360 ($100 in chips) 
Seat 8: RICKA16 ($100 in chips) 
Seat 9: morosun ($19.36 in chips) 
morosun: posts small blind $0.50
WDW3: is sitting out 
WDW3 leaves the table
Jimy Tiltman: posts big blind $1
*** HOLE CARDS ***
Dealt to matiko09 [Jc Tc]
myatiy 96 joins the table at seat #1 
myatiy 96 leaves the table
matiko09: raises $2 to $3
xHourglass joins the table at seat #1 
Zeeshka: folds 
DUkalisUA: folds 
blackmont111: folds 
Moszes360: folds 
RICKA16: folds 
morosun: folds 
Jimy Tiltman: folds 
Uncalled bet ($2) returned to matiko09
matiko09 collected $2.50 from pot
matiko09: doesn't show hand 
*** SUMMARY ***
Total pot $2.50 | Rake $0 
Seat 2: Jimy Tiltman (big blind) folded before Flop
Seat 3: matiko09 collected ($2.50)
Seat 4: Zeeshka folded before Flop (didn't bet)
Seat 5: DUkalisUA folded before Flop (didn't bet)
Seat 6: blackmont111 folded before Flop (didn't bet)
Seat 7: Moszes360 folded before Flop (didn't bet)
Seat 8: RICKA16 (button) folded before Flop (didn't bet)
Seat 9: morosun (small blind) folded before Flop





PokerStars Hand #150800068932:  Hold'em No Limit ($0.50/$1.00 USD) - 2016/03/23 13:52:59 CET [2016/03/23 8:52:59 ET]
Table 'Atlantis' 9-max Seat #4 is the button
Seat 1: xHourglass ($157.28 in chips) 
Seat 2: tffff2006 ($44.42 in chips) 
Seat 3: CAJUN890 ($114.29 in chips) 
Seat 4: matiko09 ($121.45 in chips) 
Seat 5: Pvsx. ($100 in chips) 
Seat 6: Jimy Tiltman ($133.81 in chips) 
Seat 7: Zeeshka ($106.32 in chips) 
Seat 8: DUkalisUA ($100 in chips) 
Seat 9: WDW3 ($130.56 in chips) 
Pvsx.: posts small blind $0.50
Jimy Tiltman: posts big blind $1
*** HOLE CARDS ***
Dealt to matiko09 [Jc 9s]
Zeeshka: raises $2 to $3
DUkalisUA: folds 
WDW3: folds 
xHourglass: folds 
tffff2006: folds 
CAJUN890: folds 
matiko09: folds 
Pvsx.: folds 
Jimy Tiltman: folds 
Uncalled bet ($2) returned to Zeeshka
Zeeshka collected $2.50 from pot
Zeeshka: doesn't show hand 
*** SUMMARY ***
Total pot $2.50 | Rake $0 
Seat 1: xHourglass folded before Flop (didn't bet)
Seat 2: tffff2006 folded before Flop (didn't bet)
Seat 3: CAJUN890 folded before Flop (didn't bet)
Seat 4: matiko09 (button) folded before Flop (didn't bet)
Seat 5: Pvsx. (small blind) folded before Flop
Seat 6: Jimy Tiltman (big blind) folded before Flop
Seat 7: Zeeshka collected ($2.50)
Seat 8: DUkalisUA folded before Flop (didn't bet)
Seat 9: WDW3 folded before Flop (didn't bet)





PokerStars Hand #150800069619:  Hold'em No Limit ($0.50/$1.00 USD) - 2016/03/23 13:53:00 CET [2016/03/23 8:53:00 ET]
Table 'Merope II' 9-max Seat #5 is the button
Seat 1: Jimy Tiltman ($108.71 in chips) 
Seat 2: Zeeshka ($100 in chips) 
Seat 3: Sherlockplay ($100 in chips) 
Seat 4: YuriiSolodya ($30.50 in chips) 
Seat 5: DUkalisUA ($105.10 in chips) 
Seat 6: rebelTC ($89.78 in chips) 
Seat 7: matiko09 ($101.50 in chips) 
Seat 8: titentei ($96.50 in chips) 
Seat 9: RICKA16 ($100 in chips) 
rebelTC: posts small blind $0.50
matiko09: posts big blind $1
*** HOLE CARDS ***
Dealt to matiko09 [2s 7c]
titentei: folds 
RICKA16: folds 
Jimy Tiltman: folds 
Zeeshka: folds 
Sherlockplay: folds 
YuriiSolodya: folds 
DUkalisUA: folds 
rebelTC: calls $0.50
matiko09: checks 
*** FLOP *** [Qd 5d 9s]
rebelTC: checks 
matiko09: checks 
*** TURN *** [Qd 5d 9s] [6s]
rebelTC: bets $1.91
matiko09: folds 
Uncalled bet ($1.91) returned to rebelTC
rebelTC collected $1.91 from pot
rebelTC: doesn't show hand 
*** SUMMARY ***
Total pot $2 | Rake $0.09 
Board [Qd 5d 9s 6s]
Seat 1: Jimy Tiltman folded before Flop (didn't bet)
Seat 2: Zeeshka folded before Flop (didn't bet)
Seat 3: Sherlockplay folded before Flop (didn't bet)
Seat 4: YuriiSolodya folded before Flop (didn't bet)
Seat 5: DUkalisUA (button) folded before Flop (didn't bet)
Seat 6: rebelTC (small blind) collected ($1.91)
Seat 7: matiko09 (big blind) folded on the Turn
Seat 8: titentei folded before Flop (didn't bet)
Seat 9: RICKA16 folded before Flop (didn't bet)





PokerStars Hand #150800070624:  Hold'em No Limit ($1/$2 USD) - 2016/03/23 13:53:02 CET [2016/03/23 8:53:02 ET]
Table 'Herba II' 9-max Seat #3 is the button
Seat 1: matiko09 ($221.48 in chips) 
Seat 2: Moszes360 ($201.20 in chips) 
Seat 3: Cirilico ($160 in chips) 
Seat 4: DUkalisUA ($284.78 in chips) 
Seat 5: chippo boy ($211.04 in chips) 
Seat 6: WDW3 ($216.38 in chips) 
Seat 7: InsomniaRU ($213.42 in chips) 
Seat 8: The_red_area ($460.98 in chips) 
Seat 9: mrhighryza ($62.23 in chips) 
DUkalisUA: posts small blind $1
chippo boy: posts big blind $2
*** HOLE CARDS ***
Dealt to matiko09 [As 4d]
WDW3: folds 
InsomniaRU: folds 
The_red_area: folds 
mrhighryza: folds 
matiko09: folds 
Moszes360: raises $4 to $6
Cirilico: folds 
DUkalisUA: calls $5
chippo boy: calls $4
*** FLOP *** [2c 2s Td]
DUkalisUA: bets $9
chippo boy: calls $9
Moszes360: folds 
*** TURN *** [2c 2s Td] [8d]
DUkalisUA: bets $20
chippo boy: folds 
Uncalled bet ($20) returned to DUkalisUA
DUkalisUA collected $34.38 from pot
DUkalisUA: doesn't show hand 
*** SUMMARY ***
Total pot $36 | Rake $1.62 
Board [2c 2s Td 8d]
Seat 1: matiko09 folded before Flop (didn't bet)
Seat 2: Moszes360 folded on the Flop
Seat 3: Cirilico (button) folded before Flop (didn't bet)
Seat 4: DUkalisUA (small blind) collected ($34.38)
Seat 5: chippo boy (big blind) folded on the Turn
Seat 6: WDW3 folded before Flop (didn't bet)
Seat 7: InsomniaRU folded before Flop (didn't bet)
Seat 8: The_red_area folded before Flop (didn't bet)
Seat 9: mrhighryza folded before Flop (didn't bet)





PokerStars Hand #150800074232:  Hold'em No Limit ($1/$2 USD) - 2016/03/23 13:53:08 CET [2016/03/23 8:53:08 ET]
Table 'Berbericia II' 9-max Seat #5 is the button
Seat 2: Moszes360 ($230.52 in chips) 
Seat 3: Fish4trips ($212.02 in chips) 
Seat 4: bennetb77 ($94.12 in chips) 
Seat 5: darren1031 ($208.47 in chips) 
Seat 6: Charity86 ($179.38 in chips) 
Seat 8: matiko09 ($300.51 in chips) 
Charity86: posts small blind $1
matiko09: posts big blind $2
B@ngel: sits out 
*** HOLE CARDS ***
Dealt to matiko09 [4s 2s]
daniferdoser joins the table at seat #1 
Moszes360: folds 
Fish4trips: folds 
bennetb77: raises $2 to $4
darren1031: folds 
Charity86: calls $3
matiko09: folds 
*** FLOP *** [Ts 7d Qc]
Charity86: checks 
bennetb77: bets $5
Charity86: calls $5
*** TURN *** [Ts 7d Qc] [4h]
Charity86: checks 
bennetb77: bets $9.74
Charity86: folds 
Uncalled bet ($9.74) returned to bennetb77
bennetb77 collected $19.10 from pot
bennetb77: doesn't show hand 
*** SUMMARY ***
Total pot $20 | Rake $0.90 
Board [Ts 7d Qc 4h]
Seat 2: Moszes360 folded before Flop (didn't bet)
Seat 3: Fish4trips folded before Flop (didn't bet)
Seat 4: bennetb77 collected ($19.10)
Seat 5: darren1031 (button) folded before Flop (didn't bet)
Seat 6: Charity86 (small blind) folded on the Turn
Seat 8: matiko09 (big blind) folded before Flop





PokerStars Hand #150800083255:  Hold'em No Limit ($0.50/$1.00 USD) - 2016/03/23 13:53:24 CET [2016/03/23 8:53:24 ET]
Table 'Smiley' 9-max Seat #9 is the button
Seat 2: Jimy Tiltman ($100 in chips) 
Seat 3: matiko09 ($103.48 in chips) 
Seat 4: Zeeshka ($146.92 in chips) 
Seat 5: DUkalisUA ($204.70 in chips) 
Seat 6: blackmont111 ($124.67 in chips) 
Seat 7: Moszes360 ($100 in chips) 
Seat 8: RICKA16 ($100 in chips) 
Seat 9: morosun ($18.86 in chips) 
xHourglass will be allowed to play after the button
Jimy Tiltman: posts small blind $0.50
matiko09: posts big blind $1
*** HOLE CARDS ***
Dealt to matiko09 [8d 8s]
Zeeshka: folds 
DUkalisUA: raises $2 to $3
blackmont111: folds 
Moszes360: folds 
RICKA16: calls $3
morosun: calls $3
Jimy Tiltman: folds 
matiko09: calls $2
*** FLOP *** [6h 7c Qh]
matiko09: checks 
DUkalisUA: bets $8
RICKA16: calls $8
morosun: raises $7.86 to $15.86 and is all-in
matiko09: folds 
DUkalisUA: folds 
RICKA16: calls $7.86
*** TURN *** [6h 7c Qh] [9h]
*** RIVER *** [6h 7c Qh 9h] [7s]
*** SHOW DOWN ***
RICKA16: shows [Kd Ks] (two pair, Kings and Sevens)
morosun: shows [2c 5c] (a pair of Sevens)
RICKA16 collected $49.87 from pot
*** SUMMARY ***
Total pot $52.22 | Rake $2.35 
Board [6h 7c Qh 9h 7s]
Seat 2: Jimy Tiltman (small blind) folded before Flop
Seat 3: matiko09 (big blind) folded on the Flop
Seat 4: Zeeshka folded before Flop (didn't bet)
Seat 5: DUkalisUA folded on the Flop
Seat 6: blackmont111 folded before Flop (didn't bet)
Seat 7: Moszes360 folded before Flop (didn't bet)
Seat 8: RICKA16 showed [Kd Ks] and won ($49.87) with two pair, Kings and Sevens
Seat 9: morosun (button) showed [2c 5c] and lost with a pair of Sevens





PokerStars Hand #150800083070:  Hold'em No Limit ($1/$2 USD) - 2016/03/23 13:53:24 CET [2016/03/23 8:53:24 ET]
Table 'Kiess' 9-max Seat #6 is the button
Seat 1: Cirilico ($163.56 in chips) 
Seat 2: DUkalisUA ($475.57 in chips) 
Seat 3: The_red_area ($378.14 in chips) 
Seat 4: Moszes360 ($204.77 in chips) 
Seat 5: chippo boy ($320.88 in chips) 
Seat 6: matiko09 ($288.84 in chips) 
Seat 7: InsomniaRU ($274.17 in chips) 
Seat 9: Fish4trips ($217.55 in chips) 
InsomniaRU: posts small blind $1
WDW3: is sitting out 
WDW3 leaves the table
Fish4trips: posts big blind $2
*** HOLE CARDS ***
Dealt to matiko09 [8s 3c]
Cirilico: folds 
DUkalisUA: folds 
The_red_area: folds 
Moszes360: raises $4 to $6
chippo boy: folds 
matiko09: folds 
InsomniaRU: folds 
Fish4trips: folds 
Uncalled bet ($4) returned to Moszes360
Moszes360 collected $5 from pot
Moszes360: doesn't show hand 
*** SUMMARY ***
Total pot $5 | Rake $0 
Seat 1: Cirilico folded before Flop (didn't bet)
Seat 2: DUkalisUA folded before Flop (didn't bet)
Seat 3: The_red_area folded before Flop (didn't bet)
Seat 4: Moszes360 collected ($5)
Seat 5: chippo boy folded before Flop (didn't bet)
Seat 6: matiko09 (button) folded before Flop (didn't bet)
Seat 7: InsomniaRU (small blind) folded before Flop
Seat 9: Fish4trips (big blind) folded before Flop





PokerStars Hand #150800088332:  Hold'em No Limit ($0.25/$0.50 USD) - 2016/03/23 13:53:33 CET [2016/03/23 8:53:33 ET]
Table 'Pyrrhus' 9-max Seat #4 is the button
Seat 1: lumen21 ($50 in chips) 
Seat 2: Zeeshka ($50 in chips) 
Seat 3: IvanUrgant ($83.12 in chips) 
Seat 4: GriffinBerg ($11.34 in chips) 
Seat 5: Moszes360 ($61.25 in chips) 
Seat 6: whalldo ($165.12 in chips) 
Seat 7: matiko09 ($131.02 in chips) 
Seat 8: dndngod ($60.23 in chips) 
Seat 9: CvMCvMCvM ($113.11 in chips) 
Moszes360: posts small blind $0.25
whalldo: posts big blind $0.50
*** HOLE CARDS ***
Dealt to matiko09 [9d 4s]
matiko09: folds 
dndngod: folds 
CvMCvMCvM: folds 
lumen21: folds 
Zeeshka: folds 
IvanUrgant: folds 
GriffinBerg: folds 
Moszes360: folds 
Uncalled bet ($0.25) returned to whalldo
whalldo collected $0.50 from pot
whalldo: doesn't show hand 
*** SUMMARY ***
Total pot $0.50 | Rake $0 
Seat 1: lumen21 folded before Flop (didn't bet)
Seat 2: Zeeshka folded before Flop (didn't bet)
Seat 3: IvanUrgant folded before Flop (didn't bet)
Seat 4: GriffinBerg (button) folded before Flop (didn't bet)
Seat 5: Moszes360 (small blind) folded before Flop
Seat 6: whalldo (big blind) collected ($0.50)
Seat 7: matiko09 folded before Flop (didn't bet)
Seat 8: dndngod folded before Flop (didn't bet)
Seat 9: CvMCvMCvM folded before Flop (didn't bet)





PokerStars Hand #150800090201:  Hold'em No Limit (€0.25/€0.50 EUR) - 2016/03/23 13:53:36 CET [2016/03/23 8:53:36 ET]
Table 'Hesperia II' 9-max Seat #8 is the button
Seat 1: CAJUN890 (€55.83 in chips) 
Seat 2: dndngod (€54.89 in chips) 
Seat 3: IvanUrgant (€57.05 in chips) 
Seat 4: Zelenis (€21.15 in chips) 
Seat 5: Avrora-sp (€52 in chips) 
Seat 6: CvMCvMCvM (€50 in chips) 
Seat 7: matiko09 (€60.23 in chips) 
Seat 8: Ahangama (€50 in chips) 
Seat 9: Red_Warning (€50 in chips) 
Red_Warning: posts small blind €0.25
CAJUN890: posts big blind €0.50
*** HOLE CARDS ***
Dealt to matiko09 [9s 8c]
dndngod: folds 
IvanUrgant: raises €1 to €1.50
Zelenis: folds 
Avrora-sp: folds 
CvMCvMCvM: folds 
matiko09: folds 
Ahangama: folds 
Red_Warning: folds 
CAJUN890: folds 
Uncalled bet (€1) returned to IvanUrgant
IvanUrgant collected €1.25 from pot
IvanUrgant: doesn't show hand 
*** SUMMARY ***
Total pot €1.25 | Rake €0 
Seat 1: CAJUN890 (big blind) folded before Flop
Seat 2: dndngod folded before Flop (didn't bet)
Seat 3: IvanUrgant collected (€1.25)
Seat 4: Zelenis folded before Flop (didn't bet)
Seat 5: Avrora-sp folded before Flop (didn't bet)
Seat 6: CvMCvMCvM folded before Flop (didn't bet)
Seat 7: matiko09 folded before Flop (didn't bet)
Seat 8: Ahangama (button) folded before Flop (didn't bet)
Seat 9: Red_Warning (small blind) folded before Flop





PokerStars Hand #150800091473:  Hold'em No Limit ($1/$2 USD) - 2016/03/23 13:53:39 CET [2016/03/23 8:53:39 ET]
Table 'Kypria II' 9-max Seat #5 is the button
Seat 1: geldwolfje ($152.66 in chips) 
Seat 2: coinflip_si ($200 in chips) 
Seat 3: seouljam ($202.73 in chips) 
Seat 4: nailz83 ($63.14 in chips) 
Seat 5: InsomniaRU ($372.62 in chips) 
Seat 6: matiko09 ($286.69 in chips) 
Seat 7: DUkalisUA ($200 in chips) 
Seat 8: Fish4trips ($340.79 in chips) 
Seat 9: WDW3 ($205.19 in chips) 
matiko09: posts small blind $1
DUkalisUA: posts big blind $2
*** HOLE CARDS ***
Dealt to matiko09 [Qs Jc]
Fish4trips: folds 
WDW3: folds 
geldwolfje: folds 
coinflip_si: folds 
seouljam: folds 
nailz83: raises $4 to $6
InsomniaRU: folds 
matiko09: folds 
DUkalisUA: folds 
Uncalled bet ($4) returned to nailz83
nailz83 collected $5 from pot
nailz83: doesn't show hand 
*** SUMMARY ***
Total pot $5 | Rake $0 
Seat 1: geldwolfje folded before Flop (didn't bet)
Seat 2: coinflip_si folded before Flop (didn't bet)
Seat 3: seouljam folded before Flop (didn't bet)
Seat 4: nailz83 collected ($5)
Seat 5: InsomniaRU (button) folded before Flop (didn't bet)
Seat 6: matiko09 (small blind) folded before Flop
Seat 7: DUkalisUA (big blind) folded before Flop
Seat 8: Fish4trips folded before Flop (didn't bet)
Seat 9: WDW3 folded before Flop (didn't bet)





PokerStars Hand #150800092143:  Hold'em No Limit ($0.50/$1.00 USD) - 2016/03/23 13:53:40 CET [2016/03/23 8:53:40 ET]
Table 'Atlantis' 9-max Seat #5 is the button
Seat 1: xHourglass ($157.28 in chips) 
Seat 2: tffff2006 ($44.42 in chips) 
Seat 3: CAJUN890 ($114.29 in chips) 
Seat 4: matiko09 ($121.45 in chips) 
Seat 5: Pvsx. ($100 in chips) 
Seat 6: Jimy Tiltman ($132.81 in chips) 
Seat 7: Zeeshka ($107.82 in chips) 
Seat 8: DUkalisUA ($100 in chips) 
Seat 9: WDW3 ($130.56 in chips) 
Jimy Tiltman: posts small blind $0.50
Zeeshka: posts big blind $1
*** HOLE CARDS ***
Dealt to matiko09 [7h 5d]
DUkalisUA: folds 
WDW3: folds 
xHourglass: folds 
tffff2006: raises $2 to $3
CAJUN890: folds 
matiko09: folds 
Pvsx.: folds 
Jimy Tiltman: folds 
Zeeshka: folds 
Uncalled bet ($2) returned to tffff2006
tffff2006 collected $2.50 from pot
*** SUMMARY ***
Total pot $2.50 | Rake $0 
Seat 1: xHourglass folded before Flop (didn't bet)
Seat 2: tffff2006 collected ($2.50)
Seat 3: CAJUN890 folded before Flop (didn't bet)
Seat 4: matiko09 folded before Flop (didn't bet)
Seat 5: Pvsx. (button) folded before Flop (didn't bet)
Seat 6: Jimy Tiltman (small blind) folded before Flop
Seat 7: Zeeshka (big blind) folded before Flop
Seat 8: DUkalisUA folded before Flop (didn't bet)
Seat 9: WDW3 folded before Flop (didn't bet)





PokerStars Hand #150800096445:  Hold'em No Limit ($0.50/$1.00 USD) - 2016/03/23 13:53:47 CET [2016/03/23 8:53:47 ET]
Table 'Merope II' 9-max Seat #6 is the button
Seat 1: Jimy Tiltman ($108.71 in chips) 
Seat 2: Zeeshka ($100 in chips) 
Seat 3: Sherlockplay ($100 in chips) 
Seat 4: YuriiSolodya ($30.50 in chips) 
Seat 5: DUkalisUA ($105.10 in chips) 
Seat 6: rebelTC ($90.69 in chips) 
Seat 7: matiko09 ($100.50 in chips) 
Seat 8: titentei ($96.50 in chips) 
Seat 9: RICKA16 ($100 in chips) 
matiko09: posts small blind $0.50
titentei: posts big blind $1
*** HOLE CARDS ***
Dealt to matiko09 [9h Js]
RICKA16: folds 
Jimy Tiltman: folds 
Zeeshka: folds 
Sherlockplay: raises $1.50 to $2.50
YuriiSolodya: folds 
DUkalisUA: raises $6 to $8.50
rebelTC: folds 
matiko09: folds 
titentei: folds 
Sherlockplay: raises $11 to $19.50
DUkalisUA: folds 
Uncalled bet ($11) returned to Sherlockplay
Sherlockplay collected $18.50 from pot
Sherlockplay: doesn't show hand 
*** SUMMARY ***
Total pot $18.50 | Rake $0 
Seat 1: Jimy Tiltman folded before Flop (didn't bet)
Seat 2: Zeeshka folded before Flop (didn't bet)
Seat 3: Sherlockplay collected ($18.50)
Seat 4: YuriiSolodya folded before Flop (didn't bet)
Seat 5: DUkalisUA folded before Flop
Seat 6: rebelTC (button) folded before Flop (didn't bet)
Seat 7: matiko09 (small blind) folded before Flop
Seat 8: titentei (big blind) folded before Flop
Seat 9: RICKA16 folded before Flop (didn't bet)





PokerStars Hand #150800096577:  Hold'em No Limit ($0.50/$1.00 USD) - 2016/03/23 13:53:48 CET [2016/03/23 8:53:48 ET]
Table 'Oljato' 9-max Seat #1 is the button
Seat 1: xHourglass ($121.07 in chips) 
Seat 3: DUkalisUA ($100 in chips) 
Seat 4: Pvsx. ($137.57 in chips) 
Seat 6: WDW3 ($114.58 in chips) 
Seat 7: matiko09 ($154.09 in chips) 
Seat 8: Zeeshka ($403.29 in chips) 
Seat 9: Jimy Tiltman ($108.12 in chips) 
DUkalisUA: posts small blind $0.50
Pvsx.: posts big blind $1
lumen21: sits out 
*** HOLE CARDS ***
Dealt to matiko09 [Jd Ts]
WDW3: raises $1.80 to $2.80
CAJUN890 joins the table at seat #2 
matiko09: folds 
Zeeshka: folds 
Jimy Tiltman: raises $6.20 to $9
xHourglass: folds 
DUkalisUA: folds 
Pvsx.: folds 
WDW3: folds 
Uncalled bet ($6.20) returned to Jimy Tiltman
Jimy Tiltman collected $7.10 from pot
Jimy Tiltman: doesn't show hand 
*** SUMMARY ***
Total pot $7.10 | Rake $0 
Seat 1: xHourglass (button) folded before Flop (didn't bet)
Seat 3: DUkalisUA (small blind) folded before Flop
Seat 4: Pvsx. (big blind) folded before Flop
Seat 6: WDW3 folded before Flop
Seat 7: matiko09 folded before Flop (didn't bet)
Seat 8: Zeeshka folded before Flop (didn't bet)
Seat 9: Jimy Tiltman collected ($7.10)





PokerStars Hand #150800101263:  Hold'em No Limit ($1/$2 USD) - 2016/03/23 13:53:56 CET [2016/03/23 8:53:56 ET]
Table 'Herba II' 9-max Seat #4 is the button
Seat 1: matiko09 ($221.48 in chips) 
Seat 2: Moszes360 ($200 in chips) 
Seat 3: Cirilico ($160 in chips) 
Seat 4: DUkalisUA ($304.16 in chips) 
Seat 5: chippo boy ($196.04 in chips) 
Seat 7: InsomniaRU ($213.42 in chips) 
Seat 8: The_red_area ($460.98 in chips) 
Seat 9: mrhighryza ($62.23 in chips) 
chippo boy: posts small blind $1
WDW3: is sitting out 
WDW3 leaves the table
InsomniaRU: posts big blind $2
*** HOLE CARDS ***
Dealt to matiko09 [Jc Qs]
The_red_area: folds 
mrhighryza: folds 
Fish4trips joins the table at seat #6 
matiko09: folds 
Moszes360: folds 
Cirilico: folds 
DUkalisUA: folds 
chippo boy: calls $1
InsomniaRU: checks 
*** FLOP *** [6s 8c Kh]
chippo boy: checks 
InsomniaRU: checks 
*** TURN *** [6s 8c Kh] [2h]
chippo boy: checks 
InsomniaRU: checks 
*** RIVER *** [6s 8c Kh 2h] [6c]
chippo boy: bets $2
InsomniaRU: folds 
Uncalled bet ($2) returned to chippo boy
chippo boy collected $3.82 from pot
*** SUMMARY ***
Total pot $4 | Rake $0.18 
Board [6s 8c Kh 2h 6c]
Seat 1: matiko09 folded before Flop (didn't bet)
Seat 2: Moszes360 folded before Flop (didn't bet)
Seat 3: Cirilico folded before Flop (didn't bet)
Seat 4: DUkalisUA (button) folded before Flop (didn't bet)
Seat 5: chippo boy (small blind) collected ($3.82)
Seat 7: InsomniaRU (big blind) folded on the River
Seat 8: The_red_area folded before Flop (didn't bet)
Seat 9: mrhighryza folded before Flop (didn't bet)





PokerStars Hand #150800101896:  Hold'em No Limit ($1/$2 USD) - 2016/03/23 13:53:57 CET [2016/03/23 8:53:57 ET]
Table 'Kiess' 9-max Seat #7 is the button
Seat 1: Cirilico ($163.56 in chips) 
Seat 2: DUkalisUA ($475.57 in chips) 
Seat 3: The_red_area ($378.14 in chips) 
Seat 4: Moszes360 ($207.77 in chips) 
Seat 5: chippo boy ($320.88 in chips) 
Seat 6: matiko09 ($288.84 in chips) 
Seat 7: InsomniaRU ($273.17 in chips) 
Seat 9: Fish4trips ($215.55 in chips) 
Fish4trips: posts small blind $1
Cirilico: posts big blind $2
*** HOLE CARDS ***
Dealt to matiko09 [6c Jc]
DUkalisUA: folds 
The_red_area: folds 
Moszes360: folds 
chippo boy: raises $4 to $6
matiko09: folds 
InsomniaRU: folds 
Fish4trips: folds 
myatiy 96 joins the table at seat #8 
myatiy 96 leaves the table
Cirilico: folds 
Uncalled bet ($4) returned to chippo boy
chippo boy collected $5 from pot
*** SUMMARY ***
Total pot $5 | Rake $0 
Seat 1: Cirilico (big blind) folded before Flop
Seat 2: DUkalisUA folded before Flop (didn't bet)
Seat 3: The_red_area folded before Flop (didn't bet)
Seat 4: Moszes360 folded before Flop (didn't bet)
Seat 5: chippo boy collected ($5)
Seat 6: matiko09 folded before Flop (didn't bet)
Seat 7: InsomniaRU (button) folded before Flop (didn't bet)
Seat 9: Fish4trips (small blind) folded before Flop





PokerStars Hand #150800102870:  Hold'em No Limit ($0.50/$1.00 USD) - 2016/03/23 13:53:59 CET [2016/03/23 8:53:59 ET]
Table 'Kippes' 9-max Seat #8 is the button
Seat 1: Pvsx. ($100 in chips) 
Seat 2: RICKA16 ($128.63 in chips) 
Seat 3: CAJUN890 ($126.97 in chips) 
Seat 4: matiko09 ($100 in chips) 
Seat 5: Jimy Tiltman ($118.36 in chips) 
Seat 6: WDW3 ($116.57 in chips) 
Seat 7: lumen21 ($115.02 in chips) 
Seat 8: Zeeshka ($110.30 in chips) 
Seat 9: wang19790906 ($82.42 in chips) 
wang19790906: posts small blind $0.50
Pvsx.: posts big blind $1
*** HOLE CARDS ***
Dealt to matiko09 [2s Kh]
RICKA16: folds 
CAJUN890: folds 
matiko09: folds 
Jimy Tiltman: folds 
WDW3: folds 
lumen21: folds 
Zeeshka: folds 
wang19790906: folds 
Uncalled bet ($0.50) returned to Pvsx.
Pvsx. collected $1 from pot
Pvsx.: doesn't show hand 
*** SUMMARY ***
Total pot $1 | Rake $0 
Seat 1: Pvsx. (big blind) collected ($1)
Seat 2: RICKA16 folded before Flop (didn't bet)
Seat 3: CAJUN890 folded before Flop (didn't bet)
Seat 4: matiko09 folded before Flop (didn't bet)
Seat 5: Jimy Tiltman folded before Flop (didn't bet)
Seat 6: WDW3 folded before Flop (didn't bet)
Seat 7: lumen21 folded before Flop (didn't bet)
Seat 8: Zeeshka (button) folded before Flop (didn't bet)
Seat 9: wang19790906 (small blind) folded before Flop





PokerStars Hand #150800102618:  Hold'em No Limit ($0.50/$1.00 USD) - 2016/03/23 13:53:59 CET [2016/03/23 8:53:59 ET]
Table 'Donar II' 9-max Seat #3 is the button
Seat 1: Effort92 ($100 in chips) 
Seat 2: nobrunobru1 ($82.89 in chips) 
Seat 3: st-germ30 ($92.71 in chips) 
Seat 4: DUkalisUA ($103.80 in chips) 
Seat 5: matiko09 ($101.20 in chips) 
Seat 6: ardo888 ($127.12 in chips) 
Seat 7: hammerwife ($100 in chips) 
DUkalisUA: posts small blind $0.50
matiko09: posts big blind $1
oxfordtenzin: sits out 
Effort92: posts the ante $0.20
nobrunobru1: posts the ante $0.20
st-germ30: posts the ante $0.20
DUkalisUA: posts the ante $0.20
matiko09: posts the ante $0.20
ardo888: posts the ante $0.20
hammerwife: posts the ante $0.20
*** HOLE CARDS ***
Dealt to matiko09 [6c 9d]
ardo888: folds 
hammerwife: folds 
Effort92: folds 
nobrunobru1: folds 
st-germ30: raises $2 to $3
DUkalisUA: raises $6.50 to $9.50
matiko09: folds 
st-germ30: calls $6.50
*** FLOP *** [Jc 5d 7s]
DUkalisUA: checks 
st-germ30: bets $13
DUkalisUA: calls $13
*** TURN *** [Jc 5d 7s] [Qd]
DUkalisUA: checks 
st-germ30: checks 
*** RIVER *** [Jc 5d 7s Qd] [3d]
DUkalisUA: checks 
st-germ30: checks 
*** SHOW DOWN ***
DUkalisUA: shows [Ts Js] (a pair of Jacks)
st-germ30: mucks hand 
DUkalisUA collected $45.27 from pot
*** SUMMARY ***
Total pot $47.40 | Rake $2.13 
Board [Jc 5d 7s Qd 3d]
Seat 1: Effort92 folded before Flop (didn't bet)
Seat 2: nobrunobru1 folded before Flop (didn't bet)
Seat 3: st-germ30 (button) mucked [Ac 3c]
Seat 4: DUkalisUA (small blind) showed [Ts Js] and won ($45.27) with a pair of Jacks
Seat 5: matiko09 (big blind) folded before Flop
Seat 6: ardo888 folded before Flop (didn't bet)
Seat 7: hammerwife folded before Flop (didn't bet)





PokerStars Hand #150800103602:  Hold'em No Limit ($0.25/$0.50 USD) - 2016/03/23 13:54:00 CET [2016/03/23 8:54:00 ET]
Table 'Belnika' 9-max Seat #9 is the button
Seat 1: yellowfever0 ($18.44 in chips) 
Seat 2: NeverRegret7 ($51.99 in chips) 
Seat 3: ChiChioChi ($78.15 in chips) 
Seat 4: matiko09 ($66.10 in chips) 
Seat 5: IvanUrgant ($50 in chips) 
Seat 6: Ahangama ($56.75 in chips) 
Seat 7: Zeeshka ($50 in chips) 
Seat 8: lumen21 ($66.97 in chips) 
Seat 9: dndngod ($61.16 in chips) 
yellowfever0: posts small blind $0.25
NeverRegret7: posts big blind $0.50
*** HOLE CARDS ***
Dealt to matiko09 [5c Jh]
ChiChioChi: calls $0.50
matiko09: folds 
IvanUrgant: folds 
Ahangama: folds 
Zeeshka: folds 
lumen21: folds 
dndngod: folds 
yellowfever0: folds 
NeverRegret7: checks 
*** FLOP *** [4c Ad 6h]
NeverRegret7: checks 
ChiChioChi: checks 
*** TURN *** [4c Ad 6h] [Ks]
NeverRegret7: checks 
ChiChioChi: bets $1.50
NeverRegret7: folds 
Uncalled bet ($1.50) returned to ChiChioChi
ChiChioChi collected $1.19 from pot
ChiChioChi: doesn't show hand 
*** SUMMARY ***
Total pot $1.25 | Rake $0.06 
Board [4c Ad 6h Ks]
Seat 1: yellowfever0 (small blind) folded before Flop
Seat 2: NeverRegret7 (big blind) folded on the Turn
Seat 3: ChiChioChi collected ($1.19)
Seat 4: matiko09 folded before Flop (didn't bet)
Seat 5: IvanUrgant folded before Flop (didn't bet)
Seat 6: Ahangama folded before Flop (didn't bet)
Seat 7: Zeeshka folded before Flop (didn't bet)
Seat 8: lumen21 folded before Flop (didn't bet)
Seat 9: dndngod (button) folded before Flop (didn't bet)





PokerStars Hand #150800107379:  Hold'em No Limit ($1/$2 USD) - 2016/03/23 13:54:07 CET [2016/03/23 8:54:07 ET]
Table 'Berbericia II' 9-max Seat #6 is the button
Seat 2: Moszes360 ($230.52 in chips) 
Seat 3: Fish4trips ($212.02 in chips) 
Seat 4: bennetb77 ($104.22 in chips) 
Seat 5: darren1031 ($208.47 in chips) 
Seat 6: Charity86 ($170.38 in chips) 
Seat 8: matiko09 ($298.51 in chips) 
Seat 9: B@ngel ($200 in chips) 
matiko09: posts small blind $1
B@ngel: posts big blind $2
daniferdoser: sits out 
*** HOLE CARDS ***
Dealt to matiko09 [Js 6h]
Moszes360: folds 
Fish4trips: folds 
bennetb77: folds 
darren1031: calls $2
Charity86: folds 
matiko09: folds 
B@ngel: checks 
*** FLOP *** [2d Ks 6d]
B@ngel: checks 
darren1031: bets $4
B@ngel: calls $4
*** TURN *** [2d Ks 6d] [6s]
B@ngel: checks 
darren1031: bets $8
B@ngel: calls $8
*** RIVER *** [2d Ks 6d 6s] [7s]
B@ngel: checks 
darren1031: checks 
*** SHOW DOWN ***
B@ngel: shows [5d 9d] (a pair of Sixes)
darren1031: shows [Qh 9s] (a pair of Sixes - King+Queen kicker)
darren1031 collected $27.70 from pot
*** SUMMARY ***
Total pot $29 | Rake $1.30 
Board [2d Ks 6d 6s 7s]
Seat 2: Moszes360 folded before Flop (didn't bet)
Seat 3: Fish4trips folded before Flop (didn't bet)
Seat 4: bennetb77 folded before Flop (didn't bet)
Seat 5: darren1031 showed [Qh 9s] and won ($27.70) with a pair of Sixes
Seat 6: Charity86 (button) folded before Flop (didn't bet)
Seat 8: matiko09 (small blind) folded before Flop
Seat 9: B@ngel (big blind) showed [5d 9d] and lost with a pair of Sixes





PokerStars Hand #150800108881:  Hold'em No Limit ($0.25/$0.50 USD) - 2016/03/23 13:54:10 CET [2016/03/23 8:54:10 ET]
Table 'Pyrrhus' 9-max Seat #5 is the button
Seat 1: lumen21 ($50 in chips) 
Seat 2: Zeeshka ($50 in chips) 
Seat 3: IvanUrgant ($83.12 in chips) 
Seat 4: GriffinBerg ($11.34 in chips) 
Seat 5: Moszes360 ($61 in chips) 
Seat 6: whalldo ($165.37 in chips) 
Seat 7: matiko09 ($131.02 in chips) 
Seat 8: dndngod ($60.23 in chips) 
Seat 9: CvMCvMCvM ($113.11 in chips) 
whalldo: posts small blind $0.25
matiko09: posts big blind $0.50
*** HOLE CARDS ***
Dealt to matiko09 [5s 9c]
dndngod: folds 
CvMCvMCvM: raises $0.76 to $1.26
lumen21: folds 
Zeeshka: folds 
IvanUrgant: folds 
GriffinBerg: folds 
Moszes360: folds 
whalldo: folds 
matiko09: folds 
Uncalled bet ($0.76) returned to CvMCvMCvM
CvMCvMCvM collected $1.25 from pot
CvMCvMCvM: doesn't show hand 
*** SUMMARY ***
Total pot $1.25 | Rake $0 
Seat 1: lumen21 folded before Flop (didn't bet)
Seat 2: Zeeshka folded before Flop (didn't bet)
Seat 3: IvanUrgant folded before Flop (didn't bet)
Seat 4: GriffinBerg folded before Flop (didn't bet)
Seat 5: Moszes360 (button) folded before Flop (didn't bet)
Seat 6: whalldo (small blind) folded before Flop
Seat 7: matiko09 (big blind) folded before Flop
Seat 8: dndngod folded before Flop (didn't bet)
Seat 9: CvMCvMCvM collected ($1.25)





PokerStars Hand #150800115652:  Hold'em No Limit (€0.25/€0.50 EUR) - 2016/03/23 13:54:22 CET [2016/03/23 8:54:22 ET]
Table 'Hesperia II' 9-max Seat #9 is the button
Seat 1: CAJUN890 (€55.33 in chips) 
Seat 2: dndngod (€54.89 in chips) 
Seat 3: IvanUrgant (€57.80 in chips) 
Seat 4: Zelenis (€21.15 in chips) 
Seat 5: Avrora-sp (€52 in chips) 
Seat 6: CvMCvMCvM (€50 in chips) 
Seat 7: matiko09 (€60.23 in chips) 
Seat 8: Ahangama (€50 in chips) 
Seat 9: Red_Warning (€50 in chips) 
CAJUN890: posts small blind €0.25
dndngod: posts big blind €0.50
*** HOLE CARDS ***
Dealt to matiko09 [Qh Ad]
IvanUrgant: folds 
Zelenis: folds 
Avrora-sp: raises €1 to €1.50
CvMCvMCvM: folds 
matiko09: calls €1.50
Ahangama: folds 
Red_Warning: folds 
CAJUN890: folds 
dndngod: folds 
*** FLOP *** [4h 8c Th]
Avrora-sp: bets €2.39
matiko09: folds 
Uncalled bet (€2.39) returned to Avrora-sp
Avrora-sp collected €3.58 from pot
Avrora-sp: doesn't show hand 
*** SUMMARY ***
Total pot €3.75 | Rake €0.17 
Board [4h 8c Th]
Seat 1: CAJUN890 (small blind) folded before Flop
Seat 2: dndngod (big blind) folded before Flop
Seat 3: IvanUrgant folded before Flop (didn't bet)
Seat 4: Zelenis folded before Flop (didn't bet)
Seat 5: Avrora-sp collected (€3.58)
Seat 6: CvMCvMCvM folded before Flop (didn't bet)
Seat 7: matiko09 folded on the Flop
Seat 8: Ahangama folded before Flop (didn't bet)
Seat 9: Red_Warning (button) folded before Flop (didn't bet)





PokerStars Hand #150800117888:  Hold'em No Limit ($1/$2 USD) - 2016/03/23 13:54:26 CET [2016/03/23 8:54:26 ET]
Table 'Kypria II' 9-max Seat #6 is the button
Seat 1: geldwolfje ($152.66 in chips) 
Seat 2: coinflip_si ($200 in chips) 
Seat 3: seouljam ($202.73 in chips) 
Seat 4: nailz83 ($66.14 in chips) 
Seat 5: InsomniaRU ($372.62 in chips) 
Seat 6: matiko09 ($285.69 in chips) 
Seat 7: DUkalisUA ($200 in chips) 
Seat 8: Fish4trips ($340.79 in chips) 
Seat 9: WDW3 ($205.19 in chips) 
DUkalisUA: posts small blind $1
Fish4trips: posts big blind $2
*** HOLE CARDS ***
Dealt to matiko09 [8d 5c]
WDW3: raises $3.60 to $5.60
geldwolfje: folds 
coinflip_si: folds 
seouljam: folds 
nailz83: calls $5.60
InsomniaRU: folds 
matiko09: folds 
DUkalisUA: folds 
Fish4trips: calls $3.60
*** FLOP *** [9d 4c 9s]
Fish4trips: checks 
WDW3: bets $9
nailz83: calls $9
Fish4trips: folds 
*** TURN *** [9d 4c 9s] [8c]
WDW3: bets $15
nailz83: calls $15
*** RIVER *** [9d 4c 9s 8c] [2s]
WDW3: bets $45
nailz83: folds 
Uncalled bet ($45) returned to WDW3
WDW3 collected $63 from pot
WDW3: doesn't show hand 
*** SUMMARY ***
Total pot $65.80 | Rake $2.80 
Board [9d 4c 9s 8c 2s]
Seat 1: geldwolfje folded before Flop (didn't bet)
Seat 2: coinflip_si folded before Flop (didn't bet)
Seat 3: seouljam folded before Flop (didn't bet)
Seat 4: nailz83 folded on the River
Seat 5: InsomniaRU folded before Flop (didn't bet)
Seat 6: matiko09 (button) folded before Flop (didn't bet)
Seat 7: DUkalisUA (small blind) folded before Flop
Seat 8: Fish4trips (big blind) folded on the Flop
Seat 9: WDW3 collected ($63)





PokerStars Hand #150800117934:  Hold'em No Limit ($0.50/$1.00 USD) - 2016/03/23 13:54:26 CET [2016/03/23 8:54:26 ET]
Table 'Atlantis' 9-max Seat #6 is the button
Seat 1: xHourglass ($157.28 in chips) 
Seat 2: tffff2006 ($45.92 in chips) 
Seat 3: CAJUN890 ($114.29 in chips) 
Seat 4: matiko09 ($121.45 in chips) 
Seat 5: Pvsx. ($100 in chips) 
Seat 6: Jimy Tiltman ($132.31 in chips) 
Seat 7: Zeeshka ($106.82 in chips) 
Seat 8: DUkalisUA ($100 in chips) 
Seat 9: WDW3 ($130.56 in chips) 
Zeeshka: posts small blind $0.50
DUkalisUA: posts big blind $1
*** HOLE CARDS ***
Dealt to matiko09 [5c Qs]
WDW3: folds 
xHourglass: folds 
tffff2006: folds 
CAJUN890: raises $3 to $4
matiko09: folds 
Pvsx.: folds 
Jimy Tiltman: folds 
Zeeshka: folds 
DUkalisUA: folds 
Uncalled bet ($3) returned to CAJUN890
CAJUN890 collected $2.50 from pot
CAJUN890: doesn't show hand 
*** SUMMARY ***
Total pot $2.50 | Rake $0 
Seat 1: xHourglass folded before Flop (didn't bet)
Seat 2: tffff2006 folded before Flop (didn't bet)
Seat 3: CAJUN890 collected ($2.50)
Seat 4: matiko09 folded before Flop (didn't bet)
Seat 5: Pvsx. folded before Flop (didn't bet)
Seat 6: Jimy Tiltman (button) folded before Flop (didn't bet)
Seat 7: Zeeshka (small blind) folded before Flop
Seat 8: DUkalisUA (big blind) folded before Flop
Seat 9: WDW3 folded before Flop (didn't bet)





PokerStars Hand #150800119208:  Hold'em No Limit ($1/$2 USD) - 2016/03/23 13:54:28 CET [2016/03/23 8:54:28 ET]
Table 'Kiess' 9-max Seat #9 is the button
Seat 1: Cirilico ($161.56 in chips) 
Seat 2: DUkalisUA ($475.57 in chips) 
Seat 3: The_red_area ($378.14 in chips) 
Seat 4: Moszes360 ($207.77 in chips) 
Seat 5: chippo boy ($323.88 in chips) 
Seat 6: matiko09 ($288.84 in chips) 
Seat 7: InsomniaRU ($273.17 in chips) 
Seat 9: Fish4trips ($214.55 in chips) 
Cirilico: posts small blind $1
DUkalisUA: posts big blind $2
*** HOLE CARDS ***
Dealt to matiko09 [Ah 8s]
The_red_area: folds 
Moszes360: folds 
chippo boy: folds 
matiko09: folds 
InsomniaRU: folds 
Fish4trips: raises $2 to $4
Cirilico: folds 
DUkalisUA: calls $2
*** FLOP *** [Qs 5h Td]
DUkalisUA: checks 
Fish4trips: checks 
*** TURN *** [Qs 5h Td] [7d]
DUkalisUA: bets $6.45
Fish4trips: folds 
Uncalled bet ($6.45) returned to DUkalisUA
DUkalisUA collected $8.60 from pot
DUkalisUA: doesn't show hand 
*** SUMMARY ***
Total pot $9 | Rake $0.40 
Board [Qs 5h Td 7d]
Seat 1: Cirilico (small blind) folded before Flop
Seat 2: DUkalisUA (big blind) collected ($8.60)
Seat 3: The_red_area folded before Flop (didn't bet)
Seat 4: Moszes360 folded before Flop (didn't bet)
Seat 5: chippo boy folded before Flop (didn't bet)
Seat 6: matiko09 folded before Flop (didn't bet)
Seat 7: InsomniaRU folded before Flop (didn't bet)
Seat 9: Fish4trips (button) folded on the Turn





PokerStars Hand #150800122634:  Hold'em No Limit ($1/$2 USD) - 2016/03/23 13:54:34 CET [2016/03/23 8:54:34 ET]
Table 'Alma II' 9-max Seat #6 is the button
Seat 1: berggren ($215.15 in chips) 
Seat 2: glanza_mike ($200 in chips) 
Seat 4: daniferdoser ($201.78 in chips) 
Seat 5: dah44 ($208.10 in chips) 
Seat 6: InsomniaRU ($200 in chips) 
Seat 7: cliffdogz ($178 in chips) 
Seat 8: matiko09 ($200 in chips) 
cliffdogz: posts small blind $1
matiko09: posts big blind $2
carflam7: sits out 
*** HOLE CARDS ***
Dealt to matiko09 [Td Jh]
berggren: calls $2
glanza_mike: folds 
daniferdoser: folds 
dah44: folds 
InsomniaRU: folds 
cliffdogz: folds 
matiko09: checks 
*** FLOP *** [Kc Js Qd]
matiko09: checks 
berggren: bets $2
matiko09: calls $2
*** TURN *** [Kc Js Qd] [7s]
matiko09: checks 
berggren: bets $6
matiko09: folds 
Uncalled bet ($6) returned to berggren
berggren collected $8.60 from pot
berggren: doesn't show hand 
*** SUMMARY ***
Total pot $9 | Rake $0.40 
Board [Kc Js Qd 7s]
Seat 1: berggren collected ($8.60)
Seat 2: glanza_mike folded before Flop (didn't bet)
Seat 4: daniferdoser folded before Flop (didn't bet)
Seat 5: dah44 folded before Flop (didn't bet)
Seat 6: InsomniaRU (button) folded before Flop (didn't bet)
Seat 7: cliffdogz (small blind) folded before Flop
Seat 8: matiko09 (big blind) folded on the Turn





PokerStars Hand #150800124778:  Hold'em No Limit ($1/$2 USD) - 2016/03/23 13:54:38 CET [2016/03/23 8:54:38 ET]
Table 'Herba II' 9-max Seat #5 is the button
Seat 1: matiko09 ($221.48 in chips) 
Seat 2: Moszes360 ($200 in chips) 
Seat 3: Cirilico ($160 in chips) 
Seat 4: DUkalisUA ($304.16 in chips) 
Seat 5: chippo boy ($197.86 in chips) 
Seat 7: InsomniaRU ($211.42 in chips) 
Seat 8: The_red_area ($460.98 in chips) 
Seat 9: mrhighryza ($62.23 in chips) 
Fish4trips will be allowed to play after the button
InsomniaRU: posts small blind $1
The_red_area: posts big blind $2
*** HOLE CARDS ***
Dealt to matiko09 [Th Kc]
mrhighryza: folds 
matiko09: folds 
Moszes360: folds 
Cirilico: folds 
DUkalisUA: raises $3 to $5
chippo boy: calls $5
InsomniaRU: folds 
The_red_area: calls $3
*** FLOP *** [Qc 5d 7d]
The_red_area: checks 
DUkalisUA: bets $10.08
chippo boy: calls $10.08
The_red_area: folds 
*** TURN *** [Qc 5d 7d] [Jd]
Fish4trips leaves the table
DUkalisUA: checks 
chippo boy: bets $16
DUkalisUA: folds 
Uncalled bet ($16) returned to chippo boy
chippo boy collected $34.53 from pot
*** SUMMARY ***
Total pot $36.16 | Rake $1.63 
Board [Qc 5d 7d Jd]
Seat 1: matiko09 folded before Flop (didn't bet)
Seat 2: Moszes360 folded before Flop (didn't bet)
Seat 3: Cirilico folded before Flop (didn't bet)
Seat 4: DUkalisUA folded on the Turn
Seat 5: chippo boy (button) collected ($34.53)
Seat 7: InsomniaRU (small blind) folded before Flop
Seat 8: The_red_area (big blind) folded on the Flop
Seat 9: mrhighryza folded before Flop (didn't bet)





PokerStars Hand #150800125262:  Hold'em No Limit ($0.50/$1.00 USD) - 2016/03/23 13:54:38 CET [2016/03/23 8:54:38 ET]
Table 'Oljato' 9-max Seat #3 is the button
Seat 1: xHourglass ($121.07 in chips) 
Seat 3: DUkalisUA ($100 in chips) 
Seat 4: Pvsx. ($136.57 in chips) 
Seat 5: lumen21 ($103.21 in chips) 
Seat 6: WDW3 ($111.78 in chips) 
Seat 7: matiko09 ($154.09 in chips) 
Seat 8: Zeeshka ($403.29 in chips) 
Seat 9: Jimy Tiltman ($112.42 in chips) 
Pvsx.: posts small blind $0.50
lumen21: posts big blind $1
CAJUN890: sits out 
*** HOLE CARDS ***
Dealt to matiko09 [7c 3h]
WDW3: folds 
matiko09: folds 
Zeeshka: folds 
Jimy Tiltman: folds 
xHourglass: folds 
DUkalisUA: folds 
Pvsx.: folds 
Uncalled bet ($0.50) returned to lumen21
lumen21 collected $1 from pot
lumen21: doesn't show hand 
*** SUMMARY ***
Total pot $1 | Rake $0 
Seat 1: xHourglass folded before Flop (didn't bet)
Seat 3: DUkalisUA (button) folded before Flop (didn't bet)
Seat 4: Pvsx. (small blind) folded before Flop
Seat 5: lumen21 (big blind) collected ($1)
Seat 6: WDW3 folded before Flop (didn't bet)
Seat 7: matiko09 folded before Flop (didn't bet)
Seat 8: Zeeshka folded before Flop (didn't bet)
Seat 9: Jimy Tiltman folded before Flop (didn't bet)





PokerStars Hand #150800125995:  Hold'em No Limit ($0.50/$1.00 USD) - 2016/03/23 13:54:40 CET [2016/03/23 8:54:40 ET]
Table 'Smiley' 9-max Seat #2 is the button
Seat 2: Jimy Tiltman ($100 in chips) 
Seat 3: matiko09 ($100.48 in chips) 
Seat 4: Zeeshka ($146.92 in chips) 
Seat 5: DUkalisUA ($193.70 in chips) 
Seat 6: blackmont111 ($124.67 in chips) 
Seat 7: Moszes360 ($100 in chips) 
Seat 8: RICKA16 ($131.01 in chips) 
matiko09: posts small blind $0.50
Zeeshka: posts big blind $1
xHourglass: sits out 
*** HOLE CARDS ***
Dealt to matiko09 [4h 5d]
DUkalisUA: folds 
blackmont111: folds 
Moszes360: folds 
RICKA16: folds 
morosun leaves the table
Jimy Tiltman: folds 
Pvsx. joins the table at seat #9 
matiko09: folds 
Uncalled bet ($0.50) returned to Zeeshka
Zeeshka collected $1 from pot
Zeeshka: doesn't show hand 
*** SUMMARY ***
Total pot $1 | Rake $0 
Seat 2: Jimy Tiltman (button) folded before Flop (didn't bet)
Seat 3: matiko09 (small blind) folded before Flop
Seat 4: Zeeshka (big blind) collected ($1)
Seat 5: DUkalisUA folded before Flop (didn't bet)
Seat 6: blackmont111 folded before Flop (didn't bet)
Seat 7: Moszes360 folded before Flop (didn't bet)
Seat 8: RICKA16 folded before Flop (didn't bet)





PokerStars Hand #150800126553:  Hold'em No Limit ($0.25/$0.50 USD) - 2016/03/23 13:54:41 CET [2016/03/23 8:54:41 ET]
Table 'Pyrrhus' 9-max Seat #6 is the button
Seat 1: lumen21 ($50 in chips) 
Seat 2: Zeeshka ($50 in chips) 
Seat 3: IvanUrgant ($83.12 in chips) 
Seat 4: GriffinBerg ($11.34 in chips) 
Seat 5: Moszes360 ($61 in chips) 
Seat 6: whalldo ($165.12 in chips) 
Seat 7: matiko09 ($130.52 in chips) 
Seat 8: dndngod ($60.23 in chips) 
Seat 9: CvMCvMCvM ($113.86 in chips) 
matiko09: posts small blind $0.25
dndngod: posts big blind $0.50
*** HOLE CARDS ***
Dealt to matiko09 [Qd As]
CvMCvMCvM: folds 
lumen21: folds 
Zeeshka: folds 
IvanUrgant: folds 
GriffinBerg: raises $1 to $1.50
Moszes360: folds 
whalldo: folds 
matiko09: raises $3 to $4.50
dndngod: folds 
GriffinBerg: raises $6.84 to $11.34 and is all-in
matiko09: calls $6.84
*** FLOP *** [8s Ac 2c]
*** TURN *** [8s Ac 2c] [4d]
*** RIVER *** [8s Ac 2c 4d] [Tc]
*** SHOW DOWN ***
matiko09: shows [Qd As] (a pair of Aces)
GriffinBerg: mucks hand 
matiko09 collected $22.14 from pot
*** SUMMARY ***
Total pot $23.18 | Rake $1.04 
Board [8s Ac 2c 4d Tc]
Seat 1: lumen21 folded before Flop (didn't bet)
Seat 2: Zeeshka folded before Flop (didn't bet)
Seat 3: IvanUrgant folded before Flop (didn't bet)
Seat 4: GriffinBerg mucked [Ah 9h]
Seat 5: Moszes360 folded before Flop (didn't bet)
Seat 6: whalldo (button) folded before Flop (didn't bet)
Seat 7: matiko09 (small blind) showed [Qd As] and won ($22.14) with a pair of Aces
Seat 8: dndngod (big blind) folded before Flop
Seat 9: CvMCvMCvM folded before Flop (didn't bet)





PokerStars Hand #150800127308:  Hold'em No Limit ($0.50/$1.00 USD) - 2016/03/23 13:54:42 CET [2016/03/23 8:54:42 ET]
Table 'Merope II' 9-max Seat #7 is the button
Seat 1: Jimy Tiltman ($108.71 in chips) 
Seat 2: Zeeshka ($100 in chips) 
Seat 3: Sherlockplay ($110 in chips) 
Seat 4: YuriiSolodya ($30.50 in chips) 
Seat 5: DUkalisUA ($100 in chips) 
Seat 6: rebelTC ($90.69 in chips) 
Seat 7: matiko09 ($100 in chips) 
Seat 8: titentei ($95.50 in chips) 
Seat 9: RICKA16 ($100 in chips) 
titentei: posts small blind $0.50
RICKA16: posts big blind $1
*** HOLE CARDS ***
Dealt to matiko09 [6c 7s]
Jimy Tiltman: folds 
Zeeshka: folds 
Sherlockplay: raises $1.50 to $2.50
YuriiSolodya: calls $2.50
DUkalisUA: folds 
rebelTC: calls $2.50
matiko09: folds 
titentei: folds 
RICKA16: folds 
*** FLOP *** [Td 5h Ah]
Sherlockplay: bets $5.73
YuriiSolodya: calls $5.73
rebelTC: folds 
*** TURN *** [Td 5h Ah] [9s]
Sherlockplay: bets $16.50
YuriiSolodya: raises $5.77 to $22.27 and is all-in
Sherlockplay: calls $5.77
*** FIRST RIVER *** [Td 5h Ah 9s] [Jc]
*** SECOND RIVER *** [Td 5h Ah 9s] [2s]
*** FIRST SHOW DOWN ***
Sherlockplay: shows [As Kd] (a pair of Aces)
YuriiSolodya: mucks hand 
Sherlockplay collected $31.10 from pot
*** SECOND SHOW DOWN ***
Sherlockplay: shows [As Kd] (a pair of Aces)
YuriiSolodya: mucks hand 
Sherlockplay collected $31.10 from pot
*** SUMMARY ***
Total pot $65 | Rake $2.80 
Hand was run twice
FIRST Board [Td 5h Ah 9s Jc]
SECOND Board [Td 5h Ah 9s 2s]
Seat 1: Jimy Tiltman folded before Flop (didn't bet)
Seat 2: Zeeshka folded before Flop (didn't bet)
Seat 3: Sherlockplay showed [As Kd] and won ($31.10) with a pair of Aces, and won ($31.10) with a pair of Aces
Seat 4: YuriiSolodya mucked [Ac 3c]
Seat 5: DUkalisUA folded before Flop (didn't bet)
Seat 6: rebelTC folded on the Flop
Seat 7: matiko09 (button) folded before Flop (didn't bet)
Seat 8: titentei (small blind) folded before Flop
Seat 9: RICKA16 (big blind) folded before Flop





PokerStars Hand #150800127908:  Hold'em No Limit ($0.50/$1.00 USD) - 2016/03/23 13:54:43 CET [2016/03/23 8:54:43 ET]
Table 'Kippes' 9-max Seat #9 is the button
Seat 1: Pvsx. ($100.50 in chips) 
Seat 2: RICKA16 ($128.63 in chips) 
Seat 3: CAJUN890 ($126.97 in chips) 
Seat 4: matiko09 ($100 in chips) 
Seat 5: Jimy Tiltman ($118.36 in chips) 
Seat 6: WDW3 ($116.57 in chips) 
Seat 7: lumen21 ($115.02 in chips) 
Seat 8: Zeeshka ($110.30 in chips) 
Seat 9: wang19790906 ($81.92 in chips) 
Pvsx.: posts small blind $0.50
RICKA16: posts big blind $1
*** HOLE CARDS ***
Dealt to matiko09 [8h Jd]
CAJUN890: folds 
matiko09: folds 
Jimy Tiltman: folds 
WDW3: folds 
lumen21: folds 
Zeeshka: folds 
wang19790906: folds 
Pvsx.: folds 
Uncalled bet ($0.50) returned to RICKA16
RICKA16 collected $1 from pot
RICKA16: doesn't show hand 
*** SUMMARY ***
Total pot $1 | Rake $0 
Seat 1: Pvsx. (small blind) folded before Flop
Seat 2: RICKA16 (big blind) collected ($1)
Seat 3: CAJUN890 folded before Flop (didn't bet)
Seat 4: matiko09 folded before Flop (didn't bet)
Seat 5: Jimy Tiltman folded before Flop (didn't bet)
Seat 6: WDW3 folded before Flop (didn't bet)
Seat 7: lumen21 folded before Flop (didn't bet)
Seat 8: Zeeshka folded before Flop (didn't bet)
Seat 9: wang19790906 (button) folded before Flop (didn't bet)





PokerStars Hand #150800134458:  Hold'em No Limit ($1/$2 USD) - 2016/03/23 13:54:55 CET [2016/03/23 8:54:55 ET]
Table 'Berbericia II' 9-max Seat #8 is the button
Seat 1: daniferdoser ($200 in chips) 
Seat 2: Moszes360 ($230.52 in chips) 
Seat 3: Fish4trips ($212.02 in chips) 
Seat 4: bennetb77 ($104.22 in chips) 
Seat 5: darren1031 ($222.17 in chips) 
Seat 6: Charity86 ($170.38 in chips) 
Seat 8: matiko09 ($297.51 in chips) 
Seat 9: B@ngel ($186 in chips) 
B@ngel: posts small blind $1
daniferdoser: posts big blind $2
*** HOLE CARDS ***
Dealt to matiko09 [6h Tc]
Moszes360: folds 
Fish4trips: folds 
bennetb77: raises $2 to $4
darren1031: calls $4
Charity86: folds 
matiko09: folds 
B@ngel: folds 
daniferdoser: folds 
*** FLOP *** [4h 7s 9d]
bennetb77: bets $5.35
darren1031: raises $6.65 to $12
bennetb77: folds 
Uncalled bet ($6.65) returned to darren1031
darren1031 collected $20.72 from pot
*** SUMMARY ***
Total pot $21.70 | Rake $0.98 
Board [4h 7s 9d]
Seat 1: daniferdoser (big blind) folded before Flop
Seat 2: Moszes360 folded before Flop (didn't bet)
Seat 3: Fish4trips folded before Flop (didn't bet)
Seat 4: bennetb77 folded on the Flop
Seat 5: darren1031 collected ($20.72)
Seat 6: Charity86 folded before Flop (didn't bet)
Seat 8: matiko09 (button) folded before Flop (didn't bet)
Seat 9: B@ngel (small blind) folded before Flop





PokerStars Hand #150800139140:  Hold'em No Limit ($0.50/$1.00 USD) - 2016/03/23 13:55:03 CET [2016/03/23 8:55:03 ET]
Table 'Smiley' 9-max Seat #3 is the button
Seat 2: Jimy Tiltman ($100 in chips) 
Seat 3: matiko09 ($100 in chips) 
Seat 4: Zeeshka ($147.42 in chips) 
Seat 5: DUkalisUA ($193.70 in chips) 
Seat 6: blackmont111 ($124.67 in chips) 
Seat 7: Moszes360 ($100 in chips) 
Seat 8: RICKA16 ($131.01 in chips) 
Zeeshka: posts small blind $0.50
DUkalisUA: posts big blind $1
Pvsx.: sits out 
xHourglass: sits out 
*** HOLE CARDS ***
Dealt to matiko09 [3c 7d]
blackmont111: raises $2 to $3
Moszes360: folds 
RICKA16: folds 
Jimy Tiltman: folds 
matiko09: folds 
Zeeshka: folds 
DUkalisUA: folds 
Uncalled bet ($2) returned to blackmont111
blackmont111 collected $2.50 from pot
*** SUMMARY ***
Total pot $2.50 | Rake $0 
Seat 2: Jimy Tiltman folded before Flop (didn't bet)
Seat 3: matiko09 (button) folded before Flop (didn't bet)
Seat 4: Zeeshka (small blind) folded before Flop
Seat 5: DUkalisUA (big blind) folded before Flop
Seat 6: blackmont111 collected ($2.50)
Seat 7: Moszes360 folded before Flop (didn't bet)
Seat 8: RICKA16 folded before Flop (didn't bet)





PokerStars Hand #150800140285:  Hold'em No Limit ($0.50/$1.00 USD) - 2016/03/23 13:55:05 CET [2016/03/23 8:55:05 ET]
Table 'Donar II' 9-max Seat #4 is the button
Seat 1: Effort92 ($100 in chips) 
Seat 2: nobrunobru1 ($82.69 in chips) 
Seat 3: st-germ30 ($70.01 in chips) 
Seat 4: DUkalisUA ($126.37 in chips) 
Seat 5: matiko09 ($100 in chips) 
Seat 6: ardo888 ($126.92 in chips) 
Seat 7: hammerwife ($100 in chips) 
matiko09: posts small blind $0.50
ardo888: posts big blind $1
oxfordtenzin is disconnected 
oxfordtenzin has timed out while disconnected
oxfordtenzin: is sitting out 
Effort92: posts the ante $0.20
nobrunobru1: posts the ante $0.20
st-germ30: posts the ante $0.20
DUkalisUA: posts the ante $0.20
matiko09: posts the ante $0.20
ardo888: posts the ante $0.20
hammerwife: posts the ante $0.20
*** HOLE CARDS ***
Dealt to matiko09 [2h 3d]
hammerwife: folds 
Effort92: folds 
nobrunobru1: folds 
st-germ30: raises $10 to $11
DUkalisUA: folds 
matiko09: folds 
ardo888: folds 
Uncalled bet ($10) returned to st-germ30
st-germ30 collected $3.90 from pot
st-germ30: doesn't show hand 
*** SUMMARY ***
Total pot $3.90 | Rake $0 
Seat 1: Effort92 folded before Flop (didn't bet)
Seat 2: nobrunobru1 folded before Flop (didn't bet)
Seat 3: st-germ30 collected ($3.90)
Seat 4: DUkalisUA (button) folded before Flop (didn't bet)
Seat 5: matiko09 (small blind) folded before Flop
Seat 6: ardo888 (big blind) folded before Flop
Seat 7: hammerwife folded before Flop (didn't bet)





PokerStars Hand #150800142631:  Hold'em No Limit ($0.50/$1.00 USD) - 2016/03/23 13:55:09 CET [2016/03/23 8:55:09 ET]
Table 'Atlantis' 9-max Seat #7 is the button
Seat 1: xHourglass ($157.28 in chips) 
Seat 2: tffff2006 ($45.92 in chips) 
Seat 3: CAJUN890 ($115.79 in chips) 
Seat 4: matiko09 ($121.45 in chips) 
Seat 5: Pvsx. ($100 in chips) 
Seat 6: Jimy Tiltman ($132.31 in chips) 
Seat 7: Zeeshka ($106.32 in chips) 
Seat 8: DUkalisUA ($100 in chips) 
DUkalisUA: posts small blind $0.50
WDW3: is sitting out 
WDW3 leaves the table
xHourglass: posts big blind $1
*** HOLE CARDS ***
Dealt to matiko09 [4c 6d]
myatiy 96 joins the table at seat #9 
myatiy 96 leaves the table
RICKA16 joins the table at seat #9 
tffff2006: folds 
CAJUN890: folds 
matiko09: folds 
Pvsx.: raises $1.50 to $2.50
Jimy Tiltman: folds 
Zeeshka: calls $2.50
DUkalisUA: calls $2
xHourglass: calls $1.50
*** FLOP *** [3d Ah As]
DUkalisUA: checks 
xHourglass: checks 
Pvsx.: checks 
Zeeshka: checks 
*** TURN *** [3d Ah As] [Qd]
DUkalisUA: bets $5
xHourglass: folds 
Pvsx.: folds 
Zeeshka: folds 
Uncalled bet ($5) returned to DUkalisUA
DUkalisUA collected $9.55 from pot
DUkalisUA: doesn't show hand 
*** SUMMARY ***
Total pot $10 | Rake $0.45 
Board [3d Ah As Qd]
Seat 1: xHourglass (big blind) folded on the Turn
Seat 2: tffff2006 folded before Flop (didn't bet)
Seat 3: CAJUN890 folded before Flop (didn't bet)
Seat 4: matiko09 folded before Flop (didn't bet)
Seat 5: Pvsx. folded on the Turn
Seat 6: Jimy Tiltman folded before Flop (didn't bet)
Seat 7: Zeeshka (button) folded on the Turn
Seat 8: DUkalisUA (small blind) collected ($9.55)





PokerStars Hand #150800142464:  Hold'em No Limit ($0.25/$0.50 USD) - 2016/03/23 13:55:09 CET [2016/03/23 8:55:09 ET]
Table 'Belnika' 9-max Seat #1 is the button
Seat 1: yellowfever0 ($18.19 in chips) 
Seat 2: NeverRegret7 ($51.49 in chips) 
Seat 3: ChiChioChi ($78.84 in chips) 
Seat 4: matiko09 ($66.10 in chips) 
Seat 5: IvanUrgant ($50 in chips) 
Seat 6: Ahangama ($56.75 in chips) 
Seat 7: Zeeshka ($50 in chips) 
Seat 8: lumen21 ($66.97 in chips) 
Seat 9: dndngod ($61.16 in chips) 
NeverRegret7: posts small blind $0.25
ChiChioChi: posts big blind $0.50
*** HOLE CARDS ***
Dealt to matiko09 [8d 6s]
matiko09: folds 
IvanUrgant: raises $1 to $1.50
Ahangama: folds 
Zeeshka: folds 
lumen21: folds 
dndngod: folds 
yellowfever0: folds 
NeverRegret7: folds 
ChiChioChi: folds 
Uncalled bet ($1) returned to IvanUrgant
IvanUrgant collected $1.25 from pot
IvanUrgant: doesn't show hand 
*** SUMMARY ***
Total pot $1.25 | Rake $0 
Seat 1: yellowfever0 (button) folded before Flop (didn't bet)
Seat 2: NeverRegret7 (small blind) folded before Flop
Seat 3: ChiChioChi (big blind) folded before Flop
Seat 4: matiko09 folded before Flop (didn't bet)
Seat 5: IvanUrgant collected ($1.25)
Seat 6: Ahangama folded before Flop (didn't bet)
Seat 7: Zeeshka folded before Flop (didn't bet)
Seat 8: lumen21 folded before Flop (didn't bet)
Seat 9: dndngod folded before Flop (didn't bet)





PokerStars Hand #150800149333:  Hold'em No Limit (€0.25/€0.50 EUR) - 2016/03/23 13:55:22 CET [2016/03/23 8:55:22 ET]
Table 'Hesperia II' 9-max Seat #1 is the button
Seat 1: CAJUN890 (€55.08 in chips) 
Seat 2: dndngod (€54.39 in chips) 
Seat 3: IvanUrgant (€57.80 in chips) 
Seat 4: Zelenis (€21.15 in chips) 
Seat 5: Avrora-sp (€54.08 in chips) 
Seat 6: CvMCvMCvM (€50 in chips) 
Seat 7: matiko09 (€58.73 in chips) 
Seat 8: Ahangama (€50 in chips) 
Seat 9: Red_Warning (€50 in chips) 
dndngod: posts small blind €0.25
IvanUrgant: posts big blind €0.50
*** HOLE CARDS ***
Dealt to matiko09 [5h Ah]
Zelenis: folds 
Avrora-sp: folds 
CvMCvMCvM: folds 
matiko09: raises €1 to €1.50
Ahangama: folds 
Red_Warning: folds 
CAJUN890: folds 
dndngod: folds 
IvanUrgant: folds 
Uncalled bet (€1) returned to matiko09
matiko09 collected €1.25 from pot
matiko09: doesn't show hand 
*** SUMMARY ***
Total pot €1.25 | Rake €0 
Seat 1: CAJUN890 (button) folded before Flop (didn't bet)
Seat 2: dndngod (small blind) folded before Flop
Seat 3: IvanUrgant (big blind) folded before Flop
Seat 4: Zelenis folded before Flop (didn't bet)
Seat 5: Avrora-sp folded before Flop (didn't bet)
Seat 6: CvMCvMCvM folded before Flop (didn't bet)
Seat 7: matiko09 collected (€1.25)
Seat 8: Ahangama folded before Flop (didn't bet)
Seat 9: Red_Warning folded before Flop (didn't bet)





PokerStars Hand #150800152900:  Hold'em No Limit ($1/$2 USD) - 2016/03/23 13:55:29 CET [2016/03/23 8:55:29 ET]
Table 'Herba II' 9-max Seat #7 is the button
Seat 1: matiko09 ($221.48 in chips) 
Seat 2: Moszes360 ($200 in chips) 
Seat 3: Cirilico ($160 in chips) 
Seat 4: DUkalisUA ($289.08 in chips) 
Seat 5: chippo boy ($217.31 in chips) 
Seat 7: InsomniaRU ($210.42 in chips) 
Seat 8: The_red_area ($455.98 in chips) 
Seat 9: mrhighryza ($62.23 in chips) 
The_red_area: posts small blind $1
mrhighryza: posts big blind $2
*** HOLE CARDS ***
Dealt to matiko09 [9d 3d]
matiko09: folds 
Moszes360: folds 
Cirilico: folds 
DUkalisUA: folds 
chippo boy: folds 
InsomniaRU: raises $3 to $5
The_red_area: folds 
mrhighryza: calls $3
*** FLOP *** [Ah 9c 4c]
mrhighryza: checks 
Too-Anti-To joins the table at seat #6 
InsomniaRU: checks 
*** TURN *** [Ah 9c 4c] [Jh]
mrhighryza: bets $2
InsomniaRU: calls $2
*** RIVER *** [Ah 9c 4c Jh] [2c]
mrhighryza: checks 
InsomniaRU: checks 
*** SHOW DOWN ***
mrhighryza: shows [4h Kd] (a pair of Fours)
InsomniaRU: mucks hand 
mrhighryza collected $14.32 from pot
*** SUMMARY ***
Total pot $15 | Rake $0.68 
Board [Ah 9c 4c Jh 2c]
Seat 1: matiko09 folded before Flop (didn't bet)
Seat 2: Moszes360 folded before Flop (didn't bet)
Seat 3: Cirilico folded before Flop (didn't bet)
Seat 4: DUkalisUA folded before Flop (didn't bet)
Seat 5: chippo boy folded before Flop (didn't bet)
Seat 7: InsomniaRU (button) mucked [Th Ks]
Seat 8: The_red_area (small blind) folded before Flop
Seat 9: mrhighryza (big blind) showed [4h Kd] and won ($14.32) with a pair of Fours





PokerStars Hand #150800153468:  Hold'em No Limit ($0.50/$1.00 USD) - 2016/03/23 13:55:30 CET [2016/03/23 8:55:30 ET]
Table 'Kippes' 9-max Seat #1 is the button
Seat 1: Pvsx. ($100 in chips) 
Seat 2: RICKA16 ($129.13 in chips) 
Seat 3: CAJUN890 ($126.97 in chips) 
Seat 4: matiko09 ($100 in chips) 
Seat 5: Jimy Tiltman ($118.36 in chips) 
Seat 6: WDW3 ($116.57 in chips) 
Seat 7: lumen21 ($115.02 in chips) 
Seat 8: Zeeshka ($110.30 in chips) 
Seat 9: wang19790906 ($81.92 in chips) 
RICKA16: posts small blind $0.50
CAJUN890: posts big blind $1
*** HOLE CARDS ***
Dealt to matiko09 [Th Ts]
matiko09: raises $2 to $3
Jimy Tiltman: folds 
WDW3: folds 
lumen21: folds 
Zeeshka: folds 
wang19790906: folds 
Pvsx.: calls $3
RICKA16: folds 
CAJUN890: calls $2
*** FLOP *** [5c 4c 7h]
CAJUN890: checks 
matiko09: checks 
Pvsx.: bets $5
CAJUN890: folds 
matiko09: calls $5
*** TURN *** [5c 4c 7h] [2s]
matiko09: checks 
Pvsx.: checks 
*** RIVER *** [5c 4c 7h 2s] [2c]
matiko09: bets $9
Pvsx.: raises $14 to $23
matiko09: folds 
Uncalled bet ($14) returned to Pvsx.
Pvsx. collected $35.81 from pot
Pvsx.: doesn't show hand 
*** SUMMARY ***
Total pot $37.50 | Rake $1.69 
Board [5c 4c 7h 2s 2c]
Seat 1: Pvsx. (button) collected ($35.81)
Seat 2: RICKA16 (small blind) folded before Flop
Seat 3: CAJUN890 (big blind) folded on the Flop
Seat 4: matiko09 folded on the River
Seat 5: Jimy Tiltman folded before Flop (didn't bet)
Seat 6: WDW3 folded before Flop (didn't bet)
Seat 7: lumen21 folded before Flop (didn't bet)
Seat 8: Zeeshka folded before Flop (didn't bet)
Seat 9: wang19790906 folded before Flop (didn't bet)





PokerStars Hand #150800154503:  Hold'em No Limit ($0.25/$0.50 USD) - 2016/03/23 13:55:32 CET [2016/03/23 8:55:32 ET]
Table 'Pyrrhus' 9-max Seat #7 is the button
Seat 1: lumen21 ($50 in chips) 
Seat 2: Zeeshka ($50 in chips) 
Seat 3: IvanUrgant ($83.12 in chips) 
Seat 5: Moszes360 ($61 in chips) 
Seat 6: whalldo ($165.12 in chips) 
Seat 7: matiko09 ($141.32 in chips) 
Seat 8: dndngod ($59.73 in chips) 
Seat 9: CvMCvMCvM ($113.86 in chips) 
dndngod: posts small blind $0.25
CvMCvMCvM: posts big blind $0.50
*** HOLE CARDS ***
Dealt to matiko09 [7s 7h]
lumen21: folds 
Zeeshka: folds 
IvanUrgant: folds 
Moszes360: folds 
whalldo: raises $1 to $1.50
matiko09: calls $1.50
dndngod: folds 
CvMCvMCvM: folds 
*** FLOP *** [6s 9c 9h]
whalldo: bets $2.38
matiko09: calls $2.38
*** TURN *** [6s 9c 9h] [Ac]
whalldo: bets $5.41
matiko09: folds 
Uncalled bet ($5.41) returned to whalldo
whalldo collected $8.13 from pot
whalldo: doesn't show hand 
*** SUMMARY ***
Total pot $8.51 | Rake $0.38 
Board [6s 9c 9h Ac]
Seat 1: lumen21 folded before Flop (didn't bet)
Seat 2: Zeeshka folded before Flop (didn't bet)
Seat 3: IvanUrgant folded before Flop (didn't bet)
Seat 5: Moszes360 folded before Flop (didn't bet)
Seat 6: whalldo collected ($8.13)
Seat 7: matiko09 (button) folded on the Turn
Seat 8: dndngod (small blind) folded before Flop
Seat 9: CvMCvMCvM (big blind) folded before Flop





PokerStars Hand #150800155347:  Hold'em No Limit ($1/$2 USD) - 2016/03/23 13:55:34 CET [2016/03/23 8:55:34 ET]
Table 'Kiess' 9-max Seat #1 is the button
Seat 1: Cirilico ($160.56 in chips) 
Seat 2: DUkalisUA ($480.17 in chips) 
Seat 3: The_red_area ($378.14 in chips) 
Seat 4: Moszes360 ($207.77 in chips) 
Seat 5: chippo boy ($323.88 in chips) 
Seat 6: matiko09 ($288.84 in chips) 
Seat 7: InsomniaRU ($273.17 in chips) 
Seat 9: Fish4trips ($210.55 in chips) 
DUkalisUA: posts small blind $1
The_red_area: posts big blind $2
*** HOLE CARDS ***
Dealt to matiko09 [4c 3d]
Moszes360: folds 
erfk1958 joins the table at seat #8 
chippo boy: folds 
matiko09: folds 
InsomniaRU: folds 
Fish4trips: raises $3 to $5
Cirilico: folds 
DUkalisUA: raises $14 to $19
The_red_area: folds 
Fish4trips: calls $14
*** FLOP *** [8c Qc 6s]
DUkalisUA: bets $18
Fish4trips: calls $18
*** TURN *** [8c Qc 6s] [6h]
DUkalisUA: bets $38
Fish4trips: calls $38
*** RIVER *** [8c Qc 6s 6h] [2h]
DUkalisUA: bets $179.04
Fish4trips: calls $135.55 and is all-in
Uncalled bet ($43.49) returned to DUkalisUA
*** SHOW DOWN ***
DUkalisUA: shows [Ks Kc] (two pair, Kings and Sixes)
Fish4trips: mucks hand 
DUkalisUA collected $420.30 from pot
*** SUMMARY ***
Total pot $423.10 | Rake $2.80 
Board [8c Qc 6s 6h 2h]
Seat 1: Cirilico (button) folded before Flop (didn't bet)
Seat 2: DUkalisUA (small blind) showed [Ks Kc] and won ($420.30) with two pair, Kings and Sixes
Seat 3: The_red_area (big blind) folded before Flop
Seat 4: Moszes360 folded before Flop (didn't bet)
Seat 5: chippo boy folded before Flop (didn't bet)
Seat 6: matiko09 folded before Flop (didn't bet)
Seat 7: InsomniaRU folded before Flop (didn't bet)
Seat 9: Fish4trips mucked [Qh Ad]





PokerStars Hand #150800160674:  Hold'em No Limit ($0.25/$0.50 USD) - 2016/03/23 13:55:45 CET [2016/03/23 8:55:45 ET]
Table 'Belnika' 9-max Seat #2 is the button
Seat 1: yellowfever0 ($18.19 in chips) 
Seat 2: NeverRegret7 ($51.24 in chips) 
Seat 3: ChiChioChi ($78.34 in chips) 
Seat 4: matiko09 ($66.10 in chips) 
Seat 5: IvanUrgant ($50.75 in chips) 
Seat 6: Ahangama ($56.75 in chips) 
Seat 7: Zeeshka ($50 in chips) 
Seat 8: lumen21 ($66.97 in chips) 
Seat 9: dndngod ($61.16 in chips) 
ChiChioChi: posts small blind $0.25
matiko09: posts big blind $0.50
*** HOLE CARDS ***
Dealt to matiko09 [9c 3h]
IvanUrgant: folds 
Ahangama: folds 
Zeeshka: folds 
lumen21: raises $1 to $1.50
dndngod: folds 
yellowfever0: folds 
NeverRegret7: raises $2 to $3.50
ChiChioChi: folds 
matiko09: folds 
lumen21: calls $2
*** FLOP *** [Jh Js Td]
lumen21: checks 
NeverRegret7: checks 
*** TURN *** [Jh Js Td] [9s]
lumen21: checks 
NeverRegret7: bets $3.70
lumen21: folds 
Uncalled bet ($3.70) returned to NeverRegret7
NeverRegret7 collected $7.40 from pot
NeverRegret7: doesn't show hand 
*** SUMMARY ***
Total pot $7.75 | Rake $0.35 
Board [Jh Js Td 9s]
Seat 1: yellowfever0 folded before Flop (didn't bet)
Seat 2: NeverRegret7 (button) collected ($7.40)
Seat 3: ChiChioChi (small blind) folded before Flop
Seat 4: matiko09 (big blind) folded before Flop
Seat 5: IvanUrgant folded before Flop (didn't bet)
Seat 6: Ahangama folded before Flop (didn't bet)
Seat 7: Zeeshka folded before Flop (didn't bet)
Seat 8: lumen21 folded on the Turn
Seat 9: dndngod folded before Flop (didn't bet)





PokerStars Hand #150800161944:  Hold'em No Limit (€0.25/€0.50 EUR) - 2016/03/23 13:55:47 CET [2016/03/23 8:55:47 ET]
Table 'Hesperia II' 9-max Seat #2 is the button
Seat 1: CAJUN890 (€55.08 in chips) 
Seat 2: dndngod (€54.14 in chips) 
Seat 3: IvanUrgant (€57.30 in chips) 
Seat 4: Zelenis (€21.15 in chips) 
Seat 5: Avrora-sp (€54.08 in chips) 
Seat 6: CvMCvMCvM (€50 in chips) 
Seat 7: matiko09 (€59.48 in chips) 
Seat 8: Ahangama (€50 in chips) 
Seat 9: Red_Warning (€50 in chips) 
IvanUrgant: posts small blind €0.25
Zelenis: posts big blind €0.50
*** HOLE CARDS ***
Dealt to matiko09 [3s Qd]
Avrora-sp: raises €1 to €1.50
CvMCvMCvM: folds 
matiko09: folds 
Ahangama: calls €1.50
Red_Warning: folds 
CAJUN890: folds 
dndngod: folds 
IvanUrgant: folds 
Zelenis: calls €1
*** FLOP *** [5c 6s 4s]
Zelenis: bets €2
Avrora-sp: folds 
Ahangama: raises €3.50 to €5.50
Zelenis: calls €3.50
*** TURN *** [5c 6s 4s] [Kc]
Zelenis: checks 
Ahangama: bets €14.25
Zelenis: folds 
Uncalled bet (€14.25) returned to Ahangama
Ahangama collected €15.04 from pot
Ahangama: doesn't show hand 
*** SUMMARY ***
Total pot €15.75 | Rake €0.71 
Board [5c 6s 4s Kc]
Seat 1: CAJUN890 folded before Flop (didn't bet)
Seat 2: dndngod (button) folded before Flop (didn't bet)
Seat 3: IvanUrgant (small blind) folded before Flop
Seat 4: Zelenis (big blind) folded on the Turn
Seat 5: Avrora-sp folded on the Flop
Seat 6: CvMCvMCvM folded before Flop (didn't bet)
Seat 7: matiko09 folded before Flop (didn't bet)
Seat 8: Ahangama collected (€15.04)
Seat 9: Red_Warning folded before Flop (didn't bet)





PokerStars Hand #150800162766:  Hold'em No Limit ($0.50/$1.00 USD) - 2016/03/23 13:55:49 CET [2016/03/23 8:55:49 ET]
Table 'Smiley' 9-max Seat #4 is the button
Seat 2: Jimy Tiltman ($100 in chips) 
Seat 3: matiko09 ($100 in chips) 
Seat 4: Zeeshka ($146.92 in chips) 
Seat 5: DUkalisUA ($192.70 in chips) 
Seat 6: blackmont111 ($126.17 in chips) 
Seat 7: Moszes360 ($100 in chips) 
Seat 8: RICKA16 ($131.01 in chips) 
DUkalisUA: posts small blind $0.50
blackmont111: posts big blind $1
Pvsx.: sits out 
xHourglass: sits out 
*** HOLE CARDS ***
Dealt to matiko09 [7d 9h]
Moszes360: folds 
RICKA16: folds 
Jimy Tiltman: folds 
matiko09: folds 
Zeeshka: raises $1.50 to $2.50
DUkalisUA: folds 
blackmont111: folds 
Uncalled bet ($1.50) returned to Zeeshka
Zeeshka collected $2.50 from pot
Zeeshka: doesn't show hand 
*** SUMMARY ***
Total pot $2.50 | Rake $0 
Seat 2: Jimy Tiltman folded before Flop (didn't bet)
Seat 3: matiko09 folded before Flop (didn't bet)
Seat 4: Zeeshka (button) collected ($2.50)
Seat 5: DUkalisUA (small blind) folded before Flop
Seat 6: blackmont111 (big blind) folded before Flop
Seat 7: Moszes360 folded before Flop (didn't bet)
Seat 8: RICKA16 folded before Flop (didn't bet)





PokerStars Hand #150800164810:  Hold'em No Limit ($1/$2 USD) - 2016/03/23 13:55:53 CET [2016/03/23 8:55:53 ET]
Table 'Alma II' 9-max Seat #7 is the button
Seat 1: berggren ($219.75 in chips) 
Seat 2: glanza_mike ($200 in chips) 
Seat 4: daniferdoser ($201.78 in chips) 
Seat 5: dah44 ($208.10 in chips) 
Seat 6: InsomniaRU ($200 in chips) 
Seat 7: cliffdogz ($177 in chips) 
Seat 8: matiko09 ($200 in chips) 
Seat 9: carflam7 ($160 in chips) 
matiko09: posts small blind $1
carflam7: posts big blind $2
*** HOLE CARDS ***
Dealt to matiko09 [Kh Kd]
berggren: folds 
glanza_mike: folds 
daniferdoser: folds 
dah44: folds 
InsomniaRU: folds 
cliffdogz: raises $2 to $4
matiko09: raises $13 to $17
carflam7: folds 
cliffdogz: folds 
Uncalled bet ($13) returned to matiko09
matiko09 collected $10 from pot
matiko09: doesn't show hand 
*** SUMMARY ***
Total pot $10 | Rake $0 
Seat 1: berggren folded before Flop (didn't bet)
Seat 2: glanza_mike folded before Flop (didn't bet)
Seat 4: daniferdoser folded before Flop (didn't bet)
Seat 5: dah44 folded before Flop (didn't bet)
Seat 6: InsomniaRU folded before Flop (didn't bet)
Seat 7: cliffdogz (button) folded before Flop
Seat 8: matiko09 (small blind) collected ($10)
Seat 9: carflam7 (big blind) folded before Flop





PokerStars Hand #150800165931:  Hold'em No Limit ($1/$2 USD) - 2016/03/23 13:55:55 CET [2016/03/23 8:55:55 ET]
Table 'Kypria II' 9-max Seat #7 is the button
Seat 1: geldwolfje ($152.66 in chips) 
Seat 2: coinflip_si ($200 in chips) 
Seat 3: seouljam ($202.73 in chips) 
Seat 4: nailz83 ($36.54 in chips) 
Seat 5: InsomniaRU ($372.62 in chips) 
Seat 6: matiko09 ($285.69 in chips) 
Seat 7: DUkalisUA ($200 in chips) 
Seat 8: Fish4trips ($335.19 in chips) 
Fish4trips: posts small blind $1
WDW3: is sitting out 
WDW3 leaves the table
geldwolfje: posts big blind $2
*** HOLE CARDS ***
Dealt to matiko09 [Ts 4d]
coinflip_si: folds 
seouljam: raises $2.70 to $4.70
nailz83: calls $4.70
Moszes360 joins the table at seat #9 
InsomniaRU: folds 
matiko09: folds 
DUkalisUA: folds 
Fish4trips: folds 
geldwolfje: calls $2.70
*** FLOP *** [Th Qd 9s]
geldwolfje: checks 
seouljam: checks 
nailz83: checks 
*** TURN *** [Th Qd 9s] [Qs]
geldwolfje: checks 
seouljam: checks 
nailz83: checks 
*** RIVER *** [Th Qd 9s Qs] [Qh]
geldwolfje: checks 
seouljam: bets $6
nailz83: folds 
geldwolfje: folds 
Uncalled bet ($6) returned to seouljam
seouljam collected $14.42 from pot
seouljam: doesn't show hand 
*** SUMMARY ***
Total pot $15.10 | Rake $0.68 
Board [Th Qd 9s Qs Qh]
Seat 1: geldwolfje (big blind) folded on the River
Seat 2: coinflip_si folded before Flop (didn't bet)
Seat 3: seouljam collected ($14.42)
Seat 4: nailz83 folded on the River
Seat 5: InsomniaRU folded before Flop (didn't bet)
Seat 6: matiko09 folded before Flop (didn't bet)
Seat 7: DUkalisUA (button) folded before Flop (didn't bet)
Seat 8: Fish4trips (small blind) folded before Flop





PokerStars Hand #150800166629:  Hold'em No Limit ($1/$2 USD) - 2016/03/23 13:55:56 CET [2016/03/23 8:55:56 ET]
Table 'Berbericia II' 9-max Seat #9 is the button
Seat 1: daniferdoser ($200 in chips) 
Seat 2: Moszes360 ($230.52 in chips) 
Seat 3: Fish4trips ($212.02 in chips) 
Seat 4: bennetb77 ($94.87 in chips) 
Seat 5: darren1031 ($233.54 in chips) 
Seat 6: Charity86 ($170.38 in chips) 
Seat 8: matiko09 ($297.51 in chips) 
Seat 9: B@ngel ($200 in chips) 
daniferdoser: posts small blind $1
Moszes360: posts big blind $2
*** HOLE CARDS ***
Dealt to matiko09 [Qh 6d]
Fish4trips: folds 
bennetb77: folds 
darren1031: folds 
Charity86: folds 
matiko09: folds 
B@ngel: folds 
daniferdoser: folds 
Uncalled bet ($1) returned to Moszes360
Moszes360 collected $2 from pot
Moszes360: doesn't show hand 
*** SUMMARY ***
Total pot $2 | Rake $0 
Seat 1: daniferdoser (small blind) folded before Flop
Seat 2: Moszes360 (big blind) collected ($2)
Seat 3: Fish4trips folded before Flop (didn't bet)
Seat 4: bennetb77 folded before Flop (didn't bet)
Seat 5: darren1031 folded before Flop (didn't bet)
Seat 6: Charity86 folded before Flop (didn't bet)
Seat 8: matiko09 folded before Flop (didn't bet)
Seat 9: B@ngel (button) folded before Flop (didn't bet)





PokerStars Hand #150800170098:  Hold'em No Limit ($0.50/$1.00 USD) - 2016/03/23 13:56:03 CET [2016/03/23 8:56:03 ET]
Table 'Donar II' 9-max Seat #5 is the button
Seat 1: Effort92 ($100 in chips) 
Seat 2: nobrunobru1 ($82.49 in chips) 
Seat 3: st-germ30 ($100 in chips) 
Seat 4: DUkalisUA ($126.17 in chips) 
Seat 5: matiko09 ($100 in chips) 
Seat 6: ardo888 ($125.72 in chips) 
ardo888: posts small blind $0.50
hammerwife: is sitting out 
Effort92: posts big blind $1
Effort92: posts the ante $0.20
nobrunobru1: posts the ante $0.20
st-germ30: posts the ante $0.20
DUkalisUA: posts the ante $0.20
matiko09: posts the ante $0.20
ardo888: posts the ante $0.20
*** HOLE CARDS ***
Dealt to matiko09 [8h Td]
nobrunobru1: calls $1
st-germ30: calls $1
DUkalisUA: folds 
matiko09: folds 
ardo888: calls $0.50
Effort92: checks 
*** FLOP *** [7s Ah Jc]
ardo888: checks 
Effort92: checks 
nobrunobru1: bets $2
st-germ30: calls $2
ardo888: folds 
Effort92: calls $2
*** TURN *** [7s Ah Jc] [4h]
Effort92: checks 
nobrunobru1: checks 
st-germ30: checks 
*** RIVER *** [7s Ah Jc 4h] [Kd]
Effort92: bets $6.62
nobrunobru1: calls $6.62
st-germ30: folds 
*** SHOW DOWN ***
Effort92: shows [Th Qc] (a straight, Ten to Ace)
nobrunobru1: mucks hand 
Effort92 collected $23.34 from pot
*** SUMMARY ***
Total pot $24.44 | Rake $1.10 
Board [7s Ah Jc 4h Kd]
Seat 1: Effort92 (big blind) showed [Th Qc] and won ($23.34) with a straight, Ten to Ace
Seat 2: nobrunobru1 mucked [Ac 2c]
Seat 3: st-germ30 folded on the River
Seat 4: DUkalisUA folded before Flop (didn't bet)
Seat 5: matiko09 (button) folded before Flop (didn't bet)
Seat 6: ardo888 (small blind) folded on the Flop





PokerStars Hand #150800177300:  Hold'em No Limit ($0.50/$1.00 USD) - 2016/03/23 13:56:18 CET [2016/03/23 8:56:18 ET]
Table 'Atlantis' 9-max Seat #8 is the button
Seat 1: xHourglass ($154.78 in chips) 
Seat 2: tffff2006 ($45.92 in chips) 
Seat 3: CAJUN890 ($115.79 in chips) 
Seat 4: matiko09 ($121.45 in chips) 
Seat 5: Pvsx. ($100 in chips) 
Seat 6: Jimy Tiltman ($132.31 in chips) 
Seat 7: Zeeshka ($103.82 in chips) 
Seat 8: DUkalisUA ($107.05 in chips) 
RICKA16 will be allowed to play after the button
xHourglass: posts small blind $0.50
tffff2006: posts big blind $1
*** HOLE CARDS ***
Dealt to matiko09 [4h 4c]
CAJUN890: folds 
matiko09: raises $2 to $3
Pvsx.: folds 
Jimy Tiltman: folds 
Zeeshka: raises $6 to $9
DUkalisUA: folds 
xHourglass: folds 
tffff2006: folds 
matiko09: folds 
Uncalled bet ($6) returned to Zeeshka
Zeeshka collected $7.50 from pot
Zeeshka: doesn't show hand 
*** SUMMARY ***
Total pot $7.50 | Rake $0 
Seat 1: xHourglass (small blind) folded before Flop
Seat 2: tffff2006 (big blind) folded before Flop
Seat 3: CAJUN890 folded before Flop (didn't bet)
Seat 4: matiko09 folded before Flop
Seat 5: Pvsx. folded before Flop (didn't bet)
Seat 6: Jimy Tiltman folded before Flop (didn't bet)
Seat 7: Zeeshka collected ($7.50)
Seat 8: DUkalisUA (button) folded before Flop (didn't bet)





PokerStars Hand #150800178595:  Hold'em No Limit ($0.50/$1.00 USD) - 2016/03/23 13:56:20 CET [2016/03/23 8:56:20 ET]
Table 'Smiley' 9-max Seat #5 is the button
Seat 2: Jimy Tiltman ($100 in chips) 
Seat 3: matiko09 ($100 in chips) 
Seat 4: Zeeshka ($148.42 in chips) 
Seat 5: DUkalisUA ($192.20 in chips) 
Seat 6: blackmont111 ($125.17 in chips) 
Seat 7: Moszes360 ($100 in chips) 
Seat 8: RICKA16 ($131.01 in chips) 
blackmont111: posts small blind $0.50
Moszes360: posts big blind $1
Pvsx.: sits out 
xHourglass: sits out 
*** HOLE CARDS ***
Dealt to matiko09 [2s Jc]
RICKA16: folds 
RICKA16 leaves the table
Jimy Tiltman: folds 
momtscheto joins the table at seat #8 
matiko09: folds 
Zeeshka: raises $2 to $3
DUkalisUA: folds 
blackmont111: calls $2.50
Moszes360: folds 
*** FLOP *** [Kh Th 6d]
blackmont111: checks 
Zeeshka: checks 
*** TURN *** [Kh Th 6d] [9c]
blackmont111: bets $4
Zeeshka: calls $4
*** RIVER *** [Kh Th 6d 9c] [Jh]
blackmont111: checks 
Zeeshka: bets $7.87
blackmont111: calls $7.87
*** SHOW DOWN ***
Zeeshka: shows [Ts Qh] (a straight, Nine to King)
blackmont111: mucks hand 
Zeeshka collected $29.36 from pot
*** SUMMARY ***
Total pot $30.74 | Rake $1.38 
Board [Kh Th 6d 9c Jh]
Seat 2: Jimy Tiltman folded before Flop (didn't bet)
Seat 3: matiko09 folded before Flop (didn't bet)
Seat 4: Zeeshka showed [Ts Qh] and won ($29.36) with a straight, Nine to King
Seat 5: DUkalisUA (button) folded before Flop (didn't bet)
Seat 6: blackmont111 (small blind) mucked [Ad As]
Seat 7: Moszes360 (big blind) folded before Flop
Seat 8: RICKA16 folded before Flop (didn't bet)





PokerStars Hand #150800182396:  Hold'em No Limit ($1/$2 USD) - 2016/03/23 13:56:28 CET [2016/03/23 8:56:28 ET]
Table 'Berbericia II' 9-max Seat #1 is the button
Seat 1: daniferdoser ($200 in chips) 
Seat 2: Moszes360 ($231.52 in chips) 
Seat 3: Fish4trips ($212.02 in chips) 
Seat 4: bennetb77 ($94.87 in chips) 
Seat 5: darren1031 ($233.54 in chips) 
Seat 6: Charity86 ($170.38 in chips) 
Seat 8: matiko09 ($297.51 in chips) 
Seat 9: B@ngel ($200 in chips) 
Moszes360: posts small blind $1
Fish4trips: posts big blind $2
*** HOLE CARDS ***
Dealt to matiko09 [Ah 7s]
bennetb77: folds 
darren1031: folds 
Charity86: folds 
matiko09: folds 
B@ngel: folds 
daniferdoser: folds 
Moszes360: raises $4 to $6
Fish4trips: folds 
Uncalled bet ($4) returned to Moszes360
Moszes360 collected $4 from pot
Moszes360: doesn't show hand 
*** SUMMARY ***
Total pot $4 | Rake $0 
Seat 1: daniferdoser (button) folded before Flop (didn't bet)
Seat 2: Moszes360 (small blind) collected ($4)
Seat 3: Fish4trips (big blind) folded before Flop
Seat 4: bennetb77 folded before Flop (didn't bet)
Seat 5: darren1031 folded before Flop (didn't bet)
Seat 6: Charity86 folded before Flop (didn't bet)
Seat 8: matiko09 folded before Flop (didn't bet)
Seat 9: B@ngel folded before Flop (didn't bet)





PokerStars Hand #150800191016:  Hold'em No Limit ($0.50/$1.00 USD) - 2016/03/23 13:56:44 CET [2016/03/23 8:56:44 ET]
Table 'Merope II' 9-max Seat #8 is the button
Seat 1: Jimy Tiltman ($108.71 in chips) 
Seat 2: Zeeshka ($100 in chips) 
Seat 3: Sherlockplay ($141.70 in chips) 
Seat 5: DUkalisUA ($100 in chips) 
Seat 6: rebelTC ($88.19 in chips) 
Seat 7: matiko09 ($100 in chips) 
Seat 8: titentei ($95 in chips) 
Seat 9: RICKA16 ($100 in chips) 
RICKA16: posts small blind $0.50
Jimy Tiltman: posts big blind $1
*** HOLE CARDS ***
Dealt to matiko09 [3c 3s]
Zeeshka: raises $2 to $3
Sherlockplay: folds 
DUkalisUA: folds 
rebelTC: folds 
rebelTC leaves the table
myatiy 96 joins the table at seat #6 
myatiy 96 leaves the table
Effort92 joins the table at seat #6 
matiko09: folds 
titentei: folds 
RICKA16: folds 
Jimy Tiltman: folds 
Uncalled bet ($2) returned to Zeeshka
Zeeshka collected $2.50 from pot
Zeeshka: doesn't show hand 
*** SUMMARY ***
Total pot $2.50 | Rake $0 
Seat 1: Jimy Tiltman (big blind) folded before Flop
Seat 2: Zeeshka collected ($2.50)
Seat 3: Sherlockplay folded before Flop (didn't bet)
Seat 5: DUkalisUA folded before Flop (didn't bet)
Seat 6: rebelTC folded before Flop (didn't bet)
Seat 7: matiko09 folded before Flop (didn't bet)
Seat 8: titentei (button) folded before Flop (didn't bet)
Seat 9: RICKA16 (small blind) folded before Flop





PokerStars Hand #150800194786:  Hold'em No Limit ($1/$2 USD) - 2016/03/23 13:56:52 CET [2016/03/23 8:56:52 ET]
Table 'Kypria II' 9-max Seat #8 is the button
Seat 1: geldwolfje ($147.96 in chips) 
Seat 2: coinflip_si ($200 in chips) 
Seat 3: seouljam ($212.45 in chips) 
Seat 4: nailz83 ($31.84 in chips) 
Seat 5: InsomniaRU ($372.62 in chips) 
Seat 6: matiko09 ($285.69 in chips) 
Seat 7: DUkalisUA ($200 in chips) 
Seat 8: Fish4trips ($334.19 in chips) 
Moszes360 will be allowed to play after the button
geldwolfje: posts small blind $1
coinflip_si: posts big blind $2
*** HOLE CARDS ***
Dealt to matiko09 [Ac Js]
seouljam: folds 
nailz83: folds 
InsomniaRU: folds 
matiko09: raises $3 to $5
DUkalisUA: folds 
Fish4trips: folds 
geldwolfje: calls $4
coinflip_si: folds 
*** FLOP *** [8c 4h 7d]
geldwolfje: checks 
matiko09: checks 
*** TURN *** [8c 4h 7d] [6c]
geldwolfje: bets $10
matiko09: folds 
Uncalled bet ($10) returned to geldwolfje
geldwolfje collected $11.46 from pot
geldwolfje: doesn't show hand 
*** SUMMARY ***
Total pot $12 | Rake $0.54 
Board [8c 4h 7d 6c]
Seat 1: geldwolfje (small blind) collected ($11.46)
Seat 2: coinflip_si (big blind) folded before Flop
Seat 3: seouljam folded before Flop (didn't bet)
Seat 4: nailz83 folded before Flop (didn't bet)
Seat 5: InsomniaRU folded before Flop (didn't bet)
Seat 6: matiko09 folded on the Turn
Seat 7: DUkalisUA folded before Flop (didn't bet)
Seat 8: Fish4trips (button) folded before Flop (didn't bet)





PokerStars Hand #150800196806:  Hold'em No Limit ($0.25/$0.50 USD) - 2016/03/23 13:56:56 CET [2016/03/23 8:56:56 ET]
Table 'Pyrrhus' 9-max Seat #8 is the button
Seat 1: lumen21 ($50 in chips) 
Seat 2: Zeeshka ($50 in chips) 
Seat 3: IvanUrgant ($83.12 in chips) 
Seat 4: GriffinBerg ($24.64 in chips) 
Seat 5: Moszes360 ($61 in chips) 
Seat 6: whalldo ($169.37 in chips) 
Seat 7: matiko09 ($137.44 in chips) 
Seat 8: dndngod ($59.48 in chips) 
Seat 9: CvMCvMCvM ($113.36 in chips) 
CvMCvMCvM: posts small blind $0.25
lumen21: posts big blind $0.50
*** HOLE CARDS ***
Dealt to matiko09 [Qc Td]
Zeeshka: raises $1 to $1.50
IvanUrgant: folds 
GriffinBerg: calls $1.50
Moszes360: folds 
whalldo: folds 
matiko09: folds 
dndngod: folds 
CvMCvMCvM: folds 
lumen21: folds 
*** FLOP *** [3h 2s Jd]
Zeeshka: bets $1.96
GriffinBerg: calls $1.96
*** TURN *** [3h 2s Jd] [Jh]
Zeeshka: checks 
GriffinBerg: bets $3
Zeeshka: folds 
Uncalled bet ($3) returned to GriffinBerg
GriffinBerg collected $7.32 from pot
*** SUMMARY ***
Total pot $7.67 | Rake $0.35 
Board [3h 2s Jd Jh]
Seat 1: lumen21 (big blind) folded before Flop
Seat 2: Zeeshka folded on the Turn
Seat 3: IvanUrgant folded before Flop (didn't bet)
Seat 4: GriffinBerg collected ($7.32)
Seat 5: Moszes360 folded before Flop (didn't bet)
Seat 6: whalldo folded before Flop (didn't bet)
Seat 7: matiko09 folded before Flop (didn't bet)
Seat 8: dndngod (button) folded before Flop (didn't bet)
Seat 9: CvMCvMCvM (small blind) folded before Flop





PokerStars Hand #150800197607:  Hold'em No Limit ($0.25/$0.50 USD) - 2016/03/23 13:56:57 CET [2016/03/23 8:56:57 ET]
Table 'Belnika' 9-max Seat #3 is the button
Seat 1: yellowfever0 ($18.19 in chips) 
Seat 2: NeverRegret7 ($55.14 in chips) 
Seat 3: ChiChioChi ($78.09 in chips) 
Seat 4: matiko09 ($65.60 in chips) 
Seat 5: IvanUrgant ($50.75 in chips) 
Seat 6: Ahangama ($56.75 in chips) 
Seat 7: Zeeshka ($50 in chips) 
Seat 8: lumen21 ($63.47 in chips) 
Seat 9: dndngod ($61.16 in chips) 
matiko09: posts small blind $0.25
IvanUrgant: posts big blind $0.50
*** HOLE CARDS ***
Dealt to matiko09 [Qs 9d]
Ahangama: folds 
Zeeshka: folds 
lumen21: folds 
dndngod: raises $1 to $1.50
yellowfever0: calls $1.50
NeverRegret7: calls $1.50
ChiChioChi: folds 
matiko09: folds 
IvanUrgant: folds 
*** FLOP *** [5c 3h 2h]
dndngod: checks 
yellowfever0: bets $2.50
NeverRegret7: calls $2.50
dndngod: folds 
*** TURN *** [5c 3h 2h] [5d]
yellowfever0: checks 
NeverRegret7: checks 
*** RIVER *** [5c 3h 2h 5d] [9c]
yellowfever0: checks 
NeverRegret7: checks 
*** SHOW DOWN ***
yellowfever0: shows [4s Js] (a pair of Fives)
NeverRegret7: shows [Ac Kh] (a pair of Fives - Ace kicker)
NeverRegret7 collected $9.79 from pot
*** SUMMARY ***
Total pot $10.25 | Rake $0.46 
Board [5c 3h 2h 5d 9c]
Seat 1: yellowfever0 showed [4s Js] and lost with a pair of Fives
Seat 2: NeverRegret7 showed [Ac Kh] and won ($9.79) with a pair of Fives
Seat 3: ChiChioChi (button) folded before Flop (didn't bet)
Seat 4: matiko09 (small blind) folded before Flop
Seat 5: IvanUrgant (big blind) folded before Flop
Seat 6: Ahangama folded before Flop (didn't bet)
Seat 7: Zeeshka folded before Flop (didn't bet)
Seat 8: lumen21 folded before Flop (didn't bet)
Seat 9: dndngod folded on the Flop





PokerStars Hand #150800201192:  Hold'em No Limit ($0.50/$1.00 USD) - 2016/03/23 13:57:04 CET [2016/03/23 8:57:04 ET]
Table 'Atlantis' 9-max Seat #1 is the button
Seat 1: xHourglass ($154.28 in chips) 
Seat 2: tffff2006 ($44.92 in chips) 
Seat 3: CAJUN890 ($115.79 in chips) 
Seat 4: matiko09 ($118.45 in chips) 
Seat 5: Pvsx. ($100 in chips) 
Seat 6: Jimy Tiltman ($132.31 in chips) 
Seat 7: Zeeshka ($108.32 in chips) 
Seat 8: DUkalisUA ($107.05 in chips) 
tffff2006: posts small blind $0.50
CAJUN890: posts big blind $1
RICKA16: sits out 
*** HOLE CARDS ***
Dealt to matiko09 [4s 3c]
matiko09: folds 
Pvsx.: folds 
Jimy Tiltman: raises $2 to $3
Zeeshka: folds 
DUkalisUA: folds 
xHourglass: folds 
tffff2006: folds 
CAJUN890: folds 
Uncalled bet ($2) returned to Jimy Tiltman
Jimy Tiltman collected $2.50 from pot
Jimy Tiltman: doesn't show hand 
*** SUMMARY ***
Total pot $2.50 | Rake $0 
Seat 1: xHourglass (button) folded before Flop (didn't bet)
Seat 2: tffff2006 (small blind) folded before Flop
Seat 3: CAJUN890 (big blind) folded before Flop
Seat 4: matiko09 folded before Flop (didn't bet)
Seat 5: Pvsx. folded before Flop (didn't bet)
Seat 6: Jimy Tiltman collected ($2.50)
Seat 7: Zeeshka folded before Flop (didn't bet)
Seat 8: DUkalisUA folded before Flop (didn't bet)





PokerStars Hand #150800202694:  Hold'em No Limit ($1/$2 USD) - 2016/03/23 13:57:07 CET [2016/03/23 8:57:07 ET]
Table 'Alma II' 9-max Seat #8 is the button
Seat 1: berggren ($219.75 in chips) 
Seat 2: glanza_mike ($200 in chips) 
Seat 4: daniferdoser ($201.78 in chips) 
Seat 5: dah44 ($208.10 in chips) 
Seat 6: InsomniaRU ($200 in chips) 
Seat 7: cliffdogz ($173 in chips) 
Seat 8: matiko09 ($206 in chips) 
Seat 9: carflam7 ($158 in chips) 
carflam7: posts small blind $1
berggren: posts big blind $2
*** HOLE CARDS ***
Dealt to matiko09 [4h Ac]
glanza_mike: folds 
daniferdoser: folds 
dah44: folds 
InsomniaRU: folds 
cliffdogz: raises $3.60 to $5.60
matiko09: folds 
carflam7: folds 
berggren: folds 
Uncalled bet ($3.60) returned to cliffdogz
cliffdogz collected $5 from pot
*** SUMMARY ***
Total pot $5 | Rake $0 
Seat 1: berggren (big blind) folded before Flop
Seat 2: glanza_mike folded before Flop (didn't bet)
Seat 4: daniferdoser folded before Flop (didn't bet)
Seat 5: dah44 folded before Flop (didn't bet)
Seat 6: InsomniaRU folded before Flop (didn't bet)
Seat 7: cliffdogz collected ($5)
Seat 8: matiko09 (button) folded before Flop (didn't bet)
Seat 9: carflam7 (small blind) folded before Flop





PokerStars Hand #150800203559:  Hold'em No Limit ($1/$2 USD) - 2016/03/23 13:57:09 CET [2016/03/23 8:57:09 ET]
Table 'Berbericia II' 9-max Seat #2 is the button
Seat 1: daniferdoser ($200 in chips) 
Seat 2: Moszes360 ($233.52 in chips) 
Seat 3: Fish4trips ($210.02 in chips) 
Seat 4: bennetb77 ($94.87 in chips) 
Seat 5: darren1031 ($233.54 in chips) 
Seat 6: Charity86 ($170.38 in chips) 
Seat 8: matiko09 ($297.51 in chips) 
Seat 9: B@ngel ($200 in chips) 
Fish4trips: posts small blind $1
bennetb77: posts big blind $2
*** HOLE CARDS ***
Dealt to matiko09 [Tc 6s]
darren1031: folds 
Charity86: folds 
matiko09: folds 
B@ngel: folds 
daniferdoser: raises $2 to $4
Moszes360: folds 
Fish4trips: folds 
bennetb77: folds 
Uncalled bet ($2) returned to daniferdoser
daniferdoser collected $5 from pot
daniferdoser: doesn't show hand 
*** SUMMARY ***
Total pot $5 | Rake $0 
Seat 1: daniferdoser collected ($5)
Seat 2: Moszes360 (button) folded before Flop (didn't bet)
Seat 3: Fish4trips (small blind) folded before Flop
Seat 4: bennetb77 (big blind) folded before Flop
Seat 5: darren1031 folded before Flop (didn't bet)
Seat 6: Charity86 folded before Flop (didn't bet)
Seat 8: matiko09 folded before Flop (didn't bet)
Seat 9: B@ngel folded before Flop (didn't bet)





PokerStars Hand #150800203522:  Hold'em No Limit (€0.25/€0.50 EUR) - 2016/03/23 13:57:09 CET [2016/03/23 8:57:09 ET]
Table 'Hesperia II' 9-max Seat #3 is the button
Seat 1: CAJUN890 (€55.08 in chips) 
Seat 2: dndngod (€54.14 in chips) 
Seat 3: IvanUrgant (€57.05 in chips) 
Seat 4: Zelenis (€14.15 in chips) 
Seat 6: CvMCvMCvM (€50 in chips) 
Seat 7: matiko09 (€59.48 in chips) 
Seat 8: Ahangama (€58.04 in chips) 
Seat 9: Red_Warning (€50 in chips) 
Zelenis: posts small blind €0.25
Avrora-sp: is sitting out 
CvMCvMCvM: posts big blind €0.50
*** HOLE CARDS ***
Dealt to matiko09 [2d Kd]
matiko09: folds 
Ahangama: folds 
Red_Warning: folds 
CAJUN890: folds 
dndngod: folds 
IvanUrgant: folds 
Zelenis: folds 
Uncalled bet (€0.25) returned to CvMCvMCvM
CvMCvMCvM collected €0.50 from pot
CvMCvMCvM: doesn't show hand 
*** SUMMARY ***
Total pot €0.50 | Rake €0 
Seat 1: CAJUN890 folded before Flop (didn't bet)
Seat 2: dndngod folded before Flop (didn't bet)
Seat 3: IvanUrgant (button) folded before Flop (didn't bet)
Seat 4: Zelenis (small blind) folded before Flop
Seat 6: CvMCvMCvM (big blind) collected (€0.50)
Seat 7: matiko09 folded before Flop (didn't bet)
Seat 8: Ahangama folded before Flop (didn't bet)
Seat 9: Red_Warning folded before Flop (didn't bet)





PokerStars Hand #150800206847:  Hold'em No Limit ($0.50/$1.00 USD) - 2016/03/23 13:57:15 CET [2016/03/23 8:57:15 ET]
Table 'Kippes' 9-max Seat #2 is the button
Seat 1: Pvsx. ($118.81 in chips) 
Seat 2: RICKA16 ($128.63 in chips) 
Seat 3: CAJUN890 ($123.97 in chips) 
Seat 4: matiko09 ($100 in chips) 
Seat 5: Jimy Tiltman ($118.36 in chips) 
Seat 6: WDW3 ($116.57 in chips) 
Seat 7: lumen21 ($115.02 in chips) 
Seat 8: Zeeshka ($110.30 in chips) 
Seat 9: wang19790906 ($81.92 in chips) 
CAJUN890: posts small blind $0.50
matiko09: posts big blind $1
*** HOLE CARDS ***
Dealt to matiko09 [Jh 5s]
Jimy Tiltman: folds 
WDW3: folds 
lumen21: folds 
Zeeshka: folds 
wang19790906: folds 
Pvsx.: raises $1.50 to $2.50
RICKA16: folds 
CAJUN890: folds 
matiko09: folds 
Uncalled bet ($1.50) returned to Pvsx.
Pvsx. collected $2.50 from pot
Pvsx.: doesn't show hand 
*** SUMMARY ***
Total pot $2.50 | Rake $0 
Seat 1: Pvsx. collected ($2.50)
Seat 2: RICKA16 (button) folded before Flop (didn't bet)
Seat 3: CAJUN890 (small blind) folded before Flop
Seat 4: matiko09 (big blind) folded before Flop
Seat 5: Jimy Tiltman folded before Flop (didn't bet)
Seat 6: WDW3 folded before Flop (didn't bet)
Seat 7: lumen21 folded before Flop (didn't bet)
Seat 8: Zeeshka folded before Flop (didn't bet)
Seat 9: wang19790906 folded before Flop (didn't bet)





PokerStars Hand #150800208559:  Hold'em No Limit ($0.50/$1.00 USD) - 2016/03/23 13:57:19 CET [2016/03/23 8:57:19 ET]
Table 'Merope II' 9-max Seat #9 is the button
Seat 1: Jimy Tiltman ($107.71 in chips) 
Seat 2: Zeeshka ($101.50 in chips) 
Seat 3: Sherlockplay ($141.70 in chips) 
Seat 4: YuriiSolodya ($40 in chips) 
Seat 5: DUkalisUA ($100 in chips) 
Seat 7: matiko09 ($100 in chips) 
Seat 8: titentei ($95 in chips) 
Seat 9: RICKA16 ($99.50 in chips) 
Jimy Tiltman: posts small blind $0.50
Zeeshka: posts big blind $1
Effort92: sits out 
*** HOLE CARDS ***
Dealt to matiko09 [9h Kc]
Sherlockplay: folds 
YuriiSolodya: folds 
DUkalisUA: folds 
matiko09: folds 
titentei: folds 
RICKA16: folds 
Jimy Tiltman: raises $2 to $3
Zeeshka: calls $2
*** FLOP *** [2c Ad 4s]
Jimy Tiltman: bets $3.65
Zeeshka: folds 
Uncalled bet ($3.65) returned to Jimy Tiltman
Jimy Tiltman collected $5.73 from pot
Jimy Tiltman: doesn't show hand 
*** SUMMARY ***
Total pot $6 | Rake $0.27 
Board [2c Ad 4s]
Seat 1: Jimy Tiltman (small blind) collected ($5.73)
Seat 2: Zeeshka (big blind) folded on the Flop
Seat 3: Sherlockplay folded before Flop (didn't bet)
Seat 4: YuriiSolodya folded before Flop (didn't bet)
Seat 5: DUkalisUA folded before Flop (didn't bet)
Seat 7: matiko09 folded before Flop (didn't bet)
Seat 8: titentei folded before Flop (didn't bet)
Seat 9: RICKA16 (button) folded before Flop (didn't bet)





PokerStars Hand #150800210194:  Hold'em No Limit ($0.50/$1.00 USD) - 2016/03/23 13:57:22 CET [2016/03/23 8:57:22 ET]
Table 'Donar II' 9-max Seat #6 is the button
Seat 1: Effort92 ($113.52 in chips) 
Seat 2: nobrunobru1 ($72.67 in chips) 
Seat 3: st-germ30 ($96.80 in chips) 
Seat 4: DUkalisUA ($125.97 in chips) 
Seat 5: matiko09 ($100 in chips) 
Seat 6: ardo888 ($124.52 in chips) 
oxfordtenzin will be allowed to play after the button
Effort92: posts small blind $0.50
nobrunobru1: posts big blind $1
Effort92: posts the ante $0.20
nobrunobru1: posts the ante $0.20
st-germ30: posts the ante $0.20
DUkalisUA: posts the ante $0.20
matiko09: posts the ante $0.20
ardo888: posts the ante $0.20
*** HOLE CARDS ***
Dealt to matiko09 [2s 7s]
st-germ30: folds 
DUkalisUA: folds 
matiko09: folds 
ardo888: raises $1.50 to $2.50
Effort92: folds 
nobrunobru1: calls $1.50
*** FLOP *** [Jh 5c Td]
nobrunobru1: checks 
ardo888: bets $3.50
nobrunobru1: raises $3.50 to $7
ardo888: calls $3.50
*** TURN *** [Jh 5c Td] [9s]
nobrunobru1: bets $11
ardo888: folds 
Uncalled bet ($11) returned to nobrunobru1
nobrunobru1 collected $19.77 from pot
nobrunobru1: doesn't show hand 
*** SUMMARY ***
Total pot $20.70 | Rake $0.93 
Board [Jh 5c Td 9s]
Seat 1: Effort92 (small blind) folded before Flop
Seat 2: nobrunobru1 (big blind) collected ($19.77)
Seat 3: st-germ30 folded before Flop (didn't bet)
Seat 4: DUkalisUA folded before Flop (didn't bet)
Seat 5: matiko09 folded before Flop (didn't bet)
Seat 6: ardo888 (button) folded on the Turn





PokerStars Hand #150800211387:  Hold'em No Limit ($1/$2 USD) - 2016/03/23 13:57:24 CET [2016/03/23 8:57:24 ET]
Table 'Kypria II' 9-max Seat #1 is the button
Seat 1: geldwolfje ($154.42 in chips) 
Seat 2: coinflip_si ($200 in chips) 
Seat 3: seouljam ($212.45 in chips) 
Seat 4: nailz83 ($31.84 in chips) 
Seat 5: InsomniaRU ($372.62 in chips) 
Seat 6: matiko09 ($280.69 in chips) 
Seat 7: DUkalisUA ($200 in chips) 
Seat 8: Fish4trips ($334.19 in chips) 
coinflip_si: posts small blind $1
seouljam: posts big blind $2
Moszes360: sits out 
*** HOLE CARDS ***
Dealt to matiko09 [Tc 8h]
nailz83: folds 
InsomniaRU: folds 
matiko09: folds 
DUkalisUA: raises $4 to $6
Fish4trips: folds 
geldwolfje: folds 
coinflip_si: folds 
nailz83 leaves the table
seouljam: folds 
Uncalled bet ($4) returned to DUkalisUA
DUkalisUA collected $5 from pot
DUkalisUA: doesn't show hand 
*** SUMMARY ***
Total pot $5 | Rake $0 
Seat 1: geldwolfje (button) folded before Flop (didn't bet)
Seat 2: coinflip_si (small blind) folded before Flop
Seat 3: seouljam (big blind) folded before Flop
Seat 4: nailz83 folded before Flop (didn't bet)
Seat 5: InsomniaRU folded before Flop (didn't bet)
Seat 6: matiko09 folded before Flop (didn't bet)
Seat 7: DUkalisUA collected ($5)
Seat 8: Fish4trips folded before Flop (didn't bet)





PokerStars Hand #150800211518:  Hold'em No Limit ($1/$2 USD) - 2016/03/23 13:57:24 CET [2016/03/23 8:57:24 ET]
Table 'Kiess' 9-max Seat #2 is the button
Seat 1: Cirilico ($160.56 in chips) 
Seat 2: DUkalisUA ($689.92 in chips) 
Seat 4: Moszes360 ($207.77 in chips) 
Seat 5: chippo boy ($323.88 in chips) 
Seat 6: matiko09 ($288.84 in chips) 
Seat 7: InsomniaRU ($273.17 in chips) 
Seat 9: Fish4trips ($200 in chips) 
Moszes360: posts small blind $1
chippo boy: posts big blind $2
erfk1958: sits out 
*** HOLE CARDS ***
Dealt to matiko09 [4c Qd]
matiko09: folds 
InsomniaRU: folds 
Fish4trips: folds 
Cirilico: folds 
DUkalisUA: raises $2 to $4
Moszes360: folds 
chippo boy: calls $2
*** FLOP *** [6h 4s Ah]
chippo boy: checks 
DUkalisUA: bets $5
chippo boy: folds 
Uncalled bet ($5) returned to DUkalisUA
DUkalisUA collected $8.60 from pot
DUkalisUA: doesn't show hand 
*** SUMMARY ***
Total pot $9 | Rake $0.40 
Board [6h 4s Ah]
Seat 1: Cirilico folded before Flop (didn't bet)
Seat 2: DUkalisUA (button) collected ($8.60)
Seat 4: Moszes360 (small blind) folded before Flop
Seat 5: chippo boy (big blind) folded on the Flop
Seat 6: matiko09 folded before Flop (didn't bet)
Seat 7: InsomniaRU folded before Flop (didn't bet)
Seat 9: Fish4trips folded before Flop (didn't bet)





PokerStars Hand #150800212265:  Hold'em No Limit ($1/$2 USD) - 2016/03/23 13:57:26 CET [2016/03/23 8:57:26 ET]
Table 'Herba II' 9-max Seat #9 is the button
Seat 1: matiko09 ($221.48 in chips) 
Seat 2: Moszes360 ($200 in chips) 
Seat 3: Cirilico ($160 in chips) 
Seat 4: DUkalisUA ($289.08 in chips) 
Seat 5: chippo boy ($217.31 in chips) 
Seat 7: InsomniaRU ($203.42 in chips) 
Seat 9: mrhighryza ($69.55 in chips) 
matiko09: posts small blind $1
Moszes360: posts big blind $2
Too-Anti-To: sits out 
*** HOLE CARDS ***
Dealt to matiko09 [8h Td]
Cirilico: folds 
DUkalisUA: folds 
chippo boy: calls $2
InsomniaRU: raises $5 to $7
mrhighryza: folds 
matiko09: folds 
Moszes360: folds 
chippo boy: calls $5
*** FLOP *** [Kd 7c Jd]
chippo boy: checks 
InsomniaRU: checks 
*** TURN *** [Kd 7c Jd] [6c]
chippo boy: bets $8
InsomniaRU: folds 
Uncalled bet ($8) returned to chippo boy
chippo boy collected $16.24 from pot
*** SUMMARY ***
Total pot $17 | Rake $0.76 
Board [Kd 7c Jd 6c]
Seat 1: matiko09 (small blind) folded before Flop
Seat 2: Moszes360 (big blind) folded before Flop
Seat 3: Cirilico folded before Flop (didn't bet)
Seat 4: DUkalisUA folded before Flop (didn't bet)
Seat 5: chippo boy collected ($16.24)
Seat 7: InsomniaRU folded on the Turn
Seat 9: mrhighryza (button) folded before Flop (didn't bet)





PokerStars Hand #150800220313:  Hold'em No Limit ($0.50/$1.00 USD) - 2016/03/23 13:57:42 CET [2016/03/23 8:57:42 ET]
Table 'Atlantis' 9-max Seat #2 is the button
Seat 1: xHourglass ($154.28 in chips) 
Seat 2: tffff2006 ($44.42 in chips) 
Seat 3: CAJUN890 ($114.79 in chips) 
Seat 4: matiko09 ($118.45 in chips) 
Seat 5: Pvsx. ($100 in chips) 
Seat 6: Jimy Tiltman ($133.81 in chips) 
Seat 7: Zeeshka ($108.32 in chips) 
Seat 8: DUkalisUA ($107.05 in chips) 
CAJUN890: posts small blind $0.50
matiko09: posts big blind $1
RICKA16: sits out 
*** HOLE CARDS ***
Dealt to matiko09 [7d 5h]
Pvsx.: folds 
Jimy Tiltman: folds 
Zeeshka: folds 
DUkalisUA: folds 
xHourglass: folds 
tffff2006: raises $2 to $3
CAJUN890: calls $2.50
matiko09: folds 
*** FLOP *** [Qh 8c Js]
CAJUN890: bets $3
tffff2006: raises $3 to $6
CAJUN890: folds 
Uncalled bet ($3) returned to tffff2006
tffff2006 collected $12.42 from pot
tffff2006: doesn't show hand 
*** SUMMARY ***
Total pot $13 | Rake $0.58 
Board [Qh 8c Js]
Seat 1: xHourglass folded before Flop (didn't bet)
Seat 2: tffff2006 (button) collected ($12.42)
Seat 3: CAJUN890 (small blind) folded on the Flop
Seat 4: matiko09 (big blind) folded before Flop
Seat 5: Pvsx. folded before Flop (didn't bet)
Seat 6: Jimy Tiltman folded before Flop (didn't bet)
Seat 7: Zeeshka folded before Flop (didn't bet)
Seat 8: DUkalisUA folded before Flop (didn't bet)





PokerStars Hand #150800223428:  Hold'em No Limit ($1/$2 USD) - 2016/03/23 13:57:47 CET [2016/03/23 8:57:47 ET]
Table 'Berbericia II' 9-max Seat #3 is the button
Seat 1: daniferdoser ($203 in chips) 
Seat 2: Moszes360 ($233.52 in chips) 
Seat 3: Fish4trips ($209.02 in chips) 
Seat 4: bennetb77 ($92.87 in chips) 
Seat 5: darren1031 ($233.54 in chips) 
Seat 6: Charity86 ($170.38 in chips) 
Seat 8: matiko09 ($297.51 in chips) 
Seat 9: B@ngel ($200 in chips) 
bennetb77: posts small blind $1
darren1031: posts big blind $2
*** HOLE CARDS ***
Dealt to matiko09 [Ac 3s]
Charity86: folds 
matiko09: folds 
B@ngel: folds 
daniferdoser: folds 
Moszes360: folds 
Fish4trips: raises $2 to $4
bennetb77: folds 
darren1031: calls $2
*** FLOP *** [7h 4s Jd]
darren1031: checks 
Fish4trips: bets $5.42
darren1031: calls $5.42
*** TURN *** [7h 4s Jd] [Kh]
darren1031: checks 
Fish4trips: bets $13
darren1031: calls $13
*** RIVER *** [7h 4s Jd Kh] [Kd]
darren1031: checks 
Fish4trips: checks 
*** SHOW DOWN ***
darren1031: shows [7d 8c] (two pair, Kings and Sevens)
Fish4trips: mucks hand 
darren1031 collected $43.78 from pot
*** SUMMARY ***
Total pot $45.84 | Rake $2.06 
Board [7h 4s Jd Kh Kd]
Seat 1: daniferdoser folded before Flop (didn't bet)
Seat 2: Moszes360 folded before Flop (didn't bet)
Seat 3: Fish4trips (button) mucked [Qh 9s]
Seat 4: bennetb77 (small blind) folded before Flop
Seat 5: darren1031 (big blind) showed [7d 8c] and won ($43.78) with two pair, Kings and Sevens
Seat 6: Charity86 folded before Flop (didn't bet)
Seat 8: matiko09 folded before Flop (didn't bet)
Seat 9: B@ngel folded before Flop (didn't bet)





PokerStars Hand #150800224496:  Hold'em No Limit ($1/$2 USD) - 2016/03/23 13:57:49 CET [2016/03/23 8:57:49 ET]
Table 'Kypria II' 9-max Seat #2 is the button
Seat 1: geldwolfje ($154.42 in chips) 
Seat 2: coinflip_si ($200 in chips) 
Seat 3: seouljam ($210.45 in chips) 
Seat 5: InsomniaRU ($372.62 in chips) 
Seat 6: matiko09 ($280.69 in chips) 
Seat 7: DUkalisUA ($203 in chips) 
Seat 8: Fish4trips ($334.19 in chips) 
seouljam: posts small blind $1
InsomniaRU: posts big blind $2
Moszes360: sits out 
*** HOLE CARDS ***
Dealt to matiko09 [Qh 4s]
matiko09: folds 
DUkalisUA: folds 
Fish4trips: folds 
geldwolfje: raises $4 to $6
coinflip_si: folds 
seouljam: folds 
InsomniaRU: folds 
Uncalled bet ($4) returned to geldwolfje
geldwolfje collected $5 from pot
geldwolfje: doesn't show hand 
*** SUMMARY ***
Total pot $5 | Rake $0 
Seat 1: geldwolfje collected ($5)
Seat 2: coinflip_si (button) folded before Flop (didn't bet)
Seat 3: seouljam (small blind) folded before Flop
Seat 5: InsomniaRU (big blind) folded before Flop
Seat 6: matiko09 folded before Flop (didn't bet)
Seat 7: DUkalisUA folded before Flop (didn't bet)
Seat 8: Fish4trips folded before Flop (didn't bet)





PokerStars Hand #150800226573:  Hold'em No Limit ($1/$2 USD) - 2016/03/23 13:57:54 CET [2016/03/23 8:57:54 ET]
Table 'Kiess' 9-max Seat #4 is the button
Seat 1: Cirilico ($160.56 in chips) 
Seat 2: DUkalisUA ($694.52 in chips) 
Seat 4: Moszes360 ($206.77 in chips) 
Seat 5: chippo boy ($319.88 in chips) 
Seat 6: matiko09 ($288.84 in chips) 
Seat 7: InsomniaRU ($273.17 in chips) 
Seat 9: Fish4trips ($200 in chips) 
chippo boy: posts small blind $1
matiko09: posts big blind $2
erfk1958: sits out 
*** HOLE CARDS ***
Dealt to matiko09 [5s 2d]
InsomniaRU: folds 
Fish4trips: folds 
Cirilico: raises $4 to $6
DUkalisUA: folds 
Moszes360: folds 
chippo boy: folds 
matiko09: folds 
Uncalled bet ($4) returned to Cirilico
Cirilico collected $5 from pot
Cirilico: doesn't show hand 
*** SUMMARY ***
Total pot $5 | Rake $0 
Seat 1: Cirilico collected ($5)
Seat 2: DUkalisUA folded before Flop (didn't bet)
Seat 4: Moszes360 (button) folded before Flop (didn't bet)
Seat 5: chippo boy (small blind) folded before Flop
Seat 6: matiko09 (big blind) folded before Flop
Seat 7: InsomniaRU folded before Flop (didn't bet)
Seat 9: Fish4trips folded before Flop (didn't bet)





PokerStars Hand #150800226897:  Hold'em No Limit ($1/$2 USD) - 2016/03/23 13:57:54 CET [2016/03/23 8:57:54 ET]
Table 'Alma II' 9-max Seat #9 is the button
Seat 1: berggren ($217.75 in chips) 
Seat 2: glanza_mike ($200 in chips) 
Seat 4: daniferdoser ($201.78 in chips) 
Seat 5: dah44 ($208.10 in chips) 
Seat 6: InsomniaRU ($200 in chips) 
Seat 7: cliffdogz ($176 in chips) 
Seat 8: matiko09 ($206 in chips) 
Seat 9: carflam7 ($157 in chips) 
berggren: posts small blind $1
glanza_mike: posts big blind $2
*** HOLE CARDS ***
Dealt to matiko09 [Kc Jd]
daniferdoser: folds 
dah44 is disconnected 
dah44 is connected 
dah44: folds 
InsomniaRU: folds 
cliffdogz: folds 
matiko09: raises $3 to $5
carflam7: folds 
berggren: folds 
glanza_mike: folds 
Uncalled bet ($3) returned to matiko09
matiko09 collected $5 from pot
matiko09: doesn't show hand 
*** SUMMARY ***
Total pot $5 | Rake $0 
Seat 1: berggren (small blind) folded before Flop
Seat 2: glanza_mike (big blind) folded before Flop
Seat 4: daniferdoser folded before Flop (didn't bet)
Seat 5: dah44 folded before Flop (didn't bet)
Seat 6: InsomniaRU folded before Flop (didn't bet)
Seat 7: cliffdogz folded before Flop (didn't bet)
Seat 8: matiko09 collected ($5)
Seat 9: carflam7 (button) folded before Flop (didn't bet)





PokerStars Hand #150800229250:  Hold'em No Limit ($0.50/$1.00 USD) - 2016/03/23 13:57:59 CET [2016/03/23 8:57:59 ET]
Table 'Kippes' 9-max Seat #3 is the button
Seat 1: Pvsx. ($120.31 in chips) 
Seat 2: RICKA16 ($128.63 in chips) 
Seat 3: CAJUN890 ($123.47 in chips) 
Seat 4: matiko09 ($100 in chips) 
Seat 5: Jimy Tiltman ($118.36 in chips) 
Seat 6: WDW3 ($116.57 in chips) 
Seat 7: lumen21 ($115.02 in chips) 
Seat 8: Zeeshka ($110.30 in chips) 
Seat 9: wang19790906 ($81.92 in chips) 
matiko09: posts small blind $0.50
Jimy Tiltman: posts big blind $1
*** HOLE CARDS ***
Dealt to matiko09 [7s Jc]
WDW3: folds 
lumen21: folds 
WDW3 leaves the table
DUkalisUA joins the table at seat #6 
Zeeshka: folds 
wang19790906: folds 
Pvsx.: folds 
RICKA16: raises $2 to $3
CAJUN890: folds 
matiko09: folds 
Jimy Tiltman: folds 
Uncalled bet ($2) returned to RICKA16
RICKA16 collected $2.50 from pot
RICKA16: doesn't show hand 
*** SUMMARY ***
Total pot $2.50 | Rake $0 
Seat 1: Pvsx. folded before Flop (didn't bet)
Seat 2: RICKA16 collected ($2.50)
Seat 3: CAJUN890 (button) folded before Flop (didn't bet)
Seat 4: matiko09 (small blind) folded before Flop
Seat 5: Jimy Tiltman (big blind) folded before Flop
Seat 6: WDW3 folded before Flop (didn't bet)
Seat 7: lumen21 folded before Flop (didn't bet)
Seat 8: Zeeshka folded before Flop (didn't bet)
Seat 9: wang19790906 folded before Flop (didn't bet)





PokerStars Hand #150800231362:  Hold'em No Limit ($0.25/$0.50 USD) - 2016/03/23 13:58:03 CET [2016/03/23 8:58:03 ET]
Table 'Belnika' 9-max Seat #4 is the button
Seat 1: yellowfever0 ($14.19 in chips) 
Seat 2: NeverRegret7 ($60.93 in chips) 
Seat 3: ChiChioChi ($78.09 in chips) 
Seat 4: matiko09 ($65.35 in chips) 
Seat 5: IvanUrgant ($50.25 in chips) 
Seat 6: Ahangama ($56.75 in chips) 
Seat 7: Zeeshka ($50 in chips) 
Seat 8: lumen21 ($63.47 in chips) 
Seat 9: dndngod ($59.66 in chips) 
IvanUrgant: posts small blind $0.25
Ahangama: posts big blind $0.50
*** HOLE CARDS ***
Dealt to matiko09 [7h Qd]
Zeeshka: folds 
lumen21: folds 
dndngod: folds 
yellowfever0 has timed out
yellowfever0: folds 
NeverRegret7: folds 
ChiChioChi: folds 
matiko09: folds 
IvanUrgant: folds 
Uncalled bet ($0.25) returned to Ahangama
Ahangama collected $0.50 from pot
Ahangama: doesn't show hand 
*** SUMMARY ***
Total pot $0.50 | Rake $0 
Seat 1: yellowfever0 folded before Flop (didn't bet)
Seat 2: NeverRegret7 folded before Flop (didn't bet)
Seat 3: ChiChioChi folded before Flop (didn't bet)
Seat 4: matiko09 (button) folded before Flop (didn't bet)
Seat 5: IvanUrgant (small blind) folded before Flop
Seat 6: Ahangama (big blind) collected ($0.50)
Seat 7: Zeeshka folded before Flop (didn't bet)
Seat 8: lumen21 folded before Flop (didn't bet)
Seat 9: dndngod folded before Flop (didn't bet)





PokerStars Hand #150800234273:  Hold'em No Limit ($0.50/$1.00 USD) - 2016/03/23 13:58:09 CET [2016/03/23 8:58:09 ET]
Table 'Donar II' 9-max Seat #1 is the button
Seat 1: Effort92 ($112.82 in chips) 
Seat 2: nobrunobru1 ($82.74 in chips) 
Seat 3: st-germ30 ($96.60 in chips) 
Seat 4: DUkalisUA ($125.77 in chips) 
Seat 5: matiko09 ($100 in chips) 
Seat 6: ardo888 ($114.82 in chips) 
nobrunobru1: posts small blind $0.50
st-germ30: posts big blind $1
oxfordtenzin: sits out 
Effort92: posts the ante $0.20
nobrunobru1: posts the ante $0.20
st-germ30: posts the ante $0.20
DUkalisUA: posts the ante $0.20
matiko09: posts the ante $0.20
ardo888: posts the ante $0.20
*** HOLE CARDS ***
Dealt to matiko09 [2d 5h]
DUkalisUA: folds 
matiko09: folds 
ardo888: folds 
Effort92: folds 
nobrunobru1: raises $2 to $3
st-germ30: folds 
Uncalled bet ($2) returned to nobrunobru1
nobrunobru1 collected $3.20 from pot
nobrunobru1: doesn't show hand 
*** SUMMARY ***
Total pot $3.20 | Rake $0 
Seat 1: Effort92 (button) folded before Flop (didn't bet)
Seat 2: nobrunobru1 (small blind) collected ($3.20)
Seat 3: st-germ30 (big blind) folded before Flop
Seat 4: DUkalisUA folded before Flop (didn't bet)
Seat 5: matiko09 folded before Flop (didn't bet)
Seat 6: ardo888 folded before Flop (didn't bet)





PokerStars Hand #150800235652:  Hold'em No Limit ($0.25/$0.50 USD) - 2016/03/23 13:58:11 CET [2016/03/23 8:58:11 ET]
Table 'Pyrrhus' 9-max Seat #9 is the button
Seat 1: lumen21 ($50 in chips) 
Seat 2: Zeeshka ($50 in chips) 
Seat 3: IvanUrgant ($83.12 in chips) 
Seat 4: GriffinBerg ($28.50 in chips) 
Seat 5: Moszes360 ($61 in chips) 
Seat 6: whalldo ($169.37 in chips) 
Seat 7: matiko09 ($137.44 in chips) 
Seat 8: dndngod ($59.48 in chips) 
Seat 9: CvMCvMCvM ($113.11 in chips) 
lumen21: posts small blind $0.25
Zeeshka: posts big blind $0.50
*** HOLE CARDS ***
Dealt to matiko09 [Qh 9c]
IvanUrgant: folds 
GriffinBerg: folds 
Moszes360: folds 
whalldo: folds 
matiko09: folds 
dndngod: folds 
CvMCvMCvM: raises $0.76 to $1.26
lumen21: folds 
Zeeshka: folds 
Uncalled bet ($0.76) returned to CvMCvMCvM
CvMCvMCvM collected $1.25 from pot
CvMCvMCvM: doesn't show hand 
*** SUMMARY ***
Total pot $1.25 | Rake $0 
Seat 1: lumen21 (small blind) folded before Flop
Seat 2: Zeeshka (big blind) folded before Flop
Seat 3: IvanUrgant folded before Flop (didn't bet)
Seat 4: GriffinBerg folded before Flop (didn't bet)
Seat 5: Moszes360 folded before Flop (didn't bet)
Seat 6: whalldo folded before Flop (didn't bet)
Seat 7: matiko09 folded before Flop (didn't bet)
Seat 8: dndngod folded before Flop (didn't bet)
Seat 9: CvMCvMCvM (button) collected ($1.25)





PokerStars Hand #150800237034:  Hold'em No Limit ($0.50/$1.00 USD) - 2016/03/23 13:58:14 CET [2016/03/23 8:58:14 ET]
Table 'Smiley' 9-max Seat #6 is the button
Seat 2: Jimy Tiltman ($100 in chips) 
Seat 3: matiko09 ($100 in chips) 
Seat 4: Zeeshka ($162.91 in chips) 
Seat 5: DUkalisUA ($192.20 in chips) 
Seat 6: blackmont111 ($110.30 in chips) 
Seat 7: Moszes360 ($100 in chips) 
Seat 8: momtscheto ($50 in chips) 
Moszes360: posts small blind $0.50
momtscheto: posts big blind $1
Pvsx.: sits out 
xHourglass: sits out 
*** HOLE CARDS ***
Dealt to matiko09 [3s 6d]
Jimy Tiltman: folds 
matiko09: folds 
Zeeshka: raises $2 to $3
DUkalisUA: folds 
blackmont111: folds 
Moszes360: folds 
momtscheto: calls $2
*** FLOP *** [8d 7s 6h]
momtscheto: checks 
Zeeshka: checks 
*** TURN *** [8d 7s 6h] [8h]
momtscheto: bets $3.10
Zeeshka: calls $3.10
*** RIVER *** [8d 7s 6h 8h] [4s]
momtscheto: bets $11
Zeeshka: folds 
Uncalled bet ($11) returned to momtscheto
momtscheto collected $12.13 from pot
*** SUMMARY ***
Total pot $12.70 | Rake $0.57 
Board [8d 7s 6h 8h 4s]
Seat 2: Jimy Tiltman folded before Flop (didn't bet)
Seat 3: matiko09 folded before Flop (didn't bet)
Seat 4: Zeeshka folded on the River
Seat 5: DUkalisUA folded before Flop (didn't bet)
Seat 6: blackmont111 (button) folded before Flop (didn't bet)
Seat 7: Moszes360 (small blind) folded before Flop
Seat 8: momtscheto (big blind) collected ($12.13)





PokerStars Hand #150800238491:  Hold'em No Limit ($1/$2 USD) - 2016/03/23 13:58:17 CET [2016/03/23 8:58:17 ET]
Table 'Kiess' 9-max Seat #5 is the button
Seat 1: Cirilico ($163.56 in chips) 
Seat 2: DUkalisUA ($694.52 in chips) 
Seat 4: Moszes360 ($206.77 in chips) 
Seat 5: chippo boy ($318.88 in chips) 
Seat 6: matiko09 ($286.84 in chips) 
Seat 7: InsomniaRU ($273.17 in chips) 
Seat 9: Fish4trips ($200 in chips) 
matiko09: posts small blind $1
InsomniaRU: posts big blind $2
erfk1958: sits out 
*** HOLE CARDS ***
Dealt to matiko09 [2h 7d]
Fish4trips: folds 
Cirilico: folds 
DUkalisUA: folds 
Moszes360: folds 
chippo boy: folds 
matiko09: folds 
Uncalled bet ($1) returned to InsomniaRU
InsomniaRU collected $2 from pot
InsomniaRU: doesn't show hand 
*** SUMMARY ***
Total pot $2 | Rake $0 
Seat 1: Cirilico folded before Flop (didn't bet)
Seat 2: DUkalisUA folded before Flop (didn't bet)
Seat 4: Moszes360 folded before Flop (didn't bet)
Seat 5: chippo boy (button) folded before Flop (didn't bet)
Seat 6: matiko09 (small blind) folded before Flop
Seat 7: InsomniaRU (big blind) collected ($2)
Seat 9: Fish4trips folded before Flop (didn't bet)





PokerStars Hand #150800239420:  Hold'em No Limit ($1/$2 USD) - 2016/03/23 13:58:19 CET [2016/03/23 8:58:19 ET]
Table 'Kypria II' 9-max Seat #3 is the button
Seat 1: geldwolfje ($157.42 in chips) 
Seat 2: coinflip_si ($200 in chips) 
Seat 3: seouljam ($209.45 in chips) 
Seat 5: InsomniaRU ($370.62 in chips) 
Seat 6: matiko09 ($280.69 in chips) 
Seat 7: DUkalisUA ($203 in chips) 
Seat 8: Fish4trips ($334.19 in chips) 
InsomniaRU: posts small blind $1
matiko09: posts big blind $2
Moszes360: sits out 
*** HOLE CARDS ***
Dealt to matiko09 [As 3d]
DUkalisUA: folds 
Fish4trips: folds 
geldwolfje: raises $4 to $6
coinflip_si: folds 
VolanDog joins the table at seat #4 
seouljam: calls $6
InsomniaRU: raises $16 to $22
matiko09: folds 
geldwolfje: calls $16
seouljam: folds 
*** FLOP *** [Jd 6s 8d]
InsomniaRU: bets $33.10
geldwolfje: folds 
Uncalled bet ($33.10) returned to InsomniaRU
InsomniaRU collected $49.66 from pot
InsomniaRU: doesn't show hand 
*** SUMMARY ***
Total pot $52 | Rake $2.34 
Board [Jd 6s 8d]
Seat 1: geldwolfje folded on the Flop
Seat 2: coinflip_si folded before Flop (didn't bet)
Seat 3: seouljam (button) folded before Flop
Seat 5: InsomniaRU (small blind) collected ($49.66)
Seat 6: matiko09 (big blind) folded before Flop
Seat 7: DUkalisUA folded before Flop (didn't bet)
Seat 8: Fish4trips folded before Flop (didn't bet)





PokerStars Hand #150800242726:  Hold'em No Limit ($0.50/$1.00 USD) - 2016/03/23 13:58:25 CET [2016/03/23 8:58:25 ET]
Table 'Merope II' 9-max Seat #1 is the button
Seat 1: Jimy Tiltman ($110.44 in chips) 
Seat 2: Zeeshka ($100 in chips) 
Seat 3: Sherlockplay ($141.70 in chips) 
Seat 4: YuriiSolodya ($40 in chips) 
Seat 5: DUkalisUA ($100 in chips) 
Seat 7: matiko09 ($100 in chips) 
Seat 8: titentei ($95 in chips) 
Seat 9: RICKA16 ($99.50 in chips) 
Zeeshka: posts small blind $0.50
Sherlockplay: posts big blind $1
Effort92: sits out 
*** HOLE CARDS ***
Dealt to matiko09 [9h Jc]
YuriiSolodya: folds 
DUkalisUA: folds 
matiko09: folds 
titentei: folds 
RICKA16: folds 
Jimy Tiltman: folds 
Zeeshka: folds 
Uncalled bet ($0.50) returned to Sherlockplay
Sherlockplay collected $1 from pot
Sherlockplay: doesn't show hand 
*** SUMMARY ***
Total pot $1 | Rake $0 
Seat 1: Jimy Tiltman (button) folded before Flop (didn't bet)
Seat 2: Zeeshka (small blind) folded before Flop
Seat 3: Sherlockplay (big blind) collected ($1)
Seat 4: YuriiSolodya folded before Flop (didn't bet)
Seat 5: DUkalisUA folded before Flop (didn't bet)
Seat 7: matiko09 folded before Flop (didn't bet)
Seat 8: titentei folded before Flop (didn't bet)
Seat 9: RICKA16 folded before Flop (didn't bet)





PokerStars Hand #150800248267:  Hold'em No Limit ($0.25/$0.50 USD) - 2016/03/23 13:58:36 CET [2016/03/23 8:58:36 ET]
Table 'Pyrrhus' 9-max Seat #1 is the button
Seat 1: lumen21 ($50 in chips) 
Seat 2: Zeeshka ($50 in chips) 
Seat 3: IvanUrgant ($83.12 in chips) 
Seat 4: GriffinBerg ($28.50 in chips) 
Seat 5: Moszes360 ($61 in chips) 
Seat 6: whalldo ($169.37 in chips) 
Seat 7: matiko09 ($137.44 in chips) 
Seat 8: dndngod ($59.48 in chips) 
Seat 9: CvMCvMCvM ($113.86 in chips) 
Zeeshka: posts small blind $0.25
IvanUrgant: posts big blind $0.50
*** HOLE CARDS ***
Dealt to matiko09 [2d 6s]
GriffinBerg: folds 
Moszes360: folds 
whalldo has timed out
whalldo: folds 
whalldo leaves the table
matiko09: folds 
Ahangama joins the table at seat #6 
dndngod: raises $1 to $1.50
CvMCvMCvM: folds 
lumen21: folds 
Zeeshka: raises $3.45 to $4.95
IvanUrgant: folds 
dndngod: raises $5.55 to $10.50
Zeeshka: raises $39.50 to $50 and is all-in
dndngod: calls $39.50
*** FIRST FLOP *** [9s 8h 9h]
*** FIRST TURN *** [9s 8h 9h] [Jh]
*** FIRST RIVER *** [9s 8h 9h Jh] [Ks]
*** SECOND FLOP *** [Ad Qc 2c]
*** SECOND TURN *** [Ad Qc 2c] [3s]
*** SECOND RIVER *** [Ad Qc 2c 3s] [8d]
*** FIRST SHOW DOWN ***
Zeeshka: shows [As Kd] (two pair, Kings and Nines)
dndngod: shows [Kh Ah] (a flush, Ace high)
dndngod collected $49 from pot
*** SECOND SHOW DOWN ***
Zeeshka: shows [As Kd] (a pair of Aces)
dndngod: shows [Kh Ah] (a pair of Aces)
Zeeshka collected $24.50 from pot
dndngod collected $24.50 from pot
*** SUMMARY ***
Total pot $100.50 | Rake $2.50 
Hand was run twice
FIRST Board [9s 8h 9h Jh Ks]
SECOND Board [Ad Qc 2c 3s 8d]
Seat 1: lumen21 (button) folded before Flop (didn't bet)
Seat 2: Zeeshka (small blind) showed [As Kd] and lost with two pair, Kings and Nines, and won ($24.50) with a pair of Aces
Seat 3: IvanUrgant (big blind) folded before Flop
Seat 4: GriffinBerg folded before Flop (didn't bet)
Seat 5: Moszes360 folded before Flop (didn't bet)
Seat 6: whalldo folded before Flop (didn't bet)
Seat 7: matiko09 folded before Flop (didn't bet)
Seat 8: dndngod showed [Kh Ah] and won ($49) with a flush, Ace high, and won ($24.50) with a pair of Aces
Seat 9: CvMCvMCvM folded before Flop (didn't bet)





PokerStars Hand #150800249602:  Hold'em No Limit ($0.50/$1.00 USD) - 2016/03/23 13:58:38 CET [2016/03/23 8:58:38 ET]
Table 'Kippes' 9-max Seat #4 is the button
Seat 1: Pvsx. ($120.31 in chips) 
Seat 2: RICKA16 ($130.13 in chips) 
Seat 3: CAJUN890 ($123.47 in chips) 
Seat 4: matiko09 ($100 in chips) 
Seat 5: Jimy Tiltman ($117.36 in chips) 
Seat 6: DUkalisUA ($100 in chips) 
Seat 7: lumen21 ($115.02 in chips) 
Seat 8: Zeeshka ($110.30 in chips) 
Seat 9: wang19790906 ($81.92 in chips) 
Jimy Tiltman: posts small blind $0.50
DUkalisUA: posts big blind $1
*** HOLE CARDS ***
Dealt to matiko09 [9c Ac]
lumen21: folds 
Zeeshka: folds 
wang19790906: folds 
Pvsx.: folds 
RICKA16: folds 
CAJUN890: raises $2 to $3
matiko09: folds 
Jimy Tiltman: folds 
DUkalisUA: folds 
Uncalled bet ($2) returned to CAJUN890
CAJUN890 collected $2.50 from pot
CAJUN890: doesn't show hand 
*** SUMMARY ***
Total pot $2.50 | Rake $0 
Seat 1: Pvsx. folded before Flop (didn't bet)
Seat 2: RICKA16 folded before Flop (didn't bet)
Seat 3: CAJUN890 collected ($2.50)
Seat 4: matiko09 (button) folded before Flop (didn't bet)
Seat 5: Jimy Tiltman (small blind) folded before Flop
Seat 6: DUkalisUA (big blind) folded before Flop
Seat 7: lumen21 folded before Flop (didn't bet)
Seat 8: Zeeshka folded before Flop (didn't bet)
Seat 9: wang19790906 folded before Flop (didn't bet)





PokerStars Hand #150800251681:  Hold'em No Limit ($1/$2 USD) - 2016/03/23 13:58:43 CET [2016/03/23 8:58:43 ET]
Table 'Kiess' 9-max Seat #6 is the button
Seat 1: Cirilico ($163.56 in chips) 
Seat 2: DUkalisUA ($694.52 in chips) 
Seat 4: Moszes360 ($206.77 in chips) 
Seat 5: chippo boy ($318.88 in chips) 
Seat 6: matiko09 ($285.84 in chips) 
Seat 7: InsomniaRU ($274.17 in chips) 
Seat 8: erfk1958 ($122 in chips) 
Seat 9: Fish4trips ($200 in chips) 
InsomniaRU: posts small blind $1
erfk1958: posts big blind $2
*** HOLE CARDS ***
Dealt to matiko09 [Ad Tc]
Fish4trips: folds 
Cirilico: folds 
DUkalisUA: folds 
Moszes360: folds 
chippo boy: calls $2
matiko09: raises $6 to $8
InsomniaRU: folds 
erfk1958: folds 
chippo boy: calls $6
*** FLOP *** [9s 3s 4d]
chippo boy: checks 
matiko09: checks 
*** TURN *** [9s 3s 4d] [9h]
chippo boy: bets $10
matiko09: folds 
Uncalled bet ($10) returned to chippo boy
chippo boy collected $18.14 from pot
*** SUMMARY ***
Total pot $19 | Rake $0.86 
Board [9s 3s 4d 9h]
Seat 1: Cirilico folded before Flop (didn't bet)
Seat 2: DUkalisUA folded before Flop (didn't bet)
Seat 4: Moszes360 folded before Flop (didn't bet)
Seat 5: chippo boy collected ($18.14)
Seat 6: matiko09 (button) folded on the Turn
Seat 7: InsomniaRU (small blind) folded before Flop
Seat 8: erfk1958 (big blind) folded before Flop
Seat 9: Fish4trips folded before Flop (didn't bet)





PokerStars Hand #150800254124:  Hold'em No Limit ($0.50/$1.00 USD) - 2016/03/23 13:58:47 CET [2016/03/23 8:58:47 ET]
Table 'Merope II' 9-max Seat #2 is the button
Seat 1: Jimy Tiltman ($110.44 in chips) 
Seat 2: Zeeshka ($100 in chips) 
Seat 3: Sherlockplay ($142.20 in chips) 
Seat 4: YuriiSolodya ($40 in chips) 
Seat 5: DUkalisUA ($100 in chips) 
Seat 7: matiko09 ($100 in chips) 
Seat 8: titentei ($95 in chips) 
Seat 9: RICKA16 ($99.50 in chips) 
Sherlockplay: posts small blind $0.50
YuriiSolodya: posts big blind $1
Effort92: sits out 
*** HOLE CARDS ***
Dealt to matiko09 [Qs 2d]
DUkalisUA: folds 
matiko09: folds 
titentei: folds 
RICKA16: folds 
Jimy Tiltman: folds 
Zeeshka: raises $1.50 to $2.50
Sherlockplay: folds 
YuriiSolodya: calls $1.50
*** FLOP *** [8h 5s As]
YuriiSolodya: bets $1
Zeeshka: folds 
Uncalled bet ($1) returned to YuriiSolodya
YuriiSolodya collected $5.25 from pot
YuriiSolodya: doesn't show hand 
*** SUMMARY ***
Total pot $5.50 | Rake $0.25 
Board [8h 5s As]
Seat 1: Jimy Tiltman folded before Flop (didn't bet)
Seat 2: Zeeshka (button) folded on the Flop
Seat 3: Sherlockplay (small blind) folded before Flop
Seat 4: YuriiSolodya (big blind) collected ($5.25)
Seat 5: DUkalisUA folded before Flop (didn't bet)
Seat 7: matiko09 folded before Flop (didn't bet)
Seat 8: titentei folded before Flop (didn't bet)
Seat 9: RICKA16 folded before Flop (didn't bet)





PokerStars Hand #150800257145:  Hold'em No Limit ($0.50/$1.00 USD) - 2016/03/23 13:58:53 CET [2016/03/23 8:58:53 ET]
Table 'Atlantis' 9-max Seat #3 is the button
Seat 1: xHourglass ($154.28 in chips) 
Seat 2: tffff2006 ($50.84 in chips) 
Seat 3: CAJUN890 ($108.79 in chips) 
Seat 4: matiko09 ($117.45 in chips) 
Seat 5: Pvsx. ($100 in chips) 
Seat 6: Jimy Tiltman ($133.81 in chips) 
Seat 7: Zeeshka ($108.32 in chips) 
Seat 8: DUkalisUA ($107.05 in chips) 
matiko09: posts small blind $0.50
Pvsx.: posts big blind $1
RICKA16: sits out 
*** HOLE CARDS ***
Dealt to matiko09 [Js 7c]
Jimy Tiltman: folds 
Zeeshka: folds 
DUkalisUA: folds 
xHourglass: folds 
tffff2006: folds 
CAJUN890: folds 
matiko09: folds 
Uncalled bet ($0.50) returned to Pvsx.
Pvsx. collected $1 from pot
Pvsx.: doesn't show hand 
*** SUMMARY ***
Total pot $1 | Rake $0 
Seat 1: xHourglass folded before Flop (didn't bet)
Seat 2: tffff2006 folded before Flop (didn't bet)
Seat 3: CAJUN890 (button) folded before Flop (didn't bet)
Seat 4: matiko09 (small blind) folded before Flop
Seat 5: Pvsx. (big blind) collected ($1)
Seat 6: Jimy Tiltman folded before Flop (didn't bet)
Seat 7: Zeeshka folded before Flop (didn't bet)
Seat 8: DUkalisUA folded before Flop (didn't bet)





PokerStars Hand #150800257809:  Hold'em No Limit ($1/$2 USD) - 2016/03/23 13:58:55 CET [2016/03/23 8:58:55 ET]
Table 'Alma II' 9-max Seat #1 is the button
Seat 1: berggren ($216.75 in chips) 
Seat 2: glanza_mike ($200 in chips) 
Seat 4: daniferdoser ($201.78 in chips) 
Seat 5: dah44 ($208.10 in chips) 
Seat 6: InsomniaRU ($200 in chips) 
Seat 7: cliffdogz ($176 in chips) 
Seat 8: matiko09 ($209 in chips) 
Seat 9: carflam7 ($157 in chips) 
glanza_mike: posts small blind $1
daniferdoser: posts big blind $2
*** HOLE CARDS ***
Dealt to matiko09 [Qc Qs]
dah44: folds 
InsomniaRU: raises $3 to $5
cliffdogz: calls $5
matiko09: raises $13 to $18
carflam7: folds 
berggren: folds 
glanza_mike: folds 
daniferdoser: folds 
InsomniaRU: folds 
cliffdogz: calls $13
*** FLOP *** [Qd 6s 5h]
cliffdogz: checks 
matiko09: bets $13.02
cliffdogz: raises $13.02 to $26.04
matiko09: calls $13.02
*** TURN *** [Qd 6s 5h] [6c]
cliffdogz: bets $42
matiko09: calls $42
*** RIVER *** [Qd 6s 5h 6c] [Td]
cliffdogz: bets $89.96 and is all-in
matiko09: calls $89.96
*** SHOW DOWN ***
cliffdogz: shows [5d 5s] (a full house, Fives full of Sixes)
matiko09: shows [Qc Qs] (a full house, Queens full of Sixes)
matiko09 collected $357.20 from pot
*** SUMMARY ***
Total pot $360 | Rake $2.80 
Board [Qd 6s 5h 6c Td]
Seat 1: berggren (button) folded before Flop (didn't bet)
Seat 2: glanza_mike (small blind) folded before Flop
Seat 4: daniferdoser (big blind) folded before Flop
Seat 5: dah44 folded before Flop (didn't bet)
Seat 6: InsomniaRU folded before Flop
Seat 7: cliffdogz showed [5d 5s] and lost with a full house, Fives full of Sixes
Seat 8: matiko09 showed [Qc Qs] and won ($357.20) with a full house, Queens full of Sixes
Seat 9: carflam7 folded before Flop (didn't bet)





PokerStars Hand #150800258382:  Hold'em No Limit ($1/$2 USD) - 2016/03/23 13:58:56 CET [2016/03/23 8:58:56 ET]
Table 'Herba II' 9-max Seat #1 is the button
Seat 1: matiko09 ($220.48 in chips) 
Seat 2: Moszes360 ($200 in chips) 
Seat 3: Cirilico ($160 in chips) 
Seat 4: DUkalisUA ($289.08 in chips) 
Seat 5: chippo boy ($226.55 in chips) 
Seat 7: InsomniaRU ($200 in chips) 
Seat 9: mrhighryza ($69.55 in chips) 
Moszes360: posts small blind $1
Cirilico: posts big blind $2
Too-Anti-To: sits out 
*** HOLE CARDS ***
Dealt to matiko09 [8c 3d]
DUkalisUA: folds 
chippo boy: folds 
InsomniaRU: folds 
mrhighryza: raises $2 to $4
matiko09: folds 
Moszes360: folds 
Cirilico: folds 
Uncalled bet ($2) returned to mrhighryza
mrhighryza collected $5 from pot
*** SUMMARY ***
Total pot $5 | Rake $0 
Seat 1: matiko09 (button) folded before Flop (didn't bet)
Seat 2: Moszes360 (small blind) folded before Flop
Seat 3: Cirilico (big blind) folded before Flop
Seat 4: DUkalisUA folded before Flop (didn't bet)
Seat 5: chippo boy folded before Flop (didn't bet)
Seat 7: InsomniaRU folded before Flop (didn't bet)
Seat 9: mrhighryza collected ($5)





PokerStars Hand #150800260394:  Hold'em No Limit ($0.25/$0.50 USD) - 2016/03/23 13:59:00 CET [2016/03/23 8:59:00 ET]
Table 'Belnika' 9-max Seat #5 is the button
Seat 1: yellowfever0 ($14.19 in chips) 
Seat 2: NeverRegret7 ($60.93 in chips) 
Seat 3: ChiChioChi ($78.09 in chips) 
Seat 4: matiko09 ($65.35 in chips) 
Seat 5: IvanUrgant ($50 in chips) 
Seat 6: Ahangama ($57 in chips) 
Seat 8: lumen21 ($63.47 in chips) 
Seat 9: dndngod ($59.66 in chips) 
Ahangama: posts small blind $0.25
Zeeshka: is sitting out 
Zeeshka leaves the table
lumen21: posts big blind $0.50
*** HOLE CARDS ***
Dealt to matiko09 [9s 5c]
dndngod: folds 
CvMCvMCvM joins the table at seat #7 
yellowfever0: folds 
NeverRegret7: folds 
ChiChioChi: folds 
matiko09: folds 
IvanUrgant: folds 
Ahangama: folds 
Uncalled bet ($0.25) returned to lumen21
lumen21 collected $0.50 from pot
lumen21: doesn't show hand 
*** SUMMARY ***
Total pot $0.50 | Rake $0 
Seat 1: yellowfever0 folded before Flop (didn't bet)
Seat 2: NeverRegret7 folded before Flop (didn't bet)
Seat 3: ChiChioChi folded before Flop (didn't bet)
Seat 4: matiko09 folded before Flop (didn't bet)
Seat 5: IvanUrgant (button) folded before Flop (didn't bet)
Seat 6: Ahangama (small blind) folded before Flop
Seat 8: lumen21 (big blind) collected ($0.50)
Seat 9: dndngod folded before Flop (didn't bet)





PokerStars Hand #150800261532:  Hold'em No Limit ($0.50/$1.00 USD) - 2016/03/23 13:59:02 CET [2016/03/23 8:59:02 ET]
Table 'Donar II' 9-max Seat #2 is the button
Seat 1: Effort92 ($112.62 in chips) 
Seat 2: nobrunobru1 ($84.74 in chips) 
Seat 3: st-germ30 ($95.40 in chips) 
Seat 4: DUkalisUA ($125.57 in chips) 
Seat 5: matiko09 ($100 in chips) 
Seat 6: ardo888 ($114.62 in chips) 
st-germ30: posts small blind $0.50
DUkalisUA: posts big blind $1
$-Twackle-$: sits out 
oxfordtenzin: sits out 
Effort92: posts the ante $0.20
nobrunobru1: posts the ante $0.20
st-germ30: posts the ante $0.20
DUkalisUA: posts the ante $0.20
matiko09: posts the ante $0.20
ardo888: posts the ante $0.20
*** HOLE CARDS ***
Dealt to matiko09 [Th 4h]
matiko09: folds 
ardo888: raises $2 to $3
Effort92: folds 
nobrunobru1: calls $3
st-germ30: folds 
DUkalisUA: folds 
*** FLOP *** [2d 5c 7h]
ardo888: bets $5.50
nobrunobru1: folds 
Uncalled bet ($5.50) returned to ardo888
ardo888 collected $8.31 from pot
ardo888: doesn't show hand 
*** SUMMARY ***
Total pot $8.70 | Rake $0.39 
Board [2d 5c 7h]
Seat 1: Effort92 folded before Flop (didn't bet)
Seat 2: nobrunobru1 (button) folded on the Flop
Seat 3: st-germ30 (small blind) folded before Flop
Seat 4: DUkalisUA (big blind) folded before Flop
Seat 5: matiko09 folded before Flop (didn't bet)
Seat 6: ardo888 collected ($8.31)





PokerStars Hand #150800262250:  Hold'em No Limit ($0.50/$1.00 USD) - 2016/03/23 13:59:03 CET [2016/03/23 8:59:03 ET]
Table 'Kippes' 9-max Seat #5 is the button
Seat 1: Pvsx. ($120.31 in chips) 
Seat 2: RICKA16 ($130.13 in chips) 
Seat 3: CAJUN890 ($124.97 in chips) 
Seat 4: matiko09 ($100 in chips) 
Seat 5: Jimy Tiltman ($116.86 in chips) 
Seat 6: DUkalisUA ($100 in chips) 
Seat 7: lumen21 ($115.02 in chips) 
Seat 8: Zeeshka ($110.30 in chips) 
Seat 9: wang19790906 ($81.92 in chips) 
DUkalisUA: posts small blind $0.50
lumen21: posts big blind $1
*** HOLE CARDS ***
Dealt to matiko09 [9h 7h]
Zeeshka: folds 
wang19790906: folds 
Pvsx.: folds 
RICKA16: folds 
CAJUN890: calls $1
matiko09: raises $3 to $4
Jimy Tiltman: folds 
DUkalisUA: folds 
lumen21: folds 
CAJUN890: calls $3
*** FLOP *** [3c 6s 9c]
CAJUN890: checks 
matiko09: bets $5
CAJUN890: folds 
Uncalled bet ($5) returned to matiko09
matiko09 collected $9.07 from pot
matiko09: doesn't show hand 
*** SUMMARY ***
Total pot $9.50 | Rake $0.43 
Board [3c 6s 9c]
Seat 1: Pvsx. folded before Flop (didn't bet)
Seat 2: RICKA16 folded before Flop (didn't bet)
Seat 3: CAJUN890 folded on the Flop
Seat 4: matiko09 collected ($9.07)
Seat 5: Jimy Tiltman (button) folded before Flop (didn't bet)
Seat 6: DUkalisUA (small blind) folded before Flop
Seat 7: lumen21 (big blind) folded before Flop
Seat 8: Zeeshka folded before Flop (didn't bet)
Seat 9: wang19790906 folded before Flop (didn't bet)





PokerStars Hand #150800264727:  Hold'em No Limit ($1/$2 USD) - 2016/03/23 13:59:08 CET [2016/03/23 8:59:08 ET]
Table 'Kypria II' 9-max Seat #5 is the button
Seat 1: geldwolfje ($135.42 in chips) 
Seat 2: coinflip_si ($200 in chips) 
Seat 3: seouljam ($203.45 in chips) 
Seat 5: InsomniaRU ($398.28 in chips) 
Seat 6: matiko09 ($278.69 in chips) 
Seat 7: DUkalisUA ($203 in chips) 
Seat 8: Fish4trips ($334.19 in chips) 
matiko09: posts small blind $1
DUkalisUA: posts big blind $2
Moszes360: sits out 
VolanDog: sits out 
*** HOLE CARDS ***
Dealt to matiko09 [9s Qs]
Fish4trips: folds 
geldwolfje: folds 
coinflip_si: raises $3 to $5
seouljam: folds 
InsomniaRU: folds 
seouljam said, "bad fold geld you push allin there, insomnia had nothing obvious bluff"
matiko09: folds 
DUkalisUA: folds 
Uncalled bet ($3) returned to coinflip_si
coinflip_si collected $5 from pot
coinflip_si: doesn't show hand 
*** SUMMARY ***
Total pot $5 | Rake $0 
Seat 1: geldwolfje folded before Flop (didn't bet)
Seat 2: coinflip_si collected ($5)
Seat 3: seouljam folded before Flop (didn't bet)
Seat 5: InsomniaRU (button) folded before Flop (didn't bet)
Seat 6: matiko09 (small blind) folded before Flop
Seat 7: DUkalisUA (big blind) folded before Flop
Seat 8: Fish4trips folded before Flop (didn't bet)





PokerStars Hand #150800272440:  Hold'em No Limit ($1/$2 USD) - 2016/03/23 13:59:23 CET [2016/03/23 8:59:23 ET]
Table 'Kiess' 9-max Seat #7 is the button
Seat 1: Cirilico ($163.56 in chips) 
Seat 2: DUkalisUA ($694.52 in chips) 
Seat 4: Moszes360 ($206.77 in chips) 
Seat 5: chippo boy ($329.02 in chips) 
Seat 6: matiko09 ($277.84 in chips) 
Seat 7: InsomniaRU ($273.17 in chips) 
Seat 8: erfk1958 ($120 in chips) 
Seat 9: Fish4trips ($200 in chips) 
erfk1958: posts small blind $1
Fish4trips: posts big blind $2
*** HOLE CARDS ***
Dealt to matiko09 [2c Td]
Cirilico: raises $4 to $6
DUkalisUA: folds 
Moszes360: folds 
chippo boy: folds 
matiko09: folds 
InsomniaRU: folds 
erfk1958: folds 
Fish4trips: calls $4
*** FLOP *** [5d As 8s]
Fish4trips: checks 
Cirilico: bets $8
Fish4trips: calls $8
*** TURN *** [5d As 8s] [5h]
Fish4trips: checks 
Cirilico: bets $21
Fish4trips: calls $21
*** RIVER *** [5d As 8s 5h] [2h]
Fish4trips: checks 
Cirilico: bets $44
Fish4trips: folds 
Uncalled bet ($44) returned to Cirilico
Cirilico collected $68.20 from pot
Cirilico: doesn't show hand 
*** SUMMARY ***
Total pot $71 | Rake $2.80 
Board [5d As 8s 5h 2h]
Seat 1: Cirilico collected ($68.20)
Seat 2: DUkalisUA folded before Flop (didn't bet)
Seat 4: Moszes360 folded before Flop (didn't bet)
Seat 5: chippo boy folded before Flop (didn't bet)
Seat 6: matiko09 folded before Flop (didn't bet)
Seat 7: InsomniaRU (button) folded before Flop (didn't bet)
Seat 8: erfk1958 (small blind) folded before Flop
Seat 9: Fish4trips (big blind) folded on the River





PokerStars Hand #150800272256:  Hold'em No Limit ($1/$2 USD) - 2016/03/23 13:59:23 CET [2016/03/23 8:59:23 ET]
Table 'Herba II' 9-max Seat #2 is the button
Seat 1: matiko09 ($220.48 in chips) 
Seat 2: Moszes360 ($200 in chips) 
Seat 3: Cirilico ($160 in chips) 
Seat 4: DUkalisUA ($289.08 in chips) 
Seat 5: chippo boy ($226.55 in chips) 
Seat 7: InsomniaRU ($200 in chips) 
Seat 9: mrhighryza ($72.55 in chips) 
Cirilico: posts small blind $1
DUkalisUA: posts big blind $2
Too-Anti-To: sits out 
*** HOLE CARDS ***
Dealt to matiko09 [4s 6d]
chippo boy: folds 
InsomniaRU: folds 
mrhighryza: folds 
matiko09: folds 
Moszes360: raises $2.20 to $4.20
Cirilico: calls $3.20
DUkalisUA: raises $19.80 to $24
Moszes360: folds 
Cirilico: folds 
Uncalled bet ($19.80) returned to DUkalisUA
DUkalisUA collected $12.60 from pot
DUkalisUA: doesn't show hand 
*** SUMMARY ***
Total pot $12.60 | Rake $0 
Seat 1: matiko09 folded before Flop (didn't bet)
Seat 2: Moszes360 (button) folded before Flop
Seat 3: Cirilico (small blind) folded before Flop
Seat 4: DUkalisUA (big blind) collected ($12.60)
Seat 5: chippo boy folded before Flop (didn't bet)
Seat 7: InsomniaRU folded before Flop (didn't bet)
Seat 9: mrhighryza folded before Flop (didn't bet)





PokerStars Hand #150800274831:  Hold'em No Limit ($0.50/$1.00 USD) - 2016/03/23 13:59:28 CET [2016/03/23 8:59:28 ET]
Table 'Atlantis' 9-max Seat #4 is the button
Seat 1: xHourglass ($154.28 in chips) 
Seat 2: tffff2006 ($50.84 in chips) 
Seat 3: CAJUN890 ($108.79 in chips) 
Seat 4: matiko09 ($116.95 in chips) 
Seat 5: Pvsx. ($100.50 in chips) 
Seat 6: Jimy Tiltman ($133.81 in chips) 
Seat 7: Zeeshka ($108.32 in chips) 
Seat 8: DUkalisUA ($107.05 in chips) 
Pvsx.: posts small blind $0.50
Jimy Tiltman: posts big blind $1
RICKA16: sits out 
*** HOLE CARDS ***
Dealt to matiko09 [6h Tc]
Zeeshka: folds 
DUkalisUA: folds 
xHourglass: raises $2 to $3
tffff2006: folds 
CAJUN890: folds 
matiko09: folds 
Pvsx.: folds 
Jimy Tiltman: calls $2
*** FLOP *** [Kh 5s 9d]
Jimy Tiltman: checks 
xHourglass: checks 
*** TURN *** [Kh 5s 9d] [2s]
Jimy Tiltman: checks 
xHourglass: bets $5
Jimy Tiltman: calls $5
*** RIVER *** [Kh 5s 9d 2s] [Ks]
Jimy Tiltman: checks 
xHourglass: bets $11.25
Jimy Tiltman: calls $11.25
*** SHOW DOWN ***
xHourglass: shows [Qs 8s] (a flush, King high)
Jimy Tiltman: mucks hand 
xHourglass collected $37.24 from pot
*** SUMMARY ***
Total pot $39 | Rake $1.76 
Board [Kh 5s 9d 2s Ks]
Seat 1: xHourglass showed [Qs 8s] and won ($37.24) with a flush, King high
Seat 2: tffff2006 folded before Flop (didn't bet)
Seat 3: CAJUN890 folded before Flop (didn't bet)
Seat 4: matiko09 (button) folded before Flop (didn't bet)
Seat 5: Pvsx. (small blind) folded before Flop
Seat 6: Jimy Tiltman (big blind) mucked [Js Ts]
Seat 7: Zeeshka folded before Flop (didn't bet)
Seat 8: DUkalisUA folded before Flop (didn't bet)





PokerStars Hand #150800275090:  Hold'em No Limit ($1/$2 USD) - 2016/03/23 13:59:29 CET [2016/03/23 8:59:29 ET]
Table 'Berbericia II' 9-max Seat #4 is the button
Seat 1: daniferdoser ($203 in chips) 
Seat 2: Moszes360 ($233.52 in chips) 
Seat 3: Fish4trips ($200 in chips) 
Seat 4: bennetb77 ($91.87 in chips) 
Seat 5: darren1031 ($254.90 in chips) 
Seat 6: Charity86 ($170.38 in chips) 
Seat 8: matiko09 ($297.51 in chips) 
Seat 9: B@ngel ($200 in chips) 
darren1031: posts small blind $1
Charity86: posts big blind $2
$-Twackle-$: sits out 
*** HOLE CARDS ***
Dealt to matiko09 [8h Qc]
matiko09: folds 
B@ngel: folds 
daniferdoser: raises $2.92 to $4.92
Moszes360: folds 
Fish4trips: folds 
bennetb77: folds 
darren1031: raises $7.08 to $12
Charity86: folds 
daniferdoser: calls $7.08
*** FLOP *** [8s 4h 5s]
darren1031: bets $14
daniferdoser: folds 
Uncalled bet ($14) returned to darren1031
darren1031 collected $24.83 from pot
darren1031: doesn't show hand 
*** SUMMARY ***
Total pot $26 | Rake $1.17 
Board [8s 4h 5s]
Seat 1: daniferdoser folded on the Flop
Seat 2: Moszes360 folded before Flop (didn't bet)
Seat 3: Fish4trips folded before Flop (didn't bet)
Seat 4: bennetb77 (button) folded before Flop (didn't bet)
Seat 5: darren1031 (small blind) collected ($24.83)
Seat 6: Charity86 (big blind) folded before Flop
Seat 8: matiko09 folded before Flop (didn't bet)
Seat 9: B@ngel folded before Flop (didn't bet)





PokerStars Hand #150800276228:  Hold'em No Limit ($0.50/$1.00 USD) - 2016/03/23 13:59:31 CET [2016/03/23 8:59:31 ET]
Table 'Smiley' 9-max Seat #7 is the button
Seat 2: Jimy Tiltman ($100 in chips) 
Seat 3: matiko09 ($100 in chips) 
Seat 4: Zeeshka ($156.81 in chips) 
Seat 5: DUkalisUA ($192.20 in chips) 
Seat 6: blackmont111 ($110.30 in chips) 
Seat 7: Moszes360 ($100 in chips) 
Seat 8: momtscheto ($56.03 in chips) 
Seat 9: Pvsx. ($100 in chips) 
momtscheto: posts small blind $0.50
Pvsx.: posts big blind $1
xHourglass: sits out 
*** HOLE CARDS ***
Dealt to matiko09 [Th 9s]
Jimy Tiltman: raises $2 to $3
matiko09: folds 
Zeeshka: folds 
DUkalisUA: folds 
blackmont111: folds 
Moszes360: folds 
momtscheto: calls $2.50
Pvsx.: calls $2
*** FLOP *** [Td As 7d]
momtscheto: bets $5
Pvsx.: folds 
Jimy Tiltman: calls $5
*** TURN *** [Td As 7d] [Kd]
momtscheto: bets $12
Jimy Tiltman: calls $12
*** RIVER *** [Td As 7d Kd] [6s]
momtscheto: bets $18
Jimy Tiltman: calls $18
*** SHOW DOWN ***
momtscheto: shows [8c Jh] (high card Ace)
Jimy Tiltman: shows [Js Ah] (a pair of Aces)
Jimy Tiltman collected $76.20 from pot
*** SUMMARY ***
Total pot $79 | Rake $2.80 
Board [Td As 7d Kd 6s]
Seat 2: Jimy Tiltman showed [Js Ah] and won ($76.20) with a pair of Aces
Seat 3: matiko09 folded before Flop (didn't bet)
Seat 4: Zeeshka folded before Flop (didn't bet)
Seat 5: DUkalisUA folded before Flop (didn't bet)
Seat 6: blackmont111 folded before Flop (didn't bet)
Seat 7: Moszes360 (button) folded before Flop (didn't bet)
Seat 8: momtscheto (small blind) showed [8c Jh] and lost with high card Ace
Seat 9: Pvsx. (big blind) folded on the Flop





PokerStars Hand #150800277274:  Hold'em No Limit ($0.25/$0.50 USD) - 2016/03/23 13:59:33 CET [2016/03/23 8:59:33 ET]
Table 'Belnika' 9-max Seat #6 is the button
Seat 1: yellowfever0 ($14.19 in chips) 
Seat 2: NeverRegret7 ($60.93 in chips) 
Seat 3: ChiChioChi ($78.09 in chips) 
Seat 4: matiko09 ($65.35 in chips) 
Seat 5: IvanUrgant ($50 in chips) 
Seat 6: Ahangama ($56.75 in chips) 
Seat 8: lumen21 ($63.72 in chips) 
Seat 9: dndngod ($59.66 in chips) 
CvMCvMCvM will be allowed to play after the button
lumen21: posts small blind $0.25
dndngod: posts big blind $0.50
*** HOLE CARDS ***
Dealt to matiko09 [Qc 2d]
yellowfever0: calls $0.50
NeverRegret7: calls $0.50
ChiChioChi: raises $0.50 to $1
matiko09: folds 
IvanUrgant: folds 
Ahangama: folds 
lumen21: folds 
dndngod: folds 
yellowfever0: calls $0.50
NeverRegret7: calls $0.50
*** FLOP *** [9h 4s Ad]
yellowfever0: checks 
NeverRegret7: checks 
ChiChioChi: checks 
*** TURN *** [9h 4s Ad] [3d]
yellowfever0: checks 
NeverRegret7: checks 
ChiChioChi: checks 
*** RIVER *** [9h 4s Ad 3d] [8c]
yellowfever0: checks 
NeverRegret7: checks 
ChiChioChi: bets $2
yellowfever0: folds 
NeverRegret7: folds 
Uncalled bet ($2) returned to ChiChioChi
ChiChioChi collected $3.58 from pot
ChiChioChi: doesn't show hand 
*** SUMMARY ***
Total pot $3.75 | Rake $0.17 
Board [9h 4s Ad 3d 8c]
Seat 1: yellowfever0 folded on the River
Seat 2: NeverRegret7 folded on the River
Seat 3: ChiChioChi collected ($3.58)
Seat 4: matiko09 folded before Flop (didn't bet)
Seat 5: IvanUrgant folded before Flop (didn't bet)
Seat 6: Ahangama (button) folded before Flop (didn't bet)
Seat 8: lumen21 (small blind) folded before Flop
Seat 9: dndngod (big blind) folded before Flop





PokerStars Hand #150800277466:  Hold'em No Limit ($0.50/$1.00 USD) - 2016/03/23 13:59:33 CET [2016/03/23 8:59:33 ET]
Table 'Merope II' 9-max Seat #3 is the button
Seat 1: Jimy Tiltman ($110.44 in chips) 
Seat 2: Zeeshka ($100 in chips) 
Seat 3: Sherlockplay ($141.70 in chips) 
Seat 4: YuriiSolodya ($42.75 in chips) 
Seat 5: DUkalisUA ($100 in chips) 
Seat 7: matiko09 ($100 in chips) 
Seat 8: titentei ($95 in chips) 
Seat 9: RICKA16 ($99.50 in chips) 
YuriiSolodya: posts small blind $0.50
DUkalisUA: posts big blind $1
Effort92: sits out 
*** HOLE CARDS ***
Dealt to matiko09 [2d 5h]
matiko09: folds 
titentei: folds 
RICKA16: folds 
Jimy Tiltman: folds 
Zeeshka: folds 
Sherlockplay: raises $1.50 to $2.50
YuriiSolodya: calls $2
DUkalisUA: folds 
*** FLOP *** [6h Ks 4c]
YuriiSolodya: bets $1
Sherlockplay: folds 
Uncalled bet ($1) returned to YuriiSolodya
YuriiSolodya collected $5.73 from pot
YuriiSolodya: doesn't show hand 
*** SUMMARY ***
Total pot $6 | Rake $0.27 
Board [6h Ks 4c]
Seat 1: Jimy Tiltman folded before Flop (didn't bet)
Seat 2: Zeeshka folded before Flop (didn't bet)
Seat 3: Sherlockplay (button) folded on the Flop
Seat 4: YuriiSolodya (small blind) collected ($5.73)
Seat 5: DUkalisUA (big blind) folded before Flop
Seat 7: matiko09 folded before Flop (didn't bet)
Seat 8: titentei folded before Flop (didn't bet)
Seat 9: RICKA16 folded before Flop (didn't bet)





PokerStars Hand #150800281456:  Hold'em No Limit ($0.50/$1.00 USD) - 2016/03/23 13:59:41 CET [2016/03/23 8:59:41 ET]
Table 'Donar II' 9-max Seat #3 is the button
Seat 1: Effort92 ($112.42 in chips) 
Seat 2: nobrunobru1 ($81.54 in chips) 
Seat 3: st-germ30 ($94.70 in chips) 
Seat 4: DUkalisUA ($124.37 in chips) 
Seat 5: matiko09 ($100 in chips) 
Seat 6: ardo888 ($119.73 in chips) 
DUkalisUA: posts small blind $0.50
matiko09: posts big blind $1
$-Twackle-$: sits out 
oxfordtenzin: sits out 
Effort92: posts the ante $0.20
nobrunobru1: posts the ante $0.20
st-germ30: posts the ante $0.20
DUkalisUA: posts the ante $0.20
matiko09: posts the ante $0.20
ardo888: posts the ante $0.20
*** HOLE CARDS ***
Dealt to matiko09 [Qd 6h]
ardo888: folds 
Effort92: folds 
nobrunobru1: folds 
st-germ30: raises $3 to $4
DUkalisUA: folds 
matiko09: folds 
Uncalled bet ($3) returned to st-germ30
st-germ30 collected $3.70 from pot
st-germ30: doesn't show hand 
*** SUMMARY ***
Total pot $3.70 | Rake $0 
Seat 1: Effort92 folded before Flop (didn't bet)
Seat 2: nobrunobru1 folded before Flop (didn't bet)
Seat 3: st-germ30 (button) collected ($3.70)
Seat 4: DUkalisUA (small blind) folded before Flop
Seat 5: matiko09 (big blind) folded before Flop
Seat 6: ardo888 folded before Flop (didn't bet)





PokerStars Hand #150800284474:  Hold'em No Limit ($1/$2 USD) - 2016/03/23 13:59:47 CET [2016/03/23 8:59:47 ET]
Table 'Kypria II' 9-max Seat #6 is the button
Seat 1: geldwolfje ($135.42 in chips) 
Seat 2: coinflip_si ($203 in chips) 
Seat 3: seouljam ($203.45 in chips) 
Seat 5: InsomniaRU ($398.28 in chips) 
Seat 6: matiko09 ($277.69 in chips) 
Seat 7: DUkalisUA ($201 in chips) 
Seat 8: Fish4trips ($334.19 in chips) 
DUkalisUA: posts small blind $1
Fish4trips: posts big blind $2
Moszes360: sits out 
VolanDog: sits out 
*** HOLE CARDS ***
Dealt to matiko09 [Kh 6h]
seouljam said, "i know how he plays"
geldwolfje: folds 
coinflip_si: folds 
seouljam: folds 
InsomniaRU: raises $3 to $5
matiko09: folds 
DUkalisUA: folds 
Fish4trips: calls $3
*** FLOP *** [3c As Tc]
Fish4trips: checks 
InsomniaRU: checks 
*** TURN *** [3c As Tc] [7c]
Fish4trips: checks 
InsomniaRU: bets $7.04
Fish4trips: folds 
Uncalled bet ($7.04) returned to InsomniaRU
InsomniaRU collected $10.50 from pot
InsomniaRU: doesn't show hand 
*** SUMMARY ***
Total pot $11 | Rake $0.50 
Board [3c As Tc 7c]
Seat 1: geldwolfje folded before Flop (didn't bet)
Seat 2: coinflip_si folded before Flop (didn't bet)
Seat 3: seouljam folded before Flop (didn't bet)
Seat 5: InsomniaRU collected ($10.50)
Seat 6: matiko09 (button) folded before Flop (didn't bet)
Seat 7: DUkalisUA (small blind) folded before Flop
Seat 8: Fish4trips (big blind) folded on the Turn





PokerStars Hand #150800286836:  Hold'em No Limit ($0.50/$1.00 USD) - 2016/03/23 13:59:52 CET [2016/03/23 8:59:52 ET]
Table 'Kippes' 9-max Seat #6 is the button
Seat 1: Pvsx. ($120.31 in chips) 
Seat 2: RICKA16 ($130.13 in chips) 
Seat 3: CAJUN890 ($120.97 in chips) 
Seat 4: matiko09 ($105.07 in chips) 
Seat 5: Jimy Tiltman ($116.86 in chips) 
Seat 6: DUkalisUA ($100 in chips) 
Seat 7: lumen21 ($114.02 in chips) 
Seat 9: wang19790906 ($81.92 in chips) 
lumen21: posts small blind $0.50
Zeeshka: is sitting out 
wang19790906: posts big blind $1
*** HOLE CARDS ***
Dealt to matiko09 [8c Ks]
Zeeshka leaves the table
Pvsx.: folds 
RICKA16: folds 
CAJUN890: calls $1
matiko09: folds 
Jimy Tiltman: folds 
DUkalisUA: raises $3 to $4
lumen21: folds 
wang19790906: calls $3
CAJUN890: folds 
*** FLOP *** [2d Jd 6c]
wang19790906: checks 
DUkalisUA: bets $6.80
wang19790906: calls $6.80
*** TURN *** [2d Jd 6c] [9c]
wang19790906: checks 
DUkalisUA: bets $14.55
wang19790906: folds 
Uncalled bet ($14.55) returned to DUkalisUA
DUkalisUA collected $22.06 from pot
DUkalisUA: doesn't show hand 
*** SUMMARY ***
Total pot $23.10 | Rake $1.04 
Board [2d Jd 6c 9c]
Seat 1: Pvsx. folded before Flop (didn't bet)
Seat 2: RICKA16 folded before Flop (didn't bet)
Seat 3: CAJUN890 folded before Flop
Seat 4: matiko09 folded before Flop (didn't bet)
Seat 5: Jimy Tiltman folded before Flop (didn't bet)
Seat 6: DUkalisUA (button) collected ($22.06)
Seat 7: lumen21 (small blind) folded before Flop
Seat 9: wang19790906 (big blind) folded on the Turn





PokerStars Hand #150800290595:  Hold'em No Limit ($0.25/$0.50 USD) - 2016/03/23 13:59:59 CET [2016/03/23 8:59:59 ET]
Table 'Pyrrhus' 9-max Seat #2 is the button
Seat 1: lumen21 ($50 in chips) 
Seat 2: Zeeshka ($50 in chips) 
Seat 3: IvanUrgant ($82.62 in chips) 
Seat 4: GriffinBerg ($28.50 in chips) 
Seat 5: Moszes360 ($61 in chips) 
Seat 7: matiko09 ($137.44 in chips) 
Seat 8: dndngod ($82.98 in chips) 
Seat 9: CvMCvMCvM ($113.86 in chips) 
IvanUrgant: posts small blind $0.25
GriffinBerg: posts big blind $0.50
Ahangama: sits out 
*** HOLE CARDS ***
Dealt to matiko09 [4s 8s]
Moszes360: folds 
matiko09: folds 
dndngod: folds 
CvMCvMCvM: folds 
lumen21: raises $0.75 to $1.25
Zeeshka: folds 
IvanUrgant: folds 
GriffinBerg: calls $0.75
*** FLOP *** [9d Qs 2s]
GriffinBerg: checks 
lumen21: bets $2.02
GriffinBerg: folds 
Uncalled bet ($2.02) returned to lumen21
lumen21 collected $2.63 from pot
lumen21: doesn't show hand 
*** SUMMARY ***
Total pot $2.75 | Rake $0.12 
Board [9d Qs 2s]
Seat 1: lumen21 collected ($2.63)
Seat 2: Zeeshka (button) folded before Flop (didn't bet)
Seat 3: IvanUrgant (small blind) folded before Flop
Seat 4: GriffinBerg (big blind) folded on the Flop
Seat 5: Moszes360 folded before Flop (didn't bet)
Seat 7: matiko09 folded before Flop (didn't bet)
Seat 8: dndngod folded before Flop (didn't bet)
Seat 9: CvMCvMCvM folded before Flop (didn't bet)





PokerStars Hand #150800294076:  Hold'em No Limit ($0.50/$1.00 USD) - 2016/03/23 14:00:05 CET [2016/03/23 9:00:05 ET]
Table 'Donar II' 9-max Seat #4 is the button
Seat 1: Effort92 ($112.22 in chips) 
Seat 2: nobrunobru1 ($81.34 in chips) 
Seat 3: st-germ30 ($97.20 in chips) 
Seat 4: DUkalisUA ($123.67 in chips) 
Seat 5: matiko09 ($100 in chips) 
Seat 6: ardo888 ($119.53 in chips) 
matiko09: posts small blind $0.50
ardo888: posts big blind $1
$-Twackle-$: sits out 
oxfordtenzin: sits out 
Effort92: posts the ante $0.20
nobrunobru1: posts the ante $0.20
st-germ30: posts the ante $0.20
DUkalisUA: posts the ante $0.20
matiko09: posts the ante $0.20
ardo888: posts the ante $0.20
*** HOLE CARDS ***
Dealt to matiko09 [Qh 7c]
Effort92: folds 
nobrunobru1: raises $1 to $2
st-germ30: folds 
DUkalisUA: folds 
matiko09: folds 
ardo888: folds 
Uncalled bet ($1) returned to nobrunobru1
nobrunobru1 collected $3.70 from pot
nobrunobru1: doesn't show hand 
*** SUMMARY ***
Total pot $3.70 | Rake $0 
Seat 1: Effort92 folded before Flop (didn't bet)
Seat 2: nobrunobru1 collected ($3.70)
Seat 3: st-germ30 folded before Flop (didn't bet)
Seat 4: DUkalisUA (button) folded before Flop (didn't bet)
Seat 5: matiko09 (small blind) folded before Flop
Seat 6: ardo888 (big blind) folded before Flop





PokerStars Hand #150800299749:  Hold'em No Limit ($1/$2 USD) - 2016/03/23 14:00:16 CET [2016/03/23 9:00:16 ET]
Table 'Achaia' 9-max Seat #1 is the button
Seat 1: ilaviiitech ($200 in chips) 
Seat 2: InsomniaRU ($219.16 in chips) 
Seat 3: matiko09 ($200 in chips) 
Seat 5: Do-Man22 ($116.96 in chips) 
Seat 6: nickreason17 ($200 in chips) 
Seat 7: morosun ($210.14 in chips) 
Seat 9: glanza_mike ($200 in chips) 
InsomniaRU: posts small blind $1
matiko09: posts big blind $2
nailz83: sits out 
Do-Man22: posts big blind $2
$-Twackle-$: sits out 
*** HOLE CARDS ***
Dealt to matiko09 [7d Ah]
Do-Man22: raises $6 to $8
nickreason17: folds 
morosun: folds 
glanza_mike: folds 
ilaviiitech: folds 
InsomniaRU: folds 
matiko09: folds 
Uncalled bet ($6) returned to Do-Man22
Do-Man22 collected $5 from pot
Do-Man22: doesn't show hand 
*** SUMMARY ***
Total pot $5 | Rake $0 
Seat 1: ilaviiitech (button) folded before Flop (didn't bet)
Seat 2: InsomniaRU (small blind) folded before Flop
Seat 3: matiko09 (big blind) folded before Flop
Seat 5: Do-Man22 collected ($5)
Seat 6: nickreason17 folded before Flop (didn't bet)
Seat 7: morosun folded before Flop (didn't bet)
Seat 9: glanza_mike folded before Flop (didn't bet)





PokerStars Hand #150800305633:  Hold'em No Limit ($1/$2 USD) - 2016/03/23 14:00:27 CET [2016/03/23 9:00:27 ET]
Table 'Herba II' 9-max Seat #3 is the button
Seat 1: matiko09 ($220.48 in chips) 
Seat 2: Moszes360 ($200 in chips) 
Seat 3: Cirilico ($160 in chips) 
Seat 4: DUkalisUA ($297.48 in chips) 
Seat 5: chippo boy ($226.55 in chips) 
Seat 7: InsomniaRU ($200 in chips) 
Seat 9: mrhighryza ($72.55 in chips) 
DUkalisUA: posts small blind $1
chippo boy: posts big blind $2
Too-Anti-To: sits out 
*** HOLE CARDS ***
Dealt to matiko09 [Qd Kh]
InsomniaRU: folds 
mrhighryza: folds 
matiko09: raises $3 to $5
Moszes360: calls $5
Cirilico: folds 
DUkalisUA: folds 
chippo boy: calls $3
*** FLOP *** [8c Jd Ks]
chippo boy: checks 
matiko09: bets $10
Moszes360: calls $10
chippo boy: folds 
*** TURN *** [8c Jd Ks] [7s]
matiko09: checks 
Moszes360: bets $22.69
matiko09: calls $22.69
*** RIVER *** [8c Jd Ks 7s] [Ah]
matiko09: checks 
Moszes360: checks 
*** SHOW DOWN ***
matiko09: shows [Qd Kh] (a pair of Kings)
Moszes360: shows [Kc Jc] (two pair, Kings and Jacks)
Moszes360 collected $78.58 from pot
*** SUMMARY ***
Total pot $81.38 | Rake $2.80 
Board [8c Jd Ks 7s Ah]
Seat 1: matiko09 showed [Qd Kh] and lost with a pair of Kings
Seat 2: Moszes360 showed [Kc Jc] and won ($78.58) with two pair, Kings and Jacks
Seat 3: Cirilico (button) folded before Flop (didn't bet)
Seat 4: DUkalisUA (small blind) folded before Flop
Seat 5: chippo boy (big blind) folded on the Flop
Seat 7: InsomniaRU folded before Flop (didn't bet)
Seat 9: mrhighryza folded before Flop (didn't bet)





PokerStars Hand #150800309671:  Hold'em No Limit ($1/$2 USD) - 2016/03/23 14:00:35 CET [2016/03/23 9:00:35 ET]
Table 'Berbericia II' 9-max Seat #5 is the button
Seat 1: daniferdoser ($200 in chips) 
Seat 2: Moszes360 ($233.52 in chips) 
Seat 3: Fish4trips ($200 in chips) 
Seat 4: bennetb77 ($91.87 in chips) 
Seat 5: darren1031 ($267.73 in chips) 
Seat 6: Charity86 ($168.38 in chips) 
Seat 7: $-Twackle-$ ($200 in chips) 
Seat 8: matiko09 ($297.51 in chips) 
Seat 9: B@ngel ($200 in chips) 
Charity86: posts small blind $1
$-Twackle-$: posts big blind $2
*** HOLE CARDS ***
Dealt to matiko09 [2h Kc]
matiko09: folds 
B@ngel: folds 
daniferdoser: folds 
Moszes360: raises $4 to $6
Fish4trips: folds 
bennetb77: folds 
darren1031: folds 
Charity86: calls $5
$-Twackle-$: folds 
*** FLOP *** [Td 9h 7d]
Charity86: bets $6.68
Moszes360: folds 
Uncalled bet ($6.68) returned to Charity86
Charity86 collected $13.37 from pot
*** SUMMARY ***
Total pot $14 | Rake $0.63 
Board [Td 9h 7d]
Seat 1: daniferdoser folded before Flop (didn't bet)
Seat 2: Moszes360 folded on the Flop
Seat 3: Fish4trips folded before Flop (didn't bet)
Seat 4: bennetb77 folded before Flop (didn't bet)
Seat 5: darren1031 (button) folded before Flop (didn't bet)
Seat 6: Charity86 (small blind) collected ($13.37)
Seat 7: $-Twackle-$ (big blind) folded before Flop
Seat 8: matiko09 folded before Flop (didn't bet)
Seat 9: B@ngel folded before Flop (didn't bet)





PokerStars Hand #150800311167:  Hold'em No Limit ($0.50/$1.00 USD) - 2016/03/23 14:00:38 CET [2016/03/23 9:00:38 ET]
Table 'Merope II' 9-max Seat #4 is the button
Seat 1: Jimy Tiltman ($110.44 in chips) 
Seat 2: Zeeshka ($100 in chips) 
Seat 3: Sherlockplay ($139.20 in chips) 
Seat 4: YuriiSolodya ($45.98 in chips) 
Seat 5: DUkalisUA ($100 in chips) 
Seat 6: Effort92 ($100 in chips) 
Seat 7: matiko09 ($100 in chips) 
Seat 8: titentei ($95 in chips) 
Seat 9: RICKA16 ($99.50 in chips) 
DUkalisUA: posts small blind $0.50
Effort92: posts big blind $1
*** HOLE CARDS ***
Dealt to matiko09 [Qh Tc]
matiko09: folds 
titentei: folds 
RICKA16: folds 
Jimy Tiltman: folds 
Zeeshka: folds 
Sherlockplay: folds 
YuriiSolodya: folds 
DUkalisUA: folds 
Uncalled bet ($0.50) returned to Effort92
Effort92 collected $1 from pot
Effort92: doesn't show hand 
*** SUMMARY ***
Total pot $1 | Rake $0 
Seat 1: Jimy Tiltman folded before Flop (didn't bet)
Seat 2: Zeeshka folded before Flop (didn't bet)
Seat 3: Sherlockplay folded before Flop (didn't bet)
Seat 4: YuriiSolodya (button) folded before Flop (didn't bet)
Seat 5: DUkalisUA (small blind) folded before Flop
Seat 6: Effort92 (big blind) collected ($1)
Seat 7: matiko09 folded before Flop (didn't bet)
Seat 8: titentei folded before Flop (didn't bet)
Seat 9: RICKA16 folded before Flop (didn't bet)





PokerStars Hand #150800317341:  Hold'em No Limit ($0.50/$1.00 USD) - 2016/03/23 14:00:49 CET [2016/03/23 9:00:49 ET]
Table 'Smiley' 9-max Seat #8 is the button
Seat 1: xHourglass ($100 in chips) 
Seat 2: Jimy Tiltman ($138.20 in chips) 
Seat 3: matiko09 ($100 in chips) 
Seat 4: Zeeshka ($156.81 in chips) 
Seat 5: DUkalisUA ($192.20 in chips) 
Seat 6: blackmont111 ($110.30 in chips) 
Seat 7: Moszes360 ($100 in chips) 
Seat 8: momtscheto ($18.03 in chips) 
Seat 9: Pvsx. ($100 in chips) 
Pvsx.: posts small blind $0.50
xHourglass: posts big blind $1
*** HOLE CARDS ***
Dealt to matiko09 [Td Jc]
Jimy Tiltman: folds 
matiko09: folds 
Zeeshka: raises $2 to $3
DUkalisUA: folds 
blackmont111: folds 
Moszes360: folds 
momtscheto: raises $15.03 to $18.03 and is all-in
Pvsx.: folds 
xHourglass: folds 
Zeeshka: calls $15.03
*** FIRST FLOP *** [3c 3s Tc]
*** FIRST TURN *** [3c 3s Tc] [Jh]
*** FIRST RIVER *** [3c 3s Tc Jh] [8c]
*** SECOND FLOP *** [Js Qs 5c]
*** SECOND TURN *** [Js Qs 5c] [2s]
*** SECOND RIVER *** [Js Qs 5c 2s] [8h]
*** FIRST SHOW DOWN ***
Zeeshka: shows [Kd Qh] (a pair of Threes)
momtscheto: shows [Ah As] (two pair, Aces and Threes)
momtscheto collected $17.94 from pot
*** SECOND SHOW DOWN ***
Zeeshka: shows [Kd Qh] (a pair of Queens)
momtscheto: shows [Ah As] (a pair of Aces)
momtscheto collected $17.93 from pot
*** SUMMARY ***
Total pot $37.56 | Rake $1.69 
Hand was run twice
FIRST Board [3c 3s Tc Jh 8c]
SECOND Board [Js Qs 5c 2s 8h]
Seat 1: xHourglass (big blind) folded before Flop
Seat 2: Jimy Tiltman folded before Flop (didn't bet)
Seat 3: matiko09 folded before Flop (didn't bet)
Seat 4: Zeeshka showed [Kd Qh] and lost with a pair of Threes, and lost with a pair of Queens
Seat 5: DUkalisUA folded before Flop (didn't bet)
Seat 6: blackmont111 folded before Flop (didn't bet)
Seat 7: Moszes360 folded before Flop (didn't bet)
Seat 8: momtscheto (button) showed [Ah As] and won ($17.94) with two pair, Aces and Threes, and won ($17.93) with a pair of Aces
Seat 9: Pvsx. (small blind) folded before Flop





PokerStars Hand #150800318095:  Hold'em No Limit ($0.50/$1.00 USD) - 2016/03/23 14:00:51 CET [2016/03/23 9:00:51 ET]
Table 'Donar II' 9-max Seat #5 is the button
Seat 1: Effort92 ($112.02 in chips) 
Seat 2: nobrunobru1 ($83.84 in chips) 
Seat 3: st-germ30 ($97 in chips) 
Seat 4: DUkalisUA ($123.47 in chips) 
Seat 5: matiko09 ($100 in chips) 
Seat 6: ardo888 ($118.33 in chips) 
Seat 8: $-Twackle-$ ($100 in chips) 
ardo888: posts small blind $0.50
$-Twackle-$: posts big blind $1
oxfordtenzin: sits out 
Effort92: posts the ante $0.20
nobrunobru1: posts the ante $0.20
st-germ30: posts the ante $0.20
DUkalisUA: posts the ante $0.20
matiko09: posts the ante $0.20
ardo888: posts the ante $0.20
$-Twackle-$: posts the ante $0.20
*** HOLE CARDS ***
Dealt to matiko09 [9s 9h]
Effort92: folds 
nobrunobru1: folds 
st-germ30: raises $2 to $3
DUkalisUA: folds 
matiko09: calls $3
ardo888: folds 
$-Twackle-$: folds 
*** FLOP *** [Ad 5s 8c]
st-germ30: bets $4
matiko09: calls $4
*** TURN *** [Ad 5s 8c] [2h]
st-germ30: checks 
matiko09: checks 
*** RIVER *** [Ad 5s 8c 2h] [3h]
st-germ30: checks 
matiko09: checks 
*** SHOW DOWN ***
st-germ30: shows [Qd Td] (high card Ace)
matiko09: shows [9s 9h] (a pair of Nines)
matiko09 collected $16.14 from pot
*** SUMMARY ***
Total pot $16.90 | Rake $0.76 
Board [Ad 5s 8c 2h 3h]
Seat 1: Effort92 folded before Flop (didn't bet)
Seat 2: nobrunobru1 folded before Flop (didn't bet)
Seat 3: st-germ30 showed [Qd Td] and lost with high card Ace
Seat 4: DUkalisUA folded before Flop (didn't bet)
Seat 5: matiko09 (button) showed [9s 9h] and won ($16.14) with a pair of Nines
Seat 6: ardo888 (small blind) folded before Flop
Seat 8: $-Twackle-$ (big blind) folded before Flop





PokerStars Hand #150800320778:  Hold'em No Limit ($1/$2 USD) - 2016/03/23 14:00:55 CET [2016/03/23 9:00:55 ET]
Table 'Achaia' 9-max Seat #2 is the button
Seat 1: ilaviiitech ($200 in chips) 
Seat 2: InsomniaRU ($218.16 in chips) 
Seat 3: matiko09 ($200 in chips) 
Seat 4: nailz83 ($200 in chips) 
Seat 5: Do-Man22 ($119.96 in chips) 
Seat 6: nickreason17 ($200 in chips) 
Seat 7: morosun ($210.14 in chips) 
Seat 9: glanza_mike ($200 in chips) 
matiko09: posts small blind $1
nailz83: posts big blind $2
$-Twackle-$: sits out 
*** HOLE CARDS ***
Dealt to matiko09 [Ks 9s]
Do-Man22: folds 
nickreason17: raises $4 to $6
morosun: calls $6
glanza_mike: folds 
ilaviiitech: folds 
InsomniaRU: folds 
matiko09: folds 
nailz83: calls $4
*** FLOP *** [3d 5h 8h]
nailz83: checks 
nickreason17: bets $12
morosun: calls $12
nailz83: folds 
*** TURN *** [3d 5h 8h] [6s]
nickreason17: bets $29
morosun: folds 
Uncalled bet ($29) returned to nickreason17
nickreason17 collected $41.06 from pot
*** SUMMARY ***
Total pot $43 | Rake $1.94 
Board [3d 5h 8h 6s]
Seat 1: ilaviiitech folded before Flop (didn't bet)
Seat 2: InsomniaRU (button) folded before Flop (didn't bet)
Seat 3: matiko09 (small blind) folded before Flop
Seat 4: nailz83 (big blind) folded on the Flop
Seat 5: Do-Man22 folded before Flop (didn't bet)
Seat 6: nickreason17 collected ($41.06)
Seat 7: morosun folded on the Turn
Seat 9: glanza_mike folded before Flop (didn't bet)





PokerStars Hand #150800321839:  Hold'em No Limit ($1/$2 USD) - 2016/03/23 14:00:57 CET [2016/03/23 9:00:57 ET]
Table 'Kypria II' 9-max Seat #7 is the button
Seat 1: geldwolfje ($135.42 in chips) 
Seat 2: coinflip_si ($203 in chips) 
Seat 3: seouljam ($203.45 in chips) 
Seat 5: InsomniaRU ($403.78 in chips) 
Seat 6: matiko09 ($277.69 in chips) 
Seat 7: DUkalisUA ($200 in chips) 
Seat 8: Fish4trips ($329.19 in chips) 
Seat 9: Moszes360 ($200 in chips) 
Fish4trips: posts small blind $1
Moszes360: posts big blind $2
VolanDog: sits out 
*** HOLE CARDS ***
Dealt to matiko09 [8c As]
geldwolfje said, "sorry i had ace"
geldwolfje: folds 
coinflip_si: folds 
seouljam: folds 
InsomniaRU: raises $3 to $5
seouljam said, "play the player not the cards!"
matiko09: folds 
DUkalisUA: folds 
Fish4trips: folds 
Moszes360: folds 
Uncalled bet ($3) returned to InsomniaRU
InsomniaRU collected $5 from pot
InsomniaRU: doesn't show hand 
*** SUMMARY ***
Total pot $5 | Rake $0 
Seat 1: geldwolfje folded before Flop (didn't bet)
Seat 2: coinflip_si folded before Flop (didn't bet)
Seat 3: seouljam folded before Flop (didn't bet)
Seat 5: InsomniaRU collected ($5)
Seat 6: matiko09 folded before Flop (didn't bet)
Seat 7: DUkalisUA (button) folded before Flop (didn't bet)
Seat 8: Fish4trips (small blind) folded before Flop
Seat 9: Moszes360 (big blind) folded before Flop





PokerStars Hand #150800322760:  Hold'em No Limit ($0.50/$1.00 USD) - 2016/03/23 14:00:59 CET [2016/03/23 9:00:59 ET]
Table 'Kippes' 9-max Seat #7 is the button
Seat 1: Pvsx. ($120.31 in chips) 
Seat 2: RICKA16 ($130.13 in chips) 
Seat 3: CAJUN890 ($119.97 in chips) 
Seat 4: matiko09 ($105.07 in chips) 
Seat 5: Jimy Tiltman ($116.86 in chips) 
Seat 6: DUkalisUA ($111.26 in chips) 
Seat 7: lumen21 ($113.52 in chips) 
Seat 9: wang19790906 ($71.12 in chips) 
wang19790906: posts small blind $0.50
Pvsx.: posts big blind $1
*** HOLE CARDS ***
Dealt to matiko09 [Ks 8h]
RICKA16: folds 
CAJUN890: folds 
matiko09: folds 
Jimy Tiltman: folds 
DUkalisUA: raises $1.50 to $2.50
lumen21: folds 
albert_ratza joins the table at seat #8 
wang19790906: folds 
Pvsx.: folds 
Uncalled bet ($1.50) returned to DUkalisUA
DUkalisUA collected $2.50 from pot
DUkalisUA: doesn't show hand 
*** SUMMARY ***
Total pot $2.50 | Rake $0 
Seat 1: Pvsx. (big blind) folded before Flop
Seat 2: RICKA16 folded before Flop (didn't bet)
Seat 3: CAJUN890 folded before Flop (didn't bet)
Seat 4: matiko09 folded before Flop (didn't bet)
Seat 5: Jimy Tiltman folded before Flop (didn't bet)
Seat 6: DUkalisUA collected ($2.50)
Seat 7: lumen21 (button) folded before Flop (didn't bet)
Seat 9: wang19790906 (small blind) folded before Flop





PokerStars Hand #150800324443:  Hold'em No Limit ($0.25/$0.50 USD) - 2016/03/23 14:01:02 CET [2016/03/23 9:01:02 ET]
Table 'Pyrrhus' 9-max Seat #3 is the button
Seat 1: lumen21 ($51.38 in chips) 
Seat 2: Zeeshka ($50 in chips) 
Seat 3: IvanUrgant ($82.37 in chips) 
Seat 4: GriffinBerg ($27.25 in chips) 
Seat 6: Ahangama ($50 in chips) 
Seat 7: matiko09 ($137.44 in chips) 
Seat 8: dndngod ($82.98 in chips) 
Seat 9: CvMCvMCvM ($113.86 in chips) 
GriffinBerg: posts small blind $0.25
Moszes360: is sitting out 
Ahangama: posts big blind $0.50
*** HOLE CARDS ***
Dealt to matiko09 [8s 7c]
Moszes360 leaves the table
ZonTTT joins the table at seat #5 
matiko09: folds 
dndngod: folds 
CvMCvMCvM: folds 
lumen21: raises $1 to $1.50
Zeeshka: folds 
IvanUrgant: folds 
GriffinBerg: raises $2.50 to $4
Ahangama: folds 
lumen21: folds 
Uncalled bet ($2.50) returned to GriffinBerg
GriffinBerg collected $3.50 from pot
*** SUMMARY ***
Total pot $3.50 | Rake $0 
Seat 1: lumen21 folded before Flop
Seat 2: Zeeshka folded before Flop (didn't bet)
Seat 3: IvanUrgant (button) folded before Flop (didn't bet)
Seat 4: GriffinBerg (small blind) collected ($3.50)
Seat 6: Ahangama (big blind) folded before Flop
Seat 7: matiko09 folded before Flop (didn't bet)
Seat 8: dndngod folded before Flop (didn't bet)
Seat 9: CvMCvMCvM folded before Flop (didn't bet)





PokerStars Hand #150800326462:  Hold'em No Limit ($0.25/$0.50 USD) - 2016/03/23 14:01:06 CET [2016/03/23 9:01:06 ET]
Table 'Belnika' 9-max Seat #8 is the button
Seat 1: yellowfever0 ($13.19 in chips) 
Seat 2: NeverRegret7 ($59.93 in chips) 
Seat 3: ChiChioChi ($80.67 in chips) 
Seat 4: matiko09 ($65.35 in chips) 
Seat 5: IvanUrgant ($50 in chips) 
Seat 6: Ahangama ($56.75 in chips) 
Seat 8: lumen21 ($63.47 in chips) 
Seat 9: dndngod ($59.16 in chips) 
dndngod: posts small blind $0.25
yellowfever0: posts big blind $0.50
CvMCvMCvM: sits out 
*** HOLE CARDS ***
Dealt to matiko09 [Ac 8c]
NeverRegret7: raises $0.75 to $1.25
ChiChioChi: folds 
matiko09: folds 
IvanUrgant: folds 
Ahangama: calls $1.25
lumen21: folds 
dndngod: folds 
yellowfever0: calls $0.75
*** FLOP *** [Jh 2c 2d]
yellowfever0: checks 
NeverRegret7: bets $1.91
Ahangama: folds 
yellowfever0: calls $1.91
*** TURN *** [Jh 2c 2d] [7h]
yellowfever0: checks 
NeverRegret7: checks 
*** RIVER *** [Jh 2c 2d 7h] [7d]
yellowfever0: bets $3.73
NeverRegret7: folds 
Uncalled bet ($3.73) returned to yellowfever0
yellowfever0 collected $7.47 from pot
yellowfever0: doesn't show hand 
*** SUMMARY ***
Total pot $7.82 | Rake $0.35 
Board [Jh 2c 2d 7h 7d]
Seat 1: yellowfever0 (big blind) collected ($7.47)
Seat 2: NeverRegret7 folded on the River
Seat 3: ChiChioChi folded before Flop (didn't bet)
Seat 4: matiko09 folded before Flop (didn't bet)
Seat 5: IvanUrgant folded before Flop (didn't bet)
Seat 6: Ahangama folded on the Flop
Seat 8: lumen21 (button) folded before Flop (didn't bet)
Seat 9: dndngod (small blind) folded before Flop





PokerStars Hand #150800329699:  Hold'em No Limit ($0.50/$1.00 USD) - 2016/03/23 14:01:12 CET [2016/03/23 9:01:12 ET]
Table 'Atlantis' 9-max Seat #5 is the button
Seat 1: xHourglass ($172.27 in chips) 
Seat 2: tffff2006 ($50.84 in chips) 
Seat 3: CAJUN890 ($108.79 in chips) 
Seat 4: matiko09 ($116.95 in chips) 
Seat 5: Pvsx. ($100 in chips) 
Seat 6: Jimy Tiltman ($114.56 in chips) 
Seat 8: DUkalisUA ($107.05 in chips) 
Jimy Tiltman: posts small blind $0.50
Zeeshka: is sitting out 
DUkalisUA: posts big blind $1
RICKA16: sits out 
*** HOLE CARDS ***
Dealt to matiko09 [Qh Th]
Zeeshka leaves the table
xHourglass: folds 
tffff2006: calls $1
CAJUN890: raises $2 to $3
matiko09: folds 
Pvsx.: calls $3
Jimy Tiltman: folds 
DUkalisUA: folds 
tffff2006: raises $8.50 to $11.50
Sherlockplay joins the table at seat #7 
CAJUN890: folds 
Pvsx.: folds 
Uncalled bet ($8.50) returned to tffff2006
tffff2006 collected $10.50 from pot
tffff2006: doesn't show hand 
*** SUMMARY ***
Total pot $10.50 | Rake $0 
Seat 1: xHourglass folded before Flop (didn't bet)
Seat 2: tffff2006 collected ($10.50)
Seat 3: CAJUN890 folded before Flop
Seat 4: matiko09 folded before Flop (didn't bet)
Seat 5: Pvsx. (button) folded before Flop
Seat 6: Jimy Tiltman (small blind) folded before Flop
Seat 8: DUkalisUA (big blind) folded before Flop





PokerStars Hand #150800338902:  Hold'em No Limit ($0.50/$1.00 USD) - 2016/03/23 14:01:28 CET [2016/03/23 9:01:28 ET]
Table 'Merope II' 9-max Seat #5 is the button
Seat 1: Jimy Tiltman ($110.44 in chips) 
Seat 2: Zeeshka ($100 in chips) 
Seat 3: Sherlockplay ($139.20 in chips) 
Seat 4: YuriiSolodya ($45.98 in chips) 
Seat 5: DUkalisUA ($100 in chips) 
Seat 6: Effort92 ($100.50 in chips) 
Seat 7: matiko09 ($100 in chips) 
Seat 8: titentei ($95 in chips) 
Seat 9: RICKA16 ($99.50 in chips) 
Effort92: posts small blind $0.50
matiko09: posts big blind $1
*** HOLE CARDS ***
Dealt to matiko09 [3d Jh]
titentei: folds 
RICKA16: folds 
Jimy Tiltman: folds 
Zeeshka: folds 
Sherlockplay: raises $1.50 to $2.50
YuriiSolodya: folds 
DUkalisUA: folds 
Effort92: raises $5.50 to $8
matiko09: folds 
Sherlockplay: calls $5.50
*** FLOP *** [Kc Ad 2d]
Effort92: checks 
Sherlockplay: checks 
*** TURN *** [Kc Ad 2d] [2s]
Effort92: checks 
Sherlockplay: checks 
*** RIVER *** [Kc Ad 2d 2s] [Tc]
Effort92: checks 
Sherlockplay: checks 
*** SHOW DOWN ***
Effort92: shows [5s 5d] (two pair, Fives and Deuces)
Sherlockplay: shows [Qd Qh] (two pair, Queens and Deuces)
Sherlockplay collected $16.24 from pot
*** SUMMARY ***
Total pot $17 | Rake $0.76 
Board [Kc Ad 2d 2s Tc]
Seat 1: Jimy Tiltman folded before Flop (didn't bet)
Seat 2: Zeeshka folded before Flop (didn't bet)
Seat 3: Sherlockplay showed [Qd Qh] and won ($16.24) with two pair, Queens and Deuces
Seat 4: YuriiSolodya folded before Flop (didn't bet)
Seat 5: DUkalisUA (button) folded before Flop (didn't bet)
Seat 6: Effort92 (small blind) showed [5s 5d] and lost with two pair, Fives and Deuces
Seat 7: matiko09 (big blind) folded before Flop
Seat 8: titentei folded before Flop (didn't bet)
Seat 9: RICKA16 folded before Flop (didn't bet)





PokerStars Hand #150800343338:  Hold'em No Limit ($1/$2 USD) - 2016/03/23 14:01:36 CET [2016/03/23 9:01:36 ET]
Table 'Kypria II' 9-max Seat #8 is the button
Seat 1: geldwolfje ($135.42 in chips) 
Seat 2: coinflip_si ($203 in chips) 
Seat 3: seouljam ($203.45 in chips) 
Seat 5: InsomniaRU ($406.78 in chips) 
Seat 6: matiko09 ($277.69 in chips) 
Seat 7: DUkalisUA ($200 in chips) 
Seat 8: Fish4trips ($328.19 in chips) 
Seat 9: Moszes360 ($200 in chips) 
Moszes360: posts small blind $1
geldwolfje: posts big blind $2
VolanDog: sits out 
*** HOLE CARDS ***
Dealt to matiko09 [2c Ts]
geldwolfje said, "sorry sorry"
coinflip_si: folds 
seouljam: folds 
seouljam said, "insomnia is your typical russian maniac"
InsomniaRU: folds 
matiko09: folds 
DUkalisUA: folds 
Fish4trips: folds 
Moszes360: raises $4 to $6
geldwolfje: folds 
Uncalled bet ($4) returned to Moszes360
Moszes360 collected $4 from pot
Moszes360: doesn't show hand 
seouljam said, "who 3 bets preflop far too much"
*** SUMMARY ***
Total pot $4 | Rake $0 
Seat 1: geldwolfje (big blind) folded before Flop
Seat 2: coinflip_si folded before Flop (didn't bet)
Seat 3: seouljam folded before Flop (didn't bet)
Seat 5: InsomniaRU folded before Flop (didn't bet)
Seat 6: matiko09 folded before Flop (didn't bet)
Seat 7: DUkalisUA folded before Flop (didn't bet)
Seat 8: Fish4trips (button) folded before Flop (didn't bet)
Seat 9: Moszes360 (small blind) collected ($4)





PokerStars Hand #150800344540:  Hold'em No Limit ($1/$2 USD) - 2016/03/23 14:01:39 CET [2016/03/23 9:01:39 ET]
Table 'Alma II' 9-max Seat #2 is the button
Seat 1: berggren ($216.75 in chips) 
Seat 2: glanza_mike ($200 in chips) 
Seat 4: daniferdoser ($200 in chips) 
Seat 5: dah44 ($208.10 in chips) 
Seat 6: InsomniaRU ($200 in chips) 
Seat 8: matiko09 ($390.20 in chips) 
Seat 9: carflam7 ($157 in chips) 
$-Twackle-$ will be allowed to play after the button
daniferdoser: posts small blind $1
dah44: posts big blind $2
*** HOLE CARDS ***
Dealt to matiko09 [8c 7d]
InsomniaRU: raises $3 to $5
matiko09: folds 
carflam7: calls $5
berggren: calls $5
glanza_mike: folds 
daniferdoser: folds 
dah44: folds 
*** FLOP *** [7c 2s Jc]
InsomniaRU: checks 
carflam7: checks 
berggren: bets $12
InsomniaRU: folds 
carflam7: folds 
Uncalled bet ($12) returned to berggren
berggren collected $17.19 from pot
berggren: doesn't show hand 
*** SUMMARY ***
Total pot $18 | Rake $0.81 
Board [7c 2s Jc]
Seat 1: berggren collected ($17.19)
Seat 2: glanza_mike (button) folded before Flop (didn't bet)
Seat 4: daniferdoser (small blind) folded before Flop
Seat 5: dah44 (big blind) folded before Flop
Seat 6: InsomniaRU folded on the Flop
Seat 8: matiko09 folded before Flop (didn't bet)
Seat 9: carflam7 folded on the Flop





PokerStars Hand #150800345684:  Hold'em No Limit ($0.50/$1.00 USD) - 2016/03/23 14:01:40 CET [2016/03/23 9:01:40 ET]
Table 'Kippes' 9-max Seat #9 is the button
Seat 1: Pvsx. ($119.31 in chips) 
Seat 2: RICKA16 ($130.13 in chips) 
Seat 3: CAJUN890 ($119.97 in chips) 
Seat 4: matiko09 ($105.07 in chips) 
Seat 5: Jimy Tiltman ($116.86 in chips) 
Seat 6: DUkalisUA ($112.76 in chips) 
Seat 7: lumen21 ($113.52 in chips) 
Seat 9: wang19790906 ($70.62 in chips) 
Pvsx.: posts small blind $0.50
RICKA16: posts big blind $1
albert_ratza: sits out 
*** HOLE CARDS ***
Dealt to matiko09 [6d 9c]
CAJUN890: folds 
matiko09: folds 
Jimy Tiltman: folds 
DUkalisUA: raises $2 to $3
lumen21: folds 
wang19790906: folds 
Pvsx.: folds 
RICKA16: folds 
Uncalled bet ($2) returned to DUkalisUA
DUkalisUA collected $2.50 from pot
DUkalisUA: doesn't show hand 
*** SUMMARY ***
Total pot $2.50 | Rake $0 
Seat 1: Pvsx. (small blind) folded before Flop
Seat 2: RICKA16 (big blind) folded before Flop
Seat 3: CAJUN890 folded before Flop (didn't bet)
Seat 4: matiko09 folded before Flop (didn't bet)
Seat 5: Jimy Tiltman folded before Flop (didn't bet)
Seat 6: DUkalisUA collected ($2.50)
Seat 7: lumen21 folded before Flop (didn't bet)
Seat 9: wang19790906 (button) folded before Flop (didn't bet)





PokerStars Hand #150800349678:  Hold'em No Limit ($1/$2 USD) - 2016/03/23 14:01:47 CET [2016/03/23 9:01:47 ET]
Table 'Herba II' 9-max Seat #4 is the button
Seat 1: matiko09 ($200 in chips) 
Seat 2: Moszes360 ($240.89 in chips) 
Seat 3: Cirilico ($160 in chips) 
Seat 4: DUkalisUA ($296.48 in chips) 
Seat 5: chippo boy ($221.55 in chips) 
Seat 6: Too-Anti-To ($200 in chips) 
Seat 7: InsomniaRU ($200 in chips) 
Seat 9: mrhighryza ($72.55 in chips) 
chippo boy: posts small blind $1
Too-Anti-To: posts big blind $2
*** HOLE CARDS ***
Dealt to matiko09 [3d 3s]
InsomniaRU: folds 
mrhighryza: folds 
matiko09: raises $3 to $5
Moszes360: folds 
Cirilico: folds 
DUkalisUA: folds 
chippo boy: calls $4
Too-Anti-To: folds 
*** FLOP *** [9s 4s Ac]
chippo boy: checks 
matiko09: checks 
*** TURN *** [9s 4s Ac] [8c]
chippo boy: checks 
matiko09: checks 
*** RIVER *** [9s 4s Ac 8c] [Qs]
chippo boy: checks 
matiko09: checks 
*** SHOW DOWN ***
chippo boy: shows [Kc Jh] (high card Ace)
matiko09: shows [3d 3s] (a pair of Threes)
matiko09 collected $11.46 from pot
*** SUMMARY ***
Total pot $12 | Rake $0.54 
Board [9s 4s Ac 8c Qs]
Seat 1: matiko09 showed [3d 3s] and won ($11.46) with a pair of Threes
Seat 2: Moszes360 folded before Flop (didn't bet)
Seat 3: Cirilico folded before Flop (didn't bet)
Seat 4: DUkalisUA (button) folded before Flop (didn't bet)
Seat 5: chippo boy (small blind) showed [Kc Jh] and lost with high card Ace
Seat 6: Too-Anti-To (big blind) folded before Flop
Seat 7: InsomniaRU folded before Flop (didn't bet)
Seat 9: mrhighryza folded before Flop (didn't bet)





PokerStars Hand #150800351301:  Hold'em No Limit ($1/$2 USD) - 2016/03/23 14:01:50 CET [2016/03/23 9:01:50 ET]
Table 'Achaia' 9-max Seat #3 is the button
Seat 1: ilaviiitech ($200 in chips) 
Seat 2: InsomniaRU ($218.16 in chips) 
Seat 3: matiko09 ($200 in chips) 
Seat 4: nailz83 ($194 in chips) 
Seat 5: Do-Man22 ($119.96 in chips) 
Seat 6: nickreason17 ($223.06 in chips) 
Seat 7: morosun ($192.14 in chips) 
Seat 9: glanza_mike ($200 in chips) 
nailz83: posts small blind $1
Do-Man22: posts big blind $2
$-Twackle-$: sits out 
*** HOLE CARDS ***
Dealt to matiko09 [Jh 2d]
nickreason17: folds 
morosun: folds 
glanza_mike: folds 
ilaviiitech: folds 
InsomniaRU: folds 
matiko09: folds 
nailz83: folds 
Uncalled bet ($1) returned to Do-Man22
Do-Man22 collected $2 from pot
Do-Man22: doesn't show hand 
*** SUMMARY ***
Total pot $2 | Rake $0 
Seat 1: ilaviiitech folded before Flop (didn't bet)
Seat 2: InsomniaRU folded before Flop (didn't bet)
Seat 3: matiko09 (button) folded before Flop (didn't bet)
Seat 4: nailz83 (small blind) folded before Flop
Seat 5: Do-Man22 (big blind) collected ($2)
Seat 6: nickreason17 folded before Flop (didn't bet)
Seat 7: morosun folded before Flop (didn't bet)
Seat 9: glanza_mike folded before Flop (didn't bet)





PokerStars Hand #150800353309:  Hold'em No Limit ($1/$2 USD) - 2016/03/23 14:01:54 CET [2016/03/23 9:01:54 ET]
Table 'Kiess' 9-max Seat #8 is the button
Seat 1: Cirilico ($196.76 in chips) 
Seat 2: DUkalisUA ($694.52 in chips) 
Seat 4: Moszes360 ($206.77 in chips) 
Seat 5: chippo boy ($329.02 in chips) 
Seat 6: matiko09 ($277.84 in chips) 
Seat 7: InsomniaRU ($273.17 in chips) 
Seat 8: erfk1958 ($119 in chips) 
Seat 9: Fish4trips ($200 in chips) 
Fish4trips: posts small blind $1
Cirilico: posts big blind $2
*** HOLE CARDS ***
Dealt to matiko09 [9c 5c]
DUkalisUA: folds 
Moszes360: folds 
chippo boy: calls $2
matiko09: folds 
InsomniaRU: folds 
erfk1958: calls $2
Fish4trips: raises $9 to $11
Cirilico: raises $21 to $32
chippo boy: folds 
erfk1958: folds 
Fish4trips: raises $168 to $200 and is all-in
Cirilico: calls $164.76 and is all-in
Uncalled bet ($3.24) returned to Fish4trips
*** FIRST FLOP *** [2s 9s Kh]
*** FIRST TURN *** [2s 9s Kh] [Qc]
*** FIRST RIVER *** [2s 9s Kh Qc] [2h]
*** SECOND FLOP *** [8h Ac Kd]
*** SECOND TURN *** [8h Ac Kd] [2d]
*** SECOND RIVER *** [8h Ac Kd 2d] [Jh]
*** FIRST SHOW DOWN ***
Fish4trips: shows [Qs Qh] (a full house, Queens full of Deuces)
Cirilico: shows [Kc As] (two pair, Kings and Deuces)
Fish4trips collected $197.36 from pot
*** SECOND SHOW DOWN ***
Fish4trips: shows [Qs Qh] (a pair of Queens)
Cirilico: shows [Kc As] (two pair, Aces and Kings)
Cirilico collected $197.36 from pot
*** SUMMARY ***
Total pot $397.52 | Rake $2.80 
Hand was run twice
FIRST Board [2s 9s Kh Qc 2h]
SECOND Board [8h Ac Kd 2d Jh]
Seat 1: Cirilico (big blind) showed [Kc As] and lost with two pair, Kings and Deuces, and won ($197.36) with two pair, Aces and Kings
Seat 2: DUkalisUA folded before Flop (didn't bet)
Seat 4: Moszes360 folded before Flop (didn't bet)
Seat 5: chippo boy folded before Flop
Seat 6: matiko09 folded before Flop (didn't bet)
Seat 7: InsomniaRU folded before Flop (didn't bet)
Seat 8: erfk1958 (button) folded before Flop
Seat 9: Fish4trips (small blind) showed [Qs Qh] and won ($197.36) with a full house, Queens full of Deuces, and lost with a pair of Queens





PokerStars Hand #150800356149:  Hold'em No Limit ($1/$2 USD) - 2016/03/23 14:01:59 CET [2016/03/23 9:01:59 ET]
Table 'Kypria II' 9-max Seat #9 is the button
Seat 1: geldwolfje ($133.42 in chips) 
Seat 2: coinflip_si ($203 in chips) 
Seat 3: seouljam ($203.45 in chips) 
Seat 5: InsomniaRU ($406.78 in chips) 
Seat 6: matiko09 ($277.69 in chips) 
Seat 7: DUkalisUA ($200 in chips) 
Seat 8: Fish4trips ($328.19 in chips) 
Seat 9: Moszes360 ($202 in chips) 
geldwolfje: posts small blind $1
coinflip_si: posts big blind $2
VolanDog: sits out 
*** HOLE CARDS ***
Dealt to matiko09 [As 2d]
seouljam: folds 
InsomniaRU: folds 
matiko09: folds 
DUkalisUA: folds 
Fish4trips: folds 
Moszes360: raises $2.20 to $4.20
geldwolfje: folds 
coinflip_si: calls $2.20
*** FLOP *** [6h 7d Ac]
coinflip_si: checks 
Moszes360: bets $5.92
coinflip_si: calls $5.92
*** TURN *** [6h 7d Ac] [Qs]
coinflip_si: checks 
Moszes360: checks 
*** RIVER *** [6h 7d Ac Qs] [3s]
coinflip_si: checks 
Moszes360: checks 
*** SHOW DOWN ***
coinflip_si: shows [7c Kd] (a pair of Sevens)
Moszes360: mucks hand 
coinflip_si collected $20.28 from pot
*** SUMMARY ***
Total pot $21.24 | Rake $0.96 
Board [6h 7d Ac Qs 3s]
Seat 1: geldwolfje (small blind) folded before Flop
Seat 2: coinflip_si (big blind) showed [7c Kd] and won ($20.28) with a pair of Sevens
Seat 3: seouljam folded before Flop (didn't bet)
Seat 5: InsomniaRU folded before Flop (didn't bet)
Seat 6: matiko09 folded before Flop (didn't bet)
Seat 7: DUkalisUA folded before Flop (didn't bet)
Seat 8: Fish4trips folded before Flop (didn't bet)
Seat 9: Moszes360 (button) mucked [4c 3h]





PokerStars Hand #150800356396:  Hold'em No Limit ($0.50/$1.00 USD) - 2016/03/23 14:01:59 CET [2016/03/23 9:01:59 ET]
Table 'Smiley' 9-max Seat #9 is the button
Seat 1: xHourglass ($100 in chips) 
Seat 2: Jimy Tiltman ($138.20 in chips) 
Seat 3: matiko09 ($100 in chips) 
Seat 4: Zeeshka ($138.78 in chips) 
Seat 5: DUkalisUA ($192.20 in chips) 
Seat 6: blackmont111 ($110.30 in chips) 
Seat 7: Moszes360 ($100 in chips) 
Seat 8: momtscheto ($35.87 in chips) 
Seat 9: Pvsx. ($100 in chips) 
xHourglass: posts small blind $0.50
Jimy Tiltman: posts big blind $1
*** HOLE CARDS ***
Dealt to matiko09 [Jd 5d]
matiko09: folds 
Zeeshka: folds 
DUkalisUA: folds 
blackmont111: folds 
Moszes360: folds 
momtscheto: raises $1 to $2
Pvsx.: folds 
xHourglass: folds 
Jimy Tiltman: folds 
Uncalled bet ($1) returned to momtscheto
momtscheto collected $2.50 from pot
*** SUMMARY ***
Total pot $2.50 | Rake $0 
Seat 1: xHourglass (small blind) folded before Flop
Seat 2: Jimy Tiltman (big blind) folded before Flop
Seat 3: matiko09 folded before Flop (didn't bet)
Seat 4: Zeeshka folded before Flop (didn't bet)
Seat 5: DUkalisUA folded before Flop (didn't bet)
Seat 6: blackmont111 folded before Flop (didn't bet)
Seat 7: Moszes360 folded before Flop (didn't bet)
Seat 8: momtscheto collected ($2.50)
Seat 9: Pvsx. (button) folded before Flop (didn't bet)





PokerStars Hand #150800357937:  Hold'em No Limit ($0.50/$1.00 USD) - 2016/03/23 14:02:02 CET [2016/03/23 9:02:02 ET]
Table 'Donar II' 9-max Seat #6 is the button
Seat 1: Effort92 ($111.82 in chips) 
Seat 2: nobrunobru1 ($83.64 in chips) 
Seat 3: st-germ30 ($89.80 in chips) 
Seat 4: DUkalisUA ($123.27 in chips) 
Seat 5: matiko09 ($108.94 in chips) 
Seat 6: ardo888 ($117.63 in chips) 
Seat 8: $-Twackle-$ ($100 in chips) 
Seat 9: oxfordtenzin ($100 in chips) 
$-Twackle-$: posts small blind $0.50
oxfordtenzin: posts big blind $1
Effort92: posts the ante $0.20
nobrunobru1: posts the ante $0.20
st-germ30: posts the ante $0.20
DUkalisUA: posts the ante $0.20
matiko09: posts the ante $0.20
ardo888: posts the ante $0.20
$-Twackle-$: posts the ante $0.20
oxfordtenzin: posts the ante $0.20
*** HOLE CARDS ***
Dealt to matiko09 [4c Jc]
Effort92: folds 
nobrunobru1: calls $1
st-germ30: folds 
DUkalisUA: folds 
matiko09: folds 
ardo888: folds 
$-Twackle-$: raises $3.50 to $4.50
oxfordtenzin: calls $3.50
nobrunobru1: calls $3.50
*** FLOP *** [Qd 3s 4s]
$-Twackle-$: bets $9.50
oxfordtenzin: calls $9.50
nobrunobru1: folds 
*** TURN *** [Qd 3s 4s] [2c]
$-Twackle-$: checks 
oxfordtenzin: bets $18
$-Twackle-$: folds 
Uncalled bet ($18) returned to oxfordtenzin
oxfordtenzin collected $32.57 from pot
oxfordtenzin: doesn't show hand 
*** SUMMARY ***
Total pot $34.10 | Rake $1.53 
Board [Qd 3s 4s 2c]
Seat 1: Effort92 folded before Flop (didn't bet)
Seat 2: nobrunobru1 folded on the Flop
Seat 3: st-germ30 folded before Flop (didn't bet)
Seat 4: DUkalisUA folded before Flop (didn't bet)
Seat 5: matiko09 folded before Flop (didn't bet)
Seat 6: ardo888 (button) folded before Flop (didn't bet)
Seat 8: $-Twackle-$ (small blind) folded on the Turn
Seat 9: oxfordtenzin (big blind) collected ($32.57)





PokerStars Hand #150800360104:  Hold'em No Limit ($0.25/$0.50 USD) - 2016/03/23 14:02:06 CET [2016/03/23 9:02:06 ET]
Table 'Pyrrhus' 9-max Seat #4 is the button
Seat 1: lumen21 ($50 in chips) 
Seat 2: Zeeshka ($50 in chips) 
Seat 3: IvanUrgant ($82.37 in chips) 
Seat 4: GriffinBerg ($29.25 in chips) 
Seat 6: Ahangama ($50 in chips) 
Seat 7: matiko09 ($137.44 in chips) 
Seat 8: dndngod ($82.98 in chips) 
Seat 9: CvMCvMCvM ($113.86 in chips) 
ZonTTT will be allowed to play after the button
Ahangama: posts small blind $0.25
matiko09: posts big blind $0.50
*** HOLE CARDS ***
Dealt to matiko09 [Kd 9d]
dndngod: raises $1 to $1.50
CvMCvMCvM: folds 
lumen21: folds 
Zeeshka: folds 
IvanUrgant: folds 
GriffinBerg: folds 
Ahangama: folds 
matiko09: folds 
Uncalled bet ($1) returned to dndngod
dndngod collected $1.25 from pot
dndngod: doesn't show hand 
*** SUMMARY ***
Total pot $1.25 | Rake $0 
Seat 1: lumen21 folded before Flop (didn't bet)
Seat 2: Zeeshka folded before Flop (didn't bet)
Seat 3: IvanUrgant folded before Flop (didn't bet)
Seat 4: GriffinBerg (button) folded before Flop (didn't bet)
Seat 6: Ahangama (small blind) folded before Flop
Seat 7: matiko09 (big blind) folded before Flop
Seat 8: dndngod collected ($1.25)
Seat 9: CvMCvMCvM folded before Flop (didn't bet)





PokerStars Hand #150800366715:  Hold'em No Limit ($1/$2 USD) - 2016/03/23 14:02:17 CET [2016/03/23 9:02:17 ET]
Table 'Achaia' 9-max Seat #4 is the button
Seat 1: ilaviiitech ($200 in chips) 
Seat 2: InsomniaRU ($218.16 in chips) 
Seat 3: matiko09 ($200 in chips) 
Seat 4: nailz83 ($193 in chips) 
Seat 5: Do-Man22 ($120.96 in chips) 
Seat 6: nickreason17 ($223.06 in chips) 
Seat 7: morosun ($192.14 in chips) 
Seat 9: glanza_mike ($200 in chips) 
Do-Man22: posts small blind $1
nickreason17: posts big blind $2
$-Twackle-$: sits out 
*** HOLE CARDS ***
Dealt to matiko09 [9h Qs]
morosun: folds 
glanza_mike: folds 
ilaviiitech: folds 
InsomniaRU: raises $3 to $5
matiko09: folds 
nailz83: folds 
Do-Man22: folds 
nickreason17: folds 
Uncalled bet ($3) returned to InsomniaRU
InsomniaRU collected $5 from pot
InsomniaRU: doesn't show hand 
*** SUMMARY ***
Total pot $5 | Rake $0 
Seat 1: ilaviiitech folded before Flop (didn't bet)
Seat 2: InsomniaRU collected ($5)
Seat 3: matiko09 folded before Flop (didn't bet)
Seat 4: nailz83 (button) folded before Flop (didn't bet)
Seat 5: Do-Man22 (small blind) folded before Flop
Seat 6: nickreason17 (big blind) folded before Flop
Seat 7: morosun folded before Flop (didn't bet)
Seat 9: glanza_mike folded before Flop (didn't bet)





PokerStars Hand #150800367240:  Hold'em No Limit ($0.50/$1.00 USD) - 2016/03/23 14:02:18 CET [2016/03/23 9:02:18 ET]
Table 'Kippes' 9-max Seat #1 is the button
Seat 1: Pvsx. ($118.81 in chips) 
Seat 2: RICKA16 ($129.13 in chips) 
Seat 3: CAJUN890 ($119.97 in chips) 
Seat 4: matiko09 ($105.07 in chips) 
Seat 5: Jimy Tiltman ($116.86 in chips) 
Seat 6: DUkalisUA ($114.26 in chips) 
Seat 7: lumen21 ($113.52 in chips) 
Seat 9: wang19790906 ($70.62 in chips) 
RICKA16: posts small blind $0.50
CAJUN890: posts big blind $1
albert_ratza: sits out 
*** HOLE CARDS ***
Dealt to matiko09 [Th 4h]
matiko09: folds 
Jimy Tiltman: folds 
DUkalisUA: folds 
lumen21: folds 
wang19790906: folds 
Pvsx.: raises $1.50 to $2.50
RICKA16: folds 
CAJUN890: folds 
Uncalled bet ($1.50) returned to Pvsx.
Pvsx. collected $2.50 from pot
Pvsx.: doesn't show hand 
*** SUMMARY ***
Total pot $2.50 | Rake $0 
Seat 1: Pvsx. (button) collected ($2.50)
Seat 2: RICKA16 (small blind) folded before Flop
Seat 3: CAJUN890 (big blind) folded before Flop
Seat 4: matiko09 folded before Flop (didn't bet)
Seat 5: Jimy Tiltman folded before Flop (didn't bet)
Seat 6: DUkalisUA folded before Flop (didn't bet)
Seat 7: lumen21 folded before Flop (didn't bet)
Seat 9: wang19790906 folded before Flop (didn't bet)





PokerStars Hand #150800371665:  Hold'em No Limit ($0.50/$1.00 USD) - 2016/03/23 14:02:25 CET [2016/03/23 9:02:25 ET]
Table 'Smiley' 9-max Seat #1 is the button
Seat 1: xHourglass ($100 in chips) 
Seat 2: Jimy Tiltman ($137.20 in chips) 
Seat 3: matiko09 ($100 in chips) 
Seat 4: Zeeshka ($138.78 in chips) 
Seat 5: DUkalisUA ($192.20 in chips) 
Seat 6: blackmont111 ($110.30 in chips) 
Seat 7: Moszes360 ($100 in chips) 
Seat 8: momtscheto ($37.37 in chips) 
Seat 9: Pvsx. ($100 in chips) 
Jimy Tiltman: posts small blind $0.50
matiko09: posts big blind $1
*** HOLE CARDS ***
Dealt to matiko09 [6c 9h]
Zeeshka: folds 
DUkalisUA: raises $2 to $3
blackmont111: folds 
Moszes360: calls $3
momtscheto: calls $3
Pvsx.: raises $11 to $14
xHourglass: folds 
Jimy Tiltman: folds 
matiko09: folds 
DUkalisUA: folds 
Moszes360: folds 
momtscheto: calls $11
*** FLOP *** [5d Js 7s]
momtscheto: bets $23.37 and is all-in
Pvsx.: calls $23.37
*** TURN *** [5d Js 7s] [5s]
*** RIVER *** [5d Js 7s 5s] [2s]
*** SHOW DOWN ***
momtscheto: shows [9c Ts] (a flush, Jack high)
Pvsx.: shows [As Qh] (a flush, Ace high)
Pvsx. collected $79.44 from pot
*** SUMMARY ***
Total pot $82.24 | Rake $2.80 
Board [5d Js 7s 5s 2s]
Seat 1: xHourglass (button) folded before Flop (didn't bet)
Seat 2: Jimy Tiltman (small blind) folded before Flop
Seat 3: matiko09 (big blind) folded before Flop
Seat 4: Zeeshka folded before Flop (didn't bet)
Seat 5: DUkalisUA folded before Flop
Seat 6: blackmont111 folded before Flop (didn't bet)
Seat 7: Moszes360 folded before Flop
Seat 8: momtscheto showed [9c Ts] and lost with a flush, Jack high
Seat 9: Pvsx. showed [As Qh] and won ($79.44) with a flush, Ace high





PokerStars Hand #150800372608:  Hold'em No Limit ($0.25/$0.50 USD) - 2016/03/23 14:02:27 CET [2016/03/23 9:02:27 ET]
Table 'Belnika' 9-max Seat #9 is the button
Seat 1: yellowfever0 ($17.50 in chips) 
Seat 2: NeverRegret7 ($56.77 in chips) 
Seat 3: ChiChioChi ($80.67 in chips) 
Seat 4: matiko09 ($65.35 in chips) 
Seat 5: IvanUrgant ($50 in chips) 
Seat 6: Ahangama ($55.50 in chips) 
Seat 8: lumen21 ($63.47 in chips) 
Seat 9: dndngod ($58.91 in chips) 
yellowfever0: posts small blind $0.25
NeverRegret7: posts big blind $0.50
CvMCvMCvM: sits out 
*** HOLE CARDS ***
Dealt to matiko09 [4h 5h]
ChiChioChi: calls $0.50
matiko09: folds 
IvanUrgant: raises $2 to $2.50
Ahangama: folds 
lumen21: folds 
dndngod: folds 
yellowfever0: folds 
NeverRegret7: folds 
ChiChioChi: calls $2
*** FLOP *** [9h 3h 5c]
ChiChioChi: bets $3.50
IvanUrgant: folds 
Uncalled bet ($3.50) returned to ChiChioChi
ChiChioChi collected $5.49 from pot
ChiChioChi: doesn't show hand 
*** SUMMARY ***
Total pot $5.75 | Rake $0.26 
Board [9h 3h 5c]
Seat 1: yellowfever0 (small blind) folded before Flop
Seat 2: NeverRegret7 (big blind) folded before Flop
Seat 3: ChiChioChi collected ($5.49)
Seat 4: matiko09 folded before Flop (didn't bet)
Seat 5: IvanUrgant folded on the Flop
Seat 6: Ahangama folded before Flop (didn't bet)
Seat 8: lumen21 folded before Flop (didn't bet)
Seat 9: dndngod (button) folded before Flop (didn't bet)





PokerStars Hand #150800376866:  Hold'em No Limit ($1/$2 USD) - 2016/03/23 14:02:34 CET [2016/03/23 9:02:34 ET]
Table 'Achaia' 9-max Seat #5 is the button
Seat 1: ilaviiitech ($200 in chips) 
Seat 2: InsomniaRU ($221.16 in chips) 
Seat 3: matiko09 ($200 in chips) 
Seat 4: nailz83 ($193 in chips) 
Seat 5: Do-Man22 ($119.96 in chips) 
Seat 6: nickreason17 ($221.06 in chips) 
Seat 7: morosun ($192.14 in chips) 
Seat 9: glanza_mike ($200 in chips) 
nickreason17: posts small blind $1
morosun: posts big blind $2
$-Twackle-$: sits out 
*** HOLE CARDS ***
Dealt to matiko09 [3h 2s]
glanza_mike: raises $4 to $6
ilaviiitech: folds 
InsomniaRU: folds 
matiko09: folds 
nailz83: folds 
Do-Man22: calls $6
nickreason17: folds 
morosun: calls $4
*** FLOP *** [2c Kh 9h]
morosun: checks 
glanza_mike: checks 
Do-Man22: bets $22
morosun: calls $22
glanza_mike: folds 
*** TURN *** [2c Kh 9h] [5c]
morosun: checks 
Do-Man22: bets $76
morosun: calls $76
*** RIVER *** [2c Kh 9h 5c] [9c]
morosun: checks 
Do-Man22: bets $15.96 and is all-in
morosun: calls $15.96
*** SHOW DOWN ***
Do-Man22: shows [9d Kd] (a full house, Nines full of Kings)
morosun: shows [6h 5h] (two pair, Nines and Fives)
Do-Man22 collected $244.12 from pot
*** SUMMARY ***
Total pot $246.92 | Rake $2.80 
Board [2c Kh 9h 5c 9c]
Seat 1: ilaviiitech folded before Flop (didn't bet)
Seat 2: InsomniaRU folded before Flop (didn't bet)
Seat 3: matiko09 folded before Flop (didn't bet)
Seat 4: nailz83 folded before Flop (didn't bet)
Seat 5: Do-Man22 (button) showed [9d Kd] and won ($244.12) with a full house, Nines full of Kings
Seat 6: nickreason17 (small blind) folded before Flop
Seat 7: morosun (big blind) showed [6h 5h] and lost with two pair, Nines and Fives
Seat 9: glanza_mike folded on the Flop





PokerStars Hand #150800376931:  Hold'em No Limit ($0.50/$1.00 USD) - 2016/03/23 14:02:34 CET [2016/03/23 9:02:34 ET]
Table 'Atlantis' 9-max Seat #6 is the button
Seat 1: xHourglass ($172.27 in chips) 
Seat 2: tffff2006 ($58.34 in chips) 
Seat 3: CAJUN890 ($105.79 in chips) 
Seat 4: matiko09 ($116.95 in chips) 
Seat 5: Pvsx. ($100 in chips) 
Seat 6: Jimy Tiltman ($114.06 in chips) 
Seat 8: DUkalisUA ($106.05 in chips) 
Seat 9: RICKA16 ($100 in chips) 
DUkalisUA: posts small blind $0.50
RICKA16: posts big blind $1
*** HOLE CARDS ***
Dealt to matiko09 [Ad 6s]
xHourglass: folds 
tffff2006: folds 
CAJUN890: folds 
matiko09: folds 
Pvsx.: folds 
Jimy Tiltman: folds 
DUkalisUA: folds 
Uncalled bet ($0.50) returned to RICKA16
RICKA16 collected $1 from pot
RICKA16: doesn't show hand 
*** SUMMARY ***
Total pot $1 | Rake $0 
Seat 1: xHourglass folded before Flop (didn't bet)
Seat 2: tffff2006 folded before Flop (didn't bet)
Seat 3: CAJUN890 folded before Flop (didn't bet)
Seat 4: matiko09 folded before Flop (didn't bet)
Seat 5: Pvsx. folded before Flop (didn't bet)
Seat 6: Jimy Tiltman (button) folded before Flop (didn't bet)
Seat 8: DUkalisUA (small blind) folded before Flop
Seat 9: RICKA16 (big blind) collected ($1)





PokerStars Hand #150800377648:  Hold'em No Limit ($1/$2 USD) - 2016/03/23 14:02:36 CET [2016/03/23 9:02:36 ET]
Table 'Alma II' 9-max Seat #4 is the button
Seat 1: berggren ($228.94 in chips) 
Seat 2: glanza_mike ($200 in chips) 
Seat 4: daniferdoser ($200 in chips) 
Seat 5: dah44 ($206.10 in chips) 
Seat 6: InsomniaRU ($200 in chips) 
Seat 8: matiko09 ($390.20 in chips) 
Seat 9: carflam7 ($152 in chips) 
dah44: posts small blind $1
InsomniaRU: posts big blind $2
$-Twackle-$: sits out 
*** HOLE CARDS ***
Dealt to matiko09 [Jd Ts]
matiko09: folds 
carflam7: folds 
berggren: folds 
glanza_mike: folds 
cliffdogz leaves the table
T0ny Adams joins the table at seat #7 
daniferdoser: folds 
dah44: folds 
Uncalled bet ($1) returned to InsomniaRU
InsomniaRU collected $2 from pot
InsomniaRU: doesn't show hand 
*** SUMMARY ***
Total pot $2 | Rake $0 
Seat 1: berggren folded before Flop (didn't bet)
Seat 2: glanza_mike folded before Flop (didn't bet)
Seat 4: daniferdoser (button) folded before Flop (didn't bet)
Seat 5: dah44 (small blind) folded before Flop
Seat 6: InsomniaRU (big blind) collected ($2)
Seat 8: matiko09 folded before Flop (didn't bet)
Seat 9: carflam7 folded before Flop (didn't bet)





PokerStars Hand #150800384081:  Hold'em No Limit ($0.25/$0.50 USD) - 2016/03/23 14:02:47 CET [2016/03/23 9:02:47 ET]
Table 'Pyrrhus' 9-max Seat #6 is the button
Seat 1: lumen21 ($50 in chips) 
Seat 2: Zeeshka ($50 in chips) 
Seat 3: IvanUrgant ($82.37 in chips) 
Seat 4: GriffinBerg ($29.25 in chips) 
Seat 6: Ahangama ($50 in chips) 
Seat 7: matiko09 ($136.94 in chips) 
Seat 8: dndngod ($83.73 in chips) 
Seat 9: CvMCvMCvM ($113.86 in chips) 
matiko09: posts small blind $0.25
dndngod: posts big blind $0.50
ZonTTT: sits out 
*** HOLE CARDS ***
Dealt to matiko09 [Kh 7s]
CvMCvMCvM: folds 
lumen21: folds 
Zeeshka: folds 
IvanUrgant: folds 
GriffinBerg: raises $1 to $1.50
Ahangama: folds 
matiko09: folds 
dndngod: folds 
Uncalled bet ($1) returned to GriffinBerg
GriffinBerg collected $1.25 from pot
*** SUMMARY ***
Total pot $1.25 | Rake $0 
Seat 1: lumen21 folded before Flop (didn't bet)
Seat 2: Zeeshka folded before Flop (didn't bet)
Seat 3: IvanUrgant folded before Flop (didn't bet)
Seat 4: GriffinBerg collected ($1.25)
Seat 6: Ahangama (button) folded before Flop (didn't bet)
Seat 7: matiko09 (small blind) folded before Flop
Seat 8: dndngod (big blind) folded before Flop
Seat 9: CvMCvMCvM folded before Flop (didn't bet)





PokerStars Hand #150800386096:  Hold'em No Limit ($0.50/$1.00 USD) - 2016/03/23 14:02:51 CET [2016/03/23 9:02:51 ET]
Table 'Kippes' 9-max Seat #2 is the button
Seat 1: Pvsx. ($120.31 in chips) 
Seat 2: RICKA16 ($128.63 in chips) 
Seat 3: CAJUN890 ($118.97 in chips) 
Seat 4: matiko09 ($105.07 in chips) 
Seat 5: Jimy Tiltman ($116.86 in chips) 
Seat 6: DUkalisUA ($114.26 in chips) 
Seat 7: lumen21 ($113.52 in chips) 
Seat 8: albert_ratza ($62.45 in chips) 
Seat 9: wang19790906 ($70.62 in chips) 
CAJUN890: posts small blind $0.50
matiko09: posts big blind $1
albert_ratza: posts big blind $1
*** HOLE CARDS ***
Dealt to matiko09 [2c 3s]
Jimy Tiltman: folds 
DUkalisUA: raises $3 to $4
lumen21: folds 
albert_ratza: folds 
wang19790906: folds 
Pvsx.: folds 
RICKA16: folds 
CAJUN890: calls $3.50
matiko09: folds 
*** FLOP *** [Jd 5c Kc]
CAJUN890: bets $4.77
DUkalisUA: folds 
Uncalled bet ($4.77) returned to CAJUN890
CAJUN890 collected $9.55 from pot
CAJUN890: doesn't show hand 
*** SUMMARY ***
Total pot $10 | Rake $0.45 
Board [Jd 5c Kc]
Seat 1: Pvsx. folded before Flop (didn't bet)
Seat 2: RICKA16 (button) folded before Flop (didn't bet)
Seat 3: CAJUN890 (small blind) collected ($9.55)
Seat 4: matiko09 (big blind) folded before Flop
Seat 5: Jimy Tiltman folded before Flop (didn't bet)
Seat 6: DUkalisUA folded on the Flop
Seat 7: lumen21 folded before Flop (didn't bet)
Seat 8: albert_ratza folded before Flop
Seat 9: wang19790906 folded before Flop (didn't bet)





PokerStars Hand #150800387399:  Hold'em No Limit ($0.50/$1.00 USD) - 2016/03/23 14:02:53 CET [2016/03/23 9:02:53 ET]
Table 'Atlantis' 9-max Seat #8 is the button
Seat 1: xHourglass ($172.27 in chips) 
Seat 2: tffff2006 ($58.34 in chips) 
Seat 3: CAJUN890 ($105.79 in chips) 
Seat 4: matiko09 ($116.95 in chips) 
Seat 5: Pvsx. ($100 in chips) 
Seat 6: Jimy Tiltman ($114.06 in chips) 
Seat 8: DUkalisUA ($105.55 in chips) 
Seat 9: RICKA16 ($100.50 in chips) 
RICKA16: posts small blind $0.50
xHourglass: posts big blind $1
*** HOLE CARDS ***
Dealt to matiko09 [8c 5d]
tffff2006: calls $1
CAJUN890: folds 
matiko09: folds 
Pvsx.: folds 
Jimy Tiltman: raises $3 to $4
DUkalisUA: raises $4.50 to $8.50
RICKA16: folds 
xHourglass: folds 
tffff2006: folds 
Jimy Tiltman said, "idiot fishreg :D"
Jimy Tiltman: calls $4.50
*** FLOP *** [9c 4c 5c]
Jimy Tiltman: checks 
DUkalisUA: bets $12.28
Jimy Tiltman: raises $93.28 to $105.56 and is all-in
DUkalisUA: folds 
Uncalled bet ($93.28) returned to Jimy Tiltman
Jimy Tiltman collected $42.08 from pot
Jimy Tiltman: doesn't show hand 
*** SUMMARY ***
Total pot $44.06 | Rake $1.98 
Board [9c 4c 5c]
Seat 1: xHourglass (big blind) folded before Flop
Seat 2: tffff2006 folded before Flop
Seat 3: CAJUN890 folded before Flop (didn't bet)
Seat 4: matiko09 folded before Flop (didn't bet)
Seat 5: Pvsx. folded before Flop (didn't bet)
Seat 6: Jimy Tiltman collected ($42.08)
Seat 8: DUkalisUA (button) folded on the Flop
Seat 9: RICKA16 (small blind) folded before Flop





PokerStars Hand #150800390598:  Hold'em No Limit ($1/$2 USD) - 2016/03/23 14:02:59 CET [2016/03/23 9:02:59 ET]
Table 'Herba II' 9-max Seat #5 is the button
Seat 1: matiko09 ($206.46 in chips) 
Seat 2: Moszes360 ($240.89 in chips) 
Seat 3: Cirilico ($160 in chips) 
Seat 4: DUkalisUA ($296.48 in chips) 
Seat 5: chippo boy ($216.55 in chips) 
Seat 6: Too-Anti-To ($198 in chips) 
Seat 7: InsomniaRU ($200 in chips) 
Seat 9: mrhighryza ($72.55 in chips) 
Too-Anti-To: posts small blind $1
InsomniaRU: posts big blind $2
*** HOLE CARDS ***
Dealt to matiko09 [4c Js]
mrhighryza: folds 
matiko09: folds 
Moszes360: folds 
Cirilico: folds 
DUkalisUA: raises $3 to $5
chippo boy: folds 
Too-Anti-To: folds 
InsomniaRU: folds 
Uncalled bet ($3) returned to DUkalisUA
DUkalisUA collected $5 from pot
DUkalisUA: doesn't show hand 
*** SUMMARY ***
Total pot $5 | Rake $0 
Seat 1: matiko09 folded before Flop (didn't bet)
Seat 2: Moszes360 folded before Flop (didn't bet)
Seat 3: Cirilico folded before Flop (didn't bet)
Seat 4: DUkalisUA collected ($5)
Seat 5: chippo boy (button) folded before Flop (didn't bet)
Seat 6: Too-Anti-To (small blind) folded before Flop
Seat 7: InsomniaRU (big blind) folded before Flop
Seat 9: mrhighryza folded before Flop (didn't bet)





PokerStars Hand #150800397006:  Hold'em No Limit ($1/$2 USD) - 2016/03/23 14:03:10 CET [2016/03/23 9:03:10 ET]
Table 'Kiess' 9-max Seat #9 is the button
Seat 1: Cirilico ($197.36 in chips) 
Seat 2: DUkalisUA ($694.52 in chips) 
Seat 4: Moszes360 ($206.77 in chips) 
Seat 5: chippo boy ($327.02 in chips) 
Seat 6: matiko09 ($277.84 in chips) 
Seat 7: InsomniaRU ($273.17 in chips) 
Seat 8: erfk1958 ($117 in chips) 
Seat 9: Fish4trips ($200.60 in chips) 
Cirilico: posts small blind $1
DUkalisUA: posts big blind $2
*** HOLE CARDS ***
Dealt to matiko09 [2s Ac]
Moszes360: folds 
chippo boy: folds 
matiko09: folds 
InsomniaRU: folds 
erfk1958: raises $2 to $4
Fish4trips: folds 
Cirilico: folds 
DUkalisUA: folds 
Uncalled bet ($2) returned to erfk1958
erfk1958 collected $5 from pot
erfk1958: doesn't show hand 
*** SUMMARY ***
Total pot $5 | Rake $0 
Seat 1: Cirilico (small blind) folded before Flop
Seat 2: DUkalisUA (big blind) folded before Flop
Seat 4: Moszes360 folded before Flop (didn't bet)
Seat 5: chippo boy folded before Flop (didn't bet)
Seat 6: matiko09 folded before Flop (didn't bet)
Seat 7: InsomniaRU folded before Flop (didn't bet)
Seat 8: erfk1958 collected ($5)
Seat 9: Fish4trips (button) folded before Flop (didn't bet)





PokerStars Hand #150800397838:  Hold'em No Limit ($1/$2 USD) - 2016/03/23 14:03:11 CET [2016/03/23 9:03:11 ET]
Table 'Alma II' 9-max Seat #5 is the button
Seat 1: berggren ($228.94 in chips) 
Seat 2: glanza_mike ($200 in chips) 
Seat 4: daniferdoser ($200 in chips) 
Seat 5: dah44 ($205.10 in chips) 
Seat 6: InsomniaRU ($201 in chips) 
Seat 8: matiko09 ($390.20 in chips) 
Seat 9: carflam7 ($152 in chips) 
InsomniaRU: posts small blind $1
matiko09: posts big blind $2
$-Twackle-$: sits out 
*** HOLE CARDS ***
Dealt to matiko09 [8h Ac]
carflam7: raises $4 to $6
berggren: folds 
glanza_mike: folds 
daniferdoser: folds 
dah44: folds 
InsomniaRU: folds 
matiko09: folds 
Uncalled bet ($4) returned to carflam7
carflam7 collected $5 from pot
*** SUMMARY ***
Total pot $5 | Rake $0 
Seat 1: berggren folded before Flop (didn't bet)
Seat 2: glanza_mike folded before Flop (didn't bet)
Seat 4: daniferdoser folded before Flop (didn't bet)
Seat 5: dah44 (button) folded before Flop (didn't bet)
Seat 6: InsomniaRU (small blind) folded before Flop
Seat 8: matiko09 (big blind) folded before Flop
Seat 9: carflam7 collected ($5)





PokerStars Hand #150800402525:  Hold'em No Limit ($0.25/$0.50 USD) - 2016/03/23 14:03:20 CET [2016/03/23 9:03:20 ET]
Table 'Pyrrhus' 9-max Seat #7 is the button
Seat 1: lumen21 ($50 in chips) 
Seat 2: Zeeshka ($50 in chips) 
Seat 3: IvanUrgant ($82.37 in chips) 
Seat 4: GriffinBerg ($30 in chips) 
Seat 6: Ahangama ($50 in chips) 
Seat 7: matiko09 ($136.69 in chips) 
Seat 8: dndngod ($83.23 in chips) 
Seat 9: CvMCvMCvM ($113.86 in chips) 
dndngod: posts small blind $0.25
CvMCvMCvM: posts big blind $0.50
ZonTTT: sits out 
*** HOLE CARDS ***
Dealt to matiko09 [Qh 7c]
lumen21: folds 
Zeeshka: raises $1 to $1.50
IvanUrgant: folds 
GriffinBerg: folds 
Ahangama: folds 
matiko09: folds 
dndngod: folds 
CvMCvMCvM: folds 
Uncalled bet ($1) returned to Zeeshka
Zeeshka collected $1.25 from pot
Zeeshka: doesn't show hand 
*** SUMMARY ***
Total pot $1.25 | Rake $0 
Seat 1: lumen21 folded before Flop (didn't bet)
Seat 2: Zeeshka collected ($1.25)
Seat 3: IvanUrgant folded before Flop (didn't bet)
Seat 4: GriffinBerg folded before Flop (didn't bet)
Seat 6: Ahangama folded before Flop (didn't bet)
Seat 7: matiko09 (button) folded before Flop (didn't bet)
Seat 8: dndngod (small blind) folded before Flop
Seat 9: CvMCvMCvM (big blind) folded before Flop





PokerStars Hand #150800402798:  Hold'em No Limit ($0.50/$1.00 USD) - 2016/03/23 14:03:20 CET [2016/03/23 9:03:20 ET]
Table 'Kippes' 9-max Seat #3 is the button
Seat 1: Pvsx. ($120.31 in chips) 
Seat 2: RICKA16 ($128.63 in chips) 
Seat 3: CAJUN890 ($124.52 in chips) 
Seat 4: matiko09 ($104.07 in chips) 
Seat 5: Jimy Tiltman ($116.86 in chips) 
Seat 6: DUkalisUA ($110.26 in chips) 
Seat 7: lumen21 ($113.52 in chips) 
Seat 8: albert_ratza ($61.45 in chips) 
Seat 9: wang19790906 ($70.62 in chips) 
matiko09: posts small blind $0.50
Jimy Tiltman: posts big blind $1
*** HOLE CARDS ***
Dealt to matiko09 [6c 5s]
DUkalisUA: folds 
lumen21: folds 
albert_ratza: calls $1
wang19790906: calls $1
Pvsx.: raises $4.50 to $5.50
RICKA16: calls $5.50
CAJUN890: folds 
matiko09: folds 
Jimy Tiltman: folds 
albert_ratza: folds 
wang19790906: folds 
*** FLOP *** [Jc 8s Qh]
Pvsx.: bets $7
RICKA16: calls $7
*** TURN *** [Jc 8s Qh] [3c]
Pvsx.: checks 
RICKA16: bets $20
Pvsx.: folds 
Uncalled bet ($20) returned to RICKA16
RICKA16 collected $27.22 from pot
RICKA16: doesn't show hand 
*** SUMMARY ***
Total pot $28.50 | Rake $1.28 
Board [Jc 8s Qh 3c]
Seat 1: Pvsx. folded on the Turn
Seat 2: RICKA16 collected ($27.22)
Seat 3: CAJUN890 (button) folded before Flop (didn't bet)
Seat 4: matiko09 (small blind) folded before Flop
Seat 5: Jimy Tiltman (big blind) folded before Flop
Seat 6: DUkalisUA folded before Flop (didn't bet)
Seat 7: lumen21 folded before Flop (didn't bet)
Seat 8: albert_ratza folded before Flop
Seat 9: wang19790906 folded before Flop





PokerStars Hand #150800403815:  Hold'em No Limit ($0.50/$1.00 USD) - 2016/03/23 14:03:22 CET [2016/03/23 9:03:22 ET]
Table 'Merope II' 9-max Seat #6 is the button
Seat 1: Jimy Tiltman ($110.44 in chips) 
Seat 2: Zeeshka ($100 in chips) 
Seat 3: Sherlockplay ($147.44 in chips) 
Seat 4: YuriiSolodya ($45.98 in chips) 
Seat 5: DUkalisUA ($100 in chips) 
Seat 6: Effort92 ($100 in chips) 
Seat 7: matiko09 ($100 in chips) 
Seat 8: titentei ($95 in chips) 
Seat 9: RICKA16 ($99.50 in chips) 
matiko09: posts small blind $0.50
titentei: posts big blind $1
*** HOLE CARDS ***
Dealt to matiko09 [Ad As]
RICKA16: raises $2 to $3
Jimy Tiltman: folds 
Zeeshka: folds 
Sherlockplay: folds 
YuriiSolodya: calls $3
DUkalisUA: folds 
Effort92: folds 
matiko09: raises $8 to $11
titentei: folds 
RICKA16: folds 
YuriiSolodya: calls $8
*** FLOP *** [8c 9c Th]
matiko09: bets $18
YuriiSolodya: raises $16.98 to $34.98 and is all-in
matiko09: calls $16.98
*** TURN *** [8c 9c Th] [9h]
*** RIVER *** [8c 9c Th 9h] [9d]
*** SHOW DOWN ***
matiko09: shows [Ad As] (a full house, Nines full of Aces)
YuriiSolodya: mucks hand 
matiko09 collected $93.16 from pot
*** SUMMARY ***
Total pot $95.96 | Rake $2.80 
Board [8c 9c Th 9h 9d]
Seat 1: Jimy Tiltman folded before Flop (didn't bet)
Seat 2: Zeeshka folded before Flop (didn't bet)
Seat 3: Sherlockplay folded before Flop (didn't bet)
Seat 4: YuriiSolodya mucked [Jc Kc]
Seat 5: DUkalisUA folded before Flop (didn't bet)
Seat 6: Effort92 (button) folded before Flop (didn't bet)
Seat 7: matiko09 (small blind) showed [Ad As] and won ($93.16) with a full house, Nines full of Aces
Seat 8: titentei (big blind) folded before Flop
Seat 9: RICKA16 folded before Flop





PokerStars Hand #150800403867:  Hold'em No Limit ($1/$2 USD) - 2016/03/23 14:03:22 CET [2016/03/23 9:03:22 ET]
Table 'Herba II' 9-max Seat #6 is the button
Seat 1: matiko09 ($206.46 in chips) 
Seat 2: Moszes360 ($240.89 in chips) 
Seat 3: Cirilico ($160 in chips) 
Seat 4: DUkalisUA ($299.48 in chips) 
Seat 5: chippo boy ($216.55 in chips) 
Seat 6: Too-Anti-To ($197 in chips) 
Seat 7: InsomniaRU ($200 in chips) 
Seat 9: mrhighryza ($72.55 in chips) 
InsomniaRU: posts small blind $1
mrhighryza: posts big blind $2
*** HOLE CARDS ***
Dealt to matiko09 [9d 7c]
matiko09: folds 
Moszes360: folds 
Cirilico: folds 
DUkalisUA: folds 
chippo boy: raises $4 to $6
Too-Anti-To: folds 
InsomniaRU: folds 
mrhighryza: calls $4
*** FLOP *** [9h 6d 5d]
mrhighryza: checks 
chippo boy: checks 
*** TURN *** [9h 6d 5d] [Th]
mrhighryza: bets $6
chippo boy: raises $10 to $16
mrhighryza: calls $10
*** RIVER *** [9h 6d 5d Th] [Ts]
mrhighryza: checks 
chippo boy: bets $28
mrhighryza: folds 
Uncalled bet ($28) returned to chippo boy
chippo boy collected $42.98 from pot
*** SUMMARY ***
Total pot $45 | Rake $2.02 
Board [9h 6d 5d Th Ts]
Seat 1: matiko09 folded before Flop (didn't bet)
Seat 2: Moszes360 folded before Flop (didn't bet)
Seat 3: Cirilico folded before Flop (didn't bet)
Seat 4: DUkalisUA folded before Flop (didn't bet)
Seat 5: chippo boy collected ($42.98)
Seat 6: Too-Anti-To (button) folded before Flop (didn't bet)
Seat 7: InsomniaRU (small blind) folded before Flop
Seat 9: mrhighryza (big blind) folded on the River





PokerStars Hand #150800405947:  Hold'em No Limit ($1/$2 USD) - 2016/03/23 14:03:26 CET [2016/03/23 9:03:26 ET]
Table 'Kypria II' 9-max Seat #1 is the button
Seat 1: geldwolfje ($132.42 in chips) 
Seat 2: coinflip_si ($213.16 in chips) 
Seat 3: seouljam ($203.45 in chips) 
Seat 5: InsomniaRU ($406.78 in chips) 
Seat 6: matiko09 ($277.69 in chips) 
Seat 7: DUkalisUA ($200 in chips) 
Seat 8: Fish4trips ($328.19 in chips) 
Seat 9: Moszes360 ($200 in chips) 
coinflip_si: posts small blind $1
seouljam: posts big blind $2
VolanDog: sits out 
*** HOLE CARDS ***
Dealt to matiko09 [Ts 8s]
InsomniaRU: folds 
matiko09: folds 
DUkalisUA: folds 
Fish4trips: folds 
Moszes360: folds 
geldwolfje: folds 
coinflip_si: raises $3 to $5
seouljam: folds 
Uncalled bet ($3) returned to coinflip_si
coinflip_si collected $4 from pot
coinflip_si: doesn't show hand 
*** SUMMARY ***
Total pot $4 | Rake $0 
Seat 1: geldwolfje (button) folded before Flop (didn't bet)
Seat 2: coinflip_si (small blind) collected ($4)
Seat 3: seouljam (big blind) folded before Flop
Seat 5: InsomniaRU folded before Flop (didn't bet)
Seat 6: matiko09 folded before Flop (didn't bet)
Seat 7: DUkalisUA folded before Flop (didn't bet)
Seat 8: Fish4trips folded before Flop (didn't bet)
Seat 9: Moszes360 folded before Flop (didn't bet)





PokerStars Hand #150800409183:  Hold'em No Limit ($0.50/$1.00 USD) - 2016/03/23 14:03:31 CET [2016/03/23 9:03:31 ET]
Table 'Smiley' 9-max Seat #2 is the button
Seat 1: xHourglass ($100 in chips) 
Seat 2: Jimy Tiltman ($136.70 in chips) 
Seat 3: matiko09 ($100 in chips) 
Seat 5: DUkalisUA ($189.20 in chips) 
Seat 6: blackmont111 ($110.30 in chips) 
Seat 7: Moszes360 ($100 in chips) 
Seat 9: Pvsx. ($142.07 in chips) 
matiko09: posts small blind $0.50
Zeeshka: is sitting out 
DUkalisUA: posts big blind $1
*** HOLE CARDS ***
Dealt to matiko09 [6c 3s]
Zeeshka leaves the table
blackmont111: folds 
momtscheto leaves the table
Moszes360: folds 
Pvsx.: folds 
xHourglass: raises $2 to $3
Sherlockplay joins the table at seat #8 
Jimy Tiltman: folds 
matiko09: folds 
DUkalisUA: calls $2
*** FLOP *** [8s 5s 8h]
DUkalisUA: checks 
CAJUN890 joins the table at seat #4 
xHourglass: bets $4
DUkalisUA: folds 
Uncalled bet ($4) returned to xHourglass
xHourglass collected $6.21 from pot
xHourglass: doesn't show hand 
*** SUMMARY ***
Total pot $6.50 | Rake $0.29 
Board [8s 5s 8h]
Seat 1: xHourglass collected ($6.21)
Seat 2: Jimy Tiltman (button) folded before Flop (didn't bet)
Seat 3: matiko09 (small blind) folded before Flop
Seat 5: DUkalisUA (big blind) folded on the Flop
Seat 6: blackmont111 folded before Flop (didn't bet)
Seat 7: Moszes360 folded before Flop (didn't bet)
Seat 9: Pvsx. folded before Flop (didn't bet)





PokerStars Hand #150800410009:  Hold'em No Limit ($0.25/$0.50 USD) - 2016/03/23 14:03:33 CET [2016/03/23 9:03:33 ET]
Table 'Belnika' 9-max Seat #1 is the button
Seat 1: yellowfever0 ($17.25 in chips) 
Seat 2: NeverRegret7 ($56.27 in chips) 
Seat 3: ChiChioChi ($83.66 in chips) 
Seat 4: matiko09 ($65.35 in chips) 
Seat 5: IvanUrgant ($50 in chips) 
Seat 6: Ahangama ($55.50 in chips) 
Seat 8: lumen21 ($63.47 in chips) 
Seat 9: dndngod ($58.91 in chips) 
NeverRegret7: posts small blind $0.25
ChiChioChi: posts big blind $0.50
CvMCvMCvM: sits out 
*** HOLE CARDS ***
Dealt to matiko09 [Js Ah]
matiko09: raises $1 to $1.50
IvanUrgant: folds 
Ahangama: folds 
lumen21: folds 
dndngod: folds 
yellowfever0: calls $1.50
NeverRegret7: folds 
ChiChioChi: folds 
*** FLOP *** [Jd 9s 6s]
matiko09: bets $2.50
yellowfever0: folds 
Uncalled bet ($2.50) returned to matiko09
matiko09 collected $3.58 from pot
matiko09: doesn't show hand 
*** SUMMARY ***
Total pot $3.75 | Rake $0.17 
Board [Jd 9s 6s]
Seat 1: yellowfever0 (button) folded on the Flop
Seat 2: NeverRegret7 (small blind) folded before Flop
Seat 3: ChiChioChi (big blind) folded before Flop
Seat 4: matiko09 collected ($3.58)
Seat 5: IvanUrgant folded before Flop (didn't bet)
Seat 6: Ahangama folded before Flop (didn't bet)
Seat 8: lumen21 folded before Flop (didn't bet)
Seat 9: dndngod folded before Flop (didn't bet)





PokerStars Hand #150800411460:  Hold'em No Limit ($0.50/$1.00 USD) - 2016/03/23 14:03:35 CET [2016/03/23 9:03:35 ET]
Table 'Donar II' 9-max Seat #8 is the button
Seat 1: Effort92 ($111.62 in chips) 
Seat 2: nobrunobru1 ($78.94 in chips) 
Seat 3: st-germ30 ($100 in chips) 
Seat 4: DUkalisUA ($123.07 in chips) 
Seat 5: matiko09 ($108.74 in chips) 
Seat 6: ardo888 ($117.43 in chips) 
Seat 8: $-Twackle-$ ($100 in chips) 
Seat 9: oxfordtenzin ($118.37 in chips) 
oxfordtenzin: posts small blind $0.50
Effort92: posts big blind $1
Effort92: posts the ante $0.20
nobrunobru1: posts the ante $0.20
st-germ30: posts the ante $0.20
DUkalisUA: posts the ante $0.20
matiko09: posts the ante $0.20
ardo888: posts the ante $0.20
$-Twackle-$: posts the ante $0.20
oxfordtenzin: posts the ante $0.20
*** HOLE CARDS ***
Dealt to matiko09 [5h 8d]
nobrunobru1: calls $1
st-germ30: folds 
DUkalisUA: folds 
matiko09: folds 
ardo888: folds 
$-Twackle-$: folds 
oxfordtenzin: raises $2 to $3
Effort92: folds 
nobrunobru1: calls $2
*** FLOP *** [Th 4c 9h]
oxfordtenzin: bets $4
nobrunobru1: folds 
Uncalled bet ($4) returned to oxfordtenzin
oxfordtenzin collected $8.21 from pot
oxfordtenzin: doesn't show hand 
*** SUMMARY ***
Total pot $8.60 | Rake $0.39 
Board [Th 4c 9h]
Seat 1: Effort92 (big blind) folded before Flop
Seat 2: nobrunobru1 folded on the Flop
Seat 3: st-germ30 folded before Flop (didn't bet)
Seat 4: DUkalisUA folded before Flop (didn't bet)
Seat 5: matiko09 folded before Flop (didn't bet)
Seat 6: ardo888 folded before Flop (didn't bet)
Seat 8: $-Twackle-$ (button) folded before Flop (didn't bet)
Seat 9: oxfordtenzin (small blind) collected ($8.21)





PokerStars Hand #150800413015:  Hold'em No Limit ($1/$2 USD) - 2016/03/23 14:03:38 CET [2016/03/23 9:03:38 ET]
Table 'Kiess' 9-max Seat #1 is the button
Seat 1: Cirilico ($196.36 in chips) 
Seat 2: DUkalisUA ($692.52 in chips) 
Seat 4: Moszes360 ($206.77 in chips) 
Seat 5: chippo boy ($327.02 in chips) 
Seat 6: matiko09 ($277.84 in chips) 
Seat 7: InsomniaRU ($273.17 in chips) 
Seat 8: erfk1958 ($120 in chips) 
Seat 9: Fish4trips ($200.60 in chips) 
DUkalisUA: posts small blind $1
Moszes360: posts big blind $2
*** HOLE CARDS ***
Dealt to matiko09 [4c Jd]
chippo boy: folds 
matiko09: folds 
InsomniaRU: folds 
erfk1958: folds 
Fish4trips: folds 
Cirilico: raises $3 to $5
DUkalisUA: folds 
Moszes360: calls $3
*** FLOP *** [As 3d 4d]
Moszes360: checks 
Cirilico: bets $7
Moszes360: folds 
Uncalled bet ($7) returned to Cirilico
Cirilico collected $10.50 from pot
Cirilico: doesn't show hand 
*** SUMMARY ***
Total pot $11 | Rake $0.50 
Board [As 3d 4d]
Seat 1: Cirilico (button) collected ($10.50)
Seat 2: DUkalisUA (small blind) folded before Flop
Seat 4: Moszes360 (big blind) folded on the Flop
Seat 5: chippo boy folded before Flop (didn't bet)
Seat 6: matiko09 folded before Flop (didn't bet)
Seat 7: InsomniaRU folded before Flop (didn't bet)
Seat 8: erfk1958 folded before Flop (didn't bet)
Seat 9: Fish4trips folded before Flop (didn't bet)





PokerStars Hand #150800420311:  Hold'em No Limit ($1/$2 USD) - 2016/03/23 14:03:51 CET [2016/03/23 9:03:51 ET]
Table 'Achaia' 9-max Seat #6 is the button
Seat 1: ilaviiitech ($200 in chips) 
Seat 2: InsomniaRU ($221.16 in chips) 
Seat 3: matiko09 ($200 in chips) 
Seat 4: nailz83 ($200 in chips) 
Seat 5: Do-Man22 ($244.12 in chips) 
Seat 6: nickreason17 ($220.06 in chips) 
Seat 7: morosun ($72.18 in chips) 
Seat 8: $-Twackle-$ ($200 in chips) 
Seat 9: glanza_mike ($200 in chips) 
morosun: posts small blind $1
$-Twackle-$: posts big blind $2
*** HOLE CARDS ***
Dealt to matiko09 [7s Jc]
glanza_mike: folds 
ilaviiitech: folds 
InsomniaRU: folds 
matiko09: folds 
nailz83: raises $4 to $6
Do-Man22: folds 
nickreason17: folds 
morosun: folds 
$-Twackle-$: folds 
Uncalled bet ($4) returned to nailz83
nailz83 collected $5 from pot
nailz83: doesn't show hand 
*** SUMMARY ***
Total pot $5 | Rake $0 
Seat 1: ilaviiitech folded before Flop (didn't bet)
Seat 2: InsomniaRU folded before Flop (didn't bet)
Seat 3: matiko09 folded before Flop (didn't bet)
Seat 4: nailz83 collected ($5)
Seat 5: Do-Man22 folded before Flop (didn't bet)
Seat 6: nickreason17 (button) folded before Flop (didn't bet)
Seat 7: morosun (small blind) folded before Flop
Seat 8: $-Twackle-$ (big blind) folded before Flop
Seat 9: glanza_mike folded before Flop (didn't bet)





PokerStars Hand #150800421014:  Hold'em No Limit ($0.25/$0.50 USD) - 2016/03/23 14:03:52 CET [2016/03/23 9:03:52 ET]
Table 'Pyrrhus' 9-max Seat #8 is the button
Seat 1: lumen21 ($50 in chips) 
Seat 2: Zeeshka ($50.75 in chips) 
Seat 3: IvanUrgant ($82.37 in chips) 
Seat 4: GriffinBerg ($30 in chips) 
Seat 6: Ahangama ($50 in chips) 
Seat 7: matiko09 ($136.69 in chips) 
Seat 8: dndngod ($82.98 in chips) 
Seat 9: CvMCvMCvM ($113.36 in chips) 
CvMCvMCvM: posts small blind $0.25
lumen21: posts big blind $0.50
ZonTTT: sits out 
*** HOLE CARDS ***
Dealt to matiko09 [Tc Jh]
Zeeshka: folds 
IvanUrgant: folds 
GriffinBerg: raises $1 to $1.50
Ahangama: folds 
matiko09: folds 
dndngod: calls $1.50
CvMCvMCvM: folds 
lumen21: folds 
*** FLOP *** [3s 9h 4c]
GriffinBerg: checks 
dndngod: checks 
*** TURN *** [3s 9h 4c] [6d]
GriffinBerg: bets $1.45
dndngod: folds 
Uncalled bet ($1.45) returned to GriffinBerg
GriffinBerg collected $3.58 from pot
*** SUMMARY ***
Total pot $3.75 | Rake $0.17 
Board [3s 9h 4c 6d]
Seat 1: lumen21 (big blind) folded before Flop
Seat 2: Zeeshka folded before Flop (didn't bet)
Seat 3: IvanUrgant folded before Flop (didn't bet)
Seat 4: GriffinBerg collected ($3.58)
Seat 6: Ahangama folded before Flop (didn't bet)
Seat 7: matiko09 folded before Flop (didn't bet)
Seat 8: dndngod (button) folded on the Turn
Seat 9: CvMCvMCvM (small blind) folded before Flop





PokerStars Hand #150800431224:  Hold'em No Limit ($1/$2 USD) - 2016/03/23 14:04:10 CET [2016/03/23 9:04:10 ET]
Table 'Alma II' 9-max Seat #6 is the button
Seat 1: berggren ($228.94 in chips) 
Seat 2: glanza_mike ($200 in chips) 
Seat 4: daniferdoser ($200 in chips) 
Seat 5: dah44 ($205.10 in chips) 
Seat 6: InsomniaRU ($200 in chips) 
Seat 8: matiko09 ($388.20 in chips) 
Seat 9: carflam7 ($155 in chips) 
matiko09: posts small blind $1
carflam7: posts big blind $2
$-Twackle-$: sits out 
*** HOLE CARDS ***
Dealt to matiko09 [4h Ac]
berggren: folds 
glanza_mike: raises $4 to $6
daniferdoser: folds 
dah44: folds 
InsomniaRU: folds 
matiko09: folds 
carflam7: folds 
Uncalled bet ($4) returned to glanza_mike
glanza_mike collected $5 from pot
glanza_mike: doesn't show hand 
*** SUMMARY ***
Total pot $5 | Rake $0 
Seat 1: berggren folded before Flop (didn't bet)
Seat 2: glanza_mike collected ($5)
Seat 4: daniferdoser folded before Flop (didn't bet)
Seat 5: dah44 folded before Flop (didn't bet)
Seat 6: InsomniaRU (button) folded before Flop (didn't bet)
Seat 8: matiko09 (small blind) folded before Flop
Seat 9: carflam7 (big blind) folded before Flop





PokerStars Hand #150800432670:  Hold'em No Limit ($1/$2 USD) - 2016/03/23 14:04:12 CET [2016/03/23 9:04:12 ET]
Table 'Ennomos II' 9-max Seat #7 is the button
Seat 3: $-Twackle-$ ($203 in chips) 
Seat 4: glanza_mike ($200 in chips) 
Seat 6: nickreason17 ($233.50 in chips) 
Seat 7: daniferdoser ($200 in chips) 
Seat 8: yyfk ($200 in chips) 
Seat 9: matiko09 ($200 in chips) 
yyfk: posts small blind $1
matiko09: posts big blind $2
ilaviiitech: sits out 
*** HOLE CARDS ***
Dealt to matiko09 [3s 7h]
$-Twackle-$: raises $4 to $6
glanza_mike: folds 
nickreason17: calls $6
daniferdoser: calls $6
yyfk: folds 
matiko09: folds 
*** FLOP *** [2h 5d 7d]
$-Twackle-$: checks 
nickreason17: bets $10.50
daniferdoser: calls $10.50
South011 joins the table at seat #5 
coinflip_si joins the table at seat #2 
coinflip_si leaves the table
$-Twackle-$: folds 
*** TURN *** [2h 5d 7d] [3c]
nickreason17: bets $28.07
Subam joins the table at seat #2 
daniferdoser: calls $28.07
*** RIVER *** [2h 5d 7d 3c] [6d]
nickreason17: checks 
daniferdoser: bets $155.43 and is all-in
nickreason17: folds 
Uncalled bet ($155.43) returned to daniferdoser
daniferdoser collected $95.34 from pot
daniferdoser: doesn't show hand 
*** SUMMARY ***
Total pot $98.14 | Rake $2.80 
Board [2h 5d 7d 3c 6d]
Seat 3: $-Twackle-$ folded on the Flop
Seat 4: glanza_mike folded before Flop (didn't bet)
Seat 6: nickreason17 folded on the River
Seat 7: daniferdoser (button) collected ($95.34)
Seat 8: yyfk (small blind) folded before Flop
Seat 9: matiko09 (big blind) folded before Flop





PokerStars Hand #150800433856:  Hold'em No Limit ($0.50/$1.00 USD) - 2016/03/23 14:04:14 CET [2016/03/23 9:04:14 ET]
Table 'Atlantis' 9-max Seat #9 is the button
Seat 1: xHourglass ($171.27 in chips) 
Seat 2: tffff2006 ($57.34 in chips) 
Seat 3: CAJUN890 ($105.79 in chips) 
Seat 4: matiko09 ($116.95 in chips) 
Seat 5: Pvsx. ($100 in chips) 
Seat 6: Jimy Tiltman ($135.36 in chips) 
Seat 8: DUkalisUA ($100 in chips) 
Seat 9: RICKA16 ($100 in chips) 
xHourglass: posts small blind $0.50
tffff2006: posts big blind $1
Sherlockplay: sits out 
*** HOLE CARDS ***
Dealt to matiko09 [Ad Jc]
CAJUN890: folds 
matiko09: raises $2 to $3
Pvsx.: calls $3
Jimy Tiltman: folds 
DUkalisUA: folds 
RICKA16: folds 
xHourglass: folds 
tffff2006: folds 
*** FLOP *** [Qd 6d Kc]
matiko09: bets $4.15
Pvsx.: calls $4.15
*** TURN *** [Qd 6d Kc] [5s]
matiko09: checks 
Pvsx.: bets $8
matiko09: folds 
Uncalled bet ($8) returned to Pvsx.
Pvsx. collected $15.09 from pot
*** SUMMARY ***
Total pot $15.80 | Rake $0.71 
Board [Qd 6d Kc 5s]
Seat 1: xHourglass (small blind) folded before Flop
Seat 2: tffff2006 (big blind) folded before Flop
Seat 3: CAJUN890 folded before Flop (didn't bet)
Seat 4: matiko09 folded on the Turn
Seat 5: Pvsx. collected ($15.09)
Seat 6: Jimy Tiltman folded before Flop (didn't bet)
Seat 8: DUkalisUA folded before Flop (didn't bet)
Seat 9: RICKA16 (button) folded before Flop (didn't bet)





PokerStars Hand #150800435042:  Hold'em No Limit ($0.25/$0.50 USD) - 2016/03/23 14:04:16 CET [2016/03/23 9:04:16 ET]
Table 'Belnika' 9-max Seat #2 is the button
Seat 1: yellowfever0 ($15.75 in chips) 
Seat 2: NeverRegret7 ($56.02 in chips) 
Seat 3: ChiChioChi ($83.16 in chips) 
Seat 4: matiko09 ($67.43 in chips) 
Seat 5: IvanUrgant ($50 in chips) 
Seat 6: Ahangama ($55.50 in chips) 
Seat 8: lumen21 ($63.47 in chips) 
Seat 9: dndngod ($58.91 in chips) 
ChiChioChi: posts small blind $0.25
matiko09: posts big blind $0.50
CvMCvMCvM: sits out 
*** HOLE CARDS ***
Dealt to matiko09 [Td 9s]
IvanUrgant: folds 
IvanUrgant leaves the table
Ahangama: folds 
Red_Warning joins the table at seat #5 
Red_Warning leaves the table
lumen21: raises $1 to $1.50
ZonTTT joins the table at seat #5 
dndngod: folds 
yellowfever0: folds 
NeverRegret7: folds 
ChiChioChi: folds 
matiko09: folds 
Uncalled bet ($1) returned to lumen21
lumen21 collected $1.25 from pot
lumen21: doesn't show hand 
*** SUMMARY ***
Total pot $1.25 | Rake $0 
Seat 1: yellowfever0 folded before Flop (didn't bet)
Seat 2: NeverRegret7 (button) folded before Flop (didn't bet)
Seat 3: ChiChioChi (small blind) folded before Flop
Seat 4: matiko09 (big blind) folded before Flop
Seat 5: IvanUrgant folded before Flop (didn't bet)
Seat 6: Ahangama folded before Flop (didn't bet)
Seat 8: lumen21 collected ($1.25)
Seat 9: dndngod folded before Flop (didn't bet)





PokerStars Hand #150800435457:  Hold'em No Limit ($1/$2 USD) - 2016/03/23 14:04:17 CET [2016/03/23 9:04:17 ET]
Table 'Kypria II' 9-max Seat #2 is the button
Seat 1: geldwolfje ($132.42 in chips) 
Seat 2: coinflip_si ($215.16 in chips) 
Seat 3: seouljam ($201.45 in chips) 
Seat 4: VolanDog ($200 in chips) 
Seat 5: InsomniaRU ($406.78 in chips) 
Seat 6: matiko09 ($277.69 in chips) 
Seat 7: DUkalisUA ($200 in chips) 
Seat 8: Fish4trips ($328.19 in chips) 
Seat 9: Moszes360 ($200 in chips) 
seouljam: posts small blind $1
VolanDog: posts big blind $2
*** HOLE CARDS ***
Dealt to matiko09 [9d 5h]
InsomniaRU: folds 
matiko09: folds 
DUkalisUA: raises $4 to $6
Fish4trips: folds 
Moszes360: folds 
geldwolfje: folds 
coinflip_si: folds 
seouljam: folds 
VolanDog: folds 
Uncalled bet ($4) returned to DUkalisUA
DUkalisUA collected $5 from pot
DUkalisUA: doesn't show hand 
*** SUMMARY ***
Total pot $5 | Rake $0 
Seat 1: geldwolfje folded before Flop (didn't bet)
Seat 2: coinflip_si (button) folded before Flop (didn't bet)
Seat 3: seouljam (small blind) folded before Flop
Seat 4: VolanDog (big blind) folded before Flop
Seat 5: InsomniaRU folded before Flop (didn't bet)
Seat 6: matiko09 folded before Flop (didn't bet)
Seat 7: DUkalisUA collected ($5)
Seat 8: Fish4trips folded before Flop (didn't bet)
Seat 9: Moszes360 folded before Flop (didn't bet)





PokerStars Hand #150800437844:  Hold'em No Limit ($1/$2 USD) - 2016/03/23 14:04:21 CET [2016/03/23 9:04:21 ET]
Table 'Herba II' 9-max Seat #7 is the button
Seat 1: matiko09 ($206.46 in chips) 
Seat 2: Moszes360 ($240.89 in chips) 
Seat 3: Cirilico ($160 in chips) 
Seat 4: DUkalisUA ($299.48 in chips) 
Seat 5: chippo boy ($237.53 in chips) 
Seat 6: Too-Anti-To ($197 in chips) 
Seat 7: InsomniaRU ($200 in chips) 
Seat 9: mrhighryza ($50.55 in chips) 
mrhighryza: posts small blind $1
matiko09: posts big blind $2
*** HOLE CARDS ***
Dealt to matiko09 [7d 3h]
Moszes360: folds 
Cirilico: folds 
DUkalisUA: folds 
chippo boy: folds 
Too-Anti-To: raises $3 to $5
InsomniaRU: folds 
mrhighryza: folds 
matiko09: folds 
Uncalled bet ($3) returned to Too-Anti-To
Too-Anti-To collected $5 from pot
Too-Anti-To: doesn't show hand 
*** SUMMARY ***
Total pot $5 | Rake $0 
Seat 1: matiko09 (big blind) folded before Flop
Seat 2: Moszes360 folded before Flop (didn't bet)
Seat 3: Cirilico folded before Flop (didn't bet)
Seat 4: DUkalisUA folded before Flop (didn't bet)
Seat 5: chippo boy folded before Flop (didn't bet)
Seat 6: Too-Anti-To collected ($5)
Seat 7: InsomniaRU (button) folded before Flop (didn't bet)
Seat 9: mrhighryza (small blind) folded before Flop





PokerStars Hand #150800440358:  Hold'em No Limit ($0.50/$1.00 USD) - 2016/03/23 14:04:26 CET [2016/03/23 9:04:26 ET]
Table 'Donar II' 9-max Seat #9 is the button
Seat 1: Effort92 ($110.42 in chips) 
Seat 2: nobrunobru1 ($75.74 in chips) 
Seat 3: st-germ30 ($99.80 in chips) 
Seat 4: DUkalisUA ($122.87 in chips) 
Seat 5: matiko09 ($108.54 in chips) 
Seat 6: ardo888 ($117.23 in chips) 
Seat 8: $-Twackle-$ ($100 in chips) 
Seat 9: oxfordtenzin ($123.38 in chips) 
Effort92: posts small blind $0.50
nobrunobru1: posts big blind $1
Effort92: posts the ante $0.20
nobrunobru1: posts the ante $0.20
st-germ30: posts the ante $0.20
DUkalisUA: posts the ante $0.20
matiko09: posts the ante $0.20
ardo888: posts the ante $0.20
$-Twackle-$: posts the ante $0.20
oxfordtenzin: posts the ante $0.20
*** HOLE CARDS ***
Dealt to matiko09 [9h 8c]
st-germ30: folds 
DUkalisUA: folds 
matiko09: folds 
ardo888: folds 
$-Twackle-$: folds 
oxfordtenzin: raises $1 to $2
Effort92: calls $1.50
nobrunobru1: raises $2 to $4
oxfordtenzin is disconnected 
oxfordtenzin is connected 
hammerwife leaves the table
oxfordtenzin: calls $2
Effort92: calls $2
*** FLOP *** [Td Jh 4c]
Effort92: checks 
nobrunobru1: bets $3
oxfordtenzin: calls $3
Effort92: calls $3
*** TURN *** [Td Jh 4c] [6s]
Effort92: checks 
nobrunobru1: bets $3
oxfordtenzin: raises $7 to $10
BKA12 joins the table at seat #7 
BKA12 leaves the table
nickreason17 joins the table at seat #7 
Effort92: folds 
nobrunobru1: folds 
Uncalled bet ($7) returned to oxfordtenzin
oxfordtenzin collected $27.31 from pot
oxfordtenzin: doesn't show hand 
*** SUMMARY ***
Total pot $28.60 | Rake $1.29 
Board [Td Jh 4c 6s]
Seat 1: Effort92 (small blind) folded on the Turn
Seat 2: nobrunobru1 (big blind) folded on the Turn
Seat 3: st-germ30 folded before Flop (didn't bet)
Seat 4: DUkalisUA folded before Flop (didn't bet)
Seat 5: matiko09 folded before Flop (didn't bet)
Seat 6: ardo888 folded before Flop (didn't bet)
Seat 8: $-Twackle-$ folded before Flop (didn't bet)
Seat 9: oxfordtenzin (button) collected ($27.31)





PokerStars Hand #150800441968:  Hold'em No Limit ($1/$2 USD) - 2016/03/23 14:04:28 CET [2016/03/23 9:04:28 ET]
Table 'Alma II' 9-max Seat #8 is the button
Seat 1: berggren ($228.94 in chips) 
Seat 2: glanza_mike ($203 in chips) 
Seat 4: daniferdoser ($200 in chips) 
Seat 5: dah44 ($205.10 in chips) 
Seat 6: InsomniaRU ($200 in chips) 
Seat 8: matiko09 ($387.20 in chips) 
Seat 9: carflam7 ($153 in chips) 
carflam7: posts small blind $1
berggren: posts big blind $2
$-Twackle-$: sits out 
*** HOLE CARDS ***
Dealt to matiko09 [3s Jh]
glanza_mike: folds 
daniferdoser: folds 
dah44: folds 
InsomniaRU: folds 
matiko09: folds 
carflam7: folds 
Uncalled bet ($1) returned to berggren
berggren collected $2 from pot
berggren: doesn't show hand 
*** SUMMARY ***
Total pot $2 | Rake $0 
Seat 1: berggren (big blind) collected ($2)
Seat 2: glanza_mike folded before Flop (didn't bet)
Seat 4: daniferdoser folded before Flop (didn't bet)
Seat 5: dah44 folded before Flop (didn't bet)
Seat 6: InsomniaRU folded before Flop (didn't bet)
Seat 8: matiko09 (button) folded before Flop (didn't bet)
Seat 9: carflam7 (small blind) folded before Flop





PokerStars Hand #150800442143:  Hold'em No Limit ($0.50/$1.00 USD) - 2016/03/23 14:04:29 CET [2016/03/23 9:04:29 ET]
Table 'Kippes' 9-max Seat #4 is the button
Seat 1: Pvsx. ($107.81 in chips) 
Seat 2: RICKA16 ($143.35 in chips) 
Seat 3: CAJUN890 ($124.52 in chips) 
Seat 4: matiko09 ($103.57 in chips) 
Seat 5: Jimy Tiltman ($115.86 in chips) 
Seat 6: DUkalisUA ($110.26 in chips) 
Seat 7: lumen21 ($113.52 in chips) 
Seat 8: albert_ratza ($60.45 in chips) 
Seat 9: wang19790906 ($69.62 in chips) 
Jimy Tiltman: posts small blind $0.50
DUkalisUA: posts big blind $1
*** HOLE CARDS ***
Dealt to matiko09 [5c Qd]
lumen21: folds 
albert_ratza: folds 
wang19790906: folds 
Pvsx.: folds 
RICKA16: raises $2 to $3
CAJUN890: folds 
matiko09: folds 
Jimy Tiltman: folds 
DUkalisUA: folds 
Uncalled bet ($2) returned to RICKA16
RICKA16 collected $2.50 from pot
RICKA16: doesn't show hand 
*** SUMMARY ***
Total pot $2.50 | Rake $0 
Seat 1: Pvsx. folded before Flop (didn't bet)
Seat 2: RICKA16 collected ($2.50)
Seat 3: CAJUN890 folded before Flop (didn't bet)
Seat 4: matiko09 (button) folded before Flop (didn't bet)
Seat 5: Jimy Tiltman (small blind) folded before Flop
Seat 6: DUkalisUA (big blind) folded before Flop
Seat 7: lumen21 folded before Flop (didn't bet)
Seat 8: albert_ratza folded before Flop (didn't bet)
Seat 9: wang19790906 folded before Flop (didn't bet)





PokerStars Hand #150800443220:  Hold'em No Limit ($0.50/$1.00 USD) - 2016/03/23 14:04:31 CET [2016/03/23 9:04:31 ET]
Table 'Smiley' 9-max Seat #3 is the button
Seat 1: xHourglass ($103.21 in chips) 
Seat 2: Jimy Tiltman ($136.70 in chips) 
Seat 3: matiko09 ($100 in chips) 
Seat 5: DUkalisUA ($186.20 in chips) 
Seat 7: Moszes360 ($100 in chips) 
Seat 9: Pvsx. ($142.07 in chips) 
CAJUN890 will be allowed to play after the button
DUkalisUA: posts small blind $0.50
blackmont111: is sitting out 
Moszes360: posts big blind $1
Sherlockplay: sits out 
*** HOLE CARDS ***
Dealt to matiko09 [Ad 3c]
Pvsx.: folds 
xHourglass: folds 
Jimy Tiltman: raises $1 to $2
matiko09: folds 
DUkalisUA: folds 
Moszes360: folds 
Uncalled bet ($1) returned to Jimy Tiltman
Jimy Tiltman collected $2.50 from pot
Jimy Tiltman: doesn't show hand 
*** SUMMARY ***
Total pot $2.50 | Rake $0 
Seat 1: xHourglass folded before Flop (didn't bet)
Seat 2: Jimy Tiltman collected ($2.50)
Seat 3: matiko09 (button) folded before Flop (didn't bet)
Seat 5: DUkalisUA (small blind) folded before Flop
Seat 7: Moszes360 (big blind) folded before Flop
Seat 9: Pvsx. folded before Flop (didn't bet)





PokerStars Hand #150800450849:  Hold'em No Limit ($1/$2 USD) - 2016/03/23 14:04:44 CET [2016/03/23 9:04:44 ET]
Table 'Kiess' 9-max Seat #2 is the button
Seat 1: Cirilico ($201.86 in chips) 
Seat 2: DUkalisUA ($691.52 in chips) 
Seat 4: Moszes360 ($201.77 in chips) 
Seat 5: chippo boy ($327.02 in chips) 
Seat 6: matiko09 ($277.84 in chips) 
Seat 7: InsomniaRU ($273.17 in chips) 
Seat 8: erfk1958 ($120 in chips) 
Seat 9: Fish4trips ($200.60 in chips) 
Moszes360: posts small blind $1
chippo boy: posts big blind $2
*** HOLE CARDS ***
Dealt to matiko09 [7d 3c]
matiko09: folds 
InsomniaRU: folds 
erfk1958: folds 
Fish4trips: folds 
Cirilico: folds 
DUkalisUA: raises $3 to $5
Moszes360: folds 
chippo boy: calls $3
*** FLOP *** [2s Kh Jd]
chippo boy: checks 
DUkalisUA: checks 
*** TURN *** [2s Kh Jd] [4c]
chippo boy: bets $8
DUkalisUA: calls $8
*** RIVER *** [2s Kh Jd 4c] [Qc]
chippo boy: bets $12
DUkalisUA: folds 
Uncalled bet ($12) returned to chippo boy
chippo boy collected $25.78 from pot
*** SUMMARY ***
Total pot $27 | Rake $1.22 
Board [2s Kh Jd 4c Qc]
Seat 1: Cirilico folded before Flop (didn't bet)
Seat 2: DUkalisUA (button) folded on the River
Seat 4: Moszes360 (small blind) folded before Flop
Seat 5: chippo boy (big blind) collected ($25.78)
Seat 6: matiko09 folded before Flop (didn't bet)
Seat 7: InsomniaRU folded before Flop (didn't bet)
Seat 8: erfk1958 folded before Flop (didn't bet)
Seat 9: Fish4trips folded before Flop (didn't bet)





PokerStars Hand #150800451627:  Hold'em No Limit ($1/$2 USD) - 2016/03/23 14:04:45 CET [2016/03/23 9:04:45 ET]
Table 'Kypria II' 9-max Seat #3 is the button
Seat 1: geldwolfje ($132.42 in chips) 
Seat 2: coinflip_si ($215.16 in chips) 
Seat 3: seouljam ($200.45 in chips) 
Seat 4: VolanDog ($200 in chips) 
Seat 5: InsomniaRU ($406.78 in chips) 
Seat 6: matiko09 ($277.69 in chips) 
Seat 7: DUkalisUA ($203 in chips) 
Seat 8: Fish4trips ($328.19 in chips) 
Seat 9: Moszes360 ($200 in chips) 
VolanDog: posts small blind $1
InsomniaRU: posts big blind $2
*** HOLE CARDS ***
Dealt to matiko09 [6h 2s]
matiko09: folds 
DUkalisUA: folds 
Fish4trips: folds 
Moszes360: folds 
geldwolfje: raises $4 to $6
coinflip_si: raises $10 to $16
seouljam: folds 
VolanDog: folds 
InsomniaRU: folds 
geldwolfje: calls $10
*** FLOP *** [2c Ad Th]
geldwolfje: checks 
coinflip_si: checks 
*** TURN *** [2c Ad Th] [Qs]
geldwolfje: bets $8
coinflip_si: calls $8
*** RIVER *** [2c Ad Th Qs] [2h]
geldwolfje: bets $10
coinflip_si: folds 
Uncalled bet ($10) returned to geldwolfje
geldwolfje collected $48.70 from pot
geldwolfje: doesn't show hand 
*** SUMMARY ***
Total pot $51 | Rake $2.30 
Board [2c Ad Th Qs 2h]
Seat 1: geldwolfje collected ($48.70)
Seat 2: coinflip_si folded on the River
Seat 3: seouljam (button) folded before Flop (didn't bet)
Seat 4: VolanDog (small blind) folded before Flop
Seat 5: InsomniaRU (big blind) folded before Flop
Seat 6: matiko09 folded before Flop (didn't bet)
Seat 7: DUkalisUA folded before Flop (didn't bet)
Seat 8: Fish4trips folded before Flop (didn't bet)
Seat 9: Moszes360 folded before Flop (didn't bet)





PokerStars Hand #150800455138:  Hold'em No Limit ($1/$2 USD) - 2016/03/23 14:04:51 CET [2016/03/23 9:04:51 ET]
Table 'Alma II' 9-max Seat #9 is the button
Seat 1: berggren ($229.94 in chips) 
Seat 2: glanza_mike ($203 in chips) 
Seat 4: daniferdoser ($200 in chips) 
Seat 5: dah44 ($205.10 in chips) 
Seat 6: InsomniaRU ($200 in chips) 
Seat 8: matiko09 ($387.20 in chips) 
Seat 9: carflam7 ($152 in chips) 
berggren: posts small blind $1
glanza_mike: posts big blind $2
$-Twackle-$: sits out 
*** HOLE CARDS ***
Dealt to matiko09 [2c Ts]
daniferdoser: folds 
dah44: raises $2 to $4
InsomniaRU: folds 
matiko09: folds 
carflam7: folds 
berggren: folds 
glanza_mike: raises $10 to $14
dah44: calls $10
*** FLOP *** [4h Kd 6s]
glanza_mike: bets $9.14
dah44: folds 
Uncalled bet ($9.14) returned to glanza_mike
glanza_mike collected $27.70 from pot
glanza_mike: doesn't show hand 
*** SUMMARY ***
Total pot $29 | Rake $1.30 
Board [4h Kd 6s]
Seat 1: berggren (small blind) folded before Flop
Seat 2: glanza_mike (big blind) collected ($27.70)
Seat 4: daniferdoser folded before Flop (didn't bet)
Seat 5: dah44 folded on the Flop
Seat 6: InsomniaRU folded before Flop (didn't bet)
Seat 8: matiko09 folded before Flop (didn't bet)
Seat 9: carflam7 (button) folded before Flop (didn't bet)





PokerStars Hand #150800455060:  Hold'em No Limit ($1/$2 USD) - 2016/03/23 14:04:51 CET [2016/03/23 9:04:51 ET]
Table 'Achaia' 9-max Seat #7 is the button
Seat 1: ilaviiitech ($200 in chips) 
Seat 2: InsomniaRU ($221.16 in chips) 
Seat 3: matiko09 ($200 in chips) 
Seat 4: nailz83 ($203 in chips) 
Seat 5: Do-Man22 ($244.12 in chips) 
Seat 6: nickreason17 ($220.06 in chips) 
Seat 7: morosun ($71.18 in chips) 
Seat 8: $-Twackle-$ ($200 in chips) 
Seat 9: glanza_mike ($200 in chips) 
$-Twackle-$: posts small blind $1
glanza_mike: posts big blind $2
*** HOLE CARDS ***
Dealt to matiko09 [Jc Qd]
ilaviiitech: folds 
InsomniaRU: raises $3 to $5
matiko09: folds 
nailz83: folds 
Do-Man22: folds 
nickreason17: folds 
morosun: folds 
Do-Man22 leaves the table
$-Twackle-$: folds 
glanza_mike: calls $3
*** FLOP *** [4s Kd 4d]
glanza_mike: checks 
InsomniaRU: checks 
*** TURN *** [4s Kd 4d] [8d]
glanza_mike: checks 
InsomniaRU: checks 
*** RIVER *** [4s Kd 4d 8d] [5h]
glanza_mike: checks 
InsomniaRU: checks 
*** SHOW DOWN ***
glanza_mike: shows [As Qc] (a pair of Fours)
InsomniaRU: shows [3s 3h] (two pair, Fours and Threes)
InsomniaRU collected $10.50 from pot
*** SUMMARY ***
Total pot $11 | Rake $0.50 
Board [4s Kd 4d 8d 5h]
Seat 1: ilaviiitech folded before Flop (didn't bet)
Seat 2: InsomniaRU showed [3s 3h] and won ($10.50) with two pair, Fours and Threes
Seat 3: matiko09 folded before Flop (didn't bet)
Seat 4: nailz83 folded before Flop (didn't bet)
Seat 5: Do-Man22 folded before Flop (didn't bet)
Seat 6: nickreason17 folded before Flop (didn't bet)
Seat 7: morosun (button) folded before Flop (didn't bet)
Seat 8: $-Twackle-$ (small blind) folded before Flop
Seat 9: glanza_mike (big blind) showed [As Qc] and lost with a pair of Fours





PokerStars Hand #150800457025:  Hold'em No Limit ($0.50/$1.00 USD) - 2016/03/23 14:04:54 CET [2016/03/23 9:04:54 ET]
Table 'Smiley' 9-max Seat #5 is the button
Seat 1: xHourglass ($103.21 in chips) 
Seat 2: Jimy Tiltman ($138.20 in chips) 
Seat 3: matiko09 ($100 in chips) 
Seat 5: DUkalisUA ($185.70 in chips) 
Seat 7: Moszes360 ($100 in chips) 
Seat 8: Sherlockplay ($100 in chips) 
Seat 9: Pvsx. ($142.07 in chips) 
Moszes360: posts small blind $0.50
Sherlockplay: posts big blind $1
CAJUN890: sits out 
*** HOLE CARDS ***
Dealt to matiko09 [Ac Tc]
Pvsx.: raises $1.50 to $2.50
xHourglass: folds 
Jimy Tiltman: folds 
matiko09: folds 
DUkalisUA: calls $2.50
Moszes360: folds 
Sherlockplay: calls $1.50
*** FLOP *** [Qd Jh 3c]
Sherlockplay: checks 
Pvsx.: checks 
DUkalisUA: checks 
*** TURN *** [Qd Jh 3c] [9d]
Sherlockplay: bets $6.50
Pvsx.: folds 
DUkalisUA: folds 
Uncalled bet ($6.50) returned to Sherlockplay
Sherlockplay collected $7.64 from pot
Sherlockplay: doesn't show hand 
*** SUMMARY ***
Total pot $8 | Rake $0.36 
Board [Qd Jh 3c 9d]
Seat 1: xHourglass folded before Flop (didn't bet)
Seat 2: Jimy Tiltman folded before Flop (didn't bet)
Seat 3: matiko09 folded before Flop (didn't bet)
Seat 5: DUkalisUA (button) folded on the Turn
Seat 7: Moszes360 (small blind) folded before Flop
Seat 8: Sherlockplay (big blind) collected ($7.64)
Seat 9: Pvsx. folded on the Turn





PokerStars Hand #150800457866:  Hold'em No Limit ($0.25/$0.50 USD) - 2016/03/23 14:04:56 CET [2016/03/23 9:04:56 ET]
Table 'Belnika' 9-max Seat #3 is the button
Seat 1: yellowfever0 ($15.75 in chips) 
Seat 2: NeverRegret7 ($56.02 in chips) 
Seat 3: ChiChioChi ($82.91 in chips) 
Seat 4: matiko09 ($66.93 in chips) 
Seat 5: ZonTTT ($50 in chips) 
Seat 6: Ahangama ($55.50 in chips) 
Seat 8: lumen21 ($64.22 in chips) 
Seat 9: dndngod ($58.91 in chips) 
matiko09: posts small blind $0.25
ZonTTT: posts big blind $0.50
CvMCvMCvM: sits out 
*** HOLE CARDS ***
Dealt to matiko09 [3d Jh]
Ahangama: raises $0.75 to $1.25
lumen21: folds 
dndngod: folds 
yellowfever0: folds 
NeverRegret7: folds 
ChiChioChi: calls $1.25
matiko09: folds 
ZonTTT: folds 
*** FLOP *** [5d 3s Jc]
Ahangama: bets $1.50
ChiChioChi: raises $4.50 to $6
Ahangama: folds 
Uncalled bet ($4.50) returned to ChiChioChi
ChiChioChi collected $5.97 from pot
ChiChioChi: doesn't show hand 
*** SUMMARY ***
Total pot $6.25 | Rake $0.28 
Board [5d 3s Jc]
Seat 1: yellowfever0 folded before Flop (didn't bet)
Seat 2: NeverRegret7 folded before Flop (didn't bet)
Seat 3: ChiChioChi (button) collected ($5.97)
Seat 4: matiko09 (small blind) folded before Flop
Seat 5: ZonTTT (big blind) folded before Flop
Seat 6: Ahangama folded on the Flop
Seat 8: lumen21 folded before Flop (didn't bet)
Seat 9: dndngod folded before Flop (didn't bet)





PokerStars Hand #150800462999:  Hold'em No Limit ($1/$2 USD) - 2016/03/23 14:05:03 CET [2016/03/23 9:05:03 ET]
Table 'Herba II' 9-max Seat #9 is the button
Seat 1: matiko09 ($204.46 in chips) 
Seat 2: Moszes360 ($240.89 in chips) 
Seat 3: Cirilico ($160 in chips) 
Seat 4: DUkalisUA ($299.48 in chips) 
Seat 5: chippo boy ($237.53 in chips) 
Seat 6: Too-Anti-To ($200 in chips) 
Seat 7: InsomniaRU ($200 in chips) 
Seat 9: mrhighryza ($49.55 in chips) 
matiko09: posts small blind $1
Moszes360: posts big blind $2
*** HOLE CARDS ***
Dealt to matiko09 [8c Kd]
Cirilico: folds 
DUkalisUA: folds 
chippo boy: folds 
Too-Anti-To: folds 
InsomniaRU: raises $3 to $5
mrhighryza: folds 
matiko09: folds 
Moszes360: folds 
Uncalled bet ($3) returned to InsomniaRU
InsomniaRU collected $5 from pot
InsomniaRU: doesn't show hand 
*** SUMMARY ***
Total pot $5 | Rake $0 
Seat 1: matiko09 (small blind) folded before Flop
Seat 2: Moszes360 (big blind) folded before Flop
Seat 3: Cirilico folded before Flop (didn't bet)
Seat 4: DUkalisUA folded before Flop (didn't bet)
Seat 5: chippo boy folded before Flop (didn't bet)
Seat 6: Too-Anti-To folded before Flop (didn't bet)
Seat 7: InsomniaRU collected ($5)
Seat 9: mrhighryza (button) folded before Flop (didn't bet)





PokerStars Hand #150800463711:  Hold'em No Limit ($0.25/$0.50 USD) - 2016/03/23 14:05:05 CET [2016/03/23 9:05:05 ET]
Table 'Pyrrhus' 9-max Seat #9 is the button
Seat 1: lumen21 ($50 in chips) 
Seat 4: GriffinBerg ($32.08 in chips) 
Seat 6: Ahangama ($50 in chips) 
Seat 7: matiko09 ($136.69 in chips) 
Seat 8: dndngod ($81.48 in chips) 
Seat 9: CvMCvMCvM ($113.11 in chips) 
lumen21: posts small blind $0.25
Zeeshka: is sitting out 
Zeeshka leaves the table
IvanUrgant: is sitting out 
GriffinBerg: posts big blind $0.50
ZonTTT: sits out 
*** HOLE CARDS ***
Dealt to matiko09 [2c Kh]
edidaz joins the table at seat #2 
IvanUrgant leaves the table
Ahangama: folds 
edidaz leaves the table
Sherlockplay joins the table at seat #2 
matiko09: folds 
dndngod: raises $0.75 to $1.25
Sherlockplay leaves the table
CvMCvMCvM: folds 
lumen21: folds 
GriffinBerg: calls $0.75
*** FLOP *** [8c As Kd]
GriffinBerg: checks 
dndngod: checks 
*** TURN *** [8c As Kd] [6d]
i L00K great joins the table at seat #3 
GriffinBerg: bets $1
dndngod: calls $1
*** RIVER *** [8c As Kd 6d] [5d]
alemão007 joins the table at seat #2 
GriffinBerg: checks 
dndngod: bets $2
GriffinBerg: folds 
Uncalled bet ($2) returned to dndngod
dndngod collected $4.54 from pot
dndngod: doesn't show hand 
*** SUMMARY ***
Total pot $4.75 | Rake $0.21 
Board [8c As Kd 6d 5d]
Seat 1: lumen21 (small blind) folded before Flop
Seat 4: GriffinBerg (big blind) folded on the River
Seat 6: Ahangama folded before Flop (didn't bet)
Seat 7: matiko09 folded before Flop (didn't bet)
Seat 8: dndngod collected ($4.54)
Seat 9: CvMCvMCvM (button) folded before Flop (didn't bet)





PokerStars Hand #150800468990:  Hold'em No Limit ($0.50/$1.00 USD) - 2016/03/23 14:05:14 CET [2016/03/23 9:05:14 ET]
Table 'Merope II' 9-max Seat #7 is the button
Seat 1: Jimy Tiltman ($110.44 in chips) 
Seat 2: Zeeshka ($100 in chips) 
Seat 3: Sherlockplay ($147.44 in chips) 
Seat 5: DUkalisUA ($100 in chips) 
Seat 6: Effort92 ($100 in chips) 
Seat 7: matiko09 ($147.18 in chips) 
Seat 8: titentei ($94 in chips) 
Seat 9: RICKA16 ($100 in chips) 
titentei: posts small blind $0.50
RICKA16: posts big blind $1
*** HOLE CARDS ***
Dealt to matiko09 [8s 6d]
Jimy Tiltman: raises $1.50 to $2.50
Zeeshka: folds 
Sherlockplay: folds 
DUkalisUA: calls $2.50
Effort92: folds 
matiko09: folds 
titentei: folds 
RICKA16: folds 
*** FLOP *** [9d Jh Kd]
Jimy Tiltman: checks 
DUkalisUA: checks 
*** TURN *** [9d Jh Kd] [Jd]
Jimy Tiltman: checks 
DUkalisUA: checks 
*** RIVER *** [9d Jh Kd Jd] [5s]
Jimy Tiltman: checks 
DUkalisUA: checks 
*** SHOW DOWN ***
Jimy Tiltman: shows [4c 4h] (two pair, Jacks and Fours)
DUkalisUA: shows [6h 6s] (two pair, Jacks and Sixes)
DUkalisUA collected $6.21 from pot
*** SUMMARY ***
Total pot $6.50 | Rake $0.29 
Board [9d Jh Kd Jd 5s]
Seat 1: Jimy Tiltman showed [4c 4h] and lost with two pair, Jacks and Fours
Seat 2: Zeeshka folded before Flop (didn't bet)
Seat 3: Sherlockplay folded before Flop (didn't bet)
Seat 5: DUkalisUA showed [6h 6s] and won ($6.21) with two pair, Jacks and Sixes
Seat 6: Effort92 folded before Flop (didn't bet)
Seat 7: matiko09 (button) folded before Flop (didn't bet)
Seat 8: titentei (small blind) folded before Flop
Seat 9: RICKA16 (big blind) folded before Flop





PokerStars Hand #150800469579:  Hold'em No Limit ($0.50/$1.00 USD) - 2016/03/23 14:05:15 CET [2016/03/23 9:05:15 ET]
Table 'Kippes' 9-max Seat #5 is the button
Seat 1: Pvsx. ($107.81 in chips) 
Seat 2: RICKA16 ($144.85 in chips) 
Seat 3: CAJUN890 ($124.52 in chips) 
Seat 4: matiko09 ($103.57 in chips) 
Seat 5: Jimy Tiltman ($115.36 in chips) 
Seat 6: DUkalisUA ($109.26 in chips) 
Seat 7: lumen21 ($113.52 in chips) 
Seat 8: albert_ratza ($60.45 in chips) 
Seat 9: wang19790906 ($69.62 in chips) 
DUkalisUA: posts small blind $0.50
lumen21: posts big blind $1
*** HOLE CARDS ***
Dealt to matiko09 [Ah 9h]
albert_ratza: folds 
wang19790906: folds 
Pvsx.: folds 
RICKA16: folds 
CAJUN890: folds 
matiko09: raises $1.50 to $2.50
Jimy Tiltman: folds 
DUkalisUA: raises $6 to $8.50
lumen21: folds 
matiko09: folds 
Uncalled bet ($6) returned to DUkalisUA
DUkalisUA collected $6 from pot
DUkalisUA: doesn't show hand 
*** SUMMARY ***
Total pot $6 | Rake $0 
Seat 1: Pvsx. folded before Flop (didn't bet)
Seat 2: RICKA16 folded before Flop (didn't bet)
Seat 3: CAJUN890 folded before Flop (didn't bet)
Seat 4: matiko09 folded before Flop
Seat 5: Jimy Tiltman (button) folded before Flop (didn't bet)
Seat 6: DUkalisUA (small blind) collected ($6)
Seat 7: lumen21 (big blind) folded before Flop
Seat 8: albert_ratza folded before Flop (didn't bet)
Seat 9: wang19790906 folded before Flop (didn't bet)





PokerStars Hand #150800478502:  Hold'em No Limit ($1/$2 USD) - 2016/03/23 14:05:31 CET [2016/03/23 9:05:31 ET]
Table 'Kiess' 9-max Seat #4 is the button
Seat 1: Cirilico ($201.86 in chips) 
Seat 2: DUkalisUA ($678.52 in chips) 
Seat 4: Moszes360 ($200.77 in chips) 
Seat 5: chippo boy ($339.80 in chips) 
Seat 6: matiko09 ($277.84 in chips) 
Seat 7: InsomniaRU ($273.17 in chips) 
Seat 8: erfk1958 ($120 in chips) 
Seat 9: Fish4trips ($200.60 in chips) 
chippo boy: posts small blind $1
matiko09: posts big blind $2
*** HOLE CARDS ***
Dealt to matiko09 [2h 9c]
InsomniaRU: folds 
erfk1958: folds 
Fish4trips: raises $3 to $5
Cirilico: folds 
DUkalisUA: folds 
Moszes360: folds 
chippo boy: folds 
matiko09: folds 
Uncalled bet ($3) returned to Fish4trips
Fish4trips collected $5 from pot
Fish4trips: doesn't show hand 
*** SUMMARY ***
Total pot $5 | Rake $0 
Seat 1: Cirilico folded before Flop (didn't bet)
Seat 2: DUkalisUA folded before Flop (didn't bet)
Seat 4: Moszes360 (button) folded before Flop (didn't bet)
Seat 5: chippo boy (small blind) folded before Flop
Seat 6: matiko09 (big blind) folded before Flop
Seat 7: InsomniaRU folded before Flop (didn't bet)
Seat 8: erfk1958 folded before Flop (didn't bet)
Seat 9: Fish4trips collected ($5)





PokerStars Hand #150800479378:  Hold'em No Limit ($1/$2 USD) - 2016/03/23 14:05:32 CET [2016/03/23 9:05:32 ET]
Table 'Herba II' 9-max Seat #1 is the button
Seat 1: matiko09 ($203.46 in chips) 
Seat 2: Moszes360 ($238.89 in chips) 
Seat 3: Cirilico ($160 in chips) 
Seat 4: DUkalisUA ($299.48 in chips) 
Seat 5: chippo boy ($237.53 in chips) 
Seat 6: Too-Anti-To ($200 in chips) 
Seat 7: InsomniaRU ($203 in chips) 
Seat 9: mrhighryza ($49.55 in chips) 
Moszes360: posts small blind $1
Cirilico: posts big blind $2
*** HOLE CARDS ***
Dealt to matiko09 [6h Kc]
DUkalisUA: folds 
chippo boy: folds 
Too-Anti-To: raises $3 to $5
InsomniaRU: folds 
mrhighryza: folds 
matiko09: folds 
Moszes360: folds 
Cirilico: folds 
Uncalled bet ($3) returned to Too-Anti-To
Too-Anti-To collected $5 from pot
Too-Anti-To: doesn't show hand 
*** SUMMARY ***
Total pot $5 | Rake $0 
Seat 1: matiko09 (button) folded before Flop (didn't bet)
Seat 2: Moszes360 (small blind) folded before Flop
Seat 3: Cirilico (big blind) folded before Flop
Seat 4: DUkalisUA folded before Flop (didn't bet)
Seat 5: chippo boy folded before Flop (didn't bet)
Seat 6: Too-Anti-To collected ($5)
Seat 7: InsomniaRU folded before Flop (didn't bet)
Seat 9: mrhighryza folded before Flop (didn't bet)





PokerStars Hand #150800484129:  Hold'em No Limit ($1/$2 USD) - 2016/03/23 14:05:40 CET [2016/03/23 9:05:40 ET]
Table 'Kypria II' 9-max Seat #4 is the button
Seat 1: geldwolfje ($157.12 in chips) 
Seat 2: coinflip_si ($200 in chips) 
Seat 3: seouljam ($200.45 in chips) 
Seat 4: VolanDog ($200 in chips) 
Seat 5: InsomniaRU ($404.78 in chips) 
Seat 6: matiko09 ($277.69 in chips) 
Seat 7: DUkalisUA ($203 in chips) 
Seat 8: Fish4trips ($328.19 in chips) 
Seat 9: Moszes360 ($200 in chips) 
InsomniaRU: posts small blind $1
matiko09: posts big blind $2
*** HOLE CARDS ***
Dealt to matiko09 [9h 2d]
DUkalisUA: raises $4 to $6
Fish4trips: folds 
Moszes360: folds 
geldwolfje: calls $6
coinflip_si: raises $20 to $26
seouljam: folds 
VolanDog: folds 
InsomniaRU: folds 
matiko09: folds 
DUkalisUA: folds 
geldwolfje: folds 
Uncalled bet ($20) returned to coinflip_si
coinflip_si collected $21 from pot
coinflip_si: doesn't show hand 
*** SUMMARY ***
Total pot $21 | Rake $0 
Seat 1: geldwolfje folded before Flop
Seat 2: coinflip_si collected ($21)
Seat 3: seouljam folded before Flop (didn't bet)
Seat 4: VolanDog (button) folded before Flop (didn't bet)
Seat 5: InsomniaRU (small blind) folded before Flop
Seat 6: matiko09 (big blind) folded before Flop
Seat 7: DUkalisUA folded before Flop
Seat 8: Fish4trips folded before Flop (didn't bet)
Seat 9: Moszes360 folded before Flop (didn't bet)





PokerStars Hand #150800486633:  Hold'em No Limit ($0.50/$1.00 USD) - 2016/03/23 14:05:45 CET [2016/03/23 9:05:45 ET]
Table 'Atlantis' 9-max Seat #1 is the button
Seat 1: xHourglass ($170.77 in chips) 
Seat 2: tffff2006 ($56.34 in chips) 
Seat 3: CAJUN890 ($105.79 in chips) 
Seat 4: matiko09 ($109.80 in chips) 
Seat 5: Pvsx. ($107.94 in chips) 
Seat 6: Jimy Tiltman ($135.36 in chips) 
Seat 8: DUkalisUA ($100 in chips) 
Seat 9: RICKA16 ($100 in chips) 
tffff2006: posts small blind $0.50
CAJUN890: posts big blind $1
Sherlockplay: sits out 
*** HOLE CARDS ***
Dealt to matiko09 [2h Th]
matiko09: folds 
Pvsx.: folds 
Jimy Tiltman: raises $2 to $3
DUkalisUA: folds 
RICKA16: calls $3
xHourglass: folds 
tffff2006: folds 
CAJUN890: folds 
*** FLOP *** [Kc 2c 5c]
Jimy Tiltman: checks 
RICKA16: checks 
*** TURN *** [Kc 2c 5c] [5h]
Jimy Tiltman: checks 
RICKA16: checks 
*** RIVER *** [Kc 2c 5c 5h] [7h]
Jimy Tiltman: checks 
RICKA16: checks 
*** SHOW DOWN ***
Jimy Tiltman: shows [Ts Js] (a pair of Fives)
RICKA16: shows [Qh Ah] (a pair of Fives - Ace kicker)
RICKA16 collected $7.16 from pot
*** SUMMARY ***
Total pot $7.50 | Rake $0.34 
Board [Kc 2c 5c 5h 7h]
Seat 1: xHourglass (button) folded before Flop (didn't bet)
Seat 2: tffff2006 (small blind) folded before Flop
Seat 3: CAJUN890 (big blind) folded before Flop
Seat 4: matiko09 folded before Flop (didn't bet)
Seat 5: Pvsx. folded before Flop (didn't bet)
Seat 6: Jimy Tiltman showed [Ts Js] and lost with a pair of Fives
Seat 8: DUkalisUA folded before Flop (didn't bet)
Seat 9: RICKA16 showed [Qh Ah] and won ($7.16) with a pair of Fives





PokerStars Hand #150800492091:  Hold'em No Limit ($1/$2 USD) - 2016/03/23 14:05:54 CET [2016/03/23 9:05:54 ET]
Table 'Herba II' 9-max Seat #2 is the button
Seat 1: matiko09 ($203.46 in chips) 
Seat 2: Moszes360 ($237.89 in chips) 
Seat 3: Cirilico ($160 in chips) 
Seat 4: DUkalisUA ($299.48 in chips) 
Seat 5: chippo boy ($237.53 in chips) 
Seat 6: Too-Anti-To ($203 in chips) 
Seat 7: InsomniaRU ($203 in chips) 
Seat 9: mrhighryza ($49.55 in chips) 
Cirilico: posts small blind $1
DUkalisUA: posts big blind $2
*** HOLE CARDS ***
Dealt to matiko09 [Kd Jh]
chippo boy: folds 
Too-Anti-To: folds 
InsomniaRU: folds 
mrhighryza: folds 
matiko09: raises $3 to $5
Moszes360: folds 
Cirilico: folds 
DUkalisUA: folds 
Uncalled bet ($3) returned to matiko09
matiko09 collected $5 from pot
matiko09: doesn't show hand 
*** SUMMARY ***
Total pot $5 | Rake $0 
Seat 1: matiko09 collected ($5)
Seat 2: Moszes360 (button) folded before Flop (didn't bet)
Seat 3: Cirilico (small blind) folded before Flop
Seat 4: DUkalisUA (big blind) folded before Flop
Seat 5: chippo boy folded before Flop (didn't bet)
Seat 6: Too-Anti-To folded before Flop (didn't bet)
Seat 7: InsomniaRU folded before Flop (didn't bet)
Seat 9: mrhighryza folded before Flop (didn't bet)





PokerStars Hand #150800493703:  Hold'em No Limit ($1/$2 USD) - 2016/03/23 14:05:56 CET [2016/03/23 9:05:56 ET]
Table 'Alma II' 9-max Seat #1 is the button
Seat 1: berggren ($228.94 in chips) 
Seat 2: glanza_mike ($216.70 in chips) 
Seat 3: $-Twackle-$ ($200 in chips) 
Seat 4: daniferdoser ($200 in chips) 
Seat 5: dah44 ($191.10 in chips) 
Seat 6: InsomniaRU ($200 in chips) 
Seat 8: matiko09 ($387.20 in chips) 
Seat 9: carflam7 ($152 in chips) 
glanza_mike: posts small blind $1
$-Twackle-$: posts big blind $2
*** HOLE CARDS ***
Dealt to matiko09 [Ac Ad]
daniferdoser: folds 
dah44: folds 
InsomniaRU: folds 
matiko09: raises $3 to $5
carflam7: folds 
berggren: folds 
glanza_mike: folds 
$-Twackle-$: folds 
Uncalled bet ($3) returned to matiko09
matiko09 collected $5 from pot
matiko09: doesn't show hand 
*** SUMMARY ***
Total pot $5 | Rake $0 
Seat 1: berggren (button) folded before Flop (didn't bet)
Seat 2: glanza_mike (small blind) folded before Flop
Seat 3: $-Twackle-$ (big blind) folded before Flop
Seat 4: daniferdoser folded before Flop (didn't bet)
Seat 5: dah44 folded before Flop (didn't bet)
Seat 6: InsomniaRU folded before Flop (didn't bet)
Seat 8: matiko09 collected ($5)
Seat 9: carflam7 folded before Flop (didn't bet)





PokerStars Hand #150800498985:  Hold'em No Limit ($0.25/$0.50 USD) - 2016/03/23 14:06:05 CET [2016/03/23 9:06:05 ET]
Table 'Belnika' 9-max Seat #4 is the button
Seat 1: yellowfever0 ($15.75 in chips) 
Seat 2: NeverRegret7 ($56.02 in chips) 
Seat 3: ChiChioChi ($86.13 in chips) 
Seat 4: matiko09 ($66.68 in chips) 
Seat 5: ZonTTT ($50 in chips) 
Seat 6: Ahangama ($52.75 in chips) 
Seat 8: lumen21 ($64.22 in chips) 
Seat 9: dndngod ($58.91 in chips) 
ZonTTT: posts small blind $0.25
Ahangama: posts big blind $0.50
CvMCvMCvM: sits out 
*** HOLE CARDS ***
Dealt to matiko09 [5c 4d]
lumen21: folds 
dndngod: folds 
yellowfever0: folds 
NeverRegret7: folds 
ChiChioChi: folds 
matiko09: folds 
ZonTTT: raises $1 to $1.50
Ahangama: calls $1
*** FLOP *** [Js 8d As]
ZonTTT: bets $1.75
Ahangama: calls $1.75
*** TURN *** [Js 8d As] [3h]
ZonTTT: bets $4
Ahangama: calls $4
*** RIVER *** [Js 8d As 3h] [Ts]
ZonTTT: bets $9
Ahangama: folds 
Uncalled bet ($9) returned to ZonTTT
ZonTTT collected $13.85 from pot
ZonTTT: doesn't show hand 
*** SUMMARY ***
Total pot $14.50 | Rake $0.65 
Board [Js 8d As 3h Ts]
Seat 1: yellowfever0 folded before Flop (didn't bet)
Seat 2: NeverRegret7 folded before Flop (didn't bet)
Seat 3: ChiChioChi folded before Flop (didn't bet)
Seat 4: matiko09 (button) folded before Flop (didn't bet)
Seat 5: ZonTTT (small blind) collected ($13.85)
Seat 6: Ahangama (big blind) folded on the River
Seat 8: lumen21 folded before Flop (didn't bet)
Seat 9: dndngod folded before Flop (didn't bet)





PokerStars Hand #150800505372:  Hold'em No Limit ($1/$2 USD) - 2016/03/23 14:06:16 CET [2016/03/23 9:06:16 ET]
Table 'Kiess' 9-max Seat #5 is the button
Seat 1: Cirilico ($201.86 in chips) 
Seat 2: DUkalisUA ($678.52 in chips) 
Seat 4: Moszes360 ($200.77 in chips) 
Seat 5: chippo boy ($338.80 in chips) 
Seat 6: matiko09 ($275.84 in chips) 
Seat 7: InsomniaRU ($273.17 in chips) 
Seat 8: erfk1958 ($120 in chips) 
Seat 9: Fish4trips ($203.60 in chips) 
matiko09: posts small blind $1
InsomniaRU: posts big blind $2
*** HOLE CARDS ***
Dealt to matiko09 [3h 7h]
erfk1958: folds 
Fish4trips: folds 
Cirilico: folds 
DUkalisUA: raises $4 to $6
Moszes360: folds 
chippo boy: folds 
matiko09: folds 
Fish4trips leaves the table
nickreason17 joins the table at seat #9 
InsomniaRU: raises $14 to $20
DUkalisUA: calls $14
*** FLOP *** [9d 6c Ac]
InsomniaRU: checks 
DUkalisUA: bets $18
InsomniaRU: folds 
Uncalled bet ($18) returned to DUkalisUA
DUkalisUA collected $39.16 from pot
DUkalisUA: doesn't show hand 
*** SUMMARY ***
Total pot $41 | Rake $1.84 
Board [9d 6c Ac]
Seat 1: Cirilico folded before Flop (didn't bet)
Seat 2: DUkalisUA collected ($39.16)
Seat 4: Moszes360 folded before Flop (didn't bet)
Seat 5: chippo boy (button) folded before Flop (didn't bet)
Seat 6: matiko09 (small blind) folded before Flop
Seat 7: InsomniaRU (big blind) folded on the Flop
Seat 8: erfk1958 folded before Flop (didn't bet)
Seat 9: Fish4trips folded before Flop (didn't bet)





PokerStars Hand #150800504833:  Hold'em No Limit ($0.50/$1.00 USD) - 2016/03/23 14:06:16 CET [2016/03/23 9:06:16 ET]
Table 'Kippes' 9-max Seat #6 is the button
Seat 1: Pvsx. ($107.81 in chips) 
Seat 2: RICKA16 ($144.85 in chips) 
Seat 3: CAJUN890 ($124.52 in chips) 
Seat 4: matiko09 ($101.07 in chips) 
Seat 5: Jimy Tiltman ($115.36 in chips) 
Seat 6: DUkalisUA ($112.76 in chips) 
Seat 7: lumen21 ($112.52 in chips) 
Seat 8: albert_ratza ($60.45 in chips) 
Seat 9: wang19790906 ($69.62 in chips) 
lumen21: posts small blind $0.50
albert_ratza: posts big blind $1
*** HOLE CARDS ***
Dealt to matiko09 [6h Jd]
wang19790906: folds 
Pvsx.: folds 
RICKA16: folds 
CAJUN890: folds 
matiko09: folds 
Jimy Tiltman: raises $1 to $2
DUkalisUA: calls $2
lumen21: folds 
albert_ratza: calls $1
*** FLOP *** [2c 4h 3s]
albert_ratza: bets $3
Jimy Tiltman: folds 
DUkalisUA: folds 
Uncalled bet ($3) returned to albert_ratza
albert_ratza collected $6.21 from pot
albert_ratza: doesn't show hand 
*** SUMMARY ***
Total pot $6.50 | Rake $0.29 
Board [2c 4h 3s]
Seat 1: Pvsx. folded before Flop (didn't bet)
Seat 2: RICKA16 folded before Flop (didn't bet)
Seat 3: CAJUN890 folded before Flop (didn't bet)
Seat 4: matiko09 folded before Flop (didn't bet)
Seat 5: Jimy Tiltman folded on the Flop
Seat 6: DUkalisUA (button) folded on the Flop
Seat 7: lumen21 (small blind) folded before Flop
Seat 8: albert_ratza (big blind) collected ($6.21)
Seat 9: wang19790906 folded before Flop (didn't bet)





PokerStars Hand #150800507937:  Hold'em No Limit ($0.25/$0.50 USD) - 2016/03/23 14:06:21 CET [2016/03/23 9:06:21 ET]
Table 'Pyrrhus' 9-max Seat #1 is the button
Seat 1: lumen21 ($50 in chips) 
Seat 4: GriffinBerg ($29.83 in chips) 
Seat 5: ZonTTT ($50 in chips) 
Seat 6: Ahangama ($50 in chips) 
Seat 7: matiko09 ($136.69 in chips) 
Seat 8: dndngod ($83.77 in chips) 
Seat 9: CvMCvMCvM ($113.11 in chips) 
alemão007 will be allowed to play after the button
i L00K great will be allowed to play after the button
GriffinBerg: posts small blind $0.25
ZonTTT: posts big blind $0.50
*** HOLE CARDS ***
Dealt to matiko09 [8s Js]
Ahangama: folds 
matiko09: folds 
dndngod: folds 
CvMCvMCvM: folds 
lumen21: raises $0.75 to $1.25
GriffinBerg: folds 
ZonTTT: folds 
Uncalled bet ($0.75) returned to lumen21
lumen21 collected $1.25 from pot
lumen21: doesn't show hand 
*** SUMMARY ***
Total pot $1.25 | Rake $0 
Seat 1: lumen21 (button) collected ($1.25)
Seat 4: GriffinBerg (small blind) folded before Flop
Seat 5: ZonTTT (big blind) folded before Flop
Seat 6: Ahangama folded before Flop (didn't bet)
Seat 7: matiko09 folded before Flop (didn't bet)
Seat 8: dndngod folded before Flop (didn't bet)
Seat 9: CvMCvMCvM folded before Flop (didn't bet)





PokerStars Hand #150800508829:  Hold'em No Limit ($0.50/$1.00 USD) - 2016/03/23 14:06:22 CET [2016/03/23 9:06:22 ET]
Table 'Donar II' 9-max Seat #1 is the button
Seat 1: Effort92 ($103.22 in chips) 
Seat 2: nobrunobru1 ($65.54 in chips) 
Seat 3: st-germ30 ($99.60 in chips) 
Seat 4: DUkalisUA ($122.67 in chips) 
Seat 5: matiko09 ($108.34 in chips) 
Seat 6: ardo888 ($117.03 in chips) 
Seat 8: $-Twackle-$ ($100 in chips) 
Seat 9: oxfordtenzin ($140.49 in chips) 
nobrunobru1: posts small blind $0.50
st-germ30: posts big blind $1
nickreason17: sits out 
Effort92: posts the ante $0.20
nobrunobru1: posts the ante $0.20
st-germ30: posts the ante $0.20
DUkalisUA: posts the ante $0.20
matiko09: posts the ante $0.20
ardo888: posts the ante $0.20
$-Twackle-$: posts the ante $0.20
oxfordtenzin: posts the ante $0.20
*** HOLE CARDS ***
Dealt to matiko09 [Kd Jd]
DUkalisUA: folds 
matiko09: raises $2 to $3
ardo888: folds 
$-Twackle-$: folds 
oxfordtenzin: folds 
Effort92: folds 
nobrunobru1: folds 
st-germ30: calls $2
*** FLOP *** [2s 4s 3d]
st-germ30: checks 
matiko09: checks 
*** TURN *** [2s 4s 3d] [2h]
st-germ30: bets $3
matiko09: folds 
Uncalled bet ($3) returned to st-germ30
st-germ30 collected $7.74 from pot
st-germ30: doesn't show hand 
*** SUMMARY ***
Total pot $8.10 | Rake $0.36 
Board [2s 4s 3d 2h]
Seat 1: Effort92 (button) folded before Flop (didn't bet)
Seat 2: nobrunobru1 (small blind) folded before Flop
Seat 3: st-germ30 (big blind) collected ($7.74)
Seat 4: DUkalisUA folded before Flop (didn't bet)
Seat 5: matiko09 folded on the Turn
Seat 6: ardo888 folded before Flop (didn't bet)
Seat 8: $-Twackle-$ folded before Flop (didn't bet)
Seat 9: oxfordtenzin folded before Flop (didn't bet)





PokerStars Hand #150800511951:  Hold'em No Limit ($0.50/$1.00 USD) - 2016/03/23 14:06:27 CET [2016/03/23 9:06:27 ET]
Table 'Merope II' 9-max Seat #8 is the button
Seat 1: Jimy Tiltman ($107.94 in chips) 
Seat 2: Zeeshka ($100 in chips) 
Seat 3: Sherlockplay ($147.44 in chips) 
Seat 4: YuriiSolodya ($40 in chips) 
Seat 5: DUkalisUA ($103.71 in chips) 
Seat 6: Effort92 ($100 in chips) 
Seat 7: matiko09 ($147.18 in chips) 
Seat 8: titentei ($93.50 in chips) 
Seat 9: RICKA16 ($99 in chips) 
RICKA16: posts small blind $0.50
Jimy Tiltman: posts big blind $1
*** HOLE CARDS ***
Dealt to matiko09 [As 2d]
Zeeshka: folds 
Sherlockplay: folds 
YuriiSolodya: folds 
DUkalisUA: folds 
Effort92: folds 
matiko09: folds 
titentei: raises $2 to $3
RICKA16: folds 
Jimy Tiltman: folds 
Uncalled bet ($2) returned to titentei
titentei collected $2.50 from pot
titentei: doesn't show hand 
*** SUMMARY ***
Total pot $2.50 | Rake $0 
Seat 1: Jimy Tiltman (big blind) folded before Flop
Seat 2: Zeeshka folded before Flop (didn't bet)
Seat 3: Sherlockplay folded before Flop (didn't bet)
Seat 4: YuriiSolodya folded before Flop (didn't bet)
Seat 5: DUkalisUA folded before Flop (didn't bet)
Seat 6: Effort92 folded before Flop (didn't bet)
Seat 7: matiko09 folded before Flop (didn't bet)
Seat 8: titentei (button) collected ($2.50)
Seat 9: RICKA16 (small blind) folded before Flop





PokerStars Hand #150800512917:  Hold'em No Limit ($0.50/$1.00 USD) - 2016/03/23 14:06:29 CET [2016/03/23 9:06:29 ET]
Table 'Smiley' 9-max Seat #7 is the button
Seat 1: xHourglass ($103.21 in chips) 
Seat 2: Jimy Tiltman ($138.20 in chips) 
Seat 3: matiko09 ($100 in chips) 
Seat 5: DUkalisUA ($183.20 in chips) 
Seat 7: Moszes360 ($100 in chips) 
Seat 8: Sherlockplay ($105.14 in chips) 
Seat 9: Pvsx. ($139.57 in chips) 
Sherlockplay: posts small blind $0.50
Pvsx.: posts big blind $1
CAJUN890: sits out 
*** HOLE CARDS ***
Dealt to matiko09 [8s 8h]
xHourglass: folds 
Jimy Tiltman: folds 
matiko09: raises $2 to $3
DUkalisUA: folds 
Moszes360: folds 
Sherlockplay: folds 
Pvsx.: calls $2
*** FLOP *** [Ts 7s Ah]
Pvsx.: checks 
matiko09: checks 
*** TURN *** [Ts 7s Ah] [4s]
Pvsx.: bets $3.10
matiko09: calls $3.10
*** RIVER *** [Ts 7s Ah 4s] [4h]
Pvsx.: bets $8
matiko09: folds 
Uncalled bet ($8) returned to Pvsx.
Pvsx. collected $12.13 from pot
*** SUMMARY ***
Total pot $12.70 | Rake $0.57 
Board [Ts 7s Ah 4s 4h]
Seat 1: xHourglass folded before Flop (didn't bet)
Seat 2: Jimy Tiltman folded before Flop (didn't bet)
Seat 3: matiko09 folded on the River
Seat 5: DUkalisUA folded before Flop (didn't bet)
Seat 7: Moszes360 (button) folded before Flop (didn't bet)
Seat 8: Sherlockplay (small blind) folded before Flop
Seat 9: Pvsx. (big blind) collected ($12.13)





PokerStars Hand #150800513178:  Hold'em No Limit ($1/$2 USD) - 2016/03/23 14:06:29 CET [2016/03/23 9:06:29 ET]
Table 'Herba II' 9-max Seat #3 is the button
Seat 1: matiko09 ($206.46 in chips) 
Seat 2: Moszes360 ($237.89 in chips) 
Seat 3: Cirilico ($160 in chips) 
Seat 4: DUkalisUA ($297.48 in chips) 
Seat 5: chippo boy ($237.53 in chips) 
Seat 6: Too-Anti-To ($203 in chips) 
Seat 7: InsomniaRU ($203 in chips) 
Seat 9: mrhighryza ($49.55 in chips) 
DUkalisUA: posts small blind $1
chippo boy: posts big blind $2
*** HOLE CARDS ***
Dealt to matiko09 [5c Th]
Too-Anti-To: folds 
InsomniaRU: folds 
mrhighryza: calls $2
matiko09: folds 
Moszes360: folds 
Cirilico: folds 
DUkalisUA: calls $1
chippo boy: raises $8 to $10
mrhighryza: folds 
DUkalisUA: folds 
Uncalled bet ($8) returned to chippo boy
chippo boy collected $6 from pot
*** SUMMARY ***
Total pot $6 | Rake $0 
Seat 1: matiko09 folded before Flop (didn't bet)
Seat 2: Moszes360 folded before Flop (didn't bet)
Seat 3: Cirilico (button) folded before Flop (didn't bet)
Seat 4: DUkalisUA (small blind) folded before Flop
Seat 5: chippo boy (big blind) collected ($6)
Seat 6: Too-Anti-To folded before Flop (didn't bet)
Seat 7: InsomniaRU folded before Flop (didn't bet)
Seat 9: mrhighryza folded before Flop





PokerStars Hand #150800514420:  Hold'em No Limit ($1/$2 USD) - 2016/03/23 14:06:32 CET [2016/03/23 9:06:32 ET]
Table 'Kypria II' 9-max Seat #5 is the button
Seat 1: geldwolfje ($151.12 in chips) 
Seat 2: coinflip_si ($215 in chips) 
Seat 3: seouljam ($200.45 in chips) 
Seat 4: VolanDog ($200 in chips) 
Seat 5: InsomniaRU ($403.78 in chips) 
Seat 6: matiko09 ($275.69 in chips) 
Seat 7: DUkalisUA ($200 in chips) 
Seat 8: Fish4trips ($328.19 in chips) 
Seat 9: Moszes360 ($200 in chips) 
matiko09: posts small blind $1
DUkalisUA: posts big blind $2
*** HOLE CARDS ***
Dealt to matiko09 [9h 9c]
Fish4trips: folds 
Fish4trips leaves the table
Moszes360: folds 
geldwolfje: folds 
coinflip_si: folds 
seouljam: folds 
VolanDog: raises $3 to $5
InsomniaRU: folds 
Cirilico joins the table at seat #8 
matiko09: raises $11 to $16
DUkalisUA: folds 
VolanDog: calls $11
*** FLOP *** [5d 2d Qs]
matiko09: checks 
VolanDog: checks 
*** TURN *** [5d 2d Qs] [7c]
matiko09: bets $16
VolanDog: calls $16
*** RIVER *** [5d 2d Qs 7c] [3h]
matiko09: checks 
VolanDog: checks 
*** SHOW DOWN ***
matiko09: shows [9h 9c] (a pair of Nines)
VolanDog: mucks hand 
matiko09 collected $63.20 from pot
*** SUMMARY ***
Total pot $66 | Rake $2.80 
Board [5d 2d Qs 7c 3h]
Seat 1: geldwolfje folded before Flop (didn't bet)
Seat 2: coinflip_si folded before Flop (didn't bet)
Seat 3: seouljam folded before Flop (didn't bet)
Seat 4: VolanDog mucked [8s 8c]
Seat 5: InsomniaRU (button) folded before Flop (didn't bet)
Seat 6: matiko09 (small blind) showed [9h 9c] and won ($63.20) with a pair of Nines
Seat 7: DUkalisUA (big blind) folded before Flop
Seat 8: Fish4trips folded before Flop (didn't bet)
Seat 9: Moszes360 folded before Flop (didn't bet)





PokerStars Hand #150800514698:  Hold'em No Limit ($1/$2 USD) - 2016/03/23 14:06:32 CET [2016/03/23 9:06:32 ET]
Table 'Achaia' 9-max Seat #8 is the button
Seat 1: ilaviiitech ($200 in chips) 
Seat 2: InsomniaRU ($226.66 in chips) 
Seat 3: matiko09 ($200 in chips) 
Seat 4: nailz83 ($203 in chips) 
Seat 6: nickreason17 ($220.06 in chips) 
Seat 7: morosun ($71.18 in chips) 
Seat 8: $-Twackle-$ ($200 in chips) 
Seat 9: glanza_mike ($200 in chips) 
glanza_mike: posts small blind $1
ilaviiitech: posts big blind $2
*** HOLE CARDS ***
Dealt to matiko09 [Td Kc]
InsomniaRU: folds 
matiko09: folds 
nailz83: calls $2
nickreason17: folds 
morosun: folds 
DUkalisUA joins the table at seat #5 
$-Twackle-$: folds 
glanza_mike: raises $5 to $7
ilaviiitech: folds 
nailz83: calls $5
*** FLOP *** [Kd 5c Jc]
glanza_mike: bets $5.04
nailz83: folds 
Uncalled bet ($5.04) returned to glanza_mike
glanza_mike collected $15.28 from pot
glanza_mike: doesn't show hand 
*** SUMMARY ***
Total pot $16 | Rake $0.72 
Board [Kd 5c Jc]
Seat 1: ilaviiitech (big blind) folded before Flop
Seat 2: InsomniaRU folded before Flop (didn't bet)
Seat 3: matiko09 folded before Flop (didn't bet)
Seat 4: nailz83 folded on the Flop
Seat 6: nickreason17 folded before Flop (didn't bet)
Seat 7: morosun folded before Flop (didn't bet)
Seat 8: $-Twackle-$ (button) folded before Flop (didn't bet)
Seat 9: glanza_mike (small blind) collected ($15.28)





PokerStars Hand #150800515890:  Hold'em No Limit ($1/$2 USD) - 2016/03/23 14:06:34 CET [2016/03/23 9:06:34 ET]
Table 'Ennomos II' 9-max Seat #8 is the button
Seat 1: ilaviiitech ($200 in chips) 
Seat 3: $-Twackle-$ ($200 in chips) 
Seat 4: glanza_mike ($200 in chips) 
Seat 5: South011 ($200 in chips) 
Seat 6: nickreason17 ($200 in chips) 
Seat 7: daniferdoser ($250.77 in chips) 
Seat 8: yyfk ($200 in chips) 
Seat 9: matiko09 ($200 in chips) 
matiko09: posts small blind $1
ilaviiitech: posts big blind $2
Subam: sits out 
South011: posts big blind $2
*** HOLE CARDS ***
Dealt to matiko09 [9d 2h]
$-Twackle-$: folds 
glanza_mike: folds 
South011: checks 
nickreason17: folds 
daniferdoser: folds 
yyfk: folds 
matiko09: folds 
ilaviiitech: checks 
*** FLOP *** [Kh 8c Qd]
ilaviiitech: checks 
South011: bets $4
ilaviiitech: folds 
Uncalled bet ($4) returned to South011
South011 collected $4.78 from pot
South011: doesn't show hand 
*** SUMMARY ***
Total pot $5 | Rake $0.22 
Board [Kh 8c Qd]
Seat 1: ilaviiitech (big blind) folded on the Flop
Seat 3: $-Twackle-$ folded before Flop (didn't bet)
Seat 4: glanza_mike folded before Flop (didn't bet)
Seat 5: South011 collected ($4.78)
Seat 6: nickreason17 folded before Flop (didn't bet)
Seat 7: daniferdoser folded before Flop (didn't bet)
Seat 8: yyfk (button) folded before Flop (didn't bet)
Seat 9: matiko09 (small blind) folded before Flop





PokerStars Hand #150800521864:  Hold'em No Limit ($1/$2 USD) - 2016/03/23 14:06:44 CET [2016/03/23 9:06:44 ET]
Table 'Alma II' 9-max Seat #2 is the button
Seat 1: berggren ($228.94 in chips) 
Seat 2: glanza_mike ($215.70 in chips) 
Seat 3: $-Twackle-$ ($200 in chips) 
Seat 4: daniferdoser ($200 in chips) 
Seat 5: dah44 ($191.10 in chips) 
Seat 6: InsomniaRU ($200 in chips) 
Seat 8: matiko09 ($390.20 in chips) 
Seat 9: carflam7 ($152 in chips) 
$-Twackle-$: posts small blind $1
daniferdoser: posts big blind $2
T0ny Adams: sits out 
*** HOLE CARDS ***
Dealt to matiko09 [8c 2h]
dah44: folds 
InsomniaRU: folds 
matiko09: folds 
carflam7: folds 
berggren: raises $4 to $6
glanza_mike: folds 
$-Twackle-$: folds 
daniferdoser: folds 
Uncalled bet ($4) returned to berggren
berggren collected $5 from pot
berggren: doesn't show hand 
*** SUMMARY ***
Total pot $5 | Rake $0 
Seat 1: berggren collected ($5)
Seat 2: glanza_mike (button) folded before Flop (didn't bet)
Seat 3: $-Twackle-$ (small blind) folded before Flop
Seat 4: daniferdoser (big blind) folded before Flop
Seat 5: dah44 folded before Flop (didn't bet)
Seat 6: InsomniaRU folded before Flop (didn't bet)
Seat 8: matiko09 folded before Flop (didn't bet)
Seat 9: carflam7 folded before Flop (didn't bet)





PokerStars Hand #150800524234:  Hold'em No Limit ($0.25/$0.50 USD) - 2016/03/23 14:06:48 CET [2016/03/23 9:06:48 ET]
Table 'Pyrrhus' 9-max Seat #4 is the button
Seat 1: lumen21 ($50.75 in chips) 
Seat 2: alemão007 ($50 in chips) 
Seat 4: GriffinBerg ($29.58 in chips) 
Seat 5: ZonTTT ($50 in chips) 
Seat 6: Ahangama ($50 in chips) 
Seat 7: matiko09 ($136.69 in chips) 
Seat 8: dndngod ($83.77 in chips) 
Seat 9: CvMCvMCvM ($113.11 in chips) 
ZonTTT: posts small blind $0.25
Ahangama: posts big blind $0.50
alemão007: posts big blind $0.50
i L00K great: sits out 
*** HOLE CARDS ***
Dealt to matiko09 [5c Kc]
matiko09: folds 
dndngod: folds 
CvMCvMCvM: folds 
lumen21: folds 
alemão007: checks 
GriffinBerg: folds 
ZonTTT: folds 
Ahangama: checks 
*** FLOP *** [7c Kd Tc]
Ahangama: checks 
alemão007: bets $0.50
Ahangama: folds 
Uncalled bet ($0.50) returned to alemão007
alemão007 collected $1.19 from pot
alemão007: doesn't show hand 
*** SUMMARY ***
Total pot $1.25 | Rake $0.06 
Board [7c Kd Tc]
Seat 1: lumen21 folded before Flop (didn't bet)
Seat 2: alemão007 collected ($1.19)
Seat 4: GriffinBerg (button) folded before Flop (didn't bet)
Seat 5: ZonTTT (small blind) folded before Flop
Seat 6: Ahangama (big blind) folded on the Flop
Seat 7: matiko09 folded before Flop (didn't bet)
Seat 8: dndngod folded before Flop (didn't bet)
Seat 9: CvMCvMCvM folded before Flop (didn't bet)





PokerStars Hand #150800527380:  Hold'em No Limit ($0.50/$1.00 USD) - 2016/03/23 14:06:53 CET [2016/03/23 9:06:53 ET]
Table 'Kippes' 9-max Seat #7 is the button
Seat 1: Pvsx. ($107.81 in chips) 
Seat 2: RICKA16 ($144.85 in chips) 
Seat 3: CAJUN890 ($124.52 in chips) 
Seat 4: matiko09 ($101.07 in chips) 
Seat 5: Jimy Tiltman ($113.36 in chips) 
Seat 6: DUkalisUA ($110.76 in chips) 
Seat 7: lumen21 ($112.02 in chips) 
Seat 8: albert_ratza ($64.66 in chips) 
Seat 9: wang19790906 ($69.62 in chips) 
albert_ratza: posts small blind $0.50
wang19790906: posts big blind $1
*** HOLE CARDS ***
Dealt to matiko09 [5c 9s]
Pvsx.: folds 
RICKA16: raises $2 to $3
CAJUN890: folds 
matiko09: folds 
Jimy Tiltman: folds 
DUkalisUA: folds 
lumen21: folds 
albert_ratza: calls $2.50
wang19790906: calls $2
*** FLOP *** [2h 3d 5s]
albert_ratza: bets $8.60
wang19790906: folds 
RICKA16: calls $8.60
*** TURN *** [2h 3d 5s] [7h]
albert_ratza: bets $25.02
RICKA16: raises $25.02 to $50.04
albert_ratza: raises $3.02 to $53.06 and is all-in
RICKA16: calls $3.02
*** RIVER *** [2h 3d 5s 7h] [Th]
*** SHOW DOWN ***
albert_ratza: shows [4c 4s] (a pair of Fours)
RICKA16: shows [Jc Jd] (a pair of Jacks)
RICKA16 collected $129.52 from pot
*** SUMMARY ***
Total pot $132.32 | Rake $2.80 
Board [2h 3d 5s 7h Th]
Seat 1: Pvsx. folded before Flop (didn't bet)
Seat 2: RICKA16 showed [Jc Jd] and won ($129.52) with a pair of Jacks
Seat 3: CAJUN890 folded before Flop (didn't bet)
Seat 4: matiko09 folded before Flop (didn't bet)
Seat 5: Jimy Tiltman folded before Flop (didn't bet)
Seat 6: DUkalisUA folded before Flop (didn't bet)
Seat 7: lumen21 (button) folded before Flop (didn't bet)
Seat 8: albert_ratza (small blind) showed [4c 4s] and lost with a pair of Fours
Seat 9: wang19790906 (big blind) folded on the Flop





PokerStars Hand #150800528202:  Hold'em No Limit ($0.50/$1.00 USD) - 2016/03/23 14:06:54 CET [2016/03/23 9:06:54 ET]
Table 'Atlantis' 9-max Seat #2 is the button
Seat 1: xHourglass ($170.77 in chips) 
Seat 2: tffff2006 ($55.84 in chips) 
Seat 3: CAJUN890 ($104.79 in chips) 
Seat 4: matiko09 ($109.80 in chips) 
Seat 5: Pvsx. ($107.94 in chips) 
Seat 6: Jimy Tiltman ($132.36 in chips) 
Seat 8: DUkalisUA ($100 in chips) 
Seat 9: RICKA16 ($104.16 in chips) 
CAJUN890: posts small blind $0.50
matiko09: posts big blind $1
Sherlockplay: sits out 
*** HOLE CARDS ***
Dealt to matiko09 [6s Kc]
Pvsx.: folds 
Jimy Tiltman: folds 
DUkalisUA: folds 
RICKA16: folds 
xHourglass: folds 
tffff2006: raises $2 to $3
CAJUN890: folds 
matiko09: folds 
Uncalled bet ($2) returned to tffff2006
tffff2006 collected $2.50 from pot
tffff2006: doesn't show hand 
*** SUMMARY ***
Total pot $2.50 | Rake $0 
Seat 1: xHourglass folded before Flop (didn't bet)
Seat 2: tffff2006 (button) collected ($2.50)
Seat 3: CAJUN890 (small blind) folded before Flop
Seat 4: matiko09 (big blind) folded before Flop
Seat 5: Pvsx. folded before Flop (didn't bet)
Seat 6: Jimy Tiltman folded before Flop (didn't bet)
Seat 8: DUkalisUA folded before Flop (didn't bet)
Seat 9: RICKA16 folded before Flop (didn't bet)





PokerStars Hand #150800532757:  Hold'em No Limit ($0.50/$1.00 USD) - 2016/03/23 14:07:02 CET [2016/03/23 9:07:02 ET]
Table 'Merope II' 9-max Seat #9 is the button
Seat 1: Jimy Tiltman ($106.94 in chips) 
Seat 4: YuriiSolodya ($40 in chips) 
Seat 5: DUkalisUA ($103.71 in chips) 
Seat 6: Effort92 ($100 in chips) 
Seat 7: matiko09 ($147.18 in chips) 
Seat 8: titentei ($95 in chips) 
Seat 9: RICKA16 ($98.50 in chips) 
Jimy Tiltman: posts small blind $0.50
Zeeshka: is sitting out 
Sherlockplay: is sitting out 
Zeeshka leaves the table
YuriiSolodya: posts big blind $1
*** HOLE CARDS ***
Dealt to matiko09 [Ks Kh]
$-Twackle-$ joins the table at seat #2 
Sherlockplay leaves the table
DUkalisUA: raises $2 to $3
Effort92: folds 
matiko09: calls $3
titentei: folds 
RICKA16: calls $3
BKA12 joins the table at seat #3 
BKA12 leaves the table
Jimy Tiltman: folds 
nickreason17 joins the table at seat #3 
nickreason17 leaves the table
YuriiSolodya: calls $2
*** FLOP *** [5s Qd 2d]
pablos1922 joins the table at seat #3 
YuriiSolodya: checks 
DUkalisUA: bets $8.95
matiko09: calls $8.95
RICKA16: folds 
YuriiSolodya: folds 
*** TURN *** [5s Qd 2d] [9c]
DUkalisUA: bets $23
matiko09: calls $23
*** RIVER *** [5s Qd 2d 9c] [Ah]
DUkalisUA: bets $68.76 and is all-in
matiko09: folds 
Uncalled bet ($68.76) returned to DUkalisUA
DUkalisUA collected $73.60 from pot
DUkalisUA: doesn't show hand 
*** SUMMARY ***
Total pot $76.40 | Rake $2.80 
Board [5s Qd 2d 9c Ah]
Seat 1: Jimy Tiltman (small blind) folded before Flop
Seat 4: YuriiSolodya (big blind) folded on the Flop
Seat 5: DUkalisUA collected ($73.60)
Seat 6: Effort92 folded before Flop (didn't bet)
Seat 7: matiko09 folded on the River
Seat 8: titentei folded before Flop (didn't bet)
Seat 9: RICKA16 (button) folded on the Flop





PokerStars Hand #150800537338:  Hold'em No Limit ($1/$2 USD) - 2016/03/23 14:07:10 CET [2016/03/23 9:07:10 ET]
Table 'Achaia' 9-max Seat #9 is the button
Seat 1: ilaviiitech ($200 in chips) 
Seat 2: InsomniaRU ($226.66 in chips) 
Seat 3: matiko09 ($200 in chips) 
Seat 4: nailz83 ($196 in chips) 
Seat 6: nickreason17 ($220.06 in chips) 
Seat 7: morosun ($87.49 in chips) 
Seat 8: $-Twackle-$ ($200 in chips) 
Seat 9: glanza_mike ($208.28 in chips) 
ilaviiitech: posts small blind $1
InsomniaRU: posts big blind $2
DUkalisUA: sits out 
*** HOLE CARDS ***
Dealt to matiko09 [Td 9c]
matiko09: folds 
nailz83: raises $4 to $6
nickreason17: folds 
morosun: calls $6
$-Twackle-$: folds 
glanza_mike: folds 
ilaviiitech: folds 
InsomniaRU: folds 
*** FLOP *** [Kc 3c Ad]
nailz83: bets $10
morosun: folds 
Uncalled bet ($10) returned to nailz83
nailz83 collected $14.32 from pot
nailz83: doesn't show hand 
*** SUMMARY ***
Total pot $15 | Rake $0.68 
Board [Kc 3c Ad]
Seat 1: ilaviiitech (small blind) folded before Flop
Seat 2: InsomniaRU (big blind) folded before Flop
Seat 3: matiko09 folded before Flop (didn't bet)
Seat 4: nailz83 collected ($14.32)
Seat 6: nickreason17 folded before Flop (didn't bet)
Seat 7: morosun folded on the Flop
Seat 8: $-Twackle-$ folded before Flop (didn't bet)
Seat 9: glanza_mike (button) folded before Flop (didn't bet)





PokerStars Hand #150800538817:  Hold'em No Limit ($1/$2 USD) - 2016/03/23 14:07:12 CET [2016/03/23 9:07:12 ET]
Table 'Ennomos II' 9-max Seat #9 is the button
Seat 1: ilaviiitech ($200 in chips) 
Seat 2: Subam ($160 in chips) 
Seat 3: $-Twackle-$ ($200 in chips) 
Seat 4: glanza_mike ($200 in chips) 
Seat 5: South011 ($202.78 in chips) 
Seat 6: nickreason17 ($200 in chips) 
Seat 7: daniferdoser ($250.77 in chips) 
Seat 8: yyfk ($200 in chips) 
Seat 9: matiko09 ($200 in chips) 
ilaviiitech: posts small blind $1
Subam: posts big blind $2
*** HOLE CARDS ***
Dealt to matiko09 [Ts 3c]
$-Twackle-$: folds 
glanza_mike: folds 
South011: folds 
nickreason17: folds 
daniferdoser: folds 
yyfk: raises $3 to $5
matiko09: folds 
ilaviiitech: folds 
Subam: raises $13 to $18
yyfk: calls $13
*** FLOP *** [4s 9c 8h]
Subam: bets $28
yyfk: calls $28
*** TURN *** [4s 9c 8h] [Jd]
Subam: bets $114 and is all-in
yyfk: folds 
Uncalled bet ($114) returned to Subam
Subam collected $90.20 from pot
Subam: doesn't show hand 
*** SUMMARY ***
Total pot $93 | Rake $2.80 
Board [4s 9c 8h Jd]
Seat 1: ilaviiitech (small blind) folded before Flop
Seat 2: Subam (big blind) collected ($90.20)
Seat 3: $-Twackle-$ folded before Flop (didn't bet)
Seat 4: glanza_mike folded before Flop (didn't bet)
Seat 5: South011 folded before Flop (didn't bet)
Seat 6: nickreason17 folded before Flop (didn't bet)
Seat 7: daniferdoser folded before Flop (didn't bet)
Seat 8: yyfk folded on the Turn
Seat 9: matiko09 (button) folded before Flop (didn't bet)





PokerStars Hand #150800539392:  Hold'em No Limit ($1/$2 USD) - 2016/03/23 14:07:13 CET [2016/03/23 9:07:13 ET]
Table 'Herba II' 9-max Seat #4 is the button
Seat 1: matiko09 ($206.46 in chips) 
Seat 2: Moszes360 ($237.89 in chips) 
Seat 3: Cirilico ($160 in chips) 
Seat 4: DUkalisUA ($295.48 in chips) 
Seat 5: chippo boy ($241.53 in chips) 
Seat 6: Too-Anti-To ($203 in chips) 
Seat 7: InsomniaRU ($203 in chips) 
Seat 9: mrhighryza ($47.55 in chips) 
chippo boy: posts small blind $1
Too-Anti-To: posts big blind $2
*** HOLE CARDS ***
Dealt to matiko09 [Js 6d]
InsomniaRU: folds 
mrhighryza: folds 
matiko09: folds 
Moszes360: folds 
Cirilico: folds 
DUkalisUA: folds 
chippo boy: raises $4 to $6
Too-Anti-To: folds 
Uncalled bet ($4) returned to chippo boy
chippo boy collected $4 from pot
*** SUMMARY ***
Total pot $4 | Rake $0 
Seat 1: matiko09 folded before Flop (didn't bet)
Seat 2: Moszes360 folded before Flop (didn't bet)
Seat 3: Cirilico folded before Flop (didn't bet)
Seat 4: DUkalisUA (button) folded before Flop (didn't bet)
Seat 5: chippo boy (small blind) collected ($4)
Seat 6: Too-Anti-To (big blind) folded before Flop
Seat 7: InsomniaRU folded before Flop (didn't bet)
Seat 9: mrhighryza folded before Flop (didn't bet)





PokerStars Hand #150800543926:  Hold'em No Limit ($0.50/$1.00 USD) - 2016/03/23 14:07:21 CET [2016/03/23 9:07:21 ET]
Table 'Donar II' 9-max Seat #3 is the button
Seat 1: Effort92 ($103.02 in chips) 
Seat 3: st-germ30 ($104.14 in chips) 
Seat 4: DUkalisUA ($122.47 in chips) 
Seat 5: matiko09 ($105.14 in chips) 
Seat 6: ardo888 ($116.83 in chips) 
Seat 8: $-Twackle-$ ($100 in chips) 
Seat 9: oxfordtenzin ($140.29 in chips) 
DUkalisUA: posts small blind $0.50
matiko09: posts big blind $1
nickreason17: sits out 
Effort92: posts the ante $0.20
st-germ30: posts the ante $0.20
DUkalisUA: posts the ante $0.20
matiko09: posts the ante $0.20
ardo888: posts the ante $0.20
$-Twackle-$: posts the ante $0.20
oxfordtenzin: posts the ante $0.20
*** HOLE CARDS ***
Dealt to matiko09 [Kh 7h]
ardo888: raises $2 to $3
nickreason17 leaves the table
$-Twackle-$: folds 
oxfordtenzin: calls $3
Effort92: folds 
st-germ30: folds 
BKA12 joins the table at seat #7 
BKA12 leaves the table
DUkalisUA: folds 
matiko09: folds 
*** FLOP *** [Kc 2h 6d]
ardo888: checks 
oxfordtenzin: checks 
*** TURN *** [Kc 2h 6d] [5c]
ardo888: checks 
oxfordtenzin: bets $4.80
ardo888: calls $4.80
*** RIVER *** [Kc 2h 6d 5c] [4d]
ardo888: checks 
oxfordtenzin: checks 
*** SHOW DOWN ***
ardo888: shows [7s 7d] (a pair of Sevens)
oxfordtenzin: mucks hand 
ardo888 collected $17.67 from pot
*** SUMMARY ***
Total pot $18.50 | Rake $0.83 
Board [Kc 2h 6d 5c 4d]
Seat 1: Effort92 folded before Flop (didn't bet)
Seat 3: st-germ30 (button) folded before Flop (didn't bet)
Seat 4: DUkalisUA (small blind) folded before Flop
Seat 5: matiko09 (big blind) folded before Flop
Seat 6: ardo888 showed [7s 7d] and won ($17.67) with a pair of Sevens
Seat 8: $-Twackle-$ folded before Flop (didn't bet)
Seat 9: oxfordtenzin mucked [6c Ac]





PokerStars Hand #150800543946:  Hold'em No Limit ($1/$2 USD) - 2016/03/23 14:07:21 CET [2016/03/23 9:07:21 ET]
Table 'Alma II' 9-max Seat #3 is the button
Seat 1: berggren ($231.94 in chips) 
Seat 2: glanza_mike ($215.70 in chips) 
Seat 3: $-Twackle-$ ($200 in chips) 
Seat 4: daniferdoser ($200 in chips) 
Seat 5: dah44 ($191.10 in chips) 
Seat 6: InsomniaRU ($200 in chips) 
Seat 8: matiko09 ($390.20 in chips) 
Seat 9: carflam7 ($152 in chips) 
daniferdoser: posts small blind $1
dah44: posts big blind $2
T0ny Adams: sits out 
*** HOLE CARDS ***
Dealt to matiko09 [Tc 8d]
InsomniaRU: raises $3 to $5
matiko09: folds 
carflam7: raises $13 to $18
berggren: folds 
glanza_mike: folds 
$-Twackle-$: folds 
daniferdoser: folds 
dah44: folds 
InsomniaRU: folds 
Uncalled bet ($13) returned to carflam7
carflam7 collected $13 from pot
*** SUMMARY ***
Total pot $13 | Rake $0 
Seat 1: berggren folded before Flop (didn't bet)
Seat 2: glanza_mike folded before Flop (didn't bet)
Seat 3: $-Twackle-$ (button) folded before Flop (didn't bet)
Seat 4: daniferdoser (small blind) folded before Flop
Seat 5: dah44 (big blind) folded before Flop
Seat 6: InsomniaRU folded before Flop
Seat 8: matiko09 folded before Flop (didn't bet)
Seat 9: carflam7 collected ($13)





PokerStars Hand #150800548714:  Hold'em No Limit ($0.50/$1.00 USD) - 2016/03/23 14:07:29 CET [2016/03/23 9:07:29 ET]
Table 'Atlantis' 9-max Seat #3 is the button
Seat 1: xHourglass ($170.77 in chips) 
Seat 2: tffff2006 ($57.34 in chips) 
Seat 3: CAJUN890 ($104.29 in chips) 
Seat 4: matiko09 ($108.80 in chips) 
Seat 5: Pvsx. ($107.94 in chips) 
Seat 6: Jimy Tiltman ($132.36 in chips) 
Seat 8: DUkalisUA ($100 in chips) 
Seat 9: RICKA16 ($104.16 in chips) 
matiko09: posts small blind $0.50
Pvsx.: posts big blind $1
Sherlockplay: sits out 
*** HOLE CARDS ***
Dealt to matiko09 [Jh Kd]
Jimy Tiltman: folds 
DUkalisUA: folds 
RICKA16: folds 
xHourglass: folds 
tffff2006: folds 
CAJUN890: folds 
matiko09: raises $1.50 to $2.50
Pvsx.: folds 
Uncalled bet ($1.50) returned to matiko09
matiko09 collected $2 from pot
matiko09: doesn't show hand 
*** SUMMARY ***
Total pot $2 | Rake $0 
Seat 1: xHourglass folded before Flop (didn't bet)
Seat 2: tffff2006 folded before Flop (didn't bet)
Seat 3: CAJUN890 (button) folded before Flop (didn't bet)
Seat 4: matiko09 (small blind) collected ($2)
Seat 5: Pvsx. (big blind) folded before Flop
Seat 6: Jimy Tiltman folded before Flop (didn't bet)
Seat 8: DUkalisUA folded before Flop (didn't bet)
Seat 9: RICKA16 folded before Flop (didn't bet)





PokerStars Hand #150800553606:  Hold'em No Limit ($0.25/$0.50 USD) - 2016/03/23 14:07:37 CET [2016/03/23 9:07:37 ET]
Table 'Pyrrhus' 9-max Seat #5 is the button
Seat 1: lumen21 ($50.75 in chips) 
Seat 2: alemão007 ($50.69 in chips) 
Seat 4: GriffinBerg ($29.58 in chips) 
Seat 5: ZonTTT ($50 in chips) 
Seat 6: Ahangama ($50 in chips) 
Seat 7: matiko09 ($136.69 in chips) 
Seat 8: dndngod ($83.77 in chips) 
Seat 9: CvMCvMCvM ($113.11 in chips) 
Ahangama: posts small blind $0.25
matiko09: posts big blind $0.50
i L00K great: sits out 
*** HOLE CARDS ***
Dealt to matiko09 [8c 2s]
dndngod: folds 
CvMCvMCvM: raises $0.76 to $1.26
lumen21: raises $2.74 to $4
alemão007: folds 
GriffinBerg: folds 
ZonTTT: folds 
Ahangama: folds 
matiko09: folds 
CvMCvMCvM: calls $2.74
*** FLOP *** [Qd 8s Th]
CvMCvMCvM: checks 
lumen21: checks 
*** TURN *** [Qd 8s Th] [6s]
CvMCvMCvM: checks 
lumen21: bets $4.59
CvMCvMCvM: calls $4.59
*** RIVER *** [Qd 8s Th 6s] [8d]
CvMCvMCvM: checks 
lumen21: bets $9.41
CvMCvMCvM: calls $9.41
*** SHOW DOWN ***
lumen21: shows [Ad Ah] (two pair, Aces and Eights)
CvMCvMCvM: mucks hand 
lumen21 collected $35.10 from pot
*** SUMMARY ***
Total pot $36.75 | Rake $1.65 
Board [Qd 8s Th 6s 8d]
Seat 1: lumen21 showed [Ad Ah] and won ($35.10) with two pair, Aces and Eights
Seat 2: alemão007 folded before Flop (didn't bet)
Seat 4: GriffinBerg folded before Flop (didn't bet)
Seat 5: ZonTTT (button) folded before Flop (didn't bet)
Seat 6: Ahangama (small blind) folded before Flop
Seat 7: matiko09 (big blind) folded before Flop
Seat 8: dndngod folded before Flop (didn't bet)
Seat 9: CvMCvMCvM mucked [Kd Ks]





PokerStars Hand #150800557864:  Hold'em No Limit ($1/$2 USD) - 2016/03/23 14:07:44 CET [2016/03/23 9:07:44 ET]
Table 'Herba II' 9-max Seat #5 is the button
Seat 1: matiko09 ($206.46 in chips) 
Seat 2: Moszes360 ($237.89 in chips) 
Seat 3: Cirilico ($160 in chips) 
Seat 4: DUkalisUA ($295.48 in chips) 
Seat 5: chippo boy ($243.53 in chips) 
Seat 6: Too-Anti-To ($201 in chips) 
Seat 7: InsomniaRU ($203 in chips) 
Seat 9: mrhighryza ($47.55 in chips) 
Too-Anti-To: posts small blind $1
InsomniaRU: posts big blind $2
*** HOLE CARDS ***
Dealt to matiko09 [Tc 5c]
mrhighryza: folds 
matiko09: folds 
Moszes360: folds 
Cirilico: folds 
DUkalisUA: folds 
chippo boy: calls $2
Too-Anti-To: folds 
InsomniaRU: checks 
*** FLOP *** [7d 9d 9c]
InsomniaRU: checks 
chippo boy: checks 
*** TURN *** [7d 9d 9c] [7s]
InsomniaRU: checks 
chippo boy: checks 
*** RIVER *** [7d 9d 9c 7s] [4s]
InsomniaRU: bets $3.18
chippo boy: folds 
Uncalled bet ($3.18) returned to InsomniaRU
InsomniaRU collected $4.78 from pot
InsomniaRU: doesn't show hand 
*** SUMMARY ***
Total pot $5 | Rake $0.22 
Board [7d 9d 9c 7s 4s]
Seat 1: matiko09 folded before Flop (didn't bet)
Seat 2: Moszes360 folded before Flop (didn't bet)
Seat 3: Cirilico folded before Flop (didn't bet)
Seat 4: DUkalisUA folded before Flop (didn't bet)
Seat 5: chippo boy (button) folded on the River
Seat 6: Too-Anti-To (small blind) folded before Flop
Seat 7: InsomniaRU (big blind) collected ($4.78)
Seat 9: mrhighryza folded before Flop (didn't bet)





PokerStars Hand #150800558810:  Hold'em No Limit ($0.50/$1.00 USD) - 2016/03/23 14:07:46 CET [2016/03/23 9:07:46 ET]
Table 'Smiley' 9-max Seat #8 is the button
Seat 1: xHourglass ($103.21 in chips) 
Seat 2: Jimy Tiltman ($138.20 in chips) 
Seat 3: matiko09 ($100 in chips) 
Seat 5: DUkalisUA ($183.20 in chips) 
Seat 7: Moszes360 ($100 in chips) 
Seat 8: Sherlockplay ($104.64 in chips) 
Seat 9: Pvsx. ($145.60 in chips) 
Pvsx.: posts small blind $0.50
xHourglass: posts big blind $1
CAJUN890: sits out 
*** HOLE CARDS ***
Dealt to matiko09 [6d Jd]
Jimy Tiltman: folds 
matiko09: folds 
DUkalisUA: raises $2 to $3
Moszes360: folds 
Sherlockplay: folds 
Pvsx.: folds 
xHourglass: folds 
Uncalled bet ($2) returned to DUkalisUA
DUkalisUA collected $2.50 from pot
DUkalisUA: doesn't show hand 
*** SUMMARY ***
Total pot $2.50 | Rake $0 
Seat 1: xHourglass (big blind) folded before Flop
Seat 2: Jimy Tiltman folded before Flop (didn't bet)
Seat 3: matiko09 folded before Flop (didn't bet)
Seat 5: DUkalisUA collected ($2.50)
Seat 7: Moszes360 folded before Flop (didn't bet)
Seat 8: Sherlockplay (button) folded before Flop (didn't bet)
Seat 9: Pvsx. (small blind) folded before Flop





PokerStars Hand #150800560663:  Hold'em No Limit ($0.25/$0.50 USD) - 2016/03/23 14:07:49 CET [2016/03/23 9:07:49 ET]
Table 'Belnika' 9-max Seat #5 is the button
Seat 1: yellowfever0 ($15.75 in chips) 
Seat 2: NeverRegret7 ($56.02 in chips) 
Seat 3: ChiChioChi ($86.13 in chips) 
Seat 4: matiko09 ($66.68 in chips) 
Seat 5: ZonTTT ($56.60 in chips) 
Seat 6: Ahangama ($50 in chips) 
Seat 7: CvMCvMCvM ($50 in chips) 
Seat 8: lumen21 ($64.22 in chips) 
Seat 9: dndngod ($58.91 in chips) 
Ahangama: posts small blind $0.25
CvMCvMCvM: posts big blind $0.50
*** HOLE CARDS ***
Dealt to matiko09 [Ad Js]
lumen21: folds 
dndngod: folds 
yellowfever0: folds 
NeverRegret7: folds 
ChiChioChi: folds 
matiko09: raises $1 to $1.50
ZonTTT: folds 
Ahangama: folds 
CvMCvMCvM: calls $1
*** FLOP *** [6h Qh Td]
CvMCvMCvM: checks 
matiko09: bets $2.02
CvMCvMCvM: folds 
Uncalled bet ($2.02) returned to matiko09
matiko09 collected $3.10 from pot
matiko09: doesn't show hand 
*** SUMMARY ***
Total pot $3.25 | Rake $0.15 
Board [6h Qh Td]
Seat 1: yellowfever0 folded before Flop (didn't bet)
Seat 2: NeverRegret7 folded before Flop (didn't bet)
Seat 3: ChiChioChi folded before Flop (didn't bet)
Seat 4: matiko09 collected ($3.10)
Seat 5: ZonTTT (button) folded before Flop (didn't bet)
Seat 6: Ahangama (small blind) folded before Flop
Seat 7: CvMCvMCvM (big blind) folded on the Flop
Seat 8: lumen21 folded before Flop (didn't bet)
Seat 9: dndngod folded before Flop (didn't bet)





PokerStars Hand #150800565596:  Hold'em No Limit ($0.50/$1.00 USD) - 2016/03/23 14:07:57 CET [2016/03/23 9:07:57 ET]
Table 'Atlantis' 9-max Seat #4 is the button
Seat 1: xHourglass ($170.77 in chips) 
Seat 2: tffff2006 ($57.34 in chips) 
Seat 3: CAJUN890 ($104.29 in chips) 
Seat 4: matiko09 ($109.80 in chips) 
Seat 5: Pvsx. ($106.94 in chips) 
Seat 6: Jimy Tiltman ($132.36 in chips) 
Seat 8: DUkalisUA ($100 in chips) 
Seat 9: RICKA16 ($104.16 in chips) 
Pvsx.: posts small blind $0.50
Jimy Tiltman: posts big blind $1
Sherlockplay: sits out 
*** HOLE CARDS ***
Dealt to matiko09 [2s Qc]
DUkalisUA: folds 
RICKA16: folds 
xHourglass: raises $2 to $3
tffff2006: folds 
CAJUN890: raises $4 to $7
matiko09: folds 
Pvsx.: folds 
Jimy Tiltman: folds 
xHourglass: folds 
Uncalled bet ($4) returned to CAJUN890
CAJUN890 collected $7.50 from pot
CAJUN890: doesn't show hand 
*** SUMMARY ***
Total pot $7.50 | Rake $0 
Seat 1: xHourglass folded before Flop
Seat 2: tffff2006 folded before Flop (didn't bet)
Seat 3: CAJUN890 collected ($7.50)
Seat 4: matiko09 (button) folded before Flop (didn't bet)
Seat 5: Pvsx. (small blind) folded before Flop
Seat 6: Jimy Tiltman (big blind) folded before Flop
Seat 8: DUkalisUA folded before Flop (didn't bet)
Seat 9: RICKA16 folded before Flop (didn't bet)





PokerStars Hand #150800568694:  Hold'em No Limit ($1/$2 USD) - 2016/03/23 14:08:02 CET [2016/03/23 9:08:02 ET]
Table 'Kiess' 9-max Seat #6 is the button
Seat 1: Cirilico ($201.86 in chips) 
Seat 2: DUkalisUA ($697.68 in chips) 
Seat 4: Moszes360 ($200.77 in chips) 
Seat 5: chippo boy ($338.80 in chips) 
Seat 6: matiko09 ($274.84 in chips) 
Seat 7: InsomniaRU ($253.17 in chips) 
Seat 8: erfk1958 ($120 in chips) 
InsomniaRU: posts small blind $1
erfk1958: posts big blind $2
nickreason17: sits out 
*** HOLE CARDS ***
Dealt to matiko09 [Jh 5s]
Cirilico: folds 
DUkalisUA: folds 
Moszes360: folds 
chippo boy: folds 
matiko09: folds 
InsomniaRU: raises $3 to $5
erfk1958: calls $3
*** FLOP *** [Th Qd 8c]
InsomniaRU: checks 
erfk1958: bets $6
InsomniaRU: folds 
Uncalled bet ($6) returned to erfk1958
erfk1958 collected $9.55 from pot
erfk1958: doesn't show hand 
*** SUMMARY ***
Total pot $10 | Rake $0.45 
Board [Th Qd 8c]
Seat 1: Cirilico folded before Flop (didn't bet)
Seat 2: DUkalisUA folded before Flop (didn't bet)
Seat 4: Moszes360 folded before Flop (didn't bet)
Seat 5: chippo boy folded before Flop (didn't bet)
Seat 6: matiko09 (button) folded before Flop (didn't bet)
Seat 7: InsomniaRU (small blind) folded on the Flop
Seat 8: erfk1958 (big blind) collected ($9.55)





PokerStars Hand #150800573954:  Hold'em No Limit ($1/$2 USD) - 2016/03/23 14:08:11 CET [2016/03/23 9:08:11 ET]
Table 'Kypria II' 9-max Seat #6 is the button
Seat 1: geldwolfje ($151.12 in chips) 
Seat 2: coinflip_si ($215 in chips) 
Seat 3: seouljam ($200.45 in chips) 
Seat 4: VolanDog ($200 in chips) 
Seat 5: InsomniaRU ($403.78 in chips) 
Seat 6: matiko09 ($306.89 in chips) 
Seat 7: DUkalisUA ($200 in chips) 
Seat 8: Cirilico ($160 in chips) 
Seat 9: Moszes360 ($200 in chips) 
DUkalisUA: posts small blind $1
Cirilico: posts big blind $2
*** HOLE CARDS ***
Dealt to matiko09 [8s Qd]
Moszes360: folds 
geldwolfje: folds 
coinflip_si: folds 
seouljam: raises $2.70 to $4.70
VolanDog: folds 
InsomniaRU: folds 
matiko09: folds 
DUkalisUA: folds 
Cirilico: folds 
Uncalled bet ($2.70) returned to seouljam
seouljam collected $5 from pot
seouljam: doesn't show hand 
*** SUMMARY ***
Total pot $5 | Rake $0 
Seat 1: geldwolfje folded before Flop (didn't bet)
Seat 2: coinflip_si folded before Flop (didn't bet)
Seat 3: seouljam collected ($5)
Seat 4: VolanDog folded before Flop (didn't bet)
Seat 5: InsomniaRU folded before Flop (didn't bet)
Seat 6: matiko09 (button) folded before Flop (didn't bet)
Seat 7: DUkalisUA (small blind) folded before Flop
Seat 8: Cirilico (big blind) folded before Flop
Seat 9: Moszes360 folded before Flop (didn't bet)





PokerStars Hand #150800575886:  Hold'em No Limit ($1/$2 USD) - 2016/03/23 14:08:14 CET [2016/03/23 9:08:14 ET]
Table 'Achaia' 9-max Seat #1 is the button
Seat 1: ilaviiitech ($200 in chips) 
Seat 2: InsomniaRU ($224.66 in chips) 
Seat 3: matiko09 ($200 in chips) 
Seat 4: nailz83 ($204.32 in chips) 
Seat 6: nickreason17 ($220.06 in chips) 
Seat 7: morosun ($161.49 in chips) 
Seat 8: $-Twackle-$ ($200 in chips) 
Seat 9: glanza_mike ($208.28 in chips) 
InsomniaRU: posts small blind $1
matiko09: posts big blind $2
DUkalisUA: sits out 
*** HOLE CARDS ***
Dealt to matiko09 [Kc Ac]
nailz83: folds 
nickreason17: folds 
morosun: folds 
$-Twackle-$: folds 
glanza_mike: folds 
ilaviiitech: folds 
InsomniaRU: folds 
Uncalled bet ($1) returned to matiko09
matiko09 collected $2 from pot
matiko09: doesn't show hand 
*** SUMMARY ***
Total pot $2 | Rake $0 
Seat 1: ilaviiitech (button) folded before Flop (didn't bet)
Seat 2: InsomniaRU (small blind) folded before Flop
Seat 3: matiko09 (big blind) collected ($2)
Seat 4: nailz83 folded before Flop (didn't bet)
Seat 6: nickreason17 folded before Flop (didn't bet)
Seat 7: morosun folded before Flop (didn't bet)
Seat 8: $-Twackle-$ folded before Flop (didn't bet)
Seat 9: glanza_mike folded before Flop (didn't bet)





PokerStars Hand #150800579525:  Hold'em No Limit ($0.50/$1.00 USD) - 2016/03/23 14:08:21 CET [2016/03/23 9:08:21 ET]
Table 'Kippes' 9-max Seat #9 is the button
Seat 1: Pvsx. ($107.81 in chips) 
Seat 2: RICKA16 ($209.71 in chips) 
Seat 3: CAJUN890 ($124.52 in chips) 
Seat 4: matiko09 ($101.07 in chips) 
Seat 5: Jimy Tiltman ($113.36 in chips) 
Seat 6: DUkalisUA ($110.76 in chips) 
Seat 7: lumen21 ($112.02 in chips) 
Seat 9: wang19790906 ($66.62 in chips) 
Pvsx.: posts small blind $0.50
RICKA16: posts big blind $1
*** HOLE CARDS ***
Dealt to matiko09 [8s Qd]
CAJUN890: folds 
albert_ratza leaves the table
matiko09: folds 
Jimy Tiltman: folds 
DUkalisUA: folds 
lumen21: folds 
wang19790906: folds 
Pvsx.: folds 
Uncalled bet ($0.50) returned to RICKA16
RICKA16 collected $1 from pot
RICKA16: doesn't show hand 
*** SUMMARY ***
Total pot $1 | Rake $0 
Seat 1: Pvsx. (small blind) folded before Flop
Seat 2: RICKA16 (big blind) collected ($1)
Seat 3: CAJUN890 folded before Flop (didn't bet)
Seat 4: matiko09 folded before Flop (didn't bet)
Seat 5: Jimy Tiltman folded before Flop (didn't bet)
Seat 6: DUkalisUA folded before Flop (didn't bet)
Seat 7: lumen21 folded before Flop (didn't bet)
Seat 9: wang19790906 (button) folded before Flop (didn't bet)





PokerStars Hand #150800579631:  Hold'em No Limit ($1/$2 USD) - 2016/03/23 14:08:21 CET [2016/03/23 9:08:21 ET]
Table 'Ennomos II' 9-max Seat #1 is the button
Seat 1: ilaviiitech ($200 in chips) 
Seat 2: Subam ($204.20 in chips) 
Seat 3: $-Twackle-$ ($200 in chips) 
Seat 4: glanza_mike ($200 in chips) 
Seat 5: South011 ($202.78 in chips) 
Seat 6: nickreason17 ($200 in chips) 
Seat 7: daniferdoser ($250.77 in chips) 
Seat 8: yyfk ($200 in chips) 
Seat 9: matiko09 ($200 in chips) 
Subam: posts small blind $1
$-Twackle-$: posts big blind $2
*** HOLE CARDS ***
Dealt to matiko09 [7d Jh]
glanza_mike: raises $4 to $6
South011: folds 
nickreason17: folds 
daniferdoser: folds 
yyfk: folds 
matiko09: folds 
ilaviiitech: calls $6
Subam: folds 
$-Twackle-$: folds 
*** FLOP *** [3d Qc Ks]
glanza_mike: bets $7.16
ilaviiitech: folds 
Uncalled bet ($7.16) returned to glanza_mike
glanza_mike collected $14.32 from pot
glanza_mike: doesn't show hand 
*** SUMMARY ***
Total pot $15 | Rake $0.68 
Board [3d Qc Ks]
Seat 1: ilaviiitech (button) folded on the Flop
Seat 2: Subam (small blind) folded before Flop
Seat 3: $-Twackle-$ (big blind) folded before Flop
Seat 4: glanza_mike collected ($14.32)
Seat 5: South011 folded before Flop (didn't bet)
Seat 6: nickreason17 folded before Flop (didn't bet)
Seat 7: daniferdoser folded before Flop (didn't bet)
Seat 8: yyfk folded before Flop (didn't bet)
Seat 9: matiko09 folded before Flop (didn't bet)





PokerStars Hand #150800583740:  Hold'em No Limit ($0.50/$1.00 USD) - 2016/03/23 14:08:28 CET [2016/03/23 9:08:28 ET]
Table 'Smiley' 9-max Seat #9 is the button
Seat 1: xHourglass ($102.21 in chips) 
Seat 2: Jimy Tiltman ($138.20 in chips) 
Seat 3: matiko09 ($100 in chips) 
Seat 5: DUkalisUA ($184.70 in chips) 
Seat 7: Moszes360 ($100 in chips) 
Seat 8: Sherlockplay ($104.64 in chips) 
Seat 9: Pvsx. ($145.10 in chips) 
xHourglass: posts small blind $0.50
Jimy Tiltman: posts big blind $1
CAJUN890: sits out 
*** HOLE CARDS ***
Dealt to matiko09 [6c 9d]
matiko09: folds 
DUkalisUA: folds 
Moszes360: folds 
Sherlockplay: raises $1.50 to $2.50
Pvsx.: folds 
xHourglass: folds 
Jimy Tiltman: calls $1.50
*** FLOP *** [Kd 6h Kh]
Jimy Tiltman: checks 
Sherlockplay: bets $3.50
Jimy Tiltman: folds 
Uncalled bet ($3.50) returned to Sherlockplay
Sherlockplay collected $5.25 from pot
*** SUMMARY ***
Total pot $5.50 | Rake $0.25 
Board [Kd 6h Kh]
Seat 1: xHourglass (small blind) folded before Flop
Seat 2: Jimy Tiltman (big blind) folded on the Flop
Seat 3: matiko09 folded before Flop (didn't bet)
Seat 5: DUkalisUA folded before Flop (didn't bet)
Seat 7: Moszes360 folded before Flop (didn't bet)
Seat 8: Sherlockplay collected ($5.25)
Seat 9: Pvsx. (button) folded before Flop (didn't bet)





PokerStars Hand #150800586525:  Hold'em No Limit ($0.50/$1.00 USD) - 2016/03/23 14:08:32 CET [2016/03/23 9:08:32 ET]
Table 'Donar II' 9-max Seat #4 is the button
Seat 1: Effort92 ($102.82 in chips) 
Seat 3: st-germ30 ($103.94 in chips) 
Seat 4: DUkalisUA ($121.77 in chips) 
Seat 5: matiko09 ($103.94 in chips) 
Seat 6: ardo888 ($126.50 in chips) 
Seat 8: $-Twackle-$ ($100 in chips) 
Seat 9: oxfordtenzin ($132.29 in chips) 
matiko09: posts small blind $0.50
ardo888: posts big blind $1
Effort92: posts the ante $0.20
st-germ30: posts the ante $0.20
DUkalisUA: posts the ante $0.20
matiko09: posts the ante $0.20
ardo888: posts the ante $0.20
$-Twackle-$: posts the ante $0.20
oxfordtenzin: posts the ante $0.20
*** HOLE CARDS ***
Dealt to matiko09 [Td 6c]
$-Twackle-$: folds 
oxfordtenzin: folds 
Effort92: folds 
st-germ30: folds 
DUkalisUA: folds 
matiko09: folds 
Uncalled bet ($0.50) returned to ardo888
ardo888 collected $2.40 from pot
ardo888: doesn't show hand 
*** SUMMARY ***
Total pot $2.40 | Rake $0 
Seat 1: Effort92 folded before Flop (didn't bet)
Seat 3: st-germ30 folded before Flop (didn't bet)
Seat 4: DUkalisUA (button) folded before Flop (didn't bet)
Seat 5: matiko09 (small blind) folded before Flop
Seat 6: ardo888 (big blind) collected ($2.40)
Seat 8: $-Twackle-$ folded before Flop (didn't bet)
Seat 9: oxfordtenzin folded before Flop (didn't bet)





PokerStars Hand #150800590612:  Hold'em No Limit ($0.25/$0.50 USD) - 2016/03/23 14:08:39 CET [2016/03/23 9:08:39 ET]
Table 'Pyrrhus' 9-max Seat #6 is the button
Seat 1: lumen21 ($67.85 in chips) 
Seat 2: alemão007 ($50.69 in chips) 
Seat 4: GriffinBerg ($29.58 in chips) 
Seat 5: ZonTTT ($50 in chips) 
Seat 6: Ahangama ($50 in chips) 
Seat 7: matiko09 ($136.19 in chips) 
Seat 8: dndngod ($83.77 in chips) 
Seat 9: CvMCvMCvM ($95.11 in chips) 
matiko09: posts small blind $0.25
dndngod: posts big blind $0.50
i L00K great: sits out 
*** HOLE CARDS ***
Dealt to matiko09 [As 3d]
CvMCvMCvM: folds 
lumen21: folds 
alemão007: folds 
GriffinBerg: raises $1 to $1.50
ZonTTT: folds 
Ahangama: folds 
matiko09: folds 
dndngod: folds 
Uncalled bet ($1) returned to GriffinBerg
GriffinBerg collected $1.25 from pot
*** SUMMARY ***
Total pot $1.25 | Rake $0 
Seat 1: lumen21 folded before Flop (didn't bet)
Seat 2: alemão007 folded before Flop (didn't bet)
Seat 4: GriffinBerg collected ($1.25)
Seat 5: ZonTTT folded before Flop (didn't bet)
Seat 6: Ahangama (button) folded before Flop (didn't bet)
Seat 7: matiko09 (small blind) folded before Flop
Seat 8: dndngod (big blind) folded before Flop
Seat 9: CvMCvMCvM folded before Flop (didn't bet)





PokerStars Hand #150800592356:  Hold'em No Limit ($0.50/$1.00 USD) - 2016/03/23 14:08:42 CET [2016/03/23 9:08:42 ET]
Table 'Atlantis' 9-max Seat #5 is the button
Seat 1: xHourglass ($167.77 in chips) 
Seat 2: tffff2006 ($57.34 in chips) 
Seat 3: CAJUN890 ($108.79 in chips) 
Seat 4: matiko09 ($109.80 in chips) 
Seat 5: Pvsx. ($106.44 in chips) 
Seat 6: Jimy Tiltman ($131.36 in chips) 
Seat 7: Sherlockplay ($100 in chips) 
Seat 8: DUkalisUA ($100 in chips) 
Seat 9: RICKA16 ($104.16 in chips) 
Jimy Tiltman: posts small blind $0.50
Sherlockplay: posts big blind $1
*** HOLE CARDS ***
Dealt to matiko09 [Jc Qc]
DUkalisUA: folds 
RICKA16: folds 
xHourglass: raises $2 to $3
tffff2006: folds 
CAJUN890: folds 
matiko09: calls $3
Pvsx.: folds 
Jimy Tiltman: folds 
Sherlockplay: folds 
*** FLOP *** [Td 5c Jd]
xHourglass: bets $5.50
matiko09: calls $5.50
*** TURN *** [Td 5c Jd] [Qh]
xHourglass: bets $13.50
matiko09: calls $13.50
*** RIVER *** [Td 5c Jd Qh] [2c]
xHourglass: checks 
matiko09: bets $24
xHourglass: folds 
Uncalled bet ($24) returned to matiko09
matiko09 collected $43.45 from pot
matiko09: doesn't show hand 
*** SUMMARY ***
Total pot $45.50 | Rake $2.05 
Board [Td 5c Jd Qh 2c]
Seat 1: xHourglass folded on the River
Seat 2: tffff2006 folded before Flop (didn't bet)
Seat 3: CAJUN890 folded before Flop (didn't bet)
Seat 4: matiko09 collected ($43.45)
Seat 5: Pvsx. (button) folded before Flop (didn't bet)
Seat 6: Jimy Tiltman (small blind) folded before Flop
Seat 7: Sherlockplay (big blind) folded before Flop
Seat 8: DUkalisUA folded before Flop (didn't bet)
Seat 9: RICKA16 folded before Flop (didn't bet)





PokerStars Hand #150800592492:  Hold'em No Limit ($1/$2 USD) - 2016/03/23 14:08:43 CET [2016/03/23 9:08:43 ET]
Table 'Achaia' 9-max Seat #2 is the button
Seat 1: ilaviiitech ($200 in chips) 
Seat 2: InsomniaRU ($223.66 in chips) 
Seat 3: matiko09 ($201 in chips) 
Seat 4: nailz83 ($204.32 in chips) 
Seat 6: nickreason17 ($220.06 in chips) 
Seat 7: morosun ($181.67 in chips) 
Seat 8: $-Twackle-$ ($200 in chips) 
Seat 9: glanza_mike ($208.28 in chips) 
matiko09: posts small blind $1
nailz83: posts big blind $2
DUkalisUA: sits out 
*** HOLE CARDS ***
Dealt to matiko09 [Jc Qs]
nickreason17: folds 
morosun: raises $4 to $6
$-Twackle-$: folds 
glanza_mike: folds 
ilaviiitech: folds 
InsomniaRU: folds 
matiko09: folds 
nailz83: calls $4
*** FLOP *** [9d 3d 8h]
nailz83: checks 
morosun: checks 
*** TURN *** [9d 3d 8h] [Ts]
nailz83: checks 
morosun: bets $6.21
nailz83: folds 
Uncalled bet ($6.21) returned to morosun
morosun collected $12.42 from pot
*** SUMMARY ***
Total pot $13 | Rake $0.58 
Board [9d 3d 8h Ts]
Seat 1: ilaviiitech folded before Flop (didn't bet)
Seat 2: InsomniaRU (button) folded before Flop (didn't bet)
Seat 3: matiko09 (small blind) folded before Flop
Seat 4: nailz83 (big blind) folded on the Turn
Seat 6: nickreason17 folded before Flop (didn't bet)
Seat 7: morosun collected ($12.42)
Seat 8: $-Twackle-$ folded before Flop (didn't bet)
Seat 9: glanza_mike folded before Flop (didn't bet)





PokerStars Hand #150800594907:  Hold'em No Limit ($0.50/$1.00 USD) - 2016/03/23 14:08:47 CET [2016/03/23 9:08:47 ET]
Table 'Kippes' 9-max Seat #1 is the button
Seat 1: Pvsx. ($107.31 in chips) 
Seat 2: RICKA16 ($210.21 in chips) 
Seat 3: CAJUN890 ($124.52 in chips) 
Seat 4: matiko09 ($101.07 in chips) 
Seat 5: Jimy Tiltman ($113.36 in chips) 
Seat 6: DUkalisUA ($110.76 in chips) 
Seat 7: lumen21 ($112.02 in chips) 
Seat 9: wang19790906 ($66.62 in chips) 
RICKA16: posts small blind $0.50
CAJUN890: posts big blind $1
*** HOLE CARDS ***
Dealt to matiko09 [9d 2d]
matiko09: folds 
Jimy Tiltman: raises $2 to $3
DUkalisUA: folds 
Sherlockplay joins the table at seat #8 
lumen21: folds 
wang19790906: folds 
Pvsx.: folds 
RICKA16: folds 
CAJUN890: folds 
Uncalled bet ($2) returned to Jimy Tiltman
Jimy Tiltman collected $2.50 from pot
Jimy Tiltman: doesn't show hand 
*** SUMMARY ***
Total pot $2.50 | Rake $0 
Seat 1: Pvsx. (button) folded before Flop (didn't bet)
Seat 2: RICKA16 (small blind) folded before Flop
Seat 3: CAJUN890 (big blind) folded before Flop
Seat 4: matiko09 folded before Flop (didn't bet)
Seat 5: Jimy Tiltman collected ($2.50)
Seat 6: DUkalisUA folded before Flop (didn't bet)
Seat 7: lumen21 folded before Flop (didn't bet)
Seat 9: wang19790906 folded before Flop (didn't bet)





PokerStars Hand #150800600452:  Hold'em No Limit ($0.25/$0.50 USD) - 2016/03/23 14:08:56 CET [2016/03/23 9:08:56 ET]
Table 'Belnika' 9-max Seat #6 is the button
Seat 1: yellowfever0 ($15.75 in chips) 
Seat 2: NeverRegret7 ($56.02 in chips) 
Seat 3: ChiChioChi ($86.13 in chips) 
Seat 4: matiko09 ($68.28 in chips) 
Seat 5: ZonTTT ($56.60 in chips) 
Seat 6: Ahangama ($50 in chips) 
Seat 7: CvMCvMCvM ($50 in chips) 
Seat 8: lumen21 ($64.22 in chips) 
Seat 9: dndngod ($58.91 in chips) 
CvMCvMCvM: posts small blind $0.25
lumen21: posts big blind $0.50
*** HOLE CARDS ***
Dealt to matiko09 [2d Kc]
dndngod: folds 
yellowfever0: folds 
NeverRegret7: raises $0.75 to $1.25
ChiChioChi: calls $1.25
matiko09: folds 
ZonTTT: folds 
Ahangama: folds 
CvMCvMCvM: calls $1
lumen21: folds 
*** FLOP *** [As 6c 7s]
CvMCvMCvM: checks 
NeverRegret7: checks 
ChiChioChi: checks 
*** TURN *** [As 6c 7s] [2c]
CvMCvMCvM: checks 
NeverRegret7: checks 
ChiChioChi: bets $2.50
CvMCvMCvM: raises $5.50 to $8
NeverRegret7: folds 
ChiChioChi: calls $5.50
*** RIVER *** [As 6c 7s 2c] [Tc]
CvMCvMCvM: checks 
ChiChioChi: checks 
*** SHOW DOWN ***
CvMCvMCvM: shows [7d 7c] (three of a kind, Sevens)
ChiChioChi: mucks hand 
CvMCvMCvM collected $19.34 from pot
*** SUMMARY ***
Total pot $20.25 | Rake $0.91 
Board [As 6c 7s 2c Tc]
Seat 1: yellowfever0 folded before Flop (didn't bet)
Seat 2: NeverRegret7 folded on the Turn
Seat 3: ChiChioChi mucked [Qd Ac]
Seat 4: matiko09 folded before Flop (didn't bet)
Seat 5: ZonTTT folded before Flop (didn't bet)
Seat 6: Ahangama (button) folded before Flop (didn't bet)
Seat 7: CvMCvMCvM (small blind) showed [7d 7c] and won ($19.34) with three of a kind, Sevens
Seat 8: lumen21 (big blind) folded before Flop
Seat 9: dndngod folded before Flop (didn't bet)





PokerStars Hand #150800601669:  Hold'em No Limit ($0.50/$1.00 USD) - 2016/03/23 14:08:58 CET [2016/03/23 9:08:58 ET]
Table 'Donar II' 9-max Seat #5 is the button
Seat 1: Effort92 ($102.62 in chips) 
Seat 3: st-germ30 ($103.74 in chips) 
Seat 4: DUkalisUA ($121.57 in chips) 
Seat 5: matiko09 ($103.24 in chips) 
Seat 6: ardo888 ($128.20 in chips) 
Seat 8: $-Twackle-$ ($100 in chips) 
Seat 9: oxfordtenzin ($132.09 in chips) 
ardo888: posts small blind $0.50
$-Twackle-$: posts big blind $1
Effort92: posts the ante $0.20
st-germ30: posts the ante $0.20
DUkalisUA: posts the ante $0.20
matiko09: posts the ante $0.20
ardo888: posts the ante $0.20
$-Twackle-$: posts the ante $0.20
oxfordtenzin: posts the ante $0.20
*** HOLE CARDS ***
Dealt to matiko09 [9d 9s]
oxfordtenzin: folds 
Effort92: raises $1.50 to $2.50
st-germ30: folds 
DUkalisUA: raises $6 to $8.50
matiko09: folds 
ardo888: folds 
$-Twackle-$: folds 
Effort92: calls $6
*** FLOP *** [7h Qh 2d]
Effort92: checks 
DUkalisUA: bets $12
JimineyCrik joins the table at seat #7 
Effort92: folds 
Uncalled bet ($12) returned to DUkalisUA
DUkalisUA collected $19 from pot
DUkalisUA: doesn't show hand 
*** SUMMARY ***
Total pot $19.90 | Rake $0.90 
Board [7h Qh 2d]
Seat 1: Effort92 folded on the Flop
Seat 3: st-germ30 folded before Flop (didn't bet)
Seat 4: DUkalisUA collected ($19)
Seat 5: matiko09 (button) folded before Flop (didn't bet)
Seat 6: ardo888 (small blind) folded before Flop
Seat 8: $-Twackle-$ (big blind) folded before Flop
Seat 9: oxfordtenzin folded before Flop (didn't bet)





PokerStars Hand #150800604115:  Hold'em No Limit ($0.25/$0.50 USD) - 2016/03/23 14:09:02 CET [2016/03/23 9:09:02 ET]
Table 'Pyrrhus' 9-max Seat #7 is the button
Seat 1: lumen21 ($67.85 in chips) 
Seat 2: alemão007 ($50.69 in chips) 
Seat 4: GriffinBerg ($30.33 in chips) 
Seat 5: ZonTTT ($50 in chips) 
Seat 6: Ahangama ($50 in chips) 
Seat 7: matiko09 ($135.94 in chips) 
Seat 8: dndngod ($83.27 in chips) 
Seat 9: CvMCvMCvM ($95.11 in chips) 
dndngod: posts small blind $0.25
CvMCvMCvM: posts big blind $0.50
i L00K great: sits out 
*** HOLE CARDS ***
Dealt to matiko09 [8c 2d]
lumen21: folds 
alemão007: folds 
GriffinBerg: folds 
ZonTTT: folds 
Ahangama: raises $0.75 to $1.25
matiko09: folds 
dndngod: folds 
CvMCvMCvM: folds 
Uncalled bet ($0.75) returned to Ahangama
Ahangama collected $1.25 from pot
Ahangama: doesn't show hand 
*** SUMMARY ***
Total pot $1.25 | Rake $0 
Seat 1: lumen21 folded before Flop (didn't bet)
Seat 2: alemão007 folded before Flop (didn't bet)
Seat 4: GriffinBerg folded before Flop (didn't bet)
Seat 5: ZonTTT folded before Flop (didn't bet)
Seat 6: Ahangama collected ($1.25)
Seat 7: matiko09 (button) folded before Flop (didn't bet)
Seat 8: dndngod (small blind) folded before Flop
Seat 9: CvMCvMCvM (big blind) folded before Flop





PokerStars Hand #150800603905:  Hold'em No Limit ($1/$2 USD) - 2016/03/23 14:09:02 CET [2016/03/23 9:09:02 ET]
Table 'Kypria II' 9-max Seat #7 is the button
Seat 1: geldwolfje ($151.12 in chips) 
Seat 2: coinflip_si ($215 in chips) 
Seat 3: seouljam ($203.45 in chips) 
Seat 4: VolanDog ($200 in chips) 
Seat 5: InsomniaRU ($403.78 in chips) 
Seat 6: matiko09 ($306.89 in chips) 
Seat 7: DUkalisUA ($200 in chips) 
Seat 8: Cirilico ($160 in chips) 
Seat 9: Moszes360 ($200 in chips) 
Cirilico: posts small blind $1
Moszes360: posts big blind $2
*** HOLE CARDS ***
Dealt to matiko09 [Qh Qs]
geldwolfje: folds 
coinflip_si: folds 
seouljam: folds 
VolanDog: raises $4 to $6
InsomniaRU: folds 
matiko09: raises $13.50 to $19.50
DUkalisUA: folds 
Cirilico: folds 
Moszes360: folds 
VolanDog: raises $13.50 to $33
matiko09: calls $13.50
*** FLOP *** [Th 3h 9c]
VolanDog: bets $19.86
matiko09: calls $19.86
*** TURN *** [Th 3h 9c] [Qc]
VolanDog: checks 
matiko09: bets $60
VolanDog: folds 
Uncalled bet ($60) returned to matiko09
matiko09 collected $105.92 from pot
matiko09: doesn't show hand 
*** SUMMARY ***
Total pot $108.72 | Rake $2.80 
Board [Th 3h 9c Qc]
Seat 1: geldwolfje folded before Flop (didn't bet)
Seat 2: coinflip_si folded before Flop (didn't bet)
Seat 3: seouljam folded before Flop (didn't bet)
Seat 4: VolanDog folded on the Turn
Seat 5: InsomniaRU folded before Flop (didn't bet)
Seat 6: matiko09 collected ($105.92)
Seat 7: DUkalisUA (button) folded before Flop (didn't bet)
Seat 8: Cirilico (small blind) folded before Flop
Seat 9: Moszes360 (big blind) folded before Flop





PokerStars Hand #150800608359:  Hold'em No Limit ($0.50/$1.00 USD) - 2016/03/23 14:09:09 CET [2016/03/23 9:09:09 ET]
Table 'Merope II' 9-max Seat #1 is the button
Seat 1: Jimy Tiltman ($106.44 in chips) 
Seat 4: YuriiSolodya ($37 in chips) 
Seat 5: DUkalisUA ($142.36 in chips) 
Seat 6: Effort92 ($100 in chips) 
Seat 7: matiko09 ($112.23 in chips) 
Seat 8: titentei ($95 in chips) 
Seat 9: RICKA16 ($97 in chips) 
$-Twackle-$ will be allowed to play after the button
pablos1922 will be allowed to play after the button
YuriiSolodya: posts small blind $0.50
DUkalisUA: posts big blind $1
*** HOLE CARDS ***
Dealt to matiko09 [2h 2c]
Effort92: folds 
matiko09: folds 
titentei: folds 
RICKA16: folds 
Jimy Tiltman: folds 
YuriiSolodya: folds 
Uncalled bet ($0.50) returned to DUkalisUA
DUkalisUA collected $1 from pot
DUkalisUA: doesn't show hand 
*** SUMMARY ***
Total pot $1 | Rake $0 
Seat 1: Jimy Tiltman (button) folded before Flop (didn't bet)
Seat 4: YuriiSolodya (small blind) folded before Flop
Seat 5: DUkalisUA (big blind) collected ($1)
Seat 6: Effort92 folded before Flop (didn't bet)
Seat 7: matiko09 folded before Flop (didn't bet)
Seat 8: titentei folded before Flop (didn't bet)
Seat 9: RICKA16 folded before Flop (didn't bet)





PokerStars Hand #150800610140:  Hold'em No Limit ($1/$2 USD) - 2016/03/23 14:09:12 CET [2016/03/23 9:09:12 ET]
Table 'Ennomos II' 9-max Seat #2 is the button
Seat 1: ilaviiitech ($200 in chips) 
Seat 2: Subam ($203.20 in chips) 
Seat 3: $-Twackle-$ ($200 in chips) 
Seat 4: glanza_mike ($208.32 in chips) 
Seat 5: South011 ($202.78 in chips) 
Seat 6: nickreason17 ($200 in chips) 
Seat 7: daniferdoser ($250.77 in chips) 
Seat 8: yyfk ($200 in chips) 
Seat 9: matiko09 ($200 in chips) 
$-Twackle-$: posts small blind $1
glanza_mike: posts big blind $2
*** HOLE CARDS ***
Dealt to matiko09 [Kh 4d]
South011: folds 
nickreason17: folds 
daniferdoser: folds 
yyfk: folds 
matiko09: folds 
ilaviiitech: folds 
Subam: raises $2 to $4
$-Twackle-$: folds 
glanza_mike: folds 
Uncalled bet ($2) returned to Subam
Subam collected $5 from pot
Subam: doesn't show hand 
*** SUMMARY ***
Total pot $5 | Rake $0 
Seat 1: ilaviiitech folded before Flop (didn't bet)
Seat 2: Subam (button) collected ($5)
Seat 3: $-Twackle-$ (small blind) folded before Flop
Seat 4: glanza_mike (big blind) folded before Flop
Seat 5: South011 folded before Flop (didn't bet)
Seat 6: nickreason17 folded before Flop (didn't bet)
Seat 7: daniferdoser folded before Flop (didn't bet)
Seat 8: yyfk folded before Flop (didn't bet)
Seat 9: matiko09 folded before Flop (didn't bet)





PokerStars Hand #150800614037:  Hold'em No Limit ($0.50/$1.00 USD) - 2016/03/23 14:09:19 CET [2016/03/23 9:09:19 ET]
Table 'Smiley' 9-max Seat #1 is the button
Seat 1: xHourglass ($101.71 in chips) 
Seat 2: Jimy Tiltman ($135.70 in chips) 
Seat 3: matiko09 ($100 in chips) 
Seat 5: DUkalisUA ($184.70 in chips) 
Seat 7: Moszes360 ($100 in chips) 
Seat 8: Sherlockplay ($107.39 in chips) 
Seat 9: Pvsx. ($145.10 in chips) 
Jimy Tiltman: posts small blind $0.50
matiko09: posts big blind $1
CAJUN890: sits out 
*** HOLE CARDS ***
Dealt to matiko09 [2h As]
DUkalisUA: raises $2 to $3
Moszes360: folds 
Sherlockplay: folds 
Pvsx.: folds 
xHourglass: folds 
Jimy Tiltman: folds 
matiko09: folds 
Uncalled bet ($2) returned to DUkalisUA
DUkalisUA collected $2.50 from pot
DUkalisUA: doesn't show hand 
*** SUMMARY ***
Total pot $2.50 | Rake $0 
Seat 1: xHourglass (button) folded before Flop (didn't bet)
Seat 2: Jimy Tiltman (small blind) folded before Flop
Seat 3: matiko09 (big blind) folded before Flop
Seat 5: DUkalisUA collected ($2.50)
Seat 7: Moszes360 folded before Flop (didn't bet)
Seat 8: Sherlockplay folded before Flop (didn't bet)
Seat 9: Pvsx. folded before Flop (didn't bet)





PokerStars Hand #150800615584:  Hold'em No Limit ($1/$2 USD) - 2016/03/23 14:09:21 CET [2016/03/23 9:09:21 ET]
Table 'Achaia' 9-max Seat #3 is the button
Seat 1: ilaviiitech ($200 in chips) 
Seat 2: InsomniaRU ($223.66 in chips) 
Seat 3: matiko09 ($200 in chips) 
Seat 4: nailz83 ($198.32 in chips) 
Seat 5: DUkalisUA ($200 in chips) 
Seat 6: nickreason17 ($220.06 in chips) 
Seat 7: morosun ($188.09 in chips) 
Seat 8: $-Twackle-$ ($200 in chips) 
Seat 9: glanza_mike ($208.28 in chips) 
nailz83: posts small blind $1
DUkalisUA: posts big blind $2
*** HOLE CARDS ***
Dealt to matiko09 [8d 3d]
nickreason17: folds 
morosun: folds 
$-Twackle-$: folds 
glanza_mike: folds 
ilaviiitech: folds 
InsomniaRU: raises $3 to $5
matiko09: folds 
nailz83: folds 
DUkalisUA: folds 
Uncalled bet ($3) returned to InsomniaRU
InsomniaRU collected $5 from pot
InsomniaRU: doesn't show hand 
*** SUMMARY ***
Total pot $5 | Rake $0 
Seat 1: ilaviiitech folded before Flop (didn't bet)
Seat 2: InsomniaRU collected ($5)
Seat 3: matiko09 (button) folded before Flop (didn't bet)
Seat 4: nailz83 (small blind) folded before Flop
Seat 5: DUkalisUA (big blind) folded before Flop
Seat 6: nickreason17 folded before Flop (didn't bet)
Seat 7: morosun folded before Flop (didn't bet)
Seat 8: $-Twackle-$ folded before Flop (didn't bet)
Seat 9: glanza_mike folded before Flop (didn't bet)





PokerStars Hand #150800617690:  Hold'em No Limit ($0.25/$0.50 USD) - 2016/03/23 14:09:25 CET [2016/03/23 9:09:25 ET]
Table 'Pyrrhus' 9-max Seat #8 is the button
Seat 1: lumen21 ($67.85 in chips) 
Seat 2: alemão007 ($50.69 in chips) 
Seat 4: GriffinBerg ($30.33 in chips) 
Seat 5: ZonTTT ($50 in chips) 
Seat 6: Ahangama ($50.75 in chips) 
Seat 7: matiko09 ($135.94 in chips) 
Seat 8: dndngod ($83.02 in chips) 
Seat 9: CvMCvMCvM ($94.61 in chips) 
CvMCvMCvM: posts small blind $0.25
lumen21: posts big blind $0.50
i L00K great: sits out 
*** HOLE CARDS ***
Dealt to matiko09 [Tc 8h]
alemão007: folds 
GriffinBerg: folds 
ZonTTT: raises $1 to $1.50
Ahangama: folds 
matiko09: folds 
dndngod: folds 
CvMCvMCvM: raises $3.50 to $5
lumen21: folds 
ZonTTT: folds 
Uncalled bet ($3.50) returned to CvMCvMCvM
CvMCvMCvM collected $3.50 from pot
CvMCvMCvM: doesn't show hand 
*** SUMMARY ***
Total pot $3.50 | Rake $0 
Seat 1: lumen21 (big blind) folded before Flop
Seat 2: alemão007 folded before Flop (didn't bet)
Seat 4: GriffinBerg folded before Flop (didn't bet)
Seat 5: ZonTTT folded before Flop
Seat 6: Ahangama folded before Flop (didn't bet)
Seat 7: matiko09 folded before Flop (didn't bet)
Seat 8: dndngod (button) folded before Flop (didn't bet)
Seat 9: CvMCvMCvM (small blind) collected ($3.50)





PokerStars Hand #150800618331:  Hold'em No Limit ($0.50/$1.00 USD) - 2016/03/23 14:09:26 CET [2016/03/23 9:09:26 ET]
Table 'Kippes' 9-max Seat #2 is the button
Seat 1: Pvsx. ($107.31 in chips) 
Seat 2: RICKA16 ($209.71 in chips) 
Seat 3: CAJUN890 ($123.52 in chips) 
Seat 4: matiko09 ($101.07 in chips) 
Seat 5: Jimy Tiltman ($114.86 in chips) 
Seat 6: DUkalisUA ($110.76 in chips) 
Seat 7: lumen21 ($112.02 in chips) 
Seat 9: wang19790906 ($66.62 in chips) 
CAJUN890: posts small blind $0.50
matiko09: posts big blind $1
Sherlockplay: sits out 
*** HOLE CARDS ***
Dealt to matiko09 [4c 7s]
Jimy Tiltman: folds 
DUkalisUA: folds 
lumen21: folds 
wang19790906: raises $3 to $4
Pvsx.: folds 
RICKA16: folds 
CAJUN890: folds 
matiko09: folds 
Uncalled bet ($3) returned to wang19790906
wang19790906 collected $2.50 from pot
wang19790906: doesn't show hand 
*** SUMMARY ***
Total pot $2.50 | Rake $0 
Seat 1: Pvsx. folded before Flop (didn't bet)
Seat 2: RICKA16 (button) folded before Flop (didn't bet)
Seat 3: CAJUN890 (small blind) folded before Flop
Seat 4: matiko09 (big blind) folded before Flop
Seat 5: Jimy Tiltman folded before Flop (didn't bet)
Seat 6: DUkalisUA folded before Flop (didn't bet)
Seat 7: lumen21 folded before Flop (didn't bet)
Seat 9: wang19790906 collected ($2.50)





PokerStars Hand #150800619790:  Hold'em No Limit ($0.50/$1.00 USD) - 2016/03/23 14:09:28 CET [2016/03/23 9:09:28 ET]
Table 'Merope II' 9-max Seat #4 is the button
Seat 1: Jimy Tiltman ($106.44 in chips) 
Seat 4: YuriiSolodya ($36.50 in chips) 
Seat 5: DUkalisUA ($142.86 in chips) 
Seat 6: Effort92 ($100 in chips) 
Seat 7: matiko09 ($112.23 in chips) 
Seat 8: titentei ($95 in chips) 
Seat 9: RICKA16 ($100 in chips) 
DUkalisUA: posts small blind $0.50
Effort92: posts big blind $1
$-Twackle-$: sits out 
pablos1922: sits out 
*** HOLE CARDS ***
Dealt to matiko09 [Qc 2c]
matiko09: folds 
titentei: folds 
RICKA16: folds 
Jimy Tiltman: folds 
YuriiSolodya: folds 
DUkalisUA: raises $1.50 to $2.50
Effort92: calls $1.50
*** FLOP *** [Kd 8d 3s]
DUkalisUA: checks 
Effort92: checks 
*** TURN *** [Kd 8d 3s] [4s]
DUkalisUA: bets $3.15
Effort92: folds 
Uncalled bet ($3.15) returned to DUkalisUA
DUkalisUA collected $4.78 from pot
DUkalisUA: doesn't show hand 
*** SUMMARY ***
Total pot $5 | Rake $0.22 
Board [Kd 8d 3s 4s]
Seat 1: Jimy Tiltman folded before Flop (didn't bet)
Seat 4: YuriiSolodya (button) folded before Flop (didn't bet)
Seat 5: DUkalisUA (small blind) collected ($4.78)
Seat 6: Effort92 (big blind) folded on the Turn
Seat 7: matiko09 folded before Flop (didn't bet)
Seat 8: titentei folded before Flop (didn't bet)
Seat 9: RICKA16 folded before Flop (didn't bet)





PokerStars Hand #150800625870:  Hold'em No Limit ($1/$2 USD) - 2016/03/23 14:09:39 CET [2016/03/23 9:09:39 ET]
Table 'Ennomos II' 9-max Seat #3 is the button
Seat 1: ilaviiitech ($200 in chips) 
Seat 2: Subam ($206.20 in chips) 
Seat 3: $-Twackle-$ ($200 in chips) 
Seat 4: glanza_mike ($206.32 in chips) 
Seat 5: South011 ($202.78 in chips) 
Seat 6: nickreason17 ($200 in chips) 
Seat 7: daniferdoser ($250.77 in chips) 
Seat 8: yyfk ($200 in chips) 
Seat 9: matiko09 ($200 in chips) 
glanza_mike: posts small blind $1
South011: posts big blind $2
*** HOLE CARDS ***
Dealt to matiko09 [8c 3d]
nickreason17: folds 
daniferdoser: folds 
yyfk: folds 
matiko09: folds 
ilaviiitech: folds 
Subam: raises $2 to $4
$-Twackle-$: folds 
glanza_mike: calls $3
South011: calls $2
*** FLOP *** [2c Ah Kc]
glanza_mike: checks 
South011: checks 
Subam: bets $6
glanza_mike: folds 
South011: folds 
Uncalled bet ($6) returned to Subam
Subam collected $11.46 from pot
Subam: doesn't show hand 
*** SUMMARY ***
Total pot $12 | Rake $0.54 
Board [2c Ah Kc]
Seat 1: ilaviiitech folded before Flop (didn't bet)
Seat 2: Subam collected ($11.46)
Seat 3: $-Twackle-$ (button) folded before Flop (didn't bet)
Seat 4: glanza_mike (small blind) folded on the Flop
Seat 5: South011 (big blind) folded on the Flop
Seat 6: nickreason17 folded before Flop (didn't bet)
Seat 7: daniferdoser folded before Flop (didn't bet)
Seat 8: yyfk folded before Flop (didn't bet)
Seat 9: matiko09 folded before Flop (didn't bet)





PokerStars Hand #150800626645:  Hold'em No Limit ($1/$2 USD) - 2016/03/23 14:09:40 CET [2016/03/23 9:09:40 ET]
Table 'Herba II' 9-max Seat #6 is the button
Seat 1: matiko09 ($206.46 in chips) 
Seat 2: Moszes360 ($237.89 in chips) 
Seat 3: Cirilico ($160 in chips) 
Seat 4: DUkalisUA ($295.48 in chips) 
Seat 5: chippo boy ($241.53 in chips) 
Seat 6: Too-Anti-To ($200 in chips) 
Seat 7: InsomniaRU ($205.78 in chips) 
Seat 8: The_red_area ($454.98 in chips) 
Seat 9: mrhighryza ($47.55 in chips) 
InsomniaRU: posts small blind $1
The_red_area: posts big blind $2
*** HOLE CARDS ***
Dealt to matiko09 [5c 3s]
mrhighryza: calls $2
matiko09: folds 
Moszes360: folds 
Cirilico: folds 
DUkalisUA: folds 
chippo boy: raises $6 to $8
Too-Anti-To: folds 
InsomniaRU: folds 
The_red_area: calls $6
mrhighryza: calls $6
*** FLOP *** [2s 9s 8d]
The_red_area: checks 
mrhighryza: bets $39.55 and is all-in
chippo boy: folds 
The_red_area: folds 
Uncalled bet ($39.55) returned to mrhighryza
mrhighryza collected $23.88 from pot
*** SUMMARY ***
Total pot $25 | Rake $1.12 
Board [2s 9s 8d]
Seat 1: matiko09 folded before Flop (didn't bet)
Seat 2: Moszes360 folded before Flop (didn't bet)
Seat 3: Cirilico folded before Flop (didn't bet)
Seat 4: DUkalisUA folded before Flop (didn't bet)
Seat 5: chippo boy folded on the Flop
Seat 6: Too-Anti-To (button) folded before Flop (didn't bet)
Seat 7: InsomniaRU (small blind) folded before Flop
Seat 8: The_red_area (big blind) folded on the Flop
Seat 9: mrhighryza collected ($23.88)





PokerStars Hand #150800626892:  Hold'em No Limit ($1/$2 USD) - 2016/03/23 14:09:40 CET [2016/03/23 9:09:40 ET]
Table 'Kiess' 9-max Seat #7 is the button
Seat 1: Cirilico ($201.86 in chips) 
Seat 2: DUkalisUA ($697.68 in chips) 
Seat 4: Moszes360 ($200.77 in chips) 
Seat 5: chippo boy ($338.80 in chips) 
Seat 6: matiko09 ($274.84 in chips) 
Seat 7: InsomniaRU ($248.17 in chips) 
Seat 8: erfk1958 ($124.55 in chips) 
Seat 9: nickreason17 ($200 in chips) 
erfk1958: posts small blind $1
nickreason17: posts big blind $2
The_red_area: sits out 
*** HOLE CARDS ***
Dealt to matiko09 [7d Kd]
Cirilico: folds 
DUkalisUA: folds 
Moszes360: raises $4 to $6
chippo boy: calls $6
matiko09: folds 
InsomniaRU: folds 
erfk1958: folds 
nickreason17: folds 
*** FLOP *** [2h 6s 2s]
Moszes360: checks 
chippo boy: bets $8
Moszes360: folds 
Uncalled bet ($8) returned to chippo boy
chippo boy collected $14.32 from pot
*** SUMMARY ***
Total pot $15 | Rake $0.68 
Board [2h 6s 2s]
Seat 1: Cirilico folded before Flop (didn't bet)
Seat 2: DUkalisUA folded before Flop (didn't bet)
Seat 4: Moszes360 folded on the Flop
Seat 5: chippo boy collected ($14.32)
Seat 6: matiko09 folded before Flop (didn't bet)
Seat 7: InsomniaRU (button) folded before Flop (didn't bet)
Seat 8: erfk1958 (small blind) folded before Flop
Seat 9: nickreason17 (big blind) folded before Flop





PokerStars Hand #150800626622:  Hold'em No Limit ($0.50/$1.00 USD) - 2016/03/23 14:09:40 CET [2016/03/23 9:09:40 ET]
Table 'Smiley' 9-max Seat #2 is the button
Seat 1: xHourglass ($101.71 in chips) 
Seat 2: Jimy Tiltman ($135.20 in chips) 
Seat 3: matiko09 ($100 in chips) 
Seat 4: CAJUN890 ($100 in chips) 
Seat 5: DUkalisUA ($186.20 in chips) 
Seat 7: Moszes360 ($100 in chips) 
Seat 8: Sherlockplay ($107.39 in chips) 
Seat 9: Pvsx. ($145.10 in chips) 
matiko09: posts small blind $0.50
CAJUN890: posts big blind $1
*** HOLE CARDS ***
Dealt to matiko09 [Js 7c]
DUkalisUA: folds 
Moszes360: folds 
Sherlockplay: folds 
Pvsx.: folds 
xHourglass: raises $2 to $3
Jimy Tiltman: folds 
matiko09: folds 
CAJUN890: calls $2
*** FLOP *** [7s 8s Jh]
CAJUN890: checks 
xHourglass: checks 
*** TURN *** [7s 8s Jh] [Qd]
CAJUN890: bets $3
xHourglass: calls $3
*** RIVER *** [7s 8s Jh Qd] [Td]
CAJUN890: checks 
xHourglass: bets $7.50
CAJUN890: folds 
Uncalled bet ($7.50) returned to xHourglass
xHourglass collected $11.94 from pot
xHourglass: doesn't show hand 
*** SUMMARY ***
Total pot $12.50 | Rake $0.56 
Board [7s 8s Jh Qd Td]
Seat 1: xHourglass collected ($11.94)
Seat 2: Jimy Tiltman (button) folded before Flop (didn't bet)
Seat 3: matiko09 (small blind) folded before Flop
Seat 4: CAJUN890 (big blind) folded on the River
Seat 5: DUkalisUA folded before Flop (didn't bet)
Seat 7: Moszes360 folded before Flop (didn't bet)
Seat 8: Sherlockplay folded before Flop (didn't bet)
Seat 9: Pvsx. folded before Flop (didn't bet)





PokerStars Hand #150800635796:  Hold'em No Limit ($1/$2 USD) - 2016/03/23 14:09:55 CET [2016/03/23 9:09:55 ET]
Table 'Achaia' 9-max Seat #4 is the button
Seat 1: ilaviiitech ($200 in chips) 
Seat 2: InsomniaRU ($226.66 in chips) 
Seat 3: matiko09 ($200 in chips) 
Seat 4: nailz83 ($197.32 in chips) 
Seat 5: DUkalisUA ($200 in chips) 
Seat 6: nickreason17 ($220.06 in chips) 
Seat 7: morosun ($188.09 in chips) 
Seat 8: $-Twackle-$ ($200 in chips) 
Seat 9: glanza_mike ($208.28 in chips) 
DUkalisUA: posts small blind $1
nickreason17: posts big blind $2
*** HOLE CARDS ***
Dealt to matiko09 [As 7s]
morosun: folds 
$-Twackle-$: raises $4 to $6
glanza_mike: folds 
ilaviiitech: folds 
InsomniaRU: folds 
matiko09: folds 
nailz83: calls $6
DUkalisUA: folds 
nickreason17: calls $4
*** FLOP *** [5s 6h 7h]
nickreason17: checks 
$-Twackle-$: checks 
nailz83: checks 
*** TURN *** [5s 6h 7h] [Js]
nickreason17: checks 
$-Twackle-$: checks 
nailz83: bets $10
nickreason17: folds 
$-Twackle-$: folds 
Uncalled bet ($10) returned to nailz83
nailz83 collected $18.14 from pot
nailz83: doesn't show hand 
*** SUMMARY ***
Total pot $19 | Rake $0.86 
Board [5s 6h 7h Js]
Seat 1: ilaviiitech folded before Flop (didn't bet)
Seat 2: InsomniaRU folded before Flop (didn't bet)
Seat 3: matiko09 folded before Flop (didn't bet)
Seat 4: nailz83 (button) collected ($18.14)
Seat 5: DUkalisUA (small blind) folded before Flop
Seat 6: nickreason17 (big blind) folded on the Turn
Seat 7: morosun folded before Flop (didn't bet)
Seat 8: $-Twackle-$ folded on the Turn
Seat 9: glanza_mike folded before Flop (didn't bet)





PokerStars Hand #150800638009:  Hold'em No Limit ($0.50/$1.00 USD) - 2016/03/23 14:09:59 CET [2016/03/23 9:09:59 ET]
Table 'Atlantis' 9-max Seat #6 is the button
Seat 1: xHourglass ($145.77 in chips) 
Seat 2: tffff2006 ($57.34 in chips) 
Seat 3: CAJUN890 ($108.79 in chips) 
Seat 4: matiko09 ($131.25 in chips) 
Seat 5: Pvsx. ($106.44 in chips) 
Seat 6: Jimy Tiltman ($130.86 in chips) 
Seat 7: Sherlockplay ($100 in chips) 
Seat 8: DUkalisUA ($100 in chips) 
Seat 9: RICKA16 ($104.16 in chips) 
Sherlockplay: posts small blind $0.50
DUkalisUA: posts big blind $1
*** HOLE CARDS ***
Dealt to matiko09 [8h Kh]
RICKA16: folds 
xHourglass: folds 
tffff2006: folds 
CAJUN890: folds 
matiko09: folds 
Pvsx.: raises $1.50 to $2.50
Jimy Tiltman: folds 
Sherlockplay: raises $6 to $8.50
DUkalisUA: folds 
Pvsx.: calls $6
*** FLOP *** [6h 7s 8c]
Sherlockplay: checks 
Pvsx.: bets $8.59
Sherlockplay: folds 
Uncalled bet ($8.59) returned to Pvsx.
Pvsx. collected $17.19 from pot
Pvsx.: doesn't show hand 
*** SUMMARY ***
Total pot $18 | Rake $0.81 
Board [6h 7s 8c]
Seat 1: xHourglass folded before Flop (didn't bet)
Seat 2: tffff2006 folded before Flop (didn't bet)
Seat 3: CAJUN890 folded before Flop (didn't bet)
Seat 4: matiko09 folded before Flop (didn't bet)
Seat 5: Pvsx. collected ($17.19)
Seat 6: Jimy Tiltman (button) folded before Flop (didn't bet)
Seat 7: Sherlockplay (small blind) folded on the Flop
Seat 8: DUkalisUA (big blind) folded before Flop
Seat 9: RICKA16 folded before Flop (didn't bet)





PokerStars Hand #150800643807:  Hold'em No Limit ($0.25/$0.50 USD) - 2016/03/23 14:10:08 CET [2016/03/23 9:10:08 ET]
Table 'Pyrrhus' 9-max Seat #9 is the button
Seat 1: lumen21 ($67.35 in chips) 
Seat 2: alemão007 ($50.69 in chips) 
Seat 4: GriffinBerg ($30.33 in chips) 
Seat 5: ZonTTT ($50 in chips) 
Seat 6: Ahangama ($50.75 in chips) 
Seat 7: matiko09 ($135.94 in chips) 
Seat 8: dndngod ($83.02 in chips) 
Seat 9: CvMCvMCvM ($96.61 in chips) 
lumen21: posts small blind $0.25
alemão007: posts big blind $0.50
i L00K great: sits out 
*** HOLE CARDS ***
Dealt to matiko09 [6h 8h]
GriffinBerg: folds 
ZonTTT: folds 
Ahangama: folds 
matiko09: folds 
dndngod: folds 
CvMCvMCvM: folds 
lumen21: raises $1 to $1.50
alemão007: calls $1
*** FLOP *** [5d 5s Ah]
lumen21: bets $1.57
alemão007: raises $2.43 to $4
lumen21: calls $2.43
*** TURN *** [5d 5s Ah] [8s]
lumen21: checks 
alemão007: bets $5.75
lumen21: calls $5.75
*** RIVER *** [5d 5s Ah 8s] [Tc]
lumen21: bets $56.10 and is all-in
alemão007: folds 
Uncalled bet ($56.10) returned to lumen21
lumen21 collected $21.49 from pot
lumen21: doesn't show hand 
*** SUMMARY ***
Total pot $22.50 | Rake $1.01 
Board [5d 5s Ah 8s Tc]
Seat 1: lumen21 (small blind) collected ($21.49)
Seat 2: alemão007 (big blind) folded on the River
Seat 4: GriffinBerg folded before Flop (didn't bet)
Seat 5: ZonTTT folded before Flop (didn't bet)
Seat 6: Ahangama folded before Flop (didn't bet)
Seat 7: matiko09 folded before Flop (didn't bet)
Seat 8: dndngod folded before Flop (didn't bet)
Seat 9: CvMCvMCvM (button) folded before Flop (didn't bet)





PokerStars Hand #150800643512:  Hold'em No Limit ($0.50/$1.00 USD) - 2016/03/23 14:10:08 CET [2016/03/23 9:10:08 ET]
Table 'Kippes' 9-max Seat #3 is the button
Seat 1: Pvsx. ($107.31 in chips) 
Seat 2: RICKA16 ($209.71 in chips) 
Seat 3: CAJUN890 ($123.02 in chips) 
Seat 4: matiko09 ($100.07 in chips) 
Seat 5: Jimy Tiltman ($114.86 in chips) 
Seat 6: DUkalisUA ($110.76 in chips) 
Seat 7: lumen21 ($112.02 in chips) 
Seat 9: wang19790906 ($68.12 in chips) 
matiko09: posts small blind $0.50
Jimy Tiltman: posts big blind $1
Sherlockplay: sits out 
*** HOLE CARDS ***
Dealt to matiko09 [Jc 9c]
DUkalisUA: folds 
lumen21: folds 
wang19790906: calls $1
Pvsx.: folds 
RICKA16: raises $3 to $4
CAJUN890: folds 
matiko09: folds 
Jimy Tiltman: folds 
wang19790906: calls $3
*** FLOP *** [5d 2d 4h]
wang19790906: checks 
RICKA16: bets $6
wang19790906: calls $6
*** TURN *** [5d 2d 4h] [7d]
wang19790906: checks 
RICKA16: checks 
*** RIVER *** [5d 2d 4h 7d] [8s]
wang19790906: bets $10.26
RICKA16: calls $10.26
*** SHOW DOWN ***
wang19790906: shows [Kc Kh] (a pair of Kings)
RICKA16: mucks hand 
wang19790906 collected $40.13 from pot
*** SUMMARY ***
Total pot $42.02 | Rake $1.89 
Board [5d 2d 4h 7d 8s]
Seat 1: Pvsx. folded before Flop (didn't bet)
Seat 2: RICKA16 mucked [Qs Qd]
Seat 3: CAJUN890 (button) folded before Flop (didn't bet)
Seat 4: matiko09 (small blind) folded before Flop
Seat 5: Jimy Tiltman (big blind) folded before Flop
Seat 6: DUkalisUA folded before Flop (didn't bet)
Seat 7: lumen21 folded before Flop (didn't bet)
Seat 9: wang19790906 showed [Kc Kh] and won ($40.13) with a pair of Kings





PokerStars Hand #150800648632:  Hold'em No Limit ($0.25/$0.50 USD) - 2016/03/23 14:10:17 CET [2016/03/23 9:10:17 ET]
Table 'Belnika' 9-max Seat #7 is the button
Seat 1: yellowfever0 ($15.75 in chips) 
Seat 2: NeverRegret7 ($54.77 in chips) 
Seat 3: ChiChioChi ($76.88 in chips) 
Seat 4: matiko09 ($68.28 in chips) 
Seat 5: ZonTTT ($56.60 in chips) 
Seat 6: Ahangama ($50 in chips) 
Seat 7: CvMCvMCvM ($60.09 in chips) 
Seat 8: lumen21 ($63.72 in chips) 
Seat 9: dndngod ($58.91 in chips) 
lumen21: posts small blind $0.25
dndngod: posts big blind $0.50
*** HOLE CARDS ***
Dealt to matiko09 [6d Th]
yellowfever0: folds 
NeverRegret7: folds 
ChiChioChi: raises $0.50 to $1
matiko09: folds 
ZonTTT: folds 
Ahangama: folds 
CvMCvMCvM: folds 
lumen21: folds 
dndngod: folds 
Uncalled bet ($0.50) returned to ChiChioChi
ChiChioChi collected $1.25 from pot
ChiChioChi: doesn't show hand 
*** SUMMARY ***
Total pot $1.25 | Rake $0 
Seat 1: yellowfever0 folded before Flop (didn't bet)
Seat 2: NeverRegret7 folded before Flop (didn't bet)
Seat 3: ChiChioChi collected ($1.25)
Seat 4: matiko09 folded before Flop (didn't bet)
Seat 5: ZonTTT folded before Flop (didn't bet)
Seat 6: Ahangama folded before Flop (didn't bet)
Seat 7: CvMCvMCvM (button) folded before Flop (didn't bet)
Seat 8: lumen21 (small blind) folded before Flop
Seat 9: dndngod (big blind) folded before Flop





PokerStars Hand #150800650869:  Hold'em No Limit ($0.50/$1.00 USD) - 2016/03/23 14:10:20 CET [2016/03/23 9:10:20 ET]
Table 'Donar II' 9-max Seat #6 is the button
Seat 1: Effort92 ($100 in chips) 
Seat 3: st-germ30 ($103.54 in chips) 
Seat 4: DUkalisUA ($131.87 in chips) 
Seat 5: matiko09 ($103.04 in chips) 
Seat 6: ardo888 ($127.50 in chips) 
Seat 8: $-Twackle-$ ($100 in chips) 
Seat 9: oxfordtenzin ($131.89 in chips) 
JimineyCrik will be allowed to play after the button
$-Twackle-$: posts small blind $0.50
oxfordtenzin: posts big blind $1
Effort92: posts the ante $0.20
st-germ30: posts the ante $0.20
DUkalisUA: posts the ante $0.20
matiko09: posts the ante $0.20
ardo888: posts the ante $0.20
$-Twackle-$: posts the ante $0.20
oxfordtenzin: posts the ante $0.20
*** HOLE CARDS ***
Dealt to matiko09 [9s Qd]
Effort92: folds 
st-germ30: folds 
DUkalisUA: folds 
matiko09: folds 
ardo888: raises $1.50 to $2.50
$-Twackle-$: folds 
oxfordtenzin: folds 
Uncalled bet ($1.50) returned to ardo888
ardo888 collected $3.90 from pot
ardo888: doesn't show hand 
*** SUMMARY ***
Total pot $3.90 | Rake $0 
Seat 1: Effort92 folded before Flop (didn't bet)
Seat 3: st-germ30 folded before Flop (didn't bet)
Seat 4: DUkalisUA folded before Flop (didn't bet)
Seat 5: matiko09 folded before Flop (didn't bet)
Seat 6: ardo888 (button) collected ($3.90)
Seat 8: $-Twackle-$ (small blind) folded before Flop
Seat 9: oxfordtenzin (big blind) folded before Flop





PokerStars Hand #150800656344:  Hold'em No Limit ($1/$2 USD) - 2016/03/23 14:10:29 CET [2016/03/23 9:10:29 ET]
Table 'Kiess' 9-max Seat #8 is the button
Seat 1: Cirilico ($201.86 in chips) 
Seat 2: DUkalisUA ($697.68 in chips) 
Seat 4: Moszes360 ($200 in chips) 
Seat 5: chippo boy ($347.12 in chips) 
Seat 6: matiko09 ($274.84 in chips) 
Seat 7: InsomniaRU ($248.17 in chips) 
Seat 8: erfk1958 ($123.55 in chips) 
Seat 9: nickreason17 ($200 in chips) 
nickreason17: posts small blind $1
Cirilico: posts big blind $2
The_red_area: sits out 
*** HOLE CARDS ***
Dealt to matiko09 [4c 3d]
DUkalisUA: folds 
Moszes360: folds 
chippo boy: calls $2
matiko09: folds 
InsomniaRU: folds 
erfk1958: folds 
nickreason17: raises $6 to $8
Cirilico: folds 
chippo boy: calls $6
*** FLOP *** [5s 9h Td]
nickreason17: bets $12
chippo boy: raises $12 to $24
nickreason17: calls $12
*** TURN *** [5s 9h Td] [Qc]
nickreason17: checks 
chippo boy: bets $32
nickreason17: calls $32
*** RIVER *** [5s 9h Td Qc] [7h]
nickreason17: checks 
chippo boy: bets $64
nickreason17: calls $64
*** SHOW DOWN ***
chippo boy: shows [5c Tc] (two pair, Tens and Fives)
nickreason17: mucks hand 
chippo boy collected $255.20 from pot
*** SUMMARY ***
Total pot $258 | Rake $2.80 
Board [5s 9h Td Qc 7h]
Seat 1: Cirilico (big blind) folded before Flop
Seat 2: DUkalisUA folded before Flop (didn't bet)
Seat 4: Moszes360 folded before Flop (didn't bet)
Seat 5: chippo boy showed [5c Tc] and won ($255.20) with two pair, Tens and Fives
Seat 6: matiko09 folded before Flop (didn't bet)
Seat 7: InsomniaRU folded before Flop (didn't bet)
Seat 8: erfk1958 (button) folded before Flop (didn't bet)
Seat 9: nickreason17 (small blind) mucked [As Ac]





PokerStars Hand #150800658315:  Hold'em No Limit ($0.50/$1.00 USD) - 2016/03/23 14:10:32 CET [2016/03/23 9:10:32 ET]
Table 'Merope II' 9-max Seat #5 is the button
Seat 1: Jimy Tiltman ($106.44 in chips) 
Seat 4: YuriiSolodya ($36.50 in chips) 
Seat 5: DUkalisUA ($145.14 in chips) 
Seat 6: Effort92 ($100 in chips) 
Seat 7: matiko09 ($112.23 in chips) 
Seat 8: titentei ($95 in chips) 
Seat 9: RICKA16 ($100 in chips) 
Effort92: posts small blind $0.50
matiko09: posts big blind $1
$-Twackle-$: sits out 
pablos1922: sits out 
*** HOLE CARDS ***
Dealt to matiko09 [5h Jd]
titentei: folds 
RICKA16: folds 
Jimy Tiltman: raises $2 to $3
YuriiSolodya: raises $3 to $6
DUkalisUA: folds 
Effort92: folds 
matiko09: folds 
Jimy Tiltman: calls $3
*** FLOP *** [5c 7s 5d]
Jimy Tiltman: checks 
YuriiSolodya: bets $12.89
Jimy Tiltman: raises $87.55 to $100.44 and is all-in
YuriiSolodya: calls $17.61 and is all-in
Uncalled bet ($69.94) returned to Jimy Tiltman
*** FIRST TURN *** [5c 7s 5d] [2d]
*** FIRST RIVER *** [5c 7s 5d 2d] [Tc]
*** SECOND TURN *** [5c 7s 5d] [Ts]
*** SECOND RIVER *** [5c 7s 5d Ts] [3h]
*** FIRST SHOW DOWN ***
Jimy Tiltman: shows [6h 6d] (two pair, Sixes and Fives)
YuriiSolodya: shows [As Ah] (two pair, Aces and Fives)
YuriiSolodya collected $35.85 from pot
*** SECOND SHOW DOWN ***
Jimy Tiltman: shows [6h 6d] (two pair, Sixes and Fives)
YuriiSolodya: shows [As Ah] (two pair, Aces and Fives)
YuriiSolodya collected $35.85 from pot
*** SUMMARY ***
Total pot $74.50 | Rake $2.80 
Hand was run twice
FIRST Board [5c 7s 5d 2d Tc]
SECOND Board [5c 7s 5d Ts 3h]
Seat 1: Jimy Tiltman showed [6h 6d] and lost with two pair, Sixes and Fives, and lost with two pair, Sixes and Fives
Seat 4: YuriiSolodya showed [As Ah] and won ($35.85) with two pair, Aces and Fives, and won ($35.85) with two pair, Aces and Fives
Seat 5: DUkalisUA (button) folded before Flop (didn't bet)
Seat 6: Effort92 (small blind) folded before Flop
Seat 7: matiko09 (big blind) folded before Flop
Seat 8: titentei folded before Flop (didn't bet)
Seat 9: RICKA16 folded before Flop (didn't bet)





PokerStars Hand #150800665992:  Hold'em No Limit ($1/$2 USD) - 2016/03/23 14:10:45 CET [2016/03/23 9:10:45 ET]
Table 'Ennomos II' 9-max Seat #4 is the button
Seat 1: ilaviiitech ($200 in chips) 
Seat 2: Subam ($213.66 in chips) 
Seat 3: $-Twackle-$ ($200 in chips) 
Seat 4: glanza_mike ($202.32 in chips) 
Seat 5: South011 ($198.78 in chips) 
Seat 6: nickreason17 ($200 in chips) 
Seat 7: daniferdoser ($250.77 in chips) 
Seat 8: yyfk ($200 in chips) 
Seat 9: matiko09 ($200 in chips) 
South011: posts small blind $1
nickreason17: posts big blind $2
*** HOLE CARDS ***
Dealt to matiko09 [Th 3s]
daniferdoser: folds 
yyfk: raises $3 to $5
matiko09: folds 
ilaviiitech: folds 
Subam: folds 
$-Twackle-$: folds 
glanza_mike: folds 
South011: folds 
nickreason17: folds 
Uncalled bet ($3) returned to yyfk
yyfk collected $5 from pot
yyfk: doesn't show hand 
*** SUMMARY ***
Total pot $5 | Rake $0 
Seat 1: ilaviiitech folded before Flop (didn't bet)
Seat 2: Subam folded before Flop (didn't bet)
Seat 3: $-Twackle-$ folded before Flop (didn't bet)
Seat 4: glanza_mike (button) folded before Flop (didn't bet)
Seat 5: South011 (small blind) folded before Flop
Seat 6: nickreason17 (big blind) folded before Flop
Seat 7: daniferdoser folded before Flop (didn't bet)
Seat 8: yyfk collected ($5)
Seat 9: matiko09 folded before Flop (didn't bet)





PokerStars Hand #150800666603:  Hold'em No Limit ($1/$2 USD) - 2016/03/23 14:10:46 CET [2016/03/23 9:10:46 ET]
Table 'Herba II' 9-max Seat #7 is the button
Seat 1: matiko09 ($206.46 in chips) 
Seat 2: Moszes360 ($237.89 in chips) 
Seat 3: Cirilico ($160 in chips) 
Seat 4: DUkalisUA ($295.48 in chips) 
Seat 5: chippo boy ($233.53 in chips) 
Seat 6: Too-Anti-To ($200 in chips) 
Seat 7: InsomniaRU ($204.78 in chips) 
Seat 8: The_red_area ($446.98 in chips) 
Seat 9: mrhighryza ($63.43 in chips) 
The_red_area: posts small blind $1
mrhighryza: posts big blind $2
*** HOLE CARDS ***
Dealt to matiko09 [Th 3s]
matiko09: folds 
Moszes360: raises $4 to $6
Cirilico: folds 
DUkalisUA: folds 
chippo boy: folds 
Too-Anti-To: raises $12 to $18
InsomniaRU: folds 
The_red_area: folds 
mrhighryza: folds 
Moszes360: folds 
Uncalled bet ($12) returned to Too-Anti-To
Too-Anti-To collected $15 from pot
Too-Anti-To: doesn't show hand 
*** SUMMARY ***
Total pot $15 | Rake $0 
Seat 1: matiko09 folded before Flop (didn't bet)
Seat 2: Moszes360 folded before Flop
Seat 3: Cirilico folded before Flop (didn't bet)
Seat 4: DUkalisUA folded before Flop (didn't bet)
Seat 5: chippo boy folded before Flop (didn't bet)
Seat 6: Too-Anti-To collected ($15)
Seat 7: InsomniaRU (button) folded before Flop (didn't bet)
Seat 8: The_red_area (small blind) folded before Flop
Seat 9: mrhighryza (big blind) folded before Flop





PokerStars Hand #150800666869:  Hold'em No Limit ($1/$2 USD) - 2016/03/23 14:10:47 CET [2016/03/23 9:10:47 ET]
Table 'Kypria II' 9-max Seat #8 is the button
Seat 1: geldwolfje ($151.12 in chips) 
Seat 2: coinflip_si ($215 in chips) 
Seat 3: seouljam ($203.45 in chips) 
Seat 4: VolanDog ($200 in chips) 
Seat 5: InsomniaRU ($403.78 in chips) 
Seat 6: matiko09 ($359.95 in chips) 
Seat 7: DUkalisUA ($200 in chips) 
Seat 8: Cirilico ($160 in chips) 
Seat 9: Moszes360 ($200 in chips) 
Moszes360: posts small blind $1
geldwolfje: posts big blind $2
*** HOLE CARDS ***
Dealt to matiko09 [2d 6d]
coinflip_si: folds 
seouljam: folds 
VolanDog: raises $3 to $5
InsomniaRU: folds 
matiko09: folds 
DUkalisUA: folds 
Cirilico: folds 
Moszes360: folds 
geldwolfje: folds 
Uncalled bet ($3) returned to VolanDog
VolanDog collected $5 from pot
*** SUMMARY ***
Total pot $5 | Rake $0 
Seat 1: geldwolfje (big blind) folded before Flop
Seat 2: coinflip_si folded before Flop (didn't bet)
Seat 3: seouljam folded before Flop (didn't bet)
Seat 4: VolanDog collected ($5)
Seat 5: InsomniaRU folded before Flop (didn't bet)
Seat 6: matiko09 folded before Flop (didn't bet)
Seat 7: DUkalisUA folded before Flop (didn't bet)
Seat 8: Cirilico (button) folded before Flop (didn't bet)
Seat 9: Moszes360 (small blind) folded before Flop





PokerStars Hand #150800668298:  Hold'em No Limit ($0.25/$0.50 USD) - 2016/03/23 14:10:49 CET [2016/03/23 9:10:49 ET]
Table 'Belnika' 9-max Seat #8 is the button
Seat 1: yellowfever0 ($15.75 in chips) 
Seat 2: NeverRegret7 ($54.77 in chips) 
Seat 3: ChiChioChi ($77.63 in chips) 
Seat 4: matiko09 ($68.28 in chips) 
Seat 5: ZonTTT ($56.60 in chips) 
Seat 6: Ahangama ($50 in chips) 
Seat 7: CvMCvMCvM ($60.09 in chips) 
Seat 8: lumen21 ($63.47 in chips) 
Seat 9: dndngod ($58.41 in chips) 
dndngod: posts small blind $0.25
yellowfever0: posts big blind $0.50
*** HOLE CARDS ***
Dealt to matiko09 [Ah 7c]
NeverRegret7: folds 
ChiChioChi: raises $0.50 to $1
matiko09: folds 
ZonTTT: folds 
Ahangama: calls $1
CvMCvMCvM: calls $1
lumen21: calls $1
dndngod: folds 
yellowfever0: folds 
*** FLOP *** [Kc 8h 4d]
ChiChioChi: checks 
Ahangama: checks 
CvMCvMCvM: bets $2.63
lumen21: folds 
ChiChioChi: folds 
ChiChioChi leaves the table
Ahangama: folds 
Uncalled bet ($2.63) returned to CvMCvMCvM
edidaz joins the table at seat #3 
CvMCvMCvM collected $4.54 from pot
CvMCvMCvM: doesn't show hand 
*** SUMMARY ***
Total pot $4.75 | Rake $0.21 
Board [Kc 8h 4d]
Seat 1: yellowfever0 (big blind) folded before Flop
Seat 2: NeverRegret7 folded before Flop (didn't bet)
Seat 3: ChiChioChi folded on the Flop
Seat 4: matiko09 folded before Flop (didn't bet)
Seat 5: ZonTTT folded before Flop (didn't bet)
Seat 6: Ahangama folded on the Flop
Seat 7: CvMCvMCvM collected ($4.54)
Seat 8: lumen21 (button) folded on the Flop
Seat 9: dndngod (small blind) folded before Flop





PokerStars Hand #150800670716:  Hold'em No Limit ($0.50/$1.00 USD) - 2016/03/23 14:10:53 CET [2016/03/23 9:10:53 ET]
Table 'Atlantis' 9-max Seat #7 is the button
Seat 1: xHourglass ($145.77 in chips) 
Seat 2: tffff2006 ($57.34 in chips) 
Seat 3: CAJUN890 ($108.79 in chips) 
Seat 4: matiko09 ($131.25 in chips) 
Seat 5: Pvsx. ($115.13 in chips) 
Seat 6: Jimy Tiltman ($130.86 in chips) 
Seat 7: Sherlockplay ($100 in chips) 
Seat 8: DUkalisUA ($100 in chips) 
DUkalisUA: posts small blind $0.50
RICKA16: is sitting out 
xHourglass: posts big blind $1
*** HOLE CARDS ***
Dealt to matiko09 [7c 3s]
tffff2006: folds 
CAJUN890: folds 
matiko09: folds 
Pvsx.: folds 
Jimy Tiltman: folds 
Sherlockplay: folds 
DUkalisUA: raises $1.50 to $2.50
xHourglass: folds 
Uncalled bet ($1.50) returned to DUkalisUA
DUkalisUA collected $2 from pot
DUkalisUA: doesn't show hand 
*** SUMMARY ***
Total pot $2 | Rake $0 
Seat 1: xHourglass (big blind) folded before Flop
Seat 2: tffff2006 folded before Flop (didn't bet)
Seat 3: CAJUN890 folded before Flop (didn't bet)
Seat 4: matiko09 folded before Flop (didn't bet)
Seat 5: Pvsx. folded before Flop (didn't bet)
Seat 6: Jimy Tiltman folded before Flop (didn't bet)
Seat 7: Sherlockplay (button) folded before Flop (didn't bet)
Seat 8: DUkalisUA (small blind) collected ($2)





PokerStars Hand #150800675812:  Hold'em No Limit ($0.50/$1.00 USD) - 2016/03/23 14:11:02 CET [2016/03/23 9:11:02 ET]
Table 'Donar II' 9-max Seat #8 is the button
Seat 1: Effort92 ($100 in chips) 
Seat 3: st-germ30 ($103.34 in chips) 
Seat 4: DUkalisUA ($131.67 in chips) 
Seat 5: matiko09 ($102.84 in chips) 
Seat 6: ardo888 ($130.20 in chips) 
Seat 8: $-Twackle-$ ($100 in chips) 
Seat 9: oxfordtenzin ($130.69 in chips) 
oxfordtenzin: posts small blind $0.50
Effort92: posts big blind $1
JimineyCrik: sits out 
Effort92: posts the ante $0.20
st-germ30: posts the ante $0.20
DUkalisUA: posts the ante $0.20
matiko09: posts the ante $0.20
ardo888: posts the ante $0.20
$-Twackle-$: posts the ante $0.20
oxfordtenzin: posts the ante $0.20
*** HOLE CARDS ***
Dealt to matiko09 [4s 4h]
st-germ30: folds 
DUkalisUA: raises $2 to $3
matiko09: folds 
ardo888: folds 
$-Twackle-$: folds 
oxfordtenzin: raises $5 to $8
Effort92: folds 
DUkalisUA: calls $5
*** FLOP *** [6d Qd Ah]
oxfordtenzin: checks 
DUkalisUA: bets $11.59
oxfordtenzin: calls $11.59
*** TURN *** [6d Qd Ah] [3d]
oxfordtenzin: checks 
DUkalisUA: bets $33
oxfordtenzin: folds 
Uncalled bet ($33) returned to DUkalisUA
DUkalisUA collected $39.71 from pot
DUkalisUA: doesn't show hand 
*** SUMMARY ***
Total pot $41.58 | Rake $1.87 
Board [6d Qd Ah 3d]
Seat 1: Effort92 (big blind) folded before Flop
Seat 3: st-germ30 folded before Flop (didn't bet)
Seat 4: DUkalisUA collected ($39.71)
Seat 5: matiko09 folded before Flop (didn't bet)
Seat 6: ardo888 folded before Flop (didn't bet)
Seat 8: $-Twackle-$ (button) folded before Flop (didn't bet)
Seat 9: oxfordtenzin (small blind) folded on the Turn





PokerStars Hand #150800677054:  Hold'em No Limit ($1/$2 USD) - 2016/03/23 14:11:04 CET [2016/03/23 9:11:04 ET]
Table 'Achaia' 9-max Seat #5 is the button
Seat 1: ilaviiitech ($200 in chips) 
Seat 2: InsomniaRU ($226.66 in chips) 
Seat 3: matiko09 ($200 in chips) 
Seat 4: nailz83 ($209.46 in chips) 
Seat 5: DUkalisUA ($200 in chips) 
Seat 6: nickreason17 ($214.06 in chips) 
Seat 7: morosun ($188.09 in chips) 
Seat 8: $-Twackle-$ ($200 in chips) 
Seat 9: glanza_mike ($208.28 in chips) 
nickreason17: posts small blind $1
morosun: posts big blind $2
*** HOLE CARDS ***
Dealt to matiko09 [Js 3h]
$-Twackle-$: folds 
glanza_mike: folds 
ilaviiitech: folds 
InsomniaRU: folds 
matiko09: folds 
nailz83: folds 
DUkalisUA: raises $3 to $5
nickreason17: folds 
morosun: folds 
Uncalled bet ($3) returned to DUkalisUA
DUkalisUA collected $5 from pot
DUkalisUA: doesn't show hand 
*** SUMMARY ***
Total pot $5 | Rake $0 
Seat 1: ilaviiitech folded before Flop (didn't bet)
Seat 2: InsomniaRU folded before Flop (didn't bet)
Seat 3: matiko09 folded before Flop (didn't bet)
Seat 4: nailz83 folded before Flop (didn't bet)
Seat 5: DUkalisUA (button) collected ($5)
Seat 6: nickreason17 (small blind) folded before Flop
Seat 7: morosun (big blind) folded before Flop
Seat 8: $-Twackle-$ folded before Flop (didn't bet)
Seat 9: glanza_mike folded before Flop (didn't bet)





PokerStars Hand #150800680844:  Hold'em No Limit ($0.50/$1.00 USD) - 2016/03/23 14:11:10 CET [2016/03/23 9:11:10 ET]
Table 'Smiley' 9-max Seat #3 is the button
Seat 1: xHourglass ($107.65 in chips) 
Seat 2: Jimy Tiltman ($135.20 in chips) 
Seat 3: matiko09 ($100 in chips) 
Seat 4: CAJUN890 ($94 in chips) 
Seat 8: Sherlockplay ($107.39 in chips) 
Seat 9: Pvsx. ($145.10 in chips) 
CAJUN890: posts small blind $0.50
DUkalisUA: is sitting out 
Moszes360: is sitting out 
DUkalisUA leaves the table
Sherlockplay: posts big blind $1
*** HOLE CARDS ***
Dealt to matiko09 [6h 8d]
Szevasztopol joins the table at seat #5 
Pvsx.: folds 
Moszes360 leaves the table
BKA12 joins the table at seat #7 
BKA12 leaves the table
xHourglass: raises $2 to $3
Jimy Tiltman: folds 
matiko09: folds 
$-Twackle-$ joins the table at seat #7 
CAJUN890: folds 
Sherlockplay: folds 
Uncalled bet ($2) returned to xHourglass
xHourglass collected $2.50 from pot
xHourglass: doesn't show hand 
*** SUMMARY ***
Total pot $2.50 | Rake $0 
Seat 1: xHourglass collected ($2.50)
Seat 2: Jimy Tiltman folded before Flop (didn't bet)
Seat 3: matiko09 (button) folded before Flop (didn't bet)
Seat 4: CAJUN890 (small blind) folded before Flop
Seat 8: Sherlockplay (big blind) folded before Flop
Seat 9: Pvsx. folded before Flop (didn't bet)





PokerStars Hand #150800685530:  Hold'em No Limit ($1/$2 USD) - 2016/03/23 14:11:18 CET [2016/03/23 9:11:18 ET]
Table 'Ennomos II' 9-max Seat #5 is the button
Seat 1: ilaviiitech ($200 in chips) 
Seat 2: Subam ($213.66 in chips) 
Seat 3: $-Twackle-$ ($200 in chips) 
Seat 4: glanza_mike ($202.32 in chips) 
Seat 5: South011 ($197.78 in chips) 
Seat 6: nickreason17 ($200 in chips) 
Seat 7: daniferdoser ($250.77 in chips) 
Seat 8: yyfk ($203 in chips) 
Seat 9: matiko09 ($200 in chips) 
nickreason17: posts small blind $1
daniferdoser: posts big blind $2
*** HOLE CARDS ***
Dealt to matiko09 [8h 7h]
yyfk: folds 
matiko09: folds 
ilaviiitech: folds 
Subam: folds 
$-Twackle-$: folds 
glanza_mike: folds 
South011: raises $2 to $4
nickreason17: folds 
daniferdoser: calls $2
*** FLOP *** [4s 9d 2d]
daniferdoser: checks 
South011: bets $6
daniferdoser: calls $6
*** TURN *** [4s 9d 2d] [Qh]
daniferdoser: checks 
South011: bets $10
daniferdoser: folds 
Uncalled bet ($10) returned to South011
South011 collected $20.06 from pot
South011: doesn't show hand 
*** SUMMARY ***
Total pot $21 | Rake $0.94 
Board [4s 9d 2d Qh]
Seat 1: ilaviiitech folded before Flop (didn't bet)
Seat 2: Subam folded before Flop (didn't bet)
Seat 3: $-Twackle-$ folded before Flop (didn't bet)
Seat 4: glanza_mike folded before Flop (didn't bet)
Seat 5: South011 (button) collected ($20.06)
Seat 6: nickreason17 (small blind) folded before Flop
Seat 7: daniferdoser (big blind) folded on the Turn
Seat 8: yyfk folded before Flop (didn't bet)
Seat 9: matiko09 folded before Flop (didn't bet)





PokerStars Hand #150800688999:  Hold'em No Limit ($1/$2 USD) - 2016/03/23 14:11:24 CET [2016/03/23 9:11:24 ET]
Table 'Kypria II' 9-max Seat #9 is the button
Seat 1: geldwolfje ($149.12 in chips) 
Seat 2: coinflip_si ($215 in chips) 
Seat 3: seouljam ($203.45 in chips) 
Seat 4: VolanDog ($203 in chips) 
Seat 5: InsomniaRU ($403.78 in chips) 
Seat 6: matiko09 ($359.95 in chips) 
Seat 7: DUkalisUA ($200 in chips) 
Seat 8: Cirilico ($160 in chips) 
Seat 9: Moszes360 ($200 in chips) 
geldwolfje: posts small blind $1
coinflip_si: posts big blind $2
*** HOLE CARDS ***
Dealt to matiko09 [Qh 5d]
seouljam: folds 
VolanDog: folds 
InsomniaRU: folds 
matiko09: folds 
DUkalisUA: raises $4 to $6
Cirilico: folds 
Moszes360: folds 
geldwolfje: calls $5
coinflip_si: folds 
*** FLOP *** [Jh Qs Kh]
geldwolfje: checks 
DUkalisUA: checks 
*** TURN *** [Jh Qs Kh] [2c]
geldwolfje: checks 
DUkalisUA: checks 
*** RIVER *** [Jh Qs Kh 2c] [Th]
geldwolfje: checks 
DUkalisUA: checks 
*** SHOW DOWN ***
geldwolfje: shows [4s 4d] (a pair of Fours)
DUkalisUA: shows [7d 7h] (a pair of Sevens)
DUkalisUA collected $13.37 from pot
*** SUMMARY ***
Total pot $14 | Rake $0.63 
Board [Jh Qs Kh 2c Th]
Seat 1: geldwolfje (small blind) showed [4s 4d] and lost with a pair of Fours
Seat 2: coinflip_si (big blind) folded before Flop
Seat 3: seouljam folded before Flop (didn't bet)
Seat 4: VolanDog folded before Flop (didn't bet)
Seat 5: InsomniaRU folded before Flop (didn't bet)
Seat 6: matiko09 folded before Flop (didn't bet)
Seat 7: DUkalisUA showed [7d 7h] and won ($13.37) with a pair of Sevens
Seat 8: Cirilico folded before Flop (didn't bet)
Seat 9: Moszes360 (button) folded before Flop (didn't bet)





PokerStars Hand #150800695116:  Hold'em No Limit ($0.50/$1.00 USD) - 2016/03/23 14:11:34 CET [2016/03/23 9:11:34 ET]
Table 'Merope II' 9-max Seat #6 is the button
Seat 1: Jimy Tiltman ($100 in chips) 
Seat 4: YuriiSolodya ($71.70 in chips) 
Seat 5: DUkalisUA ($145.14 in chips) 
Seat 6: Effort92 ($100 in chips) 
Seat 7: matiko09 ($111.23 in chips) 
Seat 8: titentei ($95 in chips) 
Seat 9: RICKA16 ($100 in chips) 
matiko09: posts small blind $0.50
titentei: posts big blind $1
$-Twackle-$: sits out 
pablos1922: sits out 
*** HOLE CARDS ***
Dealt to matiko09 [4h Qd]
RICKA16: raises $2 to $3
Jimy Tiltman: raises $6.44 to $9.44
YuriiSolodya: calls $9.44
DUkalisUA: folds 
Effort92: folds 
matiko09: folds 
titentei: folds 
RICKA16: folds 
*** FLOP *** [5c Qs 9c]
Jimy Tiltman: checks 
YuriiSolodya: bets $11.16
Jimy Tiltman: folds 
Uncalled bet ($11.16) returned to YuriiSolodya
YuriiSolodya collected $22.33 from pot
YuriiSolodya: doesn't show hand 
*** SUMMARY ***
Total pot $23.38 | Rake $1.05 
Board [5c Qs 9c]
Seat 1: Jimy Tiltman folded on the Flop
Seat 4: YuriiSolodya collected ($22.33)
Seat 5: DUkalisUA folded before Flop (didn't bet)
Seat 6: Effort92 (button) folded before Flop (didn't bet)
Seat 7: matiko09 (small blind) folded before Flop
Seat 8: titentei (big blind) folded before Flop
Seat 9: RICKA16 folded before Flop





PokerStars Hand #150800697373:  Hold'em No Limit ($0.50/$1.00 USD) - 2016/03/23 14:11:38 CET [2016/03/23 9:11:38 ET]
Table 'Atlantis' 9-max Seat #8 is the button
Seat 1: xHourglass ($144.77 in chips) 
Seat 2: tffff2006 ($57.34 in chips) 
Seat 3: CAJUN890 ($108.79 in chips) 
Seat 4: matiko09 ($131.25 in chips) 
Seat 5: Pvsx. ($115.13 in chips) 
Seat 6: Jimy Tiltman ($130.86 in chips) 
Seat 7: Sherlockplay ($100 in chips) 
Seat 8: DUkalisUA ($101 in chips) 
xHourglass: posts small blind $0.50
tffff2006: posts big blind $1
*** HOLE CARDS ***
Dealt to matiko09 [3d 5s]
CAJUN890: folds 
matiko09: folds 
Pvsx. has timed out
Pvsx.: folds 
Jimy Tiltman: raises $2 to $3
Sherlockplay: raises $6 to $9
DUkalisUA: folds 
xHourglass: folds 
tffff2006: folds 
Jimy Tiltman: raises $12 to $21
Sherlockplay: folds 
Uncalled bet ($12) returned to Jimy Tiltman
Jimy Tiltman collected $19.50 from pot
Jimy Tiltman: doesn't show hand 
*** SUMMARY ***
Total pot $19.50 | Rake $0 
Seat 1: xHourglass (small blind) folded before Flop
Seat 2: tffff2006 (big blind) folded before Flop
Seat 3: CAJUN890 folded before Flop (didn't bet)
Seat 4: matiko09 folded before Flop (didn't bet)
Seat 5: Pvsx. folded before Flop (didn't bet)
Seat 6: Jimy Tiltman collected ($19.50)
Seat 7: Sherlockplay folded before Flop
Seat 8: DUkalisUA (button) folded before Flop (didn't bet)





PokerStars Hand #150800698825:  Hold'em No Limit ($0.50/$1.00 USD) - 2016/03/23 14:11:40 CET [2016/03/23 9:11:40 ET]
Table 'Kippes' 9-max Seat #4 is the button
Seat 1: Pvsx. ($107.31 in chips) 
Seat 2: RICKA16 ($189.45 in chips) 
Seat 3: CAJUN890 ($123.02 in chips) 
Seat 4: matiko09 ($100 in chips) 
Seat 5: Jimy Tiltman ($113.86 in chips) 
Seat 6: DUkalisUA ($110.76 in chips) 
Seat 7: lumen21 ($112.02 in chips) 
Seat 9: wang19790906 ($87.99 in chips) 
Jimy Tiltman: posts small blind $0.50
DUkalisUA: posts big blind $1
Sherlockplay: sits out 
*** HOLE CARDS ***
Dealt to matiko09 [2h 7h]
lumen21: folds 
wang19790906: calls $1
Pvsx.: folds 
RICKA16: folds 
CAJUN890: folds 
matiko09: folds 
Jimy Tiltman: calls $0.50
DUkalisUA: raises $3 to $4
wang19790906: calls $3
Jimy Tiltman: folds 
*** FLOP *** [Ad Jc 9c]
DUkalisUA: bets $6.45
wang19790906: folds 
Uncalled bet ($6.45) returned to DUkalisUA
DUkalisUA collected $8.60 from pot
DUkalisUA: doesn't show hand 
*** SUMMARY ***
Total pot $9 | Rake $0.40 
Board [Ad Jc 9c]
Seat 1: Pvsx. folded before Flop (didn't bet)
Seat 2: RICKA16 folded before Flop (didn't bet)
Seat 3: CAJUN890 folded before Flop (didn't bet)
Seat 4: matiko09 (button) folded before Flop (didn't bet)
Seat 5: Jimy Tiltman (small blind) folded before Flop
Seat 6: DUkalisUA (big blind) collected ($8.60)
Seat 7: lumen21 folded before Flop (didn't bet)
Seat 9: wang19790906 folded on the Flop





PokerStars Hand #150800698815:  Hold'em No Limit ($1/$2 USD) - 2016/03/23 14:11:40 CET [2016/03/23 9:11:40 ET]
Table 'Achaia' 9-max Seat #6 is the button
Seat 1: ilaviiitech ($200 in chips) 
Seat 2: InsomniaRU ($226.66 in chips) 
Seat 3: matiko09 ($200 in chips) 
Seat 4: nailz83 ($209.46 in chips) 
Seat 5: DUkalisUA ($203 in chips) 
Seat 6: nickreason17 ($213.06 in chips) 
Seat 7: morosun ($186.09 in chips) 
Seat 8: $-Twackle-$ ($200 in chips) 
Seat 9: glanza_mike ($208.28 in chips) 
morosun: posts small blind $1
$-Twackle-$: posts big blind $2
*** HOLE CARDS ***
Dealt to matiko09 [Kc 5d]
glanza_mike: raises $4 to $6
ilaviiitech: folds 
InsomniaRU: folds 
matiko09: folds 
nailz83: folds 
DUkalisUA: folds 
nickreason17: folds 
morosun: folds 
$-Twackle-$: folds 
Uncalled bet ($4) returned to glanza_mike
glanza_mike collected $5 from pot
glanza_mike: doesn't show hand 
*** SUMMARY ***
Total pot $5 | Rake $0 
Seat 1: ilaviiitech folded before Flop (didn't bet)
Seat 2: InsomniaRU folded before Flop (didn't bet)
Seat 3: matiko09 folded before Flop (didn't bet)
Seat 4: nailz83 folded before Flop (didn't bet)
Seat 5: DUkalisUA folded before Flop (didn't bet)
Seat 6: nickreason17 (button) folded before Flop (didn't bet)
Seat 7: morosun (small blind) folded before Flop
Seat 8: $-Twackle-$ (big blind) folded before Flop
Seat 9: glanza_mike collected ($5)





PokerStars Hand #150800699395:  Hold'em No Limit ($1/$2 USD) - 2016/03/23 14:11:41 CET [2016/03/23 9:11:41 ET]
Table 'Herba II' 9-max Seat #8 is the button
Seat 1: matiko09 ($206.46 in chips) 
Seat 2: Moszes360 ($231.89 in chips) 
Seat 3: Cirilico ($160 in chips) 
Seat 4: DUkalisUA ($295.48 in chips) 
Seat 5: chippo boy ($233.53 in chips) 
Seat 6: Too-Anti-To ($209 in chips) 
Seat 7: InsomniaRU ($204.78 in chips) 
Seat 8: The_red_area ($445.98 in chips) 
Seat 9: mrhighryza ($61.43 in chips) 
mrhighryza: posts small blind $1
matiko09: posts big blind $2
*** HOLE CARDS ***
Dealt to matiko09 [4d 9s]
Moszes360: folds 
Cirilico: folds 
DUkalisUA has timed out
DUkalisUA: folds 
chippo boy: folds 
Too-Anti-To: raises $3 to $5
InsomniaRU: folds 
The_red_area: folds 
mrhighryza: calls $4
matiko09: folds 
*** FLOP *** [5s 6h Js]
mrhighryza: checks 
Too-Anti-To: bets $6.87
mrhighryza: folds 
Uncalled bet ($6.87) returned to Too-Anti-To
Too-Anti-To collected $11.46 from pot
Too-Anti-To: doesn't show hand 
*** SUMMARY ***
Total pot $12 | Rake $0.54 
Board [5s 6h Js]
Seat 1: matiko09 (big blind) folded before Flop
Seat 2: Moszes360 folded before Flop (didn't bet)
Seat 3: Cirilico folded before Flop (didn't bet)
Seat 4: DUkalisUA folded before Flop (didn't bet)
Seat 5: chippo boy folded before Flop (didn't bet)
Seat 6: Too-Anti-To collected ($11.46)
Seat 7: InsomniaRU folded before Flop (didn't bet)
Seat 8: The_red_area (button) folded before Flop (didn't bet)
Seat 9: mrhighryza (small blind) folded on the Flop





PokerStars Hand #150800703193:  Hold'em No Limit ($1/$2 USD) - 2016/03/23 14:11:47 CET [2016/03/23 9:11:47 ET]
Table 'Ennomos II' 9-max Seat #6 is the button
Seat 1: ilaviiitech ($200 in chips) 
Seat 2: Subam ($213.66 in chips) 
Seat 3: $-Twackle-$ ($200 in chips) 
Seat 4: glanza_mike ($202.32 in chips) 
Seat 5: South011 ($207.84 in chips) 
Seat 6: nickreason17 ($200 in chips) 
Seat 7: daniferdoser ($240.77 in chips) 
Seat 8: yyfk ($203 in chips) 
Seat 9: matiko09 ($200 in chips) 
daniferdoser: posts small blind $1
yyfk: posts big blind $2
*** HOLE CARDS ***
Dealt to matiko09 [4s 3s]
matiko09: folds 
ilaviiitech: folds 
Subam has timed out
Subam: folds 
$-Twackle-$: folds 
glanza_mike: folds 
South011: raises $4 to $6
nickreason17: calls $6
daniferdoser: calls $5
yyfk: calls $4
*** FLOP *** [Ts 7s Ks]
daniferdoser: checks 
yyfk: checks 
South011: bets $12
nickreason17: calls $12
daniferdoser: folds 
yyfk: folds 
*** TURN *** [Ts 7s Ks] [Qh]
South011: checks 
nickreason17: bets $35
South011: folds 
Uncalled bet ($35) returned to nickreason17
nickreason17 collected $45.84 from pot
*** SUMMARY ***
Total pot $48 | Rake $2.16 
Board [Ts 7s Ks Qh]
Seat 1: ilaviiitech folded before Flop (didn't bet)
Seat 2: Subam folded before Flop (didn't bet)
Seat 3: $-Twackle-$ folded before Flop (didn't bet)
Seat 4: glanza_mike folded before Flop (didn't bet)
Seat 5: South011 folded on the Turn
Seat 6: nickreason17 (button) collected ($45.84)
Seat 7: daniferdoser (small blind) folded on the Flop
Seat 8: yyfk (big blind) folded on the Flop
Seat 9: matiko09 folded before Flop (didn't bet)





PokerStars Hand #150800703290:  Hold'em No Limit ($0.50/$1.00 USD) - 2016/03/23 14:11:47 CET [2016/03/23 9:11:47 ET]
Table 'Smiley' 9-max Seat #4 is the button
Seat 1: xHourglass ($109.15 in chips) 
Seat 2: Jimy Tiltman ($135.20 in chips) 
Seat 3: matiko09 ($100 in chips) 
Seat 4: CAJUN890 ($93.50 in chips) 
Seat 8: Sherlockplay ($106.39 in chips) 
Seat 9: Pvsx. ($145.10 in chips) 
Szevasztopol will be allowed to play after the button
blackmont111 will be allowed to play after the button
$-Twackle-$ will be allowed to play after the button
Sherlockplay: posts small blind $0.50
Pvsx.: posts big blind $1
*** HOLE CARDS ***
Dealt to matiko09 [Qc 5h]
xHourglass: folds 
Jimy Tiltman: folds 
matiko09: folds 
CAJUN890: folds 
Sherlockplay: folds 
Uncalled bet ($0.50) returned to Pvsx.
Pvsx. collected $1 from pot
Pvsx.: doesn't show hand 
*** SUMMARY ***
Total pot $1 | Rake $0 
Seat 1: xHourglass folded before Flop (didn't bet)
Seat 2: Jimy Tiltman folded before Flop (didn't bet)
Seat 3: matiko09 folded before Flop (didn't bet)
Seat 4: CAJUN890 (button) folded before Flop (didn't bet)
Seat 8: Sherlockplay (small blind) folded before Flop
Seat 9: Pvsx. (big blind) collected ($1)





PokerStars Hand #150800704475:  Hold'em No Limit ($0.25/$0.50 USD) - 2016/03/23 14:11:49 CET [2016/03/23 9:11:49 ET]
Table 'Belnika' 9-max Seat #9 is the button
Seat 1: yellowfever0 ($15.25 in chips) 
Seat 2: NeverRegret7 ($54.77 in chips) 
Seat 4: matiko09 ($68.28 in chips) 
Seat 5: ZonTTT ($56.60 in chips) 
Seat 6: Ahangama ($50 in chips) 
Seat 7: CvMCvMCvM ($63.63 in chips) 
Seat 8: lumen21 ($62.47 in chips) 
Seat 9: dndngod ($58.16 in chips) 
yellowfever0: posts small blind $0.25
NeverRegret7: posts big blind $0.50
*** HOLE CARDS ***
Dealt to matiko09 [Qd 4c]
matiko09: folds 
ZonTTT: folds 
Ahangama: folds 
CvMCvMCvM: folds 
lumen21: folds 
dndngod: folds 
yellowfever0: calls $0.25
NeverRegret7: checks 
*** FLOP *** [5h 7s 2d]
edidaz leaves the table
yellowfever0: bets $0.96
NeverRegret7: calls $0.96
*** TURN *** [5h 7s 2d] [4h]
RyMorgy joins the table at seat #3 
yellowfever0: bets $2.79
NeverRegret7: calls $2.79
*** RIVER *** [5h 7s 2d 4h] [Td]
yellowfever0: bets $8.12
NeverRegret7: folds 
Uncalled bet ($8.12) returned to yellowfever0
yellowfever0 collected $8.12 from pot
yellowfever0: doesn't show hand 
*** SUMMARY ***
Total pot $8.50 | Rake $0.38 
Board [5h 7s 2d 4h Td]
Seat 1: yellowfever0 (small blind) collected ($8.12)
Seat 2: NeverRegret7 (big blind) folded on the River
Seat 4: matiko09 folded before Flop (didn't bet)
Seat 5: ZonTTT folded before Flop (didn't bet)
Seat 6: Ahangama folded before Flop (didn't bet)
Seat 7: CvMCvMCvM folded before Flop (didn't bet)
Seat 8: lumen21 folded before Flop (didn't bet)
Seat 9: dndngod (button) folded before Flop (didn't bet)





PokerStars Hand #150800705166:  Hold'em No Limit ($0.25/$0.50 USD) - 2016/03/23 14:11:51 CET [2016/03/23 9:11:51 ET]
Table 'Pyrrhus' 9-max Seat #1 is the button
Seat 1: lumen21 ($77.59 in chips) 
Seat 2: alemão007 ($39.44 in chips) 
Seat 3: i L00K great ($50 in chips) 
Seat 4: GriffinBerg ($30.33 in chips) 
Seat 5: ZonTTT ($50 in chips) 
Seat 6: Ahangama ($50.75 in chips) 
Seat 7: matiko09 ($135.94 in chips) 
Seat 8: dndngod ($83.02 in chips) 
Seat 9: CvMCvMCvM ($96.61 in chips) 
alemão007: posts small blind $0.25
i L00K great: posts big blind $0.50
*** HOLE CARDS ***
Dealt to matiko09 [Ts Kd]
GriffinBerg: raises $1 to $1.50
ZonTTT: folds 
Ahangama: folds 
matiko09: folds 
dndngod: folds 
CvMCvMCvM: folds 
lumen21: folds 
alemão007: folds 
i L00K great: folds 
Uncalled bet ($1) returned to GriffinBerg
GriffinBerg collected $1.25 from pot
*** SUMMARY ***
Total pot $1.25 | Rake $0 
Seat 1: lumen21 (button) folded before Flop (didn't bet)
Seat 2: alemão007 (small blind) folded before Flop
Seat 3: i L00K great (big blind) folded before Flop
Seat 4: GriffinBerg collected ($1.25)
Seat 5: ZonTTT folded before Flop (didn't bet)
Seat 6: Ahangama folded before Flop (didn't bet)
Seat 7: matiko09 folded before Flop (didn't bet)
Seat 8: dndngod folded before Flop (didn't bet)
Seat 9: CvMCvMCvM folded before Flop (didn't bet)





PokerStars Hand #150800715525:  Hold'em No Limit ($0.50/$1.00 USD) - 2016/03/23 14:12:08 CET [2016/03/23 9:12:08 ET]
Table 'Smiley' 9-max Seat #8 is the button
Seat 1: xHourglass ($109.15 in chips) 
Seat 2: Jimy Tiltman ($135.20 in chips) 
Seat 3: matiko09 ($100 in chips) 
Seat 4: CAJUN890 ($93.50 in chips) 
Seat 6: blackmont111 ($110.30 in chips) 
Seat 8: Sherlockplay ($105.89 in chips) 
Seat 9: Pvsx. ($145.60 in chips) 
Pvsx.: posts small blind $0.50
xHourglass: posts big blind $1
Szevasztopol: sits out 
blackmont111: posts small & big blinds $1.50
$-Twackle-$: sits out 
*** HOLE CARDS ***
Dealt to matiko09 [9h 5c]
Jimy Tiltman: folds 
matiko09: folds 
CAJUN890: calls $1
blackmont111: checks 
Sherlockplay: folds 
Pvsx.: folds 
xHourglass: checks 
*** FLOP *** [5h Kh Qd]
xHourglass: checks 
CAJUN890: bets $3
blackmont111: folds 
xHourglass: folds 
Uncalled bet ($3) returned to CAJUN890
CAJUN890 collected $3.82 from pot
CAJUN890: doesn't show hand 
*** SUMMARY ***
Total pot $4 | Rake $0.18 
Board [5h Kh Qd]
Seat 1: xHourglass (big blind) folded on the Flop
Seat 2: Jimy Tiltman folded before Flop (didn't bet)
Seat 3: matiko09 folded before Flop (didn't bet)
Seat 4: CAJUN890 collected ($3.82)
Seat 6: blackmont111 folded on the Flop
Seat 8: Sherlockplay (button) folded before Flop (didn't bet)
Seat 9: Pvsx. (small blind) folded before Flop





PokerStars Hand #150800722722:  Hold'em No Limit ($0.25/$0.50 USD) - 2016/03/23 14:12:20 CET [2016/03/23 9:12:20 ET]
Table 'Pyrrhus' 9-max Seat #2 is the button
Seat 1: lumen21 ($77.59 in chips) 
Seat 2: alemão007 ($50 in chips) 
Seat 3: i L00K great ($50 in chips) 
Seat 4: GriffinBerg ($31.08 in chips) 
Seat 5: ZonTTT ($50 in chips) 
Seat 6: Ahangama ($50.75 in chips) 
Seat 7: matiko09 ($135.94 in chips) 
Seat 8: dndngod ($83.02 in chips) 
Seat 9: CvMCvMCvM ($96.61 in chips) 
i L00K great: posts small blind $0.25
GriffinBerg: posts big blind $0.50
*** HOLE CARDS ***
Dealt to matiko09 [9s 5h]
ZonTTT: folds 
Ahangama: folds 
matiko09: folds 
dndngod: folds 
CvMCvMCvM: folds 
lumen21: raises $0.75 to $1.25
alemão007: calls $1.25
i L00K great: folds 
GriffinBerg: calls $0.75
*** FLOP *** [2d 6c 3h]
GriffinBerg: checks 
lumen21: bets $2.94
alemão007: folds 
GriffinBerg: folds 
Uncalled bet ($2.94) returned to lumen21
lumen21 collected $3.82 from pot
lumen21: doesn't show hand 
*** SUMMARY ***
Total pot $4 | Rake $0.18 
Board [2d 6c 3h]
Seat 1: lumen21 collected ($3.82)
Seat 2: alemão007 (button) folded on the Flop
Seat 3: i L00K great (small blind) folded before Flop
Seat 4: GriffinBerg (big blind) folded on the Flop
Seat 5: ZonTTT folded before Flop (didn't bet)
Seat 6: Ahangama folded before Flop (didn't bet)
Seat 7: matiko09 folded before Flop (didn't bet)
Seat 8: dndngod folded before Flop (didn't bet)
Seat 9: CvMCvMCvM folded before Flop (didn't bet)





PokerStars Hand #150800723683:  Hold'em No Limit ($1/$2 USD) - 2016/03/23 14:12:21 CET [2016/03/23 9:12:21 ET]
Table 'Achaia' 9-max Seat #7 is the button
Seat 1: ilaviiitech ($200 in chips) 
Seat 2: InsomniaRU ($226.66 in chips) 
Seat 3: matiko09 ($200 in chips) 
Seat 4: nailz83 ($209.46 in chips) 
Seat 5: DUkalisUA ($203 in chips) 
Seat 6: nickreason17 ($213.06 in chips) 
Seat 7: morosun ($185.09 in chips) 
Seat 8: $-Twackle-$ ($200 in chips) 
Seat 9: glanza_mike ($211.28 in chips) 
$-Twackle-$: posts small blind $1
glanza_mike: posts big blind $2
*** HOLE CARDS ***
Dealt to matiko09 [Td Jd]
ilaviiitech: raises $4 to $6
InsomniaRU: folds 
matiko09: calls $6
nailz83: folds 
DUkalisUA: folds 
nickreason17: folds 
morosun: calls $6
$-Twackle-$: calls $5
glanza_mike: calls $4
*** FLOP *** [Ah Jh Qc]
$-Twackle-$: checks 
glanza_mike: checks 
ilaviiitech: checks 
matiko09: checks 
morosun: checks 
*** TURN *** [Ah Jh Qc] [Tc]
$-Twackle-$: bets $20
glanza_mike: folds 
ilaviiitech: folds 
matiko09: folds 
morosun: folds 
Uncalled bet ($20) returned to $-Twackle-$
$-Twackle-$ collected $28.65 from pot
$-Twackle-$: doesn't show hand 
*** SUMMARY ***
Total pot $30 | Rake $1.35 
Board [Ah Jh Qc Tc]
Seat 1: ilaviiitech folded on the Turn
Seat 2: InsomniaRU folded before Flop (didn't bet)
Seat 3: matiko09 folded on the Turn
Seat 4: nailz83 folded before Flop (didn't bet)
Seat 5: DUkalisUA folded before Flop (didn't bet)
Seat 6: nickreason17 folded before Flop (didn't bet)
Seat 7: morosun (button) folded on the Turn
Seat 8: $-Twackle-$ (small blind) collected ($28.65)
Seat 9: glanza_mike (big blind) folded on the Turn





PokerStars Hand #150800729277:  Hold'em No Limit ($1/$2 USD) - 2016/03/23 14:12:31 CET [2016/03/23 9:12:31 ET]
Table 'Kypria II' 9-max Seat #1 is the button
Seat 1: geldwolfje ($143.12 in chips) 
Seat 2: coinflip_si ($213 in chips) 
Seat 3: seouljam ($203.45 in chips) 
Seat 4: VolanDog ($203 in chips) 
Seat 5: InsomniaRU ($403.78 in chips) 
Seat 6: matiko09 ($359.95 in chips) 
Seat 7: DUkalisUA ($207.37 in chips) 
Seat 8: Cirilico ($160 in chips) 
Seat 9: Moszes360 ($200 in chips) 
coinflip_si: posts small blind $1
seouljam: posts big blind $2
*** HOLE CARDS ***
Dealt to matiko09 [8d Tc]
VolanDog: folds 
InsomniaRU: folds 
matiko09: folds 
DUkalisUA: folds 
Cirilico: folds 
Moszes360: folds 
geldwolfje: folds 
coinflip_si: raises $3 to $5
seouljam: raises $9 to $14
coinflip_si: folds 
Uncalled bet ($9) returned to seouljam
seouljam collected $10 from pot
seouljam: doesn't show hand 
*** SUMMARY ***
Total pot $10 | Rake $0 
Seat 1: geldwolfje (button) folded before Flop (didn't bet)
Seat 2: coinflip_si (small blind) folded before Flop
Seat 3: seouljam (big blind) collected ($10)
Seat 4: VolanDog folded before Flop (didn't bet)
Seat 5: InsomniaRU folded before Flop (didn't bet)
Seat 6: matiko09 folded before Flop (didn't bet)
Seat 7: DUkalisUA folded before Flop (didn't bet)
Seat 8: Cirilico folded before Flop (didn't bet)
Seat 9: Moszes360 folded before Flop (didn't bet)





PokerStars Hand #150800732190:  Hold'em No Limit ($1/$2 USD) - 2016/03/23 14:12:36 CET [2016/03/23 9:12:36 ET]
Table 'Kiess' 9-max Seat #9 is the button
Seat 1: Cirilico ($199.86 in chips) 
Seat 2: DUkalisUA ($697.68 in chips) 
Seat 4: Moszes360 ($200 in chips) 
Seat 5: chippo boy ($474.32 in chips) 
Seat 6: matiko09 ($274.84 in chips) 
Seat 7: InsomniaRU ($248.17 in chips) 
Seat 8: erfk1958 ($123.55 in chips) 
Seat 9: nickreason17 ($200 in chips) 
Cirilico: posts small blind $1
DUkalisUA: posts big blind $2
The_red_area: sits out 
*** HOLE CARDS ***
Dealt to matiko09 [6h 5h]
Moszes360: folds 
chippo boy: folds 
matiko09: folds 
InsomniaRU: raises $3 to $5
erfk1958: folds 
nickreason17: calls $5
Cirilico: folds 
DUkalisUA: folds 
*** FLOP *** [8d As 5d]
InsomniaRU: checks 
nickreason17: bets $8
InsomniaRU: calls $8
*** TURN *** [8d As 5d] [Ks]
InsomniaRU: checks 
nickreason17: checks 
*** RIVER *** [8d As 5d Ks] [6s]
InsomniaRU: checks 
nickreason17: bets $18
InsomniaRU: raises $42.46 to $60.46
nickreason17 has timed out
nickreason17: folds 
Uncalled bet ($42.46) returned to InsomniaRU
InsomniaRU collected $62.20 from pot
InsomniaRU: doesn't show hand 
*** SUMMARY ***
Total pot $65 | Rake $2.80 
Board [8d As 5d Ks 6s]
Seat 1: Cirilico (small blind) folded before Flop
Seat 2: DUkalisUA (big blind) folded before Flop
Seat 4: Moszes360 folded before Flop (didn't bet)
Seat 5: chippo boy folded before Flop (didn't bet)
Seat 6: matiko09 folded before Flop (didn't bet)
Seat 7: InsomniaRU collected ($62.20)
Seat 8: erfk1958 folded before Flop (didn't bet)
Seat 9: nickreason17 (button) folded on the River





PokerStars Hand #150800733448:  Hold'em No Limit ($0.50/$1.00 USD) - 2016/03/23 14:12:38 CET [2016/03/23 9:12:38 ET]
Table 'Kippes' 9-max Seat #5 is the button
Seat 1: Pvsx. ($107.31 in chips) 
Seat 2: RICKA16 ($189.45 in chips) 
Seat 3: CAJUN890 ($123.02 in chips) 
Seat 4: matiko09 ($100 in chips) 
Seat 5: Jimy Tiltman ($112.86 in chips) 
Seat 6: DUkalisUA ($115.36 in chips) 
Seat 7: lumen21 ($112.02 in chips) 
Seat 9: wang19790906 ($83.99 in chips) 
DUkalisUA: posts small blind $0.50
lumen21: posts big blind $1
Sherlockplay: sits out 
*** HOLE CARDS ***
Dealt to matiko09 [9d 6d]
wang19790906: raises $3 to $4
Pvsx.: folds 
RICKA16: folds 
CAJUN890: folds 
matiko09: folds 
Jimy Tiltman: folds 
DUkalisUA: folds 
lumen21: folds 
Uncalled bet ($3) returned to wang19790906
wang19790906 collected $2.50 from pot
wang19790906: doesn't show hand 
*** SUMMARY ***
Total pot $2.50 | Rake $0 
Seat 1: Pvsx. folded before Flop (didn't bet)
Seat 2: RICKA16 folded before Flop (didn't bet)
Seat 3: CAJUN890 folded before Flop (didn't bet)
Seat 4: matiko09 folded before Flop (didn't bet)
Seat 5: Jimy Tiltman (button) folded before Flop (didn't bet)
Seat 6: DUkalisUA (small blind) folded before Flop
Seat 7: lumen21 (big blind) folded before Flop
Seat 9: wang19790906 collected ($2.50)





PokerStars Hand #150800733457:  Hold'em No Limit ($1/$2 USD) - 2016/03/23 14:12:38 CET [2016/03/23 9:12:38 ET]
Table 'Herba II' 9-max Seat #9 is the button
Seat 1: matiko09 ($204.46 in chips) 
Seat 2: Moszes360 ($231.89 in chips) 
Seat 3: Cirilico ($160 in chips) 
Seat 4: DUkalisUA ($295.48 in chips) 
Seat 5: chippo boy ($233.53 in chips) 
Seat 6: Too-Anti-To ($215.46 in chips) 
Seat 7: InsomniaRU ($204.78 in chips) 
Seat 8: The_red_area ($445.98 in chips) 
Seat 9: mrhighryza ($56.43 in chips) 
matiko09: posts small blind $1
Moszes360: posts big blind $2
*** HOLE CARDS ***
Dealt to matiko09 [8c 6d]
Cirilico: folds 
DUkalisUA: raises $4 to $6
chippo boy: folds 
Too-Anti-To: folds 
InsomniaRU: folds 
The_red_area: folds 
mrhighryza: folds 
matiko09: folds 
Moszes360: folds 
Uncalled bet ($4) returned to DUkalisUA
DUkalisUA collected $5 from pot
DUkalisUA: doesn't show hand 
*** SUMMARY ***
Total pot $5 | Rake $0 
Seat 1: matiko09 (small blind) folded before Flop
Seat 2: Moszes360 (big blind) folded before Flop
Seat 3: Cirilico folded before Flop (didn't bet)
Seat 4: DUkalisUA collected ($5)
Seat 5: chippo boy folded before Flop (didn't bet)
Seat 6: Too-Anti-To folded before Flop (didn't bet)
Seat 7: InsomniaRU folded before Flop (didn't bet)
Seat 8: The_red_area folded before Flop (didn't bet)
Seat 9: mrhighryza (button) folded before Flop (didn't bet)





PokerStars Hand #150800734826:  Hold'em No Limit ($0.50/$1.00 USD) - 2016/03/23 14:12:40 CET [2016/03/23 9:12:40 ET]
Table 'Merope II' 9-max Seat #7 is the button
Seat 1: Jimy Tiltman ($100 in chips) 
Seat 4: YuriiSolodya ($84.59 in chips) 
Seat 5: DUkalisUA ($145.14 in chips) 
Seat 6: Effort92 ($100 in chips) 
Seat 7: matiko09 ($110.73 in chips) 
Seat 8: titentei ($94 in chips) 
titentei: posts small blind $0.50
RICKA16: is sitting out 
Jimy Tiltman: posts big blind $1
$-Twackle-$: sits out 
pablos1922: sits out 
*** HOLE CARDS ***
Dealt to matiko09 [Jd 2h]
YuriiSolodya: folds 
DUkalisUA: folds 
Effort92: folds 
matiko09: folds 
titentei: folds 
Uncalled bet ($0.50) returned to Jimy Tiltman
Jimy Tiltman collected $1 from pot
Jimy Tiltman: doesn't show hand 
*** SUMMARY ***
Total pot $1 | Rake $0 
Seat 1: Jimy Tiltman (big blind) collected ($1)
Seat 4: YuriiSolodya folded before Flop (didn't bet)
Seat 5: DUkalisUA folded before Flop (didn't bet)
Seat 6: Effort92 folded before Flop (didn't bet)
Seat 7: matiko09 (button) folded before Flop (didn't bet)
Seat 8: titentei (small blind) folded before Flop





PokerStars Hand #150800740627:  Hold'em No Limit (€0.50/€1.00 EUR) - 2016/03/23 14:12:50 CET [2016/03/23 9:12:50 ET]
Table 'Lanzia' 9-max Seat #3 is the button
Seat 1: Dantist1122 (€100 in chips) 
Seat 2: ardo888 (€103 in chips) 
Seat 3: Effort92 (€198.85 in chips) 
Seat 4: niong62 (€89.51 in chips) 
Seat 5: matiko09 (€100 in chips) 
Seat 6: nickreason17 (€100 in chips) 
Seat 7: $-Twackle-$ (€100 in chips) 
Seat 8: edidaz (€100 in chips) 
Seat 9: TonnaMunz (€100 in chips) 
niong62: posts small blind €0.50
matiko09: posts big blind €1
*** HOLE CARDS ***
Dealt to matiko09 [8s 4h]
nickreason17: folds 
$-Twackle-$: folds 
edidaz: folds 
TonnaMunz: folds 
Dantist1122: folds 
ardo888: folds 
Effort92: folds 
nickreason17 leaves the table
BKA12 joins the table at seat #6 
BKA12 leaves the table
Red4erT joins the table at seat #6 
niong62: calls €0.50
matiko09: checks 
*** FLOP *** [Tc 7c Ac]
niong62: checks 
matiko09: checks 
*** TURN *** [Tc 7c Ac] [Js]
niong62: checks 
matiko09: checks 
*** RIVER *** [Tc 7c Ac Js] [Jd]
niong62: checks 
matiko09: checks 
*** SHOW DOWN ***
niong62: shows [7h Kd] (two pair, Jacks and Sevens)
matiko09: mucks hand 
niong62 collected €1.91 from pot
*** SUMMARY ***
Total pot €2 | Rake €0.09 
Board [Tc 7c Ac Js Jd]
Seat 1: Dantist1122 folded before Flop (didn't bet)
Seat 2: ardo888 folded before Flop (didn't bet)
Seat 3: Effort92 (button) folded before Flop (didn't bet)
Seat 4: niong62 (small blind) showed [7h Kd] and won (€1.91) with two pair, Jacks and Sevens
Seat 5: matiko09 (big blind) mucked [8s 4h]
Seat 6: nickreason17 folded before Flop (didn't bet)
Seat 7: $-Twackle-$ folded before Flop (didn't bet)
Seat 8: edidaz folded before Flop (didn't bet)
Seat 9: TonnaMunz folded before Flop (didn't bet)





PokerStars Hand #150800740478:  Hold'em No Limit ($0.25/$0.50 USD) - 2016/03/23 14:12:50 CET [2016/03/23 9:12:50 ET]
Table 'Belnika' 9-max Seat #1 is the button
Seat 1: yellowfever0 ($19.12 in chips) 
Seat 2: NeverRegret7 ($50.52 in chips) 
Seat 3: RyMorgy ($50 in chips) 
Seat 4: matiko09 ($68.28 in chips) 
Seat 5: ZonTTT ($56.60 in chips) 
Seat 6: Ahangama ($50 in chips) 
Seat 7: CvMCvMCvM ($63.63 in chips) 
Seat 8: lumen21 ($62.47 in chips) 
Seat 9: dndngod ($58.16 in chips) 
NeverRegret7: posts small blind $0.25
RyMorgy: posts big blind $0.50
*** HOLE CARDS ***
Dealt to matiko09 [9s Ad]
matiko09: folds 
ZonTTT: raises $1 to $1.50
Ahangama: folds 
CvMCvMCvM: folds 
lumen21: folds 
dndngod: raises $3.50 to $5
yellowfever0: folds 
NeverRegret7: folds 
RyMorgy: folds 
CvMCvMCvM is disconnected 
ZonTTT: calls $3.50
*** FLOP *** [4c 3h Jd]
ZonTTT: checks 
dndngod: bets $6
ZonTTT: calls $6
*** TURN *** [4c 3h Jd] [3d]
ZonTTT: checks 
dndngod: bets $14.50
ZonTTT: folds 
Uncalled bet ($14.50) returned to dndngod
dndngod collected $21.73 from pot
dndngod: doesn't show hand 
*** SUMMARY ***
Total pot $22.75 | Rake $1.02 
Board [4c 3h Jd 3d]
Seat 1: yellowfever0 (button) folded before Flop (didn't bet)
Seat 2: NeverRegret7 (small blind) folded before Flop
Seat 3: RyMorgy (big blind) folded before Flop
Seat 4: matiko09 folded before Flop (didn't bet)
Seat 5: ZonTTT folded on the Turn
Seat 6: Ahangama folded before Flop (didn't bet)
Seat 7: CvMCvMCvM folded before Flop (didn't bet)
Seat 8: lumen21 folded before Flop (didn't bet)
Seat 9: dndngod collected ($21.73)





PokerStars Hand #150800741274:  Hold'em No Limit ($1/$2 USD) - 2016/03/23 14:12:51 CET [2016/03/23 9:12:51 ET]
Table 'Deipylos II' 9-max Seat #1 is the button
Seat 1: $-Twackle-$ ($200 in chips) 
Seat 2: T0ny Adams ($81 in chips) 
Seat 4: matiko09 ($200 in chips) 
Seat 9: Ranatuo84 ($192.38 in chips) 
T0ny Adams: posts small blind $1
matiko09: posts big blind $2
InsomniaRU: sits out 
Igoriah: sits out 
*** HOLE CARDS ***
Dealt to matiko09 [Th Qs]
Ranatuo84: calls $2
volwebni4ek joins the table at seat #7 
$-Twackle-$: folds 
T0ny Adams: calls $1
matiko09: raises $8 to $10
Ranatuo84: folds 
T0ny Adams: folds 
Uncalled bet ($8) returned to matiko09
matiko09 collected $6 from pot
matiko09: doesn't show hand 
*** SUMMARY ***
Total pot $6 | Rake $0 
Seat 1: $-Twackle-$ (button) folded before Flop (didn't bet)
Seat 2: T0ny Adams (small blind) folded before Flop
Seat 4: matiko09 (big blind) collected ($6)
Seat 9: Ranatuo84 folded before Flop





PokerStars Hand #150800744139:  Hold'em No Limit ($0.50/$1.00 USD) - 2016/03/23 14:12:56 CET [2016/03/23 9:12:56 ET]
Table 'Merope II' 9-max Seat #8 is the button
Seat 1: Jimy Tiltman ($100.50 in chips) 
Seat 2: $-Twackle-$ ($100 in chips) 
Seat 4: YuriiSolodya ($84.59 in chips) 
Seat 5: DUkalisUA ($145.14 in chips) 
Seat 6: Effort92 ($100 in chips) 
Seat 7: matiko09 ($110.73 in chips) 
Seat 8: titentei ($93.50 in chips) 
Jimy Tiltman: posts small blind $0.50
$-Twackle-$: posts big blind $1
pablos1922: sits out 
*** HOLE CARDS ***
Dealt to matiko09 [Td 2d]
YuriiSolodya: raises $1 to $2
DUkalisUA: folds 
Effort92: folds 
matiko09: folds 
titentei: folds 
Jimy Tiltman: folds 
$-Twackle-$: folds 
Uncalled bet ($1) returned to YuriiSolodya
YuriiSolodya collected $2.50 from pot
YuriiSolodya: doesn't show hand 
*** SUMMARY ***
Total pot $2.50 | Rake $0 
Seat 1: Jimy Tiltman (small blind) folded before Flop
Seat 2: $-Twackle-$ (big blind) folded before Flop
Seat 4: YuriiSolodya collected ($2.50)
Seat 5: DUkalisUA folded before Flop (didn't bet)
Seat 6: Effort92 folded before Flop (didn't bet)
Seat 7: matiko09 folded before Flop (didn't bet)
Seat 8: titentei (button) folded before Flop (didn't bet)





PokerStars Hand #150800745481:  Hold'em No Limit ($0.50/$1.00 USD) - 2016/03/23 14:12:58 CET [2016/03/23 9:12:58 ET]
Table 'Atlantis' 9-max Seat #1 is the button
Seat 1: xHourglass ($144.27 in chips) 
Seat 2: tffff2006 ($56.34 in chips) 
Seat 3: CAJUN890 ($108.79 in chips) 
Seat 4: matiko09 ($131.25 in chips) 
Seat 5: Pvsx. ($115.13 in chips) 
Seat 6: Jimy Tiltman ($141.36 in chips) 
Seat 7: Sherlockplay ($100 in chips) 
Seat 8: DUkalisUA ($101 in chips) 
tffff2006: posts small blind $0.50
CAJUN890: posts big blind $1
*** HOLE CARDS ***
Dealt to matiko09 [Qs Ks]
matiko09: raises $2 to $3
Pvsx.: folds 
Jimy Tiltman: folds 
Sherlockplay: calls $3
DUkalisUA: folds 
xHourglass: folds 
tffff2006 has timed out
tffff2006: folds 
CAJUN890: calls $2
*** FLOP *** [4s Jh Jc]
CAJUN890: checks 
matiko09: checks 
Sherlockplay: bets $5.50
CAJUN890: folds 
matiko09: folds 
Uncalled bet ($5.50) returned to Sherlockplay
Sherlockplay collected $9.07 from pot
Sherlockplay: doesn't show hand 
*** SUMMARY ***
Total pot $9.50 | Rake $0.43 
Board [4s Jh Jc]
Seat 1: xHourglass (button) folded before Flop (didn't bet)
Seat 2: tffff2006 (small blind) folded before Flop
Seat 3: CAJUN890 (big blind) folded on the Flop
Seat 4: matiko09 folded on the Flop
Seat 5: Pvsx. folded before Flop (didn't bet)
Seat 6: Jimy Tiltman folded before Flop (didn't bet)
Seat 7: Sherlockplay collected ($9.07)
Seat 8: DUkalisUA folded before Flop (didn't bet)





PokerStars Hand #150800747709:  Hold'em No Limit ($1/$2 USD) - 2016/03/23 14:13:02 CET [2016/03/23 9:13:02 ET]
Table 'Herba II' 9-max Seat #1 is the button
Seat 1: matiko09 ($203.46 in chips) 
Seat 2: Moszes360 ($229.89 in chips) 
Seat 3: Cirilico ($160 in chips) 
Seat 4: DUkalisUA ($298.48 in chips) 
Seat 5: chippo boy ($233.53 in chips) 
Seat 6: Too-Anti-To ($215.46 in chips) 
Seat 7: InsomniaRU ($204.78 in chips) 
Seat 8: The_red_area ($445.98 in chips) 
Seat 9: mrhighryza ($56.43 in chips) 
Moszes360: posts small blind $1
Cirilico: posts big blind $2
*** HOLE CARDS ***
Dealt to matiko09 [Th 3s]
DUkalisUA: raises $4 to $6
chippo boy: folds 
Too-Anti-To: folds 
InsomniaRU: folds 
The_red_area: folds 
mrhighryza: folds 
matiko09: folds 
Moszes360: folds 
Cirilico: folds 
Uncalled bet ($4) returned to DUkalisUA
DUkalisUA collected $5 from pot
DUkalisUA: doesn't show hand 
*** SUMMARY ***
Total pot $5 | Rake $0 
Seat 1: matiko09 (button) folded before Flop (didn't bet)
Seat 2: Moszes360 (small blind) folded before Flop
Seat 3: Cirilico (big blind) folded before Flop
Seat 4: DUkalisUA collected ($5)
Seat 5: chippo boy folded before Flop (didn't bet)
Seat 6: Too-Anti-To folded before Flop (didn't bet)
Seat 7: InsomniaRU folded before Flop (didn't bet)
Seat 8: The_red_area folded before Flop (didn't bet)
Seat 9: mrhighryza folded before Flop (didn't bet)





PokerStars Hand #150800748690:  Hold'em No Limit ($1/$2 USD) - 2016/03/23 14:13:03 CET [2016/03/23 9:13:03 ET]
Table 'Ennomos II' 9-max Seat #7 is the button
Seat 1: ilaviiitech ($200 in chips) 
Seat 2: Subam ($213.66 in chips) 
Seat 3: $-Twackle-$ ($200 in chips) 
Seat 4: glanza_mike ($202.32 in chips) 
Seat 5: South011 ($189.84 in chips) 
Seat 6: nickreason17 ($227.84 in chips) 
Seat 7: daniferdoser ($234.77 in chips) 
Seat 8: yyfk ($200 in chips) 
Seat 9: matiko09 ($200 in chips) 
yyfk: posts small blind $1
matiko09: posts big blind $2
*** HOLE CARDS ***
Dealt to matiko09 [Kh Qs]
ilaviiitech: folds 
Subam: folds 
$-Twackle-$: folds 
glanza_mike: folds 
South011: folds 
nickreason17: folds 
daniferdoser: folds 
yyfk: folds 
Uncalled bet ($1) returned to matiko09
matiko09 collected $2 from pot
matiko09: doesn't show hand 
*** SUMMARY ***
Total pot $2 | Rake $0 
Seat 1: ilaviiitech folded before Flop (didn't bet)
Seat 2: Subam folded before Flop (didn't bet)
Seat 3: $-Twackle-$ folded before Flop (didn't bet)
Seat 4: glanza_mike folded before Flop (didn't bet)
Seat 5: South011 folded before Flop (didn't bet)
Seat 6: nickreason17 folded before Flop (didn't bet)
Seat 7: daniferdoser (button) folded before Flop (didn't bet)
Seat 8: yyfk (small blind) folded before Flop
Seat 9: matiko09 (big blind) collected ($2)





PokerStars Hand #150800748563:  Hold'em No Limit ($0.25/$0.50 USD) - 2016/03/23 14:13:03 CET [2016/03/23 9:13:03 ET]
Table 'Pyrrhus' 9-max Seat #3 is the button
Seat 1: lumen21 ($80.16 in chips) 
Seat 2: alemão007 ($48.75 in chips) 
Seat 3: i L00K great ($50 in chips) 
Seat 4: GriffinBerg ($29.83 in chips) 
Seat 5: ZonTTT ($50 in chips) 
Seat 6: Ahangama ($50.75 in chips) 
Seat 7: matiko09 ($135.94 in chips) 
Seat 8: dndngod ($83.02 in chips) 
Seat 9: CvMCvMCvM ($96.61 in chips) 
GriffinBerg: posts small blind $0.25
ZonTTT: posts big blind $0.50
*** HOLE CARDS ***
Dealt to matiko09 [6d 3d]
Ahangama: folds 
matiko09: folds 
dndngod: folds 
CvMCvMCvM is disconnected 
CvMCvMCvM is connected 
CvMCvMCvM has timed out
CvMCvMCvM: folds 
lumen21: folds 
alemão007: folds 
i L00K great: folds 
GriffinBerg: raises $1 to $1.50
ZonTTT: calls $1
*** FLOP *** [5c Ks 2d]
GriffinBerg: checks 
ZonTTT: bets $1.75
GriffinBerg: raises $1.75 to $3.50
ZonTTT: calls $1.75
*** TURN *** [5c Ks 2d] [Qs]
GriffinBerg: bets $4.77
ZonTTT: folds 
Uncalled bet ($4.77) returned to GriffinBerg
GriffinBerg collected $9.55 from pot
*** SUMMARY ***
Total pot $10 | Rake $0.45 
Board [5c Ks 2d Qs]
Seat 1: lumen21 folded before Flop (didn't bet)
Seat 2: alemão007 folded before Flop (didn't bet)
Seat 3: i L00K great (button) folded before Flop (didn't bet)
Seat 4: GriffinBerg (small blind) collected ($9.55)
Seat 5: ZonTTT (big blind) folded on the Turn
Seat 6: Ahangama folded before Flop (didn't bet)
Seat 7: matiko09 folded before Flop (didn't bet)
Seat 8: dndngod folded before Flop (didn't bet)
Seat 9: CvMCvMCvM folded before Flop (didn't bet)





PokerStars Hand #150800749726:  Hold'em No Limit ($1/$2 USD) - 2016/03/23 14:13:05 CET [2016/03/23 9:13:05 ET]
Table 'Kypria II' 9-max Seat #2 is the button
Seat 1: geldwolfje ($143.12 in chips) 
Seat 2: coinflip_si ($208 in chips) 
Seat 3: seouljam ($208.45 in chips) 
Seat 4: VolanDog ($203 in chips) 
Seat 5: InsomniaRU ($403.78 in chips) 
Seat 6: matiko09 ($359.95 in chips) 
Seat 7: DUkalisUA ($207.37 in chips) 
Seat 8: Cirilico ($160 in chips) 
Seat 9: Moszes360 ($200 in chips) 
seouljam: posts small blind $1
VolanDog: posts big blind $2
*** HOLE CARDS ***
Dealt to matiko09 [5d 6s]
InsomniaRU: folds 
matiko09: folds 
DUkalisUA: folds 
Cirilico: raises $4 to $6
Moszes360: folds 
geldwolfje: calls $6
coinflip_si: folds 
seouljam: folds 
VolanDog: folds 
*** FLOP *** [6h 4d Ts]
Cirilico: checks 
geldwolfje: bets $8
Cirilico: calls $8
*** TURN *** [6h 4d Ts] [2c]
Cirilico: checks 
geldwolfje: bets $18
Cirilico: calls $18
*** RIVER *** [6h 4d Ts 2c] [3c]
Cirilico: checks 
geldwolfje: bets $48
Cirilico: calls $48
*** SHOW DOWN ***
geldwolfje: shows [9h Qc] (high card Queen)
Cirilico: shows [Td Kd] (a pair of Tens)
Cirilico collected $160.20 from pot
*** SUMMARY ***
Total pot $163 | Rake $2.80 
Board [6h 4d Ts 2c 3c]
Seat 1: geldwolfje showed [9h Qc] and lost with high card Queen
Seat 2: coinflip_si (button) folded before Flop (didn't bet)
Seat 3: seouljam (small blind) folded before Flop
Seat 4: VolanDog (big blind) folded before Flop
Seat 5: InsomniaRU folded before Flop (didn't bet)
Seat 6: matiko09 folded before Flop (didn't bet)
Seat 7: DUkalisUA folded before Flop (didn't bet)
Seat 8: Cirilico showed [Td Kd] and won ($160.20) with a pair of Tens
Seat 9: Moszes360 folded before Flop (didn't bet)





PokerStars Hand #150800750602:  Hold'em No Limit ($0.50/$1.00 USD) - 2016/03/23 14:13:07 CET [2016/03/23 9:13:07 ET]
Table 'Kippes' 9-max Seat #6 is the button
Seat 1: Pvsx. ($107.31 in chips) 
Seat 2: RICKA16 ($189.45 in chips) 
Seat 3: CAJUN890 ($123.02 in chips) 
Seat 4: matiko09 ($100 in chips) 
Seat 5: Jimy Tiltman ($112.86 in chips) 
Seat 6: DUkalisUA ($114.86 in chips) 
Seat 7: lumen21 ($111.02 in chips) 
Seat 8: Sherlockplay ($100 in chips) 
Seat 9: wang19790906 ($85.49 in chips) 
lumen21: posts small blind $0.50
Sherlockplay: posts big blind $1
*** HOLE CARDS ***
Dealt to matiko09 [Tc 3c]
wang19790906: folds 
Pvsx.: folds 
RICKA16: folds 
CAJUN890: folds 
matiko09: folds 
Jimy Tiltman: raises $1 to $2
DUkalisUA: folds 
lumen21: raises $6 to $8
Sherlockplay: folds 
Jimy Tiltman: calls $6
*** FLOP *** [6c 8s Js]
lumen21: checks 
Jimy Tiltman: bets $11
lumen21: calls $11
*** TURN *** [6c 8s Js] [Kh]
lumen21: checks 
Jimy Tiltman: bets $23
lumen21: folds 
Uncalled bet ($23) returned to Jimy Tiltman
Jimy Tiltman collected $37.24 from pot
Jimy Tiltman: doesn't show hand 
*** SUMMARY ***
Total pot $39 | Rake $1.76 
Board [6c 8s Js Kh]
Seat 1: Pvsx. folded before Flop (didn't bet)
Seat 2: RICKA16 folded before Flop (didn't bet)
Seat 3: CAJUN890 folded before Flop (didn't bet)
Seat 4: matiko09 folded before Flop (didn't bet)
Seat 5: Jimy Tiltman collected ($37.24)
Seat 6: DUkalisUA (button) folded before Flop (didn't bet)
Seat 7: lumen21 (small blind) folded on the Turn
Seat 8: Sherlockplay (big blind) folded before Flop
Seat 9: wang19790906 folded before Flop (didn't bet)





PokerStars Hand #150800756449:  Hold'em No Limit ($0.50/$1.00 USD) - 2016/03/23 14:13:17 CET [2016/03/23 9:13:17 ET]
Table 'Donar II' 9-max Seat #9 is the button
Seat 1: Effort92 ($100 in chips) 
Seat 3: st-germ30 ($103.14 in chips) 
Seat 4: DUkalisUA ($151.59 in chips) 
Seat 5: matiko09 ($102.64 in chips) 
Seat 6: ardo888 ($130 in chips) 
Seat 8: $-Twackle-$ ($100 in chips) 
Seat 9: oxfordtenzin ($110.90 in chips) 
Effort92: posts small blind $0.50
st-germ30: posts big blind $1
JimineyCrik: sits out 
Effort92: posts the ante $0.20
st-germ30: posts the ante $0.20
DUkalisUA: posts the ante $0.20
matiko09: posts the ante $0.20
ardo888: posts the ante $0.20
$-Twackle-$: posts the ante $0.20
oxfordtenzin: posts the ante $0.20
*** HOLE CARDS ***
Dealt to matiko09 [4s 9c]
DUkalisUA: folds 
matiko09: folds 
ardo888: folds 
$-Twackle-$: raises $1.50 to $2.50
oxfordtenzin: calls $2.50
Effort92: folds 
st-germ30: calls $1.50
*** FLOP *** [8c Ah Jd]
st-germ30: checks 
$-Twackle-$: bets $6.50
oxfordtenzin: calls $6.50
st-germ30: folds 
*** TURN *** [8c Ah Jd] [4c]
$-Twackle-$: checks 
oxfordtenzin: bets $11
$-Twackle-$: folds 
Uncalled bet ($11) returned to oxfordtenzin
oxfordtenzin collected $21.39 from pot
oxfordtenzin: doesn't show hand 
*** SUMMARY ***
Total pot $22.40 | Rake $1.01 
Board [8c Ah Jd 4c]
Seat 1: Effort92 (small blind) folded before Flop
Seat 3: st-germ30 (big blind) folded on the Flop
Seat 4: DUkalisUA folded before Flop (didn't bet)
Seat 5: matiko09 folded before Flop (didn't bet)
Seat 6: ardo888 folded before Flop (didn't bet)
Seat 8: $-Twackle-$ folded on the Turn
Seat 9: oxfordtenzin (button) collected ($21.39)





PokerStars Hand #150800761430:  Hold'em No Limit ($1/$2 USD) - 2016/03/23 14:13:25 CET [2016/03/23 9:13:25 ET]
Table 'Ennomos II' 9-max Seat #8 is the button
Seat 1: ilaviiitech ($200 in chips) 
Seat 2: Subam ($213.66 in chips) 
Seat 3: $-Twackle-$ ($200 in chips) 
Seat 4: glanza_mike ($202.32 in chips) 
Seat 5: South011 ($189.84 in chips) 
Seat 6: nickreason17 ($227.84 in chips) 
Seat 7: daniferdoser ($234.77 in chips) 
Seat 8: yyfk ($200 in chips) 
Seat 9: matiko09 ($201 in chips) 
matiko09: posts small blind $1
ilaviiitech: posts big blind $2
*** HOLE CARDS ***
Dealt to matiko09 [Jc 8h]
Subam: folds 
$-Twackle-$: folds 
glanza_mike: folds 
South011: folds 
nickreason17: folds 
daniferdoser: raises $3 to $5
yyfk: folds 
matiko09: folds 
ilaviiitech: folds 
Uncalled bet ($3) returned to daniferdoser
daniferdoser collected $5 from pot
daniferdoser: doesn't show hand 
*** SUMMARY ***
Total pot $5 | Rake $0 
Seat 1: ilaviiitech (big blind) folded before Flop
Seat 2: Subam folded before Flop (didn't bet)
Seat 3: $-Twackle-$ folded before Flop (didn't bet)
Seat 4: glanza_mike folded before Flop (didn't bet)
Seat 5: South011 folded before Flop (didn't bet)
Seat 6: nickreason17 folded before Flop (didn't bet)
Seat 7: daniferdoser collected ($5)
Seat 8: yyfk (button) folded before Flop (didn't bet)
Seat 9: matiko09 (small blind) folded before Flop





PokerStars Hand #150800766601:  Hold'em No Limit ($1/$2 USD) - 2016/03/23 14:13:33 CET [2016/03/23 9:13:33 ET]
Table 'Deipylos II' 9-max Seat #2 is the button
Seat 1: $-Twackle-$ ($200 in chips) 
Seat 2: T0ny Adams ($79 in chips) 
Seat 4: matiko09 ($204 in chips) 
Seat 5: InsomniaRU ($200 in chips) 
Seat 9: Ranatuo84 ($190.38 in chips) 
matiko09: posts small blind $1
InsomniaRU: posts big blind $2
nickreason17: sits out 
volwebni4ek: sits out 
Igoriah: sits out 
*** HOLE CARDS ***
Dealt to matiko09 [9d 3d]
Ranatuo84: folds 
$-Twackle-$: folds 
T0ny Adams: raises $3.24 to $5.24
matiko09: folds 
InsomniaRU: folds 
Uncalled bet ($3.24) returned to T0ny Adams
T0ny Adams collected $5 from pot
T0ny Adams: doesn't show hand 
*** SUMMARY ***
Total pot $5 | Rake $0 
Seat 1: $-Twackle-$ folded before Flop (didn't bet)
Seat 2: T0ny Adams (button) collected ($5)
Seat 4: matiko09 (small blind) folded before Flop
Seat 5: InsomniaRU (big blind) folded before Flop
Seat 9: Ranatuo84 folded before Flop (didn't bet)





PokerStars Hand #150800767385:  Hold'em No Limit ($0.50/$1.00 USD) - 2016/03/23 14:13:35 CET [2016/03/23 9:13:35 ET]
Table 'Merope II' 9-max Seat #1 is the button
Seat 1: Jimy Tiltman ($100 in chips) 
Seat 2: $-Twackle-$ ($100 in chips) 
Seat 3: pablos1922 ($100 in chips) 
Seat 4: YuriiSolodya ($86.09 in chips) 
Seat 5: DUkalisUA ($145.14 in chips) 
Seat 6: Effort92 ($100 in chips) 
Seat 7: matiko09 ($110.73 in chips) 
Seat 8: titentei ($93.50 in chips) 
$-Twackle-$: posts small blind $0.50
pablos1922: posts big blind $1
*** HOLE CARDS ***
Dealt to matiko09 [4c Qh]
YuriiSolodya: folds 
DUkalisUA: folds 
Effort92: folds 
matiko09: folds 
titentei: folds 
Jimy Tiltman: raises $2 to $3
$-Twackle-$: folds 
pablos1922: calls $2
*** FLOP *** [4h 8d 3d]
pablos1922: checks 
Jimy Tiltman: checks 
*** TURN *** [4h 8d 3d] [7d]
pablos1922: checks 
Jimy Tiltman: checks 
*** RIVER *** [4h 8d 3d 7d] [Kd]
pablos1922: checks 
Jimy Tiltman: checks 
*** SHOW DOWN ***
pablos1922: shows [Jd Tc] (a flush, King high)
Jimy Tiltman: mucks hand 
pablos1922 collected $6.21 from pot
*** SUMMARY ***
Total pot $6.50 | Rake $0.29 
Board [4h 8d 3d 7d Kd]
Seat 1: Jimy Tiltman (button) mucked [9c Ks]
Seat 2: $-Twackle-$ (small blind) folded before Flop
Seat 3: pablos1922 (big blind) showed [Jd Tc] and won ($6.21) with a flush, King high
Seat 4: YuriiSolodya folded before Flop (didn't bet)
Seat 5: DUkalisUA folded before Flop (didn't bet)
Seat 6: Effort92 folded before Flop (didn't bet)
Seat 7: matiko09 folded before Flop (didn't bet)
Seat 8: titentei folded before Flop (didn't bet)





PokerStars Hand #150800770506:  Hold'em No Limit ($1/$2 USD) - 2016/03/23 14:13:40 CET [2016/03/23 9:13:40 ET]
Table 'Herba II' 9-max Seat #2 is the button
Seat 1: matiko09 ($203.46 in chips) 
Seat 2: Moszes360 ($228.89 in chips) 
Seat 3: Cirilico ($160 in chips) 
Seat 4: DUkalisUA ($301.48 in chips) 
Seat 5: chippo boy ($233.53 in chips) 
Seat 6: Too-Anti-To ($215.46 in chips) 
Seat 7: InsomniaRU ($204.78 in chips) 
Seat 8: The_red_area ($445.98 in chips) 
Seat 9: mrhighryza ($56.43 in chips) 
Cirilico: posts small blind $1
DUkalisUA: posts big blind $2
*** HOLE CARDS ***
Dealt to matiko09 [Ac Jc]
chippo boy: calls $2
Too-Anti-To: folds 
InsomniaRU: folds 
The_red_area: folds 
mrhighryza: folds 
matiko09: raises $6 to $8
Moszes360: folds 
Cirilico: folds 
DUkalisUA: folds 
chippo boy: calls $6
*** FLOP *** [5s 2h Th]
chippo boy: checks 
matiko09: checks 
*** TURN *** [5s 2h Th] [5d]
chippo boy: bets $10
matiko09: folds 
Uncalled bet ($10) returned to chippo boy
chippo boy collected $18.14 from pot
*** SUMMARY ***
Total pot $19 | Rake $0.86 
Board [5s 2h Th 5d]
Seat 1: matiko09 folded on the Turn
Seat 2: Moszes360 (button) folded before Flop (didn't bet)
Seat 3: Cirilico (small blind) folded before Flop
Seat 4: DUkalisUA (big blind) folded before Flop
Seat 5: chippo boy collected ($18.14)
Seat 6: Too-Anti-To folded before Flop (didn't bet)
Seat 7: InsomniaRU folded before Flop (didn't bet)
Seat 8: The_red_area folded before Flop (didn't bet)
Seat 9: mrhighryza folded before Flop (didn't bet)





PokerStars Hand #150800775703:  Hold'em No Limit ($1/$2 USD) - 2016/03/23 14:13:49 CET [2016/03/23 9:13:49 ET]
Table 'Ennomos II' 9-max Seat #9 is the button
Seat 1: ilaviiitech ($200 in chips) 
Seat 2: Subam ($213.66 in chips) 
Seat 3: $-Twackle-$ ($200 in chips) 
Seat 4: glanza_mike ($202.32 in chips) 
Seat 5: South011 ($189.84 in chips) 
Seat 6: nickreason17 ($227.84 in chips) 
Seat 7: daniferdoser ($237.77 in chips) 
Seat 8: yyfk ($200 in chips) 
Seat 9: matiko09 ($200 in chips) 
ilaviiitech: posts small blind $1
Subam: posts big blind $2
*** HOLE CARDS ***
Dealt to matiko09 [4s 5h]
$-Twackle-$: folds 
glanza_mike: folds 
South011: raises $4 to $6
nickreason17: folds 
daniferdoser: folds 
yyfk: folds 
matiko09: folds 
ilaviiitech: folds 
Subam: folds 
Uncalled bet ($4) returned to South011
South011 collected $5 from pot
South011: doesn't show hand 
*** SUMMARY ***
Total pot $5 | Rake $0 
Seat 1: ilaviiitech (small blind) folded before Flop
Seat 2: Subam (big blind) folded before Flop
Seat 3: $-Twackle-$ folded before Flop (didn't bet)
Seat 4: glanza_mike folded before Flop (didn't bet)
Seat 5: South011 collected ($5)
Seat 6: nickreason17 folded before Flop (didn't bet)
Seat 7: daniferdoser folded before Flop (didn't bet)
Seat 8: yyfk folded before Flop (didn't bet)
Seat 9: matiko09 (button) folded before Flop (didn't bet)





PokerStars Hand #150800781504:  Hold'em No Limit ($1/$2 USD) - 2016/03/23 14:13:59 CET [2016/03/23 9:13:59 ET]
Table 'Achaia' 9-max Seat #8 is the button
Seat 1: ilaviiitech ($200 in chips) 
Seat 2: InsomniaRU ($226.66 in chips) 
Seat 3: matiko09 ($200 in chips) 
Seat 4: nailz83 ($209.46 in chips) 
Seat 5: DUkalisUA ($203 in chips) 
Seat 6: nickreason17 ($213.06 in chips) 
Seat 7: morosun ($179.09 in chips) 
Seat 8: $-Twackle-$ ($222.65 in chips) 
Seat 9: glanza_mike ($205.28 in chips) 
glanza_mike: posts small blind $1
ilaviiitech: posts big blind $2
*** HOLE CARDS ***
Dealt to matiko09 [4s Jh]
InsomniaRU: folds 
matiko09: folds 
nailz83: folds 
DUkalisUA: raises $4 to $6
nickreason17: folds 
morosun: folds 
$-Twackle-$: folds 
glanza_mike: folds 
ilaviiitech: folds 
Uncalled bet ($4) returned to DUkalisUA
DUkalisUA collected $5 from pot
DUkalisUA: doesn't show hand 
*** SUMMARY ***
Total pot $5 | Rake $0 
Seat 1: ilaviiitech (big blind) folded before Flop
Seat 2: InsomniaRU folded before Flop (didn't bet)
Seat 3: matiko09 folded before Flop (didn't bet)
Seat 4: nailz83 folded before Flop (didn't bet)
Seat 5: DUkalisUA collected ($5)
Seat 6: nickreason17 folded before Flop (didn't bet)
Seat 7: morosun folded before Flop (didn't bet)
Seat 8: $-Twackle-$ (button) folded before Flop (didn't bet)
Seat 9: glanza_mike (small blind) folded before Flop





PokerStars Hand #150800782182:  Hold'em No Limit ($1/$2 USD) - 2016/03/23 14:14:00 CET [2016/03/23 9:14:00 ET]
Table 'Deipylos II' 9-max Seat #4 is the button
Seat 1: $-Twackle-$ ($200 in chips) 
Seat 2: T0ny Adams ($82 in chips) 
Seat 4: matiko09 ($203 in chips) 
Seat 5: InsomniaRU ($200 in chips) 
Seat 6: nickreason17 ($201 in chips) 
Seat 9: Ranatuo84 ($190.38 in chips) 
InsomniaRU: posts small blind $1
nickreason17: posts big blind $2
volwebni4ek: sits out 
Igoriah: sits out 
*** HOLE CARDS ***
Dealt to matiko09 [2s 6h]
Ranatuo84: calls $2
$-Twackle-$: raises $5 to $7
T0ny Adams: folds 
matiko09: folds 
InsomniaRU: folds 
nickreason17: folds 
Ranatuo84: calls $5
*** FLOP *** [Ks 4s 3s]
Ranatuo84: checks 
$-Twackle-$: bets $9
Ranatuo84: calls $9
*** TURN *** [Ks 4s 3s] [9d]
Ranatuo84: checks 
$-Twackle-$: bets $19
Ranatuo84: calls $19
*** RIVER *** [Ks 4s 3s 9d] [3d]
Ranatuo84: checks 
$-Twackle-$: checks 
*** SHOW DOWN ***
Ranatuo84: shows [Js 9h] (two pair, Nines and Threes)
$-Twackle-$: mucks hand 
Ranatuo84 collected $70.20 from pot
*** SUMMARY ***
Total pot $73 | Rake $2.80 
Board [Ks 4s 3s 9d 3d]
Seat 1: $-Twackle-$ mucked [As Qc]
Seat 2: T0ny Adams folded before Flop (didn't bet)
Seat 4: matiko09 (button) folded before Flop (didn't bet)
Seat 5: InsomniaRU (small blind) folded before Flop
Seat 6: nickreason17 (big blind) folded before Flop
Seat 9: Ranatuo84 showed [Js 9h] and won ($70.20) with two pair, Nines and Threes





PokerStars Hand #150800785499:  Hold'em No Limit ($1/$2 USD) - 2016/03/23 14:14:05 CET [2016/03/23 9:14:05 ET]
Table 'Ennomos II' 9-max Seat #1 is the button
Seat 1: ilaviiitech ($200 in chips) 
Seat 2: Subam ($211.66 in chips) 
Seat 3: $-Twackle-$ ($200 in chips) 
Seat 4: glanza_mike ($202.32 in chips) 
Seat 5: South011 ($192.84 in chips) 
Seat 6: nickreason17 ($227.84 in chips) 
Seat 7: daniferdoser ($237.77 in chips) 
Seat 8: yyfk ($200 in chips) 
Seat 9: matiko09 ($200 in chips) 
Subam: posts small blind $1
$-Twackle-$: posts big blind $2
*** HOLE CARDS ***
Dealt to matiko09 [Qs 7d]
glanza_mike: folds 
South011: calls $2
nickreason17: raises $6 to $8
daniferdoser: folds 
yyfk: folds 
matiko09: folds 
ilaviiitech: folds 
Subam: folds 
$-Twackle-$: folds 
South011: calls $6
*** FLOP *** [4d 5s 8d]
South011: checks 
nickreason17: bets $9.50
South011: folds 
Uncalled bet ($9.50) returned to nickreason17
nickreason17 collected $18.14 from pot
*** SUMMARY ***
Total pot $19 | Rake $0.86 
Board [4d 5s 8d]
Seat 1: ilaviiitech (button) folded before Flop (didn't bet)
Seat 2: Subam (small blind) folded before Flop
Seat 3: $-Twackle-$ (big blind) folded before Flop
Seat 4: glanza_mike folded before Flop (didn't bet)
Seat 5: South011 folded on the Flop
Seat 6: nickreason17 collected ($18.14)
Seat 7: daniferdoser folded before Flop (didn't bet)
Seat 8: yyfk folded before Flop (didn't bet)
Seat 9: matiko09 folded before Flop (didn't bet)





PokerStars Hand #150800800607:  Hold'em No Limit ($1/$2 USD) - 2016/03/23 14:14:31 CET [2016/03/23 9:14:31 ET]
Table 'Kypria II' 9-max Seat #3 is the button
Seat 1: geldwolfje ($63.12 in chips) 
Seat 2: coinflip_si ($208 in chips) 
Seat 3: seouljam ($207.45 in chips) 
Seat 4: VolanDog ($201 in chips) 
Seat 5: InsomniaRU ($403.78 in chips) 
Seat 6: matiko09 ($359.95 in chips) 
Seat 7: DUkalisUA ($207.37 in chips) 
Seat 8: Cirilico ($240.20 in chips) 
Seat 9: Moszes360 ($200 in chips) 
VolanDog: posts small blind $1
InsomniaRU: posts big blind $2
*** HOLE CARDS ***
Dealt to matiko09 [4h 3d]
matiko09: folds 
DUkalisUA: folds 
seouljam said, "doh"
Cirilico: folds 
Moszes360: folds 
geldwolfje: folds 
coinflip_si: raises $3 to $5
seouljam: calls $5
VolanDog: folds 
InsomniaRU: folds 
*** FLOP *** [Jh Qs 6s]
coinflip_si: checks 
seouljam: checks 
*** TURN *** [Jh Qs 6s] [Td]
coinflip_si: bets $8
seouljam: calls $8
*** RIVER *** [Jh Qs 6s Td] [9h]
coinflip_si: checks 
seouljam: checks 
*** SHOW DOWN ***
coinflip_si: shows [Ad Kd] (a straight, Ten to Ace)
seouljam: mucks hand 
coinflip_si collected $27.70 from pot
*** SUMMARY ***
Total pot $29 | Rake $1.30 
Board [Jh Qs 6s Td 9h]
Seat 1: geldwolfje folded before Flop (didn't bet)
Seat 2: coinflip_si showed [Ad Kd] and won ($27.70) with a straight, Ten to Ace
Seat 3: seouljam (button) mucked [Qd Ac]
Seat 4: VolanDog (small blind) folded before Flop
Seat 5: InsomniaRU (big blind) folded before Flop
Seat 6: matiko09 folded before Flop (didn't bet)
Seat 7: DUkalisUA folded before Flop (didn't bet)
Seat 8: Cirilico folded before Flop (didn't bet)
Seat 9: Moszes360 folded before Flop (didn't bet)





PokerStars Hand #150800803562:  Hold'em No Limit ($0.50/$1.00 USD) - 2016/03/23 14:14:36 CET [2016/03/23 9:14:36 ET]
Table 'Kippes' 9-max Seat #7 is the button
Seat 1: Pvsx. ($107.31 in chips) 
Seat 2: RICKA16 ($189.45 in chips) 
Seat 3: CAJUN890 ($123.02 in chips) 
Seat 4: matiko09 ($100 in chips) 
Seat 5: Jimy Tiltman ($131.10 in chips) 
Seat 6: DUkalisUA ($114.86 in chips) 
Seat 7: lumen21 ($100 in chips) 
Seat 8: Sherlockplay ($100 in chips) 
Seat 9: wang19790906 ($85.49 in chips) 
Sherlockplay: posts small blind $0.50
wang19790906: posts big blind $1
*** HOLE CARDS ***
Dealt to matiko09 [Qc 3d]
Pvsx.: folds 
RICKA16: folds 
CAJUN890: folds 
matiko09: folds 
Jimy Tiltman: folds 
DUkalisUA: folds 
lumen21: raises $2 to $3
Sherlockplay: folds 
wang19790906: raises $3 to $6
lumen21: calls $3
*** FLOP *** [2h Th 7s]
wang19790906: bets $5.97
lumen21: folds 
Uncalled bet ($5.97) returned to wang19790906
wang19790906 collected $11.94 from pot
wang19790906: doesn't show hand 
*** SUMMARY ***
Total pot $12.50 | Rake $0.56 
Board [2h Th 7s]
Seat 1: Pvsx. folded before Flop (didn't bet)
Seat 2: RICKA16 folded before Flop (didn't bet)
Seat 3: CAJUN890 folded before Flop (didn't bet)
Seat 4: matiko09 folded before Flop (didn't bet)
Seat 5: Jimy Tiltman folded before Flop (didn't bet)
Seat 6: DUkalisUA folded before Flop (didn't bet)
Seat 7: lumen21 (button) folded on the Flop
Seat 8: Sherlockplay (small blind) folded before Flop
Seat 9: wang19790906 (big blind) collected ($11.94)





PokerStars Hand #150800804690:  Hold'em No Limit ($1/$2 USD) - 2016/03/23 14:14:38 CET [2016/03/23 9:14:38 ET]
Table 'Achaia' 9-max Seat #9 is the button
Seat 1: ilaviiitech ($200 in chips) 
Seat 2: InsomniaRU ($226.66 in chips) 
Seat 3: matiko09 ($200 in chips) 
Seat 4: nailz83 ($209.46 in chips) 
Seat 5: DUkalisUA ($206 in chips) 
Seat 6: nickreason17 ($213.06 in chips) 
Seat 7: morosun ($179.09 in chips) 
Seat 8: $-Twackle-$ ($222.65 in chips) 
Seat 9: glanza_mike ($204.28 in chips) 
ilaviiitech: posts small blind $1
InsomniaRU: posts big blind $2
*** HOLE CARDS ***
Dealt to matiko09 [7c 9h]
matiko09: folds 
nailz83: folds 
DUkalisUA: raises $4 to $6
nickreason17: folds 
morosun: folds 
$-Twackle-$: folds 
glanza_mike: folds 
ilaviiitech: calls $5
InsomniaRU: folds 
*** FLOP *** [2h Qd 6h]
ilaviiitech: checks 
DUkalisUA: bets $8.82
ilaviiitech: folds 
Uncalled bet ($8.82) returned to DUkalisUA
DUkalisUA collected $13.37 from pot
DUkalisUA: doesn't show hand 
*** SUMMARY ***
Total pot $14 | Rake $0.63 
Board [2h Qd 6h]
Seat 1: ilaviiitech (small blind) folded on the Flop
Seat 2: InsomniaRU (big blind) folded before Flop
Seat 3: matiko09 folded before Flop (didn't bet)
Seat 4: nailz83 folded before Flop (didn't bet)
Seat 5: DUkalisUA collected ($13.37)
Seat 6: nickreason17 folded before Flop (didn't bet)
Seat 7: morosun folded before Flop (didn't bet)
Seat 8: $-Twackle-$ folded before Flop (didn't bet)
Seat 9: glanza_mike (button) folded before Flop (didn't bet)





PokerStars Hand #150800805367:  Hold'em No Limit ($0.50/$1.00 USD) - 2016/03/23 14:14:39 CET [2016/03/23 9:14:39 ET]
Table 'Merope II' 9-max Seat #2 is the button
Seat 1: Jimy Tiltman ($100 in chips) 
Seat 2: $-Twackle-$ ($100 in chips) 
Seat 3: pablos1922 ($103.21 in chips) 
Seat 4: YuriiSolodya ($86.09 in chips) 
Seat 5: DUkalisUA ($145.14 in chips) 
Seat 6: Effort92 ($100 in chips) 
Seat 7: matiko09 ($110.73 in chips) 
Seat 8: titentei ($93.50 in chips) 
pablos1922: posts small blind $0.50
YuriiSolodya: posts big blind $1
*** HOLE CARDS ***
Dealt to matiko09 [Js 7h]
DUkalisUA: folds 
Effort92: folds 
matiko09: folds 
titentei: folds 
Jimy Tiltman: raises $1 to $2
$-Twackle-$: calls $2
pablos1922: folds 
YuriiSolodya: folds 
*** FLOP *** [3h 8s 4c]
Jimy Tiltman: bets $3.50
$-Twackle-$: calls $3.50
*** TURN *** [3h 8s 4c] [Ts]
Jimy Tiltman: checks 
$-Twackle-$: bets $8.50
Jimy Tiltman: calls $8.50
*** RIVER *** [3h 8s 4c Ts] [Kd]
Jimy Tiltman: checks 
$-Twackle-$: bets $19.50
Jimy Tiltman: folds 
Uncalled bet ($19.50) returned to $-Twackle-$
$-Twackle-$ collected $28.17 from pot
$-Twackle-$: doesn't show hand 
*** SUMMARY ***
Total pot $29.50 | Rake $1.33 
Board [3h 8s 4c Ts Kd]
Seat 1: Jimy Tiltman folded on the River
Seat 2: $-Twackle-$ (button) collected ($28.17)
Seat 3: pablos1922 (small blind) folded before Flop
Seat 4: YuriiSolodya (big blind) folded before Flop
Seat 5: DUkalisUA folded before Flop (didn't bet)
Seat 6: Effort92 folded before Flop (didn't bet)
Seat 7: matiko09 folded before Flop (didn't bet)
Seat 8: titentei folded before Flop (didn't bet)





PokerStars Hand #150800806386:  Hold'em No Limit (€0.50/€1.00 EUR) - 2016/03/23 14:14:41 CET [2016/03/23 9:14:41 ET]
Table 'Lanzia' 9-max Seat #4 is the button
Seat 1: Dantist1122 (€100 in chips) 
Seat 2: ardo888 (€103 in chips) 
Seat 3: Effort92 (€198.85 in chips) 
Seat 4: niong62 (€90.42 in chips) 
Seat 5: matiko09 (€100 in chips) 
Seat 6: Red4erT (€40 in chips) 
Seat 7: $-Twackle-$ (€100 in chips) 
Seat 8: edidaz (€100 in chips) 
Seat 9: TonnaMunz (€100 in chips) 
matiko09: posts small blind €0.50
Red4erT: posts big blind €1
*** HOLE CARDS ***
Dealt to matiko09 [Js 3d]
$-Twackle-$: folds 
edidaz: folds 
TonnaMunz: folds 
Dantist1122: folds 
ardo888: folds 
Effort92: folds 
niong62: raises €1 to €2
matiko09: folds 
Red4erT: folds 
Uncalled bet (€1) returned to niong62
niong62 collected €2.50 from pot
*** SUMMARY ***
Total pot €2.50 | Rake €0 
Seat 1: Dantist1122 folded before Flop (didn't bet)
Seat 2: ardo888 folded before Flop (didn't bet)
Seat 3: Effort92 folded before Flop (didn't bet)
Seat 4: niong62 (button) collected (€2.50)
Seat 5: matiko09 (small blind) folded before Flop
Seat 6: Red4erT (big blind) folded before Flop
Seat 7: $-Twackle-$ folded before Flop (didn't bet)
Seat 8: edidaz folded before Flop (didn't bet)
Seat 9: TonnaMunz folded before Flop (didn't bet)





PokerStars Hand #150800807733:  Hold'em No Limit ($0.50/$1.00 USD) - 2016/03/23 14:14:43 CET [2016/03/23 9:14:43 ET]
Table 'Donar II' 9-max Seat #1 is the button
Seat 1: Effort92 ($100 in chips) 
Seat 3: st-germ30 ($100.44 in chips) 
Seat 4: DUkalisUA ($151.39 in chips) 
Seat 5: matiko09 ($102.44 in chips) 
Seat 6: ardo888 ($129.80 in chips) 
Seat 8: $-Twackle-$ ($100 in chips) 
Seat 9: oxfordtenzin ($123.09 in chips) 
nobrunobru1 will be allowed to play after the button
st-germ30: posts small blind $0.50
DUkalisUA: posts big blind $1
JimineyCrik: sits out 
Effort92: posts the ante $0.20
st-germ30: posts the ante $0.20
DUkalisUA: posts the ante $0.20
matiko09: posts the ante $0.20
ardo888: posts the ante $0.20
$-Twackle-$: posts the ante $0.20
oxfordtenzin: posts the ante $0.20
*** HOLE CARDS ***
Dealt to matiko09 [Jh 6d]
matiko09: folds 
ardo888: folds 
$-Twackle-$: folds 
oxfordtenzin: folds 
Effort92: folds 
st-germ30: calls $0.50
DUkalisUA: checks 
*** FLOP *** [5c Ah 4s]
st-germ30: bets $1
DUkalisUA: folds 
Uncalled bet ($1) returned to st-germ30
st-germ30 collected $3.25 from pot
*** SUMMARY ***
Total pot $3.40 | Rake $0.15 
Board [5c Ah 4s]
Seat 1: Effort92 (button) folded before Flop (didn't bet)
Seat 3: st-germ30 (small blind) collected ($3.25)
Seat 4: DUkalisUA (big blind) folded on the Flop
Seat 5: matiko09 folded before Flop (didn't bet)
Seat 6: ardo888 folded before Flop (didn't bet)
Seat 8: $-Twackle-$ folded before Flop (didn't bet)
Seat 9: oxfordtenzin folded before Flop (didn't bet)





PokerStars Hand #150800808775:  Hold'em No Limit ($1/$2 USD) - 2016/03/23 14:14:45 CET [2016/03/23 9:14:45 ET]
Table 'Ennomos II' 9-max Seat #2 is the button
Seat 1: ilaviiitech ($200 in chips) 
Seat 2: Subam ($210.66 in chips) 
Seat 3: $-Twackle-$ ($200 in chips) 
Seat 4: glanza_mike ($202.32 in chips) 
Seat 5: South011 ($184.84 in chips) 
Seat 6: nickreason17 ($237.98 in chips) 
Seat 7: daniferdoser ($237.77 in chips) 
Seat 8: yyfk ($200 in chips) 
Seat 9: matiko09 ($200 in chips) 
$-Twackle-$: posts small blind $1
glanza_mike: posts big blind $2
*** HOLE CARDS ***
Dealt to matiko09 [7s Jd]
South011: folds 
nickreason17: folds 
daniferdoser: folds 
yyfk: folds 
matiko09: folds 
ilaviiitech: folds 
Subam: folds 
$-Twackle-$: folds 
Uncalled bet ($1) returned to glanza_mike
glanza_mike collected $2 from pot
glanza_mike: doesn't show hand 
*** SUMMARY ***
Total pot $2 | Rake $0 
Seat 1: ilaviiitech folded before Flop (didn't bet)
Seat 2: Subam (button) folded before Flop (didn't bet)
Seat 3: $-Twackle-$ (small blind) folded before Flop
Seat 4: glanza_mike (big blind) collected ($2)
Seat 5: South011 folded before Flop (didn't bet)
Seat 6: nickreason17 folded before Flop (didn't bet)
Seat 7: daniferdoser folded before Flop (didn't bet)
Seat 8: yyfk folded before Flop (didn't bet)
Seat 9: matiko09 folded before Flop (didn't bet)





PokerStars Hand #150800809880:  Hold'em No Limit ($1/$2 USD) - 2016/03/23 14:14:47 CET [2016/03/23 9:14:47 ET]
Table 'Kiess' 9-max Seat #1 is the button
Seat 1: Cirilico ($198.86 in chips) 
Seat 2: DUkalisUA ($695.68 in chips) 
Seat 3: The_red_area ($376.14 in chips) 
Seat 4: Moszes360 ($200 in chips) 
Seat 5: chippo boy ($474.32 in chips) 
Seat 6: matiko09 ($274.84 in chips) 
Seat 7: InsomniaRU ($279.37 in chips) 
Seat 8: erfk1958 ($123.55 in chips) 
Seat 9: nickreason17 ($200 in chips) 
DUkalisUA: posts small blind $1
The_red_area: posts big blind $2
*** HOLE CARDS ***
Dealt to matiko09 [Qc 8s]
Moszes360: folds 
chippo boy: folds 
matiko09: folds 
InsomniaRU: folds 
erfk1958: folds 
nickreason17: folds 
Cirilico: folds 
DUkalisUA: raises $3 to $5
The_red_area: raises $10 to $15
DUkalisUA: calls $10
*** FLOP *** [2d Th Ac]
DUkalisUA: checks 
The_red_area: bets $28.65
DUkalisUA: folds 
Uncalled bet ($28.65) returned to The_red_area
The_red_area collected $28.65 from pot
The_red_area: doesn't show hand 
*** SUMMARY ***
Total pot $30 | Rake $1.35 
Board [2d Th Ac]
Seat 1: Cirilico (button) folded before Flop (didn't bet)
Seat 2: DUkalisUA (small blind) folded on the Flop
Seat 3: The_red_area (big blind) collected ($28.65)
Seat 4: Moszes360 folded before Flop (didn't bet)
Seat 5: chippo boy folded before Flop (didn't bet)
Seat 6: matiko09 folded before Flop (didn't bet)
Seat 7: InsomniaRU folded before Flop (didn't bet)
Seat 8: erfk1958 folded before Flop (didn't bet)
Seat 9: nickreason17 folded before Flop (didn't bet)





PokerStars Hand #150800813555:  Hold'em No Limit ($1/$2 USD) - 2016/03/23 14:14:53 CET [2016/03/23 9:14:53 ET]
Table 'Herba II' 9-max Seat #3 is the button
Seat 1: matiko09 ($200 in chips) 
Seat 2: Moszes360 ($228.89 in chips) 
Seat 3: Cirilico ($160 in chips) 
Seat 4: DUkalisUA ($299.48 in chips) 
Seat 5: chippo boy ($243.67 in chips) 
Seat 6: Too-Anti-To ($215.46 in chips) 
Seat 7: InsomniaRU ($204.78 in chips) 
Seat 8: The_red_area ($445.98 in chips) 
Seat 9: mrhighryza ($56.43 in chips) 
DUkalisUA: posts small blind $1
chippo boy: posts big blind $2
*** HOLE CARDS ***
Dealt to matiko09 [9h 4d]
Too-Anti-To: folds 
InsomniaRU: folds 
The_red_area: folds 
mrhighryza: folds 
matiko09: folds 
Moszes360: raises $4 to $6
Cirilico: folds 
DUkalisUA: folds 
chippo boy: calls $4
*** FLOP *** [Ad Ks 8s]
chippo boy: checks 
Moszes360: checks 
*** TURN *** [Ad Ks 8s] [4h]
chippo boy: checks 
Moszes360: checks 
*** RIVER *** [Ad Ks 8s 4h] [Kd]
chippo boy: bets $6
Moszes360: calls $6
*** SHOW DOWN ***
chippo boy: shows [Ac 9s] (two pair, Aces and Kings)
Moszes360: mucks hand 
chippo boy collected $23.88 from pot
*** SUMMARY ***
Total pot $25 | Rake $1.12 
Board [Ad Ks 8s 4h Kd]
Seat 1: matiko09 folded before Flop (didn't bet)
Seat 2: Moszes360 mucked [Jh Js]
Seat 3: Cirilico (button) folded before Flop (didn't bet)
Seat 4: DUkalisUA (small blind) folded before Flop
Seat 5: chippo boy (big blind) showed [Ac 9s] and won ($23.88) with two pair, Aces and Kings
Seat 6: Too-Anti-To folded before Flop (didn't bet)
Seat 7: InsomniaRU folded before Flop (didn't bet)
Seat 8: The_red_area folded before Flop (didn't bet)
Seat 9: mrhighryza folded before Flop (didn't bet)





PokerStars Hand #150800814238:  Hold'em No Limit ($0.50/$1.00 USD) - 2016/03/23 14:14:54 CET [2016/03/23 9:14:54 ET]
Table 'Atlantis' 9-max Seat #3 is the button
Seat 1: xHourglass ($144.27 in chips) 
Seat 3: CAJUN890 ($105.79 in chips) 
Seat 4: matiko09 ($128.25 in chips) 
Seat 5: Pvsx. ($115.13 in chips) 
Seat 6: Jimy Tiltman ($141.36 in chips) 
Seat 7: Sherlockplay ($106.07 in chips) 
Seat 8: DUkalisUA ($101 in chips) 
matiko09: posts small blind $0.50
Pvsx.: posts big blind $1
*** HOLE CARDS ***
Dealt to matiko09 [Ad Ac]
Jimy Tiltman: folds 
Sherlockplay: raises $1.50 to $2.50
DUkalisUA: folds 
xHourglass: folds 
CAJUN890: folds 
matiko09: raises $8.50 to $11
Pvsx.: folds 
Sherlockplay: folds 
Uncalled bet ($8.50) returned to matiko09
matiko09 collected $6 from pot
matiko09: doesn't show hand 
*** SUMMARY ***
Total pot $6 | Rake $0 
Seat 1: xHourglass folded before Flop (didn't bet)
Seat 3: CAJUN890 (button) folded before Flop (didn't bet)
Seat 4: matiko09 (small blind) collected ($6)
Seat 5: Pvsx. (big blind) folded before Flop
Seat 6: Jimy Tiltman folded before Flop (didn't bet)
Seat 7: Sherlockplay folded before Flop
Seat 8: DUkalisUA folded before Flop (didn't bet)





PokerStars Hand #150800815886:  Hold'em No Limit ($0.25/$0.50 USD) - 2016/03/23 14:14:57 CET [2016/03/23 9:14:57 ET]
Table 'Pyrrhus' 9-max Seat #4 is the button
Seat 1: lumen21 ($80.16 in chips) 
Seat 2: alemão007 ($48.75 in chips) 
Seat 3: i L00K great ($50 in chips) 
Seat 4: GriffinBerg ($34.38 in chips) 
Seat 5: ZonTTT ($50 in chips) 
Seat 6: Ahangama ($50.75 in chips) 
Seat 7: matiko09 ($135.94 in chips) 
Seat 8: dndngod ($83.02 in chips) 
Seat 9: CvMCvMCvM ($96.61 in chips) 
ZonTTT: posts small blind $0.25
Ahangama: posts big blind $0.50
*** HOLE CARDS ***
Dealt to matiko09 [3d 6c]
matiko09: folds 
dndngod: raises $1 to $1.50
CvMCvMCvM: folds 
lumen21: folds 
alemão007: folds 
GriffinBerg is disconnected 
i L00K great: folds 
GriffinBerg: folds 
ZonTTT: folds 
Ahangama: folds 
Uncalled bet ($1) returned to dndngod
dndngod collected $1.25 from pot
*** SUMMARY ***
Total pot $1.25 | Rake $0 
Seat 1: lumen21 folded before Flop (didn't bet)
Seat 2: alemão007 folded before Flop (didn't bet)
Seat 3: i L00K great folded before Flop (didn't bet)
Seat 4: GriffinBerg (button) folded before Flop (didn't bet)
Seat 5: ZonTTT (small blind) folded before Flop
Seat 6: Ahangama (big blind) folded before Flop
Seat 7: matiko09 folded before Flop (didn't bet)
Seat 8: dndngod collected ($1.25)
Seat 9: CvMCvMCvM folded before Flop (didn't bet)





PokerStars Hand #150800821891:  Hold'em No Limit ($0.25/$0.50 USD) - 2016/03/23 14:15:06 CET [2016/03/23 9:15:06 ET]
Table 'Belnika' 9-max Seat #2 is the button
Seat 1: yellowfever0 ($19.12 in chips) 
Seat 2: NeverRegret7 ($50.27 in chips) 
Seat 3: RyMorgy ($49.50 in chips) 
Seat 4: matiko09 ($68.28 in chips) 
Seat 5: ZonTTT ($50 in chips) 
Seat 6: Ahangama ($50 in chips) 
Seat 7: CvMCvMCvM ($63.63 in chips) 
Seat 8: lumen21 ($62.47 in chips) 
Seat 9: dndngod ($68.89 in chips) 
RyMorgy: posts small blind $0.25
matiko09: posts big blind $0.50
*** HOLE CARDS ***
Dealt to matiko09 [Kc 2c]
ZonTTT: folds 
Ahangama: folds 
CvMCvMCvM: folds 
lumen21: folds 
dndngod: folds 
yellowfever0: folds 
NeverRegret7: folds 
RyMorgy: raises $0.75 to $1.25
matiko09: raises $2.75 to $4
RyMorgy: folds 
Uncalled bet ($2.75) returned to matiko09
matiko09 collected $2.50 from pot
matiko09: doesn't show hand 
*** SUMMARY ***
Total pot $2.50 | Rake $0 
Seat 1: yellowfever0 folded before Flop (didn't bet)
Seat 2: NeverRegret7 (button) folded before Flop (didn't bet)
Seat 3: RyMorgy (small blind) folded before Flop
Seat 4: matiko09 (big blind) collected ($2.50)
Seat 5: ZonTTT folded before Flop (didn't bet)
Seat 6: Ahangama folded before Flop (didn't bet)
Seat 7: CvMCvMCvM folded before Flop (didn't bet)
Seat 8: lumen21 folded before Flop (didn't bet)
Seat 9: dndngod folded before Flop (didn't bet)





PokerStars Hand #150800826967:  Hold'em No Limit (€0.50/€1.00 EUR) - 2016/03/23 14:15:15 CET [2016/03/23 9:15:15 ET]
Table 'Lanzia' 9-max Seat #5 is the button
Seat 1: Dantist1122 (€100 in chips) 
Seat 2: ardo888 (€103 in chips) 
Seat 3: Effort92 (€198.85 in chips) 
Seat 4: niong62 (€91.92 in chips) 
Seat 5: matiko09 (€100 in chips) 
Seat 6: Red4erT (€40 in chips) 
Seat 7: $-Twackle-$ (€100 in chips) 
Seat 8: edidaz (€100 in chips) 
Seat 9: TonnaMunz (€100 in chips) 
Red4erT: posts small blind €0.50
$-Twackle-$: posts big blind €1
*** HOLE CARDS ***
Dealt to matiko09 [Ac 2d]
edidaz: folds 
TonnaMunz: folds 
edidaz leaves the table
Dantist1122: folds 
TonnaMunz leaves the table
ardo888: folds 
Muinmyheart joins the table at seat #8 
Effort92: folds 
Muinmyheart said, "rfbu"
niong62: folds 
matiko09: raises €1.27 to €2.27
Butcher1848 joins the table at seat #9 
Red4erT: raises €3.73 to €6
$-Twackle-$: folds 
matiko09: folds 
Uncalled bet (€3.73) returned to Red4erT
Red4erT collected €5.54 from pot
Red4erT: doesn't show hand 
*** SUMMARY ***
Total pot €5.54 | Rake €0 
Seat 1: Dantist1122 folded before Flop (didn't bet)
Seat 2: ardo888 folded before Flop (didn't bet)
Seat 3: Effort92 folded before Flop (didn't bet)
Seat 4: niong62 folded before Flop (didn't bet)
Seat 5: matiko09 (button) folded before Flop
Seat 6: Red4erT (small blind) collected (€5.54)
Seat 7: $-Twackle-$ (big blind) folded before Flop
Seat 8: edidaz folded before Flop (didn't bet)
Seat 9: TonnaMunz folded before Flop (didn't bet)





PokerStars Hand #150800829744:  Hold'em No Limit ($1/$2 USD) - 2016/03/23 14:15:20 CET [2016/03/23 9:15:20 ET]
Table 'Deipylos II' 9-max Seat #5 is the button
Seat 1: $-Twackle-$ ($200 in chips) 
Seat 2: T0ny Adams ($82 in chips) 
Seat 4: matiko09 ($203 in chips) 
Seat 5: InsomniaRU ($200 in chips) 
Seat 6: nickreason17 ($200 in chips) 
Seat 7: volwebni4ek ($80 in chips) 
Seat 9: Ranatuo84 ($225.58 in chips) 
nickreason17: posts small blind $1
volwebni4ek: posts big blind $2
Igoriah: sits out 
*** HOLE CARDS ***
Dealt to matiko09 [9h 7c]
Ranatuo84: folds 
$-Twackle-$: folds 
T0ny Adams: folds 
matiko09: folds 
InsomniaRU: raises $3 to $5
nickreason17: folds 
volwebni4ek: folds 
Uncalled bet ($3) returned to InsomniaRU
InsomniaRU collected $5 from pot
InsomniaRU: doesn't show hand 
*** SUMMARY ***
Total pot $5 | Rake $0 
Seat 1: $-Twackle-$ folded before Flop (didn't bet)
Seat 2: T0ny Adams folded before Flop (didn't bet)
Seat 4: matiko09 folded before Flop (didn't bet)
Seat 5: InsomniaRU (button) collected ($5)
Seat 6: nickreason17 (small blind) folded before Flop
Seat 7: volwebni4ek (big blind) folded before Flop
Seat 9: Ranatuo84 folded before Flop (didn't bet)





PokerStars Hand #150800832711:  Hold'em No Limit ($0.50/$1.00 USD) - 2016/03/23 14:15:25 CET [2016/03/23 9:15:25 ET]
Table 'Donar II' 9-max Seat #3 is the button
Seat 1: Effort92 ($100 in chips) 
Seat 2: nobrunobru1 ($64.84 in chips) 
Seat 3: st-germ30 ($102.49 in chips) 
Seat 4: DUkalisUA ($150.19 in chips) 
Seat 5: matiko09 ($102.24 in chips) 
Seat 6: ardo888 ($129.60 in chips) 
Seat 8: $-Twackle-$ ($100 in chips) 
Seat 9: oxfordtenzin ($122.89 in chips) 
DUkalisUA: posts small blind $0.50
matiko09: posts big blind $1
JimineyCrik: sits out 
nobrunobru1: posts small & big blinds $1.50
Effort92: posts the ante $0.20
nobrunobru1: posts the ante $0.20
st-germ30: posts the ante $0.20
DUkalisUA: posts the ante $0.20
matiko09: posts the ante $0.20
ardo888: posts the ante $0.20
$-Twackle-$: posts the ante $0.20
oxfordtenzin: posts the ante $0.20
*** HOLE CARDS ***
Dealt to matiko09 [4c 3s]
ardo888: folds 
$-Twackle-$: raises $2.50 to $3.50
oxfordtenzin: folds 
Effort92: folds 
nobrunobru1: folds 
st-germ30: folds 
DUkalisUA: folds 
matiko09: folds 
Uncalled bet ($2.50) returned to $-Twackle-$
$-Twackle-$ collected $5.60 from pot
$-Twackle-$: doesn't show hand 
*** SUMMARY ***
Total pot $5.60 | Rake $0 
Seat 1: Effort92 folded before Flop (didn't bet)
Seat 2: nobrunobru1 folded before Flop
Seat 3: st-germ30 (button) folded before Flop (didn't bet)
Seat 4: DUkalisUA (small blind) folded before Flop
Seat 5: matiko09 (big blind) folded before Flop
Seat 6: ardo888 folded before Flop (didn't bet)
Seat 8: $-Twackle-$ collected ($5.60)
Seat 9: oxfordtenzin folded before Flop (didn't bet)





PokerStars Hand #150800833414:  Hold'em No Limit ($1/$2 USD) - 2016/03/23 14:15:26 CET [2016/03/23 9:15:26 ET]
Table 'Kypria II' 9-max Seat #4 is the button
Seat 1: geldwolfje ($63.12 in chips) 
Seat 2: coinflip_si ($222.70 in chips) 
Seat 3: seouljam ($194.45 in chips) 
Seat 4: VolanDog ($200 in chips) 
Seat 5: InsomniaRU ($401.78 in chips) 
Seat 6: matiko09 ($359.95 in chips) 
Seat 7: DUkalisUA ($207.37 in chips) 
Seat 8: Cirilico ($240.20 in chips) 
Seat 9: Moszes360 ($200 in chips) 
InsomniaRU: posts small blind $1
matiko09: posts big blind $2
*** HOLE CARDS ***
Dealt to matiko09 [Ac 4s]
DUkalisUA: folds 
seouljam said, "nice try"
Cirilico: folds 
Moszes360: folds 
geldwolfje: raises $4 to $6
coinflip_si: folds 
seouljam: calls $6
VolanDog: folds 
InsomniaRU: folds 
matiko09: folds 
*** FLOP *** [Js Qh 6c]
geldwolfje: checks 
seouljam: bets $6
geldwolfje: raises $6 to $12
seouljam: folds 
Uncalled bet ($6) returned to geldwolfje
geldwolfje collected $25.78 from pot
geldwolfje: doesn't show hand 
*** SUMMARY ***
Total pot $27 | Rake $1.22 
Board [Js Qh 6c]
Seat 1: geldwolfje collected ($25.78)
Seat 2: coinflip_si folded before Flop (didn't bet)
Seat 3: seouljam folded on the Flop
Seat 4: VolanDog (button) folded before Flop (didn't bet)
Seat 5: InsomniaRU (small blind) folded before Flop
Seat 6: matiko09 (big blind) folded before Flop
Seat 7: DUkalisUA folded before Flop (didn't bet)
Seat 8: Cirilico folded before Flop (didn't bet)
Seat 9: Moszes360 folded before Flop (didn't bet)





PokerStars Hand #150800836035:  Hold'em No Limit ($1/$2 USD) - 2016/03/23 14:15:30 CET [2016/03/23 9:15:30 ET]
Table 'Ennomos II' 9-max Seat #3 is the button
Seat 1: ilaviiitech ($200 in chips) 
Seat 2: Subam ($210.66 in chips) 
Seat 3: $-Twackle-$ ($200 in chips) 
Seat 4: glanza_mike ($203.32 in chips) 
Seat 5: South011 ($184.84 in chips) 
Seat 6: nickreason17 ($237.98 in chips) 
Seat 7: daniferdoser ($237.77 in chips) 
Seat 8: yyfk ($200 in chips) 
Seat 9: matiko09 ($200 in chips) 
glanza_mike: posts small blind $1
South011: posts big blind $2
*** HOLE CARDS ***
Dealt to matiko09 [8c 6d]
nickreason17: folds 
daniferdoser: raises $3 to $5
yyfk: raises $13 to $18
matiko09: folds 
ilaviiitech: folds 
Subam has timed out
Subam: folds 
$-Twackle-$: folds 
glanza_mike: folds 
South011: calls $16
daniferdoser: raises $32 to $50
yyfk: folds 
South011: raises $64 to $114
daniferdoser: raises $64 to $178
South011: raises $6.84 to $184.84 and is all-in
daniferdoser: calls $6.84
*** FLOP *** [Ah Kd Js]
*** TURN *** [Ah Kd Js] [Jh]
*** RIVER *** [Ah Kd Js Jh] [Th]
*** SHOW DOWN ***
South011: shows [As Ad] (a full house, Aces full of Jacks)
daniferdoser: shows [Ac Kh] (two pair, Aces and Kings)
South011 collected $385.88 from pot
*** SUMMARY ***
Total pot $388.68 | Rake $2.80 
Board [Ah Kd Js Jh Th]
Seat 1: ilaviiitech folded before Flop (didn't bet)
Seat 2: Subam folded before Flop (didn't bet)
Seat 3: $-Twackle-$ (button) folded before Flop (didn't bet)
Seat 4: glanza_mike (small blind) folded before Flop
Seat 5: South011 (big blind) showed [As Ad] and won ($385.88) with a full house, Aces full of Jacks
Seat 6: nickreason17 folded before Flop (didn't bet)
Seat 7: daniferdoser showed [Ac Kh] and lost with two pair, Aces and Kings
Seat 8: yyfk folded before Flop
Seat 9: matiko09 folded before Flop (didn't bet)





PokerStars Hand #150800836328:  Hold'em No Limit ($0.50/$1.00 USD) - 2016/03/23 14:15:31 CET [2016/03/23 9:15:31 ET]
Table 'Kippes' 9-max Seat #8 is the button
Seat 1: Pvsx. ($107.31 in chips) 
Seat 2: RICKA16 ($189.45 in chips) 
Seat 3: CAJUN890 ($123.02 in chips) 
Seat 4: matiko09 ($100 in chips) 
Seat 5: Jimy Tiltman ($131.10 in chips) 
Seat 6: DUkalisUA ($114.86 in chips) 
Seat 7: lumen21 ($100 in chips) 
Seat 8: Sherlockplay ($100 in chips) 
Seat 9: wang19790906 ($91.43 in chips) 
wang19790906: posts small blind $0.50
Pvsx.: posts big blind $1
*** HOLE CARDS ***
Dealt to matiko09 [8h 5h]
RICKA16: folds 
CAJUN890: raises $3 to $4
matiko09: folds 
Jimy Tiltman: folds 
DUkalisUA: folds 
lumen21: calls $4
Sherlockplay: folds 
wang19790906: folds 
Pvsx.: calls $3
*** FLOP *** [Js 4d 7c]
Pvsx.: checks 
CAJUN890: bets $5.97
lumen21: folds 
Pvsx.: calls $5.97
*** TURN *** [Js 4d 7c] [8d]
Pvsx.: checks 
CAJUN890: checks 
*** RIVER *** [Js 4d 7c 8d] [5d]
Pvsx.: checks 
CAJUN890: checks 
*** SHOW DOWN ***
Pvsx.: shows [3h 3d] (a pair of Threes)
CAJUN890: mucks hand 
Pvsx. collected $23.34 from pot
*** SUMMARY ***
Total pot $24.44 | Rake $1.10 
Board [Js 4d 7c 8d 5d]
Seat 1: Pvsx. (big blind) showed [3h 3d] and won ($23.34) with a pair of Threes
Seat 2: RICKA16 folded before Flop (didn't bet)
Seat 3: CAJUN890 mucked [Kc Ad]
Seat 4: matiko09 folded before Flop (didn't bet)
Seat 5: Jimy Tiltman folded before Flop (didn't bet)
Seat 6: DUkalisUA folded before Flop (didn't bet)
Seat 7: lumen21 folded on the Flop
Seat 8: Sherlockplay (button) folded before Flop (didn't bet)
Seat 9: wang19790906 (small blind) folded before Flop





PokerStars Hand #150800841137:  Hold'em No Limit ($0.50/$1.00 USD) - 2016/03/23 14:15:39 CET [2016/03/23 9:15:39 ET]
Table 'Atlantis' 9-max Seat #4 is the button
Seat 1: xHourglass ($144.27 in chips) 
Seat 3: CAJUN890 ($105.79 in chips) 
Seat 4: matiko09 ($131.75 in chips) 
Seat 5: Pvsx. ($114.13 in chips) 
Seat 6: Jimy Tiltman ($141.36 in chips) 
Seat 7: Sherlockplay ($103.57 in chips) 
Seat 8: DUkalisUA ($101 in chips) 
Pvsx.: posts small blind $0.50
Jimy Tiltman: posts big blind $1
*** HOLE CARDS ***
Dealt to matiko09 [Kd Ts]
Sherlockplay: folds 
DUkalisUA: raises $2 to $3
xHourglass: folds 
CAJUN890: folds 
matiko09: folds 
Pvsx.: folds 
Jimy Tiltman: folds 
Uncalled bet ($2) returned to DUkalisUA
DUkalisUA collected $2.50 from pot
DUkalisUA: doesn't show hand 
*** SUMMARY ***
Total pot $2.50 | Rake $0 
Seat 1: xHourglass folded before Flop (didn't bet)
Seat 3: CAJUN890 folded before Flop (didn't bet)
Seat 4: matiko09 (button) folded before Flop (didn't bet)
Seat 5: Pvsx. (small blind) folded before Flop
Seat 6: Jimy Tiltman (big blind) folded before Flop
Seat 7: Sherlockplay folded before Flop (didn't bet)
Seat 8: DUkalisUA collected ($2.50)





PokerStars Hand #150800846121:  Hold'em No Limit ($0.25/$0.50 USD) - 2016/03/23 14:15:47 CET [2016/03/23 9:15:47 ET]
Table 'Pyrrhus' 9-max Seat #5 is the button
Seat 1: lumen21 ($80.16 in chips) 
Seat 2: alemão007 ($48.75 in chips) 
Seat 3: i L00K great ($50 in chips) 
Seat 4: GriffinBerg ($34.38 in chips) 
Seat 5: ZonTTT ($50 in chips) 
Seat 6: Ahangama ($50.25 in chips) 
Seat 7: matiko09 ($135.94 in chips) 
Seat 8: dndngod ($83.77 in chips) 
Seat 9: CvMCvMCvM ($96.61 in chips) 
Ahangama: posts small blind $0.25
matiko09: posts big blind $0.50
*** HOLE CARDS ***
Dealt to matiko09 [9h Js]
dndngod: raises $1 to $1.50
CvMCvMCvM: folds 
lumen21: folds 
alemão007: folds 
i L00K great: folds 
GriffinBerg: folds 
ZonTTT: folds 
Ahangama: folds 
matiko09: folds 
Uncalled bet ($1) returned to dndngod
dndngod collected $1.25 from pot
dndngod: doesn't show hand 
*** SUMMARY ***
Total pot $1.25 | Rake $0 
Seat 1: lumen21 folded before Flop (didn't bet)
Seat 2: alemão007 folded before Flop (didn't bet)
Seat 3: i L00K great folded before Flop (didn't bet)
Seat 4: GriffinBerg folded before Flop (didn't bet)
Seat 5: ZonTTT (button) folded before Flop (didn't bet)
Seat 6: Ahangama (small blind) folded before Flop
Seat 7: matiko09 (big blind) folded before Flop
Seat 8: dndngod collected ($1.25)
Seat 9: CvMCvMCvM folded before Flop (didn't bet)





PokerStars Hand #150800846657:  Hold'em No Limit ($1/$2 USD) - 2016/03/23 14:15:48 CET [2016/03/23 9:15:48 ET]
Table 'Herba II' 9-max Seat #4 is the button
Seat 1: matiko09 ($200 in chips) 
Seat 2: Moszes360 ($216.89 in chips) 
Seat 3: Cirilico ($160 in chips) 
Seat 4: DUkalisUA ($298.48 in chips) 
Seat 5: chippo boy ($255.55 in chips) 
Seat 6: Too-Anti-To ($215.46 in chips) 
Seat 7: InsomniaRU ($204.78 in chips) 
Seat 8: The_red_area ($445.98 in chips) 
Seat 9: mrhighryza ($56.43 in chips) 
chippo boy: posts small blind $1
Too-Anti-To: posts big blind $2
*** HOLE CARDS ***
Dealt to matiko09 [7h 5s]
InsomniaRU: folds 
The_red_area: folds 
mrhighryza: folds 
matiko09: folds 
Moszes360: raises $4 to $6
Cirilico: folds 
DUkalisUA: folds 
chippo boy: calls $5
Too-Anti-To: folds 
*** FLOP *** [5c 3c As]
chippo boy: checks 
Moszes360: checks 
*** TURN *** [5c 3c As] [4c]
chippo boy: bets $6
Moszes360: calls $6
*** RIVER *** [5c 3c As 4c] [Jd]
chippo boy: bets $14
Moszes360: folds 
Uncalled bet ($14) returned to chippo boy
chippo boy collected $24.83 from pot
*** SUMMARY ***
Total pot $26 | Rake $1.17 
Board [5c 3c As 4c Jd]
Seat 1: matiko09 folded before Flop (didn't bet)
Seat 2: Moszes360 folded on the River
Seat 3: Cirilico folded before Flop (didn't bet)
Seat 4: DUkalisUA (button) folded before Flop (didn't bet)
Seat 5: chippo boy (small blind) collected ($24.83)
Seat 6: Too-Anti-To (big blind) folded before Flop
Seat 7: InsomniaRU folded before Flop (didn't bet)
Seat 8: The_red_area folded before Flop (didn't bet)
Seat 9: mrhighryza folded before Flop (didn't bet)





PokerStars Hand #150800849813:  Hold'em No Limit ($0.25/$0.50 USD) - 2016/03/23 14:15:53 CET [2016/03/23 9:15:53 ET]
Table 'Belnika' 9-max Seat #3 is the button
Seat 1: yellowfever0 ($19.12 in chips) 
Seat 2: NeverRegret7 ($50.27 in chips) 
Seat 3: RyMorgy ($48.25 in chips) 
Seat 4: matiko09 ($69.53 in chips) 
Seat 5: ZonTTT ($50 in chips) 
Seat 6: Ahangama ($50 in chips) 
Seat 7: CvMCvMCvM ($63.63 in chips) 
Seat 8: lumen21 ($62.47 in chips) 
Seat 9: dndngod ($68.89 in chips) 
matiko09: posts small blind $0.25
ZonTTT: posts big blind $0.50
*** HOLE CARDS ***
Dealt to matiko09 [5d 7d]
Ahangama: folds 
CvMCvMCvM: raises $0.57 to $1.07
lumen21: folds 
dndngod: folds 
yellowfever0: calls $1.07
NeverRegret7: folds 
RyMorgy: raises $2.93 to $4
matiko09: folds 
ZonTTT: folds 
CvMCvMCvM: folds 
yellowfever0: calls $2.93
*** FLOP *** [4d 4s 7c]
yellowfever0: checks 
RyMorgy: bets $6.50
yellowfever0: calls $6.50
*** TURN *** [4d 4s 7c] [9h]
yellowfever0: checks 
RyMorgy: checks 
*** RIVER *** [4d 4s 7c 9h] [Qs]
yellowfever0: checks 
RyMorgy: checks 
*** SHOW DOWN ***
yellowfever0: shows [3s 6s] (a pair of Fours)
RyMorgy: shows [Ah Ks] (a pair of Fours - Ace kicker)
RyMorgy collected $21.79 from pot
*** SUMMARY ***
Total pot $22.82 | Rake $1.03 
Board [4d 4s 7c 9h Qs]
Seat 1: yellowfever0 showed [3s 6s] and lost with a pair of Fours
Seat 2: NeverRegret7 folded before Flop (didn't bet)
Seat 3: RyMorgy (button) showed [Ah Ks] and won ($21.79) with a pair of Fours
Seat 4: matiko09 (small blind) folded before Flop
Seat 5: ZonTTT (big blind) folded before Flop
Seat 6: Ahangama folded before Flop (didn't bet)
Seat 7: CvMCvMCvM folded before Flop
Seat 8: lumen21 folded before Flop (didn't bet)
Seat 9: dndngod folded before Flop (didn't bet)





PokerStars Hand #150800854759:  Hold'em No Limit (€0.50/€1.00 EUR) - 2016/03/23 14:16:01 CET [2016/03/23 9:16:01 ET]
Table 'Lanzia' 9-max Seat #6 is the button
Seat 1: Dantist1122 (€100 in chips) 
Seat 2: ardo888 (€103 in chips) 
Seat 3: Effort92 (€198.85 in chips) 
Seat 4: niong62 (€91.92 in chips) 
Seat 5: matiko09 (€100 in chips) 
Seat 6: Red4erT (€43.27 in chips) 
Seat 7: $-Twackle-$ (€100 in chips) 
Seat 8: Muinmyheart (€100 in chips) 
$-Twackle-$: posts small blind €0.50
Muinmyheart: posts big blind €1
Butcher1848: sits out 
*** HOLE CARDS ***
Dealt to matiko09 [Jc 7h]
Dantist1122: folds 
ardo888: folds 
Effort92: folds 
niong62: calls €1
matiko09: folds 
Red4erT: raises €1.50 to €2.50
$-Twackle-$: calls €2
Muinmyheart: folds 
niong62: calls €1.50
*** FLOP *** [5h 4h 6h]
$-Twackle-$: checks 
niong62: checks 
Red4erT: bets €4.22
$-Twackle-$: folds 
niong62: calls €4.22
*** TURN *** [5h 4h 6h] [Qs]
niong62: checks 
Red4erT: checks 
*** RIVER *** [5h 4h 6h Qs] [2d]
niong62: bets €5
Red4erT: folds 
Uncalled bet (€5) returned to niong62
niong62 collected €16.18 from pot
*** SUMMARY ***
Total pot €16.94 | Rake €0.76 
Board [5h 4h 6h Qs 2d]
Seat 1: Dantist1122 folded before Flop (didn't bet)
Seat 2: ardo888 folded before Flop (didn't bet)
Seat 3: Effort92 folded before Flop (didn't bet)
Seat 4: niong62 collected (€16.18)
Seat 5: matiko09 folded before Flop (didn't bet)
Seat 6: Red4erT (button) folded on the River
Seat 7: $-Twackle-$ (small blind) folded on the Flop
Seat 8: Muinmyheart (big blind) folded before Flop





PokerStars Hand #150800856023:  Hold'em No Limit ($1/$2 USD) - 2016/03/23 14:16:03 CET [2016/03/23 9:16:03 ET]
Table 'Kiess' 9-max Seat #2 is the button
Seat 1: Cirilico ($198.86 in chips) 
Seat 2: DUkalisUA ($680.68 in chips) 
Seat 3: The_red_area ($389.79 in chips) 
Seat 4: Moszes360 ($200 in chips) 
Seat 5: chippo boy ($474.32 in chips) 
Seat 6: matiko09 ($274.84 in chips) 
Seat 7: InsomniaRU ($279.37 in chips) 
Seat 8: erfk1958 ($123.55 in chips) 
Seat 9: nickreason17 ($200 in chips) 
The_red_area: posts small blind $1
Moszes360: posts big blind $2
*** HOLE CARDS ***
Dealt to matiko09 [Qs 6c]
chippo boy: folds 
matiko09: folds 
InsomniaRU: raises $3 to $5
erfk1958: folds 
nickreason17: folds 
Cirilico: folds 
DUkalisUA: calls $5
The_red_area: folds 
Moszes360: folds 
*** FLOP *** [Kd 3h 2h]
InsomniaRU: checks 
DUkalisUA: checks 
*** TURN *** [Kd 3h 2h] [Ac]
InsomniaRU has timed out
InsomniaRU: checks 
DUkalisUA: bets $8.19
InsomniaRU: folds 
Uncalled bet ($8.19) returned to DUkalisUA
DUkalisUA collected $12.42 from pot
DUkalisUA: doesn't show hand 
*** SUMMARY ***
Total pot $13 | Rake $0.58 
Board [Kd 3h 2h Ac]
Seat 1: Cirilico folded before Flop (didn't bet)
Seat 2: DUkalisUA (button) collected ($12.42)
Seat 3: The_red_area (small blind) folded before Flop
Seat 4: Moszes360 (big blind) folded before Flop
Seat 5: chippo boy folded before Flop (didn't bet)
Seat 6: matiko09 folded before Flop (didn't bet)
Seat 7: InsomniaRU folded on the Turn
Seat 8: erfk1958 folded before Flop (didn't bet)
Seat 9: nickreason17 folded before Flop (didn't bet)





PokerStars Hand #150800856691:  Hold'em No Limit ($1/$2 USD) - 2016/03/23 14:16:04 CET [2016/03/23 9:16:04 ET]
Table 'Deipylos II' 9-max Seat #6 is the button
Seat 1: $-Twackle-$ ($200 in chips) 
Seat 2: T0ny Adams ($82 in chips) 
Seat 4: matiko09 ($203 in chips) 
Seat 5: InsomniaRU ($203 in chips) 
Seat 6: nickreason17 ($200 in chips) 
Seat 7: volwebni4ek ($80 in chips) 
Seat 8: Igoriah ($200 in chips) 
Seat 9: Ranatuo84 ($225.58 in chips) 
volwebni4ek: posts small blind $1
Igoriah: posts big blind $2
*** HOLE CARDS ***
Dealt to matiko09 [3d 9s]
Ranatuo84: calls $2
$-Twackle-$: folds 
T0ny Adams: folds 
matiko09: folds 
InsomniaRU: folds 
nickreason17: folds 
volwebni4ek: folds 
Igoriah: checks 
*** FLOP *** [7c Ah 8h]
Igoriah: checks 
Ranatuo84: bets $2
Igoriah: folds 
Uncalled bet ($2) returned to Ranatuo84
Ranatuo84 collected $4.78 from pot
*** SUMMARY ***
Total pot $5 | Rake $0.22 
Board [7c Ah 8h]
Seat 1: $-Twackle-$ folded before Flop (didn't bet)
Seat 2: T0ny Adams folded before Flop (didn't bet)
Seat 4: matiko09 folded before Flop (didn't bet)
Seat 5: InsomniaRU folded before Flop (didn't bet)
Seat 6: nickreason17 (button) folded before Flop (didn't bet)
Seat 7: volwebni4ek (small blind) folded before Flop
Seat 8: Igoriah (big blind) folded on the Flop
Seat 9: Ranatuo84 collected ($4.78)





PokerStars Hand #150800862374:  Hold'em No Limit ($0.50/$1.00 USD) - 2016/03/23 14:16:13 CET [2016/03/23 9:16:13 ET]
Table 'Donar II' 9-max Seat #4 is the button
Seat 1: Effort92 ($100 in chips) 
Seat 2: nobrunobru1 ($63.14 in chips) 
Seat 3: st-germ30 ($102.29 in chips) 
Seat 4: DUkalisUA ($149.49 in chips) 
Seat 5: matiko09 ($101.04 in chips) 
Seat 6: ardo888 ($129.40 in chips) 
Seat 8: $-Twackle-$ ($104.40 in chips) 
Seat 9: oxfordtenzin ($122.69 in chips) 
matiko09: posts small blind $0.50
ardo888: posts big blind $1
JimineyCrik: sits out 
Effort92: posts the ante $0.20
nobrunobru1: posts the ante $0.20
st-germ30: posts the ante $0.20
DUkalisUA: posts the ante $0.20
matiko09: posts the ante $0.20
ardo888: posts the ante $0.20
$-Twackle-$: posts the ante $0.20
oxfordtenzin: posts the ante $0.20
*** HOLE CARDS ***
Dealt to matiko09 [Qh 3s]
$-Twackle-$: raises $2 to $3
oxfordtenzin: folds 
Effort92: folds 
nobrunobru1: folds 
st-germ30: folds 
DUkalisUA: folds 
matiko09: folds 
ardo888: folds 
Uncalled bet ($2) returned to $-Twackle-$
$-Twackle-$ collected $4.10 from pot
$-Twackle-$: doesn't show hand 
*** SUMMARY ***
Total pot $4.10 | Rake $0 
Seat 1: Effort92 folded before Flop (didn't bet)
Seat 2: nobrunobru1 folded before Flop (didn't bet)
Seat 3: st-germ30 folded before Flop (didn't bet)
Seat 4: DUkalisUA (button) folded before Flop (didn't bet)
Seat 5: matiko09 (small blind) folded before Flop
Seat 6: ardo888 (big blind) folded before Flop
Seat 8: $-Twackle-$ collected ($4.10)
Seat 9: oxfordtenzin folded before Flop (didn't bet)





PokerStars Hand #150800862378:  Hold'em No Limit ($1/$2 USD) - 2016/03/23 14:16:13 CET [2016/03/23 9:16:13 ET]
Table 'Achaia' 9-max Seat #1 is the button
Seat 1: ilaviiitech ($200 in chips) 
Seat 2: InsomniaRU ($224.66 in chips) 
Seat 3: matiko09 ($200 in chips) 
Seat 4: nailz83 ($209.46 in chips) 
Seat 5: DUkalisUA ($213.37 in chips) 
Seat 6: nickreason17 ($213.06 in chips) 
Seat 7: morosun ($179.09 in chips) 
Seat 8: $-Twackle-$ ($222.65 in chips) 
Seat 9: glanza_mike ($204.28 in chips) 
InsomniaRU: posts small blind $1
matiko09: posts big blind $2
*** HOLE CARDS ***
Dealt to matiko09 [9c Jc]
nailz83: calls $2
DUkalisUA: folds 
nickreason17: folds 
morosun: raises $4 to $6
$-Twackle-$: folds 
glanza_mike: folds 
ilaviiitech: folds 
InsomniaRU: folds 
matiko09: folds 
nailz83: calls $4
*** FLOP *** [9s Td 3d]
nailz83: checks 
morosun: bets $8
nailz83: calls $8
*** TURN *** [9s Td 3d] [Th]
nailz83: checks 
morosun: bets $8
nailz83: calls $8
*** RIVER *** [9s Td 3d Th] [5c]
nailz83: checks 
morosun: bets $10
nailz83: folds 
Uncalled bet ($10) returned to morosun
morosun collected $44.88 from pot
*** SUMMARY ***
Total pot $47 | Rake $2.12 
Board [9s Td 3d Th 5c]
Seat 1: ilaviiitech (button) folded before Flop (didn't bet)
Seat 2: InsomniaRU (small blind) folded before Flop
Seat 3: matiko09 (big blind) folded before Flop
Seat 4: nailz83 folded on the River
Seat 5: DUkalisUA folded before Flop (didn't bet)
Seat 6: nickreason17 folded before Flop (didn't bet)
Seat 7: morosun collected ($44.88)
Seat 8: $-Twackle-$ folded before Flop (didn't bet)
Seat 9: glanza_mike folded before Flop (didn't bet)





PokerStars Hand #150800861890:  Hold'em No Limit ($0.50/$1.00 USD) - 2016/03/23 14:16:13 CET [2016/03/23 9:16:13 ET]
Table 'Atlantis' 9-max Seat #5 is the button
Seat 1: xHourglass ($144.27 in chips) 
Seat 3: CAJUN890 ($105.79 in chips) 
Seat 4: matiko09 ($131.75 in chips) 
Seat 5: Pvsx. ($113.63 in chips) 
Seat 6: Jimy Tiltman ($140.36 in chips) 
Seat 7: Sherlockplay ($103.57 in chips) 
Seat 8: DUkalisUA ($102.50 in chips) 
Jimy Tiltman: posts small blind $0.50
Sherlockplay: posts big blind $1
*** HOLE CARDS ***
Dealt to matiko09 [Ac Qh]
DUkalisUA: folds 
xHourglass: folds 
CAJUN890: folds 
matiko09: raises $1.50 to $2.50
Pvsx.: folds 
Jimy Tiltman: raises $7.50 to $10
Sherlockplay: raises $12.50 to $22.50
matiko09: folds 
Jimy Tiltman: calls $12.50
*** FLOP *** [Kc 5d 4c]
Jimy Tiltman: checks 
Sherlockplay: bets $18.50
Jimy Tiltman: calls $18.50
*** TURN *** [Kc 5d 4c] [Kd]
Jimy Tiltman: checks 
Sherlockplay: bets $62.57 and is all-in
Jimy Tiltman: folds 
Uncalled bet ($62.57) returned to Sherlockplay
Sherlockplay collected $81.70 from pot
Sherlockplay: doesn't show hand 
*** SUMMARY ***
Total pot $84.50 | Rake $2.80 
Board [Kc 5d 4c Kd]
Seat 1: xHourglass folded before Flop (didn't bet)
Seat 3: CAJUN890 folded before Flop (didn't bet)
Seat 4: matiko09 folded before Flop
Seat 5: Pvsx. (button) folded before Flop (didn't bet)
Seat 6: Jimy Tiltman (small blind) folded on the Turn
Seat 7: Sherlockplay (big blind) collected ($81.70)
Seat 8: DUkalisUA folded before Flop (didn't bet)





PokerStars Hand #150800864721:  Hold'em No Limit ($0.50/$1.00 USD) - 2016/03/23 14:16:17 CET [2016/03/23 9:16:17 ET]
Table 'Merope II' 9-max Seat #3 is the button
Seat 1: Jimy Tiltman ($100 in chips) 
Seat 2: $-Twackle-$ ($114.17 in chips) 
Seat 3: pablos1922 ($102.71 in chips) 
Seat 4: YuriiSolodya ($85.09 in chips) 
Seat 5: DUkalisUA ($145.14 in chips) 
Seat 6: Effort92 ($100 in chips) 
Seat 7: matiko09 ($110.73 in chips) 
Seat 8: titentei ($93.50 in chips) 
YuriiSolodya: posts small blind $0.50
DUkalisUA: posts big blind $1
*** HOLE CARDS ***
Dealt to matiko09 [Kc 6c]
Effort92: folds 
matiko09: folds 
titentei: folds 
Jimy Tiltman: folds 
$-Twackle-$: folds 
pablos1922: raises $2 to $3
YuriiSolodya: folds 
DUkalisUA: calls $2
*** FLOP *** [7s Ad 2s]
DUkalisUA: checks 
pablos1922: checks 
*** TURN *** [7s Ad 2s] [3d]
DUkalisUA: checks 
pablos1922: bets $3.10
DUkalisUA: folds 
Uncalled bet ($3.10) returned to pablos1922
pablos1922 collected $6.21 from pot
pablos1922: doesn't show hand 
*** SUMMARY ***
Total pot $6.50 | Rake $0.29 
Board [7s Ad 2s 3d]
Seat 1: Jimy Tiltman folded before Flop (didn't bet)
Seat 2: $-Twackle-$ folded before Flop (didn't bet)
Seat 3: pablos1922 (button) collected ($6.21)
Seat 4: YuriiSolodya (small blind) folded before Flop
Seat 5: DUkalisUA (big blind) folded on the Turn
Seat 6: Effort92 folded before Flop (didn't bet)
Seat 7: matiko09 folded before Flop (didn't bet)
Seat 8: titentei folded before Flop (didn't bet)





PokerStars Hand #150800869332:  Hold'em No Limit ($0.25/$0.50 USD) - 2016/03/23 14:16:25 CET [2016/03/23 9:16:25 ET]
Table 'Pyrrhus' 9-max Seat #6 is the button
Seat 1: lumen21 ($80.16 in chips) 
Seat 2: alemão007 ($48.75 in chips) 
Seat 3: i L00K great ($50 in chips) 
Seat 4: GriffinBerg ($34.38 in chips) 
Seat 5: ZonTTT ($50 in chips) 
Seat 6: Ahangama ($50 in chips) 
Seat 7: matiko09 ($135.44 in chips) 
Seat 8: dndngod ($84.52 in chips) 
Seat 9: CvMCvMCvM ($96.61 in chips) 
matiko09: posts small blind $0.25
dndngod: posts big blind $0.50
*** HOLE CARDS ***
Dealt to matiko09 [4s Qs]
CvMCvMCvM: folds 
lumen21: folds 
alemão007: folds 
i L00K great: folds 
GriffinBerg: folds 
ZonTTT: raises $0.75 to $1.25
Ahangama: folds 
matiko09: folds 
dndngod: calls $0.75
*** FLOP *** [6h 4d 9s]
dndngod: checks 
ZonTTT: bets $1.75
dndngod: calls $1.75
*** TURN *** [6h 4d 9s] [9d]
dndngod: checks 
ZonTTT: bets $4
dndngod: calls $4
*** RIVER *** [6h 4d 9s 9d] [Jd]
dndngod: checks 
ZonTTT: checks 
*** SHOW DOWN ***
dndngod: shows [6s 7s] (two pair, Nines and Sixes)
ZonTTT: shows [Qd Qc] (two pair, Queens and Nines)
ZonTTT collected $13.61 from pot
*** SUMMARY ***
Total pot $14.25 | Rake $0.64 
Board [6h 4d 9s 9d Jd]
Seat 1: lumen21 folded before Flop (didn't bet)
Seat 2: alemão007 folded before Flop (didn't bet)
Seat 3: i L00K great folded before Flop (didn't bet)
Seat 4: GriffinBerg folded before Flop (didn't bet)
Seat 5: ZonTTT showed [Qd Qc] and won ($13.61) with two pair, Queens and Nines
Seat 6: Ahangama (button) folded before Flop (didn't bet)
Seat 7: matiko09 (small blind) folded before Flop
Seat 8: dndngod (big blind) showed [6s 7s] and lost with two pair, Nines and Sixes
Seat 9: CvMCvMCvM folded before Flop (didn't bet)





PokerStars Hand #150800872077:  Hold'em No Limit ($1/$2 USD) - 2016/03/23 14:16:30 CET [2016/03/23 9:16:30 ET]
Table 'Herba II' 9-max Seat #5 is the button
Seat 1: matiko09 ($200 in chips) 
Seat 2: Moszes360 ($204.89 in chips) 
Seat 3: Cirilico ($160 in chips) 
Seat 4: DUkalisUA ($298.48 in chips) 
Seat 5: chippo boy ($268.38 in chips) 
Seat 6: Too-Anti-To ($213.46 in chips) 
Seat 7: InsomniaRU ($204.78 in chips) 
Seat 8: The_red_area ($445.98 in chips) 
Seat 9: mrhighryza ($56.43 in chips) 
Too-Anti-To: posts small blind $1
InsomniaRU: posts big blind $2
*** HOLE CARDS ***
Dealt to matiko09 [7c 8s]
The_red_area: folds 
mrhighryza: calls $2
matiko09: folds 
Moszes360: folds 
Cirilico: raises $4 to $6
DUkalisUA: folds 
chippo boy: folds 
Too-Anti-To: folds 
InsomniaRU: folds 
mrhighryza: calls $4
*** FLOP *** [2c Ad 4h]
mrhighryza: checks 
Cirilico: checks 
*** TURN *** [2c Ad 4h] [3c]
mrhighryza: checks 
Cirilico: checks 
*** RIVER *** [2c Ad 4h 3c] [Tc]
mrhighryza: checks 
Cirilico: checks 
*** SHOW DOWN ***
mrhighryza: shows [9h Kh] (high card Ace)
Cirilico: shows [7s 7h] (a pair of Sevens)
Cirilico collected $14.32 from pot
*** SUMMARY ***
Total pot $15 | Rake $0.68 
Board [2c Ad 4h 3c Tc]
Seat 1: matiko09 folded before Flop (didn't bet)
Seat 2: Moszes360 folded before Flop (didn't bet)
Seat 3: Cirilico showed [7s 7h] and won ($14.32) with a pair of Sevens
Seat 4: DUkalisUA folded before Flop (didn't bet)
Seat 5: chippo boy (button) folded before Flop (didn't bet)
Seat 6: Too-Anti-To (small blind) folded before Flop
Seat 7: InsomniaRU (big blind) folded before Flop
Seat 8: The_red_area folded before Flop (didn't bet)
Seat 9: mrhighryza showed [9h Kh] and lost with high card Ace





PokerStars Hand #150800880641:  Hold'em No Limit ($1/$2 USD) - 2016/03/23 14:16:44 CET [2016/03/23 9:16:44 ET]
Table 'Kypria II' 9-max Seat #5 is the button
Seat 1: geldwolfje ($76.90 in chips) 
Seat 2: coinflip_si ($222.70 in chips) 
Seat 3: seouljam ($182.45 in chips) 
Seat 4: VolanDog ($200 in chips) 
Seat 5: InsomniaRU ($400.78 in chips) 
Seat 6: matiko09 ($357.95 in chips) 
Seat 7: DUkalisUA ($207.37 in chips) 
Seat 8: Cirilico ($240.20 in chips) 
Seat 9: Moszes360 ($200 in chips) 
matiko09: posts small blind $1
DUkalisUA: posts big blind $2
*** HOLE CARDS ***
Dealt to matiko09 [3s Kc]
Cirilico: raises $4 to $6
Moszes360: folds 
geldwolfje: folds 
coinflip_si: folds 
seouljam: folds 
VolanDog: folds 
InsomniaRU: folds 
matiko09: folds 
DUkalisUA: folds 
Uncalled bet ($4) returned to Cirilico
Cirilico collected $5 from pot
Cirilico: doesn't show hand 
*** SUMMARY ***
Total pot $5 | Rake $0 
Seat 1: geldwolfje folded before Flop (didn't bet)
Seat 2: coinflip_si folded before Flop (didn't bet)
Seat 3: seouljam folded before Flop (didn't bet)
Seat 4: VolanDog folded before Flop (didn't bet)
Seat 5: InsomniaRU (button) folded before Flop (didn't bet)
Seat 6: matiko09 (small blind) folded before Flop
Seat 7: DUkalisUA (big blind) folded before Flop
Seat 8: Cirilico collected ($5)
Seat 9: Moszes360 folded before Flop (didn't bet)





PokerStars Hand #150800884396:  Hold'em No Limit ($1/$2 USD) - 2016/03/23 14:16:50 CET [2016/03/23 9:16:50 ET]
Table 'Deipylos II' 9-max Seat #7 is the button
Seat 1: $-Twackle-$ ($200 in chips) 
Seat 2: T0ny Adams ($82 in chips) 
Seat 4: matiko09 ($203 in chips) 
Seat 5: InsomniaRU ($203 in chips) 
Seat 6: nickreason17 ($200 in chips) 
Seat 7: volwebni4ek ($80 in chips) 
Seat 8: Igoriah ($200 in chips) 
Seat 9: Ranatuo84 ($228.36 in chips) 
Igoriah: posts small blind $1
Ranatuo84: posts big blind $2
*** HOLE CARDS ***
Dealt to matiko09 [7d Qs]
$-Twackle-$: raises $4 to $6
T0ny Adams: folds 
matiko09: folds 
InsomniaRU: folds 
nickreason17: folds 
volwebni4ek: folds 
Igoriah: folds 
Ranatuo84: calls $4
*** FLOP *** [Kd 3c Td]
Ranatuo84: checks 
$-Twackle-$: checks 
*** TURN *** [Kd 3c Td] [8h]
Ranatuo84: bets $2
$-Twackle-$: calls $2
*** RIVER *** [Kd 3c Td 8h] [Ah]
Ranatuo84: bets $2
$-Twackle-$: calls $2
*** SHOW DOWN ***
Ranatuo84: shows [9d 9c] (a pair of Nines)
$-Twackle-$: mucks hand 
Ranatuo84 collected $20.06 from pot
*** SUMMARY ***
Total pot $21 | Rake $0.94 
Board [Kd 3c Td 8h Ah]
Seat 1: $-Twackle-$ mucked [8s 7s]
Seat 2: T0ny Adams folded before Flop (didn't bet)
Seat 4: matiko09 folded before Flop (didn't bet)
Seat 5: InsomniaRU folded before Flop (didn't bet)
Seat 6: nickreason17 folded before Flop (didn't bet)
Seat 7: volwebni4ek (button) folded before Flop (didn't bet)
Seat 8: Igoriah (small blind) folded before Flop
Seat 9: Ranatuo84 (big blind) showed [9d 9c] and won ($20.06) with a pair of Nines





PokerStars Hand #150800889048:  Hold'em No Limit ($0.50/$1.00 USD) - 2016/03/23 14:16:58 CET [2016/03/23 9:16:58 ET]
Table 'Kippes' 9-max Seat #9 is the button
Seat 1: Pvsx. ($120.68 in chips) 
Seat 3: CAJUN890 ($113.05 in chips) 
Seat 4: matiko09 ($100 in chips) 
Seat 5: Jimy Tiltman ($131.10 in chips) 
Seat 6: DUkalisUA ($114.86 in chips) 
Seat 7: lumen21 ($100 in chips) 
Seat 8: Sherlockplay ($100 in chips) 
Seat 9: wang19790906 ($90.93 in chips) 
Pvsx.: posts small blind $0.50
RICKA16: is sitting out 
CAJUN890: posts big blind $1
*** HOLE CARDS ***
Dealt to matiko09 [3d 5h]
matiko09: folds 
Jimy Tiltman: folds 
DUkalisUA: folds 
lumen21: folds 
Sherlockplay: folds 
wang19790906: raises $2 to $3
Pvsx.: folds 
CAJUN890: folds 
Uncalled bet ($2) returned to wang19790906
wang19790906 collected $2.50 from pot
wang19790906: doesn't show hand 
*** SUMMARY ***
Total pot $2.50 | Rake $0 
Seat 1: Pvsx. (small blind) folded before Flop
Seat 3: CAJUN890 (big blind) folded before Flop
Seat 4: matiko09 folded before Flop (didn't bet)
Seat 5: Jimy Tiltman folded before Flop (didn't bet)
Seat 6: DUkalisUA folded before Flop (didn't bet)
Seat 7: lumen21 folded before Flop (didn't bet)
Seat 8: Sherlockplay folded before Flop (didn't bet)
Seat 9: wang19790906 (button) collected ($2.50)





PokerStars Hand #150800893353:  Hold'em No Limit ($0.25/$0.50 USD) - 2016/03/23 14:17:05 CET [2016/03/23 9:17:05 ET]
Table 'Belnika' 9-max Seat #4 is the button
Seat 1: yellowfever0 ($8.62 in chips) 
Seat 2: NeverRegret7 ($50.27 in chips) 
Seat 3: RyMorgy ($59.54 in chips) 
Seat 4: matiko09 ($69.28 in chips) 
Seat 5: ZonTTT ($50 in chips) 
Seat 6: Ahangama ($50 in chips) 
Seat 7: CvMCvMCvM ($62.56 in chips) 
Seat 8: lumen21 ($62.47 in chips) 
Seat 9: dndngod ($68.89 in chips) 
ZonTTT: posts small blind $0.25
Ahangama: posts big blind $0.50
*** HOLE CARDS ***
Dealt to matiko09 [8d 3s]
CvMCvMCvM: folds 
lumen21: folds 
dndngod: folds 
yellowfever0: raises $1 to $1.50
NeverRegret7: folds 
RyMorgy: folds 
matiko09: folds 
ZonTTT: folds 
Ahangama: folds 
Uncalled bet ($1) returned to yellowfever0
yellowfever0 collected $1.25 from pot
*** SUMMARY ***
Total pot $1.25 | Rake $0 
Seat 1: yellowfever0 collected ($1.25)
Seat 2: NeverRegret7 folded before Flop (didn't bet)
Seat 3: RyMorgy folded before Flop (didn't bet)
Seat 4: matiko09 (button) folded before Flop (didn't bet)
Seat 5: ZonTTT (small blind) folded before Flop
Seat 6: Ahangama (big blind) folded before Flop
Seat 7: CvMCvMCvM folded before Flop (didn't bet)
Seat 8: lumen21 folded before Flop (didn't bet)
Seat 9: dndngod folded before Flop (didn't bet)





PokerStars Hand #150800897515:  Hold'em No Limit ($1/$2 USD) - 2016/03/23 14:17:11 CET [2016/03/23 9:17:11 ET]
Table 'Kypria II' 9-max Seat #6 is the button
Seat 1: geldwolfje ($76.90 in chips) 
Seat 2: coinflip_si ($222.70 in chips) 
Seat 3: seouljam ($182.45 in chips) 
Seat 4: VolanDog ($200 in chips) 
Seat 5: InsomniaRU ($400.78 in chips) 
Seat 6: matiko09 ($356.95 in chips) 
Seat 7: DUkalisUA ($205.37 in chips) 
Seat 9: Moszes360 ($200 in chips) 
DUkalisUA: posts small blind $1
Cirilico: is sitting out 
Moszes360: posts big blind $2
*** HOLE CARDS ***
Dealt to matiko09 [Ac 3c]
geldwolfje: folds 
coinflip_si: folds 
seouljam: folds 
VolanDog: folds 
Cirilico leaves the table
InsomniaRU: folds 
Pearl Jam87 joins the table at seat #8 
matiko09: raises $2.54 to $4.54
DUkalisUA: folds 
Moszes360: raises $11.46 to $16
geldwolfje said, "ak"
matiko09: raises $20 to $36
Moszes360: folds 
Uncalled bet ($20) returned to matiko09
matiko09 collected $33 from pot
matiko09: doesn't show hand 
*** SUMMARY ***
Total pot $33 | Rake $0 
Seat 1: geldwolfje folded before Flop (didn't bet)
Seat 2: coinflip_si folded before Flop (didn't bet)
Seat 3: seouljam folded before Flop (didn't bet)
Seat 4: VolanDog folded before Flop (didn't bet)
Seat 5: InsomniaRU folded before Flop (didn't bet)
Seat 6: matiko09 (button) collected ($33)
Seat 7: DUkalisUA (small blind) folded before Flop
Seat 9: Moszes360 (big blind) folded before Flop





PokerStars Hand #150800901986:  Hold'em No Limit ($0.50/$1.00 USD) - 2016/03/23 14:17:19 CET [2016/03/23 9:17:19 ET]
Table 'Merope II' 9-max Seat #4 is the button
Seat 1: Jimy Tiltman ($100 in chips) 
Seat 2: $-Twackle-$ ($114.17 in chips) 
Seat 3: pablos1922 ($105.92 in chips) 
Seat 4: YuriiSolodya ($84.59 in chips) 
Seat 5: DUkalisUA ($142.14 in chips) 
Seat 6: Effort92 ($100 in chips) 
Seat 7: matiko09 ($110.73 in chips) 
Seat 8: titentei ($93.50 in chips) 
DUkalisUA: posts small blind $0.50
Effort92: posts big blind $1
*** HOLE CARDS ***
Dealt to matiko09 [5c 7c]
matiko09: folds 
titentei: folds 
Jimy Tiltman: raises $2 to $3
$-Twackle-$: raises $6 to $9
pablos1922: folds 
YuriiSolodya: folds 
DUkalisUA: folds 
Effort92: folds 
Jimy Tiltman: calls $6
*** FLOP *** [Tc 8c Kh]
Jimy Tiltman: checks 
$-Twackle-$: bets $9.50
Jimy Tiltman: raises $16.50 to $26
$-Twackle-$: calls $16.50
*** TURN *** [Tc 8c Kh] [5h]
Jimy Tiltman: bets $65 and is all-in
$-Twackle-$: folds 
Uncalled bet ($65) returned to Jimy Tiltman
Jimy Tiltman collected $68.70 from pot
Jimy Tiltman: doesn't show hand 
*** SUMMARY ***
Total pot $71.50 | Rake $2.80 
Board [Tc 8c Kh 5h]
Seat 1: Jimy Tiltman collected ($68.70)
Seat 2: $-Twackle-$ folded on the Turn
Seat 3: pablos1922 folded before Flop (didn't bet)
Seat 4: YuriiSolodya (button) folded before Flop (didn't bet)
Seat 5: DUkalisUA (small blind) folded before Flop
Seat 6: Effort92 (big blind) folded before Flop
Seat 7: matiko09 folded before Flop (didn't bet)
Seat 8: titentei folded before Flop (didn't bet)





PokerStars Hand #150800909488:  Hold'em No Limit ($0.25/$0.50 USD) - 2016/03/23 14:17:31 CET [2016/03/23 9:17:31 ET]
Table 'Pyrrhus' 9-max Seat #7 is the button
Seat 1: lumen21 ($80.16 in chips) 
Seat 2: alemão007 ($48.75 in chips) 
Seat 3: i L00K great ($50 in chips) 
Seat 4: GriffinBerg ($34.38 in chips) 
Seat 5: ZonTTT ($56.61 in chips) 
Seat 6: Ahangama ($50 in chips) 
Seat 7: matiko09 ($135.19 in chips) 
Seat 8: dndngod ($77.52 in chips) 
Seat 9: CvMCvMCvM ($96.61 in chips) 
dndngod: posts small blind $0.25
CvMCvMCvM: posts big blind $0.50
*** HOLE CARDS ***
Dealt to matiko09 [Ad Js]
lumen21: folds 
alemão007: folds 
i L00K great: folds 
GriffinBerg has timed out while being disconnected
GriffinBerg: folds 
ZonTTT: folds 
Ahangama: folds 
matiko09: raises $0.63 to $1.13
dndngod: folds 
CvMCvMCvM: calls $0.63
*** FLOP *** [3c Kc Tc]
CvMCvMCvM: checks 
matiko09: checks 
*** TURN *** [3c Kc Tc] [9s]
CvMCvMCvM: bets $1.72
matiko09: folds 
Uncalled bet ($1.72) returned to CvMCvMCvM
CvMCvMCvM collected $2.40 from pot
CvMCvMCvM: doesn't show hand 
*** SUMMARY ***
Total pot $2.51 | Rake $0.11 
Board [3c Kc Tc 9s]
Seat 1: lumen21 folded before Flop (didn't bet)
Seat 2: alemão007 folded before Flop (didn't bet)
Seat 3: i L00K great folded before Flop (didn't bet)
Seat 4: GriffinBerg folded before Flop (didn't bet)
Seat 5: ZonTTT folded before Flop (didn't bet)
Seat 6: Ahangama folded before Flop (didn't bet)
Seat 7: matiko09 (button) folded on the Turn
Seat 8: dndngod (small blind) folded before Flop
Seat 9: CvMCvMCvM (big blind) collected ($2.40)





PokerStars Hand #150800910705:  Hold'em No Limit ($0.50/$1.00 USD) - 2016/03/23 14:17:33 CET [2016/03/23 9:17:33 ET]
Table 'Donar II' 9-max Seat #5 is the button
Seat 1: Effort92 ($100 in chips) 
Seat 2: nobrunobru1 ($62.94 in chips) 
Seat 3: st-germ30 ($102.09 in chips) 
Seat 4: DUkalisUA ($149.29 in chips) 
Seat 5: matiko09 ($100.34 in chips) 
Seat 6: ardo888 ($128.20 in chips) 
Seat 7: JimineyCrik ($92.45 in chips) 
Seat 8: $-Twackle-$ ($107.30 in chips) 
Seat 9: oxfordtenzin ($122.49 in chips) 
ardo888: posts small blind $0.50
JimineyCrik: posts big blind $1
Effort92: posts the ante $0.20
nobrunobru1: posts the ante $0.20
st-germ30: posts the ante $0.20
DUkalisUA: posts the ante $0.20
matiko09: posts the ante $0.20
ardo888: posts the ante $0.20
JimineyCrik: posts the ante $0.20
$-Twackle-$: posts the ante $0.20
oxfordtenzin: posts the ante $0.20
*** HOLE CARDS ***
Dealt to matiko09 [Ks Td]
$-Twackle-$: folds 
oxfordtenzin: folds 
Effort92: folds 
nobrunobru1: folds 
st-germ30: folds 
DUkalisUA: folds 
matiko09: raises $1.50 to $2.50
ardo888: raises $7 to $9.50
JimineyCrik: folds 
matiko09: folds 
Uncalled bet ($7) returned to ardo888
ardo888 collected $7.80 from pot
ardo888: doesn't show hand 
*** SUMMARY ***
Total pot $7.80 | Rake $0 
Seat 1: Effort92 folded before Flop (didn't bet)
Seat 2: nobrunobru1 folded before Flop (didn't bet)
Seat 3: st-germ30 folded before Flop (didn't bet)
Seat 4: DUkalisUA folded before Flop (didn't bet)
Seat 5: matiko09 (button) folded before Flop
Seat 6: ardo888 (small blind) collected ($7.80)
Seat 7: JimineyCrik (big blind) folded before Flop
Seat 8: $-Twackle-$ folded before Flop (didn't bet)
Seat 9: oxfordtenzin folded before Flop (didn't bet)





PokerStars Hand #150800910609:  Hold'em No Limit ($1/$2 USD) - 2016/03/23 14:17:33 CET [2016/03/23 9:17:33 ET]
Table 'Achaia' 9-max Seat #2 is the button
Seat 1: ilaviiitech ($200 in chips) 
Seat 2: InsomniaRU ($223.66 in chips) 
Seat 3: matiko09 ($200 in chips) 
Seat 4: nailz83 ($187.46 in chips) 
Seat 5: DUkalisUA ($213.37 in chips) 
Seat 6: nickreason17 ($213.06 in chips) 
Seat 7: morosun ($201.97 in chips) 
Seat 8: $-Twackle-$ ($222.65 in chips) 
Seat 9: glanza_mike ($204.28 in chips) 
matiko09: posts small blind $1
nailz83: posts big blind $2
*** HOLE CARDS ***
Dealt to matiko09 [4s 2c]
DUkalisUA: folds 
nickreason17: folds 
morosun: calls $2
$-Twackle-$: folds 
glanza_mike: folds 
ilaviiitech: folds 
InsomniaRU: folds 
matiko09: folds 
nailz83: checks 
*** FLOP *** [Ad 7c Jh]
nailz83: checks 
morosun: bets $4
nailz83: calls $4
*** TURN *** [Ad 7c Jh] [Ks]
nailz83: checks 
morosun: bets $4
nailz83: calls $4
*** RIVER *** [Ad 7c Jh Ks] [8s]
nailz83: checks 
morosun: checks 
*** SHOW DOWN ***
nailz83: shows [Td 7d] (a pair of Sevens)
morosun: shows [6s As] (a pair of Aces)
morosun collected $20.06 from pot
*** SUMMARY ***
Total pot $21 | Rake $0.94 
Board [Ad 7c Jh Ks 8s]
Seat 1: ilaviiitech folded before Flop (didn't bet)
Seat 2: InsomniaRU (button) folded before Flop (didn't bet)
Seat 3: matiko09 (small blind) folded before Flop
Seat 4: nailz83 (big blind) showed [Td 7d] and lost with a pair of Sevens
Seat 5: DUkalisUA folded before Flop (didn't bet)
Seat 6: nickreason17 folded before Flop (didn't bet)
Seat 7: morosun showed [6s As] and won ($20.06) with a pair of Aces
Seat 8: $-Twackle-$ folded before Flop (didn't bet)
Seat 9: glanza_mike folded before Flop (didn't bet)





PokerStars Hand #150800911639:  Hold'em No Limit ($1/$2 USD) - 2016/03/23 14:17:34 CET [2016/03/23 9:17:34 ET]
Table 'Kiess' 9-max Seat #3 is the button
Seat 1: Cirilico ($198.86 in chips) 
Seat 2: DUkalisUA ($688.10 in chips) 
Seat 3: The_red_area ($388.79 in chips) 
Seat 4: Moszes360 ($200 in chips) 
Seat 5: chippo boy ($474.32 in chips) 
Seat 6: matiko09 ($274.84 in chips) 
Seat 7: InsomniaRU ($274.37 in chips) 
Seat 8: erfk1958 ($123.55 in chips) 
Seat 9: nickreason17 ($200 in chips) 
Moszes360: posts small blind $1
chippo boy: posts big blind $2
*** HOLE CARDS ***
Dealt to matiko09 [9h Td]
matiko09: folds 
InsomniaRU: folds 
erfk1958: raises $2 to $4
nickreason17: folds 
Cirilico: raises $10 to $14
DUkalisUA: calls $14
The_red_area: folds 
Moszes360: folds 
chippo boy: calls $12
erfk1958: folds 
*** FLOP *** [5d Ks Kd]
chippo boy: checks 
Cirilico: bets $22.44
DUkalisUA: folds 
chippo boy: folds 
Uncalled bet ($22.44) returned to Cirilico
Cirilico collected $44.88 from pot
Cirilico: doesn't show hand 
*** SUMMARY ***
Total pot $47 | Rake $2.12 
Board [5d Ks Kd]
Seat 1: Cirilico collected ($44.88)
Seat 2: DUkalisUA folded on the Flop
Seat 3: The_red_area (button) folded before Flop (didn't bet)
Seat 4: Moszes360 (small blind) folded before Flop
Seat 5: chippo boy (big blind) folded on the Flop
Seat 6: matiko09 folded before Flop (didn't bet)
Seat 7: InsomniaRU folded before Flop (didn't bet)
Seat 8: erfk1958 folded before Flop
Seat 9: nickreason17 folded before Flop (didn't bet)





PokerStars Hand #150800914593:  Hold'em No Limit ($0.50/$1.00 USD) - 2016/03/23 14:17:39 CET [2016/03/23 9:17:39 ET]
Table 'Atlantis' 9-max Seat #6 is the button
Seat 1: xHourglass ($144.27 in chips) 
Seat 2: tffff2006 ($55.84 in chips) 
Seat 3: CAJUN890 ($105.79 in chips) 
Seat 4: matiko09 ($129.25 in chips) 
Seat 5: Pvsx. ($113.63 in chips) 
Seat 6: Jimy Tiltman ($100 in chips) 
Seat 7: Sherlockplay ($144.27 in chips) 
Seat 8: DUkalisUA ($102.50 in chips) 
Sherlockplay: posts small blind $0.50
DUkalisUA: posts big blind $1
*** HOLE CARDS ***
Dealt to matiko09 [7c Ac]
xHourglass: folds 
tffff2006 has timed out
tffff2006: folds 
CAJUN890: folds 
matiko09: raises $2 to $3
Pvsx.: folds 
Jimy Tiltman: folds 
Sherlockplay: folds 
DUkalisUA: folds 
Uncalled bet ($2) returned to matiko09
matiko09 collected $2.50 from pot
matiko09: doesn't show hand 
*** SUMMARY ***
Total pot $2.50 | Rake $0 
Seat 1: xHourglass folded before Flop (didn't bet)
Seat 2: tffff2006 folded before Flop (didn't bet)
Seat 3: CAJUN890 folded before Flop (didn't bet)
Seat 4: matiko09 collected ($2.50)
Seat 5: Pvsx. folded before Flop (didn't bet)
Seat 6: Jimy Tiltman (button) folded before Flop (didn't bet)
Seat 7: Sherlockplay (small blind) folded before Flop
Seat 8: DUkalisUA (big blind) folded before Flop





PokerStars Hand #150800914916:  Hold'em No Limit ($0.25/$0.50 USD) - 2016/03/23 14:17:40 CET [2016/03/23 9:17:40 ET]
Table 'Belnika' 9-max Seat #5 is the button
Seat 1: yellowfever0 ($9.37 in chips) 
Seat 2: NeverRegret7 ($50.27 in chips) 
Seat 3: RyMorgy ($59.54 in chips) 
Seat 4: matiko09 ($69.28 in chips) 
Seat 5: ZonTTT ($50 in chips) 
Seat 6: Ahangama ($50 in chips) 
Seat 7: CvMCvMCvM ($62.56 in chips) 
Seat 8: lumen21 ($62.47 in chips) 
Seat 9: dndngod ($68.89 in chips) 
Ahangama: posts small blind $0.25
CvMCvMCvM: posts big blind $0.50
*** HOLE CARDS ***
Dealt to matiko09 [4d 9c]
lumen21: folds 
dndngod: folds 
yellowfever0: raises $1 to $1.50
NeverRegret7: folds 
RyMorgy: folds 
matiko09: folds 
ZonTTT: folds 
Ahangama: folds 
CvMCvMCvM: folds 
Uncalled bet ($1) returned to yellowfever0
yellowfever0 collected $1.25 from pot
yellowfever0: doesn't show hand 
*** SUMMARY ***
Total pot $1.25 | Rake $0 
Seat 1: yellowfever0 collected ($1.25)
Seat 2: NeverRegret7 folded before Flop (didn't bet)
Seat 3: RyMorgy folded before Flop (didn't bet)
Seat 4: matiko09 folded before Flop (didn't bet)
Seat 5: ZonTTT (button) folded before Flop (didn't bet)
Seat 6: Ahangama (small blind) folded before Flop
Seat 7: CvMCvMCvM (big blind) folded before Flop
Seat 8: lumen21 folded before Flop (didn't bet)
Seat 9: dndngod folded before Flop (didn't bet)





PokerStars Hand #150800915457:  Hold'em No Limit ($0.50/$1.00 USD) - 2016/03/23 14:17:41 CET [2016/03/23 9:17:41 ET]
Table 'Kippes' 9-max Seat #1 is the button
Seat 1: Pvsx. ($120.18 in chips) 
Seat 3: CAJUN890 ($112.05 in chips) 
Seat 4: matiko09 ($100 in chips) 
Seat 5: Jimy Tiltman ($131.10 in chips) 
Seat 6: DUkalisUA ($114.86 in chips) 
Seat 7: lumen21 ($100 in chips) 
Seat 8: Sherlockplay ($100 in chips) 
Seat 9: wang19790906 ($92.43 in chips) 
CAJUN890: posts small blind $0.50
matiko09: posts big blind $1
*** HOLE CARDS ***
Dealt to matiko09 [6d 6s]
Jimy Tiltman: folds 
DUkalisUA: folds 
lumen21: folds 
Sherlockplay: folds 
wang19790906: folds 
Pvsx.: folds 
CAJUN890: raises $2 to $3
matiko09: calls $2
*** FLOP *** [4c 2h 7c]
CAJUN890: bets $2.86
matiko09: calls $2.86
*** TURN *** [4c 2h 7c] [2s]
CAJUN890: bets $5.59
matiko09: calls $5.59
*** RIVER *** [4c 2h 7c 2s] [Jc]
CAJUN890: bets $10.93
matiko09: folds 
Uncalled bet ($10.93) returned to CAJUN890
CAJUN890 collected $21.87 from pot
CAJUN890: doesn't show hand 
*** SUMMARY ***
Total pot $22.90 | Rake $1.03 
Board [4c 2h 7c 2s Jc]
Seat 1: Pvsx. (button) folded before Flop (didn't bet)
Seat 3: CAJUN890 (small blind) collected ($21.87)
Seat 4: matiko09 (big blind) folded on the River
Seat 5: Jimy Tiltman folded before Flop (didn't bet)
Seat 6: DUkalisUA folded before Flop (didn't bet)
Seat 7: lumen21 folded before Flop (didn't bet)
Seat 8: Sherlockplay folded before Flop (didn't bet)
Seat 9: wang19790906 folded before Flop (didn't bet)





PokerStars Hand #150800919281:  Hold'em No Limit ($1/$2 USD) - 2016/03/23 14:17:47 CET [2016/03/23 9:17:47 ET]
Table 'Ennomos II' 9-max Seat #4 is the button
Seat 1: ilaviiitech ($200 in chips) 
Seat 2: Subam ($210.66 in chips) 
Seat 3: $-Twackle-$ ($200 in chips) 
Seat 4: glanza_mike ($202.32 in chips) 
Seat 5: South011 ($385.88 in chips) 
Seat 6: nickreason17 ($237.98 in chips) 
Seat 7: daniferdoser ($200 in chips) 
Seat 8: yyfk ($200 in chips) 
Seat 9: matiko09 ($200 in chips) 
South011: posts small blind $1
nickreason17: posts big blind $2
*** HOLE CARDS ***
Dealt to matiko09 [2h Kc]
daniferdoser: folds 
yyfk: folds 
matiko09: folds 
ilaviiitech: folds 
Subam: raises $2 to $4
yyfk said, "nh"
$-Twackle-$: calls $4
glanza_mike: raises $13 to $17
South011: folds 
nickreason17: folds 
Subam: calls $13
$-Twackle-$: calls $13
*** FLOP *** [Ac 3h 7h]
Subam: checks 
$-Twackle-$: checks 
glanza_mike: bets $17.01
Subam: calls $17.01
$-Twackle-$: folds 
*** TURN *** [Ac 3h 7h] [Tc]
Subam: checks 
glanza_mike: bets $42.61
Subam: calls $42.61
*** RIVER *** [Ac 3h 7h Tc] [Ah]
Subam: checks 
glanza_mike: bets $125.70 and is all-in
Subam: calls $125.70
*** SHOW DOWN ***
glanza_mike: shows [5c 4c] (a pair of Aces)
Subam: shows [Qc Ad] (three of a kind, Aces)
Subam collected $421.84 from pot
*** SUMMARY ***
Total pot $424.64 | Rake $2.80 
Board [Ac 3h 7h Tc Ah]
Seat 1: ilaviiitech folded before Flop (didn't bet)
Seat 2: Subam showed [Qc Ad] and won ($421.84) with three of a kind, Aces
Seat 3: $-Twackle-$ folded on the Flop
Seat 4: glanza_mike (button) showed [5c 4c] and lost with a pair of Aces
Seat 5: South011 (small blind) folded before Flop
Seat 6: nickreason17 (big blind) folded before Flop
Seat 7: daniferdoser folded before Flop (didn't bet)
Seat 8: yyfk folded before Flop (didn't bet)
Seat 9: matiko09 folded before Flop (didn't bet)





PokerStars Hand #150800924182:  Hold'em No Limit ($1/$2 USD) - 2016/03/23 14:17:55 CET [2016/03/23 9:17:55 ET]
Table 'Herba II' 9-max Seat #6 is the button
Seat 1: matiko09 ($200 in chips) 
Seat 2: Moszes360 ($204.89 in chips) 
Seat 3: Cirilico ($168.32 in chips) 
Seat 4: DUkalisUA ($298.48 in chips) 
Seat 5: chippo boy ($268.38 in chips) 
Seat 6: Too-Anti-To ($212.46 in chips) 
Seat 7: InsomniaRU ($202.78 in chips) 
Seat 8: The_red_area ($445.98 in chips) 
Seat 9: mrhighryza ($50.43 in chips) 
InsomniaRU: posts small blind $1
The_red_area: posts big blind $2
*** HOLE CARDS ***
Dealt to matiko09 [Ad Qs]
mrhighryza: folds 
matiko09: raises $3 to $5
Moszes360: folds 
Cirilico: calls $5
DUkalisUA: folds 
chippo boy: calls $5
Too-Anti-To: folds 
InsomniaRU: folds 
The_red_area: calls $3
*** FLOP *** [8c Qh 2s]
The_red_area: checks 
matiko09: bets $13.04
Cirilico: folds 
chippo boy: folds 
The_red_area: folds 
Uncalled bet ($13.04) returned to matiko09
matiko09 collected $20.06 from pot
matiko09: doesn't show hand 
*** SUMMARY ***
Total pot $21 | Rake $0.94 
Board [8c Qh 2s]
Seat 1: matiko09 collected ($20.06)
Seat 2: Moszes360 folded before Flop (didn't bet)
Seat 3: Cirilico folded on the Flop
Seat 4: DUkalisUA folded before Flop (didn't bet)
Seat 5: chippo boy folded on the Flop
Seat 6: Too-Anti-To (button) folded before Flop (didn't bet)
Seat 7: InsomniaRU (small blind) folded before Flop
Seat 8: The_red_area (big blind) folded on the Flop
Seat 9: mrhighryza folded before Flop (didn't bet)





PokerStars Hand #150800925315:  Hold'em No Limit (€0.50/€1.00 EUR) - 2016/03/23 14:17:57 CET [2016/03/23 9:17:57 ET]
Table 'Lanzia' 9-max Seat #7 is the button
Seat 1: Dantist1122 (€100 in chips) 
Seat 2: ardo888 (€103 in chips) 
Seat 3: Effort92 (€198.85 in chips) 
Seat 4: niong62 (€101.38 in chips) 
Seat 5: matiko09 (€100 in chips) 
Seat 6: Red4erT (€40 in chips) 
Seat 7: $-Twackle-$ (€100 in chips) 
Seat 8: Muinmyheart (€100 in chips) 
Seat 9: Butcher1848 (€100 in chips) 
Muinmyheart: posts small blind €0.50
Butcher1848: posts big blind €1
*** HOLE CARDS ***
Dealt to matiko09 [Qd 2s]
Dantist1122: folds 
Dantist1122 leaves the table
ardo888: folds 
Effort92: folds 
niong62: folds 
matiko09: folds 
Red4erT: folds 
$-Twackle-$: raises €1.10 to €2.10
Muinmyheart: folds 
Butcher1848: raises €5.94 to €8.04
$-Twackle-$: folds 
Uncalled bet (€5.94) returned to Butcher1848
Butcher1848 collected €4.70 from pot
Butcher1848: doesn't show hand 
*** SUMMARY ***
Total pot €4.70 | Rake €0 
Seat 1: Dantist1122 folded before Flop (didn't bet)
Seat 2: ardo888 folded before Flop (didn't bet)
Seat 3: Effort92 folded before Flop (didn't bet)
Seat 4: niong62 folded before Flop (didn't bet)
Seat 5: matiko09 folded before Flop (didn't bet)
Seat 6: Red4erT folded before Flop (didn't bet)
Seat 7: $-Twackle-$ (button) folded before Flop
Seat 8: Muinmyheart (small blind) folded before Flop
Seat 9: Butcher1848 (big blind) collected (€4.70)





PokerStars Hand #150800925004:  Hold'em No Limit ($1/$2 USD) - 2016/03/23 14:17:57 CET [2016/03/23 9:17:57 ET]
Table 'Deipylos II' 9-max Seat #8 is the button
Seat 1: $-Twackle-$ ($200 in chips) 
Seat 2: T0ny Adams ($82 in chips) 
Seat 4: matiko09 ($203 in chips) 
Seat 5: InsomniaRU ($203 in chips) 
Seat 6: nickreason17 ($200 in chips) 
Seat 7: volwebni4ek ($80 in chips) 
Seat 8: Igoriah ($200 in chips) 
Seat 9: Ranatuo84 ($238.42 in chips) 
Ranatuo84: posts small blind $1
$-Twackle-$: posts big blind $2
*** HOLE CARDS ***
Dealt to matiko09 [4h Td]
T0ny Adams: raises $3 to $5
matiko09: folds 
InsomniaRU: folds 
nickreason17: folds 
volwebni4ek: folds 
Igoriah: folds 
Ranatuo84: calls $4
$-Twackle-$: calls $3
*** FLOP *** [Th 7h Ks]
Ranatuo84: checks 
$-Twackle-$: checks 
T0ny Adams: bets $6.29
Ranatuo84: folds 
$-Twackle-$: folds 
Uncalled bet ($6.29) returned to T0ny Adams
T0ny Adams collected $14.32 from pot
T0ny Adams: doesn't show hand 
*** SUMMARY ***
Total pot $15 | Rake $0.68 
Board [Th 7h Ks]
Seat 1: $-Twackle-$ (big blind) folded on the Flop
Seat 2: T0ny Adams collected ($14.32)
Seat 4: matiko09 folded before Flop (didn't bet)
Seat 5: InsomniaRU folded before Flop (didn't bet)
Seat 6: nickreason17 folded before Flop (didn't bet)
Seat 7: volwebni4ek folded before Flop (didn't bet)
Seat 8: Igoriah (button) folded before Flop (didn't bet)
Seat 9: Ranatuo84 (small blind) folded on the Flop





PokerStars Hand #150800928187:  Hold'em No Limit ($1/$2 USD) - 2016/03/23 14:18:02 CET [2016/03/23 9:18:02 ET]
Table 'Kypria II' 9-max Seat #7 is the button
Seat 1: geldwolfje ($76.90 in chips) 
Seat 2: coinflip_si ($222.70 in chips) 
Seat 3: seouljam ($182.45 in chips) 
Seat 4: VolanDog ($200 in chips) 
Seat 5: InsomniaRU ($400.78 in chips) 
Seat 6: matiko09 ($373.95 in chips) 
Seat 7: DUkalisUA ($204.37 in chips) 
Seat 9: Moszes360 ($200 in chips) 
Pearl Jam87 will be allowed to play after the button
Moszes360: posts small blind $1
geldwolfje: posts big blind $2
*** HOLE CARDS ***
Dealt to matiko09 [9d Js]
coinflip_si: folds 
seouljam: folds 
VolanDog: folds 
InsomniaRU: folds 
matiko09: folds 
DUkalisUA: folds 
Moszes360: raises $2.20 to $4.20
geldwolfje: folds 
Uncalled bet ($2.20) returned to Moszes360
Moszes360 collected $4 from pot
Moszes360: doesn't show hand 
*** SUMMARY ***
Total pot $4 | Rake $0 
Seat 1: geldwolfje (big blind) folded before Flop
Seat 2: coinflip_si folded before Flop (didn't bet)
Seat 3: seouljam folded before Flop (didn't bet)
Seat 4: VolanDog folded before Flop (didn't bet)
Seat 5: InsomniaRU folded before Flop (didn't bet)
Seat 6: matiko09 folded before Flop (didn't bet)
Seat 7: DUkalisUA (button) folded before Flop (didn't bet)
Seat 9: Moszes360 (small blind) collected ($4)





PokerStars Hand #150800935293:  Hold'em No Limit ($0.25/$0.50 USD) - 2016/03/23 14:18:14 CET [2016/03/23 9:18:14 ET]
Table 'Belnika' 9-max Seat #6 is the button
Seat 1: yellowfever0 ($10.12 in chips) 
Seat 2: NeverRegret7 ($50.27 in chips) 
Seat 3: RyMorgy ($59.54 in chips) 
Seat 4: matiko09 ($69.28 in chips) 
Seat 5: ZonTTT ($50 in chips) 
Seat 6: Ahangama ($50 in chips) 
Seat 7: CvMCvMCvM ($62.06 in chips) 
Seat 8: lumen21 ($62.47 in chips) 
Seat 9: dndngod ($68.89 in chips) 
CvMCvMCvM: posts small blind $0.25
lumen21: posts big blind $0.50
*** HOLE CARDS ***
Dealt to matiko09 [Tc 8c]
dndngod: folds 
yellowfever0: folds 
NeverRegret7: raises $0.75 to $1.25
RyMorgy: folds 
matiko09: folds 
ZonTTT: folds 
yellowfever0 leaves the table
Ahangama: folds 
CvMCvMCvM: folds 
lumen21: folds 
Uncalled bet ($0.75) returned to NeverRegret7
NeverRegret7 collected $1.25 from pot
NeverRegret7: doesn't show hand 
*** SUMMARY ***
Total pot $1.25 | Rake $0 
Seat 1: yellowfever0 folded before Flop (didn't bet)
Seat 2: NeverRegret7 collected ($1.25)
Seat 3: RyMorgy folded before Flop (didn't bet)
Seat 4: matiko09 folded before Flop (didn't bet)
Seat 5: ZonTTT folded before Flop (didn't bet)
Seat 6: Ahangama (button) folded before Flop (didn't bet)
Seat 7: CvMCvMCvM (small blind) folded before Flop
Seat 8: lumen21 (big blind) folded before Flop
Seat 9: dndngod folded before Flop (didn't bet)





PokerStars Hand #150800937595:  Hold'em No Limit ($0.50/$1.00 USD) - 2016/03/23 14:18:17 CET [2016/03/23 9:18:17 ET]
Table 'Donar II' 9-max Seat #6 is the button
Seat 1: Effort92 ($100 in chips) 
Seat 2: nobrunobru1 ($62.74 in chips) 
Seat 3: st-germ30 ($101.89 in chips) 
Seat 4: DUkalisUA ($149.09 in chips) 
Seat 5: matiko09 ($100 in chips) 
Seat 6: ardo888 ($133.30 in chips) 
Seat 7: JimineyCrik ($91.25 in chips) 
Seat 8: $-Twackle-$ ($107.10 in chips) 
Seat 9: oxfordtenzin ($122.29 in chips) 
JimineyCrik: posts small blind $0.50
$-Twackle-$: posts big blind $1
Effort92: posts the ante $0.20
nobrunobru1: posts the ante $0.20
st-germ30: posts the ante $0.20
DUkalisUA: posts the ante $0.20
matiko09: posts the ante $0.20
ardo888: posts the ante $0.20
JimineyCrik: posts the ante $0.20
$-Twackle-$: posts the ante $0.20
oxfordtenzin: posts the ante $0.20
*** HOLE CARDS ***
Dealt to matiko09 [5c Ts]
oxfordtenzin: folds 
Effort92: raises $1.50 to $2.50
nobrunobru1: folds 
st-germ30: folds 
DUkalisUA: folds 
matiko09: folds 
ardo888: folds 
JimineyCrik: folds 
$-Twackle-$: folds 
Uncalled bet ($1.50) returned to Effort92
Effort92 collected $4.30 from pot
Effort92: doesn't show hand 
*** SUMMARY ***
Total pot $4.30 | Rake $0 
Seat 1: Effort92 collected ($4.30)
Seat 2: nobrunobru1 folded before Flop (didn't bet)
Seat 3: st-germ30 folded before Flop (didn't bet)
Seat 4: DUkalisUA folded before Flop (didn't bet)
Seat 5: matiko09 folded before Flop (didn't bet)
Seat 6: ardo888 (button) folded before Flop (didn't bet)
Seat 7: JimineyCrik (small blind) folded before Flop
Seat 8: $-Twackle-$ (big blind) folded before Flop
Seat 9: oxfordtenzin folded before Flop (didn't bet)





PokerStars Hand #150800942171:  Hold'em No Limit ($0.50/$1.00 USD) - 2016/03/23 14:18:25 CET [2016/03/23 9:18:25 ET]
Table 'Atlantis' 9-max Seat #7 is the button
Seat 1: xHourglass ($144.27 in chips) 
Seat 2: tffff2006 ($55.84 in chips) 
Seat 3: CAJUN890 ($105.79 in chips) 
Seat 4: matiko09 ($130.75 in chips) 
Seat 5: Pvsx. ($113.63 in chips) 
Seat 6: Jimy Tiltman ($100 in chips) 
Seat 7: Sherlockplay ($143.77 in chips) 
Seat 8: DUkalisUA ($101.50 in chips) 
DUkalisUA: posts small blind $0.50
xHourglass: posts big blind $1
*** HOLE CARDS ***
Dealt to matiko09 [4d As]
tffff2006: folds 
CAJUN890: folds 
matiko09: folds 
Pvsx.: folds 
Jimy Tiltman: folds 
Sherlockplay: raises $1.50 to $2.50
DUkalisUA: folds 
xHourglass: raises $5 to $7.50
Sherlockplay: folds 
Uncalled bet ($5) returned to xHourglass
xHourglass collected $5.50 from pot
xHourglass: doesn't show hand 
*** SUMMARY ***
Total pot $5.50 | Rake $0 
Seat 1: xHourglass (big blind) collected ($5.50)
Seat 2: tffff2006 folded before Flop (didn't bet)
Seat 3: CAJUN890 folded before Flop (didn't bet)
Seat 4: matiko09 folded before Flop (didn't bet)
Seat 5: Pvsx. folded before Flop (didn't bet)
Seat 6: Jimy Tiltman folded before Flop (didn't bet)
Seat 7: Sherlockplay (button) folded before Flop
Seat 8: DUkalisUA (small blind) folded before Flop





PokerStars Hand #150800947036:  Hold'em No Limit ($0.50/$1.00 USD) - 2016/03/23 14:18:33 CET [2016/03/23 9:18:33 ET]
Table 'Kippes' 9-max Seat #3 is the button
Seat 1: Pvsx. ($120.18 in chips) 
Seat 3: CAJUN890 ($122.47 in chips) 
Seat 4: matiko09 ($100 in chips) 
Seat 5: Jimy Tiltman ($131.10 in chips) 
Seat 6: DUkalisUA ($114.86 in chips) 
Seat 7: lumen21 ($100 in chips) 
Seat 8: Sherlockplay ($100 in chips) 
Seat 9: wang19790906 ($92.43 in chips) 
matiko09: posts small blind $0.50
Jimy Tiltman: posts big blind $1
*** HOLE CARDS ***
Dealt to matiko09 [7s 6d]
DUkalisUA: folds 
lumen21: folds 
Sherlockplay: folds 
wang19790906: folds 
Pvsx.: folds 
CAJUN890: folds 
matiko09: folds 
Uncalled bet ($0.50) returned to Jimy Tiltman
Jimy Tiltman collected $1 from pot
Jimy Tiltman: doesn't show hand 
*** SUMMARY ***
Total pot $1 | Rake $0 
Seat 1: Pvsx. folded before Flop (didn't bet)
Seat 3: CAJUN890 (button) folded before Flop (didn't bet)
Seat 4: matiko09 (small blind) folded before Flop
Seat 5: Jimy Tiltman (big blind) collected ($1)
Seat 6: DUkalisUA folded before Flop (didn't bet)
Seat 7: lumen21 folded before Flop (didn't bet)
Seat 8: Sherlockplay folded before Flop (didn't bet)
Seat 9: wang19790906 folded before Flop (didn't bet)





PokerStars Hand #150800949072:  Hold'em No Limit ($0.25/$0.50 USD) - 2016/03/23 14:18:37 CET [2016/03/23 9:18:37 ET]
Table 'Belnika' 9-max Seat #7 is the button
Seat 2: NeverRegret7 ($51.02 in chips) 
Seat 3: RyMorgy ($59.54 in chips) 
Seat 4: matiko09 ($69.28 in chips) 
Seat 5: ZonTTT ($50 in chips) 
Seat 6: Ahangama ($50 in chips) 
Seat 7: CvMCvMCvM ($61.81 in chips) 
Seat 8: lumen21 ($61.97 in chips) 
Seat 9: dndngod ($68.89 in chips) 
lumen21: posts small blind $0.25
dndngod: posts big blind $0.50
*** HOLE CARDS ***
Dealt to matiko09 [2d 5c]
NeverRegret7: raises $0.75 to $1.25
RyMorgy: folds 
matiko09: folds 
ZonTTT: folds 
Ahangama: folds 
CvMCvMCvM: folds 
lumen21: folds 
dndngod: raises $3 to $4.25
NeverRegret7: folds 
Uncalled bet ($3) returned to dndngod
dndngod collected $2.75 from pot
dndngod: doesn't show hand 
*** SUMMARY ***
Total pot $2.75 | Rake $0 
Seat 2: NeverRegret7 folded before Flop
Seat 3: RyMorgy folded before Flop (didn't bet)
Seat 4: matiko09 folded before Flop (didn't bet)
Seat 5: ZonTTT folded before Flop (didn't bet)
Seat 6: Ahangama folded before Flop (didn't bet)
Seat 7: CvMCvMCvM (button) folded before Flop (didn't bet)
Seat 8: lumen21 (small blind) folded before Flop
Seat 9: dndngod (big blind) collected ($2.75)





PokerStars Hand #150800954185:  Hold'em No Limit ($1/$2 USD) - 2016/03/23 14:18:45 CET [2016/03/23 9:18:45 ET]
Table 'Kypria II' 9-max Seat #9 is the button
Seat 1: geldwolfje ($74.90 in chips) 
Seat 2: coinflip_si ($222.70 in chips) 
Seat 3: seouljam ($182.45 in chips) 
Seat 4: VolanDog ($200 in chips) 
Seat 5: InsomniaRU ($400.78 in chips) 
Seat 6: matiko09 ($373.95 in chips) 
Seat 7: DUkalisUA ($204.37 in chips) 
Seat 9: Moszes360 ($202 in chips) 
geldwolfje: posts small blind $1
coinflip_si: posts big blind $2
Pearl Jam87: sits out 
*** HOLE CARDS ***
Dealt to matiko09 [Kh 7h]
seouljam: folds 
VolanDog: folds 
InsomniaRU: raises $3 to $5
matiko09: folds 
DUkalisUA: folds 
Moszes360: folds 
geldwolfje: raises $15 to $20
coinflip_si: folds 
InsomniaRU: folds 
Uncalled bet ($15) returned to geldwolfje
geldwolfje collected $12 from pot
geldwolfje: doesn't show hand 
*** SUMMARY ***
Total pot $12 | Rake $0 
Seat 1: geldwolfje (small blind) collected ($12)
Seat 2: coinflip_si (big blind) folded before Flop
Seat 3: seouljam folded before Flop (didn't bet)
Seat 4: VolanDog folded before Flop (didn't bet)
Seat 5: InsomniaRU folded before Flop
Seat 6: matiko09 folded before Flop (didn't bet)
Seat 7: DUkalisUA folded before Flop (didn't bet)
Seat 9: Moszes360 (button) folded before Flop (didn't bet)





PokerStars Hand #150800957651:  Hold'em No Limit ($0.50/$1.00 USD) - 2016/03/23 14:18:51 CET [2016/03/23 9:18:51 ET]
Table 'Donar II' 9-max Seat #7 is the button
Seat 1: Effort92 ($103.10 in chips) 
Seat 2: nobrunobru1 ($62.54 in chips) 
Seat 3: st-germ30 ($101.69 in chips) 
Seat 4: DUkalisUA ($148.89 in chips) 
Seat 5: matiko09 ($100 in chips) 
Seat 6: ardo888 ($133.10 in chips) 
Seat 7: JimineyCrik ($90.55 in chips) 
Seat 8: $-Twackle-$ ($105.90 in chips) 
Seat 9: oxfordtenzin ($122.09 in chips) 
$-Twackle-$: posts small blind $0.50
oxfordtenzin: posts big blind $1
Effort92: posts the ante $0.20
nobrunobru1: posts the ante $0.20
st-germ30: posts the ante $0.20
DUkalisUA: posts the ante $0.20
matiko09: posts the ante $0.20
ardo888: posts the ante $0.20
JimineyCrik: posts the ante $0.20
$-Twackle-$: posts the ante $0.20
oxfordtenzin: posts the ante $0.20
*** HOLE CARDS ***
Dealt to matiko09 [Qc 9d]
Effort92: raises $1.50 to $2.50
nobrunobru1: calls $2.50
st-germ30: folds 
DUkalisUA: folds 
matiko09: folds 
ardo888: calls $2.50
JimineyCrik: folds 
$-Twackle-$: folds 
oxfordtenzin: folds 
*** FLOP *** [Qs 7d Ad]
Effort92: bets $6.70
nobrunobru1: folds 
ardo888: folds 
Uncalled bet ($6.70) returned to Effort92
Effort92 collected $10.31 from pot
Effort92: doesn't show hand 
*** SUMMARY ***
Total pot $10.80 | Rake $0.49 
Board [Qs 7d Ad]
Seat 1: Effort92 collected ($10.31)
Seat 2: nobrunobru1 folded on the Flop
Seat 3: st-germ30 folded before Flop (didn't bet)
Seat 4: DUkalisUA folded before Flop (didn't bet)
Seat 5: matiko09 folded before Flop (didn't bet)
Seat 6: ardo888 folded on the Flop
Seat 7: JimineyCrik (button) folded before Flop (didn't bet)
Seat 8: $-Twackle-$ (small blind) folded before Flop
Seat 9: oxfordtenzin (big blind) folded before Flop





PokerStars Hand #150800960513:  Hold'em No Limit ($1/$2 USD) - 2016/03/23 14:18:55 CET [2016/03/23 9:18:55 ET]
Table 'Kiess' 9-max Seat #4 is the button
Seat 1: Cirilico ($229.74 in chips) 
Seat 2: DUkalisUA ($674.10 in chips) 
Seat 3: The_red_area ($388.79 in chips) 
Seat 4: Moszes360 ($200 in chips) 
Seat 5: chippo boy ($460.32 in chips) 
Seat 6: matiko09 ($274.84 in chips) 
Seat 7: InsomniaRU ($274.37 in chips) 
Seat 8: erfk1958 ($119.55 in chips) 
Seat 9: nickreason17 ($200 in chips) 
chippo boy: posts small blind $1
matiko09: posts big blind $2
*** HOLE CARDS ***
Dealt to matiko09 [Tc Jd]
InsomniaRU: folds 
erfk1958: folds 
nickreason17: raises $4 to $6
Cirilico: folds 
DUkalisUA: folds 
The_red_area: calls $6
Moszes360: folds 
chippo boy: folds 
matiko09: folds 
*** FLOP *** [3h 9d 7c]
nickreason17: checks 
The_red_area: checks 
*** TURN *** [3h 9d 7c] [5h]
nickreason17: bets $9
The_red_area: calls $9
*** RIVER *** [3h 9d 7c 5h] [4c]
nickreason17: checks 
The_red_area: bets $31.52
nickreason17: calls $31.52
*** SHOW DOWN ***
The_red_area: shows [Jh Kh] (high card King)
nickreason17: shows [8s 8d] (a pair of Eights)
nickreason17 collected $93.24 from pot
*** SUMMARY ***
Total pot $96.04 | Rake $2.80 
Board [3h 9d 7c 5h 4c]
Seat 1: Cirilico folded before Flop (didn't bet)
Seat 2: DUkalisUA folded before Flop (didn't bet)
Seat 3: The_red_area showed [Jh Kh] and lost with high card King
Seat 4: Moszes360 (button) folded before Flop (didn't bet)
Seat 5: chippo boy (small blind) folded before Flop
Seat 6: matiko09 (big blind) folded before Flop
Seat 7: InsomniaRU folded before Flop (didn't bet)
Seat 8: erfk1958 folded before Flop (didn't bet)
Seat 9: nickreason17 showed [8s 8d] and won ($93.24) with a pair of Eights





PokerStars Hand #150800961387:  Hold'em No Limit ($0.25/$0.50 USD) - 2016/03/23 14:18:57 CET [2016/03/23 9:18:57 ET]
Table 'Pyrrhus' 9-max Seat #8 is the button
Seat 1: lumen21 ($80.16 in chips) 
Seat 2: alemão007 ($48.75 in chips) 
Seat 3: i L00K great ($50 in chips) 
Seat 4: GriffinBerg ($34.38 in chips) 
Seat 5: ZonTTT ($56.61 in chips) 
Seat 6: Ahangama ($50 in chips) 
Seat 7: matiko09 ($134.06 in chips) 
Seat 8: dndngod ($77.27 in chips) 
Seat 9: CvMCvMCvM ($97.88 in chips) 
CvMCvMCvM: posts small blind $0.25
lumen21: posts big blind $0.50
*** HOLE CARDS ***
Dealt to matiko09 [9s Ah]
alemão007: folds 
i L00K great: folds 
GriffinBerg: folds 
ZonTTT: folds 
Ahangama: folds 
matiko09: raises $0.75 to $1.25
dndngod: folds 
CvMCvMCvM: folds 
lumen21: folds 
Uncalled bet ($0.75) returned to matiko09
matiko09 collected $1.25 from pot
matiko09: doesn't show hand 
*** SUMMARY ***
Total pot $1.25 | Rake $0 
Seat 1: lumen21 (big blind) folded before Flop
Seat 2: alemão007 folded before Flop (didn't bet)
Seat 3: i L00K great folded before Flop (didn't bet)
Seat 4: GriffinBerg folded before Flop (didn't bet)
Seat 5: ZonTTT folded before Flop (didn't bet)
Seat 6: Ahangama folded before Flop (didn't bet)
Seat 7: matiko09 collected ($1.25)
Seat 8: dndngod (button) folded before Flop (didn't bet)
Seat 9: CvMCvMCvM (small blind) folded before Flop





PokerStars Hand #150800962869:  Hold'em No Limit ($0.50/$1.00 USD) - 2016/03/23 14:18:59 CET [2016/03/23 9:18:59 ET]
Table 'Kippes' 9-max Seat #4 is the button
Seat 1: Pvsx. ($120.18 in chips) 
Seat 3: CAJUN890 ($122.47 in chips) 
Seat 4: matiko09 ($100 in chips) 
Seat 5: Jimy Tiltman ($131.60 in chips) 
Seat 6: DUkalisUA ($114.86 in chips) 
Seat 7: lumen21 ($100 in chips) 
Seat 8: Sherlockplay ($100 in chips) 
Seat 9: wang19790906 ($92.43 in chips) 
Jimy Tiltman: posts small blind $0.50
DUkalisUA: posts big blind $1
*** HOLE CARDS ***
Dealt to matiko09 [8d Jh]
lumen21: folds 
Sherlockplay: folds 
wang19790906: folds 
Pvsx.: folds 
CAJUN890: raises $2 to $3
matiko09: folds 
Jimy Tiltman: folds 
DUkalisUA: folds 
Uncalled bet ($2) returned to CAJUN890
CAJUN890 collected $2.50 from pot
CAJUN890: doesn't show hand 
*** SUMMARY ***
Total pot $2.50 | Rake $0 
Seat 1: Pvsx. folded before Flop (didn't bet)
Seat 3: CAJUN890 collected ($2.50)
Seat 4: matiko09 (button) folded before Flop (didn't bet)
Seat 5: Jimy Tiltman (small blind) folded before Flop
Seat 6: DUkalisUA (big blind) folded before Flop
Seat 7: lumen21 folded before Flop (didn't bet)
Seat 8: Sherlockplay folded before Flop (didn't bet)
Seat 9: wang19790906 folded before Flop (didn't bet)





PokerStars Hand #150800966833:  Hold'em No Limit ($1/$2 USD) - 2016/03/23 14:19:06 CET [2016/03/23 9:19:06 ET]
Table 'Herba II' 9-max Seat #7 is the button
Seat 1: matiko09 ($215.06 in chips) 
Seat 2: Moszes360 ($204.89 in chips) 
Seat 3: Cirilico ($163.32 in chips) 
Seat 4: DUkalisUA ($298.48 in chips) 
Seat 5: chippo boy ($263.38 in chips) 
Seat 6: Too-Anti-To ($212.46 in chips) 
Seat 7: InsomniaRU ($201.78 in chips) 
Seat 8: The_red_area ($440.98 in chips) 
Seat 9: mrhighryza ($50.43 in chips) 
The_red_area: posts small blind $1
mrhighryza: posts big blind $2
*** HOLE CARDS ***
Dealt to matiko09 [Kh 2s]
matiko09: folds 
Moszes360: folds 
Cirilico: folds 
DUkalisUA: raises $4 to $6
chippo boy: folds 
Too-Anti-To: folds 
InsomniaRU: folds 
The_red_area: folds 
mrhighryza: calls $4
*** FLOP *** [4s Ks Qd]
mrhighryza: checks 
DUkalisUA: bets $9.31
mrhighryza: folds 
Uncalled bet ($9.31) returned to DUkalisUA
DUkalisUA collected $12.42 from pot
DUkalisUA: doesn't show hand 
*** SUMMARY ***
Total pot $13 | Rake $0.58 
Board [4s Ks Qd]
Seat 1: matiko09 folded before Flop (didn't bet)
Seat 2: Moszes360 folded before Flop (didn't bet)
Seat 3: Cirilico folded before Flop (didn't bet)
Seat 4: DUkalisUA collected ($12.42)
Seat 5: chippo boy folded before Flop (didn't bet)
Seat 6: Too-Anti-To folded before Flop (didn't bet)
Seat 7: InsomniaRU (button) folded before Flop (didn't bet)
Seat 8: The_red_area (small blind) folded before Flop
Seat 9: mrhighryza (big blind) folded on the Flop





PokerStars Hand #150800967992:  Hold'em No Limit ($0.25/$0.50 USD) - 2016/03/23 14:19:08 CET [2016/03/23 9:19:08 ET]
Table 'Belnika' 9-max Seat #8 is the button
Seat 2: NeverRegret7 ($49.77 in chips) 
Seat 3: RyMorgy ($59.54 in chips) 
Seat 4: matiko09 ($69.28 in chips) 
Seat 5: ZonTTT ($50 in chips) 
Seat 6: Ahangama ($50 in chips) 
Seat 7: CvMCvMCvM ($61.81 in chips) 
Seat 8: lumen21 ($61.72 in chips) 
Seat 9: dndngod ($70.39 in chips) 
dndngod: posts small blind $0.25
NeverRegret7: posts big blind $0.50
*** HOLE CARDS ***
Dealt to matiko09 [4d Tc]
RyMorgy: folds 
matiko09: folds 
ZonTTT: folds 
Ahangama: folds 
CvMCvMCvM: folds 
denitz21 joins the table at seat #1 
lumen21: raises $0.75 to $1.25
dndngod: folds 
NeverRegret7: folds 
Uncalled bet ($0.75) returned to lumen21
lumen21 collected $1.25 from pot
lumen21: doesn't show hand 
*** SUMMARY ***
Total pot $1.25 | Rake $0 
Seat 2: NeverRegret7 (big blind) folded before Flop
Seat 3: RyMorgy folded before Flop (didn't bet)
Seat 4: matiko09 folded before Flop (didn't bet)
Seat 5: ZonTTT folded before Flop (didn't bet)
Seat 6: Ahangama folded before Flop (didn't bet)
Seat 7: CvMCvMCvM folded before Flop (didn't bet)
Seat 8: lumen21 (button) collected ($1.25)
Seat 9: dndngod (small blind) folded before Flop





PokerStars Hand #150800970004:  Hold'em No Limit ($1/$2 USD) - 2016/03/23 14:19:11 CET [2016/03/23 9:19:11 ET]
Table 'Achaia' 9-max Seat #3 is the button
Seat 1: ilaviiitech ($200 in chips) 
Seat 2: InsomniaRU ($223.66 in chips) 
Seat 3: matiko09 ($200 in chips) 
Seat 4: nailz83 ($177.46 in chips) 
Seat 5: DUkalisUA ($213.37 in chips) 
Seat 6: nickreason17 ($213.06 in chips) 
Seat 7: morosun ($212.03 in chips) 
Seat 8: $-Twackle-$ ($222.65 in chips) 
Seat 9: glanza_mike ($204.28 in chips) 
nailz83: posts small blind $1
DUkalisUA: posts big blind $2
*** HOLE CARDS ***
Dealt to matiko09 [2c Js]
nickreason17: folds 
morosun: folds 
$-Twackle-$: folds 
glanza_mike: folds 
ilaviiitech: folds 
InsomniaRU: folds 
matiko09: folds 
nailz83: folds 
Uncalled bet ($1) returned to DUkalisUA
DUkalisUA collected $2 from pot
DUkalisUA: doesn't show hand 
*** SUMMARY ***
Total pot $2 | Rake $0 
Seat 1: ilaviiitech folded before Flop (didn't bet)
Seat 2: InsomniaRU folded before Flop (didn't bet)
Seat 3: matiko09 (button) folded before Flop (didn't bet)
Seat 4: nailz83 (small blind) folded before Flop
Seat 5: DUkalisUA (big blind) collected ($2)
Seat 6: nickreason17 folded before Flop (didn't bet)
Seat 7: morosun folded before Flop (didn't bet)
Seat 8: $-Twackle-$ folded before Flop (didn't bet)
Seat 9: glanza_mike folded before Flop (didn't bet)





PokerStars Hand #150800971616:  Hold'em No Limit ($0.50/$1.00 USD) - 2016/03/23 14:19:14 CET [2016/03/23 9:19:14 ET]
Table 'Merope II' 9-max Seat #5 is the button
Seat 1: Jimy Tiltman ($133.70 in chips) 
Seat 2: $-Twackle-$ ($100 in chips) 
Seat 3: pablos1922 ($105.92 in chips) 
Seat 4: YuriiSolodya ($84.59 in chips) 
Seat 5: DUkalisUA ($141.64 in chips) 
Seat 6: Effort92 ($100 in chips) 
Seat 7: matiko09 ($110.73 in chips) 
Seat 8: titentei ($93.50 in chips) 
Effort92: posts small blind $0.50
matiko09: posts big blind $1
*** HOLE CARDS ***
Dealt to matiko09 [8c 9d]
titentei: folds 
Jimy Tiltman: folds 
$-Twackle-$: folds 
pablos1922: folds 
YuriiSolodya: raises $1 to $2
DUkalisUA: folds 
Effort92: folds 
matiko09: folds 
Uncalled bet ($1) returned to YuriiSolodya
YuriiSolodya collected $2.50 from pot
YuriiSolodya: doesn't show hand 
*** SUMMARY ***
Total pot $2.50 | Rake $0 
Seat 1: Jimy Tiltman folded before Flop (didn't bet)
Seat 2: $-Twackle-$ folded before Flop (didn't bet)
Seat 3: pablos1922 folded before Flop (didn't bet)
Seat 4: YuriiSolodya collected ($2.50)
Seat 5: DUkalisUA (button) folded before Flop (didn't bet)
Seat 6: Effort92 (small blind) folded before Flop
Seat 7: matiko09 (big blind) folded before Flop
Seat 8: titentei folded before Flop (didn't bet)





PokerStars Hand #150800972634:  Hold'em No Limit (€0.50/€1.00 EUR) - 2016/03/23 14:19:15 CET [2016/03/23 9:19:15 ET]
Table 'Lanzia' 9-max Seat #8 is the button
Seat 2: ardo888 (€103 in chips) 
Seat 3: Effort92 (€198.85 in chips) 
Seat 4: niong62 (€101.38 in chips) 
Seat 5: matiko09 (€100 in chips) 
Seat 6: Red4erT (€40 in chips) 
Seat 7: $-Twackle-$ (€100 in chips) 
Seat 8: Muinmyheart (€100 in chips) 
Seat 9: Butcher1848 (€102.60 in chips) 
Butcher1848: posts small blind €0.50
ardo888: posts big blind €1
*** HOLE CARDS ***
Dealt to matiko09 [As 2c]
Effort92: folds 
niong62: raises €1 to €2
matiko09: folds 
Red4erT: folds 
$-Twackle-$: folds 
Muinmyheart: raises €6 to €8
Butcher1848: folds 
ardo888: folds 
niong62: folds 
Uncalled bet (€6) returned to Muinmyheart
Muinmyheart collected €5.50 from pot
Muinmyheart: doesn't show hand 
*** SUMMARY ***
Total pot €5.50 | Rake €0 
Seat 2: ardo888 (big blind) folded before Flop
Seat 3: Effort92 folded before Flop (didn't bet)
Seat 4: niong62 folded before Flop
Seat 5: matiko09 folded before Flop (didn't bet)
Seat 6: Red4erT folded before Flop (didn't bet)
Seat 7: $-Twackle-$ folded before Flop (didn't bet)
Seat 8: Muinmyheart (button) collected (€5.50)
Seat 9: Butcher1848 (small blind) folded before Flop





PokerStars Hand #150800974371:  Hold'em No Limit ($1/$2 USD) - 2016/03/23 14:19:18 CET [2016/03/23 9:19:18 ET]
Table 'Kypria II' 9-max Seat #1 is the button
Seat 1: geldwolfje ($81.90 in chips) 
Seat 2: coinflip_si ($220.70 in chips) 
Seat 3: seouljam ($182.45 in chips) 
Seat 4: VolanDog ($200 in chips) 
Seat 5: InsomniaRU ($395.78 in chips) 
Seat 6: matiko09 ($373.95 in chips) 
Seat 7: DUkalisUA ($204.37 in chips) 
Seat 9: Moszes360 ($202 in chips) 
coinflip_si: posts small blind $1
seouljam: posts big blind $2
Pearl Jam87: sits out 
*** HOLE CARDS ***
Dealt to matiko09 [Kh 4s]
VolanDog: folds 
InsomniaRU: raises $3 to $5
matiko09: folds 
DUkalisUA: folds 
Moszes360: folds 
geldwolfje: folds 
coinflip_si: folds 
seouljam: calls $3
*** FLOP *** [3c 2h 2d]
seouljam: checks 
InsomniaRU: bets $4.20
seouljam: folds 
Uncalled bet ($4.20) returned to InsomniaRU
InsomniaRU collected $10.50 from pot
InsomniaRU: doesn't show hand 
*** SUMMARY ***
Total pot $11 | Rake $0.50 
Board [3c 2h 2d]
Seat 1: geldwolfje (button) folded before Flop (didn't bet)
Seat 2: coinflip_si (small blind) folded before Flop
Seat 3: seouljam (big blind) folded on the Flop
Seat 4: VolanDog folded before Flop (didn't bet)
Seat 5: InsomniaRU collected ($10.50)
Seat 6: matiko09 folded before Flop (didn't bet)
Seat 7: DUkalisUA folded before Flop (didn't bet)
Seat 9: Moszes360 folded before Flop (didn't bet)





PokerStars Hand #150800976367:  Hold'em No Limit ($0.50/$1.00 USD) - 2016/03/23 14:19:22 CET [2016/03/23 9:19:22 ET]
Table 'Atlantis' 9-max Seat #8 is the button
Seat 1: xHourglass ($147.27 in chips) 
Seat 2: tffff2006 ($55.84 in chips) 
Seat 3: CAJUN890 ($105.79 in chips) 
Seat 4: matiko09 ($130.75 in chips) 
Seat 5: Pvsx. ($113.63 in chips) 
Seat 6: Jimy Tiltman ($100 in chips) 
Seat 7: Sherlockplay ($141.27 in chips) 
Seat 8: DUkalisUA ($101 in chips) 
xHourglass: posts small blind $0.50
tffff2006: posts big blind $1
*** HOLE CARDS ***
Dealt to matiko09 [6c 2s]
CAJUN890: folds 
matiko09: folds 
Pvsx.: raises $1.50 to $2.50
Jimy Tiltman: folds 
Sherlockplay: folds 
DUkalisUA: folds 
xHourglass: folds 
tffff2006: raises $2 to $4.50
Pvsx.: calls $2
*** FLOP *** [7h 4h 2c]
tffff2006: bets $4.53
Pvsx.: calls $4.53
*** TURN *** [7h 4h 2c] [4d]
tffff2006: checks 
Pvsx.: bets $9
tffff2006: calls $9
*** RIVER *** [7h 4h 2c 4d] [7d]
tffff2006: checks 
Pvsx.: checks 
*** SHOW DOWN ***
tffff2006: shows [9c 9h] (two pair, Nines and Sevens)
Pvsx.: mucks hand 
tffff2006 collected $34.91 from pot
*** SUMMARY ***
Total pot $36.56 | Rake $1.65 
Board [7h 4h 2c 4d 7d]
Seat 1: xHourglass (small blind) folded before Flop
Seat 2: tffff2006 (big blind) showed [9c 9h] and won ($34.91) with two pair, Nines and Sevens
Seat 3: CAJUN890 folded before Flop (didn't bet)
Seat 4: matiko09 folded before Flop (didn't bet)
Seat 5: Pvsx. mucked [Kc Ad]
Seat 6: Jimy Tiltman folded before Flop (didn't bet)
Seat 7: Sherlockplay folded before Flop (didn't bet)
Seat 8: DUkalisUA (button) folded before Flop (didn't bet)





PokerStars Hand #150800977033:  Hold'em No Limit ($1/$2 USD) - 2016/03/23 14:19:23 CET [2016/03/23 9:19:23 ET]
Table 'Deipylos II' 9-max Seat #9 is the button
Seat 1: $-Twackle-$ ($200 in chips) 
Seat 2: T0ny Adams ($91.32 in chips) 
Seat 4: matiko09 ($203 in chips) 
Seat 5: InsomniaRU ($203 in chips) 
Seat 6: nickreason17 ($200 in chips) 
Seat 7: volwebni4ek ($80 in chips) 
Seat 8: Igoriah ($200 in chips) 
Seat 9: Ranatuo84 ($233.42 in chips) 
$-Twackle-$: posts small blind $1
T0ny Adams: posts big blind $2
*** HOLE CARDS ***
Dealt to matiko09 [9d Th]
matiko09: folds 
InsomniaRU: folds 
nickreason17: raises $3 to $5
volwebni4ek: folds 
Igoriah: folds 
Ranatuo84: folds 
$-Twackle-$: folds 
T0ny Adams: folds 
Uncalled bet ($3) returned to nickreason17
nickreason17 collected $5 from pot
*** SUMMARY ***
Total pot $5 | Rake $0 
Seat 1: $-Twackle-$ (small blind) folded before Flop
Seat 2: T0ny Adams (big blind) folded before Flop
Seat 4: matiko09 folded before Flop (didn't bet)
Seat 5: InsomniaRU folded before Flop (didn't bet)
Seat 6: nickreason17 collected ($5)
Seat 7: volwebni4ek folded before Flop (didn't bet)
Seat 8: Igoriah folded before Flop (didn't bet)
Seat 9: Ranatuo84 (button) folded before Flop (didn't bet)





PokerStars Hand #150800980370:  Hold'em No Limit ($1/$2 USD) - 2016/03/23 14:19:28 CET [2016/03/23 9:19:28 ET]
Table 'Achaia' 9-max Seat #4 is the button
Seat 1: ilaviiitech ($200 in chips) 
Seat 2: InsomniaRU ($223.66 in chips) 
Seat 3: matiko09 ($200 in chips) 
Seat 4: nailz83 ($176.46 in chips) 
Seat 5: DUkalisUA ($214.37 in chips) 
Seat 6: nickreason17 ($213.06 in chips) 
Seat 7: morosun ($212.03 in chips) 
Seat 8: $-Twackle-$ ($222.65 in chips) 
Seat 9: glanza_mike ($204.28 in chips) 
DUkalisUA: posts small blind $1
nickreason17: posts big blind $2
*** HOLE CARDS ***
Dealt to matiko09 [Qh 9d]
morosun: folds 
$-Twackle-$: folds 
glanza_mike: folds 
ilaviiitech: folds 
InsomniaRU: folds 
matiko09: folds 
nailz83: raises $4 to $6
DUkalisUA: folds 
nickreason17: folds 
Uncalled bet ($4) returned to nailz83
nailz83 collected $5 from pot
nailz83: doesn't show hand 
*** SUMMARY ***
Total pot $5 | Rake $0 
Seat 1: ilaviiitech folded before Flop (didn't bet)
Seat 2: InsomniaRU folded before Flop (didn't bet)
Seat 3: matiko09 folded before Flop (didn't bet)
Seat 4: nailz83 (button) collected ($5)
Seat 5: DUkalisUA (small blind) folded before Flop
Seat 6: nickreason17 (big blind) folded before Flop
Seat 7: morosun folded before Flop (didn't bet)
Seat 8: $-Twackle-$ folded before Flop (didn't bet)
Seat 9: glanza_mike folded before Flop (didn't bet)





PokerStars Hand #150800981589:  Hold'em No Limit ($0.50/$1.00 USD) - 2016/03/23 14:19:30 CET [2016/03/23 9:19:30 ET]
Table 'Kippes' 9-max Seat #5 is the button
Seat 1: Pvsx. ($120.18 in chips) 
Seat 3: CAJUN890 ($123.97 in chips) 
Seat 4: matiko09 ($100 in chips) 
Seat 5: Jimy Tiltman ($131.10 in chips) 
Seat 6: DUkalisUA ($113.86 in chips) 
Seat 7: lumen21 ($100 in chips) 
Seat 8: Sherlockplay ($100 in chips) 
Seat 9: wang19790906 ($92.43 in chips) 
DUkalisUA: posts small blind $0.50
lumen21: posts big blind $1
*** HOLE CARDS ***
Dealt to matiko09 [9s 6c]
Sherlockplay: folds 
wang19790906: raises $1 to $2
Pvsx.: folds 
CAJUN890: folds 
matiko09: folds 
Jimy Tiltman: folds 
DUkalisUA: folds 
lumen21: calls $1
*** FLOP *** [Qc Ts 2d]
lumen21: checks 
wang19790906: bets $2.15
lumen21: calls $2.15
*** TURN *** [Qc Ts 2d] [8c]
lumen21: checks 
wang19790906: bets $4.20
lumen21: calls $4.20
*** RIVER *** [Qc Ts 2d 8c] [4d]
lumen21: checks 
wang19790906: checks 
*** SHOW DOWN ***
lumen21: shows [Jh Ah] (high card Ace)
wang19790906: shows [6s Qs] (a pair of Queens)
wang19790906 collected $16.43 from pot
*** SUMMARY ***
Total pot $17.20 | Rake $0.77 
Board [Qc Ts 2d 8c 4d]
Seat 1: Pvsx. folded before Flop (didn't bet)
Seat 3: CAJUN890 folded before Flop (didn't bet)
Seat 4: matiko09 folded before Flop (didn't bet)
Seat 5: Jimy Tiltman (button) folded before Flop (didn't bet)
Seat 6: DUkalisUA (small blind) folded before Flop
Seat 7: lumen21 (big blind) showed [Jh Ah] and lost with high card Ace
Seat 8: Sherlockplay folded before Flop (didn't bet)
Seat 9: wang19790906 showed [6s Qs] and won ($16.43) with a pair of Queens





PokerStars Hand #150800985127:  Hold'em No Limit ($0.25/$0.50 USD) - 2016/03/23 14:19:36 CET [2016/03/23 9:19:36 ET]
Table 'Pyrrhus' 9-max Seat #9 is the button
Seat 1: lumen21 ($79.66 in chips) 
Seat 2: alemão007 ($48.75 in chips) 
Seat 3: i L00K great ($50 in chips) 
Seat 4: GriffinBerg ($34.38 in chips) 
Seat 5: ZonTTT ($56.61 in chips) 
Seat 6: Ahangama ($50 in chips) 
Seat 7: matiko09 ($134.81 in chips) 
Seat 8: dndngod ($77.27 in chips) 
Seat 9: CvMCvMCvM ($97.63 in chips) 
lumen21: posts small blind $0.25
alemão007: posts big blind $0.50
*** HOLE CARDS ***
Dealt to matiko09 [4c 5c]
i L00K great: folds 
GriffinBerg: folds 
ZonTTT: folds 
Ahangama: folds 
matiko09: folds 
dndngod: folds 
CvMCvMCvM: folds 
lumen21: raises $1 to $1.50
alemão007: calls $1
*** FLOP *** [2c Kh Qd]
lumen21: bets $2.20
alemão007: folds 
Uncalled bet ($2.20) returned to lumen21
lumen21 collected $2.86 from pot
lumen21: doesn't show hand 
*** SUMMARY ***
Total pot $3 | Rake $0.14 
Board [2c Kh Qd]
Seat 1: lumen21 (small blind) collected ($2.86)
Seat 2: alemão007 (big blind) folded on the Flop
Seat 3: i L00K great folded before Flop (didn't bet)
Seat 4: GriffinBerg folded before Flop (didn't bet)
Seat 5: ZonTTT folded before Flop (didn't bet)
Seat 6: Ahangama folded before Flop (didn't bet)
Seat 7: matiko09 folded before Flop (didn't bet)
Seat 8: dndngod folded before Flop (didn't bet)
Seat 9: CvMCvMCvM (button) folded before Flop (didn't bet)





PokerStars Hand #150800987772:  Hold'em No Limit ($1/$2 USD) - 2016/03/23 14:19:40 CET [2016/03/23 9:19:40 ET]
Table 'Kiess' 9-max Seat #5 is the button
Seat 1: Cirilico ($229.74 in chips) 
Seat 2: DUkalisUA ($674.10 in chips) 
Seat 3: The_red_area ($342.27 in chips) 
Seat 4: Moszes360 ($200 in chips) 
Seat 5: chippo boy ($459.32 in chips) 
Seat 6: matiko09 ($272.84 in chips) 
Seat 7: InsomniaRU ($274.37 in chips) 
Seat 8: erfk1958 ($119.55 in chips) 
Seat 9: nickreason17 ($246.72 in chips) 
matiko09: posts small blind $1
InsomniaRU: posts big blind $2
*** HOLE CARDS ***
Dealt to matiko09 [5c Ac]
erfk1958: folds 
nickreason17: folds 
Cirilico: folds 
DUkalisUA has timed out
DUkalisUA: folds 
The_red_area: folds 
Moszes360: folds 
chippo boy: calls $2
matiko09: calls $1
InsomniaRU: checks 
*** FLOP *** [Ad Kh 8c]
matiko09: bets $3.72
InsomniaRU: folds 
chippo boy: calls $3.72
*** TURN *** [Ad Kh 8c] [5d]
matiko09: bets $10
chippo boy: folds 
Uncalled bet ($10) returned to matiko09
matiko09 collected $12.84 from pot
matiko09: doesn't show hand 
*** SUMMARY ***
Total pot $13.44 | Rake $0.60 
Board [Ad Kh 8c 5d]
Seat 1: Cirilico folded before Flop (didn't bet)
Seat 2: DUkalisUA folded before Flop (didn't bet)
Seat 3: The_red_area folded before Flop (didn't bet)
Seat 4: Moszes360 folded before Flop (didn't bet)
Seat 5: chippo boy (button) folded on the Turn
Seat 6: matiko09 (small blind) collected ($12.84)
Seat 7: InsomniaRU (big blind) folded on the Flop
Seat 8: erfk1958 folded before Flop (didn't bet)
Seat 9: nickreason17 folded before Flop (didn't bet)





PokerStars Hand #150800988312:  Hold'em No Limit ($1/$2 USD) - 2016/03/23 14:19:41 CET [2016/03/23 9:19:41 ET]
Table 'Herba II' 9-max Seat #8 is the button
Seat 1: matiko09 ($215.06 in chips) 
Seat 2: Moszes360 ($204.89 in chips) 
Seat 3: Cirilico ($163.32 in chips) 
Seat 4: DUkalisUA ($304.90 in chips) 
Seat 5: chippo boy ($263.38 in chips) 
Seat 6: Too-Anti-To ($212.46 in chips) 
Seat 7: InsomniaRU ($201.78 in chips) 
Seat 8: The_red_area ($439.98 in chips) 
Seat 9: mrhighryza ($44.43 in chips) 
mrhighryza: posts small blind $1
matiko09: posts big blind $2
*** HOLE CARDS ***
Dealt to matiko09 [Ad 2c]
Moszes360: folds 
Cirilico: raises $4 to $6
DUkalisUA: folds 
chippo boy: calls $6
Too-Anti-To: folds 
InsomniaRU: folds 
The_red_area: folds 
mrhighryza: folds 
matiko09: folds 
*** FLOP *** [Kd Tc 2s]
Cirilico: bets $10
chippo boy: raises $10 to $20
Cirilico: calls $10
*** TURN *** [Kd Tc 2s] [As]
Cirilico: checks 
chippo boy: checks 
*** RIVER *** [Kd Tc 2s As] [Kh]
Cirilico: checks 
chippo boy: checks 
*** SHOW DOWN ***
Cirilico: shows [Qd Ac] (two pair, Aces and Kings)
chippo boy: mucks hand 
Cirilico collected $52.52 from pot
*** SUMMARY ***
Total pot $55 | Rake $2.48 
Board [Kd Tc 2s As Kh]
Seat 1: matiko09 (big blind) folded before Flop
Seat 2: Moszes360 folded before Flop (didn't bet)
Seat 3: Cirilico showed [Qd Ac] and won ($52.52) with two pair, Aces and Kings
Seat 4: DUkalisUA folded before Flop (didn't bet)
Seat 5: chippo boy mucked [8s Ah]
Seat 6: Too-Anti-To folded before Flop (didn't bet)
Seat 7: InsomniaRU folded before Flop (didn't bet)
Seat 8: The_red_area (button) folded before Flop (didn't bet)
Seat 9: mrhighryza (small blind) folded before Flop





PokerStars Hand #150800989621:  Hold'em No Limit ($0.50/$1.00 USD) - 2016/03/23 14:19:43 CET [2016/03/23 9:19:43 ET]
Table 'Merope II' 9-max Seat #6 is the button
Seat 1: Jimy Tiltman ($133.70 in chips) 
Seat 2: $-Twackle-$ ($100 in chips) 
Seat 3: pablos1922 ($105.92 in chips) 
Seat 4: YuriiSolodya ($86.09 in chips) 
Seat 5: DUkalisUA ($141.64 in chips) 
Seat 6: Effort92 ($100 in chips) 
Seat 7: matiko09 ($109.73 in chips) 
Seat 8: titentei ($93.50 in chips) 
matiko09: posts small blind $0.50
titentei: posts big blind $1
*** HOLE CARDS ***
Dealt to matiko09 [Ac 9h]
Jimy Tiltman: folds 
$-Twackle-$: folds 
pablos1922: folds 
YuriiSolodya: folds 
DUkalisUA: raises $1.50 to $2.50
Effort92: folds 
matiko09: folds 
titentei: calls $1.50
*** FLOP *** [7d 2d 5s]
titentei: checks 
DUkalisUA: checks 
*** TURN *** [7d 2d 5s] [Js]
titentei: checks 
DUkalisUA: bets $3.46
titentei: folds 
Uncalled bet ($3.46) returned to DUkalisUA
DUkalisUA collected $5.25 from pot
DUkalisUA: doesn't show hand 
*** SUMMARY ***
Total pot $5.50 | Rake $0.25 
Board [7d 2d 5s Js]
Seat 1: Jimy Tiltman folded before Flop (didn't bet)
Seat 2: $-Twackle-$ folded before Flop (didn't bet)
Seat 3: pablos1922 folded before Flop (didn't bet)
Seat 4: YuriiSolodya folded before Flop (didn't bet)
Seat 5: DUkalisUA collected ($5.25)
Seat 6: Effort92 (button) folded before Flop (didn't bet)
Seat 7: matiko09 (small blind) folded before Flop
Seat 8: titentei (big blind) folded on the Turn





PokerStars Hand #150800990327:  Hold'em No Limit ($1/$2 USD) - 2016/03/23 14:19:45 CET [2016/03/23 9:19:45 ET]
Table 'Deipylos II' 9-max Seat #1 is the button
Seat 1: $-Twackle-$ ($200 in chips) 
Seat 2: T0ny Adams ($89.32 in chips) 
Seat 4: matiko09 ($203 in chips) 
Seat 5: InsomniaRU ($203 in chips) 
Seat 6: nickreason17 ($203 in chips) 
Seat 7: volwebni4ek ($80 in chips) 
Seat 8: Igoriah ($200 in chips) 
Seat 9: Ranatuo84 ($233.42 in chips) 
T0ny Adams: posts small blind $1
matiko09: posts big blind $2
*** HOLE CARDS ***
Dealt to matiko09 [9d Kh]
InsomniaRU: folds 
nickreason17: folds 
volwebni4ek: folds 
Igoriah: raises $3 to $5
Ranatuo84: calls $5
$-Twackle-$: folds 
T0ny Adams: folds 
matiko09: folds 
*** FLOP *** [2c 5c 6d]
Igoriah: bets $9
Ranatuo84: calls $9
*** TURN *** [2c 5c 6d] [7h]
Igoriah: bets $21
Ranatuo84: calls $21
*** RIVER *** [2c 5c 6d 7h] [4h]
Igoriah: checks 
Ranatuo84: checks 
*** SHOW DOWN ***
Igoriah: shows [7s 7d] (three of a kind, Sevens)
Ranatuo84: shows [8d 5d] (a straight, Four to Eight)
Ranatuo84 collected $70.20 from pot
*** SUMMARY ***
Total pot $73 | Rake $2.80 
Board [2c 5c 6d 7h 4h]
Seat 1: $-Twackle-$ (button) folded before Flop (didn't bet)
Seat 2: T0ny Adams (small blind) folded before Flop
Seat 4: matiko09 (big blind) folded before Flop
Seat 5: InsomniaRU folded before Flop (didn't bet)
Seat 6: nickreason17 folded before Flop (didn't bet)
Seat 7: volwebni4ek folded before Flop (didn't bet)
Seat 8: Igoriah showed [7s 7d] and lost with three of a kind, Sevens
Seat 9: Ranatuo84 showed [8d 5d] and won ($70.20) with a straight, Four to Eight





PokerStars Hand #150800997218:  Hold'em No Limit ($0.50/$1.00 USD) - 2016/03/23 14:19:56 CET [2016/03/23 9:19:56 ET]
Table 'Donar II' 9-max Seat #8 is the button
Seat 1: Effort92 ($110.71 in chips) 
Seat 2: nobrunobru1 ($59.84 in chips) 
Seat 3: st-germ30 ($101.49 in chips) 
Seat 4: DUkalisUA ($148.69 in chips) 
Seat 5: matiko09 ($100 in chips) 
Seat 6: ardo888 ($130.40 in chips) 
Seat 7: JimineyCrik ($90.35 in chips) 
Seat 8: $-Twackle-$ ($105.20 in chips) 
Seat 9: oxfordtenzin ($120.89 in chips) 
oxfordtenzin: posts small blind $0.50
Effort92: posts big blind $1
Effort92: posts the ante $0.20
nobrunobru1: posts the ante $0.20
st-germ30: posts the ante $0.20
DUkalisUA: posts the ante $0.20
matiko09: posts the ante $0.20
ardo888: posts the ante $0.20
JimineyCrik: posts the ante $0.20
$-Twackle-$: posts the ante $0.20
oxfordtenzin: posts the ante $0.20
*** HOLE CARDS ***
Dealt to matiko09 [Jh 9c]
nobrunobru1: folds 
st-germ30: folds 
DUkalisUA: folds 
matiko09: folds 
ardo888: folds 
JimineyCrik: raises $1 to $2
$-Twackle-$: folds 
oxfordtenzin: calls $1.50
Effort92: calls $1
*** FLOP *** [7s 9s 2s]
oxfordtenzin: checks 
Effort92: checks 
JimineyCrik: bets $3.79
oxfordtenzin: folds 
Effort92: calls $3.79
*** TURN *** [7s 9s 2s] [7h]
Effort92: checks 
JimineyCrik: bets $7.49
Effort92: folds 
Uncalled bet ($7.49) returned to JimineyCrik
JimineyCrik collected $14.69 from pot
JimineyCrik: doesn't show hand 
*** SUMMARY ***
Total pot $15.38 | Rake $0.69 
Board [7s 9s 2s 7h]
Seat 1: Effort92 (big blind) folded on the Turn
Seat 2: nobrunobru1 folded before Flop (didn't bet)
Seat 3: st-germ30 folded before Flop (didn't bet)
Seat 4: DUkalisUA folded before Flop (didn't bet)
Seat 5: matiko09 folded before Flop (didn't bet)
Seat 6: ardo888 folded before Flop (didn't bet)
Seat 7: JimineyCrik collected ($14.69)
Seat 8: $-Twackle-$ (button) folded before Flop (didn't bet)
Seat 9: oxfordtenzin (small blind) folded on the Flop





PokerStars Hand #150801000736:  Hold'em No Limit (€0.50/€1.00 EUR) - 2016/03/23 14:20:02 CET [2016/03/23 9:20:02 ET]
Table 'Lanzia' 9-max Seat #9 is the button
Seat 2: ardo888 (€102 in chips) 
Seat 3: Effort92 (€198.85 in chips) 
Seat 4: niong62 (€99.38 in chips) 
Seat 5: matiko09 (€100 in chips) 
Seat 6: Red4erT (€40 in chips) 
Seat 7: $-Twackle-$ (€100 in chips) 
Seat 8: Muinmyheart (€103.50 in chips) 
Seat 9: Butcher1848 (€102.10 in chips) 
ardo888: posts small blind €0.50
Effort92: posts big blind €1
*** HOLE CARDS ***
Dealt to matiko09 [3d As]
niong62: folds 
matiko09: folds 
Red4erT: folds 
$-Twackle-$: folds 
Muinmyheart: folds 
Butcher1848: folds 
ardo888: folds 
Uncalled bet (€0.50) returned to Effort92
Effort92 collected €1 from pot
Effort92: doesn't show hand 
*** SUMMARY ***
Total pot €1 | Rake €0 
Seat 2: ardo888 (small blind) folded before Flop
Seat 3: Effort92 (big blind) collected (€1)
Seat 4: niong62 folded before Flop (didn't bet)
Seat 5: matiko09 folded before Flop (didn't bet)
Seat 6: Red4erT folded before Flop (didn't bet)
Seat 7: $-Twackle-$ folded before Flop (didn't bet)
Seat 8: Muinmyheart folded before Flop (didn't bet)
Seat 9: Butcher1848 (button) folded before Flop (didn't bet)





PokerStars Hand #150801001580:  Hold'em No Limit ($1/$2 USD) - 2016/03/23 14:20:03 CET [2016/03/23 9:20:03 ET]
Table 'Ennomos II' 9-max Seat #5 is the button
Seat 1: ilaviiitech ($200 in chips) 
Seat 2: Subam ($430.18 in chips) 
Seat 3: $-Twackle-$ ($200 in chips) 
Seat 4: glanza_mike ($200 in chips) 
Seat 5: South011 ($384.88 in chips) 
Seat 6: nickreason17 ($235.98 in chips) 
Seat 7: daniferdoser ($200 in chips) 
Seat 8: yyfk ($200 in chips) 
Seat 9: matiko09 ($200 in chips) 
nickreason17: posts small blind $1
daniferdoser: posts big blind $2
*** HOLE CARDS ***
Dealt to matiko09 [9h Kd]
yyfk: folds 
matiko09: folds 
ilaviiitech: folds 
Subam: folds 
$-Twackle-$: folds 
glanza_mike: folds 
South011: folds 
nickreason17: raises $3 to $5
daniferdoser: folds 
Uncalled bet ($3) returned to nickreason17
nickreason17 collected $4 from pot
*** SUMMARY ***
Total pot $4 | Rake $0 
Seat 1: ilaviiitech folded before Flop (didn't bet)
Seat 2: Subam folded before Flop (didn't bet)
Seat 3: $-Twackle-$ folded before Flop (didn't bet)
Seat 4: glanza_mike folded before Flop (didn't bet)
Seat 5: South011 (button) folded before Flop (didn't bet)
Seat 6: nickreason17 (small blind) collected ($4)
Seat 7: daniferdoser (big blind) folded before Flop
Seat 8: yyfk folded before Flop (didn't bet)
Seat 9: matiko09 folded before Flop (didn't bet)





PokerStars Hand #150801002989:  Hold'em No Limit ($1/$2 USD) - 2016/03/23 14:20:06 CET [2016/03/23 9:20:06 ET]
Table 'Achaia' 9-max Seat #5 is the button
Seat 1: ilaviiitech ($200 in chips) 
Seat 2: InsomniaRU ($223.66 in chips) 
Seat 3: matiko09 ($200 in chips) 
Seat 4: nailz83 ($179.46 in chips) 
Seat 5: DUkalisUA ($213.37 in chips) 
Seat 6: nickreason17 ($211.06 in chips) 
Seat 7: morosun ($212.03 in chips) 
Seat 8: $-Twackle-$ ($222.65 in chips) 
Seat 9: glanza_mike ($204.28 in chips) 
nickreason17: posts small blind $1
morosun: posts big blind $2
*** HOLE CARDS ***
Dealt to matiko09 [7d Ts]
$-Twackle-$: folds 
glanza_mike: folds 
ilaviiitech: folds 
InsomniaRU: folds 
matiko09: folds 
nailz83: folds 
DUkalisUA: folds 
nickreason17: raises $3 to $5
morosun: calls $3
*** FLOP *** [4c 5c 3d]
nickreason17: checks 
morosun: bets $4
nickreason17: calls $4
*** TURN *** [4c 5c 3d] [9c]
nickreason17: checks 
morosun: bets $4
nickreason17: folds 
Uncalled bet ($4) returned to morosun
morosun collected $17.19 from pot
*** SUMMARY ***
Total pot $18 | Rake $0.81 
Board [4c 5c 3d 9c]
Seat 1: ilaviiitech folded before Flop (didn't bet)
Seat 2: InsomniaRU folded before Flop (didn't bet)
Seat 3: matiko09 folded before Flop (didn't bet)
Seat 4: nailz83 folded before Flop (didn't bet)
Seat 5: DUkalisUA (button) folded before Flop (didn't bet)
Seat 6: nickreason17 (small blind) folded on the Turn
Seat 7: morosun (big blind) collected ($17.19)
Seat 8: $-Twackle-$ folded before Flop (didn't bet)
Seat 9: glanza_mike folded before Flop (didn't bet)





PokerStars Hand #150801005903:  Hold'em No Limit ($1/$2 USD) - 2016/03/23 14:20:10 CET [2016/03/23 9:20:10 ET]
Table 'Kypria II' 9-max Seat #2 is the button
Seat 1: geldwolfje ($81.90 in chips) 
Seat 2: coinflip_si ($219.70 in chips) 
Seat 3: seouljam ($177.45 in chips) 
Seat 4: VolanDog ($200 in chips) 
Seat 5: InsomniaRU ($401.28 in chips) 
Seat 6: matiko09 ($373.95 in chips) 
Seat 7: DUkalisUA ($204.37 in chips) 
Seat 9: Moszes360 ($202 in chips) 
seouljam: posts small blind $1
VolanDog: posts big blind $2
Pearl Jam87: sits out 
*** HOLE CARDS ***
Dealt to matiko09 [9c Ac]
InsomniaRU: folds 
matiko09: folds 
DUkalisUA: raises $4 to $6
Moszes360: folds 
geldwolfje: folds 
coinflip_si: folds 
seouljam: raises $10 to $16
VolanDog: folds 
DUkalisUA: folds 
Uncalled bet ($10) returned to seouljam
seouljam collected $14 from pot
seouljam: doesn't show hand 
*** SUMMARY ***
Total pot $14 | Rake $0 
Seat 1: geldwolfje folded before Flop (didn't bet)
Seat 2: coinflip_si (button) folded before Flop (didn't bet)
Seat 3: seouljam (small blind) collected ($14)
Seat 4: VolanDog (big blind) folded before Flop
Seat 5: InsomniaRU folded before Flop (didn't bet)
Seat 6: matiko09 folded before Flop (didn't bet)
Seat 7: DUkalisUA folded before Flop
Seat 9: Moszes360 folded before Flop (didn't bet)





PokerStars Hand #150801009745:  Hold'em No Limit ($0.25/$0.50 USD) - 2016/03/23 14:20:17 CET [2016/03/23 9:20:17 ET]
Table 'Pyrrhus' 9-max Seat #1 is the button
Seat 1: lumen21 ($81.02 in chips) 
Seat 2: alemão007 ($47.25 in chips) 
Seat 3: i L00K great ($50 in chips) 
Seat 4: GriffinBerg ($34.38 in chips) 
Seat 5: ZonTTT ($56.61 in chips) 
Seat 6: Ahangama ($50 in chips) 
Seat 7: matiko09 ($134.81 in chips) 
Seat 8: dndngod ($77.27 in chips) 
Seat 9: CvMCvMCvM ($97.63 in chips) 
alemão007: posts small blind $0.25
i L00K great: posts big blind $0.50
*** HOLE CARDS ***
Dealt to matiko09 [6h 4s]
GriffinBerg: folds 
ZonTTT: folds 
Ahangama: folds 
matiko09: folds 
dndngod: raises $0.75 to $1.25
CvMCvMCvM: folds 
lumen21: calls $1.25
alemão007: folds 
i L00K great: calls $0.75
*** FLOP *** [Kd 2s 7h]
i L00K great: checks 
dndngod: bets $2.50
lumen21: folds 
i L00K great: folds 
Uncalled bet ($2.50) returned to dndngod
dndngod collected $3.82 from pot
dndngod: doesn't show hand 
*** SUMMARY ***
Total pot $4 | Rake $0.18 
Board [Kd 2s 7h]
Seat 1: lumen21 (button) folded on the Flop
Seat 2: alemão007 (small blind) folded before Flop
Seat 3: i L00K great (big blind) folded on the Flop
Seat 4: GriffinBerg folded before Flop (didn't bet)
Seat 5: ZonTTT folded before Flop (didn't bet)
Seat 6: Ahangama folded before Flop (didn't bet)
Seat 7: matiko09 folded before Flop (didn't bet)
Seat 8: dndngod collected ($3.82)
Seat 9: CvMCvMCvM folded before Flop (didn't bet)





PokerStars Hand #150801016835:  Hold'em No Limit ($0.50/$1.00 USD) - 2016/03/23 14:20:28 CET [2016/03/23 9:20:28 ET]
Table 'Atlantis' 9-max Seat #1 is the button
Seat 1: xHourglass ($146.77 in chips) 
Seat 2: tffff2006 ($72.72 in chips) 
Seat 3: CAJUN890 ($105.79 in chips) 
Seat 4: matiko09 ($130.75 in chips) 
Seat 5: Pvsx. ($100 in chips) 
Seat 6: Jimy Tiltman ($100 in chips) 
Seat 7: Sherlockplay ($141.27 in chips) 
Seat 8: DUkalisUA ($101 in chips) 
tffff2006: posts small blind $0.50
CAJUN890: posts big blind $1
*** HOLE CARDS ***
Dealt to matiko09 [7c 6c]
matiko09: folds 
Pvsx.: folds 
Jimy Tiltman: folds 
Sherlockplay: raises $1.50 to $2.50
DUkalisUA: folds 
xHourglass: raises $5 to $7.50
tffff2006: folds 
CAJUN890: folds 
Sherlockplay: folds 
Uncalled bet ($5) returned to xHourglass
xHourglass collected $6.50 from pot
xHourglass: doesn't show hand 
*** SUMMARY ***
Total pot $6.50 | Rake $0 
Seat 1: xHourglass (button) collected ($6.50)
Seat 2: tffff2006 (small blind) folded before Flop
Seat 3: CAJUN890 (big blind) folded before Flop
Seat 4: matiko09 folded before Flop (didn't bet)
Seat 5: Pvsx. folded before Flop (didn't bet)
Seat 6: Jimy Tiltman folded before Flop (didn't bet)
Seat 7: Sherlockplay folded before Flop
Seat 8: DUkalisUA folded before Flop (didn't bet)





PokerStars Hand #150801020151:  Hold'em No Limit (€0.50/€1.00 EUR) - 2016/03/23 14:20:34 CET [2016/03/23 9:20:34 ET]
Table 'Lanzia' 9-max Seat #2 is the button
Seat 2: ardo888 (€101.50 in chips) 
Seat 3: Effort92 (€199.35 in chips) 
Seat 4: niong62 (€99.38 in chips) 
Seat 5: matiko09 (€100 in chips) 
Seat 6: Red4erT (€40 in chips) 
Seat 7: $-Twackle-$ (€100 in chips) 
Seat 8: Muinmyheart (€103.50 in chips) 
Seat 9: Butcher1848 (€102.10 in chips) 
Effort92: posts small blind €0.50
niong62: posts big blind €1
*** HOLE CARDS ***
Dealt to matiko09 [7h 2h]
matiko09: folds 
Red4erT: folds 
$-Twackle-$: folds 
Muinmyheart: folds 
fk154 joins the table at seat #1 
Butcher1848: raises €1.54 to €2.54
ardo888: folds 
Effort92: calls €2.04
niong62: folds 
*** FLOP *** [5c Jc Kh]
Effort92: checks 
Butcher1848: bets €3.40
Effort92: folds 
Uncalled bet (€3.40) returned to Butcher1848
Butcher1848 collected €5.81 from pot
Butcher1848: doesn't show hand 
*** SUMMARY ***
Total pot €6.08 | Rake €0.27 
Board [5c Jc Kh]
Seat 2: ardo888 (button) folded before Flop (didn't bet)
Seat 3: Effort92 (small blind) folded on the Flop
Seat 4: niong62 (big blind) folded before Flop
Seat 5: matiko09 folded before Flop (didn't bet)
Seat 6: Red4erT folded before Flop (didn't bet)
Seat 7: $-Twackle-$ folded before Flop (didn't bet)
Seat 8: Muinmyheart folded before Flop (didn't bet)
Seat 9: Butcher1848 collected (€5.81)





PokerStars Hand #150801020787:  Hold'em No Limit ($0.50/$1.00 USD) - 2016/03/23 14:20:35 CET [2016/03/23 9:20:35 ET]
Table 'Kippes' 9-max Seat #6 is the button
Seat 1: Pvsx. ($120.18 in chips) 
Seat 3: CAJUN890 ($123.97 in chips) 
Seat 4: matiko09 ($100 in chips) 
Seat 5: Jimy Tiltman ($131.10 in chips) 
Seat 6: DUkalisUA ($113.36 in chips) 
Seat 7: lumen21 ($100 in chips) 
Seat 8: Sherlockplay ($100 in chips) 
Seat 9: wang19790906 ($100.51 in chips) 
lumen21: posts small blind $0.50
Sherlockplay: posts big blind $1
*** HOLE CARDS ***
Dealt to matiko09 [8s Qd]
wang19790906: calls $1
Pvsx.: folds 
CAJUN890: folds 
matiko09: folds 
Jimy Tiltman: raises $2.50 to $3.50
DUkalisUA: folds 
lumen21: folds 
Sherlockplay: folds 
wang19790906: calls $2.50
*** FLOP *** [7d 4d 4h]
wang19790906: checks 
Jimy Tiltman: bets $6.09
wang19790906: folds 
Uncalled bet ($6.09) returned to Jimy Tiltman
Jimy Tiltman collected $8.12 from pot
Jimy Tiltman: doesn't show hand 
*** SUMMARY ***
Total pot $8.50 | Rake $0.38 
Board [7d 4d 4h]
Seat 1: Pvsx. folded before Flop (didn't bet)
Seat 3: CAJUN890 folded before Flop (didn't bet)
Seat 4: matiko09 folded before Flop (didn't bet)
Seat 5: Jimy Tiltman collected ($8.12)
Seat 6: DUkalisUA (button) folded before Flop (didn't bet)
Seat 7: lumen21 (small blind) folded before Flop
Seat 8: Sherlockplay (big blind) folded before Flop
Seat 9: wang19790906 folded on the Flop





PokerStars Hand #150801031015:  Hold'em No Limit ($1/$2 USD) - 2016/03/23 14:20:37 CET [2016/03/23 9:20:37 ET]
Table 'Ennomos II' 9-max Seat #6 is the button
Seat 1: ilaviiitech ($200 in chips) 
Seat 2: Subam ($430.18 in chips) 
Seat 3: $-Twackle-$ ($200 in chips) 
Seat 4: glanza_mike ($200 in chips) 
Seat 5: South011 ($384.88 in chips) 
Seat 6: nickreason17 ($237.98 in chips) 
Seat 7: daniferdoser ($200 in chips) 
Seat 8: yyfk ($200 in chips) 
Seat 9: matiko09 ($200 in chips) 
daniferdoser: posts small blind $1
yyfk: posts big blind $2
*** HOLE CARDS ***
Dealt to matiko09 [Qc 9d]
matiko09: folds 
ilaviiitech: folds 
Subam: raises $2 to $4
$-Twackle-$: folds 
glanza_mike: folds 
South011: folds 
nickreason17: folds 
daniferdoser: folds 
yyfk: calls $2
*** FLOP *** [7c 4h Th]
yyfk: checks 
Subam: bets $4
yyfk: calls $4
*** TURN *** [7c 4h Th] [Jc]
yyfk: checks 
ilaviiitech said, " y vas toge v lobi stoliu zakkriutiu"
Subam: checks 
*** RIVER *** [7c 4h Th Jc] [2c]
yyfk: bets $10.82
ilaviiitech said, "?"
Subam: folds 
Uncalled bet ($10.82) returned to yyfk
yyfk collected $16.24 from pot
yyfk: doesn't show hand 
*** SUMMARY ***
Total pot $17 | Rake $0.76 
Board [7c 4h Th Jc 2c]
Seat 1: ilaviiitech folded before Flop (didn't bet)
Seat 2: Subam folded on the River
Seat 3: $-Twackle-$ folded before Flop (didn't bet)
Seat 4: glanza_mike folded before Flop (didn't bet)
Seat 5: South011 folded before Flop (didn't bet)
Seat 6: nickreason17 (button) folded before Flop (didn't bet)
Seat 7: daniferdoser (small blind) folded before Flop
Seat 8: yyfk (big blind) collected ($16.24)
Seat 9: matiko09 folded before Flop (didn't bet)





PokerStars Hand #150801040176:  Hold'em No Limit ($1/$2 USD) - 2016/03/23 14:20:52 CET [2016/03/23 9:20:52 ET]
Table 'Achaia' 9-max Seat #6 is the button
Seat 1: ilaviiitech ($200 in chips) 
Seat 2: InsomniaRU ($223.66 in chips) 
Seat 3: matiko09 ($200 in chips) 
Seat 4: nailz83 ($179.46 in chips) 
Seat 5: DUkalisUA ($213.37 in chips) 
Seat 6: nickreason17 ($202.06 in chips) 
Seat 7: morosun ($220.22 in chips) 
Seat 8: $-Twackle-$ ($222.65 in chips) 
Seat 9: glanza_mike ($204.28 in chips) 
morosun: posts small blind $1
$-Twackle-$: posts big blind $2
*** HOLE CARDS ***
Dealt to matiko09 [3s Ah]
glanza_mike: folds 
ilaviiitech: folds 
InsomniaRU: folds 
matiko09: folds 
nailz83: folds 
DUkalisUA has timed out
DUkalisUA: folds 
nickreason17: raises $2.08 to $4.08
morosun: folds 
$-Twackle-$: calls $2.08
*** FLOP *** [Qc 8s As]
$-Twackle-$: checks 
nickreason17: checks 
*** TURN *** [Qc 8s As] [5c]
$-Twackle-$: checks 
nickreason17: bets $6.12
$-Twackle-$: calls $6.12
*** RIVER *** [Qc 8s As 5c] [Tc]
$-Twackle-$: checks 
nickreason17: bets $10.22
$-Twackle-$: folds 
Uncalled bet ($10.22) returned to nickreason17
nickreason17 collected $20.44 from pot
*** SUMMARY ***
Total pot $21.40 | Rake $0.96 
Board [Qc 8s As 5c Tc]
Seat 1: ilaviiitech folded before Flop (didn't bet)
Seat 2: InsomniaRU folded before Flop (didn't bet)
Seat 3: matiko09 folded before Flop (didn't bet)
Seat 4: nailz83 folded before Flop (didn't bet)
Seat 5: DUkalisUA folded before Flop (didn't bet)
Seat 6: nickreason17 (button) collected ($20.44)
Seat 7: morosun (small blind) folded before Flop
Seat 8: $-Twackle-$ (big blind) folded on the River
Seat 9: glanza_mike folded before Flop (didn't bet)





PokerStars Hand #150801040472:  Hold'em No Limit ($0.50/$1.00 USD) - 2016/03/23 14:20:53 CET [2016/03/23 9:20:53 ET]
Table 'Merope II' 9-max Seat #7 is the button
Seat 1: Jimy Tiltman ($133.70 in chips) 
Seat 2: $-Twackle-$ ($100 in chips) 
Seat 3: pablos1922 ($105.92 in chips) 
Seat 4: YuriiSolodya ($86.09 in chips) 
Seat 5: DUkalisUA ($144.39 in chips) 
Seat 6: Effort92 ($100 in chips) 
Seat 7: matiko09 ($109.23 in chips) 
Seat 8: titentei ($91 in chips) 
titentei: posts small blind $0.50
Jimy Tiltman: posts big blind $1
*** HOLE CARDS ***
Dealt to matiko09 [6s Ac]
$-Twackle-$: folds 
pablos1922: raises $2 to $3
YuriiSolodya: folds 
DUkalisUA: calls $3
Effort92: folds 
matiko09: folds 
titentei: folds 
Jimy Tiltman: folds 
*** FLOP *** [Ad 3c Tc]
pablos1922: checks 
DUkalisUA: bets $4.72
pablos1922: folds 
Uncalled bet ($4.72) returned to DUkalisUA
DUkalisUA collected $7.16 from pot
DUkalisUA: doesn't show hand 
*** SUMMARY ***
Total pot $7.50 | Rake $0.34 
Board [Ad 3c Tc]
Seat 1: Jimy Tiltman (big blind) folded before Flop
Seat 2: $-Twackle-$ folded before Flop (didn't bet)
Seat 3: pablos1922 folded on the Flop
Seat 4: YuriiSolodya folded before Flop (didn't bet)
Seat 5: DUkalisUA collected ($7.16)
Seat 6: Effort92 folded before Flop (didn't bet)
Seat 7: matiko09 (button) folded before Flop (didn't bet)
Seat 8: titentei (small blind) folded before Flop





PokerStars Hand #150801041947:  Hold'em No Limit ($1/$2 USD) - 2016/03/23 14:20:55 CET [2016/03/23 9:20:55 ET]
Table 'Deipylos II' 9-max Seat #2 is the button
Seat 1: $-Twackle-$ ($200 in chips) 
Seat 2: T0ny Adams ($88.32 in chips) 
Seat 4: matiko09 ($201 in chips) 
Seat 5: InsomniaRU ($203 in chips) 
Seat 6: nickreason17 ($203 in chips) 
Seat 7: volwebni4ek ($80 in chips) 
Seat 8: Igoriah ($200 in chips) 
Seat 9: Ranatuo84 ($268.62 in chips) 
matiko09: posts small blind $1
InsomniaRU: posts big blind $2
*** HOLE CARDS ***
Dealt to matiko09 [6s 4c]
nickreason17: raises $3 to $5
volwebni4ek: calls $5
Igoriah: folds 
Ranatuo84: folds 
$-Twackle-$: folds 
T0ny Adams: folds 
matiko09: folds 
InsomniaRU: folds 
*** FLOP *** [6c Kc Jd]
nickreason17: bets $8
volwebni4ek: raises $14.22 to $22.22
nickreason17: folds 
Uncalled bet ($14.22) returned to volwebni4ek
volwebni4ek collected $27.70 from pot
volwebni4ek: doesn't show hand 
*** SUMMARY ***
Total pot $29 | Rake $1.30 
Board [6c Kc Jd]
Seat 1: $-Twackle-$ folded before Flop (didn't bet)
Seat 2: T0ny Adams (button) folded before Flop (didn't bet)
Seat 4: matiko09 (small blind) folded before Flop
Seat 5: InsomniaRU (big blind) folded before Flop
Seat 6: nickreason17 folded on the Flop
Seat 7: volwebni4ek collected ($27.70)
Seat 8: Igoriah folded before Flop (didn't bet)
Seat 9: Ranatuo84 folded before Flop (didn't bet)





PokerStars Hand #150801044080:  Hold'em No Limit ($1/$2 USD) - 2016/03/23 14:20:59 CET [2016/03/23 9:20:59 ET]
Table 'Kypria II' 9-max Seat #3 is the button
Seat 1: geldwolfje ($81.90 in chips) 
Seat 2: coinflip_si ($219.70 in chips) 
Seat 3: seouljam ($185.45 in chips) 
Seat 4: VolanDog ($200 in chips) 
Seat 5: InsomniaRU ($401.28 in chips) 
Seat 6: matiko09 ($373.95 in chips) 
Seat 7: DUkalisUA ($200 in chips) 
Seat 9: Moszes360 ($202 in chips) 
VolanDog: posts small blind $1
InsomniaRU: posts big blind $2
Pearl Jam87: sits out 
*** HOLE CARDS ***
Dealt to matiko09 [6c Td]
matiko09: folds 
DUkalisUA: folds 
Moszes360: folds 
geldwolfje: folds 
coinflip_si: folds 
seouljam: raises $2.40 to $4.40
VolanDog: folds 
InsomniaRU: calls $2.40
*** FLOP *** [2d 5c 3d]
InsomniaRU: checks 
seouljam: checks 
*** TURN *** [2d 5c 3d] [2h]
InsomniaRU: checks 
seouljam: bets $6
InsomniaRU: calls $6
*** RIVER *** [2d 5c 3d 2h] [9d]
InsomniaRU: checks 
seouljam: bets $10
InsomniaRU: calls $10
*** SHOW DOWN ***
seouljam: shows [Jd Js] (two pair, Jacks and Deuces)
InsomniaRU: mucks hand 
seouljam collected $39.92 from pot
*** SUMMARY ***
Total pot $41.80 | Rake $1.88 
Board [2d 5c 3d 2h 9d]
Seat 1: geldwolfje folded before Flop (didn't bet)
Seat 2: coinflip_si folded before Flop (didn't bet)
Seat 3: seouljam (button) showed [Jd Js] and won ($39.92) with two pair, Jacks and Deuces
Seat 4: VolanDog (small blind) folded before Flop
Seat 5: InsomniaRU (big blind) mucked [Ad 9s]
Seat 6: matiko09 folded before Flop (didn't bet)
Seat 7: DUkalisUA folded before Flop (didn't bet)
Seat 9: Moszes360 folded before Flop (didn't bet)





PokerStars Hand #150801050346:  Hold'em No Limit ($0.50/$1.00 USD) - 2016/03/23 14:21:09 CET [2016/03/23 9:21:09 ET]
Table 'Donar II' 9-max Seat #9 is the button
Seat 1: Effort92 ($104.72 in chips) 
Seat 2: nobrunobru1 ($59.64 in chips) 
Seat 3: st-germ30 ($101.29 in chips) 
Seat 4: DUkalisUA ($148.49 in chips) 
Seat 5: matiko09 ($100 in chips) 
Seat 6: ardo888 ($130.20 in chips) 
Seat 7: JimineyCrik ($99.05 in chips) 
Seat 8: $-Twackle-$ ($105 in chips) 
Seat 9: oxfordtenzin ($118.69 in chips) 
Effort92: posts small blind $0.50
nobrunobru1: posts big blind $1
Effort92: posts the ante $0.20
nobrunobru1: posts the ante $0.20
st-germ30: posts the ante $0.20
DUkalisUA: posts the ante $0.20
matiko09: posts the ante $0.20
ardo888: posts the ante $0.20
JimineyCrik: posts the ante $0.20
$-Twackle-$: posts the ante $0.20
oxfordtenzin: posts the ante $0.20
*** HOLE CARDS ***
Dealt to matiko09 [9c 9d]
st-germ30: folds 
DUkalisUA: raises $2 to $3
matiko09: calls $3
ardo888: folds 
JimineyCrik: folds 
$-Twackle-$: calls $3
oxfordtenzin: folds 
Effort92: folds 
nobrunobru1: folds 
*** FLOP *** [Qs 6c Js]
DUkalisUA: checks 
matiko09: checks 
$-Twackle-$: checks 
*** TURN *** [Qs 6c Js] [4h]
DUkalisUA: checks 
matiko09: checks 
$-Twackle-$: bets $7.50
DUkalisUA: folds 
matiko09: folds 
Uncalled bet ($7.50) returned to $-Twackle-$
$-Twackle-$ collected $11.75 from pot
$-Twackle-$: doesn't show hand 
*** SUMMARY ***
Total pot $12.30 | Rake $0.55 
Board [Qs 6c Js 4h]
Seat 1: Effort92 (small blind) folded before Flop
Seat 2: nobrunobru1 (big blind) folded before Flop
Seat 3: st-germ30 folded before Flop (didn't bet)
Seat 4: DUkalisUA folded on the Turn
Seat 5: matiko09 folded on the Turn
Seat 6: ardo888 folded before Flop (didn't bet)
Seat 7: JimineyCrik folded before Flop (didn't bet)
Seat 8: $-Twackle-$ collected ($11.75)
Seat 9: oxfordtenzin (button) folded before Flop (didn't bet)





PokerStars Hand #150801051477:  Hold'em No Limit ($1/$2 USD) - 2016/03/23 14:21:11 CET [2016/03/23 9:21:11 ET]
Table 'Herba II' 9-max Seat #9 is the button
Seat 1: matiko09 ($213.06 in chips) 
Seat 2: Moszes360 ($204.89 in chips) 
Seat 3: Cirilico ($189.84 in chips) 
Seat 4: DUkalisUA ($304.90 in chips) 
Seat 5: chippo boy ($237.38 in chips) 
Seat 6: Too-Anti-To ($212.46 in chips) 
Seat 7: InsomniaRU ($201.78 in chips) 
Seat 8: The_red_area ($439.98 in chips) 
Seat 9: mrhighryza ($43.43 in chips) 
matiko09: posts small blind $1
Moszes360: posts big blind $2
*** HOLE CARDS ***
Dealt to matiko09 [Ks 5s]
Cirilico: folds 
DUkalisUA: folds 
chippo boy: raises $4 to $6
Too-Anti-To: folds 
InsomniaRU: folds 
The_red_area: folds 
mrhighryza: calls $6
matiko09: folds 
Moszes360: calls $4
*** FLOP *** [Jd Qs Td]
Moszes360: checks 
chippo boy: checks 
mrhighryza: checks 
*** TURN *** [Jd Qs Td] [7s]
Moszes360: checks 
chippo boy: bets $10
mrhighryza: calls $10
Moszes360: folds 
*** RIVER *** [Jd Qs Td 7s] [Qc]
chippo boy: checks 
mrhighryza: checks 
*** SHOW DOWN ***
chippo boy: shows [3h 6h] (a pair of Queens)
mrhighryza: shows [9s 9c] (two pair, Queens and Nines)
mrhighryza collected $37.24 from pot
*** SUMMARY ***
Total pot $39 | Rake $1.76 
Board [Jd Qs Td 7s Qc]
Seat 1: matiko09 (small blind) folded before Flop
Seat 2: Moszes360 (big blind) folded on the Turn
Seat 3: Cirilico folded before Flop (didn't bet)
Seat 4: DUkalisUA folded before Flop (didn't bet)
Seat 5: chippo boy showed [3h 6h] and lost with a pair of Queens
Seat 6: Too-Anti-To folded before Flop (didn't bet)
Seat 7: InsomniaRU folded before Flop (didn't bet)
Seat 8: The_red_area folded before Flop (didn't bet)
Seat 9: mrhighryza (button) showed [9s 9c] and won ($37.24) with two pair, Queens and Nines





PokerStars Hand #150801054245:  Hold'em No Limit ($0.50/$1.00 USD) - 2016/03/23 14:21:15 CET [2016/03/23 9:21:15 ET]
Table 'Kippes' 9-max Seat #7 is the button
Seat 1: Pvsx. ($120.18 in chips) 
Seat 3: CAJUN890 ($123.97 in chips) 
Seat 4: matiko09 ($100 in chips) 
Seat 5: Jimy Tiltman ($135.72 in chips) 
Seat 6: DUkalisUA ($113.36 in chips) 
Seat 7: lumen21 ($100 in chips) 
Seat 8: Sherlockplay ($100 in chips) 
Seat 9: wang19790906 ($97.01 in chips) 
Sherlockplay: posts small blind $0.50
wang19790906: posts big blind $1
*** HOLE CARDS ***
Dealt to matiko09 [Kh 7d]
Pvsx.: folds 
CAJUN890: folds 
matiko09: folds 
Jimy Tiltman: folds 
DUkalisUA: folds 
lumen21: raises $2 to $3
Sherlockplay: folds 
wang19790906: folds 
Uncalled bet ($2) returned to lumen21
lumen21 collected $2.50 from pot
lumen21: doesn't show hand 
*** SUMMARY ***
Total pot $2.50 | Rake $0 
Seat 1: Pvsx. folded before Flop (didn't bet)
Seat 3: CAJUN890 folded before Flop (didn't bet)
Seat 4: matiko09 folded before Flop (didn't bet)
Seat 5: Jimy Tiltman folded before Flop (didn't bet)
Seat 6: DUkalisUA folded before Flop (didn't bet)
Seat 7: lumen21 (button) collected ($2.50)
Seat 8: Sherlockplay (small blind) folded before Flop
Seat 9: wang19790906 (big blind) folded before Flop





PokerStars Hand #150801055629:  Hold'em No Limit ($0.50/$1.00 USD) - 2016/03/23 14:21:18 CET [2016/03/23 9:21:18 ET]
Table 'Atlantis' 9-max Seat #2 is the button
Seat 1: xHourglass ($150.77 in chips) 
Seat 2: tffff2006 ($72.22 in chips) 
Seat 3: CAJUN890 ($104.79 in chips) 
Seat 4: matiko09 ($130.75 in chips) 
Seat 5: Pvsx. ($100 in chips) 
Seat 6: Jimy Tiltman ($100 in chips) 
Seat 7: Sherlockplay ($138.77 in chips) 
Seat 8: DUkalisUA ($101 in chips) 
CAJUN890: posts small blind $0.50
matiko09: posts big blind $1
*** HOLE CARDS ***
Dealt to matiko09 [8s Tc]
Pvsx.: folds 
Jimy Tiltman: folds 
Sherlockplay: folds 
DUkalisUA: raises $2 to $3
xHourglass: folds 
tffff2006: folds 
CAJUN890: folds 
matiko09: folds 
Uncalled bet ($2) returned to DUkalisUA
DUkalisUA collected $2.50 from pot
DUkalisUA: doesn't show hand 
*** SUMMARY ***
Total pot $2.50 | Rake $0 
Seat 1: xHourglass folded before Flop (didn't bet)
Seat 2: tffff2006 (button) folded before Flop (didn't bet)
Seat 3: CAJUN890 (small blind) folded before Flop
Seat 4: matiko09 (big blind) folded before Flop
Seat 5: Pvsx. folded before Flop (didn't bet)
Seat 6: Jimy Tiltman folded before Flop (didn't bet)
Seat 7: Sherlockplay folded before Flop (didn't bet)
Seat 8: DUkalisUA collected ($2.50)





PokerStars Hand #150801057656:  Hold'em No Limit ($1/$2 USD) - 2016/03/23 14:21:21 CET [2016/03/23 9:21:21 ET]
Table 'Kiess' 9-max Seat #6 is the button
Seat 1: Cirilico ($229.74 in chips) 
Seat 2: DUkalisUA ($674.10 in chips) 
Seat 3: The_red_area ($342.27 in chips) 
Seat 4: Moszes360 ($200 in chips) 
Seat 5: chippo boy ($453.60 in chips) 
Seat 6: matiko09 ($279.96 in chips) 
Seat 7: InsomniaRU ($272.37 in chips) 
Seat 8: erfk1958 ($119.55 in chips) 
Seat 9: nickreason17 ($246.72 in chips) 
InsomniaRU: posts small blind $1
erfk1958: posts big blind $2
*** HOLE CARDS ***
Dealt to matiko09 [3h Jd]
nickreason17: folds 
Cirilico: folds 
nickreason17 leaves the table
T0ny Adams joins the table at seat #9 
DUkalisUA: folds 
The_red_area: folds 
Moszes360: folds 
chippo boy: folds 
matiko09: folds 
InsomniaRU: raises $3 to $5
erfk1958: folds 
Uncalled bet ($3) returned to InsomniaRU
InsomniaRU collected $4 from pot
InsomniaRU: doesn't show hand 
*** SUMMARY ***
Total pot $4 | Rake $0 
Seat 1: Cirilico folded before Flop (didn't bet)
Seat 2: DUkalisUA folded before Flop (didn't bet)
Seat 3: The_red_area folded before Flop (didn't bet)
Seat 4: Moszes360 folded before Flop (didn't bet)
Seat 5: chippo boy folded before Flop (didn't bet)
Seat 6: matiko09 (button) folded before Flop (didn't bet)
Seat 7: InsomniaRU (small blind) collected ($4)
Seat 8: erfk1958 (big blind) folded before Flop
Seat 9: nickreason17 folded before Flop (didn't bet)





PokerStars Hand #150801065443:  Hold'em No Limit (€0.50/€1.00 EUR) - 2016/03/23 14:21:34 CET [2016/03/23 9:21:34 ET]
Table 'Lanzia' 9-max Seat #3 is the button
Seat 1: fk154 (€40 in chips) 
Seat 2: ardo888 (€101.50 in chips) 
Seat 3: Effort92 (€196.81 in chips) 
Seat 4: niong62 (€98.38 in chips) 
Seat 5: matiko09 (€100 in chips) 
Seat 6: Red4erT (€40 in chips) 
Seat 7: $-Twackle-$ (€100 in chips) 
Seat 8: Muinmyheart (€103.50 in chips) 
Seat 9: Butcher1848 (€105.37 in chips) 
niong62: posts small blind €0.50
matiko09: posts big blind €1
fk154: posts big blind €1
*** HOLE CARDS ***
Dealt to matiko09 [4h 7d]
Red4erT: folds 
$-Twackle-$: raises €2.50 to €3.50
Muinmyheart: folds 
Butcher1848: folds 
fk154: folds 
ardo888: folds 
Effort92: folds 
niong62: calls €3
matiko09: folds 
*** FLOP *** [9c Qh Td]
niong62: bets €3
$-Twackle-$: raises €8 to €11
niong62: calls €8
*** TURN *** [9c Qh Td] [9s]
niong62: checks 
$-Twackle-$: bets €20
niong62: folds 
Uncalled bet (€20) returned to $-Twackle-$
$-Twackle-$ collected €29.60 from pot
$-Twackle-$: doesn't show hand 
*** SUMMARY ***
Total pot €31 | Rake €1.40 
Board [9c Qh Td 9s]
Seat 1: fk154 folded before Flop
Seat 2: ardo888 folded before Flop (didn't bet)
Seat 3: Effort92 (button) folded before Flop (didn't bet)
Seat 4: niong62 (small blind) folded on the Turn
Seat 5: matiko09 (big blind) folded before Flop
Seat 6: Red4erT folded before Flop (didn't bet)
Seat 7: $-Twackle-$ collected (€29.60)
Seat 8: Muinmyheart folded before Flop (didn't bet)
Seat 9: Butcher1848 folded before Flop (didn't bet)





PokerStars Hand #150801070093:  Hold'em No Limit ($0.25/$0.50 USD) - 2016/03/23 14:21:41 CET [2016/03/23 9:21:41 ET]
Table 'Pyrrhus' 9-max Seat #2 is the button
Seat 1: lumen21 ($79.77 in chips) 
Seat 2: alemão007 ($47 in chips) 
Seat 3: i L00K great ($50 in chips) 
Seat 4: GriffinBerg ($34.38 in chips) 
Seat 5: ZonTTT ($56.61 in chips) 
Seat 6: Ahangama ($50 in chips) 
Seat 7: matiko09 ($134.81 in chips) 
Seat 8: dndngod ($79.84 in chips) 
Seat 9: CvMCvMCvM ($97.63 in chips) 
i L00K great: posts small blind $0.25
GriffinBerg: posts big blind $0.50
*** HOLE CARDS ***
Dealt to matiko09 [8c As]
ZonTTT: folds 
Ahangama: raises $0.75 to $1.25
matiko09: folds 
dndngod: folds 
CvMCvMCvM: folds 
lumen21: folds 
alemão007: folds 
i L00K great: folds 
GriffinBerg: folds 
Uncalled bet ($0.75) returned to Ahangama
Ahangama collected $1.25 from pot
Ahangama: doesn't show hand 
*** SUMMARY ***
Total pot $1.25 | Rake $0 
Seat 1: lumen21 folded before Flop (didn't bet)
Seat 2: alemão007 (button) folded before Flop (didn't bet)
Seat 3: i L00K great (small blind) folded before Flop
Seat 4: GriffinBerg (big blind) folded before Flop
Seat 5: ZonTTT folded before Flop (didn't bet)
Seat 6: Ahangama collected ($1.25)
Seat 7: matiko09 folded before Flop (didn't bet)
Seat 8: dndngod folded before Flop (didn't bet)
Seat 9: CvMCvMCvM folded before Flop (didn't bet)





PokerStars Hand #150801070785:  Hold'em No Limit ($0.50/$1.00 USD) - 2016/03/23 14:21:43 CET [2016/03/23 9:21:43 ET]
Table 'Kippes' 9-max Seat #8 is the button
Seat 1: Pvsx. ($120.18 in chips) 
Seat 3: CAJUN890 ($123.97 in chips) 
Seat 4: matiko09 ($100 in chips) 
Seat 5: Jimy Tiltman ($135.72 in chips) 
Seat 6: DUkalisUA ($113.36 in chips) 
Seat 7: lumen21 ($101.50 in chips) 
Seat 8: Sherlockplay ($100 in chips) 
Seat 9: wang19790906 ($96.01 in chips) 
wang19790906: posts small blind $0.50
Pvsx.: posts big blind $1
*** HOLE CARDS ***
Dealt to matiko09 [4s Ks]
CAJUN890: folds 
matiko09: folds 
Jimy Tiltman: folds 
DUkalisUA: folds 
lumen21: folds 
Sherlockplay: folds 
wang19790906: calls $0.50
Pvsx.: checks 
*** FLOP *** [4d Th 7h]
wang19790906: checks 
Pvsx.: checks 
*** TURN *** [4d Th 7h] [9s]
wang19790906: checks 
Pvsx.: checks 
*** RIVER *** [4d Th 7h 9s] [7s]
wang19790906: checks 
Pvsx.: checks 
*** SHOW DOWN ***
wang19790906: shows [Kh Ac] (a pair of Sevens)
Pvsx.: mucks hand 
wang19790906 collected $1.91 from pot
*** SUMMARY ***
Total pot $2 | Rake $0.09 
Board [4d Th 7h 9s 7s]
Seat 1: Pvsx. (big blind) mucked [As 8d]
Seat 3: CAJUN890 folded before Flop (didn't bet)
Seat 4: matiko09 folded before Flop (didn't bet)
Seat 5: Jimy Tiltman folded before Flop (didn't bet)
Seat 6: DUkalisUA folded before Flop (didn't bet)
Seat 7: lumen21 folded before Flop (didn't bet)
Seat 8: Sherlockplay (button) folded before Flop (didn't bet)
Seat 9: wang19790906 (small blind) showed [Kh Ac] and won ($1.91) with a pair of Sevens





PokerStars Hand #150801070916:  Hold'em No Limit ($1/$2 USD) - 2016/03/23 14:21:43 CET [2016/03/23 9:21:43 ET]
Table 'Kiess' 9-max Seat #7 is the button
Seat 1: Cirilico ($229.74 in chips) 
Seat 2: DUkalisUA ($674.10 in chips) 
Seat 3: The_red_area ($342.27 in chips) 
Seat 4: Moszes360 ($200 in chips) 
Seat 5: chippo boy ($453.60 in chips) 
Seat 6: matiko09 ($279.96 in chips) 
Seat 7: InsomniaRU ($274.37 in chips) 
Seat 8: erfk1958 ($117.55 in chips) 
Seat 9: T0ny Adams ($80 in chips) 
erfk1958: posts small blind $1
T0ny Adams: posts big blind $2
*** HOLE CARDS ***
Dealt to matiko09 [Qd Ks]
Cirilico: folds 
DUkalisUA: folds 
The_red_area: folds 
Moszes360: folds 
chippo boy: calls $2
matiko09: raises $6 to $8
InsomniaRU: folds 
erfk1958: folds 
T0ny Adams: folds 
chippo boy: calls $6
*** FLOP *** [7d Jc 6h]
chippo boy: checks 
matiko09: bets $10
chippo boy: calls $10
*** TURN *** [7d Jc 6h] [9d]
chippo boy: checks 
matiko09: checks 
*** RIVER *** [7d Jc 6h 9d] [3h]
chippo boy: checks 
matiko09: checks 
*** SHOW DOWN ***
chippo boy: shows [8h Ah] (high card Ace)
matiko09: mucks hand 
chippo boy collected $37.24 from pot
*** SUMMARY ***
Total pot $39 | Rake $1.76 
Board [7d Jc 6h 9d 3h]
Seat 1: Cirilico folded before Flop (didn't bet)
Seat 2: DUkalisUA folded before Flop (didn't bet)
Seat 3: The_red_area folded before Flop (didn't bet)
Seat 4: Moszes360 folded before Flop (didn't bet)
Seat 5: chippo boy showed [8h Ah] and won ($37.24) with high card Ace
Seat 6: matiko09 mucked [Qd Ks]
Seat 7: InsomniaRU (button) folded before Flop (didn't bet)
Seat 8: erfk1958 (small blind) folded before Flop
Seat 9: T0ny Adams (big blind) folded before Flop





PokerStars Hand #150801072898:  Hold'em No Limit ($0.50/$1.00 USD) - 2016/03/23 14:21:46 CET [2016/03/23 9:21:46 ET]
Table 'Atlantis' 9-max Seat #3 is the button
Seat 1: xHourglass ($150.77 in chips) 
Seat 2: tffff2006 ($72.22 in chips) 
Seat 3: CAJUN890 ($104.29 in chips) 
Seat 4: matiko09 ($129.75 in chips) 
Seat 5: Pvsx. ($100 in chips) 
Seat 6: Jimy Tiltman ($100 in chips) 
Seat 7: Sherlockplay ($138.77 in chips) 
Seat 8: DUkalisUA ($102.50 in chips) 
matiko09: posts small blind $0.50
Pvsx.: posts big blind $1
*** HOLE CARDS ***
Dealt to matiko09 [8c 8h]
Jimy Tiltman: folds 
Sherlockplay: folds 
DUkalisUA: folds 
xHourglass: folds 
tffff2006: raises $1.50 to $2.50
CAJUN890: folds 
matiko09: raises $5.50 to $8
Pvsx.: folds 
tffff2006: folds [Kc]
Uncalled bet ($5.50) returned to matiko09
matiko09 collected $6 from pot
matiko09: doesn't show hand 
*** SUMMARY ***
Total pot $6 | Rake $0 
Seat 1: xHourglass folded before Flop (didn't bet)
Seat 2: tffff2006 folded before Flop
Seat 3: CAJUN890 (button) folded before Flop (didn't bet)
Seat 4: matiko09 (small blind) collected ($6)
Seat 5: Pvsx. (big blind) folded before Flop
Seat 6: Jimy Tiltman folded before Flop (didn't bet)
Seat 7: Sherlockplay folded before Flop (didn't bet)
Seat 8: DUkalisUA folded before Flop (didn't bet)





PokerStars Hand #150801079475:  Hold'em No Limit ($1/$2 USD) - 2016/03/23 14:21:57 CET [2016/03/23 9:21:57 ET]
Table 'Ennomos II' 9-max Seat #7 is the button
Seat 1: ilaviiitech ($200 in chips) 
Seat 2: Subam ($422.18 in chips) 
Seat 3: $-Twackle-$ ($200 in chips) 
Seat 4: glanza_mike ($200 in chips) 
Seat 5: South011 ($384.88 in chips) 
Seat 6: nickreason17 ($237.98 in chips) 
Seat 7: daniferdoser ($200 in chips) 
Seat 8: yyfk ($208.24 in chips) 
Seat 9: matiko09 ($200 in chips) 
yyfk: posts small blind $1
matiko09: posts big blind $2
*** HOLE CARDS ***
Dealt to matiko09 [9d 9h]
ilaviiitech: folds 
Subam: folds 
$-Twackle-$: raises $4 to $6
ilaviiitech said, "nic"
glanza_mike: folds 
South011: folds 
nickreason17: folds 
daniferdoser: folds 
yyfk: folds 
matiko09: calls $4
*** FLOP *** [4s 6d Th]
matiko09: checks 
Subam is disconnected 
$-Twackle-$: bets $9
matiko09: calls $9
*** TURN *** [4s 6d Th] [9c]
matiko09: checks 
$-Twackle-$: checks 
*** RIVER *** [4s 6d Th 9c] [Ks]
matiko09: bets $18
$-Twackle-$: raises $50 to $68
matiko09: folds 
Uncalled bet ($50) returned to $-Twackle-$
$-Twackle-$ collected $64.20 from pot
$-Twackle-$: doesn't show hand 
*** SUMMARY ***
Total pot $67 | Rake $2.80 
Board [4s 6d Th 9c Ks]
Seat 1: ilaviiitech folded before Flop (didn't bet)
Seat 2: Subam folded before Flop (didn't bet)
Seat 3: $-Twackle-$ collected ($64.20)
Seat 4: glanza_mike folded before Flop (didn't bet)
Seat 5: South011 folded before Flop (didn't bet)
Seat 6: nickreason17 folded before Flop (didn't bet)
Seat 7: daniferdoser (button) folded before Flop (didn't bet)
Seat 8: yyfk (small blind) folded before Flop
Seat 9: matiko09 (big blind) folded on the River





PokerStars Hand #150801080084:  Hold'em No Limit ($0.50/$1.00 USD) - 2016/03/23 14:21:58 CET [2016/03/23 9:21:58 ET]
Table 'Merope II' 9-max Seat #8 is the button
Seat 1: Jimy Tiltman ($132.70 in chips) 
Seat 2: $-Twackle-$ ($100 in chips) 
Seat 3: pablos1922 ($102.92 in chips) 
Seat 4: YuriiSolodya ($86.09 in chips) 
Seat 5: DUkalisUA ($148.55 in chips) 
Seat 6: Effort92 ($100 in chips) 
Seat 7: matiko09 ($109.23 in chips) 
Seat 8: titentei ($90.50 in chips) 
Jimy Tiltman: posts small blind $0.50
$-Twackle-$: posts big blind $1
*** HOLE CARDS ***
Dealt to matiko09 [Ts 2s]
pablos1922: raises $1 to $2
YuriiSolodya: calls $2
DUkalisUA: folds 
Effort92: folds 
matiko09: folds 
titentei: folds 
Jimy Tiltman: folds 
$-Twackle-$: folds 
*** FLOP *** [Qd Ah As]
pablos1922: checks 
YuriiSolodya: bets $5.25
pablos1922: folds 
Uncalled bet ($5.25) returned to YuriiSolodya
YuriiSolodya collected $5.25 from pot
YuriiSolodya: doesn't show hand 
*** SUMMARY ***
Total pot $5.50 | Rake $0.25 
Board [Qd Ah As]
Seat 1: Jimy Tiltman (small blind) folded before Flop
Seat 2: $-Twackle-$ (big blind) folded before Flop
Seat 3: pablos1922 folded on the Flop
Seat 4: YuriiSolodya collected ($5.25)
Seat 5: DUkalisUA folded before Flop (didn't bet)
Seat 6: Effort92 folded before Flop (didn't bet)
Seat 7: matiko09 folded before Flop (didn't bet)
Seat 8: titentei (button) folded before Flop (didn't bet)





PokerStars Hand #150801089138:  Hold'em No Limit ($0.25/$0.50 USD) - 2016/03/23 14:22:13 CET [2016/03/23 9:22:13 ET]
Table 'Pyrrhus' 9-max Seat #3 is the button
Seat 1: lumen21 ($79.77 in chips) 
Seat 2: alemão007 ($47 in chips) 
Seat 3: i L00K great ($50 in chips) 
Seat 4: GriffinBerg ($33.88 in chips) 
Seat 5: ZonTTT ($56.61 in chips) 
Seat 6: Ahangama ($50.75 in chips) 
Seat 7: matiko09 ($134.81 in chips) 
Seat 8: dndngod ($79.84 in chips) 
Seat 9: CvMCvMCvM ($97.63 in chips) 
GriffinBerg: posts small blind $0.25
ZonTTT: posts big blind $0.50
*** HOLE CARDS ***
Dealt to matiko09 [5d Kh]
Ahangama: folds 
matiko09: folds 
dndngod: folds 
CvMCvMCvM: folds 
lumen21: folds 
alemão007: folds 
i L00K great: folds 
GriffinBerg: calls $0.25
ZonTTT: checks 
*** FLOP *** [Td Jh 5h]
GriffinBerg: checks 
ZonTTT: checks 
*** TURN *** [Td Jh 5h] [9c]
GriffinBerg: bets $0.50
ZonTTT: folds 
Uncalled bet ($0.50) returned to GriffinBerg
GriffinBerg collected $0.96 from pot
*** SUMMARY ***
Total pot $1 | Rake $0.04 
Board [Td Jh 5h 9c]
Seat 1: lumen21 folded before Flop (didn't bet)
Seat 2: alemão007 folded before Flop (didn't bet)
Seat 3: i L00K great (button) folded before Flop (didn't bet)
Seat 4: GriffinBerg (small blind) collected ($0.96)
Seat 5: ZonTTT (big blind) folded on the Turn
Seat 6: Ahangama folded before Flop (didn't bet)
Seat 7: matiko09 folded before Flop (didn't bet)
Seat 8: dndngod folded before Flop (didn't bet)
Seat 9: CvMCvMCvM folded before Flop (didn't bet)





PokerStars Hand #150801092737:  Hold'em No Limit ($1/$2 USD) - 2016/03/23 14:22:19 CET [2016/03/23 9:22:19 ET]
Table 'Herba II' 9-max Seat #1 is the button
Seat 1: matiko09 ($212.06 in chips) 
Seat 2: Moszes360 ($200 in chips) 
Seat 3: Cirilico ($189.84 in chips) 
Seat 4: DUkalisUA ($304.90 in chips) 
Seat 5: chippo boy ($221.38 in chips) 
Seat 6: Too-Anti-To ($212.46 in chips) 
Seat 7: InsomniaRU ($201.78 in chips) 
Seat 8: The_red_area ($439.98 in chips) 
Seat 9: mrhighryza ($64.67 in chips) 
Moszes360: posts small blind $1
Cirilico: posts big blind $2
*** HOLE CARDS ***
Dealt to matiko09 [8h Qc]
DUkalisUA: folds 
chippo boy: folds 
Too-Anti-To: folds 
InsomniaRU: folds 
The_red_area: folds 
mrhighryza: calls $2
matiko09: folds 
Moszes360: calls $1
Cirilico: checks 
*** FLOP *** [Th 5d Kd]
Moszes360: bets $5.50
Cirilico: folds 
mrhighryza: folds 
Uncalled bet ($5.50) returned to Moszes360
Moszes360 collected $5.73 from pot
Moszes360: doesn't show hand 
*** SUMMARY ***
Total pot $6 | Rake $0.27 
Board [Th 5d Kd]
Seat 1: matiko09 (button) folded before Flop (didn't bet)
Seat 2: Moszes360 (small blind) collected ($5.73)
Seat 3: Cirilico (big blind) folded on the Flop
Seat 4: DUkalisUA folded before Flop (didn't bet)
Seat 5: chippo boy folded before Flop (didn't bet)
Seat 6: Too-Anti-To folded before Flop (didn't bet)
Seat 7: InsomniaRU folded before Flop (didn't bet)
Seat 8: The_red_area folded before Flop (didn't bet)
Seat 9: mrhighryza folded on the Flop





PokerStars Hand #150801096723:  Hold'em No Limit ($0.50/$1.00 USD) - 2016/03/23 14:22:25 CET [2016/03/23 9:22:25 ET]
Table 'Atlantis' 9-max Seat #4 is the button
Seat 1: xHourglass ($150.77 in chips) 
Seat 2: tffff2006 ($69.72 in chips) 
Seat 3: CAJUN890 ($104.29 in chips) 
Seat 4: matiko09 ($133.25 in chips) 
Seat 5: Pvsx. ($100 in chips) 
Seat 6: Jimy Tiltman ($100 in chips) 
Seat 7: Sherlockplay ($138.77 in chips) 
Seat 8: DUkalisUA ($102.50 in chips) 
Pvsx.: posts small blind $0.50
Jimy Tiltman: posts big blind $1
*** HOLE CARDS ***
Dealt to matiko09 [6h 4s]
Sherlockplay: folds 
DUkalisUA: folds 
xHourglass: folds 
tffff2006: folds 
CAJUN890: folds 
matiko09: folds 
Pvsx.: raises $1.50 to $2.50
Jimy Tiltman: calls $1.50
*** FLOP *** [6c 7c Js]
Pvsx.: checks 
Jimy Tiltman: bets $2.87
Pvsx.: folds 
Uncalled bet ($2.87) returned to Jimy Tiltman
Jimy Tiltman collected $4.78 from pot
Jimy Tiltman: doesn't show hand 
*** SUMMARY ***
Total pot $5 | Rake $0.22 
Board [6c 7c Js]
Seat 1: xHourglass folded before Flop (didn't bet)
Seat 2: tffff2006 folded before Flop (didn't bet)
Seat 3: CAJUN890 folded before Flop (didn't bet)
Seat 4: matiko09 (button) folded before Flop (didn't bet)
Seat 5: Pvsx. (small blind) folded on the Flop
Seat 6: Jimy Tiltman (big blind) collected ($4.78)
Seat 7: Sherlockplay folded before Flop (didn't bet)
Seat 8: DUkalisUA folded before Flop (didn't bet)





PokerStars Hand #150801096889:  Hold'em No Limit ($1/$2 USD) - 2016/03/23 14:22:26 CET [2016/03/23 9:22:26 ET]
Table 'Deipylos II' 9-max Seat #4 is the button
Seat 1: $-Twackle-$ ($200 in chips) 
Seat 2: T0ny Adams ($88.32 in chips) 
Seat 4: matiko09 ($200 in chips) 
Seat 5: InsomniaRU ($201 in chips) 
Seat 6: nickreason17 ($200 in chips) 
Seat 7: volwebni4ek ($94.70 in chips) 
Seat 8: Igoriah ($200 in chips) 
Seat 9: Ranatuo84 ($268.62 in chips) 
InsomniaRU: posts small blind $1
nickreason17: posts big blind $2
*** HOLE CARDS ***
Dealt to matiko09 [8d 2h]
volwebni4ek: folds 
Igoriah: raises $3 to $5
Ranatuo84: calls $5
$-Twackle-$: folds 
coinflip_si leaves the table
DUkalisUA joins the table at seat #3 
T0ny Adams: folds 
matiko09: folds 
InsomniaRU: raises $15 to $20
nickreason17: folds 
Igoriah: folds 
Ranatuo84: calls $15
*** FLOP *** [5d Ts 9h]
InsomniaRU: bets $26.03
Ranatuo84: folds 
Uncalled bet ($26.03) returned to InsomniaRU
InsomniaRU collected $44.88 from pot
InsomniaRU: doesn't show hand 
*** SUMMARY ***
Total pot $47 | Rake $2.12 
Board [5d Ts 9h]
Seat 1: $-Twackle-$ folded before Flop (didn't bet)
Seat 2: T0ny Adams folded before Flop (didn't bet)
Seat 4: matiko09 (button) folded before Flop (didn't bet)
Seat 5: InsomniaRU (small blind) collected ($44.88)
Seat 6: nickreason17 (big blind) folded before Flop
Seat 7: volwebni4ek folded before Flop (didn't bet)
Seat 8: Igoriah folded before Flop
Seat 9: Ranatuo84 folded on the Flop





PokerStars Hand #150801098977:  Hold'em No Limit ($1/$2 USD) - 2016/03/23 14:22:29 CET [2016/03/23 9:22:29 ET]
Table 'Achaia' 9-max Seat #7 is the button
Seat 1: ilaviiitech ($200 in chips) 
Seat 2: InsomniaRU ($223.66 in chips) 
Seat 3: matiko09 ($200 in chips) 
Seat 4: nailz83 ($179.46 in chips) 
Seat 5: DUkalisUA ($213.37 in chips) 
Seat 6: nickreason17 ($212.30 in chips) 
Seat 7: morosun ($219.22 in chips) 
Seat 8: $-Twackle-$ ($212.45 in chips) 
Seat 9: glanza_mike ($204.28 in chips) 
$-Twackle-$: posts small blind $1
glanza_mike: posts big blind $2
*** HOLE CARDS ***
Dealt to matiko09 [7c 8d]
ilaviiitech: folds 
InsomniaRU: folds 
matiko09: folds 
nailz83: folds 
DUkalisUA: folds 
nickreason17: folds 
morosun: raises $4 to $6
$-Twackle-$: raises $13 to $19
glanza_mike: folds 
morosun: calls $13
*** FLOP *** [9s Js Kd]
$-Twackle-$: bets $14
morosun: folds 
Uncalled bet ($14) returned to $-Twackle-$
$-Twackle-$ collected $38.20 from pot
$-Twackle-$: doesn't show hand 
*** SUMMARY ***
Total pot $40 | Rake $1.80 
Board [9s Js Kd]
Seat 1: ilaviiitech folded before Flop (didn't bet)
Seat 2: InsomniaRU folded before Flop (didn't bet)
Seat 3: matiko09 folded before Flop (didn't bet)
Seat 4: nailz83 folded before Flop (didn't bet)
Seat 5: DUkalisUA folded before Flop (didn't bet)
Seat 6: nickreason17 folded before Flop (didn't bet)
Seat 7: morosun (button) folded on the Flop
Seat 8: $-Twackle-$ (small blind) collected ($38.20)
Seat 9: glanza_mike (big blind) folded before Flop





PokerStars Hand #150801102681:  Hold'em No Limit ($0.50/$1.00 USD) - 2016/03/23 14:22:35 CET [2016/03/23 9:22:35 ET]
Table 'Kippes' 9-max Seat #9 is the button
Seat 1: Pvsx. ($119.18 in chips) 
Seat 3: CAJUN890 ($123.97 in chips) 
Seat 4: matiko09 ($100 in chips) 
Seat 5: Jimy Tiltman ($135.72 in chips) 
Seat 6: DUkalisUA ($113.36 in chips) 
Seat 7: lumen21 ($101.50 in chips) 
Seat 8: Sherlockplay ($100 in chips) 
Seat 9: wang19790906 ($96.92 in chips) 
Pvsx.: posts small blind $0.50
CAJUN890: posts big blind $1
*** HOLE CARDS ***
Dealt to matiko09 [Ts 4s]
matiko09: folds 
Jimy Tiltman: folds 
DUkalisUA: folds 
lumen21: folds 
Sherlockplay: folds 
wang19790906: raises $1 to $2
Pvsx.: folds 
CAJUN890: calls $1
*** FLOP *** [3s 6d Td]
CAJUN890: checks 
wang19790906: checks 
*** TURN *** [3s 6d Td] [4d]
CAJUN890: bets $3
wang19790906: calls $3
*** RIVER *** [3s 6d Td 4d] [6h]
CAJUN890: bets $8
wang19790906: folds 
Uncalled bet ($8) returned to CAJUN890
CAJUN890 collected $10.03 from pot
CAJUN890: doesn't show hand 
*** SUMMARY ***
Total pot $10.50 | Rake $0.47 
Board [3s 6d Td 4d 6h]
Seat 1: Pvsx. (small blind) folded before Flop
Seat 3: CAJUN890 (big blind) collected ($10.03)
Seat 4: matiko09 folded before Flop (didn't bet)
Seat 5: Jimy Tiltman folded before Flop (didn't bet)
Seat 6: DUkalisUA folded before Flop (didn't bet)
Seat 7: lumen21 folded before Flop (didn't bet)
Seat 8: Sherlockplay folded before Flop (didn't bet)
Seat 9: wang19790906 (button) folded on the River





PokerStars Hand #150801104677:  Hold'em No Limit (€0.50/€1.00 EUR) - 2016/03/23 14:22:38 CET [2016/03/23 9:22:38 ET]
Table 'Lanzia' 9-max Seat #4 is the button
Seat 1: fk154 (€39 in chips) 
Seat 2: ardo888 (€101.50 in chips) 
Seat 3: Effort92 (€196.81 in chips) 
Seat 4: niong62 (€83.88 in chips) 
Seat 5: matiko09 (€100 in chips) 
Seat 6: Red4erT (€40 in chips) 
Seat 7: $-Twackle-$ (€115.10 in chips) 
Seat 8: Muinmyheart (€103.50 in chips) 
Seat 9: Butcher1848 (€105.37 in chips) 
matiko09: posts small blind €0.50
Red4erT: posts big blind €1
*** HOLE CARDS ***
Dealt to matiko09 [6s Ts]
$-Twackle-$: folds 
Muinmyheart: folds 
Butcher1848: folds 
fk154: folds 
ardo888: folds 
Effort92: folds 
niong62: raises €1 to €2
matiko09: folds 
Red4erT: folds 
Uncalled bet (€1) returned to niong62
niong62 collected €2.50 from pot
*** SUMMARY ***
Total pot €2.50 | Rake €0 
Seat 1: fk154 folded before Flop (didn't bet)
Seat 2: ardo888 folded before Flop (didn't bet)
Seat 3: Effort92 folded before Flop (didn't bet)
Seat 4: niong62 (button) collected (€2.50)
Seat 5: matiko09 (small blind) folded before Flop
Seat 6: Red4erT (big blind) folded before Flop
Seat 7: $-Twackle-$ folded before Flop (didn't bet)
Seat 8: Muinmyheart folded before Flop (didn't bet)
Seat 9: Butcher1848 folded before Flop (didn't bet)





PokerStars Hand #150801107034:  Hold'em No Limit ($1/$2 USD) - 2016/03/23 14:22:42 CET [2016/03/23 9:22:42 ET]
Table 'Kiess' 9-max Seat #8 is the button
Seat 1: Cirilico ($229.74 in chips) 
Seat 2: DUkalisUA ($674.10 in chips) 
Seat 3: The_red_area ($342.27 in chips) 
Seat 4: Moszes360 ($200 in chips) 
Seat 5: chippo boy ($472.84 in chips) 
Seat 6: matiko09 ($261.96 in chips) 
Seat 7: InsomniaRU ($274.37 in chips) 
Seat 8: erfk1958 ($116.55 in chips) 
Seat 9: T0ny Adams ($78 in chips) 
T0ny Adams: posts small blind $1
Cirilico: posts big blind $2
*** HOLE CARDS ***
Dealt to matiko09 [5s Td]
DUkalisUA: folds 
The_red_area: folds 
Moszes360: folds 
chippo boy: calls $2
matiko09: folds 
InsomniaRU: raises $5 to $7
erfk1958: folds 
T0ny Adams: folds 
Cirilico: folds 
chippo boy: calls $5
*** FLOP *** [2c Qh 6h]
chippo boy: checks 
InsomniaRU: bets $10.88
chippo boy: calls $10.88
*** TURN *** [2c Qh 6h] [9h]
chippo boy: checks 
InsomniaRU: bets $24.67
chippo boy: folds 
Uncalled bet ($24.67) returned to InsomniaRU
InsomniaRU collected $37.02 from pot
InsomniaRU: doesn't show hand 
*** SUMMARY ***
Total pot $38.76 | Rake $1.74 
Board [2c Qh 6h 9h]
Seat 1: Cirilico (big blind) folded before Flop
Seat 2: DUkalisUA folded before Flop (didn't bet)
Seat 3: The_red_area folded before Flop (didn't bet)
Seat 4: Moszes360 folded before Flop (didn't bet)
Seat 5: chippo boy folded on the Turn
Seat 6: matiko09 folded before Flop (didn't bet)
Seat 7: InsomniaRU collected ($37.02)
Seat 8: erfk1958 (button) folded before Flop (didn't bet)
Seat 9: T0ny Adams (small blind) folded before Flop





PokerStars Hand #150801112631:  Hold'em No Limit ($1/$2 USD) - 2016/03/23 14:22:51 CET [2016/03/23 9:22:51 ET]
Table 'Kypria II' 9-max Seat #4 is the button
Seat 1: geldwolfje ($81.90 in chips) 
Seat 2: coinflip_si ($219.70 in chips) 
Seat 3: seouljam ($204.97 in chips) 
Seat 4: VolanDog ($200 in chips) 
Seat 5: InsomniaRU ($380.88 in chips) 
Seat 6: matiko09 ($373.95 in chips) 
Seat 7: DUkalisUA ($200 in chips) 
Seat 9: Moszes360 ($202 in chips) 
InsomniaRU: posts small blind $1
matiko09: posts big blind $2
Pearl Jam87: sits out 
*** HOLE CARDS ***
Dealt to matiko09 [Qh 9s]
DUkalisUA: folds 
Moszes360: folds 
geldwolfje: folds 
coinflip_si: folds 
seouljam: raises $2.80 to $4.80
VolanDog: calls $4.80
InsomniaRU: folds 
matiko09: folds 
*** FLOP *** [7d 2d Kh]
seouljam: bets $8
VolanDog: folds 
Uncalled bet ($8) returned to seouljam
seouljam collected $12.03 from pot
seouljam: doesn't show hand 
*** SUMMARY ***
Total pot $12.60 | Rake $0.57 
Board [7d 2d Kh]
Seat 1: geldwolfje folded before Flop (didn't bet)
Seat 2: coinflip_si folded before Flop (didn't bet)
Seat 3: seouljam collected ($12.03)
Seat 4: VolanDog (button) folded on the Flop
Seat 5: InsomniaRU (small blind) folded before Flop
Seat 6: matiko09 (big blind) folded before Flop
Seat 7: DUkalisUA folded before Flop (didn't bet)
Seat 9: Moszes360 folded before Flop (didn't bet)





PokerStars Hand #150801114898:  Hold'em No Limit ($0.50/$1.00 USD) - 2016/03/23 14:22:55 CET [2016/03/23 9:22:55 ET]
Table 'Donar II' 9-max Seat #1 is the button
Seat 1: Effort92 ($104.02 in chips) 
Seat 2: nobrunobru1 ($58.44 in chips) 
Seat 3: st-germ30 ($101.09 in chips) 
Seat 4: DUkalisUA ($145.29 in chips) 
Seat 5: matiko09 ($100 in chips) 
Seat 6: ardo888 ($130 in chips) 
Seat 7: JimineyCrik ($98.85 in chips) 
Seat 8: $-Twackle-$ ($113.55 in chips) 
Seat 9: oxfordtenzin ($118.49 in chips) 
nobrunobru1: posts small blind $0.50
st-germ30: posts big blind $1
Effort92: posts the ante $0.20
nobrunobru1: posts the ante $0.20
st-germ30: posts the ante $0.20
DUkalisUA: posts the ante $0.20
matiko09: posts the ante $0.20
ardo888: posts the ante $0.20
JimineyCrik: posts the ante $0.20
$-Twackle-$: posts the ante $0.20
oxfordtenzin: posts the ante $0.20
*** HOLE CARDS ***
Dealt to matiko09 [9c Jd]
DUkalisUA: folds 
matiko09: folds 
ardo888: folds 
JimineyCrik: folds 
$-Twackle-$: folds 
oxfordtenzin: raises $2 to $3
Effort92: folds 
nobrunobru1: calls $2.50
st-germ30: calls $2
*** FLOP *** [Ks 9s 6h]
nobrunobru1: checks 
st-germ30: checks 
oxfordtenzin: bets $6.10
nobrunobru1: folds 
st-germ30: folds 
Uncalled bet ($6.10) returned to oxfordtenzin
oxfordtenzin collected $10.31 from pot
oxfordtenzin: doesn't show hand 
*** SUMMARY ***
Total pot $10.80 | Rake $0.49 
Board [Ks 9s 6h]
Seat 1: Effort92 (button) folded before Flop (didn't bet)
Seat 2: nobrunobru1 (small blind) folded on the Flop
Seat 3: st-germ30 (big blind) folded on the Flop
Seat 4: DUkalisUA folded before Flop (didn't bet)
Seat 5: matiko09 folded before Flop (didn't bet)
Seat 6: ardo888 folded before Flop (didn't bet)
Seat 7: JimineyCrik folded before Flop (didn't bet)
Seat 8: $-Twackle-$ folded before Flop (didn't bet)
Seat 9: oxfordtenzin collected ($10.31)





PokerStars Hand #150801116293:  Hold'em No Limit ($1/$2 USD) - 2016/03/23 14:22:57 CET [2016/03/23 9:22:57 ET]
Table 'Herba II' 9-max Seat #2 is the button
Seat 1: matiko09 ($212.06 in chips) 
Seat 2: Moszes360 ($203.73 in chips) 
Seat 3: Cirilico ($187.84 in chips) 
Seat 4: DUkalisUA ($304.90 in chips) 
Seat 5: chippo boy ($221.38 in chips) 
Seat 6: Too-Anti-To ($212.46 in chips) 
Seat 7: InsomniaRU ($201.78 in chips) 
Seat 8: The_red_area ($439.98 in chips) 
Seat 9: mrhighryza ($62.67 in chips) 
Cirilico: posts small blind $1
DUkalisUA: posts big blind $2
*** HOLE CARDS ***
Dealt to matiko09 [As Ts]
chippo boy: folds 
Too-Anti-To: folds 
InsomniaRU: raises $3 to $5
The_red_area: folds 
mrhighryza: folds 
matiko09: folds 
Moszes360: calls $5
Cirilico: folds 
DUkalisUA: folds 
*** FLOP *** [7c 4c 9h]
InsomniaRU: checks 
Moszes360: bets $8.19
InsomniaRU: folds 
Uncalled bet ($8.19) returned to Moszes360
Moszes360 collected $12.42 from pot
Moszes360: doesn't show hand 
*** SUMMARY ***
Total pot $13 | Rake $0.58 
Board [7c 4c 9h]
Seat 1: matiko09 folded before Flop (didn't bet)
Seat 2: Moszes360 (button) collected ($12.42)
Seat 3: Cirilico (small blind) folded before Flop
Seat 4: DUkalisUA (big blind) folded before Flop
Seat 5: chippo boy folded before Flop (didn't bet)
Seat 6: Too-Anti-To folded before Flop (didn't bet)
Seat 7: InsomniaRU folded on the Flop
Seat 8: The_red_area folded before Flop (didn't bet)
Seat 9: mrhighryza folded before Flop (didn't bet)





PokerStars Hand #150801119111:  Hold'em No Limit ($0.25/$0.50 USD) - 2016/03/23 14:23:02 CET [2016/03/23 9:23:02 ET]
Table 'Pyrrhus' 9-max Seat #4 is the button
Seat 1: lumen21 ($79.77 in chips) 
Seat 2: alemão007 ($47 in chips) 
Seat 3: i L00K great ($50 in chips) 
Seat 4: GriffinBerg ($34.34 in chips) 
Seat 5: ZonTTT ($56.11 in chips) 
Seat 6: Ahangama ($50.75 in chips) 
Seat 7: matiko09 ($134.81 in chips) 
Seat 8: dndngod ($79.84 in chips) 
Seat 9: CvMCvMCvM ($97.63 in chips) 
ZonTTT: posts small blind $0.25
Ahangama: posts big blind $0.50
*** HOLE CARDS ***
Dealt to matiko09 [6d 3d]
matiko09: folds 
dndngod: folds 
CvMCvMCvM: raises $0.57 to $1.07
lumen21: folds 
alemão007: folds 
i L00K great: folds 
GriffinBerg: folds 
ZonTTT: folds 
Ahangama: folds 
Uncalled bet ($0.57) returned to CvMCvMCvM
CvMCvMCvM collected $1.25 from pot
CvMCvMCvM: doesn't show hand 
*** SUMMARY ***
Total pot $1.25 | Rake $0 
Seat 1: lumen21 folded before Flop (didn't bet)
Seat 2: alemão007 folded before Flop (didn't bet)
Seat 3: i L00K great folded before Flop (didn't bet)
Seat 4: GriffinBerg (button) folded before Flop (didn't bet)
Seat 5: ZonTTT (small blind) folded before Flop
Seat 6: Ahangama (big blind) folded before Flop
Seat 7: matiko09 folded before Flop (didn't bet)
Seat 8: dndngod folded before Flop (didn't bet)
Seat 9: CvMCvMCvM collected ($1.25)





PokerStars Hand #150801122782:  Hold'em No Limit ($0.50/$1.00 USD) - 2016/03/23 14:23:08 CET [2016/03/23 9:23:08 ET]
Table 'Merope II' 9-max Seat #1 is the button
Seat 1: Jimy Tiltman ($132.20 in chips) 
Seat 2: $-Twackle-$ ($100 in chips) 
Seat 3: pablos1922 ($100.92 in chips) 
Seat 4: YuriiSolodya ($89.34 in chips) 
Seat 5: DUkalisUA ($148.55 in chips) 
Seat 6: Effort92 ($100 in chips) 
Seat 7: matiko09 ($109.23 in chips) 
Seat 8: titentei ($90.50 in chips) 
$-Twackle-$: posts small blind $0.50
pablos1922: posts big blind $1
*** HOLE CARDS ***
Dealt to matiko09 [6s 5h]
YuriiSolodya: folds 
DUkalisUA: folds 
Effort92: folds 
matiko09: folds 
titentei: folds 
Jimy Tiltman: folds 
$-Twackle-$: folds 
Uncalled bet ($0.50) returned to pablos1922
pablos1922 collected $1 from pot
pablos1922: doesn't show hand 
*** SUMMARY ***
Total pot $1 | Rake $0 
Seat 1: Jimy Tiltman (button) folded before Flop (didn't bet)
Seat 2: $-Twackle-$ (small blind) folded before Flop
Seat 3: pablos1922 (big blind) collected ($1)
Seat 4: YuriiSolodya folded before Flop (didn't bet)
Seat 5: DUkalisUA folded before Flop (didn't bet)
Seat 6: Effort92 folded before Flop (didn't bet)
Seat 7: matiko09 folded before Flop (didn't bet)
Seat 8: titentei folded before Flop (didn't bet)





PokerStars Hand #150801122491:  Hold'em No Limit ($1/$2 USD) - 2016/03/23 14:23:08 CET [2016/03/23 9:23:08 ET]
Table 'Achaia' 9-max Seat #8 is the button
Seat 2: InsomniaRU ($223.66 in chips) 
Seat 3: matiko09 ($200 in chips) 
Seat 4: nailz83 ($179.46 in chips) 
Seat 5: DUkalisUA ($213.37 in chips) 
Seat 6: nickreason17 ($212.30 in chips) 
Seat 7: morosun ($200.22 in chips) 
Seat 8: $-Twackle-$ ($231.65 in chips) 
Seat 9: glanza_mike ($202.28 in chips) 
glanza_mike: posts small blind $1
ilaviiitech: is sitting out 
InsomniaRU: posts big blind $2
*** HOLE CARDS ***
Dealt to matiko09 [Qh Jh]
ilaviiitech leaves the table
matiko09: raises $3 to $5
nailz83: folds 
DUkalisUA: folds 
nickreason17: folds 
morosun: folds 
$-Twackle-$: folds 
glanza_mike: folds 
InsomniaRU: folds 
Uncalled bet ($3) returned to matiko09
matiko09 collected $5 from pot
matiko09: doesn't show hand 
*** SUMMARY ***
Total pot $5 | Rake $0 
Seat 2: InsomniaRU (big blind) folded before Flop
Seat 3: matiko09 collected ($5)
Seat 4: nailz83 folded before Flop (didn't bet)
Seat 5: DUkalisUA folded before Flop (didn't bet)
Seat 6: nickreason17 folded before Flop (didn't bet)
Seat 7: morosun folded before Flop (didn't bet)
Seat 8: $-Twackle-$ (button) folded before Flop (didn't bet)
Seat 9: glanza_mike (small blind) folded before Flop





PokerStars Hand #150801126377:  Hold'em No Limit ($0.50/$1.00 USD) - 2016/03/23 14:23:14 CET [2016/03/23 9:23:14 ET]
Table 'Atlantis' 9-max Seat #5 is the button
Seat 1: xHourglass ($150.77 in chips) 
Seat 2: tffff2006 ($69.72 in chips) 
Seat 3: CAJUN890 ($104.29 in chips) 
Seat 4: matiko09 ($133.25 in chips) 
Seat 5: Pvsx. ($100 in chips) 
Seat 6: Jimy Tiltman ($102.28 in chips) 
Seat 7: Sherlockplay ($138.77 in chips) 
Seat 8: DUkalisUA ($102.50 in chips) 
Jimy Tiltman: posts small blind $0.50
Sherlockplay: posts big blind $1
*** HOLE CARDS ***
Dealt to matiko09 [7c 3s]
DUkalisUA: folds 
xHourglass: folds 
tffff2006: folds 
CAJUN890: folds 
matiko09: folds 
Pvsx.: raises $1.50 to $2.50
Jimy Tiltman: folds 
Sherlockplay: calls $1.50
*** FLOP *** [Qd Qc Qh]
Sherlockplay: checks 
Pvsx.: bets $2.62
Sherlockplay: folds 
Uncalled bet ($2.62) returned to Pvsx.
Pvsx. collected $5.25 from pot
Pvsx.: doesn't show hand 
*** SUMMARY ***
Total pot $5.50 | Rake $0.25 
Board [Qd Qc Qh]
Seat 1: xHourglass folded before Flop (didn't bet)
Seat 2: tffff2006 folded before Flop (didn't bet)
Seat 3: CAJUN890 folded before Flop (didn't bet)
Seat 4: matiko09 folded before Flop (didn't bet)
Seat 5: Pvsx. (button) collected ($5.25)
Seat 6: Jimy Tiltman (small blind) folded before Flop
Seat 7: Sherlockplay (big blind) folded on the Flop
Seat 8: DUkalisUA folded before Flop (didn't bet)





PokerStars Hand #150801127571:  Hold'em No Limit (€0.50/€1.00 EUR) - 2016/03/23 14:23:16 CET [2016/03/23 9:23:16 ET]
Table 'Lanzia' 9-max Seat #5 is the button
Seat 1: fk154 (€39 in chips) 
Seat 2: ardo888 (€101.50 in chips) 
Seat 3: Effort92 (€196.81 in chips) 
Seat 4: niong62 (€85.38 in chips) 
Seat 5: matiko09 (€100 in chips) 
Seat 6: Red4erT (€40 in chips) 
Seat 7: $-Twackle-$ (€115.10 in chips) 
Seat 8: Muinmyheart (€103.50 in chips) 
Seat 9: Butcher1848 (€105.37 in chips) 
Red4erT: posts small blind €0.50
$-Twackle-$: posts big blind €1
*** HOLE CARDS ***
Dealt to matiko09 [2d Th]
Muinmyheart: folds 
Butcher1848: folds 
fk154: folds 
ardo888: folds 
Effort92: folds 
niong62: raises €1 to €2
matiko09: folds 
Red4erT: folds 
$-Twackle-$: calls €1
*** FLOP *** [7s 3h 5s]
$-Twackle-$: checks 
niong62: bets €2
$-Twackle-$: calls €2
*** TURN *** [7s 3h 5s] [Qc]
$-Twackle-$: checks 
niong62: checks 
*** RIVER *** [7s 3h 5s Qc] [Qh]
$-Twackle-$: checks 
niong62: checks 
*** SHOW DOWN ***
$-Twackle-$: shows [5h 4h] (two pair, Queens and Fives)
niong62: mucks hand 
$-Twackle-$ collected €8.12 from pot
*** SUMMARY ***
Total pot €8.50 | Rake €0.38 
Board [7s 3h 5s Qc Qh]
Seat 1: fk154 folded before Flop (didn't bet)
Seat 2: ardo888 folded before Flop (didn't bet)
Seat 3: Effort92 folded before Flop (didn't bet)
Seat 4: niong62 mucked [Jc Tc]
Seat 5: matiko09 (button) folded before Flop (didn't bet)
Seat 6: Red4erT (small blind) folded before Flop
Seat 7: $-Twackle-$ (big blind) showed [5h 4h] and won (€8.12) with two pair, Queens and Fives
Seat 8: Muinmyheart folded before Flop (didn't bet)
Seat 9: Butcher1848 folded before Flop (didn't bet)





PokerStars Hand #150801134694:  Hold'em No Limit ($0.50/$1.00 USD) - 2016/03/23 14:23:27 CET [2016/03/23 9:23:27 ET]
Table 'Merope II' 9-max Seat #2 is the button
Seat 1: Jimy Tiltman ($132.20 in chips) 
Seat 2: $-Twackle-$ ($100 in chips) 
Seat 3: pablos1922 ($101.42 in chips) 
Seat 4: YuriiSolodya ($89.34 in chips) 
Seat 5: DUkalisUA ($148.55 in chips) 
Seat 6: Effort92 ($100 in chips) 
Seat 7: matiko09 ($109.23 in chips) 
Seat 8: titentei ($90.50 in chips) 
pablos1922: posts small blind $0.50
YuriiSolodya: posts big blind $1
*** HOLE CARDS ***
Dealt to matiko09 [As 7s]
DUkalisUA: raises $2 to $3
Effort92: folds 
matiko09: folds 
titentei: folds 
Jimy Tiltman: folds 
$-Twackle-$: folds 
pablos1922: folds 
YuriiSolodya: calls $2
*** FLOP *** [Ks 2d 9d]
YuriiSolodya: checks 
DUkalisUA: bets $4.50
YuriiSolodya: folds 
Uncalled bet ($4.50) returned to DUkalisUA
DUkalisUA collected $6.21 from pot
DUkalisUA: doesn't show hand 
*** SUMMARY ***
Total pot $6.50 | Rake $0.29 
Board [Ks 2d 9d]
Seat 1: Jimy Tiltman folded before Flop (didn't bet)
Seat 2: $-Twackle-$ (button) folded before Flop (didn't bet)
Seat 3: pablos1922 (small blind) folded before Flop
Seat 4: YuriiSolodya (big blind) folded on the Flop
Seat 5: DUkalisUA collected ($6.21)
Seat 6: Effort92 folded before Flop (didn't bet)
Seat 7: matiko09 folded before Flop (didn't bet)
Seat 8: titentei folded before Flop (didn't bet)





PokerStars Hand #150801136387:  Hold'em No Limit ($0.50/$1.00 USD) - 2016/03/23 14:23:30 CET [2016/03/23 9:23:30 ET]
Table 'Kippes' 9-max Seat #1 is the button
Seat 1: Pvsx. ($118.68 in chips) 
Seat 3: CAJUN890 ($129 in chips) 
Seat 4: matiko09 ($100 in chips) 
Seat 5: Jimy Tiltman ($135.72 in chips) 
Seat 6: DUkalisUA ($113.36 in chips) 
Seat 7: lumen21 ($101.50 in chips) 
Seat 8: Sherlockplay ($100 in chips) 
Seat 9: wang19790906 ($91.92 in chips) 
CAJUN890: posts small blind $0.50
matiko09: posts big blind $1
*** HOLE CARDS ***
Dealt to matiko09 [Jd 7h]
Jimy Tiltman: folds 
DUkalisUA: folds 
lumen21: folds 
Sherlockplay: folds 
wang19790906: calls $1
Pvsx.: folds 
CAJUN890: calls $0.50
matiko09: checks 
*** FLOP *** [5c 3s 8c]
CAJUN890: checks 
matiko09: checks 
wang19790906: checks 
*** TURN *** [5c 3s 8c] [Td]
CAJUN890: checks 
matiko09: checks 
wang19790906: checks 
*** RIVER *** [5c 3s 8c Td] [4h]
CAJUN890: checks 
matiko09: checks 
wang19790906: bets $2.86
CAJUN890: folds 
matiko09: folds 
Uncalled bet ($2.86) returned to wang19790906
wang19790906 collected $2.86 from pot
*** SUMMARY ***
Total pot $3 | Rake $0.14 
Board [5c 3s 8c Td 4h]
Seat 1: Pvsx. (button) folded before Flop (didn't bet)
Seat 3: CAJUN890 (small blind) folded on the River
Seat 4: matiko09 (big blind) folded on the River
Seat 5: Jimy Tiltman folded before Flop (didn't bet)
Seat 6: DUkalisUA folded before Flop (didn't bet)
Seat 7: lumen21 folded before Flop (didn't bet)
Seat 8: Sherlockplay folded before Flop (didn't bet)
Seat 9: wang19790906 collected ($2.86)





PokerStars Hand #150801136839:  Hold'em No Limit ($0.25/$0.50 USD) - 2016/03/23 14:23:31 CET [2016/03/23 9:23:31 ET]
Table 'Pyrrhus' 9-max Seat #5 is the button
Seat 1: lumen21 ($79.77 in chips) 
Seat 2: alemão007 ($47 in chips) 
Seat 3: i L00K great ($50 in chips) 
Seat 4: GriffinBerg ($34.34 in chips) 
Seat 5: ZonTTT ($55.86 in chips) 
Seat 6: Ahangama ($50.25 in chips) 
Seat 7: matiko09 ($134.81 in chips) 
Seat 8: dndngod ($79.84 in chips) 
Seat 9: CvMCvMCvM ($98.38 in chips) 
Ahangama: posts small blind $0.25
matiko09: posts big blind $0.50
*** HOLE CARDS ***
Dealt to matiko09 [Qh Qs]
dndngod: raises $1 to $1.50
CvMCvMCvM: folds 
lumen21: folds 
alemão007: folds 
i L00K great: folds 
GriffinBerg: folds 
ZonTTT: folds 
Ahangama: folds 
matiko09: calls $1
*** FLOP *** [5h Qc 3s]
matiko09: checks 
dndngod: checks 
*** TURN *** [5h Qc 3s] [4d]
matiko09: bets $1.61
dndngod: calls $1.61
*** RIVER *** [5h Qc 3s 4d] [Kd]
matiko09: bets $4.02
dndngod: folds 
Uncalled bet ($4.02) returned to matiko09
matiko09 collected $6.18 from pot
matiko09: doesn't show hand 
*** SUMMARY ***
Total pot $6.47 | Rake $0.29 
Board [5h Qc 3s 4d Kd]
Seat 1: lumen21 folded before Flop (didn't bet)
Seat 2: alemão007 folded before Flop (didn't bet)
Seat 3: i L00K great folded before Flop (didn't bet)
Seat 4: GriffinBerg folded before Flop (didn't bet)
Seat 5: ZonTTT (button) folded before Flop (didn't bet)
Seat 6: Ahangama (small blind) folded before Flop
Seat 7: matiko09 (big blind) collected ($6.18)
Seat 8: dndngod folded on the River
Seat 9: CvMCvMCvM folded before Flop (didn't bet)





PokerStars Hand #150801137356:  Hold'em No Limit ($1/$2 USD) - 2016/03/23 14:23:32 CET [2016/03/23 9:23:32 ET]
Table 'Kypria II' 9-max Seat #5 is the button
Seat 1: geldwolfje ($81.90 in chips) 
Seat 2: coinflip_si ($219.70 in chips) 
Seat 3: seouljam ($212.20 in chips) 
Seat 4: VolanDog ($200 in chips) 
Seat 5: InsomniaRU ($379.88 in chips) 
Seat 6: matiko09 ($371.95 in chips) 
Seat 7: DUkalisUA ($200 in chips) 
Seat 9: Moszes360 ($202 in chips) 
matiko09: posts small blind $1
DUkalisUA: posts big blind $2
Pearl Jam87: sits out 
*** HOLE CARDS ***
Dealt to matiko09 [Js Qc]
Moszes360: folds 
geldwolfje: raises $6 to $8
coinflip_si: folds 
seouljam: calls $8
VolanDog: folds 
InsomniaRU: folds 
matiko09: folds 
DUkalisUA: calls $6
*** FLOP *** [Jd 5s 3h]
DUkalisUA: checks 
geldwolfje: checks 
seouljam: bets $8
DUkalisUA: folds 
geldwolfje: raises $65.90 to $73.90 and is all-in
seouljam: calls $65.90
*** TURN *** [Jd 5s 3h] [Ah]
*** RIVER *** [Jd 5s 3h Ah] [3c]
*** SHOW DOWN ***
geldwolfje: shows [Jc Ts] (two pair, Jacks and Threes)
seouljam: shows [4h 6h] (a pair of Threes)
geldwolfje collected $170 from pot
*** SUMMARY ***
Total pot $172.80 | Rake $2.80 
Board [Jd 5s 3h Ah 3c]
Seat 1: geldwolfje showed [Jc Ts] and won ($170) with two pair, Jacks and Threes
Seat 2: coinflip_si folded before Flop (didn't bet)
Seat 3: seouljam showed [4h 6h] and lost with a pair of Threes
Seat 4: VolanDog folded before Flop (didn't bet)
Seat 5: InsomniaRU (button) folded before Flop (didn't bet)
Seat 6: matiko09 (small blind) folded before Flop
Seat 7: DUkalisUA (big blind) folded on the Flop
Seat 9: Moszes360 folded before Flop (didn't bet)





PokerStars Hand #150801138361:  Hold'em No Limit ($1/$2 USD) - 2016/03/23 14:23:34 CET [2016/03/23 9:23:34 ET]
Table 'Achaia' 9-max Seat #9 is the button
Seat 2: InsomniaRU ($221.66 in chips) 
Seat 3: matiko09 ($203 in chips) 
Seat 4: nailz83 ($179.46 in chips) 
Seat 5: DUkalisUA ($213.37 in chips) 
Seat 6: nickreason17 ($212.30 in chips) 
Seat 7: morosun ($200.22 in chips) 
Seat 8: $-Twackle-$ ($231.65 in chips) 
Seat 9: glanza_mike ($201.28 in chips) 
InsomniaRU: posts small blind $1
matiko09: posts big blind $2
*** HOLE CARDS ***
Dealt to matiko09 [8d Js]
nailz83: folds 
DUkalisUA: folds 
nickreason17: folds 
morosun: folds 
$-Twackle-$: folds 
Moszes360 joins the table at seat #1 
glanza_mike: raises $4 to $6
InsomniaRU: folds 
matiko09: folds 
Uncalled bet ($4) returned to glanza_mike
glanza_mike collected $5 from pot
glanza_mike: doesn't show hand 
*** SUMMARY ***
Total pot $5 | Rake $0 
Seat 2: InsomniaRU (small blind) folded before Flop
Seat 3: matiko09 (big blind) folded before Flop
Seat 4: nailz83 folded before Flop (didn't bet)
Seat 5: DUkalisUA folded before Flop (didn't bet)
Seat 6: nickreason17 folded before Flop (didn't bet)
Seat 7: morosun folded before Flop (didn't bet)
Seat 8: $-Twackle-$ folded before Flop (didn't bet)
Seat 9: glanza_mike (button) collected ($5)





PokerStars Hand #150801148795:  Hold'em No Limit ($1/$2 USD) - 2016/03/23 14:23:51 CET [2016/03/23 9:23:51 ET]
Table 'Herba II' 9-max Seat #3 is the button
Seat 1: matiko09 ($212.06 in chips) 
Seat 2: Moszes360 ($211.15 in chips) 
Seat 3: Cirilico ($186.84 in chips) 
Seat 4: DUkalisUA ($302.90 in chips) 
Seat 5: chippo boy ($221.38 in chips) 
Seat 6: Too-Anti-To ($212.46 in chips) 
Seat 7: InsomniaRU ($200 in chips) 
Seat 9: mrhighryza ($62.67 in chips) 
DUkalisUA: posts small blind $1
chippo boy: posts big blind $2
*** HOLE CARDS ***
Dealt to matiko09 [Js 2h]
Too-Anti-To: folds 
InsomniaRU: folds 
mrhighryza: folds 
matiko09: folds 
Moszes360: raises $4 to $6
Cirilico: folds 
DUkalisUA: folds 
chippo boy: calls $4
*** FLOP *** [Kh As 2s]
chippo boy: checks 
Moszes360: bets $10.55
chippo boy: calls $10.55
*** TURN *** [Kh As 2s] [5c]
chippo boy: checks 
Moszes360: bets $27.68
chippo boy: folds 
Uncalled bet ($27.68) returned to Moszes360
Moszes360 collected $32.57 from pot
Moszes360: doesn't show hand 
*** SUMMARY ***
Total pot $34.10 | Rake $1.53 
Board [Kh As 2s 5c]
Seat 1: matiko09 folded before Flop (didn't bet)
Seat 2: Moszes360 collected ($32.57)
Seat 3: Cirilico (button) folded before Flop (didn't bet)
Seat 4: DUkalisUA (small blind) folded before Flop
Seat 5: chippo boy (big blind) folded on the Turn
Seat 6: Too-Anti-To folded before Flop (didn't bet)
Seat 7: InsomniaRU folded before Flop (didn't bet)
Seat 9: mrhighryza folded before Flop (didn't bet)





PokerStars Hand #150801150528:  Hold'em No Limit ($1/$2 USD) - 2016/03/23 14:23:54 CET [2016/03/23 9:23:54 ET]
Table 'Deipylos II' 9-max Seat #5 is the button
Seat 1: $-Twackle-$ ($200 in chips) 
Seat 2: T0ny Adams ($88.32 in chips) 
Seat 4: matiko09 ($200 in chips) 
Seat 5: InsomniaRU ($225.88 in chips) 
Seat 6: nickreason17 ($200 in chips) 
Seat 7: volwebni4ek ($94.70 in chips) 
Seat 8: Igoriah ($200 in chips) 
Seat 9: Ranatuo84 ($248.62 in chips) 
nickreason17: posts small blind $1
volwebni4ek: posts big blind $2
DUkalisUA: sits out 
*** HOLE CARDS ***
Dealt to matiko09 [Qc Ah]
Igoriah: raises $3 to $5
Ranatuo84: folds 
$-Twackle-$: folds 
T0ny Adams: folds 
matiko09: calls $5
InsomniaRU: folds 
nickreason17: raises $17 to $22
volwebni4ek: folds 
Igoriah: calls $17
matiko09: calls $17
*** FLOP *** [8d Ad 4c]
nickreason17: checks 
Igoriah: bets $39
matiko09: calls $39
nickreason17: folds 
*** TURN *** [8d Ad 4c] [Ts]
Igoriah: bets $139 and is all-in
matiko09: folds 
Uncalled bet ($139) returned to Igoriah
Igoriah collected $143.20 from pot
Igoriah: doesn't show hand 
*** SUMMARY ***
Total pot $146 | Rake $2.80 
Board [8d Ad 4c Ts]
Seat 1: $-Twackle-$ folded before Flop (didn't bet)
Seat 2: T0ny Adams folded before Flop (didn't bet)
Seat 4: matiko09 folded on the Turn
Seat 5: InsomniaRU (button) folded before Flop (didn't bet)
Seat 6: nickreason17 (small blind) folded on the Flop
Seat 7: volwebni4ek (big blind) folded before Flop
Seat 8: Igoriah collected ($143.20)
Seat 9: Ranatuo84 folded before Flop (didn't bet)





PokerStars Hand #150801153334:  Hold'em No Limit ($1/$2 USD) - 2016/03/23 14:23:58 CET [2016/03/23 9:23:58 ET]
Table 'Kiess' 9-max Seat #9 is the button
Seat 1: Cirilico ($227.74 in chips) 
Seat 2: DUkalisUA ($674.10 in chips) 
Seat 4: Moszes360 ($200 in chips) 
Seat 5: chippo boy ($454.96 in chips) 
Seat 6: matiko09 ($261.96 in chips) 
Seat 7: InsomniaRU ($293.51 in chips) 
Seat 8: erfk1958 ($116.55 in chips) 
Seat 9: T0ny Adams ($77 in chips) 
Cirilico: posts small blind $1
DUkalisUA: posts big blind $2
*** HOLE CARDS ***
Dealt to matiko09 [2d 4d]
Moszes360: folds 
chippo boy: folds 
matiko09: folds 
InsomniaRU: folds 
erfk1958: folds 
T0ny Adams: folds 
Cirilico: raises $4 to $6
DUkalisUA: folds 
Uncalled bet ($4) returned to Cirilico
Cirilico collected $4 from pot
Cirilico: doesn't show hand 
*** SUMMARY ***
Total pot $4 | Rake $0 
Seat 1: Cirilico (small blind) collected ($4)
Seat 2: DUkalisUA (big blind) folded before Flop
Seat 4: Moszes360 folded before Flop (didn't bet)
Seat 5: chippo boy folded before Flop (didn't bet)
Seat 6: matiko09 folded before Flop (didn't bet)
Seat 7: InsomniaRU folded before Flop (didn't bet)
Seat 8: erfk1958 folded before Flop (didn't bet)
Seat 9: T0ny Adams (button) folded before Flop (didn't bet)





PokerStars Hand #150801154275:  Hold'em No Limit ($1/$2 USD) - 2016/03/23 14:24:00 CET [2016/03/23 9:24:00 ET]
Table 'Achaia' 9-max Seat #2 is the button
Seat 2: InsomniaRU ($220.66 in chips) 
Seat 3: matiko09 ($201 in chips) 
Seat 4: nailz83 ($179.46 in chips) 
Seat 5: DUkalisUA ($213.37 in chips) 
Seat 6: nickreason17 ($212.30 in chips) 
Seat 7: morosun ($200.22 in chips) 
Seat 8: $-Twackle-$ ($231.65 in chips) 
Seat 9: glanza_mike ($204.28 in chips) 
matiko09: posts small blind $1
nailz83: posts big blind $2
Moszes360: sits out 
*** HOLE CARDS ***
Dealt to matiko09 [Ac Qd]
DUkalisUA: folds 
nickreason17: folds 
morosun: raises $4 to $6
$-Twackle-$: folds 
glanza_mike: folds 
InsomniaRU: folds 
matiko09: calls $5
nailz83: calls $4
*** FLOP *** [6h 4d Ts]
matiko09: checks 
nailz83: checks 
morosun: bets $8
matiko09: folds 
nailz83: calls $8
*** TURN *** [6h 4d Ts] [2c]
nailz83: checks 
morosun: checks 
*** RIVER *** [6h 4d Ts 2c] [Js]
nailz83: bets $20
morosun: calls $20
*** SHOW DOWN ***
nailz83: shows [4c 6d] (two pair, Sixes and Fours)
morosun: mucks hand 
nailz83 collected $71.20 from pot
*** SUMMARY ***
Total pot $74 | Rake $2.80 
Board [6h 4d Ts 2c Js]
Seat 2: InsomniaRU (button) folded before Flop (didn't bet)
Seat 3: matiko09 (small blind) folded on the Flop
Seat 4: nailz83 (big blind) showed [4c 6d] and won ($71.20) with two pair, Sixes and Fours
Seat 5: DUkalisUA folded before Flop (didn't bet)
Seat 6: nickreason17 folded before Flop (didn't bet)
Seat 7: morosun mucked [Jd Kh]
Seat 8: $-Twackle-$ folded before Flop (didn't bet)
Seat 9: glanza_mike folded before Flop (didn't bet)





PokerStars Hand #150801155506:  Hold'em No Limit ($0.50/$1.00 USD) - 2016/03/23 14:24:02 CET [2016/03/23 9:24:02 ET]
Table 'Swings' 9-max Seat #6 is the button
Seat 1: Sherlockplay ($100 in chips) 
Seat 2: Harbinger X ($80 in chips) 
Seat 3: pablos1922 ($100 in chips) 
Seat 4: chaps1988 ($100 in chips) 
Seat 5: chautinhtri9 ($100 in chips) 
Seat 6: matiko09 ($100 in chips) 
Seat 7: nickreason17 ($100 in chips) 
Seat 8: RICKA16 ($100 in chips) 
Seat 9: Vlad_1965_77 ($100 in chips) 
nickreason17: posts small blind $0.50
RICKA16: posts big blind $1
*** HOLE CARDS ***
Dealt to matiko09 [9c Jc]
Vlad_1965_77: folds 
Sherlockplay: folds 
Harbinger X: folds 
pablos1922: folds 
pablos1922 leaves the table
chaps1988: folds 
chautinhtri9: raises $1 to $2
matiko09: folds 
nickreason17: folds 
maxxmeister joins the table at seat #3 
RICKA16 has timed out
RICKA16: folds 
Uncalled bet ($1) returned to chautinhtri9
chautinhtri9 collected $2.50 from pot
chautinhtri9: doesn't show hand 
*** SUMMARY ***
Total pot $2.50 | Rake $0 
Seat 1: Sherlockplay folded before Flop (didn't bet)
Seat 2: Harbinger X folded before Flop (didn't bet)
Seat 3: pablos1922 folded before Flop (didn't bet)
Seat 4: chaps1988 folded before Flop (didn't bet)
Seat 5: chautinhtri9 collected ($2.50)
Seat 6: matiko09 (button) folded before Flop (didn't bet)
Seat 7: nickreason17 (small blind) folded before Flop
Seat 8: RICKA16 (big blind) folded before Flop
Seat 9: Vlad_1965_77 folded before Flop (didn't bet)





PokerStars Hand #150801156935:  Hold'em No Limit ($0.50/$1.00 USD) - 2016/03/23 14:24:04 CET [2016/03/23 9:24:04 ET]
Table 'Merope II' 9-max Seat #3 is the button
Seat 1: Jimy Tiltman ($132.20 in chips) 
Seat 2: $-Twackle-$ ($100 in chips) 
Seat 3: pablos1922 ($100.92 in chips) 
Seat 4: YuriiSolodya ($86.34 in chips) 
Seat 5: DUkalisUA ($151.76 in chips) 
Seat 6: Effort92 ($100 in chips) 
Seat 7: matiko09 ($109.23 in chips) 
Seat 8: titentei ($90.50 in chips) 
YuriiSolodya: posts small blind $0.50
DUkalisUA: posts big blind $1
*** HOLE CARDS ***
Dealt to matiko09 [4s 7d]
Effort92: folds 
matiko09: folds 
titentei: folds 
Jimy Tiltman: raises $2 to $3
$-Twackle-$: folds 
pablos1922: calls $3
YuriiSolodya: folds 
DUkalisUA: folds 
*** FLOP *** [6h 5s 7s]
Jimy Tiltman: bets $4.20
pablos1922: folds 
Uncalled bet ($4.20) returned to Jimy Tiltman
Jimy Tiltman collected $7.16 from pot
Jimy Tiltman: doesn't show hand 
*** SUMMARY ***
Total pot $7.50 | Rake $0.34 
Board [6h 5s 7s]
Seat 1: Jimy Tiltman collected ($7.16)
Seat 2: $-Twackle-$ folded before Flop (didn't bet)
Seat 3: pablos1922 (button) folded on the Flop
Seat 4: YuriiSolodya (small blind) folded before Flop
Seat 5: DUkalisUA (big blind) folded before Flop
Seat 6: Effort92 folded before Flop (didn't bet)
Seat 7: matiko09 folded before Flop (didn't bet)
Seat 8: titentei folded before Flop (didn't bet)





PokerStars Hand #150801158545:  Hold'em No Limit ($0.50/$1.00 USD) - 2016/03/23 14:24:07 CET [2016/03/23 9:24:07 ET]
Table 'Atlantis' 9-max Seat #6 is the button
Seat 1: xHourglass ($150.77 in chips) 
Seat 2: tffff2006 ($69.72 in chips) 
Seat 3: CAJUN890 ($104.29 in chips) 
Seat 4: matiko09 ($133.25 in chips) 
Seat 5: Pvsx. ($102.75 in chips) 
Seat 6: Jimy Tiltman ($101.78 in chips) 
Seat 7: Sherlockplay ($136.27 in chips) 
Seat 8: DUkalisUA ($102.50 in chips) 
Sherlockplay: posts small blind $0.50
DUkalisUA: posts big blind $1
*** HOLE CARDS ***
Dealt to matiko09 [4s 5h]
xHourglass: folds 
tffff2006: folds 
CAJUN890: folds 
matiko09: folds 
Pvsx.: raises $1.50 to $2.50
Jimy Tiltman: folds 
Sherlockplay: folds 
DUkalisUA: folds 
Uncalled bet ($1.50) returned to Pvsx.
Pvsx. collected $2.50 from pot
Pvsx.: doesn't show hand 
*** SUMMARY ***
Total pot $2.50 | Rake $0 
Seat 1: xHourglass folded before Flop (didn't bet)
Seat 2: tffff2006 folded before Flop (didn't bet)
Seat 3: CAJUN890 folded before Flop (didn't bet)
Seat 4: matiko09 folded before Flop (didn't bet)
Seat 5: Pvsx. collected ($2.50)
Seat 6: Jimy Tiltman (button) folded before Flop (didn't bet)
Seat 7: Sherlockplay (small blind) folded before Flop
Seat 8: DUkalisUA (big blind) folded before Flop





PokerStars Hand #150801162067:  Hold'em No Limit (€0.50/€1.00 EUR) - 2016/03/23 14:24:13 CET [2016/03/23 9:24:13 ET]
Table 'Lanzia' 9-max Seat #6 is the button
Seat 1: fk154 (€39 in chips) 
Seat 2: ardo888 (€101.50 in chips) 
Seat 3: Effort92 (€196.81 in chips) 
Seat 4: niong62 (€81.38 in chips) 
Seat 5: matiko09 (€100 in chips) 
Seat 6: Red4erT (€40 in chips) 
Seat 7: $-Twackle-$ (€119.22 in chips) 
Seat 8: Muinmyheart (€103.50 in chips) 
Seat 9: Butcher1848 (€105.37 in chips) 
$-Twackle-$: posts small blind €0.50
Muinmyheart: posts big blind €1
*** HOLE CARDS ***
Dealt to matiko09 [7c Qc]
Butcher1848: folds 
fk154: raises €1 to €2
ardo888: folds 
Effort92: folds 
niong62: calls €2
matiko09: folds 
Red4erT: folds 
$-Twackle-$: folds 
Muinmyheart: folds 
*** FLOP *** [Kd Ac 6h]
fk154: checks 
niong62: checks 
*** TURN *** [Kd Ac 6h] [Ks]
fk154: checks 
niong62: checks 
*** RIVER *** [Kd Ac 6h Ks] [5c]
fk154: bets €1
niong62: folds 
Uncalled bet (€1) returned to fk154
fk154 collected €5.25 from pot
fk154: doesn't show hand 
*** SUMMARY ***
Total pot €5.50 | Rake €0.25 
Board [Kd Ac 6h Ks 5c]
Seat 1: fk154 collected (€5.25)
Seat 2: ardo888 folded before Flop (didn't bet)
Seat 3: Effort92 folded before Flop (didn't bet)
Seat 4: niong62 folded on the River
Seat 5: matiko09 folded before Flop (didn't bet)
Seat 6: Red4erT (button) folded before Flop (didn't bet)
Seat 7: $-Twackle-$ (small blind) folded before Flop
Seat 8: Muinmyheart (big blind) folded before Flop
Seat 9: Butcher1848 folded before Flop (didn't bet)





PokerStars Hand #150801164333:  Hold'em No Limit ($0.50/$1.00 USD) - 2016/03/23 14:24:17 CET [2016/03/23 9:24:17 ET]
Table 'Donar II' 9-max Seat #2 is the button
Seat 1: Effort92 ($103.82 in chips) 
Seat 2: nobrunobru1 ($55.24 in chips) 
Seat 3: st-germ30 ($97.89 in chips) 
Seat 4: DUkalisUA ($145.09 in chips) 
Seat 5: matiko09 ($100 in chips) 
Seat 6: ardo888 ($129.80 in chips) 
Seat 7: JimineyCrik ($98.65 in chips) 
Seat 8: $-Twackle-$ ($113.35 in chips) 
Seat 9: oxfordtenzin ($125.60 in chips) 
st-germ30: posts small blind $0.50
DUkalisUA: posts big blind $1
Effort92: posts the ante $0.20
nobrunobru1: posts the ante $0.20
st-germ30: posts the ante $0.20
DUkalisUA: posts the ante $0.20
matiko09: posts the ante $0.20
ardo888: posts the ante $0.20
JimineyCrik: posts the ante $0.20
$-Twackle-$: posts the ante $0.20
oxfordtenzin: posts the ante $0.20
*** HOLE CARDS ***
Dealt to matiko09 [7d Qd]
matiko09: folds 
ardo888: folds 
JimineyCrik: folds 
$-Twackle-$: folds 
oxfordtenzin: folds 
Effort92: folds 
nobrunobru1: folds 
st-germ30: folds 
Uncalled bet ($0.50) returned to DUkalisUA
DUkalisUA collected $2.80 from pot
DUkalisUA: doesn't show hand 
*** SUMMARY ***
Total pot $2.80 | Rake $0 
Seat 1: Effort92 folded before Flop (didn't bet)
Seat 2: nobrunobru1 (button) folded before Flop (didn't bet)
Seat 3: st-germ30 (small blind) folded before Flop
Seat 4: DUkalisUA (big blind) collected ($2.80)
Seat 5: matiko09 folded before Flop (didn't bet)
Seat 6: ardo888 folded before Flop (didn't bet)
Seat 7: JimineyCrik folded before Flop (didn't bet)
Seat 8: $-Twackle-$ folded before Flop (didn't bet)
Seat 9: oxfordtenzin folded before Flop (didn't bet)





PokerStars Hand #150801167029:  Hold'em No Limit ($1/$2 USD) - 2016/03/23 14:24:21 CET [2016/03/23 9:24:21 ET]
Table 'Ennomos II' 9-max Seat #8 is the button
Seat 1: ilaviiitech ($200 in chips) 
Seat 2: Subam ($422.18 in chips) 
Seat 3: $-Twackle-$ ($231.20 in chips) 
Seat 4: glanza_mike ($200 in chips) 
Seat 5: South011 ($384.88 in chips) 
Seat 6: nickreason17 ($237.98 in chips) 
Seat 7: daniferdoser ($200 in chips) 
Seat 8: yyfk ($207.24 in chips) 
Seat 9: matiko09 ($200 in chips) 
matiko09: posts small blind $1
ilaviiitech: posts big blind $2
*** HOLE CARDS ***
Dealt to matiko09 [4c Kh]
Subam has timed out
Subam: folds 
$-Twackle-$: folds 
glanza_mike: raises $4 to $6
South011: folds 
nickreason17: raises $12 to $18
daniferdoser: folds 
yyfk: folds 
matiko09: folds 
ilaviiitech: folds 
glanza_mike: folds 
Uncalled bet ($12) returned to nickreason17
nickreason17 collected $15 from pot
*** SUMMARY ***
Total pot $15 | Rake $0 
Seat 1: ilaviiitech (big blind) folded before Flop
Seat 2: Subam folded before Flop (didn't bet)
Seat 3: $-Twackle-$ folded before Flop (didn't bet)
Seat 4: glanza_mike folded before Flop
Seat 5: South011 folded before Flop (didn't bet)
Seat 6: nickreason17 collected ($15)
Seat 7: daniferdoser folded before Flop (didn't bet)
Seat 8: yyfk (button) folded before Flop (didn't bet)
Seat 9: matiko09 (small blind) folded before Flop





PokerStars Hand #150801172102:  Hold'em No Limit ($1/$2 USD) - 2016/03/23 14:24:29 CET [2016/03/23 9:24:29 ET]
Table 'Kiess' 9-max Seat #1 is the button
Seat 1: Cirilico ($229.74 in chips) 
Seat 2: DUkalisUA ($672.10 in chips) 
Seat 4: Moszes360 ($200 in chips) 
Seat 5: chippo boy ($454.96 in chips) 
Seat 6: matiko09 ($261.96 in chips) 
Seat 7: InsomniaRU ($293.51 in chips) 
Seat 8: erfk1958 ($116.55 in chips) 
Seat 9: T0ny Adams ($77 in chips) 
DUkalisUA: posts small blind $1
Moszes360: posts big blind $2
*** HOLE CARDS ***
Dealt to matiko09 [3s Kd]
chippo boy: folds 
matiko09: folds 
InsomniaRU: raises $3 to $5
erfk1958: calls $5
T0ny Adams: folds 
Cirilico: folds 
DUkalisUA: folds 
Moszes360: folds 
*** FLOP *** [7h 6s Jc]
InsomniaRU: checks 
erfk1958: bets $6
InsomniaRU: calls $6
*** TURN *** [7h 6s Jc] [8c]
InsomniaRU: checks 
erfk1958: checks 
*** RIVER *** [7h 6s Jc 8c] [Ad]
InsomniaRU: bets $9.55
erfk1958: folds 
Uncalled bet ($9.55) returned to InsomniaRU
InsomniaRU collected $23.88 from pot
InsomniaRU: doesn't show hand 
*** SUMMARY ***
Total pot $25 | Rake $1.12 
Board [7h 6s Jc 8c Ad]
Seat 1: Cirilico (button) folded before Flop (didn't bet)
Seat 2: DUkalisUA (small blind) folded before Flop
Seat 4: Moszes360 (big blind) folded before Flop
Seat 5: chippo boy folded before Flop (didn't bet)
Seat 6: matiko09 folded before Flop (didn't bet)
Seat 7: InsomniaRU collected ($23.88)
Seat 8: erfk1958 folded on the River
Seat 9: T0ny Adams folded before Flop (didn't bet)





PokerStars Hand #150801182129:  Hold'em No Limit ($1/$2 USD) - 2016/03/23 14:24:46 CET [2016/03/23 9:24:46 ET]
Table 'Herba II' 9-max Seat #4 is the button
Seat 1: matiko09 ($212.06 in chips) 
Seat 2: Moszes360 ($227.17 in chips) 
Seat 3: Cirilico ($186.84 in chips) 
Seat 4: DUkalisUA ($301.90 in chips) 
Seat 5: chippo boy ($204.83 in chips) 
Seat 6: Too-Anti-To ($212.46 in chips) 
Seat 7: InsomniaRU ($200 in chips) 
Seat 9: mrhighryza ($62.67 in chips) 
chippo boy: posts small blind $1
Too-Anti-To: posts big blind $2
*** HOLE CARDS ***
Dealt to matiko09 [8h 6s]
InsomniaRU: folds 
mrhighryza: folds 
matiko09: folds 
Moszes360: folds 
Cirilico: folds 
DUkalisUA: folds 
chippo boy: folds 
Uncalled bet ($1) returned to Too-Anti-To
Too-Anti-To collected $2 from pot
Too-Anti-To: doesn't show hand 
*** SUMMARY ***
Total pot $2 | Rake $0 
Seat 1: matiko09 folded before Flop (didn't bet)
Seat 2: Moszes360 folded before Flop (didn't bet)
Seat 3: Cirilico folded before Flop (didn't bet)
Seat 4: DUkalisUA (button) folded before Flop (didn't bet)
Seat 5: chippo boy (small blind) folded before Flop
Seat 6: Too-Anti-To (big blind) collected ($2)
Seat 7: InsomniaRU folded before Flop (didn't bet)
Seat 9: mrhighryza folded before Flop (didn't bet)





PokerStars Hand #150801183190:  Hold'em No Limit ($1/$2 USD) - 2016/03/23 14:24:48 CET [2016/03/23 9:24:48 ET]
Table 'Kypria II' 9-max Seat #6 is the button
Seat 1: geldwolfje ($170 in chips) 
Seat 2: coinflip_si ($219.70 in chips) 
Seat 3: seouljam ($130.30 in chips) 
Seat 4: VolanDog ($200 in chips) 
Seat 5: InsomniaRU ($379.88 in chips) 
Seat 6: matiko09 ($370.95 in chips) 
Seat 7: DUkalisUA ($200 in chips) 
Seat 8: Pearl Jam87 ($200 in chips) 
Seat 9: Moszes360 ($202 in chips) 
DUkalisUA: posts small blind $1
Pearl Jam87: posts big blind $2
*** HOLE CARDS ***
Dealt to matiko09 [9d 8s]
Moszes360: raises $4 to $6
geldwolfje: folds 
coinflip_si: folds 
seouljam: calls $6
VolanDog: folds 
InsomniaRU: folds 
geldwolfje said, "sorry"
matiko09: folds 
DUkalisUA: folds 
Pearl Jam87: folds 
*** FLOP *** [9c 7h Tc]
Moszes360: checks 
seouljam: bets $6
Moszes360: folds 
Uncalled bet ($6) returned to seouljam
seouljam collected $14.32 from pot
seouljam: doesn't show hand 
*** SUMMARY ***
Total pot $15 | Rake $0.68 
Board [9c 7h Tc]
Seat 1: geldwolfje folded before Flop (didn't bet)
Seat 2: coinflip_si folded before Flop (didn't bet)
Seat 3: seouljam collected ($14.32)
Seat 4: VolanDog folded before Flop (didn't bet)
Seat 5: InsomniaRU folded before Flop (didn't bet)
Seat 6: matiko09 (button) folded before Flop (didn't bet)
Seat 7: DUkalisUA (small blind) folded before Flop
Seat 8: Pearl Jam87 (big blind) folded before Flop
Seat 9: Moszes360 folded on the Flop





PokerStars Hand #150801185668:  Hold'em No Limit ($0.50/$1.00 USD) - 2016/03/23 14:24:52 CET [2016/03/23 9:24:52 ET]
Table 'Donar II' 9-max Seat #3 is the button
Seat 1: Effort92 ($103.62 in chips) 
Seat 2: nobrunobru1 ($55.04 in chips) 
Seat 3: st-germ30 ($97.19 in chips) 
Seat 4: DUkalisUA ($147.19 in chips) 
Seat 5: matiko09 ($100 in chips) 
Seat 6: ardo888 ($129.60 in chips) 
Seat 7: JimineyCrik ($98.45 in chips) 
Seat 8: $-Twackle-$ ($113.15 in chips) 
Seat 9: oxfordtenzin ($125.40 in chips) 
DUkalisUA: posts small blind $0.50
matiko09: posts big blind $1
Effort92: posts the ante $0.20
nobrunobru1: posts the ante $0.20
st-germ30: posts the ante $0.20
DUkalisUA: posts the ante $0.20
matiko09: posts the ante $0.20
ardo888: posts the ante $0.20
JimineyCrik: posts the ante $0.20
$-Twackle-$: posts the ante $0.20
oxfordtenzin: posts the ante $0.20
*** HOLE CARDS ***
Dealt to matiko09 [9d 6c]
ardo888: raises $2 to $3
JimineyCrik: calls $3
$-Twackle-$: folds 
oxfordtenzin: folds 
Effort92: folds 
nobrunobru1: folds 
st-germ30: folds 
DUkalisUA: folds 
matiko09: folds 
*** FLOP *** [9c Td 4s]
ardo888: bets $5.50
JimineyCrik: folds 
Uncalled bet ($5.50) returned to ardo888
ardo888 collected $8.88 from pot
ardo888: doesn't show hand 
*** SUMMARY ***
Total pot $9.30 | Rake $0.42 
Board [9c Td 4s]
Seat 1: Effort92 folded before Flop (didn't bet)
Seat 2: nobrunobru1 folded before Flop (didn't bet)
Seat 3: st-germ30 (button) folded before Flop (didn't bet)
Seat 4: DUkalisUA (small blind) folded before Flop
Seat 5: matiko09 (big blind) folded before Flop
Seat 6: ardo888 collected ($8.88)
Seat 7: JimineyCrik folded on the Flop
Seat 8: $-Twackle-$ folded before Flop (didn't bet)
Seat 9: oxfordtenzin folded before Flop (didn't bet)





PokerStars Hand #150801185650:  Hold'em No Limit ($0.50/$1.00 USD) - 2016/03/23 14:24:52 CET [2016/03/23 9:24:52 ET]
Table 'Atlantis' 9-max Seat #7 is the button
Seat 1: xHourglass ($150.77 in chips) 
Seat 2: tffff2006 ($69.72 in chips) 
Seat 3: CAJUN890 ($104.29 in chips) 
Seat 4: matiko09 ($133.25 in chips) 
Seat 5: Pvsx. ($104.25 in chips) 
Seat 6: Jimy Tiltman ($101.78 in chips) 
Seat 7: Sherlockplay ($135.77 in chips) 
Seat 8: DUkalisUA ($101.50 in chips) 
DUkalisUA: posts small blind $0.50
xHourglass: posts big blind $1
*** HOLE CARDS ***
Dealt to matiko09 [5h Qd]
tffff2006: folds 
CAJUN890: folds 
matiko09: folds 
Pvsx.: folds 
Jimy Tiltman: folds 
Sherlockplay: raises $1.50 to $2.50
DUkalisUA: folds 
xHourglass: folds 
Uncalled bet ($1.50) returned to Sherlockplay
Sherlockplay collected $2.50 from pot
Sherlockplay: doesn't show hand 
*** SUMMARY ***
Total pot $2.50 | Rake $0 
Seat 1: xHourglass (big blind) folded before Flop
Seat 2: tffff2006 folded before Flop (didn't bet)
Seat 3: CAJUN890 folded before Flop (didn't bet)
Seat 4: matiko09 folded before Flop (didn't bet)
Seat 5: Pvsx. folded before Flop (didn't bet)
Seat 6: Jimy Tiltman folded before Flop (didn't bet)
Seat 7: Sherlockplay (button) collected ($2.50)
Seat 8: DUkalisUA (small blind) folded before Flop





PokerStars Hand #150801188347:  Hold'em No Limit ($0.50/$1.00 USD) - 2016/03/23 14:24:56 CET [2016/03/23 9:24:56 ET]
Table 'Kippes' 9-max Seat #3 is the button
Seat 1: Pvsx. ($118.68 in chips) 
Seat 3: CAJUN890 ($128 in chips) 
Seat 4: matiko09 ($100 in chips) 
Seat 5: Jimy Tiltman ($135.72 in chips) 
Seat 6: DUkalisUA ($113.36 in chips) 
Seat 7: lumen21 ($101.50 in chips) 
Seat 8: Sherlockplay ($100 in chips) 
Seat 9: wang19790906 ($93.78 in chips) 
matiko09: posts small blind $0.50
Jimy Tiltman: posts big blind $1
*** HOLE CARDS ***
Dealt to matiko09 [9d Ah]
DUkalisUA: folds 
lumen21: folds 
Sherlockplay: folds 
wang19790906: calls $1
Pvsx.: folds 
CAJUN890: folds 
matiko09: calls $0.50
Jimy Tiltman: raises $3 to $4
wang19790906: folds 
matiko09: folds 
Uncalled bet ($3) returned to Jimy Tiltman
Jimy Tiltman collected $3 from pot
Jimy Tiltman: doesn't show hand 
*** SUMMARY ***
Total pot $3 | Rake $0 
Seat 1: Pvsx. folded before Flop (didn't bet)
Seat 3: CAJUN890 (button) folded before Flop (didn't bet)
Seat 4: matiko09 (small blind) folded before Flop
Seat 5: Jimy Tiltman (big blind) collected ($3)
Seat 6: DUkalisUA folded before Flop (didn't bet)
Seat 7: lumen21 folded before Flop (didn't bet)
Seat 8: Sherlockplay folded before Flop (didn't bet)
Seat 9: wang19790906 folded before Flop





PokerStars Hand #150801190085:  Hold'em No Limit ($0.50/$1.00 USD) - 2016/03/23 14:24:59 CET [2016/03/23 9:24:59 ET]
Table 'Merope II' 9-max Seat #4 is the button
Seat 1: Jimy Tiltman ($136.36 in chips) 
Seat 2: $-Twackle-$ ($100 in chips) 
Seat 3: pablos1922 ($97.92 in chips) 
Seat 4: YuriiSolodya ($85.84 in chips) 
Seat 5: DUkalisUA ($150.76 in chips) 
Seat 6: Effort92 ($100 in chips) 
Seat 7: matiko09 ($109.23 in chips) 
Seat 8: titentei ($90.50 in chips) 
DUkalisUA: posts small blind $0.50
Effort92: posts big blind $1
*** HOLE CARDS ***
Dealt to matiko09 [Jh 4d]
matiko09: folds 
titentei: folds 
Jimy Tiltman: folds 
$-Twackle-$: folds 
pablos1922: raises $2 to $3
YuriiSolodya: folds 
DUkalisUA: calls $2.50
Effort92: folds 
*** FLOP *** [Ac Kd Jc]
DUkalisUA: checks 
pablos1922: checks 
*** TURN *** [Ac Kd Jc] [7c]
DUkalisUA: bets $2.67
pablos1922: calls $2.67
*** RIVER *** [Ac Kd Jc 7c] [6d]
DUkalisUA: checks 
pablos1922: checks 
*** SHOW DOWN ***
DUkalisUA: shows [Qh Ks] (a pair of Kings)
pablos1922: mucks hand 
DUkalisUA collected $11.78 from pot
*** SUMMARY ***
Total pot $12.34 | Rake $0.56 
Board [Ac Kd Jc 7c 6d]
Seat 1: Jimy Tiltman folded before Flop (didn't bet)
Seat 2: $-Twackle-$ folded before Flop (didn't bet)
Seat 3: pablos1922 mucked [Tc Kh]
Seat 4: YuriiSolodya (button) folded before Flop (didn't bet)
Seat 5: DUkalisUA (small blind) showed [Qh Ks] and won ($11.78) with a pair of Kings
Seat 6: Effort92 (big blind) folded before Flop
Seat 7: matiko09 folded before Flop (didn't bet)
Seat 8: titentei folded before Flop (didn't bet)





PokerStars Hand #150801191654:  Hold'em No Limit ($0.25/$0.50 USD) - 2016/03/23 14:25:02 CET [2016/03/23 9:25:02 ET]
Table 'Pyrrhus' 9-max Seat #6 is the button
Seat 1: lumen21 ($79.77 in chips) 
Seat 2: alemão007 ($47 in chips) 
Seat 3: i L00K great ($50 in chips) 
Seat 4: GriffinBerg ($34.34 in chips) 
Seat 5: ZonTTT ($55.86 in chips) 
Seat 6: Ahangama ($50 in chips) 
Seat 7: matiko09 ($137.88 in chips) 
Seat 8: dndngod ($76.73 in chips) 
Seat 9: CvMCvMCvM ($98.38 in chips) 
matiko09: posts small blind $0.25
dndngod: posts big blind $0.50
*** HOLE CARDS ***
Dealt to matiko09 [Ah 4d]
CvMCvMCvM: folds 
lumen21: folds 
alemão007: folds 
i L00K great: folds 
GriffinBerg: folds 
ZonTTT: folds 
Ahangama: folds 
matiko09: folds 
Uncalled bet ($0.25) returned to dndngod
dndngod collected $0.50 from pot
dndngod: doesn't show hand 
*** SUMMARY ***
Total pot $0.50 | Rake $0 
Seat 1: lumen21 folded before Flop (didn't bet)
Seat 2: alemão007 folded before Flop (didn't bet)
Seat 3: i L00K great folded before Flop (didn't bet)
Seat 4: GriffinBerg folded before Flop (didn't bet)
Seat 5: ZonTTT folded before Flop (didn't bet)
Seat 6: Ahangama (button) folded before Flop (didn't bet)
Seat 7: matiko09 (small blind) folded before Flop
Seat 8: dndngod (big blind) collected ($0.50)
Seat 9: CvMCvMCvM folded before Flop (didn't bet)





PokerStars Hand #150801192599:  Hold'em No Limit ($1/$2 USD) - 2016/03/23 14:25:03 CET [2016/03/23 9:25:03 ET]
Table 'Herba II' 9-max Seat #5 is the button
Seat 1: matiko09 ($212.06 in chips) 
Seat 2: Moszes360 ($227.17 in chips) 
Seat 3: Cirilico ($186.84 in chips) 
Seat 4: DUkalisUA ($301.90 in chips) 
Seat 5: chippo boy ($203.83 in chips) 
Seat 6: Too-Anti-To ($213.46 in chips) 
Seat 7: InsomniaRU ($200 in chips) 
Seat 9: mrhighryza ($62.67 in chips) 
Too-Anti-To: posts small blind $1
InsomniaRU: posts big blind $2
*** HOLE CARDS ***
Dealt to matiko09 [5d Kh]
mrhighryza: folds 
matiko09: folds 
Moszes360: folds 
Cirilico: folds 
DUkalisUA: folds 
chippo boy: folds 
Too-Anti-To: folds 
Uncalled bet ($1) returned to InsomniaRU
InsomniaRU collected $2 from pot
InsomniaRU: doesn't show hand 
*** SUMMARY ***
Total pot $2 | Rake $0 
Seat 1: matiko09 folded before Flop (didn't bet)
Seat 2: Moszes360 folded before Flop (didn't bet)
Seat 3: Cirilico folded before Flop (didn't bet)
Seat 4: DUkalisUA folded before Flop (didn't bet)
Seat 5: chippo boy (button) folded before Flop (didn't bet)
Seat 6: Too-Anti-To (small blind) folded before Flop
Seat 7: InsomniaRU (big blind) collected ($2)
Seat 9: mrhighryza folded before Flop (didn't bet)





PokerStars Hand #150801202400:  Hold'em No Limit ($1/$2 USD) - 2016/03/23 14:25:20 CET [2016/03/23 9:25:20 ET]
Table 'Kypria II' 9-max Seat #7 is the button
Seat 1: geldwolfje ($170 in chips) 
Seat 2: coinflip_si ($219.70 in chips) 
Seat 3: seouljam ($138.62 in chips) 
Seat 4: VolanDog ($200 in chips) 
Seat 5: InsomniaRU ($379.88 in chips) 
Seat 6: matiko09 ($370.95 in chips) 
Seat 7: DUkalisUA ($200 in chips) 
Seat 8: Pearl Jam87 ($200 in chips) 
Seat 9: Moszes360 ($200 in chips) 
Pearl Jam87: posts small blind $1
Moszes360: posts big blind $2
*** HOLE CARDS ***
Dealt to matiko09 [4s 2d]
geldwolfje: folds 
coinflip_si: folds 
seouljam: folds 
VolanDog: raises $4 to $6
InsomniaRU: folds 
matiko09: folds 
DUkalisUA: folds 
Pearl Jam87: folds 
Moszes360: folds 
Uncalled bet ($4) returned to VolanDog
VolanDog collected $5 from pot
*** SUMMARY ***
Total pot $5 | Rake $0 
Seat 1: geldwolfje folded before Flop (didn't bet)
Seat 2: coinflip_si folded before Flop (didn't bet)
Seat 3: seouljam folded before Flop (didn't bet)
Seat 4: VolanDog collected ($5)
Seat 5: InsomniaRU folded before Flop (didn't bet)
Seat 6: matiko09 folded before Flop (didn't bet)
Seat 7: DUkalisUA (button) folded before Flop (didn't bet)
Seat 8: Pearl Jam87 (small blind) folded before Flop
Seat 9: Moszes360 (big blind) folded before Flop





PokerStars Hand #150801204770:  Hold'em No Limit ($1/$2 USD) - 2016/03/23 14:25:23 CET [2016/03/23 9:25:23 ET]
Table 'Achaia' 9-max Seat #3 is the button
Seat 2: InsomniaRU ($220.66 in chips) 
Seat 3: matiko09 ($200 in chips) 
Seat 4: nailz83 ($216.66 in chips) 
Seat 6: nickreason17 ($212.30 in chips) 
Seat 7: morosun ($166.22 in chips) 
Seat 8: $-Twackle-$ ($231.65 in chips) 
Seat 9: glanza_mike ($204.28 in chips) 
nailz83: posts small blind $1
DUkalisUA: is sitting out 
nickreason17: posts big blind $2
Moszes360: sits out 
*** HOLE CARDS ***
Dealt to matiko09 [7h Kd]
DUkalisUA leaves the table
morosun: folds 
$-Twackle-$: folds 
glanza_mike: raises $4 to $6
InsomniaRU: folds 
matiko09: folds 
nailz83: folds 
nickreason17: folds 
Uncalled bet ($4) returned to glanza_mike
glanza_mike collected $5 from pot
glanza_mike: doesn't show hand 
*** SUMMARY ***
Total pot $5 | Rake $0 
Seat 2: InsomniaRU folded before Flop (didn't bet)
Seat 3: matiko09 (button) folded before Flop (didn't bet)
Seat 4: nailz83 (small blind) folded before Flop
Seat 6: nickreason17 (big blind) folded before Flop
Seat 7: morosun folded before Flop (didn't bet)
Seat 8: $-Twackle-$ folded before Flop (didn't bet)
Seat 9: glanza_mike collected ($5)





PokerStars Hand #150801204899:  Hold'em No Limit ($1/$2 USD) - 2016/03/23 14:25:24 CET [2016/03/23 9:25:24 ET]
Table 'Ennomos II' 9-max Seat #9 is the button
Seat 1: ilaviiitech ($200 in chips) 
Seat 2: Subam ($422.18 in chips) 
Seat 3: $-Twackle-$ ($231.20 in chips) 
Seat 4: glanza_mike ($200 in chips) 
Seat 5: South011 ($384.88 in chips) 
Seat 6: nickreason17 ($246.98 in chips) 
Seat 7: daniferdoser ($200 in chips) 
Seat 8: yyfk ($207.24 in chips) 
Seat 9: matiko09 ($200 in chips) 
ilaviiitech: posts small blind $1
Subam: posts big blind $2
*** HOLE CARDS ***
Dealt to matiko09 [Th 5h]
$-Twackle-$: folds 
glanza_mike: folds 
South011: folds 
nickreason17: folds 
daniferdoser: folds 
yyfk: folds 
matiko09: folds 
ilaviiitech: folds 
Uncalled bet ($1) returned to Subam
Subam collected $2 from pot
Subam: doesn't show hand 
*** SUMMARY ***
Total pot $2 | Rake $0 
Seat 1: ilaviiitech (small blind) folded before Flop
Seat 2: Subam (big blind) collected ($2)
Seat 3: $-Twackle-$ folded before Flop (didn't bet)
Seat 4: glanza_mike folded before Flop (didn't bet)
Seat 5: South011 folded before Flop (didn't bet)
Seat 6: nickreason17 folded before Flop (didn't bet)
Seat 7: daniferdoser folded before Flop (didn't bet)
Seat 8: yyfk folded before Flop (didn't bet)
Seat 9: matiko09 (button) folded before Flop (didn't bet)





PokerStars Hand #150801206130:  Hold'em No Limit ($0.50/$1.00 USD) - 2016/03/23 14:25:26 CET [2016/03/23 9:25:26 ET]
Table 'Atlantis' 9-max Seat #8 is the button
Seat 1: xHourglass ($149.77 in chips) 
Seat 2: tffff2006 ($69.72 in chips) 
Seat 3: CAJUN890 ($104.29 in chips) 
Seat 4: matiko09 ($133.25 in chips) 
Seat 5: Pvsx. ($104.25 in chips) 
Seat 6: Jimy Tiltman ($101.78 in chips) 
Seat 7: Sherlockplay ($137.27 in chips) 
Seat 8: DUkalisUA ($101 in chips) 
xHourglass: posts small blind $0.50
tffff2006: posts big blind $1
*** HOLE CARDS ***
Dealt to matiko09 [4h 2h]
CAJUN890: folds 
matiko09: folds 
Pvsx.: folds 
Jimy Tiltman: folds 
Sherlockplay: raises $1.50 to $2.50
DUkalisUA: folds 
xHourglass: calls $2
tffff2006: folds 
*** FLOP *** [9c 8c Jh]
xHourglass: checks 
Sherlockplay: checks 
*** TURN *** [9c 8c Jh] [Kd]
xHourglass: bets $4.29
Sherlockplay: folds 
Uncalled bet ($4.29) returned to xHourglass
xHourglass collected $5.73 from pot
xHourglass: doesn't show hand 
*** SUMMARY ***
Total pot $6 | Rake $0.27 
Board [9c 8c Jh Kd]
Seat 1: xHourglass (small blind) collected ($5.73)
Seat 2: tffff2006 (big blind) folded before Flop
Seat 3: CAJUN890 folded before Flop (didn't bet)
Seat 4: matiko09 folded before Flop (didn't bet)
Seat 5: Pvsx. folded before Flop (didn't bet)
Seat 6: Jimy Tiltman folded before Flop (didn't bet)
Seat 7: Sherlockplay folded on the Turn
Seat 8: DUkalisUA (button) folded before Flop (didn't bet)





PokerStars Hand #150801209214:  Hold'em No Limit (€0.50/€1.00 EUR) - 2016/03/23 14:25:31 CET [2016/03/23 9:25:31 ET]
Table 'Lanzia' 9-max Seat #7 is the button
Seat 1: fk154 (€42.25 in chips) 
Seat 2: ardo888 (€101.50 in chips) 
Seat 3: Effort92 (€196.81 in chips) 
Seat 4: niong62 (€79.38 in chips) 
Seat 5: matiko09 (€100 in chips) 
Seat 6: Red4erT (€40 in chips) 
Seat 7: $-Twackle-$ (€118.72 in chips) 
Seat 8: Muinmyheart (€102.50 in chips) 
Seat 9: Butcher1848 (€105.37 in chips) 
Muinmyheart: posts small blind €0.50
Butcher1848: posts big blind €1
*** HOLE CARDS ***
Dealt to matiko09 [7c Ks]
fk154: raises €1 to €2
ardo888: folds 
Effort92: folds 
niong62: folds 
matiko09: folds 
Red4erT: folds 
$-Twackle-$: folds 
Muinmyheart: folds 
Butcher1848: folds 
Uncalled bet (€1) returned to fk154
fk154 collected €2.50 from pot
*** SUMMARY ***
Total pot €2.50 | Rake €0 
Seat 1: fk154 collected (€2.50)
Seat 2: ardo888 folded before Flop (didn't bet)
Seat 3: Effort92 folded before Flop (didn't bet)
Seat 4: niong62 folded before Flop (didn't bet)
Seat 5: matiko09 folded before Flop (didn't bet)
Seat 6: Red4erT folded before Flop (didn't bet)
Seat 7: $-Twackle-$ (button) folded before Flop (didn't bet)
Seat 8: Muinmyheart (small blind) folded before Flop
Seat 9: Butcher1848 (big blind) folded before Flop





PokerStars Hand #150801209955:  Hold'em No Limit ($0.25/$0.50 USD) - 2016/03/23 14:25:32 CET [2016/03/23 9:25:32 ET]
Table 'Pyrrhus' 9-max Seat #7 is the button
Seat 1: lumen21 ($79.77 in chips) 
Seat 2: alemão007 ($47 in chips) 
Seat 3: i L00K great ($50 in chips) 
Seat 4: GriffinBerg ($34.34 in chips) 
Seat 5: ZonTTT ($55.86 in chips) 
Seat 6: Ahangama ($50 in chips) 
Seat 7: matiko09 ($137.63 in chips) 
Seat 8: dndngod ($76.98 in chips) 
Seat 9: CvMCvMCvM ($98.38 in chips) 
dndngod: posts small blind $0.25
CvMCvMCvM: posts big blind $0.50
*** HOLE CARDS ***
Dealt to matiko09 [3d 4s]
lumen21: folds 
alemão007: folds 
i L00K great: folds 
GriffinBerg: folds 
ZonTTT: folds 
Ahangama: folds 
matiko09: folds 
dndngod: folds 
Uncalled bet ($0.25) returned to CvMCvMCvM
CvMCvMCvM collected $0.50 from pot
CvMCvMCvM: doesn't show hand 
*** SUMMARY ***
Total pot $0.50 | Rake $0 
Seat 1: lumen21 folded before Flop (didn't bet)
Seat 2: alemão007 folded before Flop (didn't bet)
Seat 3: i L00K great folded before Flop (didn't bet)
Seat 4: GriffinBerg folded before Flop (didn't bet)
Seat 5: ZonTTT folded before Flop (didn't bet)
Seat 6: Ahangama folded before Flop (didn't bet)
Seat 7: matiko09 (button) folded before Flop (didn't bet)
Seat 8: dndngod (small blind) folded before Flop
Seat 9: CvMCvMCvM (big blind) collected ($0.50)





PokerStars Hand #150801210656:  Hold'em No Limit ($1/$2 USD) - 2016/03/23 14:25:33 CET [2016/03/23 9:25:33 ET]
Table 'Herba II' 9-max Seat #6 is the button
Seat 1: matiko09 ($212.06 in chips) 
Seat 2: Moszes360 ($227.17 in chips) 
Seat 3: Cirilico ($186.84 in chips) 
Seat 4: DUkalisUA ($301.90 in chips) 
Seat 5: chippo boy ($203.83 in chips) 
Seat 6: Too-Anti-To ($212.46 in chips) 
Seat 7: InsomniaRU ($201 in chips) 
Seat 9: mrhighryza ($62.67 in chips) 
InsomniaRU: posts small blind $1
mrhighryza: posts big blind $2
*** HOLE CARDS ***
Dealt to matiko09 [Ac 2h]
matiko09: folds 
Moszes360: folds 
Cirilico: folds 
DUkalisUA: folds 
chippo boy: folds 
Too-Anti-To: folds 
InsomniaRU: raises $3 to $5
mrhighryza: folds 
Uncalled bet ($3) returned to InsomniaRU
InsomniaRU collected $4 from pot
InsomniaRU: doesn't show hand 
*** SUMMARY ***
Total pot $4 | Rake $0 
Seat 1: matiko09 folded before Flop (didn't bet)
Seat 2: Moszes360 folded before Flop (didn't bet)
Seat 3: Cirilico folded before Flop (didn't bet)
Seat 4: DUkalisUA folded before Flop (didn't bet)
Seat 5: chippo boy folded before Flop (didn't bet)
Seat 6: Too-Anti-To (button) folded before Flop (didn't bet)
Seat 7: InsomniaRU (small blind) collected ($4)
Seat 9: mrhighryza (big blind) folded before Flop





PokerStars Hand #150801216988:  Hold'em No Limit ($1/$2 USD) - 2016/03/23 14:25:43 CET [2016/03/23 9:25:43 ET]
Table 'Achaia' 9-max Seat #4 is the button
Seat 2: InsomniaRU ($220.66 in chips) 
Seat 3: matiko09 ($200 in chips) 
Seat 4: nailz83 ($215.66 in chips) 
Seat 6: nickreason17 ($210.30 in chips) 
Seat 7: morosun ($166.22 in chips) 
Seat 8: $-Twackle-$ ($231.65 in chips) 
Seat 9: glanza_mike ($207.28 in chips) 
nickreason17: posts small blind $1
morosun: posts big blind $2
Moszes360: sits out 
*** HOLE CARDS ***
Dealt to matiko09 [7h 9c]
$-Twackle-$: folds 
glanza_mike: folds 
InsomniaRU: folds 
matiko09: folds 
nailz83: folds 
nickreason17: folds 
Uncalled bet ($1) returned to morosun
morosun collected $2 from pot
*** SUMMARY ***
Total pot $2 | Rake $0 
Seat 2: InsomniaRU folded before Flop (didn't bet)
Seat 3: matiko09 folded before Flop (didn't bet)
Seat 4: nailz83 (button) folded before Flop (didn't bet)
Seat 6: nickreason17 (small blind) folded before Flop
Seat 7: morosun (big blind) collected ($2)
Seat 8: $-Twackle-$ folded before Flop (didn't bet)
Seat 9: glanza_mike folded before Flop (didn't bet)





PokerStars Hand #150801218642:  Hold'em No Limit ($1/$2 USD) - 2016/03/23 14:25:46 CET [2016/03/23 9:25:46 ET]
Table 'Ennomos II' 9-max Seat #1 is the button
Seat 1: ilaviiitech ($200 in chips) 
Seat 2: Subam ($423.18 in chips) 
Seat 3: $-Twackle-$ ($231.20 in chips) 
Seat 4: glanza_mike ($200 in chips) 
Seat 5: South011 ($384.88 in chips) 
Seat 6: nickreason17 ($246.98 in chips) 
Seat 7: daniferdoser ($200 in chips) 
Seat 8: yyfk ($207.24 in chips) 
Seat 9: matiko09 ($200 in chips) 
Subam: posts small blind $1
$-Twackle-$: posts big blind $2
*** HOLE CARDS ***
Dealt to matiko09 [Kd 5s]
glanza_mike: folds 
South011: folds 
nickreason17: folds 
daniferdoser: folds 
yyfk: folds 
matiko09: folds 
ilaviiitech: folds 
Subam: folds 
Uncalled bet ($1) returned to $-Twackle-$
$-Twackle-$ collected $2 from pot
$-Twackle-$: doesn't show hand 
*** SUMMARY ***
Total pot $2 | Rake $0 
Seat 1: ilaviiitech (button) folded before Flop (didn't bet)
Seat 2: Subam (small blind) folded before Flop
Seat 3: $-Twackle-$ (big blind) collected ($2)
Seat 4: glanza_mike folded before Flop (didn't bet)
Seat 5: South011 folded before Flop (didn't bet)
Seat 6: nickreason17 folded before Flop (didn't bet)
Seat 7: daniferdoser folded before Flop (didn't bet)
Seat 8: yyfk folded before Flop (didn't bet)
Seat 9: matiko09 folded before Flop (didn't bet)





PokerStars Hand #150801220661:  Hold'em No Limit (€0.50/€1.00 EUR) - 2016/03/23 14:25:49 CET [2016/03/23 9:25:49 ET]
Table 'Lanzia' 9-max Seat #8 is the button
Seat 1: fk154 (€43.75 in chips) 
Seat 2: ardo888 (€101.50 in chips) 
Seat 3: Effort92 (€196.81 in chips) 
Seat 4: niong62 (€79.38 in chips) 
Seat 5: matiko09 (€100 in chips) 
Seat 6: Red4erT (€40 in chips) 
Seat 7: $-Twackle-$ (€118.72 in chips) 
Seat 8: Muinmyheart (€102 in chips) 
Seat 9: Butcher1848 (€104.37 in chips) 
Butcher1848: posts small blind €0.50
fk154: posts big blind €1
*** HOLE CARDS ***
Dealt to matiko09 [Ks 3d]
ardo888: folds 
Effort92: folds 
niong62: calls €1
matiko09: folds 
Red4erT: folds 
$-Twackle-$: raises €2.50 to €3.50
Muinmyheart: folds 
Butcher1848: folds 
fk154: calls €2.50
niong62: calls €2.50
*** FLOP *** [8h 2d 5h]
fk154: checks 
niong62: checks 
$-Twackle-$: bets €7
fk154: calls €7
niong62: folds 
*** TURN *** [8h 2d 5h] [4h]
fk154: checks 
$-Twackle-$: checks 
*** RIVER *** [8h 2d 5h 4h] [2h]
fk154: bets €1
$-Twackle-$: calls €1
*** SHOW DOWN ***
fk154: shows [As Qd] (a pair of Deuces)
$-Twackle-$: shows [Tc 8c] (two pair, Eights and Deuces)
$-Twackle-$ collected €25.78 from pot
*** SUMMARY ***
Total pot €27 | Rake €1.22 
Board [8h 2d 5h 4h 2h]
Seat 1: fk154 (big blind) showed [As Qd] and lost with a pair of Deuces
Seat 2: ardo888 folded before Flop (didn't bet)
Seat 3: Effort92 folded before Flop (didn't bet)
Seat 4: niong62 folded on the Flop
Seat 5: matiko09 folded before Flop (didn't bet)
Seat 6: Red4erT folded before Flop (didn't bet)
Seat 7: $-Twackle-$ showed [Tc 8c] and won (€25.78) with two pair, Eights and Deuces
Seat 8: Muinmyheart (button) folded before Flop (didn't bet)
Seat 9: Butcher1848 (small blind) folded before Flop





PokerStars Hand #150801223758:  Hold'em No Limit ($1/$2 USD) - 2016/03/23 14:25:54 CET [2016/03/23 9:25:54 ET]
Table 'Deipylos II' 9-max Seat #6 is the button
Seat 1: $-Twackle-$ ($200 in chips) 
Seat 2: T0ny Adams ($88.32 in chips) 
Seat 4: matiko09 ($200 in chips) 
Seat 5: InsomniaRU ($225.88 in chips) 
Seat 6: nickreason17 ($200 in chips) 
Seat 7: volwebni4ek ($92.70 in chips) 
Seat 8: Igoriah ($282.20 in chips) 
Seat 9: Ranatuo84 ($248.62 in chips) 
volwebni4ek: posts small blind $1
Igoriah: posts big blind $2
DUkalisUA: sits out 
*** HOLE CARDS ***
Dealt to matiko09 [2c 3c]
Ranatuo84: folds 
$-Twackle-$: folds 
T0ny Adams: raises $3 to $5
matiko09: folds 
InsomniaRU: folds 
nickreason17: folds 
volwebni4ek: folds 
Igoriah: folds 
Uncalled bet ($3) returned to T0ny Adams
T0ny Adams collected $5 from pot
T0ny Adams: doesn't show hand 
*** SUMMARY ***
Total pot $5 | Rake $0 
Seat 1: $-Twackle-$ folded before Flop (didn't bet)
Seat 2: T0ny Adams collected ($5)
Seat 4: matiko09 folded before Flop (didn't bet)
Seat 5: InsomniaRU folded before Flop (didn't bet)
Seat 6: nickreason17 (button) folded before Flop (didn't bet)
Seat 7: volwebni4ek (small blind) folded before Flop
Seat 8: Igoriah (big blind) folded before Flop
Seat 9: Ranatuo84 folded before Flop (didn't bet)





PokerStars Hand #150801225275:  Hold'em No Limit ($0.50/$1.00 USD) - 2016/03/23 14:25:57 CET [2016/03/23 9:25:57 ET]
Table 'Kippes' 9-max Seat #4 is the button
Seat 1: Pvsx. ($118.68 in chips) 
Seat 3: CAJUN890 ($128 in chips) 
Seat 4: matiko09 ($100 in chips) 
Seat 5: Jimy Tiltman ($137.72 in chips) 
Seat 6: DUkalisUA ($113.36 in chips) 
Seat 7: lumen21 ($101.50 in chips) 
Seat 8: Sherlockplay ($100 in chips) 
Seat 9: wang19790906 ($92.78 in chips) 
Jimy Tiltman: posts small blind $0.50
DUkalisUA: posts big blind $1
*** HOLE CARDS ***
Dealt to matiko09 [Td 2c]
lumen21: folds 
Sherlockplay: folds 
wang19790906: folds 
Pvsx.: folds 
CAJUN890: folds 
matiko09: folds 
Jimy Tiltman: raises $2 to $3
DUkalisUA: folds 
Uncalled bet ($2) returned to Jimy Tiltman
Jimy Tiltman collected $2 from pot
Jimy Tiltman: doesn't show hand 
*** SUMMARY ***
Total pot $2 | Rake $0 
Seat 1: Pvsx. folded before Flop (didn't bet)
Seat 3: CAJUN890 folded before Flop (didn't bet)
Seat 4: matiko09 (button) folded before Flop (didn't bet)
Seat 5: Jimy Tiltman (small blind) collected ($2)
Seat 6: DUkalisUA (big blind) folded before Flop
Seat 7: lumen21 folded before Flop (didn't bet)
Seat 8: Sherlockplay folded before Flop (didn't bet)
Seat 9: wang19790906 folded before Flop (didn't bet)





PokerStars Hand #150801229105:  Hold'em No Limit ($1/$2 USD) - 2016/03/23 14:26:03 CET [2016/03/23 9:26:03 ET]
Table 'Achaia' 9-max Seat #6 is the button
Seat 2: InsomniaRU ($220.66 in chips) 
Seat 3: matiko09 ($200 in chips) 
Seat 4: nailz83 ($215.66 in chips) 
Seat 6: nickreason17 ($209.30 in chips) 
Seat 7: morosun ($167.22 in chips) 
Seat 8: $-Twackle-$ ($231.65 in chips) 
Seat 9: glanza_mike ($207.28 in chips) 
morosun: posts small blind $1
$-Twackle-$: posts big blind $2
Moszes360: sits out 
*** HOLE CARDS ***
Dealt to matiko09 [9d 3h]
glanza_mike: folds 
InsomniaRU: folds 
matiko09: folds 
Red4erT joins the table at seat #5 
nailz83: folds 
nickreason17: folds 
morosun: folds 
Uncalled bet ($1) returned to $-Twackle-$
$-Twackle-$ collected $2 from pot
$-Twackle-$: doesn't show hand 
*** SUMMARY ***
Total pot $2 | Rake $0 
Seat 2: InsomniaRU folded before Flop (didn't bet)
Seat 3: matiko09 folded before Flop (didn't bet)
Seat 4: nailz83 folded before Flop (didn't bet)
Seat 6: nickreason17 (button) folded before Flop (didn't bet)
Seat 7: morosun (small blind) folded before Flop
Seat 8: $-Twackle-$ (big blind) collected ($2)
Seat 9: glanza_mike folded before Flop (didn't bet)





PokerStars Hand #150801228854:  Hold'em No Limit ($0.25/$0.50 USD) - 2016/03/23 14:26:03 CET [2016/03/23 9:26:03 ET]
Table 'Pyrrhus' 9-max Seat #8 is the button
Seat 2: alemão007 ($47 in chips) 
Seat 3: i L00K great ($50 in chips) 
Seat 4: GriffinBerg ($34.34 in chips) 
Seat 5: ZonTTT ($55.86 in chips) 
Seat 6: Ahangama ($50 in chips) 
Seat 7: matiko09 ($137.63 in chips) 
Seat 8: dndngod ($76.73 in chips) 
Seat 9: CvMCvMCvM ($98.63 in chips) 
CvMCvMCvM: posts small blind $0.25
alemão007: posts big blind $0.50
*** HOLE CARDS ***
Dealt to matiko09 [9d Kd]
i L00K great: folds 
GriffinBerg: folds 
ZonTTT: folds 
Ahangama: folds 
matiko09: raises $1 to $1.50
dndngod: folds 
CvMCvMCvM: folds 
alemão007: folds 
Uncalled bet ($1) returned to matiko09
matiko09 collected $1.25 from pot
matiko09: doesn't show hand 
*** SUMMARY ***
Total pot $1.25 | Rake $0 
Seat 2: alemão007 (big blind) folded before Flop
Seat 3: i L00K great folded before Flop (didn't bet)
Seat 4: GriffinBerg folded before Flop (didn't bet)
Seat 5: ZonTTT folded before Flop (didn't bet)
Seat 6: Ahangama folded before Flop (didn't bet)
Seat 7: matiko09 collected ($1.25)
Seat 8: dndngod (button) folded before Flop (didn't bet)
Seat 9: CvMCvMCvM (small blind) folded before Flop





PokerStars Hand #150801230040:  Hold'em No Limit ($1/$2 USD) - 2016/03/23 14:26:04 CET [2016/03/23 9:26:04 ET]
Table 'Kiess' 9-max Seat #2 is the button
Seat 1: Cirilico ($229.74 in chips) 
Seat 2: DUkalisUA ($671.10 in chips) 
Seat 4: Moszes360 ($200 in chips) 
Seat 5: chippo boy ($454.96 in chips) 
Seat 6: matiko09 ($261.96 in chips) 
Seat 7: InsomniaRU ($306.39 in chips) 
Seat 8: erfk1958 ($105.55 in chips) 
Seat 9: T0ny Adams ($77 in chips) 
Moszes360: posts small blind $1
chippo boy: posts big blind $2
*** HOLE CARDS ***
Dealt to matiko09 [Tc Ac]
matiko09: raises $3 to $5
InsomniaRU: folds 
erfk1958: folds 
T0ny Adams: folds 
Cirilico: folds 
DUkalisUA: folds 
Moszes360: calls $4
chippo boy: calls $3
*** FLOP *** [8c 4d Kc]
Moszes360: bets $12.17
chippo boy: folds 
matiko09: raises $19.83 to $32
Moszes360: folds 
Uncalled bet ($19.83) returned to matiko09
matiko09 collected $37.57 from pot
matiko09: doesn't show hand 
*** SUMMARY ***
Total pot $39.34 | Rake $1.77 
Board [8c 4d Kc]
Seat 1: Cirilico folded before Flop (didn't bet)
Seat 2: DUkalisUA (button) folded before Flop (didn't bet)
Seat 4: Moszes360 (small blind) folded on the Flop
Seat 5: chippo boy (big blind) folded on the Flop
Seat 6: matiko09 collected ($37.57)
Seat 7: InsomniaRU folded before Flop (didn't bet)
Seat 8: erfk1958 folded before Flop (didn't bet)
Seat 9: T0ny Adams folded before Flop (didn't bet)





PokerStars Hand #150801230259:  Hold'em No Limit ($1/$2 USD) - 2016/03/23 14:26:05 CET [2016/03/23 9:26:05 ET]
Table 'Kypria II' 9-max Seat #8 is the button
Seat 1: geldwolfje ($170 in chips) 
Seat 2: coinflip_si ($219.70 in chips) 
Seat 3: seouljam ($138.62 in chips) 
Seat 4: VolanDog ($203 in chips) 
Seat 5: InsomniaRU ($379.88 in chips) 
Seat 6: matiko09 ($370.95 in chips) 
Seat 7: DUkalisUA ($200 in chips) 
Seat 8: Pearl Jam87 ($200 in chips) 
Seat 9: Moszes360 ($200 in chips) 
Moszes360: posts small blind $1
geldwolfje: posts big blind $2
*** HOLE CARDS ***
Dealt to matiko09 [Ac 2d]
coinflip_si: folds 
seouljam: raises $2.80 to $4.80
VolanDog: folds 
InsomniaRU: folds 
matiko09: folds 
DUkalisUA: folds 
Pearl Jam87: folds 
Moszes360: folds 
geldwolfje: calls $2.80
*** FLOP *** [9s Ad 4s]
geldwolfje: checks 
seouljam: checks 
*** TURN *** [9s Ad 4s] [Kh]
geldwolfje: checks 
seouljam: checks 
*** RIVER *** [9s Ad 4s Kh] [8s]
geldwolfje: checks 
seouljam: checks 
*** SHOW DOWN ***
geldwolfje: shows [Qh 7h] (high card Ace)
seouljam: shows [4c Qc] (a pair of Fours)
seouljam collected $10.12 from pot
*** SUMMARY ***
Total pot $10.60 | Rake $0.48 
Board [9s Ad 4s Kh 8s]
Seat 1: geldwolfje (big blind) showed [Qh 7h] and lost with high card Ace
Seat 2: coinflip_si folded before Flop (didn't bet)
Seat 3: seouljam showed [4c Qc] and won ($10.12) with a pair of Fours
Seat 4: VolanDog folded before Flop (didn't bet)
Seat 5: InsomniaRU folded before Flop (didn't bet)
Seat 6: matiko09 folded before Flop (didn't bet)
Seat 7: DUkalisUA folded before Flop (didn't bet)
Seat 8: Pearl Jam87 (button) folded before Flop (didn't bet)
Seat 9: Moszes360 (small blind) folded before Flop





PokerStars Hand #150801230379:  Hold'em No Limit ($0.50/$1.00 USD) - 2016/03/23 14:26:05 CET [2016/03/23 9:26:05 ET]
Table 'Donar II' 9-max Seat #4 is the button
Seat 1: Effort92 ($103.42 in chips) 
Seat 2: nobrunobru1 ($54.84 in chips) 
Seat 3: st-germ30 ($96.99 in chips) 
Seat 4: DUkalisUA ($146.49 in chips) 
Seat 5: matiko09 ($100 in chips) 
Seat 6: ardo888 ($135.28 in chips) 
Seat 7: JimineyCrik ($95.25 in chips) 
Seat 8: $-Twackle-$ ($112.95 in chips) 
Seat 9: oxfordtenzin ($125.20 in chips) 
matiko09: posts small blind $0.50
ardo888: posts big blind $1
Effort92: posts the ante $0.20
nobrunobru1: posts the ante $0.20
st-germ30: posts the ante $0.20
DUkalisUA: posts the ante $0.20
matiko09: posts the ante $0.20
ardo888: posts the ante $0.20
JimineyCrik: posts the ante $0.20
$-Twackle-$: posts the ante $0.20
oxfordtenzin: posts the ante $0.20
*** HOLE CARDS ***
Dealt to matiko09 [Qc 4h]
JimineyCrik: folds 
$-Twackle-$: folds 
oxfordtenzin: folds 
Effort92: folds 
nobrunobru1: folds 
st-germ30: raises $2 to $3
DUkalisUA: folds 
matiko09: folds 
ardo888: folds 
Uncalled bet ($2) returned to st-germ30
st-germ30 collected $4.30 from pot
*** SUMMARY ***
Total pot $4.30 | Rake $0 
Seat 1: Effort92 folded before Flop (didn't bet)
Seat 2: nobrunobru1 folded before Flop (didn't bet)
Seat 3: st-germ30 collected ($4.30)
Seat 4: DUkalisUA (button) folded before Flop (didn't bet)
Seat 5: matiko09 (small blind) folded before Flop
Seat 6: ardo888 (big blind) folded before Flop
Seat 7: JimineyCrik folded before Flop (didn't bet)
Seat 8: $-Twackle-$ folded before Flop (didn't bet)
Seat 9: oxfordtenzin folded before Flop (didn't bet)





PokerStars Hand #150801232650:  Hold'em No Limit ($1/$2 USD) - 2016/03/23 14:26:09 CET [2016/03/23 9:26:09 ET]
Table 'Herba II' 9-max Seat #7 is the button
Seat 1: matiko09 ($212.06 in chips) 
Seat 2: Moszes360 ($227.17 in chips) 
Seat 3: Cirilico ($186.84 in chips) 
Seat 4: DUkalisUA ($301.90 in chips) 
Seat 5: chippo boy ($203.83 in chips) 
Seat 6: Too-Anti-To ($212.46 in chips) 
Seat 7: InsomniaRU ($203 in chips) 
Seat 9: mrhighryza ($60.67 in chips) 
mrhighryza: posts small blind $1
matiko09: posts big blind $2
*** HOLE CARDS ***
Dealt to matiko09 [Td 7s]
Moszes360: folds 
Cirilico: folds 
DUkalisUA: raises $4 to $6
chippo boy: folds 
Too-Anti-To: folds 
InsomniaRU: raises $12 to $18
mrhighryza: folds 
matiko09: folds 
DUkalisUA: calls $12
*** FLOP *** [3c 4s 4h]
DUkalisUA: checks 
InsomniaRU: bets $21.60
DUkalisUA: calls $21.60
*** TURN *** [3c 4s 4h] [As]
DUkalisUA: checks 
InsomniaRU: bets $46.05
DUkalisUA: calls $46.05
*** RIVER *** [3c 4s 4h As] [5d]
DUkalisUA: checks 
InsomniaRU: bets $117.35 and is all-in
DUkalisUA: calls $117.35
*** SHOW DOWN ***
InsomniaRU: shows [Ah Ad] (a full house, Aces full of Fours)
DUkalisUA: mucks hand 
InsomniaRU collected $406.20 from pot
*** SUMMARY ***
Total pot $409 | Rake $2.80 
Board [3c 4s 4h As 5d]
Seat 1: matiko09 (big blind) folded before Flop
Seat 2: Moszes360 folded before Flop (didn't bet)
Seat 3: Cirilico folded before Flop (didn't bet)
Seat 4: DUkalisUA mucked [9c 9s]
Seat 5: chippo boy folded before Flop (didn't bet)
Seat 6: Too-Anti-To folded before Flop (didn't bet)
Seat 7: InsomniaRU (button) showed [Ah Ad] and won ($406.20) with a full house, Aces full of Fours
Seat 9: mrhighryza (small blind) folded before Flop





PokerStars Hand #150801232570:  Hold'em No Limit ($0.50/$1.00 USD) - 2016/03/23 14:26:09 CET [2016/03/23 9:26:09 ET]
Table 'Merope II' 9-max Seat #5 is the button
Seat 1: Jimy Tiltman ($136.36 in chips) 
Seat 2: $-Twackle-$ ($100 in chips) 
Seat 3: pablos1922 ($92.25 in chips) 
Seat 4: YuriiSolodya ($85.84 in chips) 
Seat 5: DUkalisUA ($156.87 in chips) 
Seat 6: Effort92 ($100 in chips) 
Seat 7: matiko09 ($109.23 in chips) 
Seat 8: titentei ($90.50 in chips) 
Effort92: posts small blind $0.50
matiko09: posts big blind $1
*** HOLE CARDS ***
Dealt to matiko09 [Qd 3c]
titentei: folds 
Jimy Tiltman: folds 
$-Twackle-$: folds 
pablos1922: folds 
YuriiSolodya: folds 
DUkalisUA: raises $2 to $3
Effort92: folds 
matiko09: folds 
Uncalled bet ($2) returned to DUkalisUA
DUkalisUA collected $2.50 from pot
DUkalisUA: doesn't show hand 
*** SUMMARY ***
Total pot $2.50 | Rake $0 
Seat 1: Jimy Tiltman folded before Flop (didn't bet)
Seat 2: $-Twackle-$ folded before Flop (didn't bet)
Seat 3: pablos1922 folded before Flop (didn't bet)
Seat 4: YuriiSolodya folded before Flop (didn't bet)
Seat 5: DUkalisUA (button) collected ($2.50)
Seat 6: Effort92 (small blind) folded before Flop
Seat 7: matiko09 (big blind) folded before Flop
Seat 8: titentei folded before Flop (didn't bet)





PokerStars Hand #150801235188:  Hold'em No Limit ($0.50/$1.00 USD) - 2016/03/23 14:26:13 CET [2016/03/23 9:26:13 ET]
Table 'Kippes' 9-max Seat #5 is the button
Seat 1: Pvsx. ($118.68 in chips) 
Seat 3: CAJUN890 ($128 in chips) 
Seat 4: matiko09 ($100 in chips) 
Seat 5: Jimy Tiltman ($138.72 in chips) 
Seat 6: DUkalisUA ($112.36 in chips) 
Seat 8: Sherlockplay ($100 in chips) 
Seat 9: wang19790906 ($92.78 in chips) 
DUkalisUA: posts small blind $0.50
Sherlockplay: posts big blind $1
*** HOLE CARDS ***
Dealt to matiko09 [8h 7d]
wang19790906: folds 
Pvsx.: folds 
CAJUN890: folds 
matiko09: folds 
Jimy Tiltman: raises $1 to $2
DUkalisUA: folds 
Sherlockplay: folds 
Uncalled bet ($1) returned to Jimy Tiltman
Jimy Tiltman collected $2.50 from pot
Jimy Tiltman: doesn't show hand 
*** SUMMARY ***
Total pot $2.50 | Rake $0 
Seat 1: Pvsx. folded before Flop (didn't bet)
Seat 3: CAJUN890 folded before Flop (didn't bet)
Seat 4: matiko09 folded before Flop (didn't bet)
Seat 5: Jimy Tiltman (button) collected ($2.50)
Seat 6: DUkalisUA (small blind) folded before Flop
Seat 8: Sherlockplay (big blind) folded before Flop
Seat 9: wang19790906 folded before Flop (didn't bet)





PokerStars Hand #150801242363:  Hold'em No Limit ($1/$2 USD) - 2016/03/23 14:26:25 CET [2016/03/23 9:26:25 ET]
Table 'Achaia' 9-max Seat #7 is the button
Seat 2: InsomniaRU ($220.66 in chips) 
Seat 3: matiko09 ($200 in chips) 
Seat 4: nailz83 ($215.66 in chips) 
Seat 6: nickreason17 ($209.30 in chips) 
Seat 7: morosun ($166.22 in chips) 
Seat 8: $-Twackle-$ ($232.65 in chips) 
Seat 9: glanza_mike ($207.28 in chips) 
$-Twackle-$: posts small blind $1
glanza_mike: posts big blind $2
Moszes360: sits out 
Red4erT: sits out 
*** HOLE CARDS ***
Dealt to matiko09 [5d 4c]
InsomniaRU: folds 
matiko09: folds 
nailz83: raises $2.50 to $4.50
nickreason17: folds 
morosun: calls $4.50
$-Twackle-$: folds 
glanza_mike: folds 
*** FLOP *** [5c Kd 8c]
nailz83: bets $8
morosun: calls $8
*** TURN *** [5c Kd 8c] [As]
nailz83: bets $14
morosun: calls $14
*** RIVER *** [5c Kd 8c As] [Tc]
nailz83: checks 
Red4erT leaves the table
morosun: checks 
*** SHOW DOWN ***
nailz83: shows [2s 2h] (a pair of Deuces)
morosun: shows [8s Qd] (a pair of Eights)
morosun collected $53.48 from pot
*** SUMMARY ***
Total pot $56 | Rake $2.52 
Board [5c Kd 8c As Tc]
Seat 2: InsomniaRU folded before Flop (didn't bet)
Seat 3: matiko09 folded before Flop (didn't bet)
Seat 4: nailz83 showed [2s 2h] and lost with a pair of Deuces
Seat 6: nickreason17 folded before Flop (didn't bet)
Seat 7: morosun (button) showed [8s Qd] and won ($53.48) with a pair of Eights
Seat 8: $-Twackle-$ (small blind) folded before Flop
Seat 9: glanza_mike (big blind) folded before Flop





PokerStars Hand #150801244256:  Hold'em No Limit ($1/$2 USD) - 2016/03/23 14:26:28 CET [2016/03/23 9:26:28 ET]
Table 'Ennomos II' 9-max Seat #2 is the button
Seat 1: ilaviiitech ($200 in chips) 
Seat 2: Subam ($422.18 in chips) 
Seat 3: $-Twackle-$ ($232.20 in chips) 
Seat 4: glanza_mike ($200 in chips) 
Seat 5: South011 ($384.88 in chips) 
Seat 6: nickreason17 ($246.98 in chips) 
Seat 7: daniferdoser ($200 in chips) 
Seat 8: yyfk ($207.24 in chips) 
Seat 9: matiko09 ($200 in chips) 
$-Twackle-$: posts small blind $1
glanza_mike: posts big blind $2
*** HOLE CARDS ***
Dealt to matiko09 [5s Jc]
South011: folds 
nickreason17: raises $4 to $6
daniferdoser: folds 
yyfk: folds 
matiko09: folds 
ilaviiitech: folds 
Subam: calls $6
$-Twackle-$: folds 
glanza_mike: folds 
*** FLOP *** [2d 6d Ad]
nickreason17: checks 
Subam: checks 
*** TURN *** [2d 6d Ad] [7d]
nickreason17: checks 
Subam: checks 
*** RIVER *** [2d 6d Ad 7d] [Th]
nickreason17: bets $10
Subam: calls $10
*** SHOW DOWN ***
nickreason17: shows [Kc Jd] (a flush, Ace high)
Subam: mucks hand 
nickreason17 collected $33.42 from pot
*** SUMMARY ***
Total pot $35 | Rake $1.58 
Board [2d 6d Ad 7d Th]
Seat 1: ilaviiitech folded before Flop (didn't bet)
Seat 2: Subam (button) mucked [Ac Tc]
Seat 3: $-Twackle-$ (small blind) folded before Flop
Seat 4: glanza_mike (big blind) folded before Flop
Seat 5: South011 folded before Flop (didn't bet)
Seat 6: nickreason17 showed [Kc Jd] and won ($33.42) with a flush, Ace high
Seat 7: daniferdoser folded before Flop (didn't bet)
Seat 8: yyfk folded before Flop (didn't bet)
Seat 9: matiko09 folded before Flop (didn't bet)





PokerStars Hand #150801245152:  Hold'em No Limit ($0.25/$0.50 USD) - 2016/03/23 14:26:29 CET [2016/03/23 9:26:29 ET]
Table 'Pyrrhus' 9-max Seat #9 is the button
Seat 2: alemão007 ($46.50 in chips) 
Seat 3: i L00K great ($50 in chips) 
Seat 4: GriffinBerg ($34.34 in chips) 
Seat 5: ZonTTT ($55.86 in chips) 
Seat 6: Ahangama ($50 in chips) 
Seat 7: matiko09 ($138.38 in chips) 
Seat 8: dndngod ($76.73 in chips) 
Seat 9: CvMCvMCvM ($98.38 in chips) 
alemão007: posts small blind $0.25
i L00K great: posts big blind $0.50
*** HOLE CARDS ***
Dealt to matiko09 [5c Qc]
GriffinBerg: folds 
ZonTTT: folds 
Ahangama: folds 
matiko09: folds 
dndngod: raises $0.75 to $1.25
CvMCvMCvM: folds 
alemão007: folds 
i L00K great: folds 
Uncalled bet ($0.75) returned to dndngod
dndngod collected $1.25 from pot
dndngod: doesn't show hand 
*** SUMMARY ***
Total pot $1.25 | Rake $0 
Seat 2: alemão007 (small blind) folded before Flop
Seat 3: i L00K great (big blind) folded before Flop
Seat 4: GriffinBerg folded before Flop (didn't bet)
Seat 5: ZonTTT folded before Flop (didn't bet)
Seat 6: Ahangama folded before Flop (didn't bet)
Seat 7: matiko09 folded before Flop (didn't bet)
Seat 8: dndngod collected ($1.25)
Seat 9: CvMCvMCvM (button) folded before Flop (didn't bet)





PokerStars Hand #150801246452:  Hold'em No Limit ($0.50/$1.00 USD) - 2016/03/23 14:26:31 CET [2016/03/23 9:26:31 ET]
Table 'Merope II' 9-max Seat #6 is the button
Seat 1: Jimy Tiltman ($136.36 in chips) 
Seat 2: $-Twackle-$ ($100 in chips) 
Seat 3: pablos1922 ($92.25 in chips) 
Seat 4: YuriiSolodya ($85.84 in chips) 
Seat 5: DUkalisUA ($158.37 in chips) 
Seat 6: Effort92 ($100 in chips) 
Seat 7: matiko09 ($108.23 in chips) 
Seat 8: titentei ($90.50 in chips) 
matiko09: posts small blind $0.50
titentei: posts big blind $1
*** HOLE CARDS ***
Dealt to matiko09 [8s 2c]
Jimy Tiltman: folds 
$-Twackle-$: folds 
pablos1922: folds 
YuriiSolodya: raises $2 to $3
DUkalisUA: folds 
Effort92: folds 
matiko09: folds 
titentei: folds 
Uncalled bet ($2) returned to YuriiSolodya
YuriiSolodya collected $2.50 from pot
YuriiSolodya: doesn't show hand 
*** SUMMARY ***
Total pot $2.50 | Rake $0 
Seat 1: Jimy Tiltman folded before Flop (didn't bet)
Seat 2: $-Twackle-$ folded before Flop (didn't bet)
Seat 3: pablos1922 folded before Flop (didn't bet)
Seat 4: YuriiSolodya collected ($2.50)
Seat 5: DUkalisUA folded before Flop (didn't bet)
Seat 6: Effort92 (button) folded before Flop (didn't bet)
Seat 7: matiko09 (small blind) folded before Flop
Seat 8: titentei (big blind) folded before Flop





PokerStars Hand #150801248218:  Hold'em No Limit ($0.50/$1.00 USD) - 2016/03/23 14:26:34 CET [2016/03/23 9:26:34 ET]
Table 'Atlantis' 9-max Seat #1 is the button
Seat 1: xHourglass ($153 in chips) 
Seat 2: tffff2006 ($68.72 in chips) 
Seat 3: CAJUN890 ($104.29 in chips) 
Seat 4: matiko09 ($133.25 in chips) 
Seat 5: Pvsx. ($104.25 in chips) 
Seat 6: Jimy Tiltman ($101.78 in chips) 
Seat 7: Sherlockplay ($134.77 in chips) 
Seat 8: DUkalisUA ($101 in chips) 
tffff2006: posts small blind $0.50
CAJUN890: posts big blind $1
*** HOLE CARDS ***
Dealt to matiko09 [5c 3h]
matiko09: folds 
Pvsx.: folds 
Jimy Tiltman: folds 
Sherlockplay: folds 
DUkalisUA: raises $1.50 to $2.50
xHourglass: folds 
tffff2006: folds 
CAJUN890: folds 
Uncalled bet ($1.50) returned to DUkalisUA
DUkalisUA collected $2.50 from pot
DUkalisUA: doesn't show hand 
*** SUMMARY ***
Total pot $2.50 | Rake $0 
Seat 1: xHourglass (button) folded before Flop (didn't bet)
Seat 2: tffff2006 (small blind) folded before Flop
Seat 3: CAJUN890 (big blind) folded before Flop
Seat 4: matiko09 folded before Flop (didn't bet)
Seat 5: Pvsx. folded before Flop (didn't bet)
Seat 6: Jimy Tiltman folded before Flop (didn't bet)
Seat 7: Sherlockplay folded before Flop (didn't bet)
Seat 8: DUkalisUA collected ($2.50)





PokerStars Hand #150801247837:  Hold'em No Limit ($0.50/$1.00 USD) - 2016/03/23 14:26:34 CET [2016/03/23 9:26:34 ET]
Table 'Swings' 9-max Seat #7 is the button
Seat 1: Sherlockplay ($100 in chips) 
Seat 2: Harbinger X ($80 in chips) 
Seat 4: chaps1988 ($100 in chips) 
Seat 5: chautinhtri9 ($101.50 in chips) 
Seat 6: matiko09 ($100 in chips) 
Seat 7: nickreason17 ($100 in chips) 
Seat 9: Vlad_1965_77 ($100 in chips) 
Vlad_1965_77: posts small blind $0.50
Sherlockplay: posts big blind $1
maxxmeister: sits out 
*** HOLE CARDS ***
Dealt to matiko09 [4d Kd]
Harbinger X: folds 
chaps1988: folds 
chautinhtri9: folds 
matiko09: folds 
nickreason17: folds 
Vlad_1965_77: raises $2 to $3
Sherlockplay: folds 
Uncalled bet ($2) returned to Vlad_1965_77
Vlad_1965_77 collected $2 from pot
*** SUMMARY ***
Total pot $2 | Rake $0 
Seat 1: Sherlockplay (big blind) folded before Flop
Seat 2: Harbinger X folded before Flop (didn't bet)
Seat 4: chaps1988 folded before Flop (didn't bet)
Seat 5: chautinhtri9 folded before Flop (didn't bet)
Seat 6: matiko09 folded before Flop (didn't bet)
Seat 7: nickreason17 (button) folded before Flop (didn't bet)
Seat 9: Vlad_1965_77 (small blind) collected ($2)





PokerStars Hand #150801254167:  Hold'em No Limit ($1/$2 USD) - 2016/03/23 14:26:44 CET [2016/03/23 9:26:44 ET]
Table 'Deipylos II' 9-max Seat #7 is the button
Seat 1: $-Twackle-$ ($200 in chips) 
Seat 2: T0ny Adams ($91.32 in chips) 
Seat 4: matiko09 ($200 in chips) 
Seat 5: InsomniaRU ($225.88 in chips) 
Seat 6: nickreason17 ($200 in chips) 
Seat 7: volwebni4ek ($91.70 in chips) 
Seat 8: Igoriah ($280.20 in chips) 
Seat 9: Ranatuo84 ($248.62 in chips) 
Igoriah: posts small blind $1
Ranatuo84: posts big blind $2
DUkalisUA: sits out 
*** HOLE CARDS ***
Dealt to matiko09 [4s 4h]
$-Twackle-$: raises $4 to $6
T0ny Adams: folds 
matiko09: folds 
InsomniaRU: folds 
nickreason17: folds 
volwebni4ek: folds 
Igoriah: folds 
Ranatuo84: calls $4
*** FLOP *** [8h Kh Kc]
Ranatuo84: checks 
$-Twackle-$: bets $8
Ranatuo84: calls $8
*** TURN *** [8h Kh Kc] [Td]
Ranatuo84: checks 
$-Twackle-$: checks 
*** RIVER *** [8h Kh Kc Td] [5h]
Ranatuo84: checks 
$-Twackle-$: checks 
*** SHOW DOWN ***
Ranatuo84: shows [4d Ah] (a pair of Kings)
$-Twackle-$: shows [Jc Ad] (a pair of Kings - Ace+Jack kicker)
$-Twackle-$ collected $27.70 from pot
*** SUMMARY ***
Total pot $29 | Rake $1.30 
Board [8h Kh Kc Td 5h]
Seat 1: $-Twackle-$ showed [Jc Ad] and won ($27.70) with a pair of Kings
Seat 2: T0ny Adams folded before Flop (didn't bet)
Seat 4: matiko09 folded before Flop (didn't bet)
Seat 5: InsomniaRU folded before Flop (didn't bet)
Seat 6: nickreason17 folded before Flop (didn't bet)
Seat 7: volwebni4ek (button) folded before Flop (didn't bet)
Seat 8: Igoriah (small blind) folded before Flop
Seat 9: Ranatuo84 (big blind) showed [4d Ah] and lost with a pair of Kings





PokerStars Hand #150801259072:  Hold'em No Limit ($1/$2 USD) - 2016/03/23 14:26:52 CET [2016/03/23 9:26:52 ET]
Table 'Kypria II' 9-max Seat #9 is the button
Seat 1: geldwolfje ($165.20 in chips) 
Seat 2: coinflip_si ($219.70 in chips) 
Seat 3: seouljam ($143.94 in chips) 
Seat 4: VolanDog ($203 in chips) 
Seat 5: InsomniaRU ($379.88 in chips) 
Seat 6: matiko09 ($370.95 in chips) 
Seat 7: DUkalisUA ($200 in chips) 
Seat 8: Pearl Jam87 ($200 in chips) 
Seat 9: Moszes360 ($200 in chips) 
geldwolfje: posts small blind $1
coinflip_si: posts big blind $2
*** HOLE CARDS ***
Dealt to matiko09 [6d 9d]
seouljam: calls $2
VolanDog: folds 
InsomniaRU: folds 
matiko09: folds 
DUkalisUA: folds 
Pearl Jam87: folds 
Moszes360: folds 
geldwolfje: calls $1
coinflip_si: checks 
*** FLOP *** [Th 8h Qc]
geldwolfje: checks 
coinflip_si: checks 
seouljam: bets $6
geldwolfje: calls $6
coinflip_si: folds 
*** TURN *** [Th 8h Qc] [4h]
geldwolfje: checks 
seouljam: bets $6
geldwolfje: folds 
Uncalled bet ($6) returned to seouljam
seouljam collected $17.19 from pot
seouljam: doesn't show hand 
*** SUMMARY ***
Total pot $18 | Rake $0.81 
Board [Th 8h Qc 4h]
Seat 1: geldwolfje (small blind) folded on the Turn
Seat 2: coinflip_si (big blind) folded on the Flop
Seat 3: seouljam collected ($17.19)
Seat 4: VolanDog folded before Flop (didn't bet)
Seat 5: InsomniaRU folded before Flop (didn't bet)
Seat 6: matiko09 folded before Flop (didn't bet)
Seat 7: DUkalisUA folded before Flop (didn't bet)
Seat 8: Pearl Jam87 folded before Flop (didn't bet)
Seat 9: Moszes360 (button) folded before Flop (didn't bet)





PokerStars Hand #150801259760:  Hold'em No Limit ($0.50/$1.00 USD) - 2016/03/23 14:26:53 CET [2016/03/23 9:26:53 ET]
Table 'Donar II' 9-max Seat #5 is the button
Seat 1: Effort92 ($103.22 in chips) 
Seat 2: nobrunobru1 ($54.64 in chips) 
Seat 3: st-germ30 ($100.09 in chips) 
Seat 4: DUkalisUA ($146.29 in chips) 
Seat 5: matiko09 ($100 in chips) 
Seat 6: ardo888 ($134.08 in chips) 
Seat 7: JimineyCrik ($95.05 in chips) 
Seat 8: $-Twackle-$ ($112.75 in chips) 
Seat 9: oxfordtenzin ($125 in chips) 
ardo888: posts small blind $0.50
JimineyCrik: posts big blind $1
Effort92: posts the ante $0.20
nobrunobru1: posts the ante $0.20
st-germ30: posts the ante $0.20
DUkalisUA: posts the ante $0.20
matiko09: posts the ante $0.20
ardo888: posts the ante $0.20
JimineyCrik: posts the ante $0.20
$-Twackle-$: posts the ante $0.20
oxfordtenzin: posts the ante $0.20
*** HOLE CARDS ***
Dealt to matiko09 [Ah Th]
$-Twackle-$: folds 
oxfordtenzin: folds 
Effort92: raises $1.50 to $2.50
nobrunobru1: folds 
st-germ30: folds 
DUkalisUA: folds 
matiko09: calls $2.50
ardo888: folds 
JimineyCrik: calls $1.50
*** FLOP *** [8s 6s 7s]
JimineyCrik: checks 
Effort92: checks 
matiko09: checks 
*** TURN *** [8s 6s 7s] [Td]
JimineyCrik: bets $2.43
Effort92: folds 
matiko09: calls $2.43
*** RIVER *** [8s 6s 7s Td] [Ks]
JimineyCrik: bets $3.64
matiko09: folds 
Uncalled bet ($3.64) returned to JimineyCrik
JimineyCrik collected $14 from pot
JimineyCrik: doesn't show hand 
*** SUMMARY ***
Total pot $14.66 | Rake $0.66 
Board [8s 6s 7s Td Ks]
Seat 1: Effort92 folded on the Turn
Seat 2: nobrunobru1 folded before Flop (didn't bet)
Seat 3: st-germ30 folded before Flop (didn't bet)
Seat 4: DUkalisUA folded before Flop (didn't bet)
Seat 5: matiko09 (button) folded on the River
Seat 6: ardo888 (small blind) folded before Flop
Seat 7: JimineyCrik (big blind) collected ($14)
Seat 8: $-Twackle-$ folded before Flop (didn't bet)
Seat 9: oxfordtenzin folded before Flop (didn't bet)





PokerStars Hand #150801261887:  Hold'em No Limit ($0.50/$1.00 USD) - 2016/03/23 14:26:57 CET [2016/03/23 9:26:57 ET]
Table 'Kippes' 9-max Seat #6 is the button
Seat 1: Pvsx. ($118.68 in chips) 
Seat 3: CAJUN890 ($128 in chips) 
Seat 4: matiko09 ($100 in chips) 
Seat 5: Jimy Tiltman ($140.22 in chips) 
Seat 6: DUkalisUA ($111.86 in chips) 
Seat 8: Sherlockplay ($100 in chips) 
Seat 9: wang19790906 ($92.78 in chips) 
Sherlockplay: posts small blind $0.50
wang19790906: posts big blind $1
*** HOLE CARDS ***
Dealt to matiko09 [6h 4d]
Pvsx.: raises $1.50 to $2.50
CAJUN890: folds 
matiko09: folds 
Jimy Tiltman: folds 
DUkalisUA: folds 
Sherlockplay: folds 
wang19790906: calls $1.50
*** FLOP *** [Qd 4s 8c]
wang19790906: checks 
Pvsx.: bets $2.62
wang19790906: calls $2.62
*** TURN *** [Qd 4s 8c] [2c]
wang19790906: checks 
Pvsx.: bets $8
wang19790906: raises $8 to $16
Pvsx.: raises $16 to $32
wang19790906: calls $16
*** RIVER *** [Qd 4s 8c 2c] [9c]
wang19790906: checks 
Pvsx.: bets $71.94
wang19790906: calls $55.66 and is all-in
Uncalled bet ($16.28) returned to Pvsx.
*** SHOW DOWN ***
Pvsx.: shows [8d 8s] (three of a kind, Eights)
wang19790906: shows [2h 2d] (three of a kind, Deuces)
Pvsx. collected $183.26 from pot
*** SUMMARY ***
Total pot $186.06 | Rake $2.80 
Board [Qd 4s 8c 2c 9c]
Seat 1: Pvsx. showed [8d 8s] and won ($183.26) with three of a kind, Eights
Seat 3: CAJUN890 folded before Flop (didn't bet)
Seat 4: matiko09 folded before Flop (didn't bet)
Seat 5: Jimy Tiltman folded before Flop (didn't bet)
Seat 6: DUkalisUA (button) folded before Flop (didn't bet)
Seat 8: Sherlockplay (small blind) folded before Flop
Seat 9: wang19790906 (big blind) showed [2h 2d] and lost with three of a kind, Deuces





PokerStars Hand #150801264667:  Hold'em No Limit ($0.50/$1.00 USD) - 2016/03/23 14:27:02 CET [2016/03/23 9:27:02 ET]
Table 'Swings' 9-max Seat #9 is the button
Seat 1: Sherlockplay ($100 in chips) 
Seat 2: Harbinger X ($80 in chips) 
Seat 4: chaps1988 ($100 in chips) 
Seat 5: chautinhtri9 ($101.50 in chips) 
Seat 6: matiko09 ($100 in chips) 
Seat 7: nickreason17 ($100 in chips) 
Seat 9: Vlad_1965_77 ($101 in chips) 
Sherlockplay: posts small blind $0.50
Harbinger X: posts big blind $1
maxxmeister: sits out 
*** HOLE CARDS ***
Dealt to matiko09 [4h 6c]
chaps1988: folds 
chautinhtri9: folds 
matiko09: folds 
nickreason17: raises $1.50 to $2.50
Vlad_1965_77: folds 
Sherlockplay: folds 
Harbinger X: folds 
Uncalled bet ($1.50) returned to nickreason17
nickreason17 collected $2.50 from pot
*** SUMMARY ***
Total pot $2.50 | Rake $0 
Seat 1: Sherlockplay (small blind) folded before Flop
Seat 2: Harbinger X (big blind) folded before Flop
Seat 4: chaps1988 folded before Flop (didn't bet)
Seat 5: chautinhtri9 folded before Flop (didn't bet)
Seat 6: matiko09 folded before Flop (didn't bet)
Seat 7: nickreason17 collected ($2.50)
Seat 9: Vlad_1965_77 (button) folded before Flop (didn't bet)





PokerStars Hand #150801264700:  Hold'em No Limit ($0.50/$1.00 USD) - 2016/03/23 14:27:02 CET [2016/03/23 9:27:02 ET]
Table 'Merope II' 9-max Seat #7 is the button
Seat 1: Jimy Tiltman ($136.36 in chips) 
Seat 2: $-Twackle-$ ($100 in chips) 
Seat 3: pablos1922 ($92.25 in chips) 
Seat 4: YuriiSolodya ($87.34 in chips) 
Seat 5: DUkalisUA ($158.37 in chips) 
Seat 6: Effort92 ($100 in chips) 
Seat 7: matiko09 ($107.73 in chips) 
Seat 8: titentei ($89.50 in chips) 
titentei: posts small blind $0.50
Jimy Tiltman: posts big blind $1
*** HOLE CARDS ***
Dealt to matiko09 [Ad 4c]
$-Twackle-$: folds 
pablos1922: folds 
YuriiSolodya: folds 
DUkalisUA: folds 
Effort92: folds 
matiko09: raises $1.27 to $2.27
titentei: folds 
Jimy Tiltman: folds 
Uncalled bet ($1.27) returned to matiko09
matiko09 collected $2.50 from pot
matiko09: doesn't show hand 
*** SUMMARY ***
Total pot $2.50 | Rake $0 
Seat 1: Jimy Tiltman (big blind) folded before Flop
Seat 2: $-Twackle-$ folded before Flop (didn't bet)
Seat 3: pablos1922 folded before Flop (didn't bet)
Seat 4: YuriiSolodya folded before Flop (didn't bet)
Seat 5: DUkalisUA folded before Flop (didn't bet)
Seat 6: Effort92 folded before Flop (didn't bet)
Seat 7: matiko09 (button) collected ($2.50)
Seat 8: titentei (small blind) folded before Flop





PokerStars Hand #150801265789:  Hold'em No Limit ($0.25/$0.50 USD) - 2016/03/23 14:27:03 CET [2016/03/23 9:27:03 ET]
Table 'Pyrrhus' 9-max Seat #2 is the button
Seat 2: alemão007 ($46.25 in chips) 
Seat 3: i L00K great ($50 in chips) 
Seat 4: GriffinBerg ($34.34 in chips) 
Seat 5: ZonTTT ($55.86 in chips) 
Seat 6: Ahangama ($50 in chips) 
Seat 7: matiko09 ($138.38 in chips) 
Seat 8: dndngod ($77.48 in chips) 
Seat 9: CvMCvMCvM ($98.38 in chips) 
i L00K great: posts small blind $0.25
GriffinBerg: posts big blind $0.50
*** HOLE CARDS ***
Dealt to matiko09 [Ah 7h]
ZonTTT: folds 
Ahangama: folds 
matiko09: folds 
dndngod: folds 
CvMCvMCvM: raises $0.57 to $1.07
alemão007: raises $1.93 to $3
i L00K great: folds 
GriffinBerg: folds 
CvMCvMCvM: folds 
Uncalled bet ($1.93) returned to alemão007
alemão007 collected $2.89 from pot
alemão007: doesn't show hand 
*** SUMMARY ***
Total pot $2.89 | Rake $0 
Seat 2: alemão007 (button) collected ($2.89)
Seat 3: i L00K great (small blind) folded before Flop
Seat 4: GriffinBerg (big blind) folded before Flop
Seat 5: ZonTTT folded before Flop (didn't bet)
Seat 6: Ahangama folded before Flop (didn't bet)
Seat 7: matiko09 folded before Flop (didn't bet)
Seat 8: dndngod folded before Flop (didn't bet)
Seat 9: CvMCvMCvM folded before Flop





PokerStars Hand #150801266939:  Hold'em No Limit ($1/$2 USD) - 2016/03/23 14:27:05 CET [2016/03/23 9:27:05 ET]
Table 'Kiess' 9-max Seat #4 is the button
Seat 1: Cirilico ($229.74 in chips) 
Seat 2: DUkalisUA ($671.10 in chips) 
Seat 4: Moszes360 ($200 in chips) 
Seat 5: chippo boy ($449.96 in chips) 
Seat 6: matiko09 ($282.36 in chips) 
Seat 7: InsomniaRU ($306.39 in chips) 
Seat 8: erfk1958 ($105.55 in chips) 
Seat 9: T0ny Adams ($77 in chips) 
chippo boy: posts small blind $1
matiko09: posts big blind $2
The_red_area: sits out 
*** HOLE CARDS ***
Dealt to matiko09 [8h Ah]
InsomniaRU: folds 
erfk1958: folds 
T0ny Adams: raises $3 to $5
Cirilico: folds 
DUkalisUA: folds 
Moszes360: folds 
chippo boy: folds 
matiko09: folds 
Uncalled bet ($3) returned to T0ny Adams
T0ny Adams collected $5 from pot
T0ny Adams: doesn't show hand 
*** SUMMARY ***
Total pot $5 | Rake $0 
Seat 1: Cirilico folded before Flop (didn't bet)
Seat 2: DUkalisUA folded before Flop (didn't bet)
Seat 4: Moszes360 (button) folded before Flop (didn't bet)
Seat 5: chippo boy (small blind) folded before Flop
Seat 6: matiko09 (big blind) folded before Flop
Seat 7: InsomniaRU folded before Flop (didn't bet)
Seat 8: erfk1958 folded before Flop (didn't bet)
Seat 9: T0ny Adams collected ($5)





PokerStars Hand #150801272336:  Hold'em No Limit ($1/$2 USD) - 2016/03/23 14:27:14 CET [2016/03/23 9:27:14 ET]
Table 'Achaia' 9-max Seat #8 is the button
Seat 1: Moszes360 ($200 in chips) 
Seat 2: InsomniaRU ($220.66 in chips) 
Seat 3: matiko09 ($200 in chips) 
Seat 4: nailz83 ($189.16 in chips) 
Seat 6: nickreason17 ($209.30 in chips) 
Seat 7: morosun ($193.20 in chips) 
Seat 8: $-Twackle-$ ($231.65 in chips) 
Seat 9: glanza_mike ($205.28 in chips) 
glanza_mike: posts small blind $1
Moszes360: posts big blind $2
*** HOLE CARDS ***
Dealt to matiko09 [Qc 3h]
Igoriah joins the table at seat #5 
InsomniaRU: folds 
matiko09: folds 
nailz83: folds 
nickreason17: folds 
morosun: folds 
$-Twackle-$: folds 
glanza_mike: folds 
Uncalled bet ($1) returned to Moszes360
Moszes360 collected $2 from pot
Moszes360: doesn't show hand 
*** SUMMARY ***
Total pot $2 | Rake $0 
Seat 1: Moszes360 (big blind) collected ($2)
Seat 2: InsomniaRU folded before Flop (didn't bet)
Seat 3: matiko09 folded before Flop (didn't bet)
Seat 4: nailz83 folded before Flop (didn't bet)
Seat 6: nickreason17 folded before Flop (didn't bet)
Seat 7: morosun folded before Flop (didn't bet)
Seat 8: $-Twackle-$ (button) folded before Flop (didn't bet)
Seat 9: glanza_mike (small blind) folded before Flop





PokerStars Hand #150801278491:  Hold'em No Limit ($0.50/$1.00 USD) - 2016/03/23 14:27:24 CET [2016/03/23 9:27:24 ET]
Table 'Swings' 9-max Seat #1 is the button
Seat 1: Sherlockplay ($100 in chips) 
Seat 2: Harbinger X ($79 in chips) 
Seat 3: maxxmeister ($100 in chips) 
Seat 4: chaps1988 ($100 in chips) 
Seat 5: chautinhtri9 ($101.50 in chips) 
Seat 6: matiko09 ($100 in chips) 
Seat 7: nickreason17 ($101.50 in chips) 
Seat 9: Vlad_1965_77 ($101 in chips) 
Harbinger X: posts small blind $0.50
maxxmeister: posts big blind $1
*** HOLE CARDS ***
Dealt to matiko09 [5d 8s]
chaps1988: folds 
chautinhtri9: folds 
matiko09: folds 
nickreason17: folds 
Vlad_1965_77: raises $2.50 to $3.50
Sherlockplay: folds 
Harbinger X: folds 
maxxmeister: folds 
Uncalled bet ($2.50) returned to Vlad_1965_77
Vlad_1965_77 collected $2.50 from pot
*** SUMMARY ***
Total pot $2.50 | Rake $0 
Seat 1: Sherlockplay (button) folded before Flop (didn't bet)
Seat 2: Harbinger X (small blind) folded before Flop
Seat 3: maxxmeister (big blind) folded before Flop
Seat 4: chaps1988 folded before Flop (didn't bet)
Seat 5: chautinhtri9 folded before Flop (didn't bet)
Seat 6: matiko09 folded before Flop (didn't bet)
Seat 7: nickreason17 folded before Flop (didn't bet)
Seat 9: Vlad_1965_77 collected ($2.50)





PokerStars Hand #150801280734:  Hold'em No Limit ($1/$2 USD) - 2016/03/23 14:27:28 CET [2016/03/23 9:27:28 ET]
Table 'Kiess' 9-max Seat #5 is the button
Seat 1: Cirilico ($229.74 in chips) 
Seat 2: DUkalisUA ($671.10 in chips) 
Seat 4: Moszes360 ($200 in chips) 
Seat 5: chippo boy ($448.96 in chips) 
Seat 6: matiko09 ($280.36 in chips) 
Seat 7: InsomniaRU ($306.39 in chips) 
Seat 8: erfk1958 ($105.55 in chips) 
Seat 9: T0ny Adams ($80 in chips) 
matiko09: posts small blind $1
InsomniaRU: posts big blind $2
The_red_area: sits out 
*** HOLE CARDS ***
Dealt to matiko09 [9s 7s]
erfk1958: raises $2 to $4
T0ny Adams: folds 
Cirilico: folds 
DUkalisUA: folds 
Moszes360: calls $4
chippo boy: folds 
matiko09: folds 
InsomniaRU: calls $2
*** FLOP *** [Qd 2c Ts]
InsomniaRU: checks 
erfk1958: bets $6
Moszes360: folds 
InsomniaRU: calls $6
*** TURN *** [Qd 2c Ts] [3s]
InsomniaRU: checks 
erfk1958: bets $8
InsomniaRU: calls $8
*** RIVER *** [Qd 2c Ts 3s] [Jh]
InsomniaRU has timed out
InsomniaRU: checks 
erfk1958: checks 
*** SHOW DOWN ***
InsomniaRU: shows [Qh Kh] (a pair of Queens)
erfk1958: shows [Qs Ks] (a pair of Queens)
InsomniaRU collected $19.58 from pot
erfk1958 collected $19.58 from pot
*** SUMMARY ***
Total pot $41 | Rake $1.84 
Board [Qd 2c Ts 3s Jh]
Seat 1: Cirilico folded before Flop (didn't bet)
Seat 2: DUkalisUA folded before Flop (didn't bet)
Seat 4: Moszes360 folded on the Flop
Seat 5: chippo boy (button) folded before Flop (didn't bet)
Seat 6: matiko09 (small blind) folded before Flop
Seat 7: InsomniaRU (big blind) showed [Qh Kh] and won ($19.58) with a pair of Queens
Seat 8: erfk1958 showed [Qs Ks] and won ($19.58) with a pair of Queens
Seat 9: T0ny Adams folded before Flop (didn't bet)





PokerStars Hand #150801285312:  Hold'em No Limit ($1/$2 USD) - 2016/03/23 14:27:35 CET [2016/03/23 9:27:35 ET]
Table 'Kypria II' 9-max Seat #1 is the button
Seat 1: geldwolfje ($157.20 in chips) 
Seat 2: coinflip_si ($217.70 in chips) 
Seat 3: seouljam ($153.13 in chips) 
Seat 4: VolanDog ($203 in chips) 
Seat 5: InsomniaRU ($379.88 in chips) 
Seat 6: matiko09 ($370.95 in chips) 
Seat 7: DUkalisUA ($200 in chips) 
Seat 8: Pearl Jam87 ($200 in chips) 
Seat 9: Moszes360 ($200 in chips) 
coinflip_si: posts small blind $1
seouljam: posts big blind $2
*** HOLE CARDS ***
Dealt to matiko09 [Js Jc]
VolanDog: folds 
InsomniaRU: folds 
matiko09: raises $3 to $5
DUkalisUA: folds 
Pearl Jam87: folds 
Moszes360: folds 
geldwolfje: folds 
coinflip_si: folds 
seouljam: folds 
Uncalled bet ($3) returned to matiko09
matiko09 collected $5 from pot
matiko09: doesn't show hand 
*** SUMMARY ***
Total pot $5 | Rake $0 
Seat 1: geldwolfje (button) folded before Flop (didn't bet)
Seat 2: coinflip_si (small blind) folded before Flop
Seat 3: seouljam (big blind) folded before Flop
Seat 4: VolanDog folded before Flop (didn't bet)
Seat 5: InsomniaRU folded before Flop (didn't bet)
Seat 6: matiko09 collected ($5)
Seat 7: DUkalisUA folded before Flop (didn't bet)
Seat 8: Pearl Jam87 folded before Flop (didn't bet)
Seat 9: Moszes360 folded before Flop (didn't bet)





PokerStars Hand #150801287709:  Hold'em No Limit ($0.50/$1.00 USD) - 2016/03/23 14:27:39 CET [2016/03/23 9:27:39 ET]
Table 'Swings' 9-max Seat #2 is the button
Seat 1: Sherlockplay ($100 in chips) 
Seat 2: Harbinger X ($78.50 in chips) 
Seat 3: maxxmeister ($100 in chips) 
Seat 4: chaps1988 ($100 in chips) 
Seat 5: chautinhtri9 ($101.50 in chips) 
Seat 6: matiko09 ($100 in chips) 
Seat 7: nickreason17 ($101.50 in chips) 
Seat 9: Vlad_1965_77 ($102.50 in chips) 
maxxmeister: posts small blind $0.50
chaps1988: posts big blind $1
*** HOLE CARDS ***
Dealt to matiko09 [9d 9s]
chautinhtri9: folds 
matiko09: raises $2 to $3
nickreason17: folds 
Vlad_1965_77: folds 
Sherlockplay: folds 
Harbinger X: folds 
maxxmeister: folds 
chaps1988: folds 
Uncalled bet ($2) returned to matiko09
matiko09 collected $2.50 from pot
matiko09: doesn't show hand 
*** SUMMARY ***
Total pot $2.50 | Rake $0 
Seat 1: Sherlockplay folded before Flop (didn't bet)
Seat 2: Harbinger X (button) folded before Flop (didn't bet)
Seat 3: maxxmeister (small blind) folded before Flop
Seat 4: chaps1988 (big blind) folded before Flop
Seat 5: chautinhtri9 folded before Flop (didn't bet)
Seat 6: matiko09 collected ($2.50)
Seat 7: nickreason17 folded before Flop (didn't bet)
Seat 9: Vlad_1965_77 folded before Flop (didn't bet)





PokerStars Hand #150801289442:  Hold'em No Limit ($0.50/$1.00 USD) - 2016/03/23 14:27:42 CET [2016/03/23 9:27:42 ET]
Table 'Atlantis' 9-max Seat #2 is the button
Seat 1: xHourglass ($153 in chips) 
Seat 2: tffff2006 ($68.22 in chips) 
Seat 3: CAJUN890 ($103.29 in chips) 
Seat 4: matiko09 ($133.25 in chips) 
Seat 5: Pvsx. ($104.25 in chips) 
Seat 6: Jimy Tiltman ($101.78 in chips) 
Seat 7: Sherlockplay ($134.77 in chips) 
Seat 8: DUkalisUA ($102.50 in chips) 
CAJUN890: posts small blind $0.50
matiko09: posts big blind $1
*** HOLE CARDS ***
Dealt to matiko09 [Kd 2s]
Pvsx.: folds 
Jimy Tiltman: folds 
Sherlockplay: folds 
DUkalisUA: folds 
xHourglass: folds 
tffff2006: raises $2 to $3
CAJUN890: folds 
matiko09: folds 
Uncalled bet ($2) returned to tffff2006
tffff2006 collected $2.50 from pot
*** SUMMARY ***
Total pot $2.50 | Rake $0 
Seat 1: xHourglass folded before Flop (didn't bet)
Seat 2: tffff2006 (button) collected ($2.50)
Seat 3: CAJUN890 (small blind) folded before Flop
Seat 4: matiko09 (big blind) folded before Flop
Seat 5: Pvsx. folded before Flop (didn't bet)
Seat 6: Jimy Tiltman folded before Flop (didn't bet)
Seat 7: Sherlockplay folded before Flop (didn't bet)
Seat 8: DUkalisUA folded before Flop (didn't bet)





PokerStars Hand #150801289496:  Hold'em No Limit ($0.50/$1.00 USD) - 2016/03/23 14:27:42 CET [2016/03/23 9:27:42 ET]
Table 'Merope II' 9-max Seat #8 is the button
Seat 1: Jimy Tiltman ($135.36 in chips) 
Seat 2: $-Twackle-$ ($100 in chips) 
Seat 3: pablos1922 ($92.25 in chips) 
Seat 4: YuriiSolodya ($87.34 in chips) 
Seat 5: DUkalisUA ($158.37 in chips) 
Seat 6: Effort92 ($100 in chips) 
Seat 7: matiko09 ($109.23 in chips) 
Seat 8: titentei ($89 in chips) 
Jimy Tiltman: posts small blind $0.50
$-Twackle-$: posts big blind $1
*** HOLE CARDS ***
Dealt to matiko09 [8c Th]
pablos1922: folds 
YuriiSolodya: raises $2 to $3
DUkalisUA: folds 
Effort92: folds 
matiko09: folds 
titentei: folds 
Jimy Tiltman: folds 
$-Twackle-$: folds 
Uncalled bet ($2) returned to YuriiSolodya
YuriiSolodya collected $2.50 from pot
YuriiSolodya: doesn't show hand 
*** SUMMARY ***
Total pot $2.50 | Rake $0 
Seat 1: Jimy Tiltman (small blind) folded before Flop
Seat 2: $-Twackle-$ (big blind) folded before Flop
Seat 3: pablos1922 folded before Flop (didn't bet)
Seat 4: YuriiSolodya collected ($2.50)
Seat 5: DUkalisUA folded before Flop (didn't bet)
Seat 6: Effort92 folded before Flop (didn't bet)
Seat 7: matiko09 folded before Flop (didn't bet)
Seat 8: titentei (button) folded before Flop (didn't bet)





PokerStars Hand #150801291840:  Hold'em No Limit ($0.25/$0.50 USD) - 2016/03/23 14:27:46 CET [2016/03/23 9:27:46 ET]
Table 'Pyrrhus' 9-max Seat #3 is the button
Seat 2: alemão007 ($48.07 in chips) 
Seat 3: i L00K great ($50 in chips) 
Seat 4: GriffinBerg ($33.84 in chips) 
Seat 5: ZonTTT ($55.86 in chips) 
Seat 6: Ahangama ($50 in chips) 
Seat 7: matiko09 ($138.38 in chips) 
Seat 8: dndngod ($77.48 in chips) 
Seat 9: CvMCvMCvM ($97.31 in chips) 
GriffinBerg: posts small blind $0.25
ZonTTT: posts big blind $0.50
*** HOLE CARDS ***
Dealt to matiko09 [Qc 5c]
Ahangama: raises $0.75 to $1.25
matiko09: folds 
dndngod: folds 
CvMCvMCvM: folds 
alemão007: raises $1.25 to $2.50
i L00K great: folds 
GriffinBerg: calls $2.25
ZonTTT: folds 
Ahangama: calls $1.25
*** FLOP *** [2h Kh Qh]
GriffinBerg: checks 
Ahangama: checks 
alemão007: bets $3
GriffinBerg: folds 
Ahangama: folds 
Uncalled bet ($3) returned to alemão007
alemão007 collected $7.64 from pot
alemão007: doesn't show hand 
*** SUMMARY ***
Total pot $8 | Rake $0.36 
Board [2h Kh Qh]
Seat 2: alemão007 collected ($7.64)
Seat 3: i L00K great (button) folded before Flop (didn't bet)
Seat 4: GriffinBerg (small blind) folded on the Flop
Seat 5: ZonTTT (big blind) folded before Flop
Seat 6: Ahangama folded on the Flop
Seat 7: matiko09 folded before Flop (didn't bet)
Seat 8: dndngod folded before Flop (didn't bet)
Seat 9: CvMCvMCvM folded before Flop (didn't bet)





PokerStars Hand #150801293451:  Hold'em No Limit ($1/$2 USD) - 2016/03/23 14:27:48 CET [2016/03/23 9:27:48 ET]
Table 'Achaia' 9-max Seat #9 is the button
Seat 1: Moszes360 ($201 in chips) 
Seat 2: InsomniaRU ($220.66 in chips) 
Seat 3: matiko09 ($200 in chips) 
Seat 4: nailz83 ($189.16 in chips) 
Seat 6: nickreason17 ($209.30 in chips) 
Seat 7: morosun ($193.20 in chips) 
Seat 8: $-Twackle-$ ($231.65 in chips) 
Seat 9: glanza_mike ($204.28 in chips) 
Moszes360: posts small blind $1
InsomniaRU: posts big blind $2
Igoriah: sits out 
*** HOLE CARDS ***
Dealt to matiko09 [5h 5d]
matiko09: folds 
Igoriah leaves the table
nailz83: folds 
nickreason17: folds 
morosun: folds 
chaps1988 joins the table at seat #5 
$-Twackle-$: raises $3 to $5
glanza_mike: calls $5
Moszes360: folds 
InsomniaRU: folds 
*** FLOP *** [8s 6c 4s]
$-Twackle-$: bets $9
glanza_mike: folds 
Uncalled bet ($9) returned to $-Twackle-$
$-Twackle-$ collected $12.42 from pot
$-Twackle-$: doesn't show hand 
*** SUMMARY ***
Total pot $13 | Rake $0.58 
Board [8s 6c 4s]
Seat 1: Moszes360 (small blind) folded before Flop
Seat 2: InsomniaRU (big blind) folded before Flop
Seat 3: matiko09 folded before Flop (didn't bet)
Seat 4: nailz83 folded before Flop (didn't bet)
Seat 6: nickreason17 folded before Flop (didn't bet)
Seat 7: morosun folded before Flop (didn't bet)
Seat 8: $-Twackle-$ collected ($12.42)
Seat 9: glanza_mike (button) folded on the Flop





PokerStars Hand #150801294401:  Hold'em No Limit ($1/$2 USD) - 2016/03/23 14:27:50 CET [2016/03/23 9:27:50 ET]
Table 'Ennomos II' 9-max Seat #3 is the button
Seat 1: ilaviiitech ($200 in chips) 
Seat 2: Subam ($406.18 in chips) 
Seat 3: $-Twackle-$ ($231.20 in chips) 
Seat 4: glanza_mike ($200 in chips) 
Seat 5: South011 ($384.88 in chips) 
Seat 6: nickreason17 ($264.40 in chips) 
Seat 7: daniferdoser ($200 in chips) 
Seat 8: yyfk ($207.24 in chips) 
Seat 9: matiko09 ($200 in chips) 
glanza_mike: posts small blind $1
South011: posts big blind $2
*** HOLE CARDS ***
Dealt to matiko09 [5d 9h]
nickreason17: folds 
daniferdoser: folds 
yyfk: folds 
matiko09: folds 
ilaviiitech: folds 
Subam: raises $4 to $6
$-Twackle-$: folds 
glanza_mike: folds 
South011: folds 
Uncalled bet ($4) returned to Subam
Subam collected $5 from pot
Subam: doesn't show hand 
*** SUMMARY ***
Total pot $5 | Rake $0 
Seat 1: ilaviiitech folded before Flop (didn't bet)
Seat 2: Subam collected ($5)
Seat 3: $-Twackle-$ (button) folded before Flop (didn't bet)
Seat 4: glanza_mike (small blind) folded before Flop
Seat 5: South011 (big blind) folded before Flop
Seat 6: nickreason17 folded before Flop (didn't bet)
Seat 7: daniferdoser folded before Flop (didn't bet)
Seat 8: yyfk folded before Flop (didn't bet)
Seat 9: matiko09 folded before Flop (didn't bet)





PokerStars Hand #150801297816:  Hold'em No Limit ($1/$2 USD) - 2016/03/23 14:27:56 CET [2016/03/23 9:27:56 ET]
Table 'Kypria II' 9-max Seat #2 is the button
Seat 1: geldwolfje ($157.20 in chips) 
Seat 2: coinflip_si ($216.70 in chips) 
Seat 3: seouljam ($151.13 in chips) 
Seat 4: VolanDog ($203 in chips) 
Seat 5: InsomniaRU ($379.88 in chips) 
Seat 6: matiko09 ($373.95 in chips) 
Seat 7: DUkalisUA ($200 in chips) 
Seat 8: Pearl Jam87 ($200 in chips) 
Seat 9: Moszes360 ($200 in chips) 
seouljam: posts small blind $1
VolanDog: posts big blind $2
*** HOLE CARDS ***
Dealt to matiko09 [2d 4d]
InsomniaRU: raises $3 to $5
matiko09: folds 
DUkalisUA: raises $12 to $17
Pearl Jam87: folds 
Moszes360: folds 
geldwolfje: folds 
coinflip_si: folds 
seouljam: folds 
VolanDog: folds 
InsomniaRU: folds 
Uncalled bet ($12) returned to DUkalisUA
DUkalisUA collected $13 from pot
DUkalisUA: doesn't show hand 
*** SUMMARY ***
Total pot $13 | Rake $0 
Seat 1: geldwolfje folded before Flop (didn't bet)
Seat 2: coinflip_si (button) folded before Flop (didn't bet)
Seat 3: seouljam (small blind) folded before Flop
Seat 4: VolanDog (big blind) folded before Flop
Seat 5: InsomniaRU folded before Flop
Seat 6: matiko09 folded before Flop (didn't bet)
Seat 7: DUkalisUA collected ($13)
Seat 8: Pearl Jam87 folded before Flop (didn't bet)
Seat 9: Moszes360 folded before Flop (didn't bet)





PokerStars Hand #150801298350:  Hold'em No Limit (€0.50/€1.00 EUR) - 2016/03/23 14:27:56 CET [2016/03/23 9:27:56 ET]
Table 'Lanzia' 9-max Seat #9 is the button
Seat 1: fk154 (€32.25 in chips) 
Seat 2: ardo888 (€101.50 in chips) 
Seat 3: Effort92 (€196.81 in chips) 
Seat 4: niong62 (€75.88 in chips) 
Seat 5: matiko09 (€100 in chips) 
Seat 6: Red4erT (€40 in chips) 
Seat 7: $-Twackle-$ (€133 in chips) 
Seat 8: Muinmyheart (€102 in chips) 
Seat 9: Butcher1848 (€103.87 in chips) 
fk154: posts small blind €0.50
ardo888: posts big blind €1
*** HOLE CARDS ***
Dealt to matiko09 [Js Ad]
Effort92: folds 
niong62: raises €1 to €2
matiko09: raises €4 to €6
Red4erT: folds 
$-Twackle-$: folds 
Muinmyheart: folds 
Butcher1848: folds 
fk154: folds 
ardo888: folds 
niong62: calls €4
*** FLOP *** [8h Ac 5c]
niong62: bets €5.88
matiko09: calls €5.88
*** TURN *** [8h Ac 5c] [Jd]
niong62: checks 
matiko09: bets €16
niong62: calls €16
*** RIVER *** [8h Ac 5c Jd] [Kh]
niong62: bets €48 and is all-in
matiko09: calls €48
*** SHOW DOWN ***
niong62: shows [Qc Qh] (a pair of Queens)
matiko09: shows [Js Ad] (two pair, Aces and Jacks)
matiko09 collected €151.11 from pot
*** SUMMARY ***
Total pot €153.26 | Rake €2.15 
Board [8h Ac 5c Jd Kh]
Seat 1: fk154 (small blind) folded before Flop
Seat 2: ardo888 (big blind) folded before Flop
Seat 3: Effort92 folded before Flop (didn't bet)
Seat 4: niong62 showed [Qc Qh] and lost with a pair of Queens
Seat 5: matiko09 showed [Js Ad] and won (€151.11) with two pair, Aces and Jacks
Seat 6: Red4erT folded before Flop (didn't bet)
Seat 7: $-Twackle-$ folded before Flop (didn't bet)
Seat 8: Muinmyheart folded before Flop (didn't bet)
Seat 9: Butcher1848 (button) folded before Flop (didn't bet)





PokerStars Hand #150801300727:  Hold'em No Limit ($1/$2 USD) - 2016/03/23 14:28:00 CET [2016/03/23 9:28:00 ET]
Table 'Deipylos II' 9-max Seat #8 is the button
Seat 1: $-Twackle-$ ($213.70 in chips) 
Seat 2: T0ny Adams ($91.32 in chips) 
Seat 4: matiko09 ($200 in chips) 
Seat 5: InsomniaRU ($225.88 in chips) 
Seat 6: nickreason17 ($200 in chips) 
Seat 7: volwebni4ek ($91.70 in chips) 
Seat 8: Igoriah ($279.20 in chips) 
Seat 9: Ranatuo84 ($234.62 in chips) 
Ranatuo84: posts small blind $1
$-Twackle-$: posts big blind $2
DUkalisUA: sits out 
*** HOLE CARDS ***
Dealt to matiko09 [4s 2h]
T0ny Adams: raises $3 to $5
matiko09: folds 
InsomniaRU: folds 
nickreason17: folds 
volwebni4ek: folds 
Igoriah: folds 
Ranatuo84: folds 
$-Twackle-$: folds 
Uncalled bet ($3) returned to T0ny Adams
Ranatuo84 leaves the table
T0ny Adams collected $5 from pot
T0ny Adams: doesn't show hand 
chaps1988 joins the table at seat #9 
*** SUMMARY ***
Total pot $5 | Rake $0 
Seat 1: $-Twackle-$ (big blind) folded before Flop
Seat 2: T0ny Adams collected ($5)
Seat 4: matiko09 folded before Flop (didn't bet)
Seat 5: InsomniaRU folded before Flop (didn't bet)
Seat 6: nickreason17 folded before Flop (didn't bet)
Seat 7: volwebni4ek folded before Flop (didn't bet)
Seat 8: Igoriah (button) folded before Flop (didn't bet)
Seat 9: Ranatuo84 (small blind) folded before Flop





PokerStars Hand #150801304666:  Hold'em No Limit ($0.50/$1.00 USD) - 2016/03/23 14:28:07 CET [2016/03/23 9:28:07 ET]
Table 'Swings' 9-max Seat #3 is the button
Seat 1: Sherlockplay ($100 in chips) 
Seat 2: Harbinger X ($78.50 in chips) 
Seat 3: maxxmeister ($100 in chips) 
Seat 4: chaps1988 ($100 in chips) 
Seat 5: chautinhtri9 ($101.50 in chips) 
Seat 6: matiko09 ($101.50 in chips) 
Seat 7: nickreason17 ($101.50 in chips) 
Seat 9: Vlad_1965_77 ($102.50 in chips) 
chaps1988: posts small blind $0.50
chautinhtri9: posts big blind $1
*** HOLE CARDS ***
Dealt to matiko09 [5h 6c]
matiko09: folds 
nickreason17: folds 
Vlad_1965_77: folds 
Sherlockplay: raises $1.50 to $2.50
Harbinger X: calls $2.50
maxxmeister: folds 
chaps1988: folds 
chautinhtri9: folds 
*** FLOP *** [7c Qd 4c]
Sherlockplay: bets $4.13
Harbinger X: calls $4.13
*** TURN *** [7c Qd 4c] [Tc]
Sherlockplay: bets $7.50
Harbinger X: raises $7.50 to $15
Sherlockplay: folds 
Uncalled bet ($7.50) returned to Harbinger X
Harbinger X collected $28.42 from pot
Harbinger X: doesn't show hand 
*** SUMMARY ***
Total pot $29.76 | Rake $1.34 
Board [7c Qd 4c Tc]
Seat 1: Sherlockplay folded on the Turn
Seat 2: Harbinger X collected ($28.42)
Seat 3: maxxmeister (button) folded before Flop (didn't bet)
Seat 4: chaps1988 (small blind) folded before Flop
Seat 5: chautinhtri9 (big blind) folded before Flop
Seat 6: matiko09 folded before Flop (didn't bet)
Seat 7: nickreason17 folded before Flop (didn't bet)
Seat 9: Vlad_1965_77 folded before Flop (didn't bet)





PokerStars Hand #150801311438:  Hold'em No Limit ($1/$2 USD) - 2016/03/23 14:28:18 CET [2016/03/23 9:28:18 ET]
Table 'Herba II' 9-max Seat #9 is the button
Seat 1: matiko09 ($210.06 in chips) 
Seat 2: Moszes360 ($227.17 in chips) 
Seat 3: Cirilico ($186.84 in chips) 
Seat 4: DUkalisUA ($200 in chips) 
Seat 5: chippo boy ($203.83 in chips) 
Seat 6: Too-Anti-To ($212.46 in chips) 
Seat 7: InsomniaRU ($406.20 in chips) 
Seat 9: mrhighryza ($59.67 in chips) 
matiko09: posts small blind $1
Moszes360: posts big blind $2
The_red_area: sits out 
*** HOLE CARDS ***
Dealt to matiko09 [9d 7c]
Cirilico: folds 
DUkalisUA: folds 
chippo boy: raises $4 to $6
Too-Anti-To: folds 
InsomniaRU: folds 
mrhighryza: folds 
matiko09: folds 
Moszes360: folds 
Uncalled bet ($4) returned to chippo boy
chippo boy collected $5 from pot
*** SUMMARY ***
Total pot $5 | Rake $0 
Seat 1: matiko09 (small blind) folded before Flop
Seat 2: Moszes360 (big blind) folded before Flop
Seat 3: Cirilico folded before Flop (didn't bet)
Seat 4: DUkalisUA folded before Flop (didn't bet)
Seat 5: chippo boy collected ($5)
Seat 6: Too-Anti-To folded before Flop (didn't bet)
Seat 7: InsomniaRU folded before Flop (didn't bet)
Seat 9: mrhighryza (button) folded before Flop (didn't bet)





PokerStars Hand #150801312133:  Hold'em No Limit ($0.50/$1.00 USD) - 2016/03/23 14:28:19 CET [2016/03/23 9:28:19 ET]
Table 'Atlantis' 9-max Seat #3 is the button
Seat 1: xHourglass ($153 in chips) 
Seat 2: tffff2006 ($69.72 in chips) 
Seat 3: CAJUN890 ($102.79 in chips) 
Seat 4: matiko09 ($132.25 in chips) 
Seat 5: Pvsx. ($104.25 in chips) 
Seat 6: Jimy Tiltman ($101.78 in chips) 
Seat 7: Sherlockplay ($134.77 in chips) 
Seat 8: DUkalisUA ($102.50 in chips) 
matiko09: posts small blind $0.50
Pvsx.: posts big blind $1
*** HOLE CARDS ***
Dealt to matiko09 [Ts As]
Jimy Tiltman: folds 
Sherlockplay: folds 
DUkalisUA: folds 
xHourglass: folds 
tffff2006 has timed out
tffff2006: folds 
CAJUN890: folds 
matiko09: raises $1.50 to $2.50
Pvsx.: folds 
Uncalled bet ($1.50) returned to matiko09
matiko09 collected $2 from pot
matiko09: doesn't show hand 
*** SUMMARY ***
Total pot $2 | Rake $0 
Seat 1: xHourglass folded before Flop (didn't bet)
Seat 2: tffff2006 folded before Flop (didn't bet)
Seat 3: CAJUN890 (button) folded before Flop (didn't bet)
Seat 4: matiko09 (small blind) collected ($2)
Seat 5: Pvsx. (big blind) folded before Flop
Seat 6: Jimy Tiltman folded before Flop (didn't bet)
Seat 7: Sherlockplay folded before Flop (didn't bet)
Seat 8: DUkalisUA folded before Flop (didn't bet)





PokerStars Hand #150801314941:  Hold'em No Limit ($0.50/$1.00 USD) - 2016/03/23 14:28:23 CET [2016/03/23 9:28:23 ET]
Table 'Merope II' 9-max Seat #1 is the button
Seat 1: Jimy Tiltman ($134.86 in chips) 
Seat 2: $-Twackle-$ ($100 in chips) 
Seat 3: pablos1922 ($92.25 in chips) 
Seat 4: YuriiSolodya ($88.84 in chips) 
Seat 5: DUkalisUA ($158.37 in chips) 
Seat 6: Effort92 ($100 in chips) 
Seat 7: matiko09 ($109.23 in chips) 
Seat 8: titentei ($89 in chips) 
$-Twackle-$: posts small blind $0.50
pablos1922: posts big blind $1
*** HOLE CARDS ***
Dealt to matiko09 [Kd 4s]
YuriiSolodya: folds 
DUkalisUA: folds 
Effort92: folds 
matiko09: folds 
titentei: folds 
Jimy Tiltman: raises $1 to $2
$-Twackle-$: calls $1.50
pablos1922: calls $1
*** FLOP *** [5c Ts Js]
$-Twackle-$: checks 
pablos1922: checks 
Jimy Tiltman: checks 
*** TURN *** [5c Ts Js] [Kc]
$-Twackle-$: checks 
pablos1922: checks 
Jimy Tiltman: bets $4
$-Twackle-$: calls $4
pablos1922: folds 
*** RIVER *** [5c Ts Js Kc] [7d]
$-Twackle-$: checks 
Jimy Tiltman: bets $6.68
$-Twackle-$: folds 
Uncalled bet ($6.68) returned to Jimy Tiltman
Jimy Tiltman collected $13.37 from pot
Jimy Tiltman: doesn't show hand 
*** SUMMARY ***
Total pot $14 | Rake $0.63 
Board [5c Ts Js Kc 7d]
Seat 1: Jimy Tiltman (button) collected ($13.37)
Seat 2: $-Twackle-$ (small blind) folded on the River
Seat 3: pablos1922 (big blind) folded on the Turn
Seat 4: YuriiSolodya folded before Flop (didn't bet)
Seat 5: DUkalisUA folded before Flop (didn't bet)
Seat 6: Effort92 folded before Flop (didn't bet)
Seat 7: matiko09 folded before Flop (didn't bet)
Seat 8: titentei folded before Flop (didn't bet)





PokerStars Hand #150801314445:  Hold'em No Limit ($0.50/$1.00 USD) - 2016/03/23 14:28:23 CET [2016/03/23 9:28:23 ET]
Table 'Donar II' 9-max Seat #6 is the button
Seat 1: Effort92 ($100.52 in chips) 
Seat 2: nobrunobru1 ($54.44 in chips) 
Seat 3: st-germ30 ($99.89 in chips) 
Seat 4: DUkalisUA ($146.09 in chips) 
Seat 5: matiko09 ($100 in chips) 
Seat 6: ardo888 ($133.38 in chips) 
Seat 7: JimineyCrik ($103.92 in chips) 
Seat 8: $-Twackle-$ ($112.55 in chips) 
Seat 9: oxfordtenzin ($124.80 in chips) 
JimineyCrik: posts small blind $0.50
$-Twackle-$: posts big blind $1
Effort92: posts the ante $0.20
nobrunobru1: posts the ante $0.20
st-germ30: posts the ante $0.20
DUkalisUA: posts the ante $0.20
matiko09: posts the ante $0.20
ardo888: posts the ante $0.20
JimineyCrik: posts the ante $0.20
$-Twackle-$: posts the ante $0.20
oxfordtenzin: posts the ante $0.20
*** HOLE CARDS ***
Dealt to matiko09 [Ac 9s]
oxfordtenzin: folds 
Effort92: folds 
nobrunobru1: folds 
st-germ30: folds 
DUkalisUA: folds 
matiko09: raises $1.50 to $2.50
ardo888: folds 
JimineyCrik: folds 
$-Twackle-$: calls $1.50
*** FLOP *** [2h As Qs]
$-Twackle-$: checks 
matiko09: bets $4.53
$-Twackle-$: folds 
Uncalled bet ($4.53) returned to matiko09
matiko09 collected $6.97 from pot
matiko09: doesn't show hand 
*** SUMMARY ***
Total pot $7.30 | Rake $0.33 
Board [2h As Qs]
Seat 1: Effort92 folded before Flop (didn't bet)
Seat 2: nobrunobru1 folded before Flop (didn't bet)
Seat 3: st-germ30 folded before Flop (didn't bet)
Seat 4: DUkalisUA folded before Flop (didn't bet)
Seat 5: matiko09 collected ($6.97)
Seat 6: ardo888 (button) folded before Flop (didn't bet)
Seat 7: JimineyCrik (small blind) folded before Flop
Seat 8: $-Twackle-$ (big blind) folded on the Flop
Seat 9: oxfordtenzin folded before Flop (didn't bet)





PokerStars Hand #150801315777:  Hold'em No Limit ($1/$2 USD) - 2016/03/23 14:28:25 CET [2016/03/23 9:28:25 ET]
Table 'Ennomos II' 9-max Seat #4 is the button
Seat 1: ilaviiitech ($200 in chips) 
Seat 2: Subam ($409.18 in chips) 
Seat 3: $-Twackle-$ ($231.20 in chips) 
Seat 4: glanza_mike ($200 in chips) 
Seat 5: South011 ($382.88 in chips) 
Seat 6: nickreason17 ($264.40 in chips) 
Seat 7: daniferdoser ($200 in chips) 
Seat 8: yyfk ($207.24 in chips) 
Seat 9: matiko09 ($200 in chips) 
South011: posts small blind $1
nickreason17: posts big blind $2
*** HOLE CARDS ***
Dealt to matiko09 [3c 7d]
daniferdoser: raises $3 to $5
yyfk: folds 
matiko09: folds 
ilaviiitech: folds 
Subam: calls $5
$-Twackle-$: folds 
glanza_mike: folds 
South011: folds 
nickreason17: calls $3
*** FLOP *** [8d Ad Js]
nickreason17: checks 
daniferdoser: checks 
Subam: checks 
*** TURN *** [8d Ad Js] [5c]
nickreason17: bets $9
daniferdoser: folds 
daniferdoser leaves the table
Subam: raises $17 to $26
T0ny Adams joins the table at seat #7 
nickreason17: calls $17
*** RIVER *** [8d Ad Js 5c] [2d]
nickreason17: checks 
Subam: checks 
*** SHOW DOWN ***
nickreason17: shows [Ac 9c] (a pair of Aces)
Subam: shows [Ah Kd] (a pair of Aces - King kicker)
Subam collected $65.20 from pot
*** SUMMARY ***
Total pot $68 | Rake $2.80 
Board [8d Ad Js 5c 2d]
Seat 1: ilaviiitech folded before Flop (didn't bet)
Seat 2: Subam showed [Ah Kd] and won ($65.20) with a pair of Aces
Seat 3: $-Twackle-$ folded before Flop (didn't bet)
Seat 4: glanza_mike (button) folded before Flop (didn't bet)
Seat 5: South011 (small blind) folded before Flop
Seat 6: nickreason17 (big blind) showed [Ac 9c] and lost with a pair of Aces
Seat 7: daniferdoser folded on the Turn
Seat 8: yyfk folded before Flop (didn't bet)
Seat 9: matiko09 folded before Flop (didn't bet)





PokerStars Hand #150801320303:  Hold'em No Limit ($1/$2 USD) - 2016/03/23 14:28:32 CET [2016/03/23 9:28:32 ET]
Table 'Kypria II' 9-max Seat #3 is the button
Seat 1: geldwolfje ($157.20 in chips) 
Seat 2: coinflip_si ($216.70 in chips) 
Seat 3: seouljam ($150.13 in chips) 
Seat 4: VolanDog ($201 in chips) 
Seat 5: InsomniaRU ($374.88 in chips) 
Seat 6: matiko09 ($373.95 in chips) 
Seat 7: DUkalisUA ($208 in chips) 
Seat 8: Pearl Jam87 ($200 in chips) 
Seat 9: Moszes360 ($200 in chips) 
VolanDog: posts small blind $1
InsomniaRU: posts big blind $2
*** HOLE CARDS ***
Dealt to matiko09 [9s 4c]
matiko09: folds 
DUkalisUA: folds 
Pearl Jam87: folds 
Moszes360: folds 
geldwolfje: folds 
coinflip_si: folds 
seouljam: folds 
VolanDog: folds 
Uncalled bet ($1) returned to InsomniaRU
InsomniaRU collected $2 from pot
InsomniaRU: doesn't show hand 
*** SUMMARY ***
Total pot $2 | Rake $0 
Seat 1: geldwolfje folded before Flop (didn't bet)
Seat 2: coinflip_si folded before Flop (didn't bet)
Seat 3: seouljam (button) folded before Flop (didn't bet)
Seat 4: VolanDog (small blind) folded before Flop
Seat 5: InsomniaRU (big blind) collected ($2)
Seat 6: matiko09 folded before Flop (didn't bet)
Seat 7: DUkalisUA folded before Flop (didn't bet)
Seat 8: Pearl Jam87 folded before Flop (didn't bet)
Seat 9: Moszes360 folded before Flop (didn't bet)





PokerStars Hand #150801321431:  Hold'em No Limit ($1/$2 USD) - 2016/03/23 14:28:34 CET [2016/03/23 9:28:34 ET]
Table 'Deipylos II' 9-max Seat #1 is the button
Seat 1: $-Twackle-$ ($211.70 in chips) 
Seat 2: T0ny Adams ($94.32 in chips) 
Seat 3: DUkalisUA ($200 in chips) 
Seat 4: matiko09 ($200 in chips) 
Seat 5: InsomniaRU ($225.88 in chips) 
Seat 6: nickreason17 ($200 in chips) 
Seat 7: volwebni4ek ($91.70 in chips) 
Seat 8: Igoriah ($279.20 in chips) 
T0ny Adams: posts small blind $1
DUkalisUA: posts big blind $2
chaps1988: sits out 
*** HOLE CARDS ***
Dealt to matiko09 [Qd Jh]
matiko09: folds 
InsomniaRU: folds 
nickreason17: folds 
volwebni4ek: folds 
Igoriah: folds 
$-Twackle-$: raises $2.20 to $4.20
T0ny Adams: raises $8.80 to $13
DUkalisUA: folds 
$-Twackle-$: folds 
Uncalled bet ($8.80) returned to T0ny Adams
T0ny Adams collected $10.40 from pot
T0ny Adams: doesn't show hand 
*** SUMMARY ***
Total pot $10.40 | Rake $0 
Seat 1: $-Twackle-$ (button) folded before Flop
Seat 2: T0ny Adams (small blind) collected ($10.40)
Seat 3: DUkalisUA (big blind) folded before Flop
Seat 4: matiko09 folded before Flop (didn't bet)
Seat 5: InsomniaRU folded before Flop (didn't bet)
Seat 6: nickreason17 folded before Flop (didn't bet)
Seat 7: volwebni4ek folded before Flop (didn't bet)
Seat 8: Igoriah folded before Flop (didn't bet)





PokerStars Hand #150801322252:  Hold'em No Limit ($1/$2 USD) - 2016/03/23 14:28:35 CET [2016/03/23 9:28:35 ET]
Table 'Achaia' 9-max Seat #1 is the button
Seat 1: Moszes360 ($200 in chips) 
Seat 2: InsomniaRU ($218.66 in chips) 
Seat 3: matiko09 ($200 in chips) 
Seat 4: nailz83 ($189.16 in chips) 
Seat 6: nickreason17 ($209.30 in chips) 
Seat 7: morosun ($193.20 in chips) 
Seat 8: $-Twackle-$ ($239.07 in chips) 
Seat 9: glanza_mike ($200 in chips) 
InsomniaRU: posts small blind $1
matiko09: posts big blind $2
chaps1988: sits out 
*** HOLE CARDS ***
Dealt to matiko09 [7c 4h]
nailz83: folds 
nickreason17: folds 
morosun: folds 
$-Twackle-$: raises $4 to $6
glanza_mike: folds 
Moszes360: raises $12 to $18
InsomniaRU: folds 
matiko09: folds 
$-Twackle-$: folds 
Uncalled bet ($12) returned to Moszes360
Moszes360 collected $15 from pot
Moszes360: doesn't show hand 
*** SUMMARY ***
Total pot $15 | Rake $0 
Seat 1: Moszes360 (button) collected ($15)
Seat 2: InsomniaRU (small blind) folded before Flop
Seat 3: matiko09 (big blind) folded before Flop
Seat 4: nailz83 folded before Flop (didn't bet)
Seat 6: nickreason17 folded before Flop (didn't bet)
Seat 7: morosun folded before Flop (didn't bet)
Seat 8: $-Twackle-$ folded before Flop
Seat 9: glanza_mike folded before Flop (didn't bet)





PokerStars Hand #150801324843:  Hold'em No Limit ($1/$2 USD) - 2016/03/23 14:28:40 CET [2016/03/23 9:28:40 ET]
Table 'Herba II' 9-max Seat #1 is the button
Seat 1: matiko09 ($209.06 in chips) 
Seat 2: Moszes360 ($225.17 in chips) 
Seat 3: Cirilico ($186.84 in chips) 
Seat 4: DUkalisUA ($200 in chips) 
Seat 5: chippo boy ($206.83 in chips) 
Seat 6: Too-Anti-To ($212.46 in chips) 
Seat 7: InsomniaRU ($406.20 in chips) 
Seat 9: mrhighryza ($59.67 in chips) 
Moszes360: posts small blind $1
Cirilico: posts big blind $2
The_red_area: sits out 
*** HOLE CARDS ***
Dealt to matiko09 [Qs Ac]
DUkalisUA: folds 
chippo boy: calls $2
Too-Anti-To: folds 
InsomniaRU: folds 
mrhighryza: folds 
matiko09: raises $6 to $8
Moszes360: folds 
Cirilico: folds 
chippo boy: calls $6
*** FLOP *** [Tc 3s Ks]
chippo boy: checks 
matiko09: bets $10
chippo boy: folds 
Uncalled bet ($10) returned to matiko09
matiko09 collected $18.14 from pot
matiko09: doesn't show hand 
*** SUMMARY ***
Total pot $19 | Rake $0.86 
Board [Tc 3s Ks]
Seat 1: matiko09 (button) collected ($18.14)
Seat 2: Moszes360 (small blind) folded before Flop
Seat 3: Cirilico (big blind) folded before Flop
Seat 4: DUkalisUA folded before Flop (didn't bet)
Seat 5: chippo boy folded on the Flop
Seat 6: Too-Anti-To folded before Flop (didn't bet)
Seat 7: InsomniaRU folded before Flop (didn't bet)
Seat 9: mrhighryza folded before Flop (didn't bet)





PokerStars Hand #150801332840:  Hold'em No Limit ($1/$2 USD) - 2016/03/23 14:28:52 CET [2016/03/23 9:28:52 ET]
Table 'Kypria II' 9-max Seat #4 is the button
Seat 1: geldwolfje ($157.20 in chips) 
Seat 2: coinflip_si ($216.70 in chips) 
Seat 3: seouljam ($150.13 in chips) 
Seat 4: VolanDog ($200 in chips) 
Seat 5: InsomniaRU ($375.88 in chips) 
Seat 6: matiko09 ($373.95 in chips) 
Seat 7: DUkalisUA ($208 in chips) 
Seat 8: Pearl Jam87 ($200 in chips) 
Seat 9: Moszes360 ($200 in chips) 
InsomniaRU: posts small blind $1
matiko09: posts big blind $2
*** HOLE CARDS ***
Dealt to matiko09 [Ts Kd]
DUkalisUA: folds 
Pearl Jam87: folds 
Moszes360: folds 
geldwolfje: raises $2 to $4
coinflip_si: folds 
seouljam: calls $4
VolanDog: calls $4
InsomniaRU: folds 
matiko09: calls $2
*** FLOP *** [4c Kh Jc]
matiko09: checks 
geldwolfje: checks 
seouljam: checks 
VolanDog: checks 
*** TURN *** [4c Kh Jc] [Jh]
matiko09: checks 
geldwolfje: checks 
seouljam: checks 
VolanDog: checks 
*** RIVER *** [4c Kh Jc Jh] [7h]
matiko09: checks 
geldwolfje: checks 
seouljam: bets $6
VolanDog: raises $16 to $22
matiko09: folds 
geldwolfje: folds 
seouljam: folds 
Uncalled bet ($16) returned to VolanDog
VolanDog collected $27.70 from pot
*** SUMMARY ***
Total pot $29 | Rake $1.30 
Board [4c Kh Jc Jh 7h]
Seat 1: geldwolfje folded on the River
Seat 2: coinflip_si folded before Flop (didn't bet)
Seat 3: seouljam folded on the River
Seat 4: VolanDog (button) collected ($27.70)
Seat 5: InsomniaRU (small blind) folded before Flop
Seat 6: matiko09 (big blind) folded on the River
Seat 7: DUkalisUA folded before Flop (didn't bet)
Seat 8: Pearl Jam87 folded before Flop (didn't bet)
Seat 9: Moszes360 folded before Flop (didn't bet)





PokerStars Hand #150801333782:  Hold'em No Limit ($0.25/$0.50 USD) - 2016/03/23 14:28:54 CET [2016/03/23 9:28:54 ET]
Table 'Pyrrhus' 9-max Seat #4 is the button
Seat 2: alemão007 ($53.21 in chips) 
Seat 3: i L00K great ($50 in chips) 
Seat 4: GriffinBerg ($31.34 in chips) 
Seat 5: ZonTTT ($55.36 in chips) 
Seat 6: Ahangama ($50 in chips) 
Seat 7: matiko09 ($138.38 in chips) 
Seat 8: dndngod ($77.48 in chips) 
Seat 9: CvMCvMCvM ($97.31 in chips) 
ZonTTT: posts small blind $0.25
Ahangama: posts big blind $0.50
*** HOLE CARDS ***
Dealt to matiko09 [Ac 7h]
matiko09: folds 
dndngod: folds 
CvMCvMCvM: folds 
alemão007: folds 
i L00K great: folds 
GriffinBerg: raises $1 to $1.50
ZonTTT: folds 
Ahangama: folds 
Uncalled bet ($1) returned to GriffinBerg
GriffinBerg collected $1.25 from pot
*** SUMMARY ***
Total pot $1.25 | Rake $0 
Seat 2: alemão007 folded before Flop (didn't bet)
Seat 3: i L00K great folded before Flop (didn't bet)
Seat 4: GriffinBerg (button) collected ($1.25)
Seat 5: ZonTTT (small blind) folded before Flop
Seat 6: Ahangama (big blind) folded before Flop
Seat 7: matiko09 folded before Flop (didn't bet)
Seat 8: dndngod folded before Flop (didn't bet)
Seat 9: CvMCvMCvM folded before Flop (didn't bet)





PokerStars Hand #150801340119:  Hold'em No Limit ($0.50/$1.00 USD) - 2016/03/23 14:29:04 CET [2016/03/23 9:29:04 ET]
Table 'Kippes' 9-max Seat #8 is the button
Seat 1: Pvsx. ($209.16 in chips) 
Seat 3: CAJUN890 ($128 in chips) 
Seat 4: matiko09 ($100 in chips) 
Seat 5: Jimy Tiltman ($140.22 in chips) 
Seat 6: DUkalisUA ($111.86 in chips) 
Seat 8: Sherlockplay ($100 in chips) 
Pvsx.: posts small blind $0.50
CAJUN890: posts big blind $1
*** HOLE CARDS ***
Dealt to matiko09 [Qs Ts]
matiko09: folds 
Jimy Tiltman: folds 
DUkalisUA: folds 
Sherlockplay: folds 
Pvsx.: raises $1.50 to $2.50
CAJUN890: folds 
Uncalled bet ($1.50) returned to Pvsx.
Pvsx. collected $2 from pot
Pvsx.: doesn't show hand 
*** SUMMARY ***
Total pot $2 | Rake $0 
Seat 1: Pvsx. (small blind) collected ($2)
Seat 3: CAJUN890 (big blind) folded before Flop
Seat 4: matiko09 folded before Flop (didn't bet)
Seat 5: Jimy Tiltman folded before Flop (didn't bet)
Seat 6: DUkalisUA folded before Flop (didn't bet)
Seat 8: Sherlockplay (button) folded before Flop (didn't bet)





PokerStars Hand #150801343124:  Hold'em No Limit ($0.50/$1.00 USD) - 2016/03/23 14:29:09 CET [2016/03/23 9:29:09 ET]
Table 'Atlantis' 9-max Seat #4 is the button
Seat 1: xHourglass ($153 in chips) 
Seat 2: tffff2006 ($69.72 in chips) 
Seat 3: CAJUN890 ($102.79 in chips) 
Seat 4: matiko09 ($133.25 in chips) 
Seat 5: Pvsx. ($103.25 in chips) 
Seat 6: Jimy Tiltman ($101.78 in chips) 
Seat 7: Sherlockplay ($134.77 in chips) 
Seat 8: DUkalisUA ($102.50 in chips) 
Pvsx.: posts small blind $0.50
Jimy Tiltman: posts big blind $1
*** HOLE CARDS ***
Dealt to matiko09 [Kc 8c]
Sherlockplay: folds 
DUkalisUA: folds 
xHourglass: folds 
tffff2006: folds 
CAJUN890: folds 
matiko09: raises $1.27 to $2.27
Pvsx.: folds 
Jimy Tiltman: raises $6.23 to $8.50
matiko09: calls $6.23
*** FLOP *** [Jc As 4d]
Jimy Tiltman: bets $10
matiko09: folds 
Uncalled bet ($10) returned to Jimy Tiltman
Jimy Tiltman collected $16.71 from pot
Jimy Tiltman: doesn't show hand 
*** SUMMARY ***
Total pot $17.50 | Rake $0.79 
Board [Jc As 4d]
Seat 1: xHourglass folded before Flop (didn't bet)
Seat 2: tffff2006 folded before Flop (didn't bet)
Seat 3: CAJUN890 folded before Flop (didn't bet)
Seat 4: matiko09 (button) folded on the Flop
Seat 5: Pvsx. (small blind) folded before Flop
Seat 6: Jimy Tiltman (big blind) collected ($16.71)
Seat 7: Sherlockplay folded before Flop (didn't bet)
Seat 8: DUkalisUA folded before Flop (didn't bet)





PokerStars Hand #150801345435:  Hold'em No Limit ($0.50/$1.00 USD) - 2016/03/23 14:29:13 CET [2016/03/23 9:29:13 ET]
Table 'Donar II' 9-max Seat #7 is the button
Seat 1: Effort92 ($100.32 in chips) 
Seat 2: nobrunobru1 ($54.24 in chips) 
Seat 3: st-germ30 ($99.69 in chips) 
Seat 4: DUkalisUA ($145.89 in chips) 
Seat 5: matiko09 ($104.27 in chips) 
Seat 6: ardo888 ($133.18 in chips) 
Seat 7: JimineyCrik ($103.22 in chips) 
Seat 8: $-Twackle-$ ($109.85 in chips) 
Seat 9: oxfordtenzin ($124.60 in chips) 
$-Twackle-$: posts small blind $0.50
oxfordtenzin: posts big blind $1
Effort92: posts the ante $0.20
nobrunobru1: posts the ante $0.20
st-germ30: posts the ante $0.20
DUkalisUA: posts the ante $0.20
matiko09: posts the ante $0.20
ardo888: posts the ante $0.20
JimineyCrik: posts the ante $0.20
$-Twackle-$: posts the ante $0.20
oxfordtenzin: posts the ante $0.20
*** HOLE CARDS ***
Dealt to matiko09 [5d Ks]
Effort92: raises $2 to $3
nobrunobru1: folds 
st-germ30: folds 
DUkalisUA: folds 
matiko09: folds 
ardo888: folds 
JimineyCrik: folds 
$-Twackle-$: folds 
oxfordtenzin: folds 
Uncalled bet ($2) returned to Effort92
Effort92 collected $4.30 from pot
Effort92: doesn't show hand 
*** SUMMARY ***
Total pot $4.30 | Rake $0 
Seat 1: Effort92 collected ($4.30)
Seat 2: nobrunobru1 folded before Flop (didn't bet)
Seat 3: st-germ30 folded before Flop (didn't bet)
Seat 4: DUkalisUA folded before Flop (didn't bet)
Seat 5: matiko09 folded before Flop (didn't bet)
Seat 6: ardo888 folded before Flop (didn't bet)
Seat 7: JimineyCrik (button) folded before Flop (didn't bet)
Seat 8: $-Twackle-$ (small blind) folded before Flop
Seat 9: oxfordtenzin (big blind) folded before Flop





PokerStars Hand #150801346847:  Hold'em No Limit ($1/$2 USD) - 2016/03/23 14:29:15 CET [2016/03/23 9:29:15 ET]
Table 'Achaia' 9-max Seat #2 is the button
Seat 1: Moszes360 ($209 in chips) 
Seat 2: InsomniaRU ($217.66 in chips) 
Seat 3: matiko09 ($200 in chips) 
Seat 4: nailz83 ($189.16 in chips) 
Seat 6: nickreason17 ($209.30 in chips) 
Seat 7: morosun ($193.20 in chips) 
Seat 8: $-Twackle-$ ($233.07 in chips) 
Seat 9: glanza_mike ($200 in chips) 
matiko09: posts small blind $1
nailz83: posts big blind $2
chaps1988: sits out 
*** HOLE CARDS ***
Dealt to matiko09 [6h 2h]
nickreason17: folds 
morosun: raises $2 to $4
$-Twackle-$: folds 
glanza_mike: folds 
Moszes360: folds 
InsomniaRU: folds 
matiko09: folds 
nailz83: calls $2
*** FLOP *** [As 2s Jd]
nailz83: checks 
morosun: bets $6
nailz83: calls $6
*** TURN *** [As 2s Jd] [4h]
nailz83: checks 
morosun: checks 
*** RIVER *** [As 2s Jd 4h] [3d]
nailz83: bets $10
morosun: folds 
Uncalled bet ($10) returned to nailz83
nailz83 collected $20.06 from pot
nailz83: doesn't show hand 
*** SUMMARY ***
Total pot $21 | Rake $0.94 
Board [As 2s Jd 4h 3d]
Seat 1: Moszes360 folded before Flop (didn't bet)
Seat 2: InsomniaRU (button) folded before Flop (didn't bet)
Seat 3: matiko09 (small blind) folded before Flop
Seat 4: nailz83 (big blind) collected ($20.06)
Seat 6: nickreason17 folded before Flop (didn't bet)
Seat 7: morosun folded on the River
Seat 8: $-Twackle-$ folded before Flop (didn't bet)
Seat 9: glanza_mike folded before Flop (didn't bet)





PokerStars Hand #150801346825:  Hold'em No Limit ($0.25/$0.50 USD) - 2016/03/23 14:29:15 CET [2016/03/23 9:29:15 ET]
Table 'Pyrrhus' 9-max Seat #5 is the button
Seat 2: alemão007 ($53.21 in chips) 
Seat 3: i L00K great ($50 in chips) 
Seat 4: GriffinBerg ($32.09 in chips) 
Seat 5: ZonTTT ($55.11 in chips) 
Seat 6: Ahangama ($50 in chips) 
Seat 7: matiko09 ($138.38 in chips) 
Seat 8: dndngod ($77.48 in chips) 
Seat 9: CvMCvMCvM ($97.31 in chips) 
Ahangama: posts small blind $0.25
matiko09: posts big blind $0.50
*** HOLE CARDS ***
Dealt to matiko09 [7c 8s]
dndngod: folds 
CvMCvMCvM: folds 
alemão007: folds 
i L00K great: folds 
GriffinBerg: folds 
ZonTTT: folds 
Ahangama: folds 
Uncalled bet ($0.25) returned to matiko09
matiko09 collected $0.50 from pot
matiko09: doesn't show hand 
*** SUMMARY ***
Total pot $0.50 | Rake $0 
Seat 2: alemão007 folded before Flop (didn't bet)
Seat 3: i L00K great folded before Flop (didn't bet)
Seat 4: GriffinBerg folded before Flop (didn't bet)
Seat 5: ZonTTT (button) folded before Flop (didn't bet)
Seat 6: Ahangama (small blind) folded before Flop
Seat 7: matiko09 (big blind) collected ($0.50)
Seat 8: dndngod folded before Flop (didn't bet)
Seat 9: CvMCvMCvM folded before Flop (didn't bet)





PokerStars Hand #150801347065:  Hold'em No Limit (€0.50/€1.00 EUR) - 2016/03/23 14:29:15 CET [2016/03/23 9:29:15 ET]
Table 'Lanzia' 9-max Seat #1 is the button
Seat 1: fk154 (€31.75 in chips) 
Seat 2: ardo888 (€100.50 in chips) 
Seat 3: Effort92 (€196.81 in chips) 
Seat 5: matiko09 (€175.23 in chips) 
Seat 6: Red4erT (€40 in chips) 
Seat 7: $-Twackle-$ (€133 in chips) 
Seat 8: Muinmyheart (€102 in chips) 
Seat 9: Butcher1848 (€103.87 in chips) 
ardo888: posts small blind €0.50
Effort92: posts big blind €1
*** HOLE CARDS ***
Dealt to matiko09 [9s 6h]
matiko09: folds 
Red4erT: folds 
niong62 leaves the table
volwebni4ek joins the table at seat #4 
$-Twackle-$: folds 
Muinmyheart: folds 
Butcher1848: folds 
fk154: folds 
ardo888: folds 
Uncalled bet (€0.50) returned to Effort92
Effort92 collected €1 from pot
Effort92: doesn't show hand 
*** SUMMARY ***
Total pot €1 | Rake €0 
Seat 1: fk154 (button) folded before Flop (didn't bet)
Seat 2: ardo888 (small blind) folded before Flop
Seat 3: Effort92 (big blind) collected (€1)
Seat 5: matiko09 folded before Flop (didn't bet)
Seat 6: Red4erT folded before Flop (didn't bet)
Seat 7: $-Twackle-$ folded before Flop (didn't bet)
Seat 8: Muinmyheart folded before Flop (didn't bet)
Seat 9: Butcher1848 folded before Flop (didn't bet)





PokerStars Hand #150801347290:  Hold'em No Limit ($1/$2 USD) - 2016/03/23 14:29:16 CET [2016/03/23 9:29:16 ET]
Table 'Ennomos II' 9-max Seat #5 is the button
Seat 1: ilaviiitech ($200 in chips) 
Seat 2: Subam ($443.38 in chips) 
Seat 3: $-Twackle-$ ($231.20 in chips) 
Seat 4: glanza_mike ($200 in chips) 
Seat 5: South011 ($381.88 in chips) 
Seat 6: nickreason17 ($233.40 in chips) 
Seat 8: yyfk ($207.24 in chips) 
Seat 9: matiko09 ($200 in chips) 
nickreason17: posts small blind $1
yyfk: posts big blind $2
*** HOLE CARDS ***
Dealt to matiko09 [6c 3c]
matiko09: folds 
ilaviiitech: folds 
Subam: folds 
$-Twackle-$: folds 
glanza_mike: raises $4 to $6
South011: calls $6
nickreason17: folds 
yyfk: calls $4
*** FLOP *** [Jd Jc Ad]
yyfk: checks 
glanza_mike: checks 
South011: checks 
*** TURN *** [Jd Jc Ad] [Qc]
yyfk: checks 
glanza_mike: checks 
South011: checks 
*** RIVER *** [Jd Jc Ad Qc] [Js]
yyfk: checks 
glanza_mike: checks 
South011: checks 
*** SHOW DOWN ***
yyfk: shows [Th 6h] (three of a kind, Jacks)
glanza_mike: shows [8h Kh] (three of a kind, Jacks - Ace+King kicker)
South011: shows [6d 6s] (a full house, Jacks full of Sixes)
South011 collected $18.14 from pot
*** SUMMARY ***
Total pot $19 | Rake $0.86 
Board [Jd Jc Ad Qc Js]
Seat 1: ilaviiitech folded before Flop (didn't bet)
Seat 2: Subam folded before Flop (didn't bet)
Seat 3: $-Twackle-$ folded before Flop (didn't bet)
Seat 4: glanza_mike showed [8h Kh] and lost with three of a kind, Jacks
Seat 5: South011 (button) showed [6d 6s] and won ($18.14) with a full house, Jacks full of Sixes
Seat 6: nickreason17 (small blind) folded before Flop
Seat 8: yyfk (big blind) showed [Th 6h] and lost with three of a kind, Jacks
Seat 9: matiko09 folded before Flop (didn't bet)





PokerStars Hand #150801349281:  Hold'em No Limit ($0.50/$1.00 USD) - 2016/03/23 14:29:19 CET [2016/03/23 9:29:19 ET]
Table 'Swings' 9-max Seat #4 is the button
Seat 1: Sherlockplay ($100 in chips) 
Seat 2: Harbinger X ($92.79 in chips) 
Seat 3: maxxmeister ($100 in chips) 
Seat 4: chaps1988 ($100 in chips) 
Seat 5: chautinhtri9 ($100.50 in chips) 
Seat 6: matiko09 ($101.50 in chips) 
Seat 7: nickreason17 ($101.50 in chips) 
Seat 9: Vlad_1965_77 ($102.50 in chips) 
chautinhtri9: posts small blind $0.50
matiko09: posts big blind $1
*** HOLE CARDS ***
Dealt to matiko09 [4c Tc]
nickreason17: folds 
Vlad_1965_77: raises $2 to $3
Sherlockplay: folds 
Harbinger X: calls $3
maxxmeister: folds 
chaps1988: folds 
chautinhtri9: calls $2.50
matiko09: folds 
*** FLOP *** [Ts 6s Kd]
chautinhtri9: checks 
Vlad_1965_77: bets $9.55
Harbinger X: folds 
chautinhtri9: folds 
Uncalled bet ($9.55) returned to Vlad_1965_77
Vlad_1965_77 collected $9.55 from pot
*** SUMMARY ***
Total pot $10 | Rake $0.45 
Board [Ts 6s Kd]
Seat 1: Sherlockplay folded before Flop (didn't bet)
Seat 2: Harbinger X folded on the Flop
Seat 3: maxxmeister folded before Flop (didn't bet)
Seat 4: chaps1988 (button) folded before Flop (didn't bet)
Seat 5: chautinhtri9 (small blind) folded on the Flop
Seat 6: matiko09 (big blind) folded before Flop
Seat 7: nickreason17 folded before Flop (didn't bet)
Seat 9: Vlad_1965_77 collected ($9.55)





PokerStars Hand #150801350715:  Hold'em No Limit ($0.50/$1.00 USD) - 2016/03/23 14:29:21 CET [2016/03/23 9:29:21 ET]
Table 'Kippes' 9-max Seat #1 is the button
Seat 1: Pvsx. ($210.16 in chips) 
Seat 3: CAJUN890 ($127 in chips) 
Seat 4: matiko09 ($100 in chips) 
Seat 5: Jimy Tiltman ($140.22 in chips) 
Seat 6: DUkalisUA ($111.86 in chips) 
Seat 8: Sherlockplay ($100 in chips) 
CAJUN890: posts small blind $0.50
matiko09: posts big blind $1
*** HOLE CARDS ***
Dealt to matiko09 [Th 8h]
Jimy Tiltman: raises $2 to $3
DUkalisUA: raises $6.50 to $9.50
Sherlockplay: folds 
Pvsx.: folds 
CAJUN890: folds 
matiko09: folds 
Jimy Tiltman: calls $6.50
*** FLOP *** [6d 9h Qd]
Jimy Tiltman: checks 
DUkalisUA: bets $12.92
Jimy Tiltman: folds 
Uncalled bet ($12.92) returned to DUkalisUA
DUkalisUA collected $19.58 from pot
DUkalisUA: doesn't show hand 
*** SUMMARY ***
Total pot $20.50 | Rake $0.92 
Board [6d 9h Qd]
Seat 1: Pvsx. (button) folded before Flop (didn't bet)
Seat 3: CAJUN890 (small blind) folded before Flop
Seat 4: matiko09 (big blind) folded before Flop
Seat 5: Jimy Tiltman folded on the Flop
Seat 6: DUkalisUA collected ($19.58)
Seat 8: Sherlockplay folded before Flop (didn't bet)





PokerStars Hand #150801357464:  Hold'em No Limit ($1/$2 USD) - 2016/03/23 14:29:32 CET [2016/03/23 9:29:32 ET]
Table 'Kiess' 9-max Seat #6 is the button
Seat 1: Cirilico ($229.74 in chips) 
Seat 2: DUkalisUA ($671.10 in chips) 
Seat 4: Moszes360 ($200 in chips) 
Seat 5: chippo boy ($448.96 in chips) 
Seat 6: matiko09 ($279.36 in chips) 
Seat 7: InsomniaRU ($307.97 in chips) 
Seat 8: erfk1958 ($107.13 in chips) 
Seat 9: T0ny Adams ($80 in chips) 
InsomniaRU: posts small blind $1
erfk1958: posts big blind $2
The_red_area: sits out 
*** HOLE CARDS ***
Dealt to matiko09 [3d 4c]
T0ny Adams: folds 
Cirilico: raises $4 to $6
DUkalisUA: folds 
Moszes360: folds 
chippo boy: folds 
matiko09: folds 
InsomniaRU: folds 
erfk1958: folds 
Uncalled bet ($4) returned to Cirilico
Cirilico collected $5 from pot
Cirilico: doesn't show hand 
*** SUMMARY ***
Total pot $5 | Rake $0 
Seat 1: Cirilico collected ($5)
Seat 2: DUkalisUA folded before Flop (didn't bet)
Seat 4: Moszes360 folded before Flop (didn't bet)
Seat 5: chippo boy folded before Flop (didn't bet)
Seat 6: matiko09 (button) folded before Flop (didn't bet)
Seat 7: InsomniaRU (small blind) folded before Flop
Seat 8: erfk1958 (big blind) folded before Flop
Seat 9: T0ny Adams folded before Flop (didn't bet)





PokerStars Hand #150801357197:  Hold'em No Limit ($1/$2 USD) - 2016/03/23 14:29:32 CET [2016/03/23 9:29:32 ET]
Table 'Herba II' 9-max Seat #2 is the button
Seat 1: matiko09 ($219.20 in chips) 
Seat 2: Moszes360 ($224.17 in chips) 
Seat 3: Cirilico ($184.84 in chips) 
Seat 4: DUkalisUA ($200 in chips) 
Seat 5: chippo boy ($198.83 in chips) 
Seat 6: Too-Anti-To ($212.46 in chips) 
Seat 7: InsomniaRU ($406.20 in chips) 
Seat 9: mrhighryza ($59.67 in chips) 
Cirilico: posts small blind $1
DUkalisUA: posts big blind $2
The_red_area: sits out 
*** HOLE CARDS ***
Dealt to matiko09 [Qh 4s]
chippo boy: folds 
Too-Anti-To: folds 
InsomniaRU: folds 
mrhighryza: folds 
matiko09: folds 
Moszes360: folds 
Cirilico: folds 
Uncalled bet ($1) returned to DUkalisUA
DUkalisUA collected $2 from pot
DUkalisUA: doesn't show hand 
*** SUMMARY ***
Total pot $2 | Rake $0 
Seat 1: matiko09 folded before Flop (didn't bet)
Seat 2: Moszes360 (button) folded before Flop (didn't bet)
Seat 3: Cirilico (small blind) folded before Flop
Seat 4: DUkalisUA (big blind) collected ($2)
Seat 5: chippo boy folded before Flop (didn't bet)
Seat 6: Too-Anti-To folded before Flop (didn't bet)
Seat 7: InsomniaRU folded before Flop (didn't bet)
Seat 9: mrhighryza folded before Flop (didn't bet)





