PokerStars Hand #149391561310:  Hold'em No Limit ($0.50/$1.00 USD) - 2016/02/25 16:30:02 CET [2016/02/25 10:30:02 ET]
Table 'Eros II' 9-max Seat #8 is the button
Seat 1: sebaaastian ($101.50 in chips) 
Seat 2: Sweden_Pound ($108 in chips) 
Seat 3: niong62 ($77.50 in chips) 
Seat 5: lysandrafly ($100 in chips) 
Seat 6: el Fatto ($104.23 in chips) 
Seat 7: xAndorx ($122.84 in chips) 
Seat 8: matiko09 ($100 in chips) 
Seat 9: b_____a__242 ($79.89 in chips) 
b_____a__242: posts small blind $0.50
sebaaastian: posts big blind $1
hammerwife: sits out 
*** HOLE CARDS ***
Dealt to matiko09 [7c Jh]
Sweden_Pound has timed out
Sweden_Pound: folds 
niong62: raises $1 to $2
lysandrafly: folds 
el Fatto: folds 
xAndorx: folds 
matiko09: folds 
b_____a__242: folds 
sebaaastian: folds 
Uncalled bet ($1) returned to niong62
niong62 collected $2.50 from pot
*** SUMMARY ***
Total pot $2.50 | Rake $0 
Seat 1: sebaaastian (big blind) folded before Flop
Seat 2: Sweden_Pound folded before Flop (didn't bet)
Seat 3: niong62 collected ($2.50)
Seat 5: lysandrafly folded before Flop (didn't bet)
Seat 6: el Fatto folded before Flop (didn't bet)
Seat 7: xAndorx folded before Flop (didn't bet)
Seat 8: matiko09 (button) folded before Flop (didn't bet)
Seat 9: b_____a__242 (small blind) folded before Flop





PokerStars Hand #149391564669:  Hold'em No Limit (€0.25/€0.50 EUR) - 2016/02/25 16:30:06 CET [2016/02/25 10:30:06 ET]
Table 'Leo Minor III' 9-max Seat #8 is the button
Seat 1: Al3xAnd3r22 (€50 in chips) 
Seat 3: Rorerzap (€50 in chips) 
Seat 4: RvPersie (€60.83 in chips) 
Seat 5: kasse_62 (€32.06 in chips) 
Seat 6: Wwwasian (€54.04 in chips) 
Seat 7: Apparat888 (€30.51 in chips) 
Seat 8: mi$$I$Elena (€90.15 in chips) 
Seat 9: matiko09 (€50.25 in chips) 
matiko09: posts small blind €0.25
Al3xAnd3r22: posts big blind €0.50
vasiy379: sits out 
*** HOLE CARDS ***
Dealt to matiko09 [8d Qh]
Rorerzap: folds 
RvPersie: folds 
kasse_62: folds 
Wwwasian: folds 
Apparat888: folds 
mi$$I$Elena: raises €0.75 to €1.25
matiko09: folds 
Al3xAnd3r22: raises €3.75 to €5
mi$$I$Elena: folds 
Uncalled bet (€3.75) returned to Al3xAnd3r22
Al3xAnd3r22 collected €2.75 from pot
Al3xAnd3r22: doesn't show hand 
*** SUMMARY ***
Total pot €2.75 | Rake €0 
Seat 1: Al3xAnd3r22 (big blind) collected (€2.75)
Seat 3: Rorerzap folded before Flop (didn't bet)
Seat 4: RvPersie folded before Flop (didn't bet)
Seat 5: kasse_62 folded before Flop (didn't bet)
Seat 6: Wwwasian folded before Flop (didn't bet)
Seat 7: Apparat888 folded before Flop (didn't bet)
Seat 8: mi$$I$Elena (button) folded before Flop
Seat 9: matiko09 (small blind) folded before Flop





PokerStars Hand #149391569682:  Hold'em No Limit ($0.50/$1.00 USD) - 2016/02/25 16:30:13 CET [2016/02/25 10:30:13 ET]
Table 'Kleopatra II' 9-max Seat #2 is the button
Seat 1: wsg86 ($100 in chips) 
Seat 2: mycka86 ($100 in chips) 
Seat 3: Monsthand ($129.78 in chips) 
Seat 4: Joe_Carlos ($40 in chips) 
Seat 5: apfush ($100 in chips) 
Seat 6: pardama ($171.56 in chips) 
Seat 7: RMilPoker ($100.70 in chips) 
Seat 8: Lesley2002 ($123.44 in chips) 
Seat 9: matiko09 ($131.44 in chips) 
Monsthand: posts small blind $0.50
Joe_Carlos: posts big blind $1
*** HOLE CARDS ***
Dealt to matiko09 [5h Th]
apfush: folds 
pardama: folds 
RMilPoker: folds 
Lesley2002: folds 
matiko09: folds 
wsg86: folds 
mycka86: folds 
Monsthand: raises $1.50 to $2.50
Joe_Carlos: folds 
Uncalled bet ($1.50) returned to Monsthand
Monsthand collected $2 from pot
*** SUMMARY ***
Total pot $2 | Rake $0 
Seat 1: wsg86 folded before Flop (didn't bet)
Seat 2: mycka86 (button) folded before Flop (didn't bet)
Seat 3: Monsthand (small blind) collected ($2)
Seat 4: Joe_Carlos (big blind) folded before Flop
Seat 5: apfush folded before Flop (didn't bet)
Seat 6: pardama folded before Flop (didn't bet)
Seat 7: RMilPoker folded before Flop (didn't bet)
Seat 8: Lesley2002 folded before Flop (didn't bet)
Seat 9: matiko09 folded before Flop (didn't bet)





PokerStars Hand #149391578216:  Hold'em No Limit ($0.50/$1.00 USD) - 2016/02/25 16:30:25 CET [2016/02/25 10:30:25 ET]
Table 'Lina II' 9-max Seat #9 is the button
Seat 1: Lesley2002 ($176.04 in chips) 
Seat 2: matiko09 ($100 in chips) 
Seat 4: Nennenurse ($59.63 in chips) 
Seat 6: Lujan87 ($100 in chips) 
Seat 7: Monsthand ($152.30 in chips) 
Seat 9: Sweden_Pound ($253.02 in chips) 
Lesley2002: posts small blind $0.50
matiko09: posts big blind $1
swizzly58: sits out 
djammusic: sits out 
*** HOLE CARDS ***
Dealt to matiko09 [Qs 4d]
Nennenurse: folds 
Lujan87: raises $2 to $3
Monsthand: raises $6 to $9
Sweden_Pound: raises $13 to $22
Lesley2002: folds 
matiko09: folds 
Lujan87: folds 
Monsthand: folds 
Uncalled bet ($13) returned to Sweden_Pound
Sweden_Pound collected $22.50 from pot
Sweden_Pound: doesn't show hand 
*** SUMMARY ***
Total pot $22.50 | Rake $0 
Seat 1: Lesley2002 (small blind) folded before Flop
Seat 2: matiko09 (big blind) folded before Flop
Seat 4: Nennenurse folded before Flop (didn't bet)
Seat 6: Lujan87 folded before Flop
Seat 7: Monsthand folded before Flop
Seat 9: Sweden_Pound (button) collected ($22.50)





PokerStars Hand #149391581118:  Hold'em No Limit ($0.50/$1.00 USD) - 2016/02/25 16:30:29 CET [2016/02/25 10:30:29 ET]
Table 'Zeuxo II' 9-max Seat #5 is the button
Seat 1: b_____a__242 ($197.70 in chips) 
Seat 2: Sweden_Pound ($102.75 in chips) 
Seat 3: xAndorx ($100 in chips) 
Seat 4: sebaaastian ($123.61 in chips) 
Seat 5: bauss84 ($32.45 in chips) 
Seat 6: Cogss ($91 in chips) 
Seat 7: djammusic ($37.53 in chips) 
Seat 8: matiko09 ($100 in chips) 
Seat 9: Sreshta222 ($212.13 in chips) 
Cogss: posts small blind $0.50
djammusic: posts big blind $1
*** HOLE CARDS ***
Dealt to matiko09 [8h 5c]
matiko09: folds 
Sreshta222: folds 
b_____a__242: raises $2 to $3
Sweden_Pound: folds 
xAndorx: folds 
sebaaastian: folds 
bauss84: calls $3
Cogss: calls $2.50
djammusic: folds 
*** FLOP *** [8d Tc 7c]
Cogss: bets $9.55
b_____a__242: folds 
bauss84: folds 
Uncalled bet ($9.55) returned to Cogss
Cogss collected $9.55 from pot
*** SUMMARY ***
Total pot $10 | Rake $0.45 
Board [8d Tc 7c]
Seat 1: b_____a__242 folded on the Flop
Seat 2: Sweden_Pound folded before Flop (didn't bet)
Seat 3: xAndorx folded before Flop (didn't bet)
Seat 4: sebaaastian folded before Flop (didn't bet)
Seat 5: bauss84 (button) folded on the Flop
Seat 6: Cogss (small blind) collected ($9.55)
Seat 7: djammusic (big blind) folded before Flop
Seat 8: matiko09 folded before Flop (didn't bet)
Seat 9: Sreshta222 folded before Flop (didn't bet)





PokerStars Hand #149391586962:  Hold'em No Limit ($0.50/$1.00 USD) - 2016/02/25 16:30:36 CET [2016/02/25 10:30:36 ET]
Table 'Euphemia II' 9-max Seat #3 is the button
Seat 1: pardama ($198.20 in chips) 
Seat 2: Venomous100% ($100 in chips) 
Seat 3: Mukhin1 ($100 in chips) 
Seat 4: Lahesell ($100 in chips) 
Seat 5: HomerrrJay ($100 in chips) 
Seat 6: Ty Nick 420 ($100 in chips) 
Seat 7: Sweden_Pound ($100 in chips) 
Seat 8: sreichma ($101.50 in chips) 
Seat 9: matiko09 ($100 in chips) 
Lahesell: posts small blind $0.50
HomerrrJay: posts big blind $1
*** HOLE CARDS ***
Dealt to matiko09 [5s Qs]
Ty Nick 420: raises $1.50 to $2.50
Sweden_Pound: folds 
sreichma: folds 
matiko09: folds 
pardama: folds 
Venomous100%: folds 
Mukhin1: folds 
Lahesell: folds 
HomerrrJay: folds 
Uncalled bet ($1.50) returned to Ty Nick 420
Ty Nick 420 collected $2.50 from pot
*** SUMMARY ***
Total pot $2.50 | Rake $0 
Seat 1: pardama folded before Flop (didn't bet)
Seat 2: Venomous100% folded before Flop (didn't bet)
Seat 3: Mukhin1 (button) folded before Flop (didn't bet)
Seat 4: Lahesell (small blind) folded before Flop
Seat 5: HomerrrJay (big blind) folded before Flop
Seat 6: Ty Nick 420 collected ($2.50)
Seat 7: Sweden_Pound folded before Flop (didn't bet)
Seat 8: sreichma folded before Flop (didn't bet)
Seat 9: matiko09 folded before Flop (didn't bet)





PokerStars Hand #149391589645:  Hold'em No Limit ($0.50/$1.00 USD) - 2016/02/25 16:30:40 CET [2016/02/25 10:30:40 ET]
Table 'Eros II' 9-max Seat #9 is the button
Seat 1: sebaaastian ($100.50 in chips) 
Seat 2: Sweden_Pound ($108 in chips) 
Seat 3: niong62 ($79 in chips) 
Seat 5: lysandrafly ($100 in chips) 
Seat 6: el Fatto ($104.23 in chips) 
Seat 7: xAndorx ($122.84 in chips) 
Seat 8: matiko09 ($100 in chips) 
Seat 9: b_____a__242 ($79.39 in chips) 
sebaaastian: posts small blind $0.50
Sweden_Pound: posts big blind $1
hammerwife: sits out 
*** HOLE CARDS ***
Dealt to matiko09 [2h 6s]
niong62: folds 
lysandrafly: folds 
el Fatto: folds 
xAndorx: raises $2 to $3
matiko09: folds 
b_____a__242: folds 
sebaaastian: folds 
Sweden_Pound: folds 
Uncalled bet ($2) returned to xAndorx
xAndorx collected $2.50 from pot
xAndorx: doesn't show hand 
*** SUMMARY ***
Total pot $2.50 | Rake $0 
Seat 1: sebaaastian (small blind) folded before Flop
Seat 2: Sweden_Pound (big blind) folded before Flop
Seat 3: niong62 folded before Flop (didn't bet)
Seat 5: lysandrafly folded before Flop (didn't bet)
Seat 6: el Fatto folded before Flop (didn't bet)
Seat 7: xAndorx collected ($2.50)
Seat 8: matiko09 folded before Flop (didn't bet)
Seat 9: b_____a__242 (button) folded before Flop (didn't bet)





PokerStars Hand #149391597916:  Hold'em No Limit (€0.25/€0.50 EUR) - 2016/02/25 16:30:51 CET [2016/02/25 10:30:51 ET]
Table 'Leo Minor III' 9-max Seat #9 is the button
Seat 1: Al3xAnd3r22 (€51.50 in chips) 
Seat 2: vasiy379 (€50 in chips) 
Seat 3: Rorerzap (€50 in chips) 
Seat 4: RvPersie (€60.83 in chips) 
Seat 5: kasse_62 (€32.06 in chips) 
Seat 6: Wwwasian (€54.04 in chips) 
Seat 7: Apparat888 (€30.51 in chips) 
Seat 8: mi$$I$Elena (€88.90 in chips) 
Seat 9: matiko09 (€50 in chips) 
Al3xAnd3r22: posts small blind €0.25
vasiy379: posts big blind €0.50
*** HOLE CARDS ***
Dealt to matiko09 [Jd 7c]
Rorerzap: folds 
RvPersie: folds 
kasse_62: folds 
Wwwasian: folds 
Apparat888: raises €1 to €1.50
mi$$I$Elena: raises €3 to €4.50
matiko09: folds 
Al3xAnd3r22: folds 
vasiy379: folds 
Apparat888: folds 
Uncalled bet (€3) returned to mi$$I$Elena
mi$$I$Elena collected €3.75 from pot
mi$$I$Elena: doesn't show hand 
*** SUMMARY ***
Total pot €3.75 | Rake €0 
Seat 1: Al3xAnd3r22 (small blind) folded before Flop
Seat 2: vasiy379 (big blind) folded before Flop
Seat 3: Rorerzap folded before Flop (didn't bet)
Seat 4: RvPersie folded before Flop (didn't bet)
Seat 5: kasse_62 folded before Flop (didn't bet)
Seat 6: Wwwasian folded before Flop (didn't bet)
Seat 7: Apparat888 folded before Flop
Seat 8: mi$$I$Elena collected (€3.75)
Seat 9: matiko09 (button) folded before Flop (didn't bet)





PokerStars Hand #149391600823:  Hold'em No Limit ($0.50/$1.00 USD) - 2016/02/25 16:30:55 CET [2016/02/25 10:30:55 ET]
Table 'Kleopatra II' 9-max Seat #3 is the button
Seat 1: wsg86 ($100 in chips) 
Seat 2: mycka86 ($100 in chips) 
Seat 3: Monsthand ($130.78 in chips) 
Seat 4: Joe_Carlos ($39 in chips) 
Seat 5: apfush ($100 in chips) 
Seat 6: pardama ($171.56 in chips) 
Seat 7: RMilPoker ($100.70 in chips) 
Seat 8: Lesley2002 ($123.44 in chips) 
Seat 9: matiko09 ($131.44 in chips) 
Joe_Carlos: posts small blind $0.50
apfush: posts big blind $1
*** HOLE CARDS ***
Dealt to matiko09 [8s 9s]
pardama: folds 
RMilPoker: folds 
pardama leaves the table
Lesley2002: raises $2 to $3
Aalleekks joins the table at seat #6 
Aalleekks leaves the table
matiko09: calls $3
wsg86: folds 
mycka86: folds 
Sweden_Pound joins the table at seat #6 
Monsthand: raises $8.50 to $11.50
Joe_Carlos: folds 
apfush: folds 
Lesley2002: calls $8.50
matiko09: calls $8.50
*** FLOP *** [4s 9c Ks]
Lesley2002: checks 
matiko09: checks 
Monsthand: bets $14.50
Lesley2002: folds 
matiko09: calls $14.50
*** TURN *** [4s 9c Ks] [7s]
matiko09: checks 
Monsthand: checks 
*** RIVER *** [4s 9c Ks 7s] [4c]
matiko09: bets $32.34
Monsthand: calls $32.34
*** SHOW DOWN ***
matiko09: shows [8s 9s] (a flush, King high)
Monsthand: shows [4d 7d] (a full house, Fours full of Sevens)
Monsthand collected $126.88 from pot
*** SUMMARY ***
Total pot $129.68 | Rake $2.80 
Board [4s 9c Ks 7s 4c]
Seat 1: wsg86 folded before Flop (didn't bet)
Seat 2: mycka86 folded before Flop (didn't bet)
Seat 3: Monsthand (button) showed [4d 7d] and won ($126.88) with a full house, Fours full of Sevens
Seat 4: Joe_Carlos (small blind) folded before Flop
Seat 5: apfush (big blind) folded before Flop
Seat 6: pardama folded before Flop (didn't bet)
Seat 7: RMilPoker folded before Flop (didn't bet)
Seat 8: Lesley2002 folded on the Flop
Seat 9: matiko09 showed [8s 9s] and lost with a flush, King high





PokerStars Hand #149391607605:  Hold'em No Limit ($0.50/$1.00 USD) - 2016/02/25 16:31:04 CET [2016/02/25 10:31:04 ET]
Table 'Simona' 9-max Seat #1 is the button
Seat 1: mycka86 ($114.21 in chips) 
Seat 2: xAndorx ($109.53 in chips) 
Seat 3: Sweden_Pound ($100 in chips) 
Seat 4: matiko09 ($280.42 in chips) 
Seat 5: sebaaastian ($100 in chips) 
Seat 6: Ty Nick 420 ($106 in chips) 
Seat 7: Aalleekks ($102.30 in chips) 
Seat 8: Monsthand ($133.26 in chips) 
Seat 9: Slushpup69 ($50.97 in chips) 
xAndorx: posts small blind $0.50
Sweden_Pound: posts big blind $1
*** HOLE CARDS ***
Dealt to matiko09 [Ad 3h]
matiko09: folds 
sebaaastian: folds 
Ty Nick 420: folds 
Aalleekks: raises $2 to $3
Monsthand: folds 
Slushpup69: folds 
mycka86: folds 
xAndorx: folds 
Sweden_Pound: folds 
Uncalled bet ($2) returned to Aalleekks
Aalleekks collected $2.50 from pot
Aalleekks: doesn't show hand 
*** SUMMARY ***
Total pot $2.50 | Rake $0 
Seat 1: mycka86 (button) folded before Flop (didn't bet)
Seat 2: xAndorx (small blind) folded before Flop
Seat 3: Sweden_Pound (big blind) folded before Flop
Seat 4: matiko09 folded before Flop (didn't bet)
Seat 5: sebaaastian folded before Flop (didn't bet)
Seat 6: Ty Nick 420 folded before Flop (didn't bet)
Seat 7: Aalleekks collected ($2.50)
Seat 8: Monsthand folded before Flop (didn't bet)
Seat 9: Slushpup69 folded before Flop (didn't bet)





PokerStars Hand #149391607869:  Hold'em No Limit ($0.50/$1.00 USD) - 2016/02/25 16:31:04 CET [2016/02/25 10:31:04 ET]
Table 'Lucia III' 9-max Seat #6 is the button
Seat 1: Monsthand ($125.45 in chips) 
Seat 2: kuanhung0903 ($78.50 in chips) 
Seat 3: mycka86 ($107.12 in chips) 
Seat 4: swatek1986 ($133.09 in chips) 
Seat 5: Sweden_Pound ($202.07 in chips) 
Seat 6: matiko09 ($109.23 in chips) 
Seat 7: Ty Nick 420 ($201.52 in chips) 
Seat 8: apfush ($100 in chips) 
Seat 9: Apparat888 ($38.45 in chips) 
Ty Nick 420: posts small blind $0.50
apfush: posts big blind $1
*** HOLE CARDS ***
Dealt to matiko09 [5d Jd]
Apparat888: folds 
Monsthand: folds 
kuanhung0903: calls $1
mycka86: raises $3.50 to $4.50
swatek1986: folds 
Sweden_Pound: folds 
matiko09: folds 
Ty Nick 420: folds 
apfush: folds 
kuanhung0903: folds 
Uncalled bet ($3.50) returned to mycka86
mycka86 collected $3.50 from pot
*** SUMMARY ***
Total pot $3.50 | Rake $0 
Seat 1: Monsthand folded before Flop (didn't bet)
Seat 2: kuanhung0903 folded before Flop
Seat 3: mycka86 collected ($3.50)
Seat 4: swatek1986 folded before Flop (didn't bet)
Seat 5: Sweden_Pound folded before Flop (didn't bet)
Seat 6: matiko09 (button) folded before Flop (didn't bet)
Seat 7: Ty Nick 420 (small blind) folded before Flop
Seat 8: apfush (big blind) folded before Flop
Seat 9: Apparat888 folded before Flop (didn't bet)





PokerStars Hand #149391612077:  Hold'em No Limit ($0.25/$0.50 USD) - 2016/02/25 16:31:10 CET [2016/02/25 10:31:10 ET]
Table 'Thalpius III' 9-max Seat #1 is the button
Seat 1: BrotherLove9 ($53.60 in chips) 
Seat 2: matiko09 ($55.14 in chips) 
Seat 3: jamba83 ($53.81 in chips) 
Seat 4: Wwwasian ($50 in chips) 
Seat 5: Rorerzap ($55.52 in chips) 
Seat 6: Brobarian89 ($63.40 in chips) 
Seat 7: v4n0v ($50 in chips) 
Seat 8: jeroemie123 ($47.56 in chips) 
Seat 9: Gemb1rdd ($65.93 in chips) 
matiko09: posts small blind $0.25
jamba83: posts big blind $0.50
*** HOLE CARDS ***
Dealt to matiko09 [8s 7h]
Wwwasian has timed out
Wwwasian: folds 
Rorerzap: folds 
Brobarian89: folds 
Brobarian89 leaves the table
v4n0v: folds 
jeroemie123: folds 
Domotirko228 joins the table at seat #6 
Gemb1rdd: raises $0.75 to $1.25
Domotirko228 leaves the table
mi$$I$Elena joins the table at seat #6 
mi$$I$Elena leaves the table
BrotherLove9: folds 
rdrill joins the table at seat #6 
matiko09: folds 
jamba83: folds 
Uncalled bet ($0.75) returned to Gemb1rdd
Gemb1rdd collected $1.25 from pot
Gemb1rdd: doesn't show hand 
*** SUMMARY ***
Total pot $1.25 | Rake $0 
Seat 1: BrotherLove9 (button) folded before Flop (didn't bet)
Seat 2: matiko09 (small blind) folded before Flop
Seat 3: jamba83 (big blind) folded before Flop
Seat 4: Wwwasian folded before Flop (didn't bet)
Seat 5: Rorerzap folded before Flop (didn't bet)
Seat 6: Brobarian89 folded before Flop (didn't bet)
Seat 7: v4n0v folded before Flop (didn't bet)
Seat 8: jeroemie123 folded before Flop (didn't bet)
Seat 9: Gemb1rdd collected ($1.25)





PokerStars Hand #149391613460:  Hold'em No Limit ($0.50/$1.00 USD) - 2016/02/25 16:31:12 CET [2016/02/25 10:31:12 ET]
Table 'Eros II' 9-max Seat #1 is the button
Seat 1: sebaaastian ($100 in chips) 
Seat 2: Sweden_Pound ($107 in chips) 
Seat 3: niong62 ($79 in chips) 
Seat 5: lysandrafly ($100 in chips) 
Seat 6: el Fatto ($104.23 in chips) 
Seat 7: xAndorx ($124.34 in chips) 
Seat 8: matiko09 ($100 in chips) 
Seat 9: b_____a__242 ($79.39 in chips) 
Sweden_Pound: posts small blind $0.50
niong62: posts big blind $1
hammerwife: sits out 
*** HOLE CARDS ***
Dealt to matiko09 [7c 3h]
lysandrafly: folds 
el Fatto: folds 
xAndorx: raises $2 to $3
matiko09: folds 
b_____a__242: folds 
sebaaastian: folds 
Sweden_Pound: folds 
niong62: folds 
Uncalled bet ($2) returned to xAndorx
xAndorx collected $2.50 from pot
xAndorx: doesn't show hand 
*** SUMMARY ***
Total pot $2.50 | Rake $0 
Seat 1: sebaaastian (button) folded before Flop (didn't bet)
Seat 2: Sweden_Pound (small blind) folded before Flop
Seat 3: niong62 (big blind) folded before Flop
Seat 5: lysandrafly folded before Flop (didn't bet)
Seat 6: el Fatto folded before Flop (didn't bet)
Seat 7: xAndorx collected ($2.50)
Seat 8: matiko09 folded before Flop (didn't bet)
Seat 9: b_____a__242 folded before Flop (didn't bet)





PokerStars Hand #149391613435:  Hold'em No Limit ($0.50/$1.00 USD) - 2016/02/25 16:31:12 CET [2016/02/25 10:31:12 ET]
Table 'Lina II' 9-max Seat #1 is the button
Seat 1: Lesley2002 ($175.54 in chips) 
Seat 2: matiko09 ($100 in chips) 
Seat 4: Nennenurse ($59.63 in chips) 
Seat 6: Lujan87 ($100 in chips) 
Seat 7: Monsthand ($143.30 in chips) 
Seat 9: Sweden_Pound ($266.52 in chips) 
matiko09: posts small blind $0.50
Nennenurse: posts big blind $1
swizzly58: sits out 
djammusic: sits out 
*** HOLE CARDS ***
Dealt to matiko09 [2h 6s]
Lujan87: folds 
Monsthand: folds 
Sweden_Pound: raises $1.50 to $2.50
Lesley2002: folds 
matiko09: folds 
Nennenurse: calls $1.50
*** FLOP *** [5d 2d 2s]
Nennenurse: checks 
Sweden_Pound: bets $3.41
Nennenurse: folds 
Uncalled bet ($3.41) returned to Sweden_Pound
Sweden_Pound collected $5.25 from pot
Sweden_Pound: doesn't show hand 
*** SUMMARY ***
Total pot $5.50 | Rake $0.25 
Board [5d 2d 2s]
Seat 1: Lesley2002 (button) folded before Flop (didn't bet)
Seat 2: matiko09 (small blind) folded before Flop
Seat 4: Nennenurse (big blind) folded on the Flop
Seat 6: Lujan87 folded before Flop (didn't bet)
Seat 7: Monsthand folded before Flop (didn't bet)
Seat 9: Sweden_Pound collected ($5.25)





PokerStars Hand #149391615745:  Hold'em No Limit ($0.25/$0.50 USD) - 2016/02/25 16:31:15 CET [2016/02/25 10:31:15 ET]
Table 'Lohja II' 9-max Seat #9 is the button
Seat 1: MoonJimmy ($148.48 in chips) 
Seat 2: Apparat888 ($30.53 in chips) 
Seat 3: guvalc1952 ($141.72 in chips) 
Seat 4: r4mz3s ($54.03 in chips) 
Seat 5: jimmy410 ($33.96 in chips) 
Seat 6: Player1705 ($125.29 in chips) 
Seat 7: matiko09 ($159.46 in chips) 
Seat 8: jamba83 ($58.15 in chips) 
Seat 9: Muinmyheart ($78.97 in chips) 
MoonJimmy: posts small blind $0.25
Apparat888: posts big blind $0.50
MoonJimmy: posts the ante $0.10
Apparat888: posts the ante $0.10
guvalc1952: posts the ante $0.10
r4mz3s: posts the ante $0.10
jimmy410: posts the ante $0.10
Player1705: posts the ante $0.10
matiko09: posts the ante $0.10
jamba83: posts the ante $0.10
Muinmyheart: posts the ante $0.10
*** HOLE CARDS ***
Dealt to matiko09 [6d 5c]
guvalc1952: folds 
r4mz3s: folds 
jimmy410: folds 
Player1705: folds 
matiko09: folds 
jamba83: raises $0.50 to $1
Muinmyheart: folds 
MoonJimmy: folds 
Apparat888: folds 
Uncalled bet ($0.50) returned to jamba83
jamba83 collected $2.15 from pot
*** SUMMARY ***
Total pot $2.15 | Rake $0 
Seat 1: MoonJimmy (small blind) folded before Flop
Seat 2: Apparat888 (big blind) folded before Flop
Seat 3: guvalc1952 folded before Flop (didn't bet)
Seat 4: r4mz3s folded before Flop (didn't bet)
Seat 5: jimmy410 folded before Flop (didn't bet)
Seat 6: Player1705 folded before Flop (didn't bet)
Seat 7: matiko09 folded before Flop (didn't bet)
Seat 8: jamba83 collected ($2.15)
Seat 9: Muinmyheart (button) folded before Flop (didn't bet)





PokerStars Hand #149391629032:  Hold'em No Limit ($0.50/$1.00 USD) - 2016/02/25 16:31:32 CET [2016/02/25 10:31:32 ET]
Table 'Zeuxo II' 9-max Seat #6 is the button
Seat 1: b_____a__242 ($194.70 in chips) 
Seat 2: Sweden_Pound ($102.75 in chips) 
Seat 3: xAndorx ($100 in chips) 
Seat 4: sebaaastian ($123.61 in chips) 
Seat 5: bauss84 ($29.45 in chips) 
Seat 6: Cogss ($97.55 in chips) 
Seat 7: djammusic ($36.53 in chips) 
Seat 8: matiko09 ($100 in chips) 
Seat 9: Sreshta222 ($212.13 in chips) 
djammusic: posts small blind $0.50
matiko09: posts big blind $1
*** HOLE CARDS ***
Dealt to matiko09 [4h 7s]
Sreshta222: folds 
b_____a__242: raises $2.48 to $3.48
Sweden_Pound: folds 
xAndorx: folds 
sebaaastian: folds 
bauss84: calls $3.48
Cogss: calls $3.48
djammusic: folds 
matiko09: folds 
*** FLOP *** [2h 5d Qs]
b_____a__242: checks 
bauss84: checks 
Cogss: bets $11.40
b_____a__242: calls $11.40
bauss84: folds 
*** TURN *** [2h 5d Qs] [4c]
b_____a__242: checks 
Cogss: checks 
*** RIVER *** [2h 5d Qs 4c] [Ah]
b_____a__242: bets $9.50
Cogss: folds 
Uncalled bet ($9.50) returned to b_____a__242
b_____a__242 collected $33.18 from pot
b_____a__242: doesn't show hand 
*** SUMMARY ***
Total pot $34.74 | Rake $1.56 
Board [2h 5d Qs 4c Ah]
Seat 1: b_____a__242 collected ($33.18)
Seat 2: Sweden_Pound folded before Flop (didn't bet)
Seat 3: xAndorx folded before Flop (didn't bet)
Seat 4: sebaaastian folded before Flop (didn't bet)
Seat 5: bauss84 folded on the Flop
Seat 6: Cogss (button) folded on the River
Seat 7: djammusic (small blind) folded before Flop
Seat 8: matiko09 (big blind) folded before Flop
Seat 9: Sreshta222 folded before Flop (didn't bet)





PokerStars Hand #149391629581:  Hold'em No Limit (€0.25/€0.50 EUR) - 2016/02/25 16:31:33 CET [2016/02/25 10:31:33 ET]
Table 'Leo Minor III' 9-max Seat #1 is the button
Seat 1: Al3xAnd3r22 (€51.25 in chips) 
Seat 2: vasiy379 (€50 in chips) 
Seat 3: Rorerzap (€50 in chips) 
Seat 4: RvPersie (€60.83 in chips) 
Seat 5: kasse_62 (€32.06 in chips) 
Seat 6: Wwwasian (€54.04 in chips) 
Seat 7: Apparat888 (€29.01 in chips) 
Seat 8: mi$$I$Elena (€91.15 in chips) 
Seat 9: matiko09 (€50 in chips) 
vasiy379: posts small blind €0.25
Rorerzap: posts big blind €0.50
*** HOLE CARDS ***
Dealt to matiko09 [7s Jd]
RvPersie: folds 
kasse_62: raises €0.50 to €1
Wwwasian: folds 
Apparat888: folds 
mi$$I$Elena: folds 
matiko09: folds 
Al3xAnd3r22: folds 
vasiy379: folds 
Rorerzap: folds 
Uncalled bet (€0.50) returned to kasse_62
kasse_62 collected €1.25 from pot
kasse_62: doesn't show hand 
*** SUMMARY ***
Total pot €1.25 | Rake €0 
Seat 1: Al3xAnd3r22 (button) folded before Flop (didn't bet)
Seat 2: vasiy379 (small blind) folded before Flop
Seat 3: Rorerzap (big blind) folded before Flop
Seat 4: RvPersie folded before Flop (didn't bet)
Seat 5: kasse_62 collected (€1.25)
Seat 6: Wwwasian folded before Flop (didn't bet)
Seat 7: Apparat888 folded before Flop (didn't bet)
Seat 8: mi$$I$Elena folded before Flop (didn't bet)
Seat 9: matiko09 folded before Flop (didn't bet)





PokerStars Hand #149391632955:  Hold'em No Limit ($0.50/$1.00 USD) - 2016/02/25 16:31:38 CET [2016/02/25 10:31:38 ET]
Table 'Guisan' 9-max Seat #6 is the button
Seat 1: stockbridge8 ($73.50 in chips) 
Seat 2: mycka86 ($100 in chips) 
Seat 3: Ju$tTrustMe ($100 in chips) 
Seat 4: matiko09 ($175.25 in chips) 
Seat 5: Jeckpot1989 ($40.05 in chips) 
Seat 6: 19R&J91 ($254.79 in chips) 
Seat 7: sebaaastian ($117.09 in chips) 
Seat 8: Monsthand ($100 in chips) 
Seat 9: Sweden_Pound ($134.70 in chips) 
sebaaastian: posts small blind $0.50
Monsthand: posts big blind $1
*** HOLE CARDS ***
Dealt to matiko09 [Qh 9h]
Sweden_Pound: folds 
stockbridge8: folds 
Jeckpot1989 said, ">:("
mycka86: folds 
Ju$tTrustMe: folds 
matiko09: folds 
Jeckpot1989: folds 
19R&J91: raises $3 to $4
sebaaastian: folds 
Monsthand: folds 
Uncalled bet ($3) returned to 19R&J91
19R&J91 collected $2.50 from pot
19R&J91: doesn't show hand 
*** SUMMARY ***
Total pot $2.50 | Rake $0 
Seat 1: stockbridge8 folded before Flop (didn't bet)
Seat 2: mycka86 folded before Flop (didn't bet)
Seat 3: Ju$tTrustMe folded before Flop (didn't bet)
Seat 4: matiko09 folded before Flop (didn't bet)
Seat 5: Jeckpot1989 folded before Flop (didn't bet)
Seat 6: 19R&J91 (button) collected ($2.50)
Seat 7: sebaaastian (small blind) folded before Flop
Seat 8: Monsthand (big blind) folded before Flop
Seat 9: Sweden_Pound folded before Flop (didn't bet)





PokerStars Hand #149391633516:  Hold'em No Limit ($0.50/$1.00 USD) - 2016/02/25 16:31:38 CET [2016/02/25 10:31:38 ET]
Table 'Morosovia II' 9-max Seat #2 is the button
Seat 1: apfush ($129.41 in chips) 
Seat 2: lysandrafly ($100 in chips) 
Seat 3: sebaaastian ($137.37 in chips) 
Seat 4: matiko09 ($171.85 in chips) 
Seat 5: pimpoza ($67.89 in chips) 
Seat 6: Sweden_Pound ($147.76 in chips) 
Seat 7: Ty Nick 420 ($194.19 in chips) 
Seat 8: Monsthand ($100.50 in chips) 
Seat 9: geniusgiqq ($59.96 in chips) 
sebaaastian: posts small blind $0.50
matiko09: posts big blind $1
*** HOLE CARDS ***
Dealt to matiko09 [7d Jd]
pimpoza: folds 
Sweden_Pound: raises $2 to $3
Ty Nick 420: folds 
Monsthand: folds 
geniusgiqq: calls $3
apfush: folds 
lysandrafly: folds 
sebaaastian: folds 
matiko09: folds 
*** FLOP *** [6s Th 9c]
Sweden_Pound: bets $4.65
geniusgiqq: calls $4.65
*** TURN *** [6s Th 9c] [Jh]
Sweden_Pound: checks 
geniusgiqq: bets $8.50
Sweden_Pound: folds 
Uncalled bet ($8.50) returned to geniusgiqq
geniusgiqq collected $16.04 from pot
geniusgiqq: doesn't show hand 
*** SUMMARY ***
Total pot $16.80 | Rake $0.76 
Board [6s Th 9c Jh]
Seat 1: apfush folded before Flop (didn't bet)
Seat 2: lysandrafly (button) folded before Flop (didn't bet)
Seat 3: sebaaastian (small blind) folded before Flop
Seat 4: matiko09 (big blind) folded before Flop
Seat 5: pimpoza folded before Flop (didn't bet)
Seat 6: Sweden_Pound folded on the Turn
Seat 7: Ty Nick 420 folded before Flop (didn't bet)
Seat 8: Monsthand folded before Flop (didn't bet)
Seat 9: geniusgiqq collected ($16.04)





PokerStars Hand #149391634355:  Hold'em No Limit ($0.25/$0.50 USD) - 2016/02/25 16:31:39 CET [2016/02/25 10:31:39 ET]
Table 'Lohja II' 9-max Seat #1 is the button
Seat 1: MoonJimmy ($148.13 in chips) 
Seat 2: Apparat888 ($29.93 in chips) 
Seat 3: guvalc1952 ($141.62 in chips) 
Seat 4: r4mz3s ($53.93 in chips) 
Seat 5: jimmy410 ($33.86 in chips) 
Seat 6: Player1705 ($125.19 in chips) 
Seat 7: matiko09 ($159.36 in chips) 
Seat 8: jamba83 ($59.70 in chips) 
Seat 9: Muinmyheart ($78.87 in chips) 
Apparat888: posts small blind $0.25
guvalc1952: posts big blind $0.50
MoonJimmy: posts the ante $0.10
Apparat888: posts the ante $0.10
guvalc1952: posts the ante $0.10
r4mz3s: posts the ante $0.10
jimmy410: posts the ante $0.10
Player1705: posts the ante $0.10
matiko09: posts the ante $0.10
jamba83: posts the ante $0.10
Muinmyheart: posts the ante $0.10
*** HOLE CARDS ***
Dealt to matiko09 [Tc 7c]
r4mz3s: folds 
jimmy410: folds 
Player1705: folds 
matiko09: folds 
jamba83: folds 
Muinmyheart: raises $1 to $1.50
MoonJimmy: folds 
Apparat888: folds 
guvalc1952: calls $1
*** FLOP *** [9s Qs 6h]
guvalc1952: checks 
Muinmyheart: bets $3.25
guvalc1952: calls $3.25
*** TURN *** [9s Qs 6h] [3c]
guvalc1952: checks 
Muinmyheart: bets $9
guvalc1952: folds 
Uncalled bet ($9) returned to Muinmyheart
Muinmyheart collected $10.17 from pot
Muinmyheart: doesn't show hand 
*** SUMMARY ***
Total pot $10.65 | Rake $0.48 
Board [9s Qs 6h 3c]
Seat 1: MoonJimmy (button) folded before Flop (didn't bet)
Seat 2: Apparat888 (small blind) folded before Flop
Seat 3: guvalc1952 (big blind) folded on the Turn
Seat 4: r4mz3s folded before Flop (didn't bet)
Seat 5: jimmy410 folded before Flop (didn't bet)
Seat 6: Player1705 folded before Flop (didn't bet)
Seat 7: matiko09 folded before Flop (didn't bet)
Seat 8: jamba83 folded before Flop (didn't bet)
Seat 9: Muinmyheart collected ($10.17)





PokerStars Hand #149391634002:  Hold'em No Limit ($0.50/$1.00 USD) - 2016/02/25 16:31:39 CET [2016/02/25 10:31:39 ET]
Table 'Eros II' 9-max Seat #2 is the button
Seat 1: sebaaastian ($100 in chips) 
Seat 2: Sweden_Pound ($106.50 in chips) 
Seat 3: niong62 ($78 in chips) 
Seat 4: hammerwife ($100 in chips) 
Seat 5: lysandrafly ($100 in chips) 
Seat 6: el Fatto ($104.23 in chips) 
Seat 7: xAndorx ($125.84 in chips) 
Seat 8: matiko09 ($100 in chips) 
Seat 9: b_____a__242 ($79.39 in chips) 
niong62: posts small blind $0.50
hammerwife: posts big blind $1
*** HOLE CARDS ***
Dealt to matiko09 [3s As]
lysandrafly: folds 
el Fatto: folds 
xAndorx: folds 
matiko09: raises $2 to $3
b_____a__242: folds 
sebaaastian: folds 
Sweden_Pound: folds 
niong62: calls $2.50
hammerwife: folds 
*** FLOP *** [7s 5d 9h]
niong62: checks 
matiko09: checks 
*** TURN *** [7s 5d 9h] [Jc]
niong62: bets $1
matiko09: folds 
Uncalled bet ($1) returned to niong62
niong62 collected $6.68 from pot
*** SUMMARY ***
Total pot $7 | Rake $0.32 
Board [7s 5d 9h Jc]
Seat 1: sebaaastian folded before Flop (didn't bet)
Seat 2: Sweden_Pound (button) folded before Flop (didn't bet)
Seat 3: niong62 (small blind) collected ($6.68)
Seat 4: hammerwife (big blind) folded before Flop
Seat 5: lysandrafly folded before Flop (didn't bet)
Seat 6: el Fatto folded before Flop (didn't bet)
Seat 7: xAndorx folded before Flop (didn't bet)
Seat 8: matiko09 folded on the Turn
Seat 9: b_____a__242 folded before Flop (didn't bet)





PokerStars Hand #149391636275:  Hold'em No Limit ($0.50/$1.00 USD) - 2016/02/25 16:31:42 CET [2016/02/25 10:31:42 ET]
Table 'Lina II' 9-max Seat #2 is the button
Seat 1: Lesley2002 ($175.54 in chips) 
Seat 2: matiko09 ($100 in chips) 
Seat 4: Nennenurse ($57.13 in chips) 
Seat 5: swizzly58 ($40 in chips) 
Seat 6: Lujan87 ($100 in chips) 
Seat 7: Monsthand ($143.30 in chips) 
Seat 9: Sweden_Pound ($269.27 in chips) 
Nennenurse: posts small blind $0.50
swizzly58: posts big blind $1
djammusic: sits out 
*** HOLE CARDS ***
Dealt to matiko09 [Jc 7d]
Lujan87: folds 
Monsthand: folds 
Lujan87 leaves the table
Sweden_Pound: folds 
Lesley2002: folds 
sebaaastian joins the table at seat #6 
matiko09: folds 
Nennenurse: folds 
Uncalled bet ($0.50) returned to swizzly58
swizzly58 collected $1 from pot
swizzly58: doesn't show hand 
*** SUMMARY ***
Total pot $1 | Rake $0 
Seat 1: Lesley2002 folded before Flop (didn't bet)
Seat 2: matiko09 (button) folded before Flop (didn't bet)
Seat 4: Nennenurse (small blind) folded before Flop
Seat 5: swizzly58 (big blind) collected ($1)
Seat 6: Lujan87 folded before Flop (didn't bet)
Seat 7: Monsthand folded before Flop (didn't bet)
Seat 9: Sweden_Pound folded before Flop (didn't bet)





PokerStars Hand #149391638978:  Hold'em No Limit ($0.50/$1.00 USD) - 2016/02/25 16:31:46 CET [2016/02/25 10:31:46 ET]
Table 'Euphemia II' 9-max Seat #4 is the button
Seat 1: pardama ($198.20 in chips) 
Seat 2: Venomous100% ($100 in chips) 
Seat 3: Mukhin1 ($100 in chips) 
Seat 4: Lahesell ($100 in chips) 
Seat 5: HomerrrJay ($100 in chips) 
Seat 6: Ty Nick 420 ($101.50 in chips) 
Seat 7: Sweden_Pound ($100 in chips) 
Seat 8: sreichma ($101.50 in chips) 
Seat 9: matiko09 ($100 in chips) 
HomerrrJay: posts small blind $0.50
Ty Nick 420: posts big blind $1
*** HOLE CARDS ***
Dealt to matiko09 [7d 6s]
Sweden_Pound: folds 
sreichma: folds 
matiko09: folds 
pardama: folds 
Venomous100%: folds 
Mukhin1: raises $1.60 to $2.60
Lahesell: folds 
HomerrrJay: folds 
Ty Nick 420: folds 
Uncalled bet ($1.60) returned to Mukhin1
Mukhin1 collected $2.50 from pot
Mukhin1: doesn't show hand 
*** SUMMARY ***
Total pot $2.50 | Rake $0 
Seat 1: pardama folded before Flop (didn't bet)
Seat 2: Venomous100% folded before Flop (didn't bet)
Seat 3: Mukhin1 collected ($2.50)
Seat 4: Lahesell (button) folded before Flop (didn't bet)
Seat 5: HomerrrJay (small blind) folded before Flop
Seat 6: Ty Nick 420 (big blind) folded before Flop
Seat 7: Sweden_Pound folded before Flop (didn't bet)
Seat 8: sreichma folded before Flop (didn't bet)
Seat 9: matiko09 folded before Flop (didn't bet)





PokerStars Hand #149391640645:  Hold'em No Limit ($0.50/$1.00 USD) - 2016/02/25 16:31:48 CET [2016/02/25 10:31:48 ET]
Table 'Simona' 9-max Seat #2 is the button
Seat 1: mycka86 ($114.21 in chips) 
Seat 2: xAndorx ($109.03 in chips) 
Seat 3: Sweden_Pound ($100 in chips) 
Seat 4: matiko09 ($280.42 in chips) 
Seat 5: sebaaastian ($100 in chips) 
Seat 6: Ty Nick 420 ($106 in chips) 
Seat 7: Aalleekks ($103.80 in chips) 
Seat 8: Monsthand ($133.26 in chips) 
Seat 9: Slushpup69 ($50.97 in chips) 
Sweden_Pound: posts small blind $0.50
matiko09: posts big blind $1
*** HOLE CARDS ***
Dealt to matiko09 [Jd Ts]
sebaaastian: folds 
Ty Nick 420: folds 
Aalleekks: folds 
Monsthand: folds 
Slushpup69: raises $2 to $3
mycka86: folds 
xAndorx: folds 
Sweden_Pound: folds 
matiko09: folds 
Uncalled bet ($2) returned to Slushpup69
Slushpup69 collected $2.50 from pot
*** SUMMARY ***
Total pot $2.50 | Rake $0 
Seat 1: mycka86 folded before Flop (didn't bet)
Seat 2: xAndorx (button) folded before Flop (didn't bet)
Seat 3: Sweden_Pound (small blind) folded before Flop
Seat 4: matiko09 (big blind) folded before Flop
Seat 5: sebaaastian folded before Flop (didn't bet)
Seat 6: Ty Nick 420 folded before Flop (didn't bet)
Seat 7: Aalleekks folded before Flop (didn't bet)
Seat 8: Monsthand folded before Flop (didn't bet)
Seat 9: Slushpup69 collected ($2.50)





PokerStars Hand #149391642240:  Hold'em No Limit ($0.50/$1.00 USD) - 2016/02/25 16:31:50 CET [2016/02/25 10:31:50 ET]
Table 'Lucia III' 9-max Seat #7 is the button
Seat 1: Monsthand ($125.45 in chips) 
Seat 2: kuanhung0903 ($77.50 in chips) 
Seat 3: mycka86 ($109.62 in chips) 
Seat 4: swatek1986 ($133.09 in chips) 
Seat 5: Sweden_Pound ($202.07 in chips) 
Seat 6: matiko09 ($109.23 in chips) 
Seat 7: Ty Nick 420 ($201.02 in chips) 
Seat 8: apfush ($100 in chips) 
Seat 9: Apparat888 ($38.45 in chips) 
apfush: posts small blind $0.50
Apparat888: posts big blind $1
*** HOLE CARDS ***
Dealt to matiko09 [3d 5h]
Monsthand: folds 
kuanhung0903: folds 
mycka86: folds 
swatek1986 has timed out
swatek1986: folds 
Sweden_Pound: raises $2 to $3
matiko09: folds 
Ty Nick 420: raises $6 to $9
apfush: folds 
Apparat888: folds 
Sweden_Pound: raises $14 to $23
Ty Nick 420: calls $14
*** FLOP *** [2h 4h 8d]
Sweden_Pound: bets $28.50
Ty Nick 420: folds 
Uncalled bet ($28.50) returned to Sweden_Pound
Sweden_Pound collected $45.36 from pot
Sweden_Pound: doesn't show hand 
*** SUMMARY ***
Total pot $47.50 | Rake $2.14 
Board [2h 4h 8d]
Seat 1: Monsthand folded before Flop (didn't bet)
Seat 2: kuanhung0903 folded before Flop (didn't bet)
Seat 3: mycka86 folded before Flop (didn't bet)
Seat 4: swatek1986 folded before Flop (didn't bet)
Seat 5: Sweden_Pound collected ($45.36)
Seat 6: matiko09 folded before Flop (didn't bet)
Seat 7: Ty Nick 420 (button) folded on the Flop
Seat 8: apfush (small blind) folded before Flop
Seat 9: Apparat888 (big blind) folded before Flop





PokerStars Hand #149391652787:  Hold'em No Limit ($0.50/$1.00 USD) - 2016/02/25 16:32:04 CET [2016/02/25 10:32:04 ET]
Table 'Lina II' 9-max Seat #4 is the button
Seat 1: Lesley2002 ($175.54 in chips) 
Seat 2: matiko09 ($100 in chips) 
Seat 4: Nennenurse ($56.63 in chips) 
Seat 5: swizzly58 ($40.50 in chips) 
Seat 6: sebaaastian ($100 in chips) 
Seat 7: Monsthand ($143.30 in chips) 
Seat 9: Sweden_Pound ($269.27 in chips) 
swizzly58: posts small blind $0.50
sebaaastian: posts big blind $1
djammusic: sits out 
*** HOLE CARDS ***
Dealt to matiko09 [3s 5h]
Monsthand: folds 
Sweden_Pound: folds 
Lesley2002: folds 
matiko09: folds 
Nennenurse: folds 
swizzly58: calls $0.50
sebaaastian: raises $3.50 to $4.50
swizzly58: folds 
Uncalled bet ($3.50) returned to sebaaastian
sebaaastian collected $2 from pot
sebaaastian: doesn't show hand 
*** SUMMARY ***
Total pot $2 | Rake $0 
Seat 1: Lesley2002 folded before Flop (didn't bet)
Seat 2: matiko09 folded before Flop (didn't bet)
Seat 4: Nennenurse (button) folded before Flop (didn't bet)
Seat 5: swizzly58 (small blind) folded before Flop
Seat 6: sebaaastian (big blind) collected ($2)
Seat 7: Monsthand folded before Flop (didn't bet)
Seat 9: Sweden_Pound folded before Flop (didn't bet)





PokerStars Hand #149391655499:  Hold'em No Limit (€0.25/€0.50 EUR) - 2016/02/25 16:32:07 CET [2016/02/25 10:32:07 ET]
Table 'Leo Minor III' 9-max Seat #2 is the button
Seat 1: Al3xAnd3r22 (€51.25 in chips) 
Seat 2: vasiy379 (€50 in chips) 
Seat 3: Rorerzap (€50 in chips) 
Seat 4: RvPersie (€60.83 in chips) 
Seat 5: kasse_62 (€32.81 in chips) 
Seat 6: Wwwasian (€54.04 in chips) 
Seat 7: Apparat888 (€29.01 in chips) 
Seat 8: mi$$I$Elena (€91.15 in chips) 
Seat 9: matiko09 (€50 in chips) 
Rorerzap: posts small blind €0.25
RvPersie: posts big blind €0.50
*** HOLE CARDS ***
Dealt to matiko09 [2h 5d]
kasse_62: folds 
Wwwasian: folds 
Apparat888: folds 
mi$$I$Elena: folds 
matiko09: folds 
Al3xAnd3r22: folds 
vasiy379: raises €0.60 to €1.10
Rorerzap: raises €2.90 to €4
RvPersie: folds 
vasiy379: folds 
Uncalled bet (€2.90) returned to Rorerzap
Rorerzap collected €2.70 from pot
Rorerzap: doesn't show hand 
*** SUMMARY ***
Total pot €2.70 | Rake €0 
Seat 1: Al3xAnd3r22 folded before Flop (didn't bet)
Seat 2: vasiy379 (button) folded before Flop
Seat 3: Rorerzap (small blind) collected (€2.70)
Seat 4: RvPersie (big blind) folded before Flop
Seat 5: kasse_62 folded before Flop (didn't bet)
Seat 6: Wwwasian folded before Flop (didn't bet)
Seat 7: Apparat888 folded before Flop (didn't bet)
Seat 8: mi$$I$Elena folded before Flop (didn't bet)
Seat 9: matiko09 folded before Flop (didn't bet)





PokerStars Hand #149391660614:  Hold'em No Limit ($0.50/$1.00 USD) - 2016/02/25 16:32:14 CET [2016/02/25 10:32:14 ET]
Table 'Guisan' 9-max Seat #7 is the button
Seat 1: stockbridge8 ($73.50 in chips) 
Seat 2: mycka86 ($100 in chips) 
Seat 3: Ju$tTrustMe ($100 in chips) 
Seat 4: matiko09 ($175.25 in chips) 
Seat 5: Jeckpot1989 ($40.05 in chips) 
Seat 6: 19R&J91 ($256.29 in chips) 
Seat 7: sebaaastian ($116.59 in chips) 
Seat 8: Monsthand ($100 in chips) 
Seat 9: Sweden_Pound ($134.70 in chips) 
Monsthand: posts small blind $0.50
Sweden_Pound: posts big blind $1
*** HOLE CARDS ***
Dealt to matiko09 [9h 7h]
stockbridge8: folds 
mycka86: folds 
Ju$tTrustMe: raises $2 to $3
matiko09: folds 
Jeckpot1989: folds 
19R&J91: raises $2 to $5
sebaaastian: folds 
Monsthand: folds 
Sweden_Pound: raises $13 to $18
Ju$tTrustMe: folds 
19R&J91: calls $13
*** FLOP *** [6s Ac 6d]
Sweden_Pound: bets $24.52
19R&J91: calls $24.52
*** TURN *** [6s Ac 6d] [5s]
Sweden_Pound: bets $45
19R&J91: raises $93 to $138
Sweden_Pound: calls $47.18 and is all-in
Uncalled bet ($45.82) returned to 19R&J91
*** RIVER *** [6s Ac 6d 5s] [4h]
*** SHOW DOWN ***
Sweden_Pound: shows [As Kd] (two pair, Aces and Sixes)
19R&J91: shows [Qh 6h] (three of a kind, Sixes)
19R&J91 collected $270.10 from pot
*** SUMMARY ***
Total pot $272.90 | Rake $2.80 
Board [6s Ac 6d 5s 4h]
Seat 1: stockbridge8 folded before Flop (didn't bet)
Seat 2: mycka86 folded before Flop (didn't bet)
Seat 3: Ju$tTrustMe folded before Flop
Seat 4: matiko09 folded before Flop (didn't bet)
Seat 5: Jeckpot1989 folded before Flop (didn't bet)
Seat 6: 19R&J91 showed [Qh 6h] and won ($270.10) with three of a kind, Sixes
Seat 7: sebaaastian (button) folded before Flop (didn't bet)
Seat 8: Monsthand (small blind) folded before Flop
Seat 9: Sweden_Pound (big blind) showed [As Kd] and lost with two pair, Aces and Sixes





PokerStars Hand #149391664979:  Hold'em No Limit ($0.50/$1.00 USD) - 2016/02/25 16:32:20 CET [2016/02/25 10:32:20 ET]
Table 'Euphemia II' 9-max Seat #5 is the button
Seat 1: pardama ($198.20 in chips) 
Seat 2: Venomous100% ($100 in chips) 
Seat 3: Mukhin1 ($101.50 in chips) 
Seat 4: Lahesell ($100 in chips) 
Seat 5: HomerrrJay ($100 in chips) 
Seat 6: Ty Nick 420 ($100.50 in chips) 
Seat 7: Sweden_Pound ($100 in chips) 
Seat 8: sreichma ($101.50 in chips) 
Seat 9: matiko09 ($100 in chips) 
Ty Nick 420: posts small blind $0.50
Sweden_Pound: posts big blind $1
*** HOLE CARDS ***
Dealt to matiko09 [2c 2s]
sreichma: folds 
matiko09: folds 
pardama: folds 
pardama leaves the table
Venomous100%: folds 
Mukhin1: raises $2.02 to $3.02
Lahesell: raises $5.98 to $9
HomerrrJay: folds 
kas8304 joins the table at seat #1 
Ty Nick 420: raises $12 to $21
Sweden_Pound: folds 
Mukhin1: folds 
Lahesell: calls $12
*** FLOP *** [2d 7c 3s]
Ty Nick 420: bets $18.45
Lahesell: calls $18.45
*** TURN *** [2d 7c 3s] [Kh]
Ty Nick 420: checks 
Lahesell: checks 
*** RIVER *** [2d 7c 3s Kh] [Tc]
Ty Nick 420: checks 
Lahesell: bets $28.50
Ty Nick 420: folds 
Uncalled bet ($28.50) returned to Lahesell
Lahesell collected $80.12 from pot
Lahesell: doesn't show hand 
*** SUMMARY ***
Total pot $82.92 | Rake $2.80 
Board [2d 7c 3s Kh Tc]
Seat 1: pardama folded before Flop (didn't bet)
Seat 2: Venomous100% folded before Flop (didn't bet)
Seat 3: Mukhin1 folded before Flop
Seat 4: Lahesell collected ($80.12)
Seat 5: HomerrrJay (button) folded before Flop (didn't bet)
Seat 6: Ty Nick 420 (small blind) folded on the River
Seat 7: Sweden_Pound (big blind) folded before Flop
Seat 8: sreichma folded before Flop (didn't bet)
Seat 9: matiko09 folded before Flop (didn't bet)





PokerStars Hand #149391675254:  Hold'em No Limit ($0.25/$0.50 USD) - 2016/02/25 16:32:33 CET [2016/02/25 10:32:33 ET]
Table 'Lohja II' 9-max Seat #2 is the button
Seat 1: MoonJimmy ($148.03 in chips) 
Seat 2: Apparat888 ($29.58 in chips) 
Seat 3: guvalc1952 ($136.77 in chips) 
Seat 4: r4mz3s ($53.83 in chips) 
Seat 5: jimmy410 ($33.76 in chips) 
Seat 6: Player1705 ($125.09 in chips) 
Seat 7: matiko09 ($159.26 in chips) 
Seat 8: jamba83 ($59.60 in chips) 
Seat 9: Muinmyheart ($84.19 in chips) 
guvalc1952: posts small blind $0.25
r4mz3s: posts big blind $0.50
MoonJimmy: posts the ante $0.10
Apparat888: posts the ante $0.10
guvalc1952: posts the ante $0.10
r4mz3s: posts the ante $0.10
jimmy410: posts the ante $0.10
Player1705: posts the ante $0.10
matiko09: posts the ante $0.10
jamba83: posts the ante $0.10
Muinmyheart: posts the ante $0.10
*** HOLE CARDS ***
Dealt to matiko09 [9c 9d]
jimmy410: folds 
Player1705: raises $0.94 to $1.44
matiko09: calls $1.44
jamba83: folds 
Muinmyheart: folds 
MoonJimmy: folds 
Apparat888: folds 
guvalc1952: folds 
r4mz3s: calls $0.94
*** FLOP *** [Jd 2d 3h]
r4mz3s: checks 
jimmy410 leaves the table
Player1705: checks 
matiko09: checks 
*** TURN *** [Jd 2d 3h] [2h]
r4mz3s: bets $3.75
Player1705: folds 
matiko09: folds 
Uncalled bet ($3.75) returned to r4mz3s
r4mz3s collected $5.22 from pot
r4mz3s: doesn't show hand 
Bron By joins the table at seat #5 
*** SUMMARY ***
Total pot $5.47 | Rake $0.25 
Board [Jd 2d 3h 2h]
Seat 1: MoonJimmy folded before Flop (didn't bet)
Seat 2: Apparat888 (button) folded before Flop (didn't bet)
Seat 3: guvalc1952 (small blind) folded before Flop
Seat 4: r4mz3s (big blind) collected ($5.22)
Seat 5: jimmy410 folded before Flop (didn't bet)
Seat 6: Player1705 folded on the Turn
Seat 7: matiko09 folded on the Turn
Seat 8: jamba83 folded before Flop (didn't bet)
Seat 9: Muinmyheart folded before Flop (didn't bet)





PokerStars Hand #149391678427:  Hold'em No Limit ($0.25/$0.50 USD) - 2016/02/25 16:32:38 CET [2016/02/25 10:32:38 ET]
Table 'Thalpius III' 9-max Seat #2 is the button
Seat 1: BrotherLove9 ($53.60 in chips) 
Seat 2: matiko09 ($54.89 in chips) 
Seat 3: jamba83 ($53.31 in chips) 
Seat 4: Wwwasian ($50 in chips) 
Seat 5: Rorerzap ($55.52 in chips) 
Seat 7: v4n0v ($50 in chips) 
Seat 8: jeroemie123 ($47.56 in chips) 
Seat 9: Gemb1rdd ($66.68 in chips) 
jamba83: posts small blind $0.25
Wwwasian: posts big blind $0.50
rdrill: sits out 
*** HOLE CARDS ***
Dealt to matiko09 [Qd 8c]
Rorerzap: raises $1 to $1.50
v4n0v: folds 
jeroemie123: folds 
Gemb1rdd: folds 
BrotherLove9: folds 
matiko09: folds 
jamba83: folds 
Wwwasian: folds 
Uncalled bet ($1) returned to Rorerzap
Rorerzap collected $1.25 from pot
Rorerzap: doesn't show hand 
*** SUMMARY ***
Total pot $1.25 | Rake $0 
Seat 1: BrotherLove9 folded before Flop (didn't bet)
Seat 2: matiko09 (button) folded before Flop (didn't bet)
Seat 3: jamba83 (small blind) folded before Flop
Seat 4: Wwwasian (big blind) folded before Flop
Seat 5: Rorerzap collected ($1.25)
Seat 7: v4n0v folded before Flop (didn't bet)
Seat 8: jeroemie123 folded before Flop (didn't bet)
Seat 9: Gemb1rdd folded before Flop (didn't bet)





PokerStars Hand #149391680643:  Hold'em No Limit ($0.50/$1.00 USD) - 2016/02/25 16:32:41 CET [2016/02/25 10:32:41 ET]
Table 'Eros II' 9-max Seat #3 is the button
Seat 1: sebaaastian ($100 in chips) 
Seat 2: Sweden_Pound ($106.50 in chips) 
Seat 3: niong62 ($81.68 in chips) 
Seat 4: hammerwife ($100 in chips) 
Seat 5: lysandrafly ($100 in chips) 
Seat 6: el Fatto ($104.23 in chips) 
Seat 7: xAndorx ($125.84 in chips) 
Seat 8: matiko09 ($100 in chips) 
Seat 9: b_____a__242 ($79.39 in chips) 
hammerwife: posts small blind $0.50
lysandrafly: posts big blind $1
*** HOLE CARDS ***
Dealt to matiko09 [Qs 7s]
el Fatto: folds 
xAndorx: folds 
matiko09: folds 
b_____a__242: raises $2 to $3
sebaaastian: folds 
Sweden_Pound: folds 
niong62: calls $3
hammerwife: folds 
lysandrafly: folds 
*** FLOP *** [6s 4d 5h]
b_____a__242: bets $6
niong62: folds 
Uncalled bet ($6) returned to b_____a__242
b_____a__242 collected $7.16 from pot
b_____a__242: doesn't show hand 
*** SUMMARY ***
Total pot $7.50 | Rake $0.34 
Board [6s 4d 5h]
Seat 1: sebaaastian folded before Flop (didn't bet)
Seat 2: Sweden_Pound folded before Flop (didn't bet)
Seat 3: niong62 (button) folded on the Flop
Seat 4: hammerwife (small blind) folded before Flop
Seat 5: lysandrafly (big blind) folded before Flop
Seat 6: el Fatto folded before Flop (didn't bet)
Seat 7: xAndorx folded before Flop (didn't bet)
Seat 8: matiko09 folded before Flop (didn't bet)
Seat 9: b_____a__242 collected ($7.16)





PokerStars Hand #149391682191:  Hold'em No Limit ($0.50/$1.00 USD) - 2016/02/25 16:32:43 CET [2016/02/25 10:32:43 ET]
Table 'Simona' 9-max Seat #3 is the button
Seat 1: mycka86 ($114.21 in chips) 
Seat 2: xAndorx ($109.03 in chips) 
Seat 3: Sweden_Pound ($100 in chips) 
Seat 4: matiko09 ($279.42 in chips) 
Seat 5: sebaaastian ($100 in chips) 
Seat 6: Ty Nick 420 ($106 in chips) 
Seat 7: Aalleekks ($103.80 in chips) 
Seat 8: Monsthand ($133.26 in chips) 
Seat 9: Slushpup69 ($52.47 in chips) 
matiko09: posts small blind $0.50
sebaaastian: posts big blind $1
*** HOLE CARDS ***
Dealt to matiko09 [Ad 2d]
Ty Nick 420: folds 
Aalleekks: folds 
Monsthand: folds 
Slushpup69: calls $1
mycka86: folds 
xAndorx: folds 
Sweden_Pound: folds 
matiko09: raises $2 to $3
sebaaastian: folds 
Slushpup69: calls $2
*** FLOP *** [9c Ts 4h]
matiko09: checks 
Slushpup69: bets $2.60
matiko09: folds 
Uncalled bet ($2.60) returned to Slushpup69
Slushpup69 collected $6.68 from pot
*** SUMMARY ***
Total pot $7 | Rake $0.32 
Board [9c Ts 4h]
Seat 1: mycka86 folded before Flop (didn't bet)
Seat 2: xAndorx folded before Flop (didn't bet)
Seat 3: Sweden_Pound (button) folded before Flop (didn't bet)
Seat 4: matiko09 (small blind) folded on the Flop
Seat 5: sebaaastian (big blind) folded before Flop
Seat 6: Ty Nick 420 folded before Flop (didn't bet)
Seat 7: Aalleekks folded before Flop (didn't bet)
Seat 8: Monsthand folded before Flop (didn't bet)
Seat 9: Slushpup69 collected ($6.68)





PokerStars Hand #149391685306:  Hold'em No Limit ($0.50/$1.00 USD) - 2016/02/25 16:32:47 CET [2016/02/25 10:32:47 ET]
Table 'Lina II' 9-max Seat #5 is the button
Seat 1: Lesley2002 ($175.54 in chips) 
Seat 2: matiko09 ($100 in chips) 
Seat 4: Nennenurse ($56.63 in chips) 
Seat 5: swizzly58 ($39.50 in chips) 
Seat 6: sebaaastian ($101 in chips) 
Seat 7: Monsthand ($143.30 in chips) 
Seat 9: Sweden_Pound ($269.27 in chips) 
sebaaastian: posts small blind $0.50
Monsthand: posts big blind $1
djammusic: sits out 
*** HOLE CARDS ***
Dealt to matiko09 [Qh Ac]
Sweden_Pound: folds 
Lesley2002: folds 
matiko09: raises $2 to $3
Nennenurse: folds 
swizzly58: folds 
sebaaastian: folds 
Monsthand: calls $2
*** FLOP *** [Ks 2s 2c]
Monsthand: checks 
Bron By leaves the table
Aalleekks joins the table at seat #3 
matiko09: checks 
*** TURN *** [Ks 2s 2c] [Ad]
Aalleekks leaves the table
Ouga Buga joins the table at seat #3 
Monsthand: checks 
matiko09: checks 
*** RIVER *** [Ks 2s 2c Ad] [4c]
Monsthand: checks 
matiko09: bets $3.22
Monsthand: folds 
Uncalled bet ($3.22) returned to matiko09
matiko09 collected $6.21 from pot
matiko09: doesn't show hand 
*** SUMMARY ***
Total pot $6.50 | Rake $0.29 
Board [Ks 2s 2c Ad 4c]
Seat 1: Lesley2002 folded before Flop (didn't bet)
Seat 2: matiko09 collected ($6.21)
Seat 4: Nennenurse folded before Flop (didn't bet)
Seat 5: swizzly58 (button) folded before Flop (didn't bet)
Seat 6: sebaaastian (small blind) folded before Flop
Seat 7: Monsthand (big blind) folded on the River
Seat 9: Sweden_Pound folded before Flop (didn't bet)





PokerStars Hand #149391697953:  Hold'em No Limit (€0.25/€0.50 EUR) - 2016/02/25 16:33:03 CET [2016/02/25 10:33:03 ET]
Table 'Leo Minor III' 9-max Seat #3 is the button
Seat 1: Al3xAnd3r22 (€51.25 in chips) 
Seat 2: vasiy379 (€50 in chips) 
Seat 3: Rorerzap (€51.60 in chips) 
Seat 4: RvPersie (€60.33 in chips) 
Seat 5: kasse_62 (€32.81 in chips) 
Seat 6: Wwwasian (€54.04 in chips) 
Seat 7: Apparat888 (€29.01 in chips) 
Seat 8: mi$$I$Elena (€91.15 in chips) 
Seat 9: matiko09 (€50 in chips) 
RvPersie: posts small blind €0.25
kasse_62: posts big blind €0.50
*** HOLE CARDS ***
Dealt to matiko09 [Td 5h]
Wwwasian: folds 
Apparat888: folds 
mi$$I$Elena: raises €1 to €1.50
matiko09: folds 
Al3xAnd3r22: folds 
vasiy379: raises €3 to €4.50
Rorerzap: folds 
RvPersie: calls €4.25
kasse_62: folds 
mi$$I$Elena: calls €3
*** FLOP *** [Ks Kc 8h]
RvPersie: checks 
mi$$I$Elena: checks 
vasiy379: checks 
*** TURN *** [Ks Kc 8h] [Qs]
RvPersie: bets €8.82
mi$$I$Elena: folds 
vasiy379: folds 
Uncalled bet (€8.82) returned to RvPersie
RvPersie collected €13.37 from pot
RvPersie: doesn't show hand 
*** SUMMARY ***
Total pot €14 | Rake €0.63 
Board [Ks Kc 8h Qs]
Seat 1: Al3xAnd3r22 folded before Flop (didn't bet)
Seat 2: vasiy379 folded on the Turn
Seat 3: Rorerzap (button) folded before Flop (didn't bet)
Seat 4: RvPersie (small blind) collected (€13.37)
Seat 5: kasse_62 (big blind) folded before Flop
Seat 6: Wwwasian folded before Flop (didn't bet)
Seat 7: Apparat888 folded before Flop (didn't bet)
Seat 8: mi$$I$Elena folded on the Turn
Seat 9: matiko09 folded before Flop (didn't bet)





PokerStars Hand #149391707327:  Hold'em No Limit ($0.50/$1.00 USD) - 2016/02/25 16:33:16 CET [2016/02/25 10:33:16 ET]
Table 'Morosovia II' 9-max Seat #3 is the button
Seat 1: apfush ($129.41 in chips) 
Seat 2: lysandrafly ($100 in chips) 
Seat 3: sebaaastian ($136.87 in chips) 
Seat 4: matiko09 ($170.85 in chips) 
Seat 5: pimpoza ($67.89 in chips) 
Seat 6: Sweden_Pound ($140.11 in chips) 
Seat 7: Ty Nick 420 ($194.19 in chips) 
Seat 8: Monsthand ($100.50 in chips) 
Seat 9: geniusgiqq ($68.35 in chips) 
matiko09: posts small blind $0.50
pimpoza: posts big blind $1
*** HOLE CARDS ***
Dealt to matiko09 [4h 5c]
Sweden_Pound: folds 
Ty Nick 420: folds 
Monsthand: folds 
geniusgiqq: raises $1.50 to $2.50
apfush: raises $5.50 to $8
lysandrafly: folds 
sebaaastian: folds 
matiko09: folds 
pimpoza: folds 
geniusgiqq: calls $5.50
*** FLOP *** [7h 9d Qs]
geniusgiqq: checks 
apfush: bets $12.50
geniusgiqq: raises $17.50 to $30
apfush: raises $91.41 to $121.41 and is all-in
geniusgiqq: calls $30.35 and is all-in
Uncalled bet ($61.06) returned to apfush
*** TURN *** [7h 9d Qs] [Td]
*** RIVER *** [7h 9d Qs Td] [Js]
*** SHOW DOWN ***
geniusgiqq: shows [Th 8c] (a straight, Eight to Queen)
apfush: shows [Kc Ks] (a straight, Nine to King)
apfush collected $135.40 from pot
*** SUMMARY ***
Total pot $138.20 | Rake $2.80 
Board [7h 9d Qs Td Js]
Seat 1: apfush showed [Kc Ks] and won ($135.40) with a straight, Nine to King
Seat 2: lysandrafly folded before Flop (didn't bet)
Seat 3: sebaaastian (button) folded before Flop (didn't bet)
Seat 4: matiko09 (small blind) folded before Flop
Seat 5: pimpoza (big blind) folded before Flop
Seat 6: Sweden_Pound folded before Flop (didn't bet)
Seat 7: Ty Nick 420 folded before Flop (didn't bet)
Seat 8: Monsthand folded before Flop (didn't bet)
Seat 9: geniusgiqq showed [Th 8c] and lost with a straight, Eight to Queen





PokerStars Hand #149391713389:  Hold'em No Limit ($0.50/$1.00 USD) - 2016/02/25 16:33:24 CET [2016/02/25 10:33:24 ET]
Table 'Zeuxo II' 9-max Seat #7 is the button
Seat 1: b_____a__242 ($213 in chips) 
Seat 2: Sweden_Pound ($102.75 in chips) 
Seat 3: xAndorx ($100 in chips) 
Seat 4: sebaaastian ($123.61 in chips) 
Seat 5: bauss84 ($25.97 in chips) 
Seat 6: Cogss ($82.67 in chips) 
Seat 7: djammusic ($36.03 in chips) 
Seat 8: matiko09 ($100 in chips) 
Seat 9: Sreshta222 ($212.13 in chips) 
matiko09: posts small blind $0.50
Sreshta222: posts big blind $1
*** HOLE CARDS ***
Dealt to matiko09 [9s 4s]
b_____a__242: folds 
b_____a__242 leaves the table
Sweden_Pound: folds 
forsmthgood joins the table at seat #1 
xAndorx: folds 
sebaaastian: folds 
bauss84: calls $1
Cogss: folds 
djammusic: folds 
matiko09: folds 
Sreshta222: checks 
*** FLOP *** [2c 3h Kc]
Sreshta222: checks 
bauss84: bets $3
Sreshta222: calls $3
*** TURN *** [2c 3h Kc] [Jh]
Sreshta222: checks 
bauss84: bets $4
Sreshta222: calls $4
*** RIVER *** [2c 3h Kc Jh] [Qd]
Sreshta222: checks 
bauss84: checks 
*** SHOW DOWN ***
Sreshta222: shows [9c Qc] (a pair of Queens)
bauss84: mucks hand 
Sreshta222 collected $15.76 from pot
*** SUMMARY ***
Total pot $16.50 | Rake $0.74 
Board [2c 3h Kc Jh Qd]
Seat 1: b_____a__242 folded before Flop (didn't bet)
Seat 2: Sweden_Pound folded before Flop (didn't bet)
Seat 3: xAndorx folded before Flop (didn't bet)
Seat 4: sebaaastian folded before Flop (didn't bet)
Seat 5: bauss84 mucked [Ad 2s]
Seat 6: Cogss folded before Flop (didn't bet)
Seat 7: djammusic (button) folded before Flop (didn't bet)
Seat 8: matiko09 (small blind) folded before Flop
Seat 9: Sreshta222 (big blind) showed [9c Qc] and won ($15.76) with a pair of Queens





PokerStars Hand #149391720432:  Hold'em No Limit ($0.50/$1.00 USD) - 2016/02/25 16:33:33 CET [2016/02/25 10:33:33 ET]
Table 'Eros II' 9-max Seat #4 is the button
Seat 1: sebaaastian ($100 in chips) 
Seat 2: Sweden_Pound ($106.50 in chips) 
Seat 3: niong62 ($78.68 in chips) 
Seat 4: hammerwife ($100 in chips) 
Seat 5: lysandrafly ($100 in chips) 
Seat 6: el Fatto ($104.23 in chips) 
Seat 7: xAndorx ($125.84 in chips) 
Seat 8: matiko09 ($100 in chips) 
Seat 9: b_____a__242 ($83.55 in chips) 
lysandrafly: posts small blind $0.50
el Fatto: posts big blind $1
*** HOLE CARDS ***
Dealt to matiko09 [6d Ac]
xAndorx: folds 
xAndorx leaves the table
matiko09: folds 
b_____a__242: folds 
sebaaastian: folds 
Sweden_Pound: raises $2 to $3
niong62: folds 
hammerwife: folds 
lysandrafly: folds 
el Fatto: folds 
Uncalled bet ($2) returned to Sweden_Pound
Sweden_Pound collected $2.50 from pot
Sweden_Pound: doesn't show hand 
*** SUMMARY ***
Total pot $2.50 | Rake $0 
Seat 1: sebaaastian folded before Flop (didn't bet)
Seat 2: Sweden_Pound collected ($2.50)
Seat 3: niong62 folded before Flop (didn't bet)
Seat 4: hammerwife (button) folded before Flop (didn't bet)
Seat 5: lysandrafly (small blind) folded before Flop
Seat 6: el Fatto (big blind) folded before Flop
Seat 7: xAndorx folded before Flop (didn't bet)
Seat 8: matiko09 folded before Flop (didn't bet)
Seat 9: b_____a__242 folded before Flop (didn't bet)





PokerStars Hand #149391728393:  Hold'em No Limit ($0.25/$0.50 USD) - 2016/02/25 16:33:44 CET [2016/02/25 10:33:44 ET]
Table 'Thalpius III' 9-max Seat #3 is the button
Seat 1: BrotherLove9 ($53.60 in chips) 
Seat 2: matiko09 ($54.89 in chips) 
Seat 3: jamba83 ($53.06 in chips) 
Seat 4: Wwwasian ($50 in chips) 
Seat 5: Rorerzap ($56.27 in chips) 
Seat 7: v4n0v ($50 in chips) 
Seat 8: jeroemie123 ($47.56 in chips) 
Seat 9: Gemb1rdd ($66.68 in chips) 
Wwwasian: posts small blind $0.25
Rorerzap: posts big blind $0.50
rdrill: sits out 
*** HOLE CARDS ***
Dealt to matiko09 [As Ts]
v4n0v: folds 
jeroemie123: raises $0.50 to $1
Gemb1rdd: folds 
BrotherLove9: folds 
matiko09: raises $2.50 to $3.50
jamba83: folds 
Wwwasian: folds 
Rorerzap: folds 
jeroemie123: calls $2.50
*** FLOP *** [Td 2c Ks]
jeroemie123: checks 
matiko09: checks 
*** TURN *** [Td 2c Ks] [4c]
jeroemie123: checks 
matiko09: bets $4.81
jeroemie123: folds 
Uncalled bet ($4.81) returned to matiko09
matiko09 collected $7.40 from pot
matiko09: doesn't show hand 
*** SUMMARY ***
Total pot $7.75 | Rake $0.35 
Board [Td 2c Ks 4c]
Seat 1: BrotherLove9 folded before Flop (didn't bet)
Seat 2: matiko09 collected ($7.40)
Seat 3: jamba83 (button) folded before Flop (didn't bet)
Seat 4: Wwwasian (small blind) folded before Flop
Seat 5: Rorerzap (big blind) folded before Flop
Seat 7: v4n0v folded before Flop (didn't bet)
Seat 8: jeroemie123 folded on the Turn
Seat 9: Gemb1rdd folded before Flop (didn't bet)





PokerStars Hand #149391730630:  Hold'em No Limit ($0.50/$1.00 USD) - 2016/02/25 16:33:47 CET [2016/02/25 10:33:47 ET]
Table 'Lucia III' 9-max Seat #8 is the button
Seat 1: Monsthand ($125.45 in chips) 
Seat 2: kuanhung0903 ($77.50 in chips) 
Seat 3: mycka86 ($109.62 in chips) 
Seat 4: swatek1986 ($133.09 in chips) 
Seat 5: Sweden_Pound ($224.43 in chips) 
Seat 6: matiko09 ($109.23 in chips) 
Seat 7: Ty Nick 420 ($178.02 in chips) 
Seat 8: apfush ($100 in chips) 
Seat 9: Apparat888 ($37.45 in chips) 
Apparat888: posts small blind $0.50
Monsthand: posts big blind $1
*** HOLE CARDS ***
Dealt to matiko09 [Jc 8h]
kuanhung0903: folds 
mycka86: folds 
swatek1986: raises $2 to $3
Sweden_Pound: folds 
matiko09: folds 
Ty Nick 420: folds 
apfush: folds 
Apparat888: folds 
Monsthand: folds 
Uncalled bet ($2) returned to swatek1986
swatek1986 collected $2.50 from pot
*** SUMMARY ***
Total pot $2.50 | Rake $0 
Seat 1: Monsthand (big blind) folded before Flop
Seat 2: kuanhung0903 folded before Flop (didn't bet)
Seat 3: mycka86 folded before Flop (didn't bet)
Seat 4: swatek1986 collected ($2.50)
Seat 5: Sweden_Pound folded before Flop (didn't bet)
Seat 6: matiko09 folded before Flop (didn't bet)
Seat 7: Ty Nick 420 folded before Flop (didn't bet)
Seat 8: apfush (button) folded before Flop (didn't bet)
Seat 9: Apparat888 (small blind) folded before Flop





PokerStars Hand #149391738818:  Hold'em No Limit ($0.25/$0.50 USD) - 2016/02/25 16:33:57 CET [2016/02/25 10:33:57 ET]
Table 'Lohja II' 9-max Seat #3 is the button
Seat 1: MoonJimmy ($147.93 in chips) 
Seat 2: Apparat888 ($29.48 in chips) 
Seat 3: guvalc1952 ($136.42 in chips) 
Seat 4: r4mz3s ($57.51 in chips) 
Seat 5: Bron By ($50 in chips) 
Seat 6: Player1705 ($125 in chips) 
Seat 7: matiko09 ($157.72 in chips) 
Seat 8: jamba83 ($59.50 in chips) 
Seat 9: Muinmyheart ($84.09 in chips) 
r4mz3s: posts small blind $0.25
Bron By: posts big blind $0.50
MoonJimmy: posts the ante $0.10
Apparat888: posts the ante $0.10
guvalc1952: posts the ante $0.10
r4mz3s: posts the ante $0.10
Bron By: posts the ante $0.10
Player1705: posts the ante $0.10
matiko09: posts the ante $0.10
jamba83: posts the ante $0.10
Muinmyheart: posts the ante $0.10
*** HOLE CARDS ***
Dealt to matiko09 [Ah Tc]
Player1705: folds 
matiko09: folds 
jamba83: folds 
Muinmyheart: folds 
MoonJimmy: folds 
Apparat888: folds 
guvalc1952: calls $0.50
r4mz3s: raises $2 to $2.50
Bron By: folds 
guvalc1952: calls $2
*** FLOP *** [2d 8c 3s]
r4mz3s: checks 
Bron By leaves the table
vasiy379 joins the table at seat #5 
guvalc1952: checks 
*** TURN *** [2d 8c 3s] [4c]
r4mz3s: checks 
guvalc1952: bets $2.50
r4mz3s: calls $2.50
*** RIVER *** [2d 8c 3s 4c] [7d]
r4mz3s: checks 
guvalc1952: checks 
*** SHOW DOWN ***
r4mz3s: shows [Td As] (high card Ace)
guvalc1952: shows [Ts 3h] (a pair of Threes)
guvalc1952 collected $10.89 from pot
*** SUMMARY ***
Total pot $11.40 | Rake $0.51 
Board [2d 8c 3s 4c 7d]
Seat 1: MoonJimmy folded before Flop (didn't bet)
Seat 2: Apparat888 folded before Flop (didn't bet)
Seat 3: guvalc1952 (button) showed [Ts 3h] and won ($10.89) with a pair of Threes
Seat 4: r4mz3s (small blind) showed [Td As] and lost with high card Ace
Seat 5: Bron By (big blind) folded before Flop
Seat 6: Player1705 folded before Flop (didn't bet)
Seat 7: matiko09 folded before Flop (didn't bet)
Seat 8: jamba83 folded before Flop (didn't bet)
Seat 9: Muinmyheart folded before Flop (didn't bet)





PokerStars Hand #149391739921:  Hold'em No Limit ($0.50/$1.00 USD) - 2016/02/25 16:33:59 CET [2016/02/25 10:33:59 ET]
Table 'Kleopatra II' 9-max Seat #4 is the button
Seat 1: wsg86 ($100 in chips) 
Seat 2: mycka86 ($100 in chips) 
Seat 3: Monsthand ($199.32 in chips) 
Seat 4: Joe_Carlos ($38.50 in chips) 
Seat 5: apfush ($100 in chips) 
Seat 6: Sweden_Pound ($114.05 in chips) 
Seat 7: RMilPoker ($100.70 in chips) 
Seat 8: Lesley2002 ($111.94 in chips) 
Seat 9: matiko09 ($100 in chips) 
apfush: posts small blind $0.50
Sweden_Pound: posts big blind $1
*** HOLE CARDS ***
Dealt to matiko09 [2c 4s]
RMilPoker: folds 
Lesley2002 has timed out
Lesley2002: folds 
matiko09: folds 
wsg86: raises $2 to $3
mycka86: folds 
Monsthand: folds 
Joe_Carlos: calls $3
apfush: folds 
Sweden_Pound: folds 
*** FLOP *** [6s 2h 5c]
wsg86: checks 
Joe_Carlos: checks 
*** TURN *** [6s 2h 5c] [Kd]
wsg86: checks 
Joe_Carlos: bets $5
wsg86: folds 
Uncalled bet ($5) returned to Joe_Carlos
Joe_Carlos collected $7.16 from pot
Joe_Carlos: doesn't show hand 
*** SUMMARY ***
Total pot $7.50 | Rake $0.34 
Board [6s 2h 5c Kd]
Seat 1: wsg86 folded on the Turn
Seat 2: mycka86 folded before Flop (didn't bet)
Seat 3: Monsthand folded before Flop (didn't bet)
Seat 4: Joe_Carlos (button) collected ($7.16)
Seat 5: apfush (small blind) folded before Flop
Seat 6: Sweden_Pound (big blind) folded before Flop
Seat 7: RMilPoker folded before Flop (didn't bet)
Seat 8: Lesley2002 folded before Flop (didn't bet)
Seat 9: matiko09 folded before Flop (didn't bet)





PokerStars Hand #149391743862:  Hold'em No Limit ($0.50/$1.00 USD) - 2016/02/25 16:34:04 CET [2016/02/25 10:34:04 ET]
Table 'Simona' 9-max Seat #4 is the button
Seat 1: mycka86 ($114.21 in chips) 
Seat 2: xAndorx ($109.03 in chips) 
Seat 3: Sweden_Pound ($100 in chips) 
Seat 4: matiko09 ($276.42 in chips) 
Seat 5: sebaaastian ($100 in chips) 
Seat 6: Ty Nick 420 ($106 in chips) 
Seat 7: Aalleekks ($103.80 in chips) 
Seat 8: Monsthand ($133.26 in chips) 
Seat 9: Slushpup69 ($56.15 in chips) 
sebaaastian: posts small blind $0.50
Ty Nick 420: posts big blind $1
*** HOLE CARDS ***
Dealt to matiko09 [2s 9h]
Aalleekks: folds 
Monsthand: folds 
Slushpup69: raises $1.70 to $2.70
mycka86: folds 
xAndorx: folds 
Sweden_Pound: folds 
matiko09: folds 
sebaaastian: folds 
Ty Nick 420: folds 
Uncalled bet ($1.70) returned to Slushpup69
Slushpup69 collected $2.50 from pot
*** SUMMARY ***
Total pot $2.50 | Rake $0 
Seat 1: mycka86 folded before Flop (didn't bet)
Seat 2: xAndorx folded before Flop (didn't bet)
Seat 3: Sweden_Pound folded before Flop (didn't bet)
Seat 4: matiko09 (button) folded before Flop (didn't bet)
Seat 5: sebaaastian (small blind) folded before Flop
Seat 6: Ty Nick 420 (big blind) folded before Flop
Seat 7: Aalleekks folded before Flop (didn't bet)
Seat 8: Monsthand folded before Flop (didn't bet)
Seat 9: Slushpup69 collected ($2.50)





PokerStars Hand #149391745816:  Hold'em No Limit ($0.50/$1.00 USD) - 2016/02/25 16:34:07 CET [2016/02/25 10:34:07 ET]
Table 'Guisan' 9-max Seat #8 is the button
Seat 1: stockbridge8 ($73.50 in chips) 
Seat 2: mycka86 ($100 in chips) 
Seat 3: Ju$tTrustMe ($100 in chips) 
Seat 4: matiko09 ($175.25 in chips) 
Seat 5: Jeckpot1989 ($40.05 in chips) 
Seat 6: 19R&J91 ($391.69 in chips) 
Seat 7: sebaaastian ($116.59 in chips) 
Seat 8: Monsthand ($100 in chips) 
Seat 9: Sweden_Pound ($100 in chips) 
Sweden_Pound: posts small blind $0.50
stockbridge8: posts big blind $1
*** HOLE CARDS ***
Dealt to matiko09 [2s 4s]
mycka86: folds 
Ju$tTrustMe: raises $2 to $3
matiko09: folds 
Jeckpot1989: folds 
19R&J91: folds 
sebaaastian: folds 
Monsthand: folds 
Sweden_Pound: folds 
stockbridge8: folds 
Uncalled bet ($2) returned to Ju$tTrustMe
Ju$tTrustMe collected $2.50 from pot
*** SUMMARY ***
Total pot $2.50 | Rake $0 
Seat 1: stockbridge8 (big blind) folded before Flop
Seat 2: mycka86 folded before Flop (didn't bet)
Seat 3: Ju$tTrustMe collected ($2.50)
Seat 4: matiko09 folded before Flop (didn't bet)
Seat 5: Jeckpot1989 folded before Flop (didn't bet)
Seat 6: 19R&J91 folded before Flop (didn't bet)
Seat 7: sebaaastian folded before Flop (didn't bet)
Seat 8: Monsthand (button) folded before Flop (didn't bet)
Seat 9: Sweden_Pound (small blind) folded before Flop





PokerStars Hand #149391754484:  Hold'em No Limit ($0.50/$1.00 USD) - 2016/02/25 16:34:18 CET [2016/02/25 10:34:18 ET]
Table 'Lina II' 9-max Seat #6 is the button
Seat 1: Lesley2002 ($175.54 in chips) 
Seat 2: matiko09 ($103.21 in chips) 
Seat 4: Nennenurse ($56.63 in chips) 
Seat 5: swizzly58 ($39.50 in chips) 
Seat 6: sebaaastian ($100.50 in chips) 
Seat 7: Monsthand ($140.30 in chips) 
Seat 8: djammusic ($45.64 in chips) 
Seat 9: Sweden_Pound ($269.27 in chips) 
Monsthand: posts small blind $0.50
djammusic: posts big blind $1
Ouga Buga: sits out 
*** HOLE CARDS ***
Dealt to matiko09 [5s Kd]
Sweden_Pound: raises $2 to $3
Lesley2002: folds 
matiko09: folds 
Nennenurse: folds 
swizzly58: folds 
sebaaastian: folds 
Monsthand: folds 
djammusic: folds 
Uncalled bet ($2) returned to Sweden_Pound
Sweden_Pound collected $2.50 from pot
Sweden_Pound: doesn't show hand 
*** SUMMARY ***
Total pot $2.50 | Rake $0 
Seat 1: Lesley2002 folded before Flop (didn't bet)
Seat 2: matiko09 folded before Flop (didn't bet)
Seat 4: Nennenurse folded before Flop (didn't bet)
Seat 5: swizzly58 folded before Flop (didn't bet)
Seat 6: sebaaastian (button) folded before Flop (didn't bet)
Seat 7: Monsthand (small blind) folded before Flop
Seat 8: djammusic (big blind) folded before Flop
Seat 9: Sweden_Pound collected ($2.50)





PokerStars Hand #149391755065:  Hold'em No Limit ($0.50/$1.00 USD) - 2016/02/25 16:34:19 CET [2016/02/25 10:34:19 ET]
Table 'Lucia III' 9-max Seat #9 is the button
Seat 1: Monsthand ($124.45 in chips) 
Seat 2: kuanhung0903 ($77.50 in chips) 
Seat 3: mycka86 ($109.62 in chips) 
Seat 4: swatek1986 ($134.59 in chips) 
Seat 5: Sweden_Pound ($224.43 in chips) 
Seat 6: matiko09 ($109.23 in chips) 
Seat 7: Ty Nick 420 ($178.02 in chips) 
Seat 8: apfush ($100 in chips) 
Seat 9: Apparat888 ($36.95 in chips) 
Monsthand: posts small blind $0.50
kuanhung0903: posts big blind $1
*** HOLE CARDS ***
Dealt to matiko09 [4s 8c]
mycka86: folds 
swatek1986: folds 
Sweden_Pound: folds 
matiko09: folds 
Ty Nick 420: folds 
apfush: folds 
Apparat888: raises $1.50 to $2.50
Monsthand: folds 
kuanhung0903: raises $5.50 to $8
Apparat888: folds 
Uncalled bet ($5.50) returned to kuanhung0903
kuanhung0903 collected $5.50 from pot
kuanhung0903: doesn't show hand 
*** SUMMARY ***
Total pot $5.50 | Rake $0 
Seat 1: Monsthand (small blind) folded before Flop
Seat 2: kuanhung0903 (big blind) collected ($5.50)
Seat 3: mycka86 folded before Flop (didn't bet)
Seat 4: swatek1986 folded before Flop (didn't bet)
Seat 5: Sweden_Pound folded before Flop (didn't bet)
Seat 6: matiko09 folded before Flop (didn't bet)
Seat 7: Ty Nick 420 folded before Flop (didn't bet)
Seat 8: apfush folded before Flop (didn't bet)
Seat 9: Apparat888 (button) folded before Flop





PokerStars Hand #149391767446:  Hold'em No Limit ($0.50/$1.00 USD) - 2016/02/25 16:34:35 CET [2016/02/25 10:34:35 ET]
Table 'Morosovia II' 9-max Seat #4 is the button
Seat 1: apfush ($196.46 in chips) 
Seat 2: lysandrafly ($100 in chips) 
Seat 3: sebaaastian ($136.87 in chips) 
Seat 4: matiko09 ($170.35 in chips) 
Seat 5: pimpoza ($66.89 in chips) 
Seat 6: Sweden_Pound ($140.11 in chips) 
Seat 7: Ty Nick 420 ($194.19 in chips) 
Seat 8: Monsthand ($100.50 in chips) 
pimpoza: posts small blind $0.50
Sweden_Pound: posts big blind $1
*** HOLE CARDS ***
Dealt to matiko09 [Ad 4d]
Ty Nick 420: folds 
Monsthand: folds 
apfush: folds 
geniusgiqq leaves the table
Ouga Buga joins the table at seat #9 
lysandrafly: raises $2 to $3
sebaaastian: folds 
matiko09: folds 
pimpoza: folds 
Sweden_Pound: folds 
Uncalled bet ($2) returned to lysandrafly
lysandrafly collected $2.50 from pot
lysandrafly: doesn't show hand 
*** SUMMARY ***
Total pot $2.50 | Rake $0 
Seat 1: apfush folded before Flop (didn't bet)
Seat 2: lysandrafly collected ($2.50)
Seat 3: sebaaastian folded before Flop (didn't bet)
Seat 4: matiko09 (button) folded before Flop (didn't bet)
Seat 5: pimpoza (small blind) folded before Flop
Seat 6: Sweden_Pound (big blind) folded before Flop
Seat 7: Ty Nick 420 folded before Flop (didn't bet)
Seat 8: Monsthand folded before Flop (didn't bet)





PokerStars Hand #149391768321:  Hold'em No Limit ($0.25/$0.50 USD) - 2016/02/25 16:34:36 CET [2016/02/25 10:34:36 ET]
Table 'Thalpius III' 9-max Seat #4 is the button
Seat 1: BrotherLove9 ($53.60 in chips) 
Seat 2: matiko09 ($58.79 in chips) 
Seat 3: jamba83 ($53.06 in chips) 
Seat 4: Wwwasian ($50 in chips) 
Seat 5: Rorerzap ($55.77 in chips) 
Seat 6: rdrill ($50 in chips) 
Seat 7: v4n0v ($50 in chips) 
Seat 8: jeroemie123 ($44.06 in chips) 
Seat 9: Gemb1rdd ($66.68 in chips) 
Rorerzap: posts small blind $0.25
rdrill: posts big blind $0.50
*** HOLE CARDS ***
Dealt to matiko09 [9d 5s]
v4n0v: folds 
jeroemie123: raises $0.50 to $1
Gemb1rdd: folds 
BrotherLove9: folds 
matiko09: folds 
jamba83: folds 
Wwwasian: folds 
Rorerzap: folds 
rdrill: raises $3 to $4
jeroemie123: calls $3
*** FLOP *** [Jc Ah 2s]
rdrill: bets $4.50
jeroemie123: calls $4.50
*** TURN *** [Jc Ah 2s] [2h]
rdrill: bets $11.25
jeroemie123: folds 
Uncalled bet ($11.25) returned to rdrill
rdrill collected $16.47 from pot
*** SUMMARY ***
Total pot $17.25 | Rake $0.78 
Board [Jc Ah 2s 2h]
Seat 1: BrotherLove9 folded before Flop (didn't bet)
Seat 2: matiko09 folded before Flop (didn't bet)
Seat 3: jamba83 folded before Flop (didn't bet)
Seat 4: Wwwasian (button) folded before Flop (didn't bet)
Seat 5: Rorerzap (small blind) folded before Flop
Seat 6: rdrill (big blind) collected ($16.47)
Seat 7: v4n0v folded before Flop (didn't bet)
Seat 8: jeroemie123 folded on the Turn
Seat 9: Gemb1rdd folded before Flop (didn't bet)





PokerStars Hand #149391771078:  Hold'em No Limit ($0.50/$1.00 USD) - 2016/02/25 16:34:40 CET [2016/02/25 10:34:40 ET]
Table 'Zeuxo II' 9-max Seat #8 is the button
Seat 1: forsmthgood ($100 in chips) 
Seat 2: Sweden_Pound ($102.75 in chips) 
Seat 3: xAndorx ($100 in chips) 
Seat 4: sebaaastian ($123.61 in chips) 
Seat 5: bauss84 ($17.97 in chips) 
Seat 6: Cogss ($100 in chips) 
Seat 7: djammusic ($36.03 in chips) 
Seat 8: matiko09 ($100 in chips) 
Seat 9: Sreshta222 ($219.89 in chips) 
Sreshta222: posts small blind $0.50
forsmthgood: posts big blind $1
*** HOLE CARDS ***
Dealt to matiko09 [3h Jd]
Sweden_Pound: raises $2 to $3
xAndorx: folds 
sebaaastian: folds 
bauss84: folds 
Cogss: folds 
djammusic: folds 
matiko09: folds 
Sreshta222: folds 
forsmthgood: folds 
Uncalled bet ($2) returned to Sweden_Pound
Sweden_Pound collected $2.50 from pot
Sweden_Pound: doesn't show hand 
*** SUMMARY ***
Total pot $2.50 | Rake $0 
Seat 1: forsmthgood (big blind) folded before Flop
Seat 2: Sweden_Pound collected ($2.50)
Seat 3: xAndorx folded before Flop (didn't bet)
Seat 4: sebaaastian folded before Flop (didn't bet)
Seat 5: bauss84 folded before Flop (didn't bet)
Seat 6: Cogss folded before Flop (didn't bet)
Seat 7: djammusic folded before Flop (didn't bet)
Seat 8: matiko09 (button) folded before Flop (didn't bet)
Seat 9: Sreshta222 (small blind) folded before Flop





PokerStars Hand #149391783514:  Hold'em No Limit (€0.25/€0.50 EUR) - 2016/02/25 16:34:56 CET [2016/02/25 10:34:56 ET]
Table 'Leo Minor III' 9-max Seat #4 is the button
Seat 1: Al3xAnd3r22 (€51.25 in chips) 
Seat 2: vasiy379 (€50 in chips) 
Seat 3: Rorerzap (€51.60 in chips) 
Seat 4: RvPersie (€69.20 in chips) 
Seat 5: kasse_62 (€32.31 in chips) 
Seat 6: Wwwasian (€54.04 in chips) 
Seat 7: Apparat888 (€29.01 in chips) 
Seat 8: mi$$I$Elena (€86.65 in chips) 
Seat 9: matiko09 (€50 in chips) 
kasse_62: posts small blind €0.25
Wwwasian: posts big blind €0.50
*** HOLE CARDS ***
Dealt to matiko09 [5h 2d]
Apparat888: folds 
mi$$I$Elena: folds 
matiko09: folds 
Al3xAnd3r22: folds 
vasiy379: folds 
Rorerzap: folds 
RvPersie: raises €0.75 to €1.25
kasse_62: calls €1
Wwwasian: folds 
*** FLOP *** [Qs 7d 2s]
kasse_62: checks 
RvPersie: bets €2.14
kasse_62: folds 
Uncalled bet (€2.14) returned to RvPersie
RvPersie collected €2.86 from pot
RvPersie: doesn't show hand 
*** SUMMARY ***
Total pot €3 | Rake €0.14 
Board [Qs 7d 2s]
Seat 1: Al3xAnd3r22 folded before Flop (didn't bet)
Seat 2: vasiy379 folded before Flop (didn't bet)
Seat 3: Rorerzap folded before Flop (didn't bet)
Seat 4: RvPersie (button) collected (€2.86)
Seat 5: kasse_62 (small blind) folded on the Flop
Seat 6: Wwwasian (big blind) folded before Flop
Seat 7: Apparat888 folded before Flop (didn't bet)
Seat 8: mi$$I$Elena folded before Flop (didn't bet)
Seat 9: matiko09 folded before Flop (didn't bet)





PokerStars Hand #149391783321:  Hold'em No Limit ($0.50/$1.00 USD) - 2016/02/25 16:34:56 CET [2016/02/25 10:34:56 ET]
Table 'Lina II' 9-max Seat #7 is the button
Seat 1: Lesley2002 ($175.54 in chips) 
Seat 2: matiko09 ($103.21 in chips) 
Seat 4: Nennenurse ($56.63 in chips) 
Seat 5: swizzly58 ($39.50 in chips) 
Seat 6: sebaaastian ($100.50 in chips) 
Seat 7: Monsthand ($139.80 in chips) 
Seat 8: djammusic ($44.64 in chips) 
Seat 9: Sweden_Pound ($270.77 in chips) 
djammusic: posts small blind $0.50
Sweden_Pound: posts big blind $1
Ouga Buga: sits out 
*** HOLE CARDS ***
Dealt to matiko09 [7d 7c]
Lesley2002: folds 
matiko09: raises $2 to $3
Nennenurse: calls $3
swizzly58: folds 
sebaaastian: folds 
Monsthand: folds 
djammusic: folds 
Sweden_Pound: folds 
*** FLOP *** [4c 8c 4s]
matiko09: checks 
Nennenurse: checks 
*** TURN *** [4c 8c 4s] [2s]
matiko09: bets $4
Nennenurse: calls $4
*** RIVER *** [4c 8c 4s 2s] [8d]
matiko09: checks 
Nennenurse: checks 
*** SHOW DOWN ***
matiko09: shows [7d 7c] (two pair, Eights and Sevens)
Nennenurse: mucks hand 
matiko09 collected $14.80 from pot
*** SUMMARY ***
Total pot $15.50 | Rake $0.70 
Board [4c 8c 4s 2s 8d]
Seat 1: Lesley2002 folded before Flop (didn't bet)
Seat 2: matiko09 showed [7d 7c] and won ($14.80) with two pair, Eights and Sevens
Seat 4: Nennenurse mucked [6s As]
Seat 5: swizzly58 folded before Flop (didn't bet)
Seat 6: sebaaastian folded before Flop (didn't bet)
Seat 7: Monsthand (button) folded before Flop (didn't bet)
Seat 8: djammusic (small blind) folded before Flop
Seat 9: Sweden_Pound (big blind) folded before Flop





PokerStars Hand #149391785575:  Hold'em No Limit ($0.50/$1.00 USD) - 2016/02/25 16:34:59 CET [2016/02/25 10:34:59 ET]
Table 'Guisan' 9-max Seat #9 is the button
Seat 1: stockbridge8 ($72.50 in chips) 
Seat 2: mycka86 ($100 in chips) 
Seat 3: Ju$tTrustMe ($101.50 in chips) 
Seat 4: matiko09 ($175.25 in chips) 
Seat 5: Jeckpot1989 ($40.05 in chips) 
Seat 6: 19R&J91 ($391.69 in chips) 
Seat 7: sebaaastian ($116.59 in chips) 
Seat 8: Monsthand ($100 in chips) 
Seat 9: Sweden_Pound ($100 in chips) 
stockbridge8: posts small blind $0.50
mycka86: posts big blind $1
*** HOLE CARDS ***
Dealt to matiko09 [Qh Ts]
Ju$tTrustMe: raises $2 to $3
matiko09: folds 
Jeckpot1989: calls $3
19R&J91: folds 
sebaaastian: folds 
Monsthand: folds 
Sweden_Pound: folds 
stockbridge8: folds 
mycka86: folds 
*** FLOP *** [8h Qc 8d]
Ju$tTrustMe: checks 
Jeckpot1989: bets $3.58
Ju$tTrustMe: calls $3.58
*** TURN *** [8h Qc 8d] [2h]
Ju$tTrustMe: checks 
Jeckpot1989: checks 
*** RIVER *** [8h Qc 8d 2h] [5c]
Ju$tTrustMe: bets $5
Jeckpot1989: calls $5
*** SHOW DOWN ***
Ju$tTrustMe: shows [Qs Ks] (two pair, Queens and Eights)
Jeckpot1989: mucks hand 
Ju$tTrustMe collected $23.55 from pot
*** SUMMARY ***
Total pot $24.66 | Rake $1.11 
Board [8h Qc 8d 2h 5c]
Seat 1: stockbridge8 (small blind) folded before Flop
Seat 2: mycka86 (big blind) folded before Flop
Seat 3: Ju$tTrustMe showed [Qs Ks] and won ($23.55) with two pair, Queens and Eights
Seat 4: matiko09 folded before Flop (didn't bet)
Seat 5: Jeckpot1989 mucked [4h 4c]
Seat 6: 19R&J91 folded before Flop (didn't bet)
Seat 7: sebaaastian folded before Flop (didn't bet)
Seat 8: Monsthand folded before Flop (didn't bet)
Seat 9: Sweden_Pound (button) folded before Flop (didn't bet)





PokerStars Hand #149391787379:  Hold'em No Limit ($0.50/$1.00 USD) - 2016/02/25 16:35:01 CET [2016/02/25 10:35:01 ET]
Table 'Simona' 9-max Seat #5 is the button
Seat 1: mycka86 ($114.21 in chips) 
Seat 2: xAndorx ($109.03 in chips) 
Seat 3: Sweden_Pound ($100 in chips) 
Seat 4: matiko09 ($276.42 in chips) 
Seat 5: sebaaastian ($100 in chips) 
Seat 6: Ty Nick 420 ($105 in chips) 
Seat 7: Aalleekks ($103.80 in chips) 
Seat 8: Monsthand ($133.26 in chips) 
Seat 9: Slushpup69 ($57.65 in chips) 
Ty Nick 420: posts small blind $0.50
Aalleekks: posts big blind $1
*** HOLE CARDS ***
Dealt to matiko09 [8h 7c]
Monsthand: raises $2 to $3
Slushpup69: folds 
mycka86: folds 
xAndorx: folds 
Sweden_Pound: folds 
matiko09: folds 
sebaaastian: folds 
Ty Nick 420: folds 
Aalleekks: calls $2
*** FLOP *** [7h 8c Td]
Aalleekks: checks 
Monsthand: bets $4
Aalleekks: folds 
Uncalled bet ($4) returned to Monsthand
Monsthand collected $6.21 from pot
*** SUMMARY ***
Total pot $6.50 | Rake $0.29 
Board [7h 8c Td]
Seat 1: mycka86 folded before Flop (didn't bet)
Seat 2: xAndorx folded before Flop (didn't bet)
Seat 3: Sweden_Pound folded before Flop (didn't bet)
Seat 4: matiko09 folded before Flop (didn't bet)
Seat 5: sebaaastian (button) folded before Flop (didn't bet)
Seat 6: Ty Nick 420 (small blind) folded before Flop
Seat 7: Aalleekks (big blind) folded on the Flop
Seat 8: Monsthand collected ($6.21)
Seat 9: Slushpup69 folded before Flop (didn't bet)





PokerStars Hand #149391788501:  Hold'em No Limit ($0.50/$1.00 USD) - 2016/02/25 16:35:03 CET [2016/02/25 10:35:03 ET]
Table 'Lucia III' 9-max Seat #1 is the button
Seat 1: Monsthand ($123.95 in chips) 
Seat 2: kuanhung0903 ($80.50 in chips) 
Seat 3: mycka86 ($109.62 in chips) 
Seat 4: swatek1986 ($134.59 in chips) 
Seat 5: Sweden_Pound ($224.43 in chips) 
Seat 6: matiko09 ($109.23 in chips) 
Seat 7: Ty Nick 420 ($178.02 in chips) 
Seat 8: apfush ($100 in chips) 
Seat 9: Apparat888 ($34.45 in chips) 
kuanhung0903: posts small blind $0.50
mycka86: posts big blind $1
*** HOLE CARDS ***
Dealt to matiko09 [7c Jd]
swatek1986: folds 
Sweden_Pound: folds 
matiko09: folds 
Ty Nick 420: folds 
apfush: raises $2 to $3
Apparat888: folds 
Monsthand: folds 
kuanhung0903: calls $2.50
mycka86: calls $2
*** FLOP *** [8s Tc 4d]
kuanhung0903: checks 
mycka86: checks 
apfush: bets $6
kuanhung0903 is disconnected 
kuanhung0903 is connected 
kuanhung0903: folds 
mycka86: folds 
Uncalled bet ($6) returned to apfush
apfush collected $8.60 from pot
apfush: doesn't show hand 
*** SUMMARY ***
Total pot $9 | Rake $0.40 
Board [8s Tc 4d]
Seat 1: Monsthand (button) folded before Flop (didn't bet)
Seat 2: kuanhung0903 (small blind) folded on the Flop
Seat 3: mycka86 (big blind) folded on the Flop
Seat 4: swatek1986 folded before Flop (didn't bet)
Seat 5: Sweden_Pound folded before Flop (didn't bet)
Seat 6: matiko09 folded before Flop (didn't bet)
Seat 7: Ty Nick 420 folded before Flop (didn't bet)
Seat 8: apfush collected ($8.60)
Seat 9: Apparat888 folded before Flop (didn't bet)





PokerStars Hand #149391788973:  Hold'em No Limit ($0.50/$1.00 USD) - 2016/02/25 16:35:04 CET [2016/02/25 10:35:04 ET]
Table 'Kleopatra II' 9-max Seat #5 is the button
Seat 1: wsg86 ($100 in chips) 
Seat 2: mycka86 ($100 in chips) 
Seat 3: Monsthand ($199.32 in chips) 
Seat 4: Joe_Carlos ($42.66 in chips) 
Seat 5: apfush ($100 in chips) 
Seat 6: Sweden_Pound ($113.05 in chips) 
Seat 7: RMilPoker ($100.70 in chips) 
Seat 8: Lesley2002 ($111.94 in chips) 
Seat 9: matiko09 ($100 in chips) 
Sweden_Pound: posts small blind $0.50
RMilPoker: posts big blind $1
*** HOLE CARDS ***
Dealt to matiko09 [9c 9h]
Lesley2002: raises $1 to $2
matiko09: calls $2
wsg86: folds 
mycka86: folds 
Monsthand: folds 
Joe_Carlos: folds 
apfush: folds 
Sweden_Pound: calls $1.50
RMilPoker: folds 
*** FLOP *** [7c Js 2s]
Sweden_Pound: checks 
Lesley2002: bets $5
matiko09: calls $5
Sweden_Pound: raises $15 to $20
Lesley2002: calls $15
matiko09: folds 
*** TURN *** [7c Js 2s] [As]
Sweden_Pound: checks 
Lesley2002: bets $89.94 and is all-in
Sweden_Pound: folds 
Uncalled bet ($89.94) returned to Lesley2002
Lesley2002 collected $49.66 from pot
*** SUMMARY ***
Total pot $52 | Rake $2.34 
Board [7c Js 2s As]
Seat 1: wsg86 folded before Flop (didn't bet)
Seat 2: mycka86 folded before Flop (didn't bet)
Seat 3: Monsthand folded before Flop (didn't bet)
Seat 4: Joe_Carlos folded before Flop (didn't bet)
Seat 5: apfush (button) folded before Flop (didn't bet)
Seat 6: Sweden_Pound (small blind) folded on the Turn
Seat 7: RMilPoker (big blind) folded before Flop
Seat 8: Lesley2002 collected ($49.66)
Seat 9: matiko09 folded on the Flop





PokerStars Hand #149391792198:  Hold'em No Limit ($0.50/$1.00 USD) - 2016/02/25 16:35:08 CET [2016/02/25 10:35:08 ET]
Table 'Morosovia II' 9-max Seat #5 is the button
Seat 1: apfush ($196.46 in chips) 
Seat 2: lysandrafly ($101.50 in chips) 
Seat 3: sebaaastian ($136.87 in chips) 
Seat 4: matiko09 ($170.35 in chips) 
Seat 5: pimpoza ($66.39 in chips) 
Seat 6: Sweden_Pound ($139.11 in chips) 
Seat 7: Ty Nick 420 ($194.19 in chips) 
Seat 8: Monsthand ($100.50 in chips) 
Sweden_Pound: posts small blind $0.50
Ty Nick 420: posts big blind $1
Ouga Buga: sits out 
*** HOLE CARDS ***
Dealt to matiko09 [6d 2h]
Monsthand: folds 
apfush: folds 
lysandrafly: folds 
sebaaastian: folds 
matiko09: folds 
pimpoza: raises $2 to $3
Sweden_Pound: folds 
Ty Nick 420: folds 
Uncalled bet ($2) returned to pimpoza
pimpoza collected $2.50 from pot
*** SUMMARY ***
Total pot $2.50 | Rake $0 
Seat 1: apfush folded before Flop (didn't bet)
Seat 2: lysandrafly folded before Flop (didn't bet)
Seat 3: sebaaastian folded before Flop (didn't bet)
Seat 4: matiko09 folded before Flop (didn't bet)
Seat 5: pimpoza (button) collected ($2.50)
Seat 6: Sweden_Pound (small blind) folded before Flop
Seat 7: Ty Nick 420 (big blind) folded before Flop
Seat 8: Monsthand folded before Flop (didn't bet)





PokerStars Hand #149391795654:  Hold'em No Limit ($0.50/$1.00 USD) - 2016/02/25 16:35:12 CET [2016/02/25 10:35:12 ET]
Table 'Zeuxo II' 9-max Seat #9 is the button
Seat 1: forsmthgood ($100 in chips) 
Seat 2: Sweden_Pound ($104.25 in chips) 
Seat 3: xAndorx ($100 in chips) 
Seat 4: sebaaastian ($123.61 in chips) 
Seat 5: bauss84 ($17.97 in chips) 
Seat 6: Cogss ($100 in chips) 
Seat 7: djammusic ($36.03 in chips) 
Seat 8: matiko09 ($100 in chips) 
Seat 9: Sreshta222 ($219.39 in chips) 
forsmthgood: posts small blind $0.50
Sweden_Pound: posts big blind $1
*** HOLE CARDS ***
Dealt to matiko09 [5c Ac]
xAndorx: folds 
sebaaastian: folds 
bauss84: folds 
Cogss: raises $1 to $2
djammusic: folds 
matiko09: folds 
Sreshta222: folds 
forsmthgood: folds 
Sweden_Pound: folds 
Uncalled bet ($1) returned to Cogss
Cogss collected $2.50 from pot
*** SUMMARY ***
Total pot $2.50 | Rake $0 
Seat 1: forsmthgood (small blind) folded before Flop
Seat 2: Sweden_Pound (big blind) folded before Flop
Seat 3: xAndorx folded before Flop (didn't bet)
Seat 4: sebaaastian folded before Flop (didn't bet)
Seat 5: bauss84 folded before Flop (didn't bet)
Seat 6: Cogss collected ($2.50)
Seat 7: djammusic folded before Flop (didn't bet)
Seat 8: matiko09 folded before Flop (didn't bet)
Seat 9: Sreshta222 (button) folded before Flop (didn't bet)





PokerStars Hand #149391804548:  Hold'em No Limit ($0.25/$0.50 USD) - 2016/02/25 16:35:24 CET [2016/02/25 10:35:24 ET]
Table 'Lohja II' 9-max Seat #4 is the button
Seat 1: MoonJimmy ($147.83 in chips) 
Seat 2: Apparat888 ($29.38 in chips) 
Seat 3: guvalc1952 ($142.21 in chips) 
Seat 4: r4mz3s ($52.41 in chips) 
Seat 6: Player1705 ($125 in chips) 
Seat 7: matiko09 ($157.62 in chips) 
Seat 8: jamba83 ($59.40 in chips) 
Seat 9: Muinmyheart ($83.99 in chips) 
vasiy379 will be allowed to play after the button
Player1705: posts small blind $0.25
matiko09: posts big blind $0.50
MoonJimmy: posts the ante $0.10
Apparat888: posts the ante $0.10
guvalc1952: posts the ante $0.10
r4mz3s: posts the ante $0.10
Player1705: posts the ante $0.10
matiko09: posts the ante $0.10
jamba83: posts the ante $0.10
Muinmyheart: posts the ante $0.10
*** HOLE CARDS ***
Dealt to matiko09 [Jc Tc]
jamba83: folds 
Muinmyheart: folds 
MoonJimmy: folds 
Apparat888: raises $0.75 to $1.25
guvalc1952: folds 
r4mz3s: folds 
Player1705: folds 
matiko09: calls $0.75
*** FLOP *** [4d 2c Js]
matiko09: checks 
Apparat888: checks 
*** TURN *** [4d 2c Js] [8h]
matiko09: bets $2.20
Apparat888: calls $2.20
*** RIVER *** [4d 2c Js 8h] [9c]
matiko09: checks 
Apparat888: bets $5
matiko09: folds 
Uncalled bet ($5) returned to Apparat888
Apparat888 collected $7.59 from pot
*** SUMMARY ***
Total pot $7.95 | Rake $0.36 
Board [4d 2c Js 8h 9c]
Seat 1: MoonJimmy folded before Flop (didn't bet)
Seat 2: Apparat888 collected ($7.59)
Seat 3: guvalc1952 folded before Flop (didn't bet)
Seat 4: r4mz3s (button) folded before Flop (didn't bet)
Seat 6: Player1705 (small blind) folded before Flop
Seat 7: matiko09 (big blind) folded on the River
Seat 8: jamba83 folded before Flop (didn't bet)
Seat 9: Muinmyheart folded before Flop (didn't bet)





PokerStars Hand #149391811334:  Hold'em No Limit ($0.50/$1.00 USD) - 2016/02/25 16:35:33 CET [2016/02/25 10:35:33 ET]
Table 'Morosovia II' 9-max Seat #6 is the button
Seat 1: apfush ($196.46 in chips) 
Seat 2: lysandrafly ($101.50 in chips) 
Seat 3: sebaaastian ($136.87 in chips) 
Seat 4: matiko09 ($170.35 in chips) 
Seat 5: pimpoza ($67.89 in chips) 
Seat 6: Sweden_Pound ($138.61 in chips) 
Seat 7: Ty Nick 420 ($193.19 in chips) 
Seat 8: Monsthand ($100.50 in chips) 
Ty Nick 420: posts small blind $0.50
Monsthand: posts big blind $1
Ouga Buga: sits out 
*** HOLE CARDS ***
Dealt to matiko09 [Th 2s]
apfush: folds 
lysandrafly: folds 
sebaaastian: folds 
matiko09: folds 
pimpoza: folds 
Sweden_Pound: folds 
Ty Nick 420: folds 
Uncalled bet ($0.50) returned to Monsthand
Monsthand collected $1 from pot
*** SUMMARY ***
Total pot $1 | Rake $0 
Seat 1: apfush folded before Flop (didn't bet)
Seat 2: lysandrafly folded before Flop (didn't bet)
Seat 3: sebaaastian folded before Flop (didn't bet)
Seat 4: matiko09 folded before Flop (didn't bet)
Seat 5: pimpoza folded before Flop (didn't bet)
Seat 6: Sweden_Pound (button) folded before Flop (didn't bet)
Seat 7: Ty Nick 420 (small blind) folded before Flop
Seat 8: Monsthand (big blind) collected ($1)





PokerStars Hand #149391813787:  Hold'em No Limit ($0.50/$1.00 USD) - 2016/02/25 16:35:36 CET [2016/02/25 10:35:36 ET]
Table 'Zeuxo II' 9-max Seat #1 is the button
Seat 1: forsmthgood ($100 in chips) 
Seat 2: Sweden_Pound ($103.25 in chips) 
Seat 3: xAndorx ($100 in chips) 
Seat 4: sebaaastian ($123.61 in chips) 
Seat 5: bauss84 ($17.97 in chips) 
Seat 6: Cogss ($101.50 in chips) 
Seat 7: djammusic ($36.03 in chips) 
Seat 8: matiko09 ($100 in chips) 
Seat 9: Sreshta222 ($219.39 in chips) 
Sweden_Pound: posts small blind $0.50
xAndorx: posts big blind $1
*** HOLE CARDS ***
Dealt to matiko09 [5d 9s]
sebaaastian: folds 
bauss84: folds 
Cogss: raises $1 to $2
djammusic: folds 
matiko09: folds 
Sreshta222: folds 
forsmthgood: folds 
Sweden_Pound: folds 
xAndorx: calls $1
*** FLOP *** [3h Td Jh]
xAndorx: checks 
Cogss: bets $4.30
xAndorx: folds 
Uncalled bet ($4.30) returned to Cogss
Cogss collected $4.30 from pot
*** SUMMARY ***
Total pot $4.50 | Rake $0.20 
Board [3h Td Jh]
Seat 1: forsmthgood (button) folded before Flop (didn't bet)
Seat 2: Sweden_Pound (small blind) folded before Flop
Seat 3: xAndorx (big blind) folded on the Flop
Seat 4: sebaaastian folded before Flop (didn't bet)
Seat 5: bauss84 folded before Flop (didn't bet)
Seat 6: Cogss collected ($4.30)
Seat 7: djammusic folded before Flop (didn't bet)
Seat 8: matiko09 folded before Flop (didn't bet)
Seat 9: Sreshta222 folded before Flop (didn't bet)





PokerStars Hand #149391820603:  Hold'em No Limit ($0.25/$0.50 USD) - 2016/02/25 16:35:45 CET [2016/02/25 10:35:45 ET]
Table 'Thalpius III' 9-max Seat #5 is the button
Seat 1: BrotherLove9 ($53.60 in chips) 
Seat 2: matiko09 ($58.79 in chips) 
Seat 3: jamba83 ($53.06 in chips) 
Seat 4: Wwwasian ($50 in chips) 
Seat 5: Rorerzap ($55.52 in chips) 
Seat 6: rdrill ($57.97 in chips) 
Seat 7: v4n0v ($50 in chips) 
Seat 8: jeroemie123 ($35.56 in chips) 
Seat 9: Gemb1rdd ($66.68 in chips) 
rdrill: posts small blind $0.25
v4n0v: posts big blind $0.50
*** HOLE CARDS ***
Dealt to matiko09 [9d Ac]
jeroemie123: folds 
Gemb1rdd: folds 
BrotherLove9: folds 
matiko09: folds 
jamba83: folds 
Wwwasian: folds 
Rorerzap: raises $0.50 to $1
rdrill: folds 
v4n0v: folds 
Uncalled bet ($0.50) returned to Rorerzap
Rorerzap collected $1.25 from pot
Rorerzap: doesn't show hand 
*** SUMMARY ***
Total pot $1.25 | Rake $0 
Seat 1: BrotherLove9 folded before Flop (didn't bet)
Seat 2: matiko09 folded before Flop (didn't bet)
Seat 3: jamba83 folded before Flop (didn't bet)
Seat 4: Wwwasian folded before Flop (didn't bet)
Seat 5: Rorerzap (button) collected ($1.25)
Seat 6: rdrill (small blind) folded before Flop
Seat 7: v4n0v (big blind) folded before Flop
Seat 8: jeroemie123 folded before Flop (didn't bet)
Seat 9: Gemb1rdd folded before Flop (didn't bet)





PokerStars Hand #149391825684:  Hold'em No Limit ($0.50/$1.00 USD) - 2016/02/25 16:35:52 CET [2016/02/25 10:35:52 ET]
Table 'Lina II' 9-max Seat #8 is the button
Seat 1: Lesley2002 ($175.54 in chips) 
Seat 2: matiko09 ($111.01 in chips) 
Seat 4: Nennenurse ($49.63 in chips) 
Seat 5: swizzly58 ($39.50 in chips) 
Seat 6: sebaaastian ($100.50 in chips) 
Seat 7: Monsthand ($139.80 in chips) 
Seat 8: djammusic ($44.14 in chips) 
Seat 9: Sweden_Pound ($269.77 in chips) 
Sweden_Pound: posts small blind $0.50
Lesley2002: posts big blind $1
Ouga Buga: sits out 
*** HOLE CARDS ***
Dealt to matiko09 [2d 4s]
matiko09: folds 
Nennenurse: folds 
swizzly58: calls $1
sebaaastian: folds 
Monsthand: folds 
djammusic: folds 
Sweden_Pound: folds 
Lesley2002: checks 
*** FLOP *** [Qd Qc 5s]
Lesley2002: checks 
swizzly58: bets $3
Lesley2002: folds 
Uncalled bet ($3) returned to swizzly58
swizzly58 collected $2.39 from pot
swizzly58: doesn't show hand 
*** SUMMARY ***
Total pot $2.50 | Rake $0.11 
Board [Qd Qc 5s]
Seat 1: Lesley2002 (big blind) folded on the Flop
Seat 2: matiko09 folded before Flop (didn't bet)
Seat 4: Nennenurse folded before Flop (didn't bet)
Seat 5: swizzly58 collected ($2.39)
Seat 6: sebaaastian folded before Flop (didn't bet)
Seat 7: Monsthand folded before Flop (didn't bet)
Seat 8: djammusic (button) folded before Flop (didn't bet)
Seat 9: Sweden_Pound (small blind) folded before Flop





PokerStars Hand #149391826718:  Hold'em No Limit (€0.25/€0.50 EUR) - 2016/02/25 16:35:53 CET [2016/02/25 10:35:53 ET]
Table 'Leo Minor III' 9-max Seat #5 is the button
Seat 1: Al3xAnd3r22 (€51.25 in chips) 
Seat 2: vasiy379 (€50 in chips) 
Seat 3: Rorerzap (€51.60 in chips) 
Seat 4: RvPersie (€70.81 in chips) 
Seat 5: kasse_62 (€31.06 in chips) 
Seat 6: Wwwasian (€53.54 in chips) 
Seat 7: Apparat888 (€29.01 in chips) 
Seat 8: mi$$I$Elena (€86.65 in chips) 
Seat 9: matiko09 (€50 in chips) 
Wwwasian: posts small blind €0.25
Apparat888: posts big blind €0.50
*** HOLE CARDS ***
Dealt to matiko09 [Jc Qs]
mi$$I$Elena: folds 
matiko09: folds 
Al3xAnd3r22: raises €1 to €1.50
vasiy379: folds 
Rorerzap: folds 
RvPersie: folds 
kasse_62: folds 
Wwwasian: folds 
Apparat888: folds 
Uncalled bet (€1) returned to Al3xAnd3r22
Al3xAnd3r22 collected €1.25 from pot
Al3xAnd3r22: doesn't show hand 
*** SUMMARY ***
Total pot €1.25 | Rake €0 
Seat 1: Al3xAnd3r22 collected (€1.25)
Seat 2: vasiy379 folded before Flop (didn't bet)
Seat 3: Rorerzap folded before Flop (didn't bet)
Seat 4: RvPersie folded before Flop (didn't bet)
Seat 5: kasse_62 (button) folded before Flop (didn't bet)
Seat 6: Wwwasian (small blind) folded before Flop
Seat 7: Apparat888 (big blind) folded before Flop
Seat 8: mi$$I$Elena folded before Flop (didn't bet)
Seat 9: matiko09 folded before Flop (didn't bet)





PokerStars Hand #149391827307:  Hold'em No Limit ($0.50/$1.00 USD) - 2016/02/25 16:35:54 CET [2016/02/25 10:35:54 ET]
Table 'Simona' 9-max Seat #6 is the button
Seat 1: mycka86 ($114.21 in chips) 
Seat 2: xAndorx ($109.03 in chips) 
Seat 3: Sweden_Pound ($100 in chips) 
Seat 4: matiko09 ($276.42 in chips) 
Seat 5: sebaaastian ($100 in chips) 
Seat 6: Ty Nick 420 ($104.50 in chips) 
Seat 7: Aalleekks ($100.80 in chips) 
Seat 8: Monsthand ($136.47 in chips) 
Seat 9: Slushpup69 ($57.65 in chips) 
Aalleekks: posts small blind $0.50
Monsthand: posts big blind $1
*** HOLE CARDS ***
Dealt to matiko09 [2s 3c]
Slushpup69: folds 
mycka86: folds 
xAndorx: folds 
Sweden_Pound: folds 
matiko09: folds 
sebaaastian: raises $1.50 to $2.50
Ty Nick 420: folds 
Aalleekks: folds 
Monsthand: folds 
Uncalled bet ($1.50) returned to sebaaastian
sebaaastian collected $2.50 from pot
sebaaastian: doesn't show hand 
*** SUMMARY ***
Total pot $2.50 | Rake $0 
Seat 1: mycka86 folded before Flop (didn't bet)
Seat 2: xAndorx folded before Flop (didn't bet)
Seat 3: Sweden_Pound folded before Flop (didn't bet)
Seat 4: matiko09 folded before Flop (didn't bet)
Seat 5: sebaaastian collected ($2.50)
Seat 6: Ty Nick 420 (button) folded before Flop (didn't bet)
Seat 7: Aalleekks (small blind) folded before Flop
Seat 8: Monsthand (big blind) folded before Flop
Seat 9: Slushpup69 folded before Flop (didn't bet)





PokerStars Hand #149391835556:  Hold'em No Limit ($0.50/$1.00 USD) - 2016/02/25 16:36:05 CET [2016/02/25 10:36:05 ET]
Table 'Morosovia II' 9-max Seat #7 is the button
Seat 1: apfush ($196.46 in chips) 
Seat 2: lysandrafly ($101.50 in chips) 
Seat 3: sebaaastian ($136.87 in chips) 
Seat 4: matiko09 ($170.35 in chips) 
Seat 5: pimpoza ($67.89 in chips) 
Seat 6: Sweden_Pound ($138.61 in chips) 
Seat 7: Ty Nick 420 ($192.69 in chips) 
Seat 8: Monsthand ($101 in chips) 
Seat 9: Ouga Buga ($100 in chips) 
Monsthand: posts small blind $0.50
Ouga Buga: posts big blind $1
*** HOLE CARDS ***
Dealt to matiko09 [Kc Ts]
apfush: folds 
lysandrafly: folds 
sebaaastian: folds 
matiko09: folds 
pimpoza: raises $2 to $3
Sweden_Pound: folds 
Ty Nick 420: raises $6 to $9
Monsthand: folds 
Ouga Buga: raises $11 to $20
pimpoza: folds 
Ty Nick 420: calls $11
*** FLOP *** [Jd 5s 7h]
Ouga Buga: bets $17.69
Ty Nick 420: folds 
Uncalled bet ($17.69) returned to Ouga Buga
Ouga Buga collected $41.54 from pot
Ouga Buga: doesn't show hand 
*** SUMMARY ***
Total pot $43.50 | Rake $1.96 
Board [Jd 5s 7h]
Seat 1: apfush folded before Flop (didn't bet)
Seat 2: lysandrafly folded before Flop (didn't bet)
Seat 3: sebaaastian folded before Flop (didn't bet)
Seat 4: matiko09 folded before Flop (didn't bet)
Seat 5: pimpoza folded before Flop
Seat 6: Sweden_Pound folded before Flop (didn't bet)
Seat 7: Ty Nick 420 (button) folded on the Flop
Seat 8: Monsthand (small blind) folded before Flop
Seat 9: Ouga Buga (big blind) collected ($41.54)





PokerStars Hand #149391837699:  Hold'em No Limit ($0.50/$1.00 USD) - 2016/02/25 16:36:08 CET [2016/02/25 10:36:08 ET]
Table 'Guisan' 9-max Seat #1 is the button
Seat 1: stockbridge8 ($72 in chips) 
Seat 2: mycka86 ($100 in chips) 
Seat 4: matiko09 ($175.25 in chips) 
Seat 5: Jeckpot1989 ($28.47 in chips) 
Seat 6: 19R&J91 ($391.69 in chips) 
Seat 7: sebaaastian ($116.59 in chips) 
Seat 8: Monsthand ($100 in chips) 
Seat 9: Sweden_Pound ($100 in chips) 
mycka86: posts small blind $0.50
Ju$tTrustMe: is sitting out 
Ju$tTrustMe leaves the table
matiko09: posts big blind $1
*** HOLE CARDS ***
Dealt to matiko09 [7d 6c]
Jeckpot1989: folds 
19R&J91: folds 
sebaaastian: folds 
Monsthand: folds 
Sweden_Pound: raises $1.50 to $2.50
xAndorx joins the table at seat #3 
stockbridge8: raises $1.50 to $4
mycka86: folds 
matiko09: folds 
Sweden_Pound: calls $1.50
*** FLOP *** [4c 9s Kc]
Sweden_Pound: checks 
stockbridge8: bets $4.53
Sweden_Pound: raises $11.78 to $16.31
stockbridge8: folds 
Uncalled bet ($11.78) returned to Sweden_Pound
Sweden_Pound collected $17.72 from pot
Sweden_Pound: doesn't show hand 
*** SUMMARY ***
Total pot $18.56 | Rake $0.84 
Board [4c 9s Kc]
Seat 1: stockbridge8 (button) folded on the Flop
Seat 2: mycka86 (small blind) folded before Flop
Seat 4: matiko09 (big blind) folded before Flop
Seat 5: Jeckpot1989 folded before Flop (didn't bet)
Seat 6: 19R&J91 folded before Flop (didn't bet)
Seat 7: sebaaastian folded before Flop (didn't bet)
Seat 8: Monsthand folded before Flop (didn't bet)
Seat 9: Sweden_Pound collected ($17.72)





PokerStars Hand #149391841986:  Hold'em No Limit ($0.25/$0.50 USD) - 2016/02/25 16:36:13 CET [2016/02/25 10:36:13 ET]
Table 'Thalpius III' 9-max Seat #6 is the button
Seat 1: BrotherLove9 ($53.60 in chips) 
Seat 2: matiko09 ($58.79 in chips) 
Seat 3: jamba83 ($53.06 in chips) 
Seat 4: Wwwasian ($50 in chips) 
Seat 5: Rorerzap ($56.27 in chips) 
Seat 6: rdrill ($57.72 in chips) 
Seat 7: v4n0v ($50 in chips) 
Seat 8: jeroemie123 ($35.56 in chips) 
Seat 9: Gemb1rdd ($66.68 in chips) 
v4n0v: posts small blind $0.25
jeroemie123: posts big blind $0.50
*** HOLE CARDS ***
Dealt to matiko09 [8d Ts]
Gemb1rdd: folds 
BrotherLove9: folds 
matiko09: folds 
jamba83: folds 
Wwwasian: raises $0.90 to $1.40
Rorerzap: folds 
rdrill: folds 
v4n0v: folds 
jeroemie123: calls $0.90
*** FLOP *** [7c Ac 4c]
jeroemie123: checks 
Wwwasian: checks 
*** TURN *** [7c Ac 4c] [3h]
jeroemie123: checks 
Wwwasian: checks 
*** RIVER *** [7c Ac 4c 3h] [2c]
jeroemie123: checks 
Wwwasian: checks 
*** SHOW DOWN ***
jeroemie123: shows [9h 6d] (high card Ace)
Wwwasian: shows [2s 2d] (three of a kind, Deuces)
Wwwasian collected $2.91 from pot
*** SUMMARY ***
Total pot $3.05 | Rake $0.14 
Board [7c Ac 4c 3h 2c]
Seat 1: BrotherLove9 folded before Flop (didn't bet)
Seat 2: matiko09 folded before Flop (didn't bet)
Seat 3: jamba83 folded before Flop (didn't bet)
Seat 4: Wwwasian showed [2s 2d] and won ($2.91) with three of a kind, Deuces
Seat 5: Rorerzap folded before Flop (didn't bet)
Seat 6: rdrill (button) folded before Flop (didn't bet)
Seat 7: v4n0v (small blind) folded before Flop
Seat 8: jeroemie123 (big blind) showed [9h 6d] and lost with high card Ace
Seat 9: Gemb1rdd folded before Flop (didn't bet)





PokerStars Hand #149391846611:  Hold'em No Limit ($0.50/$1.00 USD) - 2016/02/25 16:36:20 CET [2016/02/25 10:36:20 ET]
Table 'Zeuxo II' 9-max Seat #2 is the button
Seat 1: forsmthgood ($100 in chips) 
Seat 2: Sweden_Pound ($102.75 in chips) 
Seat 3: xAndorx ($100 in chips) 
Seat 4: sebaaastian ($123.61 in chips) 
Seat 5: bauss84 ($17.97 in chips) 
Seat 6: Cogss ($103.80 in chips) 
Seat 7: djammusic ($36.03 in chips) 
Seat 8: matiko09 ($100 in chips) 
Seat 9: Sreshta222 ($219.39 in chips) 
xAndorx: posts small blind $0.50
sebaaastian: posts big blind $1
*** HOLE CARDS ***
Dealt to matiko09 [3h Jh]
bauss84: folds 
Cogss: raises $1 to $2
djammusic: folds 
matiko09: folds 
Sreshta222: folds 
forsmthgood: folds 
Sweden_Pound: folds 
xAndorx: folds 
sebaaastian: folds 
Uncalled bet ($1) returned to Cogss
Cogss collected $2.50 from pot
*** SUMMARY ***
Total pot $2.50 | Rake $0 
Seat 1: forsmthgood folded before Flop (didn't bet)
Seat 2: Sweden_Pound (button) folded before Flop (didn't bet)
Seat 3: xAndorx (small blind) folded before Flop
Seat 4: sebaaastian (big blind) folded before Flop
Seat 5: bauss84 folded before Flop (didn't bet)
Seat 6: Cogss collected ($2.50)
Seat 7: djammusic folded before Flop (didn't bet)
Seat 8: matiko09 folded before Flop (didn't bet)
Seat 9: Sreshta222 folded before Flop (didn't bet)





PokerStars Hand #149391848400:  Hold'em No Limit ($0.25/$0.50 USD) - 2016/02/25 16:36:22 CET [2016/02/25 10:36:22 ET]
Table 'Lohja II' 9-max Seat #6 is the button
Seat 1: MoonJimmy ($147.73 in chips) 
Seat 2: Apparat888 ($33.42 in chips) 
Seat 3: guvalc1952 ($142.11 in chips) 
Seat 4: r4mz3s ($52.31 in chips) 
Seat 6: Player1705 ($125 in chips) 
Seat 7: matiko09 ($154.07 in chips) 
Seat 8: jamba83 ($59.30 in chips) 
Seat 9: Muinmyheart ($83.89 in chips) 
matiko09: posts small blind $0.25
jamba83: posts big blind $0.50
vasiy379: sits out 
MoonJimmy: posts the ante $0.10
Apparat888: posts the ante $0.10
guvalc1952: posts the ante $0.10
r4mz3s: posts the ante $0.10
Player1705: posts the ante $0.10
matiko09: posts the ante $0.10
jamba83: posts the ante $0.10
Muinmyheart: posts the ante $0.10
*** HOLE CARDS ***
Dealt to matiko09 [Jh Jd]
Muinmyheart: folds 
MoonJimmy: raises $1 to $1.50
Apparat888: folds 
guvalc1952: calls $1.50
r4mz3s: folds 
Player1705: folds 
matiko09: calls $1.25
jamba83: folds 
*** FLOP *** [6h 7c 2h]
matiko09: checks 
MoonJimmy: checks 
guvalc1952: checks 
*** TURN *** [6h 7c 2h] [4s]
matiko09: bets $4
MoonJimmy: folds 
guvalc1952: folds 
Uncalled bet ($4) returned to matiko09
matiko09 collected $5.54 from pot
matiko09: doesn't show hand 
*** SUMMARY ***
Total pot $5.80 | Rake $0.26 
Board [6h 7c 2h 4s]
Seat 1: MoonJimmy folded on the Turn
Seat 2: Apparat888 folded before Flop (didn't bet)
Seat 3: guvalc1952 folded on the Turn
Seat 4: r4mz3s folded before Flop (didn't bet)
Seat 6: Player1705 (button) folded before Flop (didn't bet)
Seat 7: matiko09 (small blind) collected ($5.54)
Seat 8: jamba83 (big blind) folded before Flop
Seat 9: Muinmyheart folded before Flop (didn't bet)





PokerStars Hand #149391850707:  Hold'em No Limit (€0.25/€0.50 EUR) - 2016/02/25 16:36:25 CET [2016/02/25 10:36:25 ET]
Table 'Leo Minor III' 9-max Seat #6 is the button
Seat 1: Al3xAnd3r22 (€52 in chips) 
Seat 2: vasiy379 (€50 in chips) 
Seat 3: Rorerzap (€51.60 in chips) 
Seat 4: RvPersie (€70.81 in chips) 
Seat 5: kasse_62 (€31.06 in chips) 
Seat 6: Wwwasian (€53.29 in chips) 
Seat 7: Apparat888 (€28.51 in chips) 
Seat 8: mi$$I$Elena (€86.65 in chips) 
Seat 9: matiko09 (€50 in chips) 
Apparat888: posts small blind €0.25
mi$$I$Elena: posts big blind €0.50
*** HOLE CARDS ***
Dealt to matiko09 [Jd 2h]
matiko09: folds 
Al3xAnd3r22: folds 
vasiy379: folds 
Rorerzap: raises €1 to €1.50
RvPersie: folds 
kasse_62: folds 
Wwwasian: folds 
Apparat888: folds 
mi$$I$Elena: folds 
Uncalled bet (€1) returned to Rorerzap
Rorerzap collected €1.25 from pot
Rorerzap: doesn't show hand 
*** SUMMARY ***
Total pot €1.25 | Rake €0 
Seat 1: Al3xAnd3r22 folded before Flop (didn't bet)
Seat 2: vasiy379 folded before Flop (didn't bet)
Seat 3: Rorerzap collected (€1.25)
Seat 4: RvPersie folded before Flop (didn't bet)
Seat 5: kasse_62 folded before Flop (didn't bet)
Seat 6: Wwwasian (button) folded before Flop (didn't bet)
Seat 7: Apparat888 (small blind) folded before Flop
Seat 8: mi$$I$Elena (big blind) folded before Flop
Seat 9: matiko09 folded before Flop (didn't bet)





PokerStars Hand #149391854753:  Hold'em No Limit ($0.50/$1.00 USD) - 2016/02/25 16:36:30 CET [2016/02/25 10:36:30 ET]
Table 'Isa' 9-max Seat #7 is the button
Seat 1: matiko09 ($114.44 in chips) 
Seat 2: Monsthand ($100 in chips) 
Seat 3: sebaaastian ($115.40 in chips) 
Seat 5: Sweden_Pound ($100 in chips) 
Seat 6: xAndorx ($100 in chips) 
Seat 7: bilukm ($148.51 in chips) 
Seat 9: TideHan ($105.71 in chips) 
TideHan: posts small blind $0.50
matiko09: posts big blind $1
hammerwife: sits out 
*** HOLE CARDS ***
Dealt to matiko09 [7h Tc]
Monsthand: folds 
sebaaastian: folds 
Sweden_Pound: raises $2 to $3
xAndorx: folds 
bilukm: calls $3
TideHan: calls $2.50
matiko09: folds 
*** FLOP *** [8s 7s 5c]
TideHan: checks 
Sweden_Pound: bets $6.21
bilukm: folds 
TideHan: folds 
Uncalled bet ($6.21) returned to Sweden_Pound
Sweden_Pound collected $9.55 from pot
Sweden_Pound: doesn't show hand 
*** SUMMARY ***
Total pot $10 | Rake $0.45 
Board [8s 7s 5c]
Seat 1: matiko09 (big blind) folded before Flop
Seat 2: Monsthand folded before Flop (didn't bet)
Seat 3: sebaaastian folded before Flop (didn't bet)
Seat 5: Sweden_Pound collected ($9.55)
Seat 6: xAndorx folded before Flop (didn't bet)
Seat 7: bilukm (button) folded on the Flop
Seat 9: TideHan (small blind) folded on the Flop





PokerStars Hand #149391862565:  Hold'em No Limit ($0.50/$1.00 USD) - 2016/02/25 16:36:41 CET [2016/02/25 10:36:41 ET]
Table 'Lucia III' 9-max Seat #2 is the button
Seat 1: Monsthand ($123.95 in chips) 
Seat 2: kuanhung0903 ($77.50 in chips) 
Seat 3: mycka86 ($106.62 in chips) 
Seat 4: swatek1986 ($134.59 in chips) 
Seat 5: Sweden_Pound ($224.43 in chips) 
Seat 6: matiko09 ($109.23 in chips) 
Seat 7: Ty Nick 420 ($178.02 in chips) 
Seat 8: apfush ($105.60 in chips) 
Seat 9: Apparat888 ($34.45 in chips) 
mycka86: posts small blind $0.50
swatek1986: posts big blind $1
*** HOLE CARDS ***
Dealt to matiko09 [Jh 3d]
Sweden_Pound: folds 
matiko09: folds 
Ty Nick 420: folds 
apfush: folds 
Apparat888: folds 
Monsthand: folds 
kuanhung0903: raises $2 to $3
mycka86: folds 
swatek1986: folds 
Uncalled bet ($2) returned to kuanhung0903
kuanhung0903 collected $2.50 from pot
kuanhung0903: doesn't show hand 
*** SUMMARY ***
Total pot $2.50 | Rake $0 
Seat 1: Monsthand folded before Flop (didn't bet)
Seat 2: kuanhung0903 (button) collected ($2.50)
Seat 3: mycka86 (small blind) folded before Flop
Seat 4: swatek1986 (big blind) folded before Flop
Seat 5: Sweden_Pound folded before Flop (didn't bet)
Seat 6: matiko09 folded before Flop (didn't bet)
Seat 7: Ty Nick 420 folded before Flop (didn't bet)
Seat 8: apfush folded before Flop (didn't bet)
Seat 9: Apparat888 folded before Flop (didn't bet)





PokerStars Hand #149391867347:  Hold'em No Limit ($0.50/$1.00 USD) - 2016/02/25 16:36:47 CET [2016/02/25 10:36:47 ET]
Table 'Lina II' 9-max Seat #9 is the button
Seat 1: Lesley2002 ($174.54 in chips) 
Seat 2: matiko09 ($111.01 in chips) 
Seat 4: Nennenurse ($49.63 in chips) 
Seat 5: swizzly58 ($40.89 in chips) 
Seat 6: sebaaastian ($100.50 in chips) 
Seat 7: Monsthand ($139.80 in chips) 
Seat 8: djammusic ($44.14 in chips) 
Seat 9: Sweden_Pound ($269.27 in chips) 
Lesley2002: posts small blind $0.50
matiko09: posts big blind $1
Ouga Buga: sits out 
*** HOLE CARDS ***
Dealt to matiko09 [3c 3h]
Nennenurse: folds 
swizzly58: folds 
sebaaastian: raises $2 to $3
Monsthand: raises $6 to $9
djammusic: folds 
Sweden_Pound: folds 
Lesley2002: folds 
matiko09: folds 
sebaaastian: calls $6
*** FLOP *** [Jh Ac Jc]
sebaaastian: checks 
Monsthand: checks 
*** TURN *** [Jh Ac Jc] [9h]
sebaaastian: bets $10
Monsthand: folds 
Uncalled bet ($10) returned to sebaaastian
sebaaastian collected $18.62 from pot
sebaaastian: doesn't show hand 
*** SUMMARY ***
Total pot $19.50 | Rake $0.88 
Board [Jh Ac Jc 9h]
Seat 1: Lesley2002 (small blind) folded before Flop
Seat 2: matiko09 (big blind) folded before Flop
Seat 4: Nennenurse folded before Flop (didn't bet)
Seat 5: swizzly58 folded before Flop (didn't bet)
Seat 6: sebaaastian collected ($18.62)
Seat 7: Monsthand folded on the Turn
Seat 8: djammusic folded before Flop (didn't bet)
Seat 9: Sweden_Pound (button) folded before Flop (didn't bet)





PokerStars Hand #149391871488:  Hold'em No Limit ($0.50/$1.00 USD) - 2016/02/25 16:36:52 CET [2016/02/25 10:36:52 ET]
Table 'Simona' 9-max Seat #7 is the button
Seat 1: mycka86 ($114.21 in chips) 
Seat 2: xAndorx ($109.03 in chips) 
Seat 3: Sweden_Pound ($100 in chips) 
Seat 4: matiko09 ($276.42 in chips) 
Seat 5: sebaaastian ($101.50 in chips) 
Seat 6: Ty Nick 420 ($104.50 in chips) 
Seat 7: Aalleekks ($100.30 in chips) 
Seat 8: Monsthand ($135.47 in chips) 
Seat 9: Slushpup69 ($57.65 in chips) 
Monsthand: posts small blind $0.50
Slushpup69: posts big blind $1
*** HOLE CARDS ***
Dealt to matiko09 [2s 4s]
mycka86: folds 
xAndorx: raises $2 to $3
Sweden_Pound: folds 
matiko09: folds 
sebaaastian: folds 
Ty Nick 420: folds 
Aalleekks: folds 
Monsthand: folds 
Slushpup69: calls $2
*** FLOP *** [7h 4h Kc]
Slushpup69: checks 
xAndorx: checks 
*** TURN *** [7h 4h Kc] [6s]
Slushpup69: checks 
xAndorx: checks 
*** RIVER *** [7h 4h Kc 6s] [Qs]
Slushpup69: checks 
xAndorx: checks 
*** SHOW DOWN ***
Slushpup69: shows [2c Tc] (high card King)
xAndorx: shows [7c 8c] (a pair of Sevens)
xAndorx collected $6.21 from pot
*** SUMMARY ***
Total pot $6.50 | Rake $0.29 
Board [7h 4h Kc 6s Qs]
Seat 1: mycka86 folded before Flop (didn't bet)
Seat 2: xAndorx showed [7c 8c] and won ($6.21) with a pair of Sevens
Seat 3: Sweden_Pound folded before Flop (didn't bet)
Seat 4: matiko09 folded before Flop (didn't bet)
Seat 5: sebaaastian folded before Flop (didn't bet)
Seat 6: Ty Nick 420 folded before Flop (didn't bet)
Seat 7: Aalleekks (button) folded before Flop (didn't bet)
Seat 8: Monsthand (small blind) folded before Flop
Seat 9: Slushpup69 (big blind) showed [2c Tc] and lost with high card King





PokerStars Hand #149391876663:  Hold'em No Limit ($0.50/$1.00 USD) - 2016/02/25 16:36:59 CET [2016/02/25 10:36:59 ET]
Table 'Zeuxo II' 9-max Seat #3 is the button
Seat 1: forsmthgood ($100 in chips) 
Seat 2: Sweden_Pound ($102.75 in chips) 
Seat 3: xAndorx ($99.50 in chips) 
Seat 4: sebaaastian ($122.61 in chips) 
Seat 5: bauss84 ($17.97 in chips) 
Seat 6: Cogss ($105.30 in chips) 
Seat 7: djammusic ($36.03 in chips) 
Seat 8: matiko09 ($100 in chips) 
Seat 9: Sreshta222 ($219.39 in chips) 
sebaaastian: posts small blind $0.50
bauss84: posts big blind $1
*** HOLE CARDS ***
Dealt to matiko09 [4s As]
Cogss: folds 
djammusic: raises $1.15 to $2.15
matiko09: folds 
Sreshta222: folds 
forsmthgood: folds 
Sweden_Pound: folds 
xAndorx: folds 
sebaaastian: folds 
bauss84: calls $1.15
*** FLOP *** [8s Tc 7s]
bauss84: checks 
djammusic: bets $4
bauss84: calls $4
*** TURN *** [8s Tc 7s] [2s]
bauss84: checks 
djammusic: checks 
*** RIVER *** [8s Tc 7s 2s] [3c]
bauss84: bets $6.99
djammusic: folds 
Uncalled bet ($6.99) returned to bauss84
bauss84 collected $12.22 from pot
bauss84: doesn't show hand 
*** SUMMARY ***
Total pot $12.80 | Rake $0.58 
Board [8s Tc 7s 2s 3c]
Seat 1: forsmthgood folded before Flop (didn't bet)
Seat 2: Sweden_Pound folded before Flop (didn't bet)
Seat 3: xAndorx (button) folded before Flop (didn't bet)
Seat 4: sebaaastian (small blind) folded before Flop
Seat 5: bauss84 (big blind) collected ($12.22)
Seat 6: Cogss folded before Flop (didn't bet)
Seat 7: djammusic folded on the River
Seat 8: matiko09 folded before Flop (didn't bet)
Seat 9: Sreshta222 folded before Flop (didn't bet)





PokerStars Hand #149391886900:  Hold'em No Limit ($0.25/$0.50 USD) - 2016/02/25 16:37:12 CET [2016/02/25 10:37:12 ET]
Table 'Thalpius III' 9-max Seat #7 is the button
Seat 1: BrotherLove9 ($53.60 in chips) 
Seat 2: matiko09 ($58.79 in chips) 
Seat 3: jamba83 ($53.06 in chips) 
Seat 4: Wwwasian ($51.51 in chips) 
Seat 5: Rorerzap ($56.27 in chips) 
Seat 6: rdrill ($57.72 in chips) 
Seat 7: v4n0v ($50 in chips) 
Seat 8: jeroemie123 ($34.16 in chips) 
Seat 9: Gemb1rdd ($66.68 in chips) 
jeroemie123: posts small blind $0.25
Gemb1rdd: posts big blind $0.50
*** HOLE CARDS ***
Dealt to matiko09 [8c 4d]
BrotherLove9: folds 
matiko09: folds 
jamba83: folds 
Wwwasian: folds 
Rorerzap: raises $1 to $1.50
rdrill: folds 
v4n0v: folds 
jeroemie123: folds 
Gemb1rdd: folds 
Uncalled bet ($1) returned to Rorerzap
Rorerzap collected $1.25 from pot
Rorerzap: doesn't show hand 
*** SUMMARY ***
Total pot $1.25 | Rake $0 
Seat 1: BrotherLove9 folded before Flop (didn't bet)
Seat 2: matiko09 folded before Flop (didn't bet)
Seat 3: jamba83 folded before Flop (didn't bet)
Seat 4: Wwwasian folded before Flop (didn't bet)
Seat 5: Rorerzap collected ($1.25)
Seat 6: rdrill folded before Flop (didn't bet)
Seat 7: v4n0v (button) folded before Flop (didn't bet)
Seat 8: jeroemie123 (small blind) folded before Flop
Seat 9: Gemb1rdd (big blind) folded before Flop





PokerStars Hand #149391889012:  Hold'em No Limit ($0.50/$1.00 USD) - 2016/02/25 16:37:15 CET [2016/02/25 10:37:15 ET]
Table 'Hercules IV' 9-max Seat #8 is the button
Seat 1: matiko09 ($100 in chips) 
Seat 2: hammerwife ($100 in chips) 
Seat 3: sebaaastian ($201.70 in chips) 
Seat 4: Sweden_Pound ($100 in chips) 
Seat 5: xAndorx ($140.77 in chips) 
Seat 6: kuanhung0903 ($66.21 in chips) 
Seat 7: Ouga Buga ($100 in chips) 
Seat 8: brokat77 ($111.15 in chips) 
Seat 9: djammusic ($39.20 in chips) 
djammusic: posts small blind $0.50
matiko09: posts big blind $1
*** HOLE CARDS ***
Dealt to matiko09 [Js 4d]
hammerwife: folds 
sebaaastian: folds 
Sweden_Pound has timed out
Sweden_Pound: folds 
xAndorx: raises $2 to $3
kuanhung0903: folds 
Ouga Buga: folds 
brokat77: folds 
djammusic: folds 
matiko09: folds 
Uncalled bet ($2) returned to xAndorx
xAndorx collected $2.50 from pot
xAndorx: doesn't show hand 
*** SUMMARY ***
Total pot $2.50 | Rake $0 
Seat 1: matiko09 (big blind) folded before Flop
Seat 2: hammerwife folded before Flop (didn't bet)
Seat 3: sebaaastian folded before Flop (didn't bet)
Seat 4: Sweden_Pound folded before Flop (didn't bet)
Seat 5: xAndorx collected ($2.50)
Seat 6: kuanhung0903 folded before Flop (didn't bet)
Seat 7: Ouga Buga folded before Flop (didn't bet)
Seat 8: brokat77 (button) folded before Flop (didn't bet)
Seat 9: djammusic (small blind) folded before Flop





PokerStars Hand #149391891469:  Hold'em No Limit ($0.25/$0.50 USD) - 2016/02/25 16:37:19 CET [2016/02/25 10:37:19 ET]
Table 'Lohja II' 9-max Seat #7 is the button
Seat 1: MoonJimmy ($146.13 in chips) 
Seat 2: Apparat888 ($33.32 in chips) 
Seat 3: guvalc1952 ($140.51 in chips) 
Seat 4: r4mz3s ($52.21 in chips) 
Seat 6: Player1705 ($125 in chips) 
Seat 7: matiko09 ($158.01 in chips) 
Seat 8: jamba83 ($58.70 in chips) 
Seat 9: Muinmyheart ($83.79 in chips) 
jamba83: posts small blind $0.25
Muinmyheart: posts big blind $0.50
vasiy379: sits out 
MoonJimmy: posts the ante $0.10
Apparat888: posts the ante $0.10
guvalc1952: posts the ante $0.10
r4mz3s: posts the ante $0.10
Player1705: posts the ante $0.10
matiko09: posts the ante $0.10
jamba83: posts the ante $0.10
Muinmyheart: posts the ante $0.10
*** HOLE CARDS ***
Dealt to matiko09 [Ts 9c]
MoonJimmy: folds 
Apparat888: folds 
guvalc1952: calls $0.50
r4mz3s: folds 
Player1705: folds 
matiko09: raises $1.50 to $2
jamba83: folds 
Muinmyheart: folds 
guvalc1952: calls $1.50
*** FLOP *** [7s Ks Qs]
guvalc1952: checks 
matiko09: checks 
*** TURN *** [7s Ks Qs] [4c]
guvalc1952: bets $2.65
matiko09: folds 
Uncalled bet ($2.65) returned to guvalc1952
guvalc1952 collected $5.30 from pot
guvalc1952: doesn't show hand 
*** SUMMARY ***
Total pot $5.55 | Rake $0.25 
Board [7s Ks Qs 4c]
Seat 1: MoonJimmy folded before Flop (didn't bet)
Seat 2: Apparat888 folded before Flop (didn't bet)
Seat 3: guvalc1952 collected ($5.30)
Seat 4: r4mz3s folded before Flop (didn't bet)
Seat 6: Player1705 folded before Flop (didn't bet)
Seat 7: matiko09 (button) folded on the Turn
Seat 8: jamba83 (small blind) folded before Flop
Seat 9: Muinmyheart (big blind) folded before Flop





PokerStars Hand #149391892511:  Hold'em No Limit (€0.25/€0.50 EUR) - 2016/02/25 16:37:20 CET [2016/02/25 10:37:20 ET]
Table 'Leo Minor III' 9-max Seat #7 is the button
Seat 1: Al3xAnd3r22 (€52 in chips) 
Seat 2: vasiy379 (€50 in chips) 
Seat 3: Rorerzap (€52.35 in chips) 
Seat 4: RvPersie (€70.81 in chips) 
Seat 5: kasse_62 (€31.06 in chips) 
Seat 6: Wwwasian (€53.29 in chips) 
Seat 7: Apparat888 (€28.26 in chips) 
Seat 8: mi$$I$Elena (€86.15 in chips) 
Seat 9: matiko09 (€50 in chips) 
mi$$I$Elena: posts small blind €0.25
matiko09: posts big blind €0.50
*** HOLE CARDS ***
Dealt to matiko09 [2c 6d]
Al3xAnd3r22: folds 
vasiy379: folds 
Rorerzap: raises €1 to €1.50
RvPersie: folds 
kasse_62: calls €1.50
Wwwasian: folds 
Apparat888: folds 
mi$$I$Elena: folds 
matiko09: folds 
*** FLOP *** [6c 8c Jc]
Rorerzap: bets €2.64
kasse_62: calls €2.64
*** TURN *** [6c 8c Jc] [6h]
Rorerzap: bets €6.50
kasse_62: calls €6.50
*** RIVER *** [6c 8c Jc 6h] [Kh]
Rorerzap: checks 
kasse_62: checks 
*** SHOW DOWN ***
Rorerzap: shows [Qs Qd] (two pair, Queens and Sixes)
kasse_62: mucks hand 
Rorerzap collected €21.04 from pot
*** SUMMARY ***
Total pot €22.03 | Rake €0.99 
Board [6c 8c Jc 6h Kh]
Seat 1: Al3xAnd3r22 folded before Flop (didn't bet)
Seat 2: vasiy379 folded before Flop (didn't bet)
Seat 3: Rorerzap showed [Qs Qd] and won (€21.04) with two pair, Queens and Sixes
Seat 4: RvPersie folded before Flop (didn't bet)
Seat 5: kasse_62 mucked [9c 9d]
Seat 6: Wwwasian folded before Flop (didn't bet)
Seat 7: Apparat888 (button) folded before Flop (didn't bet)
Seat 8: mi$$I$Elena (small blind) folded before Flop
Seat 9: matiko09 (big blind) folded before Flop





PokerStars Hand #149391894782:  Hold'em No Limit ($0.50/$1.00 USD) - 2016/02/25 16:37:23 CET [2016/02/25 10:37:23 ET]
Table 'Lucia III' 9-max Seat #3 is the button
Seat 1: Monsthand ($123.95 in chips) 
Seat 2: kuanhung0903 ($79 in chips) 
Seat 3: mycka86 ($106.12 in chips) 
Seat 4: swatek1986 ($133.59 in chips) 
Seat 5: Sweden_Pound ($224.43 in chips) 
Seat 6: matiko09 ($109.23 in chips) 
Seat 7: Ty Nick 420 ($178.02 in chips) 
Seat 8: apfush ($105.60 in chips) 
Seat 9: Apparat888 ($34.45 in chips) 
swatek1986: posts small blind $0.50
Sweden_Pound: posts big blind $1
*** HOLE CARDS ***
Dealt to matiko09 [4c 8d]
matiko09: folds 
Ty Nick 420: raises $1.50 to $2.50
apfush: raises $5.50 to $8
Apparat888: folds 
Monsthand: folds 
kuanhung0903: folds 
mycka86: folds 
swatek1986: folds 
Sweden_Pound: folds 
Ty Nick 420: folds 
Uncalled bet ($5.50) returned to apfush
apfush collected $6.50 from pot
apfush: doesn't show hand 
*** SUMMARY ***
Total pot $6.50 | Rake $0 
Seat 1: Monsthand folded before Flop (didn't bet)
Seat 2: kuanhung0903 folded before Flop (didn't bet)
Seat 3: mycka86 (button) folded before Flop (didn't bet)
Seat 4: swatek1986 (small blind) folded before Flop
Seat 5: Sweden_Pound (big blind) folded before Flop
Seat 6: matiko09 folded before Flop (didn't bet)
Seat 7: Ty Nick 420 folded before Flop
Seat 8: apfush collected ($6.50)
Seat 9: Apparat888 folded before Flop (didn't bet)





PokerStars Hand #149391912593:  Hold'em No Limit ($0.50/$1.00 USD) - 2016/02/25 16:37:46 CET [2016/02/25 10:37:46 ET]
Table 'Guisan' 9-max Seat #2 is the button
Seat 1: stockbridge8 ($63.47 in chips) 
Seat 2: mycka86 ($100 in chips) 
Seat 4: matiko09 ($174.25 in chips) 
Seat 5: Jeckpot1989 ($100 in chips) 
Seat 6: 19R&J91 ($391.69 in chips) 
Seat 7: sebaaastian ($116.59 in chips) 
Seat 8: Monsthand ($100 in chips) 
Seat 9: Sweden_Pound ($109.19 in chips) 
xAndorx will be allowed to play after the button
matiko09: posts small blind $0.50
Jeckpot1989: posts big blind $1
*** HOLE CARDS ***
Dealt to matiko09 [Kc 8s]
19R&J91: raises $2 to $3
sebaaastian: folds 
Monsthand: folds 
Sweden_Pound: folds 
stockbridge8: folds 
mycka86: folds 
matiko09: folds 
Jeckpot1989: calls $2
*** FLOP *** [5s Kh 2c]
Jeckpot1989: checks 
19R&J91: bets $4
Jeckpot1989: folds 
Uncalled bet ($4) returned to 19R&J91
19R&J91 collected $6.21 from pot
19R&J91: doesn't show hand 
*** SUMMARY ***
Total pot $6.50 | Rake $0.29 
Board [5s Kh 2c]
Seat 1: stockbridge8 folded before Flop (didn't bet)
Seat 2: mycka86 (button) folded before Flop (didn't bet)
Seat 4: matiko09 (small blind) folded before Flop
Seat 5: Jeckpot1989 (big blind) folded on the Flop
Seat 6: 19R&J91 collected ($6.21)
Seat 7: sebaaastian folded before Flop (didn't bet)
Seat 8: Monsthand folded before Flop (didn't bet)
Seat 9: Sweden_Pound folded before Flop (didn't bet)





PokerStars Hand #149391915715:  Hold'em No Limit ($0.25/$0.50 USD) - 2016/02/25 16:37:50 CET [2016/02/25 10:37:50 ET]
Table 'Thalpius III' 9-max Seat #8 is the button
Seat 1: BrotherLove9 ($53.60 in chips) 
Seat 2: matiko09 ($58.79 in chips) 
Seat 3: jamba83 ($53.06 in chips) 
Seat 4: Wwwasian ($51.51 in chips) 
Seat 5: Rorerzap ($57.02 in chips) 
Seat 6: rdrill ($57.72 in chips) 
Seat 7: v4n0v ($50 in chips) 
Seat 8: jeroemie123 ($33.91 in chips) 
Seat 9: Gemb1rdd ($66.18 in chips) 
Gemb1rdd: posts small blind $0.25
BrotherLove9: posts big blind $0.50
*** HOLE CARDS ***
Dealt to matiko09 [6s 2c]
matiko09: folds 
jamba83: folds 
Wwwasian: folds 
Rorerzap: folds 
rdrill: folds 
v4n0v: folds 
jeroemie123: folds 
Gemb1rdd: raises $1 to $1.50
BrotherLove9: folds 
Uncalled bet ($1) returned to Gemb1rdd
Gemb1rdd collected $1 from pot
Gemb1rdd: doesn't show hand 
*** SUMMARY ***
Total pot $1 | Rake $0 
Seat 1: BrotherLove9 (big blind) folded before Flop
Seat 2: matiko09 folded before Flop (didn't bet)
Seat 3: jamba83 folded before Flop (didn't bet)
Seat 4: Wwwasian folded before Flop (didn't bet)
Seat 5: Rorerzap folded before Flop (didn't bet)
Seat 6: rdrill folded before Flop (didn't bet)
Seat 7: v4n0v folded before Flop (didn't bet)
Seat 8: jeroemie123 (button) folded before Flop (didn't bet)
Seat 9: Gemb1rdd (small blind) collected ($1)





PokerStars Hand #149391919780:  Hold'em No Limit ($0.50/$1.00 USD) - 2016/02/25 16:37:56 CET [2016/02/25 10:37:56 ET]
Table 'Simona' 9-max Seat #8 is the button
Seat 1: mycka86 ($114.21 in chips) 
Seat 2: xAndorx ($112.24 in chips) 
Seat 3: Sweden_Pound ($100 in chips) 
Seat 4: matiko09 ($276.42 in chips) 
Seat 5: sebaaastian ($101.50 in chips) 
Seat 6: Ty Nick 420 ($104.50 in chips) 
Seat 7: Aalleekks ($100.30 in chips) 
Seat 8: Monsthand ($134.97 in chips) 
Seat 9: Slushpup69 ($54.65 in chips) 
Slushpup69: posts small blind $0.50
mycka86: posts big blind $1
*** HOLE CARDS ***
Dealt to matiko09 [9c 8s]
xAndorx: folds 
Sweden_Pound: raises $2 to $3
matiko09: folds 
sebaaastian: folds 
Ty Nick 420: folds 
Aalleekks: folds 
Monsthand: folds 
Slushpup69: folds 
mycka86: calls $2
*** FLOP *** [5s Jd Qd]
mycka86: checks 
Sweden_Pound: bets $4.04
mycka86: raises $9.46 to $13.50
Sweden_Pound: raises $17 to $30.50
mycka86: folds 
Uncalled bet ($17) returned to Sweden_Pound
Sweden_Pound collected $31.99 from pot
Sweden_Pound: doesn't show hand 
*** SUMMARY ***
Total pot $33.50 | Rake $1.51 
Board [5s Jd Qd]
Seat 1: mycka86 (big blind) folded on the Flop
Seat 2: xAndorx folded before Flop (didn't bet)
Seat 3: Sweden_Pound collected ($31.99)
Seat 4: matiko09 folded before Flop (didn't bet)
Seat 5: sebaaastian folded before Flop (didn't bet)
Seat 6: Ty Nick 420 folded before Flop (didn't bet)
Seat 7: Aalleekks folded before Flop (didn't bet)
Seat 8: Monsthand (button) folded before Flop (didn't bet)
Seat 9: Slushpup69 (small blind) folded before Flop





PokerStars Hand #149391927150:  Hold'em No Limit ($0.50/$1.00 USD) - 2016/02/25 16:38:05 CET [2016/02/25 10:38:05 ET]
Table 'Zeuxo II' 9-max Seat #4 is the button
Seat 1: forsmthgood ($100 in chips) 
Seat 2: Sweden_Pound ($102.75 in chips) 
Seat 3: xAndorx ($99.50 in chips) 
Seat 4: sebaaastian ($122.11 in chips) 
Seat 5: bauss84 ($24.04 in chips) 
Seat 6: Cogss ($105.30 in chips) 
Seat 7: djammusic ($40 in chips) 
Seat 8: matiko09 ($100 in chips) 
Seat 9: Sreshta222 ($219.39 in chips) 
bauss84: posts small blind $0.50
Cogss: posts big blind $1
*** HOLE CARDS ***
Dealt to matiko09 [4c Ah]
djammusic: folds 
matiko09: folds 
Sreshta222: folds 
forsmthgood: folds 
Sweden_Pound: folds 
xAndorx: raises $2 to $3
sebaaastian: folds 
bauss84: folds 
Cogss: calls $2
*** FLOP *** [8d 3s 2d]
Cogss: bets $6.21
xAndorx: folds 
Uncalled bet ($6.21) returned to Cogss
Cogss collected $6.21 from pot
*** SUMMARY ***
Total pot $6.50 | Rake $0.29 
Board [8d 3s 2d]
Seat 1: forsmthgood folded before Flop (didn't bet)
Seat 2: Sweden_Pound folded before Flop (didn't bet)
Seat 3: xAndorx folded on the Flop
Seat 4: sebaaastian (button) folded before Flop (didn't bet)
Seat 5: bauss84 (small blind) folded before Flop
Seat 6: Cogss (big blind) collected ($6.21)
Seat 7: djammusic folded before Flop (didn't bet)
Seat 8: matiko09 folded before Flop (didn't bet)
Seat 9: Sreshta222 folded before Flop (didn't bet)





PokerStars Hand #149391929996:  Hold'em No Limit ($0.25/$0.50 USD) - 2016/02/25 16:38:09 CET [2016/02/25 10:38:09 ET]
Table 'Lohja II' 9-max Seat #8 is the button
Seat 1: MoonJimmy ($146.03 in chips) 
Seat 2: Apparat888 ($33.22 in chips) 
Seat 3: guvalc1952 ($143.71 in chips) 
Seat 4: r4mz3s ($52.11 in chips) 
Seat 6: Player1705 ($125 in chips) 
Seat 7: matiko09 ($155.91 in chips) 
Seat 8: jamba83 ($58.35 in chips) 
Seat 9: Muinmyheart ($83.19 in chips) 
Muinmyheart: posts small blind $0.25
MoonJimmy: posts big blind $0.50
vasiy379: sits out 
MoonJimmy: posts the ante $0.10
Apparat888: posts the ante $0.10
guvalc1952: posts the ante $0.10
r4mz3s: posts the ante $0.10
Player1705: posts the ante $0.10
matiko09: posts the ante $0.10
jamba83: posts the ante $0.10
Muinmyheart: posts the ante $0.10
*** HOLE CARDS ***
Dealt to matiko09 [9c Qh]
Apparat888: folds 
guvalc1952: folds 
r4mz3s: folds 
Player1705: raises $0.94 to $1.44
matiko09: folds 
jamba83: folds 
Muinmyheart: folds 
MoonJimmy: folds 
Uncalled bet ($0.94) returned to Player1705
Player1705 collected $2.05 from pot
Player1705: doesn't show hand 
*** SUMMARY ***
Total pot $2.05 | Rake $0 
Seat 1: MoonJimmy (big blind) folded before Flop
Seat 2: Apparat888 folded before Flop (didn't bet)
Seat 3: guvalc1952 folded before Flop (didn't bet)
Seat 4: r4mz3s folded before Flop (didn't bet)
Seat 6: Player1705 collected ($2.05)
Seat 7: matiko09 folded before Flop (didn't bet)
Seat 8: jamba83 (button) folded before Flop (didn't bet)
Seat 9: Muinmyheart (small blind) folded before Flop





PokerStars Hand #149391930544:  Hold'em No Limit ($0.50/$1.00 USD) - 2016/02/25 16:38:10 CET [2016/02/25 10:38:10 ET]
Table 'Lucia III' 9-max Seat #4 is the button
Seat 1: Monsthand ($123.95 in chips) 
Seat 2: kuanhung0903 ($79 in chips) 
Seat 3: mycka86 ($106.12 in chips) 
Seat 4: swatek1986 ($133.09 in chips) 
Seat 5: Sweden_Pound ($223.43 in chips) 
Seat 6: matiko09 ($109.23 in chips) 
Seat 7: Ty Nick 420 ($175.52 in chips) 
Seat 8: apfush ($109.60 in chips) 
Seat 9: Apparat888 ($34.45 in chips) 
Sweden_Pound: posts small blind $0.50
matiko09: posts big blind $1
*** HOLE CARDS ***
Dealt to matiko09 [5d 9h]
Ty Nick 420: folds 
apfush: folds 
Apparat888: folds 
Monsthand: folds 
kuanhung0903: folds 
mycka86: raises $1.10 to $2.10
swatek1986: folds 
Sweden_Pound: folds 
matiko09: folds 
Uncalled bet ($1.10) returned to mycka86
mycka86 collected $2.50 from pot
*** SUMMARY ***
Total pot $2.50 | Rake $0 
Seat 1: Monsthand folded before Flop (didn't bet)
Seat 2: kuanhung0903 folded before Flop (didn't bet)
Seat 3: mycka86 collected ($2.50)
Seat 4: swatek1986 (button) folded before Flop (didn't bet)
Seat 5: Sweden_Pound (small blind) folded before Flop
Seat 6: matiko09 (big blind) folded before Flop
Seat 7: Ty Nick 420 folded before Flop (didn't bet)
Seat 8: apfush folded before Flop (didn't bet)
Seat 9: Apparat888 folded before Flop (didn't bet)





PokerStars Hand #149391938148:  Hold'em No Limit ($0.50/$1.00 USD) - 2016/02/25 16:38:20 CET [2016/02/25 10:38:20 ET]
Table 'Hercules IV' 9-max Seat #9 is the button
Seat 1: matiko09 ($100 in chips) 
Seat 2: hammerwife ($100 in chips) 
Seat 3: sebaaastian ($201.70 in chips) 
Seat 4: Sweden_Pound ($100 in chips) 
Seat 5: xAndorx ($142.27 in chips) 
Seat 6: kuanhung0903 ($66.21 in chips) 
Seat 7: Ouga Buga ($100 in chips) 
Seat 8: brokat77 ($111.15 in chips) 
Seat 9: djammusic ($38.70 in chips) 
matiko09: posts small blind $0.50
hammerwife: posts big blind $1
*** HOLE CARDS ***
Dealt to matiko09 [Ah 2h]
sebaaastian: folds 
Sweden_Pound: folds 
xAndorx: raises $2 to $3
kuanhung0903: folds 
Ouga Buga: calls $3
brokat77: folds 
djammusic: folds 
matiko09: folds 
hammerwife: folds 
*** FLOP *** [Kh Jd 2d]
xAndorx: checks 
Ouga Buga: checks 
*** TURN *** [Kh Jd 2d] [Ac]
xAndorx: bets $3.50
Ouga Buga: folds 
Uncalled bet ($3.50) returned to xAndorx
xAndorx collected $7.16 from pot
xAndorx: doesn't show hand 
*** SUMMARY ***
Total pot $7.50 | Rake $0.34 
Board [Kh Jd 2d Ac]
Seat 1: matiko09 (small blind) folded before Flop
Seat 2: hammerwife (big blind) folded before Flop
Seat 3: sebaaastian folded before Flop (didn't bet)
Seat 4: Sweden_Pound folded before Flop (didn't bet)
Seat 5: xAndorx collected ($7.16)
Seat 6: kuanhung0903 folded before Flop (didn't bet)
Seat 7: Ouga Buga folded on the Turn
Seat 8: brokat77 folded before Flop (didn't bet)
Seat 9: djammusic (button) folded before Flop (didn't bet)





PokerStars Hand #149391938943:  Hold'em No Limit ($0.50/$1.00 USD) - 2016/02/25 16:38:21 CET [2016/02/25 10:38:21 ET]
Table 'Lina II' 9-max Seat #2 is the button
Seat 2: matiko09 ($110.01 in chips) 
Seat 4: Nennenurse ($49.63 in chips) 
Seat 5: swizzly58 ($40.89 in chips) 
Seat 6: sebaaastian ($110.12 in chips) 
Seat 7: Monsthand ($130.80 in chips) 
Seat 8: djammusic ($44.14 in chips) 
Seat 9: Sweden_Pound ($269.27 in chips) 
Ouga Buga will be allowed to play after the button
Nennenurse: posts small blind $0.50
swizzly58: posts big blind $1
*** HOLE CARDS ***
Dealt to matiko09 [Th 9h]
sebaaastian: folds 
Monsthand: folds 
djammusic: folds 
Sweden_Pound: folds 
matiko09: raises $1.27 to $2.27
Nennenurse: folds 
swizzly58: folds 
Uncalled bet ($1.27) returned to matiko09
matiko09 collected $2.50 from pot
matiko09: doesn't show hand 
*** SUMMARY ***
Total pot $2.50 | Rake $0 
Seat 2: matiko09 (button) collected ($2.50)
Seat 4: Nennenurse (small blind) folded before Flop
Seat 5: swizzly58 (big blind) folded before Flop
Seat 6: sebaaastian folded before Flop (didn't bet)
Seat 7: Monsthand folded before Flop (didn't bet)
Seat 8: djammusic folded before Flop (didn't bet)
Seat 9: Sweden_Pound folded before Flop (didn't bet)





PokerStars Hand #149391939884:  Hold'em No Limit ($0.50/$1.00 USD) - 2016/02/25 16:38:22 CET [2016/02/25 10:38:22 ET]
Table 'Morosovia II' 9-max Seat #8 is the button
Seat 1: apfush ($196.46 in chips) 
Seat 2: lysandrafly ($101.50 in chips) 
Seat 3: sebaaastian ($136.87 in chips) 
Seat 4: matiko09 ($170.35 in chips) 
Seat 5: pimpoza ($64.89 in chips) 
Seat 6: Sweden_Pound ($138.61 in chips) 
Seat 7: Ty Nick 420 ($172.69 in chips) 
Seat 8: Monsthand ($100.50 in chips) 
Seat 9: Ouga Buga ($121.54 in chips) 
Ouga Buga: posts small blind $0.50
apfush: posts big blind $1
*** HOLE CARDS ***
Dealt to matiko09 [Ts 7h]
lysandrafly: folds 
sebaaastian: folds 
matiko09: folds 
pimpoza: raises $2 to $3
Sweden_Pound: folds 
Ty Nick 420: calls $3
Monsthand: folds 
Ouga Buga: folds 
apfush: folds 
*** FLOP *** [6s As Kc]
pimpoza: checks 
Ty Nick 420: checks 
*** TURN *** [6s As Kc] [2c]
pimpoza: bets $6
Ty Nick 420: folds 
Uncalled bet ($6) returned to pimpoza
pimpoza collected $7.16 from pot
*** SUMMARY ***
Total pot $7.50 | Rake $0.34 
Board [6s As Kc 2c]
Seat 1: apfush (big blind) folded before Flop
Seat 2: lysandrafly folded before Flop (didn't bet)
Seat 3: sebaaastian folded before Flop (didn't bet)
Seat 4: matiko09 folded before Flop (didn't bet)
Seat 5: pimpoza collected ($7.16)
Seat 6: Sweden_Pound folded before Flop (didn't bet)
Seat 7: Ty Nick 420 folded on the Turn
Seat 8: Monsthand (button) folded before Flop (didn't bet)
Seat 9: Ouga Buga (small blind) folded before Flop





PokerStars Hand #149391942194:  Hold'em No Limit (€0.25/€0.50 EUR) - 2016/02/25 16:38:25 CET [2016/02/25 10:38:25 ET]
Table 'Leo Minor III' 9-max Seat #8 is the button
Seat 1: Al3xAnd3r22 (€52 in chips) 
Seat 2: vasiy379 (€50 in chips) 
Seat 3: Rorerzap (€62.75 in chips) 
Seat 4: RvPersie (€70.81 in chips) 
Seat 5: kasse_62 (€20.42 in chips) 
Seat 6: Wwwasian (€53.29 in chips) 
Seat 7: Apparat888 (€28.26 in chips) 
Seat 8: mi$$I$Elena (€85.90 in chips) 
Seat 9: matiko09 (€50 in chips) 
matiko09: posts small blind €0.25
Al3xAnd3r22: posts big blind €0.50
*** HOLE CARDS ***
Dealt to matiko09 [2s 2c]
vasiy379: folds 
Rorerzap: folds 
RvPersie: folds 
kasse_62: folds 
Wwwasian: folds 
Apparat888: folds 
mi$$I$Elena: raises €0.50 to €1
matiko09: folds 
Al3xAnd3r22: raises €4 to €5
mi$$I$Elena: folds 
Uncalled bet (€4) returned to Al3xAnd3r22
Al3xAnd3r22 collected €2.25 from pot
Al3xAnd3r22: doesn't show hand 
*** SUMMARY ***
Total pot €2.25 | Rake €0 
Seat 1: Al3xAnd3r22 (big blind) collected (€2.25)
Seat 2: vasiy379 folded before Flop (didn't bet)
Seat 3: Rorerzap folded before Flop (didn't bet)
Seat 4: RvPersie folded before Flop (didn't bet)
Seat 5: kasse_62 folded before Flop (didn't bet)
Seat 6: Wwwasian folded before Flop (didn't bet)
Seat 7: Apparat888 folded before Flop (didn't bet)
Seat 8: mi$$I$Elena (button) folded before Flop
Seat 9: matiko09 (small blind) folded before Flop





PokerStars Hand #149391943735:  Hold'em No Limit ($0.50/$1.00 USD) - 2016/02/25 16:38:27 CET [2016/02/25 10:38:27 ET]
Table 'Guisan' 9-max Seat #4 is the button
Seat 1: stockbridge8 ($63.47 in chips) 
Seat 2: mycka86 ($100 in chips) 
Seat 4: matiko09 ($173.75 in chips) 
Seat 5: Jeckpot1989 ($97 in chips) 
Seat 6: 19R&J91 ($394.90 in chips) 
Seat 7: sebaaastian ($116.59 in chips) 
Seat 8: Monsthand ($100 in chips) 
Seat 9: Sweden_Pound ($109.19 in chips) 
Jeckpot1989: posts small blind $0.50
19R&J91: posts big blind $1
xAndorx: sits out 
*** HOLE CARDS ***
Dealt to matiko09 [5d 7h]
sebaaastian: folds 
Monsthand: raises $2 to $3
Sweden_Pound: folds 
stockbridge8: folds 
mycka86: folds 
matiko09: folds 
Jeckpot1989: folds 
19R&J91: calls $2
*** FLOP *** [5h Jh Qd]
19R&J91: checks 
Monsthand: bets $4
19R&J91: raises $4 to $8
Monsthand: raises $11 to $19
19R&J91: calls $11
*** TURN *** [5h Jh Qd] [As]
19R&J91: checks 
Monsthand: bets $28.50
19R&J91: folds 
Uncalled bet ($28.50) returned to Monsthand
Monsthand collected $42.50 from pot
*** SUMMARY ***
Total pot $44.50 | Rake $2 
Board [5h Jh Qd As]
Seat 1: stockbridge8 folded before Flop (didn't bet)
Seat 2: mycka86 folded before Flop (didn't bet)
Seat 4: matiko09 (button) folded before Flop (didn't bet)
Seat 5: Jeckpot1989 (small blind) folded before Flop
Seat 6: 19R&J91 (big blind) folded on the Turn
Seat 7: sebaaastian folded before Flop (didn't bet)
Seat 8: Monsthand collected ($42.50)
Seat 9: Sweden_Pound folded before Flop (didn't bet)





PokerStars Hand #149391944275:  Hold'em No Limit ($0.50/$1.00 USD) - 2016/02/25 16:38:28 CET [2016/02/25 10:38:28 ET]
Table 'Isa' 9-max Seat #9 is the button
Seat 1: matiko09 ($113.44 in chips) 
Seat 2: Monsthand ($100 in chips) 
Seat 3: sebaaastian ($115.40 in chips) 
Seat 5: Sweden_Pound ($106.55 in chips) 
Seat 6: xAndorx ($100 in chips) 
Seat 7: bilukm ($145.51 in chips) 
Seat 9: TideHan ($102.71 in chips) 
matiko09: posts small blind $0.50
Monsthand: posts big blind $1
hammerwife: sits out 
*** HOLE CARDS ***
Dealt to matiko09 [Td Th]
sebaaastian: folds 
Sweden_Pound: folds 
xAndorx: raises $2 to $3
bilukm: folds 
TideHan: folds 
matiko09: raises $7 to $10
Monsthand: folds 
xAndorx: folds 
Uncalled bet ($7) returned to matiko09
matiko09 collected $7 from pot
matiko09: doesn't show hand 
*** SUMMARY ***
Total pot $7 | Rake $0 
Seat 1: matiko09 (small blind) collected ($7)
Seat 2: Monsthand (big blind) folded before Flop
Seat 3: sebaaastian folded before Flop (didn't bet)
Seat 5: Sweden_Pound folded before Flop (didn't bet)
Seat 6: xAndorx folded before Flop
Seat 7: bilukm folded before Flop (didn't bet)
Seat 9: TideHan (button) folded before Flop (didn't bet)





PokerStars Hand #149391948194:  Hold'em No Limit ($0.25/$0.50 USD) - 2016/02/25 16:38:33 CET [2016/02/25 10:38:33 ET]
Table 'Thalpius III' 9-max Seat #9 is the button
Seat 1: BrotherLove9 ($53.10 in chips) 
Seat 2: matiko09 ($58.79 in chips) 
Seat 3: jamba83 ($53.06 in chips) 
Seat 4: Wwwasian ($51.51 in chips) 
Seat 5: Rorerzap ($57.02 in chips) 
Seat 6: rdrill ($57.72 in chips) 
Seat 7: v4n0v ($50 in chips) 
Seat 8: jeroemie123 ($33.91 in chips) 
Seat 9: Gemb1rdd ($66.68 in chips) 
BrotherLove9: posts small blind $0.25
matiko09: posts big blind $0.50
*** HOLE CARDS ***
Dealt to matiko09 [9h Kc]
jamba83: folds 
Wwwasian: folds 
Rorerzap: folds 
rdrill: folds 
v4n0v: folds 
jeroemie123: calls $0.50
Gemb1rdd: calls $0.50
BrotherLove9: folds 
matiko09: checks 
*** FLOP *** [5s Ts 2d]
matiko09: checks 
jeroemie123: checks 
Gemb1rdd: bets $1
matiko09: folds 
jeroemie123: calls $1
*** TURN *** [5s Ts 2d] [7d]
jeroemie123: checks 
Gemb1rdd: checks 
*** RIVER *** [5s Ts 2d 7d] [3h]
jeroemie123: bets $2.50
Gemb1rdd: calls $2.50
*** SHOW DOWN ***
jeroemie123: shows [9d As] (high card Ace)
Gemb1rdd: shows [Tc 8c] (a pair of Tens)
Gemb1rdd collected $8.36 from pot
*** SUMMARY ***
Total pot $8.75 | Rake $0.39 
Board [5s Ts 2d 7d 3h]
Seat 1: BrotherLove9 (small blind) folded before Flop
Seat 2: matiko09 (big blind) folded on the Flop
Seat 3: jamba83 folded before Flop (didn't bet)
Seat 4: Wwwasian folded before Flop (didn't bet)
Seat 5: Rorerzap folded before Flop (didn't bet)
Seat 6: rdrill folded before Flop (didn't bet)
Seat 7: v4n0v folded before Flop (didn't bet)
Seat 8: jeroemie123 showed [9d As] and lost with high card Ace
Seat 9: Gemb1rdd (button) showed [Tc 8c] and won ($8.36) with a pair of Tens





PokerStars Hand #149391953623:  Hold'em No Limit ($0.25/$0.50 USD) - 2016/02/25 16:38:40 CET [2016/02/25 10:38:40 ET]
Table 'Lohja II' 9-max Seat #9 is the button
Seat 1: MoonJimmy ($145.43 in chips) 
Seat 2: Apparat888 ($33.12 in chips) 
Seat 3: guvalc1952 ($143.61 in chips) 
Seat 4: r4mz3s ($52.01 in chips) 
Seat 6: Player1705 ($126.45 in chips) 
Seat 7: matiko09 ($155.81 in chips) 
Seat 8: jamba83 ($58.25 in chips) 
Seat 9: Muinmyheart ($82.84 in chips) 
MoonJimmy: posts small blind $0.25
Apparat888: posts big blind $0.50
vasiy379: sits out 
MoonJimmy: posts the ante $0.10
Apparat888: posts the ante $0.10
guvalc1952: posts the ante $0.10
r4mz3s: posts the ante $0.10
Player1705: posts the ante $0.10
matiko09: posts the ante $0.10
jamba83: posts the ante $0.10
Muinmyheart: posts the ante $0.10
*** HOLE CARDS ***
Dealt to matiko09 [5d 4c]
guvalc1952: calls $0.50
r4mz3s: folds 
Player1705: folds 
matiko09: folds 
jamba83: folds 
Muinmyheart: raises $1.25 to $1.75
MoonJimmy: folds 
Apparat888: folds 
guvalc1952: calls $1.25
*** FLOP *** [Ad 2c 9d]
guvalc1952: checks 
Muinmyheart: checks 
*** TURN *** [Ad 2c 9d] [7d]
guvalc1952: checks 
Muinmyheart: checks 
*** RIVER *** [Ad 2c 9d 7d] [Qh]
guvalc1952: bets $2.41
Muinmyheart: folds 
Uncalled bet ($2.41) returned to guvalc1952
guvalc1952 collected $4.82 from pot
guvalc1952: doesn't show hand 
*** SUMMARY ***
Total pot $5.05 | Rake $0.23 
Board [Ad 2c 9d 7d Qh]
Seat 1: MoonJimmy (small blind) folded before Flop
Seat 2: Apparat888 (big blind) folded before Flop
Seat 3: guvalc1952 collected ($4.82)
Seat 4: r4mz3s folded before Flop (didn't bet)
Seat 6: Player1705 folded before Flop (didn't bet)
Seat 7: matiko09 folded before Flop (didn't bet)
Seat 8: jamba83 folded before Flop (didn't bet)
Seat 9: Muinmyheart (button) folded on the River





PokerStars Hand #149391959175:  Hold'em No Limit ($0.50/$1.00 USD) - 2016/02/25 16:38:48 CET [2016/02/25 10:38:48 ET]
Table 'Zeuxo II' 9-max Seat #5 is the button
Seat 1: forsmthgood ($100 in chips) 
Seat 2: Sweden_Pound ($102.75 in chips) 
Seat 3: xAndorx ($96.50 in chips) 
Seat 4: sebaaastian ($122.11 in chips) 
Seat 5: bauss84 ($23.54 in chips) 
Seat 6: Cogss ($108.51 in chips) 
Seat 7: djammusic ($40 in chips) 
Seat 8: matiko09 ($100 in chips) 
Seat 9: Sreshta222 ($219.39 in chips) 
Cogss: posts small blind $0.50
djammusic: posts big blind $1
*** HOLE CARDS ***
Dealt to matiko09 [5d Td]
matiko09: folds 
Sreshta222: folds 
forsmthgood: folds 
Sweden_Pound: folds 
xAndorx: folds 
sebaaastian: folds 
bauss84: raises $3 to $4
Cogss: calls $3.50
djammusic: folds 
*** FLOP *** [9d 3s Ah]
Cogss: checks 
bauss84: checks 
*** TURN *** [9d 3s Ah] [3h]
Cogss: checks 
bauss84: bets $4
Cogss: folds 
Uncalled bet ($4) returned to bauss84
bauss84 collected $8.60 from pot
bauss84: doesn't show hand 
*** SUMMARY ***
Total pot $9 | Rake $0.40 
Board [9d 3s Ah 3h]
Seat 1: forsmthgood folded before Flop (didn't bet)
Seat 2: Sweden_Pound folded before Flop (didn't bet)
Seat 3: xAndorx folded before Flop (didn't bet)
Seat 4: sebaaastian folded before Flop (didn't bet)
Seat 5: bauss84 (button) collected ($8.60)
Seat 6: Cogss (small blind) folded on the Turn
Seat 7: djammusic (big blind) folded before Flop
Seat 8: matiko09 folded before Flop (didn't bet)
Seat 9: Sreshta222 folded before Flop (didn't bet)





PokerStars Hand #149391963652:  Hold'em No Limit ($0.50/$1.00 USD) - 2016/02/25 16:38:53 CET [2016/02/25 10:38:53 ET]
Table 'Lina II' 9-max Seat #4 is the button
Seat 2: matiko09 ($111.51 in chips) 
Seat 4: Nennenurse ($49.13 in chips) 
Seat 5: swizzly58 ($39.89 in chips) 
Seat 6: sebaaastian ($110.12 in chips) 
Seat 7: Monsthand ($130.80 in chips) 
Seat 8: djammusic ($44.14 in chips) 
Seat 9: Sweden_Pound ($269.27 in chips) 
swizzly58: posts small blind $0.50
sebaaastian: posts big blind $1
Ouga Buga: sits out 
*** HOLE CARDS ***
Dealt to matiko09 [4s Ah]
Monsthand: folds 
djammusic: folds 
Sweden_Pound: folds 
matiko09: folds 
Nennenurse: folds 
swizzly58: calls $0.50
sebaaastian: checks 
*** FLOP *** [Kh 4h 3c]
swizzly58: checks 
sebaaastian: checks 
*** TURN *** [Kh 4h 3c] [As]
swizzly58: checks 
sebaaastian: checks 
*** RIVER *** [Kh 4h 3c As] [2h]
swizzly58: checks 
sebaaastian: checks 
*** SHOW DOWN ***
swizzly58: shows [Qc 9d] (high card Ace)
sebaaastian: mucks hand 
swizzly58 collected $1.91 from pot
*** SUMMARY ***
Total pot $2 | Rake $0.09 
Board [Kh 4h 3c As 2h]
Seat 2: matiko09 folded before Flop (didn't bet)
Seat 4: Nennenurse (button) folded before Flop (didn't bet)
Seat 5: swizzly58 (small blind) showed [Qc 9d] and won ($1.91) with high card Ace
Seat 6: sebaaastian (big blind) mucked [9h 7c]
Seat 7: Monsthand folded before Flop (didn't bet)
Seat 8: djammusic folded before Flop (didn't bet)
Seat 9: Sweden_Pound folded before Flop (didn't bet)





PokerStars Hand #149391965252:  Hold'em No Limit ($0.50/$1.00 USD) - 2016/02/25 16:38:55 CET [2016/02/25 10:38:55 ET]
Table 'Lucia III' 9-max Seat #5 is the button
Seat 1: Monsthand ($123.95 in chips) 
Seat 2: kuanhung0903 ($79 in chips) 
Seat 3: mycka86 ($107.62 in chips) 
Seat 4: swatek1986 ($133.09 in chips) 
Seat 5: Sweden_Pound ($222.93 in chips) 
Seat 6: matiko09 ($108.23 in chips) 
Seat 7: Ty Nick 420 ($175.52 in chips) 
Seat 8: apfush ($109.60 in chips) 
Seat 9: Apparat888 ($34.45 in chips) 
matiko09: posts small blind $0.50
Ty Nick 420: posts big blind $1
*** HOLE CARDS ***
Dealt to matiko09 [As Ks]
apfush: folds 
Apparat888: folds 
Monsthand: raises $1.70 to $2.70
kuanhung0903: folds 
mycka86: calls $2.70
swatek1986: folds 
Sweden_Pound: folds 
matiko09: raises $9.30 to $12
Ty Nick 420: folds 
Monsthand: folds 
mycka86: calls $9.30
*** FLOP *** [Tc 6h 2c]
matiko09: checks 
mycka86: bets $13.72
matiko09: folds 
Uncalled bet ($13.72) returned to mycka86
mycka86 collected $26.45 from pot
*** SUMMARY ***
Total pot $27.70 | Rake $1.25 
Board [Tc 6h 2c]
Seat 1: Monsthand folded before Flop
Seat 2: kuanhung0903 folded before Flop (didn't bet)
Seat 3: mycka86 collected ($26.45)
Seat 4: swatek1986 folded before Flop (didn't bet)
Seat 5: Sweden_Pound (button) folded before Flop (didn't bet)
Seat 6: matiko09 (small blind) folded on the Flop
Seat 7: Ty Nick 420 (big blind) folded before Flop
Seat 8: apfush folded before Flop (didn't bet)
Seat 9: Apparat888 folded before Flop (didn't bet)





PokerStars Hand #149391972378:  Hold'em No Limit ($0.50/$1.00 USD) - 2016/02/25 16:39:05 CET [2016/02/25 10:39:05 ET]
Table 'Isa' 9-max Seat #1 is the button
Seat 1: matiko09 ($117.44 in chips) 
Seat 2: Monsthand ($100 in chips) 
Seat 3: sebaaastian ($115.40 in chips) 
Seat 5: Sweden_Pound ($106.55 in chips) 
Seat 6: xAndorx ($97 in chips) 
Seat 7: bilukm ($145.51 in chips) 
Seat 9: TideHan ($102.71 in chips) 
Monsthand: posts small blind $0.50
sebaaastian: posts big blind $1
hammerwife: sits out 
*** HOLE CARDS ***
Dealt to matiko09 [Jh As]
Sweden_Pound: folds 
xAndorx has timed out
xAndorx: folds 
bilukm: raises $1 to $2
TideHan: raises $6 to $8
matiko09: raises $10 to $18
Monsthand: folds 
sebaaastian: folds 
bilukm: folds 
TideHan: folds 
Uncalled bet ($10) returned to matiko09
matiko09 collected $19.50 from pot
matiko09: doesn't show hand 
*** SUMMARY ***
Total pot $19.50 | Rake $0 
Seat 1: matiko09 (button) collected ($19.50)
Seat 2: Monsthand (small blind) folded before Flop
Seat 3: sebaaastian (big blind) folded before Flop
Seat 5: Sweden_Pound folded before Flop (didn't bet)
Seat 6: xAndorx folded before Flop (didn't bet)
Seat 7: bilukm folded before Flop
Seat 9: TideHan folded before Flop





PokerStars Hand #149391992072:  Hold'em No Limit (€0.25/€0.50 EUR) - 2016/02/25 16:39:31 CET [2016/02/25 10:39:31 ET]
Table 'Leo Minor III' 9-max Seat #9 is the button
Seat 1: Al3xAnd3r22 (€53.25 in chips) 
Seat 2: vasiy379 (€50 in chips) 
Seat 3: Rorerzap (€62.75 in chips) 
Seat 4: RvPersie (€70.81 in chips) 
Seat 5: kasse_62 (€20.42 in chips) 
Seat 6: Wwwasian (€53.29 in chips) 
Seat 7: Apparat888 (€28.26 in chips) 
Seat 8: mi$$I$Elena (€84.90 in chips) 
Seat 9: matiko09 (€50 in chips) 
Al3xAnd3r22: posts small blind €0.25
vasiy379: posts big blind €0.50
*** HOLE CARDS ***
Dealt to matiko09 [Ad 8d]
Rorerzap: folds 
RvPersie: folds 
kasse_62: folds 
Wwwasian: folds 
Apparat888: folds 
mi$$I$Elena: folds 
matiko09: raises €0.63 to €1.13
Al3xAnd3r22: folds 
vasiy379: folds 
Uncalled bet (€0.63) returned to matiko09
matiko09 collected €1.25 from pot
matiko09: doesn't show hand 
*** SUMMARY ***
Total pot €1.25 | Rake €0 
Seat 1: Al3xAnd3r22 (small blind) folded before Flop
Seat 2: vasiy379 (big blind) folded before Flop
Seat 3: Rorerzap folded before Flop (didn't bet)
Seat 4: RvPersie folded before Flop (didn't bet)
Seat 5: kasse_62 folded before Flop (didn't bet)
Seat 6: Wwwasian folded before Flop (didn't bet)
Seat 7: Apparat888 folded before Flop (didn't bet)
Seat 8: mi$$I$Elena folded before Flop (didn't bet)
Seat 9: matiko09 (button) collected (€1.25)





PokerStars Hand #149391995371:  Hold'em No Limit ($0.50/$1.00 USD) - 2016/02/25 16:39:35 CET [2016/02/25 10:39:35 ET]
Table 'Simona' 9-max Seat #9 is the button
Seat 1: mycka86 ($100 in chips) 
Seat 2: xAndorx ($112.24 in chips) 
Seat 3: Sweden_Pound ($115.49 in chips) 
Seat 4: matiko09 ($276.42 in chips) 
Seat 5: sebaaastian ($101.50 in chips) 
Seat 6: Ty Nick 420 ($104.50 in chips) 
Seat 7: Aalleekks ($100.30 in chips) 
Seat 8: Monsthand ($134.97 in chips) 
Seat 9: Slushpup69 ($54.15 in chips) 
mycka86: posts small blind $0.50
xAndorx: posts big blind $1
*** HOLE CARDS ***
Dealt to matiko09 [Qd Jc]
Sweden_Pound: raises $2 to $3
matiko09: folds 
sebaaastian: folds 
Ty Nick 420: folds 
Aalleekks: folds 
Monsthand: folds 
Slushpup69: folds 
mycka86: folds 
xAndorx: folds 
Uncalled bet ($2) returned to Sweden_Pound
Sweden_Pound collected $2.50 from pot
Sweden_Pound: doesn't show hand 
*** SUMMARY ***
Total pot $2.50 | Rake $0 
Seat 1: mycka86 (small blind) folded before Flop
Seat 2: xAndorx (big blind) folded before Flop
Seat 3: Sweden_Pound collected ($2.50)
Seat 4: matiko09 folded before Flop (didn't bet)
Seat 5: sebaaastian folded before Flop (didn't bet)
Seat 6: Ty Nick 420 folded before Flop (didn't bet)
Seat 7: Aalleekks folded before Flop (didn't bet)
Seat 8: Monsthand folded before Flop (didn't bet)
Seat 9: Slushpup69 (button) folded before Flop (didn't bet)





PokerStars Hand #149391997521:  Hold'em No Limit ($0.50/$1.00 USD) - 2016/02/25 16:39:38 CET [2016/02/25 10:39:38 ET]
Table 'Zeuxo II' 9-max Seat #6 is the button
Seat 1: forsmthgood ($100 in chips) 
Seat 2: Sweden_Pound ($102.75 in chips) 
Seat 3: xAndorx ($96.50 in chips) 
Seat 4: sebaaastian ($122.11 in chips) 
Seat 5: bauss84 ($28.14 in chips) 
Seat 6: Cogss ($104.51 in chips) 
Seat 7: djammusic ($39 in chips) 
Seat 8: matiko09 ($100 in chips) 
Seat 9: Sreshta222 ($219.39 in chips) 
djammusic: posts small blind $0.50
matiko09: posts big blind $1
*** HOLE CARDS ***
Dealt to matiko09 [5s Jc]
Sreshta222: folds 
forsmthgood: folds 
Sweden_Pound: raises $2 to $3
xAndorx: folds 
sebaaastian: folds 
bauss84: folds 
Cogss: folds 
djammusic: folds 
matiko09: folds 
Uncalled bet ($2) returned to Sweden_Pound
Sweden_Pound collected $2.50 from pot
Sweden_Pound: doesn't show hand 
*** SUMMARY ***
Total pot $2.50 | Rake $0 
Seat 1: forsmthgood folded before Flop (didn't bet)
Seat 2: Sweden_Pound collected ($2.50)
Seat 3: xAndorx folded before Flop (didn't bet)
Seat 4: sebaaastian folded before Flop (didn't bet)
Seat 5: bauss84 folded before Flop (didn't bet)
Seat 6: Cogss (button) folded before Flop (didn't bet)
Seat 7: djammusic (small blind) folded before Flop
Seat 8: matiko09 (big blind) folded before Flop
Seat 9: Sreshta222 folded before Flop (didn't bet)





PokerStars Hand #149392001163:  Hold'em No Limit ($0.25/$0.50 USD) - 2016/02/25 16:39:42 CET [2016/02/25 10:39:42 ET]
Table 'Thalpius III' 9-max Seat #1 is the button
Seat 1: BrotherLove9 ($52.85 in chips) 
Seat 2: matiko09 ($58.29 in chips) 
Seat 3: jamba83 ($53.06 in chips) 
Seat 4: Wwwasian ($51.51 in chips) 
Seat 5: Rorerzap ($57.02 in chips) 
Seat 6: rdrill ($57.72 in chips) 
Seat 7: v4n0v ($50 in chips) 
Seat 8: jeroemie123 ($29.91 in chips) 
Seat 9: Gemb1rdd ($71.04 in chips) 
matiko09: posts small blind $0.25
jamba83: posts big blind $0.50
*** HOLE CARDS ***
Dealt to matiko09 [5c 3h]
Wwwasian: folds 
Rorerzap: folds 
rdrill: folds 
v4n0v: folds 
jeroemie123: calls $0.50
Gemb1rdd: raises $1.60 to $2.10
BrotherLove9: folds 
matiko09: folds 
jamba83: folds 
jeroemie123: calls $1.60
*** FLOP *** [7s Jh Jc]
jeroemie123: checks 
Gemb1rdd: bets $2.75
jeroemie123: calls $2.75
*** TURN *** [7s Jh Jc] [Jd]
jeroemie123: checks 
Gemb1rdd: checks 
*** RIVER *** [7s Jh Jc Jd] [7h]
jeroemie123: checks 
Gemb1rdd: checks 
*** SHOW DOWN ***
jeroemie123: shows [9s 8d] (a full house, Jacks full of Sevens)
Gemb1rdd: shows [Ac Kd] (a full house, Jacks full of Sevens)
jeroemie123 collected $4.99 from pot
Gemb1rdd collected $4.99 from pot
*** SUMMARY ***
Total pot $10.45 | Rake $0.47 
Board [7s Jh Jc Jd 7h]
Seat 1: BrotherLove9 (button) folded before Flop (didn't bet)
Seat 2: matiko09 (small blind) folded before Flop
Seat 3: jamba83 (big blind) folded before Flop
Seat 4: Wwwasian folded before Flop (didn't bet)
Seat 5: Rorerzap folded before Flop (didn't bet)
Seat 6: rdrill folded before Flop (didn't bet)
Seat 7: v4n0v folded before Flop (didn't bet)
Seat 8: jeroemie123 showed [9s 8d] and won ($4.99) with a full house, Jacks full of Sevens
Seat 9: Gemb1rdd showed [Ac Kd] and won ($4.99) with a full house, Jacks full of Sevens





PokerStars Hand #149392003417:  Hold'em No Limit ($0.50/$1.00 USD) - 2016/02/25 16:39:45 CET [2016/02/25 10:39:45 ET]
Table 'Lina II' 9-max Seat #5 is the button
Seat 1: Lesley2002 ($174.04 in chips) 
Seat 2: matiko09 ($111.51 in chips) 
Seat 4: Nennenurse ($49.13 in chips) 
Seat 5: swizzly58 ($40.80 in chips) 
Seat 6: sebaaastian ($109.12 in chips) 
Seat 7: Monsthand ($130.80 in chips) 
Seat 8: djammusic ($44.14 in chips) 
Seat 9: Sweden_Pound ($269.27 in chips) 
sebaaastian: posts small blind $0.50
Monsthand: posts big blind $1
Ouga Buga: sits out 
*** HOLE CARDS ***
Dealt to matiko09 [5s 4s]
djammusic: folds 
Sweden_Pound: folds 
Lesley2002: raises $1 to $2
matiko09: folds 
Nennenurse: calls $2
swizzly58: folds 
sebaaastian: folds 
Monsthand: calls $1
*** FLOP *** [2s Kd As]
Monsthand: checks 
Lesley2002: checks 
Nennenurse: checks 
*** TURN *** [2s Kd As] [6h]
Monsthand: checks 
Lesley2002: bets $3
Nennenurse: folds 
Monsthand: calls $3
*** RIVER *** [2s Kd As 6h] [5c]
Monsthand: checks 
Lesley2002: checks 
*** SHOW DOWN ***
Monsthand: shows [Th Td] (a pair of Tens)
Lesley2002: mucks hand 
Monsthand collected $11.94 from pot
*** SUMMARY ***
Total pot $12.50 | Rake $0.56 
Board [2s Kd As 6h 5c]
Seat 1: Lesley2002 mucked [6s 7d]
Seat 2: matiko09 folded before Flop (didn't bet)
Seat 4: Nennenurse folded on the Turn
Seat 5: swizzly58 (button) folded before Flop (didn't bet)
Seat 6: sebaaastian (small blind) folded before Flop
Seat 7: Monsthand (big blind) showed [Th Td] and won ($11.94) with a pair of Tens
Seat 8: djammusic folded before Flop (didn't bet)
Seat 9: Sweden_Pound folded before Flop (didn't bet)





PokerStars Hand #149392018949:  Hold'em No Limit ($0.50/$1.00 USD) - 2016/02/25 16:40:06 CET [2016/02/25 10:40:06 ET]
Table 'Zeuxo II' 9-max Seat #7 is the button
Seat 1: forsmthgood ($100 in chips) 
Seat 2: Sweden_Pound ($104.25 in chips) 
Seat 3: xAndorx ($96.50 in chips) 
Seat 4: sebaaastian ($122.11 in chips) 
Seat 5: bauss84 ($28.14 in chips) 
Seat 6: Cogss ($104.51 in chips) 
Seat 7: djammusic ($38.50 in chips) 
Seat 8: matiko09 ($100 in chips) 
Seat 9: Sreshta222 ($219.39 in chips) 
matiko09: posts small blind $0.50
Sreshta222: posts big blind $1
*** HOLE CARDS ***
Dealt to matiko09 [3s Td]
forsmthgood: folds 
Sweden_Pound: folds 
xAndorx: folds 
sebaaastian: folds 
bauss84: folds 
Cogss: raises $1 to $2
djammusic: folds 
matiko09: folds 
Sreshta222: calls $1
*** FLOP *** [6h Jh 5s]
Sreshta222: checks 
Cogss: bets $4.30
Sreshta222: calls $4.30
*** TURN *** [6h Jh 5s] [6s]
Sreshta222: checks 
Cogss: checks 
*** RIVER *** [6h Jh 5s 6s] [Qd]
Sreshta222: checks 
Cogss: checks 
*** SHOW DOWN ***
Sreshta222: shows [Jc 9d] (two pair, Jacks and Sixes)
Cogss: mucks hand 
Sreshta222 collected $12.51 from pot
*** SUMMARY ***
Total pot $13.10 | Rake $0.59 
Board [6h Jh 5s 6s Qd]
Seat 1: forsmthgood folded before Flop (didn't bet)
Seat 2: Sweden_Pound folded before Flop (didn't bet)
Seat 3: xAndorx folded before Flop (didn't bet)
Seat 4: sebaaastian folded before Flop (didn't bet)
Seat 5: bauss84 folded before Flop (didn't bet)
Seat 6: Cogss mucked [8s Ad]
Seat 7: djammusic (button) folded before Flop (didn't bet)
Seat 8: matiko09 (small blind) folded before Flop
Seat 9: Sreshta222 (big blind) showed [Jc 9d] and won ($12.51) with two pair, Jacks and Sixes





PokerStars Hand #149392021306:  Hold'em No Limit ($0.25/$0.50 USD) - 2016/02/25 16:40:09 CET [2016/02/25 10:40:09 ET]
Table 'Lohja II' 9-max Seat #1 is the button
Seat 1: MoonJimmy ($145.08 in chips) 
Seat 2: Apparat888 ($32.52 in chips) 
Seat 3: guvalc1952 ($146.58 in chips) 
Seat 4: r4mz3s ($51.91 in chips) 
Seat 6: Player1705 ($126.35 in chips) 
Seat 7: matiko09 ($155.71 in chips) 
Seat 8: jamba83 ($58.15 in chips) 
Seat 9: Muinmyheart ($80.99 in chips) 
Apparat888: posts small blind $0.25
guvalc1952: posts big blind $0.50
vasiy379: sits out 
MoonJimmy: posts the ante $0.10
Apparat888: posts the ante $0.10
guvalc1952: posts the ante $0.10
r4mz3s: posts the ante $0.10
Player1705: posts the ante $0.10
matiko09: posts the ante $0.10
jamba83: posts the ante $0.10
Muinmyheart: posts the ante $0.10
*** HOLE CARDS ***
Dealt to matiko09 [4c 7h]
r4mz3s: folds 
r4mz3s leaves the table
Player1705: folds 
matiko09: folds 
jamba83: folds 
Muinmyheart: folds 
MoonJimmy: raises $1 to $1.50
Apparat888: folds 
guvalc1952: folds 
Uncalled bet ($1) returned to MoonJimmy
MoonJimmy collected $2.05 from pot
MoonJimmy: doesn't show hand 
*** SUMMARY ***
Total pot $2.05 | Rake $0 
Seat 1: MoonJimmy (button) collected ($2.05)
Seat 2: Apparat888 (small blind) folded before Flop
Seat 3: guvalc1952 (big blind) folded before Flop
Seat 4: r4mz3s folded before Flop (didn't bet)
Seat 6: Player1705 folded before Flop (didn't bet)
Seat 7: matiko09 folded before Flop (didn't bet)
Seat 8: jamba83 folded before Flop (didn't bet)
Seat 9: Muinmyheart folded before Flop (didn't bet)





PokerStars Hand #149392025175:  Hold'em No Limit ($0.50/$1.00 USD) - 2016/02/25 16:40:14 CET [2016/02/25 10:40:14 ET]
Table 'Hercules IV' 9-max Seat #1 is the button
Seat 1: matiko09 ($100 in chips) 
Seat 2: hammerwife ($100 in chips) 
Seat 3: sebaaastian ($201.70 in chips) 
Seat 4: Sweden_Pound ($100 in chips) 
Seat 5: xAndorx ($146.43 in chips) 
Seat 6: kuanhung0903 ($66.21 in chips) 
Seat 7: Ouga Buga ($100 in chips) 
Seat 8: brokat77 ($111.15 in chips) 
Seat 9: djammusic ($38.70 in chips) 
hammerwife: posts small blind $0.50
sebaaastian: posts big blind $1
*** HOLE CARDS ***
Dealt to matiko09 [4s 8d]
Sweden_Pound: folds 
xAndorx: folds 
kuanhung0903: folds 
Ouga Buga: folds 
brokat77: folds 
djammusic: folds 
matiko09: folds 
hammerwife has timed out
hammerwife: folds 
Uncalled bet ($0.50) returned to sebaaastian
sebaaastian collected $1 from pot
sebaaastian: doesn't show hand 
*** SUMMARY ***
Total pot $1 | Rake $0 
Seat 1: matiko09 (button) folded before Flop (didn't bet)
Seat 2: hammerwife (small blind) folded before Flop
Seat 3: sebaaastian (big blind) collected ($1)
Seat 4: Sweden_Pound folded before Flop (didn't bet)
Seat 5: xAndorx folded before Flop (didn't bet)
Seat 6: kuanhung0903 folded before Flop (didn't bet)
Seat 7: Ouga Buga folded before Flop (didn't bet)
Seat 8: brokat77 folded before Flop (didn't bet)
Seat 9: djammusic folded before Flop (didn't bet)





PokerStars Hand #149392028613:  Hold'em No Limit ($0.50/$1.00 USD) - 2016/02/25 16:40:18 CET [2016/02/25 10:40:18 ET]
Table 'Morosovia II' 9-max Seat #9 is the button
Seat 1: apfush ($195.46 in chips) 
Seat 2: lysandrafly ($101.50 in chips) 
Seat 3: sebaaastian ($136.87 in chips) 
Seat 4: matiko09 ($170.35 in chips) 
Seat 5: pimpoza ($69.05 in chips) 
Seat 6: Sweden_Pound ($138.61 in chips) 
Seat 7: Ty Nick 420 ($169.69 in chips) 
Seat 8: Monsthand ($100.50 in chips) 
Seat 9: Ouga Buga ($121.04 in chips) 
apfush: posts small blind $0.50
lysandrafly: posts big blind $1
*** HOLE CARDS ***
Dealt to matiko09 [2d Th]
sebaaastian: folds 
matiko09: folds 
pimpoza: folds 
Sweden_Pound: folds 
Ty Nick 420: folds 
Monsthand: folds 
Ouga Buga: raises $1.50 to $2.50
apfush: folds 
lysandrafly: folds 
Uncalled bet ($1.50) returned to Ouga Buga
Ouga Buga collected $2.50 from pot
Ouga Buga: doesn't show hand 
*** SUMMARY ***
Total pot $2.50 | Rake $0 
Seat 1: apfush (small blind) folded before Flop
Seat 2: lysandrafly (big blind) folded before Flop
Seat 3: sebaaastian folded before Flop (didn't bet)
Seat 4: matiko09 folded before Flop (didn't bet)
Seat 5: pimpoza folded before Flop (didn't bet)
Seat 6: Sweden_Pound folded before Flop (didn't bet)
Seat 7: Ty Nick 420 folded before Flop (didn't bet)
Seat 8: Monsthand folded before Flop (didn't bet)
Seat 9: Ouga Buga (button) collected ($2.50)





PokerStars Hand #149392034398:  Hold'em No Limit ($0.50/$1.00 USD) - 2016/02/25 16:40:26 CET [2016/02/25 10:40:26 ET]
Table 'Lina II' 9-max Seat #6 is the button
Seat 1: Lesley2002 ($169.04 in chips) 
Seat 2: matiko09 ($111.51 in chips) 
Seat 4: Nennenurse ($47.13 in chips) 
Seat 5: swizzly58 ($40.80 in chips) 
Seat 6: sebaaastian ($108.62 in chips) 
Seat 7: Monsthand ($137.74 in chips) 
Seat 8: djammusic ($44.14 in chips) 
Seat 9: Sweden_Pound ($269.27 in chips) 
Monsthand: posts small blind $0.50
djammusic: posts big blind $1
Ouga Buga: sits out 
*** HOLE CARDS ***
Dealt to matiko09 [9s 6d]
Sweden_Pound: folds 
Lesley2002: raises $1 to $2
matiko09: folds 
Nennenurse: raises $4 to $6
swizzly58: folds 
sebaaastian: folds 
Monsthand: raises $10 to $16
djammusic: folds 
Lesley2002: folds 
Nennenurse: folds 
Uncalled bet ($10) returned to Monsthand
Monsthand collected $15 from pot
*** SUMMARY ***
Total pot $15 | Rake $0 
Seat 1: Lesley2002 folded before Flop
Seat 2: matiko09 folded before Flop (didn't bet)
Seat 4: Nennenurse folded before Flop
Seat 5: swizzly58 folded before Flop (didn't bet)
Seat 6: sebaaastian (button) folded before Flop (didn't bet)
Seat 7: Monsthand (small blind) collected ($15)
Seat 8: djammusic (big blind) folded before Flop
Seat 9: Sweden_Pound folded before Flop (didn't bet)





PokerStars Hand #149392034322:  Hold'em No Limit ($0.50/$1.00 USD) - 2016/02/25 16:40:26 CET [2016/02/25 10:40:26 ET]
Table 'Simona' 9-max Seat #1 is the button
Seat 1: mycka86 ($100 in chips) 
Seat 2: xAndorx ($111.24 in chips) 
Seat 3: Sweden_Pound ($116.99 in chips) 
Seat 4: matiko09 ($276.42 in chips) 
Seat 5: sebaaastian ($101.50 in chips) 
Seat 6: Ty Nick 420 ($104.50 in chips) 
Seat 7: Aalleekks ($100.30 in chips) 
Seat 8: Monsthand ($134.97 in chips) 
Seat 9: Slushpup69 ($54.15 in chips) 
xAndorx: posts small blind $0.50
Sweden_Pound: posts big blind $1
*** HOLE CARDS ***
Dealt to matiko09 [Jh Kd]
matiko09: folds 
sebaaastian: folds 
Ty Nick 420: folds 
Aalleekks: folds 
Monsthand: folds 
Slushpup69: raises $2 to $3
mycka86: folds 
xAndorx: folds 
Sweden_Pound: folds 
Uncalled bet ($2) returned to Slushpup69
Slushpup69 collected $2.50 from pot
*** SUMMARY ***
Total pot $2.50 | Rake $0 
Seat 1: mycka86 (button) folded before Flop (didn't bet)
Seat 2: xAndorx (small blind) folded before Flop
Seat 3: Sweden_Pound (big blind) folded before Flop
Seat 4: matiko09 folded before Flop (didn't bet)
Seat 5: sebaaastian folded before Flop (didn't bet)
Seat 6: Ty Nick 420 folded before Flop (didn't bet)
Seat 7: Aalleekks folded before Flop (didn't bet)
Seat 8: Monsthand folded before Flop (didn't bet)
Seat 9: Slushpup69 collected ($2.50)





PokerStars Hand #149392038045:  Hold'em No Limit (€0.25/€0.50 EUR) - 2016/02/25 16:40:31 CET [2016/02/25 10:40:31 ET]
Table 'Leo Minor III' 9-max Seat #1 is the button
Seat 1: Al3xAnd3r22 (€53 in chips) 
Seat 2: vasiy379 (€50 in chips) 
Seat 3: Rorerzap (€62.75 in chips) 
Seat 4: RvPersie (€70.81 in chips) 
Seat 5: kasse_62 (€20.42 in chips) 
Seat 6: Wwwasian (€53.29 in chips) 
Seat 7: Apparat888 (€28.26 in chips) 
Seat 8: mi$$I$Elena (€84.90 in chips) 
Seat 9: matiko09 (€50.75 in chips) 
vasiy379: posts small blind €0.25
Rorerzap: posts big blind €0.50
*** HOLE CARDS ***
Dealt to matiko09 [4c 6d]
RvPersie: raises €0.75 to €1.25
kasse_62: folds 
Wwwasian: folds 
Apparat888: folds 
mi$$I$Elena: folds 
matiko09: folds 
Al3xAnd3r22: folds 
vasiy379: folds 
Rorerzap: folds 
Uncalled bet (€0.75) returned to RvPersie
RvPersie collected €1.25 from pot
RvPersie: doesn't show hand 
*** SUMMARY ***
Total pot €1.25 | Rake €0 
Seat 1: Al3xAnd3r22 (button) folded before Flop (didn't bet)
Seat 2: vasiy379 (small blind) folded before Flop
Seat 3: Rorerzap (big blind) folded before Flop
Seat 4: RvPersie collected (€1.25)
Seat 5: kasse_62 folded before Flop (didn't bet)
Seat 6: Wwwasian folded before Flop (didn't bet)
Seat 7: Apparat888 folded before Flop (didn't bet)
Seat 8: mi$$I$Elena folded before Flop (didn't bet)
Seat 9: matiko09 folded before Flop (didn't bet)





PokerStars Hand #149392040456:  Hold'em No Limit ($0.50/$1.00 USD) - 2016/02/25 16:40:34 CET [2016/02/25 10:40:34 ET]
Table 'Guisan' 9-max Seat #5 is the button
Seat 1: stockbridge8 ($63.47 in chips) 
Seat 2: mycka86 ($100 in chips) 
Seat 4: matiko09 ($173.75 in chips) 
Seat 5: Jeckpot1989 ($96.50 in chips) 
Seat 6: 19R&J91 ($372.90 in chips) 
Seat 7: sebaaastian ($116.59 in chips) 
Seat 8: Monsthand ($120.50 in chips) 
Seat 9: Sweden_Pound ($109.19 in chips) 
19R&J91: posts small blind $0.50
sebaaastian: posts big blind $1
xAndorx: sits out 
*** HOLE CARDS ***
Dealt to matiko09 [Kd 7d]
Monsthand: folds 
Sweden_Pound: folds 
stockbridge8: raises $2 to $3
mycka86: folds 
matiko09: folds 
Jeckpot1989: calls $3
19R&J91: calls $2.50
sebaaastian: folds 
*** FLOP *** [9h 2d 3s]
19R&J91: checks 
stockbridge8: bets $4.77
Jeckpot1989: calls $4.77
19R&J91: folds 
*** TURN *** [9h 2d 3s] [6s]
stockbridge8: bets $9.33
Jeckpot1989: folds 
Uncalled bet ($9.33) returned to stockbridge8
stockbridge8 collected $18.66 from pot
*** SUMMARY ***
Total pot $19.54 | Rake $0.88 
Board [9h 2d 3s 6s]
Seat 1: stockbridge8 collected ($18.66)
Seat 2: mycka86 folded before Flop (didn't bet)
Seat 4: matiko09 folded before Flop (didn't bet)
Seat 5: Jeckpot1989 (button) folded on the Turn
Seat 6: 19R&J91 (small blind) folded on the Flop
Seat 7: sebaaastian (big blind) folded before Flop
Seat 8: Monsthand folded before Flop (didn't bet)
Seat 9: Sweden_Pound folded before Flop (didn't bet)





PokerStars Hand #149392043454:  Hold'em No Limit ($0.25/$0.50 USD) - 2016/02/25 16:40:38 CET [2016/02/25 10:40:38 ET]
Table 'Lohja II' 9-max Seat #2 is the button
Seat 1: MoonJimmy ($146.53 in chips) 
Seat 2: Apparat888 ($32.17 in chips) 
Seat 3: guvalc1952 ($145.98 in chips) 
Seat 5: vasiy379 ($50 in chips) 
Seat 6: Player1705 ($126.25 in chips) 
Seat 7: matiko09 ($155.61 in chips) 
Seat 8: jamba83 ($58.05 in chips) 
Seat 9: Muinmyheart ($80.89 in chips) 
payback11 joins the table at seat #4 
guvalc1952: posts small blind $0.25
vasiy379: posts big blind $0.50
MoonJimmy: posts the ante $0.10
Apparat888: posts the ante $0.10
guvalc1952: posts the ante $0.10
vasiy379: posts the ante $0.10
Player1705: posts the ante $0.10
matiko09: posts the ante $0.10
jamba83: posts the ante $0.10
Muinmyheart: posts the ante $0.10
*** HOLE CARDS ***
Dealt to matiko09 [Ah 2h]
Player1705: folds 
matiko09: folds 
jamba83: folds 
Muinmyheart: raises $1 to $1.50
MoonJimmy: calls $1.50
Apparat888: folds 
guvalc1952: folds 
vasiy379: folds 
*** FLOP *** [Js 4c 3h]
Muinmyheart: bets $2.75
MoonJimmy: calls $2.75
*** TURN *** [Js 4c 3h] [6h]
Muinmyheart: checks 
MoonJimmy: bets $3.84
Muinmyheart: folds 
Uncalled bet ($3.84) returned to MoonJimmy
MoonJimmy collected $9.60 from pot
MoonJimmy: doesn't show hand 
*** SUMMARY ***
Total pot $10.05 | Rake $0.45 
Board [Js 4c 3h 6h]
Seat 1: MoonJimmy collected ($9.60)
Seat 2: Apparat888 (button) folded before Flop (didn't bet)
Seat 3: guvalc1952 (small blind) folded before Flop
Seat 5: vasiy379 (big blind) folded before Flop
Seat 6: Player1705 folded before Flop (didn't bet)
Seat 7: matiko09 folded before Flop (didn't bet)
Seat 8: jamba83 folded before Flop (didn't bet)
Seat 9: Muinmyheart folded on the Turn





PokerStars Hand #149392056305:  Hold'em No Limit ($0.50/$1.00 USD) - 2016/02/25 16:40:54 CET [2016/02/25 10:40:54 ET]
Table 'Simona' 9-max Seat #2 is the button
Seat 1: mycka86 ($100 in chips) 
Seat 2: xAndorx ($110.74 in chips) 
Seat 3: Sweden_Pound ($115.99 in chips) 
Seat 4: matiko09 ($276.42 in chips) 
Seat 5: sebaaastian ($101.50 in chips) 
Seat 6: Ty Nick 420 ($104.50 in chips) 
Seat 7: Aalleekks ($100.30 in chips) 
Seat 8: Monsthand ($134.97 in chips) 
Seat 9: Slushpup69 ($55.65 in chips) 
Sweden_Pound: posts small blind $0.50
matiko09: posts big blind $1
*** HOLE CARDS ***
Dealt to matiko09 [3d 9s]
sebaaastian: folds 
Ty Nick 420: folds 
Aalleekks: folds 
Monsthand: raises $1.70 to $2.70
Slushpup69: folds 
mycka86: folds 
xAndorx: folds 
Sweden_Pound: folds 
matiko09: folds 
Uncalled bet ($1.70) returned to Monsthand
Monsthand collected $2.50 from pot
*** SUMMARY ***
Total pot $2.50 | Rake $0 
Seat 1: mycka86 folded before Flop (didn't bet)
Seat 2: xAndorx (button) folded before Flop (didn't bet)
Seat 3: Sweden_Pound (small blind) folded before Flop
Seat 4: matiko09 (big blind) folded before Flop
Seat 5: sebaaastian folded before Flop (didn't bet)
Seat 6: Ty Nick 420 folded before Flop (didn't bet)
Seat 7: Aalleekks folded before Flop (didn't bet)
Seat 8: Monsthand collected ($2.50)
Seat 9: Slushpup69 folded before Flop (didn't bet)





PokerStars Hand #149392057121:  Hold'em No Limit ($0.50/$1.00 USD) - 2016/02/25 16:40:55 CET [2016/02/25 10:40:55 ET]
Table 'Hercules IV' 9-max Seat #2 is the button
Seat 1: matiko09 ($100 in chips) 
Seat 2: hammerwife ($100 in chips) 
Seat 3: sebaaastian ($202.20 in chips) 
Seat 4: Sweden_Pound ($100 in chips) 
Seat 5: xAndorx ($146.43 in chips) 
Seat 6: kuanhung0903 ($66.21 in chips) 
Seat 7: Ouga Buga ($100 in chips) 
Seat 8: brokat77 ($111.15 in chips) 
Seat 9: djammusic ($38.70 in chips) 
sebaaastian: posts small blind $0.50
Sweden_Pound: posts big blind $1
*** HOLE CARDS ***
Dealt to matiko09 [9c Ah]
xAndorx: folds 
kuanhung0903: folds 
Ouga Buga: folds 
brokat77: folds 
djammusic: folds 
matiko09: raises $1.50 to $2.50
hammerwife: raises $5 to $7.50
sebaaastian: folds 
Sweden_Pound: raises $11.50 to $19
matiko09: folds 
hammerwife: folds 
Uncalled bet ($11.50) returned to Sweden_Pound
Sweden_Pound collected $18 from pot
Sweden_Pound: doesn't show hand 
*** SUMMARY ***
Total pot $18 | Rake $0 
Seat 1: matiko09 folded before Flop
Seat 2: hammerwife (button) folded before Flop
Seat 3: sebaaastian (small blind) folded before Flop
Seat 4: Sweden_Pound (big blind) collected ($18)
Seat 5: xAndorx folded before Flop (didn't bet)
Seat 6: kuanhung0903 folded before Flop (didn't bet)
Seat 7: Ouga Buga folded before Flop (didn't bet)
Seat 8: brokat77 folded before Flop (didn't bet)
Seat 9: djammusic folded before Flop (didn't bet)





PokerStars Hand #149392059969:  Hold'em No Limit ($0.50/$1.00 USD) - 2016/02/25 16:40:59 CET [2016/02/25 10:40:59 ET]
Table 'Lina II' 9-max Seat #7 is the button
Seat 1: Lesley2002 ($167.04 in chips) 
Seat 2: matiko09 ($111.51 in chips) 
Seat 4: Nennenurse ($41.13 in chips) 
Seat 5: swizzly58 ($40.80 in chips) 
Seat 6: sebaaastian ($108.62 in chips) 
Seat 7: Monsthand ($146.74 in chips) 
Seat 8: djammusic ($43.14 in chips) 
Seat 9: Sweden_Pound ($269.27 in chips) 
djammusic: posts small blind $0.50
Sweden_Pound: posts big blind $1
Ouga Buga: sits out 
*** HOLE CARDS ***
Dealt to matiko09 [4h Kh]
Lesley2002: folds 
matiko09: folds 
Nennenurse: folds 
swizzly58: raises $2 to $3
sebaaastian: folds 
Monsthand: folds 
djammusic: folds 
Sweden_Pound: folds 
Uncalled bet ($2) returned to swizzly58
swizzly58 collected $2.50 from pot
swizzly58: doesn't show hand 
*** SUMMARY ***
Total pot $2.50 | Rake $0 
Seat 1: Lesley2002 folded before Flop (didn't bet)
Seat 2: matiko09 folded before Flop (didn't bet)
Seat 4: Nennenurse folded before Flop (didn't bet)
Seat 5: swizzly58 collected ($2.50)
Seat 6: sebaaastian folded before Flop (didn't bet)
Seat 7: Monsthand (button) folded before Flop (didn't bet)
Seat 8: djammusic (small blind) folded before Flop
Seat 9: Sweden_Pound (big blind) folded before Flop





PokerStars Hand #149392060126:  Hold'em No Limit ($0.25/$0.50 USD) - 2016/02/25 16:40:59 CET [2016/02/25 10:40:59 ET]
Table 'Thalpius III' 9-max Seat #2 is the button
Seat 1: BrotherLove9 ($52.85 in chips) 
Seat 2: matiko09 ($58.04 in chips) 
Seat 3: jamba83 ($52.56 in chips) 
Seat 4: Wwwasian ($51.51 in chips) 
Seat 5: Rorerzap ($57.02 in chips) 
Seat 7: v4n0v ($50 in chips) 
Seat 8: jeroemie123 ($30.05 in chips) 
Seat 9: Gemb1rdd ($71.18 in chips) 
jamba83: posts small blind $0.25
Wwwasian: posts big blind $0.50
*** HOLE CARDS ***
Dealt to matiko09 [9s 2d]
Rorerzap: folds 
v4n0v: raises $1 to $1.50
jeroemie123: folds 
Gemb1rdd: folds 
BrotherLove9: folds 
matiko09: folds 
jamba83: folds 
Wwwasian: folds 
Uncalled bet ($1) returned to v4n0v
v4n0v collected $1.25 from pot
v4n0v: doesn't show hand 
*** SUMMARY ***
Total pot $1.25 | Rake $0 
Seat 1: BrotherLove9 folded before Flop (didn't bet)
Seat 2: matiko09 (button) folded before Flop (didn't bet)
Seat 3: jamba83 (small blind) folded before Flop
Seat 4: Wwwasian (big blind) folded before Flop
Seat 5: Rorerzap folded before Flop (didn't bet)
Seat 7: v4n0v collected ($1.25)
Seat 8: jeroemie123 folded before Flop (didn't bet)
Seat 9: Gemb1rdd folded before Flop (didn't bet)





PokerStars Hand #149392061323:  Hold'em No Limit ($0.50/$1.00 USD) - 2016/02/25 16:41:01 CET [2016/02/25 10:41:01 ET]
Table 'Isa' 9-max Seat #2 is the button
Seat 1: matiko09 ($128.94 in chips) 
Seat 2: Monsthand ($100 in chips) 
Seat 3: sebaaastian ($114.40 in chips) 
Seat 4: hammerwife ($100 in chips) 
Seat 5: Sweden_Pound ($106.55 in chips) 
Seat 6: xAndorx ($97 in chips) 
Seat 7: bilukm ($143.51 in chips) 
Seat 9: TideHan ($100 in chips) 
sebaaastian: posts small blind $0.50
hammerwife: posts big blind $1
*** HOLE CARDS ***
Dealt to matiko09 [4h Th]
Sweden_Pound: folds 
xAndorx: folds 
bilukm: raises $1 to $2
TideHan: folds 
matiko09: folds 
Monsthand: folds 
sebaaastian: folds 
hammerwife: folds 
Uncalled bet ($1) returned to bilukm
bilukm collected $2.50 from pot
bilukm: doesn't show hand 
*** SUMMARY ***
Total pot $2.50 | Rake $0 
Seat 1: matiko09 folded before Flop (didn't bet)
Seat 2: Monsthand (button) folded before Flop (didn't bet)
Seat 3: sebaaastian (small blind) folded before Flop
Seat 4: hammerwife (big blind) folded before Flop
Seat 5: Sweden_Pound folded before Flop (didn't bet)
Seat 6: xAndorx folded before Flop (didn't bet)
Seat 7: bilukm collected ($2.50)
Seat 9: TideHan folded before Flop (didn't bet)





PokerStars Hand #149392070062:  Hold'em No Limit (€0.25/€0.50 EUR) - 2016/02/25 16:41:12 CET [2016/02/25 10:41:12 ET]
Table 'Leo Minor III' 9-max Seat #2 is the button
Seat 1: Al3xAnd3r22 (€53 in chips) 
Seat 2: vasiy379 (€50 in chips) 
Seat 3: Rorerzap (€62.25 in chips) 
Seat 4: RvPersie (€71.56 in chips) 
Seat 5: kasse_62 (€20.42 in chips) 
Seat 6: Wwwasian (€53.29 in chips) 
Seat 7: Apparat888 (€28.26 in chips) 
Seat 8: mi$$I$Elena (€84.90 in chips) 
Seat 9: matiko09 (€50.75 in chips) 
Rorerzap: posts small blind €0.25
RvPersie: posts big blind €0.50
*** HOLE CARDS ***
Dealt to matiko09 [Ah Jh]
kasse_62: folds 
Wwwasian: folds 
Apparat888: raises €1 to €1.50
mi$$I$Elena: folds 
matiko09: calls €1.50
Al3xAnd3r22: raises €4.50 to €6
vasiy379: folds 
Rorerzap: folds 
RvPersie: folds 
Apparat888: raises €22.26 to €28.26 and is all-in
matiko09: folds 
Al3xAnd3r22: calls €22.26
*** FLOP *** [3h As 7s]
*** TURN *** [3h As 7s] [9d]
*** RIVER *** [3h As 7s 9d] [6s]
*** SHOW DOWN ***
Apparat888: shows [Js Jc] (a pair of Jacks)
Al3xAnd3r22: shows [Qd Qc] (a pair of Queens)
Al3xAnd3r22 collected €56.77 from pot
*** SUMMARY ***
Total pot €58.77 | Rake €2 
Board [3h As 7s 9d 6s]
Seat 1: Al3xAnd3r22 showed [Qd Qc] and won (€56.77) with a pair of Queens
Seat 2: vasiy379 (button) folded before Flop (didn't bet)
Seat 3: Rorerzap (small blind) folded before Flop
Seat 4: RvPersie (big blind) folded before Flop
Seat 5: kasse_62 folded before Flop (didn't bet)
Seat 6: Wwwasian folded before Flop (didn't bet)
Seat 7: Apparat888 showed [Js Jc] and lost with a pair of Jacks
Seat 8: mi$$I$Elena folded before Flop (didn't bet)
Seat 9: matiko09 folded before Flop





PokerStars Hand #149392071277:  Hold'em No Limit ($0.50/$1.00 USD) - 2016/02/25 16:41:14 CET [2016/02/25 10:41:14 ET]
Table 'Zeuxo II' 9-max Seat #8 is the button
Seat 1: forsmthgood ($100 in chips) 
Seat 2: Sweden_Pound ($104.25 in chips) 
Seat 3: xAndorx ($96.50 in chips) 
Seat 4: sebaaastian ($122.11 in chips) 
Seat 5: bauss84 ($28.14 in chips) 
Seat 6: Cogss ($98.21 in chips) 
Seat 7: djammusic ($38.50 in chips) 
Seat 8: matiko09 ($100 in chips) 
Seat 9: Sreshta222 ($225.60 in chips) 
Sreshta222: posts small blind $0.50
forsmthgood: posts big blind $1
*** HOLE CARDS ***
Dealt to matiko09 [6s 3s]
Sweden_Pound: folds 
xAndorx: folds 
sebaaastian: folds 
bauss84: folds 
Cogss: folds 
djammusic: raises $1.02 to $2.02
matiko09: folds 
Sreshta222: raises $3.98 to $6
forsmthgood: folds 
djammusic: raises $5 to $11
Sreshta222: folds 
Uncalled bet ($5) returned to djammusic
djammusic collected $13 from pot
djammusic: doesn't show hand 
*** SUMMARY ***
Total pot $13 | Rake $0 
Seat 1: forsmthgood (big blind) folded before Flop
Seat 2: Sweden_Pound folded before Flop (didn't bet)
Seat 3: xAndorx folded before Flop (didn't bet)
Seat 4: sebaaastian folded before Flop (didn't bet)
Seat 5: bauss84 folded before Flop (didn't bet)
Seat 6: Cogss folded before Flop (didn't bet)
Seat 7: djammusic collected ($13)
Seat 8: matiko09 (button) folded before Flop (didn't bet)
Seat 9: Sreshta222 (small blind) folded before Flop





PokerStars Hand #149392079135:  Hold'em No Limit ($0.50/$1.00 USD) - 2016/02/25 16:41:24 CET [2016/02/25 10:41:24 ET]
Table 'Lina II' 9-max Seat #8 is the button
Seat 1: Lesley2002 ($167.04 in chips) 
Seat 2: matiko09 ($111.51 in chips) 
Seat 4: Nennenurse ($41.13 in chips) 
Seat 5: swizzly58 ($42.30 in chips) 
Seat 6: sebaaastian ($108.62 in chips) 
Seat 7: Monsthand ($146.74 in chips) 
Seat 8: djammusic ($42.64 in chips) 
Seat 9: Sweden_Pound ($268.27 in chips) 
Sweden_Pound: posts small blind $0.50
Lesley2002: posts big blind $1
Ouga Buga: sits out 
*** HOLE CARDS ***
Dealt to matiko09 [8s 9h]
matiko09: folds 
Nennenurse: folds 
swizzly58: folds 
sebaaastian: folds 
Monsthand: folds 
djammusic: folds 
Sweden_Pound: raises $2 to $3
Lesley2002: folds 
Uncalled bet ($2) returned to Sweden_Pound
Sweden_Pound collected $2 from pot
Sweden_Pound: doesn't show hand 
*** SUMMARY ***
Total pot $2 | Rake $0 
Seat 1: Lesley2002 (big blind) folded before Flop
Seat 2: matiko09 folded before Flop (didn't bet)
Seat 4: Nennenurse folded before Flop (didn't bet)
Seat 5: swizzly58 folded before Flop (didn't bet)
Seat 6: sebaaastian folded before Flop (didn't bet)
Seat 7: Monsthand folded before Flop (didn't bet)
Seat 8: djammusic (button) folded before Flop (didn't bet)
Seat 9: Sweden_Pound (small blind) collected ($2)





PokerStars Hand #149392080622:  Hold'em No Limit ($0.50/$1.00 USD) - 2016/02/25 16:41:26 CET [2016/02/25 10:41:26 ET]
Table 'Simona' 9-max Seat #3 is the button
Seat 1: mycka86 ($100 in chips) 
Seat 2: xAndorx ($110.74 in chips) 
Seat 3: Sweden_Pound ($115.49 in chips) 
Seat 4: matiko09 ($275.42 in chips) 
Seat 5: sebaaastian ($101.50 in chips) 
Seat 6: Ty Nick 420 ($104.50 in chips) 
Seat 7: Aalleekks ($100.30 in chips) 
Seat 8: Monsthand ($136.47 in chips) 
matiko09: posts small blind $0.50
sebaaastian: posts big blind $1
*** HOLE CARDS ***
Dealt to matiko09 [Kc 5d]
Ty Nick 420: folds 
Aalleekks: raises $2 to $3
Monsthand: folds 
mycka86: raises $6 to $9
xAndorx: folds 
Sweden_Pound: folds 
matiko09: folds 
sebaaastian: folds 
Aalleekks: calls $6
*** FLOP *** [3h 7c 3s]
Aalleekks: checks 
mycka86: bets $10.24
Aalleekks: calls $10.24
*** TURN *** [3h 7c 3s] [7h]
Aalleekks: checks 
mycka86: bets $20
Aalleekks: calls $20
*** RIVER *** [3h 7c 3s 7h] [Ac]
Aalleekks: checks 
mycka86: bets $60.76 and is all-in
Aalleekks: folds 
Uncalled bet ($60.76) returned to mycka86
mycka86 collected $77.18 from pot
*** SUMMARY ***
Total pot $79.98 | Rake $2.80 
Board [3h 7c 3s 7h Ac]
Seat 1: mycka86 collected ($77.18)
Seat 2: xAndorx folded before Flop (didn't bet)
Seat 3: Sweden_Pound (button) folded before Flop (didn't bet)
Seat 4: matiko09 (small blind) folded before Flop
Seat 5: sebaaastian (big blind) folded before Flop
Seat 6: Ty Nick 420 folded before Flop (didn't bet)
Seat 7: Aalleekks folded on the River
Seat 8: Monsthand folded before Flop (didn't bet)





PokerStars Hand #149392081709:  Hold'em No Limit ($0.25/$0.50 USD) - 2016/02/25 16:41:28 CET [2016/02/25 10:41:28 ET]
Table 'Thalpius III' 9-max Seat #3 is the button
Seat 1: BrotherLove9 ($52.85 in chips) 
Seat 2: matiko09 ($58.04 in chips) 
Seat 3: jamba83 ($52.31 in chips) 
Seat 4: Wwwasian ($51.01 in chips) 
Seat 5: Rorerzap ($57.02 in chips) 
Seat 7: v4n0v ($50.75 in chips) 
Seat 8: jeroemie123 ($30.05 in chips) 
Seat 9: Gemb1rdd ($71.18 in chips) 
Wwwasian: posts small blind $0.25
Rorerzap: posts big blind $0.50
*** HOLE CARDS ***
Dealt to matiko09 [Ts 6h]
rdrill leaves the table
v4n0v: folds 
jeroemie123: folds 
Gemb1rdd: folds 
BrotherLove9: folds 
matiko09: folds 
jamba83: folds 
ihami joins the table at seat #6 
Wwwasian: folds 
Uncalled bet ($0.25) returned to Rorerzap
Rorerzap collected $0.50 from pot
Rorerzap: doesn't show hand 
*** SUMMARY ***
Total pot $0.50 | Rake $0 
Seat 1: BrotherLove9 folded before Flop (didn't bet)
Seat 2: matiko09 folded before Flop (didn't bet)
Seat 3: jamba83 (button) folded before Flop (didn't bet)
Seat 4: Wwwasian (small blind) folded before Flop
Seat 5: Rorerzap (big blind) collected ($0.50)
Seat 7: v4n0v folded before Flop (didn't bet)
Seat 8: jeroemie123 folded before Flop (didn't bet)
Seat 9: Gemb1rdd folded before Flop (didn't bet)





PokerStars Hand #149392083015:  Hold'em No Limit ($0.50/$1.00 USD) - 2016/02/25 16:41:29 CET [2016/02/25 10:41:29 ET]
Table 'Morosovia II' 9-max Seat #1 is the button
Seat 1: apfush ($194.96 in chips) 
Seat 2: lysandrafly ($100.50 in chips) 
Seat 3: sebaaastian ($136.87 in chips) 
Seat 4: matiko09 ($170.35 in chips) 
Seat 5: pimpoza ($69.05 in chips) 
Seat 6: Sweden_Pound ($138.61 in chips) 
Seat 7: Ty Nick 420 ($169.69 in chips) 
Seat 8: Monsthand ($100.50 in chips) 
Seat 9: Ouga Buga ($122.54 in chips) 
lysandrafly: posts small blind $0.50
sebaaastian: posts big blind $1
*** HOLE CARDS ***
Dealt to matiko09 [Kc 8d]
matiko09: folds 
pimpoza: folds 
Sweden_Pound: folds 
Ty Nick 420: folds 
Monsthand: folds 
Ouga Buga: folds 
apfush: folds 
lysandrafly: folds 
Uncalled bet ($0.50) returned to sebaaastian
sebaaastian collected $1 from pot
sebaaastian: doesn't show hand 
*** SUMMARY ***
Total pot $1 | Rake $0 
Seat 1: apfush (button) folded before Flop (didn't bet)
Seat 2: lysandrafly (small blind) folded before Flop
Seat 3: sebaaastian (big blind) collected ($1)
Seat 4: matiko09 folded before Flop (didn't bet)
Seat 5: pimpoza folded before Flop (didn't bet)
Seat 6: Sweden_Pound folded before Flop (didn't bet)
Seat 7: Ty Nick 420 folded before Flop (didn't bet)
Seat 8: Monsthand folded before Flop (didn't bet)
Seat 9: Ouga Buga folded before Flop (didn't bet)





PokerStars Hand #149392083907:  Hold'em No Limit ($0.50/$1.00 USD) - 2016/02/25 16:41:30 CET [2016/02/25 10:41:30 ET]
Table 'Lucia III' 9-max Seat #6 is the button
Seat 1: Monsthand ($121.25 in chips) 
Seat 2: kuanhung0903 ($79 in chips) 
Seat 3: mycka86 ($122.07 in chips) 
Seat 4: swatek1986 ($133.09 in chips) 
Seat 5: Sweden_Pound ($222.93 in chips) 
Seat 6: matiko09 ($100 in chips) 
Seat 7: Ty Nick 420 ($174.52 in chips) 
Seat 8: apfush ($109.60 in chips) 
Seat 9: Apparat888 ($34.45 in chips) 
Ty Nick 420: posts small blind $0.50
apfush: posts big blind $1
*** HOLE CARDS ***
Dealt to matiko09 [4c Js]
Apparat888: folds 
Monsthand: folds 
kuanhung0903: calls $1
mycka86: folds 
swatek1986: raises $2 to $3
Sweden_Pound: folds 
matiko09: folds 
Ty Nick 420: raises $6 to $9
apfush: folds 
kuanhung0903: folds 
swatek1986: calls $6
*** FLOP *** [Kh 3c 2s]
Ty Nick 420: bets $12
swatek1986: raises $21.55 to $33.55
Ty Nick 420: calls $21.55
*** TURN *** [Kh 3c 2s] [4d]
Ty Nick 420: checks 
swatek1986: bets $45
Ty Nick 420: raises $46 to $91
swatek1986: calls $45.54 and is all-in
Uncalled bet ($0.46) returned to Ty Nick 420
*** RIVER *** [Kh 3c 2s 4d] [9h]
*** SHOW DOWN ***
Ty Nick 420: shows [Ah As] (a pair of Aces)
swatek1986: shows [6d 6c] (a pair of Sixes)
Ty Nick 420 collected $265.38 from pot
*** SUMMARY ***
Total pot $268.18 | Rake $2.80 
Board [Kh 3c 2s 4d 9h]
Seat 1: Monsthand folded before Flop (didn't bet)
Seat 2: kuanhung0903 folded before Flop
Seat 3: mycka86 folded before Flop (didn't bet)
Seat 4: swatek1986 showed [6d 6c] and lost with a pair of Sixes
Seat 5: Sweden_Pound folded before Flop (didn't bet)
Seat 6: matiko09 (button) folded before Flop (didn't bet)
Seat 7: Ty Nick 420 (small blind) showed [Ah As] and won ($265.38) with a pair of Aces
Seat 8: apfush (big blind) folded before Flop
Seat 9: Apparat888 folded before Flop (didn't bet)





PokerStars Hand #149392085309:  Hold'em No Limit ($0.50/$1.00 USD) - 2016/02/25 16:41:32 CET [2016/02/25 10:41:32 ET]
Table 'Guisan' 9-max Seat #6 is the button
Seat 1: stockbridge8 ($74.36 in chips) 
Seat 2: mycka86 ($100 in chips) 
Seat 4: matiko09 ($173.75 in chips) 
Seat 5: Jeckpot1989 ($88.73 in chips) 
Seat 6: 19R&J91 ($369.90 in chips) 
Seat 7: sebaaastian ($115.59 in chips) 
Seat 8: Monsthand ($120.50 in chips) 
Seat 9: Sweden_Pound ($109.19 in chips) 
sebaaastian: posts small blind $0.50
Monsthand: posts big blind $1
xAndorx: sits out 
*** HOLE CARDS ***
Dealt to matiko09 [2s Ad]
Sweden_Pound: folds 
stockbridge8: folds 
mycka86: folds 
matiko09: folds 
Jeckpot1989: folds 
19R&J91: raises $3 to $4
sebaaastian: folds 
Monsthand: calls $3
*** FLOP *** [Kh Qd 9s]
Monsthand: checks 
19R&J91: checks 
*** TURN *** [Kh Qd 9s] [2d]
Monsthand: bets $5.27
19R&J91: raises $7.27 to $12.54
Monsthand: folds 
Uncalled bet ($7.27) returned to 19R&J91
19R&J91 collected $18.18 from pot
*** SUMMARY ***
Total pot $19.04 | Rake $0.86 
Board [Kh Qd 9s 2d]
Seat 1: stockbridge8 folded before Flop (didn't bet)
Seat 2: mycka86 folded before Flop (didn't bet)
Seat 4: matiko09 folded before Flop (didn't bet)
Seat 5: Jeckpot1989 folded before Flop (didn't bet)
Seat 6: 19R&J91 (button) collected ($18.18)
Seat 7: sebaaastian (small blind) folded before Flop
Seat 8: Monsthand (big blind) folded on the Turn
Seat 9: Sweden_Pound folded before Flop (didn't bet)





PokerStars Hand #149392089645:  Hold'em No Limit ($0.50/$1.00 USD) - 2016/02/25 16:41:38 CET [2016/02/25 10:41:38 ET]
Table 'Isa' 9-max Seat #3 is the button
Seat 1: matiko09 ($128.94 in chips) 
Seat 2: Monsthand ($100 in chips) 
Seat 3: sebaaastian ($113.90 in chips) 
Seat 4: hammerwife ($100 in chips) 
Seat 5: Sweden_Pound ($106.55 in chips) 
Seat 6: xAndorx ($97 in chips) 
Seat 7: bilukm ($145.01 in chips) 
Seat 9: TideHan ($100 in chips) 
hammerwife: posts small blind $0.50
Sweden_Pound: posts big blind $1
*** HOLE CARDS ***
Dealt to matiko09 [7s Qc]
xAndorx: folds 
bilukm: raises $1 to $2
TideHan: folds 
matiko09: folds 
Monsthand: folds 
sebaaastian: folds 
hammerwife: folds 
Sweden_Pound: folds 
Uncalled bet ($1) returned to bilukm
bilukm collected $2.50 from pot
bilukm: doesn't show hand 
*** SUMMARY ***
Total pot $2.50 | Rake $0 
Seat 1: matiko09 folded before Flop (didn't bet)
Seat 2: Monsthand folded before Flop (didn't bet)
Seat 3: sebaaastian (button) folded before Flop (didn't bet)
Seat 4: hammerwife (small blind) folded before Flop
Seat 5: Sweden_Pound (big blind) folded before Flop
Seat 6: xAndorx folded before Flop (didn't bet)
Seat 7: bilukm collected ($2.50)
Seat 9: TideHan folded before Flop (didn't bet)





PokerStars Hand #149392094599:  Hold'em No Limit ($0.50/$1.00 USD) - 2016/02/25 16:41:44 CET [2016/02/25 10:41:44 ET]
Table 'Hercules IV' 9-max Seat #3 is the button
Seat 1: matiko09 ($100 in chips) 
Seat 2: hammerwife ($100 in chips) 
Seat 3: sebaaastian ($201.70 in chips) 
Seat 4: Sweden_Pound ($110.50 in chips) 
Seat 5: xAndorx ($146.43 in chips) 
Seat 6: kuanhung0903 ($66.21 in chips) 
Seat 7: Ouga Buga ($100 in chips) 
Seat 8: brokat77 ($111.15 in chips) 
Seat 9: djammusic ($38.70 in chips) 
Sweden_Pound: posts small blind $0.50
xAndorx: posts big blind $1
*** HOLE CARDS ***
Dealt to matiko09 [2c Ad]
kuanhung0903: calls $1
Ouga Buga: folds 
brokat77: folds 
djammusic: folds 
matiko09: folds 
hammerwife: folds 
sebaaastian: folds 
Sweden_Pound: folds 
xAndorx: checks 
*** FLOP *** [3d 5d 8d]
xAndorx: checks 
kuanhung0903: checks 
*** TURN *** [3d 5d 8d] [Jd]
xAndorx: checks 
kuanhung0903: checks 
*** RIVER *** [3d 5d 8d Jd] [3s]
xAndorx: checks 
kuanhung0903: checks 
*** SHOW DOWN ***
xAndorx: shows [Qs Ts] (a pair of Threes)
kuanhung0903: shows [Ks Jh] (two pair, Jacks and Threes)
kuanhung0903 collected $2.39 from pot
*** SUMMARY ***
Total pot $2.50 | Rake $0.11 
Board [3d 5d 8d Jd 3s]
Seat 1: matiko09 folded before Flop (didn't bet)
Seat 2: hammerwife folded before Flop (didn't bet)
Seat 3: sebaaastian (button) folded before Flop (didn't bet)
Seat 4: Sweden_Pound (small blind) folded before Flop
Seat 5: xAndorx (big blind) showed [Qs Ts] and lost with a pair of Threes
Seat 6: kuanhung0903 showed [Ks Jh] and won ($2.39) with two pair, Jacks and Threes
Seat 7: Ouga Buga folded before Flop (didn't bet)
Seat 8: brokat77 folded before Flop (didn't bet)
Seat 9: djammusic folded before Flop (didn't bet)





PokerStars Hand #149392103442:  Hold'em No Limit ($0.50/$1.00 USD) - 2016/02/25 16:41:56 CET [2016/02/25 10:41:56 ET]
Table 'Morosovia II' 9-max Seat #2 is the button
Seat 1: apfush ($194.96 in chips) 
Seat 2: lysandrafly ($100 in chips) 
Seat 3: sebaaastian ($137.37 in chips) 
Seat 4: matiko09 ($170.35 in chips) 
Seat 5: pimpoza ($69.05 in chips) 
Seat 6: Sweden_Pound ($138.61 in chips) 
Seat 7: Ty Nick 420 ($169.69 in chips) 
Seat 8: Monsthand ($100.50 in chips) 
Seat 9: Ouga Buga ($122.54 in chips) 
sebaaastian: posts small blind $0.50
matiko09: posts big blind $1
*** HOLE CARDS ***
Dealt to matiko09 [Ah 4h]
pimpoza: folds 
Sweden_Pound: folds 
Ty Nick 420: folds 
Monsthand: folds 
Ouga Buga: folds 
apfush: folds 
lysandrafly: folds 
sebaaastian: raises $1.50 to $2.50
matiko09: calls $1.50
*** FLOP *** [Qd 6h 7s]
sebaaastian: checks 
matiko09: checks 
*** TURN *** [Qd 6h 7s] [9d]
sebaaastian: checks 
matiko09: checks 
*** RIVER *** [Qd 6h 7s 9d] [4d]
sebaaastian: bets $3
matiko09: folds 
Uncalled bet ($3) returned to sebaaastian
sebaaastian collected $4.78 from pot
sebaaastian: doesn't show hand 
*** SUMMARY ***
Total pot $5 | Rake $0.22 
Board [Qd 6h 7s 9d 4d]
Seat 1: apfush folded before Flop (didn't bet)
Seat 2: lysandrafly (button) folded before Flop (didn't bet)
Seat 3: sebaaastian (small blind) collected ($4.78)
Seat 4: matiko09 (big blind) folded on the River
Seat 5: pimpoza folded before Flop (didn't bet)
Seat 6: Sweden_Pound folded before Flop (didn't bet)
Seat 7: Ty Nick 420 folded before Flop (didn't bet)
Seat 8: Monsthand folded before Flop (didn't bet)
Seat 9: Ouga Buga folded before Flop (didn't bet)





PokerStars Hand #149392104148:  Hold'em No Limit ($0.25/$0.50 USD) - 2016/02/25 16:41:57 CET [2016/02/25 10:41:57 ET]
Table 'Thalpius III' 9-max Seat #4 is the button
Seat 1: BrotherLove9 ($52.85 in chips) 
Seat 2: matiko09 ($58.04 in chips) 
Seat 3: jamba83 ($52.31 in chips) 
Seat 4: Wwwasian ($50.76 in chips) 
Seat 5: Rorerzap ($57.27 in chips) 
Seat 6: ihami ($50 in chips) 
Seat 7: v4n0v ($50.75 in chips) 
Seat 8: jeroemie123 ($30.05 in chips) 
Seat 9: Gemb1rdd ($71.18 in chips) 
Rorerzap: posts small blind $0.25
ihami: posts big blind $0.50
*** HOLE CARDS ***
Dealt to matiko09 [4s 4c]
v4n0v: folds 
jeroemie123: folds 
Gemb1rdd: folds 
BrotherLove9: folds 
matiko09: raises $1 to $1.50
jamba83: folds 
Wwwasian: folds 
Rorerzap: folds 
ihami: raises $3 to $4.50
matiko09: folds 
Uncalled bet ($3) returned to ihami
ihami collected $3.25 from pot
*** SUMMARY ***
Total pot $3.25 | Rake $0 
Seat 1: BrotherLove9 folded before Flop (didn't bet)
Seat 2: matiko09 folded before Flop
Seat 3: jamba83 folded before Flop (didn't bet)
Seat 4: Wwwasian (button) folded before Flop (didn't bet)
Seat 5: Rorerzap (small blind) folded before Flop
Seat 6: ihami (big blind) collected ($3.25)
Seat 7: v4n0v folded before Flop (didn't bet)
Seat 8: jeroemie123 folded before Flop (didn't bet)
Seat 9: Gemb1rdd folded before Flop (didn't bet)





PokerStars Hand #149392105535:  Hold'em No Limit ($0.50/$1.00 USD) - 2016/02/25 16:41:59 CET [2016/02/25 10:41:59 ET]
Table 'Lina II' 9-max Seat #9 is the button
Seat 1: Lesley2002 ($166.04 in chips) 
Seat 2: matiko09 ($111.51 in chips) 
Seat 4: Nennenurse ($41.13 in chips) 
Seat 5: swizzly58 ($42.30 in chips) 
Seat 6: sebaaastian ($108.62 in chips) 
Seat 7: Monsthand ($146.74 in chips) 
Seat 8: djammusic ($42.64 in chips) 
Seat 9: Sweden_Pound ($269.27 in chips) 
Lesley2002: posts small blind $0.50
matiko09: posts big blind $1
Ouga Buga: sits out 
*** HOLE CARDS ***
Dealt to matiko09 [8d 2c]
Nennenurse: folds 
swizzly58: calls $1
sebaaastian: raises $3 to $4
Monsthand: folds 
djammusic: folds 
Sweden_Pound: folds 
Lesley2002: folds 
matiko09: folds 
swizzly58: calls $3
*** FLOP *** [4s 9d Tc]
swizzly58: bets $10
sebaaastian: raises $94.62 to $104.62 and is all-in
swizzly58: calls $28.30 and is all-in
Uncalled bet ($66.32) returned to sebaaastian
*** TURN *** [4s 9d Tc] [2d]
*** RIVER *** [4s 9d Tc 2d] [8s]
*** SHOW DOWN ***
swizzly58: shows [Th Kd] (a pair of Tens)
sebaaastian: shows [Qc Jc] (a straight, Eight to Queen)
sebaaastian collected $83.30 from pot
*** SUMMARY ***
Total pot $86.10 | Rake $2.80 
Board [4s 9d Tc 2d 8s]
Seat 1: Lesley2002 (small blind) folded before Flop
Seat 2: matiko09 (big blind) folded before Flop
Seat 4: Nennenurse folded before Flop (didn't bet)
Seat 5: swizzly58 showed [Th Kd] and lost with a pair of Tens
Seat 6: sebaaastian showed [Qc Jc] and won ($83.30) with a straight, Eight to Queen
Seat 7: Monsthand folded before Flop (didn't bet)
Seat 8: djammusic folded before Flop (didn't bet)
Seat 9: Sweden_Pound (button) folded before Flop (didn't bet)





PokerStars Hand #149392114671:  Hold'em No Limit ($0.50/$1.00 USD) - 2016/02/25 16:42:10 CET [2016/02/25 10:42:10 ET]
Table 'Isa' 9-max Seat #4 is the button
Seat 1: matiko09 ($128.94 in chips) 
Seat 2: Monsthand ($100 in chips) 
Seat 3: sebaaastian ($113.90 in chips) 
Seat 4: hammerwife ($100 in chips) 
Seat 5: Sweden_Pound ($105.55 in chips) 
Seat 6: xAndorx ($100 in chips) 
Seat 7: bilukm ($146.51 in chips) 
Seat 9: TideHan ($100 in chips) 
Sweden_Pound: posts small blind $0.50
xAndorx: posts big blind $1
*** HOLE CARDS ***
Dealt to matiko09 [5s 7s]
bilukm: calls $1
TideHan: folds 
matiko09: folds 
Monsthand: raises $3 to $4
sebaaastian: calls $4
hammerwife: raises $12 to $16
Sweden_Pound: folds 
xAndorx: folds 
bilukm: folds 
Monsthand: folds 
sebaaastian: folds 
Uncalled bet ($12) returned to hammerwife
hammerwife collected $14.50 from pot
hammerwife: doesn't show hand 
*** SUMMARY ***
Total pot $14.50 | Rake $0 
Seat 1: matiko09 folded before Flop (didn't bet)
Seat 2: Monsthand folded before Flop
Seat 3: sebaaastian folded before Flop
Seat 4: hammerwife (button) collected ($14.50)
Seat 5: Sweden_Pound (small blind) folded before Flop
Seat 6: xAndorx (big blind) folded before Flop
Seat 7: bilukm folded before Flop
Seat 9: TideHan folded before Flop (didn't bet)





PokerStars Hand #149392116304:  Hold'em No Limit ($0.25/$0.50 USD) - 2016/02/25 16:42:12 CET [2016/02/25 10:42:12 ET]
Table 'Lohja II' 9-max Seat #3 is the button
Seat 1: MoonJimmy ($151.78 in chips) 
Seat 2: Apparat888 ($32.07 in chips) 
Seat 3: guvalc1952 ($145.63 in chips) 
Seat 5: vasiy379 ($50 in chips) 
Seat 7: matiko09 ($155.51 in chips) 
Seat 8: jamba83 ($57.95 in chips) 
Seat 9: Muinmyheart ($76.54 in chips) 
payback11 will be allowed to play after the button
vasiy379: posts small blind $0.25
Player1705: is sitting out 
matiko09: posts big blind $0.50
MoonJimmy: posts the ante $0.10
Apparat888: posts the ante $0.10
guvalc1952: posts the ante $0.10
vasiy379: posts the ante $0.10
matiko09: posts the ante $0.10
jamba83: posts the ante $0.10
Muinmyheart: posts the ante $0.10
*** HOLE CARDS ***
Dealt to matiko09 [2d Qc]
Player1705 leaves the table
jamba83: folds 
Muinmyheart: folds 
MoonJimmy: folds 
Apparat888: folds 
guvalc1952: calls $0.50
JustR82 joins the table at seat #6 
vasiy379: folds 
matiko09: checks 
*** FLOP *** [Jc 6c 4h]
matiko09: checks 
guvalc1952: bets $0.93
matiko09: folds 
Uncalled bet ($0.93) returned to guvalc1952
guvalc1952 collected $1.86 from pot
guvalc1952: doesn't show hand 
*** SUMMARY ***
Total pot $1.95 | Rake $0.09 
Board [Jc 6c 4h]
Seat 1: MoonJimmy folded before Flop (didn't bet)
Seat 2: Apparat888 folded before Flop (didn't bet)
Seat 3: guvalc1952 (button) collected ($1.86)
Seat 5: vasiy379 (small blind) folded before Flop
Seat 7: matiko09 (big blind) folded on the Flop
Seat 8: jamba83 folded before Flop (didn't bet)
Seat 9: Muinmyheart folded before Flop (didn't bet)





PokerStars Hand #149392120854:  Hold'em No Limit ($0.50/$1.00 USD) - 2016/02/25 16:42:18 CET [2016/02/25 10:42:18 ET]
Table 'Badenia II' 9-max Seat #8 is the button
Seat 1: matiko09 ($103 in chips) 
Seat 2: Stibitzkie ($111.42 in chips) 
Seat 3: sebaaastian ($101.50 in chips) 
Seat 4: KarlMoik1 ($368.97 in chips) 
Seat 5: djammusic ($123.59 in chips) 
Seat 6: xAndorx ($100 in chips) 
Seat 7: forsmthgood ($100 in chips) 
Seat 8: Sweden_Pound ($134.03 in chips) 
Seat 9: waisanen ($108.81 in chips) 
waisanen: posts small blind $0.50
matiko09: posts big blind $1
*** HOLE CARDS ***
Dealt to matiko09 [5s Td]
Stibitzkie: folds 
sebaaastian: folds 
KarlMoik1: folds 
djammusic: folds 
xAndorx: folds 
forsmthgood: folds 
Sweden_Pound: raises $1 to $2
waisanen: calls $1.50
matiko09: folds 
*** FLOP *** [Ac 7d Tc]
waisanen: checks 
Sweden_Pound: bets $3.11
waisanen: calls $3.11
*** TURN *** [Ac 7d Tc] [Ks]
waisanen: checks 
Sweden_Pound: checks 
*** RIVER *** [Ac 7d Tc Ks] [5h]
waisanen: bets $10.72
Sweden_Pound: folds 
Uncalled bet ($10.72) returned to waisanen
waisanen collected $10.72 from pot
*** SUMMARY ***
Total pot $11.22 | Rake $0.50 
Board [Ac 7d Tc Ks 5h]
Seat 1: matiko09 (big blind) folded before Flop
Seat 2: Stibitzkie folded before Flop (didn't bet)
Seat 3: sebaaastian folded before Flop (didn't bet)
Seat 4: KarlMoik1 folded before Flop (didn't bet)
Seat 5: djammusic folded before Flop (didn't bet)
Seat 6: xAndorx folded before Flop (didn't bet)
Seat 7: forsmthgood folded before Flop (didn't bet)
Seat 8: Sweden_Pound (button) folded on the River
Seat 9: waisanen (small blind) collected ($10.72)





PokerStars Hand #149392131442:  Hold'em No Limit (€0.25/€0.50 EUR) - 2016/02/25 16:42:32 CET [2016/02/25 10:42:32 ET]
Table 'Leo Minor III' 9-max Seat #3 is the button
Seat 1: Al3xAnd3r22 (€81.51 in chips) 
Seat 2: vasiy379 (€50 in chips) 
Seat 3: Rorerzap (€62 in chips) 
Seat 4: RvPersie (€71.06 in chips) 
Seat 5: kasse_62 (€20.42 in chips) 
Seat 6: Wwwasian (€53.29 in chips) 
Seat 7: Apparat888 (€20 in chips) 
Seat 8: mi$$I$Elena (€84.90 in chips) 
Seat 9: matiko09 (€50 in chips) 
RvPersie: posts small blind €0.25
kasse_62: posts big blind €0.50
*** HOLE CARDS ***
Dealt to matiko09 [Tc 2h]
Wwwasian: folds 
Apparat888: folds 
mi$$I$Elena: folds 
matiko09: folds 
Al3xAnd3r22: folds 
vasiy379: folds 
Rorerzap: folds 
RvPersie: raises €0.75 to €1.25
kasse_62: folds 
Uncalled bet (€0.75) returned to RvPersie
RvPersie collected €1 from pot
RvPersie: doesn't show hand 
*** SUMMARY ***
Total pot €1 | Rake €0 
Seat 1: Al3xAnd3r22 folded before Flop (didn't bet)
Seat 2: vasiy379 folded before Flop (didn't bet)
Seat 3: Rorerzap (button) folded before Flop (didn't bet)
Seat 4: RvPersie (small blind) collected (€1)
Seat 5: kasse_62 (big blind) folded before Flop
Seat 6: Wwwasian folded before Flop (didn't bet)
Seat 7: Apparat888 folded before Flop (didn't bet)
Seat 8: mi$$I$Elena folded before Flop (didn't bet)
Seat 9: matiko09 folded before Flop (didn't bet)





PokerStars Hand #149392136828:  Hold'em No Limit ($0.50/$1.00 USD) - 2016/02/25 16:42:39 CET [2016/02/25 10:42:39 ET]
Table 'Hercules IV' 9-max Seat #4 is the button
Seat 1: matiko09 ($100 in chips) 
Seat 2: hammerwife ($100 in chips) 
Seat 3: sebaaastian ($201.70 in chips) 
Seat 4: Sweden_Pound ($110 in chips) 
Seat 5: xAndorx ($145.43 in chips) 
Seat 6: kuanhung0903 ($67.60 in chips) 
Seat 7: Ouga Buga ($100 in chips) 
Seat 8: brokat77 ($111.15 in chips) 
Seat 9: djammusic ($38.70 in chips) 
xAndorx: posts small blind $0.50
kuanhung0903: posts big blind $1
*** HOLE CARDS ***
Dealt to matiko09 [Qh 4d]
Ouga Buga: folds 
brokat77: raises $1 to $2
djammusic: folds 
matiko09: folds 
hammerwife: folds 
sebaaastian: folds 
Sweden_Pound: folds 
xAndorx: calls $1.50
kuanhung0903: calls $1
*** FLOP *** [2s 7c Kd]
xAndorx: checks 
kuanhung0903: checks 
brokat77: checks 
*** TURN *** [2s 7c Kd] [8s]
xAndorx: bets $3.50
kuanhung0903: folds 
brokat77: folds 
Uncalled bet ($3.50) returned to xAndorx
xAndorx collected $5.73 from pot
xAndorx: doesn't show hand 
*** SUMMARY ***
Total pot $6 | Rake $0.27 
Board [2s 7c Kd 8s]
Seat 1: matiko09 folded before Flop (didn't bet)
Seat 2: hammerwife folded before Flop (didn't bet)
Seat 3: sebaaastian folded before Flop (didn't bet)
Seat 4: Sweden_Pound (button) folded before Flop (didn't bet)
Seat 5: xAndorx (small blind) collected ($5.73)
Seat 6: kuanhung0903 (big blind) folded on the Turn
Seat 7: Ouga Buga folded before Flop (didn't bet)
Seat 8: brokat77 folded on the Turn
Seat 9: djammusic folded before Flop (didn't bet)





PokerStars Hand #149392137902:  Hold'em No Limit ($0.50/$1.00 USD) - 2016/02/25 16:42:41 CET [2016/02/25 10:42:41 ET]
Table 'Guisan' 9-max Seat #7 is the button
Seat 1: stockbridge8 ($74.36 in chips) 
Seat 2: mycka86 ($100 in chips) 
Seat 4: matiko09 ($173.75 in chips) 
Seat 5: Jeckpot1989 ($88.73 in chips) 
Seat 6: 19R&J91 ($378.81 in chips) 
Seat 7: sebaaastian ($115.09 in chips) 
Seat 8: Monsthand ($111.23 in chips) 
Seat 9: Sweden_Pound ($109.19 in chips) 
Monsthand: posts small blind $0.50
Sweden_Pound: posts big blind $1
xAndorx: sits out 
*** HOLE CARDS ***
Dealt to matiko09 [4c 2h]
stockbridge8: folds 
mycka86: folds 
matiko09: folds 
Jeckpot1989: folds 
19R&J91: raises $4 to $5
sebaaastian: folds 
Monsthand: folds 
Sweden_Pound: folds 
Uncalled bet ($4) returned to 19R&J91
19R&J91 collected $2.50 from pot
*** SUMMARY ***
Total pot $2.50 | Rake $0 
Seat 1: stockbridge8 folded before Flop (didn't bet)
Seat 2: mycka86 folded before Flop (didn't bet)
Seat 4: matiko09 folded before Flop (didn't bet)
Seat 5: Jeckpot1989 folded before Flop (didn't bet)
Seat 6: 19R&J91 collected ($2.50)
Seat 7: sebaaastian (button) folded before Flop (didn't bet)
Seat 8: Monsthand (small blind) folded before Flop
Seat 9: Sweden_Pound (big blind) folded before Flop





PokerStars Hand #149392140919:  Hold'em No Limit ($0.50/$1.00 USD) - 2016/02/25 16:42:44 CET [2016/02/25 10:42:44 ET]
Table 'Zeuxo II' 9-max Seat #9 is the button
Seat 1: forsmthgood ($100 in chips) 
Seat 2: Sweden_Pound ($104.25 in chips) 
Seat 3: xAndorx ($100 in chips) 
Seat 4: sebaaastian ($122.11 in chips) 
Seat 5: bauss84 ($28.14 in chips) 
Seat 6: Cogss ($98.21 in chips) 
Seat 7: djammusic ($45.50 in chips) 
Seat 8: matiko09 ($100 in chips) 
Seat 9: Sreshta222 ($219.60 in chips) 
forsmthgood: posts small blind $0.50
Sweden_Pound: posts big blind $1
*** HOLE CARDS ***
Dealt to matiko09 [8c 3c]
xAndorx: folds 
sebaaastian: raises $2 to $3
bauss84: folds 
Cogss: folds 
djammusic: folds 
matiko09: folds 
Sreshta222: folds 
forsmthgood: folds 
Sweden_Pound: folds 
Uncalled bet ($2) returned to sebaaastian
sebaaastian collected $2.50 from pot
sebaaastian: doesn't show hand 
*** SUMMARY ***
Total pot $2.50 | Rake $0 
Seat 1: forsmthgood (small blind) folded before Flop
Seat 2: Sweden_Pound (big blind) folded before Flop
Seat 3: xAndorx folded before Flop (didn't bet)
Seat 4: sebaaastian collected ($2.50)
Seat 5: bauss84 folded before Flop (didn't bet)
Seat 6: Cogss folded before Flop (didn't bet)
Seat 7: djammusic folded before Flop (didn't bet)
Seat 8: matiko09 folded before Flop (didn't bet)
Seat 9: Sreshta222 (button) folded before Flop (didn't bet)





PokerStars Hand #149392141184:  Hold'em No Limit ($0.25/$0.50 USD) - 2016/02/25 16:42:45 CET [2016/02/25 10:42:45 ET]
Table 'Lohja II' 9-max Seat #5 is the button
Seat 1: MoonJimmy ($151.68 in chips) 
Seat 2: Apparat888 ($31.97 in chips) 
Seat 3: guvalc1952 ($146.89 in chips) 
Seat 5: vasiy379 ($50 in chips) 
Seat 7: matiko09 ($154.91 in chips) 
Seat 8: jamba83 ($57.85 in chips) 
Seat 9: Muinmyheart ($76.44 in chips) 
JustR82 will be allowed to play after the button
matiko09: posts small blind $0.25
jamba83: posts big blind $0.50
payback11: sits out 
MoonJimmy: posts the ante $0.10
Apparat888: posts the ante $0.10
guvalc1952: posts the ante $0.10
vasiy379: posts the ante $0.10
matiko09: posts the ante $0.10
jamba83: posts the ante $0.10
Muinmyheart: posts the ante $0.10
*** HOLE CARDS ***
Dealt to matiko09 [3s Jh]
Muinmyheart: folds 
MoonJimmy: folds 
Apparat888: raises $1 to $1.50
guvalc1952: folds 
vasiy379: folds 
matiko09: folds 
jamba83: folds 
Uncalled bet ($1) returned to Apparat888
Apparat888 collected $1.95 from pot
*** SUMMARY ***
Total pot $1.95 | Rake $0 
Seat 1: MoonJimmy folded before Flop (didn't bet)
Seat 2: Apparat888 collected ($1.95)
Seat 3: guvalc1952 folded before Flop (didn't bet)
Seat 5: vasiy379 (button) folded before Flop (didn't bet)
Seat 7: matiko09 (small blind) folded before Flop
Seat 8: jamba83 (big blind) folded before Flop
Seat 9: Muinmyheart folded before Flop (didn't bet)





PokerStars Hand #149392142091:  Hold'em No Limit ($0.25/$0.50 USD) - 2016/02/25 16:42:46 CET [2016/02/25 10:42:46 ET]
Table 'Thalpius III' 9-max Seat #5 is the button
Seat 1: BrotherLove9 ($52.85 in chips) 
Seat 2: matiko09 ($56.54 in chips) 
Seat 3: jamba83 ($52.31 in chips) 
Seat 4: Wwwasian ($50.76 in chips) 
Seat 5: Rorerzap ($57.02 in chips) 
Seat 6: ihami ($51.75 in chips) 
Seat 7: v4n0v ($50.75 in chips) 
Seat 8: jeroemie123 ($30.05 in chips) 
Seat 9: Gemb1rdd ($71.18 in chips) 
ihami: posts small blind $0.25
v4n0v: posts big blind $0.50
*** HOLE CARDS ***
Dealt to matiko09 [Jc 2c]
jeroemie123: folds 
Gemb1rdd: folds 
BrotherLove9: folds 
matiko09: folds 
jamba83: folds 
Wwwasian: folds 
Rorerzap: raises $0.50 to $1
ihami: folds 
v4n0v: folds 
Uncalled bet ($0.50) returned to Rorerzap
Rorerzap collected $1.25 from pot
Rorerzap: doesn't show hand 
*** SUMMARY ***
Total pot $1.25 | Rake $0 
Seat 1: BrotherLove9 folded before Flop (didn't bet)
Seat 2: matiko09 folded before Flop (didn't bet)
Seat 3: jamba83 folded before Flop (didn't bet)
Seat 4: Wwwasian folded before Flop (didn't bet)
Seat 5: Rorerzap (button) collected ($1.25)
Seat 6: ihami (small blind) folded before Flop
Seat 7: v4n0v (big blind) folded before Flop
Seat 8: jeroemie123 folded before Flop (didn't bet)
Seat 9: Gemb1rdd folded before Flop (didn't bet)





PokerStars Hand #149392150056:  Hold'em No Limit ($0.50/$1.00 USD) - 2016/02/25 16:42:56 CET [2016/02/25 10:42:56 ET]
Table 'Simona' 9-max Seat #4 is the button
Seat 1: mycka86 ($137.94 in chips) 
Seat 2: xAndorx ($110.74 in chips) 
Seat 3: Sweden_Pound ($115.49 in chips) 
Seat 4: matiko09 ($274.92 in chips) 
Seat 5: sebaaastian ($100.50 in chips) 
Seat 6: Ty Nick 420 ($104.50 in chips) 
Seat 7: Aalleekks ($100 in chips) 
Seat 8: Monsthand ($136.47 in chips) 
sebaaastian: posts small blind $0.50
Ty Nick 420: posts big blind $1
*** HOLE CARDS ***
Dealt to matiko09 [Qh 5c]
Aalleekks: folds 
Monsthand: folds 
mycka86: folds 
xAndorx: folds 
Sweden_Pound: folds 
matiko09: folds 
sebaaastian: raises $2 to $3
Ty Nick 420: folds 
Uncalled bet ($2) returned to sebaaastian
sebaaastian collected $2 from pot
sebaaastian: doesn't show hand 
*** SUMMARY ***
Total pot $2 | Rake $0 
Seat 1: mycka86 folded before Flop (didn't bet)
Seat 2: xAndorx folded before Flop (didn't bet)
Seat 3: Sweden_Pound folded before Flop (didn't bet)
Seat 4: matiko09 (button) folded before Flop (didn't bet)
Seat 5: sebaaastian (small blind) collected ($2)
Seat 6: Ty Nick 420 (big blind) folded before Flop
Seat 7: Aalleekks folded before Flop (didn't bet)
Seat 8: Monsthand folded before Flop (didn't bet)





PokerStars Hand #149392153124:  Hold'em No Limit ($0.50/$1.00 USD) - 2016/02/25 16:43:00 CET [2016/02/25 10:43:00 ET]
Table 'Lina II' 9-max Seat #1 is the button
Seat 1: Lesley2002 ($165.54 in chips) 
Seat 2: matiko09 ($110.51 in chips) 
Seat 3: Ouga Buga ($100 in chips) 
Seat 4: Nennenurse ($41.13 in chips) 
Seat 6: sebaaastian ($149.62 in chips) 
Seat 7: Monsthand ($146.74 in chips) 
Seat 8: djammusic ($42.64 in chips) 
Seat 9: Sweden_Pound ($269.27 in chips) 
matiko09: posts small blind $0.50
Ouga Buga: posts big blind $1
*** HOLE CARDS ***
Dealt to matiko09 [2h 2c]
Nennenurse: folds 
swizzly58 leaves the table
sebaaastian: folds 
Monsthand: folds 
djammusic: folds 
Sweden_Pound: folds 
Lesley2002: folds 
matiko09: raises $1.50 to $2.50
Ouga Buga: calls $1.50
*** FLOP *** [Ac Ks Ah]
HomerrrJay joins the table at seat #5 
matiko09: checks 
Ouga Buga: checks 
*** TURN *** [Ac Ks Ah] [2d]
matiko09: bets $3.11
Ouga Buga: folds 
Uncalled bet ($3.11) returned to matiko09
matiko09 collected $4.78 from pot
matiko09: doesn't show hand 
*** SUMMARY ***
Total pot $5 | Rake $0.22 
Board [Ac Ks Ah 2d]
Seat 1: Lesley2002 (button) folded before Flop (didn't bet)
Seat 2: matiko09 (small blind) collected ($4.78)
Seat 3: Ouga Buga (big blind) folded on the Turn
Seat 4: Nennenurse folded before Flop (didn't bet)
Seat 6: sebaaastian folded before Flop (didn't bet)
Seat 7: Monsthand folded before Flop (didn't bet)
Seat 8: djammusic folded before Flop (didn't bet)
Seat 9: Sweden_Pound folded before Flop (didn't bet)





PokerStars Hand #149392161221:  Hold'em No Limit ($0.50/$1.00 USD) - 2016/02/25 16:43:11 CET [2016/02/25 10:43:11 ET]
Table 'Isa' 9-max Seat #5 is the button
Seat 1: matiko09 ($128.94 in chips) 
Seat 2: Monsthand ($100 in chips) 
Seat 3: sebaaastian ($109.90 in chips) 
Seat 4: hammerwife ($110.50 in chips) 
Seat 5: Sweden_Pound ($105.05 in chips) 
Seat 6: xAndorx ($100 in chips) 
Seat 7: bilukm ($145.51 in chips) 
Seat 9: TideHan ($100 in chips) 
xAndorx: posts small blind $0.50
bilukm: posts big blind $1
*** HOLE CARDS ***
Dealt to matiko09 [7c Ad]
TideHan: folds 
matiko09: folds 
Monsthand: folds 
sebaaastian: folds 
hammerwife: folds 
Sweden_Pound: raises $1 to $2
xAndorx: folds 
bilukm: calls $1
*** FLOP *** [7s 9d 4s]
bilukm: bets $1
Sweden_Pound: folds 
Uncalled bet ($1) returned to bilukm
bilukm collected $4.30 from pot
bilukm: doesn't show hand 
*** SUMMARY ***
Total pot $4.50 | Rake $0.20 
Board [7s 9d 4s]
Seat 1: matiko09 folded before Flop (didn't bet)
Seat 2: Monsthand folded before Flop (didn't bet)
Seat 3: sebaaastian folded before Flop (didn't bet)
Seat 4: hammerwife folded before Flop (didn't bet)
Seat 5: Sweden_Pound (button) folded on the Flop
Seat 6: xAndorx (small blind) folded before Flop
Seat 7: bilukm (big blind) collected ($4.30)
Seat 9: TideHan folded before Flop (didn't bet)





PokerStars Hand #149392162496:  Hold'em No Limit (€0.25/€0.50 EUR) - 2016/02/25 16:43:13 CET [2016/02/25 10:43:13 ET]
Table 'Leo Minor III' 9-max Seat #4 is the button
Seat 1: Al3xAnd3r22 (€81.51 in chips) 
Seat 2: vasiy379 (€50 in chips) 
Seat 3: Rorerzap (€62 in chips) 
Seat 4: RvPersie (€71.56 in chips) 
Seat 5: kasse_62 (€19.92 in chips) 
Seat 6: Wwwasian (€53.29 in chips) 
Seat 7: Apparat888 (€20 in chips) 
Seat 8: mi$$I$Elena (€84.90 in chips) 
Seat 9: matiko09 (€50 in chips) 
kasse_62: posts small blind €0.25
Wwwasian: posts big blind €0.50
*** HOLE CARDS ***
Dealt to matiko09 [Kh 8h]
Apparat888: folds 
mi$$I$Elena: folds 
matiko09: folds 
Al3xAnd3r22: raises €1 to €1.50
Apparat888 leaves the table
vasiy379: raises €3 to €4.50
Rorerzap: folds 
RvPersie: folds 
kasse_62: folds 
Wwwasian: folds 
JustR82 joins the table at seat #7 
Al3xAnd3r22: folds 
Uncalled bet (€3) returned to vasiy379
vasiy379 collected €3.75 from pot
vasiy379: doesn't show hand 
*** SUMMARY ***
Total pot €3.75 | Rake €0 
Seat 1: Al3xAnd3r22 folded before Flop
Seat 2: vasiy379 collected (€3.75)
Seat 3: Rorerzap folded before Flop (didn't bet)
Seat 4: RvPersie (button) folded before Flop (didn't bet)
Seat 5: kasse_62 (small blind) folded before Flop
Seat 6: Wwwasian (big blind) folded before Flop
Seat 7: Apparat888 folded before Flop (didn't bet)
Seat 8: mi$$I$Elena folded before Flop (didn't bet)
Seat 9: matiko09 folded before Flop (didn't bet)





PokerStars Hand #149392171985:  Hold'em No Limit ($0.25/$0.50 USD) - 2016/02/25 16:43:25 CET [2016/02/25 10:43:25 ET]
Table 'Thalpius III' 9-max Seat #6 is the button
Seat 1: BrotherLove9 ($52.85 in chips) 
Seat 2: matiko09 ($56.54 in chips) 
Seat 3: jamba83 ($52.31 in chips) 
Seat 4: Wwwasian ($50.76 in chips) 
Seat 5: Rorerzap ($57.77 in chips) 
Seat 6: ihami ($51.50 in chips) 
Seat 7: v4n0v ($50.25 in chips) 
Seat 8: jeroemie123 ($30.05 in chips) 
Seat 9: Gemb1rdd ($71.18 in chips) 
v4n0v: posts small blind $0.25
jeroemie123: posts big blind $0.50
*** HOLE CARDS ***
Dealt to matiko09 [Ks 2d]
Gemb1rdd: folds 
BrotherLove9: folds 
matiko09: folds 
Gemb1rdd leaves the table
Domotirko228 joins the table at seat #9 
jamba83: folds 
Wwwasian: folds 
Rorerzap: folds 
ihami: raises $0.50 to $1
v4n0v: folds 
jeroemie123: folds 
Uncalled bet ($0.50) returned to ihami
ihami collected $1.25 from pot
*** SUMMARY ***
Total pot $1.25 | Rake $0 
Seat 1: BrotherLove9 folded before Flop (didn't bet)
Seat 2: matiko09 folded before Flop (didn't bet)
Seat 3: jamba83 folded before Flop (didn't bet)
Seat 4: Wwwasian folded before Flop (didn't bet)
Seat 5: Rorerzap folded before Flop (didn't bet)
Seat 6: ihami (button) collected ($1.25)
Seat 7: v4n0v (small blind) folded before Flop
Seat 8: jeroemie123 (big blind) folded before Flop
Seat 9: Gemb1rdd folded before Flop (didn't bet)





PokerStars Hand #149392174982:  Hold'em No Limit ($0.25/$0.50 USD) - 2016/02/25 16:43:29 CET [2016/02/25 10:43:29 ET]
Table 'Lohja II' 9-max Seat #7 is the button
Seat 1: MoonJimmy ($151.58 in chips) 
Seat 2: Apparat888 ($33.32 in chips) 
Seat 3: guvalc1952 ($146.79 in chips) 
Seat 5: vasiy379 ($50 in chips) 
Seat 7: matiko09 ($154.56 in chips) 
Seat 8: jamba83 ($57.25 in chips) 
Seat 9: Muinmyheart ($76.34 in chips) 
jamba83: posts small blind $0.25
Muinmyheart: posts big blind $0.50
payback11: sits out 
JustR82: sits out 
MoonJimmy: posts the ante $0.10
Apparat888: posts the ante $0.10
guvalc1952: posts the ante $0.10
vasiy379: posts the ante $0.10
matiko09: posts the ante $0.10
jamba83: posts the ante $0.10
Muinmyheart: posts the ante $0.10
*** HOLE CARDS ***
Dealt to matiko09 [Th 6c]
MoonJimmy: folds 
Apparat888: folds 
guvalc1952: calls $0.50
vasiy379: folds 
matiko09: folds 
jamba83: raises $2 to $2.50
Muinmyheart: folds 
guvalc1952: calls $2
*** FLOP *** [3h Qc 6s]
jamba83: bets $3.50
guvalc1952: folds 
Uncalled bet ($3.50) returned to jamba83
jamba83 collected $5.92 from pot
*** SUMMARY ***
Total pot $6.20 | Rake $0.28 
Board [3h Qc 6s]
Seat 1: MoonJimmy folded before Flop (didn't bet)
Seat 2: Apparat888 folded before Flop (didn't bet)
Seat 3: guvalc1952 folded on the Flop
Seat 5: vasiy379 folded before Flop (didn't bet)
Seat 7: matiko09 (button) folded before Flop (didn't bet)
Seat 8: jamba83 (small blind) collected ($5.92)
Seat 9: Muinmyheart (big blind) folded before Flop





PokerStars Hand #149392175215:  Hold'em No Limit ($0.50/$1.00 USD) - 2016/02/25 16:43:29 CET [2016/02/25 10:43:29 ET]
Table 'Morosovia II' 9-max Seat #3 is the button
Seat 1: apfush ($194.96 in chips) 
Seat 2: lysandrafly ($100 in chips) 
Seat 3: sebaaastian ($139.65 in chips) 
Seat 4: matiko09 ($167.85 in chips) 
Seat 5: pimpoza ($69.05 in chips) 
Seat 6: Sweden_Pound ($138.61 in chips) 
Seat 7: Ty Nick 420 ($169.69 in chips) 
Seat 8: Monsthand ($100.50 in chips) 
Seat 9: Ouga Buga ($122.54 in chips) 
matiko09: posts small blind $0.50
pimpoza: posts big blind $1
*** HOLE CARDS ***
Dealt to matiko09 [Jh Td]
Sweden_Pound: raises $2 to $3
Ty Nick 420: folds 
Monsthand: folds 
Ouga Buga: folds 
apfush: folds 
lysandrafly: folds 
sebaaastian: folds 
matiko09: folds 
pimpoza: calls $2
*** FLOP *** [9d 8s Ah]
pimpoza: checks 
Sweden_Pound: bets $4.04
pimpoza: calls $4.04
*** TURN *** [9d 8s Ah] [5s]
pimpoza: bets $14
Sweden_Pound: folds 
Uncalled bet ($14) returned to pimpoza
pimpoza collected $13.92 from pot
*** SUMMARY ***
Total pot $14.58 | Rake $0.66 
Board [9d 8s Ah 5s]
Seat 1: apfush folded before Flop (didn't bet)
Seat 2: lysandrafly folded before Flop (didn't bet)
Seat 3: sebaaastian (button) folded before Flop (didn't bet)
Seat 4: matiko09 (small blind) folded before Flop
Seat 5: pimpoza (big blind) collected ($13.92)
Seat 6: Sweden_Pound folded on the Turn
Seat 7: Ty Nick 420 folded before Flop (didn't bet)
Seat 8: Monsthand folded before Flop (didn't bet)
Seat 9: Ouga Buga folded before Flop (didn't bet)





PokerStars Hand #149392175639:  Hold'em No Limit ($0.50/$1.00 USD) - 2016/02/25 16:43:30 CET [2016/02/25 10:43:30 ET]
Table 'Guisan' 9-max Seat #8 is the button
Seat 1: stockbridge8 ($74.36 in chips) 
Seat 2: mycka86 ($100 in chips) 
Seat 4: matiko09 ($173.75 in chips) 
Seat 5: Jeckpot1989 ($88.73 in chips) 
Seat 6: 19R&J91 ($380.31 in chips) 
Seat 7: sebaaastian ($115.09 in chips) 
Seat 8: Monsthand ($110.73 in chips) 
Seat 9: Sweden_Pound ($108.19 in chips) 
Sweden_Pound: posts small blind $0.50
stockbridge8: posts big blind $1
xAndorx: sits out 
*** HOLE CARDS ***
Dealt to matiko09 [6h 4d]
mycka86: raises $2 to $3
matiko09: folds 
Jeckpot1989: folds 
19R&J91: calls $3
sebaaastian: folds 
Monsthand: folds 
Sweden_Pound: folds 
stockbridge8: folds 
*** FLOP *** [Ad 5d Ks]
mycka86: bets $4.50
19R&J91: calls $4.50
*** TURN *** [Ad 5d Ks] [3c]
mycka86: checks 
19R&J91: bets $5
mycka86: folds 
Uncalled bet ($5) returned to 19R&J91
19R&J91 collected $15.76 from pot
*** SUMMARY ***
Total pot $16.50 | Rake $0.74 
Board [Ad 5d Ks 3c]
Seat 1: stockbridge8 (big blind) folded before Flop
Seat 2: mycka86 folded on the Turn
Seat 4: matiko09 folded before Flop (didn't bet)
Seat 5: Jeckpot1989 folded before Flop (didn't bet)
Seat 6: 19R&J91 collected ($15.76)
Seat 7: sebaaastian folded before Flop (didn't bet)
Seat 8: Monsthand (button) folded before Flop (didn't bet)
Seat 9: Sweden_Pound (small blind) folded before Flop





PokerStars Hand #149392177770:  Hold'em No Limit ($0.50/$1.00 USD) - 2016/02/25 16:43:33 CET [2016/02/25 10:43:33 ET]
Table 'Lucia III' 9-max Seat #7 is the button
Seat 1: Monsthand ($121.25 in chips) 
Seat 2: kuanhung0903 ($78 in chips) 
Seat 3: mycka86 ($122.07 in chips) 
Seat 5: Sweden_Pound ($222.93 in chips) 
Seat 6: matiko09 ($100 in chips) 
Seat 7: Ty Nick 420 ($306.81 in chips) 
Seat 8: apfush ($108.60 in chips) 
Seat 9: Apparat888 ($34.45 in chips) 
apfush: posts small blind $0.50
Apparat888: posts big blind $1
*** HOLE CARDS ***
Dealt to matiko09 [5d Td]
Monsthand: folds 
kuanhung0903: folds 
mycka86: folds 
Sweden_Pound: folds 
swatek1986 leaves the table
matiko09: folds 
xAndorx joins the table at seat #4 
Ty Nick 420: folds 
apfush: raises $2 to $3
Apparat888: folds 
Uncalled bet ($2) returned to apfush
apfush collected $2 from pot
apfush: doesn't show hand 
*** SUMMARY ***
Total pot $2 | Rake $0 
Seat 1: Monsthand folded before Flop (didn't bet)
Seat 2: kuanhung0903 folded before Flop (didn't bet)
Seat 3: mycka86 folded before Flop (didn't bet)
Seat 5: Sweden_Pound folded before Flop (didn't bet)
Seat 6: matiko09 folded before Flop (didn't bet)
Seat 7: Ty Nick 420 (button) folded before Flop (didn't bet)
Seat 8: apfush (small blind) collected ($2)
Seat 9: Apparat888 (big blind) folded before Flop





PokerStars Hand #149392178776:  Hold'em No Limit ($0.50/$1.00 USD) - 2016/02/25 16:43:34 CET [2016/02/25 10:43:34 ET]
Table 'Simona' 9-max Seat #5 is the button
Seat 1: mycka86 ($137.94 in chips) 
Seat 2: xAndorx ($110.74 in chips) 
Seat 3: Sweden_Pound ($115.49 in chips) 
Seat 4: matiko09 ($274.92 in chips) 
Seat 5: sebaaastian ($101.50 in chips) 
Seat 6: Ty Nick 420 ($103.50 in chips) 
Seat 8: Monsthand ($136.47 in chips) 
Ty Nick 420: posts small blind $0.50
Aalleekks: is sitting out 
Monsthand: posts big blind $1
*** HOLE CARDS ***
Dealt to matiko09 [2d 3s]
Aalleekks leaves the table
mycka86: folds 
xAndorx: raises $2 to $3
Sweden_Pound: folds 
matiko09: folds 
sebaaastian: folds 
Ty Nick 420: folds 
hammerwife joins the table at seat #7 
Monsthand: folds 
Uncalled bet ($2) returned to xAndorx
xAndorx collected $2.50 from pot
xAndorx: doesn't show hand 
*** SUMMARY ***
Total pot $2.50 | Rake $0 
Seat 1: mycka86 folded before Flop (didn't bet)
Seat 2: xAndorx collected ($2.50)
Seat 3: Sweden_Pound folded before Flop (didn't bet)
Seat 4: matiko09 folded before Flop (didn't bet)
Seat 5: sebaaastian (button) folded before Flop (didn't bet)
Seat 6: Ty Nick 420 (small blind) folded before Flop
Seat 8: Monsthand (big blind) folded before Flop





PokerStars Hand #149392179729:  Hold'em No Limit ($0.50/$1.00 USD) - 2016/02/25 16:43:35 CET [2016/02/25 10:43:35 ET]
Table 'Zeuxo II' 9-max Seat #1 is the button
Seat 1: forsmthgood ($100 in chips) 
Seat 2: Sweden_Pound ($103.25 in chips) 
Seat 3: xAndorx ($100 in chips) 
Seat 4: sebaaastian ($123.61 in chips) 
Seat 5: bauss84 ($28.14 in chips) 
Seat 6: Cogss ($98.21 in chips) 
Seat 7: djammusic ($45.50 in chips) 
Seat 8: matiko09 ($100 in chips) 
Seat 9: Sreshta222 ($219.60 in chips) 
Sweden_Pound: posts small blind $0.50
xAndorx: posts big blind $1
*** HOLE CARDS ***
Dealt to matiko09 [3c Ks]
sebaaastian: folds 
bauss84: calls $1
Cogss: folds 
djammusic: folds 
matiko09: folds 
Sreshta222: folds 
forsmthgood: folds 
Sweden_Pound: calls $0.50
xAndorx: checks 
*** FLOP *** [3d 2c Kh]
Sweden_Pound: checks 
xAndorx: checks 
bauss84: bets $3.99
Sweden_Pound: folds 
xAndorx: folds 
Uncalled bet ($3.99) returned to bauss84
bauss84 collected $2.86 from pot
bauss84: doesn't show hand 
*** SUMMARY ***
Total pot $3 | Rake $0.14 
Board [3d 2c Kh]
Seat 1: forsmthgood (button) folded before Flop (didn't bet)
Seat 2: Sweden_Pound (small blind) folded on the Flop
Seat 3: xAndorx (big blind) folded on the Flop
Seat 4: sebaaastian folded before Flop (didn't bet)
Seat 5: bauss84 collected ($2.86)
Seat 6: Cogss folded before Flop (didn't bet)
Seat 7: djammusic folded before Flop (didn't bet)
Seat 8: matiko09 folded before Flop (didn't bet)
Seat 9: Sreshta222 folded before Flop (didn't bet)





PokerStars Hand #149392191374:  Hold'em No Limit ($0.50/$1.00 USD) - 2016/02/25 16:43:50 CET [2016/02/25 10:43:50 ET]
Table 'Badenia II' 9-max Seat #9 is the button
Seat 1: matiko09 ($102 in chips) 
Seat 2: Stibitzkie ($111.42 in chips) 
Seat 3: sebaaastian ($101.50 in chips) 
Seat 4: KarlMoik1 ($368.97 in chips) 
Seat 5: djammusic ($123.59 in chips) 
Seat 6: xAndorx ($100 in chips) 
Seat 7: forsmthgood ($100 in chips) 
Seat 8: Sweden_Pound ($128.92 in chips) 
Seat 9: waisanen ($114.42 in chips) 
matiko09: posts small blind $0.50
Stibitzkie: posts big blind $1
*** HOLE CARDS ***
Dealt to matiko09 [6h Jc]
sebaaastian: folds 
KarlMoik1: folds 
djammusic: folds 
xAndorx: raises $2 to $3
forsmthgood: folds 
Sweden_Pound: folds 
waisanen: folds 
matiko09: folds 
Stibitzkie: calls $2
*** FLOP *** [5h Kd 6s]
Stibitzkie: checks 
xAndorx: bets $3.50
Stibitzkie: folds 
Uncalled bet ($3.50) returned to xAndorx
xAndorx collected $6.21 from pot
xAndorx: doesn't show hand 
*** SUMMARY ***
Total pot $6.50 | Rake $0.29 
Board [5h Kd 6s]
Seat 1: matiko09 (small blind) folded before Flop
Seat 2: Stibitzkie (big blind) folded on the Flop
Seat 3: sebaaastian folded before Flop (didn't bet)
Seat 4: KarlMoik1 folded before Flop (didn't bet)
Seat 5: djammusic folded before Flop (didn't bet)
Seat 6: xAndorx collected ($6.21)
Seat 7: forsmthgood folded before Flop (didn't bet)
Seat 8: Sweden_Pound folded before Flop (didn't bet)
Seat 9: waisanen (button) folded before Flop (didn't bet)





PokerStars Hand #149392193846:  Hold'em No Limit ($0.50/$1.00 USD) - 2016/02/25 16:43:53 CET [2016/02/25 10:43:53 ET]
Table 'Isa' 9-max Seat #6 is the button
Seat 1: matiko09 ($128.94 in chips) 
Seat 2: Monsthand ($100 in chips) 
Seat 3: sebaaastian ($109.90 in chips) 
Seat 4: hammerwife ($110.50 in chips) 
Seat 5: Sweden_Pound ($103.05 in chips) 
Seat 6: xAndorx ($100 in chips) 
Seat 7: bilukm ($147.81 in chips) 
Seat 9: TideHan ($100 in chips) 
bilukm: posts small blind $0.50
TideHan: posts big blind $1
*** HOLE CARDS ***
Dealt to matiko09 [4d 4h]
matiko09: raises $2 to $3
Monsthand: folds 
sebaaastian: folds 
hammerwife: folds 
Sweden_Pound: folds 
xAndorx: folds 
bilukm: folds 
TideHan: folds 
Uncalled bet ($2) returned to matiko09
matiko09 collected $2.50 from pot
matiko09: doesn't show hand 
*** SUMMARY ***
Total pot $2.50 | Rake $0 
Seat 1: matiko09 collected ($2.50)
Seat 2: Monsthand folded before Flop (didn't bet)
Seat 3: sebaaastian folded before Flop (didn't bet)
Seat 4: hammerwife folded before Flop (didn't bet)
Seat 5: Sweden_Pound folded before Flop (didn't bet)
Seat 6: xAndorx (button) folded before Flop (didn't bet)
Seat 7: bilukm (small blind) folded before Flop
Seat 9: TideHan (big blind) folded before Flop





PokerStars Hand #149392198314:  Hold'em No Limit ($0.50/$1.00 USD) - 2016/02/25 16:43:59 CET [2016/02/25 10:43:59 ET]
Table 'Lina II' 9-max Seat #2 is the button
Seat 1: Lesley2002 ($165.54 in chips) 
Seat 2: matiko09 ($112.79 in chips) 
Seat 3: Ouga Buga ($100 in chips) 
Seat 4: Nennenurse ($41.13 in chips) 
Seat 6: sebaaastian ($149.62 in chips) 
Seat 7: Monsthand ($146.74 in chips) 
Seat 8: djammusic ($42.64 in chips) 
Seat 9: Sweden_Pound ($269.27 in chips) 
Ouga Buga: posts small blind $0.50
Nennenurse: posts big blind $1
HomerrrJay: sits out 
*** HOLE CARDS ***
Dealt to matiko09 [Kc 7s]
sebaaastian: folds 
Monsthand: folds 
djammusic: folds 
Sweden_Pound: raises $2 to $3
Lesley2002: calls $3
matiko09: folds 
Ouga Buga: folds 
Nennenurse: calls $2
*** FLOP *** [4d 9h Jh]
Nennenurse: checks 
Sweden_Pound: bets $5.90
Lesley2002: folds 
Nennenurse: folds 
Uncalled bet ($5.90) returned to Sweden_Pound
Sweden_Pound collected $9.07 from pot
Sweden_Pound: doesn't show hand 
*** SUMMARY ***
Total pot $9.50 | Rake $0.43 
Board [4d 9h Jh]
Seat 1: Lesley2002 folded on the Flop
Seat 2: matiko09 (button) folded before Flop (didn't bet)
Seat 3: Ouga Buga (small blind) folded before Flop
Seat 4: Nennenurse (big blind) folded on the Flop
Seat 6: sebaaastian folded before Flop (didn't bet)
Seat 7: Monsthand folded before Flop (didn't bet)
Seat 8: djammusic folded before Flop (didn't bet)
Seat 9: Sweden_Pound collected ($9.07)





PokerStars Hand #149392198184:  Hold'em No Limit ($0.50/$1.00 USD) - 2016/02/25 16:43:59 CET [2016/02/25 10:43:59 ET]
Table 'Lucia III' 9-max Seat #8 is the button
Seat 1: Monsthand ($121.25 in chips) 
Seat 2: kuanhung0903 ($78 in chips) 
Seat 3: mycka86 ($122.07 in chips) 
Seat 5: Sweden_Pound ($222.93 in chips) 
Seat 6: matiko09 ($100 in chips) 
Seat 7: Ty Nick 420 ($306.81 in chips) 
Seat 8: apfush ($109.60 in chips) 
Seat 9: Apparat888 ($33.45 in chips) 
Apparat888: posts small blind $0.50
Monsthand: posts big blind $1
xAndorx: sits out 
*** HOLE CARDS ***
Dealt to matiko09 [As 9s]
kuanhung0903: calls $1
mycka86: folds 
Sweden_Pound: folds 
matiko09: raises $2 to $3
Ty Nick 420: calls $3
apfush: folds 
Apparat888: folds 
Monsthand: folds 
kuanhung0903: calls $2
*** FLOP *** [5c 6h Ah]
kuanhung0903: checks 
matiko09: bets $6.52
Ty Nick 420: calls $6.52
kuanhung0903: folds 
*** TURN *** [5c 6h Ah] [3d]
matiko09: checks 
Ty Nick 420: bets $13.50
matiko09: folds 
Uncalled bet ($13.50) returned to Ty Nick 420
Ty Nick 420 collected $22.48 from pot
*** SUMMARY ***
Total pot $23.54 | Rake $1.06 
Board [5c 6h Ah 3d]
Seat 1: Monsthand (big blind) folded before Flop
Seat 2: kuanhung0903 folded on the Flop
Seat 3: mycka86 folded before Flop (didn't bet)
Seat 5: Sweden_Pound folded before Flop (didn't bet)
Seat 6: matiko09 folded on the Turn
Seat 7: Ty Nick 420 collected ($22.48)
Seat 8: apfush (button) folded before Flop (didn't bet)
Seat 9: Apparat888 (small blind) folded before Flop





PokerStars Hand #149392209136:  Hold'em No Limit (€0.25/€0.50 EUR) - 2016/02/25 16:44:13 CET [2016/02/25 10:44:13 ET]
Table 'Leo Minor III' 9-max Seat #5 is the button
Seat 1: Al3xAnd3r22 (€80.01 in chips) 
Seat 2: vasiy379 (€52.25 in chips) 
Seat 3: Rorerzap (€62 in chips) 
Seat 4: RvPersie (€71.56 in chips) 
Seat 5: kasse_62 (€19.67 in chips) 
Seat 6: Wwwasian (€52.79 in chips) 
Seat 7: JustR82 (€50 in chips) 
Seat 8: mi$$I$Elena (€84.90 in chips) 
Seat 9: matiko09 (€50 in chips) 
Wwwasian: posts small blind €0.25
JustR82: posts big blind €0.50
*** HOLE CARDS ***
Dealt to matiko09 [9d 7c]
mi$$I$Elena: folds 
matiko09: folds 
Al3xAnd3r22: folds 
vasiy379: folds 
Rorerzap: folds 
RvPersie: folds 
kasse_62: folds 
Wwwasian: folds 
Uncalled bet (€0.25) returned to JustR82
JustR82 collected €0.50 from pot
JustR82: doesn't show hand 
*** SUMMARY ***
Total pot €0.50 | Rake €0 
Seat 1: Al3xAnd3r22 folded before Flop (didn't bet)
Seat 2: vasiy379 folded before Flop (didn't bet)
Seat 3: Rorerzap folded before Flop (didn't bet)
Seat 4: RvPersie folded before Flop (didn't bet)
Seat 5: kasse_62 (button) folded before Flop (didn't bet)
Seat 6: Wwwasian (small blind) folded before Flop
Seat 7: JustR82 (big blind) collected (€0.50)
Seat 8: mi$$I$Elena folded before Flop (didn't bet)
Seat 9: matiko09 folded before Flop (didn't bet)





PokerStars Hand #149392210978:  Hold'em No Limit ($0.50/$1.00 USD) - 2016/02/25 16:44:16 CET [2016/02/25 10:44:16 ET]
Table 'Simona' 9-max Seat #6 is the button
Seat 1: mycka86 ($137.94 in chips) 
Seat 2: xAndorx ($112.24 in chips) 
Seat 3: Sweden_Pound ($115.49 in chips) 
Seat 4: matiko09 ($274.92 in chips) 
Seat 5: sebaaastian ($101.50 in chips) 
Seat 6: Ty Nick 420 ($103 in chips) 
Seat 8: Monsthand ($135.47 in chips) 
Monsthand: posts small blind $0.50
mycka86: posts big blind $1
*** HOLE CARDS ***
Dealt to matiko09 [6c Jc]
xAndorx: folds 
Sweden_Pound: folds 
matiko09: folds 
sebaaastian: raises $1.50 to $2.50
Ty Nick 420: calls $2.50
Monsthand: folds 
mycka86: folds 
*** FLOP *** [Ah 6h 3h]
sebaaastian: checks 
Ty Nick 420: checks 
*** TURN *** [Ah 6h 3h] [4s]
sebaaastian: bets $4
Ty Nick 420: folds 
Uncalled bet ($4) returned to sebaaastian
sebaaastian collected $6.21 from pot
sebaaastian: doesn't show hand 
*** SUMMARY ***
Total pot $6.50 | Rake $0.29 
Board [Ah 6h 3h 4s]
Seat 1: mycka86 (big blind) folded before Flop
Seat 2: xAndorx folded before Flop (didn't bet)
Seat 3: Sweden_Pound folded before Flop (didn't bet)
Seat 4: matiko09 folded before Flop (didn't bet)
Seat 5: sebaaastian collected ($6.21)
Seat 6: Ty Nick 420 (button) folded on the Turn
Seat 8: Monsthand (small blind) folded before Flop





PokerStars Hand #149392210922:  Hold'em No Limit ($0.50/$1.00 USD) - 2016/02/25 16:44:16 CET [2016/02/25 10:44:16 ET]
Table 'Hercules IV' 9-max Seat #5 is the button
Seat 1: matiko09 ($100 in chips) 
Seat 2: hammerwife ($100 in chips) 
Seat 3: sebaaastian ($201.70 in chips) 
Seat 4: Sweden_Pound ($110 in chips) 
Seat 5: xAndorx ($149.16 in chips) 
Seat 6: kuanhung0903 ($65.60 in chips) 
Seat 7: Ouga Buga ($100 in chips) 
Seat 8: brokat77 ($109.15 in chips) 
Seat 9: djammusic ($38.70 in chips) 
kuanhung0903: posts small blind $0.50
Ouga Buga: posts big blind $1
*** HOLE CARDS ***
Dealt to matiko09 [8c 8s]
brokat77: folds 
djammusic: folds 
matiko09: raises $2 to $3
hammerwife: folds 
sebaaastian: folds 
Sweden_Pound: folds 
xAndorx: calls $3
kuanhung0903: folds 
Ouga Buga: folds 
*** FLOP *** [Ac 5d 2c]
matiko09: checks 
xAndorx: bets $4
matiko09: calls $4
*** TURN *** [Ac 5d 2c] [2h]
matiko09: checks 
xAndorx: bets $10
matiko09: folds 
Uncalled bet ($10) returned to xAndorx
xAndorx collected $14.80 from pot
xAndorx: doesn't show hand 
*** SUMMARY ***
Total pot $15.50 | Rake $0.70 
Board [Ac 5d 2c 2h]
Seat 1: matiko09 folded on the Turn
Seat 2: hammerwife folded before Flop (didn't bet)
Seat 3: sebaaastian folded before Flop (didn't bet)
Seat 4: Sweden_Pound folded before Flop (didn't bet)
Seat 5: xAndorx (button) collected ($14.80)
Seat 6: kuanhung0903 (small blind) folded before Flop
Seat 7: Ouga Buga (big blind) folded before Flop
Seat 8: brokat77 folded before Flop (didn't bet)
Seat 9: djammusic folded before Flop (didn't bet)





PokerStars Hand #149392213013:  Hold'em No Limit ($0.25/$0.50 USD) - 2016/02/25 16:44:18 CET [2016/02/25 10:44:18 ET]
Table 'Thalpius III' 9-max Seat #7 is the button
Seat 1: BrotherLove9 ($52.85 in chips) 
Seat 2: matiko09 ($56.54 in chips) 
Seat 3: jamba83 ($52.31 in chips) 
Seat 4: Wwwasian ($50.76 in chips) 
Seat 5: Rorerzap ($57.77 in chips) 
Seat 6: ihami ($52.25 in chips) 
Seat 7: v4n0v ($50 in chips) 
Seat 8: jeroemie123 ($29.55 in chips) 
Seat 9: Domotirko228 ($50 in chips) 
jeroemie123: posts small blind $0.25
Domotirko228: posts big blind $0.50
*** HOLE CARDS ***
Dealt to matiko09 [4d 3h]
BrotherLove9: folds 
matiko09: folds 
jamba83: folds 
Wwwasian: folds 
Rorerzap: folds 
ihami: folds 
v4n0v: folds 
jeroemie123: calls $0.25
Domotirko228: checks 
*** FLOP *** [9h 2h 2d]
jeroemie123: bets $1.50
Domotirko228: calls $1.50
*** TURN *** [9h 2h 2d] [Ks]
jeroemie123: bets $2.50
Domotirko228: folds 
Uncalled bet ($2.50) returned to jeroemie123
jeroemie123 collected $3.82 from pot
jeroemie123: doesn't show hand 
*** SUMMARY ***
Total pot $4 | Rake $0.18 
Board [9h 2h 2d Ks]
Seat 1: BrotherLove9 folded before Flop (didn't bet)
Seat 2: matiko09 folded before Flop (didn't bet)
Seat 3: jamba83 folded before Flop (didn't bet)
Seat 4: Wwwasian folded before Flop (didn't bet)
Seat 5: Rorerzap folded before Flop (didn't bet)
Seat 6: ihami folded before Flop (didn't bet)
Seat 7: v4n0v (button) folded before Flop (didn't bet)
Seat 8: jeroemie123 (small blind) collected ($3.82)
Seat 9: Domotirko228 (big blind) folded on the Turn





PokerStars Hand #149392226578:  Hold'em No Limit ($0.50/$1.00 USD) - 2016/02/25 16:44:36 CET [2016/02/25 10:44:36 ET]
Table 'Guisan' 9-max Seat #9 is the button
Seat 1: stockbridge8 ($73.36 in chips) 
Seat 2: mycka86 ($100 in chips) 
Seat 4: matiko09 ($173.75 in chips) 
Seat 5: Jeckpot1989 ($88.73 in chips) 
Seat 6: 19R&J91 ($388.57 in chips) 
Seat 7: sebaaastian ($115.09 in chips) 
Seat 8: Monsthand ($110.73 in chips) 
Seat 9: Sweden_Pound ($107.69 in chips) 
stockbridge8: posts small blind $0.50
mycka86: posts big blind $1
xAndorx: sits out 
*** HOLE CARDS ***
Dealt to matiko09 [9c Th]
matiko09: folds 
Jeckpot1989: folds 
19R&J91: raises $4 to $5
sebaaastian: folds 
Monsthand: folds 
Sweden_Pound: folds 
stockbridge8: folds 
mycka86: folds 
Uncalled bet ($4) returned to 19R&J91
19R&J91 collected $2.50 from pot
19R&J91: doesn't show hand 
*** SUMMARY ***
Total pot $2.50 | Rake $0 
Seat 1: stockbridge8 (small blind) folded before Flop
Seat 2: mycka86 (big blind) folded before Flop
Seat 4: matiko09 folded before Flop (didn't bet)
Seat 5: Jeckpot1989 folded before Flop (didn't bet)
Seat 6: 19R&J91 collected ($2.50)
Seat 7: sebaaastian folded before Flop (didn't bet)
Seat 8: Monsthand folded before Flop (didn't bet)
Seat 9: Sweden_Pound (button) folded before Flop (didn't bet)





PokerStars Hand #149392227507:  Hold'em No Limit ($0.50/$1.00 USD) - 2016/02/25 16:44:37 CET [2016/02/25 10:44:37 ET]
Table 'Zeuxo II' 9-max Seat #2 is the button
Seat 1: forsmthgood ($100 in chips) 
Seat 2: Sweden_Pound ($102.25 in chips) 
Seat 3: xAndorx ($99.78 in chips) 
Seat 4: sebaaastian ($123.61 in chips) 
Seat 5: bauss84 ($30 in chips) 
Seat 6: Cogss ($98.21 in chips) 
Seat 7: djammusic ($45.50 in chips) 
Seat 8: matiko09 ($100 in chips) 
Seat 9: Sreshta222 ($219.60 in chips) 
xAndorx: posts small blind $0.50
sebaaastian: posts big blind $1
*** HOLE CARDS ***
Dealt to matiko09 [Kh 8d]
bauss84: calls $1
Cogss: calls $1
djammusic: folds 
matiko09: folds 
Sreshta222: folds 
forsmthgood: folds 
Sweden_Pound: folds 
xAndorx: calls $0.50
sebaaastian: checks 
*** FLOP *** [6c Qd 4h]
xAndorx: checks 
sebaaastian: checks 
bauss84: checks 
Cogss: bets $3.82
xAndorx: folds 
sebaaastian: folds 
bauss84: folds 
Uncalled bet ($3.82) returned to Cogss
Cogss collected $3.82 from pot
*** SUMMARY ***
Total pot $4 | Rake $0.18 
Board [6c Qd 4h]
Seat 1: forsmthgood folded before Flop (didn't bet)
Seat 2: Sweden_Pound (button) folded before Flop (didn't bet)
Seat 3: xAndorx (small blind) folded on the Flop
Seat 4: sebaaastian (big blind) folded on the Flop
Seat 5: bauss84 folded on the Flop
Seat 6: Cogss collected ($3.82)
Seat 7: djammusic folded before Flop (didn't bet)
Seat 8: matiko09 folded before Flop (didn't bet)
Seat 9: Sreshta222 folded before Flop (didn't bet)





PokerStars Hand #149392234301:  Hold'em No Limit ($0.50/$1.00 USD) - 2016/02/25 16:44:46 CET [2016/02/25 10:44:46 ET]
Table 'Morosovia II' 9-max Seat #4 is the button
Seat 1: apfush ($194.96 in chips) 
Seat 2: lysandrafly ($100 in chips) 
Seat 3: sebaaastian ($139.65 in chips) 
Seat 4: matiko09 ($167.35 in chips) 
Seat 5: pimpoza ($75.93 in chips) 
Seat 6: Sweden_Pound ($131.57 in chips) 
Seat 7: Ty Nick 420 ($169.69 in chips) 
Seat 8: Monsthand ($100.50 in chips) 
Seat 9: Ouga Buga ($122.54 in chips) 
pimpoza: posts small blind $0.50
Sweden_Pound: posts big blind $1
*** HOLE CARDS ***
Dealt to matiko09 [5s Ks]
Ty Nick 420: folds 
Monsthand: folds 
Ouga Buga: raises $1.50 to $2.50
apfush: folds 
lysandrafly: folds 
sebaaastian: folds 
matiko09: folds 
pimpoza: calls $2
Sweden_Pound: folds 
*** FLOP *** [4h 8h Kd]
pimpoza: checks 
Ouga Buga: bets $3.47
pimpoza: folds 
Uncalled bet ($3.47) returned to Ouga Buga
Ouga Buga collected $5.73 from pot
Ouga Buga: doesn't show hand 
*** SUMMARY ***
Total pot $6 | Rake $0.27 
Board [4h 8h Kd]
Seat 1: apfush folded before Flop (didn't bet)
Seat 2: lysandrafly folded before Flop (didn't bet)
Seat 3: sebaaastian folded before Flop (didn't bet)
Seat 4: matiko09 (button) folded before Flop (didn't bet)
Seat 5: pimpoza (small blind) folded on the Flop
Seat 6: Sweden_Pound (big blind) folded before Flop
Seat 7: Ty Nick 420 folded before Flop (didn't bet)
Seat 8: Monsthand folded before Flop (didn't bet)
Seat 9: Ouga Buga collected ($5.73)





PokerStars Hand #149392236509:  Hold'em No Limit ($0.50/$1.00 USD) - 2016/02/25 16:44:49 CET [2016/02/25 10:44:49 ET]
Table 'Badenia II' 9-max Seat #1 is the button
Seat 1: matiko09 ($101.50 in chips) 
Seat 2: Stibitzkie ($108.42 in chips) 
Seat 3: sebaaastian ($101.50 in chips) 
Seat 4: KarlMoik1 ($368.97 in chips) 
Seat 5: djammusic ($123.59 in chips) 
Seat 6: xAndorx ($103.21 in chips) 
Seat 7: forsmthgood ($100 in chips) 
Seat 8: Sweden_Pound ($128.92 in chips) 
Seat 9: waisanen ($114.42 in chips) 
Stibitzkie: posts small blind $0.50
sebaaastian: posts big blind $1
*** HOLE CARDS ***
Dealt to matiko09 [6h 4d]
KarlMoik1: folds 
djammusic: folds 
xAndorx: folds 
forsmthgood: raises $2 to $3
Sweden_Pound: folds 
waisanen: folds 
matiko09: folds 
Stibitzkie: raises $2 to $5
sebaaastian: folds 
forsmthgood: calls $2
*** FLOP *** [5d 6c Kh]
Stibitzkie: bets $10.50
forsmthgood: folds 
Uncalled bet ($10.50) returned to Stibitzkie
Stibitzkie collected $10.50 from pot
*** SUMMARY ***
Total pot $11 | Rake $0.50 
Board [5d 6c Kh]
Seat 1: matiko09 (button) folded before Flop (didn't bet)
Seat 2: Stibitzkie (small blind) collected ($10.50)
Seat 3: sebaaastian (big blind) folded before Flop
Seat 4: KarlMoik1 folded before Flop (didn't bet)
Seat 5: djammusic folded before Flop (didn't bet)
Seat 6: xAndorx folded before Flop (didn't bet)
Seat 7: forsmthgood folded on the Flop
Seat 8: Sweden_Pound folded before Flop (didn't bet)
Seat 9: waisanen folded before Flop (didn't bet)





PokerStars Hand #149392239998:  Hold'em No Limit ($0.50/$1.00 USD) - 2016/02/25 16:44:53 CET [2016/02/25 10:44:53 ET]
Table 'Lina II' 9-max Seat #3 is the button
Seat 1: Lesley2002 ($162.54 in chips) 
Seat 2: matiko09 ($112.79 in chips) 
Seat 3: Ouga Buga ($100 in chips) 
Seat 4: Nennenurse ($38.13 in chips) 
Seat 5: HomerrrJay ($100 in chips) 
Seat 6: sebaaastian ($149.62 in chips) 
Seat 7: Monsthand ($146.74 in chips) 
Seat 8: djammusic ($42.64 in chips) 
Seat 9: Sweden_Pound ($275.34 in chips) 
Nennenurse: posts small blind $0.50
HomerrrJay: posts big blind $1
*** HOLE CARDS ***
Dealt to matiko09 [Qh 8s]
sebaaastian: folds 
Monsthand: folds 
djammusic: folds 
Sweden_Pound: folds 
Lesley2002 has timed out
Lesley2002: folds 
matiko09: folds 
Ouga Buga: raises $1.50 to $2.50
Nennenurse: folds 
HomerrrJay: folds 
Uncalled bet ($1.50) returned to Ouga Buga
Ouga Buga collected $2.50 from pot
Ouga Buga: doesn't show hand 
*** SUMMARY ***
Total pot $2.50 | Rake $0 
Seat 1: Lesley2002 folded before Flop (didn't bet)
Seat 2: matiko09 folded before Flop (didn't bet)
Seat 3: Ouga Buga (button) collected ($2.50)
Seat 4: Nennenurse (small blind) folded before Flop
Seat 5: HomerrrJay (big blind) folded before Flop
Seat 6: sebaaastian folded before Flop (didn't bet)
Seat 7: Monsthand folded before Flop (didn't bet)
Seat 8: djammusic folded before Flop (didn't bet)
Seat 9: Sweden_Pound folded before Flop (didn't bet)





PokerStars Hand #149392241971:  Hold'em No Limit ($0.25/$0.50 USD) - 2016/02/25 16:44:56 CET [2016/02/25 10:44:56 ET]
Table 'Lohja II' 9-max Seat #8 is the button
Seat 1: MoonJimmy ($151.48 in chips) 
Seat 2: Apparat888 ($33.22 in chips) 
Seat 3: guvalc1952 ($144.19 in chips) 
Seat 5: vasiy379 ($50 in chips) 
Seat 7: matiko09 ($154.46 in chips) 
Seat 8: jamba83 ($60.57 in chips) 
Seat 9: Muinmyheart ($75.74 in chips) 
Muinmyheart: posts small blind $0.25
MoonJimmy: posts big blind $0.50
payback11: sits out 
JustR82: sits out 
MoonJimmy: posts the ante $0.10
Apparat888: posts the ante $0.10
guvalc1952: posts the ante $0.10
vasiy379: posts the ante $0.10
matiko09: posts the ante $0.10
jamba83: posts the ante $0.10
Muinmyheart: posts the ante $0.10
*** HOLE CARDS ***
Dealt to matiko09 [6c Qs]
Apparat888: folds 
guvalc1952: folds 
vasiy379: folds 
matiko09: folds 
jamba83: folds 
Muinmyheart: folds 
Uncalled bet ($0.25) returned to MoonJimmy
MoonJimmy collected $1.20 from pot
MoonJimmy: doesn't show hand 
*** SUMMARY ***
Total pot $1.20 | Rake $0 
Seat 1: MoonJimmy (big blind) collected ($1.20)
Seat 2: Apparat888 folded before Flop (didn't bet)
Seat 3: guvalc1952 folded before Flop (didn't bet)
Seat 5: vasiy379 folded before Flop (didn't bet)
Seat 7: matiko09 folded before Flop (didn't bet)
Seat 8: jamba83 (button) folded before Flop (didn't bet)
Seat 9: Muinmyheart (small blind) folded before Flop





PokerStars Hand #149392245128:  Hold'em No Limit ($0.50/$1.00 USD) - 2016/02/25 16:45:00 CET [2016/02/25 10:45:00 ET]
Table 'Isa' 9-max Seat #7 is the button
Seat 1: matiko09 ($130.44 in chips) 
Seat 2: Monsthand ($100 in chips) 
Seat 3: sebaaastian ($109.90 in chips) 
Seat 4: hammerwife ($110.50 in chips) 
Seat 5: Sweden_Pound ($103.05 in chips) 
Seat 6: xAndorx ($100 in chips) 
Seat 7: bilukm ($147.31 in chips) 
Seat 9: TideHan ($100 in chips) 
TideHan: posts small blind $0.50
matiko09: posts big blind $1
*** HOLE CARDS ***
Dealt to matiko09 [8s Ah]
Monsthand: folds 
sebaaastian: folds 
hammerwife: folds 
Sweden_Pound: folds 
xAndorx: raises $1.50 to $2.50
bilukm: calls $2.50
TideHan: folds 
matiko09: folds 
*** FLOP *** [3s Kc Qs]
xAndorx: checks 
bilukm: checks 
*** TURN *** [3s Kc Qs] [Js]
xAndorx: checks 
bilukm: bets $3.10
xAndorx: folds 
Uncalled bet ($3.10) returned to bilukm
bilukm collected $6.21 from pot
bilukm: doesn't show hand 
*** SUMMARY ***
Total pot $6.50 | Rake $0.29 
Board [3s Kc Qs Js]
Seat 1: matiko09 (big blind) folded before Flop
Seat 2: Monsthand folded before Flop (didn't bet)
Seat 3: sebaaastian folded before Flop (didn't bet)
Seat 4: hammerwife folded before Flop (didn't bet)
Seat 5: Sweden_Pound folded before Flop (didn't bet)
Seat 6: xAndorx folded on the Turn
Seat 7: bilukm (button) collected ($6.21)
Seat 9: TideHan (small blind) folded before Flop





PokerStars Hand #149392252056:  Hold'em No Limit ($0.50/$1.00 USD) - 2016/02/25 16:45:09 CET [2016/02/25 10:45:09 ET]
Table 'Guisan' 9-max Seat #1 is the button
Seat 1: stockbridge8 ($72.86 in chips) 
Seat 2: mycka86 ($100 in chips) 
Seat 3: xAndorx ($121.12 in chips) 
Seat 4: matiko09 ($173.75 in chips) 
Seat 5: Jeckpot1989 ($88.73 in chips) 
Seat 6: 19R&J91 ($390.07 in chips) 
Seat 7: sebaaastian ($115.09 in chips) 
Seat 8: Monsthand ($110.73 in chips) 
Seat 9: Sweden_Pound ($107.69 in chips) 
mycka86: posts small blind $0.50
xAndorx: posts big blind $1
*** HOLE CARDS ***
Dealt to matiko09 [Ah Qh]
matiko09: raises $2 to $3
Jeckpot1989: raises $7.50 to $10.50
19R&J91: folds 
sebaaastian: folds 
Monsthand: folds 
Sweden_Pound: folds 
stockbridge8: folds 
mycka86: folds 
xAndorx: folds 
matiko09: folds 
Uncalled bet ($7.50) returned to Jeckpot1989
Jeckpot1989 collected $7.50 from pot
Jeckpot1989: doesn't show hand 
*** SUMMARY ***
Total pot $7.50 | Rake $0 
Seat 1: stockbridge8 (button) folded before Flop (didn't bet)
Seat 2: mycka86 (small blind) folded before Flop
Seat 3: xAndorx (big blind) folded before Flop
Seat 4: matiko09 folded before Flop
Seat 5: Jeckpot1989 collected ($7.50)
Seat 6: 19R&J91 folded before Flop (didn't bet)
Seat 7: sebaaastian folded before Flop (didn't bet)
Seat 8: Monsthand folded before Flop (didn't bet)
Seat 9: Sweden_Pound folded before Flop (didn't bet)





PokerStars Hand #149392257875:  Hold'em No Limit ($0.25/$0.50 USD) - 2016/02/25 16:45:17 CET [2016/02/25 10:45:17 ET]
Table 'Lohja II' 9-max Seat #9 is the button
Seat 1: MoonJimmy ($152.33 in chips) 
Seat 2: Apparat888 ($33.12 in chips) 
Seat 3: guvalc1952 ($144.09 in chips) 
Seat 5: vasiy379 ($50 in chips) 
Seat 7: matiko09 ($154.36 in chips) 
Seat 8: jamba83 ($60.47 in chips) 
Seat 9: Muinmyheart ($75.39 in chips) 
MoonJimmy: posts small blind $0.25
Apparat888: posts big blind $0.50
payback11: sits out 
JustR82: sits out 
MoonJimmy: posts the ante $0.10
Apparat888: posts the ante $0.10
guvalc1952: posts the ante $0.10
vasiy379: posts the ante $0.10
matiko09: posts the ante $0.10
jamba83: posts the ante $0.10
Muinmyheart: posts the ante $0.10
*** HOLE CARDS ***
Dealt to matiko09 [Kc Th]
guvalc1952: calls $0.50
vasiy379: folds 
matiko09: raises $2 to $2.50
jamba83: folds 
Muinmyheart: folds 
MoonJimmy: folds 
Apparat888: folds 
guvalc1952: calls $2
*** FLOP *** [Ah 5s Jc]
guvalc1952: checks 
matiko09: bets $4
guvalc1952: calls $4
*** TURN *** [Ah 5s Jc] [5c]
guvalc1952: checks 
matiko09: checks 
*** RIVER *** [Ah 5s Jc 5c] [2h]
guvalc1952: checks 
matiko09: checks 
*** SHOW DOWN ***
guvalc1952: shows [Js Qd] (two pair, Jacks and Fives)
matiko09: mucks hand 
guvalc1952 collected $13.80 from pot
*** SUMMARY ***
Total pot $14.45 | Rake $0.65 
Board [Ah 5s Jc 5c 2h]
Seat 1: MoonJimmy (small blind) folded before Flop
Seat 2: Apparat888 (big blind) folded before Flop
Seat 3: guvalc1952 showed [Js Qd] and won ($13.80) with two pair, Jacks and Fives
Seat 5: vasiy379 folded before Flop (didn't bet)
Seat 7: matiko09 mucked [Kc Th]
Seat 8: jamba83 folded before Flop (didn't bet)
Seat 9: Muinmyheart (button) folded before Flop (didn't bet)





PokerStars Hand #149392268132:  Hold'em No Limit (€0.25/€0.50 EUR) - 2016/02/25 16:45:30 CET [2016/02/25 10:45:30 ET]
Table 'Leo Minor III' 9-max Seat #6 is the button
Seat 1: Al3xAnd3r22 (€80.01 in chips) 
Seat 2: vasiy379 (€52.25 in chips) 
Seat 3: Rorerzap (€62 in chips) 
Seat 4: RvPersie (€71.56 in chips) 
Seat 5: kasse_62 (€19.67 in chips) 
Seat 6: Wwwasian (€52.54 in chips) 
Seat 7: JustR82 (€50.25 in chips) 
Seat 9: matiko09 (€50 in chips) 
JustR82: posts small blind €0.25
mi$$I$Elena: is sitting out 
matiko09: posts big blind €0.50
*** HOLE CARDS ***
Dealt to matiko09 [Ah 2d]
mi$$I$Elena leaves the table
Bron By joins the table at seat #8 
Al3xAnd3r22: folds 
vasiy379: folds 
Rorerzap: folds 
RvPersie: folds 
kasse_62: folds 
Wwwasian: folds 
JustR82: folds 
Uncalled bet (€0.25) returned to matiko09
matiko09 collected €0.50 from pot
matiko09: doesn't show hand 
*** SUMMARY ***
Total pot €0.50 | Rake €0 
Seat 1: Al3xAnd3r22 folded before Flop (didn't bet)
Seat 2: vasiy379 folded before Flop (didn't bet)
Seat 3: Rorerzap folded before Flop (didn't bet)
Seat 4: RvPersie folded before Flop (didn't bet)
Seat 5: kasse_62 folded before Flop (didn't bet)
Seat 6: Wwwasian (button) folded before Flop (didn't bet)
Seat 7: JustR82 (small blind) folded before Flop
Seat 9: matiko09 (big blind) collected (€0.50)





PokerStars Hand #149392271685:  Hold'em No Limit ($0.50/$1.00 USD) - 2016/02/25 16:45:35 CET [2016/02/25 10:45:35 ET]
Table 'Morosovia II' 9-max Seat #5 is the button
Seat 1: apfush ($194.96 in chips) 
Seat 2: lysandrafly ($100 in chips) 
Seat 3: sebaaastian ($139.65 in chips) 
Seat 4: matiko09 ($167.35 in chips) 
Seat 5: pimpoza ($73.43 in chips) 
Seat 6: Sweden_Pound ($130.57 in chips) 
Seat 7: Ty Nick 420 ($169.69 in chips) 
Seat 8: Monsthand ($100.50 in chips) 
Seat 9: Ouga Buga ($125.77 in chips) 
Sweden_Pound: posts small blind $0.50
Ty Nick 420: posts big blind $1
*** HOLE CARDS ***
Dealt to matiko09 [Kd 6h]
Monsthand: folds 
Ouga Buga: folds 
apfush: folds 
lysandrafly: folds 
sebaaastian: folds 
matiko09: folds 
pimpoza: folds 
Sweden_Pound: folds 
Uncalled bet ($0.50) returned to Ty Nick 420
Ty Nick 420 collected $1 from pot
*** SUMMARY ***
Total pot $1 | Rake $0 
Seat 1: apfush folded before Flop (didn't bet)
Seat 2: lysandrafly folded before Flop (didn't bet)
Seat 3: sebaaastian folded before Flop (didn't bet)
Seat 4: matiko09 folded before Flop (didn't bet)
Seat 5: pimpoza (button) folded before Flop (didn't bet)
Seat 6: Sweden_Pound (small blind) folded before Flop
Seat 7: Ty Nick 420 (big blind) collected ($1)
Seat 8: Monsthand folded before Flop (didn't bet)
Seat 9: Ouga Buga folded before Flop (didn't bet)





PokerStars Hand #149392272593:  Hold'em No Limit ($0.50/$1.00 USD) - 2016/02/25 16:45:36 CET [2016/02/25 10:45:36 ET]
Table 'Hercules IV' 9-max Seat #6 is the button
Seat 1: matiko09 ($100 in chips) 
Seat 2: hammerwife ($100 in chips) 
Seat 3: sebaaastian ($201.70 in chips) 
Seat 4: Sweden_Pound ($110 in chips) 
Seat 5: xAndorx ($156.96 in chips) 
Seat 6: kuanhung0903 ($65.10 in chips) 
Seat 7: Ouga Buga ($100 in chips) 
Seat 8: brokat77 ($109.15 in chips) 
Seat 9: djammusic ($38.70 in chips) 
Ouga Buga: posts small blind $0.50
brokat77: posts big blind $1
*** HOLE CARDS ***
Dealt to matiko09 [3d Jd]
djammusic: folds 
matiko09: folds 
hammerwife: raises $2 to $3
sebaaastian: folds 
Sweden_Pound: folds 
xAndorx: folds 
kuanhung0903: folds 
Ouga Buga: folds 
brokat77: calls $2
*** FLOP *** [Qs Tc 8d]
brokat77: checks 
hammerwife: bets $3.50
brokat77: calls $3.50
*** TURN *** [Qs Tc 8d] [9h]
brokat77: checks 
hammerwife: checks 
*** RIVER *** [Qs Tc 8d 9h] [9d]
brokat77: bets $8
hammerwife: folds 
Uncalled bet ($8) returned to brokat77
brokat77 collected $12.89 from pot
brokat77: doesn't show hand 
*** SUMMARY ***
Total pot $13.50 | Rake $0.61 
Board [Qs Tc 8d 9h 9d]
Seat 1: matiko09 folded before Flop (didn't bet)
Seat 2: hammerwife folded on the River
Seat 3: sebaaastian folded before Flop (didn't bet)
Seat 4: Sweden_Pound folded before Flop (didn't bet)
Seat 5: xAndorx folded before Flop (didn't bet)
Seat 6: kuanhung0903 (button) folded before Flop (didn't bet)
Seat 7: Ouga Buga (small blind) folded before Flop
Seat 8: brokat77 (big blind) collected ($12.89)
Seat 9: djammusic folded before Flop (didn't bet)





PokerStars Hand #149392275247:  Hold'em No Limit ($0.50/$1.00 USD) - 2016/02/25 16:45:40 CET [2016/02/25 10:45:40 ET]
Table 'Lina II' 9-max Seat #4 is the button
Seat 1: Lesley2002 ($162.54 in chips) 
Seat 2: matiko09 ($112.79 in chips) 
Seat 3: Ouga Buga ($101.50 in chips) 
Seat 4: Nennenurse ($37.63 in chips) 
Seat 5: HomerrrJay ($100 in chips) 
Seat 6: sebaaastian ($149.62 in chips) 
Seat 7: Monsthand ($146.74 in chips) 
Seat 8: djammusic ($42.64 in chips) 
Seat 9: Sweden_Pound ($275.34 in chips) 
HomerrrJay: posts small blind $0.50
sebaaastian: posts big blind $1
*** HOLE CARDS ***
Dealt to matiko09 [9s 5h]
Monsthand: folds 
djammusic: folds 
Sweden_Pound: folds 
Lesley2002: folds 
matiko09: folds 
Ouga Buga: folds 
Nennenurse: folds 
HomerrrJay: folds 
Uncalled bet ($0.50) returned to sebaaastian
sebaaastian collected $1 from pot
sebaaastian: doesn't show hand 
*** SUMMARY ***
Total pot $1 | Rake $0 
Seat 1: Lesley2002 folded before Flop (didn't bet)
Seat 2: matiko09 folded before Flop (didn't bet)
Seat 3: Ouga Buga folded before Flop (didn't bet)
Seat 4: Nennenurse (button) folded before Flop (didn't bet)
Seat 5: HomerrrJay (small blind) folded before Flop
Seat 6: sebaaastian (big blind) collected ($1)
Seat 7: Monsthand folded before Flop (didn't bet)
Seat 8: djammusic folded before Flop (didn't bet)
Seat 9: Sweden_Pound folded before Flop (didn't bet)





PokerStars Hand #149392276073:  Hold'em No Limit ($0.50/$1.00 USD) - 2016/02/25 16:45:41 CET [2016/02/25 10:45:41 ET]
Table 'Badenia II' 9-max Seat #2 is the button
Seat 1: matiko09 ($101.50 in chips) 
Seat 2: Stibitzkie ($113.92 in chips) 
Seat 3: sebaaastian ($100.50 in chips) 
Seat 4: KarlMoik1 ($368.97 in chips) 
Seat 5: djammusic ($123.59 in chips) 
Seat 6: xAndorx ($103.21 in chips) 
Seat 7: forsmthgood ($100 in chips) 
Seat 8: Sweden_Pound ($128.92 in chips) 
Seat 9: waisanen ($114.42 in chips) 
sebaaastian: posts small blind $0.50
KarlMoik1: posts big blind $1
*** HOLE CARDS ***
Dealt to matiko09 [3s 8s]
djammusic: folds 
xAndorx: folds 
forsmthgood: folds 
Sweden_Pound: folds 
waisanen: calls $1
matiko09: folds 
Stibitzkie: raises $3.50 to $4.50
sebaaastian: folds 
KarlMoik1: calls $3.50
waisanen: folds 
*** FLOP *** [7c Qd Td]
KarlMoik1: checks 
Stibitzkie: bets $10.03
KarlMoik1: calls $10.03
*** TURN *** [7c Qd Td] [4s]
KarlMoik1: checks 
Stibitzkie: bets $99.39 and is all-in
KarlMoik1: folds 
Uncalled bet ($99.39) returned to Stibitzkie
Stibitzkie collected $29.18 from pot
*** SUMMARY ***
Total pot $30.56 | Rake $1.38 
Board [7c Qd Td 4s]
Seat 1: matiko09 folded before Flop (didn't bet)
Seat 2: Stibitzkie (button) collected ($29.18)
Seat 3: sebaaastian (small blind) folded before Flop
Seat 4: KarlMoik1 (big blind) folded on the Turn
Seat 5: djammusic folded before Flop (didn't bet)
Seat 6: xAndorx folded before Flop (didn't bet)
Seat 7: forsmthgood folded before Flop (didn't bet)
Seat 8: Sweden_Pound folded before Flop (didn't bet)
Seat 9: waisanen folded before Flop





PokerStars Hand #149392277490:  Hold'em No Limit ($0.50/$1.00 USD) - 2016/02/25 16:45:42 CET [2016/02/25 10:45:42 ET]
Table 'Isa' 9-max Seat #9 is the button
Seat 1: matiko09 ($129.44 in chips) 
Seat 2: Monsthand ($100 in chips) 
Seat 3: sebaaastian ($109.90 in chips) 
Seat 4: hammerwife ($110.50 in chips) 
Seat 5: Sweden_Pound ($103.05 in chips) 
Seat 6: xAndorx ($97.50 in chips) 
Seat 7: bilukm ($151.02 in chips) 
Seat 9: TideHan ($100 in chips) 
matiko09: posts small blind $0.50
Monsthand: posts big blind $1
*** HOLE CARDS ***
Dealt to matiko09 [7d 8d]
sebaaastian: folds 
hammerwife: folds 
Sweden_Pound: folds 
kvkpro leaves the table
xAndorx: folds 
bilukm: folds 
TideHan: raises $1.25 to $2.25
Venomous100% joins the table at seat #8 
matiko09: raises $6.75 to $9
Monsthand: folds 
TideHan: raises $13 to $22
matiko09: folds 
Uncalled bet ($13) returned to TideHan
TideHan collected $19 from pot
TideHan: doesn't show hand 
*** SUMMARY ***
Total pot $19 | Rake $0 
Seat 1: matiko09 (small blind) folded before Flop
Seat 2: Monsthand (big blind) folded before Flop
Seat 3: sebaaastian folded before Flop (didn't bet)
Seat 4: hammerwife folded before Flop (didn't bet)
Seat 5: Sweden_Pound folded before Flop (didn't bet)
Seat 6: xAndorx folded before Flop (didn't bet)
Seat 7: bilukm folded before Flop (didn't bet)
Seat 9: TideHan (button) collected ($19)





PokerStars Hand #149392282403:  Hold'em No Limit ($0.50/$1.00 USD) - 2016/02/25 16:45:49 CET [2016/02/25 10:45:49 ET]
Table 'Zeuxo II' 9-max Seat #3 is the button
Seat 1: forsmthgood ($100 in chips) 
Seat 2: Sweden_Pound ($102.25 in chips) 
Seat 3: xAndorx ($98.78 in chips) 
Seat 4: sebaaastian ($122.61 in chips) 
Seat 5: bauss84 ($29 in chips) 
Seat 6: Cogss ($101.03 in chips) 
Seat 7: djammusic ($45.50 in chips) 
Seat 8: matiko09 ($100 in chips) 
Seat 9: Sreshta222 ($219.60 in chips) 
sebaaastian: posts small blind $0.50
bauss84: posts big blind $1
*** HOLE CARDS ***
Dealt to matiko09 [4d Th]
Cogss: raises $1 to $2
djammusic: folds 
matiko09: folds 
Sreshta222: folds 
forsmthgood: folds 
Sweden_Pound: folds 
xAndorx: calls $2
sebaaastian: folds 
bauss84: calls $1
*** FLOP *** [Ts 2c 4s]
bauss84: checks 
Cogss: bets $6.21
xAndorx: folds 
bauss84: folds 
Uncalled bet ($6.21) returned to Cogss
Cogss collected $6.21 from pot
*** SUMMARY ***
Total pot $6.50 | Rake $0.29 
Board [Ts 2c 4s]
Seat 1: forsmthgood folded before Flop (didn't bet)
Seat 2: Sweden_Pound folded before Flop (didn't bet)
Seat 3: xAndorx (button) folded on the Flop
Seat 4: sebaaastian (small blind) folded before Flop
Seat 5: bauss84 (big blind) folded on the Flop
Seat 6: Cogss collected ($6.21)
Seat 7: djammusic folded before Flop (didn't bet)
Seat 8: matiko09 folded before Flop (didn't bet)
Seat 9: Sreshta222 folded before Flop (didn't bet)





PokerStars Hand #149392284681:  Hold'em No Limit ($0.25/$0.50 USD) - 2016/02/25 16:45:52 CET [2016/02/25 10:45:52 ET]
Table 'Thalpius III' 9-max Seat #8 is the button
Seat 1: BrotherLove9 ($52.85 in chips) 
Seat 2: matiko09 ($56.54 in chips) 
Seat 3: jamba83 ($52.31 in chips) 
Seat 4: Wwwasian ($50.76 in chips) 
Seat 5: Rorerzap ($57.77 in chips) 
Seat 6: ihami ($52.25 in chips) 
Seat 7: v4n0v ($50 in chips) 
Seat 8: jeroemie123 ($31.37 in chips) 
Seat 9: Domotirko228 ($50 in chips) 
Domotirko228: posts small blind $0.25
BrotherLove9: posts big blind $0.50
*** HOLE CARDS ***
Dealt to matiko09 [Ad 7d]
matiko09: folds 
jamba83: folds 
Wwwasian: folds 
Rorerzap: raises $1 to $1.50
ihami: folds 
v4n0v: folds 
jeroemie123: calls $1.50
Domotirko228: calls $1.25
BrotherLove9: calls $1
*** FLOP *** [Th 7s 2h]
Domotirko228: checks 
BrotherLove9: checks 
Rorerzap: checks 
jeroemie123: checks 
*** TURN *** [Th 7s 2h] [3h]
Domotirko228: checks 
BrotherLove9: bets $3.83
Rorerzap: folds 
jeroemie123: calls $3.83
Domotirko228: folds 
*** RIVER *** [Th 7s 2h 3h] [Kc]
BrotherLove9: bets $19.57
jeroemie123: folds 
Uncalled bet ($19.57) returned to BrotherLove9
BrotherLove9 collected $13.05 from pot
BrotherLove9: doesn't show hand 
*** SUMMARY ***
Total pot $13.66 | Rake $0.61 
Board [Th 7s 2h 3h Kc]
Seat 1: BrotherLove9 (big blind) collected ($13.05)
Seat 2: matiko09 folded before Flop (didn't bet)
Seat 3: jamba83 folded before Flop (didn't bet)
Seat 4: Wwwasian folded before Flop (didn't bet)
Seat 5: Rorerzap folded on the Turn
Seat 6: ihami folded before Flop (didn't bet)
Seat 7: v4n0v folded before Flop (didn't bet)
Seat 8: jeroemie123 (button) folded on the River
Seat 9: Domotirko228 (small blind) folded on the Turn





PokerStars Hand #149392285854:  Hold'em No Limit ($0.50/$1.00 USD) - 2016/02/25 16:45:54 CET [2016/02/25 10:45:54 ET]
Table 'Simona' 9-max Seat #8 is the button
Seat 1: mycka86 ($136.94 in chips) 
Seat 2: xAndorx ($112.24 in chips) 
Seat 3: Sweden_Pound ($115.49 in chips) 
Seat 4: matiko09 ($274.92 in chips) 
Seat 5: sebaaastian ($105.21 in chips) 
Seat 6: Ty Nick 420 ($100.50 in chips) 
Seat 8: Monsthand ($134.97 in chips) 
Slushpup69 will be allowed to play after the button
mycka86: posts small blind $0.50
xAndorx: posts big blind $1
hammerwife: sits out 
*** HOLE CARDS ***
Dealt to matiko09 [3c 4s]
Sweden_Pound: folds 
matiko09: folds 
sebaaastian: folds 
Ty Nick 420: raises $1.50 to $2.50
Monsthand: folds 
mycka86: folds 
xAndorx: calls $1.50
*** FLOP *** [Qc 2s 7h]
xAndorx: checks 
Ty Nick 420: bets $3
xAndorx: calls $3
*** TURN *** [Qc 2s 7h] [8c]
xAndorx: checks 
Ty Nick 420: bets $7.50
xAndorx: calls $7.50
*** RIVER *** [Qc 2s 7h 8c] [6c]
xAndorx: checks 
Ty Nick 420: bets $17.50
xAndorx: calls $17.50
*** SHOW DOWN ***
Ty Nick 420: shows [Jh Th] (high card Queen)
xAndorx: shows [Qs Ad] (a pair of Queens)
xAndorx collected $58.73 from pot
*** SUMMARY ***
Total pot $61.50 | Rake $2.77 
Board [Qc 2s 7h 8c 6c]
Seat 1: mycka86 (small blind) folded before Flop
Seat 2: xAndorx (big blind) showed [Qs Ad] and won ($58.73) with a pair of Queens
Seat 3: Sweden_Pound folded before Flop (didn't bet)
Seat 4: matiko09 folded before Flop (didn't bet)
Seat 5: sebaaastian folded before Flop (didn't bet)
Seat 6: Ty Nick 420 showed [Jh Th] and lost with high card Queen
Seat 8: Monsthand (button) folded before Flop (didn't bet)





PokerStars Hand #149392286792:  Hold'em No Limit ($0.50/$1.00 USD) - 2016/02/25 16:45:55 CET [2016/02/25 10:45:55 ET]
Table 'Morosovia II' 9-max Seat #6 is the button
Seat 1: apfush ($194.96 in chips) 
Seat 2: lysandrafly ($100 in chips) 
Seat 3: sebaaastian ($139.65 in chips) 
Seat 4: matiko09 ($167.35 in chips) 
Seat 5: pimpoza ($73.43 in chips) 
Seat 6: Sweden_Pound ($130.07 in chips) 
Seat 7: Ty Nick 420 ($170.19 in chips) 
Seat 8: Monsthand ($100.50 in chips) 
Seat 9: Ouga Buga ($125.77 in chips) 
Ty Nick 420: posts small blind $0.50
Monsthand: posts big blind $1
*** HOLE CARDS ***
Dealt to matiko09 [8c 9d]
Ouga Buga: folds 
apfush: folds 
lysandrafly: folds 
sebaaastian: raises $2 to $3
matiko09: folds 
pimpoza: calls $3
Sweden_Pound: folds 
Ty Nick 420: folds 
Monsthand: raises $10.25 to $13.25
sebaaastian: calls $10.25
pimpoza: calls $10.25
*** FLOP *** [9c 5s Tc]
Monsthand: checks 
sebaaastian: bets $22
pimpoza: calls $22
Monsthand: folds 
*** TURN *** [9c 5s Tc] [3s]
sebaaastian: bets $42
pimpoza: calls $38.18 and is all-in
Uncalled bet ($3.82) returned to sebaaastian
*** RIVER *** [9c 5s Tc 3s] [9s]
*** SHOW DOWN ***
sebaaastian: shows [Jc Jh] (two pair, Jacks and Nines)
pimpoza: shows [Td Ad] (two pair, Tens and Nines)
sebaaastian collected $157.81 from pot
*** SUMMARY ***
Total pot $160.61 | Rake $2.80 
Board [9c 5s Tc 3s 9s]
Seat 1: apfush folded before Flop (didn't bet)
Seat 2: lysandrafly folded before Flop (didn't bet)
Seat 3: sebaaastian showed [Jc Jh] and won ($157.81) with two pair, Jacks and Nines
Seat 4: matiko09 folded before Flop (didn't bet)
Seat 5: pimpoza showed [Td Ad] and lost with two pair, Tens and Nines
Seat 6: Sweden_Pound (button) folded before Flop (didn't bet)
Seat 7: Ty Nick 420 (small blind) folded before Flop
Seat 8: Monsthand (big blind) folded on the Flop
Seat 9: Ouga Buga folded before Flop (didn't bet)





PokerStars Hand #149392286731:  Hold'em No Limit ($0.50/$1.00 USD) - 2016/02/25 16:45:55 CET [2016/02/25 10:45:55 ET]
Table 'Lucia III' 9-max Seat #9 is the button
Seat 1: Monsthand ($120.25 in chips) 
Seat 2: kuanhung0903 ($75 in chips) 
Seat 3: mycka86 ($122.07 in chips) 
Seat 5: Sweden_Pound ($222.93 in chips) 
Seat 6: matiko09 ($100 in chips) 
Seat 7: Ty Nick 420 ($319.77 in chips) 
Seat 8: apfush ($109.60 in chips) 
Seat 9: Apparat888 ($32.95 in chips) 
Monsthand: posts small blind $0.50
kuanhung0903: posts big blind $1
xAndorx: sits out 
*** HOLE CARDS ***
Dealt to matiko09 [Th Td]
mycka86: folds 
Sweden_Pound: folds 
matiko09: raises $2 to $3
Ty Nick 420: folds 
apfush: raises $6 to $9
Apparat888: folds 
Monsthand: folds 
kuanhung0903: folds 
matiko09: calls $6
*** FLOP *** [4c Kh 4d]
matiko09: checks 
apfush: checks 
*** TURN *** [4c Kh 4d] [4s]
matiko09: checks 
apfush: bets $9
matiko09: folds 
Uncalled bet ($9) returned to apfush
apfush collected $18.62 from pot
apfush: doesn't show hand 
*** SUMMARY ***
Total pot $19.50 | Rake $0.88 
Board [4c Kh 4d 4s]
Seat 1: Monsthand (small blind) folded before Flop
Seat 2: kuanhung0903 (big blind) folded before Flop
Seat 3: mycka86 folded before Flop (didn't bet)
Seat 5: Sweden_Pound folded before Flop (didn't bet)
Seat 6: matiko09 folded on the Turn
Seat 7: Ty Nick 420 folded before Flop (didn't bet)
Seat 8: apfush collected ($18.62)
Seat 9: Apparat888 (button) folded before Flop (didn't bet)





PokerStars Hand #149392291001:  Hold'em No Limit ($0.50/$1.00 USD) - 2016/02/25 16:46:00 CET [2016/02/25 10:46:00 ET]
Table 'Guisan' 9-max Seat #2 is the button
Seat 1: stockbridge8 ($72.86 in chips) 
Seat 2: mycka86 ($100 in chips) 
Seat 3: xAndorx ($120.12 in chips) 
Seat 4: matiko09 ($170.75 in chips) 
Seat 5: Jeckpot1989 ($93.23 in chips) 
Seat 6: 19R&J91 ($390.07 in chips) 
Seat 7: sebaaastian ($115.09 in chips) 
Seat 8: Monsthand ($110.73 in chips) 
Seat 9: Sweden_Pound ($107.69 in chips) 
xAndorx: posts small blind $0.50
matiko09: posts big blind $1
*** HOLE CARDS ***
Dealt to matiko09 [5d 4d]
Jeckpot1989: folds 
19R&J91: folds 
sebaaastian: raises $2 to $3
Monsthand: folds 
Sweden_Pound: folds 
stockbridge8: folds 
mycka86: folds 
xAndorx: folds 
matiko09: folds 
Uncalled bet ($2) returned to sebaaastian
sebaaastian collected $2.50 from pot
sebaaastian: doesn't show hand 
*** SUMMARY ***
Total pot $2.50 | Rake $0 
Seat 1: stockbridge8 folded before Flop (didn't bet)
Seat 2: mycka86 (button) folded before Flop (didn't bet)
Seat 3: xAndorx (small blind) folded before Flop
Seat 4: matiko09 (big blind) folded before Flop
Seat 5: Jeckpot1989 folded before Flop (didn't bet)
Seat 6: 19R&J91 folded before Flop (didn't bet)
Seat 7: sebaaastian collected ($2.50)
Seat 8: Monsthand folded before Flop (didn't bet)
Seat 9: Sweden_Pound folded before Flop (didn't bet)





PokerStars Hand #149392293237:  Hold'em No Limit ($0.25/$0.50 USD) - 2016/02/25 16:46:03 CET [2016/02/25 10:46:03 ET]
Table 'Ophiuchus III' 9-max Seat #6 is the button
Seat 1: RvPersie ($100.69 in chips) 
Seat 2: ihami ($48.50 in chips) 
Seat 3: rdrill ($62.97 in chips) 
Seat 5: ReneProost ($32.95 in chips) 
Seat 6: Muinmyheart ($50 in chips) 
Seat 7: Rorerzap ($54.45 in chips) 
Seat 8: matiko09 ($50 in chips) 
Seat 9: tugboat2008 ($81.52 in chips) 
Rorerzap: posts small blind $0.25
matiko09: posts big blind $0.50
lucima10: sits out 
*** HOLE CARDS ***
Dealt to matiko09 [Qc 8c]
tugboat2008: folds 
RvPersie: folds 
ihami: folds 
rdrill: folds 
ReneProost: calls $0.50
Muinmyheart: folds 
Rorerzap: folds 
matiko09: checks 
*** FLOP *** [9h 4s 4h]
matiko09: checks 
ReneProost: bets $0.50
matiko09: folds 
Uncalled bet ($0.50) returned to ReneProost
ReneProost collected $1.19 from pot
*** SUMMARY ***
Total pot $1.25 | Rake $0.06 
Board [9h 4s 4h]
Seat 1: RvPersie folded before Flop (didn't bet)
Seat 2: ihami folded before Flop (didn't bet)
Seat 3: rdrill folded before Flop (didn't bet)
Seat 5: ReneProost collected ($1.19)
Seat 6: Muinmyheart (button) folded before Flop (didn't bet)
Seat 7: Rorerzap (small blind) folded before Flop
Seat 8: matiko09 (big blind) folded on the Flop
Seat 9: tugboat2008 folded before Flop (didn't bet)





PokerStars Hand #149392296005:  Hold'em No Limit (€0.25/€0.50 EUR) - 2016/02/25 16:46:07 CET [2016/02/25 10:46:07 ET]
Table 'Leo Minor III' 9-max Seat #7 is the button
Seat 1: Al3xAnd3r22 (€80.01 in chips) 
Seat 2: vasiy379 (€52.25 in chips) 
Seat 3: Rorerzap (€62 in chips) 
Seat 4: RvPersie (€71.56 in chips) 
Seat 5: kasse_62 (€19.67 in chips) 
Seat 6: Wwwasian (€52.54 in chips) 
Seat 7: JustR82 (€50 in chips) 
Seat 9: matiko09 (€50.25 in chips) 
Bron By will be allowed to play after the button
matiko09: posts small blind €0.25
Al3xAnd3r22: posts big blind €0.50
*** HOLE CARDS ***
Dealt to matiko09 [Qd Js]
vasiy379: raises €1 to €1.50
Rorerzap: calls €1.50
RvPersie: folds 
kasse_62: calls €1.50
Wwwasian: folds 
JustR82: calls €1.50
matiko09: folds 
Al3xAnd3r22: folds 
*** FLOP *** [Kh 8s Ad]
vasiy379: checks 
Rorerzap: checks 
kasse_62: bets €18.17 and is all-in
JustR82: folds 
vasiy379: folds 
Rorerzap: folds 
Uncalled bet (€18.17) returned to kasse_62
kasse_62 collected €6.45 from pot
kasse_62: doesn't show hand 
*** SUMMARY ***
Total pot €6.75 | Rake €0.30 
Board [Kh 8s Ad]
Seat 1: Al3xAnd3r22 (big blind) folded before Flop
Seat 2: vasiy379 folded on the Flop
Seat 3: Rorerzap folded on the Flop
Seat 4: RvPersie folded before Flop (didn't bet)
Seat 5: kasse_62 collected (€6.45)
Seat 6: Wwwasian folded before Flop (didn't bet)
Seat 7: JustR82 (button) folded on the Flop
Seat 9: matiko09 (small blind) folded before Flop





PokerStars Hand #149392298929:  Hold'em No Limit ($0.50/$1.00 USD) - 2016/02/25 16:46:11 CET [2016/02/25 10:46:11 ET]
Table 'Ebella II' 9-max Seat #5 is the button
Seat 1: Ilov3NBA ($100 in chips) 
Seat 2: Sweden_Pound ($100 in chips) 
Seat 3: Lahesell ($100 in chips) 
Seat 4: CoolestWitch ($100 in chips) 
Seat 5: matiko09 ($100 in chips) 
Seat 6: RMilPoker ($100 in chips) 
Seat 7: HomerrrJay ($100 in chips) 
Seat 8: ZMPOUTSAM140 ($40 in chips) 
Seat 9: simoniustin ($100 in chips) 
RMilPoker: posts small blind $0.50
HomerrrJay: posts big blind $1
*** HOLE CARDS ***
Dealt to matiko09 [4h Ks]
ZMPOUTSAM140: folds 
simoniustin: folds 
Ilov3NBA: folds 
Sweden_Pound: folds 
Lahesell: folds 
CoolestWitch: raises $2 to $3
matiko09: folds 
RMilPoker: raises $7 to $10
HomerrrJay: folds 
CoolestWitch: raises $21 to $31
RMilPoker: raises $69 to $100 and is all-in
CoolestWitch: calls $69 and is all-in
*** FLOP *** [As Tc Qc]
*** TURN *** [As Tc Qc] [2d]
*** RIVER *** [As Tc Qc 2d] [3s]
*** SHOW DOWN ***
RMilPoker: shows [Ac Ah] (three of a kind, Aces)
CoolestWitch: shows [Kc Kh] (a pair of Kings)
RMilPoker collected $198.20 from pot
*** SUMMARY ***
Total pot $201 | Rake $2.80 
Board [As Tc Qc 2d 3s]
Seat 1: Ilov3NBA folded before Flop (didn't bet)
Seat 2: Sweden_Pound folded before Flop (didn't bet)
Seat 3: Lahesell folded before Flop (didn't bet)
Seat 4: CoolestWitch showed [Kc Kh] and lost with a pair of Kings
Seat 5: matiko09 (button) folded before Flop (didn't bet)
Seat 6: RMilPoker (small blind) showed [Ac Ah] and won ($198.20) with three of a kind, Aces
Seat 7: HomerrrJay (big blind) folded before Flop
Seat 8: ZMPOUTSAM140 folded before Flop (didn't bet)
Seat 9: simoniustin folded before Flop (didn't bet)





PokerStars Hand #149392302821:  Hold'em No Limit ($0.50/$1.00 USD) - 2016/02/25 16:46:16 CET [2016/02/25 10:46:16 ET]
Table 'Lina II' 9-max Seat #5 is the button
Seat 1: Lesley2002 ($162.54 in chips) 
Seat 2: matiko09 ($112.79 in chips) 
Seat 3: Ouga Buga ($101.50 in chips) 
Seat 4: Nennenurse ($37.63 in chips) 
Seat 5: HomerrrJay ($100 in chips) 
Seat 6: sebaaastian ($150.12 in chips) 
Seat 7: Monsthand ($146.74 in chips) 
Seat 8: djammusic ($42.64 in chips) 
Seat 9: Sweden_Pound ($275.34 in chips) 
sebaaastian: posts small blind $0.50
Monsthand: posts big blind $1
*** HOLE CARDS ***
Dealt to matiko09 [9d 2s]
djammusic: folds 
djammusic leaves the table
mycka86 joins the table at seat #8 
Sweden_Pound: folds 
Lesley2002: folds 
matiko09: folds 
Ouga Buga: folds 
Nennenurse: raises $2 to $3
HomerrrJay: folds 
sebaaastian: folds 
Monsthand: folds 
Uncalled bet ($2) returned to Nennenurse
Nennenurse collected $2.50 from pot
*** SUMMARY ***
Total pot $2.50 | Rake $0 
Seat 1: Lesley2002 folded before Flop (didn't bet)
Seat 2: matiko09 folded before Flop (didn't bet)
Seat 3: Ouga Buga folded before Flop (didn't bet)
Seat 4: Nennenurse collected ($2.50)
Seat 5: HomerrrJay (button) folded before Flop (didn't bet)
Seat 6: sebaaastian (small blind) folded before Flop
Seat 7: Monsthand (big blind) folded before Flop
Seat 8: djammusic folded before Flop (didn't bet)
Seat 9: Sweden_Pound folded before Flop (didn't bet)





PokerStars Hand #149392311735:  Hold'em No Limit ($0.25/$0.50 USD) - 2016/02/25 16:46:27 CET [2016/02/25 10:46:27 ET]
Table 'Lohja II' 9-max Seat #1 is the button
Seat 1: MoonJimmy ($151.98 in chips) 
Seat 2: Apparat888 ($32.52 in chips) 
Seat 3: guvalc1952 ($151.29 in chips) 
Seat 5: vasiy379 ($50 in chips) 
Seat 7: matiko09 ($147.76 in chips) 
Seat 8: jamba83 ($60.37 in chips) 
Seat 9: Muinmyheart ($75.29 in chips) 
Apparat888: posts small blind $0.25
guvalc1952: posts big blind $0.50
payback11: sits out 
JustR82: sits out 
MoonJimmy: posts the ante $0.10
Apparat888: posts the ante $0.10
guvalc1952: posts the ante $0.10
vasiy379: posts the ante $0.10
matiko09: posts the ante $0.10
jamba83: posts the ante $0.10
Muinmyheart: posts the ante $0.10
*** HOLE CARDS ***
Dealt to matiko09 [9d 9c]
vasiy379: folds 
matiko09: raises $1 to $1.50
jamba83: calls $1.50
Muinmyheart: folds 
MoonJimmy: raises $3.50 to $5
Apparat888: folds 
guvalc1952: folds 
matiko09: calls $3.50
jamba83: calls $3.50
*** FLOP *** [4c 6s 4s]
matiko09: checks 
jamba83: bets $9
MoonJimmy: folds 
matiko09: calls $9
*** TURN *** [4c 6s 4s] [6d]
matiko09: checks 
jamba83: checks 
*** RIVER *** [4c 6s 4s 6d] [6c]
matiko09: checks 
jamba83: checks 
*** SHOW DOWN ***
matiko09: shows [9d 9c] (a full house, Sixes full of Nines)
jamba83: shows [Jc Js] (a full house, Sixes full of Jacks)
jamba83 collected $32.90 from pot
*** SUMMARY ***
Total pot $34.45 | Rake $1.55 
Board [4c 6s 4s 6d 6c]
Seat 1: MoonJimmy (button) folded on the Flop
Seat 2: Apparat888 (small blind) folded before Flop
Seat 3: guvalc1952 (big blind) folded before Flop
Seat 5: vasiy379 folded before Flop (didn't bet)
Seat 7: matiko09 showed [9d 9c] and lost with a full house, Sixes full of Nines
Seat 8: jamba83 showed [Jc Js] and won ($32.90) with a full house, Sixes full of Jacks
Seat 9: Muinmyheart folded before Flop (didn't bet)





PokerStars Hand #149392313478:  Hold'em No Limit ($0.50/$1.00 USD) - 2016/02/25 16:46:30 CET [2016/02/25 10:46:30 ET]
Table 'Guisan' 9-max Seat #3 is the button
Seat 1: stockbridge8 ($72.86 in chips) 
Seat 2: mycka86 ($100 in chips) 
Seat 3: xAndorx ($119.62 in chips) 
Seat 4: matiko09 ($169.75 in chips) 
Seat 5: Jeckpot1989 ($93.23 in chips) 
Seat 6: 19R&J91 ($390.07 in chips) 
Seat 7: sebaaastian ($116.59 in chips) 
Seat 8: Monsthand ($110.73 in chips) 
Seat 9: Sweden_Pound ($107.69 in chips) 
matiko09: posts small blind $0.50
Jeckpot1989: posts big blind $1
*** HOLE CARDS ***
Dealt to matiko09 [Jh 9s]
19R&J91: folds 
sebaaastian: folds 
Monsthand: folds 
Sweden_Pound: folds 
stockbridge8: raises $2 to $3
mycka86: folds 
xAndorx: folds 
matiko09: folds 
Jeckpot1989: folds 
Uncalled bet ($2) returned to stockbridge8
stockbridge8 collected $2.50 from pot
*** SUMMARY ***
Total pot $2.50 | Rake $0 
Seat 1: stockbridge8 collected ($2.50)
Seat 2: mycka86 folded before Flop (didn't bet)
Seat 3: xAndorx (button) folded before Flop (didn't bet)
Seat 4: matiko09 (small blind) folded before Flop
Seat 5: Jeckpot1989 (big blind) folded before Flop
Seat 6: 19R&J91 folded before Flop (didn't bet)
Seat 7: sebaaastian folded before Flop (didn't bet)
Seat 8: Monsthand folded before Flop (didn't bet)
Seat 9: Sweden_Pound folded before Flop (didn't bet)





PokerStars Hand #149392314704:  Hold'em No Limit ($0.50/$1.00 USD) - 2016/02/25 16:46:31 CET [2016/02/25 10:46:31 ET]
Table 'Badenia II' 9-max Seat #3 is the button
Seat 1: matiko09 ($101.50 in chips) 
Seat 2: Stibitzkie ($128.57 in chips) 
Seat 3: sebaaastian ($100 in chips) 
Seat 4: KarlMoik1 ($354.44 in chips) 
Seat 5: djammusic ($123.59 in chips) 
Seat 6: xAndorx ($103.21 in chips) 
Seat 7: forsmthgood ($100 in chips) 
Seat 8: Sweden_Pound ($128.92 in chips) 
Seat 9: waisanen ($113.42 in chips) 
KarlMoik1: posts small blind $0.50
djammusic: posts big blind $1
*** HOLE CARDS ***
Dealt to matiko09 [5h 8h]
xAndorx: folds 
forsmthgood: folds 
Sweden_Pound: folds 
waisanen: folds 
matiko09: folds 
Stibitzkie: raises $2.50 to $3.50
sebaaastian: folds 
KarlMoik1: folds 
djammusic: folds 
Uncalled bet ($2.50) returned to Stibitzkie
Stibitzkie collected $2.50 from pot
*** SUMMARY ***
Total pot $2.50 | Rake $0 
Seat 1: matiko09 folded before Flop (didn't bet)
Seat 2: Stibitzkie collected ($2.50)
Seat 3: sebaaastian (button) folded before Flop (didn't bet)
Seat 4: KarlMoik1 (small blind) folded before Flop
Seat 5: djammusic (big blind) folded before Flop
Seat 6: xAndorx folded before Flop (didn't bet)
Seat 7: forsmthgood folded before Flop (didn't bet)
Seat 8: Sweden_Pound folded before Flop (didn't bet)
Seat 9: waisanen folded before Flop (didn't bet)





PokerStars Hand #149392317711:  Hold'em No Limit ($0.50/$1.00 USD) - 2016/02/25 16:46:35 CET [2016/02/25 10:46:35 ET]
Table 'Isa' 9-max Seat #1 is the button
Seat 1: matiko09 ($120.44 in chips) 
Seat 2: Monsthand ($100 in chips) 
Seat 3: sebaaastian ($109.90 in chips) 
Seat 4: hammerwife ($110.50 in chips) 
Seat 5: Sweden_Pound ($103.05 in chips) 
Seat 6: xAndorx ($97.50 in chips) 
Seat 7: bilukm ($151.02 in chips) 
Seat 9: TideHan ($110 in chips) 
Monsthand: posts small blind $0.50
sebaaastian: posts big blind $1
Venomous100%: sits out 
*** HOLE CARDS ***
Dealt to matiko09 [Qd 8h]
hammerwife: raises $2 to $3
Sweden_Pound: folds 
xAndorx: folds 
bilukm: calls $3
TideHan: folds 
matiko09: folds 
Monsthand: folds 
sebaaastian: folds 
*** FLOP *** [5h 6d 2d]
hammerwife: checks 
bilukm: bets $7.16
hammerwife: calls $7.16
*** TURN *** [5h 6d 2d] [Ac]
hammerwife: checks 
bilukm: bets $10.42
hammerwife: calls $10.42
*** RIVER *** [5h 6d 2d Ac] [4h]
hammerwife: checks 
bilukm: checks 
*** SHOW DOWN ***
hammerwife: shows [Kh Ah] (a pair of Aces)
bilukm: shows [6s 5s] (two pair, Sixes and Fives)
bilukm collected $40.74 from pot
*** SUMMARY ***
Total pot $42.66 | Rake $1.92 
Board [5h 6d 2d Ac 4h]
Seat 1: matiko09 (button) folded before Flop (didn't bet)
Seat 2: Monsthand (small blind) folded before Flop
Seat 3: sebaaastian (big blind) folded before Flop
Seat 4: hammerwife showed [Kh Ah] and lost with a pair of Aces
Seat 5: Sweden_Pound folded before Flop (didn't bet)
Seat 6: xAndorx folded before Flop (didn't bet)
Seat 7: bilukm showed [6s 5s] and won ($40.74) with two pair, Sixes and Fives
Seat 9: TideHan folded before Flop (didn't bet)





PokerStars Hand #149392320597:  Hold'em No Limit ($0.50/$1.00 USD) - 2016/02/25 16:46:39 CET [2016/02/25 10:46:39 ET]
Table 'Zeuxo II' 9-max Seat #4 is the button
Seat 1: forsmthgood ($100 in chips) 
Seat 2: Sweden_Pound ($102.25 in chips) 
Seat 3: xAndorx ($96.78 in chips) 
Seat 4: sebaaastian ($122.11 in chips) 
Seat 5: bauss84 ($27 in chips) 
Seat 6: Cogss ($105.24 in chips) 
Seat 7: djammusic ($45.50 in chips) 
Seat 8: matiko09 ($100 in chips) 
Seat 9: Sreshta222 ($219.60 in chips) 
bauss84: posts small blind $0.50
Cogss: posts big blind $1
*** HOLE CARDS ***
Dealt to matiko09 [Td Js]
djammusic: folds 
matiko09: folds 
Sreshta222: folds 
forsmthgood: folds 
Sweden_Pound: raises $2 to $3
xAndorx: folds 
sebaaastian: folds 
bauss84: folds 
Cogss: folds 
Uncalled bet ($2) returned to Sweden_Pound
Sweden_Pound collected $2.50 from pot
Sweden_Pound: doesn't show hand 
*** SUMMARY ***
Total pot $2.50 | Rake $0 
Seat 1: forsmthgood folded before Flop (didn't bet)
Seat 2: Sweden_Pound collected ($2.50)
Seat 3: xAndorx folded before Flop (didn't bet)
Seat 4: sebaaastian (button) folded before Flop (didn't bet)
Seat 5: bauss84 (small blind) folded before Flop
Seat 6: Cogss (big blind) folded before Flop
Seat 7: djammusic folded before Flop (didn't bet)
Seat 8: matiko09 folded before Flop (didn't bet)
Seat 9: Sreshta222 folded before Flop (didn't bet)





PokerStars Hand #149392333207:  Hold'em No Limit ($0.50/$1.00 USD) - 2016/02/25 16:46:56 CET [2016/02/25 10:46:56 ET]
Table 'Lina II' 9-max Seat #6 is the button
Seat 1: Lesley2002 ($162.54 in chips) 
Seat 2: matiko09 ($112.79 in chips) 
Seat 3: Ouga Buga ($101.50 in chips) 
Seat 4: Nennenurse ($39.13 in chips) 
Seat 5: HomerrrJay ($100 in chips) 
Seat 6: sebaaastian ($149.62 in chips) 
Seat 7: Monsthand ($145.74 in chips) 
Seat 8: mycka86 ($100 in chips) 
Seat 9: Sweden_Pound ($275.34 in chips) 
Monsthand: posts small blind $0.50
mycka86: posts big blind $1
*** HOLE CARDS ***
Dealt to matiko09 [Qs 3d]
Sweden_Pound: raises $2 to $3
Lesley2002: folds 
matiko09: folds 
Ouga Buga: folds 
Nennenurse: raises $6 to $9
HomerrrJay: folds 
sebaaastian: folds 
Monsthand: folds 
mycka86: folds 
Sweden_Pound: raises $266.34 to $275.34 and is all-in
Nennenurse: calls $30.13 and is all-in
Uncalled bet ($236.21) returned to Sweden_Pound
*** FLOP *** [9h 4h 4d]
*** TURN *** [9h 4h 4d] [3c]
*** RIVER *** [9h 4h 4d 3c] [3s]
*** SHOW DOWN ***
Sweden_Pound: shows [Qc Qh] (two pair, Queens and Fours)
Nennenurse: shows [Kh Ad] (two pair, Fours and Threes)
Sweden_Pound collected $76.96 from pot
*** SUMMARY ***
Total pot $79.76 | Rake $2.80 
Board [9h 4h 4d 3c 3s]
Seat 1: Lesley2002 folded before Flop (didn't bet)
Seat 2: matiko09 folded before Flop (didn't bet)
Seat 3: Ouga Buga folded before Flop (didn't bet)
Seat 4: Nennenurse showed [Kh Ad] and lost with two pair, Fours and Threes
Seat 5: HomerrrJay folded before Flop (didn't bet)
Seat 6: sebaaastian (button) folded before Flop (didn't bet)
Seat 7: Monsthand (small blind) folded before Flop
Seat 8: mycka86 (big blind) folded before Flop
Seat 9: Sweden_Pound showed [Qc Qh] and won ($76.96) with two pair, Queens and Fours





PokerStars Hand #149392335706:  Hold'em No Limit ($0.50/$1.00 USD) - 2016/02/25 16:46:59 CET [2016/02/25 10:46:59 ET]
Table 'Guisan' 9-max Seat #4 is the button
Seat 1: stockbridge8 ($74.36 in chips) 
Seat 2: mycka86 ($100 in chips) 
Seat 3: xAndorx ($119.62 in chips) 
Seat 4: matiko09 ($169.25 in chips) 
Seat 5: Jeckpot1989 ($92.23 in chips) 
Seat 6: 19R&J91 ($390.07 in chips) 
Seat 7: sebaaastian ($116.59 in chips) 
Seat 8: Monsthand ($110.73 in chips) 
Seat 9: Sweden_Pound ($107.69 in chips) 
Jeckpot1989: posts small blind $0.50
19R&J91: posts big blind $1
*** HOLE CARDS ***
Dealt to matiko09 [Kd 3h]
sebaaastian: folds 
Monsthand: folds 
Sweden_Pound: folds 
stockbridge8: raises $2 to $3
mycka86: folds 
xAndorx: folds 
matiko09: folds 
Jeckpot1989: folds 
19R&J91: folds 
Uncalled bet ($2) returned to stockbridge8
stockbridge8 collected $2.50 from pot
*** SUMMARY ***
Total pot $2.50 | Rake $0 
Seat 1: stockbridge8 collected ($2.50)
Seat 2: mycka86 folded before Flop (didn't bet)
Seat 3: xAndorx folded before Flop (didn't bet)
Seat 4: matiko09 (button) folded before Flop (didn't bet)
Seat 5: Jeckpot1989 (small blind) folded before Flop
Seat 6: 19R&J91 (big blind) folded before Flop
Seat 7: sebaaastian folded before Flop (didn't bet)
Seat 8: Monsthand folded before Flop (didn't bet)
Seat 9: Sweden_Pound folded before Flop (didn't bet)





PokerStars Hand #149392337948:  Hold'em No Limit ($0.50/$1.00 USD) - 2016/02/25 16:47:02 CET [2016/02/25 10:47:02 ET]
Table 'Badenia II' 9-max Seat #4 is the button
Seat 1: matiko09 ($101.50 in chips) 
Seat 2: Stibitzkie ($130.07 in chips) 
Seat 3: sebaaastian ($100 in chips) 
Seat 4: KarlMoik1 ($353.94 in chips) 
Seat 5: djammusic ($122.59 in chips) 
Seat 6: xAndorx ($103.21 in chips) 
Seat 7: forsmthgood ($100 in chips) 
Seat 8: Sweden_Pound ($128.92 in chips) 
Seat 9: waisanen ($113.42 in chips) 
djammusic: posts small blind $0.50
xAndorx: posts big blind $1
*** HOLE CARDS ***
Dealt to matiko09 [Ks 9h]
forsmthgood: folds 
Sweden_Pound: folds 
waisanen: folds 
matiko09: folds 
Stibitzkie: raises $6 to $7
sebaaastian: folds 
KarlMoik1: calls $7
djammusic: folds 
xAndorx: folds 
*** FLOP *** [6s 7d 8d]
Stibitzkie: bets $14.80
KarlMoik1: folds 
Uncalled bet ($14.80) returned to Stibitzkie
Stibitzkie collected $14.80 from pot
*** SUMMARY ***
Total pot $15.50 | Rake $0.70 
Board [6s 7d 8d]
Seat 1: matiko09 folded before Flop (didn't bet)
Seat 2: Stibitzkie collected ($14.80)
Seat 3: sebaaastian folded before Flop (didn't bet)
Seat 4: KarlMoik1 (button) folded on the Flop
Seat 5: djammusic (small blind) folded before Flop
Seat 6: xAndorx (big blind) folded before Flop
Seat 7: forsmthgood folded before Flop (didn't bet)
Seat 8: Sweden_Pound folded before Flop (didn't bet)
Seat 9: waisanen folded before Flop (didn't bet)





PokerStars Hand #149392338895:  Hold'em No Limit ($0.25/$0.50 USD) - 2016/02/25 16:47:03 CET [2016/02/25 10:47:03 ET]
Table 'Ophiuchus III' 9-max Seat #7 is the button
Seat 1: RvPersie ($100.69 in chips) 
Seat 2: ihami ($48.50 in chips) 
Seat 3: rdrill ($62.97 in chips) 
Seat 5: ReneProost ($33.64 in chips) 
Seat 6: Muinmyheart ($50 in chips) 
Seat 7: Rorerzap ($54.20 in chips) 
Seat 8: matiko09 ($50 in chips) 
Seat 9: tugboat2008 ($81.52 in chips) 
matiko09: posts small blind $0.25
tugboat2008: posts big blind $0.50
lucima10: sits out 
*** HOLE CARDS ***
Dealt to matiko09 [6c As]
RvPersie: folds 
ihami: folds 
rdrill: raises $1 to $1.50
ReneProost: folds 
Muinmyheart: folds 
Rorerzap: folds 
matiko09: folds 
tugboat2008: folds 
Uncalled bet ($1) returned to rdrill
rdrill collected $1.25 from pot
*** SUMMARY ***
Total pot $1.25 | Rake $0 
Seat 1: RvPersie folded before Flop (didn't bet)
Seat 2: ihami folded before Flop (didn't bet)
Seat 3: rdrill collected ($1.25)
Seat 5: ReneProost folded before Flop (didn't bet)
Seat 6: Muinmyheart folded before Flop (didn't bet)
Seat 7: Rorerzap (button) folded before Flop (didn't bet)
Seat 8: matiko09 (small blind) folded before Flop
Seat 9: tugboat2008 (big blind) folded before Flop





PokerStars Hand #149392343663:  Hold'em No Limit (€0.25/€0.50 EUR) - 2016/02/25 16:47:09 CET [2016/02/25 10:47:09 ET]
Table 'Leo Minor III' 9-max Seat #9 is the button
Seat 1: Al3xAnd3r22 (€79.51 in chips) 
Seat 2: vasiy379 (€50.75 in chips) 
Seat 3: Rorerzap (€60.50 in chips) 
Seat 4: RvPersie (€71.56 in chips) 
Seat 5: kasse_62 (€24.62 in chips) 
Seat 6: Wwwasian (€52.54 in chips) 
Seat 7: JustR82 (€50 in chips) 
Seat 9: matiko09 (€50 in chips) 
Al3xAnd3r22: posts small blind €0.25
vasiy379: posts big blind €0.50
Bron By: sits out 
*** HOLE CARDS ***
Dealt to matiko09 [Ah Kh]
Rorerzap: folds 
RvPersie: folds 
kasse_62: calls €0.50
Wwwasian: folds 
JustR82: raises €1.50 to €2
matiko09: calls €2
Al3xAnd3r22: folds 
vasiy379: folds 
kasse_62: calls €1.50
*** FLOP *** [Ks Ac Qs]
kasse_62: checks 
JustR82: bets €4
matiko09: calls €4
kasse_62: folds 
*** TURN *** [Ks Ac Qs] [6d]
JustR82: checks 
matiko09: bets €8.50
JustR82: calls €8.50
*** RIVER *** [Ks Ac Qs 6d] [8d]
JustR82: checks 
matiko09: bets €7.50
JustR82: calls €7.50
*** SHOW DOWN ***
matiko09: shows [Ah Kh] (two pair, Aces and Kings)
JustR82: mucks hand 
matiko09 collected €44.75 from pot
*** SUMMARY ***
Total pot €46.75 | Rake €2 
Board [Ks Ac Qs 6d 8d]
Seat 1: Al3xAnd3r22 (small blind) folded before Flop
Seat 2: vasiy379 (big blind) folded before Flop
Seat 3: Rorerzap folded before Flop (didn't bet)
Seat 4: RvPersie folded before Flop (didn't bet)
Seat 5: kasse_62 folded on the Flop
Seat 6: Wwwasian folded before Flop (didn't bet)
Seat 7: JustR82 mucked [As Qh]
Seat 9: matiko09 (button) showed [Ah Kh] and won (€44.75) with two pair, Aces and Kings





PokerStars Hand #149392354444:  Hold'em No Limit ($0.50/$1.00 USD) - 2016/02/25 16:47:23 CET [2016/02/25 10:47:23 ET]
Table 'Zeuxo II' 9-max Seat #5 is the button
Seat 1: forsmthgood ($100 in chips) 
Seat 2: Sweden_Pound ($103.75 in chips) 
Seat 3: xAndorx ($96.78 in chips) 
Seat 4: sebaaastian ($122.11 in chips) 
Seat 5: bauss84 ($26.50 in chips) 
Seat 6: Cogss ($104.24 in chips) 
Seat 7: djammusic ($45.50 in chips) 
Seat 8: matiko09 ($100 in chips) 
Seat 9: Sreshta222 ($219.60 in chips) 
Cogss: posts small blind $0.50
djammusic: posts big blind $1
*** HOLE CARDS ***
Dealt to matiko09 [Tc 6d]
matiko09: folds 
Sreshta222: raises $2 to $3
forsmthgood: calls $3
Sweden_Pound: calls $3
xAndorx: calls $3
sebaaastian: folds 
bauss84: folds 
Cogss: calls $2.50
djammusic: folds 
*** FLOP *** [4c 9s 7c]
Cogss: checks 
Sreshta222: checks 
forsmthgood: checks 
Sweden_Pound: bets $9.93
xAndorx: folds 
Cogss: folds 
Sreshta222: folds 
forsmthgood: folds 
Uncalled bet ($9.93) returned to Sweden_Pound
Sweden_Pound collected $15.28 from pot
Sweden_Pound: doesn't show hand 
*** SUMMARY ***
Total pot $16 | Rake $0.72 
Board [4c 9s 7c]
Seat 1: forsmthgood folded on the Flop
Seat 2: Sweden_Pound collected ($15.28)
Seat 3: xAndorx folded on the Flop
Seat 4: sebaaastian folded before Flop (didn't bet)
Seat 5: bauss84 (button) folded before Flop (didn't bet)
Seat 6: Cogss (small blind) folded on the Flop
Seat 7: djammusic (big blind) folded before Flop
Seat 8: matiko09 folded before Flop (didn't bet)
Seat 9: Sreshta222 folded on the Flop





PokerStars Hand #149392358215:  Hold'em No Limit ($0.25/$0.50 USD) - 2016/02/25 16:47:28 CET [2016/02/25 10:47:28 ET]
Table 'Ophiuchus III' 9-max Seat #8 is the button
Seat 1: RvPersie ($100.69 in chips) 
Seat 2: ihami ($48.50 in chips) 
Seat 3: rdrill ($63.72 in chips) 
Seat 5: ReneProost ($33.64 in chips) 
Seat 6: Muinmyheart ($50 in chips) 
Seat 7: Rorerzap ($54.20 in chips) 
Seat 8: matiko09 ($50 in chips) 
Seat 9: tugboat2008 ($81.02 in chips) 
tugboat2008: posts small blind $0.25
RvPersie: posts big blind $0.50
lucima10: sits out 
*** HOLE CARDS ***
Dealt to matiko09 [Ks 4h]
ihami: folds 
rdrill: raises $1 to $1.50
ReneProost: folds 
Muinmyheart: folds 
Rorerzap: folds 
matiko09: folds 
tugboat2008: folds 
RvPersie: folds 
Uncalled bet ($1) returned to rdrill
rdrill collected $1.25 from pot
*** SUMMARY ***
Total pot $1.25 | Rake $0 
Seat 1: RvPersie (big blind) folded before Flop
Seat 2: ihami folded before Flop (didn't bet)
Seat 3: rdrill collected ($1.25)
Seat 5: ReneProost folded before Flop (didn't bet)
Seat 6: Muinmyheart folded before Flop (didn't bet)
Seat 7: Rorerzap folded before Flop (didn't bet)
Seat 8: matiko09 (button) folded before Flop (didn't bet)
Seat 9: tugboat2008 (small blind) folded before Flop





PokerStars Hand #149392363853:  Hold'em No Limit ($0.25/$0.50 USD) - 2016/02/25 16:47:36 CET [2016/02/25 10:47:36 ET]
Table 'Thalpius III' 9-max Seat #9 is the button
Seat 1: BrotherLove9 ($60.57 in chips) 
Seat 2: matiko09 ($56.54 in chips) 
Seat 3: jamba83 ($52.31 in chips) 
Seat 4: Wwwasian ($50.76 in chips) 
Seat 5: Rorerzap ($56.27 in chips) 
Seat 6: ihami ($52.25 in chips) 
Seat 7: v4n0v ($50 in chips) 
Seat 8: jeroemie123 ($26.04 in chips) 
Seat 9: Domotirko228 ($50 in chips) 
BrotherLove9: posts small blind $0.25
matiko09: posts big blind $0.50
*** HOLE CARDS ***
Dealt to matiko09 [Ts 2c]
jamba83: folds 
Wwwasian: folds 
Rorerzap: folds 
ihami: folds 
v4n0v: folds 
jeroemie123: calls $0.50
Domotirko228: folds 
BrotherLove9: folds 
matiko09: checks 
*** FLOP *** [2h 6d 4h]
matiko09: checks 
jeroemie123: checks 
*** TURN *** [2h 6d 4h] [Js]
matiko09: checks 
jeroemie123: checks 
*** RIVER *** [2h 6d 4h Js] [9c]
matiko09: checks 
jeroemie123: bets $1
matiko09: folds 
Uncalled bet ($1) returned to jeroemie123
jeroemie123 collected $1.19 from pot
jeroemie123: doesn't show hand 
*** SUMMARY ***
Total pot $1.25 | Rake $0.06 
Board [2h 6d 4h Js 9c]
Seat 1: BrotherLove9 (small blind) folded before Flop
Seat 2: matiko09 (big blind) folded on the River
Seat 3: jamba83 folded before Flop (didn't bet)
Seat 4: Wwwasian folded before Flop (didn't bet)
Seat 5: Rorerzap folded before Flop (didn't bet)
Seat 6: ihami folded before Flop (didn't bet)
Seat 7: v4n0v folded before Flop (didn't bet)
Seat 8: jeroemie123 collected ($1.19)
Seat 9: Domotirko228 (button) folded before Flop (didn't bet)





PokerStars Hand #149392367539:  Hold'em No Limit ($0.50/$1.00 USD) - 2016/02/25 16:47:40 CET [2016/02/25 10:47:40 ET]
Table 'Simona' 9-max Seat #1 is the button
Seat 1: mycka86 ($136.44 in chips) 
Seat 2: xAndorx ($140.47 in chips) 
Seat 3: Sweden_Pound ($115.49 in chips) 
Seat 4: matiko09 ($274.92 in chips) 
Seat 5: sebaaastian ($105.21 in chips) 
Seat 6: Ty Nick 420 ($70 in chips) 
Seat 8: Monsthand ($134.97 in chips) 
xAndorx: posts small blind $0.50
Sweden_Pound: posts big blind $1
hammerwife: sits out 
Slushpup69: sits out 
*** HOLE CARDS ***
Dealt to matiko09 [8s Jh]
matiko09: folds 
sebaaastian: folds 
Ty Nick 420: folds 
Ty Nick 420 leaves the table
Venomous100% joins the table at seat #6 
Monsthand: folds 
mycka86: raises $1.10 to $2.10
xAndorx: raises $5.90 to $8
Sweden_Pound: folds 
mycka86: folds 
Uncalled bet ($5.90) returned to xAndorx
xAndorx collected $5.20 from pot
xAndorx: doesn't show hand 
*** SUMMARY ***
Total pot $5.20 | Rake $0 
Seat 1: mycka86 (button) folded before Flop
Seat 2: xAndorx (small blind) collected ($5.20)
Seat 3: Sweden_Pound (big blind) folded before Flop
Seat 4: matiko09 folded before Flop (didn't bet)
Seat 5: sebaaastian folded before Flop (didn't bet)
Seat 6: Ty Nick 420 folded before Flop (didn't bet)
Seat 8: Monsthand folded before Flop (didn't bet)





PokerStars Hand #149392368310:  Hold'em No Limit ($0.50/$1.00 USD) - 2016/02/25 16:47:41 CET [2016/02/25 10:47:41 ET]
Table 'Hercules IV' 9-max Seat #7 is the button
Seat 1: matiko09 ($100 in chips) 
Seat 2: hammerwife ($100 in chips) 
Seat 3: sebaaastian ($201.70 in chips) 
Seat 4: Sweden_Pound ($110 in chips) 
Seat 5: xAndorx ($156.96 in chips) 
Seat 6: kuanhung0903 ($65.10 in chips) 
Seat 7: Ouga Buga ($100 in chips) 
Seat 8: brokat77 ($115.54 in chips) 
Seat 9: djammusic ($38.70 in chips) 
brokat77: posts small blind $0.50
djammusic: posts big blind $1
*** HOLE CARDS ***
Dealt to matiko09 [Kh 2c]
matiko09: folds 
hammerwife: raises $2 to $3
sebaaastian: folds 
Sweden_Pound: folds 
xAndorx: folds 
kuanhung0903 has timed out
kuanhung0903: folds 
Ouga Buga: folds 
brokat77: folds 
djammusic: folds 
Uncalled bet ($2) returned to hammerwife
hammerwife collected $2.50 from pot
hammerwife: doesn't show hand 
*** SUMMARY ***
Total pot $2.50 | Rake $0 
Seat 1: matiko09 folded before Flop (didn't bet)
Seat 2: hammerwife collected ($2.50)
Seat 3: sebaaastian folded before Flop (didn't bet)
Seat 4: Sweden_Pound folded before Flop (didn't bet)
Seat 5: xAndorx folded before Flop (didn't bet)
Seat 6: kuanhung0903 folded before Flop (didn't bet)
Seat 7: Ouga Buga (button) folded before Flop (didn't bet)
Seat 8: brokat77 (small blind) folded before Flop
Seat 9: djammusic (big blind) folded before Flop





PokerStars Hand #149392370659:  Hold'em No Limit ($0.50/$1.00 USD) - 2016/02/25 16:47:44 CET [2016/02/25 10:47:44 ET]
Table 'Isa' 9-max Seat #2 is the button
Seat 1: matiko09 ($120.44 in chips) 
Seat 2: Monsthand ($100 in chips) 
Seat 3: sebaaastian ($108.90 in chips) 
Seat 4: hammerwife ($100 in chips) 
Seat 5: Sweden_Pound ($103.05 in chips) 
Seat 6: xAndorx ($97.50 in chips) 
Seat 7: bilukm ($171.18 in chips) 
Seat 9: TideHan ($110 in chips) 
sebaaastian: posts small blind $0.50
hammerwife: posts big blind $1
Venomous100%: sits out 
*** HOLE CARDS ***
Dealt to matiko09 [4c 4h]
Sweden_Pound: folds 
xAndorx: folds 
bilukm: folds 
TideHan: folds 
matiko09: raises $1.50 to $2.50
Monsthand: folds 
sebaaastian: folds 
hammerwife: folds 
Uncalled bet ($1.50) returned to matiko09
matiko09 collected $2.50 from pot
matiko09: doesn't show hand 
*** SUMMARY ***
Total pot $2.50 | Rake $0 
Seat 1: matiko09 collected ($2.50)
Seat 2: Monsthand (button) folded before Flop (didn't bet)
Seat 3: sebaaastian (small blind) folded before Flop
Seat 4: hammerwife (big blind) folded before Flop
Seat 5: Sweden_Pound folded before Flop (didn't bet)
Seat 6: xAndorx folded before Flop (didn't bet)
Seat 7: bilukm folded before Flop (didn't bet)
Seat 9: TideHan folded before Flop (didn't bet)





PokerStars Hand #149392371247:  Hold'em No Limit ($0.50/$1.00 USD) - 2016/02/25 16:47:45 CET [2016/02/25 10:47:45 ET]
Table 'Lucia III' 9-max Seat #1 is the button
Seat 1: Monsthand ($119.75 in chips) 
Seat 2: kuanhung0903 ($74 in chips) 
Seat 3: mycka86 ($122.07 in chips) 
Seat 5: Sweden_Pound ($222.93 in chips) 
Seat 6: matiko09 ($100 in chips) 
Seat 7: Ty Nick 420 ($319.77 in chips) 
Seat 8: apfush ($119.22 in chips) 
Seat 9: Apparat888 ($32.95 in chips) 
kuanhung0903: posts small blind $0.50
mycka86: posts big blind $1
xAndorx: sits out 
*** HOLE CARDS ***
Dealt to matiko09 [3h Kh]
Sweden_Pound: folds 
matiko09: folds 
Ty Nick 420: folds 
apfush: folds 
Apparat888: folds 
Monsthand: folds 
kuanhung0903 has timed out
kuanhung0903: folds 
Uncalled bet ($0.50) returned to mycka86
mycka86 collected $1 from pot
*** SUMMARY ***
Total pot $1 | Rake $0 
Seat 1: Monsthand (button) folded before Flop (didn't bet)
Seat 2: kuanhung0903 (small blind) folded before Flop
Seat 3: mycka86 (big blind) collected ($1)
Seat 5: Sweden_Pound folded before Flop (didn't bet)
Seat 6: matiko09 folded before Flop (didn't bet)
Seat 7: Ty Nick 420 folded before Flop (didn't bet)
Seat 8: apfush folded before Flop (didn't bet)
Seat 9: Apparat888 folded before Flop (didn't bet)





PokerStars Hand #149392372709:  Hold'em No Limit ($0.25/$0.50 USD) - 2016/02/25 16:47:47 CET [2016/02/25 10:47:47 ET]
Table 'Lohja II' 9-max Seat #2 is the button
Seat 1: MoonJimmy ($146.88 in chips) 
Seat 2: Apparat888 ($32.17 in chips) 
Seat 3: guvalc1952 ($150.69 in chips) 
Seat 4: payback11 ($50 in chips) 
Seat 5: vasiy379 ($50 in chips) 
Seat 7: matiko09 ($133.66 in chips) 
Seat 8: jamba83 ($79.17 in chips) 
Seat 9: Muinmyheart ($75.19 in chips) 
guvalc1952: posts small blind $0.25
payback11: posts big blind $0.50
JustR82: sits out 
MoonJimmy: posts the ante $0.10
Apparat888: posts the ante $0.10
guvalc1952: posts the ante $0.10
payback11: posts the ante $0.10
vasiy379: posts the ante $0.10
matiko09: posts the ante $0.10
jamba83: posts the ante $0.10
Muinmyheart: posts the ante $0.10
*** HOLE CARDS ***
Dealt to matiko09 [Ac 2s]
vasiy379: folds 
matiko09: folds 
jamba83: raises $1 to $1.50
Muinmyheart: folds 
MoonJimmy: folds 
Apparat888: folds 
guvalc1952: calls $1.25
payback11: folds 
*** FLOP *** [Qc Tc 7s]
guvalc1952: checks 
jamba83: bets $2
guvalc1952: calls $2
*** TURN *** [Qc Tc 7s] [5d]
guvalc1952: checks 
jamba83: checks 
*** RIVER *** [Qc Tc 7s 5d] [Js]
guvalc1952: checks 
jamba83: checks 
*** SHOW DOWN ***
guvalc1952: shows [Th Kd] (a pair of Tens)
jamba83: mucks hand 
guvalc1952 collected $7.93 from pot
*** SUMMARY ***
Total pot $8.30 | Rake $0.37 
Board [Qc Tc 7s 5d Js]
Seat 1: MoonJimmy folded before Flop (didn't bet)
Seat 2: Apparat888 (button) folded before Flop (didn't bet)
Seat 3: guvalc1952 (small blind) showed [Th Kd] and won ($7.93) with a pair of Tens
Seat 4: payback11 (big blind) folded before Flop
Seat 5: vasiy379 folded before Flop (didn't bet)
Seat 7: matiko09 folded before Flop (didn't bet)
Seat 8: jamba83 mucked [6h 6c]
Seat 9: Muinmyheart folded before Flop (didn't bet)





PokerStars Hand #149392381167:  Hold'em No Limit ($0.50/$1.00 USD) - 2016/02/25 16:47:58 CET [2016/02/25 10:47:58 ET]
Table 'Guisan' 9-max Seat #5 is the button
Seat 1: stockbridge8 ($75.86 in chips) 
Seat 2: mycka86 ($100 in chips) 
Seat 3: xAndorx ($119.62 in chips) 
Seat 4: matiko09 ($169.25 in chips) 
Seat 5: Jeckpot1989 ($91.73 in chips) 
Seat 6: 19R&J91 ($389.07 in chips) 
Seat 7: sebaaastian ($116.59 in chips) 
Seat 8: Monsthand ($110.73 in chips) 
Seat 9: Sweden_Pound ($107.69 in chips) 
19R&J91: posts small blind $0.50
sebaaastian: posts big blind $1
*** HOLE CARDS ***
Dealt to matiko09 [7d 4s]
Monsthand: folds 
Sweden_Pound: folds 
stockbridge8: raises $2 to $3
mycka86: folds 
xAndorx: folds 
matiko09: folds 
Jeckpot1989: calls $3
19R&J91: calls $2.50
sebaaastian: folds 
*** FLOP *** [3c Ah 3d]
19R&J91: checks 
stockbridge8: bets $4.77
Jeckpot1989: folds 
19R&J91: folds 
Uncalled bet ($4.77) returned to stockbridge8
stockbridge8 collected $9.55 from pot
*** SUMMARY ***
Total pot $10 | Rake $0.45 
Board [3c Ah 3d]
Seat 1: stockbridge8 collected ($9.55)
Seat 2: mycka86 folded before Flop (didn't bet)
Seat 3: xAndorx folded before Flop (didn't bet)
Seat 4: matiko09 folded before Flop (didn't bet)
Seat 5: Jeckpot1989 (button) folded on the Flop
Seat 6: 19R&J91 (small blind) folded on the Flop
Seat 7: sebaaastian (big blind) folded before Flop
Seat 8: Monsthand folded before Flop (didn't bet)
Seat 9: Sweden_Pound folded before Flop (didn't bet)





PokerStars Hand #149392381193:  Hold'em No Limit ($0.25/$0.50 USD) - 2016/02/25 16:47:58 CET [2016/02/25 10:47:58 ET]
Table 'Ophiuchus III' 9-max Seat #9 is the button
Seat 1: RvPersie ($100.19 in chips) 
Seat 2: ihami ($48.50 in chips) 
Seat 3: rdrill ($64.47 in chips) 
Seat 5: ReneProost ($33.64 in chips) 
Seat 6: Muinmyheart ($50 in chips) 
Seat 7: Rorerzap ($54.20 in chips) 
Seat 8: matiko09 ($50 in chips) 
Seat 9: tugboat2008 ($80.77 in chips) 
RvPersie: posts small blind $0.25
ihami: posts big blind $0.50
lucima10: sits out 
*** HOLE CARDS ***
Dealt to matiko09 [4c 3s]
rdrill: folds 
ReneProost: folds 
Muinmyheart: folds 
Rorerzap: raises $1 to $1.50
matiko09: folds 
tugboat2008: folds 
RvPersie: raises $3.50 to $5
ihami: folds 
Rorerzap: folds 
Uncalled bet ($3.50) returned to RvPersie
RvPersie collected $3.50 from pot
*** SUMMARY ***
Total pot $3.50 | Rake $0 
Seat 1: RvPersie (small blind) collected ($3.50)
Seat 2: ihami (big blind) folded before Flop
Seat 3: rdrill folded before Flop (didn't bet)
Seat 5: ReneProost folded before Flop (didn't bet)
Seat 6: Muinmyheart folded before Flop (didn't bet)
Seat 7: Rorerzap folded before Flop
Seat 8: matiko09 folded before Flop (didn't bet)
Seat 9: tugboat2008 (button) folded before Flop (didn't bet)





PokerStars Hand #149392384466:  Hold'em No Limit ($0.50/$1.00 USD) - 2016/02/25 16:48:03 CET [2016/02/25 10:48:03 ET]
Table 'Morosovia II' 9-max Seat #7 is the button
Seat 1: apfush ($194.96 in chips) 
Seat 2: lysandrafly ($100 in chips) 
Seat 3: sebaaastian ($224.03 in chips) 
Seat 4: matiko09 ($167.35 in chips) 
Seat 6: Sweden_Pound ($130.07 in chips) 
Seat 7: Ty Nick 420 ($169.69 in chips) 
Seat 8: Monsthand ($100 in chips) 
Seat 9: Ouga Buga ($125.77 in chips) 
Monsthand: posts small blind $0.50
Ouga Buga: posts big blind $1
*** HOLE CARDS ***
Dealt to matiko09 [7h 5h]
apfush: raises $2 to $3
lysandrafly: folds 
sebaaastian: folds 
matiko09: folds 
Sweden_Pound: folds 
Ty Nick 420: folds 
Monsthand: folds 
Ouga Buga: calls $2
*** FLOP *** [3h 9c Th]
Ouga Buga: checks 
apfush: bets $4.50
Ouga Buga: raises $10.03 to $14.53
apfush: folds 
Uncalled bet ($10.03) returned to Ouga Buga
Ouga Buga collected $14.80 from pot
Ouga Buga: doesn't show hand 
*** SUMMARY ***
Total pot $15.50 | Rake $0.70 
Board [3h 9c Th]
Seat 1: apfush folded on the Flop
Seat 2: lysandrafly folded before Flop (didn't bet)
Seat 3: sebaaastian folded before Flop (didn't bet)
Seat 4: matiko09 folded before Flop (didn't bet)
Seat 6: Sweden_Pound folded before Flop (didn't bet)
Seat 7: Ty Nick 420 (button) folded before Flop (didn't bet)
Seat 8: Monsthand (small blind) folded before Flop
Seat 9: Ouga Buga (big blind) collected ($14.80)





PokerStars Hand #149392385462:  Hold'em No Limit ($0.50/$1.00 USD) - 2016/02/25 16:48:04 CET [2016/02/25 10:48:04 ET]
Table 'Badenia II' 9-max Seat #5 is the button
Seat 1: matiko09 ($101.50 in chips) 
Seat 2: Stibitzkie ($137.87 in chips) 
Seat 3: sebaaastian ($100 in chips) 
Seat 4: KarlMoik1 ($346.94 in chips) 
Seat 5: djammusic ($122.09 in chips) 
Seat 6: xAndorx ($102.21 in chips) 
Seat 7: forsmthgood ($100 in chips) 
Seat 8: Sweden_Pound ($128.92 in chips) 
Seat 9: waisanen ($113.42 in chips) 
xAndorx: posts small blind $0.50
forsmthgood: posts big blind $1
*** HOLE CARDS ***
Dealt to matiko09 [9s 8c]
Sweden_Pound: folds 
waisanen: calls $1
matiko09: folds 
Stibitzkie: raises $3.50 to $4.50
sebaaastian: calls $4.50
KarlMoik1: folds 
djammusic: folds 
xAndorx: folds 
forsmthgood: folds 
waisanen: calls $3.50
*** FLOP *** [Qs 7d 5c]
waisanen: checks 
Stibitzkie: bets $14.32
sebaaastian: folds 
waisanen: raises $94.60 to $108.92 and is all-in
Stibitzkie: calls $94.60
*** TURN *** [Qs 7d 5c] [3d]
*** RIVER *** [Qs 7d 5c 3d] [4h]
*** SHOW DOWN ***
waisanen: shows [Qc Kh] (a pair of Queens)
Stibitzkie: shows [8h 9c] (high card Queen)
waisanen collected $230.04 from pot
*** SUMMARY ***
Total pot $232.84 | Rake $2.80 
Board [Qs 7d 5c 3d 4h]
Seat 1: matiko09 folded before Flop (didn't bet)
Seat 2: Stibitzkie showed [8h 9c] and lost with high card Queen
Seat 3: sebaaastian folded on the Flop
Seat 4: KarlMoik1 folded before Flop (didn't bet)
Seat 5: djammusic (button) folded before Flop (didn't bet)
Seat 6: xAndorx (small blind) folded before Flop
Seat 7: forsmthgood (big blind) folded before Flop
Seat 8: Sweden_Pound folded before Flop (didn't bet)
Seat 9: waisanen showed [Qc Kh] and won ($230.04) with a pair of Queens





PokerStars Hand #149392398049:  Hold'em No Limit ($0.50/$1.00 USD) - 2016/02/25 16:48:20 CET [2016/02/25 10:48:20 ET]
Table 'Isa' 9-max Seat #3 is the button
Seat 1: matiko09 ($121.94 in chips) 
Seat 2: Monsthand ($100 in chips) 
Seat 3: sebaaastian ($108.40 in chips) 
Seat 4: hammerwife ($100 in chips) 
Seat 5: Sweden_Pound ($103.05 in chips) 
Seat 6: xAndorx ($97.50 in chips) 
Seat 7: bilukm ($171.18 in chips) 
Seat 9: TideHan ($110 in chips) 
hammerwife: posts small blind $0.50
Sweden_Pound: posts big blind $1
Venomous100%: sits out 
*** HOLE CARDS ***
Dealt to matiko09 [8d 5s]
xAndorx: folds 
bilukm: folds 
TideHan: folds 
matiko09: folds 
Monsthand: folds 
sebaaastian: raises $1.10 to $2.10
hammerwife: folds 
Sweden_Pound: folds 
Uncalled bet ($1.10) returned to sebaaastian
sebaaastian collected $2.50 from pot
sebaaastian: doesn't show hand 
*** SUMMARY ***
Total pot $2.50 | Rake $0 
Seat 1: matiko09 folded before Flop (didn't bet)
Seat 2: Monsthand folded before Flop (didn't bet)
Seat 3: sebaaastian (button) collected ($2.50)
Seat 4: hammerwife (small blind) folded before Flop
Seat 5: Sweden_Pound (big blind) folded before Flop
Seat 6: xAndorx folded before Flop (didn't bet)
Seat 7: bilukm folded before Flop (didn't bet)
Seat 9: TideHan folded before Flop (didn't bet)





PokerStars Hand #149392400819:  Hold'em No Limit ($0.50/$1.00 USD) - 2016/02/25 16:48:24 CET [2016/02/25 10:48:24 ET]
Table 'Ebella II' 9-max Seat #6 is the button
Seat 1: Ilov3NBA ($100 in chips) 
Seat 2: Sweden_Pound ($100 in chips) 
Seat 3: Lahesell ($100 in chips) 
Seat 5: matiko09 ($100 in chips) 
Seat 6: RMilPoker ($198.20 in chips) 
Seat 7: HomerrrJay ($100 in chips) 
Seat 8: ZMPOUTSAM140 ($74.41 in chips) 
Seat 9: simoniustin ($100 in chips) 
HomerrrJay: posts small blind $0.50
ZMPOUTSAM140: posts big blind $1
*** HOLE CARDS ***
Dealt to matiko09 [7d 3c]
simoniustin: folds 
Ilov3NBA: folds 
Sweden_Pound: folds 
Lahesell: folds 
matiko09: folds 
RMilPoker: folds 
HomerrrJay: raises $1.50 to $2.50
ZMPOUTSAM140: calls $1.50
*** FLOP *** [5c 2c 8h]
HomerrrJay: bets $2.39
ZMPOUTSAM140: calls $2.39
*** TURN *** [5c 2c 8h] [4c]
HomerrrJay: checks 
ZMPOUTSAM140: checks 
*** RIVER *** [5c 2c 8h 4c] [Ks]
HomerrrJay: checks 
ZMPOUTSAM140: checks 
*** SHOW DOWN ***
HomerrrJay: shows [9d Qd] (high card King)
ZMPOUTSAM140: shows [As 5s] (a pair of Fives)
ZMPOUTSAM140 collected $9.34 from pot
*** SUMMARY ***
Total pot $9.78 | Rake $0.44 
Board [5c 2c 8h 4c Ks]
Seat 1: Ilov3NBA folded before Flop (didn't bet)
Seat 2: Sweden_Pound folded before Flop (didn't bet)
Seat 3: Lahesell folded before Flop (didn't bet)
Seat 5: matiko09 folded before Flop (didn't bet)
Seat 6: RMilPoker (button) folded before Flop (didn't bet)
Seat 7: HomerrrJay (small blind) showed [9d Qd] and lost with high card King
Seat 8: ZMPOUTSAM140 (big blind) showed [As 5s] and won ($9.34) with a pair of Fives
Seat 9: simoniustin folded before Flop (didn't bet)





PokerStars Hand #149392405034:  Hold'em No Limit ($0.25/$0.50 USD) - 2016/02/25 16:48:30 CET [2016/02/25 10:48:30 ET]
Table 'Lohja II' 9-max Seat #3 is the button
Seat 1: MoonJimmy ($146.78 in chips) 
Seat 2: Apparat888 ($32.07 in chips) 
Seat 3: guvalc1952 ($155.02 in chips) 
Seat 4: payback11 ($50 in chips) 
Seat 5: vasiy379 ($50 in chips) 
Seat 7: matiko09 ($133.56 in chips) 
Seat 8: jamba83 ($75.57 in chips) 
Seat 9: Muinmyheart ($75.09 in chips) 
payback11: posts small blind $0.25
vasiy379: posts big blind $0.50
JustR82: sits out 
MoonJimmy: posts the ante $0.10
Apparat888: posts the ante $0.10
guvalc1952: posts the ante $0.10
payback11: posts the ante $0.10
vasiy379: posts the ante $0.10
matiko09: posts the ante $0.10
jamba83: posts the ante $0.10
Muinmyheart: posts the ante $0.10
*** HOLE CARDS ***
Dealt to matiko09 [5s 4d]
matiko09: folds 
jamba83: raises $1 to $1.50
Muinmyheart: folds 
MoonJimmy: folds 
Apparat888: folds 
guvalc1952: calls $1.50
payback11: folds 
vasiy379: folds 
*** FLOP *** [4h 8c Td]
jamba83: checks 
guvalc1952: bets $2.17
jamba83: folds 
Uncalled bet ($2.17) returned to guvalc1952
guvalc1952 collected $4.35 from pot
guvalc1952: doesn't show hand 
*** SUMMARY ***
Total pot $4.55 | Rake $0.20 
Board [4h 8c Td]
Seat 1: MoonJimmy folded before Flop (didn't bet)
Seat 2: Apparat888 folded before Flop (didn't bet)
Seat 3: guvalc1952 (button) collected ($4.35)
Seat 4: payback11 (small blind) folded before Flop
Seat 5: vasiy379 (big blind) folded before Flop
Seat 7: matiko09 folded before Flop (didn't bet)
Seat 8: jamba83 folded on the Flop
Seat 9: Muinmyheart folded before Flop (didn't bet)





PokerStars Hand #149392405600:  Hold'em No Limit ($0.50/$1.00 USD) - 2016/02/25 16:48:30 CET [2016/02/25 10:48:30 ET]
Table 'Simona' 9-max Seat #2 is the button
Seat 1: mycka86 ($134.34 in chips) 
Seat 2: xAndorx ($143.57 in chips) 
Seat 3: Sweden_Pound ($114.49 in chips) 
Seat 4: matiko09 ($274.92 in chips) 
Seat 5: sebaaastian ($105.21 in chips) 
Seat 8: Monsthand ($134.97 in chips) 
Sweden_Pound: posts small blind $0.50
matiko09: posts big blind $1
hammerwife: sits out 
Slushpup69: sits out 
*** HOLE CARDS ***
Dealt to matiko09 [4c Qc]
sebaaastian: folds 
Monsthand: folds 
mycka86: folds 
xAndorx: raises $1 to $2
Sweden_Pound: folds 
matiko09: folds 
Uncalled bet ($1) returned to xAndorx
xAndorx collected $2.50 from pot
xAndorx: doesn't show hand 
*** SUMMARY ***
Total pot $2.50 | Rake $0 
Seat 1: mycka86 folded before Flop (didn't bet)
Seat 2: xAndorx (button) collected ($2.50)
Seat 3: Sweden_Pound (small blind) folded before Flop
Seat 4: matiko09 (big blind) folded before Flop
Seat 5: sebaaastian folded before Flop (didn't bet)
Seat 8: Monsthand folded before Flop (didn't bet)





PokerStars Hand #149392414783:  Hold'em No Limit ($0.25/$0.50 USD) - 2016/02/25 16:48:42 CET [2016/02/25 10:48:42 ET]
Table 'Ophiuchus III' 9-max Seat #1 is the button
Seat 1: RvPersie ($102.19 in chips) 
Seat 2: ihami ($48 in chips) 
Seat 3: rdrill ($64.47 in chips) 
Seat 5: ReneProost ($33.64 in chips) 
Seat 6: Muinmyheart ($50 in chips) 
Seat 7: Rorerzap ($52.70 in chips) 
Seat 8: matiko09 ($50 in chips) 
Seat 9: tugboat2008 ($80.77 in chips) 
ihami: posts small blind $0.25
rdrill: posts big blind $0.50
lucima10: sits out 
*** HOLE CARDS ***
Dealt to matiko09 [3d 9d]
ReneProost: folds 
Muinmyheart: folds 
Rorerzap: folds 
matiko09: folds 
tugboat2008: raises $1 to $1.50
RvPersie: calls $1.50
ihami: folds 
rdrill: calls $1
*** FLOP *** [As 7h 8d]
rdrill: checks 
tugboat2008: checks 
RvPersie: checks 
*** TURN *** [As 7h 8d] [3c]
rdrill: bets $2.75
tugboat2008 has timed out
tugboat2008: folds 
RvPersie: folds 
Uncalled bet ($2.75) returned to rdrill
rdrill collected $4.54 from pot
*** SUMMARY ***
Total pot $4.75 | Rake $0.21 
Board [As 7h 8d 3c]
Seat 1: RvPersie (button) folded on the Turn
Seat 2: ihami (small blind) folded before Flop
Seat 3: rdrill (big blind) collected ($4.54)
Seat 5: ReneProost folded before Flop (didn't bet)
Seat 6: Muinmyheart folded before Flop (didn't bet)
Seat 7: Rorerzap folded before Flop (didn't bet)
Seat 8: matiko09 folded before Flop (didn't bet)
Seat 9: tugboat2008 folded on the Turn





PokerStars Hand #149392419682:  Hold'em No Limit ($0.50/$1.00 USD) - 2016/02/25 16:48:49 CET [2016/02/25 10:48:49 ET]
Table 'Zeuxo II' 9-max Seat #6 is the button
Seat 1: forsmthgood ($100 in chips) 
Seat 2: Sweden_Pound ($116.03 in chips) 
Seat 3: xAndorx ($93.78 in chips) 
Seat 4: sebaaastian ($122.11 in chips) 
Seat 5: bauss84 ($26.50 in chips) 
Seat 6: Cogss ($101.24 in chips) 
Seat 7: djammusic ($44.50 in chips) 
Seat 8: matiko09 ($100 in chips) 
Seat 9: Sreshta222 ($216.60 in chips) 
djammusic: posts small blind $0.50
matiko09: posts big blind $1
*** HOLE CARDS ***
Dealt to matiko09 [7d Ac]
Sreshta222: folds 
forsmthgood: folds 
Sweden_Pound: folds 
xAndorx: folds 
sebaaastian: folds 
bauss84: raises $2 to $3
Cogss: folds 
djammusic: folds 
matiko09: folds 
Uncalled bet ($2) returned to bauss84
bauss84 collected $2.50 from pot
bauss84: doesn't show hand 
*** SUMMARY ***
Total pot $2.50 | Rake $0 
Seat 1: forsmthgood folded before Flop (didn't bet)
Seat 2: Sweden_Pound folded before Flop (didn't bet)
Seat 3: xAndorx folded before Flop (didn't bet)
Seat 4: sebaaastian folded before Flop (didn't bet)
Seat 5: bauss84 collected ($2.50)
Seat 6: Cogss (button) folded before Flop (didn't bet)
Seat 7: djammusic (small blind) folded before Flop
Seat 8: matiko09 (big blind) folded before Flop
Seat 9: Sreshta222 folded before Flop (didn't bet)





PokerStars Hand #149392419794:  Hold'em No Limit ($0.50/$1.00 USD) - 2016/02/25 16:48:49 CET [2016/02/25 10:48:49 ET]
Table 'Hercules IV' 9-max Seat #8 is the button
Seat 1: matiko09 ($100 in chips) 
Seat 2: hammerwife ($101.50 in chips) 
Seat 3: sebaaastian ($201.70 in chips) 
Seat 4: Sweden_Pound ($110 in chips) 
Seat 5: xAndorx ($156.96 in chips) 
Seat 7: Ouga Buga ($100 in chips) 
Seat 8: brokat77 ($115.04 in chips) 
Seat 9: djammusic ($37.70 in chips) 
djammusic: posts small blind $0.50
matiko09: posts big blind $1
*** HOLE CARDS ***
Dealt to matiko09 [Td 7h]
hammerwife: folds 
sebaaastian: folds 
Sweden_Pound: folds 
xAndorx: folds 
Ouga Buga: folds 
brokat77: folds 
djammusic: raises $1.05 to $2.05
matiko09: folds 
Uncalled bet ($1.05) returned to djammusic
djammusic collected $2 from pot
djammusic: doesn't show hand 
*** SUMMARY ***
Total pot $2 | Rake $0 
Seat 1: matiko09 (big blind) folded before Flop
Seat 2: hammerwife folded before Flop (didn't bet)
Seat 3: sebaaastian folded before Flop (didn't bet)
Seat 4: Sweden_Pound folded before Flop (didn't bet)
Seat 5: xAndorx folded before Flop (didn't bet)
Seat 7: Ouga Buga folded before Flop (didn't bet)
Seat 8: brokat77 (button) folded before Flop (didn't bet)
Seat 9: djammusic (small blind) collected ($2)





PokerStars Hand #149392421030:  Hold'em No Limit (€0.25/€0.50 EUR) - 2016/02/25 16:48:51 CET [2016/02/25 10:48:51 ET]
Table 'Leo Minor III' 9-max Seat #1 is the button
Seat 1: Al3xAnd3r22 (€79.26 in chips) 
Seat 2: vasiy379 (€50.25 in chips) 
Seat 4: RvPersie (€71.56 in chips) 
Seat 5: kasse_62 (€22.62 in chips) 
Seat 6: Wwwasian (€52.54 in chips) 
Seat 7: JustR82 (€50 in chips) 
Seat 9: matiko09 (€72.75 in chips) 
vasiy379: posts small blind €0.25
Rorerzap: is sitting out 
RvPersie: posts big blind €0.50
Bron By: sits out 
*** HOLE CARDS ***
Dealt to matiko09 [2h 8c]
Rorerzap leaves the table
kasse_62: calls €0.50
Wwwasian: folds 
JustR82: raises €1.50 to €2
matiko09: folds 
Al3xAnd3r22: folds 
vasiy379: folds 
RvPersie: folds 
kasse_62: calls €1.50
*** FLOP *** [6c 8h Qh]
kasse_62: checks 
JustR82: bets €2.50
kasse_62: calls €2.50
*** TURN *** [6c 8h Qh] [5s]
kasse_62: checks 
JustR82: checks 
*** RIVER *** [6c 8h Qh 5s] [3d]
kasse_62: bets €5.50
JustR82: folds 
Uncalled bet (€5.50) returned to kasse_62
kasse_62 collected €9.31 from pot
kasse_62: doesn't show hand 
*** SUMMARY ***
Total pot €9.75 | Rake €0.44 
Board [6c 8h Qh 5s 3d]
Seat 1: Al3xAnd3r22 (button) folded before Flop (didn't bet)
Seat 2: vasiy379 (small blind) folded before Flop
Seat 4: RvPersie (big blind) folded before Flop
Seat 5: kasse_62 collected (€9.31)
Seat 6: Wwwasian folded before Flop (didn't bet)
Seat 7: JustR82 folded on the River
Seat 9: matiko09 folded before Flop (didn't bet)





PokerStars Hand #149392423038:  Hold'em No Limit ($0.50/$1.00 USD) - 2016/02/25 16:48:53 CET [2016/02/25 10:48:53 ET]
Table 'Simona' 9-max Seat #3 is the button
Seat 1: mycka86 ($134.34 in chips) 
Seat 2: xAndorx ($145.07 in chips) 
Seat 3: Sweden_Pound ($113.99 in chips) 
Seat 4: matiko09 ($273.92 in chips) 
Seat 5: sebaaastian ($105.21 in chips) 
Seat 8: Monsthand ($134.97 in chips) 
matiko09: posts small blind $0.50
sebaaastian: posts big blind $1
hammerwife: sits out 
Slushpup69: sits out 
*** HOLE CARDS ***
Dealt to matiko09 [Jh Jd]
Monsthand: folds 
mycka86: folds 
xAndorx: folds 
Sweden_Pound: folds 
matiko09: raises $1.50 to $2.50
sebaaastian: folds 
Uncalled bet ($1.50) returned to matiko09
matiko09 collected $2 from pot
matiko09: doesn't show hand 
*** SUMMARY ***
Total pot $2 | Rake $0 
Seat 1: mycka86 folded before Flop (didn't bet)
Seat 2: xAndorx folded before Flop (didn't bet)
Seat 3: Sweden_Pound (button) folded before Flop (didn't bet)
Seat 4: matiko09 (small blind) collected ($2)
Seat 5: sebaaastian (big blind) folded before Flop
Seat 8: Monsthand folded before Flop (didn't bet)





PokerStars Hand #149392430898:  Hold'em No Limit ($0.50/$1.00 USD) - 2016/02/25 16:49:03 CET [2016/02/25 10:49:03 ET]
Table 'Isa' 9-max Seat #4 is the button
Seat 1: matiko09 ($121.94 in chips) 
Seat 2: Monsthand ($100 in chips) 
Seat 3: sebaaastian ($109.90 in chips) 
Seat 4: hammerwife ($100 in chips) 
Seat 5: Sweden_Pound ($102.05 in chips) 
Seat 6: xAndorx ($97.50 in chips) 
Seat 7: bilukm ($171.18 in chips) 
Seat 9: TideHan ($110 in chips) 
Sweden_Pound: posts small blind $0.50
xAndorx: posts big blind $1
Venomous100%: sits out 
*** HOLE CARDS ***
Dealt to matiko09 [3h Ts]
bilukm: folds 
TideHan: folds 
matiko09: folds 
Monsthand: folds 
sebaaastian: folds 
hammerwife: raises $1.01 to $2.01
Sweden_Pound: folds 
xAndorx: calls $1.01
*** FLOP *** [3s Kd As]
xAndorx: checks 
hammerwife: bets $3
xAndorx: folds 
Uncalled bet ($3) returned to hammerwife
hammerwife collected $4.32 from pot
hammerwife: doesn't show hand 
*** SUMMARY ***
Total pot $4.52 | Rake $0.20 
Board [3s Kd As]
Seat 1: matiko09 folded before Flop (didn't bet)
Seat 2: Monsthand folded before Flop (didn't bet)
Seat 3: sebaaastian folded before Flop (didn't bet)
Seat 4: hammerwife (button) collected ($4.32)
Seat 5: Sweden_Pound (small blind) folded before Flop
Seat 6: xAndorx (big blind) folded on the Flop
Seat 7: bilukm folded before Flop (didn't bet)
Seat 9: TideHan folded before Flop (didn't bet)





PokerStars Hand #149392431726:  Hold'em No Limit ($0.25/$0.50 USD) - 2016/02/25 16:49:04 CET [2016/02/25 10:49:04 ET]
Table 'Thalpius III' 9-max Seat #1 is the button
Seat 1: BrotherLove9 ($60.32 in chips) 
Seat 2: matiko09 ($56.04 in chips) 
Seat 3: jamba83 ($52.31 in chips) 
Seat 4: Wwwasian ($50.76 in chips) 
Seat 5: Rorerzap ($56.27 in chips) 
Seat 6: ihami ($52.25 in chips) 
Seat 7: v4n0v ($50 in chips) 
Seat 8: jeroemie123 ($26.73 in chips) 
Seat 9: Domotirko228 ($50 in chips) 
matiko09: posts small blind $0.25
jamba83: posts big blind $0.50
*** HOLE CARDS ***
Dealt to matiko09 [Qd 2h]
Wwwasian: folds 
Rorerzap: folds 
ihami: folds 
v4n0v: raises $1 to $1.50
jeroemie123: folds 
Domotirko228: folds 
BrotherLove9: folds 
matiko09: folds 
jamba83: folds 
Uncalled bet ($1) returned to v4n0v
v4n0v collected $1.25 from pot
v4n0v: doesn't show hand 
*** SUMMARY ***
Total pot $1.25 | Rake $0 
Seat 1: BrotherLove9 (button) folded before Flop (didn't bet)
Seat 2: matiko09 (small blind) folded before Flop
Seat 3: jamba83 (big blind) folded before Flop
Seat 4: Wwwasian folded before Flop (didn't bet)
Seat 5: Rorerzap folded before Flop (didn't bet)
Seat 6: ihami folded before Flop (didn't bet)
Seat 7: v4n0v collected ($1.25)
Seat 8: jeroemie123 folded before Flop (didn't bet)
Seat 9: Domotirko228 folded before Flop (didn't bet)





PokerStars Hand #149392435847:  Hold'em No Limit ($0.50/$1.00 USD) - 2016/02/25 16:49:10 CET [2016/02/25 10:49:10 ET]
Table 'Morosovia II' 9-max Seat #8 is the button
Seat 1: apfush ($187.46 in chips) 
Seat 2: lysandrafly ($100 in chips) 
Seat 3: sebaaastian ($224.03 in chips) 
Seat 4: matiko09 ($167.35 in chips) 
Seat 5: pimpoza ($100 in chips) 
Seat 6: Sweden_Pound ($130.07 in chips) 
Seat 7: Ty Nick 420 ($169.69 in chips) 
Seat 8: Monsthand ($100 in chips) 
Seat 9: Ouga Buga ($133.07 in chips) 
Ouga Buga: posts small blind $0.50
apfush: posts big blind $1
*** HOLE CARDS ***
Dealt to matiko09 [2s Ts]
lysandrafly: folds 
sebaaastian: folds 
matiko09: folds 
pimpoza: folds 
Sweden_Pound: folds 
Ty Nick 420: folds 
Monsthand: folds 
Ouga Buga: folds 
Uncalled bet ($0.50) returned to apfush
apfush collected $1 from pot
apfush: doesn't show hand 
*** SUMMARY ***
Total pot $1 | Rake $0 
Seat 1: apfush (big blind) collected ($1)
Seat 2: lysandrafly folded before Flop (didn't bet)
Seat 3: sebaaastian folded before Flop (didn't bet)
Seat 4: matiko09 folded before Flop (didn't bet)
Seat 5: pimpoza folded before Flop (didn't bet)
Seat 6: Sweden_Pound folded before Flop (didn't bet)
Seat 7: Ty Nick 420 folded before Flop (didn't bet)
Seat 8: Monsthand (button) folded before Flop (didn't bet)
Seat 9: Ouga Buga (small blind) folded before Flop





PokerStars Hand #149392440682:  Hold'em No Limit ($0.25/$0.50 USD) - 2016/02/25 16:49:16 CET [2016/02/25 10:49:16 ET]
Table 'Lohja II' 9-max Seat #4 is the button
Seat 1: MoonJimmy ($146.68 in chips) 
Seat 2: Apparat888 ($31.97 in chips) 
Seat 3: guvalc1952 ($157.77 in chips) 
Seat 4: payback11 ($50 in chips) 
Seat 5: vasiy379 ($50 in chips) 
Seat 6: JustR82 ($50 in chips) 
Seat 7: matiko09 ($133.46 in chips) 
Seat 8: jamba83 ($73.97 in chips) 
Seat 9: Muinmyheart ($74.99 in chips) 
vasiy379: posts small blind $0.25
JustR82: posts big blind $0.50
MoonJimmy: posts the ante $0.10
Apparat888: posts the ante $0.10
guvalc1952: posts the ante $0.10
payback11: posts the ante $0.10
vasiy379: posts the ante $0.10
JustR82: posts the ante $0.10
matiko09: posts the ante $0.10
jamba83: posts the ante $0.10
Muinmyheart: posts the ante $0.10
*** HOLE CARDS ***
Dealt to matiko09 [7d Kh]
matiko09: folds 
jamba83: folds 
Muinmyheart: folds 
MoonJimmy: folds 
Apparat888: raises $0.75 to $1.25
guvalc1952: calls $1.25
payback11: folds 
vasiy379: folds 
JustR82: folds 
*** FLOP *** [7c 8h Ad]
Apparat888: bets $2
guvalc1952: calls $2
*** TURN *** [7c 8h Ad] [4c]
Apparat888: checks 
guvalc1952: bets $3.89
Apparat888: calls $3.89
*** RIVER *** [7c 8h Ad 4c] [Ts]
Apparat888: checks 
guvalc1952: checks 
*** SHOW DOWN ***
Apparat888: shows [9h 9s] (a pair of Nines)
guvalc1952: shows [Ac 5s] (a pair of Aces)
guvalc1952 collected $15.21 from pot
*** SUMMARY ***
Total pot $15.93 | Rake $0.72 
Board [7c 8h Ad 4c Ts]
Seat 1: MoonJimmy folded before Flop (didn't bet)
Seat 2: Apparat888 showed [9h 9s] and lost with a pair of Nines
Seat 3: guvalc1952 showed [Ac 5s] and won ($15.21) with a pair of Aces
Seat 4: payback11 (button) folded before Flop (didn't bet)
Seat 5: vasiy379 (small blind) folded before Flop
Seat 6: JustR82 (big blind) folded before Flop
Seat 7: matiko09 folded before Flop (didn't bet)
Seat 8: jamba83 folded before Flop (didn't bet)
Seat 9: Muinmyheart folded before Flop (didn't bet)





PokerStars Hand #149392442105:  Hold'em No Limit ($0.50/$1.00 USD) - 2016/02/25 16:49:18 CET [2016/02/25 10:49:18 ET]
Table 'Ebella II' 9-max Seat #7 is the button
Seat 1: Ilov3NBA ($100 in chips) 
Seat 2: Sweden_Pound ($100 in chips) 
Seat 3: Lahesell ($100 in chips) 
Seat 4: CoolestWitch ($50.86 in chips) 
Seat 5: matiko09 ($100 in chips) 
Seat 6: RMilPoker ($198.20 in chips) 
Seat 7: HomerrrJay ($100 in chips) 
Seat 8: ZMPOUTSAM140 ($78.86 in chips) 
Seat 9: simoniustin ($100 in chips) 
ZMPOUTSAM140: posts small blind $0.50
simoniustin: posts big blind $1
*** HOLE CARDS ***
Dealt to matiko09 [4h Tc]
Ilov3NBA: folds 
Sweden_Pound: folds 
Lahesell: folds 
CoolestWitch: raises $1.50 to $2.50
matiko09: folds 
RMilPoker: calls $2.50
HomerrrJay: folds 
ZMPOUTSAM140: folds 
simoniustin: folds 
*** FLOP *** [6s Js As]
CoolestWitch: bets $4
RMilPoker: folds 
Uncalled bet ($4) returned to CoolestWitch
CoolestWitch collected $6.21 from pot
CoolestWitch: doesn't show hand 
*** SUMMARY ***
Total pot $6.50 | Rake $0.29 
Board [6s Js As]
Seat 1: Ilov3NBA folded before Flop (didn't bet)
Seat 2: Sweden_Pound folded before Flop (didn't bet)
Seat 3: Lahesell folded before Flop (didn't bet)
Seat 4: CoolestWitch collected ($6.21)
Seat 5: matiko09 folded before Flop (didn't bet)
Seat 6: RMilPoker folded on the Flop
Seat 7: HomerrrJay (button) folded before Flop (didn't bet)
Seat 8: ZMPOUTSAM140 (small blind) folded before Flop
Seat 9: simoniustin (big blind) folded before Flop





PokerStars Hand #149392443290:  Hold'em No Limit ($0.50/$1.00 USD) - 2016/02/25 16:49:20 CET [2016/02/25 10:49:20 ET]
Table 'Guisan' 9-max Seat #6 is the button
Seat 1: stockbridge8 ($82.41 in chips) 
Seat 2: mycka86 ($100 in chips) 
Seat 3: xAndorx ($119.62 in chips) 
Seat 4: matiko09 ($169.25 in chips) 
Seat 5: Jeckpot1989 ($88.73 in chips) 
Seat 6: 19R&J91 ($386.07 in chips) 
Seat 7: sebaaastian ($115.59 in chips) 
Seat 8: Monsthand ($110.73 in chips) 
Seat 9: Sweden_Pound ($107.69 in chips) 
sebaaastian: posts small blind $0.50
Monsthand: posts big blind $1
*** HOLE CARDS ***
Dealt to matiko09 [Ah Qd]
Sweden_Pound: folds 
stockbridge8: folds 
mycka86: folds 
xAndorx: folds 
matiko09: raises $2 to $3
Jeckpot1989: folds 
19R&J91: calls $3
sebaaastian: folds 
Monsthand: calls $2
*** FLOP *** [Jh As 4h]
Monsthand: checks 
matiko09: bets $5.90
19R&J91: folds 
Monsthand: raises $11.10 to $17
matiko09: folds 
Uncalled bet ($11.10) returned to Monsthand
Monsthand collected $20.34 from pot
*** SUMMARY ***
Total pot $21.30 | Rake $0.96 
Board [Jh As 4h]
Seat 1: stockbridge8 folded before Flop (didn't bet)
Seat 2: mycka86 folded before Flop (didn't bet)
Seat 3: xAndorx folded before Flop (didn't bet)
Seat 4: matiko09 folded on the Flop
Seat 5: Jeckpot1989 folded before Flop (didn't bet)
Seat 6: 19R&J91 (button) folded on the Flop
Seat 7: sebaaastian (small blind) folded before Flop
Seat 8: Monsthand (big blind) collected ($20.34)
Seat 9: Sweden_Pound folded before Flop (didn't bet)





PokerStars Hand #149392443879:  Hold'em No Limit ($0.50/$1.00 USD) - 2016/02/25 16:49:20 CET [2016/02/25 10:49:20 ET]
Table 'Simona' 9-max Seat #4 is the button
Seat 1: mycka86 ($134.34 in chips) 
Seat 2: xAndorx ($145.07 in chips) 
Seat 3: Sweden_Pound ($113.99 in chips) 
Seat 4: matiko09 ($274.92 in chips) 
Seat 5: sebaaastian ($104.21 in chips) 
Seat 7: hammerwife ($100 in chips) 
Seat 8: Monsthand ($134.97 in chips) 
sebaaastian: posts small blind $0.50
hammerwife: posts big blind $1
Slushpup69: sits out 
*** HOLE CARDS ***
Dealt to matiko09 [Tc 2h]
Monsthand: folds 
mycka86: folds 
xAndorx: folds 
Sweden_Pound: raises $1.50 to $2.50
matiko09: folds 
sebaaastian: folds 
hammerwife: folds 
Uncalled bet ($1.50) returned to Sweden_Pound
Sweden_Pound collected $2.50 from pot
Sweden_Pound: doesn't show hand 
*** SUMMARY ***
Total pot $2.50 | Rake $0 
Seat 1: mycka86 folded before Flop (didn't bet)
Seat 2: xAndorx folded before Flop (didn't bet)
Seat 3: Sweden_Pound collected ($2.50)
Seat 4: matiko09 (button) folded before Flop (didn't bet)
Seat 5: sebaaastian (small blind) folded before Flop
Seat 7: hammerwife (big blind) folded before Flop
Seat 8: Monsthand folded before Flop (didn't bet)





PokerStars Hand #149392445419:  Hold'em No Limit ($0.50/$1.00 USD) - 2016/02/25 16:49:22 CET [2016/02/25 10:49:22 ET]
Table 'Zeuxo II' 9-max Seat #7 is the button
Seat 1: forsmthgood ($100 in chips) 
Seat 2: Sweden_Pound ($116.03 in chips) 
Seat 3: xAndorx ($93.78 in chips) 
Seat 4: sebaaastian ($122.11 in chips) 
Seat 5: bauss84 ($28 in chips) 
Seat 6: Cogss ($101.24 in chips) 
Seat 7: djammusic ($44 in chips) 
Seat 8: matiko09 ($100 in chips) 
matiko09: posts small blind $0.50
forsmthgood: posts big blind $1
*** HOLE CARDS ***
Dealt to matiko09 [Td 4s]
Sweden_Pound: folds 
xAndorx: folds 
sebaaastian: folds 
bauss84: folds 
Cogss: raises $1 to $2
djammusic: folds 
matiko09: folds 
forsmthgood: raises $5.50 to $7.50
Cogss: calls $5.50
*** FLOP *** [7c Jc 9h]
forsmthgood: bets $10
Cogss: folds 
Uncalled bet ($10) returned to forsmthgood
forsmthgood collected $14.80 from pot
forsmthgood: doesn't show hand 
*** SUMMARY ***
Total pot $15.50 | Rake $0.70 
Board [7c Jc 9h]
Seat 1: forsmthgood (big blind) collected ($14.80)
Seat 2: Sweden_Pound folded before Flop (didn't bet)
Seat 3: xAndorx folded before Flop (didn't bet)
Seat 4: sebaaastian folded before Flop (didn't bet)
Seat 5: bauss84 folded before Flop (didn't bet)
Seat 6: Cogss folded on the Flop
Seat 7: djammusic (button) folded before Flop (didn't bet)
Seat 8: matiko09 (small blind) folded before Flop





PokerStars Hand #149392448786:  Hold'em No Limit ($0.50/$1.00 USD) - 2016/02/25 16:49:27 CET [2016/02/25 10:49:27 ET]
Table 'Hercules IV' 9-max Seat #9 is the button
Seat 1: matiko09 ($100 in chips) 
Seat 2: hammerwife ($101.50 in chips) 
Seat 3: sebaaastian ($201.70 in chips) 
Seat 4: Sweden_Pound ($110 in chips) 
Seat 5: xAndorx ($156.96 in chips) 
Seat 7: Ouga Buga ($100 in chips) 
Seat 8: brokat77 ($115.04 in chips) 
Seat 9: djammusic ($38.70 in chips) 
matiko09: posts small blind $0.50
hammerwife: posts big blind $1
*** HOLE CARDS ***
Dealt to matiko09 [2c Kh]
sebaaastian: folds 
Sweden_Pound: folds 
xAndorx: folds 
Ouga Buga: folds 
brokat77: folds 
djammusic: raises $1.02 to $2.02
matiko09: folds 
hammerwife: raises $35.98 to $38
djammusic: folds 
Uncalled bet ($35.98) returned to hammerwife
hammerwife collected $4.54 from pot
hammerwife: doesn't show hand 
*** SUMMARY ***
Total pot $4.54 | Rake $0 
Seat 1: matiko09 (small blind) folded before Flop
Seat 2: hammerwife (big blind) collected ($4.54)
Seat 3: sebaaastian folded before Flop (didn't bet)
Seat 4: Sweden_Pound folded before Flop (didn't bet)
Seat 5: xAndorx folded before Flop (didn't bet)
Seat 7: Ouga Buga folded before Flop (didn't bet)
Seat 8: brokat77 folded before Flop (didn't bet)
Seat 9: djammusic (button) folded before Flop





PokerStars Hand #149392451534:  Hold'em No Limit ($0.50/$1.00 USD) - 2016/02/25 16:49:30 CET [2016/02/25 10:49:30 ET]
Table 'Morosovia II' 9-max Seat #9 is the button
Seat 1: apfush ($187.96 in chips) 
Seat 2: lysandrafly ($100 in chips) 
Seat 3: sebaaastian ($224.03 in chips) 
Seat 4: matiko09 ($167.35 in chips) 
Seat 5: pimpoza ($100 in chips) 
Seat 6: Sweden_Pound ($130.07 in chips) 
Seat 7: Ty Nick 420 ($169.69 in chips) 
Seat 8: Monsthand ($100 in chips) 
Seat 9: Ouga Buga ($132.57 in chips) 
apfush: posts small blind $0.50
lysandrafly: posts big blind $1
*** HOLE CARDS ***
Dealt to matiko09 [Th Qc]
sebaaastian: folds 
matiko09: folds 
pimpoza: folds 
Sweden_Pound: folds 
Ty Nick 420: raises $1.50 to $2.50
Monsthand: folds 
Ouga Buga: folds 
apfush: folds 
lysandrafly: folds 
Uncalled bet ($1.50) returned to Ty Nick 420
Ty Nick 420 collected $2.50 from pot
*** SUMMARY ***
Total pot $2.50 | Rake $0 
Seat 1: apfush (small blind) folded before Flop
Seat 2: lysandrafly (big blind) folded before Flop
Seat 3: sebaaastian folded before Flop (didn't bet)
Seat 4: matiko09 folded before Flop (didn't bet)
Seat 5: pimpoza folded before Flop (didn't bet)
Seat 6: Sweden_Pound folded before Flop (didn't bet)
Seat 7: Ty Nick 420 collected ($2.50)
Seat 8: Monsthand folded before Flop (didn't bet)
Seat 9: Ouga Buga (button) folded before Flop (didn't bet)





PokerStars Hand #149392461200:  Hold'em No Limit ($0.50/$1.00 USD) - 2016/02/25 16:49:43 CET [2016/02/25 10:49:43 ET]
Table 'Badenia II' 9-max Seat #6 is the button
Seat 1: matiko09 ($101.50 in chips) 
Seat 2: Stibitzkie ($24.45 in chips) 
Seat 3: sebaaastian ($100 in chips) 
Seat 4: KarlMoik1 ($346.94 in chips) 
Seat 5: djammusic ($122.09 in chips) 
Seat 6: xAndorx ($101.71 in chips) 
Seat 7: forsmthgood ($100 in chips) 
Seat 8: Sweden_Pound ($128.92 in chips) 
Seat 9: waisanen ($230.04 in chips) 
forsmthgood: posts small blind $0.50
Sweden_Pound: posts big blind $1
*** HOLE CARDS ***
Dealt to matiko09 [Qc 4c]
waisanen: folds 
matiko09: folds 
Stibitzkie: raises $23.45 to $24.45 and is all-in
sebaaastian: calls $24.45
KarlMoik1: folds 
djammusic: folds 
xAndorx: folds 
forsmthgood: folds 
Sweden_Pound: folds 
*** FLOP *** [7c 5h 5s]
*** TURN *** [7c 5h 5s] [Ac]
*** RIVER *** [7c 5h 5s Ac] [Ad]
*** SHOW DOWN ***
Stibitzkie: shows [8h 6h] (two pair, Aces and Fives)
sebaaastian: shows [Ah Kh] (a full house, Aces full of Fives)
sebaaastian collected $48.13 from pot
*** SUMMARY ***
Total pot $50.40 | Rake $2.27 
Board [7c 5h 5s Ac Ad]
Seat 1: matiko09 folded before Flop (didn't bet)
Seat 2: Stibitzkie showed [8h 6h] and lost with two pair, Aces and Fives
Seat 3: sebaaastian showed [Ah Kh] and won ($48.13) with a full house, Aces full of Fives
Seat 4: KarlMoik1 folded before Flop (didn't bet)
Seat 5: djammusic folded before Flop (didn't bet)
Seat 6: xAndorx (button) folded before Flop (didn't bet)
Seat 7: forsmthgood (small blind) folded before Flop
Seat 8: Sweden_Pound (big blind) folded before Flop
Seat 9: waisanen folded before Flop (didn't bet)





PokerStars Hand #149392462650:  Hold'em No Limit ($0.50/$1.00 USD) - 2016/02/25 16:49:45 CET [2016/02/25 10:49:45 ET]
Table 'Simona' 9-max Seat #5 is the button
Seat 1: mycka86 ($134.34 in chips) 
Seat 2: xAndorx ($145.07 in chips) 
Seat 3: Sweden_Pound ($115.49 in chips) 
Seat 4: matiko09 ($274.92 in chips) 
Seat 5: sebaaastian ($103.71 in chips) 
Seat 7: hammerwife ($100 in chips) 
Seat 9: Slushpup69 ($55.65 in chips) 
hammerwife: posts small blind $0.50
Monsthand: is sitting out 
Slushpup69: posts big blind $1
*** HOLE CARDS ***
Dealt to matiko09 [Kh 2h]
Monsthand leaves the table
mycka86: folds 
xAndorx: folds 
Sweden_Pound: folds 
matiko09: folds 
sebaaastian: folds 
hammerwife: folds 
Uncalled bet ($0.50) returned to Slushpup69
Slushpup69 collected $1 from pot
*** SUMMARY ***
Total pot $1 | Rake $0 
Seat 1: mycka86 folded before Flop (didn't bet)
Seat 2: xAndorx folded before Flop (didn't bet)
Seat 3: Sweden_Pound folded before Flop (didn't bet)
Seat 4: matiko09 folded before Flop (didn't bet)
Seat 5: sebaaastian (button) folded before Flop (didn't bet)
Seat 7: hammerwife (small blind) folded before Flop
Seat 9: Slushpup69 (big blind) collected ($1)





PokerStars Hand #149392464069:  Hold'em No Limit (€0.25/€0.50 EUR) - 2016/02/25 16:49:47 CET [2016/02/25 10:49:47 ET]
Table 'Leo Minor III' 9-max Seat #2 is the button
Seat 1: Al3xAnd3r22 (€79.26 in chips) 
Seat 2: vasiy379 (€50 in chips) 
Seat 4: RvPersie (€71.06 in chips) 
Seat 5: kasse_62 (€27.43 in chips) 
Seat 6: Wwwasian (€52.54 in chips) 
Seat 7: JustR82 (€50 in chips) 
Seat 9: matiko09 (€72.75 in chips) 
RvPersie: posts small blind €0.25
kasse_62: posts big blind €0.50
Bron By: sits out 
*** HOLE CARDS ***
Dealt to matiko09 [Jc Qc]
Wwwasian: folds 
JustR82: folds 
matiko09: raises €1 to €1.50
Al3xAnd3r22: folds 
vasiy379: folds 
RvPersie: folds 
kasse_62: folds 
Uncalled bet (€1) returned to matiko09
matiko09 collected €1.25 from pot
matiko09: doesn't show hand 
*** SUMMARY ***
Total pot €1.25 | Rake €0 
Seat 1: Al3xAnd3r22 folded before Flop (didn't bet)
Seat 2: vasiy379 (button) folded before Flop (didn't bet)
Seat 4: RvPersie (small blind) folded before Flop
Seat 5: kasse_62 (big blind) folded before Flop
Seat 6: Wwwasian folded before Flop (didn't bet)
Seat 7: JustR82 folded before Flop (didn't bet)
Seat 9: matiko09 collected (€1.25)





PokerStars Hand #149392463916:  Hold'em No Limit ($0.50/$1.00 USD) - 2016/02/25 16:49:47 CET [2016/02/25 10:49:47 ET]
Table 'Isa' 9-max Seat #5 is the button
Seat 1: matiko09 ($121.94 in chips) 
Seat 2: Monsthand ($100 in chips) 
Seat 3: sebaaastian ($109.90 in chips) 
Seat 4: hammerwife ($102.31 in chips) 
Seat 5: Sweden_Pound ($101.55 in chips) 
Seat 6: xAndorx ($95.49 in chips) 
Seat 7: bilukm ($171.18 in chips) 
Seat 9: TideHan ($110 in chips) 
xAndorx: posts small blind $0.50
bilukm: posts big blind $1
Venomous100%: sits out 
*** HOLE CARDS ***
Dealt to matiko09 [6c Ts]
TideHan: folds 
matiko09: folds 
Monsthand: folds 
sebaaastian: folds 
hammerwife: folds 
Sweden_Pound: folds 
xAndorx: folds 
Uncalled bet ($0.50) returned to bilukm
bilukm collected $1 from pot
bilukm: doesn't show hand 
*** SUMMARY ***
Total pot $1 | Rake $0 
Seat 1: matiko09 folded before Flop (didn't bet)
Seat 2: Monsthand folded before Flop (didn't bet)
Seat 3: sebaaastian folded before Flop (didn't bet)
Seat 4: hammerwife folded before Flop (didn't bet)
Seat 5: Sweden_Pound (button) folded before Flop (didn't bet)
Seat 6: xAndorx (small blind) folded before Flop
Seat 7: bilukm (big blind) collected ($1)
Seat 9: TideHan folded before Flop (didn't bet)





PokerStars Hand #149392472339:  Hold'em No Limit ($0.25/$0.50 USD) - 2016/02/25 16:49:58 CET [2016/02/25 10:49:58 ET]
Table 'Thalpius III' 9-max Seat #2 is the button
Seat 1: BrotherLove9 ($60.32 in chips) 
Seat 2: matiko09 ($55.79 in chips) 
Seat 3: jamba83 ($51.81 in chips) 
Seat 4: Wwwasian ($50.76 in chips) 
Seat 5: Rorerzap ($56.27 in chips) 
Seat 6: ihami ($52.25 in chips) 
Seat 7: v4n0v ($50.75 in chips) 
Seat 8: jeroemie123 ($26.73 in chips) 
Seat 9: Domotirko228 ($50 in chips) 
jamba83: posts small blind $0.25
Wwwasian: posts big blind $0.50
*** HOLE CARDS ***
Dealt to matiko09 [4s 2h]
Rorerzap: folds 
ihami: folds 
v4n0v: folds 
jeroemie123: raises $0.50 to $1
Domotirko228: folds 
BrotherLove9: folds 
matiko09: folds 
jamba83: calls $0.75
Wwwasian: calls $0.50
*** FLOP *** [6c Qc 3h]
jamba83: checks 
Wwwasian: checks 
jeroemie123: bets $1.50
jamba83: folds 
Wwwasian: calls $1.50
*** TURN *** [6c Qc 3h] [3c]
Wwwasian: checks 
jeroemie123: bets $3
Wwwasian: raises $6.50 to $9.50
jeroemie123: raises $6.50 to $16
Wwwasian: calls $6.50
*** RIVER *** [6c Qc 3h 3c] [4c]
Wwwasian: bets $32.26 and is all-in
jeroemie123: calls $8.23 and is all-in
Uncalled bet ($24.03) returned to Wwwasian
*** SHOW DOWN ***
Wwwasian: shows [3d 4d] (a full house, Threes full of Fours)
jeroemie123: shows [7c Jc] (a flush, Queen high)
Wwwasian collected $52.01 from pot
*** SUMMARY ***
Total pot $54.46 | Rake $2.45 
Board [6c Qc 3h 3c 4c]
Seat 1: BrotherLove9 folded before Flop (didn't bet)
Seat 2: matiko09 (button) folded before Flop (didn't bet)
Seat 3: jamba83 (small blind) folded on the Flop
Seat 4: Wwwasian (big blind) showed [3d 4d] and won ($52.01) with a full house, Threes full of Fours
Seat 5: Rorerzap folded before Flop (didn't bet)
Seat 6: ihami folded before Flop (didn't bet)
Seat 7: v4n0v folded before Flop (didn't bet)
Seat 8: jeroemie123 showed [7c Jc] and lost with a flush, Queen high
Seat 9: Domotirko228 folded before Flop (didn't bet)





PokerStars Hand #149392478212:  Hold'em No Limit ($0.50/$1.00 USD) - 2016/02/25 16:50:05 CET [2016/02/25 10:50:05 ET]
Table 'Simona' 9-max Seat #7 is the button
Seat 1: mycka86 ($134.34 in chips) 
Seat 2: xAndorx ($145.07 in chips) 
Seat 3: Sweden_Pound ($115.49 in chips) 
Seat 4: matiko09 ($274.92 in chips) 
Seat 5: sebaaastian ($103.71 in chips) 
Seat 7: hammerwife ($100 in chips) 
Seat 9: Slushpup69 ($56.15 in chips) 
Slushpup69: posts small blind $0.50
mycka86: posts big blind $1
*** HOLE CARDS ***
Dealt to matiko09 [Kd 8c]
xAndorx: folds 
Sweden_Pound: folds 
matiko09: folds 
Ouga Buga joins the table at seat #8 
sebaaastian: raises $1.50 to $2.50
hammerwife: folds 
Slushpup69: raises $8.50 to $11
mycka86: folds 
sebaaastian: calls $8.50
*** FLOP *** [Jh 6c 3c]
Slushpup69: bets $10.98
sebaaastian: raises $81.73 to $92.71 and is all-in
Slushpup69: folds 
Uncalled bet ($81.73) returned to sebaaastian
sebaaastian collected $42.94 from pot
sebaaastian: doesn't show hand 
*** SUMMARY ***
Total pot $44.96 | Rake $2.02 
Board [Jh 6c 3c]
Seat 1: mycka86 (big blind) folded before Flop
Seat 2: xAndorx folded before Flop (didn't bet)
Seat 3: Sweden_Pound folded before Flop (didn't bet)
Seat 4: matiko09 folded before Flop (didn't bet)
Seat 5: sebaaastian collected ($42.94)
Seat 7: hammerwife (button) folded before Flop (didn't bet)
Seat 9: Slushpup69 (small blind) folded on the Flop





PokerStars Hand #149392479824:  Hold'em No Limit ($0.50/$1.00 USD) - 2016/02/25 16:50:07 CET [2016/02/25 10:50:07 ET]
Table 'Hercules IV' 9-max Seat #1 is the button
Seat 1: matiko09 ($100 in chips) 
Seat 2: hammerwife ($104.02 in chips) 
Seat 3: sebaaastian ($201.70 in chips) 
Seat 4: Sweden_Pound ($110 in chips) 
Seat 5: xAndorx ($156.96 in chips) 
Seat 7: Ouga Buga ($100 in chips) 
Seat 8: brokat77 ($115.04 in chips) 
Seat 9: djammusic ($36.68 in chips) 
hammerwife: posts small blind $0.50
sebaaastian: posts big blind $1
*** HOLE CARDS ***
Dealt to matiko09 [Ad 8h]
Sweden_Pound: folds 
xAndorx: folds 
Ouga Buga: folds 
brokat77: folds 
djammusic: raises $1.02 to $2.02
matiko09: folds 
hammerwife: folds 
sebaaastian: folds 
Uncalled bet ($1.02) returned to djammusic
djammusic collected $2.50 from pot
djammusic: doesn't show hand 
*** SUMMARY ***
Total pot $2.50 | Rake $0 
Seat 1: matiko09 (button) folded before Flop (didn't bet)
Seat 2: hammerwife (small blind) folded before Flop
Seat 3: sebaaastian (big blind) folded before Flop
Seat 4: Sweden_Pound folded before Flop (didn't bet)
Seat 5: xAndorx folded before Flop (didn't bet)
Seat 7: Ouga Buga folded before Flop (didn't bet)
Seat 8: brokat77 folded before Flop (didn't bet)
Seat 9: djammusic collected ($2.50)





PokerStars Hand #149392482272:  Hold'em No Limit ($0.25/$0.50 USD) - 2016/02/25 16:50:11 CET [2016/02/25 10:50:11 ET]
Table 'Lohja II' 9-max Seat #5 is the button
Seat 1: MoonJimmy ($146.58 in chips) 
Seat 2: Apparat888 ($24.73 in chips) 
Seat 3: guvalc1952 ($165.74 in chips) 
Seat 4: payback11 ($50 in chips) 
Seat 5: vasiy379 ($50 in chips) 
Seat 6: JustR82 ($50 in chips) 
Seat 7: matiko09 ($133.36 in chips) 
Seat 8: jamba83 ($73.87 in chips) 
Seat 9: Muinmyheart ($74.89 in chips) 
JustR82: posts small blind $0.25
matiko09: posts big blind $0.50
MoonJimmy: posts the ante $0.10
Apparat888: posts the ante $0.10
guvalc1952: posts the ante $0.10
payback11: posts the ante $0.10
vasiy379: posts the ante $0.10
JustR82: posts the ante $0.10
matiko09: posts the ante $0.10
jamba83: posts the ante $0.10
Muinmyheart: posts the ante $0.10
*** HOLE CARDS ***
Dealt to matiko09 [Jd 5s]
jamba83: folds 
Muinmyheart: folds 
MoonJimmy: folds 
Apparat888: folds 
guvalc1952: calls $0.50
payback11: folds 
vasiy379: folds 
JustR82: folds 
matiko09: checks 
*** FLOP *** [8d Kh Ac]
matiko09: checks 
guvalc1952: checks 
*** TURN *** [8d Kh Ac] [As]
matiko09: checks 
guvalc1952: checks 
*** RIVER *** [8d Kh Ac As] [3h]
matiko09: checks 
guvalc1952: checks 
*** SHOW DOWN ***
matiko09: shows [Jd 5s] (a pair of Aces)
guvalc1952: shows [9c 8c] (two pair, Aces and Eights)
guvalc1952 collected $2.05 from pot
*** SUMMARY ***
Total pot $2.15 | Rake $0.10 
Board [8d Kh Ac As 3h]
Seat 1: MoonJimmy folded before Flop (didn't bet)
Seat 2: Apparat888 folded before Flop (didn't bet)
Seat 3: guvalc1952 showed [9c 8c] and won ($2.05) with two pair, Aces and Eights
Seat 4: payback11 folded before Flop (didn't bet)
Seat 5: vasiy379 (button) folded before Flop (didn't bet)
Seat 6: JustR82 (small blind) folded before Flop
Seat 7: matiko09 (big blind) showed [Jd 5s] and lost with a pair of Aces
Seat 8: jamba83 folded before Flop (didn't bet)
Seat 9: Muinmyheart folded before Flop (didn't bet)





PokerStars Hand #149392485985:  Hold'em No Limit (€0.25/€0.50 EUR) - 2016/02/25 16:50:16 CET [2016/02/25 10:50:16 ET]
Table 'Leo Minor III' 9-max Seat #4 is the button
Seat 1: Al3xAnd3r22 (€79.26 in chips) 
Seat 2: vasiy379 (€50 in chips) 
Seat 4: RvPersie (€70.81 in chips) 
Seat 5: kasse_62 (€26.93 in chips) 
Seat 6: Wwwasian (€52.54 in chips) 
Seat 7: JustR82 (€50 in chips) 
Seat 9: matiko09 (€73.50 in chips) 
kasse_62: posts small blind €0.25
Wwwasian: posts big blind €0.50
Bron By: sits out 
*** HOLE CARDS ***
Dealt to matiko09 [Ks 5h]
JustR82: folds 
matiko09: folds 
Al3xAnd3r22: folds 
vasiy379: folds 
RvPersie: raises €0.75 to €1.25
kasse_62: calls €1
Wwwasian: folds 
*** FLOP *** [5c 6d Ts]
kasse_62: checks 
RvPersie: bets €1.88
kasse_62: calls €1.88
*** TURN *** [5c 6d Ts] [Kh]
kasse_62: checks 
RvPersie: bets €4.84
kasse_62: calls €4.84
*** RIVER *** [5c 6d Ts Kh] [Qd]
kasse_62: checks 
RvPersie: checks 
*** SHOW DOWN ***
kasse_62: shows [8c 7s] (high card King)
RvPersie: shows [Qs Jc] (a pair of Queens)
RvPersie collected €15.70 from pot
*** SUMMARY ***
Total pot €16.44 | Rake €0.74 
Board [5c 6d Ts Kh Qd]
Seat 1: Al3xAnd3r22 folded before Flop (didn't bet)
Seat 2: vasiy379 folded before Flop (didn't bet)
Seat 4: RvPersie (button) showed [Qs Jc] and won (€15.70) with a pair of Queens
Seat 5: kasse_62 (small blind) showed [8c 7s] and lost with high card King
Seat 6: Wwwasian (big blind) folded before Flop
Seat 7: JustR82 folded before Flop (didn't bet)
Seat 9: matiko09 folded before Flop (didn't bet)





PokerStars Hand #149392486393:  Hold'em No Limit ($0.50/$1.00 USD) - 2016/02/25 16:50:16 CET [2016/02/25 10:50:16 ET]
Table 'Zeuxo II' 9-max Seat #8 is the button
Seat 1: forsmthgood ($107.30 in chips) 
Seat 2: Sweden_Pound ($116.03 in chips) 
Seat 3: xAndorx ($93.78 in chips) 
Seat 4: sebaaastian ($122.11 in chips) 
Seat 5: bauss84 ($28 in chips) 
Seat 6: Cogss ($93.74 in chips) 
Seat 7: djammusic ($44 in chips) 
Seat 8: matiko09 ($100 in chips) 
forsmthgood: posts small blind $0.50
Sweden_Pound: posts big blind $1
*** HOLE CARDS ***
Dealt to matiko09 [Ac 5d]
xAndorx: folds 
sebaaastian: folds 
bauss84: folds 
Cogss: folds 
djammusic: raises $1.02 to $2.02
matiko09: folds 
forsmthgood: folds 
Sweden_Pound: folds 
Uncalled bet ($1.02) returned to djammusic
djammusic collected $2.50 from pot
djammusic: doesn't show hand 
*** SUMMARY ***
Total pot $2.50 | Rake $0 
Seat 1: forsmthgood (small blind) folded before Flop
Seat 2: Sweden_Pound (big blind) folded before Flop
Seat 3: xAndorx folded before Flop (didn't bet)
Seat 4: sebaaastian folded before Flop (didn't bet)
Seat 5: bauss84 folded before Flop (didn't bet)
Seat 6: Cogss folded before Flop (didn't bet)
Seat 7: djammusic collected ($2.50)
Seat 8: matiko09 (button) folded before Flop (didn't bet)





PokerStars Hand #149392490937:  Hold'em No Limit ($0.50/$1.00 USD) - 2016/02/25 16:50:22 CET [2016/02/25 10:50:22 ET]
Table 'Morosovia II' 9-max Seat #1 is the button
Seat 1: apfush ($187.46 in chips) 
Seat 2: lysandrafly ($100 in chips) 
Seat 3: sebaaastian ($224.03 in chips) 
Seat 4: matiko09 ($167.35 in chips) 
Seat 5: pimpoza ($100 in chips) 
Seat 6: Sweden_Pound ($130.07 in chips) 
Seat 7: Ty Nick 420 ($171.19 in chips) 
Seat 8: Monsthand ($100 in chips) 
Seat 9: Ouga Buga ($132.57 in chips) 
lysandrafly: posts small blind $0.50
sebaaastian: posts big blind $1
*** HOLE CARDS ***
Dealt to matiko09 [8h Kc]
matiko09: folds 
pimpoza: folds 
Sweden_Pound: folds 
Ty Nick 420: folds 
Monsthand: folds 
Ouga Buga: folds 
apfush: raises $1.20 to $2.20
lysandrafly: folds 
sebaaastian: folds 
Uncalled bet ($1.20) returned to apfush
apfush collected $2.50 from pot
apfush: doesn't show hand 
*** SUMMARY ***
Total pot $2.50 | Rake $0 
Seat 1: apfush (button) collected ($2.50)
Seat 2: lysandrafly (small blind) folded before Flop
Seat 3: sebaaastian (big blind) folded before Flop
Seat 4: matiko09 folded before Flop (didn't bet)
Seat 5: pimpoza folded before Flop (didn't bet)
Seat 6: Sweden_Pound folded before Flop (didn't bet)
Seat 7: Ty Nick 420 folded before Flop (didn't bet)
Seat 8: Monsthand folded before Flop (didn't bet)
Seat 9: Ouga Buga folded before Flop (didn't bet)





PokerStars Hand #149392493078:  Hold'em No Limit ($0.50/$1.00 USD) - 2016/02/25 16:50:25 CET [2016/02/25 10:50:25 ET]
Table 'Sabine' 9-max Seat #6 is the button
Seat 1: Aalleekks ($103.52 in chips) 
Seat 2: apfush ($109.92 in chips) 
Seat 3: Monsthand ($210.87 in chips) 
Seat 4: hammerwife ($101.50 in chips) 
Seat 5: RMilPoker ($96.50 in chips) 
Seat 6: Sweden_Pound ($115.16 in chips) 
Seat 7: clayshmert ($77.49 in chips) 
Seat 8: matiko09 ($100 in chips) 
Seat 9: djammusic ($54.22 in chips) 
clayshmert: posts small blind $0.50
matiko09: posts big blind $1
*** HOLE CARDS ***
Dealt to matiko09 [4s Ac]
djammusic: folds 
Aalleekks: folds 
apfush: folds 
Monsthand: folds 
hammerwife: folds 
RMilPoker: raises $2 to $3
Sweden_Pound: folds 
clayshmert: folds 
matiko09: folds 
Uncalled bet ($2) returned to RMilPoker
RMilPoker collected $2.50 from pot
RMilPoker: doesn't show hand 
*** SUMMARY ***
Total pot $2.50 | Rake $0 
Seat 1: Aalleekks folded before Flop (didn't bet)
Seat 2: apfush folded before Flop (didn't bet)
Seat 3: Monsthand folded before Flop (didn't bet)
Seat 4: hammerwife folded before Flop (didn't bet)
Seat 5: RMilPoker collected ($2.50)
Seat 6: Sweden_Pound (button) folded before Flop (didn't bet)
Seat 7: clayshmert (small blind) folded before Flop
Seat 8: matiko09 (big blind) folded before Flop
Seat 9: djammusic folded before Flop (didn't bet)





PokerStars Hand #149392494206:  Hold'em No Limit ($0.25/$0.50 USD) - 2016/02/25 16:50:26 CET [2016/02/25 10:50:26 ET]
Table 'Ophiuchus III' 9-max Seat #2 is the button
Seat 1: RvPersie ($100.69 in chips) 
Seat 2: ihami ($47.75 in chips) 
Seat 3: rdrill ($67.51 in chips) 
Seat 4: lucima10 ($50 in chips) 
Seat 5: ReneProost ($33.64 in chips) 
Seat 6: Muinmyheart ($50 in chips) 
Seat 7: Rorerzap ($52.70 in chips) 
Seat 8: matiko09 ($50 in chips) 
Seat 9: tugboat2008 ($79.27 in chips) 
rdrill: posts small blind $0.25
lucima10: posts big blind $0.50
*** HOLE CARDS ***
Dealt to matiko09 [Ks 2d]
ReneProost: folds 
Muinmyheart: folds 
Rorerzap: folds 
matiko09: folds 
tugboat2008: raises $1 to $1.50
RvPersie: folds 
ihami: folds 
rdrill: folds 
lucima10: folds 
Uncalled bet ($1) returned to tugboat2008
tugboat2008 collected $1.25 from pot
*** SUMMARY ***
Total pot $1.25 | Rake $0 
Seat 1: RvPersie folded before Flop (didn't bet)
Seat 2: ihami (button) folded before Flop (didn't bet)
Seat 3: rdrill (small blind) folded before Flop
Seat 4: lucima10 (big blind) folded before Flop
Seat 5: ReneProost folded before Flop (didn't bet)
Seat 6: Muinmyheart folded before Flop (didn't bet)
Seat 7: Rorerzap folded before Flop (didn't bet)
Seat 8: matiko09 folded before Flop (didn't bet)
Seat 9: tugboat2008 collected ($1.25)





PokerStars Hand #149392495082:  Hold'em No Limit ($0.50/$1.00 USD) - 2016/02/25 16:50:27 CET [2016/02/25 10:50:27 ET]
Table 'Isa' 9-max Seat #6 is the button
Seat 1: matiko09 ($121.94 in chips) 
Seat 2: Monsthand ($100 in chips) 
Seat 3: sebaaastian ($109.90 in chips) 
Seat 4: hammerwife ($102.31 in chips) 
Seat 5: Sweden_Pound ($101.55 in chips) 
Seat 6: xAndorx ($94.99 in chips) 
Seat 7: bilukm ($171.68 in chips) 
Seat 8: Venomous100% ($100 in chips) 
Seat 9: TideHan ($110 in chips) 
bilukm: posts small blind $0.50
Venomous100%: posts big blind $1
*** HOLE CARDS ***
Dealt to matiko09 [9c Js]
TideHan: folds 
matiko09: folds 
Monsthand: folds 
sebaaastian: folds 
hammerwife: folds 
Sweden_Pound: raises $1.50 to $2.50
xAndorx: folds 
bilukm: calls $2
Venomous100%: folds 
*** FLOP *** [Qh 7h 2h]
bilukm: bets $1
Sweden_Pound: raises $6 to $7
bilukm: folds 
Uncalled bet ($6) returned to Sweden_Pound
Sweden_Pound collected $7.64 from pot
Sweden_Pound: doesn't show hand 
*** SUMMARY ***
Total pot $8 | Rake $0.36 
Board [Qh 7h 2h]
Seat 1: matiko09 folded before Flop (didn't bet)
Seat 2: Monsthand folded before Flop (didn't bet)
Seat 3: sebaaastian folded before Flop (didn't bet)
Seat 4: hammerwife folded before Flop (didn't bet)
Seat 5: Sweden_Pound collected ($7.64)
Seat 6: xAndorx (button) folded before Flop (didn't bet)
Seat 7: bilukm (small blind) folded on the Flop
Seat 8: Venomous100% (big blind) folded before Flop
Seat 9: TideHan folded before Flop (didn't bet)





PokerStars Hand #149392499512:  Hold'em No Limit ($0.50/$1.00 USD) - 2016/02/25 16:50:33 CET [2016/02/25 10:50:33 ET]
Table 'Badenia II' 9-max Seat #7 is the button
Seat 1: matiko09 ($101.50 in chips) 
Seat 3: sebaaastian ($123.68 in chips) 
Seat 4: KarlMoik1 ($346.94 in chips) 
Seat 5: djammusic ($122.09 in chips) 
Seat 6: xAndorx ($101.71 in chips) 
Seat 7: forsmthgood ($100 in chips) 
Seat 8: Sweden_Pound ($127.92 in chips) 
Seat 9: waisanen ($230.04 in chips) 
Sweden_Pound: posts small blind $0.50
waisanen: posts big blind $1
*** HOLE CARDS ***
Dealt to matiko09 [Ks 7d]
matiko09: folds 
sebaaastian: folds 
KarlMoik1: folds 
djammusic: folds 
xAndorx: folds 
forsmthgood: folds 
Sweden_Pound: raises $2 to $3
waisanen: calls $2
*** FLOP *** [9c Qs 6c]
Sweden_Pound: bets $3.72
waisanen: folds 
Uncalled bet ($3.72) returned to Sweden_Pound
Sweden_Pound collected $5.73 from pot
Sweden_Pound: doesn't show hand 
*** SUMMARY ***
Total pot $6 | Rake $0.27 
Board [9c Qs 6c]
Seat 1: matiko09 folded before Flop (didn't bet)
Seat 3: sebaaastian folded before Flop (didn't bet)
Seat 4: KarlMoik1 folded before Flop (didn't bet)
Seat 5: djammusic folded before Flop (didn't bet)
Seat 6: xAndorx folded before Flop (didn't bet)
Seat 7: forsmthgood (button) folded before Flop (didn't bet)
Seat 8: Sweden_Pound (small blind) collected ($5.73)
Seat 9: waisanen (big blind) folded on the Flop





PokerStars Hand #149392501221:  Hold'em No Limit ($0.50/$1.00 USD) - 2016/02/25 16:50:35 CET [2016/02/25 10:50:35 ET]
Table 'Ebella II' 9-max Seat #8 is the button
Seat 1: Ilov3NBA ($100 in chips) 
Seat 2: Sweden_Pound ($100 in chips) 
Seat 3: Lahesell ($100 in chips) 
Seat 4: CoolestWitch ($54.57 in chips) 
Seat 5: matiko09 ($100 in chips) 
Seat 6: RMilPoker ($195.70 in chips) 
Seat 7: HomerrrJay ($100 in chips) 
Seat 8: ZMPOUTSAM140 ($78.36 in chips) 
Seat 9: simoniustin ($100 in chips) 
simoniustin: posts small blind $0.50
Ilov3NBA: posts big blind $1
*** HOLE CARDS ***
Dealt to matiko09 [9s 4s]
Sweden_Pound: folds 
Lahesell: folds 
CoolestWitch: folds 
matiko09: folds 
RMilPoker: folds 
HomerrrJay: folds 
ZMPOUTSAM140: raises $2 to $3
simoniustin: folds 
Ilov3NBA: folds 
Uncalled bet ($2) returned to ZMPOUTSAM140
ZMPOUTSAM140 collected $2.50 from pot
*** SUMMARY ***
Total pot $2.50 | Rake $0 
Seat 1: Ilov3NBA (big blind) folded before Flop
Seat 2: Sweden_Pound folded before Flop (didn't bet)
Seat 3: Lahesell folded before Flop (didn't bet)
Seat 4: CoolestWitch folded before Flop (didn't bet)
Seat 5: matiko09 folded before Flop (didn't bet)
Seat 6: RMilPoker folded before Flop (didn't bet)
Seat 7: HomerrrJay folded before Flop (didn't bet)
Seat 8: ZMPOUTSAM140 (button) collected ($2.50)
Seat 9: simoniustin (small blind) folded before Flop





PokerStars Hand #149392507643:  Hold'em No Limit ($0.50/$1.00 USD) - 2016/02/25 16:50:44 CET [2016/02/25 10:50:44 ET]
Table 'Guisan' 9-max Seat #7 is the button
Seat 1: stockbridge8 ($82.41 in chips) 
Seat 2: mycka86 ($100 in chips) 
Seat 3: xAndorx ($119.62 in chips) 
Seat 4: matiko09 ($160.35 in chips) 
Seat 5: Jeckpot1989 ($88.73 in chips) 
Seat 6: 19R&J91 ($383.07 in chips) 
Seat 7: sebaaastian ($115.09 in chips) 
Seat 8: Monsthand ($122.17 in chips) 
Seat 9: Sweden_Pound ($107.69 in chips) 
Monsthand: posts small blind $0.50
Sweden_Pound: posts big blind $1
*** HOLE CARDS ***
Dealt to matiko09 [Qc 9c]
stockbridge8: folds 
mycka86: folds 
xAndorx: folds 
matiko09: folds 
Jeckpot1989: raises $1 to $2
19R&J91: folds 
sebaaastian: raises $5 to $7
Monsthand: folds 
Sweden_Pound: folds 
Jeckpot1989: calls $5
*** FLOP *** [Qh 9s 3c]
Jeckpot1989: checks 
sebaaastian: checks 
*** TURN *** [Qh 9s 3c] [2d]
Jeckpot1989: checks 
sebaaastian: bets $9
Jeckpot1989: folds 
Uncalled bet ($9) returned to sebaaastian
sebaaastian collected $14.80 from pot
sebaaastian: doesn't show hand 
*** SUMMARY ***
Total pot $15.50 | Rake $0.70 
Board [Qh 9s 3c 2d]
Seat 1: stockbridge8 folded before Flop (didn't bet)
Seat 2: mycka86 folded before Flop (didn't bet)
Seat 3: xAndorx folded before Flop (didn't bet)
Seat 4: matiko09 folded before Flop (didn't bet)
Seat 5: Jeckpot1989 folded on the Turn
Seat 6: 19R&J91 folded before Flop (didn't bet)
Seat 7: sebaaastian (button) collected ($14.80)
Seat 8: Monsthand (small blind) folded before Flop
Seat 9: Sweden_Pound (big blind) folded before Flop





PokerStars Hand #149392511701:  Hold'em No Limit ($0.50/$1.00 USD) - 2016/02/25 16:50:49 CET [2016/02/25 10:50:49 ET]
Table 'Hercules IV' 9-max Seat #2 is the button
Seat 1: matiko09 ($100 in chips) 
Seat 2: hammerwife ($103.52 in chips) 
Seat 3: sebaaastian ($200.70 in chips) 
Seat 4: Sweden_Pound ($110 in chips) 
Seat 5: xAndorx ($156.96 in chips) 
Seat 7: Ouga Buga ($100 in chips) 
Seat 8: brokat77 ($115.04 in chips) 
Seat 9: djammusic ($38.18 in chips) 
sebaaastian: posts small blind $0.50
Sweden_Pound: posts big blind $1
*** HOLE CARDS ***
Dealt to matiko09 [Jd Jh]
xAndorx: folds 
Ouga Buga: folds 
brokat77: raises $1 to $2
djammusic: folds 
matiko09: raises $5 to $7
hammerwife: folds 
sebaaastian: folds 
Sweden_Pound: folds 
brokat77: raises $15.50 to $22.50
matiko09: folds 
Uncalled bet ($15.50) returned to brokat77
brokat77 collected $15.50 from pot
brokat77: doesn't show hand 
*** SUMMARY ***
Total pot $15.50 | Rake $0 
Seat 1: matiko09 folded before Flop
Seat 2: hammerwife (button) folded before Flop (didn't bet)
Seat 3: sebaaastian (small blind) folded before Flop
Seat 4: Sweden_Pound (big blind) folded before Flop
Seat 5: xAndorx folded before Flop (didn't bet)
Seat 7: Ouga Buga folded before Flop (didn't bet)
Seat 8: brokat77 collected ($15.50)
Seat 9: djammusic folded before Flop (didn't bet)





PokerStars Hand #149392523069:  Hold'em No Limit ($0.50/$1.00 USD) - 2016/02/25 16:51:04 CET [2016/02/25 10:51:04 ET]
Table 'Ebella II' 9-max Seat #9 is the button
Seat 1: Ilov3NBA ($100 in chips) 
Seat 2: Sweden_Pound ($100 in chips) 
Seat 3: Lahesell ($100 in chips) 
Seat 4: CoolestWitch ($54.57 in chips) 
Seat 5: matiko09 ($100 in chips) 
Seat 6: RMilPoker ($195.70 in chips) 
Seat 7: HomerrrJay ($100 in chips) 
Seat 8: ZMPOUTSAM140 ($79.86 in chips) 
Seat 9: simoniustin ($100 in chips) 
Ilov3NBA: posts small blind $0.50
Sweden_Pound: posts big blind $1
*** HOLE CARDS ***
Dealt to matiko09 [Kc Tc]
Lahesell: folds 
CoolestWitch: raises $1.50 to $2.50
matiko09: folds 
RMilPoker: folds 
HomerrrJay: folds 
ZMPOUTSAM140: calls $2.50
simoniustin: folds 
Ilov3NBA: folds 
Sweden_Pound: folds 
*** FLOP *** [Td Qs 5d]
CoolestWitch: bets $4
ZMPOUTSAM140: calls $4
*** TURN *** [Td Qs 5d] [Qd]
CoolestWitch: checks 
ZMPOUTSAM140: checks 
*** RIVER *** [Td Qs 5d Qd] [6h]
CoolestWitch: checks 
ZMPOUTSAM140: bets $13.85
CoolestWitch: folds 
Uncalled bet ($13.85) returned to ZMPOUTSAM140
ZMPOUTSAM140 collected $13.85 from pot
*** SUMMARY ***
Total pot $14.50 | Rake $0.65 
Board [Td Qs 5d Qd 6h]
Seat 1: Ilov3NBA (small blind) folded before Flop
Seat 2: Sweden_Pound (big blind) folded before Flop
Seat 3: Lahesell folded before Flop (didn't bet)
Seat 4: CoolestWitch folded on the River
Seat 5: matiko09 folded before Flop (didn't bet)
Seat 6: RMilPoker folded before Flop (didn't bet)
Seat 7: HomerrrJay folded before Flop (didn't bet)
Seat 8: ZMPOUTSAM140 collected ($13.85)
Seat 9: simoniustin (button) folded before Flop (didn't bet)





PokerStars Hand #149392526103:  Hold'em No Limit ($0.50/$1.00 USD) - 2016/02/25 16:51:08 CET [2016/02/25 10:51:08 ET]
Table 'Isa' 9-max Seat #7 is the button
Seat 1: matiko09 ($121.94 in chips) 
Seat 2: Monsthand ($100 in chips) 
Seat 3: sebaaastian ($109.90 in chips) 
Seat 4: hammerwife ($102.31 in chips) 
Seat 5: Sweden_Pound ($105.69 in chips) 
Seat 6: xAndorx ($94.99 in chips) 
Seat 7: bilukm ($168.18 in chips) 
Seat 8: Venomous100% ($100 in chips) 
Seat 9: TideHan ($110 in chips) 
Venomous100%: posts small blind $0.50
TideHan: posts big blind $1
*** HOLE CARDS ***
Dealt to matiko09 [2d 8d]
matiko09: folds 
Monsthand: folds 
sebaaastian: folds 
hammerwife: folds 
Sweden_Pound: raises $2 to $3
xAndorx: folds 
bilukm: calls $3
Venomous100%: folds 
TideHan: calls $2
*** FLOP *** [Qh Ad 7d]
TideHan: checks 
Sweden_Pound: checks 
bilukm: checks 
*** TURN *** [Qh Ad 7d] [7s]
TideHan: bets $7
Sweden_Pound: folds 
bilukm: folds 
Uncalled bet ($7) returned to TideHan
TideHan collected $9.07 from pot
TideHan: doesn't show hand 
*** SUMMARY ***
Total pot $9.50 | Rake $0.43 
Board [Qh Ad 7d 7s]
Seat 1: matiko09 folded before Flop (didn't bet)
Seat 2: Monsthand folded before Flop (didn't bet)
Seat 3: sebaaastian folded before Flop (didn't bet)
Seat 4: hammerwife folded before Flop (didn't bet)
Seat 5: Sweden_Pound folded on the Turn
Seat 6: xAndorx folded before Flop (didn't bet)
Seat 7: bilukm (button) folded on the Turn
Seat 8: Venomous100% (small blind) folded before Flop
Seat 9: TideHan (big blind) collected ($9.07)





PokerStars Hand #149392526749:  Hold'em No Limit ($0.50/$1.00 USD) - 2016/02/25 16:51:09 CET [2016/02/25 10:51:09 ET]
Table 'Sabine' 9-max Seat #7 is the button
Seat 1: Aalleekks ($103.52 in chips) 
Seat 2: apfush ($109.92 in chips) 
Seat 3: Monsthand ($210.87 in chips) 
Seat 4: hammerwife ($101.50 in chips) 
Seat 5: RMilPoker ($98 in chips) 
Seat 6: Sweden_Pound ($115.16 in chips) 
Seat 7: clayshmert ($76.99 in chips) 
Seat 8: matiko09 ($100 in chips) 
Seat 9: djammusic ($54.22 in chips) 
matiko09: posts small blind $0.50
djammusic: posts big blind $1
*** HOLE CARDS ***
Dealt to matiko09 [Js 6s]
Aalleekks: folds 
apfush: folds 
Monsthand: raises $1.70 to $2.70
hammerwife: folds 
RMilPoker: folds 
Sweden_Pound: folds 
clayshmert: folds 
matiko09: folds 
djammusic: folds 
Uncalled bet ($1.70) returned to Monsthand
Monsthand collected $2.50 from pot
*** SUMMARY ***
Total pot $2.50 | Rake $0 
Seat 1: Aalleekks folded before Flop (didn't bet)
Seat 2: apfush folded before Flop (didn't bet)
Seat 3: Monsthand collected ($2.50)
Seat 4: hammerwife folded before Flop (didn't bet)
Seat 5: RMilPoker folded before Flop (didn't bet)
Seat 6: Sweden_Pound folded before Flop (didn't bet)
Seat 7: clayshmert (button) folded before Flop (didn't bet)
Seat 8: matiko09 (small blind) folded before Flop
Seat 9: djammusic (big blind) folded before Flop





PokerStars Hand #149392529056:  Hold'em No Limit ($0.50/$1.00 USD) - 2016/02/25 16:51:12 CET [2016/02/25 10:51:12 ET]
Table 'Zeuxo II' 9-max Seat #1 is the button
Seat 1: forsmthgood ($106.80 in chips) 
Seat 2: Sweden_Pound ($115.03 in chips) 
Seat 3: xAndorx ($93.78 in chips) 
Seat 4: sebaaastian ($122.11 in chips) 
Seat 5: bauss84 ($28 in chips) 
Seat 6: Cogss ($93.74 in chips) 
Seat 7: djammusic ($45.50 in chips) 
Seat 8: matiko09 ($100 in chips) 
Sweden_Pound: posts small blind $0.50
xAndorx: posts big blind $1
*** HOLE CARDS ***
Dealt to matiko09 [4c Kh]
sebaaastian: folds 
bauss84: calls $1
Cogss: folds 
djammusic: folds 
matiko09: folds 
forsmthgood: folds 
Sweden_Pound: calls $0.50
xAndorx: checks 
*** FLOP *** [Kc 8s 4h]
Sweden_Pound: checks 
xAndorx: checks 
bauss84: bets $3.99
Sweden_Pound: folds 
xAndorx: folds 
Uncalled bet ($3.99) returned to bauss84
bauss84 collected $2.86 from pot
bauss84: doesn't show hand 
*** SUMMARY ***
Total pot $3 | Rake $0.14 
Board [Kc 8s 4h]
Seat 1: forsmthgood (button) folded before Flop (didn't bet)
Seat 2: Sweden_Pound (small blind) folded on the Flop
Seat 3: xAndorx (big blind) folded on the Flop
Seat 4: sebaaastian folded before Flop (didn't bet)
Seat 5: bauss84 collected ($2.86)
Seat 6: Cogss folded before Flop (didn't bet)
Seat 7: djammusic folded before Flop (didn't bet)
Seat 8: matiko09 folded before Flop (didn't bet)





PokerStars Hand #149392539104:  Hold'em No Limit ($0.25/$0.50 USD) - 2016/02/25 16:51:25 CET [2016/02/25 10:51:25 ET]
Table 'Ophiuchus III' 9-max Seat #3 is the button
Seat 1: RvPersie ($100.69 in chips) 
Seat 2: ihami ($47.75 in chips) 
Seat 3: rdrill ($67.26 in chips) 
Seat 4: lucima10 ($50 in chips) 
Seat 5: ReneProost ($33.64 in chips) 
Seat 6: Muinmyheart ($50 in chips) 
Seat 7: Rorerzap ($52.70 in chips) 
Seat 8: matiko09 ($50 in chips) 
Seat 9: tugboat2008 ($80.02 in chips) 
lucima10: posts small blind $0.25
ReneProost: posts big blind $0.50
*** HOLE CARDS ***
Dealt to matiko09 [7d Ac]
Muinmyheart: folds 
Rorerzap: folds 
matiko09: folds 
tugboat2008: folds 
RvPersie: folds 
ihami: folds 
rdrill: raises $0.50 to $1
lucima10: folds 
ReneProost: calls $0.50
*** FLOP *** [Ts 9c 3c]
ReneProost: checks 
rdrill: checks 
*** TURN *** [Ts 9c 3c] [Qs]
ReneProost: checks 
rdrill: bets $1.25
Muinmyheart leaves the table
Al3xAnd3r22 joins the table at seat #6 
ReneProost: calls $1.25
*** RIVER *** [Ts 9c 3c Qs] [Td]
ReneProost: checks 
rdrill: checks 
*** SHOW DOWN ***
ReneProost: shows [Kh Ks] (two pair, Kings and Tens)
rdrill: mucks hand 
ReneProost collected $4.54 from pot
*** SUMMARY ***
Total pot $4.75 | Rake $0.21 
Board [Ts 9c 3c Qs Td]
Seat 1: RvPersie folded before Flop (didn't bet)
Seat 2: ihami folded before Flop (didn't bet)
Seat 3: rdrill (button) mucked [6h As]
Seat 4: lucima10 (small blind) folded before Flop
Seat 5: ReneProost (big blind) showed [Kh Ks] and won ($4.54) with two pair, Kings and Tens
Seat 6: Muinmyheart folded before Flop (didn't bet)
Seat 7: Rorerzap folded before Flop (didn't bet)
Seat 8: matiko09 folded before Flop (didn't bet)
Seat 9: tugboat2008 folded before Flop (didn't bet)





PokerStars Hand #149392540111:  Hold'em No Limit (€0.25/€0.50 EUR) - 2016/02/25 16:51:26 CET [2016/02/25 10:51:26 ET]
Table 'Leo Minor III' 9-max Seat #5 is the button
Seat 1: Al3xAnd3r22 (€79.26 in chips) 
Seat 2: vasiy379 (€50 in chips) 
Seat 4: RvPersie (€78.54 in chips) 
Seat 5: kasse_62 (€18.96 in chips) 
Seat 6: Wwwasian (€52.04 in chips) 
Seat 7: JustR82 (€50 in chips) 
Seat 9: matiko09 (€73.50 in chips) 
Wwwasian: posts small blind €0.25
JustR82: posts big blind €0.50
Bron By: sits out 
*** HOLE CARDS ***
Dealt to matiko09 [3c Qc]
matiko09: folds 
Al3xAnd3r22: folds 
vasiy379: folds 
RvPersie: raises €0.75 to €1.25
kasse_62: folds 
kasse_62 leaves the table
Wwwasian: folds 
JustR82: folds 
Uncalled bet (€0.75) returned to RvPersie
JustR82 leaves the table
RvPersie collected €1.25 from pot
RvPersie: doesn't show hand 
*** SUMMARY ***
Total pot €1.25 | Rake €0 
Seat 1: Al3xAnd3r22 folded before Flop (didn't bet)
Seat 2: vasiy379 folded before Flop (didn't bet)
Seat 4: RvPersie collected (€1.25)
Seat 5: kasse_62 (button) folded before Flop (didn't bet)
Seat 6: Wwwasian (small blind) folded before Flop
Seat 7: JustR82 (big blind) folded before Flop
Seat 9: matiko09 folded before Flop (didn't bet)





PokerStars Hand #149392540716:  Hold'em No Limit ($0.50/$1.00 USD) - 2016/02/25 16:51:27 CET [2016/02/25 10:51:27 ET]
Table 'Sabine' 9-max Seat #8 is the button
Seat 1: Aalleekks ($103.52 in chips) 
Seat 2: apfush ($109.92 in chips) 
Seat 3: Monsthand ($212.37 in chips) 
Seat 4: hammerwife ($101.50 in chips) 
Seat 5: RMilPoker ($98 in chips) 
Seat 6: Sweden_Pound ($115.16 in chips) 
Seat 7: clayshmert ($76.99 in chips) 
Seat 8: matiko09 ($100 in chips) 
Seat 9: djammusic ($53.22 in chips) 
djammusic: posts small blind $0.50
Aalleekks: posts big blind $1
*** HOLE CARDS ***
Dealt to matiko09 [6c Jh]
apfush: folds 
Monsthand: folds 
hammerwife: folds 
RMilPoker: folds 
Sweden_Pound: raises $2 to $3
clayshmert: raises $5 to $8
matiko09: folds 
djammusic: folds 
Aalleekks: folds 
Sweden_Pound: folds 
Uncalled bet ($5) returned to clayshmert
clayshmert collected $7.50 from pot
*** SUMMARY ***
Total pot $7.50 | Rake $0 
Seat 1: Aalleekks (big blind) folded before Flop
Seat 2: apfush folded before Flop (didn't bet)
Seat 3: Monsthand folded before Flop (didn't bet)
Seat 4: hammerwife folded before Flop (didn't bet)
Seat 5: RMilPoker folded before Flop (didn't bet)
Seat 6: Sweden_Pound folded before Flop
Seat 7: clayshmert collected ($7.50)
Seat 8: matiko09 (button) folded before Flop (didn't bet)
Seat 9: djammusic (small blind) folded before Flop





PokerStars Hand #149392543280:  Hold'em No Limit ($0.50/$1.00 USD) - 2016/02/25 16:51:30 CET [2016/02/25 10:51:30 ET]
Table 'Badenia II' 9-max Seat #8 is the button
Seat 1: matiko09 ($101.50 in chips) 
Seat 2: Stibitzkie ($100 in chips) 
Seat 3: sebaaastian ($123.68 in chips) 
Seat 4: KarlMoik1 ($346.94 in chips) 
Seat 5: djammusic ($122.09 in chips) 
Seat 6: xAndorx ($101.71 in chips) 
Seat 7: forsmthgood ($100 in chips) 
Seat 8: Sweden_Pound ($130.65 in chips) 
Seat 9: waisanen ($227.04 in chips) 
waisanen: posts small blind $0.50
matiko09: posts big blind $1
*** HOLE CARDS ***
Dealt to matiko09 [9s Ac]
Stibitzkie: raises $2.50 to $3.50
sebaaastian: folds 
KarlMoik1: calls $3.50
djammusic: folds 
xAndorx: folds 
forsmthgood: folds 
Sweden_Pound: folds 
waisanen: folds 
matiko09: folds 
*** FLOP *** [Kc As 6s]
Stibitzkie: checks 
KarlMoik1: checks 
*** TURN *** [Kc As 6s] [6c]
Stibitzkie: bets $1
KarlMoik1: folds 
Uncalled bet ($1) returned to Stibitzkie
Stibitzkie collected $8.12 from pot
*** SUMMARY ***
Total pot $8.50 | Rake $0.38 
Board [Kc As 6s 6c]
Seat 1: matiko09 (big blind) folded before Flop
Seat 2: Stibitzkie collected ($8.12)
Seat 3: sebaaastian folded before Flop (didn't bet)
Seat 4: KarlMoik1 folded on the Turn
Seat 5: djammusic folded before Flop (didn't bet)
Seat 6: xAndorx folded before Flop (didn't bet)
Seat 7: forsmthgood folded before Flop (didn't bet)
Seat 8: Sweden_Pound (button) folded before Flop (didn't bet)
Seat 9: waisanen (small blind) folded before Flop





PokerStars Hand #149392544819:  Hold'em No Limit ($0.25/$0.50 USD) - 2016/02/25 16:51:32 CET [2016/02/25 10:51:32 ET]
Table 'Lohja II' 9-max Seat #6 is the button
Seat 1: MoonJimmy ($146.48 in chips) 
Seat 2: Apparat888 ($49.90 in chips) 
Seat 3: guvalc1952 ($167.19 in chips) 
Seat 4: payback11 ($50 in chips) 
Seat 5: vasiy379 ($50 in chips) 
Seat 6: JustR82 ($50 in chips) 
Seat 7: matiko09 ($132.76 in chips) 
Seat 8: jamba83 ($73.77 in chips) 
Seat 9: Muinmyheart ($74.79 in chips) 
matiko09: posts small blind $0.25
jamba83: posts big blind $0.50
MoonJimmy: posts the ante $0.10
Apparat888: posts the ante $0.10
guvalc1952: posts the ante $0.10
payback11: posts the ante $0.10
vasiy379: posts the ante $0.10
JustR82: posts the ante $0.10
matiko09: posts the ante $0.10
jamba83: posts the ante $0.10
Muinmyheart: posts the ante $0.10
*** HOLE CARDS ***
Dealt to matiko09 [6h Tc]
Muinmyheart: folds 
MoonJimmy: folds 
Apparat888: folds 
guvalc1952: folds 
payback11: folds 
vasiy379: folds 
JustR82: folds 
matiko09: raises $1 to $1.50
jamba83: calls $1
*** FLOP *** [Ac Th 9s]
matiko09: checks 
jamba83: checks 
*** TURN *** [Ac Th 9s] [3s]
matiko09: checks 
jamba83: checks 
*** RIVER *** [Ac Th 9s 3s] [Qd]
matiko09: checks 
jamba83: checks 
*** SHOW DOWN ***
matiko09: shows [6h Tc] (a pair of Tens)
jamba83: mucks hand 
matiko09 collected $3.72 from pot
*** SUMMARY ***
Total pot $3.90 | Rake $0.18 
Board [Ac Th 9s 3s Qd]
Seat 1: MoonJimmy folded before Flop (didn't bet)
Seat 2: Apparat888 folded before Flop (didn't bet)
Seat 3: guvalc1952 folded before Flop (didn't bet)
Seat 4: payback11 folded before Flop (didn't bet)
Seat 5: vasiy379 folded before Flop (didn't bet)
Seat 6: JustR82 (button) folded before Flop (didn't bet)
Seat 7: matiko09 (small blind) showed [6h Tc] and won ($3.72) with a pair of Tens
Seat 8: jamba83 (big blind) mucked [5s 5d]
Seat 9: Muinmyheart folded before Flop (didn't bet)





PokerStars Hand #149392545692:  Hold'em No Limit ($0.50/$1.00 USD) - 2016/02/25 16:51:33 CET [2016/02/25 10:51:33 ET]
Table 'Hercules IV' 9-max Seat #3 is the button
Seat 1: matiko09 ($100 in chips) 
Seat 2: hammerwife ($103.52 in chips) 
Seat 3: sebaaastian ($200.20 in chips) 
Seat 4: Sweden_Pound ($109 in chips) 
Seat 5: xAndorx ($156.96 in chips) 
Seat 7: Ouga Buga ($100 in chips) 
Seat 8: brokat77 ($123.54 in chips) 
Seat 9: djammusic ($38.18 in chips) 
Sweden_Pound: posts small blind $0.50
xAndorx: posts big blind $1
*** HOLE CARDS ***
Dealt to matiko09 [Kd 9d]
Ouga Buga: folds 
brokat77: folds 
djammusic: folds 
matiko09: raises $2 to $3
hammerwife: raises $6 to $9
sebaaastian: folds 
Sweden_Pound: folds 
xAndorx: folds 
matiko09: folds 
Uncalled bet ($6) returned to hammerwife
hammerwife collected $7.50 from pot
hammerwife: doesn't show hand 
*** SUMMARY ***
Total pot $7.50 | Rake $0 
Seat 1: matiko09 folded before Flop
Seat 2: hammerwife collected ($7.50)
Seat 3: sebaaastian (button) folded before Flop (didn't bet)
Seat 4: Sweden_Pound (small blind) folded before Flop
Seat 5: xAndorx (big blind) folded before Flop
Seat 7: Ouga Buga folded before Flop (didn't bet)
Seat 8: brokat77 folded before Flop (didn't bet)
Seat 9: djammusic folded before Flop (didn't bet)





PokerStars Hand #149392549819:  Hold'em No Limit ($0.50/$1.00 USD) - 2016/02/25 16:51:39 CET [2016/02/25 10:51:39 ET]
Table 'Simona' 9-max Seat #9 is the button
Seat 1: mycka86 ($133.34 in chips) 
Seat 2: xAndorx ($145.07 in chips) 
Seat 3: Sweden_Pound ($115.49 in chips) 
Seat 4: matiko09 ($274.92 in chips) 
Seat 5: sebaaastian ($124.67 in chips) 
Seat 7: hammerwife ($100 in chips) 
Seat 9: Slushpup69 ($34.17 in chips) 
mycka86: posts small blind $0.50
xAndorx: posts big blind $1
Ouga Buga: sits out 
*** HOLE CARDS ***
Dealt to matiko09 [Tc Jd]
Sweden_Pound: folds 
matiko09: folds 
sebaaastian: folds 
hammerwife: folds 
Slushpup69: folds 
mycka86: raises $1.75 to $2.75
xAndorx: calls $1.75
*** FLOP *** [Jc 5s Ts]
mycka86: bets $3.50
xAndorx: calls $3.50
*** TURN *** [Jc 5s Ts] [Ad]
mycka86: bets $7.50
xAndorx: folds 
Uncalled bet ($7.50) returned to mycka86
mycka86 collected $11.94 from pot
*** SUMMARY ***
Total pot $12.50 | Rake $0.56 
Board [Jc 5s Ts Ad]
Seat 1: mycka86 (small blind) collected ($11.94)
Seat 2: xAndorx (big blind) folded on the Turn
Seat 3: Sweden_Pound folded before Flop (didn't bet)
Seat 4: matiko09 folded before Flop (didn't bet)
Seat 5: sebaaastian folded before Flop (didn't bet)
Seat 7: hammerwife folded before Flop (didn't bet)
Seat 9: Slushpup69 (button) folded before Flop (didn't bet)





PokerStars Hand #149392559897:  Hold'em No Limit ($0.25/$0.50 USD) - 2016/02/25 16:51:52 CET [2016/02/25 10:51:52 ET]
Table 'Thalpius III' 9-max Seat #3 is the button
Seat 1: BrotherLove9 ($60.32 in chips) 
Seat 2: matiko09 ($55.79 in chips) 
Seat 3: jamba83 ($50.81 in chips) 
Seat 4: Wwwasian ($76.04 in chips) 
Seat 6: ihami ($52.25 in chips) 
Seat 7: v4n0v ($50.75 in chips) 
Seat 9: Domotirko228 ($50 in chips) 
Wwwasian: posts small blind $0.25
Rorerzap: is sitting out 
ihami: posts big blind $0.50
*** HOLE CARDS ***
Dealt to matiko09 [7s Qc]
Rorerzap leaves the table
v4n0v: folds 
Domotirko228: raises $1 to $1.50
BrotherLove9: folds 
matiko09: folds 
jamba83: folds 
Wwwasian: folds 
ihami: folds 
Uncalled bet ($1) returned to Domotirko228
Domotirko228 collected $1.25 from pot
Domotirko228: doesn't show hand 
*** SUMMARY ***
Total pot $1.25 | Rake $0 
Seat 1: BrotherLove9 folded before Flop (didn't bet)
Seat 2: matiko09 folded before Flop (didn't bet)
Seat 3: jamba83 (button) folded before Flop (didn't bet)
Seat 4: Wwwasian (small blind) folded before Flop
Seat 6: ihami (big blind) folded before Flop
Seat 7: v4n0v folded before Flop (didn't bet)
Seat 9: Domotirko228 collected ($1.25)





PokerStars Hand #149392559881:  Hold'em No Limit (€0.25/€0.50 EUR) - 2016/02/25 16:51:52 CET [2016/02/25 10:51:52 ET]
Table 'Leo Minor III' 9-max Seat #6 is the button
Seat 1: Al3xAnd3r22 (€79.26 in chips) 
Seat 2: vasiy379 (€50 in chips) 
Seat 4: RvPersie (€79.29 in chips) 
Seat 6: Wwwasian (€51.79 in chips) 
Seat 9: matiko09 (€73.50 in chips) 
matiko09: posts small blind €0.25
Al3xAnd3r22: posts big blind €0.50
*** HOLE CARDS ***
Dealt to matiko09 [Ks Jd]
vasiy379: folds 
Bron By leaves the table
vasiy379 leaves the table
RvPersie: folds 
Wwwasian: raises €0.75 to €1.25
matiko09: folds 
Al3xAnd3r22: folds 
Uncalled bet (€0.75) returned to Wwwasian
Wwwasian collected €1.25 from pot
Wwwasian: doesn't show hand 
*** SUMMARY ***
Total pot €1.25 | Rake €0 
Seat 1: Al3xAnd3r22 (big blind) folded before Flop
Seat 2: vasiy379 folded before Flop (didn't bet)
Seat 4: RvPersie folded before Flop (didn't bet)
Seat 6: Wwwasian (button) collected (€1.25)
Seat 9: matiko09 (small blind) folded before Flop





PokerStars Hand #149392574496:  Hold'em No Limit ($0.50/$1.00 USD) - 2016/02/25 16:52:11 CET [2016/02/25 10:52:11 ET]
Table 'Guisan' 9-max Seat #8 is the button
Seat 1: stockbridge8 ($82.41 in chips) 
Seat 2: mycka86 ($100 in chips) 
Seat 3: xAndorx ($119.62 in chips) 
Seat 4: matiko09 ($160.35 in chips) 
Seat 5: Jeckpot1989 ($81.73 in chips) 
Seat 6: 19R&J91 ($383.07 in chips) 
Seat 7: sebaaastian ($122.89 in chips) 
Seat 8: Monsthand ($121.67 in chips) 
Seat 9: Sweden_Pound ($106.69 in chips) 
Sweden_Pound: posts small blind $0.50
stockbridge8: posts big blind $1
*** HOLE CARDS ***
Dealt to matiko09 [Kd 6h]
mycka86: folds 
xAndorx: folds 
matiko09: folds 
Jeckpot1989: folds 
19R&J91: folds 
sebaaastian: raises $1.50 to $2.50
Monsthand: folds 
Sweden_Pound: folds 
stockbridge8: folds 
Uncalled bet ($1.50) returned to sebaaastian
sebaaastian collected $2.50 from pot
sebaaastian: doesn't show hand 
*** SUMMARY ***
Total pot $2.50 | Rake $0 
Seat 1: stockbridge8 (big blind) folded before Flop
Seat 2: mycka86 folded before Flop (didn't bet)
Seat 3: xAndorx folded before Flop (didn't bet)
Seat 4: matiko09 folded before Flop (didn't bet)
Seat 5: Jeckpot1989 folded before Flop (didn't bet)
Seat 6: 19R&J91 folded before Flop (didn't bet)
Seat 7: sebaaastian collected ($2.50)
Seat 8: Monsthand (button) folded before Flop (didn't bet)
Seat 9: Sweden_Pound (small blind) folded before Flop





PokerStars Hand #149392578383:  Hold'em No Limit ($0.50/$1.00 USD) - 2016/02/25 16:52:16 CET [2016/02/25 10:52:16 ET]
Table 'Hercules IV' 9-max Seat #4 is the button
Seat 1: matiko09 ($100 in chips) 
Seat 2: hammerwife ($108.02 in chips) 
Seat 3: sebaaastian ($200.20 in chips) 
Seat 4: Sweden_Pound ($108.50 in chips) 
Seat 5: xAndorx ($155.96 in chips) 
Seat 6: kuanhung0903 ($65.10 in chips) 
Seat 7: Ouga Buga ($100 in chips) 
Seat 8: brokat77 ($123.54 in chips) 
Seat 9: djammusic ($38.18 in chips) 
xAndorx: posts small blind $0.50
kuanhung0903: posts big blind $1
*** HOLE CARDS ***
Dealt to matiko09 [Qs 7h]
Ouga Buga: folds 
brokat77: folds 
djammusic: folds 
matiko09: folds 
hammerwife: folds 
sebaaastian: folds 
Sweden_Pound: raises $1 to $2
xAndorx: folds 
kuanhung0903: raises $6 to $8
Sweden_Pound: folds 
Uncalled bet ($6) returned to kuanhung0903
kuanhung0903 collected $4.50 from pot
kuanhung0903: doesn't show hand 
*** SUMMARY ***
Total pot $4.50 | Rake $0 
Seat 1: matiko09 folded before Flop (didn't bet)
Seat 2: hammerwife folded before Flop (didn't bet)
Seat 3: sebaaastian folded before Flop (didn't bet)
Seat 4: Sweden_Pound (button) folded before Flop
Seat 5: xAndorx (small blind) folded before Flop
Seat 6: kuanhung0903 (big blind) collected ($4.50)
Seat 7: Ouga Buga folded before Flop (didn't bet)
Seat 8: brokat77 folded before Flop (didn't bet)
Seat 9: djammusic folded before Flop (didn't bet)





PokerStars Hand #149392579215:  Hold'em No Limit ($0.50/$1.00 USD) - 2016/02/25 16:52:18 CET [2016/02/25 10:52:18 ET]
Table 'Zeuxo II' 9-max Seat #2 is the button
Seat 1: forsmthgood ($106.80 in chips) 
Seat 2: Sweden_Pound ($114.03 in chips) 
Seat 3: xAndorx ($92.78 in chips) 
Seat 4: sebaaastian ($122.11 in chips) 
Seat 5: bauss84 ($29.86 in chips) 
Seat 6: Cogss ($93.74 in chips) 
Seat 7: djammusic ($45.50 in chips) 
Seat 8: matiko09 ($100 in chips) 
xAndorx: posts small blind $0.50
sebaaastian: posts big blind $1
Sreshta222: sits out 
*** HOLE CARDS ***
Dealt to matiko09 [Ad Jc]
bauss84 has timed out
bauss84: folds 
Cogss: folds 
djammusic: folds 
matiko09: raises $2 to $3
forsmthgood: folds 
Sweden_Pound: calls $3
xAndorx: folds 
sebaaastian: folds 
*** FLOP *** [2s 9c Qc]
matiko09: bets $4.15
Sweden_Pound: folds 
Uncalled bet ($4.15) returned to matiko09
matiko09 collected $7.16 from pot
matiko09: doesn't show hand 
*** SUMMARY ***
Total pot $7.50 | Rake $0.34 
Board [2s 9c Qc]
Seat 1: forsmthgood folded before Flop (didn't bet)
Seat 2: Sweden_Pound (button) folded on the Flop
Seat 3: xAndorx (small blind) folded before Flop
Seat 4: sebaaastian (big blind) folded before Flop
Seat 5: bauss84 folded before Flop (didn't bet)
Seat 6: Cogss folded before Flop (didn't bet)
Seat 7: djammusic folded before Flop (didn't bet)
Seat 8: matiko09 collected ($7.16)





PokerStars Hand #149392580942:  Hold'em No Limit ($0.50/$1.00 USD) - 2016/02/25 16:52:20 CET [2016/02/25 10:52:20 ET]
Table 'Ebella II' 9-max Seat #1 is the button
Seat 1: Ilov3NBA ($100 in chips) 
Seat 2: Sweden_Pound ($100 in chips) 
Seat 3: Lahesell ($100 in chips) 
Seat 4: CoolestWitch ($48.07 in chips) 
Seat 5: matiko09 ($100 in chips) 
Seat 6: RMilPoker ($195.70 in chips) 
Seat 7: HomerrrJay ($100 in chips) 
Seat 8: ZMPOUTSAM140 ($87.21 in chips) 
Seat 9: simoniustin ($100 in chips) 
Sweden_Pound: posts small blind $0.50
Lahesell: posts big blind $1
*** HOLE CARDS ***
Dealt to matiko09 [Ah 8s]
CoolestWitch: folds 
matiko09: folds 
RMilPoker: folds 
HomerrrJay: folds 
ZMPOUTSAM140: folds 
simoniustin: folds 
Ilov3NBA: folds 
Sweden_Pound: raises $2 to $3
Lahesell: folds 
Uncalled bet ($2) returned to Sweden_Pound
Sweden_Pound collected $2 from pot
Sweden_Pound: doesn't show hand 
*** SUMMARY ***
Total pot $2 | Rake $0 
Seat 1: Ilov3NBA (button) folded before Flop (didn't bet)
Seat 2: Sweden_Pound (small blind) collected ($2)
Seat 3: Lahesell (big blind) folded before Flop
Seat 4: CoolestWitch folded before Flop (didn't bet)
Seat 5: matiko09 folded before Flop (didn't bet)
Seat 6: RMilPoker folded before Flop (didn't bet)
Seat 7: HomerrrJay folded before Flop (didn't bet)
Seat 8: ZMPOUTSAM140 folded before Flop (didn't bet)
Seat 9: simoniustin folded before Flop (didn't bet)





PokerStars Hand #149392583119:  Hold'em No Limit ($0.50/$1.00 USD) - 2016/02/25 16:52:23 CET [2016/02/25 10:52:23 ET]
Table 'Sabine' 9-max Seat #9 is the button
Seat 1: Aalleekks ($102.52 in chips) 
Seat 2: apfush ($109.92 in chips) 
Seat 3: Monsthand ($212.37 in chips) 
Seat 4: hammerwife ($101.50 in chips) 
Seat 5: RMilPoker ($98 in chips) 
Seat 6: Sweden_Pound ($112.16 in chips) 
Seat 7: clayshmert ($81.49 in chips) 
Seat 8: matiko09 ($100 in chips) 
Seat 9: djammusic ($52.72 in chips) 
Aalleekks: posts small blind $0.50
apfush: posts big blind $1
*** HOLE CARDS ***
Dealt to matiko09 [As 4c]
Monsthand: folds 
hammerwife: folds 
RMilPoker: folds 
Sweden_Pound: folds 
clayshmert: folds 
matiko09: folds 
djammusic: raises $1.02 to $2.02
Aalleekks: folds 
apfush: calls $1.02
*** FLOP *** [Kd 8s 8c]
apfush: checks 
djammusic: checks 
*** TURN *** [Kd 8s 8c] [Qc]
apfush: bets $3.50
djammusic: calls $3.50
*** RIVER *** [Kd 8s 8c Qc] [Qh]
apfush: bets $6.50
djammusic: raises $8.50 to $15
apfush: folds 
Uncalled bet ($8.50) returned to djammusic
djammusic collected $23.44 from pot
djammusic: doesn't show hand 
*** SUMMARY ***
Total pot $24.54 | Rake $1.10 
Board [Kd 8s 8c Qc Qh]
Seat 1: Aalleekks (small blind) folded before Flop
Seat 2: apfush (big blind) folded on the River
Seat 3: Monsthand folded before Flop (didn't bet)
Seat 4: hammerwife folded before Flop (didn't bet)
Seat 5: RMilPoker folded before Flop (didn't bet)
Seat 6: Sweden_Pound folded before Flop (didn't bet)
Seat 7: clayshmert folded before Flop (didn't bet)
Seat 8: matiko09 folded before Flop (didn't bet)
Seat 9: djammusic (button) collected ($23.44)





PokerStars Hand #149392589486:  Hold'em No Limit ($0.25/$0.50 USD) - 2016/02/25 16:52:31 CET [2016/02/25 10:52:31 ET]
Table 'Lohja II' 9-max Seat #7 is the button
Seat 1: MoonJimmy ($146.38 in chips) 
Seat 2: Apparat888 ($49.80 in chips) 
Seat 3: guvalc1952 ($167.09 in chips) 
Seat 4: payback11 ($50 in chips) 
Seat 5: vasiy379 ($50 in chips) 
Seat 6: JustR82 ($50 in chips) 
Seat 7: matiko09 ($134.88 in chips) 
Seat 8: jamba83 ($72.17 in chips) 
jamba83: posts small blind $0.25
Muinmyheart: is sitting out 
Muinmyheart leaves the table
MoonJimmy: posts big blind $0.50
MoonJimmy: posts the ante $0.10
Apparat888: posts the ante $0.10
guvalc1952: posts the ante $0.10
payback11: posts the ante $0.10
vasiy379: posts the ante $0.10
JustR82: posts the ante $0.10
matiko09: posts the ante $0.10
jamba83: posts the ante $0.10
*** HOLE CARDS ***
Dealt to matiko09 [Qc 5c]
Apparat888: folds 
Al3xAnd3r22 joins the table at seat #9 
guvalc1952 has timed out
guvalc1952: folds 
payback11: folds 
vasiy379: folds 
JustR82: folds 
matiko09: raises $1 to $1.50
jamba83: calls $1.25
MoonJimmy: calls $1
*** FLOP *** [Ks 7c 3c]
jamba83: checks 
MoonJimmy: checks 
matiko09: bets $3.29
jamba83: folds 
MoonJimmy: folds 
Uncalled bet ($3.29) returned to matiko09
matiko09 collected $5.06 from pot
matiko09: doesn't show hand 
*** SUMMARY ***
Total pot $5.30 | Rake $0.24 
Board [Ks 7c 3c]
Seat 1: MoonJimmy (big blind) folded on the Flop
Seat 2: Apparat888 folded before Flop (didn't bet)
Seat 3: guvalc1952 folded before Flop (didn't bet)
Seat 4: payback11 folded before Flop (didn't bet)
Seat 5: vasiy379 folded before Flop (didn't bet)
Seat 6: JustR82 folded before Flop (didn't bet)
Seat 7: matiko09 (button) collected ($5.06)
Seat 8: jamba83 (small blind) folded on the Flop





PokerStars Hand #149392591058:  Hold'em No Limit ($0.50/$1.00 USD) - 2016/02/25 16:52:33 CET [2016/02/25 10:52:33 ET]
Table 'Guisan' 9-max Seat #9 is the button
Seat 1: stockbridge8 ($81.41 in chips) 
Seat 2: mycka86 ($100 in chips) 
Seat 3: xAndorx ($119.62 in chips) 
Seat 4: matiko09 ($160.35 in chips) 
Seat 5: Jeckpot1989 ($81.73 in chips) 
Seat 6: 19R&J91 ($383.07 in chips) 
Seat 7: sebaaastian ($124.39 in chips) 
Seat 8: Monsthand ($121.67 in chips) 
Seat 9: Sweden_Pound ($106.19 in chips) 
stockbridge8: posts small blind $0.50
mycka86: posts big blind $1
*** HOLE CARDS ***
Dealt to matiko09 [Qd 8c]
xAndorx: raises $2 to $3
matiko09: folds 
Jeckpot1989: folds 
19R&J91: folds 
sebaaastian: raises $6 to $9
Monsthand: folds 
Sweden_Pound: folds 
stockbridge8: folds 
mycka86: folds 
xAndorx: folds 
Uncalled bet ($6) returned to sebaaastian
sebaaastian collected $7.50 from pot
sebaaastian: doesn't show hand 
*** SUMMARY ***
Total pot $7.50 | Rake $0 
Seat 1: stockbridge8 (small blind) folded before Flop
Seat 2: mycka86 (big blind) folded before Flop
Seat 3: xAndorx folded before Flop
Seat 4: matiko09 folded before Flop (didn't bet)
Seat 5: Jeckpot1989 folded before Flop (didn't bet)
Seat 6: 19R&J91 folded before Flop (didn't bet)
Seat 7: sebaaastian collected ($7.50)
Seat 8: Monsthand folded before Flop (didn't bet)
Seat 9: Sweden_Pound (button) folded before Flop (didn't bet)





PokerStars Hand #149392591961:  Hold'em No Limit ($0.50/$1.00 USD) - 2016/02/25 16:52:34 CET [2016/02/25 10:52:34 ET]
Table 'Isa' 9-max Seat #8 is the button
Seat 1: matiko09 ($121.94 in chips) 
Seat 2: Monsthand ($100 in chips) 
Seat 3: sebaaastian ($109.90 in chips) 
Seat 4: hammerwife ($102.31 in chips) 
Seat 5: Sweden_Pound ($102.69 in chips) 
Seat 6: xAndorx ($94.99 in chips) 
Seat 7: bilukm ($165.18 in chips) 
Seat 8: Venomous100% ($100 in chips) 
Seat 9: TideHan ($116.07 in chips) 
TideHan: posts small blind $0.50
matiko09: posts big blind $1
*** HOLE CARDS ***
Dealt to matiko09 [9h Qs]
Monsthand: folds 
sebaaastian: folds 
hammerwife: folds 
Sweden_Pound: raises $2 to $3
xAndorx: folds 
bilukm: folds 
Venomous100%: calls $3
TideHan: raises $12 to $15
matiko09: folds 
Sweden_Pound: raises $15 to $30
Venomous100%: folds 
TideHan: raises $86.07 to $116.07 and is all-in
Sweden_Pound: calls $72.69 and is all-in
Uncalled bet ($13.38) returned to TideHan
*** FLOP *** [4h 8c 2s]
*** TURN *** [4h 8c 2s] [Jd]
*** RIVER *** [4h 8c 2s Jd] [5s]
*** SHOW DOWN ***
TideHan: shows [Ad Ks] (high card Ace)
Sweden_Pound: shows [Jh Js] (three of a kind, Jacks)
Sweden_Pound collected $206.58 from pot
*** SUMMARY ***
Total pot $209.38 | Rake $2.80 
Board [4h 8c 2s Jd 5s]
Seat 1: matiko09 (big blind) folded before Flop
Seat 2: Monsthand folded before Flop (didn't bet)
Seat 3: sebaaastian folded before Flop (didn't bet)
Seat 4: hammerwife folded before Flop (didn't bet)
Seat 5: Sweden_Pound showed [Jh Js] and won ($206.58) with three of a kind, Jacks
Seat 6: xAndorx folded before Flop (didn't bet)
Seat 7: bilukm folded before Flop (didn't bet)
Seat 8: Venomous100% (button) folded before Flop
Seat 9: TideHan (small blind) showed [Ad Ks] and lost with high card Ace





PokerStars Hand #149392600352:  Hold'em No Limit ($0.25/$0.50 USD) - 2016/02/25 16:52:45 CET [2016/02/25 10:52:45 ET]
Table 'Thalpius III' 9-max Seat #4 is the button
Seat 1: BrotherLove9 ($60.32 in chips) 
Seat 2: matiko09 ($55.79 in chips) 
Seat 3: jamba83 ($50.81 in chips) 
Seat 4: Wwwasian ($75.79 in chips) 
Seat 6: ihami ($51.75 in chips) 
Seat 7: v4n0v ($50.75 in chips) 
Seat 8: jeroemie123 ($50 in chips) 
Seat 9: Domotirko228 ($50.75 in chips) 
ihami: posts small blind $0.25
v4n0v: posts big blind $0.50
*** HOLE CARDS ***
Dealt to matiko09 [6s Jd]
jeroemie123: folds 
Domotirko228: folds 
Al3xAnd3r22 joins the table at seat #5 
BrotherLove9: folds 
matiko09: folds 
jamba83: raises $0.50 to $1
Wwwasian: folds 
ihami: folds 
v4n0v: calls $0.50
*** FLOP *** [4c Ks 5c]
v4n0v: checks 
jamba83: bets $1.50
v4n0v: folds 
Uncalled bet ($1.50) returned to jamba83
jamba83 collected $2.15 from pot
*** SUMMARY ***
Total pot $2.25 | Rake $0.10 
Board [4c Ks 5c]
Seat 1: BrotherLove9 folded before Flop (didn't bet)
Seat 2: matiko09 folded before Flop (didn't bet)
Seat 3: jamba83 collected ($2.15)
Seat 4: Wwwasian (button) folded before Flop (didn't bet)
Seat 6: ihami (small blind) folded before Flop
Seat 7: v4n0v (big blind) folded on the Flop
Seat 8: jeroemie123 folded before Flop (didn't bet)
Seat 9: Domotirko228 folded before Flop (didn't bet)





PokerStars Hand #149392605140:  Hold'em No Limit ($0.50/$1.00 USD) - 2016/02/25 16:52:51 CET [2016/02/25 10:52:51 ET]
Table 'Simona' 9-max Seat #1 is the button
Seat 1: mycka86 ($139.03 in chips) 
Seat 2: xAndorx ($138.82 in chips) 
Seat 3: Sweden_Pound ($115.49 in chips) 
Seat 4: matiko09 ($274.92 in chips) 
Seat 5: sebaaastian ($124.67 in chips) 
Seat 7: hammerwife ($100 in chips) 
Seat 9: Slushpup69 ($34.17 in chips) 
xAndorx: posts small blind $0.50
Sweden_Pound: posts big blind $1
Ouga Buga: sits out 
*** HOLE CARDS ***
Dealt to matiko09 [5h 5c]
matiko09: folds 
sebaaastian: folds 
hammerwife: folds 
Slushpup69: folds 
mycka86: raises $1.10 to $2.10
xAndorx: folds 
Sweden_Pound: raises $5.90 to $8
mycka86: folds 
Uncalled bet ($5.90) returned to Sweden_Pound
Sweden_Pound collected $4.70 from pot
Sweden_Pound: doesn't show hand 
*** SUMMARY ***
Total pot $4.70 | Rake $0 
Seat 1: mycka86 (button) folded before Flop
Seat 2: xAndorx (small blind) folded before Flop
Seat 3: Sweden_Pound (big blind) collected ($4.70)
Seat 4: matiko09 folded before Flop (didn't bet)
Seat 5: sebaaastian folded before Flop (didn't bet)
Seat 7: hammerwife folded before Flop (didn't bet)
Seat 9: Slushpup69 folded before Flop (didn't bet)





PokerStars Hand #149392605451:  Hold'em No Limit ($0.50/$1.00 USD) - 2016/02/25 16:52:52 CET [2016/02/25 10:52:52 ET]
Table 'Hercules IV' 9-max Seat #5 is the button
Seat 1: matiko09 ($100 in chips) 
Seat 2: hammerwife ($108.02 in chips) 
Seat 3: sebaaastian ($200.20 in chips) 
Seat 4: Sweden_Pound ($106.50 in chips) 
Seat 5: xAndorx ($155.46 in chips) 
Seat 6: kuanhung0903 ($67.60 in chips) 
Seat 7: Ouga Buga ($100 in chips) 
Seat 8: brokat77 ($123.54 in chips) 
Seat 9: djammusic ($38.18 in chips) 
kuanhung0903: posts small blind $0.50
Ouga Buga: posts big blind $1
*** HOLE CARDS ***
Dealt to matiko09 [2c 5s]
brokat77: folds 
djammusic: folds 
matiko09: folds 
hammerwife: folds 
sebaaastian: folds 
Sweden_Pound: raises $1.50 to $2.50
xAndorx: folds 
kuanhung0903: calls $2
Ouga Buga: folds 
*** FLOP *** [Qc 2d Kd]
kuanhung0903: checks 
Sweden_Pound: checks 
*** TURN *** [Qc 2d Kd] [9s]
kuanhung0903: checks 
Sweden_Pound: bets $3.72
kuanhung0903: calls $3.72
*** RIVER *** [Qc 2d Kd 9s] [Ks]
kuanhung0903: checks 
Sweden_Pound: bets $7
kuanhung0903: folds 
Uncalled bet ($7) returned to Sweden_Pound
Sweden_Pound collected $12.84 from pot
Sweden_Pound: doesn't show hand 
*** SUMMARY ***
Total pot $13.44 | Rake $0.60 
Board [Qc 2d Kd 9s Ks]
Seat 1: matiko09 folded before Flop (didn't bet)
Seat 2: hammerwife folded before Flop (didn't bet)
Seat 3: sebaaastian folded before Flop (didn't bet)
Seat 4: Sweden_Pound collected ($12.84)
Seat 5: xAndorx (button) folded before Flop (didn't bet)
Seat 6: kuanhung0903 (small blind) folded on the River
Seat 7: Ouga Buga (big blind) folded before Flop
Seat 8: brokat77 folded before Flop (didn't bet)
Seat 9: djammusic folded before Flop (didn't bet)





PokerStars Hand #149392605976:  Hold'em No Limit ($0.50/$1.00 USD) - 2016/02/25 16:52:53 CET [2016/02/25 10:52:53 ET]
Table 'Ebella II' 9-max Seat #2 is the button
Seat 1: Ilov3NBA ($100 in chips) 
Seat 2: Sweden_Pound ($101 in chips) 
Seat 3: Lahesell ($100 in chips) 
Seat 4: CoolestWitch ($48.07 in chips) 
Seat 5: matiko09 ($100 in chips) 
Seat 6: RMilPoker ($195.70 in chips) 
Seat 7: HomerrrJay ($100 in chips) 
Seat 8: ZMPOUTSAM140 ($87.21 in chips) 
Seat 9: simoniustin ($100 in chips) 
Lahesell: posts small blind $0.50
CoolestWitch: posts big blind $1
*** HOLE CARDS ***
Dealt to matiko09 [Kd 2s]
matiko09: folds 
RMilPoker: folds 
HomerrrJay: folds 
ZMPOUTSAM140: folds 
simoniustin: folds 
Ilov3NBA: folds 
Sweden_Pound: raises $1 to $2
Lahesell: folds 
CoolestWitch: folds 
Uncalled bet ($1) returned to Sweden_Pound
Sweden_Pound collected $2.50 from pot
Sweden_Pound: doesn't show hand 
*** SUMMARY ***
Total pot $2.50 | Rake $0 
Seat 1: Ilov3NBA folded before Flop (didn't bet)
Seat 2: Sweden_Pound (button) collected ($2.50)
Seat 3: Lahesell (small blind) folded before Flop
Seat 4: CoolestWitch (big blind) folded before Flop
Seat 5: matiko09 folded before Flop (didn't bet)
Seat 6: RMilPoker folded before Flop (didn't bet)
Seat 7: HomerrrJay folded before Flop (didn't bet)
Seat 8: ZMPOUTSAM140 folded before Flop (didn't bet)
Seat 9: simoniustin folded before Flop (didn't bet)





PokerStars Hand #149392615216:  Hold'em No Limit ($0.50/$1.00 USD) - 2016/02/25 16:53:05 CET [2016/02/25 10:53:05 ET]
Table 'Badenia II' 9-max Seat #9 is the button
Seat 1: matiko09 ($100.50 in chips) 
Seat 2: Stibitzkie ($104.62 in chips) 
Seat 3: sebaaastian ($123.68 in chips) 
Seat 4: KarlMoik1 ($343.44 in chips) 
Seat 5: djammusic ($122.09 in chips) 
Seat 6: xAndorx ($101.71 in chips) 
Seat 7: forsmthgood ($100 in chips) 
Seat 8: Sweden_Pound ($130.65 in chips) 
Seat 9: waisanen ($226.54 in chips) 
matiko09: posts small blind $0.50
Stibitzkie: posts big blind $1
*** HOLE CARDS ***
Dealt to matiko09 [Kd 8c]
sebaaastian: folds 
KarlMoik1: folds 
djammusic: folds 
xAndorx: folds 
forsmthgood: raises $2 to $3
Sweden_Pound: folds 
waisanen: folds 
matiko09: folds 
Stibitzkie: calls $2
*** FLOP *** [6d 3c 5c]
Stibitzkie: bets $6.21
forsmthgood: calls $6.21
*** TURN *** [6d 3c 5c] [9h]
Stibitzkie: bets $18.07
forsmthgood: folds 
Uncalled bet ($18.07) returned to Stibitzkie
Stibitzkie collected $18.07 from pot
*** SUMMARY ***
Total pot $18.92 | Rake $0.85 
Board [6d 3c 5c 9h]
Seat 1: matiko09 (small blind) folded before Flop
Seat 2: Stibitzkie (big blind) collected ($18.07)
Seat 3: sebaaastian folded before Flop (didn't bet)
Seat 4: KarlMoik1 folded before Flop (didn't bet)
Seat 5: djammusic folded before Flop (didn't bet)
Seat 6: xAndorx folded before Flop (didn't bet)
Seat 7: forsmthgood folded on the Turn
Seat 8: Sweden_Pound folded before Flop (didn't bet)
Seat 9: waisanen (button) folded before Flop (didn't bet)





PokerStars Hand #149392628099:  Hold'em No Limit ($0.50/$1.00 USD) - 2016/02/25 16:53:22 CET [2016/02/25 10:53:22 ET]
Table 'Zeuxo II' 9-max Seat #3 is the button
Seat 1: forsmthgood ($106.80 in chips) 
Seat 2: Sweden_Pound ($111.03 in chips) 
Seat 3: xAndorx ($92.28 in chips) 
Seat 4: sebaaastian ($121.11 in chips) 
Seat 5: bauss84 ($29.86 in chips) 
Seat 6: Cogss ($93.74 in chips) 
Seat 7: djammusic ($45.50 in chips) 
Seat 8: matiko09 ($104.16 in chips) 
sebaaastian: posts small blind $0.50
bauss84: posts big blind $1
Sreshta222: sits out 
*** HOLE CARDS ***
Dealt to matiko09 [7d 9c]
Cogss: folds 
djammusic: folds 
matiko09: folds 
forsmthgood: folds 
Sweden_Pound: folds 
xAndorx: folds 
sebaaastian: folds 
Uncalled bet ($0.50) returned to bauss84
bauss84 collected $1 from pot
bauss84: doesn't show hand 
*** SUMMARY ***
Total pot $1 | Rake $0 
Seat 1: forsmthgood folded before Flop (didn't bet)
Seat 2: Sweden_Pound folded before Flop (didn't bet)
Seat 3: xAndorx (button) folded before Flop (didn't bet)
Seat 4: sebaaastian (small blind) folded before Flop
Seat 5: bauss84 (big blind) collected ($1)
Seat 6: Cogss folded before Flop (didn't bet)
Seat 7: djammusic folded before Flop (didn't bet)
Seat 8: matiko09 folded before Flop (didn't bet)





PokerStars Hand #149392629450:  Hold'em No Limit ($0.25/$0.50 USD) - 2016/02/25 16:53:23 CET [2016/02/25 10:53:23 ET]
Table 'Thalpius III' 9-max Seat #6 is the button
Seat 1: BrotherLove9 ($60.32 in chips) 
Seat 2: matiko09 ($55.79 in chips) 
Seat 3: jamba83 ($51.96 in chips) 
Seat 4: Wwwasian ($75.79 in chips) 
Seat 6: ihami ($51.50 in chips) 
Seat 7: v4n0v ($50 in chips) 
Seat 8: jeroemie123 ($50 in chips) 
Seat 9: Domotirko228 ($50.75 in chips) 
v4n0v: posts small blind $0.25
jeroemie123: posts big blind $0.50
Al3xAnd3r22: sits out 
*** HOLE CARDS ***
Dealt to matiko09 [6c 7s]
Domotirko228: folds 
BrotherLove9: folds 
matiko09: folds 
jamba83: folds 
Wwwasian: folds 
ihami: raises $0.50 to $1
v4n0v: raises $3 to $4
jeroemie123: folds 
ihami: folds 
Uncalled bet ($3) returned to v4n0v
v4n0v collected $2.50 from pot
v4n0v: doesn't show hand 
*** SUMMARY ***
Total pot $2.50 | Rake $0 
Seat 1: BrotherLove9 folded before Flop (didn't bet)
Seat 2: matiko09 folded before Flop (didn't bet)
Seat 3: jamba83 folded before Flop (didn't bet)
Seat 4: Wwwasian folded before Flop (didn't bet)
Seat 6: ihami (button) folded before Flop
Seat 7: v4n0v (small blind) collected ($2.50)
Seat 8: jeroemie123 (big blind) folded before Flop
Seat 9: Domotirko228 folded before Flop (didn't bet)





PokerStars Hand #149392631175:  Hold'em No Limit ($0.50/$1.00 USD) - 2016/02/25 16:53:26 CET [2016/02/25 10:53:26 ET]
Table 'Ebella II' 9-max Seat #3 is the button
Seat 1: Ilov3NBA ($100 in chips) 
Seat 2: Sweden_Pound ($102.50 in chips) 
Seat 3: Lahesell ($100 in chips) 
Seat 4: CoolestWitch ($47.07 in chips) 
Seat 5: matiko09 ($100 in chips) 
Seat 6: RMilPoker ($195.70 in chips) 
Seat 7: HomerrrJay ($100 in chips) 
Seat 8: ZMPOUTSAM140 ($87.21 in chips) 
Seat 9: simoniustin ($100 in chips) 
CoolestWitch: posts small blind $0.50
matiko09: posts big blind $1
*** HOLE CARDS ***
Dealt to matiko09 [6d Th]
RMilPoker: folds 
HomerrrJay: folds 
ZMPOUTSAM140: folds 
simoniustin: folds 
Ilov3NBA: folds 
Sweden_Pound: folds 
Lahesell: raises $1.10 to $2.10
CoolestWitch: folds 
matiko09: folds 
Uncalled bet ($1.10) returned to Lahesell
Lahesell collected $2.50 from pot
Lahesell: doesn't show hand 
*** SUMMARY ***
Total pot $2.50 | Rake $0 
Seat 1: Ilov3NBA folded before Flop (didn't bet)
Seat 2: Sweden_Pound folded before Flop (didn't bet)
Seat 3: Lahesell (button) collected ($2.50)
Seat 4: CoolestWitch (small blind) folded before Flop
Seat 5: matiko09 (big blind) folded before Flop
Seat 6: RMilPoker folded before Flop (didn't bet)
Seat 7: HomerrrJay folded before Flop (didn't bet)
Seat 8: ZMPOUTSAM140 folded before Flop (didn't bet)
Seat 9: simoniustin folded before Flop (didn't bet)





PokerStars Hand #149392634938:  Hold'em No Limit ($0.50/$1.00 USD) - 2016/02/25 16:53:31 CET [2016/02/25 10:53:31 ET]
Table 'Guisan' 9-max Seat #1 is the button
Seat 1: stockbridge8 ($80.91 in chips) 
Seat 2: mycka86 ($100 in chips) 
Seat 3: xAndorx ($116.62 in chips) 
Seat 4: matiko09 ($160.35 in chips) 
Seat 5: Jeckpot1989 ($81.73 in chips) 
Seat 6: 19R&J91 ($383.07 in chips) 
Seat 7: sebaaastian ($128.89 in chips) 
Seat 8: Monsthand ($121.67 in chips) 
Seat 9: Sweden_Pound ($106.19 in chips) 
mycka86: posts small blind $0.50
xAndorx: posts big blind $1
*** HOLE CARDS ***
Dealt to matiko09 [8d 8c]
matiko09: raises $2 to $3
Jeckpot1989: folds 
19R&J91: calls $3
sebaaastian: folds 
Monsthand: folds 
Sweden_Pound: folds 
stockbridge8: raises $5 to $8
Jeckpot1989 leaves the table
Apparat888 joins the table at seat #5 
mycka86: folds 
xAndorx: folds 
matiko09: calls $5
19R&J91: calls $5
*** FLOP *** [Ad 5c 8h]
matiko09: checks 
19R&J91: bets $6
stockbridge8: raises $6 to $12
matiko09: calls $12
19R&J91: calls $6
*** TURN *** [Ad 5c 8h] [Kd]
matiko09: checks 
19R&J91: bets $10
stockbridge8: calls $10
matiko09: raises $26 to $36
19R&J91: calls $26
stockbridge8: folds 
*** RIVER *** [Ad 5c 8h Kd] [Qc]
matiko09: bets $104.35 and is all-in
19R&J91: folds 
Uncalled bet ($104.35) returned to matiko09
matiko09 collected $140.70 from pot
matiko09: doesn't show hand 
*** SUMMARY ***
Total pot $143.50 | Rake $2.80 
Board [Ad 5c 8h Kd Qc]
Seat 1: stockbridge8 (button) folded on the Turn
Seat 2: mycka86 (small blind) folded before Flop
Seat 3: xAndorx (big blind) folded before Flop
Seat 4: matiko09 collected ($140.70)
Seat 5: Jeckpot1989 folded before Flop (didn't bet)
Seat 6: 19R&J91 folded on the River
Seat 7: sebaaastian folded before Flop (didn't bet)
Seat 8: Monsthand folded before Flop (didn't bet)
Seat 9: Sweden_Pound folded before Flop (didn't bet)





PokerStars Hand #149392644081:  Hold'em No Limit ($0.50/$1.00 USD) - 2016/02/25 16:53:43 CET [2016/02/25 10:53:43 ET]
Table 'Sabine' 9-max Seat #1 is the button
Seat 1: Aalleekks ($102.02 in chips) 
Seat 2: apfush ($100 in chips) 
Seat 4: hammerwife ($101.50 in chips) 
Seat 5: RMilPoker ($100 in chips) 
Seat 6: Sweden_Pound ($112.16 in chips) 
Seat 7: clayshmert ($81.49 in chips) 
Seat 8: matiko09 ($100 in chips) 
Seat 9: djammusic ($64.14 in chips) 
apfush: posts small blind $0.50
Monsthand: is sitting out 
hammerwife: posts big blind $1
*** HOLE CARDS ***
Dealt to matiko09 [5h Th]
RMilPoker: folds 
Monsthand leaves the table
Ouga Buga joins the table at seat #3 
Sweden_Pound: folds 
clayshmert: folds 
matiko09: folds 
djammusic: folds 
Aalleekks: raises $1 to $2
apfush: folds 
hammerwife: calls $1
*** FLOP *** [7s 3d 9d]
hammerwife: checks 
Aalleekks: checks 
*** TURN *** [7s 3d 9d] [As]
hammerwife: bets $5
Aalleekks: calls $5
*** RIVER *** [7s 3d 9d As] [5s]
hammerwife: checks 
Aalleekks: checks 
*** SHOW DOWN ***
hammerwife: shows [Ad 3h] (two pair, Aces and Threes)
Aalleekks: mucks hand 
hammerwife collected $13.85 from pot
*** SUMMARY ***
Total pot $14.50 | Rake $0.65 
Board [7s 3d 9d As 5s]
Seat 1: Aalleekks (button) mucked [Qd 9h]
Seat 2: apfush (small blind) folded before Flop
Seat 4: hammerwife (big blind) showed [Ad 3h] and won ($13.85) with two pair, Aces and Threes
Seat 5: RMilPoker folded before Flop (didn't bet)
Seat 6: Sweden_Pound folded before Flop (didn't bet)
Seat 7: clayshmert folded before Flop (didn't bet)
Seat 8: matiko09 folded before Flop (didn't bet)
Seat 9: djammusic folded before Flop (didn't bet)





PokerStars Hand #149392648750:  Hold'em No Limit ($0.50/$1.00 USD) - 2016/02/25 16:53:49 CET [2016/02/25 10:53:49 ET]
Table 'Simona' 9-max Seat #2 is the button
Seat 1: mycka86 ($136.93 in chips) 
Seat 2: xAndorx ($138.32 in chips) 
Seat 3: Sweden_Pound ($118.09 in chips) 
Seat 4: matiko09 ($274.92 in chips) 
Seat 5: sebaaastian ($124.67 in chips) 
Seat 7: hammerwife ($100 in chips) 
Seat 9: Slushpup69 ($34.17 in chips) 
Sweden_Pound: posts small blind $0.50
matiko09: posts big blind $1
Ouga Buga: sits out 
*** HOLE CARDS ***
Dealt to matiko09 [Ac 7h]
sebaaastian: raises $2 to $3
hammerwife: folds 
Slushpup69: raises $31.17 to $34.17 and is all-in
mycka86: folds 
xAndorx: raises $104.15 to $138.32 and is all-in
Sweden_Pound: folds 
matiko09: folds 
sebaaastian: folds 
Uncalled bet ($104.15) returned to xAndorx
*** FLOP *** [8c 4c 8s]
*** TURN *** [8c 4c 8s] [5d]
*** RIVER *** [8c 4c 8s 5d] [3h]
*** SHOW DOWN ***
Slushpup69: shows [As Qd] (a pair of Eights)
xAndorx: shows [Js Jd] (two pair, Jacks and Eights)
xAndorx collected $70.04 from pot
*** SUMMARY ***
Total pot $72.84 | Rake $2.80 
Board [8c 4c 8s 5d 3h]
Seat 1: mycka86 folded before Flop (didn't bet)
Seat 2: xAndorx (button) showed [Js Jd] and won ($70.04) with two pair, Jacks and Eights
Seat 3: Sweden_Pound (small blind) folded before Flop
Seat 4: matiko09 (big blind) folded before Flop
Seat 5: sebaaastian folded before Flop
Seat 7: hammerwife folded before Flop (didn't bet)
Seat 9: Slushpup69 showed [As Qd] and lost with a pair of Eights





PokerStars Hand #149392650037:  Hold'em No Limit ($0.50/$1.00 USD) - 2016/02/25 16:53:50 CET [2016/02/25 10:53:50 ET]
Table 'Ebella II' 9-max Seat #4 is the button
Seat 1: Ilov3NBA ($100 in chips) 
Seat 2: Sweden_Pound ($102.50 in chips) 
Seat 3: Lahesell ($101.50 in chips) 
Seat 4: CoolestWitch ($46.57 in chips) 
Seat 5: matiko09 ($100 in chips) 
Seat 6: RMilPoker ($195.70 in chips) 
Seat 7: HomerrrJay ($100 in chips) 
Seat 8: ZMPOUTSAM140 ($87.21 in chips) 
Seat 9: simoniustin ($100 in chips) 
matiko09: posts small blind $0.50
RMilPoker: posts big blind $1
*** HOLE CARDS ***
Dealt to matiko09 [Js Td]
HomerrrJay: folds 
ZMPOUTSAM140: raises $1 to $2
simoniustin: folds 
Ilov3NBA: folds 
Sweden_Pound: folds 
Lahesell: raises $5.50 to $7.50
CoolestWitch: folds 
matiko09: folds 
RMilPoker: folds 
ZMPOUTSAM140: calls $5.50
*** FLOP *** [3d Jd 6d]
ZMPOUTSAM140: checks 
Lahesell: bets $11.66
ZMPOUTSAM140: folds 
Uncalled bet ($11.66) returned to Lahesell
Lahesell collected $15.76 from pot
Lahesell: doesn't show hand 
*** SUMMARY ***
Total pot $16.50 | Rake $0.74 
Board [3d Jd 6d]
Seat 1: Ilov3NBA folded before Flop (didn't bet)
Seat 2: Sweden_Pound folded before Flop (didn't bet)
Seat 3: Lahesell collected ($15.76)
Seat 4: CoolestWitch (button) folded before Flop (didn't bet)
Seat 5: matiko09 (small blind) folded before Flop
Seat 6: RMilPoker (big blind) folded before Flop
Seat 7: HomerrrJay folded before Flop (didn't bet)
Seat 8: ZMPOUTSAM140 folded on the Flop
Seat 9: simoniustin folded before Flop (didn't bet)





PokerStars Hand #149392650344:  Hold'em No Limit ($0.50/$1.00 USD) - 2016/02/25 16:53:51 CET [2016/02/25 10:53:51 ET]
Table 'Isa' 9-max Seat #9 is the button
Seat 1: matiko09 ($120.94 in chips) 
Seat 2: Monsthand ($100 in chips) 
Seat 3: sebaaastian ($109.90 in chips) 
Seat 4: hammerwife ($102.31 in chips) 
Seat 5: Sweden_Pound ($206.58 in chips) 
Seat 6: xAndorx ($94.99 in chips) 
Seat 7: bilukm ($165.18 in chips) 
Seat 8: Venomous100% ($100 in chips) 
Seat 9: TideHan ($100 in chips) 
matiko09: posts small blind $0.50
Monsthand: posts big blind $1
*** HOLE CARDS ***
Dealt to matiko09 [8c 2s]
sebaaastian: folds 
hammerwife: folds 
Sweden_Pound: folds 
xAndorx: folds 
bilukm: folds 
Venomous100%: folds 
TideHan: raises $1.50 to $2.50
matiko09: folds 
Monsthand: folds 
Uncalled bet ($1.50) returned to TideHan
TideHan collected $2.50 from pot
TideHan: doesn't show hand 
*** SUMMARY ***
Total pot $2.50 | Rake $0 
Seat 1: matiko09 (small blind) folded before Flop
Seat 2: Monsthand (big blind) folded before Flop
Seat 3: sebaaastian folded before Flop (didn't bet)
Seat 4: hammerwife folded before Flop (didn't bet)
Seat 5: Sweden_Pound folded before Flop (didn't bet)
Seat 6: xAndorx folded before Flop (didn't bet)
Seat 7: bilukm folded before Flop (didn't bet)
Seat 8: Venomous100% folded before Flop (didn't bet)
Seat 9: TideHan (button) collected ($2.50)





PokerStars Hand #149392656212:  Hold'em No Limit ($0.25/$0.50 USD) - 2016/02/25 16:53:58 CET [2016/02/25 10:53:58 ET]
Table 'Thalpius III' 9-max Seat #7 is the button
Seat 1: BrotherLove9 ($60.32 in chips) 
Seat 2: matiko09 ($55.79 in chips) 
Seat 3: jamba83 ($51.96 in chips) 
Seat 4: Wwwasian ($75.79 in chips) 
Seat 6: ihami ($50.50 in chips) 
Seat 7: v4n0v ($51.50 in chips) 
Seat 8: jeroemie123 ($49.50 in chips) 
Seat 9: Domotirko228 ($50.75 in chips) 
jeroemie123: posts small blind $0.25
Domotirko228: posts big blind $0.50
Al3xAnd3r22: sits out 
*** HOLE CARDS ***
Dealt to matiko09 [4d 9c]
BrotherLove9: folds 
matiko09: folds 
jamba83: folds 
Wwwasian: folds 
ihami: folds 
v4n0v: folds 
jeroemie123: calls $0.25
Domotirko228: checks 
*** FLOP *** [5h Jd 3d]
jeroemie123: checks 
Domotirko228: checks 
*** TURN *** [5h Jd 3d] [7s]
jeroemie123: checks 
Domotirko228: checks 
*** RIVER *** [5h Jd 3d 7s] [Ks]
jeroemie123: checks 
Domotirko228: bets $1
jeroemie123: folds 
Uncalled bet ($1) returned to Domotirko228
Domotirko228 collected $0.96 from pot
Domotirko228: doesn't show hand 
*** SUMMARY ***
Total pot $1 | Rake $0.04 
Board [5h Jd 3d 7s Ks]
Seat 1: BrotherLove9 folded before Flop (didn't bet)
Seat 2: matiko09 folded before Flop (didn't bet)
Seat 3: jamba83 folded before Flop (didn't bet)
Seat 4: Wwwasian folded before Flop (didn't bet)
Seat 6: ihami folded before Flop (didn't bet)
Seat 7: v4n0v (button) folded before Flop (didn't bet)
Seat 8: jeroemie123 (small blind) folded on the River
Seat 9: Domotirko228 (big blind) collected ($0.96)





PokerStars Hand #149392658516:  Hold'em No Limit ($0.50/$1.00 USD) - 2016/02/25 16:54:02 CET [2016/02/25 10:54:02 ET]
Table 'Zeuxo II' 9-max Seat #4 is the button
Seat 1: forsmthgood ($106.80 in chips) 
Seat 2: Sweden_Pound ($111.03 in chips) 
Seat 3: xAndorx ($92.28 in chips) 
Seat 4: sebaaastian ($120.61 in chips) 
Seat 5: bauss84 ($30.36 in chips) 
Seat 6: Cogss ($93.74 in chips) 
Seat 7: djammusic ($45.50 in chips) 
Seat 8: matiko09 ($104.16 in chips) 
bauss84: posts small blind $0.50
Cogss: posts big blind $1
Sreshta222: sits out 
*** HOLE CARDS ***
Dealt to matiko09 [7c Jd]
djammusic: folds 
matiko09: folds 
forsmthgood: folds 
Sweden_Pound: folds 
xAndorx: folds 
sebaaastian: folds 
bauss84: calls $0.50
Cogss: raises $1 to $2
bauss84: calls $1
*** FLOP *** [5s 8c 7d]
bauss84: checks 
Cogss: bets $3.82
bauss84: calls $3.82
*** TURN *** [5s 8c 7d] [Th]
bauss84: checks 
Cogss: checks 
*** RIVER *** [5s 8c 7d Th] [9h]
bauss84: bets $24.54 and is all-in
Cogss: folds 
Uncalled bet ($24.54) returned to bauss84
bauss84 collected $11.12 from pot
bauss84: doesn't show hand 
*** SUMMARY ***
Total pot $11.64 | Rake $0.52 
Board [5s 8c 7d Th 9h]
Seat 1: forsmthgood folded before Flop (didn't bet)
Seat 2: Sweden_Pound folded before Flop (didn't bet)
Seat 3: xAndorx folded before Flop (didn't bet)
Seat 4: sebaaastian (button) folded before Flop (didn't bet)
Seat 5: bauss84 (small blind) collected ($11.12)
Seat 6: Cogss (big blind) folded on the River
Seat 7: djammusic folded before Flop (didn't bet)
Seat 8: matiko09 folded before Flop (didn't bet)





PokerStars Hand #149392671021:  Hold'em No Limit ($0.25/$0.50 USD) - 2016/02/25 16:54:18 CET [2016/02/25 10:54:18 ET]
Table 'Ophiuchus III' 9-max Seat #4 is the button
Seat 1: RvPersie ($100.69 in chips) 
Seat 2: ihami ($47.75 in chips) 
Seat 3: rdrill ($65.01 in chips) 
Seat 4: lucima10 ($50 in chips) 
Seat 5: ReneProost ($35.93 in chips) 
Seat 6: Al3xAnd3r22 ($50 in chips) 
Seat 7: Rorerzap ($52.70 in chips) 
Seat 8: matiko09 ($50 in chips) 
Seat 9: tugboat2008 ($80.02 in chips) 
ReneProost: posts small blind $0.25
Al3xAnd3r22: posts big blind $0.50
*** HOLE CARDS ***
Dealt to matiko09 [8s 6c]
Rorerzap: raises $1 to $1.50
matiko09: folds 
tugboat2008: folds 
RvPersie: folds 
ihami: folds 
rdrill: folds 
lucima10: folds 
ReneProost: folds 
Al3xAnd3r22: folds 
Uncalled bet ($1) returned to Rorerzap
Rorerzap collected $1.25 from pot
Rorerzap: doesn't show hand 
*** SUMMARY ***
Total pot $1.25 | Rake $0 
Seat 1: RvPersie folded before Flop (didn't bet)
Seat 2: ihami folded before Flop (didn't bet)
Seat 3: rdrill folded before Flop (didn't bet)
Seat 4: lucima10 (button) folded before Flop (didn't bet)
Seat 5: ReneProost (small blind) folded before Flop
Seat 6: Al3xAnd3r22 (big blind) folded before Flop
Seat 7: Rorerzap collected ($1.25)
Seat 8: matiko09 folded before Flop (didn't bet)
Seat 9: tugboat2008 folded before Flop (didn't bet)





PokerStars Hand #149392672034:  Hold'em No Limit ($0.50/$1.00 USD) - 2016/02/25 16:54:19 CET [2016/02/25 10:54:19 ET]
Table 'Hercules IV' 9-max Seat #6 is the button
Seat 1: matiko09 ($100 in chips) 
Seat 2: hammerwife ($108.02 in chips) 
Seat 3: sebaaastian ($200.20 in chips) 
Seat 4: Sweden_Pound ($113.12 in chips) 
Seat 5: xAndorx ($155.46 in chips) 
Seat 6: kuanhung0903 ($61.38 in chips) 
Seat 7: Ouga Buga ($100 in chips) 
Seat 8: brokat77 ($123.54 in chips) 
Seat 9: djammusic ($38.18 in chips) 
Ouga Buga: posts small blind $0.50
brokat77: posts big blind $1
*** HOLE CARDS ***
Dealt to matiko09 [4c Th]
djammusic: folds 
matiko09: folds 
hammerwife: folds 
sebaaastian: folds 
Sweden_Pound: raises $2 to $3
xAndorx: folds 
kuanhung0903: calls $3
Ouga Buga: folds 
brokat77: calls $2
*** FLOP *** [As Kc 2h]
brokat77: checks 
Sweden_Pound: checks 
kuanhung0903: checks 
*** TURN *** [As Kc 2h] [9c]
brokat77: checks 
Sweden_Pound: checks 
kuanhung0903: checks 
*** RIVER *** [As Kc 2h 9c] [Ah]
brokat77: checks 
Sweden_Pound: checks 
kuanhung0903: checks 
*** SHOW DOWN ***
brokat77: shows [3d 2d] (two pair, Aces and Deuces)
Sweden_Pound: shows [8h 8s] (two pair, Aces and Eights)
kuanhung0903: mucks hand 
Sweden_Pound collected $9.07 from pot
*** SUMMARY ***
Total pot $9.50 | Rake $0.43 
Board [As Kc 2h 9c Ah]
Seat 1: matiko09 folded before Flop (didn't bet)
Seat 2: hammerwife folded before Flop (didn't bet)
Seat 3: sebaaastian folded before Flop (didn't bet)
Seat 4: Sweden_Pound showed [8h 8s] and won ($9.07) with two pair, Aces and Eights
Seat 5: xAndorx folded before Flop (didn't bet)
Seat 6: kuanhung0903 (button) mucked [Js Qh]
Seat 7: Ouga Buga (small blind) folded before Flop
Seat 8: brokat77 (big blind) showed [3d 2d] and lost with two pair, Aces and Deuces
Seat 9: djammusic folded before Flop (didn't bet)





PokerStars Hand #149392675060:  Hold'em No Limit ($0.25/$0.50 USD) - 2016/02/25 16:54:23 CET [2016/02/25 10:54:23 ET]
Table 'Lohja II' 9-max Seat #8 is the button
Seat 1: MoonJimmy ($144.78 in chips) 
Seat 4: payback11 ($50 in chips) 
Seat 5: vasiy379 ($50 in chips) 
Seat 6: JustR82 ($50 in chips) 
Seat 7: matiko09 ($138.34 in chips) 
Seat 8: jamba83 ($70.57 in chips) 
Al3xAnd3r22 will be allowed to play after the button
MoonJimmy: posts small blind $0.25
Apparat888: is sitting out 
payback11: posts big blind $0.50
MoonJimmy: posts the ante $0.10
payback11: posts the ante $0.10
vasiy379: posts the ante $0.10
JustR82: posts the ante $0.10
matiko09: posts the ante $0.10
jamba83: posts the ante $0.10
*** HOLE CARDS ***
Dealt to matiko09 [As Ks]
vasiy379: folds 
JustR82: folds 
matiko09: raises $1 to $1.50
jamba83: folds 
MoonJimmy: folds 
payback11: calls $1
*** FLOP *** [7d 8d Jh]
payback11: checks 
matiko09: checks 
*** TURN *** [7d 8d Jh] [2d]
payback11: checks 
matiko09: checks 
*** RIVER *** [7d 8d Jh 2d] [6d]
payback11: bets $2.50
matiko09: folds 
Uncalled bet ($2.50) returned to payback11
payback11 collected $3.68 from pot
payback11: doesn't show hand 
*** SUMMARY ***
Total pot $3.85 | Rake $0.17 
Board [7d 8d Jh 2d 6d]
Seat 1: MoonJimmy (small blind) folded before Flop
Seat 4: payback11 (big blind) collected ($3.68)
Seat 5: vasiy379 folded before Flop (didn't bet)
Seat 6: JustR82 folded before Flop (didn't bet)
Seat 7: matiko09 folded on the River
Seat 8: jamba83 (button) folded before Flop (didn't bet)





PokerStars Hand #149392677651:  Hold'em No Limit ($0.50/$1.00 USD) - 2016/02/25 16:54:26 CET [2016/02/25 10:54:26 ET]
Table 'Badenia II' 9-max Seat #1 is the button
Seat 1: matiko09 ($100 in chips) 
Seat 2: Stibitzkie ($113.48 in chips) 
Seat 3: sebaaastian ($123.68 in chips) 
Seat 4: KarlMoik1 ($343.44 in chips) 
Seat 5: djammusic ($122.09 in chips) 
Seat 6: xAndorx ($101.71 in chips) 
Seat 7: forsmthgood ($100 in chips) 
Seat 8: Sweden_Pound ($130.65 in chips) 
Seat 9: waisanen ($226.54 in chips) 
Stibitzkie: posts small blind $0.50
sebaaastian: posts big blind $1
*** HOLE CARDS ***
Dealt to matiko09 [Ks 7s]
KarlMoik1: folds 
djammusic: folds 
xAndorx: folds 
forsmthgood: raises $2 to $3
Sweden_Pound: folds 
waisanen: folds 
matiko09: folds 
Stibitzkie: calls $2.50
sebaaastian: folds 
*** FLOP *** [2c 3c 4d]
Stibitzkie: checks 
forsmthgood: checks 
*** TURN *** [2c 3c 4d] [2h]
Stibitzkie: checks 
forsmthgood: checks 
*** RIVER *** [2c 3c 4d 2h] [6s]
Stibitzkie: bets $1
forsmthgood: folds 
Uncalled bet ($1) returned to Stibitzkie
Stibitzkie collected $6.68 from pot
*** SUMMARY ***
Total pot $7 | Rake $0.32 
Board [2c 3c 4d 2h 6s]
Seat 1: matiko09 (button) folded before Flop (didn't bet)
Seat 2: Stibitzkie (small blind) collected ($6.68)
Seat 3: sebaaastian (big blind) folded before Flop
Seat 4: KarlMoik1 folded before Flop (didn't bet)
Seat 5: djammusic folded before Flop (didn't bet)
Seat 6: xAndorx folded before Flop (didn't bet)
Seat 7: forsmthgood folded on the River
Seat 8: Sweden_Pound folded before Flop (didn't bet)
Seat 9: waisanen folded before Flop (didn't bet)





PokerStars Hand #149392681626:  Hold'em No Limit ($0.50/$1.00 USD) - 2016/02/25 16:54:32 CET [2016/02/25 10:54:32 ET]
Table 'Isa' 9-max Seat #1 is the button
Seat 1: matiko09 ($120.44 in chips) 
Seat 2: Monsthand ($100 in chips) 
Seat 3: sebaaastian ($109.90 in chips) 
Seat 4: hammerwife ($102.31 in chips) 
Seat 5: Sweden_Pound ($206.58 in chips) 
Seat 6: xAndorx ($94.99 in chips) 
Seat 7: bilukm ($165.18 in chips) 
Seat 8: Venomous100% ($100 in chips) 
Seat 9: TideHan ($101.50 in chips) 
Monsthand: posts small blind $0.50
sebaaastian: posts big blind $1
*** HOLE CARDS ***
Dealt to matiko09 [Tc 5c]
hammerwife: folds 
Sweden_Pound: folds 
xAndorx: folds 
bilukm: raises $1 to $2
Venomous100%: folds 
TideHan: folds 
matiko09: folds 
Monsthand: folds 
sebaaastian: folds 
Uncalled bet ($1) returned to bilukm
bilukm collected $2.50 from pot
bilukm: doesn't show hand 
*** SUMMARY ***
Total pot $2.50 | Rake $0 
Seat 1: matiko09 (button) folded before Flop (didn't bet)
Seat 2: Monsthand (small blind) folded before Flop
Seat 3: sebaaastian (big blind) folded before Flop
Seat 4: hammerwife folded before Flop (didn't bet)
Seat 5: Sweden_Pound folded before Flop (didn't bet)
Seat 6: xAndorx folded before Flop (didn't bet)
Seat 7: bilukm collected ($2.50)
Seat 8: Venomous100% folded before Flop (didn't bet)
Seat 9: TideHan folded before Flop (didn't bet)





PokerStars Hand #149392693563:  Hold'em No Limit ($0.25/$0.50 USD) - 2016/02/25 16:54:48 CET [2016/02/25 10:54:48 ET]
Table 'Thalpius III' 9-max Seat #8 is the button
Seat 1: BrotherLove9 ($60.32 in chips) 
Seat 2: matiko09 ($55.79 in chips) 
Seat 3: jamba83 ($51.96 in chips) 
Seat 4: Wwwasian ($75.79 in chips) 
Seat 6: ihami ($50.50 in chips) 
Seat 7: v4n0v ($51.50 in chips) 
Seat 8: jeroemie123 ($49 in chips) 
Seat 9: Domotirko228 ($51.21 in chips) 
Domotirko228: posts small blind $0.25
BrotherLove9: posts big blind $0.50
Al3xAnd3r22: sits out 
*** HOLE CARDS ***
Dealt to matiko09 [5c 5d]
matiko09: folds 
jamba83: folds 
Wwwasian: folds 
ihami: raises $1 to $1.50
v4n0v: folds 
jeroemie123: folds 
Domotirko228: folds 
BrotherLove9: folds 
Uncalled bet ($1) returned to ihami
ihami collected $1.25 from pot
*** SUMMARY ***
Total pot $1.25 | Rake $0 
Seat 1: BrotherLove9 (big blind) folded before Flop
Seat 2: matiko09 folded before Flop (didn't bet)
Seat 3: jamba83 folded before Flop (didn't bet)
Seat 4: Wwwasian folded before Flop (didn't bet)
Seat 6: ihami collected ($1.25)
Seat 7: v4n0v folded before Flop (didn't bet)
Seat 8: jeroemie123 (button) folded before Flop (didn't bet)
Seat 9: Domotirko228 (small blind) folded before Flop





PokerStars Hand #149392696608:  Hold'em No Limit ($0.50/$1.00 USD) - 2016/02/25 16:54:52 CET [2016/02/25 10:54:52 ET]
Table 'Ebella II' 9-max Seat #5 is the button
Seat 1: Ilov3NBA ($100 in chips) 
Seat 2: Sweden_Pound ($102.50 in chips) 
Seat 3: Lahesell ($109.76 in chips) 
Seat 4: CoolestWitch ($46.57 in chips) 
Seat 5: matiko09 ($100 in chips) 
Seat 6: RMilPoker ($194.70 in chips) 
Seat 7: HomerrrJay ($100 in chips) 
Seat 8: ZMPOUTSAM140 ($79.71 in chips) 
Seat 9: simoniustin ($100 in chips) 
RMilPoker: posts small blind $0.50
HomerrrJay: posts big blind $1
*** HOLE CARDS ***
Dealt to matiko09 [8d Tc]
ZMPOUTSAM140: folds 
simoniustin: folds 
Ilov3NBA: folds 
Sweden_Pound: folds 
Lahesell: folds 
CoolestWitch: folds 
matiko09: folds 
RMilPoker: folds 
Uncalled bet ($0.50) returned to HomerrrJay
HomerrrJay collected $1 from pot
HomerrrJay: doesn't show hand 
*** SUMMARY ***
Total pot $1 | Rake $0 
Seat 1: Ilov3NBA folded before Flop (didn't bet)
Seat 2: Sweden_Pound folded before Flop (didn't bet)
Seat 3: Lahesell folded before Flop (didn't bet)
Seat 4: CoolestWitch folded before Flop (didn't bet)
Seat 5: matiko09 (button) folded before Flop (didn't bet)
Seat 6: RMilPoker (small blind) folded before Flop
Seat 7: HomerrrJay (big blind) collected ($1)
Seat 8: ZMPOUTSAM140 folded before Flop (didn't bet)
Seat 9: simoniustin folded before Flop (didn't bet)





PokerStars Hand #149392700602:  Hold'em No Limit ($0.25/$0.50 USD) - 2016/02/25 16:54:57 CET [2016/02/25 10:54:57 ET]
Table 'Ophiuchus III' 9-max Seat #5 is the button
Seat 1: RvPersie ($100.69 in chips) 
Seat 2: ihami ($47.75 in chips) 
Seat 3: rdrill ($65.01 in chips) 
Seat 4: lucima10 ($50 in chips) 
Seat 5: ReneProost ($35.68 in chips) 
Seat 6: Al3xAnd3r22 ($50 in chips) 
Seat 8: matiko09 ($50 in chips) 
Seat 9: tugboat2008 ($80.02 in chips) 
Al3xAnd3r22: posts small blind $0.25
Rorerzap: is sitting out 
matiko09: posts big blind $0.50
*** HOLE CARDS ***
Dealt to matiko09 [8c As]
Rorerzap leaves the table
tugboat2008: raises $1 to $1.50
RvPersie: calls $1.50
ihami: folds 
JustR82 joins the table at seat #7 
rdrill: folds 
lucima10: calls $1.50
ReneProost: folds 
Al3xAnd3r22: folds 
matiko09: folds 
*** FLOP *** [9s 2c Kh]
tugboat2008: checks 
RvPersie: checks 
lucima10: checks 
*** TURN *** [9s 2c Kh] [6h]
tugboat2008: checks 
RvPersie: bets $3.75
lucima10: folds 
tugboat2008: folds 
Uncalled bet ($3.75) returned to RvPersie
RvPersie collected $5.01 from pot
RvPersie: doesn't show hand 
*** SUMMARY ***
Total pot $5.25 | Rake $0.24 
Board [9s 2c Kh 6h]
Seat 1: RvPersie collected ($5.01)
Seat 2: ihami folded before Flop (didn't bet)
Seat 3: rdrill folded before Flop (didn't bet)
Seat 4: lucima10 folded on the Turn
Seat 5: ReneProost (button) folded before Flop (didn't bet)
Seat 6: Al3xAnd3r22 (small blind) folded before Flop
Seat 8: matiko09 (big blind) folded before Flop
Seat 9: tugboat2008 folded on the Turn





PokerStars Hand #149392703683:  Hold'em No Limit ($0.50/$1.00 USD) - 2016/02/25 16:55:01 CET [2016/02/25 10:55:01 ET]
Table 'Sabine' 9-max Seat #2 is the button
Seat 1: Aalleekks ($100 in chips) 
Seat 2: apfush ($100 in chips) 
Seat 4: hammerwife ($108.35 in chips) 
Seat 5: RMilPoker ($100 in chips) 
Seat 6: Sweden_Pound ($112.16 in chips) 
Seat 7: clayshmert ($81.49 in chips) 
Seat 8: matiko09 ($100 in chips) 
Seat 9: djammusic ($64.14 in chips) 
Ouga Buga will be allowed to play after the button
hammerwife: posts small blind $0.50
RMilPoker: posts big blind $1
*** HOLE CARDS ***
Dealt to matiko09 [2c 4d]
Sweden_Pound: folds 
clayshmert: calls $1
matiko09: folds 
djammusic: folds 
Aalleekks: folds 
apfush: folds 
hammerwife: folds 
RMilPoker: checks 
*** FLOP *** [Qh 9d 6c]
RMilPoker: checks 
clayshmert: bets $2
RMilPoker: folds 
Uncalled bet ($2) returned to clayshmert
clayshmert collected $2.39 from pot
*** SUMMARY ***
Total pot $2.50 | Rake $0.11 
Board [Qh 9d 6c]
Seat 1: Aalleekks folded before Flop (didn't bet)
Seat 2: apfush (button) folded before Flop (didn't bet)
Seat 4: hammerwife (small blind) folded before Flop
Seat 5: RMilPoker (big blind) folded on the Flop
Seat 6: Sweden_Pound folded before Flop (didn't bet)
Seat 7: clayshmert collected ($2.39)
Seat 8: matiko09 folded before Flop (didn't bet)
Seat 9: djammusic folded before Flop (didn't bet)





PokerStars Hand #149392712057:  Hold'em No Limit ($0.25/$0.50 USD) - 2016/02/25 16:55:13 CET [2016/02/25 10:55:13 ET]
Table 'Lohja II' 9-max Seat #1 is the button
Seat 1: MoonJimmy ($144.43 in chips) 
Seat 4: payback11 ($52.08 in chips) 
Seat 5: vasiy379 ($50 in chips) 
Seat 6: JustR82 ($50 in chips) 
Seat 7: matiko09 ($136.74 in chips) 
Seat 8: jamba83 ($70.47 in chips) 
Apparat888 will be allowed to play after the button
payback11: posts small blind $0.25
vasiy379: posts big blind $0.50
Al3xAnd3r22: sits out 
MoonJimmy: posts the ante $0.10
payback11: posts the ante $0.10
vasiy379: posts the ante $0.10
JustR82: posts the ante $0.10
matiko09: posts the ante $0.10
jamba83: posts the ante $0.10
*** HOLE CARDS ***
Dealt to matiko09 [9s 9h]
JustR82: folds 
matiko09: raises $1 to $1.50
jamba83: folds 
MoonJimmy: folds 
JustR82 leaves the table
payback11: folds 
vasiy379: folds 
Uncalled bet ($1) returned to matiko09
matiko09 collected $1.85 from pot
matiko09: doesn't show hand 
*** SUMMARY ***
Total pot $1.85 | Rake $0 
Seat 1: MoonJimmy (button) folded before Flop (didn't bet)
Seat 4: payback11 (small blind) folded before Flop
Seat 5: vasiy379 (big blind) folded before Flop
Seat 6: JustR82 folded before Flop (didn't bet)
Seat 7: matiko09 collected ($1.85)
Seat 8: jamba83 folded before Flop (didn't bet)





PokerStars Hand #149392713960:  Hold'em No Limit ($0.50/$1.00 USD) - 2016/02/25 16:55:16 CET [2016/02/25 10:55:16 ET]
Table 'Simona' 9-max Seat #3 is the button
Seat 1: mycka86 ($136.93 in chips) 
Seat 2: xAndorx ($174.19 in chips) 
Seat 3: Sweden_Pound ($117.59 in chips) 
Seat 4: matiko09 ($273.92 in chips) 
Seat 5: sebaaastian ($121.67 in chips) 
Seat 7: hammerwife ($100 in chips) 
matiko09: posts small blind $0.50
sebaaastian: posts big blind $1
Ouga Buga: sits out 
*** HOLE CARDS ***
Dealt to matiko09 [Th 7s]
hammerwife: raises $1.50 to $2.50
mycka86: folds 
Slushpup69 leaves the table
xAndorx: folds 
simoniustin joins the table at seat #9 
Sweden_Pound: folds 
xAndorx leaves the table
matiko09: folds 
Ilov3NBA joins the table at seat #2 
sebaaastian: folds 
Uncalled bet ($1.50) returned to hammerwife
Ilov3NBA leaves the table
hammerwife collected $2.50 from pot
hammerwife: doesn't show hand 
oscarleon joins the table at seat #2 
*** SUMMARY ***
Total pot $2.50 | Rake $0 
Seat 1: mycka86 folded before Flop (didn't bet)
Seat 2: xAndorx folded before Flop (didn't bet)
Seat 3: Sweden_Pound (button) folded before Flop (didn't bet)
Seat 4: matiko09 (small blind) folded before Flop
Seat 5: sebaaastian (big blind) folded before Flop
Seat 7: hammerwife collected ($2.50)





PokerStars Hand #149392715204:  Hold'em No Limit ($0.50/$1.00 USD) - 2016/02/25 16:55:18 CET [2016/02/25 10:55:18 ET]
Table 'Zeuxo II' 9-max Seat #5 is the button
Seat 1: forsmthgood ($106.80 in chips) 
Seat 2: Sweden_Pound ($111.03 in chips) 
Seat 3: xAndorx ($92.28 in chips) 
Seat 4: sebaaastian ($120.61 in chips) 
Seat 5: bauss84 ($35.66 in chips) 
Seat 6: Cogss ($87.92 in chips) 
Seat 7: djammusic ($45.50 in chips) 
Seat 8: matiko09 ($104.16 in chips) 
Cogss: posts small blind $0.50
djammusic: posts big blind $1
Sreshta222: sits out 
*** HOLE CARDS ***
Dealt to matiko09 [5c 3c]
matiko09: folds 
forsmthgood: raises $2 to $3
Sweden_Pound: folds 
xAndorx: folds 
sebaaastian: folds 
bauss84: folds 
Cogss: folds 
djammusic: folds 
Uncalled bet ($2) returned to forsmthgood
forsmthgood collected $2.50 from pot
forsmthgood: doesn't show hand 
*** SUMMARY ***
Total pot $2.50 | Rake $0 
Seat 1: forsmthgood collected ($2.50)
Seat 2: Sweden_Pound folded before Flop (didn't bet)
Seat 3: xAndorx folded before Flop (didn't bet)
Seat 4: sebaaastian folded before Flop (didn't bet)
Seat 5: bauss84 (button) folded before Flop (didn't bet)
Seat 6: Cogss (small blind) folded before Flop
Seat 7: djammusic (big blind) folded before Flop
Seat 8: matiko09 folded before Flop (didn't bet)





PokerStars Hand #149392718143:  Hold'em No Limit ($0.50/$1.00 USD) - 2016/02/25 16:55:22 CET [2016/02/25 10:55:22 ET]
Table 'Isa' 9-max Seat #2 is the button
Seat 1: matiko09 ($120.44 in chips) 
Seat 2: Monsthand ($100 in chips) 
Seat 3: sebaaastian ($108.90 in chips) 
Seat 4: hammerwife ($102.31 in chips) 
Seat 5: Sweden_Pound ($206.58 in chips) 
Seat 6: xAndorx ($94.99 in chips) 
Seat 7: bilukm ($166.68 in chips) 
Seat 8: Venomous100% ($100 in chips) 
Seat 9: TideHan ($101.50 in chips) 
sebaaastian: posts small blind $0.50
hammerwife: posts big blind $1
*** HOLE CARDS ***
Dealt to matiko09 [Qs Kh]
Sweden_Pound: raises $2 to $3
xAndorx: folds 
bilukm: folds 
Venomous100%: folds 
TideHan: folds 
matiko09: folds 
Monsthand: folds 
sebaaastian: raises $7 to $10
hammerwife: folds 
Sweden_Pound: calls $7
*** FLOP *** [5d 5h 2s]
sebaaastian: bets $12
Sweden_Pound: calls $12
*** TURN *** [5d 5h 2s] [2h]
sebaaastian: bets $27
Sweden_Pound: folds 
Uncalled bet ($27) returned to sebaaastian
sebaaastian collected $42.98 from pot
sebaaastian: doesn't show hand 
*** SUMMARY ***
Total pot $45 | Rake $2.02 
Board [5d 5h 2s 2h]
Seat 1: matiko09 folded before Flop (didn't bet)
Seat 2: Monsthand (button) folded before Flop (didn't bet)
Seat 3: sebaaastian (small blind) collected ($42.98)
Seat 4: hammerwife (big blind) folded before Flop
Seat 5: Sweden_Pound folded on the Turn
Seat 6: xAndorx folded before Flop (didn't bet)
Seat 7: bilukm folded before Flop (didn't bet)
Seat 8: Venomous100% folded before Flop (didn't bet)
Seat 9: TideHan folded before Flop (didn't bet)





PokerStars Hand #149392718897:  Hold'em No Limit ($0.50/$1.00 USD) - 2016/02/25 16:55:23 CET [2016/02/25 10:55:23 ET]
Table 'Ebella II' 9-max Seat #6 is the button
Seat 1: Ilov3NBA ($100 in chips) 
Seat 2: Sweden_Pound ($102.50 in chips) 
Seat 3: Lahesell ($109.76 in chips) 
Seat 4: CoolestWitch ($46.57 in chips) 
Seat 5: matiko09 ($100 in chips) 
Seat 6: RMilPoker ($194.20 in chips) 
Seat 7: HomerrrJay ($100.50 in chips) 
Seat 8: ZMPOUTSAM140 ($79.71 in chips) 
Seat 9: simoniustin ($100 in chips) 
HomerrrJay: posts small blind $0.50
ZMPOUTSAM140: posts big blind $1
*** HOLE CARDS ***
Dealt to matiko09 [Kd Jh]
simoniustin: folds 
Ilov3NBA: folds 
Sweden_Pound: folds 
Lahesell: folds 
CoolestWitch: folds 
matiko09: raises $1.50 to $2.50
RMilPoker: folds 
HomerrrJay: folds 
ZMPOUTSAM140: calls $1.50
*** FLOP *** [2c 3h Ac]
ZMPOUTSAM140: checks 
matiko09: checks 
*** TURN *** [2c 3h Ac] [Ad]
ZMPOUTSAM140: checks 
matiko09: checks 
*** RIVER *** [2c 3h Ac Ad] [8c]
ZMPOUTSAM140: checks 
matiko09: checks 
*** SHOW DOWN ***
ZMPOUTSAM140: shows [Th 7d] (a pair of Aces)
matiko09: shows [Kd Jh] (a pair of Aces - King kicker)
matiko09 collected $5.25 from pot
*** SUMMARY ***
Total pot $5.50 | Rake $0.25 
Board [2c 3h Ac Ad 8c]
Seat 1: Ilov3NBA folded before Flop (didn't bet)
Seat 2: Sweden_Pound folded before Flop (didn't bet)
Seat 3: Lahesell folded before Flop (didn't bet)
Seat 4: CoolestWitch folded before Flop (didn't bet)
Seat 5: matiko09 showed [Kd Jh] and won ($5.25) with a pair of Aces
Seat 6: RMilPoker (button) folded before Flop (didn't bet)
Seat 7: HomerrrJay (small blind) folded before Flop
Seat 8: ZMPOUTSAM140 (big blind) showed [Th 7d] and lost with a pair of Aces
Seat 9: simoniustin folded before Flop (didn't bet)





PokerStars Hand #149392719278:  Hold'em No Limit ($0.25/$0.50 USD) - 2016/02/25 16:55:24 CET [2016/02/25 10:55:24 ET]
Table 'Thalpius III' 9-max Seat #9 is the button
Seat 1: BrotherLove9 ($59.82 in chips) 
Seat 2: matiko09 ($55.79 in chips) 
Seat 3: jamba83 ($51.96 in chips) 
Seat 4: Wwwasian ($75.79 in chips) 
Seat 6: ihami ($51.25 in chips) 
Seat 7: v4n0v ($51.50 in chips) 
Seat 8: jeroemie123 ($49 in chips) 
Seat 9: Domotirko228 ($50.96 in chips) 
BrotherLove9: posts small blind $0.25
matiko09: posts big blind $0.50
Al3xAnd3r22: sits out 
*** HOLE CARDS ***
Dealt to matiko09 [Ac Ah]
jamba83: raises $1 to $1.50
Wwwasian: folds 
ihami: folds 
v4n0v: folds 
jeroemie123: calls $1.50
Domotirko228: folds 
BrotherLove9: folds 
matiko09: raises $4.50 to $6
jamba83: folds 
jeroemie123: calls $4.50
*** FLOP *** [5h 4c 6c]
matiko09: bets $10.50
jeroemie123: folds 
Uncalled bet ($10.50) returned to matiko09
matiko09 collected $13.13 from pot
matiko09: doesn't show hand 
*** SUMMARY ***
Total pot $13.75 | Rake $0.62 
Board [5h 4c 6c]
Seat 1: BrotherLove9 (small blind) folded before Flop
Seat 2: matiko09 (big blind) collected ($13.13)
Seat 3: jamba83 folded before Flop
Seat 4: Wwwasian folded before Flop (didn't bet)
Seat 6: ihami folded before Flop (didn't bet)
Seat 7: v4n0v folded before Flop (didn't bet)
Seat 8: jeroemie123 folded on the Flop
Seat 9: Domotirko228 (button) folded before Flop (didn't bet)





PokerStars Hand #149392722902:  Hold'em No Limit ($0.25/$0.50 USD) - 2016/02/25 16:55:30 CET [2016/02/25 10:55:30 ET]
Table 'Lohja II' 9-max Seat #4 is the button
Seat 1: MoonJimmy ($144.33 in chips) 
Seat 4: payback11 ($51.73 in chips) 
Seat 5: vasiy379 ($50 in chips) 
Seat 7: matiko09 ($137.99 in chips) 
Seat 8: jamba83 ($70.37 in chips) 
vasiy379: posts small blind $0.25
matiko09: posts big blind $0.50
Al3xAnd3r22: sits out 
Apparat888: sits out 
MoonJimmy: posts the ante $0.10
payback11: posts the ante $0.10
vasiy379: posts the ante $0.10
matiko09: posts the ante $0.10
jamba83: posts the ante $0.10
*** HOLE CARDS ***
Dealt to matiko09 [6s 6c]
jamba83: folds 
MoonJimmy: folds 
payback11: folds 
vasiy379: raises $0.75 to $1.25
xAndorx joins the table at seat #6 
matiko09: calls $0.75
*** FLOP *** [Ac 8s 3h]
vasiy379: checks 
matiko09: checks 
*** TURN *** [Ac 8s 3h] [6h]
vasiy379: bets $2
matiko09: raises $4 to $6
vasiy379: calls $4
*** RIVER *** [Ac 8s 3h 6h] [Js]
vasiy379: checks 
matiko09: bets $9.50
vasiy379: calls $9.50
*** SHOW DOWN ***
matiko09: shows [6s 6c] (three of a kind, Sixes)
vasiy379: mucks hand 
matiko09 collected $32.47 from pot
*** SUMMARY ***
Total pot $34 | Rake $1.53 
Board [Ac 8s 3h 6h Js]
Seat 1: MoonJimmy folded before Flop (didn't bet)
Seat 4: payback11 (button) folded before Flop (didn't bet)
Seat 5: vasiy379 (small blind) mucked [Jd As]
Seat 7: matiko09 (big blind) showed [6s 6c] and won ($32.47) with three of a kind, Sixes
Seat 8: jamba83 folded before Flop (didn't bet)





PokerStars Hand #149392730575:  Hold'em No Limit ($0.50/$1.00 USD) - 2016/02/25 16:55:42 CET [2016/02/25 10:55:42 ET]
Table 'Sabine' 9-max Seat #4 is the button
Seat 1: Aalleekks ($100 in chips) 
Seat 2: apfush ($100 in chips) 
Seat 4: hammerwife ($107.85 in chips) 
Seat 5: RMilPoker ($99 in chips) 
Seat 6: Sweden_Pound ($112.16 in chips) 
Seat 7: clayshmert ($82.88 in chips) 
Seat 8: matiko09 ($100 in chips) 
Seat 9: djammusic ($64.14 in chips) 
RMilPoker: posts small blind $0.50
Sweden_Pound: posts big blind $1
Ouga Buga: sits out 
*** HOLE CARDS ***
Dealt to matiko09 [9c 5h]
clayshmert: calls $1
matiko09: folds 
djammusic: folds 
Aalleekks: raises $5 to $6
apfush: folds 
hammerwife: folds 
RMilPoker: folds 
Sweden_Pound: folds 
clayshmert: folds 
Uncalled bet ($5) returned to Aalleekks
Aalleekks collected $3.50 from pot
Aalleekks: doesn't show hand 
*** SUMMARY ***
Total pot $3.50 | Rake $0 
Seat 1: Aalleekks collected ($3.50)
Seat 2: apfush folded before Flop (didn't bet)
Seat 4: hammerwife (button) folded before Flop (didn't bet)
Seat 5: RMilPoker (small blind) folded before Flop
Seat 6: Sweden_Pound (big blind) folded before Flop
Seat 7: clayshmert folded before Flop
Seat 8: matiko09 folded before Flop (didn't bet)
Seat 9: djammusic folded before Flop (didn't bet)





PokerStars Hand #149392731928:  Hold'em No Limit ($0.50/$1.00 USD) - 2016/02/25 16:55:44 CET [2016/02/25 10:55:44 ET]
Table 'Simona' 9-max Seat #4 is the button
Seat 1: mycka86 ($136.93 in chips) 
Seat 3: Sweden_Pound ($117.59 in chips) 
Seat 4: matiko09 ($273.42 in chips) 
Seat 5: sebaaastian ($120.67 in chips) 
Seat 7: hammerwife ($101.50 in chips) 
sebaaastian: posts small blind $0.50
hammerwife: posts big blind $1
Ouga Buga: sits out 
simoniustin: sits out 
oscarleon: sits out 
*** HOLE CARDS ***
Dealt to matiko09 [Ks 8c]
mycka86: folds 
Sweden_Pound: folds 
matiko09: raises $1.27 to $2.27
sebaaastian: folds 
hammerwife: calls $1.27
*** FLOP *** [4c Qs Ac]
hammerwife: checks 
matiko09: checks 
*** TURN *** [4c Qs Ac] [4s]
hammerwife: bets $4
matiko09: folds 
Uncalled bet ($4) returned to hammerwife
hammerwife collected $4.81 from pot
hammerwife: doesn't show hand 
*** SUMMARY ***
Total pot $5.04 | Rake $0.23 
Board [4c Qs Ac 4s]
Seat 1: mycka86 folded before Flop (didn't bet)
Seat 3: Sweden_Pound folded before Flop (didn't bet)
Seat 4: matiko09 (button) folded on the Turn
Seat 5: sebaaastian (small blind) folded before Flop
Seat 7: hammerwife (big blind) collected ($4.81)





PokerStars Hand #149392739490:  Hold'em No Limit ($0.50/$1.00 USD) - 2016/02/25 16:55:56 CET [2016/02/25 10:55:56 ET]
Table 'Guisan' 9-max Seat #2 is the button
Seat 1: stockbridge8 ($50.91 in chips) 
Seat 2: mycka86 ($100 in chips) 
Seat 3: xAndorx ($115.62 in chips) 
Seat 4: matiko09 ($245.05 in chips) 
Seat 6: 19R&J91 ($327.07 in chips) 
Seat 7: sebaaastian ($128.89 in chips) 
Seat 8: Monsthand ($121.67 in chips) 
Seat 9: Sweden_Pound ($106.19 in chips) 
xAndorx: posts small blind $0.50
matiko09: posts big blind $1
Apparat888: sits out 
*** HOLE CARDS ***
Dealt to matiko09 [Ts Kh]
19R&J91: folds 
sebaaastian: folds 
Monsthand: folds 
Sweden_Pound: folds 
stockbridge8: folds 
mycka86: folds 
xAndorx: folds 
Uncalled bet ($0.50) returned to matiko09
matiko09 collected $1 from pot
matiko09: doesn't show hand 
*** SUMMARY ***
Total pot $1 | Rake $0 
Seat 1: stockbridge8 folded before Flop (didn't bet)
Seat 2: mycka86 (button) folded before Flop (didn't bet)
Seat 3: xAndorx (small blind) folded before Flop
Seat 4: matiko09 (big blind) collected ($1)
Seat 6: 19R&J91 folded before Flop (didn't bet)
Seat 7: sebaaastian folded before Flop (didn't bet)
Seat 8: Monsthand folded before Flop (didn't bet)
Seat 9: Sweden_Pound folded before Flop (didn't bet)





PokerStars Hand #149392739889:  Hold'em No Limit ($0.50/$1.00 USD) - 2016/02/25 16:55:56 CET [2016/02/25 10:55:56 ET]
Table 'Zeuxo II' 9-max Seat #6 is the button
Seat 1: forsmthgood ($108.30 in chips) 
Seat 2: Sweden_Pound ($111.03 in chips) 
Seat 3: xAndorx ($100 in chips) 
Seat 4: sebaaastian ($120.61 in chips) 
Seat 5: bauss84 ($35.66 in chips) 
Seat 6: Cogss ($100 in chips) 
Seat 7: djammusic ($44.50 in chips) 
Seat 8: matiko09 ($104.16 in chips) 
djammusic: posts small blind $0.50
matiko09: posts big blind $1
Sreshta222: sits out 
*** HOLE CARDS ***
Dealt to matiko09 [Kc Tc]
forsmthgood: folds 
Sweden_Pound: folds 
xAndorx: folds 
sebaaastian: folds 
bauss84: calls $1
Cogss: raises $1 to $2
djammusic: folds 
matiko09: calls $1
bauss84: calls $1
*** FLOP *** [3s Jc 5d]
matiko09: checks 
bauss84: checks 
Cogss: bets $6.21
matiko09: folds 
bauss84: folds 
Uncalled bet ($6.21) returned to Cogss
Cogss collected $6.21 from pot
*** SUMMARY ***
Total pot $6.50 | Rake $0.29 
Board [3s Jc 5d]
Seat 1: forsmthgood folded before Flop (didn't bet)
Seat 2: Sweden_Pound folded before Flop (didn't bet)
Seat 3: xAndorx folded before Flop (didn't bet)
Seat 4: sebaaastian folded before Flop (didn't bet)
Seat 5: bauss84 folded on the Flop
Seat 6: Cogss (button) collected ($6.21)
Seat 7: djammusic (small blind) folded before Flop
Seat 8: matiko09 (big blind) folded on the Flop





PokerStars Hand #149392743945:  Hold'em No Limit ($0.50/$1.00 USD) - 2016/02/25 16:56:02 CET [2016/02/25 10:56:02 ET]
Table 'Badenia II' 9-max Seat #2 is the button
Seat 1: matiko09 ($100 in chips) 
Seat 2: Stibitzkie ($117.16 in chips) 
Seat 3: sebaaastian ($122.68 in chips) 
Seat 4: KarlMoik1 ($343.44 in chips) 
Seat 5: djammusic ($122.09 in chips) 
Seat 6: xAndorx ($101.71 in chips) 
Seat 7: forsmthgood ($100 in chips) 
Seat 8: Sweden_Pound ($130.65 in chips) 
Seat 9: waisanen ($226.54 in chips) 
sebaaastian: posts small blind $0.50
KarlMoik1: posts big blind $1
*** HOLE CARDS ***
Dealt to matiko09 [8d Ac]
djammusic: folds 
xAndorx: folds 
forsmthgood: folds 
Sweden_Pound: folds 
waisanen: folds 
matiko09: folds 
Stibitzkie: raises $2 to $3
sebaaastian: folds 
KarlMoik1: folds 
Uncalled bet ($2) returned to Stibitzkie
Stibitzkie collected $2.50 from pot
*** SUMMARY ***
Total pot $2.50 | Rake $0 
Seat 1: matiko09 folded before Flop (didn't bet)
Seat 2: Stibitzkie (button) collected ($2.50)
Seat 3: sebaaastian (small blind) folded before Flop
Seat 4: KarlMoik1 (big blind) folded before Flop
Seat 5: djammusic folded before Flop (didn't bet)
Seat 6: xAndorx folded before Flop (didn't bet)
Seat 7: forsmthgood folded before Flop (didn't bet)
Seat 8: Sweden_Pound folded before Flop (didn't bet)
Seat 9: waisanen folded before Flop (didn't bet)





PokerStars Hand #149392745904:  Hold'em No Limit ($0.50/$1.00 USD) - 2016/02/25 16:56:05 CET [2016/02/25 10:56:05 ET]
Table 'Hercules IV' 9-max Seat #7 is the button
Seat 1: matiko09 ($100 in chips) 
Seat 2: hammerwife ($108.02 in chips) 
Seat 3: sebaaastian ($200.20 in chips) 
Seat 4: Sweden_Pound ($119.19 in chips) 
Seat 5: xAndorx ($155.46 in chips) 
Seat 6: kuanhung0903 ($58.38 in chips) 
Seat 7: Ouga Buga ($100 in chips) 
Seat 8: brokat77 ($120.54 in chips) 
Seat 9: djammusic ($38.18 in chips) 
brokat77: posts small blind $0.50
djammusic: posts big blind $1
*** HOLE CARDS ***
Dealt to matiko09 [9s 7h]
matiko09: folds 
hammerwife: folds 
sebaaastian: raises $2 to $3
Sweden_Pound: calls $3
xAndorx: folds 
kuanhung0903: folds 
Ouga Buga: folds 
brokat77: calls $2.50
djammusic: folds 
*** FLOP *** [2d 2s Ad]
brokat77: checks 
sebaaastian: bets $4.78
Sweden_Pound: calls $4.78
brokat77: folds 
*** TURN *** [2d 2s Ad] [7d]
sebaaastian: bets $13
Sweden_Pound: calls $13
*** RIVER *** [2d 2s Ad 7d] [3s]
sebaaastian: bets $23
Sweden_Pound: folds 
Uncalled bet ($23) returned to sebaaastian
sebaaastian collected $43.51 from pot
sebaaastian: doesn't show hand 
*** SUMMARY ***
Total pot $45.56 | Rake $2.05 
Board [2d 2s Ad 7d 3s]
Seat 1: matiko09 folded before Flop (didn't bet)
Seat 2: hammerwife folded before Flop (didn't bet)
Seat 3: sebaaastian collected ($43.51)
Seat 4: Sweden_Pound folded on the River
Seat 5: xAndorx folded before Flop (didn't bet)
Seat 6: kuanhung0903 folded before Flop (didn't bet)
Seat 7: Ouga Buga (button) folded before Flop (didn't bet)
Seat 8: brokat77 (small blind) folded on the Flop
Seat 9: djammusic (big blind) folded before Flop





PokerStars Hand #149392754674:  Hold'em No Limit ($0.50/$1.00 USD) - 2016/02/25 16:56:19 CET [2016/02/25 10:56:19 ET]
Table 'Sabine' 9-max Seat #5 is the button
Seat 1: Aalleekks ($102.50 in chips) 
Seat 2: apfush ($100 in chips) 
Seat 4: hammerwife ($107.85 in chips) 
Seat 5: RMilPoker ($98.50 in chips) 
Seat 6: Sweden_Pound ($111.16 in chips) 
Seat 7: clayshmert ($81.88 in chips) 
Seat 8: matiko09 ($100 in chips) 
Seat 9: djammusic ($64.14 in chips) 
Sweden_Pound: posts small blind $0.50
clayshmert: posts big blind $1
Ouga Buga: sits out 
*** HOLE CARDS ***
Dealt to matiko09 [Js 4c]
matiko09: folds 
djammusic: folds 
Aalleekks: folds 
apfush: folds 
hammerwife: raises $2 to $3
RMilPoker: folds 
Sweden_Pound: raises $8 to $11
clayshmert: folds 
hammerwife: calls $8
*** FLOP *** [6d Qs 3d]
Sweden_Pound: bets $14.27
hammerwife: calls $14.27
*** TURN *** [6d Qs 3d] [Qd]
Sweden_Pound: checks 
hammerwife: checks 
*** RIVER *** [6d Qs 3d Qd] [Ah]
Sweden_Pound: checks 
hammerwife: checks 
*** SHOW DOWN ***
Sweden_Pound: shows [Ac Ks] (two pair, Aces and Queens)
hammerwife: mucks hand 
Sweden_Pound collected $49.22 from pot
*** SUMMARY ***
Total pot $51.54 | Rake $2.32 
Board [6d Qs 3d Qd Ah]
Seat 1: Aalleekks folded before Flop (didn't bet)
Seat 2: apfush folded before Flop (didn't bet)
Seat 4: hammerwife mucked [Jd Jh]
Seat 5: RMilPoker (button) folded before Flop (didn't bet)
Seat 6: Sweden_Pound (small blind) showed [Ac Ks] and won ($49.22) with two pair, Aces and Queens
Seat 7: clayshmert (big blind) folded before Flop
Seat 8: matiko09 folded before Flop (didn't bet)
Seat 9: djammusic folded before Flop (didn't bet)





PokerStars Hand #149392762119:  Hold'em No Limit ($0.25/$0.50 USD) - 2016/02/25 16:56:30 CET [2016/02/25 10:56:30 ET]
Table 'Lohja II' 9-max Seat #5 is the button
Seat 1: MoonJimmy ($144.23 in chips) 
Seat 4: payback11 ($51.63 in chips) 
Seat 5: vasiy379 ($50 in chips) 
Seat 7: matiko09 ($153.61 in chips) 
Seat 8: jamba83 ($70.27 in chips) 
xAndorx will be allowed to play after the button
matiko09: posts small blind $0.25
jamba83: posts big blind $0.50
Al3xAnd3r22: sits out 
Apparat888: sits out 
MoonJimmy: posts the ante $0.10
payback11: posts the ante $0.10
vasiy379: posts the ante $0.10
matiko09: posts the ante $0.10
jamba83: posts the ante $0.10
*** HOLE CARDS ***
Dealt to matiko09 [Qd Th]
MoonJimmy: folds 
payback11: raises $0.70 to $1.20
vasiy379: folds 
matiko09: folds 
jamba83: folds 
Uncalled bet ($0.70) returned to payback11
payback11 collected $1.75 from pot
payback11: doesn't show hand 
*** SUMMARY ***
Total pot $1.75 | Rake $0 
Seat 1: MoonJimmy folded before Flop (didn't bet)
Seat 4: payback11 collected ($1.75)
Seat 5: vasiy379 (button) folded before Flop (didn't bet)
Seat 7: matiko09 (small blind) folded before Flop
Seat 8: jamba83 (big blind) folded before Flop





PokerStars Hand #149392762697:  Hold'em No Limit ($0.50/$1.00 USD) - 2016/02/25 16:56:31 CET [2016/02/25 10:56:31 ET]
Table 'Guisan' 9-max Seat #3 is the button
Seat 1: stockbridge8 ($90.91 in chips) 
Seat 2: mycka86 ($100 in chips) 
Seat 3: xAndorx ($115.12 in chips) 
Seat 4: matiko09 ($245.55 in chips) 
Seat 5: Apparat888 ($40 in chips) 
Seat 6: 19R&J91 ($327.07 in chips) 
Seat 7: sebaaastian ($128.89 in chips) 
Seat 8: Monsthand ($121.67 in chips) 
Seat 9: Sweden_Pound ($106.19 in chips) 
matiko09: posts small blind $0.50
Apparat888: posts big blind $1
*** HOLE CARDS ***
Dealt to matiko09 [9s 3c]
19R&J91: folds 
sebaaastian: folds 
Monsthand: folds 
Sweden_Pound: folds 
stockbridge8: raises $2 to $3
mycka86: folds 
xAndorx: raises $6 to $9
matiko09: folds 
Apparat888: folds 
stockbridge8: calls $6
*** FLOP *** [Ad 4h 6c]
stockbridge8: checks 
xAndorx: checks 
*** TURN *** [Ad 4h 6c] [6d]
stockbridge8: bets $9.31
xAndorx: calls $9.31
*** RIVER *** [Ad 4h 6c 6d] [Ac]
stockbridge8: checks 
xAndorx: bets $20.50
stockbridge8: folds 
Uncalled bet ($20.50) returned to xAndorx
xAndorx collected $36.40 from pot
xAndorx: doesn't show hand 
*** SUMMARY ***
Total pot $38.12 | Rake $1.72 
Board [Ad 4h 6c 6d Ac]
Seat 1: stockbridge8 folded on the River
Seat 2: mycka86 folded before Flop (didn't bet)
Seat 3: xAndorx (button) collected ($36.40)
Seat 4: matiko09 (small blind) folded before Flop
Seat 5: Apparat888 (big blind) folded before Flop
Seat 6: 19R&J91 folded before Flop (didn't bet)
Seat 7: sebaaastian folded before Flop (didn't bet)
Seat 8: Monsthand folded before Flop (didn't bet)
Seat 9: Sweden_Pound folded before Flop (didn't bet)





PokerStars Hand #149392762929:  Hold'em No Limit ($0.25/$0.50 USD) - 2016/02/25 16:56:32 CET [2016/02/25 10:56:32 ET]
Table 'Ophiuchus III' 9-max Seat #6 is the button
Seat 1: RvPersie ($104.20 in chips) 
Seat 2: ihami ($47.75 in chips) 
Seat 3: rdrill ($65.01 in chips) 
Seat 4: lucima10 ($50 in chips) 
Seat 5: ReneProost ($35.68 in chips) 
Seat 6: Al3xAnd3r22 ($50 in chips) 
Seat 8: matiko09 ($50 in chips) 
Seat 9: tugboat2008 ($78.52 in chips) 
JustR82 will be allowed to play after the button
matiko09: posts small blind $0.25
tugboat2008: posts big blind $0.50
*** HOLE CARDS ***
Dealt to matiko09 [8d 2h]
RvPersie: folds 
ihami: folds 
rdrill: raises $1 to $1.50
lucima10: calls $1.50
ReneProost: folds 
Al3xAnd3r22: folds 
matiko09: folds 
tugboat2008: folds 
*** FLOP *** [3h Kh 6c]
rdrill: bets $2
lucima10: raises $5.31 to $7.31
rdrill: calls $5.31
*** TURN *** [3h Kh 6c] [5d]
rdrill: checks 
lucima10: bets $41.19 and is all-in
rdrill: calls $41.19
*** RIVER *** [3h Kh 6c 5d] [Ac]
*** SHOW DOWN ***
rdrill: shows [As Kc] (two pair, Aces and Kings)
lucima10: shows [3c 3s] (three of a kind, Threes)
lucima10 collected $98.25 from pot
*** SUMMARY ***
Total pot $100.75 | Rake $2.50 
Board [3h Kh 6c 5d Ac]
Seat 1: RvPersie folded before Flop (didn't bet)
Seat 2: ihami folded before Flop (didn't bet)
Seat 3: rdrill showed [As Kc] and lost with two pair, Aces and Kings
Seat 4: lucima10 showed [3c 3s] and won ($98.25) with three of a kind, Threes
Seat 5: ReneProost folded before Flop (didn't bet)
Seat 6: Al3xAnd3r22 (button) folded before Flop (didn't bet)
Seat 8: matiko09 (small blind) folded before Flop
Seat 9: tugboat2008 (big blind) folded before Flop





PokerStars Hand #149392767682:  Hold'em No Limit ($0.50/$1.00 USD) - 2016/02/25 16:56:39 CET [2016/02/25 10:56:39 ET]
Table 'Ebella II' 9-max Seat #7 is the button
Seat 1: Ilov3NBA ($100 in chips) 
Seat 2: Sweden_Pound ($102.50 in chips) 
Seat 3: Lahesell ($109.76 in chips) 
Seat 4: CoolestWitch ($46.57 in chips) 
Seat 5: matiko09 ($102.75 in chips) 
Seat 6: RMilPoker ($194.20 in chips) 
Seat 7: HomerrrJay ($100 in chips) 
Seat 8: ZMPOUTSAM140 ($77.21 in chips) 
Seat 9: simoniustin ($100 in chips) 
ZMPOUTSAM140: posts small blind $0.50
simoniustin: posts big blind $1
*** HOLE CARDS ***
Dealt to matiko09 [4h 3h]
Ilov3NBA: folds 
Sweden_Pound: folds 
Lahesell: raises $2 to $3
CoolestWitch: folds 
matiko09: folds 
RMilPoker: folds 
HomerrrJay: folds 
ZMPOUTSAM140: folds 
simoniustin: folds 
Uncalled bet ($2) returned to Lahesell
Lahesell collected $2.50 from pot
Lahesell: doesn't show hand 
*** SUMMARY ***
Total pot $2.50 | Rake $0 
Seat 1: Ilov3NBA folded before Flop (didn't bet)
Seat 2: Sweden_Pound folded before Flop (didn't bet)
Seat 3: Lahesell collected ($2.50)
Seat 4: CoolestWitch folded before Flop (didn't bet)
Seat 5: matiko09 folded before Flop (didn't bet)
Seat 6: RMilPoker folded before Flop (didn't bet)
Seat 7: HomerrrJay (button) folded before Flop (didn't bet)
Seat 8: ZMPOUTSAM140 (small blind) folded before Flop
Seat 9: simoniustin (big blind) folded before Flop





PokerStars Hand #149392768942:  Hold'em No Limit ($0.50/$1.00 USD) - 2016/02/25 16:56:41 CET [2016/02/25 10:56:41 ET]
Table 'Simona' 9-max Seat #5 is the button
Seat 1: mycka86 ($136.93 in chips) 
Seat 3: Sweden_Pound ($117.59 in chips) 
Seat 4: matiko09 ($271.15 in chips) 
Seat 5: sebaaastian ($120.17 in chips) 
Seat 7: hammerwife ($104.04 in chips) 
Seat 8: Ouga Buga ($100 in chips) 
hammerwife: posts small blind $0.50
Ouga Buga: posts big blind $1
simoniustin: sits out 
oscarleon: sits out 
*** HOLE CARDS ***
Dealt to matiko09 [3s Qh]
mycka86: folds 
Venomous100% leaves the table
Sweden_Pound: folds 
matiko09: folds 
sebaaastian: folds 
hammerwife: folds 
Uncalled bet ($0.50) returned to Ouga Buga
Ouga Buga collected $1 from pot
Ouga Buga: doesn't show hand 
*** SUMMARY ***
Total pot $1 | Rake $0 
Seat 1: mycka86 folded before Flop (didn't bet)
Seat 3: Sweden_Pound folded before Flop (didn't bet)
Seat 4: matiko09 folded before Flop (didn't bet)
Seat 5: sebaaastian (button) folded before Flop (didn't bet)
Seat 7: hammerwife (small blind) folded before Flop
Seat 8: Ouga Buga (big blind) collected ($1)





PokerStars Hand #149392778244:  Hold'em No Limit ($0.25/$0.50 USD) - 2016/02/25 16:56:55 CET [2016/02/25 10:56:55 ET]
Table 'Lohja II' 9-max Seat #7 is the button
Seat 1: MoonJimmy ($144.13 in chips) 
Seat 4: payback11 ($52.78 in chips) 
Seat 5: vasiy379 ($50 in chips) 
Seat 7: matiko09 ($153.26 in chips) 
Seat 8: jamba83 ($69.67 in chips) 
Seat 9: Al3xAnd3r22 ($98 in chips) 
jamba83: posts small blind $0.25
Al3xAnd3r22: posts big blind $0.50
Apparat888: sits out 
xAndorx: sits out 
MoonJimmy: posts the ante $0.10
payback11: posts the ante $0.10
vasiy379: posts the ante $0.10
matiko09: posts the ante $0.10
jamba83: posts the ante $0.10
Al3xAnd3r22: posts the ante $0.10
*** HOLE CARDS ***
Dealt to matiko09 [6h 3c]
MoonJimmy: folds 
payback11: folds 
vasiy379: raises $0.80 to $1.30
matiko09: folds 
jamba83: folds 
Al3xAnd3r22: folds 
Uncalled bet ($0.80) returned to vasiy379
vasiy379 collected $1.85 from pot
vasiy379: doesn't show hand 
*** SUMMARY ***
Total pot $1.85 | Rake $0 
Seat 1: MoonJimmy folded before Flop (didn't bet)
Seat 4: payback11 folded before Flop (didn't bet)
Seat 5: vasiy379 collected ($1.85)
Seat 7: matiko09 (button) folded before Flop (didn't bet)
Seat 8: jamba83 (small blind) folded before Flop
Seat 9: Al3xAnd3r22 (big blind) folded before Flop





PokerStars Hand #149392781721:  Hold'em No Limit ($0.50/$1.00 USD) - 2016/02/25 16:57:00 CET [2016/02/25 10:57:00 ET]
Table 'Zeuxo II' 9-max Seat #7 is the button
Seat 1: forsmthgood ($108.30 in chips) 
Seat 2: Sweden_Pound ($111.03 in chips) 
Seat 3: xAndorx ($100 in chips) 
Seat 4: sebaaastian ($120.61 in chips) 
Seat 5: bauss84 ($33.66 in chips) 
Seat 6: Cogss ($104.21 in chips) 
Seat 7: djammusic ($44 in chips) 
Seat 8: matiko09 ($102.16 in chips) 
Seat 9: Sreshta222 ($216.60 in chips) 
matiko09: posts small blind $0.50
Sreshta222: posts big blind $1
*** HOLE CARDS ***
Dealt to matiko09 [9h 5s]
forsmthgood: folds 
Sweden_Pound: folds 
xAndorx: folds 
sebaaastian: folds 
bauss84: folds 
Cogss: raises $1 to $2
djammusic: folds 
matiko09: folds 
Sreshta222: calls $1
*** FLOP *** [3s Kc 9s]
Sreshta222: checks 
Cogss: bets $4.30
Sreshta222: calls $4.30
*** TURN *** [3s Kc 9s] [7d]
Sreshta222: checks 
Cogss: checks 
*** RIVER *** [3s Kc 9s 7d] [2h]
Sreshta222: checks 
Cogss: checks 
*** SHOW DOWN ***
Sreshta222: shows [4s As] (high card Ace)
Cogss: shows [3c Qh] (a pair of Threes)
Cogss collected $12.51 from pot
*** SUMMARY ***
Total pot $13.10 | Rake $0.59 
Board [3s Kc 9s 7d 2h]
Seat 1: forsmthgood folded before Flop (didn't bet)
Seat 2: Sweden_Pound folded before Flop (didn't bet)
Seat 3: xAndorx folded before Flop (didn't bet)
Seat 4: sebaaastian folded before Flop (didn't bet)
Seat 5: bauss84 folded before Flop (didn't bet)
Seat 6: Cogss showed [3c Qh] and won ($12.51) with a pair of Threes
Seat 7: djammusic (button) folded before Flop (didn't bet)
Seat 8: matiko09 (small blind) folded before Flop
Seat 9: Sreshta222 (big blind) showed [4s As] and lost with high card Ace





PokerStars Hand #149392784977:  Hold'em No Limit ($0.50/$1.00 USD) - 2016/02/25 16:57:05 CET [2016/02/25 10:57:05 ET]
Table 'Isa' 9-max Seat #3 is the button
Seat 1: matiko09 ($120.44 in chips) 
Seat 2: Monsthand ($100 in chips) 
Seat 3: sebaaastian ($129.88 in chips) 
Seat 4: hammerwife ($101.31 in chips) 
Seat 5: Sweden_Pound ($184.58 in chips) 
Seat 6: xAndorx ($100 in chips) 
Seat 7: bilukm ($166.68 in chips) 
Seat 8: Venomous100% ($100 in chips) 
Seat 9: TideHan ($101.50 in chips) 
hammerwife: posts small blind $0.50
Sweden_Pound: posts big blind $1
*** HOLE CARDS ***
Dealt to matiko09 [Qs 7d]
xAndorx: folds 
bilukm: raises $1 to $2
Venomous100%: folds 
TideHan: folds 
matiko09: folds 
Monsthand: folds 
sebaaastian: folds 
hammerwife: folds 
Sweden_Pound: calls $1
*** FLOP *** [7h 3d Kd]
Sweden_Pound: checks 
bilukm: checks 
*** TURN *** [7h 3d Kd] [4c]
Sweden_Pound: bets $3
bilukm: folds 
Uncalled bet ($3) returned to Sweden_Pound
Sweden_Pound collected $4.30 from pot
Sweden_Pound: doesn't show hand 
*** SUMMARY ***
Total pot $4.50 | Rake $0.20 
Board [7h 3d Kd 4c]
Seat 1: matiko09 folded before Flop (didn't bet)
Seat 2: Monsthand folded before Flop (didn't bet)
Seat 3: sebaaastian (button) folded before Flop (didn't bet)
Seat 4: hammerwife (small blind) folded before Flop
Seat 5: Sweden_Pound (big blind) collected ($4.30)
Seat 6: xAndorx folded before Flop (didn't bet)
Seat 7: bilukm folded on the Turn
Seat 8: Venomous100% folded before Flop (didn't bet)
Seat 9: TideHan folded before Flop (didn't bet)





PokerStars Hand #149392787508:  Hold'em No Limit ($0.50/$1.00 USD) - 2016/02/25 16:57:09 CET [2016/02/25 10:57:09 ET]
Table 'Ebella II' 9-max Seat #8 is the button
Seat 1: Ilov3NBA ($100 in chips) 
Seat 2: Sweden_Pound ($102.50 in chips) 
Seat 3: Lahesell ($111.26 in chips) 
Seat 4: CoolestWitch ($46.57 in chips) 
Seat 5: matiko09 ($102.75 in chips) 
Seat 6: RMilPoker ($194.20 in chips) 
Seat 7: HomerrrJay ($100 in chips) 
Seat 8: ZMPOUTSAM140 ($76.71 in chips) 
Seat 9: simoniustin ($100 in chips) 
simoniustin: posts small blind $0.50
Ilov3NBA: posts big blind $1
*** HOLE CARDS ***
Dealt to matiko09 [7h 3d]
Sweden_Pound: folds 
Lahesell: folds 
CoolestWitch: folds 
matiko09: folds 
RMilPoker: folds 
HomerrrJay: folds 
ZMPOUTSAM140: raises $2 to $3
simoniustin: folds 
Ilov3NBA: folds 
Uncalled bet ($2) returned to ZMPOUTSAM140
ZMPOUTSAM140 collected $2.50 from pot
*** SUMMARY ***
Total pot $2.50 | Rake $0 
Seat 1: Ilov3NBA (big blind) folded before Flop
Seat 2: Sweden_Pound folded before Flop (didn't bet)
Seat 3: Lahesell folded before Flop (didn't bet)
Seat 4: CoolestWitch folded before Flop (didn't bet)
Seat 5: matiko09 folded before Flop (didn't bet)
Seat 6: RMilPoker folded before Flop (didn't bet)
Seat 7: HomerrrJay folded before Flop (didn't bet)
Seat 8: ZMPOUTSAM140 (button) collected ($2.50)
Seat 9: simoniustin (small blind) folded before Flop





PokerStars Hand #149392788541:  Hold'em No Limit ($0.50/$1.00 USD) - 2016/02/25 16:57:11 CET [2016/02/25 10:57:11 ET]
Table 'Badenia II' 9-max Seat #3 is the button
Seat 1: matiko09 ($100 in chips) 
Seat 2: Stibitzkie ($118.66 in chips) 
Seat 3: sebaaastian ($122.18 in chips) 
Seat 4: KarlMoik1 ($342.44 in chips) 
Seat 5: djammusic ($122.09 in chips) 
Seat 6: xAndorx ($101.71 in chips) 
Seat 7: forsmthgood ($100 in chips) 
Seat 8: Sweden_Pound ($130.65 in chips) 
Seat 9: waisanen ($226.54 in chips) 
KarlMoik1: posts small blind $0.50
djammusic: posts big blind $1
*** HOLE CARDS ***
Dealt to matiko09 [8s Qc]
xAndorx: folds 
forsmthgood: folds 
Sweden_Pound: folds 
waisanen: calls $1
matiko09: folds 
Stibitzkie: raises $3.50 to $4.50
sebaaastian: folds 
KarlMoik1: calls $4
djammusic: folds 
waisanen: calls $3.50
*** FLOP *** [8c Jh 9d]
KarlMoik1: checks 
waisanen: checks 
Stibitzkie: bets $13.85
KarlMoik1: folds 
waisanen: calls $13.85
*** TURN *** [8c Jh 9d] [6s]
waisanen: checks 
Stibitzkie: checks 
*** RIVER *** [8c Jh 9d 6s] [Th]
waisanen: checks 
Stibitzkie: checks 
*** SHOW DOWN ***
waisanen: shows [Td Jd] (two pair, Jacks and Tens)
Stibitzkie: mucks hand 
waisanen collected $40.30 from pot
*** SUMMARY ***
Total pot $42.20 | Rake $1.90 
Board [8c Jh 9d 6s Th]
Seat 1: matiko09 folded before Flop (didn't bet)
Seat 2: Stibitzkie mucked [8d 2d]
Seat 3: sebaaastian (button) folded before Flop (didn't bet)
Seat 4: KarlMoik1 (small blind) folded on the Flop
Seat 5: djammusic (big blind) folded before Flop
Seat 6: xAndorx folded before Flop (didn't bet)
Seat 7: forsmthgood folded before Flop (didn't bet)
Seat 8: Sweden_Pound folded before Flop (didn't bet)
Seat 9: waisanen showed [Td Jd] and won ($40.30) with two pair, Jacks and Tens





PokerStars Hand #149392789102:  Hold'em No Limit ($0.25/$0.50 USD) - 2016/02/25 16:57:12 CET [2016/02/25 10:57:12 ET]
Table 'Thalpius III' 9-max Seat #1 is the button
Seat 1: BrotherLove9 ($59.57 in chips) 
Seat 2: matiko09 ($62.92 in chips) 
Seat 3: jamba83 ($50.46 in chips) 
Seat 4: Wwwasian ($75.79 in chips) 
Seat 6: ihami ($51.25 in chips) 
Seat 7: v4n0v ($51.50 in chips) 
Seat 8: jeroemie123 ($45.50 in chips) 
Seat 9: Domotirko228 ($50.96 in chips) 
matiko09: posts small blind $0.25
jamba83: posts big blind $0.50
Al3xAnd3r22: sits out 
*** HOLE CARDS ***
Dealt to matiko09 [8c 8d]
Wwwasian: folds 
ihami: folds 
v4n0v has timed out
v4n0v: folds 
jeroemie123: raises $0.50 to $1
Domotirko228: folds 
BrotherLove9: folds 
matiko09: calls $0.75
jamba83: folds 
*** FLOP *** [Kh 7c Td]
matiko09: checks 
jeroemie123: checks 
*** TURN *** [Kh 7c Td] [2d]
matiko09: checks 
jeroemie123: checks 
*** RIVER *** [Kh 7c Td 2d] [7h]
matiko09: checks 
jeroemie123: checks 
*** SHOW DOWN ***
matiko09: shows [8c 8d] (two pair, Eights and Sevens)
jeroemie123: mucks hand 
matiko09 collected $2.39 from pot
*** SUMMARY ***
Total pot $2.50 | Rake $0.11 
Board [Kh 7c Td 2d 7h]
Seat 1: BrotherLove9 (button) folded before Flop (didn't bet)
Seat 2: matiko09 (small blind) showed [8c 8d] and won ($2.39) with two pair, Eights and Sevens
Seat 3: jamba83 (big blind) folded before Flop
Seat 4: Wwwasian folded before Flop (didn't bet)
Seat 6: ihami folded before Flop (didn't bet)
Seat 7: v4n0v folded before Flop (didn't bet)
Seat 8: jeroemie123 mucked [2s Ah]
Seat 9: Domotirko228 folded before Flop (didn't bet)





PokerStars Hand #149392792347:  Hold'em No Limit ($0.50/$1.00 USD) - 2016/02/25 16:57:16 CET [2016/02/25 10:57:16 ET]
Table 'Simona' 9-max Seat #7 is the button
Seat 1: mycka86 ($136.93 in chips) 
Seat 3: Sweden_Pound ($117.59 in chips) 
Seat 4: matiko09 ($271.15 in chips) 
Seat 5: sebaaastian ($120.17 in chips) 
Seat 7: hammerwife ($103.54 in chips) 
Seat 8: Ouga Buga ($100.50 in chips) 
Seat 9: simoniustin ($100 in chips) 
Ouga Buga: posts small blind $0.50
simoniustin: posts big blind $1
oscarleon: sits out 
*** HOLE CARDS ***
Dealt to matiko09 [2h 5d]
Effort92 joins the table at seat #6 
mycka86: folds 
Sweden_Pound: folds 
matiko09: folds 
sebaaastian: raises $1.50 to $2.50
hammerwife: folds 
Ouga Buga: folds 
simoniustin: folds 
Uncalled bet ($1.50) returned to sebaaastian
sebaaastian collected $2.50 from pot
sebaaastian: doesn't show hand 
*** SUMMARY ***
Total pot $2.50 | Rake $0 
Seat 1: mycka86 folded before Flop (didn't bet)
Seat 3: Sweden_Pound folded before Flop (didn't bet)
Seat 4: matiko09 folded before Flop (didn't bet)
Seat 5: sebaaastian collected ($2.50)
Seat 7: hammerwife (button) folded before Flop (didn't bet)
Seat 8: Ouga Buga (small blind) folded before Flop
Seat 9: simoniustin (big blind) folded before Flop





PokerStars Hand #149392794656:  Hold'em No Limit ($0.25/$0.50 USD) - 2016/02/25 16:57:20 CET [2016/02/25 10:57:20 ET]
Table 'Lohja II' 9-max Seat #8 is the button
Seat 1: MoonJimmy ($144.03 in chips) 
Seat 4: payback11 ($52.68 in chips) 
Seat 5: vasiy379 ($51.25 in chips) 
Seat 7: matiko09 ($153.16 in chips) 
Seat 8: jamba83 ($69.32 in chips) 
Seat 9: Al3xAnd3r22 ($98 in chips) 
Al3xAnd3r22: posts small blind $0.25
MoonJimmy: posts big blind $0.50
Apparat888: sits out 
xAndorx: sits out 
MoonJimmy: posts the ante $0.10
payback11: posts the ante $0.10
vasiy379: posts the ante $0.10
matiko09: posts the ante $0.10
jamba83: posts the ante $0.10
Al3xAnd3r22: posts the ante $0.10
*** HOLE CARDS ***
Dealt to matiko09 [5d 5h]
payback11: folds 
vasiy379: raises $0.80 to $1.30
matiko09: folds 
jamba83: folds 
Al3xAnd3r22: folds 
MoonJimmy: folds 
Uncalled bet ($0.80) returned to vasiy379
vasiy379 collected $1.85 from pot
vasiy379: doesn't show hand 
*** SUMMARY ***
Total pot $1.85 | Rake $0 
Seat 1: MoonJimmy (big blind) folded before Flop
Seat 4: payback11 folded before Flop (didn't bet)
Seat 5: vasiy379 collected ($1.85)
Seat 7: matiko09 folded before Flop (didn't bet)
Seat 8: jamba83 (button) folded before Flop (didn't bet)
Seat 9: Al3xAnd3r22 (small blind) folded before Flop





PokerStars Hand #149392815986:  Hold'em No Limit ($0.50/$1.00 USD) - 2016/02/25 16:57:52 CET [2016/02/25 10:57:52 ET]
Table 'Ebella II' 9-max Seat #9 is the button
Seat 1: Ilov3NBA ($100 in chips) 
Seat 2: Sweden_Pound ($102.50 in chips) 
Seat 3: Lahesell ($111.26 in chips) 
Seat 4: CoolestWitch ($46.57 in chips) 
Seat 5: matiko09 ($102.75 in chips) 
Seat 7: HomerrrJay ($100 in chips) 
Seat 8: ZMPOUTSAM140 ($78.21 in chips) 
Seat 9: simoniustin ($100 in chips) 
Ilov3NBA: posts small blind $0.50
Sweden_Pound: posts big blind $1
*** HOLE CARDS ***
Dealt to matiko09 [Tc 8d]
Lahesell: folds 
CoolestWitch: folds 
matiko09: folds 
HomerrrJay: folds 
ZMPOUTSAM140: raises $2 to $3
simoniustin: calls $3
Ilov3NBA: folds 
Sweden_Pound: folds 
*** FLOP *** [7h 9s 4d]
ZMPOUTSAM140: bets $4
simoniustin: raises $8 to $12
ZMPOUTSAM140: folds 
Uncalled bet ($8) returned to simoniustin
simoniustin collected $14.80 from pot
simoniustin: doesn't show hand 
*** SUMMARY ***
Total pot $15.50 | Rake $0.70 
Board [7h 9s 4d]
Seat 1: Ilov3NBA (small blind) folded before Flop
Seat 2: Sweden_Pound (big blind) folded before Flop
Seat 3: Lahesell folded before Flop (didn't bet)
Seat 4: CoolestWitch folded before Flop (didn't bet)
Seat 5: matiko09 folded before Flop (didn't bet)
Seat 7: HomerrrJay folded before Flop (didn't bet)
Seat 8: ZMPOUTSAM140 folded on the Flop
Seat 9: simoniustin (button) collected ($14.80)





PokerStars Hand #149392820188:  Hold'em No Limit ($0.50/$1.00 USD) - 2016/02/25 16:57:59 CET [2016/02/25 10:57:59 ET]
Table 'Guisan' 9-max Seat #4 is the button
Seat 1: stockbridge8 ($72.60 in chips) 
Seat 2: mycka86 ($100 in chips) 
Seat 3: xAndorx ($133.21 in chips) 
Seat 4: matiko09 ($245.05 in chips) 
Seat 5: Apparat888 ($50 in chips) 
Seat 6: 19R&J91 ($327.07 in chips) 
Seat 7: sebaaastian ($128.89 in chips) 
Seat 8: Monsthand ($121.67 in chips) 
Seat 9: Sweden_Pound ($106.19 in chips) 
Apparat888: posts small blind $0.50
19R&J91: posts big blind $1
*** HOLE CARDS ***
Dealt to matiko09 [2s 6d]
sebaaastian: folds 
Monsthand: folds 
Sweden_Pound: raises $2 to $3
stockbridge8: folds 
mycka86: folds 
xAndorx: folds 
matiko09: folds 
Apparat888: folds 
19R&J91: raises $9 to $12
Sweden_Pound: raises $14 to $26
19R&J91: calls $14
*** FLOP *** [Ah 5s Js]
19R&J91: checks 
Sweden_Pound: checks 
*** TURN *** [Ah 5s Js] [9s]
19R&J91: bets $10
Sweden_Pound: calls $10
*** RIVER *** [Ah 5s Js 9s] [6s]
19R&J91: bets $23
Sweden_Pound: calls $23
*** SHOW DOWN ***
19R&J91: shows [Tc 2d] (high card Ace)
Sweden_Pound: shows [Ks Kh] (a flush, King high)
Sweden_Pound collected $115.70 from pot
*** SUMMARY ***
Total pot $118.50 | Rake $2.80 
Board [Ah 5s Js 9s 6s]
Seat 1: stockbridge8 folded before Flop (didn't bet)
Seat 2: mycka86 folded before Flop (didn't bet)
Seat 3: xAndorx folded before Flop (didn't bet)
Seat 4: matiko09 (button) folded before Flop (didn't bet)
Seat 5: Apparat888 (small blind) folded before Flop
Seat 6: 19R&J91 (big blind) showed [Tc 2d] and lost with high card Ace
Seat 7: sebaaastian folded before Flop (didn't bet)
Seat 8: Monsthand folded before Flop (didn't bet)
Seat 9: Sweden_Pound showed [Ks Kh] and won ($115.70) with a flush, King high





PokerStars Hand #149392824296:  Hold'em No Limit ($0.25/$0.50 USD) - 2016/02/25 16:58:05 CET [2016/02/25 10:58:05 ET]
Table 'Lohja II' 9-max Seat #9 is the button
Seat 1: MoonJimmy ($143.43 in chips) 
Seat 2: Apparat888 ($49.70 in chips) 
Seat 4: payback11 ($52.58 in chips) 
Seat 5: vasiy379 ($52.50 in chips) 
Seat 7: matiko09 ($153.06 in chips) 
Seat 8: jamba83 ($69.22 in chips) 
Seat 9: Al3xAnd3r22 ($98 in chips) 
MoonJimmy: posts small blind $0.25
Apparat888: posts big blind $0.50
xAndorx: sits out 
MoonJimmy: posts the ante $0.10
Apparat888: posts the ante $0.10
payback11: posts the ante $0.10
vasiy379: posts the ante $0.10
matiko09: posts the ante $0.10
jamba83: posts the ante $0.10
Al3xAnd3r22: posts the ante $0.10
*** HOLE CARDS ***
Dealt to matiko09 [8s Kc]
payback11: folds 
vasiy379: raises $1 to $1.50
matiko09: folds 
jamba83: folds 
Al3xAnd3r22: folds 
MoonJimmy: folds 
Apparat888: folds 
Uncalled bet ($1) returned to vasiy379
vasiy379 collected $1.95 from pot
vasiy379: doesn't show hand 
*** SUMMARY ***
Total pot $1.95 | Rake $0 
Seat 1: MoonJimmy (small blind) folded before Flop
Seat 2: Apparat888 (big blind) folded before Flop
Seat 4: payback11 folded before Flop (didn't bet)
Seat 5: vasiy379 collected ($1.95)
Seat 7: matiko09 folded before Flop (didn't bet)
Seat 8: jamba83 folded before Flop (didn't bet)
Seat 9: Al3xAnd3r22 (button) folded before Flop (didn't bet)





PokerStars Hand #149392827830:  Hold'em No Limit ($0.50/$1.00 USD) - 2016/02/25 16:58:11 CET [2016/02/25 10:58:11 ET]
Table 'Hercules IV' 9-max Seat #8 is the button
Seat 1: matiko09 ($100 in chips) 
Seat 2: hammerwife ($108.02 in chips) 
Seat 3: sebaaastian ($222.93 in chips) 
Seat 4: Sweden_Pound ($100 in chips) 
Seat 5: xAndorx ($155.46 in chips) 
Seat 6: kuanhung0903 ($58.38 in chips) 
Seat 7: Ouga Buga ($100 in chips) 
Seat 8: brokat77 ($117.54 in chips) 
Seat 9: djammusic ($37.18 in chips) 
djammusic: posts small blind $0.50
matiko09: posts big blind $1
*** HOLE CARDS ***
Dealt to matiko09 [Qh Jc]
hammerwife: folds 
sebaaastian: folds 
Sweden_Pound: folds 
xAndorx: folds 
kuanhung0903: folds 
Ouga Buga: folds 
brokat77: calls $1
djammusic: folds 
matiko09: checks 
*** FLOP *** [4h 3d 5c]
matiko09: checks 
brokat77: bets $2.39
matiko09: folds 
Uncalled bet ($2.39) returned to brokat77
brokat77 collected $2.39 from pot
brokat77: doesn't show hand 
*** SUMMARY ***
Total pot $2.50 | Rake $0.11 
Board [4h 3d 5c]
Seat 1: matiko09 (big blind) folded on the Flop
Seat 2: hammerwife folded before Flop (didn't bet)
Seat 3: sebaaastian folded before Flop (didn't bet)
Seat 4: Sweden_Pound folded before Flop (didn't bet)
Seat 5: xAndorx folded before Flop (didn't bet)
Seat 6: kuanhung0903 folded before Flop (didn't bet)
Seat 7: Ouga Buga folded before Flop (didn't bet)
Seat 8: brokat77 (button) collected ($2.39)
Seat 9: djammusic (small blind) folded before Flop





PokerStars Hand #149392831434:  Hold'em No Limit ($0.25/$0.50 USD) - 2016/02/25 16:58:16 CET [2016/02/25 10:58:16 ET]
Table 'Thalpius III' 9-max Seat #2 is the button
Seat 1: BrotherLove9 ($59.57 in chips) 
Seat 2: matiko09 ($64.31 in chips) 
Seat 3: jamba83 ($50 in chips) 
Seat 4: Wwwasian ($75.79 in chips) 
Seat 6: ihami ($51.25 in chips) 
Seat 7: v4n0v ($51.50 in chips) 
Seat 8: jeroemie123 ($49 in chips) 
Seat 9: Domotirko228 ($50.96 in chips) 
jamba83: posts small blind $0.25
Wwwasian: posts big blind $0.50
Al3xAnd3r22: sits out 
*** HOLE CARDS ***
Dealt to matiko09 [Td 2c]
ihami: folds 
v4n0v: folds 
jeroemie123 has timed out while being disconnected
jeroemie123: folds 
Domotirko228: folds 
jeroemie123 is disconnected 
BrotherLove9: folds 
matiko09: folds 
jamba83: raises $0.50 to $1
Wwwasian: calls $0.50
*** FLOP *** [9c 4d 4h]
jamba83: bets $1.50
Wwwasian: calls $1.50
*** TURN *** [9c 4d 4h] [Th]
jamba83: checks 
Wwwasian: bets $2.53
jamba83: calls $2.53
*** RIVER *** [9c 4d 4h Th] [Qs]
jamba83: checks 
Wwwasian: checks 
*** SHOW DOWN ***
jamba83: shows [Ac 9h] (two pair, Nines and Fours)
Wwwasian: mucks hand 
jamba83 collected $9.61 from pot
*** SUMMARY ***
Total pot $10.06 | Rake $0.45 
Board [9c 4d 4h Th Qs]
Seat 1: BrotherLove9 folded before Flop (didn't bet)
Seat 2: matiko09 (button) folded before Flop (didn't bet)
Seat 3: jamba83 (small blind) showed [Ac 9h] and won ($9.61) with two pair, Nines and Fours
Seat 4: Wwwasian (big blind) mucked [7s 9s]
Seat 6: ihami folded before Flop (didn't bet)
Seat 7: v4n0v folded before Flop (didn't bet)
Seat 8: jeroemie123 folded before Flop (didn't bet)
Seat 9: Domotirko228 folded before Flop (didn't bet)





PokerStars Hand #149392831949:  Hold'em No Limit ($0.50/$1.00 USD) - 2016/02/25 16:58:17 CET [2016/02/25 10:58:17 ET]
Table 'Simona' 9-max Seat #8 is the button
Seat 1: mycka86 ($136.93 in chips) 
Seat 3: Sweden_Pound ($117.59 in chips) 
Seat 4: matiko09 ($271.15 in chips) 
Seat 5: sebaaastian ($121.67 in chips) 
Seat 7: hammerwife ($103.54 in chips) 
Seat 8: Ouga Buga ($100 in chips) 
Seat 9: simoniustin ($100 in chips) 
simoniustin: posts small blind $0.50
mycka86: posts big blind $1
oscarleon: sits out 
Effort92: sits out 
*** HOLE CARDS ***
Dealt to matiko09 [Qc Kd]
Sweden_Pound: raises $2 to $3
matiko09: raises $6.50 to $9.50
sebaaastian: folds 
hammerwife: raises $13 to $22.50
Ouga Buga: folds 
simoniustin: folds 
mycka86: folds 
Sweden_Pound: folds 
matiko09: folds 
Uncalled bet ($13) returned to hammerwife
hammerwife collected $23.50 from pot
hammerwife: doesn't show hand 
*** SUMMARY ***
Total pot $23.50 | Rake $0 
Seat 1: mycka86 (big blind) folded before Flop
Seat 3: Sweden_Pound folded before Flop
Seat 4: matiko09 folded before Flop
Seat 5: sebaaastian folded before Flop (didn't bet)
Seat 7: hammerwife collected ($23.50)
Seat 8: Ouga Buga (button) folded before Flop (didn't bet)
Seat 9: simoniustin (small blind) folded before Flop





PokerStars Hand #149392832808:  Hold'em No Limit ($0.50/$1.00 USD) - 2016/02/25 16:58:18 CET [2016/02/25 10:58:18 ET]
Table 'Sabine' 9-max Seat #6 is the button
Seat 1: Aalleekks ($102.50 in chips) 
Seat 2: apfush ($100 in chips) 
Seat 4: hammerwife ($100 in chips) 
Seat 6: Sweden_Pound ($135.11 in chips) 
Seat 7: clayshmert ($80.88 in chips) 
Seat 8: matiko09 ($100 in chips) 
Seat 9: djammusic ($64.14 in chips) 
clayshmert: posts small blind $0.50
matiko09: posts big blind $1
Ouga Buga: sits out 
*** HOLE CARDS ***
Dealt to matiko09 [8c Th]
djammusic: folds 
Aalleekks: folds 
apfush: folds 
hammerwife: raises $1.50 to $2.50
Sweden_Pound: folds 
clayshmert: folds 
matiko09: folds 
Uncalled bet ($1.50) returned to hammerwife
hammerwife collected $2.50 from pot
hammerwife: doesn't show hand 
*** SUMMARY ***
Total pot $2.50 | Rake $0 
Seat 1: Aalleekks folded before Flop (didn't bet)
Seat 2: apfush folded before Flop (didn't bet)
Seat 4: hammerwife collected ($2.50)
Seat 6: Sweden_Pound (button) folded before Flop (didn't bet)
Seat 7: clayshmert (small blind) folded before Flop
Seat 8: matiko09 (big blind) folded before Flop
Seat 9: djammusic folded before Flop (didn't bet)





PokerStars Hand #149392833054:  Hold'em No Limit ($0.50/$1.00 USD) - 2016/02/25 16:58:19 CET [2016/02/25 10:58:19 ET]
Table 'Isa' 9-max Seat #4 is the button
Seat 1: matiko09 ($120.44 in chips) 
Seat 2: Monsthand ($100 in chips) 
Seat 3: sebaaastian ($129.88 in chips) 
Seat 4: hammerwife ($100.81 in chips) 
Seat 5: Sweden_Pound ($186.88 in chips) 
Seat 6: xAndorx ($100 in chips) 
Seat 7: bilukm ($164.68 in chips) 
Seat 8: Venomous100% ($100 in chips) 
Seat 9: TideHan ($101.50 in chips) 
Sweden_Pound: posts small blind $0.50
xAndorx: posts big blind $1
*** HOLE CARDS ***
Dealt to matiko09 [7c 3d]
bilukm: calls $1
Venomous100%: raises $3 to $4
TideHan: folds 
matiko09: folds 
Monsthand: calls $4
sebaaastian: folds 
hammerwife: folds 
Sweden_Pound: folds 
xAndorx: folds 
bilukm: calls $3
*** FLOP *** [Js 7h Kc]
bilukm: checks 
Venomous100%: checks 
Monsthand: bets $7
bilukm: folds 
Venomous100%: folds 
Uncalled bet ($7) returned to Monsthand
Monsthand collected $12.89 from pot
*** SUMMARY ***
Total pot $13.50 | Rake $0.61 
Board [Js 7h Kc]
Seat 1: matiko09 folded before Flop (didn't bet)
Seat 2: Monsthand collected ($12.89)
Seat 3: sebaaastian folded before Flop (didn't bet)
Seat 4: hammerwife (button) folded before Flop (didn't bet)
Seat 5: Sweden_Pound (small blind) folded before Flop
Seat 6: xAndorx (big blind) folded before Flop
Seat 7: bilukm folded on the Flop
Seat 8: Venomous100% folded on the Flop
Seat 9: TideHan folded before Flop (didn't bet)





PokerStars Hand #149392835338:  Hold'em No Limit ($0.25/$0.50 USD) - 2016/02/25 16:58:22 CET [2016/02/25 10:58:22 ET]
Table 'Ophiuchus III' 9-max Seat #8 is the button
Seat 1: RvPersie ($104.20 in chips) 
Seat 2: ihami ($47.75 in chips) 
Seat 3: rdrill ($50 in chips) 
Seat 4: lucima10 ($98.25 in chips) 
Seat 5: ReneProost ($35.68 in chips) 
Seat 6: Al3xAnd3r22 ($50 in chips) 
Seat 8: matiko09 ($50 in chips) 
Seat 9: tugboat2008 ($78.02 in chips) 
tugboat2008: posts small blind $0.25
RvPersie: posts big blind $0.50
JustR82: sits out 
*** HOLE CARDS ***
Dealt to matiko09 [Kc 5d]
ihami: folds 
rdrill: folds 
lucima10: raises $1 to $1.50
ReneProost: folds 
Al3xAnd3r22: folds 
matiko09: folds 
JustR82 leaves the table
tugboat2008: folds 
Bron By joins the table at seat #7 
RvPersie: folds 
Uncalled bet ($1) returned to lucima10
lucima10 collected $1.25 from pot
lucima10: doesn't show hand 
*** SUMMARY ***
Total pot $1.25 | Rake $0 
Seat 1: RvPersie (big blind) folded before Flop
Seat 2: ihami folded before Flop (didn't bet)
Seat 3: rdrill folded before Flop (didn't bet)
Seat 4: lucima10 collected ($1.25)
Seat 5: ReneProost folded before Flop (didn't bet)
Seat 6: Al3xAnd3r22 folded before Flop (didn't bet)
Seat 8: matiko09 (button) folded before Flop (didn't bet)
Seat 9: tugboat2008 (small blind) folded before Flop





PokerStars Hand #149392836399:  Hold'em No Limit ($0.50/$1.00 USD) - 2016/02/25 16:58:24 CET [2016/02/25 10:58:24 ET]
Table 'Zeuxo II' 9-max Seat #8 is the button
Seat 1: forsmthgood ($108.30 in chips) 
Seat 2: Sweden_Pound ($111.03 in chips) 
Seat 3: xAndorx ($100 in chips) 
Seat 4: sebaaastian ($120.61 in chips) 
Seat 5: bauss84 ($33.66 in chips) 
Seat 6: Cogss ($110.42 in chips) 
Seat 7: djammusic ($44 in chips) 
Seat 8: matiko09 ($101.66 in chips) 
Seat 9: Sreshta222 ($210.30 in chips) 
Sreshta222: posts small blind $0.50
forsmthgood: posts big blind $1
*** HOLE CARDS ***
Dealt to matiko09 [9d Qh]
Sweden_Pound: folds 
xAndorx said, "(y)"
xAndorx: folds 
sebaaastian: folds 
bauss84: folds 
Cogss: folds 
djammusic: folds 
matiko09: raises $1.27 to $2.27
Sreshta222: folds 
forsmthgood: calls $1.27
*** FLOP *** [5c 3d As]
forsmthgood: checks 
matiko09: bets $3
forsmthgood: folds 
Uncalled bet ($3) returned to matiko09
matiko09 collected $4.81 from pot
matiko09: doesn't show hand 
*** SUMMARY ***
Total pot $5.04 | Rake $0.23 
Board [5c 3d As]
Seat 1: forsmthgood (big blind) folded on the Flop
Seat 2: Sweden_Pound folded before Flop (didn't bet)
Seat 3: xAndorx folded before Flop (didn't bet)
Seat 4: sebaaastian folded before Flop (didn't bet)
Seat 5: bauss84 folded before Flop (didn't bet)
Seat 6: Cogss folded before Flop (didn't bet)
Seat 7: djammusic folded before Flop (didn't bet)
Seat 8: matiko09 (button) collected ($4.81)
Seat 9: Sreshta222 (small blind) folded before Flop





PokerStars Hand #149392841127:  Hold'em No Limit ($0.25/$0.50 USD) - 2016/02/25 16:58:31 CET [2016/02/25 10:58:31 ET]
Table 'Lohja II' 9-max Seat #1 is the button
Seat 1: MoonJimmy ($143.08 in chips) 
Seat 2: Apparat888 ($49.10 in chips) 
Seat 4: payback11 ($52.48 in chips) 
Seat 5: vasiy379 ($53.85 in chips) 
Seat 7: matiko09 ($152.96 in chips) 
Seat 8: jamba83 ($69.12 in chips) 
Seat 9: Al3xAnd3r22 ($98 in chips) 
Apparat888: posts small blind $0.25
payback11: posts big blind $0.50
xAndorx: sits out 
MoonJimmy: posts the ante $0.10
Apparat888: posts the ante $0.10
payback11: posts the ante $0.10
vasiy379: posts the ante $0.10
matiko09: posts the ante $0.10
jamba83: posts the ante $0.10
Al3xAnd3r22: posts the ante $0.10
*** HOLE CARDS ***
Dealt to matiko09 [Td 6h]
vasiy379: folds 
matiko09: folds 
jamba83: folds 
Al3xAnd3r22: raises $0.72 to $1.22
MoonJimmy: folds 
Apparat888: folds 
payback11: folds 
Uncalled bet ($0.72) returned to Al3xAnd3r22
Al3xAnd3r22 collected $1.95 from pot
Al3xAnd3r22: doesn't show hand 
*** SUMMARY ***
Total pot $1.95 | Rake $0 
Seat 1: MoonJimmy (button) folded before Flop (didn't bet)
Seat 2: Apparat888 (small blind) folded before Flop
Seat 4: payback11 (big blind) folded before Flop
Seat 5: vasiy379 folded before Flop (didn't bet)
Seat 7: matiko09 folded before Flop (didn't bet)
Seat 8: jamba83 folded before Flop (didn't bet)
Seat 9: Al3xAnd3r22 collected ($1.95)





PokerStars Hand #149392851747:  Hold'em No Limit ($0.50/$1.00 USD) - 2016/02/25 16:58:47 CET [2016/02/25 10:58:47 ET]
Table 'Sabine' 9-max Seat #7 is the button
Seat 1: Aalleekks ($102.50 in chips) 
Seat 2: apfush ($100 in chips) 
Seat 4: hammerwife ($101.50 in chips) 
Seat 6: Sweden_Pound ($135.11 in chips) 
Seat 7: clayshmert ($80.38 in chips) 
Seat 8: matiko09 ($100 in chips) 
Seat 9: djammusic ($64.14 in chips) 
matiko09: posts small blind $0.50
djammusic: posts big blind $1
Ouga Buga: sits out 
*** HOLE CARDS ***
Dealt to matiko09 [Ac Qd]
Aalleekks: folds 
apfush: folds 
hammerwife: folds 
Sweden_Pound: raises $1.50 to $2.50
clayshmert: calls $2.50
matiko09: raises $8.50 to $11
djammusic: folds 
Sweden_Pound: folds 
clayshmert: folds 
Uncalled bet ($8.50) returned to matiko09
matiko09 collected $8.50 from pot
matiko09: doesn't show hand 
*** SUMMARY ***
Total pot $8.50 | Rake $0 
Seat 1: Aalleekks folded before Flop (didn't bet)
Seat 2: apfush folded before Flop (didn't bet)
Seat 4: hammerwife folded before Flop (didn't bet)
Seat 6: Sweden_Pound folded before Flop
Seat 7: clayshmert (button) folded before Flop
Seat 8: matiko09 (small blind) collected ($8.50)
Seat 9: djammusic (big blind) folded before Flop





PokerStars Hand #149392858306:  Hold'em No Limit ($0.25/$0.50 USD) - 2016/02/25 16:58:57 CET [2016/02/25 10:58:57 ET]
Table 'Ophiuchus III' 9-max Seat #9 is the button
Seat 1: RvPersie ($103.70 in chips) 
Seat 2: ihami ($47.75 in chips) 
Seat 3: rdrill ($50 in chips) 
Seat 4: lucima10 ($99 in chips) 
Seat 5: ReneProost ($35.68 in chips) 
Seat 6: Al3xAnd3r22 ($50 in chips) 
Seat 8: matiko09 ($50 in chips) 
Seat 9: tugboat2008 ($77.77 in chips) 
RvPersie: posts small blind $0.25
ihami: posts big blind $0.50
Bron By: sits out 
*** HOLE CARDS ***
Dealt to matiko09 [Qd 4h]
rdrill: folds 
lucima10: folds 
ReneProost: folds 
Al3xAnd3r22: raises $1 to $1.50
Bron By leaves the table
matiko09: folds 
tugboat2008: folds 
jamba83 joins the table at seat #7 
rdrill leaves the table
RvPersie: folds 
ihami: folds 
Uncalled bet ($1) returned to Al3xAnd3r22
Al3xAnd3r22 collected $1.25 from pot
Al3xAnd3r22: doesn't show hand 
*** SUMMARY ***
Total pot $1.25 | Rake $0 
Seat 1: RvPersie (small blind) folded before Flop
Seat 2: ihami (big blind) folded before Flop
Seat 3: rdrill folded before Flop (didn't bet)
Seat 4: lucima10 folded before Flop (didn't bet)
Seat 5: ReneProost folded before Flop (didn't bet)
Seat 6: Al3xAnd3r22 collected ($1.25)
Seat 8: matiko09 folded before Flop (didn't bet)
Seat 9: tugboat2008 (button) folded before Flop (didn't bet)





PokerStars Hand #149392858890:  Hold'em No Limit ($0.50/$1.00 USD) - 2016/02/25 16:58:58 CET [2016/02/25 10:58:58 ET]
Table 'Ebella II' 9-max Seat #1 is the button
Seat 1: Ilov3NBA ($100 in chips) 
Seat 2: Sweden_Pound ($101.50 in chips) 
Seat 3: Lahesell ($111.26 in chips) 
Seat 4: CoolestWitch ($46.57 in chips) 
Seat 5: matiko09 ($102.75 in chips) 
Seat 7: HomerrrJay ($100 in chips) 
Seat 8: ZMPOUTSAM140 ($71.21 in chips) 
Seat 9: simoniustin ($107.80 in chips) 
Sweden_Pound: posts small blind $0.50
Lahesell: posts big blind $1
*** HOLE CARDS ***
Dealt to matiko09 [4s 5s]
CoolestWitch: folds 
CoolestWitch leaves the table
matiko09: folds 
HomerrrJay: folds 
ZMPOUTSAM140: folds 
djammusic joins the table at seat #4 
simoniustin: raises $1.50 to $2.50
Ilov3NBA: calls $2.50
Sweden_Pound: folds 
Lahesell: raises $9 to $11.50
simoniustin: folds 
Ilov3NBA: folds 
Uncalled bet ($9) returned to Lahesell
Lahesell collected $8 from pot
Lahesell: doesn't show hand 
*** SUMMARY ***
Total pot $8 | Rake $0 
Seat 1: Ilov3NBA (button) folded before Flop
Seat 2: Sweden_Pound (small blind) folded before Flop
Seat 3: Lahesell (big blind) collected ($8)
Seat 4: CoolestWitch folded before Flop (didn't bet)
Seat 5: matiko09 folded before Flop (didn't bet)
Seat 7: HomerrrJay folded before Flop (didn't bet)
Seat 8: ZMPOUTSAM140 folded before Flop (didn't bet)
Seat 9: simoniustin folded before Flop





PokerStars Hand #149392861408:  Hold'em No Limit ($0.50/$1.00 USD) - 2016/02/25 16:59:02 CET [2016/02/25 10:59:02 ET]
Table 'Hercules IV' 9-max Seat #9 is the button
Seat 1: matiko09 ($100 in chips) 
Seat 2: hammerwife ($108.02 in chips) 
Seat 3: sebaaastian ($222.93 in chips) 
Seat 4: Sweden_Pound ($100 in chips) 
Seat 5: xAndorx ($155.46 in chips) 
Seat 6: kuanhung0903 ($58.38 in chips) 
Seat 7: Ouga Buga ($100 in chips) 
Seat 8: brokat77 ($118.93 in chips) 
Seat 9: djammusic ($36.68 in chips) 
matiko09: posts small blind $0.50
hammerwife: posts big blind $1
*** HOLE CARDS ***
Dealt to matiko09 [Ks 7d]
sebaaastian: folds 
Sweden_Pound: folds 
xAndorx: folds 
kuanhung0903: folds 
Ouga Buga: folds 
brokat77: folds 
djammusic: folds 
matiko09: folds 
Uncalled bet ($0.50) returned to hammerwife
hammerwife collected $1 from pot
hammerwife: doesn't show hand 
*** SUMMARY ***
Total pot $1 | Rake $0 
Seat 1: matiko09 (small blind) folded before Flop
Seat 2: hammerwife (big blind) collected ($1)
Seat 3: sebaaastian folded before Flop (didn't bet)
Seat 4: Sweden_Pound folded before Flop (didn't bet)
Seat 5: xAndorx folded before Flop (didn't bet)
Seat 6: kuanhung0903 folded before Flop (didn't bet)
Seat 7: Ouga Buga folded before Flop (didn't bet)
Seat 8: brokat77 folded before Flop (didn't bet)
Seat 9: djammusic (button) folded before Flop (didn't bet)





PokerStars Hand #149392864692:  Hold'em No Limit ($0.25/$0.50 USD) - 2016/02/25 16:59:07 CET [2016/02/25 10:59:07 ET]
Table 'Lohja II' 9-max Seat #2 is the button
Seat 1: MoonJimmy ($142.98 in chips) 
Seat 2: Apparat888 ($48.75 in chips) 
Seat 4: payback11 ($51.88 in chips) 
Seat 6: xAndorx ($50 in chips) 
Seat 7: matiko09 ($152.86 in chips) 
Seat 8: jamba83 ($69.02 in chips) 
Seat 9: Al3xAnd3r22 ($99.35 in chips) 
payback11: posts small blind $0.25
vasiy379: is sitting out 
xAndorx: posts big blind $0.50
MoonJimmy: posts the ante $0.10
Apparat888: posts the ante $0.10
payback11: posts the ante $0.10
xAndorx: posts the ante $0.10
matiko09: posts the ante $0.10
jamba83: posts the ante $0.10
Al3xAnd3r22: posts the ante $0.10
*** HOLE CARDS ***
Dealt to matiko09 [9d Ts]
matiko09: folds 
jamba83: raises $1 to $1.50
Al3xAnd3r22: folds 
MoonJimmy: folds 
vasiy379 leaves the table
Apparat888: folds 
111STAVR111 joins the table at seat #5 
payback11: folds 
xAndorx: folds 
Uncalled bet ($1) returned to jamba83
jamba83 collected $1.95 from pot
*** SUMMARY ***
Total pot $1.95 | Rake $0 
Seat 1: MoonJimmy folded before Flop (didn't bet)
Seat 2: Apparat888 (button) folded before Flop (didn't bet)
Seat 4: payback11 (small blind) folded before Flop
Seat 6: xAndorx (big blind) folded before Flop
Seat 7: matiko09 folded before Flop (didn't bet)
Seat 8: jamba83 collected ($1.95)
Seat 9: Al3xAnd3r22 folded before Flop (didn't bet)





PokerStars Hand #149392865691:  Hold'em No Limit ($0.50/$1.00 USD) - 2016/02/25 16:59:09 CET [2016/02/25 10:59:09 ET]
Table 'Badenia II' 9-max Seat #4 is the button
Seat 1: matiko09 ($100 in chips) 
Seat 2: Stibitzkie ($100.31 in chips) 
Seat 3: sebaaastian ($122.18 in chips) 
Seat 4: KarlMoik1 ($337.94 in chips) 
Seat 5: djammusic ($121.09 in chips) 
Seat 6: xAndorx ($101.71 in chips) 
Seat 7: forsmthgood ($100 in chips) 
Seat 8: Sweden_Pound ($130.65 in chips) 
Seat 9: waisanen ($248.49 in chips) 
djammusic: posts small blind $0.50
xAndorx: posts big blind $1
*** HOLE CARDS ***
Dealt to matiko09 [3c 5h]
forsmthgood: folds 
Sweden_Pound has timed out
Sweden_Pound: folds 
waisanen: raises $2 to $3
matiko09: folds 
Stibitzkie: raises $2 to $5
sebaaastian: folds 
KarlMoik1: folds 
djammusic: folds 
xAndorx: folds 
waisanen: calls $2
*** FLOP *** [3d Ah 3h]
waisanen: checks 
Stibitzkie: checks 
*** TURN *** [3d Ah 3h] [9h]
waisanen: checks 
Stibitzkie: checks 
*** RIVER *** [3d Ah 3h 9h] [Qh]
waisanen: checks 
Stibitzkie: checks 
*** SHOW DOWN ***
waisanen: shows [Qc Ks] (two pair, Queens and Threes)
Stibitzkie: mucks hand 
waisanen collected $10.98 from pot
*** SUMMARY ***
Total pot $11.50 | Rake $0.52 
Board [3d Ah 3h 9h Qh]
Seat 1: matiko09 folded before Flop (didn't bet)
Seat 2: Stibitzkie mucked [Ts 7s]
Seat 3: sebaaastian folded before Flop (didn't bet)
Seat 4: KarlMoik1 (button) folded before Flop (didn't bet)
Seat 5: djammusic (small blind) folded before Flop
Seat 6: xAndorx (big blind) folded before Flop
Seat 7: forsmthgood folded before Flop (didn't bet)
Seat 8: Sweden_Pound folded before Flop (didn't bet)
Seat 9: waisanen showed [Qc Ks] and won ($10.98) with two pair, Queens and Threes





PokerStars Hand #149392868849:  Hold'em No Limit ($0.50/$1.00 USD) - 2016/02/25 16:59:14 CET [2016/02/25 10:59:14 ET]
Table 'Zeuxo II' 9-max Seat #9 is the button
Seat 1: forsmthgood ($106.03 in chips) 
Seat 2: Sweden_Pound ($111.03 in chips) 
Seat 3: xAndorx ($100 in chips) 
Seat 4: sebaaastian ($120.61 in chips) 
Seat 5: bauss84 ($33.66 in chips) 
Seat 6: Cogss ($110.42 in chips) 
Seat 7: djammusic ($44 in chips) 
Seat 8: matiko09 ($104.20 in chips) 
Seat 9: Sreshta222 ($209.80 in chips) 
forsmthgood: posts small blind $0.50
Sweden_Pound: posts big blind $1
*** HOLE CARDS ***
Dealt to matiko09 [Ac Jd]
xAndorx: folds 
sebaaastian: folds 
bauss84: folds 
Cogss: folds 
djammusic: folds 
matiko09: raises $1.50 to $2.50
Sreshta222: folds 
forsmthgood: folds 
Sweden_Pound: folds 
Uncalled bet ($1.50) returned to matiko09
matiko09 collected $2.50 from pot
matiko09: doesn't show hand 
*** SUMMARY ***
Total pot $2.50 | Rake $0 
Seat 1: forsmthgood (small blind) folded before Flop
Seat 2: Sweden_Pound (big blind) folded before Flop
Seat 3: xAndorx folded before Flop (didn't bet)
Seat 4: sebaaastian folded before Flop (didn't bet)
Seat 5: bauss84 folded before Flop (didn't bet)
Seat 6: Cogss folded before Flop (didn't bet)
Seat 7: djammusic folded before Flop (didn't bet)
Seat 8: matiko09 collected ($2.50)
Seat 9: Sreshta222 (button) folded before Flop (didn't bet)





PokerStars Hand #149392881258:  Hold'em No Limit ($0.50/$1.00 USD) - 2016/02/25 16:59:33 CET [2016/02/25 10:59:33 ET]
Table 'Sabine' 9-max Seat #8 is the button
Seat 1: Aalleekks ($102.50 in chips) 
Seat 2: apfush ($100 in chips) 
Seat 4: hammerwife ($101.50 in chips) 
Seat 6: Sweden_Pound ($132.61 in chips) 
Seat 7: clayshmert ($77.88 in chips) 
Seat 8: matiko09 ($106 in chips) 
Seat 9: djammusic ($63.14 in chips) 
djammusic: posts small blind $0.50
Aalleekks: posts big blind $1
Ouga Buga: sits out 
*** HOLE CARDS ***
Dealt to matiko09 [Ts Js]
apfush: folds 
hammerwife: folds 
Sweden_Pound: folds 
clayshmert: folds 
matiko09: raises $1.27 to $2.27
djammusic: folds 
Aalleekks: folds 
Uncalled bet ($1.27) returned to matiko09
matiko09 collected $2.50 from pot
matiko09: doesn't show hand 
*** SUMMARY ***
Total pot $2.50 | Rake $0 
Seat 1: Aalleekks (big blind) folded before Flop
Seat 2: apfush folded before Flop (didn't bet)
Seat 4: hammerwife folded before Flop (didn't bet)
Seat 6: Sweden_Pound folded before Flop (didn't bet)
Seat 7: clayshmert folded before Flop (didn't bet)
Seat 8: matiko09 (button) collected ($2.50)
Seat 9: djammusic (small blind) folded before Flop





PokerStars Hand #149392882168:  Hold'em No Limit ($0.25/$0.50 USD) - 2016/02/25 16:59:34 CET [2016/02/25 10:59:34 ET]
Table 'Thalpius III' 9-max Seat #3 is the button
Seat 1: BrotherLove9 ($59.57 in chips) 
Seat 2: matiko09 ($64.31 in chips) 
Seat 3: jamba83 ($54.58 in chips) 
Seat 4: Wwwasian ($70.76 in chips) 
Seat 5: Al3xAnd3r22 ($50 in chips) 
Seat 6: ihami ($51.25 in chips) 
Seat 7: v4n0v ($51.50 in chips) 
Seat 8: jeroemie123 ($50 in chips) 
Seat 9: Domotirko228 ($50.96 in chips) 
Wwwasian: posts small blind $0.25
Al3xAnd3r22: posts big blind $0.50
*** HOLE CARDS ***
Dealt to matiko09 [4s 6c]
ihami: folds 
v4n0v: folds 
jeroemie123: folds 
ihami leaves the table
Domotirko228: folds 
BrotherLove9: folds 
matiko09: folds 
jamba83: folds 
Wwwasian: folds 
Uncalled bet ($0.25) returned to Al3xAnd3r22
Al3xAnd3r22 collected $0.50 from pot
Al3xAnd3r22: doesn't show hand 
*** SUMMARY ***
Total pot $0.50 | Rake $0 
Seat 1: BrotherLove9 folded before Flop (didn't bet)
Seat 2: matiko09 folded before Flop (didn't bet)
Seat 3: jamba83 (button) folded before Flop (didn't bet)
Seat 4: Wwwasian (small blind) folded before Flop
Seat 5: Al3xAnd3r22 (big blind) collected ($0.50)
Seat 6: ihami folded before Flop (didn't bet)
Seat 7: v4n0v folded before Flop (didn't bet)
Seat 8: jeroemie123 folded before Flop (didn't bet)
Seat 9: Domotirko228 folded before Flop (didn't bet)





PokerStars Hand #149392885372:  Hold'em No Limit ($0.25/$0.50 USD) - 2016/02/25 16:59:39 CET [2016/02/25 10:59:39 ET]
Table 'Ophiuchus III' 9-max Seat #1 is the button
Seat 1: RvPersie ($103.45 in chips) 
Seat 2: ihami ($47.25 in chips) 
Seat 4: lucima10 ($99 in chips) 
Seat 5: ReneProost ($35.68 in chips) 
Seat 6: Al3xAnd3r22 ($50.75 in chips) 
Seat 8: matiko09 ($50 in chips) 
Seat 9: tugboat2008 ($77.77 in chips) 
ihami: posts small blind $0.25
lucima10: posts big blind $0.50
jamba83: sits out 
*** HOLE CARDS ***
Dealt to matiko09 [Ks 7d]
ReneProost: calls $0.50
Al3xAnd3r22: folds 
matiko09: folds 
tugboat2008: folds 
RvPersie: folds 
guessvip joins the table at seat #3 
ihami: folds 
lucima10: checks 
*** FLOP *** [8d Ac Kh]
lucima10: checks 
ReneProost: checks 
*** TURN *** [8d Ac Kh] [Td]
lucima10: checks 
ReneProost: bets $0.50
lucima10: calls $0.50
*** RIVER *** [8d Ac Kh Td] [Qs]
lucima10: checks 
ReneProost: bets $1.07
lucima10: folds 
Uncalled bet ($1.07) returned to ReneProost
ReneProost collected $2.15 from pot
*** SUMMARY ***
Total pot $2.25 | Rake $0.10 
Board [8d Ac Kh Td Qs]
Seat 1: RvPersie (button) folded before Flop (didn't bet)
Seat 2: ihami (small blind) folded before Flop
Seat 4: lucima10 (big blind) folded on the River
Seat 5: ReneProost collected ($2.15)
Seat 6: Al3xAnd3r22 folded before Flop (didn't bet)
Seat 8: matiko09 folded before Flop (didn't bet)
Seat 9: tugboat2008 folded before Flop (didn't bet)





PokerStars Hand #149392885214:  Hold'em No Limit ($0.50/$1.00 USD) - 2016/02/25 16:59:39 CET [2016/02/25 10:59:39 ET]
Table 'Hercules IV' 9-max Seat #1 is the button
Seat 1: matiko09 ($100 in chips) 
Seat 2: hammerwife ($108.52 in chips) 
Seat 4: Sweden_Pound ($100 in chips) 
Seat 5: xAndorx ($155.46 in chips) 
Seat 6: kuanhung0903 ($58.38 in chips) 
Seat 7: Ouga Buga ($100 in chips) 
Seat 8: brokat77 ($118.93 in chips) 
Seat 9: djammusic ($36.68 in chips) 
hammerwife: posts small blind $0.50
sebaaastian: is sitting out 
sebaaastian leaves the table
Sweden_Pound: posts big blind $1
*** HOLE CARDS ***
Dealt to matiko09 [6h Qs]
HomerrrJay joins the table at seat #3 
xAndorx: folds 
kuanhung0903: folds 
Ouga Buga: folds 
brokat77: folds 
djammusic: folds 
matiko09: folds 
hammerwife: folds 
Uncalled bet ($0.50) returned to Sweden_Pound
Sweden_Pound collected $1 from pot
Sweden_Pound: doesn't show hand 
*** SUMMARY ***
Total pot $1 | Rake $0 
Seat 1: matiko09 (button) folded before Flop (didn't bet)
Seat 2: hammerwife (small blind) folded before Flop
Seat 4: Sweden_Pound (big blind) collected ($1)
Seat 5: xAndorx folded before Flop (didn't bet)
Seat 6: kuanhung0903 folded before Flop (didn't bet)
Seat 7: Ouga Buga folded before Flop (didn't bet)
Seat 8: brokat77 folded before Flop (didn't bet)
Seat 9: djammusic folded before Flop (didn't bet)





PokerStars Hand #149392888342:  Hold'em No Limit ($0.25/$0.50 USD) - 2016/02/25 16:59:44 CET [2016/02/25 10:59:44 ET]
Table 'Lohja II' 9-max Seat #4 is the button
Seat 1: MoonJimmy ($142.88 in chips) 
Seat 2: Apparat888 ($48.65 in chips) 
Seat 4: payback11 ($51.53 in chips) 
Seat 6: xAndorx ($49.40 in chips) 
Seat 7: matiko09 ($152.76 in chips) 
Seat 8: jamba83 ($70.37 in chips) 
Seat 9: Al3xAnd3r22 ($99.25 in chips) 
xAndorx: posts small blind $0.25
matiko09: posts big blind $0.50
MoonJimmy: posts the ante $0.10
Apparat888: posts the ante $0.10
payback11: posts the ante $0.10
xAndorx: posts the ante $0.10
matiko09: posts the ante $0.10
jamba83: posts the ante $0.10
Al3xAnd3r22: posts the ante $0.10
*** HOLE CARDS ***
Dealt to matiko09 [Tc 2c]
jamba83: folds 
Al3xAnd3r22: folds 
MoonJimmy: folds 
Apparat888: folds 
payback11: folds 
xAndorx: folds 
Uncalled bet ($0.25) returned to matiko09
matiko09 collected $1.20 from pot
matiko09: doesn't show hand 
*** SUMMARY ***
Total pot $1.20 | Rake $0 
Seat 1: MoonJimmy folded before Flop (didn't bet)
Seat 2: Apparat888 folded before Flop (didn't bet)
Seat 4: payback11 (button) folded before Flop (didn't bet)
Seat 6: xAndorx (small blind) folded before Flop
Seat 7: matiko09 (big blind) collected ($1.20)
Seat 8: jamba83 folded before Flop (didn't bet)
Seat 9: Al3xAnd3r22 folded before Flop (didn't bet)





PokerStars Hand #149392890750:  Hold'em No Limit ($0.50/$1.00 USD) - 2016/02/25 16:59:47 CET [2016/02/25 10:59:47 ET]
Table 'Simona' 9-max Seat #9 is the button
Seat 1: mycka86 ($135.93 in chips) 
Seat 2: oscarleon ($100 in chips) 
Seat 3: Sweden_Pound ($114.59 in chips) 
Seat 4: matiko09 ($261.65 in chips) 
Seat 5: sebaaastian ($121.67 in chips) 
Seat 7: hammerwife ($117.54 in chips) 
Seat 8: Ouga Buga ($100 in chips) 
Seat 9: simoniustin ($100 in chips) 
mycka86: posts small blind $0.50
oscarleon: posts big blind $1
Effort92: sits out 
*** HOLE CARDS ***
Dealt to matiko09 [Kh Qh]
Sweden_Pound: folds 
matiko09: raises $2 to $3
sebaaastian: folds 
hammerwife: folds 
Ouga Buga: folds 
simoniustin: folds 
mycka86: folds 
oscarleon: folds 
Uncalled bet ($2) returned to matiko09
matiko09 collected $2.50 from pot
matiko09: doesn't show hand 
*** SUMMARY ***
Total pot $2.50 | Rake $0 
Seat 1: mycka86 (small blind) folded before Flop
Seat 2: oscarleon (big blind) folded before Flop
Seat 3: Sweden_Pound folded before Flop (didn't bet)
Seat 4: matiko09 collected ($2.50)
Seat 5: sebaaastian folded before Flop (didn't bet)
Seat 7: hammerwife folded before Flop (didn't bet)
Seat 8: Ouga Buga folded before Flop (didn't bet)
Seat 9: simoniustin (button) folded before Flop (didn't bet)





PokerStars Hand #149392892098:  Hold'em No Limit ($0.50/$1.00 USD) - 2016/02/25 16:59:50 CET [2016/02/25 10:59:50 ET]
Table 'Zeuxo II' 9-max Seat #1 is the button
Seat 1: forsmthgood ($105.53 in chips) 
Seat 2: Sweden_Pound ($110.03 in chips) 
Seat 3: xAndorx ($100 in chips) 
Seat 4: sebaaastian ($120.61 in chips) 
Seat 5: bauss84 ($33.66 in chips) 
Seat 6: Cogss ($110.42 in chips) 
Seat 7: djammusic ($44 in chips) 
Seat 8: matiko09 ($105.70 in chips) 
Seat 9: Sreshta222 ($209.80 in chips) 
Sweden_Pound: posts small blind $0.50
xAndorx: posts big blind $1
*** HOLE CARDS ***
Dealt to matiko09 [Js Qd]
sebaaastian: folds 
bauss84: calls $1
Cogss: raises $1 to $2
djammusic: folds 
matiko09: folds 
Sreshta222: folds 
forsmthgood: folds 
Sweden_Pound: folds 
xAndorx: folds 
bauss84: calls $1
*** FLOP *** [4c 5h Qh]
bauss84: checks 
Cogss: bets $5.25
bauss84: folds 
Uncalled bet ($5.25) returned to Cogss
Cogss collected $5.25 from pot
*** SUMMARY ***
Total pot $5.50 | Rake $0.25 
Board [4c 5h Qh]
Seat 1: forsmthgood (button) folded before Flop (didn't bet)
Seat 2: Sweden_Pound (small blind) folded before Flop
Seat 3: xAndorx (big blind) folded before Flop
Seat 4: sebaaastian folded before Flop (didn't bet)
Seat 5: bauss84 folded on the Flop
Seat 6: Cogss collected ($5.25)
Seat 7: djammusic folded before Flop (didn't bet)
Seat 8: matiko09 folded before Flop (didn't bet)
Seat 9: Sreshta222 folded before Flop (didn't bet)





PokerStars Hand #149392893479:  Hold'em No Limit ($0.50/$1.00 USD) - 2016/02/25 16:59:52 CET [2016/02/25 10:59:52 ET]
Table 'Ebella II' 9-max Seat #2 is the button
Seat 1: Ilov3NBA ($100 in chips) 
Seat 2: Sweden_Pound ($101 in chips) 
Seat 3: Lahesell ($116.76 in chips) 
Seat 4: djammusic ($40.20 in chips) 
Seat 5: matiko09 ($102.75 in chips) 
Seat 7: HomerrrJay ($100 in chips) 
Seat 8: ZMPOUTSAM140 ($71.21 in chips) 
Seat 9: simoniustin ($105.30 in chips) 
Lahesell: posts small blind $0.50
djammusic: posts big blind $1
*** HOLE CARDS ***
Dealt to matiko09 [2s 4s]
matiko09: folds 
HomerrrJay: folds 
ZMPOUTSAM140: folds 
simoniustin: folds 
Ilov3NBA: raises $1.50 to $2.50
Sweden_Pound: folds 
Lahesell: folds 
djammusic: calls $1.50
*** FLOP *** [Jh 9d 9h]
djammusic: bets $3.46
Ilov3NBA: folds 
Uncalled bet ($3.46) returned to djammusic
djammusic collected $5.25 from pot
djammusic: doesn't show hand 
*** SUMMARY ***
Total pot $5.50 | Rake $0.25 
Board [Jh 9d 9h]
Seat 1: Ilov3NBA folded on the Flop
Seat 2: Sweden_Pound (button) folded before Flop (didn't bet)
Seat 3: Lahesell (small blind) folded before Flop
Seat 4: djammusic (big blind) collected ($5.25)
Seat 5: matiko09 folded before Flop (didn't bet)
Seat 7: HomerrrJay folded before Flop (didn't bet)
Seat 8: ZMPOUTSAM140 folded before Flop (didn't bet)
Seat 9: simoniustin folded before Flop (didn't bet)





PokerStars Hand #149392895506:  Hold'em No Limit ($0.50/$1.00 USD) - 2016/02/25 16:59:55 CET [2016/02/25 10:59:55 ET]
Table 'Sabine' 9-max Seat #9 is the button
Seat 1: Aalleekks ($101.50 in chips) 
Seat 2: apfush ($100 in chips) 
Seat 4: hammerwife ($101.50 in chips) 
Seat 6: Sweden_Pound ($132.61 in chips) 
Seat 7: clayshmert ($77.88 in chips) 
Seat 8: matiko09 ($107.50 in chips) 
Seat 9: djammusic ($62.64 in chips) 
Aalleekks: posts small blind $0.50
apfush: posts big blind $1
Ouga Buga: sits out 
*** HOLE CARDS ***
Dealt to matiko09 [As 2s]
hammerwife: folds 
Sweden_Pound: folds 
clayshmert: folds 
matiko09: raises $1.50 to $2.50
djammusic: folds 
Aalleekks: folds 
apfush: folds 
Uncalled bet ($1.50) returned to matiko09
matiko09 collected $2.50 from pot
matiko09: doesn't show hand 
*** SUMMARY ***
Total pot $2.50 | Rake $0 
Seat 1: Aalleekks (small blind) folded before Flop
Seat 2: apfush (big blind) folded before Flop
Seat 4: hammerwife folded before Flop (didn't bet)
Seat 6: Sweden_Pound folded before Flop (didn't bet)
Seat 7: clayshmert folded before Flop (didn't bet)
Seat 8: matiko09 collected ($2.50)
Seat 9: djammusic (button) folded before Flop (didn't bet)





PokerStars Hand #149392897091:  Hold'em No Limit ($0.50/$1.00 USD) - 2016/02/25 16:59:57 CET [2016/02/25 10:59:57 ET]
Table 'Hercules IV' 9-max Seat #2 is the button
Seat 1: matiko09 ($100 in chips) 
Seat 2: hammerwife ($108.02 in chips) 
Seat 4: Sweden_Pound ($100.50 in chips) 
Seat 5: xAndorx ($155.46 in chips) 
Seat 6: kuanhung0903 ($58.38 in chips) 
Seat 7: Ouga Buga ($100 in chips) 
Seat 8: brokat77 ($118.93 in chips) 
Seat 9: djammusic ($36.68 in chips) 
HomerrrJay will be allowed to play after the button
Sweden_Pound: posts small blind $0.50
xAndorx: posts big blind $1
*** HOLE CARDS ***
Dealt to matiko09 [9s 4h]
kuanhung0903: folds 
Ouga Buga: folds 
brokat77: folds 
djammusic: folds 
matiko09: folds 
hammerwife: folds 
Sweden_Pound: raises $2 to $3
xAndorx: calls $2
*** FLOP *** [Qs 4s 6d]
Sweden_Pound: bets $3.72
xAndorx: calls $3.72
*** TURN *** [Qs 4s 6d] [8d]
Sweden_Pound: checks 
xAndorx: bets $8.50
Sweden_Pound: folds 
Uncalled bet ($8.50) returned to xAndorx
xAndorx collected $12.84 from pot
xAndorx: doesn't show hand 
*** SUMMARY ***
Total pot $13.44 | Rake $0.60 
Board [Qs 4s 6d 8d]
Seat 1: matiko09 folded before Flop (didn't bet)
Seat 2: hammerwife (button) folded before Flop (didn't bet)
Seat 4: Sweden_Pound (small blind) folded on the Turn
Seat 5: xAndorx (big blind) collected ($12.84)
Seat 6: kuanhung0903 folded before Flop (didn't bet)
Seat 7: Ouga Buga folded before Flop (didn't bet)
Seat 8: brokat77 folded before Flop (didn't bet)
Seat 9: djammusic folded before Flop (didn't bet)





PokerStars Hand #149392897860:  Hold'em No Limit ($0.50/$1.00 USD) - 2016/02/25 16:59:58 CET [2016/02/25 10:59:58 ET]
Table 'Isa' 9-max Seat #5 is the button
Seat 1: matiko09 ($120.44 in chips) 
Seat 2: Monsthand ($108.89 in chips) 
Seat 3: sebaaastian ($129.88 in chips) 
Seat 4: hammerwife ($100.81 in chips) 
Seat 5: Sweden_Pound ($186.38 in chips) 
Seat 6: xAndorx ($100 in chips) 
Seat 7: bilukm ($160.68 in chips) 
Seat 8: Venomous100% ($100 in chips) 
Seat 9: TideHan ($101.50 in chips) 
xAndorx: posts small blind $0.50
bilukm: posts big blind $1
*** HOLE CARDS ***
Dealt to matiko09 [Ah Ts]
Venomous100%: raises $2 to $3
TideHan: folds 
matiko09: folds 
Monsthand: folds 
sebaaastian: folds 
hammerwife: folds 
Sweden_Pound: folds 
xAndorx: calls $2.50
bilukm: folds 
*** FLOP *** [6s Kc Ad]
xAndorx: checks 
Venomous100%: bets $4.41
xAndorx: folds 
Uncalled bet ($4.41) returned to Venomous100%
Venomous100% collected $6.68 from pot
Venomous100%: doesn't show hand 
*** SUMMARY ***
Total pot $7 | Rake $0.32 
Board [6s Kc Ad]
Seat 1: matiko09 folded before Flop (didn't bet)
Seat 2: Monsthand folded before Flop (didn't bet)
Seat 3: sebaaastian folded before Flop (didn't bet)
Seat 4: hammerwife folded before Flop (didn't bet)
Seat 5: Sweden_Pound (button) folded before Flop (didn't bet)
Seat 6: xAndorx (small blind) folded on the Flop
Seat 7: bilukm (big blind) folded before Flop
Seat 8: Venomous100% collected ($6.68)
Seat 9: TideHan folded before Flop (didn't bet)





PokerStars Hand #149392900416:  Hold'em No Limit ($0.25/$0.50 USD) - 2016/02/25 17:00:02 CET [2016/02/25 11:00:02 ET]
Table 'Thalpius III' 9-max Seat #4 is the button
Seat 1: BrotherLove9 ($59.57 in chips) 
Seat 2: matiko09 ($64.31 in chips) 
Seat 3: jamba83 ($54.58 in chips) 
Seat 4: Wwwasian ($70.51 in chips) 
Seat 5: Al3xAnd3r22 ($50.25 in chips) 
Seat 7: v4n0v ($51.50 in chips) 
Seat 8: jeroemie123 ($50 in chips) 
Seat 9: Domotirko228 ($50.96 in chips) 
Al3xAnd3r22: posts small blind $0.25
v4n0v: posts big blind $0.50
*** HOLE CARDS ***
Dealt to matiko09 [2c 6s]
jeroemie123: folds 
Domotirko228: folds 
BrotherLove9: folds 
matiko09: folds 
jamba83: raises $0.50 to $1
111STAVR111 joins the table at seat #6 
Wwwasian: folds 
Al3xAnd3r22: folds 
v4n0v: calls $0.50
*** FLOP *** [7d 6h 9h]
v4n0v: checks 
jamba83: checks 
*** TURN *** [7d 6h 9h] [6c]
v4n0v: bets $2
jamba83: folds 
Uncalled bet ($2) returned to v4n0v
v4n0v collected $2.15 from pot
v4n0v: doesn't show hand 
*** SUMMARY ***
Total pot $2.25 | Rake $0.10 
Board [7d 6h 9h 6c]
Seat 1: BrotherLove9 folded before Flop (didn't bet)
Seat 2: matiko09 folded before Flop (didn't bet)
Seat 3: jamba83 folded on the Turn
Seat 4: Wwwasian (button) folded before Flop (didn't bet)
Seat 5: Al3xAnd3r22 (small blind) folded before Flop
Seat 7: v4n0v (big blind) collected ($2.15)
Seat 8: jeroemie123 folded before Flop (didn't bet)
Seat 9: Domotirko228 folded before Flop (didn't bet)





PokerStars Hand #149392901363:  Hold'em No Limit ($0.50/$1.00 USD) - 2016/02/25 17:00:03 CET [2016/02/25 11:00:03 ET]
Table 'Guisan' 9-max Seat #5 is the button
Seat 1: stockbridge8 ($72.60 in chips) 
Seat 2: mycka86 ($100 in chips) 
Seat 3: xAndorx ($133.21 in chips) 
Seat 4: matiko09 ($245.05 in chips) 
Seat 5: Apparat888 ($49.50 in chips) 
Seat 6: 19R&J91 ($268.07 in chips) 
Seat 7: sebaaastian ($128.89 in chips) 
Seat 8: Monsthand ($121.67 in chips) 
Seat 9: Sweden_Pound ($162.89 in chips) 
19R&J91: posts small blind $0.50
sebaaastian: posts big blind $1
*** HOLE CARDS ***
Dealt to matiko09 [8d Ad]
Monsthand: folds 
Sweden_Pound: raises $2 to $3
stockbridge8: raises $6 to $9
mycka86: folds 
xAndorx: folds 
matiko09: folds 
Apparat888: folds 
19R&J91: calls $8.50
sebaaastian: folds 
Monsthand leaves the table
hammerwife joins the table at seat #8 
Sweden_Pound: calls $6
*** FLOP *** [6h 7h Jc]
19R&J91: checks 
Sweden_Pound: checks 
stockbridge8: bets $13.37
19R&J91: folds 
Sweden_Pound: raises $31.63 to $45
stockbridge8: raises $18.60 to $63.60 and is all-in
Sweden_Pound: calls $18.60
*** TURN *** [6h 7h Jc] [Qc]
*** RIVER *** [6h 7h Jc Qc] [8h]
*** SHOW DOWN ***
Sweden_Pound: shows [8c 9c] (a pair of Eights)
stockbridge8: shows [Ts Th] (a pair of Tens)
stockbridge8 collected $152.40 from pot
*** SUMMARY ***
Total pot $155.20 | Rake $2.80 
Board [6h 7h Jc Qc 8h]
Seat 1: stockbridge8 showed [Ts Th] and won ($152.40) with a pair of Tens
Seat 2: mycka86 folded before Flop (didn't bet)
Seat 3: xAndorx folded before Flop (didn't bet)
Seat 4: matiko09 folded before Flop (didn't bet)
Seat 5: Apparat888 (button) folded before Flop (didn't bet)
Seat 6: 19R&J91 (small blind) folded on the Flop
Seat 7: sebaaastian (big blind) folded before Flop
Seat 8: Monsthand folded before Flop (didn't bet)
Seat 9: Sweden_Pound showed [8c 9c] and lost with a pair of Eights





PokerStars Hand #149392911317:  Hold'em No Limit ($0.50/$1.00 USD) - 2016/02/25 17:00:18 CET [2016/02/25 11:00:18 ET]
Table 'Simona' 9-max Seat #1 is the button
Seat 1: mycka86 ($135.43 in chips) 
Seat 2: oscarleon ($100 in chips) 
Seat 3: Sweden_Pound ($114.59 in chips) 
Seat 4: matiko09 ($263.15 in chips) 
Seat 5: sebaaastian ($121.67 in chips) 
Seat 7: hammerwife ($117.54 in chips) 
Seat 8: Ouga Buga ($100 in chips) 
Seat 9: simoniustin ($100 in chips) 
oscarleon: posts small blind $0.50
Sweden_Pound: posts big blind $1
Effort92: sits out 
*** HOLE CARDS ***
Dealt to matiko09 [3d Jd]
matiko09: folds 
sebaaastian: raises $2 to $3
hammerwife: folds 
Ouga Buga: folds 
simoniustin: folds 
mycka86: raises $6.50 to $9.50
oscarleon: raises $14.50 to $24
Sweden_Pound: folds 
sebaaastian: folds 
mycka86: folds 
Uncalled bet ($14.50) returned to oscarleon
oscarleon collected $23 from pot
oscarleon: doesn't show hand 
*** SUMMARY ***
Total pot $23 | Rake $0 
Seat 1: mycka86 (button) folded before Flop
Seat 2: oscarleon (small blind) collected ($23)
Seat 3: Sweden_Pound (big blind) folded before Flop
Seat 4: matiko09 folded before Flop (didn't bet)
Seat 5: sebaaastian folded before Flop
Seat 7: hammerwife folded before Flop (didn't bet)
Seat 8: Ouga Buga folded before Flop (didn't bet)
Seat 9: simoniustin folded before Flop (didn't bet)





PokerStars Hand #149392912214:  Hold'em No Limit ($0.25/$0.50 USD) - 2016/02/25 17:00:20 CET [2016/02/25 11:00:20 ET]
Table 'Lohja II' 9-max Seat #6 is the button
Seat 1: MoonJimmy ($142.78 in chips) 
Seat 2: Apparat888 ($48.55 in chips) 
Seat 4: payback11 ($51.43 in chips) 
Seat 6: xAndorx ($49.05 in chips) 
Seat 7: matiko09 ($153.61 in chips) 
Seat 8: jamba83 ($70.27 in chips) 
Seat 9: Al3xAnd3r22 ($99.15 in chips) 
matiko09: posts small blind $0.25
jamba83: posts big blind $0.50
MoonJimmy: posts the ante $0.10
Apparat888: posts the ante $0.10
payback11: posts the ante $0.10
xAndorx: posts the ante $0.10
matiko09: posts the ante $0.10
jamba83: posts the ante $0.10
Al3xAnd3r22: posts the ante $0.10
*** HOLE CARDS ***
Dealt to matiko09 [2d Jc]
Al3xAnd3r22: folds 
MoonJimmy: folds 
Apparat888: folds 
payback11: folds 
xAndorx: raises $0.75 to $1.25
matiko09: folds 
jamba83: folds 
Uncalled bet ($0.75) returned to xAndorx
xAndorx collected $1.95 from pot
xAndorx: doesn't show hand 
*** SUMMARY ***
Total pot $1.95 | Rake $0 
Seat 1: MoonJimmy folded before Flop (didn't bet)
Seat 2: Apparat888 folded before Flop (didn't bet)
Seat 4: payback11 folded before Flop (didn't bet)
Seat 6: xAndorx (button) collected ($1.95)
Seat 7: matiko09 (small blind) folded before Flop
Seat 8: jamba83 (big blind) folded before Flop
Seat 9: Al3xAnd3r22 folded before Flop (didn't bet)





PokerStars Hand #149392919647:  Hold'em No Limit ($0.50/$1.00 USD) - 2016/02/25 17:00:30 CET [2016/02/25 11:00:30 ET]
Table 'Badenia II' 9-max Seat #5 is the button
Seat 1: matiko09 ($100 in chips) 
Seat 2: Stibitzkie ($95.31 in chips) 
Seat 3: sebaaastian ($122.18 in chips) 
Seat 4: KarlMoik1 ($337.94 in chips) 
Seat 5: djammusic ($120.59 in chips) 
Seat 6: xAndorx ($100.71 in chips) 
Seat 7: forsmthgood ($100 in chips) 
Seat 8: Sweden_Pound ($130.65 in chips) 
Seat 9: waisanen ($254.47 in chips) 
xAndorx: posts small blind $0.50
forsmthgood: posts big blind $1
*** HOLE CARDS ***
Dealt to matiko09 [Qd 2h]
Sweden_Pound: folds 
waisanen: folds 
matiko09: folds 
Stibitzkie: calls $1
sebaaastian: folds 
KarlMoik1: calls $1
djammusic: folds 
xAndorx: calls $0.50
forsmthgood: checks 
*** FLOP *** [4s 4c Js]
xAndorx: bets $2
forsmthgood: folds 
Stibitzkie: folds 
KarlMoik1: folds 
Uncalled bet ($2) returned to xAndorx
xAndorx collected $3.82 from pot
xAndorx: doesn't show hand 
*** SUMMARY ***
Total pot $4 | Rake $0.18 
Board [4s 4c Js]
Seat 1: matiko09 folded before Flop (didn't bet)
Seat 2: Stibitzkie folded on the Flop
Seat 3: sebaaastian folded before Flop (didn't bet)
Seat 4: KarlMoik1 folded on the Flop
Seat 5: djammusic (button) folded before Flop (didn't bet)
Seat 6: xAndorx (small blind) collected ($3.82)
Seat 7: forsmthgood (big blind) folded on the Flop
Seat 8: Sweden_Pound folded before Flop (didn't bet)
Seat 9: waisanen folded before Flop (didn't bet)





PokerStars Hand #149392923244:  Hold'em No Limit ($0.50/$1.00 USD) - 2016/02/25 17:00:35 CET [2016/02/25 11:00:35 ET]
Table 'Sabine' 9-max Seat #1 is the button
Seat 1: Aalleekks ($101 in chips) 
Seat 2: apfush ($100 in chips) 
Seat 3: Ouga Buga ($100 in chips) 
Seat 4: hammerwife ($101.50 in chips) 
Seat 6: Sweden_Pound ($132.61 in chips) 
Seat 7: clayshmert ($77.88 in chips) 
Seat 8: matiko09 ($109 in chips) 
Seat 9: djammusic ($62.64 in chips) 
apfush: posts small blind $0.50
Ouga Buga: posts big blind $1
*** HOLE CARDS ***
Dealt to matiko09 [7d 2d]
hammerwife: raises $2 to $3
Sweden_Pound: folds 
clayshmert: folds 
matiko09: folds 
djammusic: folds 
Aalleekks: folds 
apfush: folds 
Ouga Buga: folds 
Uncalled bet ($2) returned to hammerwife
hammerwife collected $2.50 from pot
hammerwife: doesn't show hand 
*** SUMMARY ***
Total pot $2.50 | Rake $0 
Seat 1: Aalleekks (button) folded before Flop (didn't bet)
Seat 2: apfush (small blind) folded before Flop
Seat 3: Ouga Buga (big blind) folded before Flop
Seat 4: hammerwife collected ($2.50)
Seat 6: Sweden_Pound folded before Flop (didn't bet)
Seat 7: clayshmert folded before Flop (didn't bet)
Seat 8: matiko09 folded before Flop (didn't bet)
Seat 9: djammusic folded before Flop (didn't bet)





PokerStars Hand #149392926065:  Hold'em No Limit ($0.50/$1.00 USD) - 2016/02/25 17:00:40 CET [2016/02/25 11:00:40 ET]
Table 'Ebella II' 9-max Seat #3 is the button
Seat 1: Ilov3NBA ($100 in chips) 
Seat 2: Sweden_Pound ($101 in chips) 
Seat 3: Lahesell ($116.26 in chips) 
Seat 4: djammusic ($42.95 in chips) 
Seat 5: matiko09 ($102.75 in chips) 
Seat 7: HomerrrJay ($100 in chips) 
Seat 8: ZMPOUTSAM140 ($71.21 in chips) 
Seat 9: simoniustin ($105.30 in chips) 
djammusic: posts small blind $0.50
matiko09: posts big blind $1
*** HOLE CARDS ***
Dealt to matiko09 [Kd 6h]
HomerrrJay: folds 
ZMPOUTSAM140: folds 
simoniustin: raises $2 to $3
Ilov3NBA: folds 
Sweden_Pound: folds 
Lahesell: calls $3
djammusic: folds 
matiko09: folds 
*** FLOP *** [8d Jc 6d]
simoniustin: bets $4
Lahesell: calls $4
*** TURN *** [8d Jc 6d] [4h]
simoniustin: bets $8
Lahesell: calls $8
*** RIVER *** [8d Jc 6d 4h] [8s]
simoniustin: checks 
Lahesell: bets $14.73
simoniustin: folds 
Uncalled bet ($14.73) returned to Lahesell
Lahesell collected $30.08 from pot
Lahesell: doesn't show hand 
*** SUMMARY ***
Total pot $31.50 | Rake $1.42 
Board [8d Jc 6d 4h 8s]
Seat 1: Ilov3NBA folded before Flop (didn't bet)
Seat 2: Sweden_Pound folded before Flop (didn't bet)
Seat 3: Lahesell (button) collected ($30.08)
Seat 4: djammusic (small blind) folded before Flop
Seat 5: matiko09 (big blind) folded before Flop
Seat 7: HomerrrJay folded before Flop (didn't bet)
Seat 8: ZMPOUTSAM140 folded before Flop (didn't bet)
Seat 9: simoniustin folded on the River





PokerStars Hand #149392929708:  Hold'em No Limit ($0.50/$1.00 USD) - 2016/02/25 17:00:45 CET [2016/02/25 11:00:45 ET]
Table 'Isa' 9-max Seat #6 is the button
Seat 1: matiko09 ($120.44 in chips) 
Seat 2: Monsthand ($108.89 in chips) 
Seat 3: sebaaastian ($129.88 in chips) 
Seat 4: hammerwife ($100.81 in chips) 
Seat 5: Sweden_Pound ($186.38 in chips) 
Seat 6: xAndorx ($100 in chips) 
Seat 7: bilukm ($159.68 in chips) 
Seat 8: Venomous100% ($103.68 in chips) 
Seat 9: TideHan ($101.50 in chips) 
bilukm: posts small blind $0.50
Venomous100%: posts big blind $1
*** HOLE CARDS ***
Dealt to matiko09 [2c Jh]
TideHan: folds 
matiko09: folds 
Monsthand: folds 
sebaaastian: raises $2 to $3
hammerwife: folds 
Monsthand leaves the table
Sweden_Pound: folds 
xAndorx: folds 
bilukm: folds 
Venomous100%: calls $2
*** FLOP *** [Qs 8h 9d]
Venomous100%: checks 
sebaaastian: bets $4.09
Venomous100%: calls $4.09
*** TURN *** [Qs 8h 9d] [2d]
Venomous100%: checks 
sebaaastian: bets $11
Venomous100%: folds 
Uncalled bet ($11) returned to sebaaastian
Ilov3NBA joins the table at seat #2 
sebaaastian collected $14.02 from pot
sebaaastian: doesn't show hand 
*** SUMMARY ***
Total pot $14.68 | Rake $0.66 
Board [Qs 8h 9d 2d]
Seat 1: matiko09 folded before Flop (didn't bet)
Seat 2: Monsthand folded before Flop (didn't bet)
Seat 3: sebaaastian collected ($14.02)
Seat 4: hammerwife folded before Flop (didn't bet)
Seat 5: Sweden_Pound folded before Flop (didn't bet)
Seat 6: xAndorx (button) folded before Flop (didn't bet)
Seat 7: bilukm (small blind) folded before Flop
Seat 8: Venomous100% (big blind) folded on the Turn
Seat 9: TideHan folded before Flop (didn't bet)





PokerStars Hand #149392930879:  Hold'em No Limit ($0.25/$0.50 USD) - 2016/02/25 17:00:47 CET [2016/02/25 11:00:47 ET]
Table 'Lohja II' 9-max Seat #7 is the button
Seat 1: MoonJimmy ($142.68 in chips) 
Seat 2: Apparat888 ($48.45 in chips) 
Seat 4: payback11 ($51.33 in chips) 
Seat 6: xAndorx ($50.40 in chips) 
Seat 7: matiko09 ($153.26 in chips) 
Seat 8: jamba83 ($69.67 in chips) 
Seat 9: Al3xAnd3r22 ($99.05 in chips) 
jamba83: posts small blind $0.25
Al3xAnd3r22: posts big blind $0.50
MoonJimmy: posts the ante $0.10
Apparat888: posts the ante $0.10
payback11: posts the ante $0.10
xAndorx: posts the ante $0.10
matiko09: posts the ante $0.10
jamba83: posts the ante $0.10
Al3xAnd3r22: posts the ante $0.10
*** HOLE CARDS ***
Dealt to matiko09 [Jd 3c]
MoonJimmy: folds 
Apparat888: folds 
payback11: folds 
xAndorx: folds 
matiko09: raises $1 to $1.50
jamba83: calls $1.25
Al3xAnd3r22: calls $1
*** FLOP *** [2s 2c 4c]
jamba83: checks 
Al3xAnd3r22: checks 
matiko09: checks 
*** TURN *** [2s 2c 4c] [Ts]
jamba83: checks 
Al3xAnd3r22: checks 
matiko09: bets $3.23
jamba83: folds 
Al3xAnd3r22: folds 
Uncalled bet ($3.23) returned to matiko09
matiko09 collected $4.97 from pot
matiko09: doesn't show hand 
*** SUMMARY ***
Total pot $5.20 | Rake $0.23 
Board [2s 2c 4c Ts]
Seat 1: MoonJimmy folded before Flop (didn't bet)
Seat 2: Apparat888 folded before Flop (didn't bet)
Seat 4: payback11 folded before Flop (didn't bet)
Seat 6: xAndorx folded before Flop (didn't bet)
Seat 7: matiko09 (button) collected ($4.97)
Seat 8: jamba83 (small blind) folded on the Turn
Seat 9: Al3xAnd3r22 (big blind) folded on the Turn





PokerStars Hand #149392934141:  Hold'em No Limit ($0.25/$0.50 USD) - 2016/02/25 17:00:51 CET [2016/02/25 11:00:51 ET]
Table 'Ophiuchus III' 9-max Seat #2 is the button
Seat 1: RvPersie ($103.45 in chips) 
Seat 2: ihami ($47 in chips) 
Seat 4: lucima10 ($98 in chips) 
Seat 5: ReneProost ($36.83 in chips) 
Seat 6: Al3xAnd3r22 ($50.75 in chips) 
Seat 8: matiko09 ($50 in chips) 
Seat 9: tugboat2008 ($77.77 in chips) 
guessvip will be allowed to play after the button
lucima10: posts small blind $0.25
ReneProost: posts big blind $0.50
jamba83: sits out 
*** HOLE CARDS ***
Dealt to matiko09 [9s 8c]
Al3xAnd3r22: raises $1 to $1.50
matiko09: folds 
tugboat2008: folds 
RvPersie: folds 
ihami: calls $1.50
lucima10: folds 
ReneProost: folds 
*** FLOP *** [3h Jc 6c]
Al3xAnd3r22: bets $2
ihami: calls $2
*** TURN *** [3h Jc 6c] [4s]
Al3xAnd3r22: checks 
ihami: bets $4
Al3xAnd3r22: folds 
Uncalled bet ($4) returned to ihami
ihami collected $7.40 from pot
*** SUMMARY ***
Total pot $7.75 | Rake $0.35 
Board [3h Jc 6c 4s]
Seat 1: RvPersie folded before Flop (didn't bet)
Seat 2: ihami (button) collected ($7.40)
Seat 4: lucima10 (small blind) folded before Flop
Seat 5: ReneProost (big blind) folded before Flop
Seat 6: Al3xAnd3r22 folded on the Turn
Seat 8: matiko09 folded before Flop (didn't bet)
Seat 9: tugboat2008 folded before Flop (didn't bet)





PokerStars Hand #149392934429:  Hold'em No Limit ($0.25/$0.50 USD) - 2016/02/25 17:00:52 CET [2016/02/25 11:00:52 ET]
Table 'Thalpius III' 9-max Seat #5 is the button
Seat 1: BrotherLove9 ($59.57 in chips) 
Seat 2: matiko09 ($64.31 in chips) 
Seat 3: jamba83 ($53.58 in chips) 
Seat 4: Wwwasian ($70.51 in chips) 
Seat 5: Al3xAnd3r22 ($50 in chips) 
Seat 7: v4n0v ($52.65 in chips) 
Seat 8: jeroemie123 ($50 in chips) 
Seat 9: Domotirko228 ($50.96 in chips) 
111STAVR111 will be allowed to play after the button
v4n0v: posts small blind $0.25
jeroemie123: posts big blind $0.50
*** HOLE CARDS ***
Dealt to matiko09 [2c Qc]
Domotirko228: folds 
BrotherLove9: folds 
matiko09: folds 
jamba83: folds 
Wwwasian: folds 
Al3xAnd3r22: raises $1.12 to $1.62
v4n0v: folds 
jeroemie123: calls $1.12
*** FLOP *** [9h Ad 6s]
jeroemie123: checks 
Al3xAnd3r22: checks 
*** TURN *** [9h Ad 6s] [Ks]
jeroemie123: checks 
Al3xAnd3r22: bets $2.19
jeroemie123: folds 
Uncalled bet ($2.19) returned to Al3xAnd3r22
Al3xAnd3r22 collected $3.33 from pot
*** SUMMARY ***
Total pot $3.49 | Rake $0.16 
Board [9h Ad 6s Ks]
Seat 1: BrotherLove9 folded before Flop (didn't bet)
Seat 2: matiko09 folded before Flop (didn't bet)
Seat 3: jamba83 folded before Flop (didn't bet)
Seat 4: Wwwasian folded before Flop (didn't bet)
Seat 5: Al3xAnd3r22 (button) collected ($3.33)
Seat 7: v4n0v (small blind) folded before Flop
Seat 8: jeroemie123 (big blind) folded on the Turn
Seat 9: Domotirko228 folded before Flop (didn't bet)





PokerStars Hand #149392940036:  Hold'em No Limit ($0.50/$1.00 USD) - 2016/02/25 17:01:00 CET [2016/02/25 11:01:00 ET]
Table 'Zeuxo II' 9-max Seat #2 is the button
Seat 1: forsmthgood ($105.53 in chips) 
Seat 2: Sweden_Pound ($109.53 in chips) 
Seat 3: xAndorx ($100 in chips) 
Seat 4: sebaaastian ($120.61 in chips) 
Seat 5: bauss84 ($31.66 in chips) 
Seat 6: Cogss ($113.67 in chips) 
Seat 7: djammusic ($44 in chips) 
Seat 8: matiko09 ($105.70 in chips) 
Seat 9: Sreshta222 ($209.80 in chips) 
xAndorx: posts small blind $0.50
sebaaastian: posts big blind $1
*** HOLE CARDS ***
Dealt to matiko09 [2c Th]
bauss84: calls $1
Cogss: folds 
djammusic: folds 
matiko09: folds 
Sreshta222: folds 
forsmthgood: folds 
Sweden_Pound: folds 
xAndorx: calls $0.50
sebaaastian: checks 
*** FLOP *** [Jd Qd 3s]
xAndorx: checks 
sebaaastian: checks 
bauss84: checks 
*** TURN *** [Jd Qd 3s] [Ks]
xAndorx: checks 
sebaaastian: checks 
bauss84: bets $3
xAndorx: folds 
sebaaastian: folds 
Uncalled bet ($3) returned to bauss84
bauss84 collected $2.86 from pot
bauss84: doesn't show hand 
*** SUMMARY ***
Total pot $3 | Rake $0.14 
Board [Jd Qd 3s Ks]
Seat 1: forsmthgood folded before Flop (didn't bet)
Seat 2: Sweden_Pound (button) folded before Flop (didn't bet)
Seat 3: xAndorx (small blind) folded on the Turn
Seat 4: sebaaastian (big blind) folded on the Turn
Seat 5: bauss84 collected ($2.86)
Seat 6: Cogss folded before Flop (didn't bet)
Seat 7: djammusic folded before Flop (didn't bet)
Seat 8: matiko09 folded before Flop (didn't bet)
Seat 9: Sreshta222 folded before Flop (didn't bet)





PokerStars Hand #149392945849:  Hold'em No Limit ($0.50/$1.00 USD) - 2016/02/25 17:01:07 CET [2016/02/25 11:01:07 ET]
Table 'Sabine' 9-max Seat #2 is the button
Seat 1: Aalleekks ($101 in chips) 
Seat 2: apfush ($100 in chips) 
Seat 3: Ouga Buga ($100 in chips) 
Seat 6: Sweden_Pound ($132.61 in chips) 
Seat 7: clayshmert ($77.88 in chips) 
Seat 8: matiko09 ($109 in chips) 
Seat 9: djammusic ($62.64 in chips) 
Ouga Buga: posts small blind $0.50
hammerwife: is sitting out 
Sweden_Pound: posts big blind $1
*** HOLE CARDS ***
Dealt to matiko09 [5c Th]
clayshmert: folds 
matiko09: folds 
djammusic: folds 
Aalleekks: folds 
apfush: folds 
Ouga Buga: folds 
Uncalled bet ($0.50) returned to Sweden_Pound
Sweden_Pound collected $1 from pot
Sweden_Pound: doesn't show hand 
*** SUMMARY ***
Total pot $1 | Rake $0 
Seat 1: Aalleekks folded before Flop (didn't bet)
Seat 2: apfush (button) folded before Flop (didn't bet)
Seat 3: Ouga Buga (small blind) folded before Flop
Seat 6: Sweden_Pound (big blind) collected ($1)
Seat 7: clayshmert folded before Flop (didn't bet)
Seat 8: matiko09 folded before Flop (didn't bet)
Seat 9: djammusic folded before Flop (didn't bet)





PokerStars Hand #149392949352:  Hold'em No Limit ($0.50/$1.00 USD) - 2016/02/25 17:01:12 CET [2016/02/25 11:01:12 ET]
Table 'Hercules IV' 9-max Seat #4 is the button
Seat 1: matiko09 ($100 in chips) 
Seat 2: hammerwife ($108.02 in chips) 
Seat 4: Sweden_Pound ($100 in chips) 
Seat 5: xAndorx ($161.58 in chips) 
Seat 6: kuanhung0903 ($58.38 in chips) 
Seat 7: Ouga Buga ($100 in chips) 
Seat 8: brokat77 ($118.93 in chips) 
Seat 9: djammusic ($36.68 in chips) 
xAndorx: posts small blind $0.50
kuanhung0903: posts big blind $1
HomerrrJay: sits out 
*** HOLE CARDS ***
Dealt to matiko09 [7c Qs]
Ouga Buga: folds 
brokat77: calls $1
djammusic: folds 
matiko09: folds 
hammerwife: folds 
Sweden_Pound: folds 
xAndorx: folds 
kuanhung0903: checks 
*** FLOP *** [Ah 6h 5h]
kuanhung0903: checks 
brokat77: bets $2.39
kuanhung0903: calls $2.39
*** TURN *** [Ah 6h 5h] [Jc]
kuanhung0903: checks 
brokat77: bets $3
kuanhung0903: calls $3
*** RIVER *** [Ah 6h 5h Jc] [Kh]
kuanhung0903: checks 
brokat77: checks 
*** SHOW DOWN ***
kuanhung0903: shows [5d As] (two pair, Aces and Fives)
brokat77: shows [Js Ad] (two pair, Aces and Jacks)
brokat77 collected $12.68 from pot
*** SUMMARY ***
Total pot $13.28 | Rake $0.60 
Board [Ah 6h 5h Jc Kh]
Seat 1: matiko09 folded before Flop (didn't bet)
Seat 2: hammerwife folded before Flop (didn't bet)
Seat 4: Sweden_Pound (button) folded before Flop (didn't bet)
Seat 5: xAndorx (small blind) folded before Flop
Seat 6: kuanhung0903 (big blind) showed [5d As] and lost with two pair, Aces and Fives
Seat 7: Ouga Buga folded before Flop (didn't bet)
Seat 8: brokat77 showed [Js Ad] and won ($12.68) with two pair, Aces and Jacks
Seat 9: djammusic folded before Flop (didn't bet)





PokerStars Hand #149392966530:  Hold'em No Limit ($0.50/$1.00 USD) - 2016/02/25 17:01:35 CET [2016/02/25 11:01:35 ET]
Table 'Nerthus II' 9-max Seat #8 is the button
Seat 1: lysandrafly ($114.37 in chips) 
Seat 2: matiko09 ($179.77 in chips) 
Seat 3: A Hustler ($40.46 in chips) 
Seat 4: Ilov3NBA ($104.12 in chips) 
Seat 5: Sweden_Pound ($216.40 in chips) 
Seat 8: Kelvin sai ($80.75 in chips) 
lysandrafly: posts small blind $0.50
matiko09: posts big blind $1
mycka86: sits out 
Venomous100%: sits out 
*** HOLE CARDS ***
Dealt to matiko09 [4d Kh]
A Hustler: folds 
Ilov3NBA: folds 
Sweden_Pound: raises $1.50 to $2.50
Kelvin sai: calls $2.50
lysandrafly: folds 
matiko09: folds 
*** FLOP *** [5h 8s 9d]
Sweden_Pound: bets $4.04
Kelvin sai: folds 
Uncalled bet ($4.04) returned to Sweden_Pound
Sweden_Pound collected $6.21 from pot
Sweden_Pound: doesn't show hand 
*** SUMMARY ***
Total pot $6.50 | Rake $0.29 
Board [5h 8s 9d]
Seat 1: lysandrafly (small blind) folded before Flop
Seat 2: matiko09 (big blind) folded before Flop
Seat 3: A Hustler folded before Flop (didn't bet)
Seat 4: Ilov3NBA folded before Flop (didn't bet)
Seat 5: Sweden_Pound collected ($6.21)
Seat 8: Kelvin sai (button) folded on the Flop





PokerStars Hand #149392967931:  Hold'em No Limit ($0.50/$1.00 USD) - 2016/02/25 17:01:37 CET [2016/02/25 11:01:37 ET]
Table 'Badenia II' 9-max Seat #6 is the button
Seat 1: matiko09 ($100 in chips) 
Seat 2: Stibitzkie ($94.31 in chips) 
Seat 3: sebaaastian ($122.18 in chips) 
Seat 4: KarlMoik1 ($336.94 in chips) 
Seat 5: djammusic ($120.59 in chips) 
Seat 6: xAndorx ($103.53 in chips) 
Seat 7: forsmthgood ($100 in chips) 
Seat 8: Sweden_Pound ($130.65 in chips) 
Seat 9: waisanen ($254.47 in chips) 
forsmthgood: posts small blind $0.50
Sweden_Pound: posts big blind $1
*** HOLE CARDS ***
Dealt to matiko09 [6d 8c]
waisanen: folds 
matiko09: folds 
Stibitzkie: raises $2.50 to $3.50
sebaaastian: folds 
KarlMoik1: folds 
djammusic: folds 
xAndorx: folds 
forsmthgood: folds 
Sweden_Pound: folds 
Uncalled bet ($2.50) returned to Stibitzkie
Stibitzkie collected $2.50 from pot
*** SUMMARY ***
Total pot $2.50 | Rake $0 
Seat 1: matiko09 folded before Flop (didn't bet)
Seat 2: Stibitzkie collected ($2.50)
Seat 3: sebaaastian folded before Flop (didn't bet)
Seat 4: KarlMoik1 folded before Flop (didn't bet)
Seat 5: djammusic folded before Flop (didn't bet)
Seat 6: xAndorx (button) folded before Flop (didn't bet)
Seat 7: forsmthgood (small blind) folded before Flop
Seat 8: Sweden_Pound (big blind) folded before Flop
Seat 9: waisanen folded before Flop (didn't bet)





PokerStars Hand #149392970565:  Hold'em No Limit ($0.50/$1.00 USD) - 2016/02/25 17:01:41 CET [2016/02/25 11:01:41 ET]
Table 'Ebella II' 9-max Seat #4 is the button
Seat 1: Ilov3NBA ($100 in chips) 
Seat 2: Sweden_Pound ($101 in chips) 
Seat 3: Lahesell ($131.34 in chips) 
Seat 4: djammusic ($42.45 in chips) 
Seat 5: matiko09 ($101.75 in chips) 
Seat 7: HomerrrJay ($100 in chips) 
Seat 8: ZMPOUTSAM140 ($71.21 in chips) 
Seat 9: simoniustin ($100 in chips) 
matiko09: posts small blind $0.50
HomerrrJay: posts big blind $1
*** HOLE CARDS ***
Dealt to matiko09 [Ah 3c]
ZMPOUTSAM140: folds 
simoniustin: folds 
Ilov3NBA: folds 
Sweden_Pound: raises $2 to $3
Lahesell: folds 
djammusic: folds 
matiko09: folds 
HomerrrJay: folds 
Uncalled bet ($2) returned to Sweden_Pound
Sweden_Pound collected $2.50 from pot
Sweden_Pound: doesn't show hand 
*** SUMMARY ***
Total pot $2.50 | Rake $0 
Seat 1: Ilov3NBA folded before Flop (didn't bet)
Seat 2: Sweden_Pound collected ($2.50)
Seat 3: Lahesell folded before Flop (didn't bet)
Seat 4: djammusic (button) folded before Flop (didn't bet)
Seat 5: matiko09 (small blind) folded before Flop
Seat 7: HomerrrJay (big blind) folded before Flop
Seat 8: ZMPOUTSAM140 folded before Flop (didn't bet)
Seat 9: simoniustin folded before Flop (didn't bet)





PokerStars Hand #149392972933:  Hold'em No Limit ($0.50/$1.00 USD) - 2016/02/25 17:01:43 CET [2016/02/25 11:01:43 ET]
Table 'Sabine' 9-max Seat #3 is the button
Seat 1: Aalleekks ($101 in chips) 
Seat 2: apfush ($100 in chips) 
Seat 3: Ouga Buga ($100 in chips) 
Seat 6: Sweden_Pound ($133.11 in chips) 
Seat 7: clayshmert ($77.88 in chips) 
Seat 8: matiko09 ($109 in chips) 
Seat 9: djammusic ($62.64 in chips) 
Sweden_Pound: posts small blind $0.50
clayshmert: posts big blind $1
*** HOLE CARDS ***
Dealt to matiko09 [Ah 9c]
matiko09: folds 
djammusic: raises $1.50 to $2.50
Aalleekks: folds 
apfush: folds 
Ouga Buga: folds 
Sweden_Pound: folds 
clayshmert: calls $1.50
*** FLOP *** [Ts 8d 2d]
clayshmert: checks 
djammusic: bets $3.46
clayshmert: folds 
Uncalled bet ($3.46) returned to djammusic
djammusic collected $5.25 from pot
djammusic: doesn't show hand 
*** SUMMARY ***
Total pot $5.50 | Rake $0.25 
Board [Ts 8d 2d]
Seat 1: Aalleekks folded before Flop (didn't bet)
Seat 2: apfush folded before Flop (didn't bet)
Seat 3: Ouga Buga (button) folded before Flop (didn't bet)
Seat 6: Sweden_Pound (small blind) folded before Flop
Seat 7: clayshmert (big blind) folded on the Flop
Seat 8: matiko09 folded before Flop (didn't bet)
Seat 9: djammusic collected ($5.25)





PokerStars Hand #149392975082:  Hold'em No Limit ($0.50/$1.00 USD) - 2016/02/25 17:01:46 CET [2016/02/25 11:01:46 ET]
Table 'Guisan' 9-max Seat #6 is the button
Seat 1: stockbridge8 ($152.40 in chips) 
Seat 2: mycka86 ($100 in chips) 
Seat 3: xAndorx ($133.21 in chips) 
Seat 4: matiko09 ($245.05 in chips) 
Seat 5: Apparat888 ($49.50 in chips) 
Seat 6: 19R&J91 ($259.07 in chips) 
Seat 7: sebaaastian ($127.89 in chips) 
Seat 9: Sweden_Pound ($100 in chips) 
sebaaastian: posts small blind $0.50
Sweden_Pound: posts big blind $1
*** HOLE CARDS ***
Dealt to matiko09 [7c 6c]
stockbridge8: folds 
mycka86: raises $2 to $3
xAndorx: folds 
matiko09: calls $3
Apparat888: folds 
19R&J91: raises $4 to $7
sebaaastian: folds 
Sweden_Pound: folds 
mycka86: raises $48 to $55
matiko09: folds 
19R&J91: folds 
Uncalled bet ($48) returned to mycka86
mycka86 collected $18.50 from pot
*** SUMMARY ***
Total pot $18.50 | Rake $0 
Seat 1: stockbridge8 folded before Flop (didn't bet)
Seat 2: mycka86 collected ($18.50)
Seat 3: xAndorx folded before Flop (didn't bet)
Seat 4: matiko09 folded before Flop
Seat 5: Apparat888 folded before Flop (didn't bet)
Seat 6: 19R&J91 (button) folded before Flop
Seat 7: sebaaastian (small blind) folded before Flop
Seat 9: Sweden_Pound (big blind) folded before Flop





PokerStars Hand #149392977978:  Hold'em No Limit ($0.25/$0.50 USD) - 2016/02/25 17:01:50 CET [2016/02/25 11:01:50 ET]
Table 'Thalpius III' 9-max Seat #7 is the button
Seat 1: BrotherLove9 ($59.57 in chips) 
Seat 2: matiko09 ($64.31 in chips) 
Seat 3: jamba83 ($53.58 in chips) 
Seat 4: Wwwasian ($70.51 in chips) 
Seat 5: Al3xAnd3r22 ($51.71 in chips) 
Seat 7: v4n0v ($52.40 in chips) 
Seat 8: jeroemie123 ($49.14 in chips) 
Seat 9: Domotirko228 ($50.96 in chips) 
jeroemie123: posts small blind $0.25
Domotirko228: posts big blind $0.50
111STAVR111: sits out 
*** HOLE CARDS ***
Dealt to matiko09 [Ts 4c]
BrotherLove9: folds 
matiko09: folds 
jamba83: folds 
Wwwasian: folds 
Al3xAnd3r22: folds 
v4n0v: raises $0.50 to $1
jeroemie123: calls $0.75
Domotirko228: calls $0.50
*** FLOP *** [Jd 3c 5c]
jeroemie123: bets $2
Domotirko228: folds 
v4n0v: folds 
Uncalled bet ($2) returned to jeroemie123
jeroemie123 collected $2.86 from pot
jeroemie123: doesn't show hand 
*** SUMMARY ***
Total pot $3 | Rake $0.14 
Board [Jd 3c 5c]
Seat 1: BrotherLove9 folded before Flop (didn't bet)
Seat 2: matiko09 folded before Flop (didn't bet)
Seat 3: jamba83 folded before Flop (didn't bet)
Seat 4: Wwwasian folded before Flop (didn't bet)
Seat 5: Al3xAnd3r22 folded before Flop (didn't bet)
Seat 7: v4n0v (button) folded on the Flop
Seat 8: jeroemie123 (small blind) collected ($2.86)
Seat 9: Domotirko228 (big blind) folded on the Flop





PokerStars Hand #149392984206:  Hold'em No Limit ($0.50/$1.00 USD) - 2016/02/25 17:01:59 CET [2016/02/25 11:01:59 ET]
Table 'Isa' 9-max Seat #7 is the button
Seat 1: matiko09 ($120.44 in chips) 
Seat 3: sebaaastian ($136.81 in chips) 
Seat 4: hammerwife ($100.81 in chips) 
Seat 5: Sweden_Pound ($186.38 in chips) 
Seat 6: xAndorx ($100 in chips) 
Seat 7: bilukm ($159.18 in chips) 
Seat 8: Venomous100% ($100 in chips) 
Venomous100%: posts small blind $0.50
TideHan: is sitting out 
matiko09: posts big blind $1
Ilov3NBA: sits out 
*** HOLE CARDS ***
Dealt to matiko09 [3h 5d]
TideHan leaves the table
Ilov3NBA leaves the table
sebaaastian: folds 
hammerwife: folds 
HomerrrJay joins the table at seat #9 
Sweden_Pound: folds 
xAndorx: folds 
bilukm: folds 
Venomous100%: folds 
Uncalled bet ($0.50) returned to matiko09
matiko09 collected $1 from pot
matiko09: doesn't show hand 
*** SUMMARY ***
Total pot $1 | Rake $0 
Seat 1: matiko09 (big blind) collected ($1)
Seat 3: sebaaastian folded before Flop (didn't bet)
Seat 4: hammerwife folded before Flop (didn't bet)
Seat 5: Sweden_Pound folded before Flop (didn't bet)
Seat 6: xAndorx folded before Flop (didn't bet)
Seat 7: bilukm (button) folded before Flop (didn't bet)
Seat 8: Venomous100% (small blind) folded before Flop





PokerStars Hand #149393000041:  Hold'em No Limit ($0.50/$1.00 USD) - 2016/02/25 17:02:20 CET [2016/02/25 11:02:20 ET]
Table 'Mayall II' 9-max Seat #8 is the button
Seat 1: matiko09 ($115.11 in chips) 
Seat 2: Sweden_Pound ($137.97 in chips) 
Seat 3: doppy 123577 ($83.83 in chips) 
Seat 4: Ouga Buga ($104.36 in chips) 
Seat 5: SumPosad ($77.45 in chips) 
Seat 6: apfush ($112.78 in chips) 
Seat 7: r.pol218 ($59.81 in chips) 
Seat 8: kuanhung0903 ($72.48 in chips) 
Seat 9: xAndorx ($141.84 in chips) 
xAndorx: posts small blind $0.50
matiko09: posts big blind $1
*** HOLE CARDS ***
Dealt to matiko09 [Ks Jc]
Sweden_Pound: folds 
doppy 123577: calls $1
Ouga Buga: folds 
SumPosad: folds 
apfush: folds 
r.pol218: folds 
kuanhung0903: folds 
xAndorx: calls $0.50
matiko09: checks 
*** FLOP *** [Ac 5h 8s]
xAndorx: checks 
matiko09: checks 
doppy 123577: checks 
*** TURN *** [Ac 5h 8s] [4c]
xAndorx: checks 
matiko09: checks 
doppy 123577: bets $2
xAndorx: folds 
matiko09: folds 
Uncalled bet ($2) returned to doppy 123577
doppy 123577 collected $2.86 from pot
doppy 123577: doesn't show hand 
*** SUMMARY ***
Total pot $3 | Rake $0.14 
Board [Ac 5h 8s 4c]
Seat 1: matiko09 (big blind) folded on the Turn
Seat 2: Sweden_Pound folded before Flop (didn't bet)
Seat 3: doppy 123577 collected ($2.86)
Seat 4: Ouga Buga folded before Flop (didn't bet)
Seat 5: SumPosad folded before Flop (didn't bet)
Seat 6: apfush folded before Flop (didn't bet)
Seat 7: r.pol218 folded before Flop (didn't bet)
Seat 8: kuanhung0903 (button) folded before Flop (didn't bet)
Seat 9: xAndorx (small blind) folded on the Turn





PokerStars Hand #149393002913:  Hold'em No Limit ($0.50/$1.00 USD) - 2016/02/25 17:02:23 CET [2016/02/25 11:02:23 ET]
Table 'Isa' 9-max Seat #8 is the button
Seat 1: matiko09 ($120.94 in chips) 
Seat 3: sebaaastian ($136.81 in chips) 
Seat 4: hammerwife ($100.81 in chips) 
Seat 5: Sweden_Pound ($186.38 in chips) 
Seat 6: xAndorx ($100 in chips) 
Seat 7: bilukm ($159.18 in chips) 
Seat 8: Venomous100% ($100 in chips) 
HomerrrJay will be allowed to play after the button
matiko09: posts small blind $0.50
sebaaastian: posts big blind $1
*** HOLE CARDS ***
Dealt to matiko09 [Th Td]
mycka86 joins the table at seat #2 
hammerwife: folds 
Sweden_Pound: raises $2 to $3
xAndorx: folds 
bilukm: folds 
Venomous100%: folds 
matiko09: calls $2.50
sebaaastian: folds 
*** FLOP *** [Tc 2c Jc]
matiko09: checks 
Sweden_Pound: checks 
*** TURN *** [Tc 2c Jc] [Kh]
matiko09: bets $5
Sweden_Pound: folds 
Uncalled bet ($5) returned to matiko09
matiko09 collected $6.68 from pot
matiko09: doesn't show hand 
*** SUMMARY ***
Total pot $7 | Rake $0.32 
Board [Tc 2c Jc Kh]
Seat 1: matiko09 (small blind) collected ($6.68)
Seat 3: sebaaastian (big blind) folded before Flop
Seat 4: hammerwife folded before Flop (didn't bet)
Seat 5: Sweden_Pound folded on the Turn
Seat 6: xAndorx folded before Flop (didn't bet)
Seat 7: bilukm folded before Flop (didn't bet)
Seat 8: Venomous100% (button) folded before Flop (didn't bet)





PokerStars Hand #149393003710:  Hold'em No Limit ($0.50/$1.00 USD) - 2016/02/25 17:02:24 CET [2016/02/25 11:02:24 ET]
Table 'Badenia II' 9-max Seat #7 is the button
Seat 1: matiko09 ($100 in chips) 
Seat 2: Stibitzkie ($95.81 in chips) 
Seat 3: sebaaastian ($122.18 in chips) 
Seat 4: KarlMoik1 ($336.94 in chips) 
Seat 5: djammusic ($120.59 in chips) 
Seat 6: xAndorx ($103.53 in chips) 
Seat 7: forsmthgood ($100 in chips) 
Seat 8: Sweden_Pound ($129.65 in chips) 
Seat 9: waisanen ($254.47 in chips) 
Sweden_Pound: posts small blind $0.50
waisanen: posts big blind $1
*** HOLE CARDS ***
Dealt to matiko09 [6s 2c]
matiko09: folds 
Stibitzkie: folds 
sebaaastian: raises $2 to $3
KarlMoik1: calls $3
djammusic: folds 
xAndorx: folds 
forsmthgood: folds 
Sweden_Pound: folds 
waisanen: folds 
*** FLOP *** [5c Td Ad]
sebaaastian: bets $4
KarlMoik1: folds 
Uncalled bet ($4) returned to sebaaastian
sebaaastian collected $7.16 from pot
sebaaastian: doesn't show hand 
*** SUMMARY ***
Total pot $7.50 | Rake $0.34 
Board [5c Td Ad]
Seat 1: matiko09 folded before Flop (didn't bet)
Seat 2: Stibitzkie folded before Flop (didn't bet)
Seat 3: sebaaastian collected ($7.16)
Seat 4: KarlMoik1 folded on the Flop
Seat 5: djammusic folded before Flop (didn't bet)
Seat 6: xAndorx folded before Flop (didn't bet)
Seat 7: forsmthgood (button) folded before Flop (didn't bet)
Seat 8: Sweden_Pound (small blind) folded before Flop
Seat 9: waisanen (big blind) folded before Flop





PokerStars Hand #149393003471:  Hold'em No Limit ($0.25/$0.50 USD) - 2016/02/25 17:02:24 CET [2016/02/25 11:02:24 ET]
Table 'Lohja II' 9-max Seat #8 is the button
Seat 1: MoonJimmy ($142.58 in chips) 
Seat 2: Apparat888 ($48.35 in chips) 
Seat 4: payback11 ($51.23 in chips) 
Seat 6: xAndorx ($50.30 in chips) 
Seat 7: matiko09 ($156.63 in chips) 
Seat 8: jamba83 ($68.07 in chips) 
Seat 9: Al3xAnd3r22 ($98 in chips) 
Al3xAnd3r22: posts small blind $0.25
MoonJimmy: posts big blind $0.50
MoonJimmy: posts the ante $0.10
Apparat888: posts the ante $0.10
payback11: posts the ante $0.10
xAndorx: posts the ante $0.10
matiko09: posts the ante $0.10
jamba83: posts the ante $0.10
Al3xAnd3r22: posts the ante $0.10
*** HOLE CARDS ***
Dealt to matiko09 [9h 8h]
Apparat888: folds 
payback11: folds 
xAndorx: folds 
matiko09: raises $1 to $1.50
jamba83: folds 
Al3xAnd3r22: folds 
MoonJimmy: folds 
Uncalled bet ($1) returned to matiko09
matiko09 collected $1.95 from pot
matiko09: doesn't show hand 
*** SUMMARY ***
Total pot $1.95 | Rake $0 
Seat 1: MoonJimmy (big blind) folded before Flop
Seat 2: Apparat888 folded before Flop (didn't bet)
Seat 4: payback11 folded before Flop (didn't bet)
Seat 6: xAndorx folded before Flop (didn't bet)
Seat 7: matiko09 collected ($1.95)
Seat 8: jamba83 (button) folded before Flop (didn't bet)
Seat 9: Al3xAnd3r22 (small blind) folded before Flop





PokerStars Hand #149393004073:  Hold'em No Limit ($0.50/$1.00 USD) - 2016/02/25 17:02:25 CET [2016/02/25 11:02:25 ET]
Table 'Ebella II' 9-max Seat #5 is the button
Seat 1: Ilov3NBA ($100 in chips) 
Seat 2: Sweden_Pound ($102.50 in chips) 
Seat 3: Lahesell ($131.34 in chips) 
Seat 4: djammusic ($42.45 in chips) 
Seat 5: matiko09 ($101.25 in chips) 
Seat 7: HomerrrJay ($100 in chips) 
Seat 8: ZMPOUTSAM140 ($71.21 in chips) 
Seat 9: simoniustin ($100 in chips) 
HomerrrJay: posts small blind $0.50
ZMPOUTSAM140: posts big blind $1
*** HOLE CARDS ***
Dealt to matiko09 [Jc 3d]
simoniustin: folds 
Ilov3NBA: folds 
Sweden_Pound: folds 
Lahesell: raises $2 to $3
djammusic: folds 
matiko09: folds 
HomerrrJay: folds 
ZMPOUTSAM140: folds 
Uncalled bet ($2) returned to Lahesell
Lahesell collected $2.50 from pot
Lahesell: doesn't show hand 
*** SUMMARY ***
Total pot $2.50 | Rake $0 
Seat 1: Ilov3NBA folded before Flop (didn't bet)
Seat 2: Sweden_Pound folded before Flop (didn't bet)
Seat 3: Lahesell collected ($2.50)
Seat 4: djammusic folded before Flop (didn't bet)
Seat 5: matiko09 (button) folded before Flop (didn't bet)
Seat 7: HomerrrJay (small blind) folded before Flop
Seat 8: ZMPOUTSAM140 (big blind) folded before Flop
Seat 9: simoniustin folded before Flop (didn't bet)





PokerStars Hand #149393004762:  Hold'em No Limit ($0.50/$1.00 USD) - 2016/02/25 17:02:26 CET [2016/02/25 11:02:26 ET]
Table 'Nerthus II' 9-max Seat #1 is the button
Seat 1: lysandrafly ($113.87 in chips) 
Seat 2: matiko09 ($178.77 in chips) 
Seat 4: Ilov3NBA ($104.12 in chips) 
Seat 5: Sweden_Pound ($220.11 in chips) 
Seat 8: Kelvin sai ($78.25 in chips) 
matiko09: posts small blind $0.50
A Hustler: is sitting out 
Ilov3NBA: posts big blind $1
mycka86: sits out 
Venomous100%: sits out 
*** HOLE CARDS ***
Dealt to matiko09 [4c 4d]
Sweden_Pound: folds 
A Hustler leaves the table
simoniustin joins the table at seat #3 
Kelvin sai: raises $1 to $2
lysandrafly: folds 
matiko09: calls $1.50
Ilov3NBA: folds 
*** FLOP *** [3s 5c 7d]
matiko09: checks 
Kelvin sai: bets $2
matiko09: calls $2
*** TURN *** [3s 5c 7d] [5h]
matiko09: checks 
Kelvin sai: checks 
*** RIVER *** [3s 5c 7d 5h] [Th]
matiko09: checks 
Kelvin sai: bets $4
matiko09: calls $4
*** SHOW DOWN ***
Kelvin sai: shows [Jh 4h] (a pair of Fives)
matiko09: shows [4c 4d] (two pair, Fives and Fours)
matiko09 collected $16.24 from pot
*** SUMMARY ***
Total pot $17 | Rake $0.76 
Board [3s 5c 7d 5h Th]
Seat 1: lysandrafly (button) folded before Flop (didn't bet)
Seat 2: matiko09 (small blind) showed [4c 4d] and won ($16.24) with two pair, Fives and Fours
Seat 4: Ilov3NBA (big blind) folded before Flop
Seat 5: Sweden_Pound folded before Flop (didn't bet)
Seat 8: Kelvin sai showed [Jh 4h] and lost with a pair of Fives





PokerStars Hand #149393013131:  Hold'em No Limit ($0.50/$1.00 USD) - 2016/02/25 17:02:37 CET [2016/02/25 11:02:37 ET]
Table 'Sabine' 9-max Seat #6 is the button
Seat 1: Aalleekks ($101 in chips) 
Seat 2: apfush ($100 in chips) 
Seat 3: Ouga Buga ($100 in chips) 
Seat 6: Sweden_Pound ($132.61 in chips) 
Seat 7: clayshmert ($75.38 in chips) 
Seat 8: matiko09 ($109 in chips) 
Seat 9: djammusic ($65.39 in chips) 
clayshmert: posts small blind $0.50
matiko09: posts big blind $1
*** HOLE CARDS ***
Dealt to matiko09 [6c 7d]
djammusic: folds 
Aalleekks: folds 
apfush: folds 
Ouga Buga: folds 
Sweden_Pound: folds 
clayshmert: calls $0.50
matiko09: checks 
*** FLOP *** [Jc 5c 8s]
clayshmert: checks 
matiko09: bets $1.24
clayshmert: calls $1.24
*** TURN *** [Jc 5c 8s] [Kh]
clayshmert: checks 
matiko09: bets $2.78
clayshmert: calls $2.78
*** RIVER *** [Jc 5c 8s Kh] [6d]
clayshmert: checks 
matiko09: checks 
*** SHOW DOWN ***
clayshmert: shows [7c Qc] (high card King)
matiko09: shows [6c 7d] (a pair of Sixes)
matiko09 collected $9.59 from pot
*** SUMMARY ***
Total pot $10.04 | Rake $0.45 
Board [Jc 5c 8s Kh 6d]
Seat 1: Aalleekks folded before Flop (didn't bet)
Seat 2: apfush folded before Flop (didn't bet)
Seat 3: Ouga Buga folded before Flop (didn't bet)
Seat 6: Sweden_Pound (button) folded before Flop (didn't bet)
Seat 7: clayshmert (small blind) showed [7c Qc] and lost with high card King
Seat 8: matiko09 (big blind) showed [6c 7d] and won ($9.59) with a pair of Sixes
Seat 9: djammusic folded before Flop (didn't bet)





PokerStars Hand #149393018324:  Hold'em No Limit ($0.50/$1.00 USD) - 2016/02/25 17:02:43 CET [2016/02/25 11:02:43 ET]
Table 'Hercules IV' 9-max Seat #5 is the button
Seat 1: matiko09 ($100 in chips) 
Seat 2: hammerwife ($108.02 in chips) 
Seat 4: Sweden_Pound ($100 in chips) 
Seat 5: xAndorx ($161.08 in chips) 
Seat 6: kuanhung0903 ($51.99 in chips) 
Seat 7: Ouga Buga ($100 in chips) 
Seat 8: brokat77 ($125.22 in chips) 
Seat 9: djammusic ($36.68 in chips) 
kuanhung0903: posts small blind $0.50
Ouga Buga: posts big blind $1
HomerrrJay: sits out 
*** HOLE CARDS ***
Dealt to matiko09 [7h 6s]
brokat77: folds 
djammusic: folds 
matiko09: folds 
hammerwife: folds 
Sweden_Pound: raises $1.50 to $2.50
xAndorx: folds 
kuanhung0903: folds 
Ouga Buga: folds 
Uncalled bet ($1.50) returned to Sweden_Pound
Sweden_Pound collected $2.50 from pot
Sweden_Pound: doesn't show hand 
*** SUMMARY ***
Total pot $2.50 | Rake $0 
Seat 1: matiko09 folded before Flop (didn't bet)
Seat 2: hammerwife folded before Flop (didn't bet)
Seat 4: Sweden_Pound collected ($2.50)
Seat 5: xAndorx (button) folded before Flop (didn't bet)
Seat 6: kuanhung0903 (small blind) folded before Flop
Seat 7: Ouga Buga (big blind) folded before Flop
Seat 8: brokat77 folded before Flop (didn't bet)
Seat 9: djammusic folded before Flop (didn't bet)





PokerStars Hand #149393018597:  Hold'em No Limit ($0.25/$0.50 USD) - 2016/02/25 17:02:44 CET [2016/02/25 11:02:44 ET]
Table 'Thalpius III' 9-max Seat #8 is the button
Seat 1: BrotherLove9 ($59.57 in chips) 
Seat 2: matiko09 ($64.31 in chips) 
Seat 3: jamba83 ($53.58 in chips) 
Seat 4: Wwwasian ($70.51 in chips) 
Seat 5: Al3xAnd3r22 ($51.71 in chips) 
Seat 7: v4n0v ($51.40 in chips) 
Seat 8: jeroemie123 ($51 in chips) 
Seat 9: Domotirko228 ($50 in chips) 
Domotirko228: posts small blind $0.25
BrotherLove9: posts big blind $0.50
111STAVR111: sits out 
*** HOLE CARDS ***
Dealt to matiko09 [Tc Js]
matiko09: folds 
jamba83: folds 
Wwwasian: folds 
Al3xAnd3r22: folds 
v4n0v: folds 
jeroemie123: calls $0.50
Domotirko228: folds 
BrotherLove9: raises $1.50 to $2
jeroemie123: calls $1.50
*** FLOP *** [Kh 5d Jh]
BrotherLove9: bets $2.72
jeroemie123: calls $2.72
*** TURN *** [Kh 5d Jh] [5c]
BrotherLove9: checks 
jeroemie123: bets $3.50
BrotherLove9: folds 
Uncalled bet ($3.50) returned to jeroemie123
jeroemie123 collected $9.25 from pot
*** SUMMARY ***
Total pot $9.69 | Rake $0.44 
Board [Kh 5d Jh 5c]
Seat 1: BrotherLove9 (big blind) folded on the Turn
Seat 2: matiko09 folded before Flop (didn't bet)
Seat 3: jamba83 folded before Flop (didn't bet)
Seat 4: Wwwasian folded before Flop (didn't bet)
Seat 5: Al3xAnd3r22 folded before Flop (didn't bet)
Seat 7: v4n0v folded before Flop (didn't bet)
Seat 8: jeroemie123 (button) collected ($9.25)
Seat 9: Domotirko228 (small blind) folded before Flop





PokerStars Hand #149393021323:  Hold'em No Limit ($0.50/$1.00 USD) - 2016/02/25 17:02:47 CET [2016/02/25 11:02:47 ET]
Table 'Zeuxo II' 9-max Seat #3 is the button
Seat 1: forsmthgood ($105.53 in chips) 
Seat 2: Sweden_Pound ($109.53 in chips) 
Seat 3: xAndorx ($100 in chips) 
Seat 4: sebaaastian ($119.61 in chips) 
Seat 5: bauss84 ($33.52 in chips) 
Seat 6: Cogss ($113.67 in chips) 
Seat 7: djammusic ($44 in chips) 
Seat 8: matiko09 ($105.70 in chips) 
Seat 9: Sreshta222 ($209.80 in chips) 
sebaaastian: posts small blind $0.50
bauss84: posts big blind $1
*** HOLE CARDS ***
Dealt to matiko09 [3s 6h]
Cogss: raises $1 to $2
djammusic: folds 
matiko09: folds 
Sreshta222: folds 
forsmthgood: raises $5.50 to $7.50
Sweden_Pound: folds 
xAndorx: folds 
sebaaastian: folds 
bauss84: folds 
Cogss: calls $5.50
*** FLOP *** [Qh 7s 3h]
Cogss: checks 
forsmthgood: checks 
*** TURN *** [Qh 7s 3h] [Kd]
Cogss: checks 
forsmthgood: bets $4.50
Cogss: folds 
Uncalled bet ($4.50) returned to forsmthgood
forsmthgood collected $15.76 from pot
forsmthgood: doesn't show hand 
*** SUMMARY ***
Total pot $16.50 | Rake $0.74 
Board [Qh 7s 3h Kd]
Seat 1: forsmthgood collected ($15.76)
Seat 2: Sweden_Pound folded before Flop (didn't bet)
Seat 3: xAndorx (button) folded before Flop (didn't bet)
Seat 4: sebaaastian (small blind) folded before Flop
Seat 5: bauss84 (big blind) folded before Flop
Seat 6: Cogss folded on the Turn
Seat 7: djammusic folded before Flop (didn't bet)
Seat 8: matiko09 folded before Flop (didn't bet)
Seat 9: Sreshta222 folded before Flop (didn't bet)





PokerStars Hand #149393031402:  Hold'em Pot Limit ($0.50/$1.00 USD) - 2016/02/25 17:03:00 CET [2016/02/25 11:03:00 ET]
Table 'Tokai' 9-max Seat #8 is the button
Seat 1: matiko09 ($104.58 in chips) 
Seat 2: Priidix ($108.64 in chips) 
Seat 4: sebaaastian ($203.57 in chips) 
Seat 6: keaxu25 ($89.84 in chips) 
Seat 8: Wwwasian ($100 in chips) 
Seat 9: Lahesell ($123.62 in chips) 
Lahesell: posts small blind $0.50
matiko09: posts big blind $1
Ilov3NBA: sits out 
simoniustin: sits out 
nickreason17: sits out 
*** HOLE CARDS ***
Dealt to matiko09 [8c Qd]
Priidix: folds 
sebaaastian: folds 
keaxu25: folds 
Wwwasian: folds 
Lahesell: folds 
Uncalled bet ($0.50) returned to matiko09
matiko09 collected $1 from pot
matiko09: doesn't show hand 
*** SUMMARY ***
Total pot $1 | Rake $0 
Seat 1: matiko09 (big blind) collected ($1)
Seat 2: Priidix folded before Flop (didn't bet)
Seat 4: sebaaastian folded before Flop (didn't bet)
Seat 6: keaxu25 folded before Flop (didn't bet)
Seat 8: Wwwasian (button) folded before Flop (didn't bet)
Seat 9: Lahesell (small blind) folded before Flop





PokerStars Hand #149393034681:  Hold'em No Limit ($0.50/$1.00 USD) - 2016/02/25 17:03:05 CET [2016/02/25 11:03:05 ET]
Table 'Guisan' 9-max Seat #7 is the button
Seat 1: stockbridge8 ($152.40 in chips) 
Seat 2: mycka86 ($111.50 in chips) 
Seat 3: xAndorx ($133.21 in chips) 
Seat 4: matiko09 ($242.05 in chips) 
Seat 5: Apparat888 ($49.50 in chips) 
Seat 6: 19R&J91 ($252.07 in chips) 
Seat 7: sebaaastian ($127.39 in chips) 
Seat 9: Sweden_Pound ($100 in chips) 
Sweden_Pound: posts small blind $0.50
stockbridge8: posts big blind $1
*** HOLE CARDS ***
Dealt to matiko09 [Js 2d]
mycka86: folds 
xAndorx: folds 
matiko09: folds 
Apparat888: folds 
19R&J91: raises $3 to $4
sebaaastian: folds 
Sweden_Pound: folds 
stockbridge8: folds 
Uncalled bet ($3) returned to 19R&J91
19R&J91 collected $2.50 from pot
19R&J91: doesn't show hand 
*** SUMMARY ***
Total pot $2.50 | Rake $0 
Seat 1: stockbridge8 (big blind) folded before Flop
Seat 2: mycka86 folded before Flop (didn't bet)
Seat 3: xAndorx folded before Flop (didn't bet)
Seat 4: matiko09 folded before Flop (didn't bet)
Seat 5: Apparat888 folded before Flop (didn't bet)
Seat 6: 19R&J91 collected ($2.50)
Seat 7: sebaaastian (button) folded before Flop (didn't bet)
Seat 9: Sweden_Pound (small blind) folded before Flop





PokerStars Hand #149393038066:  Hold'em No Limit ($0.50/$1.00 USD) - 2016/02/25 17:03:09 CET [2016/02/25 11:03:09 ET]
Table 'Ebella II' 9-max Seat #7 is the button
Seat 1: Ilov3NBA ($100 in chips) 
Seat 2: Sweden_Pound ($102.50 in chips) 
Seat 3: Lahesell ($132.84 in chips) 
Seat 4: djammusic ($42.45 in chips) 
Seat 5: matiko09 ($101.25 in chips) 
Seat 7: HomerrrJay ($100 in chips) 
Seat 8: ZMPOUTSAM140 ($70.21 in chips) 
Seat 9: simoniustin ($100 in chips) 
ZMPOUTSAM140: posts small blind $0.50
simoniustin: posts big blind $1
*** HOLE CARDS ***
Dealt to matiko09 [3d 6h]
Ilov3NBA: folds 
Sweden_Pound: folds 
Lahesell: folds 
djammusic: folds 
matiko09: folds 
HomerrrJay: folds 
ZMPOUTSAM140: folds 
Uncalled bet ($0.50) returned to simoniustin
simoniustin collected $1 from pot
simoniustin: doesn't show hand 
*** SUMMARY ***
Total pot $1 | Rake $0 
Seat 1: Ilov3NBA folded before Flop (didn't bet)
Seat 2: Sweden_Pound folded before Flop (didn't bet)
Seat 3: Lahesell folded before Flop (didn't bet)
Seat 4: djammusic folded before Flop (didn't bet)
Seat 5: matiko09 folded before Flop (didn't bet)
Seat 7: HomerrrJay (button) folded before Flop (didn't bet)
Seat 8: ZMPOUTSAM140 (small blind) folded before Flop
Seat 9: simoniustin (big blind) collected ($1)





PokerStars Hand #149393042453:  Hold'em No Limit ($0.25/$0.50 USD) - 2016/02/25 17:03:15 CET [2016/02/25 11:03:15 ET]
Table 'Lohja II' 9-max Seat #9 is the button
Seat 1: MoonJimmy ($141.98 in chips) 
Seat 2: Apparat888 ($48.25 in chips) 
Seat 4: payback11 ($51.13 in chips) 
Seat 6: xAndorx ($50.20 in chips) 
Seat 7: matiko09 ($157.98 in chips) 
Seat 8: jamba83 ($67.97 in chips) 
Seat 9: Al3xAnd3r22 ($98 in chips) 
MoonJimmy: posts small blind $0.25
Apparat888: posts big blind $0.50
guvalc1952: sits out 
111STAVR111: sits out 
MoonJimmy: posts the ante $0.10
Apparat888: posts the ante $0.10
payback11: posts the ante $0.10
xAndorx: posts the ante $0.10
matiko09: posts the ante $0.10
jamba83: posts the ante $0.10
Al3xAnd3r22: posts the ante $0.10
*** HOLE CARDS ***
Dealt to matiko09 [6c Kc]
payback11 has timed out
payback11: folds 
xAndorx: folds 
matiko09: folds 
jamba83: folds 
Al3xAnd3r22: raises $1.12 to $1.62
MoonJimmy: folds 
Apparat888: folds 
Uncalled bet ($1.12) returned to Al3xAnd3r22
Al3xAnd3r22 collected $1.95 from pot
Al3xAnd3r22: doesn't show hand 
*** SUMMARY ***
Total pot $1.95 | Rake $0 
Seat 1: MoonJimmy (small blind) folded before Flop
Seat 2: Apparat888 (big blind) folded before Flop
Seat 4: payback11 folded before Flop (didn't bet)
Seat 6: xAndorx folded before Flop (didn't bet)
Seat 7: matiko09 folded before Flop (didn't bet)
Seat 8: jamba83 folded before Flop (didn't bet)
Seat 9: Al3xAnd3r22 (button) collected ($1.95)





PokerStars Hand #149393046267:  Hold'em No Limit ($0.50/$1.00 USD) - 2016/02/25 17:03:20 CET [2016/02/25 11:03:20 ET]
Table 'Hercules IV' 9-max Seat #6 is the button
Seat 1: matiko09 ($100 in chips) 
Seat 2: hammerwife ($108.02 in chips) 
Seat 4: Sweden_Pound ($101.50 in chips) 
Seat 5: xAndorx ($161.08 in chips) 
Seat 6: kuanhung0903 ($51.49 in chips) 
Seat 7: Ouga Buga ($100 in chips) 
Seat 8: brokat77 ($125.22 in chips) 
Seat 9: djammusic ($36.68 in chips) 
Ouga Buga: posts small blind $0.50
brokat77: posts big blind $1
HomerrrJay: sits out 
*** HOLE CARDS ***
Dealt to matiko09 [Qc Jc]
djammusic: folds 
matiko09: raises $2 to $3
hammerwife: folds 
Sweden_Pound: folds 
xAndorx: folds 
kuanhung0903: folds 
Ouga Buga: calls $2.50
brokat77: raises $9 to $12
matiko09: folds 
Ouga Buga: folds 
Uncalled bet ($9) returned to brokat77
brokat77 collected $9 from pot
brokat77: doesn't show hand 
*** SUMMARY ***
Total pot $9 | Rake $0 
Seat 1: matiko09 folded before Flop
Seat 2: hammerwife folded before Flop (didn't bet)
Seat 4: Sweden_Pound folded before Flop (didn't bet)
Seat 5: xAndorx folded before Flop (didn't bet)
Seat 6: kuanhung0903 (button) folded before Flop (didn't bet)
Seat 7: Ouga Buga (small blind) folded before Flop
Seat 8: brokat77 (big blind) collected ($9)
Seat 9: djammusic folded before Flop (didn't bet)





PokerStars Hand #149393048950:  Hold'em No Limit ($0.50/$1.00 USD) - 2016/02/25 17:03:23 CET [2016/02/25 11:03:23 ET]
Table 'Badenia II' 9-max Seat #8 is the button
Seat 1: matiko09 ($100 in chips) 
Seat 2: Stibitzkie ($95.81 in chips) 
Seat 3: sebaaastian ($126.34 in chips) 
Seat 4: KarlMoik1 ($333.94 in chips) 
Seat 5: djammusic ($120.59 in chips) 
Seat 6: xAndorx ($103.53 in chips) 
Seat 7: forsmthgood ($100 in chips) 
Seat 8: Sweden_Pound ($129.15 in chips) 
Seat 9: waisanen ($253.47 in chips) 
waisanen: posts small blind $0.50
matiko09: posts big blind $1
*** HOLE CARDS ***
Dealt to matiko09 [8c 4d]
Stibitzkie: folds 
sebaaastian: folds 
KarlMoik1: folds 
KarlMoik1 leaves the table
djammusic: folds 
xAndorx: folds 
forsmthgood: folds 
hammerwife joins the table at seat #4 
Sweden_Pound: raises $1 to $2
waisanen: folds 
matiko09: folds 
Uncalled bet ($1) returned to Sweden_Pound
Sweden_Pound collected $2.50 from pot
Sweden_Pound: doesn't show hand 
*** SUMMARY ***
Total pot $2.50 | Rake $0 
Seat 1: matiko09 (big blind) folded before Flop
Seat 2: Stibitzkie folded before Flop (didn't bet)
Seat 3: sebaaastian folded before Flop (didn't bet)
Seat 4: KarlMoik1 folded before Flop (didn't bet)
Seat 5: djammusic folded before Flop (didn't bet)
Seat 6: xAndorx folded before Flop (didn't bet)
Seat 7: forsmthgood folded before Flop (didn't bet)
Seat 8: Sweden_Pound (button) collected ($2.50)
Seat 9: waisanen (small blind) folded before Flop





PokerStars Hand #149393054264:  Hold'em Pot Limit ($0.50/$1.00 USD) - 2016/02/25 17:03:30 CET [2016/02/25 11:03:30 ET]
Table 'Tokai' 9-max Seat #9 is the button
Seat 1: matiko09 ($105.08 in chips) 
Seat 2: Priidix ($108.64 in chips) 
Seat 4: sebaaastian ($203.57 in chips) 
Seat 6: keaxu25 ($89.84 in chips) 
Seat 8: Wwwasian ($100 in chips) 
Seat 9: Lahesell ($123.12 in chips) 
matiko09: posts small blind $0.50
Priidix: posts big blind $1
Ilov3NBA: sits out 
simoniustin: sits out 
nickreason17: sits out 
*** HOLE CARDS ***
Dealt to matiko09 [4c Jd]
sebaaastian: raises $2 to $3
keaxu25: calls $3
Wwwasian: folds 
Lahesell: calls $3
matiko09: folds 
Priidix: folds 
*** FLOP *** [6s 7s Tc]
sebaaastian: checks 
keaxu25: bets $2
Lahesell: raises $9.35 to $11.35
sebaaastian: raises $27.65 to $39
keaxu25: folds 
Lahesell: folds 
Uncalled bet ($27.65) returned to sebaaastian
sebaaastian collected $33.62 from pot
sebaaastian: doesn't show hand 
*** SUMMARY ***
Total pot $35.20 | Rake $1.58 
Board [6s 7s Tc]
Seat 1: matiko09 (small blind) folded before Flop
Seat 2: Priidix (big blind) folded before Flop
Seat 4: sebaaastian collected ($33.62)
Seat 6: keaxu25 folded on the Flop
Seat 8: Wwwasian folded before Flop (didn't bet)
Seat 9: Lahesell (button) folded on the Flop





PokerStars Hand #149393055653:  Hold'em No Limit ($0.50/$1.00 USD) - 2016/02/25 17:03:32 CET [2016/02/25 11:03:32 ET]
Table 'Ebella II' 9-max Seat #8 is the button
Seat 2: Sweden_Pound ($102.50 in chips) 
Seat 3: Lahesell ($132.84 in chips) 
Seat 4: djammusic ($42.45 in chips) 
Seat 5: matiko09 ($101.25 in chips) 
Seat 7: HomerrrJay ($100 in chips) 
Seat 8: ZMPOUTSAM140 ($69.71 in chips) 
Seat 9: simoniustin ($100.50 in chips) 
simoniustin: posts small blind $0.50
Ilov3NBA: is sitting out 
Sweden_Pound: posts big blind $1
*** HOLE CARDS ***
Dealt to matiko09 [2s 6s]
Lahesell: folds 
djammusic: folds 
matiko09: folds 
HomerrrJay: folds 
ZMPOUTSAM140: raises $2 to $3
simoniustin: folds 
Ilov3NBA leaves the table
Sweden_Pound: folds 
Uncalled bet ($2) returned to ZMPOUTSAM140
ZMPOUTSAM140 collected $2.50 from pot
*** SUMMARY ***
Total pot $2.50 | Rake $0 
Seat 2: Sweden_Pound (big blind) folded before Flop
Seat 3: Lahesell folded before Flop (didn't bet)
Seat 4: djammusic folded before Flop (didn't bet)
Seat 5: matiko09 folded before Flop (didn't bet)
Seat 7: HomerrrJay folded before Flop (didn't bet)
Seat 8: ZMPOUTSAM140 (button) collected ($2.50)
Seat 9: simoniustin (small blind) folded before Flop





PokerStars Hand #149393059085:  Hold'em No Limit ($0.50/$1.00 USD) - 2016/02/25 17:03:36 CET [2016/02/25 11:03:36 ET]
Table 'Mayall II' 9-max Seat #9 is the button
Seat 1: matiko09 ($114.11 in chips) 
Seat 2: Sweden_Pound ($137.97 in chips) 
Seat 3: doppy 123577 ($85.69 in chips) 
Seat 4: Ouga Buga ($104.36 in chips) 
Seat 5: SumPosad ($77.45 in chips) 
Seat 6: apfush ($112.78 in chips) 
Seat 7: r.pol218 ($59.81 in chips) 
Seat 8: kuanhung0903 ($72.48 in chips) 
Seat 9: xAndorx ($140.84 in chips) 
matiko09: posts small blind $0.50
Sweden_Pound: posts big blind $1
*** HOLE CARDS ***
Dealt to matiko09 [As 7d]
doppy 123577: folds 
Ouga Buga: folds 
SumPosad: folds 
apfush: folds 
r.pol218: folds 
kuanhung0903: folds 
xAndorx: raises $1 to $2
matiko09: folds 
Sweden_Pound: raises $6 to $8
xAndorx: folds 
Uncalled bet ($6) returned to Sweden_Pound
Sweden_Pound collected $4.50 from pot
Sweden_Pound: doesn't show hand 
*** SUMMARY ***
Total pot $4.50 | Rake $0 
Seat 1: matiko09 (small blind) folded before Flop
Seat 2: Sweden_Pound (big blind) collected ($4.50)
Seat 3: doppy 123577 folded before Flop (didn't bet)
Seat 4: Ouga Buga folded before Flop (didn't bet)
Seat 5: SumPosad folded before Flop (didn't bet)
Seat 6: apfush folded before Flop (didn't bet)
Seat 7: r.pol218 folded before Flop (didn't bet)
Seat 8: kuanhung0903 folded before Flop (didn't bet)
Seat 9: xAndorx (button) folded before Flop





PokerStars Hand #149393061145:  Hold'em No Limit ($0.50/$1.00 USD) - 2016/02/25 17:03:39 CET [2016/02/25 11:03:39 ET]
Table 'Sabine' 9-max Seat #7 is the button
Seat 1: Aalleekks ($101 in chips) 
Seat 2: apfush ($100 in chips) 
Seat 3: Ouga Buga ($100 in chips) 
Seat 6: Sweden_Pound ($132.61 in chips) 
Seat 7: clayshmert ($70.36 in chips) 
Seat 8: matiko09 ($113.57 in chips) 
Seat 9: djammusic ($65.39 in chips) 
matiko09: posts small blind $0.50
djammusic: posts big blind $1
*** HOLE CARDS ***
Dealt to matiko09 [Jh Th]
Aalleekks: folds 
apfush: folds 
Ouga Buga: raises $1.50 to $2.50
Sweden_Pound: folds 
clayshmert: folds 
matiko09: folds 
djammusic: folds 
Uncalled bet ($1.50) returned to Ouga Buga
Ouga Buga collected $2.50 from pot
Ouga Buga: doesn't show hand 
*** SUMMARY ***
Total pot $2.50 | Rake $0 
Seat 1: Aalleekks folded before Flop (didn't bet)
Seat 2: apfush folded before Flop (didn't bet)
Seat 3: Ouga Buga collected ($2.50)
Seat 6: Sweden_Pound folded before Flop (didn't bet)
Seat 7: clayshmert (button) folded before Flop (didn't bet)
Seat 8: matiko09 (small blind) folded before Flop
Seat 9: djammusic (big blind) folded before Flop





PokerStars Hand #149393063914:  Hold'em No Limit ($0.50/$1.00 USD) - 2016/02/25 17:03:43 CET [2016/02/25 11:03:43 ET]
Table 'Guisan' 9-max Seat #9 is the button
Seat 1: stockbridge8 ($151.40 in chips) 
Seat 2: mycka86 ($111.50 in chips) 
Seat 3: xAndorx ($133.21 in chips) 
Seat 4: matiko09 ($242.05 in chips) 
Seat 5: Apparat888 ($49.50 in chips) 
Seat 6: 19R&J91 ($253.57 in chips) 
Seat 7: sebaaastian ($127.39 in chips) 
Seat 9: Sweden_Pound ($100 in chips) 
stockbridge8: posts small blind $0.50
mycka86: posts big blind $1
*** HOLE CARDS ***
Dealt to matiko09 [Td Qc]
xAndorx: folds 
matiko09: folds 
Apparat888: folds 
19R&J91: folds 
19R&J91 leaves the table
sebaaastian: folds 
Sweden_Pound: folds 
stockbridge8: folds 
Uncalled bet ($0.50) returned to mycka86
mycka86 collected $1 from pot
*** SUMMARY ***
Total pot $1 | Rake $0 
Seat 1: stockbridge8 (small blind) folded before Flop
Seat 2: mycka86 (big blind) collected ($1)
Seat 3: xAndorx folded before Flop (didn't bet)
Seat 4: matiko09 folded before Flop (didn't bet)
Seat 5: Apparat888 folded before Flop (didn't bet)
Seat 6: 19R&J91 folded before Flop (didn't bet)
Seat 7: sebaaastian folded before Flop (didn't bet)
Seat 9: Sweden_Pound (button) folded before Flop (didn't bet)





PokerStars Hand #149393070289:  Hold'em No Limit ($0.25/$0.50 USD) - 2016/02/25 17:03:51 CET [2016/02/25 11:03:51 ET]
Table 'Thalpius III' 9-max Seat #9 is the button
Seat 1: BrotherLove9 ($54.85 in chips) 
Seat 2: matiko09 ($64.31 in chips) 
Seat 3: jamba83 ($53.58 in chips) 
Seat 4: Wwwasian ($70.51 in chips) 
Seat 5: Al3xAnd3r22 ($51.71 in chips) 
Seat 7: v4n0v ($51.40 in chips) 
Seat 8: jeroemie123 ($55.53 in chips) 
Seat 9: Domotirko228 ($50 in chips) 
BrotherLove9: posts small blind $0.25
matiko09: posts big blind $0.50
111STAVR111: sits out 
*** HOLE CARDS ***
Dealt to matiko09 [8d Qh]
jamba83: folds 
Wwwasian: folds 
Al3xAnd3r22: folds 
v4n0v: folds 
jeroemie123: raises $1 to $1.50
Domotirko228: folds 
BrotherLove9: folds 
matiko09: folds 
Uncalled bet ($1) returned to jeroemie123
jeroemie123 collected $1.25 from pot
*** SUMMARY ***
Total pot $1.25 | Rake $0 
Seat 1: BrotherLove9 (small blind) folded before Flop
Seat 2: matiko09 (big blind) folded before Flop
Seat 3: jamba83 folded before Flop (didn't bet)
Seat 4: Wwwasian folded before Flop (didn't bet)
Seat 5: Al3xAnd3r22 folded before Flop (didn't bet)
Seat 7: v4n0v folded before Flop (didn't bet)
Seat 8: jeroemie123 collected ($1.25)
Seat 9: Domotirko228 (button) folded before Flop (didn't bet)





PokerStars Hand #149393072143:  Hold'em No Limit ($0.50/$1.00 USD) - 2016/02/25 17:03:53 CET [2016/02/25 11:03:53 ET]
Table 'Isa' 9-max Seat #1 is the button
Seat 1: matiko09 ($124.62 in chips) 
Seat 3: sebaaastian ($135.81 in chips) 
Seat 5: Sweden_Pound ($183.38 in chips) 
Seat 6: xAndorx ($100 in chips) 
Seat 7: bilukm ($159.18 in chips) 
Seat 8: Venomous100% ($100 in chips) 
mycka86 will be allowed to play after the button
sebaaastian: posts small blind $0.50
Sweden_Pound: posts big blind $1
HomerrrJay: sits out 
*** HOLE CARDS ***
Dealt to matiko09 [5h 4h]
xAndorx: folds 
bilukm: raises $1 to $2
Venomous100%: folds 
matiko09: folds 
sebaaastian: folds 
Sweden_Pound: folds 
Uncalled bet ($1) returned to bilukm
bilukm collected $2.50 from pot
bilukm: doesn't show hand 
*** SUMMARY ***
Total pot $2.50 | Rake $0 
Seat 1: matiko09 (button) folded before Flop (didn't bet)
Seat 3: sebaaastian (small blind) folded before Flop
Seat 5: Sweden_Pound (big blind) folded before Flop
Seat 6: xAndorx folded before Flop (didn't bet)
Seat 7: bilukm collected ($2.50)
Seat 8: Venomous100% folded before Flop (didn't bet)





PokerStars Hand #149393072061:  Hold'em No Limit ($0.25/$0.50 USD) - 2016/02/25 17:03:53 CET [2016/02/25 11:03:53 ET]
Table 'Lohja II' 9-max Seat #1 is the button
Seat 1: MoonJimmy ($141.63 in chips) 
Seat 2: Apparat888 ($47.65 in chips) 
Seat 3: guvalc1952 ($166.99 in chips) 
Seat 4: payback11 ($51.03 in chips) 
Seat 6: xAndorx ($50.10 in chips) 
Seat 7: matiko09 ($157.88 in chips) 
Seat 8: jamba83 ($67.87 in chips) 
Seat 9: Al3xAnd3r22 ($99.35 in chips) 
Apparat888: posts small blind $0.25
guvalc1952: posts big blind $0.50
111STAVR111: sits out 
MoonJimmy: posts the ante $0.10
Apparat888: posts the ante $0.10
guvalc1952: posts the ante $0.10
payback11: posts the ante $0.10
xAndorx: posts the ante $0.10
matiko09: posts the ante $0.10
jamba83: posts the ante $0.10
Al3xAnd3r22: posts the ante $0.10
*** HOLE CARDS ***
Dealt to matiko09 [9s Jd]
payback11: folds 
xAndorx: raises $1 to $1.50
matiko09: folds 
jamba83: calls $1.50
Al3xAnd3r22: folds 
MoonJimmy: folds 
Apparat888: folds 
guvalc1952 has timed out
guvalc1952: folds 
*** FLOP *** [Tc 7s 7d]
xAndorx: bets $2.25
jamba83: folds 
Uncalled bet ($2.25) returned to xAndorx
xAndorx collected $4.35 from pot
xAndorx: doesn't show hand 
*** SUMMARY ***
Total pot $4.55 | Rake $0.20 
Board [Tc 7s 7d]
Seat 1: MoonJimmy (button) folded before Flop (didn't bet)
Seat 2: Apparat888 (small blind) folded before Flop
Seat 3: guvalc1952 (big blind) folded before Flop
Seat 4: payback11 folded before Flop (didn't bet)
Seat 6: xAndorx collected ($4.35)
Seat 7: matiko09 folded before Flop (didn't bet)
Seat 8: jamba83 folded on the Flop
Seat 9: Al3xAnd3r22 folded before Flop (didn't bet)





PokerStars Hand #149393074981:  Hold'em No Limit ($0.50/$1.00 USD) - 2016/02/25 17:03:57 CET [2016/02/25 11:03:57 ET]
Table 'Nerthus II' 9-max Seat #2 is the button
Seat 1: lysandrafly ($113.87 in chips) 
Seat 2: matiko09 ($187.01 in chips) 
Seat 4: Ilov3NBA ($103.12 in chips) 
Seat 5: Sweden_Pound ($220.11 in chips) 
Seat 8: Kelvin sai ($70.25 in chips) 
simoniustin will be allowed to play after the button
Ilov3NBA: posts small blind $0.50
Sweden_Pound: posts big blind $1
mycka86: sits out 
Venomous100%: sits out 
*** HOLE CARDS ***
Dealt to matiko09 [2s Qs]
Kelvin sai: raises $1 to $2
lysandrafly: folds 
matiko09: folds 
Ilov3NBA: folds 
Sweden_Pound: folds 
Uncalled bet ($1) returned to Kelvin sai
Kelvin sai collected $2.50 from pot
Kelvin sai: doesn't show hand 
*** SUMMARY ***
Total pot $2.50 | Rake $0 
Seat 1: lysandrafly folded before Flop (didn't bet)
Seat 2: matiko09 (button) folded before Flop (didn't bet)
Seat 4: Ilov3NBA (small blind) folded before Flop
Seat 5: Sweden_Pound (big blind) folded before Flop
Seat 8: Kelvin sai collected ($2.50)





PokerStars Hand #149393081526:  Hold'em No Limit ($0.50/$1.00 USD) - 2016/02/25 17:04:06 CET [2016/02/25 11:04:06 ET]
Table 'Ebella II' 9-max Seat #9 is the button
Seat 2: Sweden_Pound ($101.50 in chips) 
Seat 3: Lahesell ($132.84 in chips) 
Seat 4: djammusic ($42.45 in chips) 
Seat 5: matiko09 ($101.25 in chips) 
Seat 7: HomerrrJay ($100 in chips) 
Seat 8: ZMPOUTSAM140 ($71.21 in chips) 
Seat 9: simoniustin ($100 in chips) 
Sweden_Pound: posts small blind $0.50
Lahesell: posts big blind $1
*** HOLE CARDS ***
Dealt to matiko09 [5h Qh]
djammusic: folds 
matiko09: folds 
HomerrrJay: folds 
ZMPOUTSAM140: folds 
simoniustin: raises $1.50 to $2.50
Sweden_Pound: folds 
Venomous100% joins the table at seat #1 
Lahesell: folds 
Uncalled bet ($1.50) returned to simoniustin
simoniustin collected $2.50 from pot
simoniustin: doesn't show hand 
*** SUMMARY ***
Total pot $2.50 | Rake $0 
Seat 2: Sweden_Pound (small blind) folded before Flop
Seat 3: Lahesell (big blind) folded before Flop
Seat 4: djammusic folded before Flop (didn't bet)
Seat 5: matiko09 folded before Flop (didn't bet)
Seat 7: HomerrrJay folded before Flop (didn't bet)
Seat 8: ZMPOUTSAM140 folded before Flop (didn't bet)
Seat 9: simoniustin (button) collected ($2.50)





PokerStars Hand #149393089839:  Hold'em No Limit ($0.50/$1.00 USD) - 2016/02/25 17:04:16 CET [2016/02/25 11:04:16 ET]
Table 'Nerthus II' 9-max Seat #4 is the button
Seat 1: lysandrafly ($113.87 in chips) 
Seat 2: matiko09 ($187.01 in chips) 
Seat 4: Ilov3NBA ($102.62 in chips) 
Seat 5: Sweden_Pound ($219.11 in chips) 
Seat 6: mycka86 ($100 in chips) 
Seat 8: Kelvin sai ($71.75 in chips) 
Sweden_Pound: posts small blind $0.50
mycka86: posts big blind $1
Venomous100%: sits out 
simoniustin: sits out 
*** HOLE CARDS ***
Dealt to matiko09 [8h Jh]
Kelvin sai: folds 
lysandrafly: folds 
matiko09: raises $1.50 to $2.50
Ilov3NBA: calls $2.50
Sweden_Pound: raises $8.50 to $11
mycka86: folds 
matiko09: folds 
Ilov3NBA: folds 
Uncalled bet ($8.50) returned to Sweden_Pound
Sweden_Pound collected $8.50 from pot
Sweden_Pound: doesn't show hand 
*** SUMMARY ***
Total pot $8.50 | Rake $0 
Seat 1: lysandrafly folded before Flop (didn't bet)
Seat 2: matiko09 folded before Flop
Seat 4: Ilov3NBA (button) folded before Flop
Seat 5: Sweden_Pound (small blind) collected ($8.50)
Seat 6: mycka86 (big blind) folded before Flop
Seat 8: Kelvin sai folded before Flop (didn't bet)





PokerStars Hand #149393089260:  Hold'em No Limit ($0.50/$1.00 USD) - 2016/02/25 17:04:16 CET [2016/02/25 11:04:16 ET]
Table 'Badenia II' 9-max Seat #9 is the button
Seat 1: matiko09 ($100 in chips) 
Seat 2: Stibitzkie ($95.81 in chips) 
Seat 3: sebaaastian ($126.34 in chips) 
Seat 5: djammusic ($120.59 in chips) 
Seat 6: xAndorx ($103.53 in chips) 
Seat 7: forsmthgood ($100 in chips) 
Seat 8: Sweden_Pound ($130.65 in chips) 
Seat 9: waisanen ($252.97 in chips) 
matiko09: posts small blind $0.50
Stibitzkie: posts big blind $1
*** HOLE CARDS ***
Dealt to matiko09 [9s 7c]
sebaaastian: folds 
djammusic: folds 
xAndorx: raises $2 to $3
forsmthgood: folds 
Sweden_Pound: folds 
waisanen: folds 
matiko09: folds 
Stibitzkie: calls $2
*** FLOP *** [9c Jd 8d]
Stibitzkie: checks 
xAndorx: checks 
*** TURN *** [9c Jd 8d] [Qc]
Stibitzkie: checks 
xAndorx: bets $4
Stibitzkie: calls $4
*** RIVER *** [9c Jd 8d Qc] [Ts]
Stibitzkie: checks 
xAndorx: bets $12
Stibitzkie: calls $12
*** SHOW DOWN ***
xAndorx: shows [Qh Kc] (a straight, Nine to King)
Stibitzkie: mucks hand 
xAndorx collected $36.77 from pot
*** SUMMARY ***
Total pot $38.50 | Rake $1.73 
Board [9c Jd 8d Qc Ts]
Seat 1: matiko09 (small blind) folded before Flop
Seat 2: Stibitzkie (big blind) mucked [6c 7h]
Seat 3: sebaaastian folded before Flop (didn't bet)
Seat 5: djammusic folded before Flop (didn't bet)
Seat 6: xAndorx showed [Qh Kc] and won ($36.77) with a straight, Nine to King
Seat 7: forsmthgood folded before Flop (didn't bet)
Seat 8: Sweden_Pound folded before Flop (didn't bet)
Seat 9: waisanen (button) folded before Flop (didn't bet)





PokerStars Hand #149393094160:  Hold'em No Limit ($0.50/$1.00 USD) - 2016/02/25 17:04:22 CET [2016/02/25 11:04:22 ET]
Table 'Hercules IV' 9-max Seat #7 is the button
Seat 1: matiko09 ($100 in chips) 
Seat 2: hammerwife ($108.02 in chips) 
Seat 4: Sweden_Pound ($101.50 in chips) 
Seat 5: xAndorx ($161.08 in chips) 
Seat 6: kuanhung0903 ($51.49 in chips) 
Seat 7: Ouga Buga ($100 in chips) 
Seat 8: brokat77 ($131.22 in chips) 
Seat 9: djammusic ($36.68 in chips) 
brokat77: posts small blind $0.50
djammusic: posts big blind $1
HomerrrJay: sits out 
*** HOLE CARDS ***
Dealt to matiko09 [Qs Kh]
matiko09: raises $2 to $3
hammerwife: folds 
Sweden_Pound: folds 
xAndorx: folds 
kuanhung0903: folds 
Ouga Buga: folds 
brokat77: folds 
djammusic: folds 
Uncalled bet ($2) returned to matiko09
matiko09 collected $2.50 from pot
matiko09: doesn't show hand 
*** SUMMARY ***
Total pot $2.50 | Rake $0 
Seat 1: matiko09 collected ($2.50)
Seat 2: hammerwife folded before Flop (didn't bet)
Seat 4: Sweden_Pound folded before Flop (didn't bet)
Seat 5: xAndorx folded before Flop (didn't bet)
Seat 6: kuanhung0903 folded before Flop (didn't bet)
Seat 7: Ouga Buga (button) folded before Flop (didn't bet)
Seat 8: brokat77 (small blind) folded before Flop
Seat 9: djammusic (big blind) folded before Flop





PokerStars Hand #149393094379:  Hold'em No Limit ($0.25/$0.50 USD) - 2016/02/25 17:04:22 CET [2016/02/25 11:04:22 ET]
Table 'Thalpius III' 9-max Seat #1 is the button
Seat 1: BrotherLove9 ($54.60 in chips) 
Seat 2: matiko09 ($63.81 in chips) 
Seat 3: jamba83 ($53.58 in chips) 
Seat 4: Wwwasian ($70.51 in chips) 
Seat 5: Al3xAnd3r22 ($51.71 in chips) 
Seat 7: v4n0v ($51.40 in chips) 
Seat 8: jeroemie123 ($56.28 in chips) 
Seat 9: Domotirko228 ($50 in chips) 
matiko09: posts small blind $0.25
jamba83: posts big blind $0.50
111STAVR111: sits out 
*** HOLE CARDS ***
Dealt to matiko09 [8s 3h]
Wwwasian: folds 
Al3xAnd3r22: folds 
v4n0v: folds 
jeroemie123: raises $0.50 to $1
Domotirko228: folds 
BrotherLove9: folds 
matiko09: folds 
jamba83: folds 
Uncalled bet ($0.50) returned to jeroemie123
jeroemie123 collected $1.25 from pot
*** SUMMARY ***
Total pot $1.25 | Rake $0 
Seat 1: BrotherLove9 (button) folded before Flop (didn't bet)
Seat 2: matiko09 (small blind) folded before Flop
Seat 3: jamba83 (big blind) folded before Flop
Seat 4: Wwwasian folded before Flop (didn't bet)
Seat 5: Al3xAnd3r22 folded before Flop (didn't bet)
Seat 7: v4n0v folded before Flop (didn't bet)
Seat 8: jeroemie123 collected ($1.25)
Seat 9: Domotirko228 folded before Flop (didn't bet)





PokerStars Hand #149393103082:  Hold'em No Limit ($0.50/$1.00 USD) - 2016/02/25 17:04:34 CET [2016/02/25 11:04:34 ET]
Table 'Zeuxo II' 9-max Seat #4 is the button
Seat 1: forsmthgood ($113.79 in chips) 
Seat 2: Sweden_Pound ($109.53 in chips) 
Seat 3: xAndorx ($100 in chips) 
Seat 4: sebaaastian ($119.11 in chips) 
Seat 5: bauss84 ($32.52 in chips) 
Seat 6: Cogss ($106.17 in chips) 
Seat 7: djammusic ($44 in chips) 
Seat 8: matiko09 ($105.70 in chips) 
Seat 9: Sreshta222 ($209.80 in chips) 
bauss84: posts small blind $0.50
Cogss: posts big blind $1
*** HOLE CARDS ***
Dealt to matiko09 [Qd 9s]
djammusic: folds 
matiko09: folds 
Sreshta222: folds 
forsmthgood: folds 
Sweden_Pound: folds 
xAndorx: raises $2 to $3
sebaaastian: folds 
bauss84: calls $2.50
Cogss: folds 
*** FLOP *** [5d 4c 4d]
bauss84: bets $3
xAndorx: folds 
Uncalled bet ($3) returned to bauss84
bauss84 collected $6.68 from pot
bauss84: doesn't show hand 
*** SUMMARY ***
Total pot $7 | Rake $0.32 
Board [5d 4c 4d]
Seat 1: forsmthgood folded before Flop (didn't bet)
Seat 2: Sweden_Pound folded before Flop (didn't bet)
Seat 3: xAndorx folded on the Flop
Seat 4: sebaaastian (button) folded before Flop (didn't bet)
Seat 5: bauss84 (small blind) collected ($6.68)
Seat 6: Cogss (big blind) folded before Flop
Seat 7: djammusic folded before Flop (didn't bet)
Seat 8: matiko09 folded before Flop (didn't bet)
Seat 9: Sreshta222 folded before Flop (didn't bet)





PokerStars Hand #149393107868:  Hold'em No Limit ($0.50/$1.00 USD) - 2016/02/25 17:04:40 CET [2016/02/25 11:04:40 ET]
Table 'Ebella II' 9-max Seat #2 is the button
Seat 2: Sweden_Pound ($101 in chips) 
Seat 3: Lahesell ($131.84 in chips) 
Seat 4: djammusic ($42.45 in chips) 
Seat 5: matiko09 ($101.25 in chips) 
Seat 7: HomerrrJay ($100 in chips) 
Seat 8: ZMPOUTSAM140 ($71.21 in chips) 
Seat 9: simoniustin ($101.50 in chips) 
Lahesell: posts small blind $0.50
djammusic: posts big blind $1
Venomous100%: sits out 
*** HOLE CARDS ***
Dealt to matiko09 [6d 2d]
matiko09: folds 
Venomous100% leaves the table
nickreason17 joins the table at seat #1 
HomerrrJay: folds 
ZMPOUTSAM140: raises $3 to $4
simoniustin: folds 
Sweden_Pound: folds 
Lahesell: folds 
djammusic: folds 
Uncalled bet ($3) returned to ZMPOUTSAM140
ZMPOUTSAM140 collected $2.50 from pot
*** SUMMARY ***
Total pot $2.50 | Rake $0 
Seat 2: Sweden_Pound (button) folded before Flop (didn't bet)
Seat 3: Lahesell (small blind) folded before Flop
Seat 4: djammusic (big blind) folded before Flop
Seat 5: matiko09 folded before Flop (didn't bet)
Seat 7: HomerrrJay folded before Flop (didn't bet)
Seat 8: ZMPOUTSAM140 collected ($2.50)
Seat 9: simoniustin folded before Flop (didn't bet)





PokerStars Hand #149393111494:  Hold'em No Limit ($0.50/$1.00 USD) - 2016/02/25 17:04:44 CET [2016/02/25 11:04:44 ET]
Table 'Mayall II' 9-max Seat #1 is the button
Seat 1: matiko09 ($113.61 in chips) 
Seat 2: Sweden_Pound ($140.47 in chips) 
Seat 3: doppy 123577 ($85.69 in chips) 
Seat 4: Ouga Buga ($104.36 in chips) 
Seat 5: SumPosad ($77.45 in chips) 
Seat 6: apfush ($112.78 in chips) 
Seat 7: r.pol218 ($59.81 in chips) 
Seat 8: kuanhung0903 ($72.48 in chips) 
Seat 9: xAndorx ($138.84 in chips) 
Sweden_Pound: posts small blind $0.50
doppy 123577: posts big blind $1
*** HOLE CARDS ***
Dealt to matiko09 [9s 4h]
Ouga Buga: folds 
SumPosad: folds 
apfush: folds 
r.pol218: folds 
kuanhung0903: folds 
xAndorx: folds 
matiko09: folds 
Sweden_Pound: folds 
Uncalled bet ($0.50) returned to doppy 123577
doppy 123577 collected $1 from pot
doppy 123577: doesn't show hand 
*** SUMMARY ***
Total pot $1 | Rake $0 
Seat 1: matiko09 (button) folded before Flop (didn't bet)
Seat 2: Sweden_Pound (small blind) folded before Flop
Seat 3: doppy 123577 (big blind) collected ($1)
Seat 4: Ouga Buga folded before Flop (didn't bet)
Seat 5: SumPosad folded before Flop (didn't bet)
Seat 6: apfush folded before Flop (didn't bet)
Seat 7: r.pol218 folded before Flop (didn't bet)
Seat 8: kuanhung0903 folded before Flop (didn't bet)
Seat 9: xAndorx folded before Flop (didn't bet)





PokerStars Hand #149393114029:  Hold'em No Limit ($0.50/$1.00 USD) - 2016/02/25 17:04:48 CET [2016/02/25 11:04:48 ET]
Table 'Sabine' 9-max Seat #8 is the button
Seat 1: Aalleekks ($101 in chips) 
Seat 2: apfush ($100 in chips) 
Seat 3: Ouga Buga ($101.50 in chips) 
Seat 6: Sweden_Pound ($132.61 in chips) 
Seat 7: clayshmert ($70.36 in chips) 
Seat 8: matiko09 ($113.07 in chips) 
Seat 9: djammusic ($64.39 in chips) 
djammusic: posts small blind $0.50
Aalleekks: posts big blind $1
*** HOLE CARDS ***
Dealt to matiko09 [7c Kc]
apfush: folds 
Ouga Buga: raises $1.50 to $2.50
Sweden_Pound: folds 
clayshmert: folds 
matiko09: folds 
djammusic: folds 
Aalleekks: folds 
Uncalled bet ($1.50) returned to Ouga Buga
Ouga Buga collected $2.50 from pot
Ouga Buga: doesn't show hand 
*** SUMMARY ***
Total pot $2.50 | Rake $0 
Seat 1: Aalleekks (big blind) folded before Flop
Seat 2: apfush folded before Flop (didn't bet)
Seat 3: Ouga Buga collected ($2.50)
Seat 6: Sweden_Pound folded before Flop (didn't bet)
Seat 7: clayshmert folded before Flop (didn't bet)
Seat 8: matiko09 (button) folded before Flop (didn't bet)
Seat 9: djammusic (small blind) folded before Flop





PokerStars Hand #149393114301:  Hold'em No Limit ($0.50/$1.00 USD) - 2016/02/25 17:04:48 CET [2016/02/25 11:04:48 ET]
Table 'Hercules IV' 9-max Seat #8 is the button
Seat 1: matiko09 ($101.50 in chips) 
Seat 2: hammerwife ($108.02 in chips) 
Seat 4: Sweden_Pound ($101.50 in chips) 
Seat 5: xAndorx ($161.08 in chips) 
Seat 6: kuanhung0903 ($51.49 in chips) 
Seat 7: Ouga Buga ($100 in chips) 
Seat 8: brokat77 ($130.72 in chips) 
Seat 9: djammusic ($35.68 in chips) 
djammusic: posts small blind $0.50
matiko09: posts big blind $1
HomerrrJay: sits out 
*** HOLE CARDS ***
Dealt to matiko09 [4c Ks]
hammerwife: folds 
Sweden_Pound has timed out
Sweden_Pound: folds 
xAndorx: folds 
kuanhung0903: folds 
Ouga Buga: folds 
brokat77: calls $1
djammusic: folds 
matiko09: checks 
*** FLOP *** [Jd 2h 3c]
matiko09: checks 
brokat77: checks 
*** TURN *** [Jd 2h 3c] [Qh]
matiko09: checks 
brokat77: bets $1.19
matiko09: folds 
Uncalled bet ($1.19) returned to brokat77
brokat77 collected $2.39 from pot
brokat77: doesn't show hand 
*** SUMMARY ***
Total pot $2.50 | Rake $0.11 
Board [Jd 2h 3c Qh]
Seat 1: matiko09 (big blind) folded on the Turn
Seat 2: hammerwife folded before Flop (didn't bet)
Seat 4: Sweden_Pound folded before Flop (didn't bet)
Seat 5: xAndorx folded before Flop (didn't bet)
Seat 6: kuanhung0903 folded before Flop (didn't bet)
Seat 7: Ouga Buga folded before Flop (didn't bet)
Seat 8: brokat77 (button) collected ($2.39)
Seat 9: djammusic (small blind) folded before Flop





PokerStars Hand #149393118581:  Hold'em No Limit ($0.25/$0.50 USD) - 2016/02/25 17:04:54 CET [2016/02/25 11:04:54 ET]
Table 'Thalpius III' 9-max Seat #2 is the button
Seat 1: BrotherLove9 ($54.60 in chips) 
Seat 2: matiko09 ($63.56 in chips) 
Seat 3: jamba83 ($53.08 in chips) 
Seat 4: Wwwasian ($70.51 in chips) 
Seat 5: Al3xAnd3r22 ($51.71 in chips) 
Seat 7: v4n0v ($51.40 in chips) 
Seat 8: jeroemie123 ($57.03 in chips) 
Seat 9: Domotirko228 ($50 in chips) 
jamba83: posts small blind $0.25
Wwwasian: posts big blind $0.50
111STAVR111: sits out 
*** HOLE CARDS ***
Dealt to matiko09 [Qs 4h]
Al3xAnd3r22: folds 
v4n0v: folds 
jeroemie123: calls $0.50
Domotirko228: folds 
BrotherLove9: folds 
matiko09: folds 
jamba83: folds 
Wwwasian: checks 
*** FLOP *** [Ac Ah 7d]
Wwwasian: checks 
jeroemie123: checks 
*** TURN *** [Ac Ah 7d] [Th]
Wwwasian: checks 
jeroemie123: bets $1.50
Wwwasian: folds 
Uncalled bet ($1.50) returned to jeroemie123
jeroemie123 collected $1.19 from pot
jeroemie123: doesn't show hand 
*** SUMMARY ***
Total pot $1.25 | Rake $0.06 
Board [Ac Ah 7d Th]
Seat 1: BrotherLove9 folded before Flop (didn't bet)
Seat 2: matiko09 (button) folded before Flop (didn't bet)
Seat 3: jamba83 (small blind) folded before Flop
Seat 4: Wwwasian (big blind) folded on the Turn
Seat 5: Al3xAnd3r22 folded before Flop (didn't bet)
Seat 7: v4n0v folded before Flop (didn't bet)
Seat 8: jeroemie123 collected ($1.19)
Seat 9: Domotirko228 folded before Flop (didn't bet)





PokerStars Hand #149393119252:  Hold'em No Limit ($0.25/$0.50 USD) - 2016/02/25 17:04:55 CET [2016/02/25 11:04:55 ET]
Table 'Lohja II' 9-max Seat #2 is the button
Seat 1: MoonJimmy ($141.53 in chips) 
Seat 2: Apparat888 ($47.30 in chips) 
Seat 4: payback11 ($50.93 in chips) 
Seat 5: 111STAVR111 ($50 in chips) 
Seat 6: xAndorx ($52.85 in chips) 
Seat 7: matiko09 ($157.78 in chips) 
Seat 8: jamba83 ($66.27 in chips) 
Seat 9: Al3xAnd3r22 ($99.25 in chips) 
payback11: posts small blind $0.25
111STAVR111: posts big blind $0.50
MoonJimmy: posts the ante $0.10
Apparat888: posts the ante $0.10
payback11: posts the ante $0.10
111STAVR111: posts the ante $0.10
xAndorx: posts the ante $0.10
matiko09: posts the ante $0.10
jamba83: posts the ante $0.10
Al3xAnd3r22: posts the ante $0.10
*** HOLE CARDS ***
Dealt to matiko09 [2d Tc]
xAndorx: folds 
matiko09: folds 
jamba83: raises $1 to $1.50
Al3xAnd3r22: folds 
MoonJimmy: folds 
Apparat888: folds 
payback11: folds 
111STAVR111: folds 
Uncalled bet ($1) returned to jamba83
jamba83 collected $2.05 from pot
*** SUMMARY ***
Total pot $2.05 | Rake $0 
Seat 1: MoonJimmy folded before Flop (didn't bet)
Seat 2: Apparat888 (button) folded before Flop (didn't bet)
Seat 4: payback11 (small blind) folded before Flop
Seat 5: 111STAVR111 (big blind) folded before Flop
Seat 6: xAndorx folded before Flop (didn't bet)
Seat 7: matiko09 folded before Flop (didn't bet)
Seat 8: jamba83 collected ($2.05)
Seat 9: Al3xAnd3r22 folded before Flop (didn't bet)





PokerStars Hand #149393119269:  Hold'em No Limit ($0.50/$1.00 USD) - 2016/02/25 17:04:55 CET [2016/02/25 11:04:55 ET]
Table 'Isa' 9-max Seat #3 is the button
Seat 1: matiko09 ($124.62 in chips) 
Seat 3: sebaaastian ($135.31 in chips) 
Seat 5: Sweden_Pound ($182.38 in chips) 
Seat 6: xAndorx ($100 in chips) 
Seat 7: bilukm ($160.68 in chips) 
Seat 8: Venomous100% ($100 in chips) 
Sweden_Pound: posts small blind $0.50
xAndorx: posts big blind $1
HomerrrJay: sits out 
mycka86: sits out 
*** HOLE CARDS ***
Dealt to matiko09 [Qh Qs]
bilukm: folds 
Venomous100%: folds 
matiko09: raises $1.50 to $2.50
sebaaastian: folds 
Sweden_Pound: folds 
xAndorx: calls $1.50
*** FLOP *** [3d 4h 2s]
xAndorx: checks 
matiko09: bets $3.41
xAndorx: folds 
Uncalled bet ($3.41) returned to matiko09
matiko09 collected $5.25 from pot
matiko09: doesn't show hand 
*** SUMMARY ***
Total pot $5.50 | Rake $0.25 
Board [3d 4h 2s]
Seat 1: matiko09 collected ($5.25)
Seat 3: sebaaastian (button) folded before Flop (didn't bet)
Seat 5: Sweden_Pound (small blind) folded before Flop
Seat 6: xAndorx (big blind) folded on the Flop
Seat 7: bilukm folded before Flop (didn't bet)
Seat 8: Venomous100% folded before Flop (didn't bet)





PokerStars Hand #149393127746:  Hold'em No Limit ($0.50/$1.00 USD) - 2016/02/25 17:05:06 CET [2016/02/25 11:05:06 ET]
Table 'Mayall II' 9-max Seat #2 is the button
Seat 1: matiko09 ($113.61 in chips) 
Seat 2: Sweden_Pound ($139.97 in chips) 
Seat 3: doppy 123577 ($86.19 in chips) 
Seat 4: Ouga Buga ($104.36 in chips) 
Seat 5: SumPosad ($77.45 in chips) 
Seat 6: apfush ($112.78 in chips) 
Seat 7: r.pol218 ($59.81 in chips) 
Seat 8: kuanhung0903 ($72.48 in chips) 
Seat 9: xAndorx ($138.84 in chips) 
doppy 123577: posts small blind $0.50
Ouga Buga: posts big blind $1
*** HOLE CARDS ***
Dealt to matiko09 [5c 6h]
SumPosad: folds 
apfush: folds 
r.pol218 has timed out
r.pol218: folds 
kuanhung0903: folds 
xAndorx has timed out
xAndorx: folds 
matiko09: folds 
Sweden_Pound: raises $1 to $2
doppy 123577: folds 
Ouga Buga: folds 
Uncalled bet ($1) returned to Sweden_Pound
Sweden_Pound collected $2.50 from pot
Sweden_Pound: doesn't show hand 
*** SUMMARY ***
Total pot $2.50 | Rake $0 
Seat 1: matiko09 folded before Flop (didn't bet)
Seat 2: Sweden_Pound (button) collected ($2.50)
Seat 3: doppy 123577 (small blind) folded before Flop
Seat 4: Ouga Buga (big blind) folded before Flop
Seat 5: SumPosad folded before Flop (didn't bet)
Seat 6: apfush folded before Flop (didn't bet)
Seat 7: r.pol218 folded before Flop (didn't bet)
Seat 8: kuanhung0903 folded before Flop (didn't bet)
Seat 9: xAndorx folded before Flop (didn't bet)





PokerStars Hand #149393135641:  Hold'em Pot Limit ($0.50/$1.00 USD) - 2016/02/25 17:05:16 CET [2016/02/25 11:05:16 ET]
Table 'Tokai' 9-max Seat #1 is the button
Seat 1: matiko09 ($104.58 in chips) 
Seat 2: Priidix ($107.64 in chips) 
Seat 3: Ilov3NBA ($100 in chips) 
Seat 4: sebaaastian ($222.84 in chips) 
Seat 6: keaxu25 ($84.84 in chips) 
Seat 8: Wwwasian ($100 in chips) 
Seat 9: Lahesell ($108.77 in chips) 
Priidix: posts small blind $0.50
Ilov3NBA: posts big blind $1
simoniustin: sits out 
nickreason17: sits out 
*** HOLE CARDS ***
Dealt to matiko09 [Td Jc]
sebaaastian: folds 
keaxu25: calls $1
Wwwasian: raises $3 to $4
Lahesell: calls $4
matiko09: folds 
Priidix: folds 
Ilov3NBA: folds 
keaxu25: calls $3
*** FLOP *** [7s 9s 3s]
keaxu25: bets $6
Wwwasian: calls $6
Lahesell: folds 
*** TURN *** [7s 9s 3s] [9c]
keaxu25: bets $6
Wwwasian: calls $6
*** RIVER *** [7s 9s 3s 9c] [8s]
keaxu25: bets $24
Wwwasian: calls $24
*** SHOW DOWN ***
keaxu25: shows [9h 8c] (a full house, Nines full of Eights)
Wwwasian: mucks hand 
keaxu25 collected $82.70 from pot
*** SUMMARY ***
Total pot $85.50 | Rake $2.80 
Board [7s 9s 3s 9c 8s]
Seat 1: matiko09 (button) folded before Flop (didn't bet)
Seat 2: Priidix (small blind) folded before Flop
Seat 3: Ilov3NBA (big blind) folded before Flop
Seat 4: sebaaastian folded before Flop (didn't bet)
Seat 6: keaxu25 showed [9h 8c] and won ($82.70) with a full house, Nines full of Eights
Seat 8: Wwwasian mucked [Tc Ks]
Seat 9: Lahesell folded on the Flop





PokerStars Hand #149393145285:  Hold'em No Limit ($0.50/$1.00 USD) - 2016/02/25 17:05:28 CET [2016/02/25 11:05:28 ET]
Table 'Nerthus II' 9-max Seat #5 is the button
Seat 1: lysandrafly ($113.87 in chips) 
Seat 2: matiko09 ($184.51 in chips) 
Seat 4: Ilov3NBA ($100.12 in chips) 
Seat 5: Sweden_Pound ($225.11 in chips) 
Seat 6: mycka86 ($100 in chips) 
Seat 7: Venomous100% ($100 in chips) 
Seat 8: Kelvin sai ($71.75 in chips) 
mycka86: posts small blind $0.50
Venomous100%: posts big blind $1
simoniustin: sits out 
*** HOLE CARDS ***
Dealt to matiko09 [6c 2d]
Kelvin sai: raises $2 to $3
lysandrafly: folds 
matiko09: folds 
Ilov3NBA: folds 
Sweden_Pound: calls $3
mycka86: folds 
Venomous100%: folds 
*** FLOP *** [Td 6d 6h]
Kelvin sai: bets $5
Sweden_Pound: folds 
Uncalled bet ($5) returned to Kelvin sai
Kelvin sai collected $7.16 from pot
Kelvin sai: doesn't show hand 
*** SUMMARY ***
Total pot $7.50 | Rake $0.34 
Board [Td 6d 6h]
Seat 1: lysandrafly folded before Flop (didn't bet)
Seat 2: matiko09 folded before Flop (didn't bet)
Seat 4: Ilov3NBA folded before Flop (didn't bet)
Seat 5: Sweden_Pound (button) folded on the Flop
Seat 6: mycka86 (small blind) folded before Flop
Seat 7: Venomous100% (big blind) folded before Flop
Seat 8: Kelvin sai collected ($7.16)





PokerStars Hand #149393150102:  Hold'em No Limit ($0.25/$0.50 USD) - 2016/02/25 17:05:34 CET [2016/02/25 11:05:34 ET]
Table 'Lohja II' 9-max Seat #4 is the button
Seat 1: MoonJimmy ($141.43 in chips) 
Seat 2: Apparat888 ($47.20 in chips) 
Seat 4: payback11 ($50.58 in chips) 
Seat 5: 111STAVR111 ($50 in chips) 
Seat 6: xAndorx ($52.75 in chips) 
Seat 7: matiko09 ($157.68 in chips) 
Seat 8: jamba83 ($67.72 in chips) 
Seat 9: Al3xAnd3r22 ($99.15 in chips) 
111STAVR111: posts small blind $0.25
xAndorx: posts big blind $0.50
guvalc1952: sits out 
MoonJimmy: posts the ante $0.10
Apparat888: posts the ante $0.10
payback11: posts the ante $0.10
111STAVR111: posts the ante $0.10
xAndorx: posts the ante $0.10
matiko09: posts the ante $0.10
jamba83: posts the ante $0.10
Al3xAnd3r22: posts the ante $0.10
*** HOLE CARDS ***
Dealt to matiko09 [Jd Js]
matiko09: raises $1 to $1.50
jamba83: folds 
Al3xAnd3r22: folds 
MoonJimmy: folds 
Apparat888: folds 
payback11: folds 
111STAVR111: folds 
xAndorx: folds 
Uncalled bet ($1) returned to matiko09
matiko09 collected $2.05 from pot
matiko09: doesn't show hand 
*** SUMMARY ***
Total pot $2.05 | Rake $0 
Seat 1: MoonJimmy folded before Flop (didn't bet)
Seat 2: Apparat888 folded before Flop (didn't bet)
Seat 4: payback11 (button) folded before Flop (didn't bet)
Seat 5: 111STAVR111 (small blind) folded before Flop
Seat 6: xAndorx (big blind) folded before Flop
Seat 7: matiko09 collected ($2.05)
Seat 8: jamba83 folded before Flop (didn't bet)
Seat 9: Al3xAnd3r22 folded before Flop (didn't bet)





PokerStars Hand #149393151518:  Hold'em No Limit ($0.50/$1.00 USD) - 2016/02/25 17:05:36 CET [2016/02/25 11:05:36 ET]
Table 'Sabine' 9-max Seat #9 is the button
Seat 1: Aalleekks ($100 in chips) 
Seat 2: apfush ($100 in chips) 
Seat 3: Ouga Buga ($103 in chips) 
Seat 6: Sweden_Pound ($132.61 in chips) 
Seat 7: clayshmert ($70.36 in chips) 
Seat 8: matiko09 ($113.07 in chips) 
Seat 9: djammusic ($63.89 in chips) 
Aalleekks: posts small blind $0.50
apfush: posts big blind $1
*** HOLE CARDS ***
Dealt to matiko09 [Td Kc]
Ouga Buga: folds 
Sweden_Pound: folds 
clayshmert: calls $1
matiko09: raises $3 to $4
djammusic: folds 
Aalleekks: folds 
apfush: calls $3
clayshmert: raises $5 to $9
matiko09: folds 
apfush: calls $5
*** FLOP *** [Ac 6h 2c]
apfush: checks 
clayshmert: bets $10.74
apfush: folds 
Uncalled bet ($10.74) returned to clayshmert
clayshmert collected $21.49 from pot
*** SUMMARY ***
Total pot $22.50 | Rake $1.01 
Board [Ac 6h 2c]
Seat 1: Aalleekks (small blind) folded before Flop
Seat 2: apfush (big blind) folded on the Flop
Seat 3: Ouga Buga folded before Flop (didn't bet)
Seat 6: Sweden_Pound folded before Flop (didn't bet)
Seat 7: clayshmert collected ($21.49)
Seat 8: matiko09 folded before Flop
Seat 9: djammusic (button) folded before Flop (didn't bet)





PokerStars Hand #149393163118:  Hold'em No Limit ($0.50/$1.00 USD) - 2016/02/25 17:05:51 CET [2016/02/25 11:05:51 ET]
Table 'Ebella II' 9-max Seat #3 is the button
Seat 2: Sweden_Pound ($101 in chips) 
Seat 3: Lahesell ($131.34 in chips) 
Seat 4: djammusic ($41.45 in chips) 
Seat 5: matiko09 ($101.25 in chips) 
Seat 7: HomerrrJay ($100 in chips) 
Seat 8: ZMPOUTSAM140 ($72.71 in chips) 
Seat 9: simoniustin ($101.50 in chips) 
djammusic: posts small blind $0.50
matiko09: posts big blind $1
*** HOLE CARDS ***
Dealt to matiko09 [Jh Jc]
HomerrrJay: folds 
ZMPOUTSAM140: folds 
simoniustin: folds 
Sweden_Pound: folds 
Lahesell: folds 
djammusic: folds 
Uncalled bet ($0.50) returned to matiko09
matiko09 collected $1 from pot
matiko09: doesn't show hand 
*** SUMMARY ***
Total pot $1 | Rake $0 
Seat 2: Sweden_Pound folded before Flop (didn't bet)
Seat 3: Lahesell (button) folded before Flop (didn't bet)
Seat 4: djammusic (small blind) folded before Flop
Seat 5: matiko09 (big blind) collected ($1)
Seat 7: HomerrrJay folded before Flop (didn't bet)
Seat 8: ZMPOUTSAM140 folded before Flop (didn't bet)
Seat 9: simoniustin folded before Flop (didn't bet)





PokerStars Hand #149393169144:  Hold'em No Limit ($0.50/$1.00 USD) - 2016/02/25 17:05:59 CET [2016/02/25 11:05:59 ET]
Table 'Zeuxo II' 9-max Seat #5 is the button
Seat 1: forsmthgood ($113.79 in chips) 
Seat 2: Sweden_Pound ($109.53 in chips) 
Seat 3: xAndorx ($100 in chips) 
Seat 4: sebaaastian ($119.11 in chips) 
Seat 5: bauss84 ($36.20 in chips) 
Seat 6: Cogss ($105.17 in chips) 
Seat 7: djammusic ($44 in chips) 
Seat 8: matiko09 ($105.70 in chips) 
Seat 9: Sreshta222 ($209.80 in chips) 
Cogss: posts small blind $0.50
djammusic: posts big blind $1
*** HOLE CARDS ***
Dealt to matiko09 [Th 4h]
matiko09: folds 
Sreshta222: folds 
forsmthgood: folds 
Sweden_Pound: raises $2 to $3
xAndorx: folds 
sebaaastian: calls $3
bauss84 has timed out
bauss84: folds 
Cogss: calls $2.50
djammusic: folds 
*** FLOP *** [Td Ts 6d]
Cogss: checks 
bauss84 leaves the table
Sweden_Pound: bets $6.21
sebaaastian: folds 
Cogss: folds 
Uncalled bet ($6.21) returned to Sweden_Pound
Sweden_Pound collected $9.55 from pot
Sweden_Pound: doesn't show hand 
*** SUMMARY ***
Total pot $10 | Rake $0.45 
Board [Td Ts 6d]
Seat 1: forsmthgood folded before Flop (didn't bet)
Seat 2: Sweden_Pound collected ($9.55)
Seat 3: xAndorx folded before Flop (didn't bet)
Seat 4: sebaaastian folded on the Flop
Seat 5: bauss84 (button) folded before Flop (didn't bet)
Seat 6: Cogss (small blind) folded on the Flop
Seat 7: djammusic (big blind) folded before Flop
Seat 8: matiko09 folded before Flop (didn't bet)
Seat 9: Sreshta222 folded before Flop (didn't bet)





PokerStars Hand #149393171187:  Hold'em No Limit ($0.50/$1.00 USD) - 2016/02/25 17:06:01 CET [2016/02/25 11:06:01 ET]
Table 'Hercules IV' 9-max Seat #9 is the button
Seat 1: matiko09 ($100.50 in chips) 
Seat 3: HomerrrJay ($100 in chips) 
Seat 5: xAndorx ($161.08 in chips) 
Seat 6: kuanhung0903 ($51.49 in chips) 
Seat 7: Ouga Buga ($100 in chips) 
Seat 8: brokat77 ($132.11 in chips) 
Seat 9: djammusic ($35.18 in chips) 
matiko09: posts small blind $0.50
HomerrrJay: posts big blind $1
*** HOLE CARDS ***
Dealt to matiko09 [Ah Kd]
xAndorx: folds 
kuanhung0903: folds 
Ouga Buga: folds 
brokat77: calls $1
djammusic: folds 
matiko09: raises $4 to $5
HomerrrJay: folds 
brokat77: calls $4
*** FLOP *** [6h 6d 9s]
matiko09: checks 
brokat77: bets $5
matiko09: calls $5
*** TURN *** [6h 6d 9s] [Tc]
matiko09: checks 
brokat77: checks 
*** RIVER *** [6h 6d 9s Tc] [7h]
matiko09: checks 
brokat77: bets $10.03
matiko09: folds 
Uncalled bet ($10.03) returned to brokat77
brokat77 collected $20.06 from pot
brokat77: doesn't show hand 
*** SUMMARY ***
Total pot $21 | Rake $0.94 
Board [6h 6d 9s Tc 7h]
Seat 1: matiko09 (small blind) folded on the River
Seat 3: HomerrrJay (big blind) folded before Flop
Seat 5: xAndorx folded before Flop (didn't bet)
Seat 6: kuanhung0903 folded before Flop (didn't bet)
Seat 7: Ouga Buga folded before Flop (didn't bet)
Seat 8: brokat77 collected ($20.06)
Seat 9: djammusic (button) folded before Flop (didn't bet)





PokerStars Hand #149393172799:  Hold'em No Limit ($0.50/$1.00 USD) - 2016/02/25 17:06:04 CET [2016/02/25 11:06:04 ET]
Table 'Mayall II' 9-max Seat #3 is the button
Seat 1: matiko09 ($113.61 in chips) 
Seat 2: Sweden_Pound ($141.47 in chips) 
Seat 3: doppy 123577 ($85.69 in chips) 
Seat 4: Ouga Buga ($103.36 in chips) 
Seat 5: SumPosad ($77.45 in chips) 
Seat 6: apfush ($112.78 in chips) 
Seat 8: kuanhung0903 ($72.48 in chips) 
Seat 9: xAndorx ($138.84 in chips) 
Ouga Buga: posts small blind $0.50
SumPosad: posts big blind $1
*** HOLE CARDS ***
Dealt to matiko09 [5h Ac]
apfush: folds 
kuanhung0903: calls $1
xAndorx: folds 
matiko09: folds 
Sweden_Pound: folds 
doppy 123577: raises $2 to $3
Ouga Buga: folds 
SumPosad: folds 
kuanhung0903: calls $2
*** FLOP *** [8h 5s 3d]
kuanhung0903: checks 
doppy 123577: checks 
*** TURN *** [8h 5s 3d] [Qs]
kuanhung0903: checks 
doppy 123577: bets $4
kuanhung0903: folds 
Uncalled bet ($4) returned to doppy 123577
doppy 123577 collected $7.16 from pot
doppy 123577: doesn't show hand 
*** SUMMARY ***
Total pot $7.50 | Rake $0.34 
Board [8h 5s 3d Qs]
Seat 1: matiko09 folded before Flop (didn't bet)
Seat 2: Sweden_Pound folded before Flop (didn't bet)
Seat 3: doppy 123577 (button) collected ($7.16)
Seat 4: Ouga Buga (small blind) folded before Flop
Seat 5: SumPosad (big blind) folded before Flop
Seat 6: apfush folded before Flop (didn't bet)
Seat 8: kuanhung0903 folded on the Turn
Seat 9: xAndorx folded before Flop (didn't bet)





PokerStars Hand #149393173494:  Hold'em No Limit ($0.25/$0.50 USD) - 2016/02/25 17:06:04 CET [2016/02/25 11:06:04 ET]
Table 'Lohja II' 9-max Seat #5 is the button
Seat 1: MoonJimmy ($141.33 in chips) 
Seat 2: Apparat888 ($47.10 in chips) 
Seat 4: payback11 ($50.48 in chips) 
Seat 5: 111STAVR111 ($49.65 in chips) 
Seat 6: xAndorx ($52.15 in chips) 
Seat 7: matiko09 ($159.13 in chips) 
Seat 8: jamba83 ($67.62 in chips) 
Seat 9: Al3xAnd3r22 ($99.05 in chips) 
xAndorx: posts small blind $0.25
matiko09: posts big blind $0.50
guvalc1952: sits out 
MoonJimmy: posts the ante $0.10
Apparat888: posts the ante $0.10
payback11: posts the ante $0.10
111STAVR111: posts the ante $0.10
xAndorx: posts the ante $0.10
matiko09: posts the ante $0.10
jamba83: posts the ante $0.10
Al3xAnd3r22: posts the ante $0.10
*** HOLE CARDS ***
Dealt to matiko09 [9d 2s]
jamba83: raises $1 to $1.50
Al3xAnd3r22: folds 
MoonJimmy: folds 
Apparat888: folds 
payback11: folds 
111STAVR111: folds 
xAndorx: calls $1.25
matiko09: folds 
*** FLOP *** [8h Kh 8d]
xAndorx: checks 
jamba83: checks 
*** TURN *** [8h Kh 8d] [Qs]
xAndorx: bets $2.25
jamba83: folds 
Uncalled bet ($2.25) returned to xAndorx
xAndorx collected $4.11 from pot
xAndorx: doesn't show hand 
*** SUMMARY ***
Total pot $4.30 | Rake $0.19 
Board [8h Kh 8d Qs]
Seat 1: MoonJimmy folded before Flop (didn't bet)
Seat 2: Apparat888 folded before Flop (didn't bet)
Seat 4: payback11 folded before Flop (didn't bet)
Seat 5: 111STAVR111 (button) folded before Flop (didn't bet)
Seat 6: xAndorx (small blind) collected ($4.11)
Seat 7: matiko09 (big blind) folded before Flop
Seat 8: jamba83 folded on the Turn
Seat 9: Al3xAnd3r22 folded before Flop (didn't bet)





PokerStars Hand #149393179914:  Hold'em No Limit ($0.50/$1.00 USD) - 2016/02/25 17:06:13 CET [2016/02/25 11:06:13 ET]
Table 'Nerthus II' 9-max Seat #6 is the button
Seat 1: lysandrafly ($113.87 in chips) 
Seat 2: matiko09 ($184.51 in chips) 
Seat 4: Ilov3NBA ($100.12 in chips) 
Seat 5: Sweden_Pound ($222.11 in chips) 
Seat 6: mycka86 ($100 in chips) 
Seat 7: Venomous100% ($100 in chips) 
Seat 8: Kelvin sai ($75.91 in chips) 
Venomous100%: posts small blind $0.50
Kelvin sai: posts big blind $1
simoniustin: sits out 
*** HOLE CARDS ***
Dealt to matiko09 [Ah Qc]
lysandrafly: folds 
matiko09: raises $2 to $3
Ilov3NBA: folds 
Sweden_Pound: calls $3
mycka86: folds 
Venomous100%: folds 
Kelvin sai: calls $2
*** FLOP *** [4h 5d 5c]
Kelvin sai: checks 
matiko09: checks 
Sweden_Pound: bets $5.90
Kelvin sai: folds 
matiko09: calls $5.90
*** TURN *** [4h 5d 5c] [Ts]
matiko09: checks 
Sweden_Pound: checks 
*** RIVER *** [4h 5d 5c Ts] [2c]
matiko09: checks 
Sweden_Pound: checks 
*** SHOW DOWN ***
matiko09: shows [Ah Qc] (a pair of Fives)
Sweden_Pound: mucks hand 
matiko09 collected $20.34 from pot
*** SUMMARY ***
Total pot $21.30 | Rake $0.96 
Board [4h 5d 5c Ts 2c]
Seat 1: lysandrafly folded before Flop (didn't bet)
Seat 2: matiko09 showed [Ah Qc] and won ($20.34) with a pair of Fives
Seat 4: Ilov3NBA folded before Flop (didn't bet)
Seat 5: Sweden_Pound mucked [Jc Ad]
Seat 6: mycka86 (button) folded before Flop (didn't bet)
Seat 7: Venomous100% (small blind) folded before Flop
Seat 8: Kelvin sai (big blind) folded on the Flop





PokerStars Hand #149393183036:  Hold'em No Limit ($0.50/$1.00 USD) - 2016/02/25 17:06:17 CET [2016/02/25 11:06:17 ET]
Table 'Isa' 9-max Seat #5 is the button
Seat 1: matiko09 ($127.37 in chips) 
Seat 3: sebaaastian ($135.31 in chips) 
Seat 5: Sweden_Pound ($181.88 in chips) 
Seat 6: xAndorx ($100 in chips) 
Seat 7: bilukm ($160.68 in chips) 
Seat 8: Venomous100% ($100 in chips) 
xAndorx: posts small blind $0.50
bilukm: posts big blind $1
HomerrrJay: sits out 
mycka86: sits out 
*** HOLE CARDS ***
Dealt to matiko09 [4h Jh]
Venomous100%: raises $2 to $3
matiko09: folds 
sebaaastian: folds 
Sweden_Pound: folds 
xAndorx: folds 
bilukm: folds 
Uncalled bet ($2) returned to Venomous100%
Venomous100% collected $2.50 from pot
Venomous100%: doesn't show hand 
*** SUMMARY ***
Total pot $2.50 | Rake $0 
Seat 1: matiko09 folded before Flop (didn't bet)
Seat 3: sebaaastian folded before Flop (didn't bet)
Seat 5: Sweden_Pound (button) folded before Flop (didn't bet)
Seat 6: xAndorx (small blind) folded before Flop
Seat 7: bilukm (big blind) folded before Flop
Seat 8: Venomous100% collected ($2.50)





PokerStars Hand #149393187643:  Hold'em No Limit ($0.25/$0.50 USD) - 2016/02/25 17:06:23 CET [2016/02/25 11:06:23 ET]
Table 'Thalpius III' 9-max Seat #3 is the button
Seat 1: BrotherLove9 ($54.60 in chips) 
Seat 2: matiko09 ($63.56 in chips) 
Seat 3: jamba83 ($52.83 in chips) 
Seat 4: Wwwasian ($70.01 in chips) 
Seat 5: Al3xAnd3r22 ($51.71 in chips) 
Seat 7: v4n0v ($51.40 in chips) 
Seat 8: jeroemie123 ($57.72 in chips) 
Seat 9: Domotirko228 ($50 in chips) 
Wwwasian: posts small blind $0.25
Al3xAnd3r22: posts big blind $0.50
111STAVR111: sits out 
*** HOLE CARDS ***
Dealt to matiko09 [Ah 6c]
v4n0v: raises $1.22 to $1.72
jeroemie123: calls $1.72
Domotirko228: folds 
BrotherLove9: folds 
matiko09: folds 
jamba83: folds 
Wwwasian: folds 
Al3xAnd3r22: folds 
*** FLOP *** [3c 4c 5h]
v4n0v: checks 
jeroemie123: bets $2.50
v4n0v: folds 
Uncalled bet ($2.50) returned to jeroemie123
jeroemie123 collected $4 from pot
*** SUMMARY ***
Total pot $4.19 | Rake $0.19 
Board [3c 4c 5h]
Seat 1: BrotherLove9 folded before Flop (didn't bet)
Seat 2: matiko09 folded before Flop (didn't bet)
Seat 3: jamba83 (button) folded before Flop (didn't bet)
Seat 4: Wwwasian (small blind) folded before Flop
Seat 5: Al3xAnd3r22 (big blind) folded before Flop
Seat 7: v4n0v folded on the Flop
Seat 8: jeroemie123 collected ($4)
Seat 9: Domotirko228 folded before Flop (didn't bet)





PokerStars Hand #149393192585:  Hold'em No Limit ($0.50/$1.00 USD) - 2016/02/25 17:06:29 CET [2016/02/25 11:06:29 ET]
Table 'Ebella II' 9-max Seat #4 is the button
Seat 2: Sweden_Pound ($101 in chips) 
Seat 3: Lahesell ($131.34 in chips) 
Seat 4: djammusic ($40.95 in chips) 
Seat 5: matiko09 ($101.75 in chips) 
Seat 8: ZMPOUTSAM140 ($72.71 in chips) 
Seat 9: simoniustin ($101.50 in chips) 
matiko09: posts small blind $0.50
HomerrrJay: is sitting out 
ZMPOUTSAM140: posts big blind $1
*** HOLE CARDS ***
Dealt to matiko09 [6d Th]
HomerrrJay leaves the table
simoniustin: folds 
Sweden_Pound: folds 
Lahesell: folds 
djammusic: folds 
matiko09: folds 
Uncalled bet ($0.50) returned to ZMPOUTSAM140
ZMPOUTSAM140 collected $1 from pot
*** SUMMARY ***
Total pot $1 | Rake $0 
Seat 2: Sweden_Pound folded before Flop (didn't bet)
Seat 3: Lahesell folded before Flop (didn't bet)
Seat 4: djammusic (button) folded before Flop (didn't bet)
Seat 5: matiko09 (small blind) folded before Flop
Seat 8: ZMPOUTSAM140 (big blind) collected ($1)
Seat 9: simoniustin folded before Flop (didn't bet)





PokerStars Hand #149393198480:  Hold'em No Limit ($0.50/$1.00 USD) - 2016/02/25 17:06:37 CET [2016/02/25 11:06:37 ET]
Table 'Badenia II' 9-max Seat #1 is the button
Seat 1: matiko09 ($100 in chips) 
Seat 2: Stibitzkie ($76.81 in chips) 
Seat 3: sebaaastian ($126.34 in chips) 
Seat 5: djammusic ($120.59 in chips) 
Seat 6: xAndorx ($121.30 in chips) 
Seat 7: forsmthgood ($100 in chips) 
Seat 8: Sweden_Pound ($130.65 in chips) 
Seat 9: waisanen ($252.97 in chips) 
Stibitzkie: posts small blind $0.50
sebaaastian: posts big blind $1
*** HOLE CARDS ***
Dealt to matiko09 [Td 6c]
djammusic: folds 
xAndorx: folds 
forsmthgood: folds 
Sweden_Pound: raises $2 to $3
waisanen: calls $3
matiko09: folds 
Stibitzkie: calls $2.50
sebaaastian: folds 
*** FLOP *** [Jh 7d Kd]
Stibitzkie: checks 
Sweden_Pound: bets $6.21
waisanen: folds 
Stibitzkie: calls $6.21
*** TURN *** [Jh 7d Kd] [6h]
Stibitzkie: checks 
Sweden_Pound: checks 
*** RIVER *** [Jh 7d Kd 6h] [As]
Stibitzkie: checks 
Sweden_Pound: checks 
*** SHOW DOWN ***
Stibitzkie: shows [3s 3d] (a pair of Threes)
Sweden_Pound: shows [Ah Qd] (a pair of Aces)
Sweden_Pound collected $21.41 from pot
*** SUMMARY ***
Total pot $22.42 | Rake $1.01 
Board [Jh 7d Kd 6h As]
Seat 1: matiko09 (button) folded before Flop (didn't bet)
Seat 2: Stibitzkie (small blind) showed [3s 3d] and lost with a pair of Threes
Seat 3: sebaaastian (big blind) folded before Flop
Seat 5: djammusic folded before Flop (didn't bet)
Seat 6: xAndorx folded before Flop (didn't bet)
Seat 7: forsmthgood folded before Flop (didn't bet)
Seat 8: Sweden_Pound showed [Ah Qd] and won ($21.41) with a pair of Aces
Seat 9: waisanen folded on the Flop





PokerStars Hand #149393200396:  Hold'em No Limit ($0.50/$1.00 USD) - 2016/02/25 17:06:39 CET [2016/02/25 11:06:39 ET]
Table 'Isa' 9-max Seat #6 is the button
Seat 1: matiko09 ($127.37 in chips) 
Seat 3: sebaaastian ($135.31 in chips) 
Seat 5: Sweden_Pound ($181.88 in chips) 
Seat 6: xAndorx ($100 in chips) 
Seat 7: bilukm ($159.68 in chips) 
Seat 8: Venomous100% ($101.50 in chips) 
bilukm: posts small blind $0.50
Venomous100%: posts big blind $1
HomerrrJay: sits out 
mycka86: sits out 
*** HOLE CARDS ***
Dealt to matiko09 [6s 4s]
matiko09: folds 
sebaaastian: folds 
Sweden_Pound: folds 
xAndorx: raises $1 to $2
bilukm: calls $1.50
Venomous100%: folds 
*** FLOP *** [6d Jh 2s]
bilukm: bets $2.39
xAndorx: folds 
Uncalled bet ($2.39) returned to bilukm
bilukm collected $4.78 from pot
bilukm: doesn't show hand 
*** SUMMARY ***
Total pot $5 | Rake $0.22 
Board [6d Jh 2s]
Seat 1: matiko09 folded before Flop (didn't bet)
Seat 3: sebaaastian folded before Flop (didn't bet)
Seat 5: Sweden_Pound folded before Flop (didn't bet)
Seat 6: xAndorx (button) folded on the Flop
Seat 7: bilukm (small blind) collected ($4.78)
Seat 8: Venomous100% (big blind) folded before Flop





PokerStars Hand #149393202372:  Hold'em Pot Limit ($0.50/$1.00 USD) - 2016/02/25 17:06:42 CET [2016/02/25 11:06:42 ET]
Table 'Tokai' 9-max Seat #2 is the button
Seat 1: matiko09 ($104.58 in chips) 
Seat 2: Priidix ($107.14 in chips) 
Seat 3: Ilov3NBA ($100 in chips) 
Seat 4: sebaaastian ($222.84 in chips) 
Seat 6: keaxu25 ($127.54 in chips) 
Seat 8: Wwwasian ($100 in chips) 
Seat 9: Lahesell ($104.77 in chips) 
Ilov3NBA: posts small blind $0.50
sebaaastian: posts big blind $1
simoniustin: sits out 
nickreason17: sits out 
*** HOLE CARDS ***
Dealt to matiko09 [4c 6h]
keaxu25: calls $1
Wwwasian: folds 
Lahesell: folds 
matiko09: folds 
Priidix: raises $3.50 to $4.50
Ilov3NBA: folds 
sebaaastian: calls $3.50
keaxu25: folds 
*** FLOP *** [Jc Js 3c]
keaxu25 leaves the table
$-Twackle-$ joins the table at seat #6 
sebaaastian: checks 
Priidix: bets $5.21
sebaaastian: folds 
Uncalled bet ($5.21) returned to Priidix
Priidix collected $10.03 from pot
*** SUMMARY ***
Total pot $10.50 | Rake $0.47 
Board [Jc Js 3c]
Seat 1: matiko09 folded before Flop (didn't bet)
Seat 2: Priidix (button) collected ($10.03)
Seat 3: Ilov3NBA (small blind) folded before Flop
Seat 4: sebaaastian (big blind) folded on the Flop
Seat 6: keaxu25 folded before Flop
Seat 8: Wwwasian folded before Flop (didn't bet)
Seat 9: Lahesell folded before Flop (didn't bet)





PokerStars Hand #149393208088:  Hold'em No Limit ($0.50/$1.00 USD) - 2016/02/25 17:06:49 CET [2016/02/25 11:06:49 ET]
Table 'Sabine' 9-max Seat #1 is the button
Seat 1: Aalleekks ($100 in chips) 
Seat 2: apfush ($100 in chips) 
Seat 3: Ouga Buga ($103 in chips) 
Seat 6: Sweden_Pound ($132.61 in chips) 
Seat 7: clayshmert ($82.85 in chips) 
Seat 8: matiko09 ($109.07 in chips) 
Seat 9: djammusic ($63.89 in chips) 
apfush: posts small blind $0.50
Ouga Buga: posts big blind $1
*** HOLE CARDS ***
Dealt to matiko09 [8d Ks]
Sweden_Pound: folds 
clayshmert: calls $1
matiko09: folds 
djammusic: folds 
Aalleekks: folds 
apfush: folds 
Ouga Buga: checks 
*** FLOP *** [Th 8h Tc]
Ouga Buga: checks 
clayshmert: bets $2
Ouga Buga: folds 
Uncalled bet ($2) returned to clayshmert
clayshmert collected $2.39 from pot
*** SUMMARY ***
Total pot $2.50 | Rake $0.11 
Board [Th 8h Tc]
Seat 1: Aalleekks (button) folded before Flop (didn't bet)
Seat 2: apfush (small blind) folded before Flop
Seat 3: Ouga Buga (big blind) folded on the Flop
Seat 6: Sweden_Pound folded before Flop (didn't bet)
Seat 7: clayshmert collected ($2.39)
Seat 8: matiko09 folded before Flop (didn't bet)
Seat 9: djammusic folded before Flop (didn't bet)





PokerStars Hand #149393210593:  Hold'em No Limit ($0.50/$1.00 USD) - 2016/02/25 17:06:52 CET [2016/02/25 11:06:52 ET]
Table 'Ebella II' 9-max Seat #5 is the button
Seat 2: Sweden_Pound ($101 in chips) 
Seat 3: Lahesell ($131.34 in chips) 
Seat 4: djammusic ($40.95 in chips) 
Seat 5: matiko09 ($101.25 in chips) 
Seat 8: ZMPOUTSAM140 ($73.21 in chips) 
Seat 9: simoniustin ($101.50 in chips) 
ZMPOUTSAM140: posts small blind $0.50
simoniustin: posts big blind $1
*** HOLE CARDS ***
Dealt to matiko09 [Qc 2c]
Sweden_Pound: folds 
Lahesell: raises $2 to $3
djammusic: folds 
matiko09: folds 
ZMPOUTSAM140: raises $7 to $10
Aalleekks joins the table at seat #7 
simoniustin: folds 
Lahesell: folds 
Uncalled bet ($7) returned to ZMPOUTSAM140
ZMPOUTSAM140 collected $7 from pot
*** SUMMARY ***
Total pot $7 | Rake $0 
Seat 2: Sweden_Pound folded before Flop (didn't bet)
Seat 3: Lahesell folded before Flop
Seat 4: djammusic folded before Flop (didn't bet)
Seat 5: matiko09 (button) folded before Flop (didn't bet)
Seat 8: ZMPOUTSAM140 (small blind) collected ($7)
Seat 9: simoniustin (big blind) folded before Flop





PokerStars Hand #149393223294:  Hold'em No Limit ($0.50/$1.00 USD) - 2016/02/25 17:07:09 CET [2016/02/25 11:07:09 ET]
Table 'Mayall II' 9-max Seat #4 is the button
Seat 1: matiko09 ($113.61 in chips) 
Seat 2: Sweden_Pound ($141.47 in chips) 
Seat 3: doppy 123577 ($89.85 in chips) 
Seat 4: Ouga Buga ($102.86 in chips) 
Seat 5: SumPosad ($76.45 in chips) 
Seat 6: apfush ($112.78 in chips) 
Seat 8: kuanhung0903 ($69.48 in chips) 
Seat 9: xAndorx ($138.84 in chips) 
SumPosad: posts small blind $0.50
apfush: posts big blind $1
*** HOLE CARDS ***
Dealt to matiko09 [5s 7c]
kuanhung0903: folds 
xAndorx: folds 
matiko09: folds 
Sweden_Pound: folds 
doppy 123577: folds 
Ouga Buga: folds 
SumPosad: folds 
Uncalled bet ($0.50) returned to apfush
apfush collected $1 from pot
apfush: doesn't show hand 
*** SUMMARY ***
Total pot $1 | Rake $0 
Seat 1: matiko09 folded before Flop (didn't bet)
Seat 2: Sweden_Pound folded before Flop (didn't bet)
Seat 3: doppy 123577 folded before Flop (didn't bet)
Seat 4: Ouga Buga (button) folded before Flop (didn't bet)
Seat 5: SumPosad (small blind) folded before Flop
Seat 6: apfush (big blind) collected ($1)
Seat 8: kuanhung0903 folded before Flop (didn't bet)
Seat 9: xAndorx folded before Flop (didn't bet)





PokerStars Hand #149393234631:  Hold'em No Limit ($0.50/$1.00 USD) - 2016/02/25 17:07:23 CET [2016/02/25 11:07:23 ET]
Table 'Isa' 9-max Seat #7 is the button
Seat 1: matiko09 ($127.37 in chips) 
Seat 3: sebaaastian ($135.31 in chips) 
Seat 5: Sweden_Pound ($181.88 in chips) 
Seat 6: xAndorx ($100 in chips) 
Seat 7: bilukm ($162.46 in chips) 
Seat 8: Venomous100% ($100.50 in chips) 
Seat 9: HomerrrJay ($100 in chips) 
Venomous100%: posts small blind $0.50
HomerrrJay: posts big blind $1
mycka86: sits out 
*** HOLE CARDS ***
Dealt to matiko09 [Qh Qc]
matiko09: raises $2 to $3
sebaaastian: folds 
Sweden_Pound: folds 
xAndorx: folds 
bilukm: folds 
Venomous100%: folds 
HomerrrJay: folds 
Uncalled bet ($2) returned to matiko09
matiko09 collected $2.50 from pot
matiko09: doesn't show hand 
*** SUMMARY ***
Total pot $2.50 | Rake $0 
Seat 1: matiko09 collected ($2.50)
Seat 3: sebaaastian folded before Flop (didn't bet)
Seat 5: Sweden_Pound folded before Flop (didn't bet)
Seat 6: xAndorx folded before Flop (didn't bet)
Seat 7: bilukm (button) folded before Flop (didn't bet)
Seat 8: Venomous100% (small blind) folded before Flop
Seat 9: HomerrrJay (big blind) folded before Flop





PokerStars Hand #149393236075:  Hold'em No Limit ($0.25/$0.50 USD) - 2016/02/25 17:07:25 CET [2016/02/25 11:07:25 ET]
Table 'Lohja II' 9-max Seat #6 is the button
Seat 1: MoonJimmy ($141.23 in chips) 
Seat 2: Apparat888 ($47 in chips) 
Seat 4: payback11 ($50.38 in chips) 
Seat 5: 111STAVR111 ($49.55 in chips) 
Seat 6: xAndorx ($54.66 in chips) 
Seat 7: matiko09 ($158.53 in chips) 
Seat 8: jamba83 ($66.02 in chips) 
Seat 9: Al3xAnd3r22 ($98.95 in chips) 
matiko09: posts small blind $0.25
jamba83: posts big blind $0.50
guvalc1952: sits out 
MoonJimmy: posts the ante $0.10
Apparat888: posts the ante $0.10
payback11: posts the ante $0.10
111STAVR111: posts the ante $0.10
xAndorx: posts the ante $0.10
matiko09: posts the ante $0.10
jamba83: posts the ante $0.10
Al3xAnd3r22: posts the ante $0.10
*** HOLE CARDS ***
Dealt to matiko09 [Th 4d]
Al3xAnd3r22: folds 
MoonJimmy: folds 
Apparat888: folds 
payback11: folds 
111STAVR111: raises $1 to $1.50
xAndorx: raises $3 to $4.50
matiko09: folds 
jamba83: folds 
111STAVR111: calls $3
*** FLOP *** [2c Kd 8h]
111STAVR111: checks 
xAndorx: bets $5.25
111STAVR111: folds 
Uncalled bet ($5.25) returned to xAndorx
xAndorx collected $10.08 from pot
xAndorx: doesn't show hand 
*** SUMMARY ***
Total pot $10.55 | Rake $0.47 
Board [2c Kd 8h]
Seat 1: MoonJimmy folded before Flop (didn't bet)
Seat 2: Apparat888 folded before Flop (didn't bet)
Seat 4: payback11 folded before Flop (didn't bet)
Seat 5: 111STAVR111 folded on the Flop
Seat 6: xAndorx (button) collected ($10.08)
Seat 7: matiko09 (small blind) folded before Flop
Seat 8: jamba83 (big blind) folded before Flop
Seat 9: Al3xAnd3r22 folded before Flop (didn't bet)





PokerStars Hand #149393236361:  Hold'em No Limit ($0.50/$1.00 USD) - 2016/02/25 17:07:25 CET [2016/02/25 11:07:25 ET]
Table 'Ebella II' 9-max Seat #8 is the button
Seat 1: nickreason17 ($100 in chips) 
Seat 2: Sweden_Pound ($101 in chips) 
Seat 3: Lahesell ($128.34 in chips) 
Seat 4: djammusic ($40.95 in chips) 
Seat 5: matiko09 ($101.25 in chips) 
Seat 8: ZMPOUTSAM140 ($77.21 in chips) 
Seat 9: simoniustin ($100.50 in chips) 
simoniustin: posts small blind $0.50
nickreason17: posts big blind $1
Aalleekks: sits out 
*** HOLE CARDS ***
Dealt to matiko09 [5s 8s]
Aalleekks leaves the table
$-Twackle-$ joins the table at seat #7 
Sweden_Pound: folds 
Lahesell: folds 
djammusic: folds 
matiko09: folds 
ZMPOUTSAM140: raises $2 to $3
simoniustin: folds 
nickreason17: calls $2
*** FLOP *** [Ts 7d Qd]
nickreason17: checks 
ZMPOUTSAM140: bets $3.10
nickreason17: calls $3.10
*** TURN *** [Ts 7d Qd] [Th]
nickreason17: checks 
ZMPOUTSAM140: checks 
*** RIVER *** [Ts 7d Qd Th] [Jh]
nickreason17: bets $6
RMilPoker leaves the table
Aalleekks joins the table at seat #6 
ZMPOUTSAM140: calls $6
*** SHOW DOWN ***
nickreason17: shows [As 3s] (a pair of Tens)
ZMPOUTSAM140: shows [6c Qs] (two pair, Queens and Tens)
ZMPOUTSAM140 collected $23.59 from pot
*** SUMMARY ***
Total pot $24.70 | Rake $1.11 
Board [Ts 7d Qd Th Jh]
Seat 1: nickreason17 (big blind) showed [As 3s] and lost with a pair of Tens
Seat 2: Sweden_Pound folded before Flop (didn't bet)
Seat 3: Lahesell folded before Flop (didn't bet)
Seat 4: djammusic folded before Flop (didn't bet)
Seat 5: matiko09 folded before Flop (didn't bet)
Seat 8: ZMPOUTSAM140 (button) showed [6c Qs] and won ($23.59) with two pair, Queens and Tens
Seat 9: simoniustin (small blind) folded before Flop





PokerStars Hand #149393244416:  Hold'em No Limit ($0.50/$1.00 USD) - 2016/02/25 17:07:36 CET [2016/02/25 11:07:36 ET]
Table 'Sabine' 9-max Seat #2 is the button
Seat 1: Aalleekks ($100 in chips) 
Seat 2: apfush ($100 in chips) 
Seat 3: Ouga Buga ($102 in chips) 
Seat 7: clayshmert ($84.24 in chips) 
Seat 8: matiko09 ($109.07 in chips) 
Seat 9: djammusic ($63.89 in chips) 
Ouga Buga: posts small blind $0.50
Sweden_Pound: is sitting out 
Sweden_Pound leaves the table
clayshmert: posts big blind $1
*** HOLE CARDS ***
Dealt to matiko09 [Ac 4d]
matiko09: folds 
djammusic: raises $1.50 to $2.50
Aalleekks: folds 
ffac joins the table at seat #6 
apfush: raises $4.50 to $7
Ouga Buga: folds 
clayshmert: calls $6
djammusic: folds 
*** FLOP *** [7d 2s 3h]
clayshmert: checks 
RMilPoker leaves the table
apfush: bets $9.50
clayshmert: calls $9.50
*** TURN *** [7d 2s 3h] [5d]
clayshmert: checks 
apfush: checks 
*** RIVER *** [7d 2s 3h 5d] [3d]
clayshmert: checks 
apfush: bets $18.50
clayshmert: calls $18.50
*** SHOW DOWN ***
apfush: shows [8d Ad] (a flush, Ace high)
clayshmert: mucks hand 
apfush collected $70.20 from pot
*** SUMMARY ***
Total pot $73 | Rake $2.80 
Board [7d 2s 3h 5d 3d]
Seat 1: Aalleekks folded before Flop (didn't bet)
Seat 2: apfush (button) showed [8d Ad] and won ($70.20) with a flush, Ace high
Seat 3: Ouga Buga (small blind) folded before Flop
Seat 7: clayshmert (big blind) mucked [8h 7h]
Seat 8: matiko09 folded before Flop (didn't bet)
Seat 9: djammusic folded before Flop





PokerStars Hand #149393245304:  Hold'em No Limit ($0.50/$1.00 USD) - 2016/02/25 17:07:37 CET [2016/02/25 11:07:37 ET]
Table 'Zeuxo II' 9-max Seat #6 is the button
Seat 1: forsmthgood ($113.79 in chips) 
Seat 2: Sweden_Pound ($116.08 in chips) 
Seat 3: xAndorx ($100 in chips) 
Seat 4: sebaaastian ($116.11 in chips) 
Seat 6: Cogss ($102.17 in chips) 
Seat 7: djammusic ($43 in chips) 
Seat 8: matiko09 ($105.70 in chips) 
Seat 9: Sreshta222 ($209.80 in chips) 
djammusic: posts small blind $0.50
matiko09: posts big blind $1
*** HOLE CARDS ***
Dealt to matiko09 [5c Jh]
Sreshta222: folds 
forsmthgood: raises $2 to $3
Sweden_Pound: folds 
xAndorx: folds 
sebaaastian: folds 
Cogss: folds 
djammusic: folds 
matiko09: folds 
Uncalled bet ($2) returned to forsmthgood
forsmthgood collected $2.50 from pot
forsmthgood: doesn't show hand 
*** SUMMARY ***
Total pot $2.50 | Rake $0 
Seat 1: forsmthgood collected ($2.50)
Seat 2: Sweden_Pound folded before Flop (didn't bet)
Seat 3: xAndorx folded before Flop (didn't bet)
Seat 4: sebaaastian folded before Flop (didn't bet)
Seat 6: Cogss (button) folded before Flop (didn't bet)
Seat 7: djammusic (small blind) folded before Flop
Seat 8: matiko09 (big blind) folded before Flop
Seat 9: Sreshta222 folded before Flop (didn't bet)





PokerStars Hand #149393250009:  Hold'em No Limit ($0.50/$1.00 USD) - 2016/02/25 17:07:43 CET [2016/02/25 11:07:43 ET]
Table 'Mayall II' 9-max Seat #5 is the button
Seat 1: matiko09 ($113.61 in chips) 
Seat 2: Sweden_Pound ($141.47 in chips) 
Seat 3: doppy 123577 ($89.85 in chips) 
Seat 4: Ouga Buga ($102.86 in chips) 
Seat 5: SumPosad ($75.95 in chips) 
Seat 6: apfush ($113.28 in chips) 
Seat 8: kuanhung0903 ($69.48 in chips) 
Seat 9: xAndorx ($138.84 in chips) 
apfush: posts small blind $0.50
kuanhung0903: posts big blind $1
*** HOLE CARDS ***
Dealt to matiko09 [Qs 7s]
xAndorx: folds 
matiko09: folds 
Sweden_Pound: folds 
doppy 123577: folds 
Ouga Buga: raises $1.50 to $2.50
SumPosad: calls $2.50
apfush: folds 
kuanhung0903: folds 
*** FLOP *** [7h Td 6c]
Ouga Buga: checks 
SumPosad: bets $5
Ouga Buga: calls $5
*** TURN *** [7h Td 6c] [Qd]
Ouga Buga: checks 
SumPosad: checks 
*** RIVER *** [7h Td 6c Qd] [4d]
Ouga Buga: checks 
SumPosad: checks 
*** SHOW DOWN ***
Ouga Buga: shows [Tc Ah] (a pair of Tens)
SumPosad: mucks hand 
Ouga Buga collected $15.76 from pot
*** SUMMARY ***
Total pot $16.50 | Rake $0.74 
Board [7h Td 6c Qd 4d]
Seat 1: matiko09 folded before Flop (didn't bet)
Seat 2: Sweden_Pound folded before Flop (didn't bet)
Seat 3: doppy 123577 folded before Flop (didn't bet)
Seat 4: Ouga Buga showed [Tc Ah] and won ($15.76) with a pair of Tens
Seat 5: SumPosad (button) mucked [3h 3d]
Seat 6: apfush (small blind) folded before Flop
Seat 8: kuanhung0903 (big blind) folded before Flop
Seat 9: xAndorx folded before Flop (didn't bet)





PokerStars Hand #149393251005:  Hold'em No Limit ($0.50/$1.00 USD) - 2016/02/25 17:07:44 CET [2016/02/25 11:07:44 ET]
Table 'Nerthus II' 9-max Seat #7 is the button
Seat 2: matiko09 ($195.95 in chips) 
Seat 4: Ilov3NBA ($100.12 in chips) 
Seat 5: Sweden_Pound ($213.21 in chips) 
Seat 6: mycka86 ($100 in chips) 
Seat 7: Venomous100% ($100 in chips) 
Seat 8: Kelvin sai ($72.91 in chips) 
Kelvin sai: posts small blind $0.50
lysandrafly: is sitting out 
matiko09: posts big blind $1
lysandrafly leaves the table
simoniustin: sits out 
*** HOLE CARDS ***
Dealt to matiko09 [8h Kd]
DUkalisUA joins the table at seat #1 
Ilov3NBA: folds 
Sweden_Pound: raises $2 to $3
mycka86: folds 
Venomous100%: folds 
Kelvin sai: calls $2.50
matiko09: folds 
*** FLOP *** [2d Ac Ad]
Kelvin sai: bets $3
Sweden_Pound: calls $3
*** TURN *** [2d Ac Ad] [Js]
Kelvin sai: checks 
Sweden_Pound: checks 
*** RIVER *** [2d Ac Ad Js] [4d]
Kelvin sai: checks 
Sweden_Pound: bets $8.07
Kelvin sai: folds 
Uncalled bet ($8.07) returned to Sweden_Pound
Sweden_Pound collected $12.42 from pot
Sweden_Pound: doesn't show hand 
*** SUMMARY ***
Total pot $13 | Rake $0.58 
Board [2d Ac Ad Js 4d]
Seat 2: matiko09 (big blind) folded before Flop
Seat 4: Ilov3NBA folded before Flop (didn't bet)
Seat 5: Sweden_Pound collected ($12.42)
Seat 6: mycka86 folded before Flop (didn't bet)
Seat 7: Venomous100% (button) folded before Flop (didn't bet)
Seat 8: Kelvin sai (small blind) folded on the River





PokerStars Hand #149393256447:  Hold'em No Limit ($0.25/$0.50 USD) - 2016/02/25 17:07:51 CET [2016/02/25 11:07:51 ET]
Table 'Thalpius III' 9-max Seat #4 is the button
Seat 1: BrotherLove9 ($54.60 in chips) 
Seat 2: matiko09 ($63.56 in chips) 
Seat 3: jamba83 ($52.83 in chips) 
Seat 4: Wwwasian ($69.76 in chips) 
Seat 5: Al3xAnd3r22 ($51.21 in chips) 
Seat 6: 111STAVR111 ($50 in chips) 
Seat 7: v4n0v ($50 in chips) 
Seat 8: jeroemie123 ($60 in chips) 
Seat 9: Domotirko228 ($50 in chips) 
Al3xAnd3r22: posts small blind $0.25
111STAVR111: posts big blind $0.50
*** HOLE CARDS ***
Dealt to matiko09 [Td 7c]
v4n0v: folds 
jeroemie123: folds 
Domotirko228: folds 
BrotherLove9: folds 
matiko09: folds 
jamba83: folds 
Wwwasian: raises $0.50 to $1
Al3xAnd3r22: folds 
111STAVR111: folds 
Uncalled bet ($0.50) returned to Wwwasian
Wwwasian collected $1.25 from pot
Wwwasian: doesn't show hand 
*** SUMMARY ***
Total pot $1.25 | Rake $0 
Seat 1: BrotherLove9 folded before Flop (didn't bet)
Seat 2: matiko09 folded before Flop (didn't bet)
Seat 3: jamba83 folded before Flop (didn't bet)
Seat 4: Wwwasian (button) collected ($1.25)
Seat 5: Al3xAnd3r22 (small blind) folded before Flop
Seat 6: 111STAVR111 (big blind) folded before Flop
Seat 7: v4n0v folded before Flop (didn't bet)
Seat 8: jeroemie123 folded before Flop (didn't bet)
Seat 9: Domotirko228 folded before Flop (didn't bet)





PokerStars Hand #149393256942:  Hold'em No Limit ($0.50/$1.00 USD) - 2016/02/25 17:07:52 CET [2016/02/25 11:07:52 ET]
Table 'Isa' 9-max Seat #8 is the button
Seat 1: matiko09 ($128.87 in chips) 
Seat 3: sebaaastian ($135.31 in chips) 
Seat 5: Sweden_Pound ($181.88 in chips) 
Seat 6: xAndorx ($100 in chips) 
Seat 7: bilukm ($162.46 in chips) 
Seat 8: Venomous100% ($100 in chips) 
Seat 9: HomerrrJay ($100 in chips) 
HomerrrJay: posts small blind $0.50
matiko09: posts big blind $1
mycka86: sits out 
*** HOLE CARDS ***
Dealt to matiko09 [Ac 9d]
sebaaastian: folds 
Sweden_Pound: raises $2 to $3
xAndorx: calls $3
bilukm: folds 
Venomous100%: folds 
HomerrrJay: folds 
matiko09: folds 
*** FLOP *** [6h 3d 7c]
Sweden_Pound: checks 
xAndorx: bets $4
Sweden_Pound: folds 
Uncalled bet ($4) returned to xAndorx
xAndorx collected $7.16 from pot
xAndorx: doesn't show hand 
*** SUMMARY ***
Total pot $7.50 | Rake $0.34 
Board [6h 3d 7c]
Seat 1: matiko09 (big blind) folded before Flop
Seat 3: sebaaastian folded before Flop (didn't bet)
Seat 5: Sweden_Pound folded on the Flop
Seat 6: xAndorx collected ($7.16)
Seat 7: bilukm folded before Flop (didn't bet)
Seat 8: Venomous100% (button) folded before Flop (didn't bet)
Seat 9: HomerrrJay (small blind) folded before Flop





PokerStars Hand #149393257610:  Hold'em Pot Limit ($0.50/$1.00 USD) - 2016/02/25 17:07:52 CET [2016/02/25 11:07:52 ET]
Table 'Tokai' 9-max Seat #3 is the button
Seat 1: matiko09 ($104.58 in chips) 
Seat 2: Priidix ($112.67 in chips) 
Seat 3: Ilov3NBA ($100 in chips) 
Seat 4: sebaaastian ($218.34 in chips) 
Seat 5: simoniustin ($100 in chips) 
Seat 8: Wwwasian ($100 in chips) 
Seat 9: Lahesell ($104.77 in chips) 
sebaaastian: posts small blind $0.50
simoniustin: posts big blind $1
nickreason17: sits out 
*** HOLE CARDS ***
Dealt to matiko09 [5c 7d]
Wwwasian: raises $1.80 to $2.80
Lahesell: folds 
matiko09: folds 
Priidix: folds 
Ilov3NBA: raises $5.70 to $8.50
sebaaastian: folds 
simoniustin: folds 
Wwwasian: folds 
Uncalled bet ($5.70) returned to Ilov3NBA
Ilov3NBA collected $7.10 from pot
Ilov3NBA: doesn't show hand 
*** SUMMARY ***
Total pot $7.10 | Rake $0 
Seat 1: matiko09 folded before Flop (didn't bet)
Seat 2: Priidix folded before Flop (didn't bet)
Seat 3: Ilov3NBA (button) collected ($7.10)
Seat 4: sebaaastian (small blind) folded before Flop
Seat 5: simoniustin (big blind) folded before Flop
Seat 8: Wwwasian folded before Flop
Seat 9: Lahesell folded before Flop (didn't bet)





PokerStars Hand #149393270348:  Hold'em No Limit ($0.50/$1.00 USD) - 2016/02/25 17:08:09 CET [2016/02/25 11:08:09 ET]
Table 'Zeuxo II' 9-max Seat #7 is the button
Seat 1: forsmthgood ($115.29 in chips) 
Seat 2: Sweden_Pound ($116.08 in chips) 
Seat 3: xAndorx ($100 in chips) 
Seat 4: sebaaastian ($116.11 in chips) 
Seat 6: Cogss ($102.17 in chips) 
Seat 7: djammusic ($42.50 in chips) 
Seat 8: matiko09 ($104.70 in chips) 
Seat 9: Sreshta222 ($209.80 in chips) 
matiko09: posts small blind $0.50
Sreshta222: posts big blind $1
*** HOLE CARDS ***
Dealt to matiko09 [6s 2c]
forsmthgood: folds 
Sweden_Pound: folds 
xAndorx: folds 
sebaaastian: folds 
Cogss: folds 
djammusic: raises $1.02 to $2.02
matiko09: folds 
Sreshta222: folds 
Uncalled bet ($1.02) returned to djammusic
djammusic collected $2.50 from pot
djammusic: doesn't show hand 
*** SUMMARY ***
Total pot $2.50 | Rake $0 
Seat 1: forsmthgood folded before Flop (didn't bet)
Seat 2: Sweden_Pound folded before Flop (didn't bet)
Seat 3: xAndorx folded before Flop (didn't bet)
Seat 4: sebaaastian folded before Flop (didn't bet)
Seat 6: Cogss folded before Flop (didn't bet)
Seat 7: djammusic (button) collected ($2.50)
Seat 8: matiko09 (small blind) folded before Flop
Seat 9: Sreshta222 (big blind) folded before Flop





PokerStars Hand #149393272145:  Hold'em No Limit ($0.50/$1.00 USD) - 2016/02/25 17:08:11 CET [2016/02/25 11:08:11 ET]
Table 'Hercules IV' 9-max Seat #1 is the button
Seat 1: matiko09 ($100 in chips) 
Seat 3: HomerrrJay ($100 in chips) 
Seat 4: Sweden_Pound ($101.50 in chips) 
Seat 5: xAndorx ($161.08 in chips) 
Seat 6: kuanhung0903 ($51.49 in chips) 
Seat 7: Ouga Buga ($100 in chips) 
Seat 8: brokat77 ($142.17 in chips) 
Seat 9: djammusic ($35.18 in chips) 
HomerrrJay: posts small blind $0.50
Sweden_Pound: posts big blind $1
*** HOLE CARDS ***
Dealt to matiko09 [Qc 9s]
xAndorx: folds 
kuanhung0903: folds 
Ouga Buga: folds 
brokat77: folds 
djammusic: folds 
matiko09: raises $2 to $3
HomerrrJay: folds 
Sweden_Pound: folds 
Uncalled bet ($2) returned to matiko09
matiko09 collected $2.50 from pot
matiko09: doesn't show hand 
*** SUMMARY ***
Total pot $2.50 | Rake $0 
Seat 1: matiko09 (button) collected ($2.50)
Seat 3: HomerrrJay (small blind) folded before Flop
Seat 4: Sweden_Pound (big blind) folded before Flop
Seat 5: xAndorx folded before Flop (didn't bet)
Seat 6: kuanhung0903 folded before Flop (didn't bet)
Seat 7: Ouga Buga folded before Flop (didn't bet)
Seat 8: brokat77 folded before Flop (didn't bet)
Seat 9: djammusic folded before Flop (didn't bet)





PokerStars Hand #149393283480:  Hold'em No Limit ($0.50/$1.00 USD) - 2016/02/25 17:08:26 CET [2016/02/25 11:08:26 ET]
Table 'Ebella II' 9-max Seat #9 is the button
Seat 1: nickreason17 ($100 in chips) 
Seat 2: Sweden_Pound ($101 in chips) 
Seat 3: Lahesell ($128.34 in chips) 
Seat 4: djammusic ($40.95 in chips) 
Seat 5: matiko09 ($101.25 in chips) 
Seat 8: ZMPOUTSAM140 ($88.70 in chips) 
Seat 9: simoniustin ($100 in chips) 
nickreason17: posts small blind $0.50
Sweden_Pound: posts big blind $1
Aalleekks: sits out 
*** HOLE CARDS ***
Dealt to matiko09 [Tc Js]
Lahesell: folds 
djammusic: folds 
matiko09: folds 
ZMPOUTSAM140: folds 
simoniustin: folds 
nickreason17: raises $1.04 to $2.04
Sweden_Pound: folds 
Uncalled bet ($1.04) returned to nickreason17
nickreason17 collected $2 from pot
*** SUMMARY ***
Total pot $2 | Rake $0 
Seat 1: nickreason17 (small blind) collected ($2)
Seat 2: Sweden_Pound (big blind) folded before Flop
Seat 3: Lahesell folded before Flop (didn't bet)
Seat 4: djammusic folded before Flop (didn't bet)
Seat 5: matiko09 folded before Flop (didn't bet)
Seat 8: ZMPOUTSAM140 folded before Flop (didn't bet)
Seat 9: simoniustin (button) folded before Flop (didn't bet)





PokerStars Hand #149393285502:  Hold'em Pot Limit ($0.50/$1.00 USD) - 2016/02/25 17:08:28 CET [2016/02/25 11:08:28 ET]
Table 'Tokai' 9-max Seat #4 is the button
Seat 1: matiko09 ($104.58 in chips) 
Seat 2: Priidix ($112.67 in chips) 
Seat 3: Ilov3NBA ($104.30 in chips) 
Seat 4: sebaaastian ($217.84 in chips) 
Seat 5: simoniustin ($100 in chips) 
Seat 7: nickreason17 ($100 in chips) 
Seat 8: Wwwasian ($100 in chips) 
Seat 9: Lahesell ($104.77 in chips) 
simoniustin: posts small blind $0.50
nickreason17: posts big blind $1
*** HOLE CARDS ***
Dealt to matiko09 [6d 3s]
Wwwasian: folds 
Lahesell: folds 
matiko09: folds 
Wwwasian leaves the table
Priidix: folds 
Ilov3NBA: folds 
Lahesell leaves the table
sebaaastian: folds 
simoniustin: folds 
Uncalled bet ($0.50) returned to nickreason17
nickreason17 collected $1 from pot
*** SUMMARY ***
Total pot $1 | Rake $0 
Seat 1: matiko09 folded before Flop (didn't bet)
Seat 2: Priidix folded before Flop (didn't bet)
Seat 3: Ilov3NBA folded before Flop (didn't bet)
Seat 4: sebaaastian (button) folded before Flop (didn't bet)
Seat 5: simoniustin (small blind) folded before Flop
Seat 7: nickreason17 (big blind) collected ($1)
Seat 8: Wwwasian folded before Flop (didn't bet)
Seat 9: Lahesell folded before Flop (didn't bet)





PokerStars Hand #149393285446:  Hold'em No Limit ($0.25/$0.50 USD) - 2016/02/25 17:08:28 CET [2016/02/25 11:08:28 ET]
Table 'Thalpius III' 9-max Seat #5 is the button
Seat 1: BrotherLove9 ($54.60 in chips) 
Seat 2: matiko09 ($63.56 in chips) 
Seat 3: jamba83 ($52.83 in chips) 
Seat 4: Wwwasian ($70.51 in chips) 
Seat 5: Al3xAnd3r22 ($50.96 in chips) 
Seat 6: 111STAVR111 ($49.50 in chips) 
Seat 7: v4n0v ($50 in chips) 
Seat 8: jeroemie123 ($60 in chips) 
Seat 9: Domotirko228 ($50 in chips) 
111STAVR111: posts small blind $0.25
v4n0v: posts big blind $0.50
*** HOLE CARDS ***
Dealt to matiko09 [3c Ks]
jeroemie123: folds 
Domotirko228: folds 
BrotherLove9: raises $1 to $1.50
matiko09: folds 
jamba83: folds 
Wwwasian: folds 
Al3xAnd3r22: folds 
111STAVR111: folds 
v4n0v: calls $1
*** FLOP *** [3s 8h 9d]
v4n0v: checks 
BrotherLove9: bets $2.07
v4n0v: calls $2.07
*** TURN *** [3s 8h 9d] [Kc]
v4n0v: checks 
BrotherLove9: checks 
*** RIVER *** [3s 8h 9d Kc] [3h]
v4n0v: bets $3.88
BrotherLove9: calls $3.88
*** SHOW DOWN ***
v4n0v: shows [Tc Td] (two pair, Tens and Threes)
BrotherLove9: shows [Qd Qc] (two pair, Queens and Threes)
BrotherLove9 collected $14.47 from pot
*** SUMMARY ***
Total pot $15.15 | Rake $0.68 
Board [3s 8h 9d Kc 3h]
Seat 1: BrotherLove9 showed [Qd Qc] and won ($14.47) with two pair, Queens and Threes
Seat 2: matiko09 folded before Flop (didn't bet)
Seat 3: jamba83 folded before Flop (didn't bet)
Seat 4: Wwwasian folded before Flop (didn't bet)
Seat 5: Al3xAnd3r22 (button) folded before Flop (didn't bet)
Seat 6: 111STAVR111 (small blind) folded before Flop
Seat 7: v4n0v (big blind) showed [Tc Td] and lost with two pair, Tens and Threes
Seat 8: jeroemie123 folded before Flop (didn't bet)
Seat 9: Domotirko228 folded before Flop (didn't bet)





PokerStars Hand #149393293980:  Hold'em No Limit ($0.50/$1.00 USD) - 2016/02/25 17:08:39 CET [2016/02/25 11:08:39 ET]
Table 'Badenia II' 9-max Seat #2 is the button
Seat 1: matiko09 ($100 in chips) 
Seat 2: Stibitzkie ($67.60 in chips) 
Seat 3: sebaaastian ($125.34 in chips) 
Seat 5: djammusic ($120.59 in chips) 
Seat 6: xAndorx ($121.30 in chips) 
Seat 7: forsmthgood ($100 in chips) 
Seat 8: Sweden_Pound ($142.85 in chips) 
Seat 9: waisanen ($249.97 in chips) 
sebaaastian: posts small blind $0.50
djammusic: posts big blind $1
*** HOLE CARDS ***
Dealt to matiko09 [8s Kc]
xAndorx: folds 
forsmthgood: folds 
Sweden_Pound: folds 
waisanen: folds 
matiko09: folds 
Stibitzkie: folds 
sebaaastian: raises $1.50 to $2.50
djammusic: folds 
Uncalled bet ($1.50) returned to sebaaastian
sebaaastian collected $2 from pot
sebaaastian: doesn't show hand 
*** SUMMARY ***
Total pot $2 | Rake $0 
Seat 1: matiko09 folded before Flop (didn't bet)
Seat 2: Stibitzkie (button) folded before Flop (didn't bet)
Seat 3: sebaaastian (small blind) collected ($2)
Seat 5: djammusic (big blind) folded before Flop
Seat 6: xAndorx folded before Flop (didn't bet)
Seat 7: forsmthgood folded before Flop (didn't bet)
Seat 8: Sweden_Pound folded before Flop (didn't bet)
Seat 9: waisanen folded before Flop (didn't bet)





PokerStars Hand #149393297808:  Hold'em No Limit ($0.50/$1.00 USD) - 2016/02/25 17:08:44 CET [2016/02/25 11:08:44 ET]
Table 'Zeuxo II' 9-max Seat #8 is the button
Seat 1: forsmthgood ($115.29 in chips) 
Seat 2: Sweden_Pound ($116.08 in chips) 
Seat 3: xAndorx ($100 in chips) 
Seat 4: sebaaastian ($116.11 in chips) 
Seat 6: Cogss ($102.17 in chips) 
Seat 7: djammusic ($44 in chips) 
Seat 8: matiko09 ($104.20 in chips) 
Seat 9: Sreshta222 ($208.80 in chips) 
Sreshta222: posts small blind $0.50
forsmthgood: posts big blind $1
*** HOLE CARDS ***
Dealt to matiko09 [4d 7h]
hammerwife joins the table at seat #5 
Sweden_Pound: folds 
xAndorx: folds 
sebaaastian: folds 
Cogss: folds 
djammusic: folds 
matiko09: folds 
Sreshta222: raises $1.50 to $2.50
forsmthgood: folds 
Uncalled bet ($1.50) returned to Sreshta222
Sreshta222 collected $2 from pot
Sreshta222: doesn't show hand 
*** SUMMARY ***
Total pot $2 | Rake $0 
Seat 1: forsmthgood (big blind) folded before Flop
Seat 2: Sweden_Pound folded before Flop (didn't bet)
Seat 3: xAndorx folded before Flop (didn't bet)
Seat 4: sebaaastian folded before Flop (didn't bet)
Seat 6: Cogss folded before Flop (didn't bet)
Seat 7: djammusic folded before Flop (didn't bet)
Seat 8: matiko09 (button) folded before Flop (didn't bet)
Seat 9: Sreshta222 (small blind) collected ($2)





PokerStars Hand #149393299289:  Hold'em Pot Limit ($0.50/$1.00 USD) - 2016/02/25 17:08:46 CET [2016/02/25 11:08:46 ET]
Table 'Tokai' 9-max Seat #5 is the button
Seat 1: matiko09 ($104.58 in chips) 
Seat 2: Priidix ($112.67 in chips) 
Seat 3: Ilov3NBA ($104.30 in chips) 
Seat 4: sebaaastian ($217.84 in chips) 
Seat 5: simoniustin ($100 in chips) 
Seat 7: nickreason17 ($100.50 in chips) 
nickreason17: posts small blind $0.50
matiko09: posts big blind $1
*** HOLE CARDS ***
Dealt to matiko09 [3d 8s]
Priidix: folds 
Ilov3NBA: folds 
Priidix leaves the table
sebaaastian: raises $1.50 to $2.50
simoniustin: folds 
nickreason17: folds 
matiko09: folds 
Uncalled bet ($1.50) returned to sebaaastian
sebaaastian collected $2.50 from pot
sebaaastian: doesn't show hand 
*** SUMMARY ***
Total pot $2.50 | Rake $0 
Seat 1: matiko09 (big blind) folded before Flop
Seat 2: Priidix folded before Flop (didn't bet)
Seat 3: Ilov3NBA folded before Flop (didn't bet)
Seat 4: sebaaastian collected ($2.50)
Seat 5: simoniustin (button) folded before Flop (didn't bet)
Seat 7: nickreason17 (small blind) folded before Flop





PokerStars Hand #149393301666:  Hold'em No Limit ($0.25/$0.50 USD) - 2016/02/25 17:08:49 CET [2016/02/25 11:08:49 ET]
Table 'Lohja II' 9-max Seat #7 is the button
Seat 1: MoonJimmy ($141.13 in chips) 
Seat 2: Apparat888 ($46.90 in chips) 
Seat 3: guvalc1952 ($166.39 in chips) 
Seat 4: payback11 ($50.28 in chips) 
Seat 5: 111STAVR111 ($50 in chips) 
Seat 6: xAndorx ($60.14 in chips) 
Seat 7: matiko09 ($158.18 in chips) 
Seat 8: jamba83 ($65.42 in chips) 
Seat 9: Al3xAnd3r22 ($98.85 in chips) 
jamba83: posts small blind $0.25
Al3xAnd3r22: posts big blind $0.50
guvalc1952: posts small blind $0.25
MoonJimmy: posts the ante $0.10
Apparat888: posts the ante $0.10
guvalc1952: posts the ante $0.10
payback11: posts the ante $0.10
111STAVR111: posts the ante $0.10
xAndorx: posts the ante $0.10
matiko09: posts the ante $0.10
jamba83: posts the ante $0.10
Al3xAnd3r22: posts the ante $0.10
*** HOLE CARDS ***
Dealt to matiko09 [Js 4c]
MoonJimmy: folds 
Apparat888: raises $0.75 to $1.25
guvalc1952: folds 
payback11: folds 
111STAVR111: folds 
xAndorx: calls $1.25
matiko09: folds 
jamba83: folds 
Al3xAnd3r22: folds 
*** FLOP *** [Kh 5c 2c]
Apparat888: checks 
xAndorx: bets $2.75
Apparat888: folds 
Uncalled bet ($2.75) returned to xAndorx
xAndorx collected $4.20 from pot
xAndorx: doesn't show hand 
*** SUMMARY ***
Total pot $4.40 | Rake $0.20 
Board [Kh 5c 2c]
Seat 1: MoonJimmy folded before Flop (didn't bet)
Seat 2: Apparat888 folded on the Flop
Seat 3: guvalc1952 folded before Flop
Seat 4: payback11 folded before Flop (didn't bet)
Seat 5: 111STAVR111 folded before Flop (didn't bet)
Seat 6: xAndorx collected ($4.20)
Seat 7: matiko09 (button) folded before Flop (didn't bet)
Seat 8: jamba83 (small blind) folded before Flop
Seat 9: Al3xAnd3r22 (big blind) folded before Flop





PokerStars Hand #149393305376:  Hold'em No Limit ($0.50/$1.00 USD) - 2016/02/25 17:08:54 CET [2016/02/25 11:08:54 ET]
Table 'Hercules IV' 9-max Seat #3 is the button
Seat 1: matiko09 ($101.50 in chips) 
Seat 3: HomerrrJay ($100 in chips) 
Seat 4: Sweden_Pound ($100.50 in chips) 
Seat 5: xAndorx ($161.08 in chips) 
Seat 6: kuanhung0903 ($51.49 in chips) 
Seat 7: Ouga Buga ($100 in chips) 
Seat 8: brokat77 ($142.17 in chips) 
Seat 9: djammusic ($35.18 in chips) 
Sweden_Pound: posts small blind $0.50
xAndorx: posts big blind $1
*** HOLE CARDS ***
Dealt to matiko09 [2d 5c]
kuanhung0903: folds 
Ouga Buga: folds 
brokat77: folds 
djammusic: folds 
matiko09: folds 
HomerrrJay: raises $1.50 to $2.50
Sweden_Pound: raises $7.50 to $10
xAndorx: folds 
HomerrrJay: raises $10 to $20
Sweden_Pound: folds 
Uncalled bet ($10) returned to HomerrrJay
HomerrrJay collected $21 from pot
HomerrrJay: doesn't show hand 
*** SUMMARY ***
Total pot $21 | Rake $0 
Seat 1: matiko09 folded before Flop (didn't bet)
Seat 3: HomerrrJay (button) collected ($21)
Seat 4: Sweden_Pound (small blind) folded before Flop
Seat 5: xAndorx (big blind) folded before Flop
Seat 6: kuanhung0903 folded before Flop (didn't bet)
Seat 7: Ouga Buga folded before Flop (didn't bet)
Seat 8: brokat77 folded before Flop (didn't bet)
Seat 9: djammusic folded before Flop (didn't bet)





PokerStars Hand #149393312970:  Hold'em No Limit ($0.50/$1.00 USD) - 2016/02/25 17:09:03 CET [2016/02/25 11:09:03 ET]
Table 'Ebella II' 9-max Seat #1 is the button
Seat 1: nickreason17 ($101 in chips) 
Seat 2: Sweden_Pound ($100 in chips) 
Seat 5: matiko09 ($101.25 in chips) 
Seat 8: ZMPOUTSAM140 ($88.70 in chips) 
Seat 9: simoniustin ($100 in chips) 
Sweden_Pound: posts small blind $0.50
Lahesell: is sitting out 
djammusic: is sitting out 
matiko09: posts big blind $1
Aalleekks: sits out 
*** HOLE CARDS ***
Dealt to matiko09 [6d 2s]
ZMPOUTSAM140: folds 
simoniustin: folds 
nickreason17: folds 
djammusic leaves the table
xAndorx joins the table at seat #4 
Sweden_Pound: folds 
Uncalled bet ($0.50) returned to matiko09
matiko09 collected $1 from pot
matiko09: doesn't show hand 
*** SUMMARY ***
Total pot $1 | Rake $0 
Seat 1: nickreason17 (button) folded before Flop (didn't bet)
Seat 2: Sweden_Pound (small blind) folded before Flop
Seat 5: matiko09 (big blind) collected ($1)
Seat 8: ZMPOUTSAM140 folded before Flop (didn't bet)
Seat 9: simoniustin folded before Flop (didn't bet)





PokerStars Hand #149393313744:  Hold'em No Limit ($0.50/$1.00 USD) - 2016/02/25 17:09:04 CET [2016/02/25 11:09:04 ET]
Table 'Sabine' 9-max Seat #3 is the button
Seat 1: Aalleekks ($100 in chips) 
Seat 2: apfush ($135.20 in chips) 
Seat 3: Ouga Buga ($101.50 in chips) 
Seat 7: clayshmert ($49.24 in chips) 
Seat 8: matiko09 ($109.07 in chips) 
Seat 9: djammusic ($61.39 in chips) 
ffac will be allowed to play after the button
clayshmert: posts small blind $0.50
matiko09: posts big blind $1
*** HOLE CARDS ***
Dealt to matiko09 [7c 9c]
djammusic: raises $1.50 to $2.50
Aalleekks: folds 
Venomous100% joins the table at seat #5 
apfush: folds 
Ouga Buga: folds 
clayshmert: folds 
matiko09: folds 
Uncalled bet ($1.50) returned to djammusic
djammusic collected $2.50 from pot
djammusic: doesn't show hand 
*** SUMMARY ***
Total pot $2.50 | Rake $0 
Seat 1: Aalleekks folded before Flop (didn't bet)
Seat 2: apfush folded before Flop (didn't bet)
Seat 3: Ouga Buga (button) folded before Flop (didn't bet)
Seat 7: clayshmert (small blind) folded before Flop
Seat 8: matiko09 (big blind) folded before Flop
Seat 9: djammusic collected ($2.50)





PokerStars Hand #149393314359:  Hold'em No Limit ($0.50/$1.00 USD) - 2016/02/25 17:09:05 CET [2016/02/25 11:09:05 ET]
Table 'Mayall II' 9-max Seat #6 is the button
Seat 1: matiko09 ($113.61 in chips) 
Seat 2: Sweden_Pound ($141.47 in chips) 
Seat 3: doppy 123577 ($89.85 in chips) 
Seat 4: Ouga Buga ($111.12 in chips) 
Seat 5: SumPosad ($68.45 in chips) 
Seat 6: apfush ($112.78 in chips) 
Seat 8: kuanhung0903 ($68.48 in chips) 
Seat 9: xAndorx ($138.84 in chips) 
kuanhung0903: posts small blind $0.50
xAndorx: posts big blind $1
*** HOLE CARDS ***
Dealt to matiko09 [4d 3c]
matiko09: folds 
Sweden_Pound: folds 
doppy 123577: folds 
Ouga Buga: folds 
SumPosad: raises $1.50 to $2.50
apfush: calls $2.50
kuanhung0903: folds 
xAndorx: folds 
*** FLOP *** [2h 8d Qh]
SumPosad: bets $4.60
apfush: calls $4.60
*** TURN *** [2h 8d Qh] [5s]
SumPosad: checks 
apfush: checks 
*** RIVER *** [2h 8d Qh 5s] [Th]
SumPosad: bets $11
apfush: folds 
Uncalled bet ($11) returned to SumPosad
SumPosad collected $14.99 from pot
SumPosad: doesn't show hand 
*** SUMMARY ***
Total pot $15.70 | Rake $0.71 
Board [2h 8d Qh 5s Th]
Seat 1: matiko09 folded before Flop (didn't bet)
Seat 2: Sweden_Pound folded before Flop (didn't bet)
Seat 3: doppy 123577 folded before Flop (didn't bet)
Seat 4: Ouga Buga folded before Flop (didn't bet)
Seat 5: SumPosad collected ($14.99)
Seat 6: apfush (button) folded on the River
Seat 8: kuanhung0903 (small blind) folded before Flop
Seat 9: xAndorx (big blind) folded before Flop





PokerStars Hand #149393319539:  Hold'em Pot Limit ($0.50/$1.00 USD) - 2016/02/25 17:09:12 CET [2016/02/25 11:09:12 ET]
Table 'Tokai' 9-max Seat #7 is the button
Seat 1: matiko09 ($103.58 in chips) 
Seat 5: simoniustin ($100 in chips) 
Seat 7: nickreason17 ($100 in chips) 
matiko09: posts small blind $0.50
Ilov3NBA: is sitting out 
sebaaastian: is sitting out 
sebaaastian leaves the table
simoniustin: posts big blind $1
*** HOLE CARDS ***
Dealt to matiko09 [6d 9s]
nickreason17: folds 
Ilov3NBA leaves the table
matiko09: folds 
Uncalled bet ($0.50) returned to simoniustin
$-Twackle-$ leaves the table
simoniustin collected $1 from pot
simoniustin: doesn't show hand 
*** SUMMARY ***
Total pot $1 | Rake $0 
Seat 1: matiko09 (small blind) folded before Flop
Seat 5: simoniustin (big blind) collected ($1)
Seat 7: nickreason17 (button) folded before Flop (didn't bet)





PokerStars Hand #149393319233:  Hold'em No Limit ($0.50/$1.00 USD) - 2016/02/25 17:09:12 CET [2016/02/25 11:09:12 ET]
Table 'Isa' 9-max Seat #9 is the button
Seat 1: matiko09 ($127.87 in chips) 
Seat 2: mycka86 ($100 in chips) 
Seat 3: sebaaastian ($135.31 in chips) 
Seat 5: Sweden_Pound ($178.88 in chips) 
Seat 6: xAndorx ($104.16 in chips) 
Seat 7: bilukm ($162.46 in chips) 
Seat 8: Venomous100% ($100 in chips) 
Seat 9: HomerrrJay ($100 in chips) 
matiko09: posts small blind $0.50
mycka86: posts big blind $1
*** HOLE CARDS ***
Dealt to matiko09 [Jh Qc]
sebaaastian: folds 
Sweden_Pound: folds 
xAndorx: raises $2 to $3
bilukm: folds 
Venomous100%: raises $6 to $9
HomerrrJay: folds 
matiko09: folds 
mycka86: folds 
xAndorx: folds 
Uncalled bet ($6) returned to Venomous100%
Venomous100% collected $7.50 from pot
Venomous100%: doesn't show hand 
*** SUMMARY ***
Total pot $7.50 | Rake $0 
Seat 1: matiko09 (small blind) folded before Flop
Seat 2: mycka86 (big blind) folded before Flop
Seat 3: sebaaastian folded before Flop (didn't bet)
Seat 5: Sweden_Pound folded before Flop (didn't bet)
Seat 6: xAndorx folded before Flop
Seat 7: bilukm folded before Flop (didn't bet)
Seat 8: Venomous100% collected ($7.50)
Seat 9: HomerrrJay (button) folded before Flop (didn't bet)





PokerStars Hand #149393327131:  Hold'em No Limit ($0.50/$1.00 USD) - 2016/02/25 17:09:22 CET [2016/02/25 11:09:22 ET]
Table 'Zeuxo II' 9-max Seat #9 is the button
Seat 1: forsmthgood ($114.29 in chips) 
Seat 2: Sweden_Pound ($116.08 in chips) 
Seat 3: xAndorx ($100 in chips) 
Seat 4: sebaaastian ($116.11 in chips) 
Seat 6: Cogss ($102.17 in chips) 
Seat 7: djammusic ($44 in chips) 
Seat 8: matiko09 ($104.20 in chips) 
Seat 9: Sreshta222 ($209.80 in chips) 
forsmthgood: posts small blind $0.50
Sweden_Pound: posts big blind $1
*** HOLE CARDS ***
Dealt to matiko09 [Td Ks]
xAndorx: folds 
sebaaastian: folds 
Cogss: raises $1 to $2
djammusic: folds 
matiko09: calls $2
Sreshta222: folds 
forsmthgood: folds 
Sweden_Pound: folds 
*** FLOP *** [2d 5h 4c]
Cogss: bets $5.25
matiko09: folds 
Uncalled bet ($5.25) returned to Cogss
Cogss collected $5.25 from pot
*** SUMMARY ***
Total pot $5.50 | Rake $0.25 
Board [2d 5h 4c]
Seat 1: forsmthgood (small blind) folded before Flop
Seat 2: Sweden_Pound (big blind) folded before Flop
Seat 3: xAndorx folded before Flop (didn't bet)
Seat 4: sebaaastian folded before Flop (didn't bet)
Seat 6: Cogss collected ($5.25)
Seat 7: djammusic folded before Flop (didn't bet)
Seat 8: matiko09 folded on the Flop
Seat 9: Sreshta222 (button) folded before Flop (didn't bet)





PokerStars Hand #149393332028:  Hold'em No Limit ($0.50/$1.00 USD) - 2016/02/25 17:09:28 CET [2016/02/25 11:09:28 ET]
Table 'Ebella II' 9-max Seat #2 is the button
Seat 1: nickreason17 ($101 in chips) 
Seat 2: Sweden_Pound ($100 in chips) 
Seat 5: matiko09 ($101.75 in chips) 
Seat 6: Aalleekks ($100 in chips) 
Seat 8: ZMPOUTSAM140 ($88.70 in chips) 
Seat 9: simoniustin ($100 in chips) 
xAndorx will be allowed to play after the button
matiko09: posts small blind $0.50
Aalleekks: posts big blind $1
*** HOLE CARDS ***
Dealt to matiko09 [2d 2h]
ZMPOUTSAM140: folds 
simoniustin: folds 
nickreason17: folds 
Sweden_Pound: folds 
matiko09: raises $1.50 to $2.50
Aalleekks: folds 
Uncalled bet ($1.50) returned to matiko09
matiko09 collected $2 from pot
matiko09: doesn't show hand 
*** SUMMARY ***
Total pot $2 | Rake $0 
Seat 1: nickreason17 folded before Flop (didn't bet)
Seat 2: Sweden_Pound (button) folded before Flop (didn't bet)
Seat 5: matiko09 (small blind) collected ($2)
Seat 6: Aalleekks (big blind) folded before Flop
Seat 8: ZMPOUTSAM140 folded before Flop (didn't bet)
Seat 9: simoniustin folded before Flop (didn't bet)





PokerStars Hand #149393332829:  Hold'em No Limit ($0.50/$1.00 USD) - 2016/02/25 17:09:29 CET [2016/02/25 11:09:29 ET]
Table 'Sabine' 9-max Seat #7 is the button
Seat 1: Aalleekks ($100 in chips) 
Seat 2: apfush ($135.20 in chips) 
Seat 3: Ouga Buga ($101.50 in chips) 
Seat 7: clayshmert ($48.74 in chips) 
Seat 8: matiko09 ($108.07 in chips) 
Seat 9: djammusic ($62.89 in chips) 
matiko09: posts small blind $0.50
djammusic: posts big blind $1
Venomous100%: sits out 
ffac: sits out 
*** HOLE CARDS ***
Dealt to matiko09 [7h 6d]
Aalleekks: folds 
apfush: folds 
Ouga Buga: raises $1.50 to $2.50
clayshmert: raises $3.50 to $6
matiko09: folds 
djammusic: folds 
Ouga Buga: raises $95.50 to $101.50 and is all-in
clayshmert: calls $42.74 and is all-in
Uncalled bet ($52.76) returned to Ouga Buga
*** FLOP *** [As 3h Tc]
*** TURN *** [As 3h Tc] [2d]
*** RIVER *** [As 3h Tc 2d] [Kd]
*** SHOW DOWN ***
Ouga Buga: shows [Ah Kh] (two pair, Aces and Kings)
clayshmert: shows [8d 8h] (a pair of Eights)
Ouga Buga collected $96.18 from pot
*** SUMMARY ***
Total pot $98.98 | Rake $2.80 
Board [As 3h Tc 2d Kd]
Seat 1: Aalleekks folded before Flop (didn't bet)
Seat 2: apfush folded before Flop (didn't bet)
Seat 3: Ouga Buga showed [Ah Kh] and won ($96.18) with two pair, Aces and Kings
Seat 7: clayshmert (button) showed [8d 8h] and lost with a pair of Eights
Seat 8: matiko09 (small blind) folded before Flop
Seat 9: djammusic (big blind) folded before Flop





PokerStars Hand #149393342996:  Hold'em No Limit ($0.50/$1.00 USD) - 2016/02/25 17:09:42 CET [2016/02/25 11:09:42 ET]
Table 'Badenia II' 9-max Seat #3 is the button
Seat 1: matiko09 ($100 in chips) 
Seat 2: Stibitzkie ($67.60 in chips) 
Seat 3: sebaaastian ($126.34 in chips) 
Seat 5: djammusic ($119.59 in chips) 
Seat 6: xAndorx ($121.30 in chips) 
Seat 7: forsmthgood ($100 in chips) 
Seat 8: Sweden_Pound ($142.85 in chips) 
Seat 9: waisanen ($249.97 in chips) 
djammusic: posts small blind $0.50
xAndorx: posts big blind $1
*** HOLE CARDS ***
Dealt to matiko09 [Kc 4c]
forsmthgood: folds 
Sweden_Pound: folds 
waisanen: folds 
matiko09: folds 
Stibitzkie: raises $2.50 to $3.50
sebaaastian: folds 
djammusic: folds 
xAndorx: folds 
Uncalled bet ($2.50) returned to Stibitzkie
Stibitzkie collected $2.50 from pot
*** SUMMARY ***
Total pot $2.50 | Rake $0 
Seat 1: matiko09 folded before Flop (didn't bet)
Seat 2: Stibitzkie collected ($2.50)
Seat 3: sebaaastian (button) folded before Flop (didn't bet)
Seat 5: djammusic (small blind) folded before Flop
Seat 6: xAndorx (big blind) folded before Flop
Seat 7: forsmthgood folded before Flop (didn't bet)
Seat 8: Sweden_Pound folded before Flop (didn't bet)
Seat 9: waisanen folded before Flop (didn't bet)





PokerStars Hand #149393350879:  Hold'em No Limit ($0.50/$1.00 USD) - 2016/02/25 17:09:52 CET [2016/02/25 11:09:52 ET]
Table 'Ebella II' 9-max Seat #5 is the button
Seat 1: nickreason17 ($101 in chips) 
Seat 2: Sweden_Pound ($100 in chips) 
Seat 5: matiko09 ($102.75 in chips) 
Seat 6: Aalleekks ($100 in chips) 
Seat 8: ZMPOUTSAM140 ($88.70 in chips) 
Seat 9: simoniustin ($100 in chips) 
Aalleekks: posts small blind $0.50
ZMPOUTSAM140: posts big blind $1
xAndorx: sits out 
*** HOLE CARDS ***
Dealt to matiko09 [9d Jc]
simoniustin: folds 
nickreason17: folds 
Sweden_Pound: folds 
matiko09: raises $1.27 to $2.27
Aalleekks: calls $1.77
ZMPOUTSAM140: calls $1.27
*** FLOP *** [As 7d 8s]
Aalleekks: checks 
ZMPOUTSAM140: checks 
matiko09: checks 
*** TURN *** [As 7d 8s] [6c]
Aalleekks: bets $3.51
ZMPOUTSAM140: folds 
matiko09: calls $3.51
*** RIVER *** [As 7d 8s 6c] [8c]
Aalleekks: bets $7.10
matiko09: folds 
Uncalled bet ($7.10) returned to Aalleekks
Aalleekks collected $13.21 from pot
Aalleekks: doesn't show hand 
*** SUMMARY ***
Total pot $13.83 | Rake $0.62 
Board [As 7d 8s 6c 8c]
Seat 1: nickreason17 folded before Flop (didn't bet)
Seat 2: Sweden_Pound folded before Flop (didn't bet)
Seat 5: matiko09 (button) folded on the River
Seat 6: Aalleekks (small blind) collected ($13.21)
Seat 8: ZMPOUTSAM140 (big blind) folded on the Turn
Seat 9: simoniustin folded before Flop (didn't bet)





PokerStars Hand #149393359438:  Hold'em No Limit ($0.25/$0.50 USD) - 2016/02/25 17:10:03 CET [2016/02/25 11:10:03 ET]
Table 'Lohja II' 9-max Seat #8 is the button
Seat 1: MoonJimmy ($141.03 in chips) 
Seat 2: Apparat888 ($45.55 in chips) 
Seat 3: guvalc1952 ($166.04 in chips) 
Seat 4: payback11 ($50.18 in chips) 
Seat 5: 111STAVR111 ($49.90 in chips) 
Seat 6: xAndorx ($62.99 in chips) 
Seat 7: matiko09 ($158.08 in chips) 
Seat 8: jamba83 ($65.07 in chips) 
Seat 9: Al3xAnd3r22 ($98.25 in chips) 
Al3xAnd3r22: posts small blind $0.25
MoonJimmy: posts big blind $0.50
MoonJimmy: posts the ante $0.10
Apparat888: posts the ante $0.10
guvalc1952: posts the ante $0.10
payback11: posts the ante $0.10
111STAVR111: posts the ante $0.10
xAndorx: posts the ante $0.10
matiko09: posts the ante $0.10
jamba83: posts the ante $0.10
Al3xAnd3r22: posts the ante $0.10
*** HOLE CARDS ***
Dealt to matiko09 [Qc Ts]
Apparat888: folds 
guvalc1952: calls $0.50
payback11: folds 
111STAVR111: folds 
xAndorx: folds 
matiko09: raises $2 to $2.50
jamba83: folds 
Al3xAnd3r22: folds 
MoonJimmy: folds 
guvalc1952: calls $2
*** FLOP *** [Ac Qd 8s]
guvalc1952: checks 
matiko09: checks 
*** TURN *** [Ac Qd 8s] [Td]
guvalc1952: checks 
matiko09: bets $4.50
guvalc1952: raises $4.50 to $9
matiko09: calls $4.50
*** RIVER *** [Ac Qd 8s Td] [5c]
guvalc1952: bets $11.77
matiko09: calls $11.77
*** SHOW DOWN ***
guvalc1952: shows [8d 8h] (three of a kind, Eights)
matiko09: mucks hand 
guvalc1952 collected $46.02 from pot
*** SUMMARY ***
Total pot $48.19 | Rake $2.17 
Board [Ac Qd 8s Td 5c]
Seat 1: MoonJimmy (big blind) folded before Flop
Seat 2: Apparat888 folded before Flop (didn't bet)
Seat 3: guvalc1952 showed [8d 8h] and won ($46.02) with three of a kind, Eights
Seat 4: payback11 folded before Flop (didn't bet)
Seat 5: 111STAVR111 folded before Flop (didn't bet)
Seat 6: xAndorx folded before Flop (didn't bet)
Seat 7: matiko09 mucked [Qc Ts]
Seat 8: jamba83 (button) folded before Flop (didn't bet)
Seat 9: Al3xAnd3r22 (small blind) folded before Flop





PokerStars Hand #149393362785:  Hold'em No Limit ($0.50/$1.00 USD) - 2016/02/25 17:10:07 CET [2016/02/25 11:10:07 ET]
Table 'Isa' 9-max Seat #1 is the button
Seat 1: matiko09 ($127.37 in chips) 
Seat 2: mycka86 ($100 in chips) 
Seat 3: sebaaastian ($135.31 in chips) 
Seat 5: Sweden_Pound ($178.88 in chips) 
Seat 6: xAndorx ($101.16 in chips) 
Seat 7: bilukm ($162.46 in chips) 
Seat 8: Venomous100% ($104.50 in chips) 
Seat 9: HomerrrJay ($100 in chips) 
mycka86: posts small blind $0.50
sebaaastian: posts big blind $1
*** HOLE CARDS ***
Dealt to matiko09 [As 6h]
Sweden_Pound: folds 
xAndorx: folds 
bilukm: folds 
Venomous100%: raises $2 to $3
HomerrrJay: folds 
matiko09: folds 
mycka86: folds 
sebaaastian: calls $2
*** FLOP *** [Ad 2h Ah]
sebaaastian: checks 
Venomous100%: bets $4.10
sebaaastian: calls $4.10
*** TURN *** [Ad 2h Ah] [2s]
sebaaastian: checks 
Venomous100%: checks 
*** RIVER *** [Ad 2h Ah 2s] [3h]
sebaaastian: bets $7
Venomous100%: folds 
Uncalled bet ($7) returned to sebaaastian
sebaaastian collected $14.04 from pot
sebaaastian: doesn't show hand 
*** SUMMARY ***
Total pot $14.70 | Rake $0.66 
Board [Ad 2h Ah 2s 3h]
Seat 1: matiko09 (button) folded before Flop (didn't bet)
Seat 2: mycka86 (small blind) folded before Flop
Seat 3: sebaaastian (big blind) collected ($14.04)
Seat 5: Sweden_Pound folded before Flop (didn't bet)
Seat 6: xAndorx folded before Flop (didn't bet)
Seat 7: bilukm folded before Flop (didn't bet)
Seat 8: Venomous100% folded on the River
Seat 9: HomerrrJay folded before Flop (didn't bet)





PokerStars Hand #149393362175:  Hold'em No Limit ($0.50/$1.00 USD) - 2016/02/25 17:10:07 CET [2016/02/25 11:10:07 ET]
Table 'Sabine' 9-max Seat #8 is the button
Seat 1: Aalleekks ($100 in chips) 
Seat 2: apfush ($135.20 in chips) 
Seat 3: Ouga Buga ($148.94 in chips) 
Seat 8: matiko09 ($107.57 in chips) 
Seat 9: djammusic ($61.89 in chips) 
djammusic: posts small blind $0.50
Aalleekks: posts big blind $1
Venomous100%: sits out 
ffac: sits out 
*** HOLE CARDS ***
Dealt to matiko09 [6h Jc]
apfush: folds 
Ouga Buga: folds 
matiko09: folds 
djammusic: raises $1.50 to $2.50
Aalleekks: folds 
Uncalled bet ($1.50) returned to djammusic
djammusic collected $2 from pot
djammusic: doesn't show hand 
*** SUMMARY ***
Total pot $2 | Rake $0 
Seat 1: Aalleekks (big blind) folded before Flop
Seat 2: apfush folded before Flop (didn't bet)
Seat 3: Ouga Buga folded before Flop (didn't bet)
Seat 8: matiko09 (button) folded before Flop (didn't bet)
Seat 9: djammusic (small blind) collected ($2)





PokerStars Hand #149393362743:  Hold'em No Limit ($0.25/$0.50 USD) - 2016/02/25 17:10:07 CET [2016/02/25 11:10:07 ET]
Table 'Thalpius III' 9-max Seat #6 is the button
Seat 1: BrotherLove9 ($61.62 in chips) 
Seat 2: matiko09 ($63.56 in chips) 
Seat 3: jamba83 ($52.83 in chips) 
Seat 4: Wwwasian ($70.51 in chips) 
Seat 5: Al3xAnd3r22 ($50.96 in chips) 
Seat 6: 111STAVR111 ($50 in chips) 
Seat 7: v4n0v ($50 in chips) 
Seat 8: jeroemie123 ($60 in chips) 
Seat 9: Domotirko228 ($50 in chips) 
v4n0v: posts small blind $0.25
jeroemie123: posts big blind $0.50
*** HOLE CARDS ***
Dealt to matiko09 [7d 8c]
Domotirko228: folds 
BrotherLove9: folds 
matiko09: folds 
jamba83: folds 
Wwwasian: folds 
Al3xAnd3r22: raises $0.72 to $1.22
111STAVR111: folds 
v4n0v: folds 
jeroemie123: folds 
Uncalled bet ($0.72) returned to Al3xAnd3r22
Al3xAnd3r22 collected $1.25 from pot
*** SUMMARY ***
Total pot $1.25 | Rake $0 
Seat 1: BrotherLove9 folded before Flop (didn't bet)
Seat 2: matiko09 folded before Flop (didn't bet)
Seat 3: jamba83 folded before Flop (didn't bet)
Seat 4: Wwwasian folded before Flop (didn't bet)
Seat 5: Al3xAnd3r22 collected ($1.25)
Seat 6: 111STAVR111 (button) folded before Flop (didn't bet)
Seat 7: v4n0v (small blind) folded before Flop
Seat 8: jeroemie123 (big blind) folded before Flop
Seat 9: Domotirko228 folded before Flop (didn't bet)





PokerStars Hand #149393365669:  Hold'em No Limit ($0.50/$1.00 USD) - 2016/02/25 17:10:11 CET [2016/02/25 11:10:11 ET]
Table 'Zeuxo II' 9-max Seat #1 is the button
Seat 1: forsmthgood ($113.79 in chips) 
Seat 2: Sweden_Pound ($115.08 in chips) 
Seat 3: xAndorx ($100 in chips) 
Seat 4: sebaaastian ($116.11 in chips) 
Seat 6: Cogss ($105.42 in chips) 
Seat 7: djammusic ($44 in chips) 
Seat 8: matiko09 ($102.20 in chips) 
Seat 9: Sreshta222 ($209.80 in chips) 
Sweden_Pound: posts small blind $0.50
xAndorx: posts big blind $1
*** HOLE CARDS ***
Dealt to matiko09 [6s 7h]
sebaaastian: folds 
Cogss: folds 
djammusic: raises $1.12 to $2.12
matiko09: folds 
Sreshta222: folds 
forsmthgood: folds 
Sweden_Pound: folds 
xAndorx: folds 
Uncalled bet ($1.12) returned to djammusic
djammusic collected $2.50 from pot
djammusic: doesn't show hand 
*** SUMMARY ***
Total pot $2.50 | Rake $0 
Seat 1: forsmthgood (button) folded before Flop (didn't bet)
Seat 2: Sweden_Pound (small blind) folded before Flop
Seat 3: xAndorx (big blind) folded before Flop
Seat 4: sebaaastian folded before Flop (didn't bet)
Seat 6: Cogss folded before Flop (didn't bet)
Seat 7: djammusic collected ($2.50)
Seat 8: matiko09 folded before Flop (didn't bet)
Seat 9: Sreshta222 folded before Flop (didn't bet)





PokerStars Hand #149393369889:  Hold'em No Limit ($0.50/$1.00 USD) - 2016/02/25 17:10:16 CET [2016/02/25 11:10:16 ET]
Table 'Hercules IV' 9-max Seat #4 is the button
Seat 1: matiko09 ($101.50 in chips) 
Seat 3: HomerrrJay ($111 in chips) 
Seat 4: Sweden_Pound ($100 in chips) 
Seat 5: xAndorx ($160.08 in chips) 
Seat 6: kuanhung0903 ($51.49 in chips) 
Seat 7: Ouga Buga ($100 in chips) 
Seat 8: brokat77 ($142.17 in chips) 
Seat 9: djammusic ($35.18 in chips) 
xAndorx: posts small blind $0.50
kuanhung0903: posts big blind $1
*** HOLE CARDS ***
Dealt to matiko09 [7c 5c]
Ouga Buga: folds 
brokat77: folds 
djammusic: folds 
matiko09: folds 
HomerrrJay: folds 
Sweden_Pound: raises $1 to $2
xAndorx: raises $5.50 to $7.50
kuanhung0903: folds 
Sweden_Pound: folds 
Uncalled bet ($5.50) returned to xAndorx
xAndorx collected $5 from pot
xAndorx: doesn't show hand 
*** SUMMARY ***
Total pot $5 | Rake $0 
Seat 1: matiko09 folded before Flop (didn't bet)
Seat 3: HomerrrJay folded before Flop (didn't bet)
Seat 4: Sweden_Pound (button) folded before Flop
Seat 5: xAndorx (small blind) collected ($5)
Seat 6: kuanhung0903 (big blind) folded before Flop
Seat 7: Ouga Buga folded before Flop (didn't bet)
Seat 8: brokat77 folded before Flop (didn't bet)
Seat 9: djammusic folded before Flop (didn't bet)





PokerStars Hand #149393370508:  Hold'em No Limit ($0.50/$1.00 USD) - 2016/02/25 17:10:17 CET [2016/02/25 11:10:17 ET]
Table 'Morosovia II' 9-max Seat #5 is the button
Seat 1: apfush ($172.26 in chips) 
Seat 2: lysandrafly ($122.44 in chips) 
Seat 3: sebaaastian ($217.86 in chips) 
Seat 4: Venomous100% ($100 in chips) 
Seat 5: pimpoza ($103.13 in chips) 
Seat 6: Sweden_Pound ($127.57 in chips) 
Seat 7: matiko09 ($167.35 in chips) 
Seat 8: simoniustin ($105.50 in chips) 
Seat 9: Ouga Buga ($135.57 in chips) 
Sweden_Pound: posts small blind $0.50
matiko09: posts big blind $1
*** HOLE CARDS ***
Dealt to matiko09 [8s 3d]
simoniustin: raises $2 to $3
Ouga Buga: folds 
apfush: folds 
lysandrafly: folds 
sebaaastian: folds 
Venomous100%: folds 
pimpoza: calls $3
Sweden_Pound: folds 
matiko09: folds 
*** FLOP *** [7c 4s 2s]
simoniustin: checks 
pimpoza: checks 
*** TURN *** [7c 4s 2s] [2d]
simoniustin: checks 
pimpoza: checks 
*** RIVER *** [7c 4s 2s 2d] [Qc]
simoniustin: bets $5
pimpoza: folds 
Uncalled bet ($5) returned to simoniustin
simoniustin collected $7.16 from pot
simoniustin: doesn't show hand 
*** SUMMARY ***
Total pot $7.50 | Rake $0.34 
Board [7c 4s 2s 2d Qc]
Seat 1: apfush folded before Flop (didn't bet)
Seat 2: lysandrafly folded before Flop (didn't bet)
Seat 3: sebaaastian folded before Flop (didn't bet)
Seat 4: Venomous100% folded before Flop (didn't bet)
Seat 5: pimpoza (button) folded on the River
Seat 6: Sweden_Pound (small blind) folded before Flop
Seat 7: matiko09 (big blind) folded before Flop
Seat 8: simoniustin collected ($7.16)
Seat 9: Ouga Buga folded before Flop (didn't bet)





PokerStars Hand #149393376677:  Hold'em No Limit ($0.50/$1.00 USD) - 2016/02/25 17:10:25 CET [2016/02/25 11:10:25 ET]
Table 'Nerthus II' 9-max Seat #8 is the button
Seat 2: matiko09 ($194.95 in chips) 
Seat 3: simoniustin ($100 in chips) 
Seat 4: Ilov3NBA ($100.12 in chips) 
Seat 5: Sweden_Pound ($219.63 in chips) 
Seat 6: mycka86 ($100 in chips) 
Seat 7: Venomous100% ($100 in chips) 
Seat 8: Kelvin sai ($66.91 in chips) 
DUkalisUA will be allowed to play after the button
matiko09: posts small blind $0.50
simoniustin: posts big blind $1
*** HOLE CARDS ***
Dealt to matiko09 [Tc 9h]
Ilov3NBA: folds 
Sweden_Pound: folds 
mycka86: folds 
Venomous100%: folds 
Kelvin sai: raises $1 to $2
matiko09: folds 
simoniustin: folds 
Uncalled bet ($1) returned to Kelvin sai
Kelvin sai collected $2.50 from pot
Kelvin sai: doesn't show hand 
*** SUMMARY ***
Total pot $2.50 | Rake $0 
Seat 2: matiko09 (small blind) folded before Flop
Seat 3: simoniustin (big blind) folded before Flop
Seat 4: Ilov3NBA folded before Flop (didn't bet)
Seat 5: Sweden_Pound folded before Flop (didn't bet)
Seat 6: mycka86 folded before Flop (didn't bet)
Seat 7: Venomous100% folded before Flop (didn't bet)
Seat 8: Kelvin sai (button) collected ($2.50)





PokerStars Hand #149393380354:  Hold'em No Limit ($0.50/$1.00 USD) - 2016/02/25 17:10:30 CET [2016/02/25 11:10:30 ET]
Table 'Sabine' 9-max Seat #9 is the button
Seat 1: Aalleekks ($100 in chips) 
Seat 2: apfush ($135.20 in chips) 
Seat 3: Ouga Buga ($148.94 in chips) 
Seat 7: clayshmert ($59.28 in chips) 
Seat 8: matiko09 ($107.57 in chips) 
Seat 9: djammusic ($62.89 in chips) 
Aalleekks: posts small blind $0.50
apfush: posts big blind $1
Venomous100%: sits out 
ffac: sits out 
*** HOLE CARDS ***
Dealt to matiko09 [9h 6s]
Ouga Buga: folds 
clayshmert: raises $2 to $3
matiko09: folds 
djammusic: folds 
Aalleekks: folds 
apfush: folds 
Uncalled bet ($2) returned to clayshmert
clayshmert collected $2.50 from pot
*** SUMMARY ***
Total pot $2.50 | Rake $0 
Seat 1: Aalleekks (small blind) folded before Flop
Seat 2: apfush (big blind) folded before Flop
Seat 3: Ouga Buga folded before Flop (didn't bet)
Seat 7: clayshmert collected ($2.50)
Seat 8: matiko09 folded before Flop (didn't bet)
Seat 9: djammusic (button) folded before Flop (didn't bet)





PokerStars Hand #149393384968:  Hold'em No Limit ($0.50/$1.00 USD) - 2016/02/25 17:10:36 CET [2016/02/25 11:10:36 ET]
Table 'Badenia II' 9-max Seat #5 is the button
Seat 1: matiko09 ($100 in chips) 
Seat 2: Stibitzkie ($69.10 in chips) 
Seat 3: sebaaastian ($126.34 in chips) 
Seat 5: djammusic ($119.09 in chips) 
Seat 6: xAndorx ($120.30 in chips) 
Seat 7: forsmthgood ($100 in chips) 
Seat 8: Sweden_Pound ($142.85 in chips) 
Seat 9: waisanen ($249.97 in chips) 
xAndorx: posts small blind $0.50
forsmthgood: posts big blind $1
*** HOLE CARDS ***
Dealt to matiko09 [Jc Jd]
Sweden_Pound: folds 
waisanen: folds 
matiko09: raises $2 to $3
Stibitzkie has timed out
Stibitzkie: folds 
sebaaastian: folds 
djammusic: folds 
xAndorx: folds 
forsmthgood: folds 
Uncalled bet ($2) returned to matiko09
matiko09 collected $2.50 from pot
matiko09: doesn't show hand 
*** SUMMARY ***
Total pot $2.50 | Rake $0 
Seat 1: matiko09 collected ($2.50)
Seat 2: Stibitzkie folded before Flop (didn't bet)
Seat 3: sebaaastian folded before Flop (didn't bet)
Seat 5: djammusic (button) folded before Flop (didn't bet)
Seat 6: xAndorx (small blind) folded before Flop
Seat 7: forsmthgood (big blind) folded before Flop
Seat 8: Sweden_Pound folded before Flop (didn't bet)
Seat 9: waisanen folded before Flop (didn't bet)





PokerStars Hand #149393389806:  Hold'em No Limit ($0.25/$0.50 USD) - 2016/02/25 17:10:42 CET [2016/02/25 11:10:42 ET]
Table 'Thalpius III' 9-max Seat #7 is the button
Seat 1: BrotherLove9 ($61.62 in chips) 
Seat 2: matiko09 ($63.56 in chips) 
Seat 3: jamba83 ($52.83 in chips) 
Seat 4: Wwwasian ($70.51 in chips) 
Seat 5: Al3xAnd3r22 ($51.71 in chips) 
Seat 6: 111STAVR111 ($50 in chips) 
Seat 7: v4n0v ($50 in chips) 
Seat 8: jeroemie123 ($59.50 in chips) 
Seat 9: Domotirko228 ($50 in chips) 
jeroemie123: posts small blind $0.25
Domotirko228: posts big blind $0.50
*** HOLE CARDS ***
Dealt to matiko09 [7c 2d]
BrotherLove9: folds 
matiko09: folds 
jamba83: folds 
Wwwasian: folds 
Al3xAnd3r22: folds 
111STAVR111: raises $0.75 to $1.25
v4n0v: raises $2.75 to $4
jeroemie123: calls $3.75
Domotirko228: calls $3.50
111STAVR111: folds 
*** FLOP *** [2s Qh 8h]
jeroemie123: checks 
Domotirko228: checks 
v4n0v: checks 
*** TURN *** [2s Qh 8h] [3c]
jeroemie123: checks 
Domotirko228: checks 
v4n0v: bets $8.61
jeroemie123: folds 
Domotirko228: folds 
Uncalled bet ($8.61) returned to v4n0v
v4n0v collected $12.65 from pot
v4n0v: doesn't show hand 
*** SUMMARY ***
Total pot $13.25 | Rake $0.60 
Board [2s Qh 8h 3c]
Seat 1: BrotherLove9 folded before Flop (didn't bet)
Seat 2: matiko09 folded before Flop (didn't bet)
Seat 3: jamba83 folded before Flop (didn't bet)
Seat 4: Wwwasian folded before Flop (didn't bet)
Seat 5: Al3xAnd3r22 folded before Flop (didn't bet)
Seat 6: 111STAVR111 folded before Flop
Seat 7: v4n0v (button) collected ($12.65)
Seat 8: jeroemie123 (small blind) folded on the Turn
Seat 9: Domotirko228 (big blind) folded on the Turn





PokerStars Hand #149393395498:  Hold'em No Limit ($0.50/$1.00 USD) - 2016/02/25 17:10:49 CET [2016/02/25 11:10:49 ET]
Table 'Sabine' 9-max Seat #1 is the button
Seat 1: Aalleekks ($100 in chips) 
Seat 2: apfush ($134.20 in chips) 
Seat 3: Ouga Buga ($148.94 in chips) 
Seat 7: clayshmert ($60.78 in chips) 
Seat 8: matiko09 ($107.57 in chips) 
Seat 9: djammusic ($62.89 in chips) 
apfush: posts small blind $0.50
Ouga Buga: posts big blind $1
Venomous100%: sits out 
ffac: sits out 
*** HOLE CARDS ***
Dealt to matiko09 [Ad Qh]
clayshmert: raises $2 to $3
matiko09: raises $5 to $8
djammusic: folds 
Aalleekks: folds 
apfush: folds 
Ouga Buga: folds 
clayshmert: calls $5
*** FLOP *** [5h Qs 2h]
clayshmert: checks 
matiko09: bets $9
clayshmert: folds 
Uncalled bet ($9) returned to matiko09
matiko09 collected $16.71 from pot
matiko09: doesn't show hand 
*** SUMMARY ***
Total pot $17.50 | Rake $0.79 
Board [5h Qs 2h]
Seat 1: Aalleekks (button) folded before Flop (didn't bet)
Seat 2: apfush (small blind) folded before Flop
Seat 3: Ouga Buga (big blind) folded before Flop
Seat 7: clayshmert folded on the Flop
Seat 8: matiko09 collected ($16.71)
Seat 9: djammusic folded before Flop (didn't bet)





PokerStars Hand #149393399385:  Hold'em No Limit ($0.50/$1.00 USD) - 2016/02/25 17:10:54 CET [2016/02/25 11:10:54 ET]
Table 'Hercules IV' 9-max Seat #5 is the button
Seat 1: matiko09 ($101.50 in chips) 
Seat 3: HomerrrJay ($111 in chips) 
Seat 4: Sweden_Pound ($100 in chips) 
Seat 5: xAndorx ($163.08 in chips) 
Seat 6: kuanhung0903 ($50.49 in chips) 
Seat 7: Ouga Buga ($100 in chips) 
Seat 8: brokat77 ($142.17 in chips) 
Seat 9: djammusic ($35.18 in chips) 
kuanhung0903: posts small blind $0.50
Ouga Buga: posts big blind $1
*** HOLE CARDS ***
Dealt to matiko09 [2c Kd]
brokat77: folds 
djammusic: folds 
matiko09: folds 
HomerrrJay: folds 
Sweden_Pound: raises $1.50 to $2.50
xAndorx: folds 
kuanhung0903: folds 
Ouga Buga: calls $1.50
*** FLOP *** [Ah 8h 2s]
Ouga Buga: checks 
Sweden_Pound: checks 
*** TURN *** [Ah 8h 2s] [7h]
Ouga Buga: bets $3.75
Sweden_Pound: calls $3.75
*** RIVER *** [Ah 8h 2s 7h] [3h]
Ouga Buga: bets $8.88
Sweden_Pound: folds 
Uncalled bet ($8.88) returned to Ouga Buga
Ouga Buga collected $12.42 from pot
Ouga Buga: doesn't show hand 
*** SUMMARY ***
Total pot $13 | Rake $0.58 
Board [Ah 8h 2s 7h 3h]
Seat 1: matiko09 folded before Flop (didn't bet)
Seat 3: HomerrrJay folded before Flop (didn't bet)
Seat 4: Sweden_Pound folded on the River
Seat 5: xAndorx (button) folded before Flop (didn't bet)
Seat 6: kuanhung0903 (small blind) folded before Flop
Seat 7: Ouga Buga (big blind) collected ($12.42)
Seat 8: brokat77 folded before Flop (didn't bet)
Seat 9: djammusic folded before Flop (didn't bet)





PokerStars Hand #149393400202:  Hold'em No Limit ($0.50/$1.00 USD) - 2016/02/25 17:10:55 CET [2016/02/25 11:10:55 ET]
Table 'Ebella II' 9-max Seat #6 is the button
Seat 1: nickreason17 ($101 in chips) 
Seat 2: Sweden_Pound ($100 in chips) 
Seat 5: matiko09 ($100 in chips) 
Seat 6: Aalleekks ($107.43 in chips) 
Seat 8: ZMPOUTSAM140 ($86.43 in chips) 
Seat 9: simoniustin ($100 in chips) 
ZMPOUTSAM140: posts small blind $0.50
simoniustin: posts big blind $1
xAndorx: sits out 
*** HOLE CARDS ***
Dealt to matiko09 [Ac 4c]
nickreason17: folds 
Sweden_Pound: folds 
matiko09: raises $1.50 to $2.50
Aalleekks: folds 
ZMPOUTSAM140: calls $2
simoniustin: calls $1.50
*** FLOP *** [Kd Kh 5s]
ZMPOUTSAM140: checks 
simoniustin: bets $5
matiko09: folds 
ZMPOUTSAM140: folds 
Uncalled bet ($5) returned to simoniustin
simoniustin collected $7.16 from pot
simoniustin: doesn't show hand 
*** SUMMARY ***
Total pot $7.50 | Rake $0.34 
Board [Kd Kh 5s]
Seat 1: nickreason17 folded before Flop (didn't bet)
Seat 2: Sweden_Pound folded before Flop (didn't bet)
Seat 5: matiko09 folded on the Flop
Seat 6: Aalleekks (button) folded before Flop (didn't bet)
Seat 8: ZMPOUTSAM140 (small blind) folded on the Flop
Seat 9: simoniustin (big blind) collected ($7.16)





PokerStars Hand #149393401130:  Hold'em No Limit ($0.50/$1.00 USD) - 2016/02/25 17:10:56 CET [2016/02/25 11:10:56 ET]
Table 'Nerthus II' 9-max Seat #2 is the button
Seat 2: matiko09 ($194.45 in chips) 
Seat 3: simoniustin ($100 in chips) 
Seat 4: Ilov3NBA ($100.12 in chips) 
Seat 5: Sweden_Pound ($219.63 in chips) 
Seat 6: mycka86 ($100 in chips) 
Seat 7: Venomous100% ($100 in chips) 
Seat 8: Kelvin sai ($68.41 in chips) 
simoniustin: posts small blind $0.50
Ilov3NBA: posts big blind $1
DUkalisUA: sits out 
*** HOLE CARDS ***
Dealt to matiko09 [4s 3c]
Sweden_Pound has timed out
Sweden_Pound: folds 
Ilov3NBA is disconnected 
mycka86: folds 
Venomous100%: folds 
Kelvin sai: folds 
matiko09: folds 
simoniustin: folds 
Uncalled bet ($0.50) returned to Ilov3NBA
Ilov3NBA collected $1 from pot
Ilov3NBA: doesn't show hand 
*** SUMMARY ***
Total pot $1 | Rake $0 
Seat 2: matiko09 (button) folded before Flop (didn't bet)
Seat 3: simoniustin (small blind) folded before Flop
Seat 4: Ilov3NBA (big blind) collected ($1)
Seat 5: Sweden_Pound folded before Flop (didn't bet)
Seat 6: mycka86 folded before Flop (didn't bet)
Seat 7: Venomous100% folded before Flop (didn't bet)
Seat 8: Kelvin sai folded before Flop (didn't bet)





PokerStars Hand #149393408954:  Hold'em No Limit ($0.50/$1.00 USD) - 2016/02/25 17:11:06 CET [2016/02/25 11:11:06 ET]
Table 'Zeuxo II' 9-max Seat #2 is the button
Seat 1: forsmthgood ($113.79 in chips) 
Seat 2: Sweden_Pound ($114.58 in chips) 
Seat 3: xAndorx ($100 in chips) 
Seat 4: sebaaastian ($116.11 in chips) 
Seat 6: Cogss ($105.42 in chips) 
Seat 7: djammusic ($45.50 in chips) 
Seat 8: matiko09 ($102.20 in chips) 
Seat 9: Sreshta222 ($209.80 in chips) 
xAndorx: posts small blind $0.50
sebaaastian: posts big blind $1
*** HOLE CARDS ***
Dealt to matiko09 [Td Kd]
Cogss: folds 
djammusic: folds 
matiko09: raises $2 to $3
Sreshta222: folds 
forsmthgood: folds 
Sweden_Pound: folds 
xAndorx: folds 
sebaaastian: folds 
Uncalled bet ($2) returned to matiko09
matiko09 collected $2.50 from pot
matiko09: doesn't show hand 
*** SUMMARY ***
Total pot $2.50 | Rake $0 
Seat 1: forsmthgood folded before Flop (didn't bet)
Seat 2: Sweden_Pound (button) folded before Flop (didn't bet)
Seat 3: xAndorx (small blind) folded before Flop
Seat 4: sebaaastian (big blind) folded before Flop
Seat 6: Cogss folded before Flop (didn't bet)
Seat 7: djammusic folded before Flop (didn't bet)
Seat 8: matiko09 collected ($2.50)
Seat 9: Sreshta222 folded before Flop (didn't bet)





PokerStars Hand #149393417479:  Hold'em No Limit ($0.50/$1.00 USD) - 2016/02/25 17:11:17 CET [2016/02/25 11:11:17 ET]
Table 'Mayall II' 9-max Seat #8 is the button
Seat 1: matiko09 ($113.61 in chips) 
Seat 2: Sweden_Pound ($141.47 in chips) 
Seat 3: doppy 123577 ($89.85 in chips) 
Seat 4: Ouga Buga ($111.12 in chips) 
Seat 5: SumPosad ($76.34 in chips) 
Seat 6: apfush ($105.68 in chips) 
Seat 7: r.pol218 ($59.81 in chips) 
Seat 8: kuanhung0903 ($67.98 in chips) 
Seat 9: xAndorx ($137.84 in chips) 
xAndorx: posts small blind $0.50
matiko09: posts big blind $1
r.pol218: posts small & big blinds $1.50
*** HOLE CARDS ***
Dealt to matiko09 [8h 6d]
Sweden_Pound: raises $3 to $4
doppy 123577: folds 
doppy 123577 leaves the table
Ouga Buga: folds 
SumPosad: folds 
simoniustin joins the table at seat #3 
apfush: folds 
r.pol218: folds 
kuanhung0903: calls $4
xAndorx: folds 
matiko09: folds 
*** FLOP *** [Th Ks Jh]
Sweden_Pound: checks 
kuanhung0903: checks 
*** TURN *** [Th Ks Jh] [3d]
Sweden_Pound: checks 
kuanhung0903: bets $6
Sweden_Pound: folds 
Uncalled bet ($6) returned to kuanhung0903
kuanhung0903 collected $10.50 from pot
kuanhung0903: doesn't show hand 
*** SUMMARY ***
Total pot $11 | Rake $0.50 
Board [Th Ks Jh 3d]
Seat 1: matiko09 (big blind) folded before Flop
Seat 2: Sweden_Pound folded on the Turn
Seat 3: doppy 123577 folded before Flop (didn't bet)
Seat 4: Ouga Buga folded before Flop (didn't bet)
Seat 5: SumPosad folded before Flop (didn't bet)
Seat 6: apfush folded before Flop (didn't bet)
Seat 7: r.pol218 folded before Flop
Seat 8: kuanhung0903 (button) collected ($10.50)
Seat 9: xAndorx (small blind) folded before Flop





PokerStars Hand #149393428255:  Hold'em No Limit ($0.50/$1.00 USD) - 2016/02/25 17:11:31 CET [2016/02/25 11:11:31 ET]
Table 'Isa' 9-max Seat #2 is the button
Seat 1: matiko09 ($127.37 in chips) 
Seat 2: mycka86 ($100 in chips) 
Seat 3: sebaaastian ($142.25 in chips) 
Seat 5: Sweden_Pound ($178.88 in chips) 
Seat 6: xAndorx ($101.16 in chips) 
Seat 7: bilukm ($162.46 in chips) 
Seat 8: Venomous100% ($100 in chips) 
Seat 9: HomerrrJay ($100 in chips) 
sebaaastian: posts small blind $0.50
Sweden_Pound: posts big blind $1
*** HOLE CARDS ***
Dealt to matiko09 [Kc Jd]
xAndorx: folds 
bilukm: folds 
Venomous100%: folds 
HomerrrJay: raises $1.50 to $2.50
matiko09: folds 
mycka86: folds 
sebaaastian: folds 
Sweden_Pound: folds 
Uncalled bet ($1.50) returned to HomerrrJay
HomerrrJay collected $2.50 from pot
HomerrrJay: doesn't show hand 
*** SUMMARY ***
Total pot $2.50 | Rake $0 
Seat 1: matiko09 folded before Flop (didn't bet)
Seat 2: mycka86 (button) folded before Flop (didn't bet)
Seat 3: sebaaastian (small blind) folded before Flop
Seat 5: Sweden_Pound (big blind) folded before Flop
Seat 6: xAndorx folded before Flop (didn't bet)
Seat 7: bilukm folded before Flop (didn't bet)
Seat 8: Venomous100% folded before Flop (didn't bet)
Seat 9: HomerrrJay collected ($2.50)





PokerStars Hand #149393435391:  Hold'em No Limit ($0.50/$1.00 USD) - 2016/02/25 17:11:40 CET [2016/02/25 11:11:40 ET]
Table 'Badenia II' 9-max Seat #6 is the button
Seat 1: matiko09 ($101.50 in chips) 
Seat 2: Stibitzkie ($69.10 in chips) 
Seat 3: sebaaastian ($126.34 in chips) 
Seat 5: djammusic ($119.09 in chips) 
Seat 6: xAndorx ($119.80 in chips) 
Seat 7: forsmthgood ($100 in chips) 
Seat 8: Sweden_Pound ($142.85 in chips) 
Seat 9: waisanen ($249.97 in chips) 
forsmthgood: posts small blind $0.50
Sweden_Pound: posts big blind $1
*** HOLE CARDS ***
Dealt to matiko09 [Ks Ah]
waisanen: calls $1
matiko09: raises $4 to $5
Stibitzkie: calls $5
sebaaastian: folds 
djammusic: folds 
xAndorx: folds 
forsmthgood: folds 
Sweden_Pound: folds 
waisanen: folds 
*** FLOP *** [3h 9s 6s]
matiko09: checks 
Stibitzkie: checks 
*** TURN *** [3h 9s 6s] [8s]
matiko09: checks 
Stibitzkie has timed out
Stibitzkie: checks 
*** RIVER *** [3h 9s 6s 8s] [Tc]
matiko09: checks 
Stibitzkie: checks 
*** SHOW DOWN ***
matiko09: shows [Ks Ah] (high card Ace)
Stibitzkie: shows [3s 5c] (a pair of Threes)
Stibitzkie collected $11.94 from pot
*** SUMMARY ***
Total pot $12.50 | Rake $0.56 
Board [3h 9s 6s 8s Tc]
Seat 1: matiko09 showed [Ks Ah] and lost with high card Ace
Seat 2: Stibitzkie showed [3s 5c] and won ($11.94) with a pair of Threes
Seat 3: sebaaastian folded before Flop (didn't bet)
Seat 5: djammusic folded before Flop (didn't bet)
Seat 6: xAndorx (button) folded before Flop (didn't bet)
Seat 7: forsmthgood (small blind) folded before Flop
Seat 8: Sweden_Pound (big blind) folded before Flop
Seat 9: waisanen folded before Flop





PokerStars Hand #149393435965:  Hold'em No Limit ($0.50/$1.00 USD) - 2016/02/25 17:11:41 CET [2016/02/25 11:11:41 ET]
Table 'Zeuxo II' 9-max Seat #3 is the button
Seat 1: forsmthgood ($113.79 in chips) 
Seat 2: Sweden_Pound ($114.58 in chips) 
Seat 3: xAndorx ($100 in chips) 
Seat 4: sebaaastian ($115.11 in chips) 
Seat 6: Cogss ($105.42 in chips) 
Seat 7: djammusic ($45.50 in chips) 
Seat 8: matiko09 ($103.70 in chips) 
Seat 9: Sreshta222 ($209.80 in chips) 
sebaaastian: posts small blind $0.50
Cogss: posts big blind $1
*** HOLE CARDS ***
Dealt to matiko09 [6d 8s]
djammusic: folds 
matiko09: folds 
Sreshta222: folds 
forsmthgood: folds 
Sweden_Pound: raises $1.50 to $2.50
xAndorx: folds 
sebaaastian: folds 
Cogss: calls $1.50
*** FLOP *** [3h 9h Ks]
Cogss: checks 
Sweden_Pound: checks 
*** TURN *** [3h 9h Ks] [9s]
Cogss: checks 
Sweden_Pound: checks 
*** RIVER *** [3h 9h Ks 9s] [3d]
Cogss: checks 
Sweden_Pound: checks 
*** SHOW DOWN ***
Cogss: shows [2c 4h] (two pair, Nines and Threes)
Sweden_Pound: shows [8c 6c] (two pair, Nines and Threes)
Cogss collected $2.63 from pot
Sweden_Pound collected $2.62 from pot
*** SUMMARY ***
Total pot $5.50 | Rake $0.25 
Board [3h 9h Ks 9s 3d]
Seat 1: forsmthgood folded before Flop (didn't bet)
Seat 2: Sweden_Pound showed [8c 6c] and won ($2.62) with two pair, Nines and Threes
Seat 3: xAndorx (button) folded before Flop (didn't bet)
Seat 4: sebaaastian (small blind) folded before Flop
Seat 6: Cogss (big blind) showed [2c 4h] and won ($2.63) with two pair, Nines and Threes
Seat 7: djammusic folded before Flop (didn't bet)
Seat 8: matiko09 folded before Flop (didn't bet)
Seat 9: Sreshta222 folded before Flop (didn't bet)





PokerStars Hand #149393438968:  Hold'em No Limit ($0.50/$1.00 USD) - 2016/02/25 17:11:45 CET [2016/02/25 11:11:45 ET]
Table 'Sabine' 9-max Seat #2 is the button
Seat 1: Aalleekks ($100 in chips) 
Seat 2: apfush ($133.70 in chips) 
Seat 3: Ouga Buga ($147.94 in chips) 
Seat 5: Venomous100% ($100 in chips) 
Seat 7: clayshmert ($52.78 in chips) 
Seat 8: matiko09 ($116.28 in chips) 
Seat 9: djammusic ($62.89 in chips) 
Ouga Buga: posts small blind $0.50
Venomous100%: posts big blind $1
ffac: sits out 
*** HOLE CARDS ***
Dealt to matiko09 [Qc 2d]
clayshmert: folds 
matiko09: folds 
djammusic: folds 
Aalleekks: folds 
apfush: folds 
Ouga Buga: folds 
Uncalled bet ($0.50) returned to Venomous100%
Venomous100% collected $1 from pot
*** SUMMARY ***
Total pot $1 | Rake $0 
Seat 1: Aalleekks folded before Flop (didn't bet)
Seat 2: apfush (button) folded before Flop (didn't bet)
Seat 3: Ouga Buga (small blind) folded before Flop
Seat 5: Venomous100% (big blind) collected ($1)
Seat 7: clayshmert folded before Flop (didn't bet)
Seat 8: matiko09 folded before Flop (didn't bet)
Seat 9: djammusic folded before Flop (didn't bet)





PokerStars Hand #149393439665:  Hold'em No Limit ($0.25/$0.50 USD) - 2016/02/25 17:11:46 CET [2016/02/25 11:11:46 ET]
Table 'Lohja II' 9-max Seat #9 is the button
Seat 1: MoonJimmy ($140.43 in chips) 
Seat 2: Apparat888 ($45.45 in chips) 
Seat 3: guvalc1952 ($188.69 in chips) 
Seat 4: payback11 ($50.08 in chips) 
Seat 5: 111STAVR111 ($49.80 in chips) 
Seat 6: xAndorx ($62.89 in chips) 
Seat 7: matiko09 ($134.71 in chips) 
Seat 8: jamba83 ($64.97 in chips) 
Seat 9: Al3xAnd3r22 ($98 in chips) 
MoonJimmy: posts small blind $0.25
Apparat888: posts big blind $0.50
MoonJimmy: posts the ante $0.10
Apparat888: posts the ante $0.10
guvalc1952: posts the ante $0.10
payback11: posts the ante $0.10
111STAVR111: posts the ante $0.10
xAndorx: posts the ante $0.10
matiko09: posts the ante $0.10
jamba83: posts the ante $0.10
Al3xAnd3r22: posts the ante $0.10
*** HOLE CARDS ***
Dealt to matiko09 [3s 3d]
guvalc1952: folds 
payback11: folds 
111STAVR111: folds 
xAndorx: folds 
matiko09: raises $1 to $1.50
jamba83: folds 
Al3xAnd3r22: calls $1.50
MoonJimmy: folds 
Apparat888: folds 
*** FLOP *** [5c Ks 8h]
matiko09: checks 
Al3xAnd3r22: checks 
*** TURN *** [5c Ks 8h] [Ac]
matiko09: checks 
Al3xAnd3r22: bets $1.55
matiko09: folds 
Uncalled bet ($1.55) returned to Al3xAnd3r22
Al3xAnd3r22 collected $4.44 from pot
*** SUMMARY ***
Total pot $4.65 | Rake $0.21 
Board [5c Ks 8h Ac]
Seat 1: MoonJimmy (small blind) folded before Flop
Seat 2: Apparat888 (big blind) folded before Flop
Seat 3: guvalc1952 folded before Flop (didn't bet)
Seat 4: payback11 folded before Flop (didn't bet)
Seat 5: 111STAVR111 folded before Flop (didn't bet)
Seat 6: xAndorx folded before Flop (didn't bet)
Seat 7: matiko09 folded on the Turn
Seat 8: jamba83 folded before Flop (didn't bet)
Seat 9: Al3xAnd3r22 (button) collected ($4.44)





PokerStars Hand #149393440797:  Hold'em No Limit ($0.50/$1.00 USD) - 2016/02/25 17:11:47 CET [2016/02/25 11:11:47 ET]
Table 'Morosovia II' 9-max Seat #6 is the button
Seat 1: apfush ($172.26 in chips) 
Seat 2: lysandrafly ($122.44 in chips) 
Seat 3: sebaaastian ($217.86 in chips) 
Seat 4: Venomous100% ($100 in chips) 
Seat 5: pimpoza ($100.13 in chips) 
Seat 6: Sweden_Pound ($127.07 in chips) 
Seat 7: matiko09 ($166.35 in chips) 
Seat 8: simoniustin ($109.66 in chips) 
Seat 9: Ouga Buga ($135.57 in chips) 
matiko09: posts small blind $0.50
simoniustin: posts big blind $1
*** HOLE CARDS ***
Dealt to matiko09 [2c 9s]
Ouga Buga: folds 
apfush: folds 
lysandrafly: folds 
sebaaastian: folds 
Venomous100%: folds 
pimpoza: raises $2 to $3
Sweden_Pound: folds 
matiko09: folds 
simoniustin: folds 
Uncalled bet ($2) returned to pimpoza
pimpoza collected $2.50 from pot
*** SUMMARY ***
Total pot $2.50 | Rake $0 
Seat 1: apfush folded before Flop (didn't bet)
Seat 2: lysandrafly folded before Flop (didn't bet)
Seat 3: sebaaastian folded before Flop (didn't bet)
Seat 4: Venomous100% folded before Flop (didn't bet)
Seat 5: pimpoza collected ($2.50)
Seat 6: Sweden_Pound (button) folded before Flop (didn't bet)
Seat 7: matiko09 (small blind) folded before Flop
Seat 8: simoniustin (big blind) folded before Flop
Seat 9: Ouga Buga folded before Flop (didn't bet)





PokerStars Hand #149393442516:  Hold'em No Limit ($0.50/$1.00 USD) - 2016/02/25 17:11:49 CET [2016/02/25 11:11:49 ET]
Table 'Nerthus II' 9-max Seat #3 is the button
Seat 2: matiko09 ($194.45 in chips) 
Seat 3: simoniustin ($100 in chips) 
Seat 4: Ilov3NBA ($100.62 in chips) 
Seat 6: mycka86 ($100 in chips) 
Seat 7: Venomous100% ($100 in chips) 
Seat 8: Kelvin sai ($68.41 in chips) 
Ilov3NBA: posts small blind $0.50
mycka86: posts big blind $1
DUkalisUA: sits out 
*** HOLE CARDS ***
Dealt to matiko09 [Ks Ac]
Venomous100%: folds 
Kelvin sai: folds 
matiko09: raises $1.50 to $2.50
simoniustin: folds 
Ilov3NBA: folds 
mycka86: folds 
Uncalled bet ($1.50) returned to matiko09
matiko09 collected $2.50 from pot
matiko09: doesn't show hand 
*** SUMMARY ***
Total pot $2.50 | Rake $0 
Seat 2: matiko09 collected ($2.50)
Seat 3: simoniustin (button) folded before Flop (didn't bet)
Seat 4: Ilov3NBA (small blind) folded before Flop
Seat 6: mycka86 (big blind) folded before Flop
Seat 7: Venomous100% folded before Flop (didn't bet)
Seat 8: Kelvin sai folded before Flop (didn't bet)





PokerStars Hand #149393446979:  Hold'em No Limit ($0.50/$1.00 USD) - 2016/02/25 17:11:55 CET [2016/02/25 11:11:55 ET]
Table 'Ebella II' 9-max Seat #8 is the button
Seat 1: nickreason17 ($101 in chips) 
Seat 2: Sweden_Pound ($100 in chips) 
Seat 5: matiko09 ($100 in chips) 
Seat 6: Aalleekks ($107.43 in chips) 
Seat 8: ZMPOUTSAM140 ($83.93 in chips) 
Seat 9: simoniustin ($104.66 in chips) 
simoniustin: posts small blind $0.50
nickreason17: posts big blind $1
xAndorx: sits out 
*** HOLE CARDS ***
Dealt to matiko09 [Th 7d]
Sweden_Pound has timed out
Sweden_Pound: folds 
matiko09: folds 
Aalleekks: folds 
ZMPOUTSAM140: folds 
simoniustin: folds 
Uncalled bet ($0.50) returned to nickreason17
nickreason17 collected $1 from pot
*** SUMMARY ***
Total pot $1 | Rake $0 
Seat 1: nickreason17 (big blind) collected ($1)
Seat 2: Sweden_Pound folded before Flop (didn't bet)
Seat 5: matiko09 folded before Flop (didn't bet)
Seat 6: Aalleekks folded before Flop (didn't bet)
Seat 8: ZMPOUTSAM140 (button) folded before Flop (didn't bet)
Seat 9: simoniustin (small blind) folded before Flop





PokerStars Hand #149393461612:  Hold'em No Limit ($0.50/$1.00 USD) - 2016/02/25 17:12:13 CET [2016/02/25 11:12:13 ET]
Table 'Sabine' 9-max Seat #3 is the button
Seat 1: Aalleekks ($100 in chips) 
Seat 2: apfush ($133.70 in chips) 
Seat 3: Ouga Buga ($147.44 in chips) 
Seat 5: Venomous100% ($100.50 in chips) 
Seat 6: ffac ($100 in chips) 
Seat 7: clayshmert ($52.78 in chips) 
Seat 8: matiko09 ($116.28 in chips) 
Seat 9: djammusic ($62.89 in chips) 
Venomous100%: posts small blind $0.50
ffac: posts big blind $1
*** HOLE CARDS ***
Dealt to matiko09 [6s Ah]
clayshmert: calls $1
matiko09: folds 
djammusic: folds 
Aalleekks: folds 
apfush: folds 
Ouga Buga has timed out
Ouga Buga: folds 
Venomous100%: raises $3 to $4
ffac: folds 
clayshmert: calls $3
*** FLOP *** [Tc 9h Qh]
Venomous100%: bets $7.95
clayshmert: folds 
Uncalled bet ($7.95) returned to Venomous100%
Venomous100% collected $8.60 from pot
Venomous100%: doesn't show hand 
*** SUMMARY ***
Total pot $9 | Rake $0.40 
Board [Tc 9h Qh]
Seat 1: Aalleekks folded before Flop (didn't bet)
Seat 2: apfush folded before Flop (didn't bet)
Seat 3: Ouga Buga (button) folded before Flop (didn't bet)
Seat 5: Venomous100% (small blind) collected ($8.60)
Seat 6: ffac (big blind) folded before Flop
Seat 7: clayshmert folded on the Flop
Seat 8: matiko09 folded before Flop (didn't bet)
Seat 9: djammusic folded before Flop (didn't bet)





PokerStars Hand #149393463234:  Hold'em No Limit ($0.50/$1.00 USD) - 2016/02/25 17:12:16 CET [2016/02/25 11:12:16 ET]
Table 'Nerthus II' 9-max Seat #4 is the button
Seat 2: matiko09 ($195.95 in chips) 
Seat 3: simoniustin ($100 in chips) 
Seat 4: Ilov3NBA ($100.12 in chips) 
Seat 6: mycka86 ($100 in chips) 
Seat 7: Venomous100% ($100 in chips) 
Seat 8: Kelvin sai ($68.41 in chips) 
Sweden_Pound will be allowed to play after the button
mycka86: posts small blind $0.50
Venomous100%: posts big blind $1
DUkalisUA: sits out 
*** HOLE CARDS ***
Dealt to matiko09 [2d 5s]
Kelvin sai: folds 
matiko09: folds 
simoniustin: folds 
Ilov3NBA: raises $1 to $2
mycka86: raises $6 to $8
Venomous100%: folds 
Ilov3NBA: folds 
Uncalled bet ($6) returned to mycka86
mycka86 collected $5 from pot
*** SUMMARY ***
Total pot $5 | Rake $0 
Seat 2: matiko09 folded before Flop (didn't bet)
Seat 3: simoniustin folded before Flop (didn't bet)
Seat 4: Ilov3NBA (button) folded before Flop
Seat 6: mycka86 (small blind) collected ($5)
Seat 7: Venomous100% (big blind) folded before Flop
Seat 8: Kelvin sai folded before Flop (didn't bet)





PokerStars Hand #149393473223:  Hold'em No Limit ($0.50/$1.00 USD) - 2016/02/25 17:12:28 CET [2016/02/25 11:12:28 ET]
Table 'Morosovia II' 9-max Seat #7 is the button
Seat 1: apfush ($172.26 in chips) 
Seat 2: lysandrafly ($122.44 in chips) 
Seat 3: sebaaastian ($217.86 in chips) 
Seat 4: Venomous100% ($100 in chips) 
Seat 5: pimpoza ($101.63 in chips) 
Seat 6: Sweden_Pound ($127.07 in chips) 
Seat 7: matiko09 ($165.85 in chips) 
Seat 8: simoniustin ($108.66 in chips) 
Seat 9: Ouga Buga ($135.57 in chips) 
simoniustin: posts small blind $0.50
Ouga Buga: posts big blind $1
*** HOLE CARDS ***
Dealt to matiko09 [Kd Jc]
apfush: folds 
lysandrafly: folds 
sebaaastian: folds 
Venomous100%: folds 
pimpoza: raises $2 to $3
Sweden_Pound: folds 
matiko09: folds 
simoniustin: folds 
Ouga Buga: folds 
Uncalled bet ($2) returned to pimpoza
pimpoza collected $2.50 from pot
*** SUMMARY ***
Total pot $2.50 | Rake $0 
Seat 1: apfush folded before Flop (didn't bet)
Seat 2: lysandrafly folded before Flop (didn't bet)
Seat 3: sebaaastian folded before Flop (didn't bet)
Seat 4: Venomous100% folded before Flop (didn't bet)
Seat 5: pimpoza collected ($2.50)
Seat 6: Sweden_Pound folded before Flop (didn't bet)
Seat 7: matiko09 (button) folded before Flop (didn't bet)
Seat 8: simoniustin (small blind) folded before Flop
Seat 9: Ouga Buga (big blind) folded before Flop





PokerStars Hand #149393477111:  Hold'em No Limit ($0.25/$0.50 USD) - 2016/02/25 17:12:33 CET [2016/02/25 11:12:33 ET]
Table 'Thalpius III' 9-max Seat #8 is the button
Seat 1: BrotherLove9 ($61.62 in chips) 
Seat 2: matiko09 ($63.56 in chips) 
Seat 3: jamba83 ($52.83 in chips) 
Seat 4: Wwwasian ($70.51 in chips) 
Seat 5: Al3xAnd3r22 ($51.71 in chips) 
Seat 6: 111STAVR111 ($50 in chips) 
Seat 7: v4n0v ($58.65 in chips) 
Seat 8: jeroemie123 ($55.50 in chips) 
Seat 9: Domotirko228 ($50 in chips) 
Domotirko228: posts small blind $0.25
BrotherLove9: posts big blind $0.50
*** HOLE CARDS ***
Dealt to matiko09 [Qc 3c]
matiko09: folds 
jamba83: folds 
Wwwasian: folds 
Al3xAnd3r22: folds 
111STAVR111: folds 
v4n0v: folds 
jeroemie123: folds 
Domotirko228: raises $1 to $1.50
BrotherLove9: folds 
Uncalled bet ($1) returned to Domotirko228
Domotirko228 collected $1 from pot
Domotirko228: doesn't show hand 
*** SUMMARY ***
Total pot $1 | Rake $0 
Seat 1: BrotherLove9 (big blind) folded before Flop
Seat 2: matiko09 folded before Flop (didn't bet)
Seat 3: jamba83 folded before Flop (didn't bet)
Seat 4: Wwwasian folded before Flop (didn't bet)
Seat 5: Al3xAnd3r22 folded before Flop (didn't bet)
Seat 6: 111STAVR111 folded before Flop (didn't bet)
Seat 7: v4n0v folded before Flop (didn't bet)
Seat 8: jeroemie123 (button) folded before Flop (didn't bet)
Seat 9: Domotirko228 (small blind) collected ($1)





PokerStars Hand #149393478821:  Hold'em No Limit ($0.50/$1.00 USD) - 2016/02/25 17:12:36 CET [2016/02/25 11:12:36 ET]
Table 'Isa' 9-max Seat #3 is the button
Seat 1: matiko09 ($127.37 in chips) 
Seat 2: mycka86 ($100 in chips) 
Seat 3: sebaaastian ($141.75 in chips) 
Seat 5: Sweden_Pound ($177.88 in chips) 
Seat 6: xAndorx ($101.16 in chips) 
Seat 7: bilukm ($162.46 in chips) 
Seat 8: Venomous100% ($100 in chips) 
Seat 9: HomerrrJay ($101.50 in chips) 
Sweden_Pound: posts small blind $0.50
xAndorx: posts big blind $1
*** HOLE CARDS ***
Dealt to matiko09 [Th 6c]
bilukm: calls $1
Venomous100%: folds 
HomerrrJay: folds 
matiko09: folds 
mycka86: raises $3.50 to $4.50
sebaaastian: folds 
Sweden_Pound: folds 
xAndorx: folds 
bilukm: folds 
Uncalled bet ($3.50) returned to mycka86
mycka86 collected $3.50 from pot
*** SUMMARY ***
Total pot $3.50 | Rake $0 
Seat 1: matiko09 folded before Flop (didn't bet)
Seat 2: mycka86 collected ($3.50)
Seat 3: sebaaastian (button) folded before Flop (didn't bet)
Seat 5: Sweden_Pound (small blind) folded before Flop
Seat 6: xAndorx (big blind) folded before Flop
Seat 7: bilukm folded before Flop
Seat 8: Venomous100% folded before Flop (didn't bet)
Seat 9: HomerrrJay folded before Flop (didn't bet)





PokerStars Hand #149393481045:  Hold'em No Limit ($0.50/$1.00 USD) - 2016/02/25 17:12:38 CET [2016/02/25 11:12:38 ET]
Table 'Ebella II' 9-max Seat #9 is the button
Seat 1: nickreason17 ($101.50 in chips) 
Seat 2: Sweden_Pound ($100 in chips) 
Seat 5: matiko09 ($100 in chips) 
Seat 6: Aalleekks ($107.43 in chips) 
Seat 8: ZMPOUTSAM140 ($83.93 in chips) 
Seat 9: simoniustin ($104.16 in chips) 
nickreason17: posts small blind $0.50
Sweden_Pound: posts big blind $1
xAndorx: sits out 
*** HOLE CARDS ***
Dealt to matiko09 [Jh 9c]
matiko09: folds 
Aalleekks: folds 
ZMPOUTSAM140: raises $1 to $2
simoniustin: folds 
nickreason17: raises $6 to $8
Sweden_Pound: folds 
ZMPOUTSAM140: folds 
Uncalled bet ($6) returned to nickreason17
nickreason17 collected $5 from pot
*** SUMMARY ***
Total pot $5 | Rake $0 
Seat 1: nickreason17 (small blind) collected ($5)
Seat 2: Sweden_Pound (big blind) folded before Flop
Seat 5: matiko09 folded before Flop (didn't bet)
Seat 6: Aalleekks folded before Flop (didn't bet)
Seat 8: ZMPOUTSAM140 folded before Flop
Seat 9: simoniustin (button) folded before Flop (didn't bet)





PokerStars Hand #149393485381:  Hold'em No Limit ($0.50/$1.00 USD) - 2016/02/25 17:12:44 CET [2016/02/25 11:12:44 ET]
Table 'Nerthus II' 9-max Seat #6 is the button
Seat 2: matiko09 ($195.95 in chips) 
Seat 3: simoniustin ($100 in chips) 
Seat 4: Ilov3NBA ($100 in chips) 
Seat 6: mycka86 ($103 in chips) 
Seat 7: Venomous100% ($100 in chips) 
Seat 8: Kelvin sai ($68.41 in chips) 
Venomous100%: posts small blind $0.50
Kelvin sai: posts big blind $1
DUkalisUA: sits out 
Sweden_Pound: sits out 
*** HOLE CARDS ***
Dealt to matiko09 [5s 9h]
matiko09: folds 
simoniustin: folds 
Ilov3NBA: raises $1.50 to $2.50
mycka86: folds 
Venomous100%: folds 
Kelvin sai: calls $1.50
*** FLOP *** [6d Ts Ah]
Kelvin sai: checks 
Ilov3NBA: checks 
*** TURN *** [6d Ts Ah] [Jd]
Kelvin sai: checks 
Ilov3NBA: checks 
*** RIVER *** [6d Ts Ah Jd] [Td]
Kelvin sai: checks 
Ilov3NBA: checks 
*** SHOW DOWN ***
Kelvin sai: shows [9d 5c] (a pair of Tens)
Ilov3NBA: shows [8h 8s] (two pair, Tens and Eights)
Ilov3NBA collected $5.25 from pot
*** SUMMARY ***
Total pot $5.50 | Rake $0.25 
Board [6d Ts Ah Jd Td]
Seat 2: matiko09 folded before Flop (didn't bet)
Seat 3: simoniustin folded before Flop (didn't bet)
Seat 4: Ilov3NBA showed [8h 8s] and won ($5.25) with two pair, Tens and Eights
Seat 6: mycka86 (button) folded before Flop (didn't bet)
Seat 7: Venomous100% (small blind) folded before Flop
Seat 8: Kelvin sai (big blind) showed [9d 5c] and lost with a pair of Tens





PokerStars Hand #149393490007:  Hold'em No Limit ($0.50/$1.00 USD) - 2016/02/25 17:12:50 CET [2016/02/25 11:12:50 ET]
Table 'Hercules IV' 9-max Seat #6 is the button
Seat 1: matiko09 ($101.50 in chips) 
Seat 3: HomerrrJay ($111 in chips) 
Seat 4: Sweden_Pound ($100 in chips) 
Seat 5: xAndorx ($163.08 in chips) 
Seat 6: kuanhung0903 ($49.99 in chips) 
Seat 7: Ouga Buga ($106.17 in chips) 
Seat 8: brokat77 ($142.17 in chips) 
Seat 9: djammusic ($35.18 in chips) 
Ouga Buga: posts small blind $0.50
brokat77: posts big blind $1
*** HOLE CARDS ***
Dealt to matiko09 [Kd 7h]
djammusic: folds 
matiko09: folds 
HomerrrJay: folds 
Sweden_Pound: folds 
xAndorx: folds 
kuanhung0903: raises $2 to $3
Ouga Buga: folds 
brokat77: calls $2
*** FLOP *** [8d 7d Qc]
brokat77: checks 
kuanhung0903: bets $4
brokat77: calls $4
*** TURN *** [8d 7d Qc] [2c]
brokat77: checks 
kuanhung0903: checks 
*** RIVER *** [8d 7d Qc 2c] [3c]
brokat77: bets $5
kuanhung0903: raises $8 to $13
brokat77: folds 
Uncalled bet ($8) returned to kuanhung0903
kuanhung0903 collected $23.40 from pot
kuanhung0903: doesn't show hand 
*** SUMMARY ***
Total pot $24.50 | Rake $1.10 
Board [8d 7d Qc 2c 3c]
Seat 1: matiko09 folded before Flop (didn't bet)
Seat 3: HomerrrJay folded before Flop (didn't bet)
Seat 4: Sweden_Pound folded before Flop (didn't bet)
Seat 5: xAndorx folded before Flop (didn't bet)
Seat 6: kuanhung0903 (button) collected ($23.40)
Seat 7: Ouga Buga (small blind) folded before Flop
Seat 8: brokat77 (big blind) folded on the River
Seat 9: djammusic folded before Flop (didn't bet)





PokerStars Hand #149393493661:  Hold'em No Limit ($0.50/$1.00 USD) - 2016/02/25 17:12:55 CET [2016/02/25 11:12:55 ET]
Table 'Mayall II' 9-max Seat #9 is the button
Seat 1: matiko09 ($112.61 in chips) 
Seat 2: Sweden_Pound ($137.47 in chips) 
Seat 4: Ouga Buga ($111.12 in chips) 
Seat 5: SumPosad ($76.34 in chips) 
Seat 6: apfush ($105.68 in chips) 
Seat 7: r.pol218 ($58.31 in chips) 
Seat 8: kuanhung0903 ($74.48 in chips) 
Seat 9: xAndorx ($137.34 in chips) 
matiko09: posts small blind $0.50
Sweden_Pound: posts big blind $1
simoniustin: sits out 
*** HOLE CARDS ***
Dealt to matiko09 [Qd 2s]
Ouga Buga: folds 
SumPosad: folds 
apfush: folds 
r.pol218: calls $1
kuanhung0903: folds 
xAndorx: folds 
matiko09: folds 
Sweden_Pound: checks 
*** FLOP *** [5h 8h Kd]
Sweden_Pound: checks 
r.pol218: checks 
*** TURN *** [5h 8h Kd] [Kc]
Sweden_Pound: checks 
r.pol218: checks 
*** RIVER *** [5h 8h Kd Kc] [Ad]
Sweden_Pound: checks 
r.pol218: checks 
*** SHOW DOWN ***
Sweden_Pound: shows [6d 4d] (a pair of Kings)
r.pol218: shows [Td Qc] (a pair of Kings - Ace+Queen kicker)
r.pol218 collected $2.39 from pot
*** SUMMARY ***
Total pot $2.50 | Rake $0.11 
Board [5h 8h Kd Kc Ad]
Seat 1: matiko09 (small blind) folded before Flop
Seat 2: Sweden_Pound (big blind) showed [6d 4d] and lost with a pair of Kings
Seat 4: Ouga Buga folded before Flop (didn't bet)
Seat 5: SumPosad folded before Flop (didn't bet)
Seat 6: apfush folded before Flop (didn't bet)
Seat 7: r.pol218 showed [Td Qc] and won ($2.39) with a pair of Kings
Seat 8: kuanhung0903 folded before Flop (didn't bet)
Seat 9: xAndorx (button) folded before Flop (didn't bet)





PokerStars Hand #149393494845:  Hold'em No Limit ($0.50/$1.00 USD) - 2016/02/25 17:12:56 CET [2016/02/25 11:12:56 ET]
Table 'Zeuxo II' 9-max Seat #4 is the button
Seat 1: forsmthgood ($113.79 in chips) 
Seat 2: Sweden_Pound ($114.70 in chips) 
Seat 3: xAndorx ($100 in chips) 
Seat 4: sebaaastian ($114.61 in chips) 
Seat 6: Cogss ($105.55 in chips) 
Seat 7: djammusic ($45.50 in chips) 
Seat 8: matiko09 ($103.70 in chips) 
Seat 9: Sreshta222 ($209.80 in chips) 
Cogss: posts small blind $0.50
djammusic: posts big blind $1
*** HOLE CARDS ***
Dealt to matiko09 [8d 7d]
matiko09: raises $2 to $3
Sreshta222: folds 
forsmthgood: folds 
Sweden_Pound: folds 
xAndorx: folds 
sebaaastian: folds 
Cogss: folds 
djammusic: folds 
Uncalled bet ($2) returned to matiko09
matiko09 collected $2.50 from pot
matiko09: doesn't show hand 
*** SUMMARY ***
Total pot $2.50 | Rake $0 
Seat 1: forsmthgood folded before Flop (didn't bet)
Seat 2: Sweden_Pound folded before Flop (didn't bet)
Seat 3: xAndorx folded before Flop (didn't bet)
Seat 4: sebaaastian (button) folded before Flop (didn't bet)
Seat 6: Cogss (small blind) folded before Flop
Seat 7: djammusic (big blind) folded before Flop
Seat 8: matiko09 collected ($2.50)
Seat 9: Sreshta222 folded before Flop (didn't bet)





PokerStars Hand #149393504545:  Hold'em No Limit ($0.50/$1.00 USD) - 2016/02/25 17:13:08 CET [2016/02/25 11:13:08 ET]
Table 'Ebella II' 9-max Seat #1 is the button
Seat 1: nickreason17 ($104.50 in chips) 
Seat 2: Sweden_Pound ($100 in chips) 
Seat 4: xAndorx ($100 in chips) 
Seat 5: matiko09 ($100 in chips) 
Seat 6: Aalleekks ($107.43 in chips) 
Seat 8: ZMPOUTSAM140 ($81.93 in chips) 
Seat 9: simoniustin ($104.16 in chips) 
Sweden_Pound: posts small blind $0.50
xAndorx: posts big blind $1
*** HOLE CARDS ***
Dealt to matiko09 [8c 2d]
matiko09: folds 
Aalleekks has timed out
Aalleekks: folds 
ZMPOUTSAM140: folds 
simoniustin: folds 
nickreason17: raises $1.04 to $2.04
Sweden_Pound: folds 
xAndorx: calls $1.04
*** FLOP *** [Ad 8s 7s]
xAndorx: checks 
nickreason17: checks 
*** TURN *** [Ad 8s 7s] [Tc]
xAndorx: checks 
nickreason17: bets $3.44
xAndorx: folds 
Uncalled bet ($3.44) returned to nickreason17
nickreason17 collected $4.37 from pot
*** SUMMARY ***
Total pot $4.58 | Rake $0.21 
Board [Ad 8s 7s Tc]
Seat 1: nickreason17 (button) collected ($4.37)
Seat 2: Sweden_Pound (small blind) folded before Flop
Seat 4: xAndorx (big blind) folded on the Turn
Seat 5: matiko09 folded before Flop (didn't bet)
Seat 6: Aalleekks folded before Flop (didn't bet)
Seat 8: ZMPOUTSAM140 folded before Flop (didn't bet)
Seat 9: simoniustin folded before Flop (didn't bet)





PokerStars Hand #149393504557:  Hold'em No Limit ($0.25/$0.50 USD) - 2016/02/25 17:13:08 CET [2016/02/25 11:13:08 ET]
Table 'Lohja II' 9-max Seat #1 is the button
Seat 1: MoonJimmy ($140.08 in chips) 
Seat 2: Apparat888 ($44.85 in chips) 
Seat 3: guvalc1952 ($188.59 in chips) 
Seat 4: payback11 ($50 in chips) 
Seat 5: 111STAVR111 ($49.70 in chips) 
Seat 6: xAndorx ($62.79 in chips) 
Seat 7: matiko09 ($133.11 in chips) 
Seat 8: jamba83 ($64.87 in chips) 
Seat 9: Al3xAnd3r22 ($100.84 in chips) 
Apparat888: posts small blind $0.25
guvalc1952: posts big blind $0.50
MoonJimmy: posts the ante $0.10
Apparat888: posts the ante $0.10
guvalc1952: posts the ante $0.10
payback11: posts the ante $0.10
111STAVR111: posts the ante $0.10
xAndorx: posts the ante $0.10
matiko09: posts the ante $0.10
jamba83: posts the ante $0.10
Al3xAnd3r22: posts the ante $0.10
*** HOLE CARDS ***
Dealt to matiko09 [Qh Kc]
payback11: folds 
111STAVR111: folds 
xAndorx: folds 
matiko09: raises $1 to $1.50
jamba83: folds 
Al3xAnd3r22: folds 
MoonJimmy: folds 
Apparat888: folds 
guvalc1952: calls $1
*** FLOP *** [5s Kd 6s]
guvalc1952: checks 
matiko09: bets $2.57
guvalc1952: calls $2.57
*** TURN *** [5s Kd 6s] [6h]
guvalc1952: checks 
matiko09: bets $5.50
guvalc1952: calls $5.50
*** RIVER *** [5s Kd 6s 6h] [4c]
guvalc1952: bets $9.69
matiko09: folds 
Uncalled bet ($9.69) returned to guvalc1952
guvalc1952 collected $19.38 from pot
guvalc1952: doesn't show hand 
*** SUMMARY ***
Total pot $20.29 | Rake $0.91 
Board [5s Kd 6s 6h 4c]
Seat 1: MoonJimmy (button) folded before Flop (didn't bet)
Seat 2: Apparat888 (small blind) folded before Flop
Seat 3: guvalc1952 (big blind) collected ($19.38)
Seat 4: payback11 folded before Flop (didn't bet)
Seat 5: 111STAVR111 folded before Flop (didn't bet)
Seat 6: xAndorx folded before Flop (didn't bet)
Seat 7: matiko09 folded on the River
Seat 8: jamba83 folded before Flop (didn't bet)
Seat 9: Al3xAnd3r22 folded before Flop (didn't bet)





PokerStars Hand #149393507799:  Hold'em No Limit ($0.50/$1.00 USD) - 2016/02/25 17:13:13 CET [2016/02/25 11:13:13 ET]
Table 'Morosovia II' 9-max Seat #8 is the button
Seat 1: apfush ($172.26 in chips) 
Seat 2: lysandrafly ($122.44 in chips) 
Seat 3: sebaaastian ($217.86 in chips) 
Seat 4: Venomous100% ($100 in chips) 
Seat 5: pimpoza ($103.13 in chips) 
Seat 6: Sweden_Pound ($127.07 in chips) 
Seat 7: matiko09 ($165.85 in chips) 
Seat 8: simoniustin ($108.16 in chips) 
Seat 9: Ouga Buga ($134.57 in chips) 
Ouga Buga: posts small blind $0.50
apfush: posts big blind $1
*** HOLE CARDS ***
Dealt to matiko09 [Qc 5c]
lysandrafly: folds 
lysandrafly leaves the table
sebaaastian: folds 
Effort92 joins the table at seat #2 
Venomous100%: folds 
pimpoza: folds 
Sweden_Pound: folds 
matiko09: folds 
simoniustin: folds 
Ouga Buga: folds 
Uncalled bet ($0.50) returned to apfush
apfush collected $1 from pot
apfush: doesn't show hand 
*** SUMMARY ***
Total pot $1 | Rake $0 
Seat 1: apfush (big blind) collected ($1)
Seat 2: lysandrafly folded before Flop (didn't bet)
Seat 3: sebaaastian folded before Flop (didn't bet)
Seat 4: Venomous100% folded before Flop (didn't bet)
Seat 5: pimpoza folded before Flop (didn't bet)
Seat 6: Sweden_Pound folded before Flop (didn't bet)
Seat 7: matiko09 folded before Flop (didn't bet)
Seat 8: simoniustin (button) folded before Flop (didn't bet)
Seat 9: Ouga Buga (small blind) folded before Flop





PokerStars Hand #149393510621:  Hold'em No Limit ($0.50/$1.00 USD) - 2016/02/25 17:13:16 CET [2016/02/25 11:13:16 ET]
Table 'Isa' 9-max Seat #5 is the button
Seat 1: matiko09 ($127.37 in chips) 
Seat 2: mycka86 ($102.50 in chips) 
Seat 3: sebaaastian ($141.75 in chips) 
Seat 5: Sweden_Pound ($177.38 in chips) 
Seat 6: xAndorx ($100.16 in chips) 
Seat 7: bilukm ($161.46 in chips) 
Seat 8: Venomous100% ($100 in chips) 
Seat 9: HomerrrJay ($101.50 in chips) 
xAndorx: posts small blind $0.50
bilukm: posts big blind $1
*** HOLE CARDS ***
Dealt to matiko09 [9c Kd]
Venomous100%: folds 
HomerrrJay: folds 
matiko09: folds 
mycka86: folds 
sebaaastian: folds 
Sweden_Pound: raises $1 to $2
xAndorx: folds 
bilukm: calls $1
*** FLOP *** [9s 8d 5c]
bilukm: checks 
Sweden_Pound: checks 
*** TURN *** [9s 8d 5c] [8h]
bilukm: bets $2.15
Sweden_Pound: folds 
Uncalled bet ($2.15) returned to bilukm
bilukm collected $4.30 from pot
bilukm: doesn't show hand 
*** SUMMARY ***
Total pot $4.50 | Rake $0.20 
Board [9s 8d 5c 8h]
Seat 1: matiko09 folded before Flop (didn't bet)
Seat 2: mycka86 folded before Flop (didn't bet)
Seat 3: sebaaastian folded before Flop (didn't bet)
Seat 5: Sweden_Pound (button) folded on the Turn
Seat 6: xAndorx (small blind) folded before Flop
Seat 7: bilukm (big blind) collected ($4.30)
Seat 8: Venomous100% folded before Flop (didn't bet)
Seat 9: HomerrrJay folded before Flop (didn't bet)





PokerStars Hand #149393512071:  Hold'em No Limit ($0.25/$0.50 USD) - 2016/02/25 17:13:18 CET [2016/02/25 11:13:18 ET]
Table 'Thalpius III' 9-max Seat #9 is the button
Seat 1: BrotherLove9 ($61.12 in chips) 
Seat 2: matiko09 ($63.56 in chips) 
Seat 3: jamba83 ($52.83 in chips) 
Seat 4: Wwwasian ($70.51 in chips) 
Seat 5: Al3xAnd3r22 ($51.71 in chips) 
Seat 6: 111STAVR111 ($50 in chips) 
Seat 7: v4n0v ($58.65 in chips) 
Seat 8: jeroemie123 ($55.50 in chips) 
Seat 9: Domotirko228 ($50.50 in chips) 
BrotherLove9: posts small blind $0.25
matiko09: posts big blind $0.50
*** HOLE CARDS ***
Dealt to matiko09 [3h As]
jamba83: folds 
Wwwasian: folds 
Al3xAnd3r22: folds 
111STAVR111: folds 
v4n0v: folds 
jeroemie123: raises $0.50 to $1
Domotirko228: folds 
BrotherLove9: folds 
matiko09: folds 
Uncalled bet ($0.50) returned to jeroemie123
jeroemie123 collected $1.25 from pot
jeroemie123: doesn't show hand 
*** SUMMARY ***
Total pot $1.25 | Rake $0 
Seat 1: BrotherLove9 (small blind) folded before Flop
Seat 2: matiko09 (big blind) folded before Flop
Seat 3: jamba83 folded before Flop (didn't bet)
Seat 4: Wwwasian folded before Flop (didn't bet)
Seat 5: Al3xAnd3r22 folded before Flop (didn't bet)
Seat 6: 111STAVR111 folded before Flop (didn't bet)
Seat 7: v4n0v folded before Flop (didn't bet)
Seat 8: jeroemie123 collected ($1.25)
Seat 9: Domotirko228 (button) folded before Flop (didn't bet)





PokerStars Hand #149393518697:  Hold'em No Limit ($0.50/$1.00 USD) - 2016/02/25 17:13:26 CET [2016/02/25 11:13:26 ET]
Table 'Zeuxo II' 9-max Seat #6 is the button
Seat 1: forsmthgood ($113.79 in chips) 
Seat 2: Sweden_Pound ($114.70 in chips) 
Seat 3: xAndorx ($100 in chips) 
Seat 4: sebaaastian ($114.61 in chips) 
Seat 6: Cogss ($105.05 in chips) 
Seat 7: djammusic ($44.50 in chips) 
Seat 8: matiko09 ($105.20 in chips) 
Seat 9: Sreshta222 ($209.80 in chips) 
djammusic: posts small blind $0.50
matiko09: posts big blind $1
*** HOLE CARDS ***
Dealt to matiko09 [Jd 4h]
Sreshta222: folds 
forsmthgood: folds 
Sweden_Pound: folds 
xAndorx: folds 
sebaaastian: raises $1.50 to $2.50
Cogss: folds 
djammusic: raises $4.50 to $7
matiko09: folds 
sebaaastian: folds 
Uncalled bet ($4.50) returned to djammusic
djammusic collected $6 from pot
djammusic: doesn't show hand 
*** SUMMARY ***
Total pot $6 | Rake $0 
Seat 1: forsmthgood folded before Flop (didn't bet)
Seat 2: Sweden_Pound folded before Flop (didn't bet)
Seat 3: xAndorx folded before Flop (didn't bet)
Seat 4: sebaaastian folded before Flop
Seat 6: Cogss (button) folded before Flop (didn't bet)
Seat 7: djammusic (small blind) collected ($6)
Seat 8: matiko09 (big blind) folded before Flop
Seat 9: Sreshta222 folded before Flop (didn't bet)





PokerStars Hand #149393519696:  Hold'em No Limit ($0.50/$1.00 USD) - 2016/02/25 17:13:28 CET [2016/02/25 11:13:28 ET]
Table 'Sabine' 9-max Seat #5 is the button
Seat 1: Aalleekks ($100 in chips) 
Seat 2: apfush ($133.70 in chips) 
Seat 3: Ouga Buga ($147.44 in chips) 
Seat 5: Venomous100% ($105.10 in chips) 
Seat 6: ffac ($100 in chips) 
Seat 7: clayshmert ($48.78 in chips) 
Seat 8: matiko09 ($116.28 in chips) 
Seat 9: djammusic ($62.89 in chips) 
ffac: posts small blind $0.50
clayshmert: posts big blind $1
*** HOLE CARDS ***
Dealt to matiko09 [Kd Ks]
matiko09: raises $2 to $3
djammusic: folds 
Aalleekks has timed out
Aalleekks: folds 
apfush: folds 
Ouga Buga: folds 
Venomous100%: folds 
ffac: folds 
clayshmert: calls $2
*** FLOP *** [8d 9c 4d]
clayshmert: checks 
matiko09: bets $4.04
clayshmert: folds 
Uncalled bet ($4.04) returned to matiko09
matiko09 collected $6.21 from pot
matiko09: doesn't show hand 
*** SUMMARY ***
Total pot $6.50 | Rake $0.29 
Board [8d 9c 4d]
Seat 1: Aalleekks folded before Flop (didn't bet)
Seat 2: apfush folded before Flop (didn't bet)
Seat 3: Ouga Buga folded before Flop (didn't bet)
Seat 5: Venomous100% (button) folded before Flop (didn't bet)
Seat 6: ffac (small blind) folded before Flop
Seat 7: clayshmert (big blind) folded on the Flop
Seat 8: matiko09 collected ($6.21)
Seat 9: djammusic folded before Flop (didn't bet)





PokerStars Hand #149393520729:  Hold'em No Limit ($0.50/$1.00 USD) - 2016/02/25 17:13:29 CET [2016/02/25 11:13:29 ET]
Table 'Nerthus II' 9-max Seat #7 is the button
Seat 1: DUkalisUA ($100 in chips) 
Seat 2: matiko09 ($195.95 in chips) 
Seat 3: simoniustin ($100 in chips) 
Seat 4: Ilov3NBA ($102.75 in chips) 
Seat 6: mycka86 ($103 in chips) 
Seat 7: Venomous100% ($100 in chips) 
Seat 8: Kelvin sai ($65.91 in chips) 
Kelvin sai: posts small blind $0.50
DUkalisUA: posts big blind $1
Sweden_Pound: sits out 
*** HOLE CARDS ***
Dealt to matiko09 [Ks 7d]
matiko09: folds 
simoniustin: folds 
Ilov3NBA: folds 
mycka86: folds 
Venomous100%: raises $2 to $3
Kelvin sai: folds 
DUkalisUA: folds 
Uncalled bet ($2) returned to Venomous100%
Venomous100% collected $2.50 from pot
Venomous100%: doesn't show hand 
*** SUMMARY ***
Total pot $2.50 | Rake $0 
Seat 1: DUkalisUA (big blind) folded before Flop
Seat 2: matiko09 folded before Flop (didn't bet)
Seat 3: simoniustin folded before Flop (didn't bet)
Seat 4: Ilov3NBA folded before Flop (didn't bet)
Seat 6: mycka86 folded before Flop (didn't bet)
Seat 7: Venomous100% (button) collected ($2.50)
Seat 8: Kelvin sai (small blind) folded before Flop





PokerStars Hand #149393536300:  Hold'em No Limit ($0.50/$1.00 USD) - 2016/02/25 17:13:49 CET [2016/02/25 11:13:49 ET]
Table 'Syrma II' 9-max Seat #5 is the button
Seat 1: lysandrafly ($100 in chips) 
Seat 2: Sreshta222 ($108.71 in chips) 
Seat 3: simoniustin ($118.42 in chips) 
Seat 5: nickreason17 ($112.54 in chips) 
Seat 6: ffac ($120.15 in chips) 
Seat 7: matiko09 ($100 in chips) 
Seat 9: gulseren848 ($63.63 in chips) 
ffac: posts small blind $0.50
matiko09: posts big blind $1
*** HOLE CARDS ***
Dealt to matiko09 [Jc 3s]
gulseren848: calls $1
lysandrafly: raises $4.50 to $5.50
Sreshta222: raises $9 to $14.50
simoniustin: folds 
nickreason17: folds 
ffac: folds 
matiko09: folds 
gulseren848: folds 
lysandrafly: folds 
Uncalled bet ($9) returned to Sreshta222
Sreshta222 collected $13.50 from pot
Sreshta222: doesn't show hand 
*** SUMMARY ***
Total pot $13.50 | Rake $0 
Seat 1: lysandrafly folded before Flop
Seat 2: Sreshta222 collected ($13.50)
Seat 3: simoniustin folded before Flop (didn't bet)
Seat 5: nickreason17 (button) folded before Flop (didn't bet)
Seat 6: ffac (small blind) folded before Flop
Seat 7: matiko09 (big blind) folded before Flop
Seat 9: gulseren848 folded before Flop





PokerStars Hand #149393541344:  Hold'em No Limit ($0.50/$1.00 USD) - 2016/02/25 17:13:55 CET [2016/02/25 11:13:55 ET]
Table 'Mayall II' 9-max Seat #1 is the button
Seat 1: matiko09 ($112.11 in chips) 
Seat 2: Sweden_Pound ($136.47 in chips) 
Seat 3: simoniustin ($100 in chips) 
Seat 4: Ouga Buga ($111.12 in chips) 
Seat 5: SumPosad ($76.34 in chips) 
Seat 6: apfush ($105.68 in chips) 
Seat 7: r.pol218 ($59.70 in chips) 
Seat 8: kuanhung0903 ($74.48 in chips) 
Seat 9: xAndorx ($137.34 in chips) 
Sweden_Pound: posts small blind $0.50
simoniustin: posts big blind $1
*** HOLE CARDS ***
Dealt to matiko09 [2c 7s]
Ouga Buga: folds 
SumPosad: folds 
apfush: folds 
r.pol218: calls $1
kuanhung0903: folds 
xAndorx: raises $3 to $4
matiko09: folds 
Sweden_Pound: raises $10 to $14
simoniustin: folds 
r.pol218: folds 
xAndorx: folds 
Uncalled bet ($10) returned to Sweden_Pound
Sweden_Pound collected $10 from pot
Sweden_Pound: doesn't show hand 
*** SUMMARY ***
Total pot $10 | Rake $0 
Seat 1: matiko09 (button) folded before Flop (didn't bet)
Seat 2: Sweden_Pound (small blind) collected ($10)
Seat 3: simoniustin (big blind) folded before Flop
Seat 4: Ouga Buga folded before Flop (didn't bet)
Seat 5: SumPosad folded before Flop (didn't bet)
Seat 6: apfush folded before Flop (didn't bet)
Seat 7: r.pol218 folded before Flop
Seat 8: kuanhung0903 folded before Flop (didn't bet)
Seat 9: xAndorx folded before Flop





PokerStars Hand #149393541971:  Hold'em No Limit ($0.50/$1.00 USD) - 2016/02/25 17:13:56 CET [2016/02/25 11:13:56 ET]
Table 'Morosovia II' 9-max Seat #9 is the button
Seat 1: apfush ($172.76 in chips) 
Seat 2: Effort92 ($100 in chips) 
Seat 3: sebaaastian ($217.86 in chips) 
Seat 4: Venomous100% ($100 in chips) 
Seat 5: pimpoza ($103.13 in chips) 
Seat 6: Sweden_Pound ($127.07 in chips) 
Seat 7: matiko09 ($165.85 in chips) 
Seat 8: simoniustin ($108.16 in chips) 
Seat 9: Ouga Buga ($134.07 in chips) 
apfush: posts small blind $0.50
Effort92: posts big blind $1
*** HOLE CARDS ***
Dealt to matiko09 [9h 8h]
sebaaastian: folds 
Venomous100%: raises $2 to $3
pimpoza: folds 
Sweden_Pound: folds 
matiko09: calls $3
simoniustin: folds 
Ouga Buga: folds 
apfush: folds 
Effort92: calls $2
*** FLOP *** [5d 6d 8s]
Effort92: checks 
Venomous100%: checks 
matiko09: bets $5.90
Effort92: calls $5.90
Venomous100%: folds 
*** TURN *** [5d 6d 8s] [8d]
Effort92: checks 
matiko09: checks 
*** RIVER *** [5d 6d 8s 8d] [7c]
Effort92: bets $12.61
matiko09: calls $12.61
*** SHOW DOWN ***
Effort92: shows [9d 9c] (a straight, Five to Nine)
matiko09: shows [9h 8h] (a straight, Five to Nine)
Effort92 collected $22.22 from pot
matiko09 collected $22.21 from pot
*** SUMMARY ***
Total pot $46.52 | Rake $2.09 
Board [5d 6d 8s 8d 7c]
Seat 1: apfush (small blind) folded before Flop
Seat 2: Effort92 (big blind) showed [9d 9c] and won ($22.22) with a straight, Five to Nine
Seat 3: sebaaastian folded before Flop (didn't bet)
Seat 4: Venomous100% folded on the Flop
Seat 5: pimpoza folded before Flop (didn't bet)
Seat 6: Sweden_Pound folded before Flop (didn't bet)
Seat 7: matiko09 showed [9h 8h] and won ($22.21) with a straight, Five to Nine
Seat 8: simoniustin folded before Flop (didn't bet)
Seat 9: Ouga Buga (button) folded before Flop (didn't bet)





PokerStars Hand #149393544020:  Hold'em No Limit ($0.50/$1.00 USD) - 2016/02/25 17:13:58 CET [2016/02/25 11:13:58 ET]
Table 'Nerthus II' 9-max Seat #8 is the button
Seat 1: DUkalisUA ($100 in chips) 
Seat 2: matiko09 ($195.95 in chips) 
Seat 3: simoniustin ($100 in chips) 
Seat 4: Ilov3NBA ($102.75 in chips) 
Seat 6: mycka86 ($103 in chips) 
Seat 7: Venomous100% ($101.50 in chips) 
Seat 8: Kelvin sai ($65.41 in chips) 
DUkalisUA: posts small blind $0.50
matiko09: posts big blind $1
Sweden_Pound: sits out 
*** HOLE CARDS ***
Dealt to matiko09 [Kd Ks]
simoniustin: raises $2 to $3
Ilov3NBA: folds 
mycka86: folds 
Venomous100%: calls $3
Kelvin sai: calls $3
DUkalisUA: calls $2.50
matiko09: raises $11 to $14
simoniustin: folds 
Venomous100%: folds 
Kelvin sai: calls $11
DUkalisUA: folds 
*** FLOP *** [Jd 2d 3h]
matiko09: bets $12
Kelvin sai: folds 
Uncalled bet ($12) returned to matiko09
matiko09 collected $35.34 from pot
matiko09: doesn't show hand 
*** SUMMARY ***
Total pot $37 | Rake $1.66 
Board [Jd 2d 3h]
Seat 1: DUkalisUA (small blind) folded before Flop
Seat 2: matiko09 (big blind) collected ($35.34)
Seat 3: simoniustin folded before Flop
Seat 4: Ilov3NBA folded before Flop (didn't bet)
Seat 6: mycka86 folded before Flop (didn't bet)
Seat 7: Venomous100% folded before Flop
Seat 8: Kelvin sai (button) folded on the Flop





PokerStars Hand #149393549493:  Hold'em No Limit ($0.25/$0.50 USD) - 2016/02/25 17:14:05 CET [2016/02/25 11:14:05 ET]
Table 'Thalpius III' 9-max Seat #1 is the button
Seat 1: BrotherLove9 ($60.87 in chips) 
Seat 2: matiko09 ($63.06 in chips) 
Seat 3: jamba83 ($52.83 in chips) 
Seat 4: Wwwasian ($70.51 in chips) 
Seat 5: Al3xAnd3r22 ($51.71 in chips) 
Seat 6: 111STAVR111 ($50 in chips) 
Seat 7: v4n0v ($58.65 in chips) 
Seat 8: jeroemie123 ($56.25 in chips) 
Seat 9: Domotirko228 ($50.50 in chips) 
matiko09: posts small blind $0.25
jamba83: posts big blind $0.50
*** HOLE CARDS ***
Dealt to matiko09 [7c 3h]
Wwwasian: folds 
Al3xAnd3r22: folds 
111STAVR111: folds 
v4n0v: folds 
jeroemie123: calls $0.50
Domotirko228: folds 
BrotherLove9: folds 
matiko09: folds 
jamba83: checks 
*** FLOP *** [3d Kc 4s]
jamba83: checks 
jeroemie123: checks 
*** TURN *** [3d Kc 4s] [Ac]
jamba83: checks 
jeroemie123: checks 
*** RIVER *** [3d Kc 4s Ac] [Js]
jamba83: checks 
jeroemie123: bets $2
jamba83: folds 
Uncalled bet ($2) returned to jeroemie123
jeroemie123 collected $1.19 from pot
jeroemie123: doesn't show hand 
*** SUMMARY ***
Total pot $1.25 | Rake $0.06 
Board [3d Kc 4s Ac Js]
Seat 1: BrotherLove9 (button) folded before Flop (didn't bet)
Seat 2: matiko09 (small blind) folded before Flop
Seat 3: jamba83 (big blind) folded on the River
Seat 4: Wwwasian folded before Flop (didn't bet)
Seat 5: Al3xAnd3r22 folded before Flop (didn't bet)
Seat 6: 111STAVR111 folded before Flop (didn't bet)
Seat 7: v4n0v folded before Flop (didn't bet)
Seat 8: jeroemie123 collected ($1.19)
Seat 9: Domotirko228 folded before Flop (didn't bet)





PokerStars Hand #149393553156:  Hold'em No Limit ($0.50/$1.00 USD) - 2016/02/25 17:14:10 CET [2016/02/25 11:14:10 ET]
Table 'Badenia II' 9-max Seat #7 is the button
Seat 1: matiko09 ($100 in chips) 
Seat 2: Stibitzkie ($76.04 in chips) 
Seat 3: sebaaastian ($126.34 in chips) 
Seat 5: djammusic ($119.09 in chips) 
Seat 6: xAndorx ($119.80 in chips) 
Seat 7: forsmthgood ($100 in chips) 
Seat 8: Sweden_Pound ($141.85 in chips) 
Seat 9: waisanen ($248.97 in chips) 
Sweden_Pound: posts small blind $0.50
waisanen: posts big blind $1
*** HOLE CARDS ***
Dealt to matiko09 [Td 9c]
matiko09: folds 
Stibitzkie: raises $1 to $2
sebaaastian: folds 
djammusic: folds 
xAndorx: folds 
forsmthgood: raises $5.50 to $7.50
Sweden_Pound: folds 
waisanen: folds 
Stibitzkie: calls $5.50
*** FLOP *** [8s 5d 4h]
Stibitzkie: checks 
forsmthgood: checks 
*** TURN *** [8s 5d 4h] [7s]
Stibitzkie: checks 
forsmthgood: checks 
*** RIVER *** [8s 5d 4h 7s] [9h]
Stibitzkie: checks 
forsmthgood: checks 
*** SHOW DOWN ***
Stibitzkie: shows [3s Qs] (high card Queen)
forsmthgood: shows [Ks Ah] (high card Ace)
forsmthgood collected $15.76 from pot
*** SUMMARY ***
Total pot $16.50 | Rake $0.74 
Board [8s 5d 4h 7s 9h]
Seat 1: matiko09 folded before Flop (didn't bet)
Seat 2: Stibitzkie showed [3s Qs] and lost with high card Queen
Seat 3: sebaaastian folded before Flop (didn't bet)
Seat 5: djammusic folded before Flop (didn't bet)
Seat 6: xAndorx folded before Flop (didn't bet)
Seat 7: forsmthgood (button) showed [Ks Ah] and won ($15.76) with high card Ace
Seat 8: Sweden_Pound (small blind) folded before Flop
Seat 9: waisanen (big blind) folded before Flop





PokerStars Hand #149393559186:  Hold'em No Limit ($0.50/$1.00 USD) - 2016/02/25 17:14:18 CET [2016/02/25 11:14:18 ET]
Table 'Ebella II' 9-max Seat #2 is the button
Seat 1: nickreason17 ($106.83 in chips) 
Seat 2: Sweden_Pound ($100 in chips) 
Seat 4: xAndorx ($100 in chips) 
Seat 5: matiko09 ($100 in chips) 
Seat 8: ZMPOUTSAM140 ($81.93 in chips) 
Seat 9: simoniustin ($104.16 in chips) 
xAndorx: posts small blind $0.50
matiko09: posts big blind $1
*** HOLE CARDS ***
Dealt to matiko09 [5c Ts]
ZMPOUTSAM140: folds 
simoniustin: raises $2 to $3
nickreason17: raises $6 to $9
Sweden_Pound: folds 
xAndorx: folds 
matiko09: folds 
simoniustin: raises $15 to $24
nickreason17: folds 
Uncalled bet ($15) returned to simoniustin
simoniustin collected $19.50 from pot
simoniustin: doesn't show hand 
*** SUMMARY ***
Total pot $19.50 | Rake $0 
Seat 1: nickreason17 folded before Flop
Seat 2: Sweden_Pound (button) folded before Flop (didn't bet)
Seat 4: xAndorx (small blind) folded before Flop
Seat 5: matiko09 (big blind) folded before Flop
Seat 8: ZMPOUTSAM140 folded before Flop (didn't bet)
Seat 9: simoniustin collected ($19.50)





PokerStars Hand #149393567663:  Hold'em No Limit ($0.50/$1.00 USD) - 2016/02/25 17:14:28 CET [2016/02/25 11:14:28 ET]
Table 'Isa' 9-max Seat #6 is the button
Seat 1: matiko09 ($127.37 in chips) 
Seat 2: mycka86 ($102.50 in chips) 
Seat 3: sebaaastian ($141.75 in chips) 
Seat 5: Sweden_Pound ($175.38 in chips) 
Seat 6: xAndorx ($100 in chips) 
Seat 7: bilukm ($163.76 in chips) 
Seat 8: Venomous100% ($100 in chips) 
Seat 9: HomerrrJay ($101.50 in chips) 
bilukm: posts small blind $0.50
Venomous100%: posts big blind $1
*** HOLE CARDS ***
Dealt to matiko09 [Qs 2h]
HomerrrJay: folds 
matiko09: folds 
mycka86: folds 
sebaaastian: folds 
Sweden_Pound: folds 
xAndorx: raises $1 to $2
bilukm: folds 
Venomous100%: calls $1
*** FLOP *** [Qc 9c Kd]
Venomous100%: checks 
xAndorx: checks 
*** TURN *** [Qc 9c Kd] [8d]
Venomous100%: bets $3
xAndorx: folds 
Uncalled bet ($3) returned to Venomous100%
Venomous100% collected $4.30 from pot
Venomous100%: doesn't show hand 
*** SUMMARY ***
Total pot $4.50 | Rake $0.20 
Board [Qc 9c Kd 8d]
Seat 1: matiko09 folded before Flop (didn't bet)
Seat 2: mycka86 folded before Flop (didn't bet)
Seat 3: sebaaastian folded before Flop (didn't bet)
Seat 5: Sweden_Pound folded before Flop (didn't bet)
Seat 6: xAndorx (button) folded on the Turn
Seat 7: bilukm (small blind) folded before Flop
Seat 8: Venomous100% (big blind) collected ($4.30)
Seat 9: HomerrrJay folded before Flop (didn't bet)





PokerStars Hand #149393572101:  Hold'em No Limit ($0.50/$1.00 USD) - 2016/02/25 17:14:34 CET [2016/02/25 11:14:34 ET]
Table 'Zeuxo II' 9-max Seat #7 is the button
Seat 1: forsmthgood ($113.79 in chips) 
Seat 2: Sweden_Pound ($114.70 in chips) 
Seat 3: xAndorx ($100 in chips) 
Seat 4: sebaaastian ($112.11 in chips) 
Seat 6: Cogss ($105.05 in chips) 
Seat 7: djammusic ($48 in chips) 
Seat 8: matiko09 ($104.20 in chips) 
Seat 9: Sreshta222 ($209.80 in chips) 
matiko09: posts small blind $0.50
Sreshta222: posts big blind $1
*** HOLE CARDS ***
Dealt to matiko09 [7c 7d]
forsmthgood: folds 
Sweden_Pound has timed out
Sweden_Pound: folds 
xAndorx: raises $2 to $3
sebaaastian: folds 
Cogss: calls $3
djammusic: folds 
matiko09: calls $2.50
Sreshta222: calls $2
*** FLOP *** [Qh Kc 5c]
matiko09: checks 
Sreshta222: checks 
xAndorx: bets $7.50
Cogss: calls $7.50
matiko09: folds 
Sreshta222: folds 
*** TURN *** [Qh Kc 5c] [8h]
xAndorx: bets $19.50
Cogss: calls $19.50
*** RIVER *** [Qh Kc 5c 8h] [8s]
xAndorx: checks 
Cogss: checks 
*** SHOW DOWN ***
xAndorx: shows [Jd Kd] (two pair, Kings and Eights)
Cogss: mucks hand 
xAndorx collected $63.20 from pot
*** SUMMARY ***
Total pot $66 | Rake $2.80 
Board [Qh Kc 5c 8h 8s]
Seat 1: forsmthgood folded before Flop (didn't bet)
Seat 2: Sweden_Pound folded before Flop (didn't bet)
Seat 3: xAndorx showed [Jd Kd] and won ($63.20) with two pair, Kings and Eights
Seat 4: sebaaastian folded before Flop (didn't bet)
Seat 6: Cogss mucked [Tc Jh]
Seat 7: djammusic (button) folded before Flop (didn't bet)
Seat 8: matiko09 (small blind) folded on the Flop
Seat 9: Sreshta222 (big blind) folded on the Flop





PokerStars Hand #149393573336:  Hold'em No Limit ($0.25/$0.50 USD) - 2016/02/25 17:14:36 CET [2016/02/25 11:14:36 ET]
Table 'Lohja II' 9-max Seat #2 is the button
Seat 1: MoonJimmy ($139.98 in chips) 
Seat 2: Apparat888 ($44.50 in chips) 
Seat 3: guvalc1952 ($198.30 in chips) 
Seat 4: payback11 ($50 in chips) 
Seat 5: 111STAVR111 ($49.60 in chips) 
Seat 6: xAndorx ($62.69 in chips) 
Seat 7: matiko09 ($123.44 in chips) 
Seat 8: jamba83 ($64.77 in chips) 
Seat 9: Al3xAnd3r22 ($100.74 in chips) 
guvalc1952: posts small blind $0.25
payback11: posts big blind $0.50
MoonJimmy: posts the ante $0.10
Apparat888: posts the ante $0.10
guvalc1952: posts the ante $0.10
payback11: posts the ante $0.10
111STAVR111: posts the ante $0.10
xAndorx: posts the ante $0.10
matiko09: posts the ante $0.10
jamba83: posts the ante $0.10
Al3xAnd3r22: posts the ante $0.10
*** HOLE CARDS ***
Dealt to matiko09 [8c Jc]
111STAVR111: raises $1 to $1.50
xAndorx: folds 
matiko09: folds 
jamba83: folds 
Al3xAnd3r22: folds 
MoonJimmy: folds 
Apparat888: folds 
guvalc1952: folds 
payback11: calls $1
*** FLOP *** [8d Td 3h]
payback11: checks 
111STAVR111: bets $2.97
payback11: folds 
Uncalled bet ($2.97) returned to 111STAVR111
111STAVR111 collected $3.96 from pot
111STAVR111: doesn't show hand 
*** SUMMARY ***
Total pot $4.15 | Rake $0.19 
Board [8d Td 3h]
Seat 1: MoonJimmy folded before Flop (didn't bet)
Seat 2: Apparat888 (button) folded before Flop (didn't bet)
Seat 3: guvalc1952 (small blind) folded before Flop
Seat 4: payback11 (big blind) folded on the Flop
Seat 5: 111STAVR111 collected ($3.96)
Seat 6: xAndorx folded before Flop (didn't bet)
Seat 7: matiko09 folded before Flop (didn't bet)
Seat 8: jamba83 folded before Flop (didn't bet)
Seat 9: Al3xAnd3r22 folded before Flop (didn't bet)





PokerStars Hand #149393575929:  Hold'em No Limit ($0.50/$1.00 USD) - 2016/02/25 17:14:39 CET [2016/02/25 11:14:39 ET]
Table 'Syrma II' 9-max Seat #6 is the button
Seat 1: lysandrafly ($100 in chips) 
Seat 2: Sreshta222 ($116.71 in chips) 
Seat 3: simoniustin ($118.42 in chips) 
Seat 5: nickreason17 ($112.54 in chips) 
Seat 6: ffac ($119.65 in chips) 
Seat 7: matiko09 ($100 in chips) 
Seat 9: gulseren848 ($62.63 in chips) 
matiko09: posts small blind $0.50
gulseren848: posts big blind $1
*** HOLE CARDS ***
Dealt to matiko09 [As 5c]
lysandrafly: folds 
Sreshta222: folds 
simoniustin: folds 
nickreason17: raises $1.50 to $2.50
ffac: folds 
matiko09: folds 
gulseren848: calls $1.50
*** FLOP *** [Th Tc Ks]
gulseren848: checks 
nickreason17: bets $2.75
gulseren848: folds 
Uncalled bet ($2.75) returned to nickreason17
nickreason17 collected $5.25 from pot
*** SUMMARY ***
Total pot $5.50 | Rake $0.25 
Board [Th Tc Ks]
Seat 1: lysandrafly folded before Flop (didn't bet)
Seat 2: Sreshta222 folded before Flop (didn't bet)
Seat 3: simoniustin folded before Flop (didn't bet)
Seat 5: nickreason17 collected ($5.25)
Seat 6: ffac (button) folded before Flop (didn't bet)
Seat 7: matiko09 (small blind) folded before Flop
Seat 9: gulseren848 (big blind) folded on the Flop





PokerStars Hand #149393583815:  Hold'em No Limit ($0.50/$1.00 USD) - 2016/02/25 17:14:49 CET [2016/02/25 11:14:49 ET]
Table 'Sabine' 9-max Seat #6 is the button
Seat 2: apfush ($133.70 in chips) 
Seat 3: Ouga Buga ($147.44 in chips) 
Seat 5: Venomous100% ($105.10 in chips) 
Seat 6: ffac ($100 in chips) 
Seat 7: clayshmert ($45.78 in chips) 
Seat 8: matiko09 ($119.49 in chips) 
Seat 9: djammusic ($62.89 in chips) 
clayshmert: posts small blind $0.50
matiko09: posts big blind $1
*** HOLE CARDS ***
Dealt to matiko09 [2s 2c]
djammusic: folds 
apfush: folds 
Ouga Buga: folds 
Venomous100%: folds 
ffac: folds 
clayshmert: calls $0.50
matiko09: checks 
*** FLOP *** [3s Ah 8d]
clayshmert: checks 
matiko09: checks 
*** TURN *** [3s Ah 8d] [4s]
clayshmert: checks 
matiko09: checks 
*** RIVER *** [3s Ah 8d 4s] [Kd]
clayshmert: checks 
matiko09: checks 
*** SHOW DOWN ***
clayshmert: shows [5c Jc] (high card Ace)
matiko09: shows [2s 2c] (a pair of Deuces)
matiko09 collected $1.91 from pot
*** SUMMARY ***
Total pot $2 | Rake $0.09 
Board [3s Ah 8d 4s Kd]
Seat 2: apfush folded before Flop (didn't bet)
Seat 3: Ouga Buga folded before Flop (didn't bet)
Seat 5: Venomous100% folded before Flop (didn't bet)
Seat 6: ffac (button) folded before Flop (didn't bet)
Seat 7: clayshmert (small blind) showed [5c Jc] and lost with high card Ace
Seat 8: matiko09 (big blind) showed [2s 2c] and won ($1.91) with a pair of Deuces
Seat 9: djammusic folded before Flop (didn't bet)





PokerStars Hand #149393591460:  Hold'em No Limit ($0.50/$1.00 USD) - 2016/02/25 17:14:59 CET [2016/02/25 11:14:59 ET]
Table 'Hercules IV' 9-max Seat #7 is the button
Seat 1: matiko09 ($101.50 in chips) 
Seat 3: HomerrrJay ($111 in chips) 
Seat 4: Sweden_Pound ($100 in chips) 
Seat 5: xAndorx ($163.08 in chips) 
Seat 6: kuanhung0903 ($61.39 in chips) 
Seat 7: Ouga Buga ($105.67 in chips) 
Seat 8: brokat77 ($130.17 in chips) 
Seat 9: djammusic ($35.18 in chips) 
brokat77: posts small blind $0.50
djammusic: posts big blind $1
*** HOLE CARDS ***
Dealt to matiko09 [Ks Js]
matiko09: raises $2 to $3
HomerrrJay: folds 
Sweden_Pound: calls $3
xAndorx: calls $3
kuanhung0903: folds 
Ouga Buga: folds 
brokat77: folds 
djammusic: folds 
*** FLOP *** [5h 9c 7s]
matiko09: checks 
Sweden_Pound: bets $6.52
xAndorx: folds 
matiko09: folds 
Uncalled bet ($6.52) returned to Sweden_Pound
Sweden_Pound collected $10.03 from pot
Sweden_Pound: doesn't show hand 
*** SUMMARY ***
Total pot $10.50 | Rake $0.47 
Board [5h 9c 7s]
Seat 1: matiko09 folded on the Flop
Seat 3: HomerrrJay folded before Flop (didn't bet)
Seat 4: Sweden_Pound collected ($10.03)
Seat 5: xAndorx folded on the Flop
Seat 6: kuanhung0903 folded before Flop (didn't bet)
Seat 7: Ouga Buga (button) folded before Flop (didn't bet)
Seat 8: brokat77 (small blind) folded before Flop
Seat 9: djammusic (big blind) folded before Flop





PokerStars Hand #149393598716:  Hold'em No Limit ($0.50/$1.00 USD) - 2016/02/25 17:15:08 CET [2016/02/25 11:15:08 ET]
Table 'Mayall II' 9-max Seat #2 is the button
Seat 1: matiko09 ($112.11 in chips) 
Seat 2: Sweden_Pound ($142.47 in chips) 
Seat 3: simoniustin ($100 in chips) 
Seat 4: Ouga Buga ($111.12 in chips) 
Seat 5: SumPosad ($76.34 in chips) 
Seat 6: apfush ($105.68 in chips) 
Seat 7: r.pol218 ($58.70 in chips) 
Seat 8: kuanhung0903 ($74.48 in chips) 
Seat 9: xAndorx ($133.34 in chips) 
simoniustin: posts small blind $0.50
Ouga Buga: posts big blind $1
*** HOLE CARDS ***
Dealt to matiko09 [5d Jc]
SumPosad: folds 
apfush: raises $2 to $3
r.pol218: folds 
kuanhung0903: calls $3
xAndorx: folds 
matiko09: folds 
Sweden_Pound: folds 
simoniustin: folds 
Ouga Buga: folds 
*** FLOP *** [6h 8s 4s]
apfush: bets $4.50
kuanhung0903: calls $4.50
*** TURN *** [6h 8s 4s] [9h]
apfush: checks 
kuanhung0903: bets $9
apfush: calls $9
*** RIVER *** [6h 8s 4s 9h] [Td]
apfush: checks 
kuanhung0903: bets $19
apfush: folds 
Uncalled bet ($19) returned to kuanhung0903
kuanhung0903 collected $32.95 from pot
kuanhung0903: doesn't show hand 
*** SUMMARY ***
Total pot $34.50 | Rake $1.55 
Board [6h 8s 4s 9h Td]
Seat 1: matiko09 folded before Flop (didn't bet)
Seat 2: Sweden_Pound (button) folded before Flop (didn't bet)
Seat 3: simoniustin (small blind) folded before Flop
Seat 4: Ouga Buga (big blind) folded before Flop
Seat 5: SumPosad folded before Flop (didn't bet)
Seat 6: apfush folded on the River
Seat 7: r.pol218 folded before Flop (didn't bet)
Seat 8: kuanhung0903 collected ($32.95)
Seat 9: xAndorx folded before Flop (didn't bet)





PokerStars Hand #149393600412:  Hold'em No Limit ($0.25/$0.50 USD) - 2016/02/25 17:15:10 CET [2016/02/25 11:15:10 ET]
Table 'Thalpius III' 9-max Seat #2 is the button
Seat 1: BrotherLove9 ($60.87 in chips) 
Seat 2: matiko09 ($62.81 in chips) 
Seat 3: jamba83 ($52.33 in chips) 
Seat 4: Wwwasian ($70.51 in chips) 
Seat 5: Al3xAnd3r22 ($51.71 in chips) 
Seat 6: 111STAVR111 ($50 in chips) 
Seat 7: v4n0v ($58.65 in chips) 
Seat 8: jeroemie123 ($56.94 in chips) 
Seat 9: Domotirko228 ($50.50 in chips) 
jamba83: posts small blind $0.25
Wwwasian: posts big blind $0.50
*** HOLE CARDS ***
Dealt to matiko09 [5d Qh]
Al3xAnd3r22: folds 
111STAVR111: raises $1 to $1.50
v4n0v: folds 
jeroemie123: calls $1.50
Domotirko228: raises $4.50 to $6
BrotherLove9: folds 
matiko09: folds 
jamba83: folds 
Wwwasian: folds 
111STAVR111: folds 
jeroemie123: calls $4.50
*** FLOP *** [6h 2h 3s]
jeroemie123: checks 
Domotirko228: checks 
*** TURN *** [6h 2h 3s] [Ts]
jeroemie123: checks 
Domotirko228: bets $6.95
jeroemie123: folds 
Uncalled bet ($6.95) returned to Domotirko228
Domotirko228 collected $13.61 from pot
Domotirko228: doesn't show hand 
*** SUMMARY ***
Total pot $14.25 | Rake $0.64 
Board [6h 2h 3s Ts]
Seat 1: BrotherLove9 folded before Flop (didn't bet)
Seat 2: matiko09 (button) folded before Flop (didn't bet)
Seat 3: jamba83 (small blind) folded before Flop
Seat 4: Wwwasian (big blind) folded before Flop
Seat 5: Al3xAnd3r22 folded before Flop (didn't bet)
Seat 6: 111STAVR111 folded before Flop
Seat 7: v4n0v folded before Flop (didn't bet)
Seat 8: jeroemie123 folded on the Turn
Seat 9: Domotirko228 collected ($13.61)





PokerStars Hand #149393601319:  Hold'em No Limit ($0.50/$1.00 USD) - 2016/02/25 17:15:11 CET [2016/02/25 11:15:11 ET]
Table 'Syrma II' 9-max Seat #7 is the button
Seat 1: lysandrafly ($100 in chips) 
Seat 2: Sreshta222 ($116.71 in chips) 
Seat 3: simoniustin ($118.42 in chips) 
Seat 5: nickreason17 ($115.29 in chips) 
Seat 6: ffac ($119.65 in chips) 
Seat 7: matiko09 ($100 in chips) 
Seat 9: gulseren848 ($60.13 in chips) 
gulseren848: posts small blind $0.50
lysandrafly: posts big blind $1
*** HOLE CARDS ***
Dealt to matiko09 [2c 9s]
Sreshta222: folds 
simoniustin: folds 
nickreason17: folds 
ffac: folds 
matiko09: folds 
gulseren848: calls $0.50
lysandrafly: checks 
*** FLOP *** [Jd 6d Tc]
gulseren848: checks 
lysandrafly: checks 
*** TURN *** [Jd 6d Tc] [9d]
gulseren848: bets $1
lysandrafly: raises $1 to $2
gulseren848: calls $1
*** RIVER *** [Jd 6d Tc 9d] [7h]
gulseren848: bets $2
lysandrafly: calls $2
*** SHOW DOWN ***
gulseren848: shows [8c 8h] (a straight, Seven to Jack)
lysandrafly: mucks hand 
gulseren848 collected $9.55 from pot
*** SUMMARY ***
Total pot $10 | Rake $0.45 
Board [Jd 6d Tc 9d 7h]
Seat 1: lysandrafly (big blind) mucked [9h 6h]
Seat 2: Sreshta222 folded before Flop (didn't bet)
Seat 3: simoniustin folded before Flop (didn't bet)
Seat 5: nickreason17 folded before Flop (didn't bet)
Seat 6: ffac folded before Flop (didn't bet)
Seat 7: matiko09 (button) folded before Flop (didn't bet)
Seat 9: gulseren848 (small blind) showed [8c 8h] and won ($9.55) with a straight, Seven to Jack





PokerStars Hand #149393606350:  Hold'em No Limit ($0.50/$1.00 USD) - 2016/02/25 17:15:18 CET [2016/02/25 11:15:18 ET]
Table 'Ebella II' 9-max Seat #4 is the button
Seat 1: nickreason17 ($100 in chips) 
Seat 2: Sweden_Pound ($100 in chips) 
Seat 4: xAndorx ($100 in chips) 
Seat 5: matiko09 ($100 in chips) 
Seat 8: ZMPOUTSAM140 ($81.93 in chips) 
Seat 9: simoniustin ($114.66 in chips) 
matiko09: posts small blind $0.50
ZMPOUTSAM140: posts big blind $1
*** HOLE CARDS ***
Dealt to matiko09 [2d 2s]
simoniustin: folds 
nickreason17: raises $2 to $3
Sweden_Pound: folds 
xAndorx: folds 
matiko09: folds 
ZMPOUTSAM140: calls $2
*** FLOP *** [Js Jd 3c]
ZMPOUTSAM140: checks 
Lahesell leaves the table
nickreason17: bets $4
ZMPOUTSAM140: folds 
Uncalled bet ($4) returned to nickreason17
hammerwife joins the table at seat #3 
nickreason17 collected $6.21 from pot
*** SUMMARY ***
Total pot $6.50 | Rake $0.29 
Board [Js Jd 3c]
Seat 1: nickreason17 collected ($6.21)
Seat 2: Sweden_Pound folded before Flop (didn't bet)
Seat 4: xAndorx (button) folded before Flop (didn't bet)
Seat 5: matiko09 (small blind) folded before Flop
Seat 8: ZMPOUTSAM140 (big blind) folded on the Flop
Seat 9: simoniustin folded before Flop (didn't bet)





PokerStars Hand #149393608298:  Hold'em No Limit ($0.50/$1.00 USD) - 2016/02/25 17:15:20 CET [2016/02/25 11:15:20 ET]
Table 'Nerthus II' 9-max Seat #1 is the button
Seat 1: DUkalisUA ($100 in chips) 
Seat 2: matiko09 ($217.29 in chips) 
Seat 3: simoniustin ($100 in chips) 
Seat 4: Ilov3NBA ($102.75 in chips) 
Seat 6: mycka86 ($103 in chips) 
Seat 7: Venomous100% ($100 in chips) 
Seat 8: Kelvin sai ($51.41 in chips) 
matiko09: posts small blind $0.50
simoniustin: posts big blind $1
Sweden_Pound: sits out 
*** HOLE CARDS ***
Dealt to matiko09 [2c Jh]
Ilov3NBA: folds 
mycka86: folds 
Venomous100%: raises $2 to $3
Kelvin sai: folds 
DUkalisUA: folds 
matiko09: folds 
simoniustin: folds 
Uncalled bet ($2) returned to Venomous100%
Venomous100% collected $2.50 from pot
Venomous100%: doesn't show hand 
*** SUMMARY ***
Total pot $2.50 | Rake $0 
Seat 1: DUkalisUA (button) folded before Flop (didn't bet)
Seat 2: matiko09 (small blind) folded before Flop
Seat 3: simoniustin (big blind) folded before Flop
Seat 4: Ilov3NBA folded before Flop (didn't bet)
Seat 6: mycka86 folded before Flop (didn't bet)
Seat 7: Venomous100% collected ($2.50)
Seat 8: Kelvin sai folded before Flop (didn't bet)





PokerStars Hand #149393618762:  Hold'em No Limit ($0.50/$1.00 USD) - 2016/02/25 17:15:34 CET [2016/02/25 11:15:34 ET]
Table 'Isa' 9-max Seat #7 is the button
Seat 1: matiko09 ($127.37 in chips) 
Seat 2: mycka86 ($102.50 in chips) 
Seat 3: sebaaastian ($141.75 in chips) 
Seat 5: Sweden_Pound ($175.38 in chips) 
Seat 6: xAndorx ($100 in chips) 
Seat 7: bilukm ($163.26 in chips) 
Seat 8: Venomous100% ($102.30 in chips) 
Seat 9: HomerrrJay ($101.50 in chips) 
Venomous100%: posts small blind $0.50
HomerrrJay: posts big blind $1
*** HOLE CARDS ***
Dealt to matiko09 [2c As]
matiko09: folds 
mycka86: folds 
sebaaastian: folds 
Sweden_Pound: folds 
xAndorx: folds 
bilukm: folds 
Venomous100%: raises $2 to $3
HomerrrJay: calls $2
*** FLOP *** [Qs Ts 4c]
Venomous100%: bets $4
HomerrrJay: folds 
Uncalled bet ($4) returned to Venomous100%
Venomous100% collected $5.73 from pot
Venomous100%: doesn't show hand 
*** SUMMARY ***
Total pot $6 | Rake $0.27 
Board [Qs Ts 4c]
Seat 1: matiko09 folded before Flop (didn't bet)
Seat 2: mycka86 folded before Flop (didn't bet)
Seat 3: sebaaastian folded before Flop (didn't bet)
Seat 5: Sweden_Pound folded before Flop (didn't bet)
Seat 6: xAndorx folded before Flop (didn't bet)
Seat 7: bilukm (button) folded before Flop (didn't bet)
Seat 8: Venomous100% (small blind) collected ($5.73)
Seat 9: HomerrrJay (big blind) folded on the Flop





PokerStars Hand #149393621276:  Hold'em No Limit ($0.50/$1.00 USD) - 2016/02/25 17:15:37 CET [2016/02/25 11:15:37 ET]
Table 'Badenia II' 9-max Seat #8 is the button
Seat 1: matiko09 ($100 in chips) 
Seat 2: Stibitzkie ($68.54 in chips) 
Seat 3: sebaaastian ($126.34 in chips) 
Seat 5: djammusic ($119.09 in chips) 
Seat 6: xAndorx ($119.80 in chips) 
Seat 7: forsmthgood ($108.26 in chips) 
Seat 8: Sweden_Pound ($141.35 in chips) 
Seat 9: waisanen ($247.97 in chips) 
waisanen: posts small blind $0.50
matiko09: posts big blind $1
*** HOLE CARDS ***
Dealt to matiko09 [2c 6s]
Stibitzkie: folds 
sebaaastian: raises $2 to $3
djammusic: folds 
xAndorx: folds 
forsmthgood: folds 
Sweden_Pound: folds 
waisanen: folds 
matiko09: folds 
Uncalled bet ($2) returned to sebaaastian
sebaaastian collected $2.50 from pot
sebaaastian: doesn't show hand 
*** SUMMARY ***
Total pot $2.50 | Rake $0 
Seat 1: matiko09 (big blind) folded before Flop
Seat 2: Stibitzkie folded before Flop (didn't bet)
Seat 3: sebaaastian collected ($2.50)
Seat 5: djammusic folded before Flop (didn't bet)
Seat 6: xAndorx folded before Flop (didn't bet)
Seat 7: forsmthgood folded before Flop (didn't bet)
Seat 8: Sweden_Pound (button) folded before Flop (didn't bet)
Seat 9: waisanen (small blind) folded before Flop





PokerStars Hand #149393625078:  Hold'em No Limit ($0.25/$0.50 USD) - 2016/02/25 17:15:42 CET [2016/02/25 11:15:42 ET]
Table 'Lohja II' 9-max Seat #3 is the button
Seat 1: MoonJimmy ($139.88 in chips) 
Seat 2: Apparat888 ($44.40 in chips) 
Seat 3: guvalc1952 ($197.95 in chips) 
Seat 4: payback11 ($50 in chips) 
Seat 5: 111STAVR111 ($51.96 in chips) 
Seat 6: xAndorx ($62.59 in chips) 
Seat 7: matiko09 ($123.34 in chips) 
Seat 8: jamba83 ($64.67 in chips) 
Seat 9: Al3xAnd3r22 ($100.64 in chips) 
payback11: posts small blind $0.25
111STAVR111: posts big blind $0.50
MoonJimmy: posts the ante $0.10
Apparat888: posts the ante $0.10
guvalc1952: posts the ante $0.10
payback11: posts the ante $0.10
111STAVR111: posts the ante $0.10
xAndorx: posts the ante $0.10
matiko09: posts the ante $0.10
jamba83: posts the ante $0.10
Al3xAnd3r22: posts the ante $0.10
*** HOLE CARDS ***
Dealt to matiko09 [9d Qc]
xAndorx: folds 
matiko09: folds 
jamba83: raises $1 to $1.50
Al3xAnd3r22: folds 
MoonJimmy: folds 
Apparat888: folds 
guvalc1952: calls $1.50
payback11: folds 
111STAVR111: folds 
*** FLOP *** [9s 7c Qs]
jamba83: bets $3
guvalc1952: calls $3
*** TURN *** [9s 7c Qs] [3c]
jamba83: bets $7
guvalc1952: calls $7
*** RIVER *** [9s 7c Qs 3c] [7s]
jamba83: checks 
guvalc1952: checks 
*** SHOW DOWN ***
jamba83: shows [Qd Ad] (two pair, Queens and Sevens)
guvalc1952: mucks hand 
jamba83 collected $23.54 from pot
*** SUMMARY ***
Total pot $24.65 | Rake $1.11 
Board [9s 7c Qs 3c 7s]
Seat 1: MoonJimmy folded before Flop (didn't bet)
Seat 2: Apparat888 folded before Flop (didn't bet)
Seat 3: guvalc1952 (button) mucked [9h 8h]
Seat 4: payback11 (small blind) folded before Flop
Seat 5: 111STAVR111 (big blind) folded before Flop
Seat 6: xAndorx folded before Flop (didn't bet)
Seat 7: matiko09 folded before Flop (didn't bet)
Seat 8: jamba83 showed [Qd Ad] and won ($23.54) with two pair, Queens and Sevens
Seat 9: Al3xAnd3r22 folded before Flop (didn't bet)





PokerStars Hand #149393633639:  Hold'em No Limit ($0.50/$1.00 USD) - 2016/02/25 17:15:52 CET [2016/02/25 11:15:52 ET]
Table 'Morosovia II' 9-max Seat #1 is the button
Seat 1: apfush ($172.26 in chips) 
Seat 2: Effort92 ($100.71 in chips) 
Seat 3: sebaaastian ($217.86 in chips) 
Seat 4: Venomous100% ($100 in chips) 
Seat 5: pimpoza ($103.13 in chips) 
Seat 6: Sweden_Pound ($127.07 in chips) 
Seat 7: matiko09 ($166.55 in chips) 
Seat 8: simoniustin ($108.16 in chips) 
Seat 9: Ouga Buga ($134.07 in chips) 
Effort92: posts small blind $0.50
sebaaastian: posts big blind $1
*** HOLE CARDS ***
Dealt to matiko09 [3s Kh]
Venomous100%: raises $2 to $3
pimpoza: calls $3
Sweden_Pound: folds 
matiko09: folds 
simoniustin: folds 
Ouga Buga: folds 
apfush: folds 
Effort92: calls $2.50
sebaaastian: folds 
*** FLOP *** [4s 3c 5s]
Effort92: bets $7.16
Venomous100%: calls $7.16
pimpoza: calls $7.16
*** TURN *** [4s 3c 5s] [Js]
Effort92: bets $17
Venomous100%: calls $17
pimpoza: folds 
*** RIVER *** [4s 3c 5s Js] [Td]
Effort92: bets $20
Venomous100%: calls $20
*** SHOW DOWN ***
Effort92: shows [4h 4d] (three of a kind, Fours)
Venomous100%: shows [8s Ts] (a flush, Jack high)
Venomous100% collected $102.68 from pot
*** SUMMARY ***
Total pot $105.48 | Rake $2.80 
Board [4s 3c 5s Js Td]
Seat 1: apfush (button) folded before Flop (didn't bet)
Seat 2: Effort92 (small blind) showed [4h 4d] and lost with three of a kind, Fours
Seat 3: sebaaastian (big blind) folded before Flop
Seat 4: Venomous100% showed [8s Ts] and won ($102.68) with a flush, Jack high
Seat 5: pimpoza folded on the Turn
Seat 6: Sweden_Pound folded before Flop (didn't bet)
Seat 7: matiko09 folded before Flop (didn't bet)
Seat 8: simoniustin folded before Flop (didn't bet)
Seat 9: Ouga Buga folded before Flop (didn't bet)





PokerStars Hand #149393634296:  Hold'em No Limit ($0.50/$1.00 USD) - 2016/02/25 17:15:53 CET [2016/02/25 11:15:53 ET]
Table 'Nerthus II' 9-max Seat #2 is the button
Seat 1: DUkalisUA ($100 in chips) 
Seat 2: matiko09 ($216.79 in chips) 
Seat 3: simoniustin ($100 in chips) 
Seat 4: Ilov3NBA ($102.75 in chips) 
Seat 6: mycka86 ($103 in chips) 
Seat 7: Venomous100% ($101.50 in chips) 
Seat 8: Kelvin sai ($51.41 in chips) 
simoniustin: posts small blind $0.50
Ilov3NBA: posts big blind $1
Sweden_Pound: sits out 
*** HOLE CARDS ***
Dealt to matiko09 [3s Ks]
mycka86: folds 
Venomous100%: raises $2 to $3
Kelvin sai: calls $3
DUkalisUA: folds 
matiko09: folds 
simoniustin: folds 
Ilov3NBA: folds 
*** FLOP *** [8d 2d 9s]
Venomous100%: bets $6.53
Kelvin sai: calls $6.53
*** TURN *** [8d 2d 9s] [Qc]
Venomous100%: bets $11
Kelvin sai: calls $11
*** RIVER *** [8d 2d 9s Qc] [3h]
Venomous100%: checks 
Kelvin sai: checks 
*** SHOW DOWN ***
Venomous100%: shows [Jd Jh] (a pair of Jacks)
Kelvin sai: mucks hand 
Venomous100% collected $40.64 from pot
*** SUMMARY ***
Total pot $42.56 | Rake $1.92 
Board [8d 2d 9s Qc 3h]
Seat 1: DUkalisUA folded before Flop (didn't bet)
Seat 2: matiko09 (button) folded before Flop (didn't bet)
Seat 3: simoniustin (small blind) folded before Flop
Seat 4: Ilov3NBA (big blind) folded before Flop
Seat 6: mycka86 folded before Flop (didn't bet)
Seat 7: Venomous100% showed [Jd Jh] and won ($40.64) with a pair of Jacks
Seat 8: Kelvin sai mucked [3d Ad]





PokerStars Hand #149393639449:  Hold'em No Limit ($0.50/$1.00 USD) - 2016/02/25 17:16:00 CET [2016/02/25 11:16:00 ET]
Table 'Hercules IV' 9-max Seat #8 is the button
Seat 1: matiko09 ($100 in chips) 
Seat 3: HomerrrJay ($111 in chips) 
Seat 4: Sweden_Pound ($107.03 in chips) 
Seat 5: xAndorx ($160.08 in chips) 
Seat 6: kuanhung0903 ($61.39 in chips) 
Seat 7: Ouga Buga ($105.67 in chips) 
Seat 8: brokat77 ($129.67 in chips) 
Seat 9: djammusic ($40 in chips) 
djammusic: posts small blind $0.50
matiko09: posts big blind $1
*** HOLE CARDS ***
Dealt to matiko09 [5h 8h]
HomerrrJay: raises $2 to $3
Sweden_Pound: calls $3
xAndorx: folds 
kuanhung0903: folds 
Ouga Buga: folds 
brokat77: folds 
djammusic: folds 
matiko09: folds 
*** FLOP *** [6c Js 2s]
HomerrrJay: checks 
Sweden_Pound: bets $4.65
HomerrrJay: folds 
Uncalled bet ($4.65) returned to Sweden_Pound
Sweden_Pound collected $7.16 from pot
Sweden_Pound: doesn't show hand 
*** SUMMARY ***
Total pot $7.50 | Rake $0.34 
Board [6c Js 2s]
Seat 1: matiko09 (big blind) folded before Flop
Seat 3: HomerrrJay folded on the Flop
Seat 4: Sweden_Pound collected ($7.16)
Seat 5: xAndorx folded before Flop (didn't bet)
Seat 6: kuanhung0903 folded before Flop (didn't bet)
Seat 7: Ouga Buga folded before Flop (didn't bet)
Seat 8: brokat77 (button) folded before Flop (didn't bet)
Seat 9: djammusic (small blind) folded before Flop





PokerStars Hand #149393642813:  Hold'em No Limit ($0.50/$1.00 USD) - 2016/02/25 17:16:04 CET [2016/02/25 11:16:04 ET]
Table 'Ebella II' 9-max Seat #5 is the button
Seat 1: nickreason17 ($103.21 in chips) 
Seat 2: Sweden_Pound ($100 in chips) 
Seat 4: xAndorx ($100 in chips) 
Seat 5: matiko09 ($100 in chips) 
Seat 8: ZMPOUTSAM140 ($78.93 in chips) 
Seat 9: simoniustin ($114.66 in chips) 
ZMPOUTSAM140: posts small blind $0.50
simoniustin: posts big blind $1
*** HOLE CARDS ***
Dealt to matiko09 [7h 8c]
nickreason17: folds 
Sweden_Pound: folds 
xAndorx: folds 
matiko09: folds 
ZMPOUTSAM140: folds 
Uncalled bet ($0.50) returned to simoniustin
simoniustin collected $1 from pot
simoniustin: doesn't show hand 
*** SUMMARY ***
Total pot $1 | Rake $0 
Seat 1: nickreason17 folded before Flop (didn't bet)
Seat 2: Sweden_Pound folded before Flop (didn't bet)
Seat 4: xAndorx folded before Flop (didn't bet)
Seat 5: matiko09 (button) folded before Flop (didn't bet)
Seat 8: ZMPOUTSAM140 (small blind) folded before Flop
Seat 9: simoniustin (big blind) collected ($1)





PokerStars Hand #149393642811:  Hold'em No Limit ($0.50/$1.00 USD) - 2016/02/25 17:16:04 CET [2016/02/25 11:16:04 ET]
Table 'Sabine' 9-max Seat #7 is the button
Seat 2: apfush ($133.70 in chips) 
Seat 3: Ouga Buga ($147.44 in chips) 
Seat 5: Venomous100% ($105.10 in chips) 
Seat 6: ffac ($100 in chips) 
Seat 7: clayshmert ($44.78 in chips) 
Seat 8: matiko09 ($120.40 in chips) 
Seat 9: djammusic ($62.89 in chips) 
matiko09: posts small blind $0.50
djammusic: posts big blind $1
*** HOLE CARDS ***
Dealt to matiko09 [Kd 3d]
apfush: folds 
Ouga Buga: folds 
Venomous100%: folds 
ffac: raises $1.50 to $2.50
clayshmert: folds 
matiko09: folds 
djammusic: raises $5 to $7.50
ffac: folds 
Uncalled bet ($5) returned to djammusic
djammusic collected $5.50 from pot
djammusic: doesn't show hand 
*** SUMMARY ***
Total pot $5.50 | Rake $0 
Seat 2: apfush folded before Flop (didn't bet)
Seat 3: Ouga Buga folded before Flop (didn't bet)
Seat 5: Venomous100% folded before Flop (didn't bet)
Seat 6: ffac folded before Flop
Seat 7: clayshmert (button) folded before Flop (didn't bet)
Seat 8: matiko09 (small blind) folded before Flop
Seat 9: djammusic (big blind) collected ($5.50)





PokerStars Hand #149393649025:  Hold'em No Limit ($0.50/$1.00 USD) - 2016/02/25 17:16:12 CET [2016/02/25 11:16:12 ET]
Table 'Badenia II' 9-max Seat #9 is the button
Seat 1: matiko09 ($100 in chips) 
Seat 2: Stibitzkie ($68.54 in chips) 
Seat 3: sebaaastian ($127.84 in chips) 
Seat 5: djammusic ($119.09 in chips) 
Seat 6: xAndorx ($119.80 in chips) 
Seat 7: forsmthgood ($108.26 in chips) 
Seat 8: Sweden_Pound ($141.35 in chips) 
Seat 9: waisanen ($247.47 in chips) 
matiko09: posts small blind $0.50
Stibitzkie: posts big blind $1
*** HOLE CARDS ***
Dealt to matiko09 [8c Ks]
sebaaastian: folds 
djammusic: raises $2 to $3
xAndorx: folds 
forsmthgood: folds 
Sweden_Pound: folds 
waisanen: folds 
matiko09: folds 
Stibitzkie: calls $2
*** FLOP *** [5c 3h 2h]
Stibitzkie: checks 
djammusic: checks 
*** TURN *** [5c 3h 2h] [Tc]
Stibitzkie: bets $6.21
djammusic: calls $6.21
*** RIVER *** [5c 3h 2h Tc] [4s]
Stibitzkie: checks 
djammusic: checks 
*** SHOW DOWN ***
Stibitzkie: shows [2d Kh] (a pair of Deuces)
djammusic: shows [Kd Td] (a pair of Tens)
djammusic collected $18.07 from pot
*** SUMMARY ***
Total pot $18.92 | Rake $0.85 
Board [5c 3h 2h Tc 4s]
Seat 1: matiko09 (small blind) folded before Flop
Seat 2: Stibitzkie (big blind) showed [2d Kh] and lost with a pair of Deuces
Seat 3: sebaaastian folded before Flop (didn't bet)
Seat 5: djammusic showed [Kd Td] and won ($18.07) with a pair of Tens
Seat 6: xAndorx folded before Flop (didn't bet)
Seat 7: forsmthgood folded before Flop (didn't bet)
Seat 8: Sweden_Pound folded before Flop (didn't bet)
Seat 9: waisanen (button) folded before Flop (didn't bet)





PokerStars Hand #149393650995:  Hold'em No Limit ($0.50/$1.00 USD) - 2016/02/25 17:16:14 CET [2016/02/25 11:16:14 ET]
Table 'Syrma II' 9-max Seat #9 is the button
Seat 1: lysandrafly ($100 in chips) 
Seat 2: Sreshta222 ($116.71 in chips) 
Seat 3: simoniustin ($118.42 in chips) 
Seat 5: nickreason17 ($115.29 in chips) 
Seat 6: ffac ($119.65 in chips) 
Seat 7: matiko09 ($100 in chips) 
Seat 9: gulseren848 ($64.68 in chips) 
lysandrafly: posts small blind $0.50
Sreshta222: posts big blind $1
*** HOLE CARDS ***
Dealt to matiko09 [Jc 2h]
simoniustin: raises $2 to $3
nickreason17: folds 
ffac: folds 
matiko09: folds 
gulseren848: folds 
lysandrafly: calls $2.50
Sreshta222: folds 
*** FLOP *** [7s 8s Ac]
lysandrafly: checks 
simoniustin: bets $4
lysandrafly: calls $4
*** TURN *** [7s 8s Ac] [9h]
lysandrafly: checks 
simoniustin: checks 
*** RIVER *** [7s 8s Ac 9h] [8d]
lysandrafly: bets $8.16
simoniustin: folds 
Uncalled bet ($8.16) returned to lysandrafly
lysandrafly collected $14.32 from pot
lysandrafly: doesn't show hand 
*** SUMMARY ***
Total pot $15 | Rake $0.68 
Board [7s 8s Ac 9h 8d]
Seat 1: lysandrafly (small blind) collected ($14.32)
Seat 2: Sreshta222 (big blind) folded before Flop
Seat 3: simoniustin folded on the River
Seat 5: nickreason17 folded before Flop (didn't bet)
Seat 6: ffac folded before Flop (didn't bet)
Seat 7: matiko09 folded before Flop (didn't bet)
Seat 9: gulseren848 (button) folded before Flop (didn't bet)





PokerStars Hand #149393651813:  Hold'em No Limit ($0.50/$1.00 USD) - 2016/02/25 17:16:15 CET [2016/02/25 11:16:15 ET]
Table 'Zeuxo II' 9-max Seat #8 is the button
Seat 1: forsmthgood ($113.79 in chips) 
Seat 2: Sweden_Pound ($114.70 in chips) 
Seat 3: xAndorx ($133.20 in chips) 
Seat 4: sebaaastian ($112.11 in chips) 
Seat 6: Cogss ($75.05 in chips) 
Seat 7: djammusic ($48 in chips) 
Seat 8: matiko09 ($101.20 in chips) 
Seat 9: Sreshta222 ($206.80 in chips) 
Sreshta222: posts small blind $0.50
forsmthgood: posts big blind $1
*** HOLE CARDS ***
Dealt to matiko09 [8c Ad]
Sweden_Pound: folds 
xAndorx: folds 
sebaaastian: folds 
Cogss: raises $1 to $2
djammusic: folds 
matiko09: folds 
Sreshta222: folds 
forsmthgood: folds 
Uncalled bet ($1) returned to Cogss
Cogss collected $2.50 from pot
*** SUMMARY ***
Total pot $2.50 | Rake $0 
Seat 1: forsmthgood (big blind) folded before Flop
Seat 2: Sweden_Pound folded before Flop (didn't bet)
Seat 3: xAndorx folded before Flop (didn't bet)
Seat 4: sebaaastian folded before Flop (didn't bet)
Seat 6: Cogss collected ($2.50)
Seat 7: djammusic folded before Flop (didn't bet)
Seat 8: matiko09 (button) folded before Flop (didn't bet)
Seat 9: Sreshta222 (small blind) folded before Flop





PokerStars Hand #149393653415:  Hold'em No Limit ($0.50/$1.00 USD) - 2016/02/25 17:16:17 CET [2016/02/25 11:16:17 ET]
Table 'Isa' 9-max Seat #8 is the button
Seat 1: matiko09 ($127.37 in chips) 
Seat 2: mycka86 ($102.50 in chips) 
Seat 3: sebaaastian ($141.75 in chips) 
Seat 5: Sweden_Pound ($175.38 in chips) 
Seat 6: xAndorx ($100 in chips) 
Seat 7: bilukm ($163.26 in chips) 
Seat 8: Venomous100% ($105.03 in chips) 
Seat 9: HomerrrJay ($100 in chips) 
HomerrrJay: posts small blind $0.50
matiko09: posts big blind $1
*** HOLE CARDS ***
Dealt to matiko09 [Ts 7c]
mycka86: folds 
sebaaastian: folds 
Sweden_Pound: raises $2 to $3
xAndorx: folds 
bilukm: folds 
Venomous100%: folds 
HomerrrJay: folds 
matiko09: folds 
Uncalled bet ($2) returned to Sweden_Pound
Sweden_Pound collected $2.50 from pot
Sweden_Pound: doesn't show hand 
*** SUMMARY ***
Total pot $2.50 | Rake $0 
Seat 1: matiko09 (big blind) folded before Flop
Seat 2: mycka86 folded before Flop (didn't bet)
Seat 3: sebaaastian folded before Flop (didn't bet)
Seat 5: Sweden_Pound collected ($2.50)
Seat 6: xAndorx folded before Flop (didn't bet)
Seat 7: bilukm folded before Flop (didn't bet)
Seat 8: Venomous100% (button) folded before Flop (didn't bet)
Seat 9: HomerrrJay (small blind) folded before Flop





PokerStars Hand #149393660890:  Hold'em No Limit ($0.50/$1.00 USD) - 2016/02/25 17:16:27 CET [2016/02/25 11:16:27 ET]
Table 'Ebella II' 9-max Seat #8 is the button
Seat 1: nickreason17 ($103.21 in chips) 
Seat 2: Sweden_Pound ($100 in chips) 
Seat 4: xAndorx ($100 in chips) 
Seat 5: matiko09 ($100 in chips) 
Seat 8: ZMPOUTSAM140 ($78.43 in chips) 
Seat 9: simoniustin ($115.16 in chips) 
simoniustin: posts small blind $0.50
nickreason17: posts big blind $1
*** HOLE CARDS ***
Dealt to matiko09 [Kc Td]
Sweden_Pound: folds 
xAndorx: folds 
matiko09: raises $1.50 to $2.50
ZMPOUTSAM140: folds 
simoniustin: folds 
nickreason17: calls $1.50
*** FLOP *** [7d 6h Ad]
nickreason17: checks 
matiko09: checks 
*** TURN *** [7d 6h Ad] [3s]
nickreason17: checks 
matiko09: checks 
*** RIVER *** [7d 6h Ad 3s] [5s]
nickreason17: bets $2.62
matiko09: folds 
Uncalled bet ($2.62) returned to nickreason17
nickreason17 collected $5.25 from pot
*** SUMMARY ***
Total pot $5.50 | Rake $0.25 
Board [7d 6h Ad 3s 5s]
Seat 1: nickreason17 (big blind) collected ($5.25)
Seat 2: Sweden_Pound folded before Flop (didn't bet)
Seat 4: xAndorx folded before Flop (didn't bet)
Seat 5: matiko09 folded on the River
Seat 8: ZMPOUTSAM140 (button) folded before Flop (didn't bet)
Seat 9: simoniustin (small blind) folded before Flop





PokerStars Hand #149393670748:  Hold'em No Limit ($0.25/$0.50 USD) - 2016/02/25 17:16:39 CET [2016/02/25 11:16:39 ET]
Table 'Lohja II' 9-max Seat #4 is the button
Seat 1: MoonJimmy ($139.78 in chips) 
Seat 2: Apparat888 ($44.30 in chips) 
Seat 3: guvalc1952 ($186.35 in chips) 
Seat 4: payback11 ($50 in chips) 
Seat 5: 111STAVR111 ($51.36 in chips) 
Seat 6: xAndorx ($62.49 in chips) 
Seat 7: matiko09 ($123.24 in chips) 
Seat 8: jamba83 ($76.61 in chips) 
Seat 9: Al3xAnd3r22 ($100.54 in chips) 
111STAVR111: posts small blind $0.25
xAndorx: posts big blind $0.50
MoonJimmy: posts the ante $0.10
Apparat888: posts the ante $0.10
guvalc1952: posts the ante $0.10
payback11: posts the ante $0.10
111STAVR111: posts the ante $0.10
xAndorx: posts the ante $0.10
matiko09: posts the ante $0.10
jamba83: posts the ante $0.10
Al3xAnd3r22: posts the ante $0.10
*** HOLE CARDS ***
Dealt to matiko09 [Jd Kd]
matiko09: raises $1 to $1.50
jamba83: folds 
Al3xAnd3r22: folds 
MoonJimmy: folds 
Apparat888: folds 
guvalc1952: calls $1.50
payback11: folds 
111STAVR111: folds 
xAndorx: folds 
*** FLOP *** [Jh 5s 4c]
matiko09: bets $2.89
guvalc1952: folds 
Uncalled bet ($2.89) returned to matiko09
matiko09 collected $4.44 from pot
matiko09: doesn't show hand 
*** SUMMARY ***
Total pot $4.65 | Rake $0.21 
Board [Jh 5s 4c]
Seat 1: MoonJimmy folded before Flop (didn't bet)
Seat 2: Apparat888 folded before Flop (didn't bet)
Seat 3: guvalc1952 folded on the Flop
Seat 4: payback11 (button) folded before Flop (didn't bet)
Seat 5: 111STAVR111 (small blind) folded before Flop
Seat 6: xAndorx (big blind) folded before Flop
Seat 7: matiko09 collected ($4.44)
Seat 8: jamba83 folded before Flop (didn't bet)
Seat 9: Al3xAnd3r22 folded before Flop (didn't bet)





PokerStars Hand #149393671364:  Hold'em No Limit ($0.25/$0.50 USD) - 2016/02/25 17:16:40 CET [2016/02/25 11:16:40 ET]
Table 'Thalpius III' 9-max Seat #3 is the button
Seat 1: BrotherLove9 ($60.87 in chips) 
Seat 2: matiko09 ($62.81 in chips) 
Seat 3: jamba83 ($52.08 in chips) 
Seat 4: Wwwasian ($70.01 in chips) 
Seat 5: Al3xAnd3r22 ($51.71 in chips) 
Seat 6: 111STAVR111 ($50 in chips) 
Seat 7: v4n0v ($58.65 in chips) 
Seat 8: jeroemie123 ($50.94 in chips) 
Seat 9: Domotirko228 ($58.11 in chips) 
Wwwasian: posts small blind $0.25
Al3xAnd3r22: posts big blind $0.50
*** HOLE CARDS ***
Dealt to matiko09 [Kc 2s]
111STAVR111: raises $1 to $1.50
v4n0v: folds 
jeroemie123: folds 
jeroemie123 leaves the table
Domotirko228: folds 
Effort92 joins the table at seat #8 
BrotherLove9: folds 
matiko09: folds 
jamba83: folds 
Wwwasian: folds 
Al3xAnd3r22: calls $1
*** FLOP *** [4d 4h 2h]
Effort92 leaves the table
Al3xAnd3r22: checks 
111STAVR111: bets $2.32
Al3xAnd3r22: calls $2.32
*** TURN *** [4d 4h 2h] [5d]
Al3xAnd3r22: checks 
111STAVR111: bets $5.27
Al3xAnd3r22: folds 
Uncalled bet ($5.27) returned to 111STAVR111
111STAVR111 collected $7.53 from pot
111STAVR111: doesn't show hand 
*** SUMMARY ***
Total pot $7.89 | Rake $0.36 
Board [4d 4h 2h 5d]
Seat 1: BrotherLove9 folded before Flop (didn't bet)
Seat 2: matiko09 folded before Flop (didn't bet)
Seat 3: jamba83 (button) folded before Flop (didn't bet)
Seat 4: Wwwasian (small blind) folded before Flop
Seat 5: Al3xAnd3r22 (big blind) folded on the Turn
Seat 6: 111STAVR111 collected ($7.53)
Seat 7: v4n0v folded before Flop (didn't bet)
Seat 8: jeroemie123 folded before Flop (didn't bet)
Seat 9: Domotirko228 folded before Flop (didn't bet)





PokerStars Hand #149393676867:  Hold'em No Limit ($0.50/$1.00 USD) - 2016/02/25 17:16:47 CET [2016/02/25 11:16:47 ET]
Table 'Isa' 9-max Seat #9 is the button
Seat 1: matiko09 ($126.37 in chips) 
Seat 2: mycka86 ($102.50 in chips) 
Seat 3: sebaaastian ($141.75 in chips) 
Seat 5: Sweden_Pound ($176.88 in chips) 
Seat 7: bilukm ($163.26 in chips) 
Seat 8: Venomous100% ($105.03 in chips) 
Seat 9: HomerrrJay ($100 in chips) 
matiko09: posts small blind $0.50
mycka86: posts big blind $1
*** HOLE CARDS ***
Dealt to matiko09 [8h 2h]
sebaaastian: folds 
Sweden_Pound: folds 
bilukm: folds 
Venomous100%: folds 
HomerrrJay: folds 
matiko09: folds 
Uncalled bet ($0.50) returned to mycka86
mycka86 collected $1 from pot
*** SUMMARY ***
Total pot $1 | Rake $0 
Seat 1: matiko09 (small blind) folded before Flop
Seat 2: mycka86 (big blind) collected ($1)
Seat 3: sebaaastian folded before Flop (didn't bet)
Seat 5: Sweden_Pound folded before Flop (didn't bet)
Seat 7: bilukm folded before Flop (didn't bet)
Seat 8: Venomous100% folded before Flop (didn't bet)
Seat 9: HomerrrJay (button) folded before Flop (didn't bet)





PokerStars Hand #149393680468:  Hold'em No Limit ($0.50/$1.00 USD) - 2016/02/25 17:16:52 CET [2016/02/25 11:16:52 ET]
Table 'Sabine' 9-max Seat #8 is the button
Seat 2: apfush ($133.70 in chips) 
Seat 3: Ouga Buga ($147.44 in chips) 
Seat 5: Venomous100% ($105.10 in chips) 
Seat 6: ffac ($100 in chips) 
Seat 7: clayshmert ($44.78 in chips) 
Seat 8: matiko09 ($119.90 in chips) 
Seat 9: djammusic ($65.89 in chips) 
djammusic: posts small blind $0.50
apfush: posts big blind $1
*** HOLE CARDS ***
Dealt to matiko09 [Kc Ac]
Ouga Buga: folds 
Venomous100%: folds 
ffac: folds 
clayshmert: calls $1
matiko09: raises $3 to $4
djammusic: folds 
apfush: folds 
clayshmert: calls $3
*** FLOP *** [3d 2s 7s]
clayshmert: checks 
matiko09: checks 
*** TURN *** [3d 2s 7s] [Qc]
clayshmert: checks 
matiko09: checks 
*** RIVER *** [3d 2s 7s Qc] [6h]
clayshmert: checks 
matiko09: checks 
*** SHOW DOWN ***
clayshmert: shows [Tc Js] (high card Queen)
matiko09: shows [Kc Ac] (high card Ace)
matiko09 collected $9.07 from pot
*** SUMMARY ***
Total pot $9.50 | Rake $0.43 
Board [3d 2s 7s Qc 6h]
Seat 2: apfush (big blind) folded before Flop
Seat 3: Ouga Buga folded before Flop (didn't bet)
Seat 5: Venomous100% folded before Flop (didn't bet)
Seat 6: ffac folded before Flop (didn't bet)
Seat 7: clayshmert showed [Tc Js] and lost with high card Queen
Seat 8: matiko09 (button) showed [Kc Ac] and won ($9.07) with high card Ace
Seat 9: djammusic (small blind) folded before Flop





PokerStars Hand #149393685510:  Hold'em No Limit ($0.50/$1.00 USD) - 2016/02/25 17:16:58 CET [2016/02/25 11:16:58 ET]
Table 'Zeuxo II' 9-max Seat #9 is the button
Seat 1: forsmthgood ($112.79 in chips) 
Seat 2: Sweden_Pound ($114.70 in chips) 
Seat 4: sebaaastian ($112.11 in chips) 
Seat 6: Cogss ($100 in chips) 
Seat 7: djammusic ($48 in chips) 
Seat 8: matiko09 ($101.20 in chips) 
Seat 9: Sreshta222 ($206.30 in chips) 
forsmthgood: posts small blind $0.50
Sweden_Pound: posts big blind $1
*** HOLE CARDS ***
Dealt to matiko09 [Td 3c]
sebaaastian: folds 
Cogss: raises $1 to $2
djammusic: folds 
matiko09: folds 
Sreshta222: calls $2
forsmthgood: folds 
Sweden_Pound: raises $8 to $10
Cogss: calls $8
Sreshta222: folds 
*** FLOP *** [9c Ad 6c]
Sweden_Pound: bets $13.50
Cogss: calls $13.50
*** TURN *** [9c Ad 6c] [8c]
Sweden_Pound: checks 
Cogss: checks 
*** RIVER *** [9c Ad 6c 8c] [7h]
Sweden_Pound: bets $28
Cogss: folds 
Uncalled bet ($28) returned to Sweden_Pound
Sweden_Pound collected $47.27 from pot
Sweden_Pound: doesn't show hand 
*** SUMMARY ***
Total pot $49.50 | Rake $2.23 
Board [9c Ad 6c 8c 7h]
Seat 1: forsmthgood (small blind) folded before Flop
Seat 2: Sweden_Pound (big blind) collected ($47.27)
Seat 4: sebaaastian folded before Flop (didn't bet)
Seat 6: Cogss folded on the River
Seat 7: djammusic folded before Flop (didn't bet)
Seat 8: matiko09 folded before Flop (didn't bet)
Seat 9: Sreshta222 (button) folded before Flop





PokerStars Hand #149393686918:  Hold'em No Limit ($0.50/$1.00 USD) - 2016/02/25 17:17:00 CET [2016/02/25 11:17:00 ET]
Table 'Hercules IV' 9-max Seat #9 is the button
Seat 1: matiko09 ($100 in chips) 
Seat 3: HomerrrJay ($108 in chips) 
Seat 4: Sweden_Pound ($111.19 in chips) 
Seat 5: xAndorx ($160.08 in chips) 
Seat 6: kuanhung0903 ($61.39 in chips) 
Seat 7: Ouga Buga ($105.67 in chips) 
Seat 8: brokat77 ($129.67 in chips) 
Seat 9: djammusic ($39.50 in chips) 
matiko09: posts small blind $0.50
HomerrrJay: posts big blind $1
*** HOLE CARDS ***
Dealt to matiko09 [2h 4s]
Sweden_Pound: folds 
xAndorx: folds 
kuanhung0903: folds 
Ouga Buga: raises $1.50 to $2.50
brokat77: folds 
djammusic: folds 
matiko09: folds 
HomerrrJay: folds 
Uncalled bet ($1.50) returned to Ouga Buga
Ouga Buga collected $2.50 from pot
Ouga Buga: doesn't show hand 
*** SUMMARY ***
Total pot $2.50 | Rake $0 
Seat 1: matiko09 (small blind) folded before Flop
Seat 3: HomerrrJay (big blind) folded before Flop
Seat 4: Sweden_Pound folded before Flop (didn't bet)
Seat 5: xAndorx folded before Flop (didn't bet)
Seat 6: kuanhung0903 folded before Flop (didn't bet)
Seat 7: Ouga Buga collected ($2.50)
Seat 8: brokat77 folded before Flop (didn't bet)
Seat 9: djammusic (button) folded before Flop (didn't bet)





PokerStars Hand #149393688705:  Hold'em No Limit ($0.50/$1.00 USD) - 2016/02/25 17:17:02 CET [2016/02/25 11:17:02 ET]
Table 'Isa' 9-max Seat #1 is the button
Seat 1: matiko09 ($125.87 in chips) 
Seat 2: mycka86 ($103 in chips) 
Seat 3: sebaaastian ($141.75 in chips) 
Seat 5: Sweden_Pound ($176.88 in chips) 
Seat 7: bilukm ($163.26 in chips) 
Seat 8: Venomous100% ($105.03 in chips) 
Seat 9: HomerrrJay ($100 in chips) 
mycka86: posts small blind $0.50
sebaaastian: posts big blind $1
*** HOLE CARDS ***
Dealt to matiko09 [2c 6d]
Sweden_Pound: folds 
bilukm: calls $1
Venomous100%: folds 
HomerrrJay: raises $3.50 to $4.50
matiko09: folds 
mycka86: folds 
sebaaastian: folds 
bilukm: calls $3.50
*** FLOP *** [9d 6h Qc]
bilukm: bets $5.01
HomerrrJay: calls $5.01
*** TURN *** [9d 6h Qc] [Qs]
bilukm: bets $9.80
HomerrrJay: raises $19.60 to $29.40
bilukm: calls $19.60
*** RIVER *** [9d 6h Qc Qs] [5h]
bilukm: checks 
HomerrrJay: bets $35.50
bilukm: calls $35.50
*** SHOW DOWN ***
HomerrrJay: shows [Ad Qh] (three of a kind, Queens)
bilukm: mucks hand 
HomerrrJay collected $147.52 from pot
*** SUMMARY ***
Total pot $150.32 | Rake $2.80 
Board [9d 6h Qc Qs 5h]
Seat 1: matiko09 (button) folded before Flop (didn't bet)
Seat 2: mycka86 (small blind) folded before Flop
Seat 3: sebaaastian (big blind) folded before Flop
Seat 5: Sweden_Pound folded before Flop (didn't bet)
Seat 7: bilukm mucked [Tc Qd]
Seat 8: Venomous100% folded before Flop (didn't bet)
Seat 9: HomerrrJay showed [Ad Qh] and won ($147.52) with three of a kind, Queens





PokerStars Hand #149393693841:  Hold'em No Limit ($0.50/$1.00 USD) - 2016/02/25 17:17:09 CET [2016/02/25 11:17:09 ET]
Table 'Badenia II' 9-max Seat #1 is the button
Seat 1: matiko09 ($100 in chips) 
Seat 2: Stibitzkie ($59.33 in chips) 
Seat 3: sebaaastian ($127.84 in chips) 
Seat 5: djammusic ($127.95 in chips) 
Seat 7: forsmthgood ($108.26 in chips) 
Seat 8: Sweden_Pound ($141.35 in chips) 
Seat 9: waisanen ($247.47 in chips) 
Stibitzkie: posts small blind $0.50
sebaaastian: posts big blind $1
*** HOLE CARDS ***
Dealt to matiko09 [9d Ad]
djammusic: folds 
forsmthgood: folds 
Sweden_Pound: folds 
waisanen: folds 
matiko09: raises $1.27 to $2.27
Stibitzkie: calls $1.77
sebaaastian: calls $1.27
*** FLOP *** [3s Qh 3c]
Stibitzkie: checks 
sebaaastian: checks 
matiko09: bets $4.23
Stibitzkie: folds 
sebaaastian: folds 
Uncalled bet ($4.23) returned to matiko09
matiko09 collected $6.50 from pot
matiko09: doesn't show hand 
*** SUMMARY ***
Total pot $6.81 | Rake $0.31 
Board [3s Qh 3c]
Seat 1: matiko09 (button) collected ($6.50)
Seat 2: Stibitzkie (small blind) folded on the Flop
Seat 3: sebaaastian (big blind) folded on the Flop
Seat 5: djammusic folded before Flop (didn't bet)
Seat 7: forsmthgood folded before Flop (didn't bet)
Seat 8: Sweden_Pound folded before Flop (didn't bet)
Seat 9: waisanen folded before Flop (didn't bet)





PokerStars Hand #149393701289:  Hold'em No Limit ($0.50/$1.00 USD) - 2016/02/25 17:17:18 CET [2016/02/25 11:17:18 ET]
Table 'Syrma II' 9-max Seat #1 is the button
Seat 1: lysandrafly ($107.32 in chips) 
Seat 2: Sreshta222 ($115.71 in chips) 
Seat 3: simoniustin ($111.42 in chips) 
Seat 5: nickreason17 ($115.29 in chips) 
Seat 6: ffac ($119.65 in chips) 
Seat 7: matiko09 ($100 in chips) 
Seat 9: gulseren848 ($64.68 in chips) 
Sreshta222: posts small blind $0.50
simoniustin: posts big blind $1
*** HOLE CARDS ***
Dealt to matiko09 [Th 2c]
nickreason17: folds 
ffac: folds 
matiko09: folds 
gulseren848: folds 
lysandrafly: folds 
Sreshta222: raises $1.09 to $2.09
simoniustin: calls $1.09
*** FLOP *** [8h Ac 8d]
Sreshta222: checks 
simoniustin: checks 
*** TURN *** [8h Ac 8d] [Kc]
Sreshta222: bets $2.50
simoniustin: calls $2.50
*** RIVER *** [8h Ac 8d Kc] [Jh]
Sreshta222: checks 
simoniustin: checks 
*** SHOW DOWN ***
Sreshta222: shows [6d 9s] (a pair of Eights)
simoniustin: shows [Jc 7c] (two pair, Jacks and Eights)
simoniustin collected $8.77 from pot
*** SUMMARY ***
Total pot $9.18 | Rake $0.41 
Board [8h Ac 8d Kc Jh]
Seat 1: lysandrafly (button) folded before Flop (didn't bet)
Seat 2: Sreshta222 (small blind) showed [6d 9s] and lost with a pair of Eights
Seat 3: simoniustin (big blind) showed [Jc 7c] and won ($8.77) with two pair, Jacks and Eights
Seat 5: nickreason17 folded before Flop (didn't bet)
Seat 6: ffac folded before Flop (didn't bet)
Seat 7: matiko09 folded before Flop (didn't bet)
Seat 9: gulseren848 folded before Flop (didn't bet)





PokerStars Hand #149393705408:  Hold'em No Limit ($0.50/$1.00 USD) - 2016/02/25 17:17:24 CET [2016/02/25 11:17:24 ET]
Table 'Mayall II' 9-max Seat #3 is the button
Seat 1: matiko09 ($112.11 in chips) 
Seat 2: Sweden_Pound ($142.47 in chips) 
Seat 3: simoniustin ($100 in chips) 
Seat 4: Ouga Buga ($110.12 in chips) 
Seat 6: apfush ($100 in chips) 
Seat 7: r.pol218 ($58.70 in chips) 
Seat 8: kuanhung0903 ($90.93 in chips) 
Ouga Buga: posts small blind $0.50
SumPosad: is sitting out 
apfush: posts big blind $1
*** HOLE CARDS ***
Dealt to matiko09 [Qh 2h]
r.pol218: folds 
SumPosad leaves the table
kuanhung0903: calls $1
HomerrrJay joins the table at seat #5 
matiko09: folds 
Sweden_Pound: folds 
simoniustin: folds 
Ouga Buga: folds 
apfush: checks 
*** FLOP *** [7c 6s 8s]
apfush: bets $2
kuanhung0903: folds 
Uncalled bet ($2) returned to apfush
apfush collected $2.39 from pot
apfush: doesn't show hand 
*** SUMMARY ***
Total pot $2.50 | Rake $0.11 
Board [7c 6s 8s]
Seat 1: matiko09 folded before Flop (didn't bet)
Seat 2: Sweden_Pound folded before Flop (didn't bet)
Seat 3: simoniustin (button) folded before Flop (didn't bet)
Seat 4: Ouga Buga (small blind) folded before Flop
Seat 6: apfush (big blind) collected ($2.39)
Seat 7: r.pol218 folded before Flop (didn't bet)
Seat 8: kuanhung0903 folded on the Flop





PokerStars Hand #149393706520:  Hold'em No Limit ($0.25/$0.50 USD) - 2016/02/25 17:17:25 CET [2016/02/25 11:17:25 ET]
Table 'Lohja II' 9-max Seat #5 is the button
Seat 1: MoonJimmy ($139.68 in chips) 
Seat 2: Apparat888 ($44.20 in chips) 
Seat 3: guvalc1952 ($184.75 in chips) 
Seat 4: payback11 ($50 in chips) 
Seat 5: 111STAVR111 ($51.01 in chips) 
Seat 7: matiko09 ($126.08 in chips) 
Seat 8: jamba83 ($76.51 in chips) 
Seat 9: Al3xAnd3r22 ($100.44 in chips) 
matiko09: posts small blind $0.25
jamba83: posts big blind $0.50
MoonJimmy: posts the ante $0.10
Apparat888: posts the ante $0.10
guvalc1952: posts the ante $0.10
payback11: posts the ante $0.10
111STAVR111: posts the ante $0.10
matiko09: posts the ante $0.10
jamba83: posts the ante $0.10
Al3xAnd3r22: posts the ante $0.10
*** HOLE CARDS ***
Dealt to matiko09 [2s 5s]
Al3xAnd3r22: folds 
MoonJimmy: folds 
Apparat888: raises $0.75 to $1.25
guvalc1952: calls $1.25
payback11: folds 
111STAVR111: folds 
matiko09: folds 
jamba83: calls $0.75
*** FLOP *** [Kd Qd 8c]
jamba83: checks 
Apparat888: checks 
guvalc1952: checks 
*** TURN *** [Kd Qd 8c] [7d]
jamba83: bets $2.50
Apparat888: folds 
guvalc1952: folds 
Uncalled bet ($2.50) returned to jamba83
jamba83 collected $4.58 from pot
*** SUMMARY ***
Total pot $4.80 | Rake $0.22 
Board [Kd Qd 8c 7d]
Seat 1: MoonJimmy folded before Flop (didn't bet)
Seat 2: Apparat888 folded on the Turn
Seat 3: guvalc1952 folded on the Turn
Seat 4: payback11 folded before Flop (didn't bet)
Seat 5: 111STAVR111 (button) folded before Flop (didn't bet)
Seat 7: matiko09 (small blind) folded before Flop
Seat 8: jamba83 (big blind) collected ($4.58)
Seat 9: Al3xAnd3r22 folded before Flop (didn't bet)





PokerStars Hand #149393708849:  Hold'em No Limit ($0.50/$1.00 USD) - 2016/02/25 17:17:28 CET [2016/02/25 11:17:28 ET]
Table 'Ebella II' 9-max Seat #9 is the button
Seat 1: nickreason17 ($105.96 in chips) 
Seat 2: Sweden_Pound ($100 in chips) 
Seat 5: matiko09 ($100 in chips) 
Seat 8: ZMPOUTSAM140 ($78.43 in chips) 
Seat 9: simoniustin ($114.66 in chips) 
nickreason17: posts small blind $0.50
Sweden_Pound: posts big blind $1
*** HOLE CARDS ***
Dealt to matiko09 [9s 2d]
matiko09: folds 
ZMPOUTSAM140: raises $1 to $2
simoniustin: folds 
nickreason17: folds 
Sweden_Pound: folds 
Uncalled bet ($1) returned to ZMPOUTSAM140
hammerwife leaves the table
ZMPOUTSAM140 collected $2.50 from pot
fanmtZ joins the table at seat #3 
*** SUMMARY ***
Total pot $2.50 | Rake $0 
Seat 1: nickreason17 (small blind) folded before Flop
Seat 2: Sweden_Pound (big blind) folded before Flop
Seat 5: matiko09 folded before Flop (didn't bet)
Seat 8: ZMPOUTSAM140 collected ($2.50)
Seat 9: simoniustin (button) folded before Flop (didn't bet)





PokerStars Hand #149393709689:  Hold'em No Limit ($0.50/$1.00 USD) - 2016/02/25 17:17:29 CET [2016/02/25 11:17:29 ET]
Table 'Hercules IV' 9-max Seat #1 is the button
Seat 1: matiko09 ($100 in chips) 
Seat 3: HomerrrJay ($107 in chips) 
Seat 4: Sweden_Pound ($111.19 in chips) 
Seat 6: kuanhung0903 ($61.39 in chips) 
Seat 7: Ouga Buga ($107.17 in chips) 
Seat 8: brokat77 ($129.67 in chips) 
Seat 9: djammusic ($39.50 in chips) 
HomerrrJay: posts small blind $0.50
Sweden_Pound: posts big blind $1
*** HOLE CARDS ***
Dealt to matiko09 [5s 3c]
kuanhung0903: calls $1
Ouga Buga: folds 
brokat77: calls $1
djammusic: folds 
matiko09: folds 
HomerrrJay: folds 
hammerwife leaves the table
Venomous100% joins the table at seat #2 
Sweden_Pound: checks 
*** FLOP *** [8h 9d 7c]
Sweden_Pound: checks 
kuanhung0903: checks 
brokat77: bets $3.34
Sweden_Pound: folds 
kuanhung0903: folds 
Uncalled bet ($3.34) returned to brokat77
brokat77 collected $3.34 from pot
brokat77: doesn't show hand 
*** SUMMARY ***
Total pot $3.50 | Rake $0.16 
Board [8h 9d 7c]
Seat 1: matiko09 (button) folded before Flop (didn't bet)
Seat 3: HomerrrJay (small blind) folded before Flop
Seat 4: Sweden_Pound (big blind) folded on the Flop
Seat 6: kuanhung0903 folded on the Flop
Seat 7: Ouga Buga folded before Flop (didn't bet)
Seat 8: brokat77 collected ($3.34)
Seat 9: djammusic folded before Flop (didn't bet)





PokerStars Hand #149393710610:  Hold'em No Limit ($0.50/$1.00 USD) - 2016/02/25 17:17:30 CET [2016/02/25 11:17:30 ET]
Table 'Nerthus II' 9-max Seat #3 is the button
Seat 1: DUkalisUA ($100 in chips) 
Seat 2: matiko09 ($216.79 in chips) 
Seat 3: simoniustin ($100 in chips) 
Seat 4: Ilov3NBA ($101.75 in chips) 
Seat 5: Sweden_Pound ($219.63 in chips) 
Seat 6: mycka86 ($103 in chips) 
Seat 7: Venomous100% ($121.61 in chips) 
Seat 8: Kelvin sai ($30.88 in chips) 
Ilov3NBA: posts small blind $0.50
Sweden_Pound: posts big blind $1
*** HOLE CARDS ***
Dealt to matiko09 [Qs Td]
mycka86: raises $2 to $3
Venomous100%: folds 
Kelvin sai: calls $3
DUkalisUA: folds 
matiko09: folds 
simoniustin: folds 
Ilov3NBA: folds 
Sweden_Pound: folds 
*** FLOP *** [2c 2d 9c]
mycka86: bets $4.50
Kelvin sai: calls $4.50
*** TURN *** [2c 2d 9c] [4d]
mycka86: bets $8.66
Kelvin sai: raises $14.72 to $23.38 and is all-in
mycka86: calls $14.72
*** RIVER *** [2c 2d 9c 4d] [Qh]
*** SHOW DOWN ***
mycka86: shows [2s As] (three of a kind, Deuces)
Kelvin sai: shows [Jh Js] (two pair, Jacks and Deuces)
mycka86 collected $60.46 from pot
*** SUMMARY ***
Total pot $63.26 | Rake $2.80 
Board [2c 2d 9c 4d Qh]
Seat 1: DUkalisUA folded before Flop (didn't bet)
Seat 2: matiko09 folded before Flop (didn't bet)
Seat 3: simoniustin (button) folded before Flop (didn't bet)
Seat 4: Ilov3NBA (small blind) folded before Flop
Seat 5: Sweden_Pound (big blind) folded before Flop
Seat 6: mycka86 showed [2s As] and won ($60.46) with three of a kind, Deuces
Seat 7: Venomous100% folded before Flop (didn't bet)
Seat 8: Kelvin sai showed [Jh Js] and lost with two pair, Jacks and Deuces





PokerStars Hand #149393715624:  Hold'em No Limit ($0.25/$0.50 USD) - 2016/02/25 17:17:36 CET [2016/02/25 11:17:36 ET]
Table 'Thalpius III' 9-max Seat #4 is the button
Seat 1: BrotherLove9 ($60.87 in chips) 
Seat 2: matiko09 ($62.81 in chips) 
Seat 3: jamba83 ($52.08 in chips) 
Seat 4: Wwwasian ($69.76 in chips) 
Seat 5: Al3xAnd3r22 ($50 in chips) 
Seat 7: v4n0v ($58.65 in chips) 
Seat 9: Domotirko228 ($58.11 in chips) 
Al3xAnd3r22: posts small blind $0.25
111STAVR111: is sitting out 
111STAVR111 leaves the table
v4n0v: posts big blind $0.50
*** HOLE CARDS ***
Dealt to matiko09 [6s Ts]
Domotirko228: folds 
BrotherLove9: folds 
matiko09: folds 
jamba83: folds 
Wwwasian: folds 
Al3xAnd3r22: raises $1 to $1.50
v4n0v: folds 
Uncalled bet ($1) returned to Al3xAnd3r22
Al3xAnd3r22 collected $1 from pot
*** SUMMARY ***
Total pot $1 | Rake $0 
Seat 1: BrotherLove9 folded before Flop (didn't bet)
Seat 2: matiko09 folded before Flop (didn't bet)
Seat 3: jamba83 folded before Flop (didn't bet)
Seat 4: Wwwasian (button) folded before Flop (didn't bet)
Seat 5: Al3xAnd3r22 (small blind) collected ($1)
Seat 7: v4n0v (big blind) folded before Flop
Seat 9: Domotirko228 folded before Flop (didn't bet)





PokerStars Hand #149393724334:  Hold'em No Limit ($0.50/$1.00 USD) - 2016/02/25 17:17:47 CET [2016/02/25 11:17:47 ET]
Table 'Sabine' 9-max Seat #9 is the button
Seat 2: apfush ($132.70 in chips) 
Seat 3: Ouga Buga ($147.44 in chips) 
Seat 5: Venomous100% ($105.10 in chips) 
Seat 6: ffac ($100 in chips) 
Seat 7: clayshmert ($40.78 in chips) 
Seat 8: matiko09 ($124.97 in chips) 
Seat 9: djammusic ($65.39 in chips) 
apfush: posts small blind $0.50
Ouga Buga: posts big blind $1
*** HOLE CARDS ***
Dealt to matiko09 [6h 8s]
Venomous100%: raises $2 to $3
ffac: folds 
clayshmert: folds 
matiko09: folds 
djammusic: folds 
apfush: folds 
Ouga Buga: calls $2
*** FLOP *** [8c 4h 4c]
Ouga Buga: checks 
Venomous100%: bets $4.10
Ouga Buga: calls $4.10
*** TURN *** [8c 4h 4c] [As]
Ouga Buga: checks 
Venomous100%: checks 
*** RIVER *** [8c 4h 4c As] [Qc]
Ouga Buga: checks 
Venomous100%: checks 
*** SHOW DOWN ***
Ouga Buga: shows [9s 9h] (two pair, Nines and Fours)
Venomous100%: shows [Jc Jh] (two pair, Jacks and Fours)
Venomous100% collected $14.04 from pot
*** SUMMARY ***
Total pot $14.70 | Rake $0.66 
Board [8c 4h 4c As Qc]
Seat 2: apfush (small blind) folded before Flop
Seat 3: Ouga Buga (big blind) showed [9s 9h] and lost with two pair, Nines and Fours
Seat 5: Venomous100% showed [Jc Jh] and won ($14.04) with two pair, Jacks and Fours
Seat 6: ffac folded before Flop (didn't bet)
Seat 7: clayshmert folded before Flop (didn't bet)
Seat 8: matiko09 folded before Flop (didn't bet)
Seat 9: djammusic (button) folded before Flop (didn't bet)





PokerStars Hand #149393730229:  Hold'em No Limit ($0.50/$1.00 USD) - 2016/02/25 17:17:55 CET [2016/02/25 11:17:55 ET]
Table 'Ebella II' 9-max Seat #1 is the button
Seat 1: nickreason17 ($105.46 in chips) 
Seat 2: Sweden_Pound ($100 in chips) 
Seat 3: fanmtZ ($40 in chips) 
Seat 5: matiko09 ($100 in chips) 
Seat 8: ZMPOUTSAM140 ($79.93 in chips) 
Seat 9: simoniustin ($114.66 in chips) 
Sweden_Pound: posts small blind $0.50
fanmtZ: posts big blind $1
Aalleekks: sits out 
*** HOLE CARDS ***
Dealt to matiko09 [6h Ks]
Aalleekks leaves the table
matiko09: folds 
gabi_igna joins the table at seat #6 
ZMPOUTSAM140: raises $2 to $3
simoniustin: folds 
nickreason17: folds 
Sweden_Pound: folds 
fanmtZ: calls $2
*** FLOP *** [Js 2h 9h]
fanmtZ: checks 
ZMPOUTSAM140: bets $3.10
fanmtZ: raises $11.53 to $14.63
ZMPOUTSAM140: folds 
Uncalled bet ($11.53) returned to fanmtZ
fanmtZ collected $12.13 from pot
fanmtZ: doesn't show hand 
*** SUMMARY ***
Total pot $12.70 | Rake $0.57 
Board [Js 2h 9h]
Seat 1: nickreason17 (button) folded before Flop (didn't bet)
Seat 2: Sweden_Pound (small blind) folded before Flop
Seat 3: fanmtZ (big blind) collected ($12.13)
Seat 5: matiko09 folded before Flop (didn't bet)
Seat 8: ZMPOUTSAM140 folded on the Flop
Seat 9: simoniustin folded before Flop (didn't bet)





PokerStars Hand #149393738141:  Hold'em No Limit ($0.50/$1.00 USD) - 2016/02/25 17:18:05 CET [2016/02/25 11:18:05 ET]
Table 'Badenia II' 9-max Seat #2 is the button
Seat 1: matiko09 ($104.23 in chips) 
Seat 2: Stibitzkie ($57.06 in chips) 
Seat 3: sebaaastian ($125.57 in chips) 
Seat 4: hammerwife ($100 in chips) 
Seat 5: djammusic ($127.95 in chips) 
Seat 7: forsmthgood ($108.26 in chips) 
Seat 8: Sweden_Pound ($141.35 in chips) 
Seat 9: waisanen ($247.47 in chips) 
sebaaastian: posts small blind $0.50
hammerwife: posts big blind $1
*** HOLE CARDS ***
Dealt to matiko09 [Kh Jh]
djammusic: folds 
forsmthgood: folds 
Sweden_Pound: folds 
waisanen: folds 
matiko09: raises $1.50 to $2.50
Stibitzkie: folds 
sebaaastian: folds 
hammerwife: folds 
Uncalled bet ($1.50) returned to matiko09
matiko09 collected $2.50 from pot
matiko09: doesn't show hand 
*** SUMMARY ***
Total pot $2.50 | Rake $0 
Seat 1: matiko09 collected ($2.50)
Seat 2: Stibitzkie (button) folded before Flop (didn't bet)
Seat 3: sebaaastian (small blind) folded before Flop
Seat 4: hammerwife (big blind) folded before Flop
Seat 5: djammusic folded before Flop (didn't bet)
Seat 7: forsmthgood folded before Flop (didn't bet)
Seat 8: Sweden_Pound folded before Flop (didn't bet)
Seat 9: waisanen folded before Flop (didn't bet)





PokerStars Hand #149393740184:  Hold'em No Limit ($0.50/$1.00 USD) - 2016/02/25 17:18:07 CET [2016/02/25 11:18:07 ET]
Table 'Mayall II' 9-max Seat #4 is the button
Seat 1: matiko09 ($112.11 in chips) 
Seat 2: Sweden_Pound ($142.47 in chips) 
Seat 3: simoniustin ($100 in chips) 
Seat 4: Ouga Buga ($109.62 in chips) 
Seat 6: apfush ($101.39 in chips) 
Seat 7: r.pol218 ($58.70 in chips) 
Seat 8: kuanhung0903 ($89.93 in chips) 
HomerrrJay will be allowed to play after the button
apfush: posts small blind $0.50
r.pol218: posts big blind $1
*** HOLE CARDS ***
Dealt to matiko09 [8d 3s]
kuanhung0903: calls $1
matiko09: folds 
Sweden_Pound: raises $3 to $4
simoniustin: calls $4
Ouga Buga: folds 
apfush: folds 
r.pol218: folds 
kuanhung0903: calls $3
*** FLOP *** [Kc 7c 5d]
kuanhung0903: checks 
Sweden_Pound: bets $8.38
simoniustin: folds 
kuanhung0903: folds 
Uncalled bet ($8.38) returned to Sweden_Pound
Sweden_Pound collected $12.89 from pot
Sweden_Pound: doesn't show hand 
*** SUMMARY ***
Total pot $13.50 | Rake $0.61 
Board [Kc 7c 5d]
Seat 1: matiko09 folded before Flop (didn't bet)
Seat 2: Sweden_Pound collected ($12.89)
Seat 3: simoniustin folded on the Flop
Seat 4: Ouga Buga (button) folded before Flop (didn't bet)
Seat 6: apfush (small blind) folded before Flop
Seat 7: r.pol218 (big blind) folded before Flop
Seat 8: kuanhung0903 folded on the Flop





PokerStars Hand #149393743112:  Hold'em No Limit ($0.50/$1.00 USD) - 2016/02/25 17:18:11 CET [2016/02/25 11:18:11 ET]
Table 'Morosovia II' 9-max Seat #2 is the button
Seat 1: apfush ($172.26 in chips) 
Seat 2: Effort92 ($100 in chips) 
Seat 3: sebaaastian ($216.86 in chips) 
Seat 4: Venomous100% ($155.52 in chips) 
Seat 5: pimpoza ($92.97 in chips) 
Seat 6: Sweden_Pound ($127.07 in chips) 
Seat 7: matiko09 ($166.55 in chips) 
Seat 8: simoniustin ($108.16 in chips) 
Seat 9: Ouga Buga ($134.07 in chips) 
sebaaastian: posts small blind $0.50
Venomous100%: posts big blind $1
*** HOLE CARDS ***
Dealt to matiko09 [7s 2h]
pimpoza: folds 
Effort92 said, "call? vot je yebok :D"
Sweden_Pound: folds 
matiko09: folds 
simoniustin: folds 
Ouga Buga: raises $1.50 to $2.50
apfush: folds 
Effort92: folds 
sebaaastian: folds 
Venomous100%: folds 
Uncalled bet ($1.50) returned to Ouga Buga
Ouga Buga collected $2.50 from pot
Ouga Buga: doesn't show hand 
*** SUMMARY ***
Total pot $2.50 | Rake $0 
Seat 1: apfush folded before Flop (didn't bet)
Seat 2: Effort92 (button) folded before Flop (didn't bet)
Seat 3: sebaaastian (small blind) folded before Flop
Seat 4: Venomous100% (big blind) folded before Flop
Seat 5: pimpoza folded before Flop (didn't bet)
Seat 6: Sweden_Pound folded before Flop (didn't bet)
Seat 7: matiko09 folded before Flop (didn't bet)
Seat 8: simoniustin folded before Flop (didn't bet)
Seat 9: Ouga Buga collected ($2.50)





PokerStars Hand #149393744018:  Hold'em No Limit ($0.25/$0.50 USD) - 2016/02/25 17:18:12 CET [2016/02/25 11:18:12 ET]
Table 'Thalpius III' 9-max Seat #5 is the button
Seat 1: BrotherLove9 ($60.87 in chips) 
Seat 2: matiko09 ($62.81 in chips) 
Seat 3: jamba83 ($52.08 in chips) 
Seat 4: Wwwasian ($69.76 in chips) 
Seat 5: Al3xAnd3r22 ($50.50 in chips) 
Seat 7: v4n0v ($58.15 in chips) 
Seat 9: Domotirko228 ($58.11 in chips) 
v4n0v: posts small blind $0.25
Domotirko228: posts big blind $0.50
*** HOLE CARDS ***
Dealt to matiko09 [7c 4d]
BrotherLove9: folds 
matiko09: folds 
jamba83: folds 
schlaflos40 joins the table at seat #6 
Wwwasian: folds 
Al3xAnd3r22: folds 
v4n0v: folds 
Uncalled bet ($0.25) returned to Domotirko228
Domotirko228 collected $0.50 from pot
Domotirko228: doesn't show hand 
*** SUMMARY ***
Total pot $0.50 | Rake $0 
Seat 1: BrotherLove9 folded before Flop (didn't bet)
Seat 2: matiko09 folded before Flop (didn't bet)
Seat 3: jamba83 folded before Flop (didn't bet)
Seat 4: Wwwasian folded before Flop (didn't bet)
Seat 5: Al3xAnd3r22 (button) folded before Flop (didn't bet)
Seat 7: v4n0v (small blind) folded before Flop
Seat 9: Domotirko228 (big blind) collected ($0.50)





PokerStars Hand #149393757766:  Hold'em No Limit ($0.25/$0.50 USD) - 2016/02/25 17:18:29 CET [2016/02/25 11:18:29 ET]
Table 'Lohja II' 9-max Seat #7 is the button
Seat 1: MoonJimmy ($139.58 in chips) 
Seat 2: Apparat888 ($42.85 in chips) 
Seat 3: guvalc1952 ($183.40 in chips) 
Seat 4: payback11 ($50 in chips) 
Seat 5: 111STAVR111 ($50.91 in chips) 
Seat 7: matiko09 ($125.73 in chips) 
Seat 8: jamba83 ($79.74 in chips) 
Seat 9: Al3xAnd3r22 ($100.34 in chips) 
jamba83: posts small blind $0.25
Al3xAnd3r22: posts big blind $0.50
MoonJimmy: posts the ante $0.10
Apparat888: posts the ante $0.10
guvalc1952: posts the ante $0.10
payback11: posts the ante $0.10
111STAVR111: posts the ante $0.10
matiko09: posts the ante $0.10
jamba83: posts the ante $0.10
Al3xAnd3r22: posts the ante $0.10
*** HOLE CARDS ***
Dealt to matiko09 [8h 3h]
MoonJimmy: folds 
Apparat888: folds 
guvalc1952: folds 
payback11: folds 
111STAVR111: folds 
matiko09: raises $1 to $1.50
jamba83: folds 
Al3xAnd3r22: calls $1
*** FLOP *** [9c 5d 3d]
Al3xAnd3r22: checks 
matiko09: checks 
*** TURN *** [9c 5d 3d] [4c]
Al3xAnd3r22: bets $2.55
matiko09: folds 
Uncalled bet ($2.55) returned to Al3xAnd3r22
Al3xAnd3r22 collected $3.87 from pot
Al3xAnd3r22: doesn't show hand 
*** SUMMARY ***
Total pot $4.05 | Rake $0.18 
Board [9c 5d 3d 4c]
Seat 1: MoonJimmy folded before Flop (didn't bet)
Seat 2: Apparat888 folded before Flop (didn't bet)
Seat 3: guvalc1952 folded before Flop (didn't bet)
Seat 4: payback11 folded before Flop (didn't bet)
Seat 5: 111STAVR111 folded before Flop (didn't bet)
Seat 7: matiko09 (button) folded on the Turn
Seat 8: jamba83 (small blind) folded before Flop
Seat 9: Al3xAnd3r22 (big blind) collected ($3.87)





PokerStars Hand #149393758296:  Hold'em No Limit ($0.50/$1.00 USD) - 2016/02/25 17:18:30 CET [2016/02/25 11:18:30 ET]
Table 'Isa' 9-max Seat #2 is the button
Seat 1: matiko09 ($125.87 in chips) 
Seat 2: mycka86 ($102.50 in chips) 
Seat 3: sebaaastian ($140.75 in chips) 
Seat 4: hammerwife ($100.81 in chips) 
Seat 5: Sweden_Pound ($176.88 in chips) 
Seat 7: bilukm ($100 in chips) 
Seat 8: Venomous100% ($105.03 in chips) 
Seat 9: HomerrrJay ($173.11 in chips) 
sebaaastian: posts small blind $0.50
hammerwife: posts big blind $1
*** HOLE CARDS ***
Dealt to matiko09 [3s Qc]
Sweden_Pound: folds 
bilukm: folds 
Venomous100%: folds 
HomerrrJay: folds 
matiko09: folds 
mycka86: raises $1.10 to $2.10
sebaaastian: folds 
hammerwife: raises $5.90 to $8
mycka86: folds 
Uncalled bet ($5.90) returned to hammerwife
hammerwife collected $4.70 from pot
hammerwife: doesn't show hand 
*** SUMMARY ***
Total pot $4.70 | Rake $0 
Seat 1: matiko09 folded before Flop (didn't bet)
Seat 2: mycka86 (button) folded before Flop
Seat 3: sebaaastian (small blind) folded before Flop
Seat 4: hammerwife (big blind) collected ($4.70)
Seat 5: Sweden_Pound folded before Flop (didn't bet)
Seat 7: bilukm folded before Flop (didn't bet)
Seat 8: Venomous100% folded before Flop (didn't bet)
Seat 9: HomerrrJay folded before Flop (didn't bet)





PokerStars Hand #149393761033:  Hold'em No Limit ($0.50/$1.00 USD) - 2016/02/25 17:18:33 CET [2016/02/25 11:18:33 ET]
Table 'Badenia II' 9-max Seat #3 is the button
Seat 1: matiko09 ($105.73 in chips) 
Seat 2: Stibitzkie ($57.06 in chips) 
Seat 3: sebaaastian ($125.07 in chips) 
Seat 4: hammerwife ($100 in chips) 
Seat 5: djammusic ($127.95 in chips) 
Seat 7: forsmthgood ($108.26 in chips) 
Seat 8: Sweden_Pound ($141.35 in chips) 
Seat 9: waisanen ($247.47 in chips) 
hammerwife: posts small blind $0.50
djammusic: posts big blind $1
*** HOLE CARDS ***
Dealt to matiko09 [8d 8c]
forsmthgood: folds 
Sweden_Pound: folds 
waisanen: folds 
matiko09: raises $2 to $3
Stibitzkie: calls $3
sebaaastian: raises $9 to $12
hammerwife: folds 
djammusic: folds 
matiko09: folds 
Stibitzkie: calls $9
*** FLOP *** [Td Jd 2c]
Stibitzkie: checks 
sebaaastian: bets $46
Stibitzkie: folds 
Uncalled bet ($46) returned to sebaaastian
sebaaastian collected $27.22 from pot
sebaaastian: doesn't show hand 
*** SUMMARY ***
Total pot $28.50 | Rake $1.28 
Board [Td Jd 2c]
Seat 1: matiko09 folded before Flop
Seat 2: Stibitzkie folded on the Flop
Seat 3: sebaaastian (button) collected ($27.22)
Seat 4: hammerwife (small blind) folded before Flop
Seat 5: djammusic (big blind) folded before Flop
Seat 7: forsmthgood folded before Flop (didn't bet)
Seat 8: Sweden_Pound folded before Flop (didn't bet)
Seat 9: waisanen folded before Flop (didn't bet)





PokerStars Hand #149393765273:  Hold'em No Limit ($0.50/$1.00 USD) - 2016/02/25 17:18:39 CET [2016/02/25 11:18:39 ET]
Table 'Syrma II' 9-max Seat #2 is the button
Seat 1: lysandrafly ($107.32 in chips) 
Seat 2: Sreshta222 ($111.12 in chips) 
Seat 3: simoniustin ($115.60 in chips) 
Seat 4: Aalleekks ($100 in chips) 
Seat 5: nickreason17 ($115.29 in chips) 
Seat 6: ffac ($119.65 in chips) 
Seat 7: matiko09 ($100 in chips) 
Seat 9: gulseren848 ($64.68 in chips) 
simoniustin: posts small blind $0.50
Aalleekks: posts big blind $1
hammerwife: sits out 
*** HOLE CARDS ***
Dealt to matiko09 [5d Ts]
nickreason17: folds 
ffac: folds 
matiko09: folds 
gulseren848: folds 
lysandrafly: folds 
Sreshta222 has timed out while being disconnected
Sreshta222: folds 
Sreshta222 is disconnected 
simoniustin: raises $1.02 to $2.02
Aalleekks: calls $1.02
*** FLOP *** [Ac 8h 3s]
simoniustin: checks 
Aalleekks: bets $2.12
simoniustin: calls $2.12
*** TURN *** [Ac 8h 3s] [4d]
simoniustin: checks 
Aalleekks: bets $5
simoniustin: calls $5
*** RIVER *** [Ac 8h 3s 4d] [Ah]
simoniustin: checks 
Aalleekks: checks 
*** SHOW DOWN ***
simoniustin: shows [Qh Qd] (two pair, Aces and Queens)
Aalleekks: mucks hand 
simoniustin collected $17.46 from pot
*** SUMMARY ***
Total pot $18.28 | Rake $0.82 
Board [Ac 8h 3s 4d Ah]
Seat 1: lysandrafly folded before Flop (didn't bet)
Seat 2: Sreshta222 (button) folded before Flop (didn't bet)
Seat 3: simoniustin (small blind) showed [Qh Qd] and won ($17.46) with two pair, Aces and Queens
Seat 4: Aalleekks (big blind) mucked [7c Js]
Seat 5: nickreason17 folded before Flop (didn't bet)
Seat 6: ffac folded before Flop (didn't bet)
Seat 7: matiko09 folded before Flop (didn't bet)
Seat 9: gulseren848 folded before Flop (didn't bet)





PokerStars Hand #149393767188:  Hold'em No Limit ($0.50/$1.00 USD) - 2016/02/25 17:18:41 CET [2016/02/25 11:18:41 ET]
Table 'Zerbinetta II' 9-max Seat #2 is the button
Seat 2: lysandrafly ($100 in chips) 
Seat 3: matiko09 ($100 in chips) 
Seat 6: nickreason17 ($100 in chips) 
Seat 9: with-w ($40 in chips) 
matiko09: posts small blind $0.50
nickreason17: posts big blind $1
*** HOLE CARDS ***
Dealt to matiko09 [Ad 8h]
sebaaastian joins the table at seat #4 
with-w: folds 
lysandrafly: folds 
hammerwife joins the table at seat #5 
matiko09: raises $1.50 to $2.50
nickreason17: calls $1.50
*** FLOP *** [Js Td Qc]
HomerrrJay joins the table at seat #7 
matiko09: checks 
nickreason17: bets $2.50
matiko09: folds 
Uncalled bet ($2.50) returned to nickreason17
nickreason17 collected $4.78 from pot
*** SUMMARY ***
Total pot $5 | Rake $0.22 
Board [Js Td Qc]
Seat 2: lysandrafly (button) folded before Flop (didn't bet)
Seat 3: matiko09 (small blind) folded on the Flop
Seat 6: nickreason17 (big blind) collected ($4.78)
Seat 9: with-w folded before Flop (didn't bet)





PokerStars Hand #149393767202:  Hold'em No Limit ($0.50/$1.00 USD) - 2016/02/25 17:18:41 CET [2016/02/25 11:18:41 ET]
Table 'Zeuxo II' 9-max Seat #1 is the button
Seat 1: forsmthgood ($112.29 in chips) 
Seat 2: Sweden_Pound ($138.47 in chips) 
Seat 4: sebaaastian ($112.11 in chips) 
Seat 6: Cogss ($76.50 in chips) 
Seat 7: djammusic ($48 in chips) 
Seat 8: matiko09 ($101.20 in chips) 
Seat 9: Sreshta222 ($204.30 in chips) 
Sweden_Pound: posts small blind $0.50
sebaaastian: posts big blind $1
*** HOLE CARDS ***
Dealt to matiko09 [Ac Qd]
Cogss: folds 
djammusic: folds 
matiko09: raises $2 to $3
Sreshta222 is disconnected 
Sreshta222 is connected 
Sreshta222: calls $3
forsmthgood: folds 
Sweden_Pound: folds 
sebaaastian: folds 
*** FLOP *** [Ts Qc 3c]
matiko09: bets $4.65
Sreshta222: calls $4.65
*** TURN *** [Ts Qc 3c] [Ah]
matiko09: checks 
Sreshta222: checks 
*** RIVER *** [Ts Qc 3c Ah] [7d]
matiko09: bets $9
Sreshta222: folds 
Uncalled bet ($9) returned to matiko09
matiko09 collected $16.04 from pot
matiko09: doesn't show hand 
*** SUMMARY ***
Total pot $16.80 | Rake $0.76 
Board [Ts Qc 3c Ah 7d]
Seat 1: forsmthgood (button) folded before Flop (didn't bet)
Seat 2: Sweden_Pound (small blind) folded before Flop
Seat 4: sebaaastian (big blind) folded before Flop
Seat 6: Cogss folded before Flop (didn't bet)
Seat 7: djammusic folded before Flop (didn't bet)
Seat 8: matiko09 collected ($16.04)
Seat 9: Sreshta222 folded on the River





PokerStars Hand #149393775325:  Hold'em No Limit ($0.50/$1.00 USD) - 2016/02/25 17:18:52 CET [2016/02/25 11:18:52 ET]
Table 'Morosovia II' 9-max Seat #3 is the button
Seat 1: apfush ($172.26 in chips) 
Seat 2: Effort92 ($100 in chips) 
Seat 3: sebaaastian ($216.36 in chips) 
Seat 4: Venomous100% ($154.52 in chips) 
Seat 5: pimpoza ($92.97 in chips) 
Seat 7: matiko09 ($166.55 in chips) 
Seat 8: simoniustin ($108.16 in chips) 
Seat 9: Ouga Buga ($135.57 in chips) 
Venomous100%: posts small blind $0.50
pimpoza: posts big blind $1
*** HOLE CARDS ***
Dealt to matiko09 [Qc 4s]
matiko09: folds 
simoniustin: folds 
Ouga Buga: raises $1.50 to $2.50
apfush: calls $2.50
Effort92: folds 
sebaaastian: folds 
Venomous100%: folds 
pimpoza: raises $6.50 to $9
Ouga Buga: calls $6.50
apfush: calls $6.50
*** FLOP *** [7s 6d 9h]
pimpoza: bets $16
Ouga Buga: folds 
apfush: raises $147.26 to $163.26 and is all-in
pimpoza: folds 
Uncalled bet ($147.26) returned to apfush
apfush collected $56.82 from pot
apfush: doesn't show hand 
*** SUMMARY ***
Total pot $59.50 | Rake $2.68 
Board [7s 6d 9h]
Seat 1: apfush collected ($56.82)
Seat 2: Effort92 folded before Flop (didn't bet)
Seat 3: sebaaastian (button) folded before Flop (didn't bet)
Seat 4: Venomous100% (small blind) folded before Flop
Seat 5: pimpoza (big blind) folded on the Flop
Seat 7: matiko09 folded before Flop (didn't bet)
Seat 8: simoniustin folded before Flop (didn't bet)
Seat 9: Ouga Buga folded on the Flop





PokerStars Hand #149393781776:  Hold'em No Limit ($0.50/$1.00 USD) - 2016/02/25 17:19:00 CET [2016/02/25 11:19:00 ET]
Table 'Hercules IV' 9-max Seat #3 is the button
Seat 1: matiko09 ($100 in chips) 
Seat 3: HomerrrJay ($106.50 in chips) 
Seat 6: kuanhung0903 ($60.39 in chips) 
Seat 7: Ouga Buga ($107.17 in chips) 
Seat 8: brokat77 ($132.01 in chips) 
Seat 9: djammusic ($39.50 in chips) 
kuanhung0903: posts small blind $0.50
Ouga Buga: posts big blind $1
*** HOLE CARDS ***
Dealt to matiko09 [8c 8d]
brokat77: folds 
djammusic: folds 
matiko09: raises $1.50 to $2.50
HomerrrJay: folds 
kuanhung0903: folds 
Ouga Buga: folds 
Uncalled bet ($1.50) returned to matiko09
matiko09 collected $2.50 from pot
matiko09: doesn't show hand 
*** SUMMARY ***
Total pot $2.50 | Rake $0 
Seat 1: matiko09 collected ($2.50)
Seat 3: HomerrrJay (button) folded before Flop (didn't bet)
Seat 6: kuanhung0903 (small blind) folded before Flop
Seat 7: Ouga Buga (big blind) folded before Flop
Seat 8: brokat77 folded before Flop (didn't bet)
Seat 9: djammusic folded before Flop (didn't bet)





PokerStars Hand #149393785150:  Hold'em No Limit ($0.50/$1.00 USD) - 2016/02/25 17:19:04 CET [2016/02/25 11:19:04 ET]
Table 'Nerthus II' 9-max Seat #4 is the button
Seat 1: DUkalisUA ($100 in chips) 
Seat 2: matiko09 ($216.79 in chips) 
Seat 3: simoniustin ($100 in chips) 
Seat 4: Ilov3NBA ($101.25 in chips) 
Seat 6: mycka86 ($132.58 in chips) 
Seat 7: Venomous100% ($121.61 in chips) 
mycka86: posts small blind $0.50
Venomous100%: posts big blind $1
hammerwife: sits out 
*** HOLE CARDS ***
Dealt to matiko09 [8h 7s]
DUkalisUA: raises $2 to $3
matiko09: folds 
simoniustin: folds 
Ilov3NBA: folds 
mycka86: folds 
Venomous100%: calls $2
*** FLOP *** [Jc Tc 2d]
Venomous100%: checks 
DUkalisUA: bets $4
Venomous100%: folds 
Uncalled bet ($4) returned to DUkalisUA
DUkalisUA collected $6.21 from pot
DUkalisUA: doesn't show hand 
*** SUMMARY ***
Total pot $6.50 | Rake $0.29 
Board [Jc Tc 2d]
Seat 1: DUkalisUA collected ($6.21)
Seat 2: matiko09 folded before Flop (didn't bet)
Seat 3: simoniustin folded before Flop (didn't bet)
Seat 4: Ilov3NBA (button) folded before Flop (didn't bet)
Seat 6: mycka86 (small blind) folded before Flop
Seat 7: Venomous100% (big blind) folded on the Flop





PokerStars Hand #149393787845:  Hold'em No Limit ($0.50/$1.00 USD) - 2016/02/25 17:19:07 CET [2016/02/25 11:19:07 ET]
Table 'Ebella II' 9-max Seat #3 is the button
Seat 1: nickreason17 ($105.46 in chips) 
Seat 3: fanmtZ ($46.03 in chips) 
Seat 5: matiko09 ($100 in chips) 
Seat 6: gabi_igna ($100 in chips) 
Seat 8: ZMPOUTSAM140 ($73.83 in chips) 
Seat 9: simoniustin ($114.66 in chips) 
matiko09: posts small blind $0.50
gabi_igna: posts big blind $1
*** HOLE CARDS ***
Dealt to matiko09 [3c Tc]
ZMPOUTSAM140: folds 
simoniustin: folds 
nickreason17: folds 
fanmtZ: folds 
matiko09: folds 
Uncalled bet ($0.50) returned to gabi_igna
gabi_igna collected $1 from pot
gabi_igna: doesn't show hand 
*** SUMMARY ***
Total pot $1 | Rake $0 
Seat 1: nickreason17 folded before Flop (didn't bet)
Seat 3: fanmtZ (button) folded before Flop (didn't bet)
Seat 5: matiko09 (small blind) folded before Flop
Seat 6: gabi_igna (big blind) collected ($1)
Seat 8: ZMPOUTSAM140 folded before Flop (didn't bet)
Seat 9: simoniustin folded before Flop (didn't bet)





PokerStars Hand #149393791569:  Hold'em No Limit ($0.50/$1.00 USD) - 2016/02/25 17:19:12 CET [2016/02/25 11:19:12 ET]
Table 'Sabine' 9-max Seat #2 is the button
Seat 2: apfush ($132.20 in chips) 
Seat 3: Ouga Buga ($140.34 in chips) 
Seat 5: Venomous100% ($112.04 in chips) 
Seat 6: ffac ($100 in chips) 
Seat 7: clayshmert ($40.78 in chips) 
Seat 8: matiko09 ($124.97 in chips) 
Seat 9: djammusic ($65.39 in chips) 
Ouga Buga: posts small blind $0.50
Venomous100%: posts big blind $1
Aalleekks: sits out 
*** HOLE CARDS ***
Dealt to matiko09 [Jh Jd]
ffac: folds 
clayshmert: folds 
matiko09: raises $2 to $3
djammusic: folds 
apfush: folds 
Ouga Buga: folds 
hammerwife leaves the table
Venomous100%: folds 
Uncalled bet ($2) returned to matiko09
matiko09 collected $2.50 from pot
matiko09: doesn't show hand 
*** SUMMARY ***
Total pot $2.50 | Rake $0 
Seat 2: apfush (button) folded before Flop (didn't bet)
Seat 3: Ouga Buga (small blind) folded before Flop
Seat 5: Venomous100% (big blind) folded before Flop
Seat 6: ffac folded before Flop (didn't bet)
Seat 7: clayshmert folded before Flop (didn't bet)
Seat 8: matiko09 collected ($2.50)
Seat 9: djammusic folded before Flop (didn't bet)





PokerStars Hand #149393792672:  Hold'em No Limit ($0.50/$1.00 USD) - 2016/02/25 17:19:13 CET [2016/02/25 11:19:13 ET]
Table 'Zerbinetta II' 9-max Seat #3 is the button
Seat 2: lysandrafly ($100 in chips) 
Seat 3: matiko09 ($100 in chips) 
Seat 6: nickreason17 ($102.28 in chips) 
Seat 7: HomerrrJay ($100 in chips) 
Seat 9: with-w ($40 in chips) 
sebaaastian will be allowed to play after the button
nickreason17: posts small blind $0.50
HomerrrJay: posts big blind $1
*** HOLE CARDS ***
Dealt to matiko09 [Qd 6c]
with-w: folds 
lysandrafly: folds 
matiko09: folds 
nickreason17: folds 
Uncalled bet ($0.50) returned to HomerrrJay
Sreshta222 joins the table at seat #8 
HomerrrJay collected $1 from pot
HomerrrJay: doesn't show hand 
*** SUMMARY ***
Total pot $1 | Rake $0 
Seat 2: lysandrafly folded before Flop (didn't bet)
Seat 3: matiko09 (button) folded before Flop (didn't bet)
Seat 6: nickreason17 (small blind) folded before Flop
Seat 7: HomerrrJay (big blind) collected ($1)
Seat 9: with-w folded before Flop (didn't bet)





PokerStars Hand #149393798852:  Hold'em No Limit ($0.50/$1.00 USD) - 2016/02/25 17:19:21 CET [2016/02/25 11:19:21 ET]
Table 'Ebella II' 9-max Seat #5 is the button
Seat 1: nickreason17 ($105.46 in chips) 
Seat 3: fanmtZ ($46.03 in chips) 
Seat 5: matiko09 ($100 in chips) 
Seat 6: gabi_igna ($100.50 in chips) 
Seat 8: ZMPOUTSAM140 ($73.83 in chips) 
Seat 9: simoniustin ($114.66 in chips) 
gabi_igna: posts small blind $0.50
ZMPOUTSAM140: posts big blind $1
*** HOLE CARDS ***
Dealt to matiko09 [5s Kc]
simoniustin: folds 
nickreason17: folds 
fanmtZ: raises $1.38 to $2.38
matiko09: folds 
gabi_igna: folds 
ZMPOUTSAM140: calls $1.38
*** FLOP *** [As 8d Th]
ZMPOUTSAM140: checks 
fanmtZ: bets $3.50
ZMPOUTSAM140: calls $3.50
*** TURN *** [As 8d Th] [3d]
ZMPOUTSAM140: checks 
fanmtZ: bets $5
ZMPOUTSAM140: raises $62.95 to $67.95 and is all-in
fanmtZ: folds 
Uncalled bet ($62.95) returned to ZMPOUTSAM140
ZMPOUTSAM140 collected $21.26 from pot
*** SUMMARY ***
Total pot $22.26 | Rake $1 
Board [As 8d Th 3d]
Seat 1: nickreason17 folded before Flop (didn't bet)
Seat 3: fanmtZ folded on the Turn
Seat 5: matiko09 (button) folded before Flop (didn't bet)
Seat 6: gabi_igna (small blind) folded before Flop
Seat 8: ZMPOUTSAM140 (big blind) collected ($21.26)
Seat 9: simoniustin folded before Flop (didn't bet)





PokerStars Hand #149393801519:  Hold'em No Limit ($0.50/$1.00 USD) - 2016/02/25 17:19:25 CET [2016/02/25 11:19:25 ET]
Table 'Zerbinetta II' 9-max Seat #6 is the button
Seat 2: lysandrafly ($100 in chips) 
Seat 3: matiko09 ($100 in chips) 
Seat 6: nickreason17 ($101.78 in chips) 
Seat 7: HomerrrJay ($100.50 in chips) 
Seat 9: with-w ($40 in chips) 
HomerrrJay: posts small blind $0.50
with-w: posts big blind $1
sebaaastian: sits out 
*** HOLE CARDS ***
Dealt to matiko09 [2s Th]
Sreshta222 leaves the table
lysandrafly: folds 
matiko09: folds 
gabi_igna joins the table at seat #8 
nickreason17: raises $1.04 to $2.04
HomerrrJay: folds 
with-w: calls $1.04
*** FLOP *** [9s 3s 8d]
with-w: checks 
nickreason17: bets $2.29
with-w: folds 
Uncalled bet ($2.29) returned to nickreason17
nickreason17 collected $4.37 from pot
*** SUMMARY ***
Total pot $4.58 | Rake $0.21 
Board [9s 3s 8d]
Seat 2: lysandrafly folded before Flop (didn't bet)
Seat 3: matiko09 folded before Flop (didn't bet)
Seat 6: nickreason17 (button) collected ($4.37)
Seat 7: HomerrrJay (small blind) folded before Flop
Seat 9: with-w (big blind) folded on the Flop





PokerStars Hand #149393805517:  Hold'em No Limit ($0.50/$1.00 USD) - 2016/02/25 17:19:29 CET [2016/02/25 11:19:29 ET]
Table 'Hercules IV' 9-max Seat #6 is the button
Seat 1: matiko09 ($101.50 in chips) 
Seat 3: HomerrrJay ($106.50 in chips) 
Seat 6: kuanhung0903 ($59.89 in chips) 
Seat 7: Ouga Buga ($106.17 in chips) 
Seat 8: brokat77 ($132.01 in chips) 
Seat 9: djammusic ($39.50 in chips) 
Ouga Buga: posts small blind $0.50
brokat77: posts big blind $1
*** HOLE CARDS ***
Dealt to matiko09 [8s Ac]
djammusic: raises $1.12 to $2.12
matiko09: folds 
HomerrrJay: folds 
kuanhung0903: folds 
Ouga Buga: folds 
brokat77: calls $1.12
*** FLOP *** [Jh 3s As]
brokat77: bets $1
djammusic: raises $3 to $4
brokat77: folds 
Uncalled bet ($3) returned to djammusic
djammusic collected $6.44 from pot
djammusic: doesn't show hand 
*** SUMMARY ***
Total pot $6.74 | Rake $0.30 
Board [Jh 3s As]
Seat 1: matiko09 folded before Flop (didn't bet)
Seat 3: HomerrrJay folded before Flop (didn't bet)
Seat 6: kuanhung0903 (button) folded before Flop (didn't bet)
Seat 7: Ouga Buga (small blind) folded before Flop
Seat 8: brokat77 (big blind) folded on the Flop
Seat 9: djammusic collected ($6.44)





PokerStars Hand #149393804938:  Hold'em No Limit ($0.50/$1.00 USD) - 2016/02/25 17:19:29 CET [2016/02/25 11:19:29 ET]
Table 'Mayall II' 9-max Seat #6 is the button
Seat 1: matiko09 ($112.11 in chips) 
Seat 3: simoniustin ($100 in chips) 
Seat 4: Ouga Buga ($109.62 in chips) 
Seat 6: apfush ($100.89 in chips) 
Seat 7: r.pol218 ($57.70 in chips) 
Seat 8: kuanhung0903 ($85.93 in chips) 
r.pol218: posts small blind $0.50
kuanhung0903: posts big blind $1
HomerrrJay: sits out 
*** HOLE CARDS ***
Dealt to matiko09 [5c Kd]
matiko09: folds 
simoniustin: folds 
Ouga Buga: folds 
apfush: raises $1.20 to $2.20
r.pol218: calls $1.70
kuanhung0903: folds 
*** FLOP *** [2d Qs Tc]
r.pol218: checks 
apfush: bets $3
r.pol218: folds 
Uncalled bet ($3) returned to apfush
apfush collected $5.16 from pot
apfush: doesn't show hand 
*** SUMMARY ***
Total pot $5.40 | Rake $0.24 
Board [2d Qs Tc]
Seat 1: matiko09 folded before Flop (didn't bet)
Seat 3: simoniustin folded before Flop (didn't bet)
Seat 4: Ouga Buga folded before Flop (didn't bet)
Seat 6: apfush (button) collected ($5.16)
Seat 7: r.pol218 (small blind) folded on the Flop
Seat 8: kuanhung0903 (big blind) folded before Flop





PokerStars Hand #149393809678:  Hold'em No Limit ($0.50/$1.00 USD) - 2016/02/25 17:19:34 CET [2016/02/25 11:19:34 ET]
Table 'Badenia II' 9-max Seat #4 is the button
Seat 1: matiko09 ($102.73 in chips) 
Seat 2: Stibitzkie ($45.06 in chips) 
Seat 3: sebaaastian ($140.29 in chips) 
Seat 4: hammerwife ($100 in chips) 
Seat 5: djammusic ($126.95 in chips) 
Seat 7: forsmthgood ($108.26 in chips) 
Seat 9: waisanen ($247.47 in chips) 
djammusic: posts small blind $0.50
forsmthgood: posts big blind $1
*** HOLE CARDS ***
Dealt to matiko09 [Td 4s]
waisanen: folds 
matiko09: folds 
Stibitzkie: folds 
sebaaastian: raises $1.50 to $2.50
hammerwife: folds 
djammusic: folds 
forsmthgood: raises $6 to $8.50
sebaaastian: calls $6
*** FLOP *** [Jc 3s Ah]
forsmthgood: checks 
sebaaastian: checks 
*** TURN *** [Jc 3s Ah] [Th]
forsmthgood: checks 
sebaaastian: bets $13
forsmthgood: folds 
Uncalled bet ($13) returned to sebaaastian
sebaaastian collected $16.71 from pot
sebaaastian: doesn't show hand 
*** SUMMARY ***
Total pot $17.50 | Rake $0.79 
Board [Jc 3s Ah Th]
Seat 1: matiko09 folded before Flop (didn't bet)
Seat 2: Stibitzkie folded before Flop (didn't bet)
Seat 3: sebaaastian collected ($16.71)
Seat 4: hammerwife (button) folded before Flop (didn't bet)
Seat 5: djammusic (small blind) folded before Flop
Seat 7: forsmthgood (big blind) folded on the Turn
Seat 9: waisanen folded before Flop (didn't bet)





PokerStars Hand #149393813636:  Hold'em No Limit ($0.50/$1.00 USD) - 2016/02/25 17:19:39 CET [2016/02/25 11:19:39 ET]
Table 'Sabine' 9-max Seat #3 is the button
Seat 2: apfush ($132.20 in chips) 
Seat 3: Ouga Buga ($139.84 in chips) 
Seat 5: Venomous100% ($111.04 in chips) 
Seat 6: ffac ($100 in chips) 
Seat 7: clayshmert ($40.78 in chips) 
Seat 8: matiko09 ($126.47 in chips) 
Seat 9: djammusic ($65.39 in chips) 
Venomous100%: posts small blind $0.50
ffac: posts big blind $1
Aalleekks: sits out 
*** HOLE CARDS ***
Dealt to matiko09 [6c 9h]
clayshmert: folds 
matiko09: folds 
djammusic: raises $1.50 to $2.50
apfush: folds 
Ouga Buga: calls $2.50
simoniustin joins the table at seat #4 
Venomous100%: calls $2
ffac: folds 
*** FLOP *** [Td 6s 5h]
Venomous100%: checks 
djammusic: bets $5.36
Ouga Buga: calls $5.36
Venomous100%: folds 
*** TURN *** [Td 6s 5h] [Tc]
djammusic: checks 
Ouga Buga: bets $6.60
djammusic: folds 
Uncalled bet ($6.60) returned to Ouga Buga
Ouga Buga collected $18.36 from pot
Ouga Buga: doesn't show hand 
*** SUMMARY ***
Total pot $19.22 | Rake $0.86 
Board [Td 6s 5h Tc]
Seat 2: apfush folded before Flop (didn't bet)
Seat 3: Ouga Buga (button) collected ($18.36)
Seat 5: Venomous100% (small blind) folded on the Flop
Seat 6: ffac (big blind) folded before Flop
Seat 7: clayshmert folded before Flop (didn't bet)
Seat 8: matiko09 folded before Flop (didn't bet)
Seat 9: djammusic folded on the Turn





PokerStars Hand #149393813369:  Hold'em No Limit ($0.50/$1.00 USD) - 2016/02/25 17:19:39 CET [2016/02/25 11:19:39 ET]
Table 'Isa' 9-max Seat #3 is the button
Seat 1: matiko09 ($125.87 in chips) 
Seat 2: mycka86 ($100.40 in chips) 
Seat 3: sebaaastian ($140.25 in chips) 
Seat 4: hammerwife ($103.41 in chips) 
Seat 7: bilukm ($100 in chips) 
Seat 8: Venomous100% ($105.03 in chips) 
Seat 9: HomerrrJay ($173.11 in chips) 
hammerwife: posts small blind $0.50
bilukm: posts big blind $1
*** HOLE CARDS ***
Dealt to matiko09 [2h Tc]
Venomous100%: raises $2 to $3
HomerrrJay: folds 
matiko09: folds 
mycka86: folds 
sebaaastian: folds 
hammerwife: folds 
bilukm: folds 
Uncalled bet ($2) returned to Venomous100%
Venomous100% collected $2.50 from pot
Venomous100%: doesn't show hand 
*** SUMMARY ***
Total pot $2.50 | Rake $0 
Seat 1: matiko09 folded before Flop (didn't bet)
Seat 2: mycka86 folded before Flop (didn't bet)
Seat 3: sebaaastian (button) folded before Flop (didn't bet)
Seat 4: hammerwife (small blind) folded before Flop
Seat 7: bilukm (big blind) folded before Flop
Seat 8: Venomous100% collected ($2.50)
Seat 9: HomerrrJay folded before Flop (didn't bet)





PokerStars Hand #149393824250:  Hold'em No Limit ($0.50/$1.00 USD) - 2016/02/25 17:19:53 CET [2016/02/25 11:19:53 ET]
Table 'Zerbinetta II' 9-max Seat #7 is the button
Seat 2: lysandrafly ($100 in chips) 
Seat 3: matiko09 ($100 in chips) 
Seat 6: nickreason17 ($104.11 in chips) 
Seat 7: HomerrrJay ($100 in chips) 
Seat 9: with-w ($37.96 in chips) 
gabi_igna will be allowed to play after the button
with-w: posts small blind $0.50
lysandrafly: posts big blind $1
sebaaastian: sits out 
hammerwife: sits out 
*** HOLE CARDS ***
Dealt to matiko09 [Jh Th]
matiko09: raises $2 to $3
nickreason17: folds 
HomerrrJay: folds 
with-w: raises $3 to $6
lysandrafly: folds 
matiko09: calls $3
*** FLOP *** [7d Qs Jd]
with-w: checks 
matiko09: checks 
*** TURN *** [7d Qs Jd] [2s]
with-w: bets $4
matiko09: calls $4
*** RIVER *** [7d Qs Jd 2s] [3d]
with-w: checks 
matiko09: checks 
*** SHOW DOWN ***
with-w: shows [Qd Ad] (a flush, Ace high)
matiko09: mucks hand 
with-w collected $20.06 from pot
*** SUMMARY ***
Total pot $21 | Rake $0.94 
Board [7d Qs Jd 2s 3d]
Seat 2: lysandrafly (big blind) folded before Flop
Seat 3: matiko09 mucked [Jh Th]
Seat 6: nickreason17 folded before Flop (didn't bet)
Seat 7: HomerrrJay (button) folded before Flop (didn't bet)
Seat 9: with-w (small blind) showed [Qd Ad] and won ($20.06) with a flush, Ace high





PokerStars Hand #149393829100:  Hold'em No Limit ($0.25/$0.50 USD) - 2016/02/25 17:19:59 CET [2016/02/25 11:19:59 ET]
Table 'Lohja II' 9-max Seat #8 is the button
Seat 1: MoonJimmy ($139.48 in chips) 
Seat 2: Apparat888 ($42.75 in chips) 
Seat 3: guvalc1952 ($183.30 in chips) 
Seat 4: payback11 ($50 in chips) 
Seat 5: 111STAVR111 ($50.81 in chips) 
Seat 7: matiko09 ($124.13 in chips) 
Seat 8: jamba83 ($79.39 in chips) 
Seat 9: Al3xAnd3r22 ($102.61 in chips) 
Al3xAnd3r22: posts small blind $0.25
MoonJimmy: posts big blind $0.50
MoonJimmy: posts the ante $0.10
Apparat888: posts the ante $0.10
guvalc1952: posts the ante $0.10
payback11: posts the ante $0.10
111STAVR111: posts the ante $0.10
matiko09: posts the ante $0.10
jamba83: posts the ante $0.10
Al3xAnd3r22: posts the ante $0.10
*** HOLE CARDS ***
Dealt to matiko09 [Jd 4h]
Apparat888: folds 
guvalc1952: calls $0.50
payback11: folds 
111STAVR111: folds 
matiko09: folds 
jamba83: raises $2 to $2.50
Al3xAnd3r22: calls $2.25
MoonJimmy: folds 
guvalc1952: calls $2
*** FLOP *** [9d 7s 9h]
Al3xAnd3r22: checks 
guvalc1952: checks 
jamba83: bets $6
Al3xAnd3r22: folds 
guvalc1952: calls $6
*** TURN *** [9d 7s 9h] [2c]
guvalc1952: checks 
jamba83: checks 
*** RIVER *** [9d 7s 9h 2c] [2h]
guvalc1952: checks 
jamba83: checks 
*** SHOW DOWN ***
guvalc1952: shows [9s 5s] (a full house, Nines full of Deuces)
jamba83: mucks hand 
guvalc1952 collected $19.86 from pot
*** SUMMARY ***
Total pot $20.80 | Rake $0.94 
Board [9d 7s 9h 2c 2h]
Seat 1: MoonJimmy (big blind) folded before Flop
Seat 2: Apparat888 folded before Flop (didn't bet)
Seat 3: guvalc1952 showed [9s 5s] and won ($19.86) with a full house, Nines full of Deuces
Seat 4: payback11 folded before Flop (didn't bet)
Seat 5: 111STAVR111 folded before Flop (didn't bet)
Seat 7: matiko09 folded before Flop (didn't bet)
Seat 8: jamba83 (button) mucked [Kh Ac]
Seat 9: Al3xAnd3r22 (small blind) folded on the Flop





PokerStars Hand #149393830517:  Hold'em No Limit ($0.50/$1.00 USD) - 2016/02/25 17:20:01 CET [2016/02/25 11:20:01 ET]
Table 'Isa' 9-max Seat #4 is the button
Seat 1: matiko09 ($125.87 in chips) 
Seat 2: mycka86 ($100.40 in chips) 
Seat 3: sebaaastian ($140.25 in chips) 
Seat 4: hammerwife ($102.91 in chips) 
Seat 7: bilukm ($100 in chips) 
Seat 8: Venomous100% ($106.53 in chips) 
Seat 9: HomerrrJay ($173.11 in chips) 
bilukm: posts small blind $0.50
Venomous100%: posts big blind $1
*** HOLE CARDS ***
Dealt to matiko09 [Ks Qd]
HomerrrJay: folds 
matiko09: raises $2 to $3
mycka86: folds 
sebaaastian: folds 
hammerwife: raises $7 to $10
bilukm: folds 
Venomous100%: folds 
matiko09: folds 
Uncalled bet ($7) returned to hammerwife
hammerwife collected $7.50 from pot
hammerwife: doesn't show hand 
*** SUMMARY ***
Total pot $7.50 | Rake $0 
Seat 1: matiko09 folded before Flop
Seat 2: mycka86 folded before Flop (didn't bet)
Seat 3: sebaaastian folded before Flop (didn't bet)
Seat 4: hammerwife (button) collected ($7.50)
Seat 7: bilukm (small blind) folded before Flop
Seat 8: Venomous100% (big blind) folded before Flop
Seat 9: HomerrrJay folded before Flop (didn't bet)





PokerStars Hand #149393834217:  Hold'em No Limit ($0.50/$1.00 USD) - 2016/02/25 17:20:05 CET [2016/02/25 11:20:05 ET]
Table 'Nerthus II' 9-max Seat #6 is the button
Seat 1: DUkalisUA ($103.21 in chips) 
Seat 2: matiko09 ($216.79 in chips) 
Seat 3: simoniustin ($100 in chips) 
Seat 4: Ilov3NBA ($101.25 in chips) 
Seat 6: mycka86 ($132.08 in chips) 
Seat 7: Venomous100% ($118.61 in chips) 
Seat 8: Kelvin sai ($50 in chips) 
Venomous100%: posts small blind $0.50
Kelvin sai: posts big blind $1
hammerwife: sits out 
*** HOLE CARDS ***
Dealt to matiko09 [Ts 3c]
DUkalisUA: folds 
matiko09: folds 
simoniustin: folds 
Ilov3NBA: folds 
mycka86: folds 
Venomous100%: folds 
Uncalled bet ($0.50) returned to Kelvin sai
Kelvin sai collected $1 from pot
Kelvin sai: doesn't show hand 
*** SUMMARY ***
Total pot $1 | Rake $0 
Seat 1: DUkalisUA folded before Flop (didn't bet)
Seat 2: matiko09 folded before Flop (didn't bet)
Seat 3: simoniustin folded before Flop (didn't bet)
Seat 4: Ilov3NBA folded before Flop (didn't bet)
Seat 6: mycka86 (button) folded before Flop (didn't bet)
Seat 7: Venomous100% (small blind) folded before Flop
Seat 8: Kelvin sai (big blind) collected ($1)





PokerStars Hand #149393835206:  Hold'em No Limit ($0.50/$1.00 USD) - 2016/02/25 17:20:07 CET [2016/02/25 11:20:07 ET]
Table 'Hercules IV' 9-max Seat #7 is the button
Seat 1: matiko09 ($101.50 in chips) 
Seat 3: HomerrrJay ($106.50 in chips) 
Seat 6: kuanhung0903 ($59.89 in chips) 
Seat 7: Ouga Buga ($105.67 in chips) 
Seat 8: brokat77 ($128.89 in chips) 
Seat 9: djammusic ($42.82 in chips) 
brokat77: posts small blind $0.50
djammusic: posts big blind $1
*** HOLE CARDS ***
Dealt to matiko09 [Js 6d]
matiko09: folds 
HomerrrJay: raises $1.50 to $2.50
kuanhung0903: folds 
Ouga Buga: calls $2.50
brokat77: folds 
djammusic: folds 
*** FLOP *** [Qh Th Jc]
HomerrrJay: bets $3.50
Ouga Buga: calls $3.50
*** TURN *** [Qh Th Jc] [Tc]
HomerrrJay: checks 
Ouga Buga: checks 
*** RIVER *** [Qh Th Jc Tc] [Kh]
HomerrrJay: checks 
Ouga Buga: checks 
*** SHOW DOWN ***
HomerrrJay: shows [7h 7c] (two pair, Tens and Sevens)
Ouga Buga: shows [Qs Ks] (two pair, Kings and Queens)
Ouga Buga collected $12.89 from pot
*** SUMMARY ***
Total pot $13.50 | Rake $0.61 
Board [Qh Th Jc Tc Kh]
Seat 1: matiko09 folded before Flop (didn't bet)
Seat 3: HomerrrJay showed [7h 7c] and lost with two pair, Tens and Sevens
Seat 6: kuanhung0903 folded before Flop (didn't bet)
Seat 7: Ouga Buga (button) showed [Qs Ks] and won ($12.89) with two pair, Kings and Queens
Seat 8: brokat77 (small blind) folded before Flop
Seat 9: djammusic (big blind) folded before Flop





PokerStars Hand #149393838131:  Hold'em No Limit ($0.50/$1.00 USD) - 2016/02/25 17:20:10 CET [2016/02/25 11:20:10 ET]
Table 'Mayall II' 9-max Seat #7 is the button
Seat 1: matiko09 ($112.11 in chips) 
Seat 3: simoniustin ($100 in chips) 
Seat 4: Ouga Buga ($109.62 in chips) 
Seat 6: apfush ($103.85 in chips) 
Seat 7: r.pol218 ($55.50 in chips) 
Seat 8: kuanhung0903 ($84.93 in chips) 
kuanhung0903: posts small blind $0.50
matiko09: posts big blind $1
HomerrrJay: sits out 
*** HOLE CARDS ***
Dealt to matiko09 [9h 6d]
simoniustin: folds 
Ouga Buga: raises $1.50 to $2.50
apfush: folds 
r.pol218: folds 
kuanhung0903: folds 
matiko09: folds 
Uncalled bet ($1.50) returned to Ouga Buga
Ouga Buga collected $2.50 from pot
Ouga Buga: doesn't show hand 
*** SUMMARY ***
Total pot $2.50 | Rake $0 
Seat 1: matiko09 (big blind) folded before Flop
Seat 3: simoniustin folded before Flop (didn't bet)
Seat 4: Ouga Buga collected ($2.50)
Seat 6: apfush folded before Flop (didn't bet)
Seat 7: r.pol218 (button) folded before Flop (didn't bet)
Seat 8: kuanhung0903 (small blind) folded before Flop





PokerStars Hand #149393841438:  Hold'em No Limit ($0.50/$1.00 USD) - 2016/02/25 17:20:14 CET [2016/02/25 11:20:14 ET]
Table 'Syrma II' 9-max Seat #3 is the button
Seat 1: lysandrafly ($107.32 in chips) 
Seat 3: simoniustin ($123.92 in chips) 
Seat 4: Aalleekks ($100 in chips) 
Seat 5: nickreason17 ($115.29 in chips) 
Seat 6: ffac ($119.65 in chips) 
Seat 7: matiko09 ($100 in chips) 
Seat 9: gulseren848 ($64.68 in chips) 
Aalleekks: posts small blind $0.50
nickreason17: posts big blind $1
hammerwife: sits out 
*** HOLE CARDS ***
Dealt to matiko09 [Js 7h]
ffac: folds 
matiko09: folds 
gulseren848: folds 
lysandrafly: raises $1.80 to $2.80
simoniustin: folds 
Aalleekks: folds 
nickreason17: folds 
Uncalled bet ($1.80) returned to lysandrafly
lysandrafly collected $2.50 from pot
lysandrafly: doesn't show hand 
*** SUMMARY ***
Total pot $2.50 | Rake $0 
Seat 1: lysandrafly collected ($2.50)
Seat 3: simoniustin (button) folded before Flop (didn't bet)
Seat 4: Aalleekks (small blind) folded before Flop
Seat 5: nickreason17 (big blind) folded before Flop
Seat 6: ffac folded before Flop (didn't bet)
Seat 7: matiko09 folded before Flop (didn't bet)
Seat 9: gulseren848 folded before Flop (didn't bet)





PokerStars Hand #149393841023:  Hold'em No Limit ($0.50/$1.00 USD) - 2016/02/25 17:20:14 CET [2016/02/25 11:20:14 ET]
Table 'Zeuxo II' 9-max Seat #4 is the button
Seat 1: forsmthgood ($112.29 in chips) 
Seat 4: sebaaastian ($111.11 in chips) 
Seat 6: Cogss ($100 in chips) 
Seat 7: djammusic ($48 in chips) 
Seat 8: matiko09 ($109.59 in chips) 
Seat 9: Sreshta222 ($196.65 in chips) 
Cogss: posts small blind $0.50
djammusic: posts big blind $1
*** HOLE CARDS ***
Dealt to matiko09 [2d 6h]
matiko09: folds 
Sreshta222: folds 
forsmthgood: folds 
sebaaastian: raises $1.50 to $2.50
Cogss: folds 
djammusic: raises $4.50 to $7
sebaaastian: folds 
Uncalled bet ($4.50) returned to djammusic
djammusic collected $5.50 from pot
djammusic: doesn't show hand 
*** SUMMARY ***
Total pot $5.50 | Rake $0 
Seat 1: forsmthgood folded before Flop (didn't bet)
Seat 4: sebaaastian (button) folded before Flop
Seat 6: Cogss (small blind) folded before Flop
Seat 7: djammusic (big blind) collected ($5.50)
Seat 8: matiko09 folded before Flop (didn't bet)
Seat 9: Sreshta222 folded before Flop (didn't bet)





PokerStars Hand #149393852727:  Hold'em No Limit ($0.50/$1.00 USD) - 2016/02/25 17:20:29 CET [2016/02/25 11:20:29 ET]
Table 'Ebella II' 9-max Seat #6 is the button
Seat 1: nickreason17 ($105.46 in chips) 
Seat 3: fanmtZ ($40 in chips) 
Seat 5: matiko09 ($100 in chips) 
Seat 6: gabi_igna ($100 in chips) 
Seat 8: ZMPOUTSAM140 ($84.21 in chips) 
Seat 9: simoniustin ($114.66 in chips) 
$-Twackle-$ will be allowed to play after the button
ZMPOUTSAM140: posts small blind $0.50
simoniustin: posts big blind $1
*** HOLE CARDS ***
Dealt to matiko09 [4h Kd]
nickreason17: folds 
fanmtZ: folds 
matiko09: folds 
gabi_igna: raises $1.50 to $2.50
ZMPOUTSAM140: calls $2
simoniustin: folds 
*** FLOP *** [7c 3c 8h]
ZMPOUTSAM140: checks 
gabi_igna: checks 
*** TURN *** [7c 3c 8h] [Ad]
ZMPOUTSAM140: checks 
gabi_igna: checks 
*** RIVER *** [7c 3c 8h Ad] [8s]
ZMPOUTSAM140: bets $2
gabi_igna: calls $2
*** SHOW DOWN ***
ZMPOUTSAM140: shows [As 5s] (two pair, Aces and Eights)
gabi_igna: shows [Ah 9h] (two pair, Aces and Eights - Nine kicker)
gabi_igna collected $9.55 from pot
*** SUMMARY ***
Total pot $10 | Rake $0.45 
Board [7c 3c 8h Ad 8s]
Seat 1: nickreason17 folded before Flop (didn't bet)
Seat 3: fanmtZ folded before Flop (didn't bet)
Seat 5: matiko09 folded before Flop (didn't bet)
Seat 6: gabi_igna (button) showed [Ah 9h] and won ($9.55) with two pair, Aces and Eights
Seat 8: ZMPOUTSAM140 (small blind) showed [As 5s] and lost with two pair, Aces and Eights
Seat 9: simoniustin (big blind) folded before Flop





PokerStars Hand #149393856059:  Hold'em No Limit ($0.50/$1.00 USD) - 2016/02/25 17:20:33 CET [2016/02/25 11:20:33 ET]
Table 'Nerthus II' 9-max Seat #7 is the button
Seat 1: DUkalisUA ($103.21 in chips) 
Seat 2: matiko09 ($216.79 in chips) 
Seat 3: simoniustin ($100 in chips) 
Seat 4: Ilov3NBA ($101.25 in chips) 
Seat 6: mycka86 ($132.08 in chips) 
Seat 7: Venomous100% ($118.11 in chips) 
Seat 8: Kelvin sai ($50.50 in chips) 
Seat 9: hammerwife ($103.50 in chips) 
Kelvin sai: posts small blind $0.50
hammerwife: posts big blind $1
*** HOLE CARDS ***
Dealt to matiko09 [6d Ac]
DUkalisUA: folds 
matiko09: folds 
simoniustin: folds 
Ilov3NBA: folds 
mycka86: folds 
Venomous100%: raises $1 to $2
Kelvin sai: calls $1.50
hammerwife: folds 
*** FLOP *** [Ah Th 5h]
Kelvin sai: bets $4.78
Venomous100%: folds 
Uncalled bet ($4.78) returned to Kelvin sai
Kelvin sai collected $4.78 from pot
Kelvin sai: doesn't show hand 
*** SUMMARY ***
Total pot $5 | Rake $0.22 
Board [Ah Th 5h]
Seat 1: DUkalisUA folded before Flop (didn't bet)
Seat 2: matiko09 folded before Flop (didn't bet)
Seat 3: simoniustin folded before Flop (didn't bet)
Seat 4: Ilov3NBA folded before Flop (didn't bet)
Seat 6: mycka86 folded before Flop (didn't bet)
Seat 7: Venomous100% (button) folded on the Flop
Seat 8: Kelvin sai (small blind) collected ($4.78)
Seat 9: hammerwife (big blind) folded before Flop





PokerStars Hand #149393861959:  Hold'em No Limit ($0.50/$1.00 USD) - 2016/02/25 17:20:40 CET [2016/02/25 11:20:40 ET]
Table 'Mayall II' 9-max Seat #8 is the button
Seat 1: matiko09 ($111.11 in chips) 
Seat 3: simoniustin ($100 in chips) 
Seat 4: Ouga Buga ($111.12 in chips) 
Seat 6: apfush ($103.85 in chips) 
Seat 7: r.pol218 ($55.50 in chips) 
Seat 8: kuanhung0903 ($84.43 in chips) 
matiko09: posts small blind $0.50
simoniustin: posts big blind $1
HomerrrJay: sits out 
*** HOLE CARDS ***
Dealt to matiko09 [Qd 7d]
Ouga Buga: folds 
apfush: folds 
r.pol218: folds 
kuanhung0903: raises $2 to $3
matiko09: folds 
simoniustin: folds 
Uncalled bet ($2) returned to kuanhung0903
kuanhung0903 collected $2.50 from pot
kuanhung0903: doesn't show hand 
*** SUMMARY ***
Total pot $2.50 | Rake $0 
Seat 1: matiko09 (small blind) folded before Flop
Seat 3: simoniustin (big blind) folded before Flop
Seat 4: Ouga Buga folded before Flop (didn't bet)
Seat 6: apfush folded before Flop (didn't bet)
Seat 7: r.pol218 folded before Flop (didn't bet)
Seat 8: kuanhung0903 (button) collected ($2.50)





PokerStars Hand #149393867262:  Hold'em No Limit ($0.50/$1.00 USD) - 2016/02/25 17:20:47 CET [2016/02/25 11:20:47 ET]
Table 'Isa' 9-max Seat #7 is the button
Seat 1: matiko09 ($122.87 in chips) 
Seat 2: mycka86 ($100.40 in chips) 
Seat 3: sebaaastian ($140.25 in chips) 
Seat 4: hammerwife ($107.41 in chips) 
Seat 7: bilukm ($100 in chips) 
Seat 8: Venomous100% ($105.53 in chips) 
Seat 9: HomerrrJay ($173.11 in chips) 
Venomous100%: posts small blind $0.50
HomerrrJay: posts big blind $1
*** HOLE CARDS ***
Dealt to matiko09 [9c 9h]
matiko09: raises $2 to $3
mycka86: folds 
sebaaastian: folds 
hammerwife: folds 
bilukm: folds 
Venomous100%: folds 
HomerrrJay: calls $2
*** FLOP *** [2s 9d Ad]
HomerrrJay: checks 
matiko09: bets $4.04
HomerrrJay: folds 
Uncalled bet ($4.04) returned to matiko09
matiko09 collected $6.21 from pot
matiko09: doesn't show hand 
*** SUMMARY ***
Total pot $6.50 | Rake $0.29 
Board [2s 9d Ad]
Seat 1: matiko09 collected ($6.21)
Seat 2: mycka86 folded before Flop (didn't bet)
Seat 3: sebaaastian folded before Flop (didn't bet)
Seat 4: hammerwife folded before Flop (didn't bet)
Seat 7: bilukm (button) folded before Flop (didn't bet)
Seat 8: Venomous100% (small blind) folded before Flop
Seat 9: HomerrrJay (big blind) folded on the Flop





PokerStars Hand #149393870444:  Hold'em No Limit ($0.50/$1.00 USD) - 2016/02/25 17:20:51 CET [2016/02/25 11:20:51 ET]
Table 'Morosovia II' 9-max Seat #4 is the button
Seat 1: apfush ($204.08 in chips) 
Seat 2: Effort92 ($100 in chips) 
Seat 3: sebaaastian ($216.36 in chips) 
Seat 4: Venomous100% ($154.02 in chips) 
Seat 5: pimpoza ($67.97 in chips) 
Seat 7: matiko09 ($166.55 in chips) 
Seat 8: simoniustin ($108.16 in chips) 
Seat 9: Ouga Buga ($126.57 in chips) 
pimpoza: posts small blind $0.50
matiko09: posts big blind $1
*** HOLE CARDS ***
Dealt to matiko09 [7s Ah]
simoniustin: folds 
Ouga Buga: folds 
apfush: folds 
Effort92: folds 
sebaaastian: raises $1.50 to $2.50
Venomous100%: folds 
pimpoza: folds 
matiko09: folds 
Uncalled bet ($1.50) returned to sebaaastian
sebaaastian collected $2.50 from pot
sebaaastian: doesn't show hand 
*** SUMMARY ***
Total pot $2.50 | Rake $0 
Seat 1: apfush folded before Flop (didn't bet)
Seat 2: Effort92 folded before Flop (didn't bet)
Seat 3: sebaaastian collected ($2.50)
Seat 4: Venomous100% (button) folded before Flop (didn't bet)
Seat 5: pimpoza (small blind) folded before Flop
Seat 7: matiko09 (big blind) folded before Flop
Seat 8: simoniustin folded before Flop (didn't bet)
Seat 9: Ouga Buga folded before Flop (didn't bet)





PokerStars Hand #149393873069:  Hold'em No Limit ($0.50/$1.00 USD) - 2016/02/25 17:20:54 CET [2016/02/25 11:20:54 ET]
Table 'Zerbinetta II' 9-max Seat #9 is the button
Seat 2: lysandrafly ($100 in chips) 
Seat 3: matiko09 ($100 in chips) 
Seat 6: nickreason17 ($104.11 in chips) 
Seat 7: HomerrrJay ($100 in chips) 
Seat 9: with-w ($48.02 in chips) 
$-Twackle-$ will be allowed to play after the button
lysandrafly: posts small blind $0.50
matiko09: posts big blind $1
sebaaastian: sits out 
hammerwife: sits out 
gabi_igna: sits out 
*** HOLE CARDS ***
Dealt to matiko09 [5h 8d]
nickreason17: raises $2 to $3
HomerrrJay: folds 
with-w: calls $3
lysandrafly: folds 
matiko09: folds 
*** FLOP *** [Kc Ts 2d]
nickreason17: bets $5
with-w: folds 
Uncalled bet ($5) returned to nickreason17
nickreason17 collected $7.16 from pot
*** SUMMARY ***
Total pot $7.50 | Rake $0.34 
Board [Kc Ts 2d]
Seat 2: lysandrafly (small blind) folded before Flop
Seat 3: matiko09 (big blind) folded before Flop
Seat 6: nickreason17 collected ($7.16)
Seat 7: HomerrrJay folded before Flop (didn't bet)
Seat 9: with-w (button) folded on the Flop





PokerStars Hand #149393874848:  Hold'em No Limit ($0.50/$1.00 USD) - 2016/02/25 17:20:56 CET [2016/02/25 11:20:56 ET]
Table 'Zeuxo II' 9-max Seat #6 is the button
Seat 1: forsmthgood ($112.29 in chips) 
Seat 4: sebaaastian ($108.61 in chips) 
Seat 6: Cogss ($99.50 in chips) 
Seat 7: djammusic ($51 in chips) 
Seat 8: matiko09 ($109.59 in chips) 
Seat 9: Sreshta222 ($196.65 in chips) 
djammusic: posts small blind $0.50
matiko09: posts big blind $1
*** HOLE CARDS ***
Dealt to matiko09 [Kh 8c]
Sreshta222: raises $1.50 to $2.50
forsmthgood: folds 
sebaaastian: folds 
Cogss: calls $2.50
djammusic: folds 
matiko09: folds 
*** FLOP *** [As 2s 5s]
Sreshta222: bets $4.65
Cogss: folds 
Uncalled bet ($4.65) returned to Sreshta222
Sreshta222 collected $6.21 from pot
Sreshta222: doesn't show hand 
*** SUMMARY ***
Total pot $6.50 | Rake $0.29 
Board [As 2s 5s]
Seat 1: forsmthgood folded before Flop (didn't bet)
Seat 4: sebaaastian folded before Flop (didn't bet)
Seat 6: Cogss (button) folded on the Flop
Seat 7: djammusic (small blind) folded before Flop
Seat 8: matiko09 (big blind) folded before Flop
Seat 9: Sreshta222 collected ($6.21)





PokerStars Hand #149393884915:  Hold'em No Limit ($0.50/$1.00 USD) - 2016/02/25 17:21:09 CET [2016/02/25 11:21:09 ET]
Table 'Ebella II' 9-max Seat #8 is the button
Seat 1: nickreason17 ($105.46 in chips) 
Seat 3: fanmtZ ($40 in chips) 
Seat 5: matiko09 ($100 in chips) 
Seat 6: gabi_igna ($105.05 in chips) 
Seat 8: ZMPOUTSAM140 ($79.71 in chips) 
Seat 9: simoniustin ($113.66 in chips) 
simoniustin: posts small blind $0.50
nickreason17: posts big blind $1
$-Twackle-$: sits out 
*** HOLE CARDS ***
Dealt to matiko09 [9s 4d]
fanmtZ: folds 
matiko09: folds 
gabi_igna: folds 
ZMPOUTSAM140: raises $1 to $2
simoniustin: calls $1.50
nickreason17: calls $1
*** FLOP *** [4s 6s Ah]
simoniustin: checks 
nickreason17: checks 
ZMPOUTSAM140: bets $3
simoniustin: calls $3
nickreason17: folds 
*** TURN *** [4s 6s Ah] [Jd]
simoniustin: checks 
ZMPOUTSAM140: bets $5.73
simoniustin: calls $5.73
*** RIVER *** [4s 6s Ah Jd] [Td]
simoniustin: checks 
ZMPOUTSAM140: bets $11.20
simoniustin: calls $11.20
*** SHOW DOWN ***
ZMPOUTSAM140: shows [7d Ad] (a pair of Aces)
simoniustin: shows [7s As] (a pair of Aces)
simoniustin collected $21.90 from pot
ZMPOUTSAM140 collected $21.90 from pot
*** SUMMARY ***
Total pot $45.86 | Rake $2.06 
Board [4s 6s Ah Jd Td]
Seat 1: nickreason17 (big blind) folded on the Flop
Seat 3: fanmtZ folded before Flop (didn't bet)
Seat 5: matiko09 folded before Flop (didn't bet)
Seat 6: gabi_igna folded before Flop (didn't bet)
Seat 8: ZMPOUTSAM140 (button) showed [7d Ad] and won ($21.90) with a pair of Aces
Seat 9: simoniustin (small blind) showed [7s As] and won ($21.90) with a pair of Aces





PokerStars Hand #149393886025:  Hold'em No Limit ($0.50/$1.00 USD) - 2016/02/25 17:21:10 CET [2016/02/25 11:21:10 ET]
Table 'Badenia II' 9-max Seat #5 is the button
Seat 1: matiko09 ($102.73 in chips) 
Seat 2: Stibitzkie ($45.06 in chips) 
Seat 3: sebaaastian ($148.50 in chips) 
Seat 4: hammerwife ($100 in chips) 
Seat 5: djammusic ($126.45 in chips) 
Seat 7: forsmthgood ($100 in chips) 
Seat 9: waisanen ($247.47 in chips) 
forsmthgood: posts small blind $0.50
waisanen: posts big blind $1
*** HOLE CARDS ***
Dealt to matiko09 [Kc 7s]
matiko09: folds 
Stibitzkie: calls $1
sebaaastian: folds 
hammerwife: folds 
djammusic: folds 
forsmthgood: folds 
waisanen: checks 
*** FLOP *** [8s 4s 4d]
waisanen: checks 
Stibitzkie: checks 
*** TURN *** [8s 4s 4d] [Ks]
waisanen: bets $1
Stibitzkie: folds 
Uncalled bet ($1) returned to waisanen
waisanen collected $2.39 from pot
*** SUMMARY ***
Total pot $2.50 | Rake $0.11 
Board [8s 4s 4d Ks]
Seat 1: matiko09 folded before Flop (didn't bet)
Seat 2: Stibitzkie folded on the Turn
Seat 3: sebaaastian folded before Flop (didn't bet)
Seat 4: hammerwife folded before Flop (didn't bet)
Seat 5: djammusic (button) folded before Flop (didn't bet)
Seat 7: forsmthgood (small blind) folded before Flop
Seat 9: waisanen (big blind) collected ($2.39)





PokerStars Hand #149393887768:  Hold'em No Limit ($0.50/$1.00 USD) - 2016/02/25 17:21:13 CET [2016/02/25 11:21:13 ET]
Table 'Sabine' 9-max Seat #5 is the button
Seat 2: apfush ($132.20 in chips) 
Seat 3: Ouga Buga ($150.34 in chips) 
Seat 5: Venomous100% ($108.54 in chips) 
Seat 6: ffac ($100 in chips) 
Seat 7: clayshmert ($40.78 in chips) 
Seat 8: matiko09 ($126.47 in chips) 
Seat 9: djammusic ($57.53 in chips) 
ffac: posts small blind $0.50
clayshmert: posts big blind $1
Aalleekks: sits out 
simoniustin: sits out 
*** HOLE CARDS ***
Dealt to matiko09 [5h 7d]
matiko09: folds 
djammusic: folds 
apfush: folds 
Ouga Buga: raises $1.50 to $2.50
Venomous100%: folds 
ffac: folds 
clayshmert: raises $3.50 to $6
Ouga Buga: raises $144.34 to $150.34 and is all-in
clayshmert: calls $34.78 and is all-in
Uncalled bet ($109.56) returned to Ouga Buga
*** FLOP *** [Jd 2h 5s]
*** TURN *** [Jd 2h 5s] [Ac]
*** RIVER *** [Jd 2h 5s Ac] [9s]
*** SHOW DOWN ***
clayshmert: shows [9c 9h] (three of a kind, Nines)
Ouga Buga: shows [Kh As] (a pair of Aces)
clayshmert collected $79.26 from pot
*** SUMMARY ***
Total pot $82.06 | Rake $2.80 
Board [Jd 2h 5s Ac 9s]
Seat 2: apfush folded before Flop (didn't bet)
Seat 3: Ouga Buga showed [Kh As] and lost with a pair of Aces
Seat 5: Venomous100% (button) folded before Flop (didn't bet)
Seat 6: ffac (small blind) folded before Flop
Seat 7: clayshmert (big blind) showed [9c 9h] and won ($79.26) with three of a kind, Nines
Seat 8: matiko09 folded before Flop (didn't bet)
Seat 9: djammusic folded before Flop (didn't bet)





PokerStars Hand #149393890944:  Hold'em No Limit ($0.50/$1.00 USD) - 2016/02/25 17:21:17 CET [2016/02/25 11:21:17 ET]
Table 'Mayall II' 9-max Seat #1 is the button
Seat 1: matiko09 ($110.61 in chips) 
Seat 3: simoniustin ($100 in chips) 
Seat 4: Ouga Buga ($111.12 in chips) 
Seat 6: apfush ($103.85 in chips) 
Seat 7: r.pol218 ($55.50 in chips) 
Seat 8: kuanhung0903 ($85.93 in chips) 
simoniustin: posts small blind $0.50
Ouga Buga: posts big blind $1
HomerrrJay: sits out 
*** HOLE CARDS ***
Dealt to matiko09 [Qc Kc]
apfush: folds 
r.pol218: calls $1
kuanhung0903: folds 
matiko09: raises $3 to $4
simoniustin: calls $3.50
Ouga Buga: folds 
r.pol218: calls $3
*** FLOP *** [4c 2c 6c]
simoniustin: checks 
r.pol218: bets $3
matiko09: raises $6 to $9
simoniustin: folds 
r.pol218: folds 
Uncalled bet ($6) returned to matiko09
matiko09 collected $18.14 from pot
matiko09: doesn't show hand 
*** SUMMARY ***
Total pot $19 | Rake $0.86 
Board [4c 2c 6c]
Seat 1: matiko09 (button) collected ($18.14)
Seat 3: simoniustin (small blind) folded on the Flop
Seat 4: Ouga Buga (big blind) folded before Flop
Seat 6: apfush folded before Flop (didn't bet)
Seat 7: r.pol218 folded on the Flop
Seat 8: kuanhung0903 folded before Flop (didn't bet)





PokerStars Hand #149393892015:  Hold'em No Limit ($0.50/$1.00 USD) - 2016/02/25 17:21:18 CET [2016/02/25 11:21:18 ET]
Table 'Nerthus II' 9-max Seat #8 is the button
Seat 1: DUkalisUA ($103.21 in chips) 
Seat 2: matiko09 ($216.79 in chips) 
Seat 3: simoniustin ($100 in chips) 
Seat 4: Ilov3NBA ($101.25 in chips) 
Seat 6: mycka86 ($132.08 in chips) 
Seat 7: Venomous100% ($116.11 in chips) 
Seat 8: Kelvin sai ($53.28 in chips) 
Seat 9: hammerwife ($102.50 in chips) 
hammerwife: posts small blind $0.50
DUkalisUA: posts big blind $1
*** HOLE CARDS ***
Dealt to matiko09 [Td 8c]
matiko09: folds 
simoniustin: raises $2 to $3
Ilov3NBA: folds 
mycka86: calls $3
Venomous100%: folds 
Kelvin sai: folds 
hammerwife: folds 
DUkalisUA: folds 
*** FLOP *** [9c Ah Tc]
simoniustin: checks 
mycka86: checks 
*** TURN *** [9c Ah Tc] [8d]
simoniustin: checks 
mycka86: checks 
*** RIVER *** [9c Ah Tc 8d] [Ts]
simoniustin: checks 
mycka86: bets $9.52
simoniustin: folds 
Uncalled bet ($9.52) returned to mycka86
mycka86 collected $7.16 from pot
*** SUMMARY ***
Total pot $7.50 | Rake $0.34 
Board [9c Ah Tc 8d Ts]
Seat 1: DUkalisUA (big blind) folded before Flop
Seat 2: matiko09 folded before Flop (didn't bet)
Seat 3: simoniustin folded on the River
Seat 4: Ilov3NBA folded before Flop (didn't bet)
Seat 6: mycka86 collected ($7.16)
Seat 7: Venomous100% folded before Flop (didn't bet)
Seat 8: Kelvin sai (button) folded before Flop (didn't bet)
Seat 9: hammerwife (small blind) folded before Flop





PokerStars Hand #149393893985:  Hold'em No Limit ($0.50/$1.00 USD) - 2016/02/25 17:21:20 CET [2016/02/25 11:21:20 ET]
Table 'Isa' 9-max Seat #8 is the button
Seat 1: matiko09 ($126.08 in chips) 
Seat 2: mycka86 ($100.40 in chips) 
Seat 3: sebaaastian ($140.25 in chips) 
Seat 4: hammerwife ($107.41 in chips) 
Seat 7: bilukm ($100 in chips) 
Seat 8: Venomous100% ($105.03 in chips) 
Seat 9: HomerrrJay ($170.11 in chips) 
HomerrrJay: posts small blind $0.50
matiko09: posts big blind $1
*** HOLE CARDS ***
Dealt to matiko09 [4h 6d]
mycka86: folds 
sebaaastian: folds 
hammerwife: folds 
bilukm: folds 
Venomous100%: raises $1 to $2
HomerrrJay: folds 
matiko09: folds 
Uncalled bet ($1) returned to Venomous100%
Venomous100% collected $2.50 from pot
Venomous100%: doesn't show hand 
*** SUMMARY ***
Total pot $2.50 | Rake $0 
Seat 1: matiko09 (big blind) folded before Flop
Seat 2: mycka86 folded before Flop (didn't bet)
Seat 3: sebaaastian folded before Flop (didn't bet)
Seat 4: hammerwife folded before Flop (didn't bet)
Seat 7: bilukm folded before Flop (didn't bet)
Seat 8: Venomous100% (button) collected ($2.50)
Seat 9: HomerrrJay (small blind) folded before Flop





PokerStars Hand #149393895483:  Hold'em No Limit ($0.50/$1.00 USD) - 2016/02/25 17:21:22 CET [2016/02/25 11:21:22 ET]
Table 'Zeuxo II' 9-max Seat #7 is the button
Seat 1: forsmthgood ($112.29 in chips) 
Seat 4: sebaaastian ($108.61 in chips) 
Seat 6: Cogss ($97 in chips) 
Seat 7: djammusic ($50.50 in chips) 
Seat 8: matiko09 ($108.59 in chips) 
Seat 9: Sreshta222 ($200.36 in chips) 
matiko09: posts small blind $0.50
Sreshta222: posts big blind $1
*** HOLE CARDS ***
Dealt to matiko09 [2h 5s]
forsmthgood: folds 
sebaaastian: folds 
Cogss: raises $1 to $2
djammusic: folds 
matiko09: folds 
Sreshta222: calls $1
*** FLOP *** [8c Tc Qs]
Sreshta222: checks 
Cogss: bets $4.30
Sreshta222: folds 
Uncalled bet ($4.30) returned to Cogss
Cogss collected $4.30 from pot
*** SUMMARY ***
Total pot $4.50 | Rake $0.20 
Board [8c Tc Qs]
Seat 1: forsmthgood folded before Flop (didn't bet)
Seat 4: sebaaastian folded before Flop (didn't bet)
Seat 6: Cogss collected ($4.30)
Seat 7: djammusic (button) folded before Flop (didn't bet)
Seat 8: matiko09 (small blind) folded before Flop
Seat 9: Sreshta222 (big blind) folded on the Flop





PokerStars Hand #149393897042:  Hold'em No Limit ($0.50/$1.00 USD) - 2016/02/25 17:21:24 CET [2016/02/25 11:21:24 ET]
Table 'Zerbinetta II' 9-max Seat #2 is the button
Seat 2: lysandrafly ($100 in chips) 
Seat 3: matiko09 ($100 in chips) 
Seat 4: sebaaastian ($100 in chips) 
Seat 6: nickreason17 ($108.27 in chips) 
Seat 7: HomerrrJay ($100 in chips) 
Seat 9: with-w ($45.02 in chips) 
matiko09: posts small blind $0.50
sebaaastian: posts big blind $1
hammerwife: sits out 
gabi_igna: sits out 
$-Twackle-$: sits out 
*** HOLE CARDS ***
Dealt to matiko09 [6d 4h]
nickreason17: folds 
HomerrrJay: folds 
with-w: folds 
lysandrafly: folds 
matiko09: folds 
Uncalled bet ($0.50) returned to sebaaastian
sebaaastian collected $1 from pot
sebaaastian: doesn't show hand 
*** SUMMARY ***
Total pot $1 | Rake $0 
Seat 2: lysandrafly (button) folded before Flop (didn't bet)
Seat 3: matiko09 (small blind) folded before Flop
Seat 4: sebaaastian (big blind) collected ($1)
Seat 6: nickreason17 folded before Flop (didn't bet)
Seat 7: HomerrrJay folded before Flop (didn't bet)
Seat 9: with-w folded before Flop (didn't bet)





PokerStars Hand #149393898185:  Hold'em No Limit ($0.50/$1.00 USD) - 2016/02/25 17:21:26 CET [2016/02/25 11:21:26 ET]
Table 'Hercules IV' 9-max Seat #8 is the button
Seat 1: matiko09 ($101.50 in chips) 
Seat 3: HomerrrJay ($100.50 in chips) 
Seat 6: kuanhung0903 ($59.89 in chips) 
Seat 7: Ouga Buga ($112.56 in chips) 
Seat 8: brokat77 ($128.39 in chips) 
Seat 9: djammusic ($41.82 in chips) 
djammusic: posts small blind $0.50
matiko09: posts big blind $1
*** HOLE CARDS ***
Dealt to matiko09 [3c 4c]
HomerrrJay: folds 
kuanhung0903: folds 
Ouga Buga: raises $1.50 to $2.50
brokat77: folds 
djammusic: folds 
matiko09: folds 
Uncalled bet ($1.50) returned to Ouga Buga
Ouga Buga collected $2.50 from pot
Ouga Buga: doesn't show hand 
*** SUMMARY ***
Total pot $2.50 | Rake $0 
Seat 1: matiko09 (big blind) folded before Flop
Seat 3: HomerrrJay folded before Flop (didn't bet)
Seat 6: kuanhung0903 folded before Flop (didn't bet)
Seat 7: Ouga Buga collected ($2.50)
Seat 8: brokat77 (button) folded before Flop (didn't bet)
Seat 9: djammusic (small blind) folded before Flop





PokerStars Hand #149393902319:  Hold'em No Limit ($0.50/$1.00 USD) - 2016/02/25 17:21:31 CET [2016/02/25 11:21:31 ET]
Table 'Morosovia II' 9-max Seat #5 is the button
Seat 1: apfush ($204.08 in chips) 
Seat 2: Effort92 ($100 in chips) 
Seat 3: sebaaastian ($217.86 in chips) 
Seat 4: Venomous100% ($154.02 in chips) 
Seat 5: pimpoza ($67.47 in chips) 
Seat 7: matiko09 ($165.55 in chips) 
Seat 8: simoniustin ($108.16 in chips) 
Seat 9: Ouga Buga ($126.57 in chips) 
matiko09: posts small blind $0.50
simoniustin: posts big blind $1
*** HOLE CARDS ***
Dealt to matiko09 [6c Tc]
Ouga Buga: folds 
apfush: raises $2 to $3
Effort92: folds 
sebaaastian: folds 
Venomous100%: folds 
pimpoza: calls $3
matiko09: folds 
simoniustin: calls $2
*** FLOP *** [Jh 9s 7c]
simoniustin: checks 
apfush: bets $6.50
pimpoza: calls $6.50
simoniustin: raises $25.50 to $32
apfush: folds 
pimpoza: folds 
Uncalled bet ($25.50) returned to simoniustin
simoniustin collected $27.70 from pot
simoniustin: doesn't show hand 
*** SUMMARY ***
Total pot $29 | Rake $1.30 
Board [Jh 9s 7c]
Seat 1: apfush folded on the Flop
Seat 2: Effort92 folded before Flop (didn't bet)
Seat 3: sebaaastian folded before Flop (didn't bet)
Seat 4: Venomous100% folded before Flop (didn't bet)
Seat 5: pimpoza (button) folded on the Flop
Seat 7: matiko09 (small blind) folded before Flop
Seat 8: simoniustin (big blind) collected ($27.70)
Seat 9: Ouga Buga folded before Flop (didn't bet)





PokerStars Hand #149393909334:  Hold'em No Limit ($0.50/$1.00 USD) - 2016/02/25 17:21:40 CET [2016/02/25 11:21:40 ET]
Table 'Zerbinetta II' 9-max Seat #3 is the button
Seat 2: lysandrafly ($100 in chips) 
Seat 3: matiko09 ($100 in chips) 
Seat 4: sebaaastian ($100.50 in chips) 
Seat 5: hammerwife ($100 in chips) 
Seat 6: nickreason17 ($108.27 in chips) 
Seat 7: HomerrrJay ($100 in chips) 
Seat 9: with-w ($45.02 in chips) 
sebaaastian: posts small blind $0.50
hammerwife: posts big blind $1
gabi_igna: sits out 
$-Twackle-$: sits out 
*** HOLE CARDS ***
Dealt to matiko09 [5c 4h]
nickreason17: folds 
HomerrrJay: folds 
with-w: folds 
lysandrafly: folds 
matiko09: folds 
sebaaastian: folds 
Uncalled bet ($0.50) returned to hammerwife
hammerwife collected $1 from pot
hammerwife: doesn't show hand 
*** SUMMARY ***
Total pot $1 | Rake $0 
Seat 2: lysandrafly folded before Flop (didn't bet)
Seat 3: matiko09 (button) folded before Flop (didn't bet)
Seat 4: sebaaastian (small blind) folded before Flop
Seat 5: hammerwife (big blind) collected ($1)
Seat 6: nickreason17 folded before Flop (didn't bet)
Seat 7: HomerrrJay folded before Flop (didn't bet)
Seat 9: with-w folded before Flop (didn't bet)





PokerStars Hand #149393913887:  Hold'em No Limit ($0.50/$1.00 USD) - 2016/02/25 17:21:46 CET [2016/02/25 11:21:46 ET]
Table 'Badenia II' 9-max Seat #7 is the button
Seat 1: matiko09 ($102.73 in chips) 
Seat 2: Stibitzkie ($44.06 in chips) 
Seat 3: sebaaastian ($148.50 in chips) 
Seat 4: hammerwife ($100 in chips) 
Seat 5: djammusic ($126.45 in chips) 
Seat 7: forsmthgood ($100 in chips) 
Seat 9: waisanen ($248.86 in chips) 
waisanen: posts small blind $0.50
matiko09: posts big blind $1
*** HOLE CARDS ***
Dealt to matiko09 [8d Td]
Stibitzkie: calls $1
sebaaastian: folds 
hammerwife: folds 
djammusic: folds 
forsmthgood: raises $3 to $4
waisanen: folds 
matiko09: folds 
Stibitzkie: raises $40.06 to $44.06 and is all-in
forsmthgood: folds 
Uncalled bet ($40.06) returned to Stibitzkie
Stibitzkie collected $9.50 from pot
*** SUMMARY ***
Total pot $9.50 | Rake $0 
Seat 1: matiko09 (big blind) folded before Flop
Seat 2: Stibitzkie collected ($9.50)
Seat 3: sebaaastian folded before Flop (didn't bet)
Seat 4: hammerwife folded before Flop (didn't bet)
Seat 5: djammusic folded before Flop (didn't bet)
Seat 7: forsmthgood (button) folded before Flop
Seat 9: waisanen (small blind) folded before Flop





PokerStars Hand #149393914568:  Hold'em No Limit ($0.25/$0.50 USD) - 2016/02/25 17:21:47 CET [2016/02/25 11:21:47 ET]
Table 'Lohja II' 9-max Seat #9 is the button
Seat 1: MoonJimmy ($138.88 in chips) 
Seat 3: guvalc1952 ($194.56 in chips) 
Seat 4: payback11 ($50 in chips) 
Seat 5: 111STAVR111 ($50.71 in chips) 
Seat 7: matiko09 ($124.03 in chips) 
Seat 8: jamba83 ($70.79 in chips) 
Seat 9: Al3xAnd3r22 ($100.01 in chips) 
MoonJimmy: posts small blind $0.25
Apparat888: is sitting out 
guvalc1952: posts big blind $0.50
MoonJimmy: posts the ante $0.10
guvalc1952: posts the ante $0.10
payback11: posts the ante $0.10
111STAVR111: posts the ante $0.10
matiko09: posts the ante $0.10
jamba83: posts the ante $0.10
Al3xAnd3r22: posts the ante $0.10
*** HOLE CARDS ***
Dealt to matiko09 [2d 8s]
payback11: folds 
111STAVR111: folds 
matiko09: folds 
jamba83: folds 
Al3xAnd3r22: folds 
MoonJimmy: raises $1 to $1.50
guvalc1952: calls $1
*** FLOP *** [Ac 5h 3s]
MoonJimmy: checks 
guvalc1952: bets $1.76
MoonJimmy: folds 
Uncalled bet ($1.76) returned to guvalc1952
guvalc1952 collected $3.53 from pot
guvalc1952: doesn't show hand 
*** SUMMARY ***
Total pot $3.70 | Rake $0.17 
Board [Ac 5h 3s]
Seat 1: MoonJimmy (small blind) folded on the Flop
Seat 3: guvalc1952 (big blind) collected ($3.53)
Seat 4: payback11 folded before Flop (didn't bet)
Seat 5: 111STAVR111 folded before Flop (didn't bet)
Seat 7: matiko09 folded before Flop (didn't bet)
Seat 8: jamba83 folded before Flop (didn't bet)
Seat 9: Al3xAnd3r22 (button) folded before Flop (didn't bet)





PokerStars Hand #149393921718:  Hold'em No Limit ($0.50/$1.00 USD) - 2016/02/25 17:21:55 CET [2016/02/25 11:21:55 ET]
Table 'Isa' 9-max Seat #9 is the button
Seat 1: matiko09 ($125.08 in chips) 
Seat 2: mycka86 ($100.40 in chips) 
Seat 3: sebaaastian ($140.25 in chips) 
Seat 4: hammerwife ($107.41 in chips) 
Seat 7: bilukm ($100 in chips) 
Seat 8: Venomous100% ($106.53 in chips) 
Seat 9: HomerrrJay ($169.61 in chips) 
matiko09: posts small blind $0.50
mycka86: posts big blind $1
*** HOLE CARDS ***
Dealt to matiko09 [Jd 3d]
sebaaastian: folds 
hammerwife: folds 
bilukm: calls $1
Venomous100%: raises $4 to $5
HomerrrJay: folds 
matiko09: folds 
mycka86: folds 
bilukm: folds 
Uncalled bet ($4) returned to Venomous100%
Venomous100% collected $3.50 from pot
Venomous100%: doesn't show hand 
*** SUMMARY ***
Total pot $3.50 | Rake $0 
Seat 1: matiko09 (small blind) folded before Flop
Seat 2: mycka86 (big blind) folded before Flop
Seat 3: sebaaastian folded before Flop (didn't bet)
Seat 4: hammerwife folded before Flop (didn't bet)
Seat 7: bilukm folded before Flop
Seat 8: Venomous100% collected ($3.50)
Seat 9: HomerrrJay (button) folded before Flop (didn't bet)





PokerStars Hand #149393923590:  Hold'em No Limit ($0.50/$1.00 USD) - 2016/02/25 17:21:58 CET [2016/02/25 11:21:58 ET]
Table 'Zeuxo II' 9-max Seat #8 is the button
Seat 1: forsmthgood ($112.29 in chips) 
Seat 4: sebaaastian ($108.61 in chips) 
Seat 6: Cogss ($99.30 in chips) 
Seat 7: djammusic ($50.50 in chips) 
Seat 8: matiko09 ($108.09 in chips) 
Seat 9: Sreshta222 ($198.36 in chips) 
Sreshta222: posts small blind $0.50
forsmthgood: posts big blind $1
*** HOLE CARDS ***
Dealt to matiko09 [7d 4c]
sebaaastian: folds 
Cogss: folds 
djammusic: folds 
matiko09: folds 
Sreshta222: raises $1.50 to $2.50
forsmthgood: calls $1.50
*** FLOP *** [5h 9s 5s]
Sreshta222: checks 
forsmthgood: checks 
*** TURN *** [5h 9s 5s] [3c]
Sreshta222: bets $1.91
forsmthgood: folds 
Uncalled bet ($1.91) returned to Sreshta222
Sreshta222 collected $4.78 from pot
Sreshta222: doesn't show hand 
*** SUMMARY ***
Total pot $5 | Rake $0.22 
Board [5h 9s 5s 3c]
Seat 1: forsmthgood (big blind) folded on the Turn
Seat 4: sebaaastian folded before Flop (didn't bet)
Seat 6: Cogss folded before Flop (didn't bet)
Seat 7: djammusic folded before Flop (didn't bet)
Seat 8: matiko09 (button) folded before Flop (didn't bet)
Seat 9: Sreshta222 (small blind) collected ($4.78)





PokerStars Hand #149393923977:  Hold'em No Limit ($0.50/$1.00 USD) - 2016/02/25 17:21:58 CET [2016/02/25 11:21:58 ET]
Table 'Sabine' 9-max Seat #6 is the button
Seat 2: apfush ($132.20 in chips) 
Seat 3: Ouga Buga ($109.56 in chips) 
Seat 5: Venomous100% ($108.54 in chips) 
Seat 6: ffac ($100 in chips) 
Seat 7: clayshmert ($79.26 in chips) 
Seat 8: matiko09 ($126.47 in chips) 
Seat 9: djammusic ($57.53 in chips) 
clayshmert: posts small blind $0.50
matiko09: posts big blind $1
Aalleekks: sits out 
simoniustin: sits out 
*** HOLE CARDS ***
Dealt to matiko09 [7s 5h]
djammusic: folds 
apfush: folds 
Ouga Buga: raises $1.50 to $2.50
Venomous100%: folds 
ffac: folds 
clayshmert: folds 
matiko09: folds 
Uncalled bet ($1.50) returned to Ouga Buga
Ouga Buga collected $2.50 from pot
Ouga Buga: doesn't show hand 
*** SUMMARY ***
Total pot $2.50 | Rake $0 
Seat 2: apfush folded before Flop (didn't bet)
Seat 3: Ouga Buga collected ($2.50)
Seat 5: Venomous100% folded before Flop (didn't bet)
Seat 6: ffac (button) folded before Flop (didn't bet)
Seat 7: clayshmert (small blind) folded before Flop
Seat 8: matiko09 (big blind) folded before Flop
Seat 9: djammusic folded before Flop (didn't bet)





PokerStars Hand #149393927113:  Hold'em No Limit ($0.50/$1.00 USD) - 2016/02/25 17:22:02 CET [2016/02/25 11:22:02 ET]
Table 'Zerbinetta II' 9-max Seat #4 is the button
Seat 2: lysandrafly ($100 in chips) 
Seat 3: matiko09 ($100 in chips) 
Seat 4: sebaaastian ($100 in chips) 
Seat 5: hammerwife ($100.50 in chips) 
Seat 6: nickreason17 ($108.27 in chips) 
Seat 7: HomerrrJay ($100 in chips) 
Seat 9: with-w ($45.02 in chips) 
hammerwife: posts small blind $0.50
nickreason17: posts big blind $1
gabi_igna: sits out 
$-Twackle-$: sits out 
*** HOLE CARDS ***
Dealt to matiko09 [Jh 2c]
HomerrrJay: folds 
with-w: calls $1
lysandrafly: folds 
matiko09: folds 
sebaaastian: raises $3 to $4
hammerwife: folds 
nickreason17: folds 
with-w: calls $3
*** FLOP *** [As Ah Qh]
with-w: checks 
sebaaastian: bets $4
with-w: calls $4
*** TURN *** [As Ah Qh] [2h]
with-w: checks 
sebaaastian: checks 
*** RIVER *** [As Ah Qh 2h] [Ks]
with-w: bets $16.71
sebaaastian: folds 
Uncalled bet ($16.71) returned to with-w
with-w collected $16.71 from pot
with-w: doesn't show hand 
*** SUMMARY ***
Total pot $17.50 | Rake $0.79 
Board [As Ah Qh 2h Ks]
Seat 2: lysandrafly folded before Flop (didn't bet)
Seat 3: matiko09 folded before Flop (didn't bet)
Seat 4: sebaaastian (button) folded on the River
Seat 5: hammerwife (small blind) folded before Flop
Seat 6: nickreason17 (big blind) folded before Flop
Seat 7: HomerrrJay folded before Flop (didn't bet)
Seat 9: with-w collected ($16.71)





PokerStars Hand #149393934401:  Hold'em No Limit ($0.50/$1.00 USD) - 2016/02/25 17:22:11 CET [2016/02/25 11:22:11 ET]
Table 'Hercules IV' 9-max Seat #9 is the button
Seat 1: matiko09 ($100.50 in chips) 
Seat 3: HomerrrJay ($100.50 in chips) 
Seat 6: kuanhung0903 ($59.89 in chips) 
Seat 7: Ouga Buga ($114.06 in chips) 
Seat 8: brokat77 ($128.39 in chips) 
Seat 9: djammusic ($41.32 in chips) 
matiko09: posts small blind $0.50
HomerrrJay: posts big blind $1
*** HOLE CARDS ***
Dealt to matiko09 [3s 7d]
kuanhung0903: folds 
Ouga Buga: folds 
brokat77: folds 
djammusic: raises $1.02 to $2.02
matiko09: folds 
HomerrrJay: folds 
Uncalled bet ($1.02) returned to djammusic
djammusic collected $2.50 from pot
djammusic: doesn't show hand 
*** SUMMARY ***
Total pot $2.50 | Rake $0 
Seat 1: matiko09 (small blind) folded before Flop
Seat 3: HomerrrJay (big blind) folded before Flop
Seat 6: kuanhung0903 folded before Flop (didn't bet)
Seat 7: Ouga Buga folded before Flop (didn't bet)
Seat 8: brokat77 folded before Flop (didn't bet)
Seat 9: djammusic (button) collected ($2.50)





PokerStars Hand #149393934195:  Hold'em No Limit ($0.50/$1.00 USD) - 2016/02/25 17:22:11 CET [2016/02/25 11:22:11 ET]
Table 'Eurysaces II' 9-max Seat #7 is the button
Seat 5: keessie93 ($66.02 in chips) 
Seat 6: nickreason17 ($100 in chips) 
Seat 7: $-Twackle-$ ($100 in chips) 
Seat 8: HomerrrJay ($100 in chips) 
Seat 9: matiko09 ($100 in chips) 
HomerrrJay: posts small blind $0.50
matiko09: posts big blind $1
*** HOLE CARDS ***
Dealt to matiko09 [5d Ks]
keessie93: folds 
nickreason17: folds 
$-Twackle-$: folds 
HomerrrJay: folds 
Uncalled bet ($0.50) returned to matiko09
matiko09 collected $1 from pot
matiko09: doesn't show hand 
*** SUMMARY ***
Total pot $1 | Rake $0 
Seat 5: keessie93 folded before Flop (didn't bet)
Seat 6: nickreason17 folded before Flop (didn't bet)
Seat 7: $-Twackle-$ (button) folded before Flop (didn't bet)
Seat 8: HomerrrJay (small blind) folded before Flop
Seat 9: matiko09 (big blind) collected ($1)





PokerStars Hand #149393941376:  Hold'em No Limit ($0.50/$1.00 USD) - 2016/02/25 17:22:20 CET [2016/02/25 11:22:20 ET]
Table 'Mayall II' 9-max Seat #3 is the button
Seat 1: matiko09 ($121.75 in chips) 
Seat 3: simoniustin ($100 in chips) 
Seat 4: Ouga Buga ($110.12 in chips) 
Seat 5: HomerrrJay ($100 in chips) 
Seat 6: apfush ($103.85 in chips) 
Seat 7: r.pol218 ($48.50 in chips) 
Seat 8: kuanhung0903 ($85.93 in chips) 
Ouga Buga: posts small blind $0.50
HomerrrJay: posts big blind $1
*** HOLE CARDS ***
Dealt to matiko09 [Kd Jc]
apfush: folds 
r.pol218: folds 
kuanhung0903: raises $2 to $3
matiko09: folds 
simoniustin: folds 
Ouga Buga: folds 
HomerrrJay: folds 
Uncalled bet ($2) returned to kuanhung0903
kuanhung0903 collected $2.50 from pot
kuanhung0903: doesn't show hand 
*** SUMMARY ***
Total pot $2.50 | Rake $0 
Seat 1: matiko09 folded before Flop (didn't bet)
Seat 3: simoniustin (button) folded before Flop (didn't bet)
Seat 4: Ouga Buga (small blind) folded before Flop
Seat 5: HomerrrJay (big blind) folded before Flop
Seat 6: apfush folded before Flop (didn't bet)
Seat 7: r.pol218 folded before Flop (didn't bet)
Seat 8: kuanhung0903 collected ($2.50)





PokerStars Hand #149393942669:  Hold'em No Limit ($0.50/$1.00 USD) - 2016/02/25 17:22:22 CET [2016/02/25 11:22:22 ET]
Table 'Eurysaces II' 9-max Seat #8 is the button
Seat 5: keessie93 ($66.02 in chips) 
Seat 6: nickreason17 ($100 in chips) 
Seat 7: $-Twackle-$ ($100 in chips) 
Seat 8: HomerrrJay ($100 in chips) 
Seat 9: matiko09 ($100.50 in chips) 
matiko09: posts small blind $0.50
keessie93: posts big blind $1
*** HOLE CARDS ***
Dealt to matiko09 [Jd 3c]
nickreason17: folds 
$-Twackle-$: raises $1.50 to $2.50
HomerrrJay: folds 
matiko09: folds 
keessie93: folds 
Uncalled bet ($1.50) returned to $-Twackle-$
Sreshta222 joins the table at seat #1 
$-Twackle-$ collected $2.50 from pot
$-Twackle-$: doesn't show hand 
*** SUMMARY ***
Total pot $2.50 | Rake $0 
Seat 5: keessie93 (big blind) folded before Flop
Seat 6: nickreason17 folded before Flop (didn't bet)
Seat 7: $-Twackle-$ collected ($2.50)
Seat 8: HomerrrJay (button) folded before Flop (didn't bet)
Seat 9: matiko09 (small blind) folded before Flop





PokerStars Hand #149393947545:  Hold'em No Limit ($0.25/$0.50 USD) - 2016/02/25 17:22:28 CET [2016/02/25 11:22:28 ET]
Table 'Lohja II' 9-max Seat #1 is the button
Seat 1: MoonJimmy ($137.28 in chips) 
Seat 3: guvalc1952 ($196.49 in chips) 
Seat 4: payback11 ($50 in chips) 
Seat 5: 111STAVR111 ($50.61 in chips) 
Seat 7: matiko09 ($123.93 in chips) 
Seat 8: jamba83 ($70.69 in chips) 
Seat 9: Al3xAnd3r22 ($99.91 in chips) 
guvalc1952: posts small blind $0.25
payback11: posts big blind $0.50
MoonJimmy: posts the ante $0.10
guvalc1952: posts the ante $0.10
payback11: posts the ante $0.10
111STAVR111: posts the ante $0.10
matiko09: posts the ante $0.10
jamba83: posts the ante $0.10
Al3xAnd3r22: posts the ante $0.10
*** HOLE CARDS ***
Dealt to matiko09 [Kd Qd]
111STAVR111: raises $1 to $1.50
matiko09: calls $1.50
jamba83: folds 
Al3xAnd3r22: folds 
MoonJimmy: folds 
guvalc1952: folds 
payback11: folds 
*** FLOP *** [Jc 8d Qs]
111STAVR111: bets $3.19
matiko09: calls $3.19
*** TURN *** [Jc 8d Qs] [9h]
111STAVR111: checks 
matiko09: checks 
*** RIVER *** [Jc 8d Qs 9h] [Ks]
111STAVR111: bets $7.50
matiko09: folds 
Uncalled bet ($7.50) returned to 111STAVR111
111STAVR111 collected $10.34 from pot
111STAVR111: doesn't show hand 
*** SUMMARY ***
Total pot $10.83 | Rake $0.49 
Board [Jc 8d Qs 9h Ks]
Seat 1: MoonJimmy (button) folded before Flop (didn't bet)
Seat 3: guvalc1952 (small blind) folded before Flop
Seat 4: payback11 (big blind) folded before Flop
Seat 5: 111STAVR111 collected ($10.34)
Seat 7: matiko09 folded on the River
Seat 8: jamba83 folded before Flop (didn't bet)
Seat 9: Al3xAnd3r22 folded before Flop (didn't bet)





PokerStars Hand #149393954589:  Hold'em No Limit ($0.50/$1.00 USD) - 2016/02/25 17:22:37 CET [2016/02/25 11:22:37 ET]
Table 'Hercules IV' 9-max Seat #1 is the button
Seat 1: matiko09 ($100 in chips) 
Seat 3: HomerrrJay ($100 in chips) 
Seat 6: kuanhung0903 ($59.89 in chips) 
Seat 7: Ouga Buga ($114.06 in chips) 
Seat 8: brokat77 ($128.39 in chips) 
Seat 9: djammusic ($42.82 in chips) 
HomerrrJay: posts small blind $0.50
kuanhung0903: posts big blind $1
*** HOLE CARDS ***
Dealt to matiko09 [Jc 8h]
Ouga Buga: folds 
brokat77: calls $1
djammusic: raises $3 to $4
matiko09: folds 
HomerrrJay: folds 
kuanhung0903: folds 
brokat77: calls $3
*** FLOP *** [3d 2h Qs]
Venomous100% leaves the table
simoniustin joins the table at seat #2 
brokat77: checks 
djammusic: bets $6
brokat77: folds 
Uncalled bet ($6) returned to djammusic
djammusic collected $9.07 from pot
djammusic: doesn't show hand 
*** SUMMARY ***
Total pot $9.50 | Rake $0.43 
Board [3d 2h Qs]
Seat 1: matiko09 (button) folded before Flop (didn't bet)
Seat 3: HomerrrJay (small blind) folded before Flop
Seat 6: kuanhung0903 (big blind) folded before Flop
Seat 7: Ouga Buga folded before Flop (didn't bet)
Seat 8: brokat77 folded on the Flop
Seat 9: djammusic collected ($9.07)





PokerStars Hand #149393955581:  Hold'em No Limit ($0.50/$1.00 USD) - 2016/02/25 17:22:38 CET [2016/02/25 11:22:38 ET]
Table 'Badenia II' 9-max Seat #9 is the button
Seat 1: matiko09 ($101.73 in chips) 
Seat 2: Stibitzkie ($49.56 in chips) 
Seat 3: sebaaastian ($148.50 in chips) 
Seat 4: hammerwife ($100 in chips) 
Seat 5: djammusic ($126.45 in chips) 
Seat 7: forsmthgood ($100 in chips) 
Seat 9: waisanen ($248.36 in chips) 
matiko09: posts small blind $0.50
Stibitzkie: posts big blind $1
*** HOLE CARDS ***
Dealt to matiko09 [3s Kh]
sebaaastian: folds 
hammerwife: folds 
djammusic: folds 
forsmthgood: folds 
waisanen: folds 
matiko09: folds 
Uncalled bet ($0.50) returned to Stibitzkie
Stibitzkie collected $1 from pot
*** SUMMARY ***
Total pot $1 | Rake $0 
Seat 1: matiko09 (small blind) folded before Flop
Seat 2: Stibitzkie (big blind) collected ($1)
Seat 3: sebaaastian folded before Flop (didn't bet)
Seat 4: hammerwife folded before Flop (didn't bet)
Seat 5: djammusic folded before Flop (didn't bet)
Seat 7: forsmthgood folded before Flop (didn't bet)
Seat 9: waisanen (button) folded before Flop (didn't bet)





PokerStars Hand #149393955613:  Hold'em No Limit ($0.50/$1.00 USD) - 2016/02/25 17:22:38 CET [2016/02/25 11:22:38 ET]
Table 'Ebella II' 9-max Seat #9 is the button
Seat 1: nickreason17 ($103.46 in chips) 
Seat 3: fanmtZ ($40 in chips) 
Seat 5: matiko09 ($100 in chips) 
Seat 6: gabi_igna ($105.05 in chips) 
Seat 8: ZMPOUTSAM140 ($79.68 in chips) 
Seat 9: simoniustin ($113.63 in chips) 
nickreason17: posts small blind $0.50
fanmtZ: posts big blind $1
$-Twackle-$: sits out 
*** HOLE CARDS ***
Dealt to matiko09 [7h 5c]
matiko09: folds 
gabi_igna: folds 
ZMPOUTSAM140: raises $1 to $2
simoniustin: folds 
nickreason17: folds 
fanmtZ: folds 
Uncalled bet ($1) returned to ZMPOUTSAM140
ZMPOUTSAM140 collected $2.50 from pot
*** SUMMARY ***
Total pot $2.50 | Rake $0 
Seat 1: nickreason17 (small blind) folded before Flop
Seat 3: fanmtZ (big blind) folded before Flop
Seat 5: matiko09 folded before Flop (didn't bet)
Seat 6: gabi_igna folded before Flop (didn't bet)
Seat 8: ZMPOUTSAM140 collected ($2.50)
Seat 9: simoniustin (button) folded before Flop (didn't bet)





PokerStars Hand #149393956735:  Hold'em No Limit ($0.50/$1.00 USD) - 2016/02/25 17:22:39 CET [2016/02/25 11:22:39 ET]
Table 'Sabine' 9-max Seat #7 is the button
Seat 2: apfush ($132.20 in chips) 
Seat 3: Ouga Buga ($111.06 in chips) 
Seat 5: Venomous100% ($108.54 in chips) 
Seat 6: ffac ($100 in chips) 
Seat 7: clayshmert ($78.76 in chips) 
Seat 8: matiko09 ($125.47 in chips) 
Seat 9: djammusic ($57.53 in chips) 
matiko09: posts small blind $0.50
djammusic: posts big blind $1
Aalleekks: sits out 
simoniustin: sits out 
*** HOLE CARDS ***
Dealt to matiko09 [8d Th]
apfush: folds 
Ouga Buga: folds 
Venomous100%: folds 
ffac: folds 
clayshmert: calls $1
matiko09: folds 
djammusic: checks 
*** FLOP *** [5c 6c 4d]
djammusic: bets $2
clayshmert: folds 
Uncalled bet ($2) returned to djammusic
djammusic collected $2.39 from pot
djammusic: doesn't show hand 
*** SUMMARY ***
Total pot $2.50 | Rake $0.11 
Board [5c 6c 4d]
Seat 2: apfush folded before Flop (didn't bet)
Seat 3: Ouga Buga folded before Flop (didn't bet)
Seat 5: Venomous100% folded before Flop (didn't bet)
Seat 6: ffac folded before Flop (didn't bet)
Seat 7: clayshmert (button) folded on the Flop
Seat 8: matiko09 (small blind) folded before Flop
Seat 9: djammusic (big blind) collected ($2.39)





PokerStars Hand #149393956213:  Hold'em No Limit ($0.50/$1.00 USD) - 2016/02/25 17:22:39 CET [2016/02/25 11:22:39 ET]
Table 'Isa' 9-max Seat #1 is the button
Seat 1: matiko09 ($124.58 in chips) 
Seat 2: mycka86 ($100 in chips) 
Seat 3: sebaaastian ($140.25 in chips) 
Seat 4: hammerwife ($107.41 in chips) 
Seat 7: bilukm ($99.28 in chips) 
Seat 8: Venomous100% ($109.03 in chips) 
Seat 9: HomerrrJay ($169.61 in chips) 
mycka86: posts small blind $0.50
sebaaastian: posts big blind $1
*** HOLE CARDS ***
Dealt to matiko09 [8c 3h]
hammerwife: raises $2 to $3
bilukm: folds 
Venomous100%: folds 
HomerrrJay: folds 
matiko09: folds 
mycka86: folds 
sebaaastian: folds 
Uncalled bet ($2) returned to hammerwife
hammerwife collected $2.50 from pot
hammerwife: doesn't show hand 
*** SUMMARY ***
Total pot $2.50 | Rake $0 
Seat 1: matiko09 (button) folded before Flop (didn't bet)
Seat 2: mycka86 (small blind) folded before Flop
Seat 3: sebaaastian (big blind) folded before Flop
Seat 4: hammerwife collected ($2.50)
Seat 7: bilukm folded before Flop (didn't bet)
Seat 8: Venomous100% folded before Flop (didn't bet)
Seat 9: HomerrrJay folded before Flop (didn't bet)





PokerStars Hand #149393958383:  Hold'em No Limit ($0.50/$1.00 USD) - 2016/02/25 17:22:42 CET [2016/02/25 11:22:42 ET]
Table 'Eurysaces II' 9-max Seat #9 is the button
Seat 5: keessie93 ($65.02 in chips) 
Seat 7: $-Twackle-$ ($101.50 in chips) 
Seat 8: HomerrrJay ($100 in chips) 
Seat 9: matiko09 ($100 in chips) 
keessie93: posts small blind $0.50
nickreason17: is sitting out 
$-Twackle-$: posts big blind $1
*** HOLE CARDS ***
Dealt to matiko09 [5d Tc]
HomerrrJay: folds 
Sreshta222 leaves the table
nickreason17 leaves the table
Hujiafeng joins the table at seat #4 
matiko09: folds 
keessie93: folds 
Uncalled bet ($0.50) returned to $-Twackle-$
$-Twackle-$ collected $1 from pot
$-Twackle-$: doesn't show hand 
*** SUMMARY ***
Total pot $1 | Rake $0 
Seat 5: keessie93 (small blind) folded before Flop
Seat 7: $-Twackle-$ (big blind) collected ($1)
Seat 8: HomerrrJay folded before Flop (didn't bet)
Seat 9: matiko09 (button) folded before Flop (didn't bet)





PokerStars Hand #149393963015:  Hold'em No Limit ($0.50/$1.00 USD) - 2016/02/25 17:22:47 CET [2016/02/25 11:22:47 ET]
Table 'Badenia II' 9-max Seat #1 is the button
Seat 1: matiko09 ($101.23 in chips) 
Seat 2: Stibitzkie ($50.06 in chips) 
Seat 3: sebaaastian ($148.50 in chips) 
Seat 4: hammerwife ($100 in chips) 
Seat 5: djammusic ($126.45 in chips) 
Seat 7: forsmthgood ($100 in chips) 
Seat 9: waisanen ($248.36 in chips) 
Stibitzkie: posts small blind $0.50
sebaaastian: posts big blind $1
*** HOLE CARDS ***
Dealt to matiko09 [Td 8s]
hammerwife: folds 
djammusic: folds 
forsmthgood: folds 
waisanen: folds 
matiko09: raises $1.27 to $2.27
Stibitzkie: raises $47.79 to $50.06 and is all-in
sebaaastian: folds 
matiko09: folds 
Uncalled bet ($47.79) returned to Stibitzkie
Stibitzkie collected $5.54 from pot
*** SUMMARY ***
Total pot $5.54 | Rake $0 
Seat 1: matiko09 (button) folded before Flop
Seat 2: Stibitzkie (small blind) collected ($5.54)
Seat 3: sebaaastian (big blind) folded before Flop
Seat 4: hammerwife folded before Flop (didn't bet)
Seat 5: djammusic folded before Flop (didn't bet)
Seat 7: forsmthgood folded before Flop (didn't bet)
Seat 9: waisanen folded before Flop (didn't bet)





PokerStars Hand #149393967162:  Hold'em No Limit ($0.50/$1.00 USD) - 2016/02/25 17:22:53 CET [2016/02/25 11:22:53 ET]
Table 'Eurysaces II' 9-max Seat #5 is the button
Seat 5: keessie93 ($64.52 in chips) 
Seat 7: $-Twackle-$ ($102 in chips) 
Seat 8: HomerrrJay ($100 in chips) 
Seat 9: matiko09 ($100 in chips) 
$-Twackle-$: posts small blind $0.50
HomerrrJay: posts big blind $1
Hujiafeng: sits out 
*** HOLE CARDS ***
Dealt to matiko09 [Qh Tc]
matiko09: raises $1.50 to $2.50
J0rmungund joins the table at seat #6 
lysandrafly joins the table at seat #1 
keessie93: folds 
sebaaastian joins the table at seat #2 
nickreason17 joins the table at seat #3 
$-Twackle-$: folds 
HomerrrJay: folds 
Uncalled bet ($1.50) returned to matiko09
matiko09 collected $2.50 from pot
matiko09: doesn't show hand 
*** SUMMARY ***
Total pot $2.50 | Rake $0 
Seat 5: keessie93 (button) folded before Flop (didn't bet)
Seat 7: $-Twackle-$ (small blind) folded before Flop
Seat 8: HomerrrJay (big blind) folded before Flop
Seat 9: matiko09 collected ($2.50)





PokerStars Hand #149393967740:  Hold'em No Limit ($0.50/$1.00 USD) - 2016/02/25 17:22:53 CET [2016/02/25 11:22:53 ET]
Table 'Nerthus II' 9-max Seat #9 is the button
Seat 1: DUkalisUA ($102.21 in chips) 
Seat 2: matiko09 ($216.79 in chips) 
Seat 3: simoniustin ($100 in chips) 
Seat 4: Ilov3NBA ($101.25 in chips) 
Seat 6: mycka86 ($136.24 in chips) 
Seat 7: Venomous100% ($116.11 in chips) 
Seat 8: Kelvin sai ($53.28 in chips) 
Seat 9: hammerwife ($102 in chips) 
DUkalisUA: posts small blind $0.50
matiko09: posts big blind $1
*** HOLE CARDS ***
Dealt to matiko09 [Jh Kc]
simoniustin: folds 
Ilov3NBA: folds 
mycka86: raises $2 to $3
Venomous100%: folds 
Kelvin sai: folds 
hammerwife: folds 
DUkalisUA: folds 
matiko09: folds 
Uncalled bet ($2) returned to mycka86
mycka86 collected $2.50 from pot
*** SUMMARY ***
Total pot $2.50 | Rake $0 
Seat 1: DUkalisUA (small blind) folded before Flop
Seat 2: matiko09 (big blind) folded before Flop
Seat 3: simoniustin folded before Flop (didn't bet)
Seat 4: Ilov3NBA folded before Flop (didn't bet)
Seat 6: mycka86 collected ($2.50)
Seat 7: Venomous100% folded before Flop (didn't bet)
Seat 8: Kelvin sai folded before Flop (didn't bet)
Seat 9: hammerwife (button) folded before Flop (didn't bet)





PokerStars Hand #149393973626:  Hold'em No Limit ($0.50/$1.00 USD) - 2016/02/25 17:23:01 CET [2016/02/25 11:23:01 ET]
Table 'Ebella II' 9-max Seat #1 is the button
Seat 1: nickreason17 ($102.96 in chips) 
Seat 3: fanmtZ ($40 in chips) 
Seat 5: matiko09 ($100 in chips) 
Seat 6: gabi_igna ($105.05 in chips) 
Seat 8: ZMPOUTSAM140 ($81.18 in chips) 
Seat 9: simoniustin ($113.63 in chips) 
fanmtZ: posts small blind $0.50
matiko09: posts big blind $1
$-Twackle-$: sits out 
*** HOLE CARDS ***
Dealt to matiko09 [3d 2h]
gabi_igna: folds 
ZMPOUTSAM140: folds 
simoniustin: folds 
nickreason17: raises $1.04 to $2.04
fanmtZ: folds 
matiko09: folds 
Uncalled bet ($1.04) returned to nickreason17
nickreason17 collected $2.50 from pot
*** SUMMARY ***
Total pot $2.50 | Rake $0 
Seat 1: nickreason17 (button) collected ($2.50)
Seat 3: fanmtZ (small blind) folded before Flop
Seat 5: matiko09 (big blind) folded before Flop
Seat 6: gabi_igna folded before Flop (didn't bet)
Seat 8: ZMPOUTSAM140 folded before Flop (didn't bet)
Seat 9: simoniustin folded before Flop (didn't bet)





PokerStars Hand #149393975883:  Hold'em No Limit ($0.50/$1.00 USD) - 2016/02/25 17:23:03 CET [2016/02/25 11:23:03 ET]
Table 'Sabine' 9-max Seat #8 is the button
Seat 1: Aalleekks ($100 in chips) 
Seat 2: apfush ($132.20 in chips) 
Seat 3: Ouga Buga ($111.06 in chips) 
Seat 5: Venomous100% ($108.54 in chips) 
Seat 6: ffac ($100 in chips) 
Seat 7: clayshmert ($77.76 in chips) 
Seat 8: matiko09 ($124.97 in chips) 
Seat 9: djammusic ($58.92 in chips) 
djammusic: posts small blind $0.50
Aalleekks: posts big blind $1
simoniustin: sits out 
*** HOLE CARDS ***
Dealt to matiko09 [Jh 2h]
apfush: folds 
Ouga Buga: folds 
Venomous100%: folds 
ffac: folds 
clayshmert: folds 
matiko09: folds 
djammusic: raises $1.50 to $2.50
Aalleekks: raises $7 to $9.50
djammusic: folds 
Uncalled bet ($7) returned to Aalleekks
Aalleekks collected $5 from pot
Aalleekks: doesn't show hand 
*** SUMMARY ***
Total pot $5 | Rake $0 
Seat 1: Aalleekks (big blind) collected ($5)
Seat 2: apfush folded before Flop (didn't bet)
Seat 3: Ouga Buga folded before Flop (didn't bet)
Seat 5: Venomous100% folded before Flop (didn't bet)
Seat 6: ffac folded before Flop (didn't bet)
Seat 7: clayshmert folded before Flop (didn't bet)
Seat 8: matiko09 (button) folded before Flop (didn't bet)
Seat 9: djammusic (small blind) folded before Flop





PokerStars Hand #149393979633:  Hold'em No Limit ($0.50/$1.00 USD) - 2016/02/25 17:23:08 CET [2016/02/25 11:23:08 ET]
Table 'Mayall II' 9-max Seat #4 is the button
Seat 1: matiko09 ($121.75 in chips) 
Seat 3: simoniustin ($100 in chips) 
Seat 4: Ouga Buga ($109.62 in chips) 
Seat 5: HomerrrJay ($100 in chips) 
Seat 6: apfush ($103.85 in chips) 
Seat 7: r.pol218 ($48.50 in chips) 
Seat 8: kuanhung0903 ($87.43 in chips) 
HomerrrJay: posts small blind $0.50
apfush: posts big blind $1
*** HOLE CARDS ***
Dealt to matiko09 [Qc 5d]
r.pol218: folds 
kuanhung0903: folds 
matiko09: folds 
simoniustin: folds 
Ouga Buga: folds 
HomerrrJay: folds 
Uncalled bet ($0.50) returned to apfush
apfush collected $1 from pot
apfush: doesn't show hand 
*** SUMMARY ***
Total pot $1 | Rake $0 
Seat 1: matiko09 folded before Flop (didn't bet)
Seat 3: simoniustin folded before Flop (didn't bet)
Seat 4: Ouga Buga (button) folded before Flop (didn't bet)
Seat 5: HomerrrJay (small blind) folded before Flop
Seat 6: apfush (big blind) collected ($1)
Seat 7: r.pol218 folded before Flop (didn't bet)
Seat 8: kuanhung0903 folded before Flop (didn't bet)





PokerStars Hand #149393981829:  Hold'em No Limit ($0.50/$1.00 USD) - 2016/02/25 17:23:11 CET [2016/02/25 11:23:11 ET]
Table 'Morosovia II' 9-max Seat #7 is the button
Seat 1: apfush ($194.58 in chips) 
Seat 2: Effort92 ($100 in chips) 
Seat 3: sebaaastian ($217.86 in chips) 
Seat 4: Venomous100% ($154.02 in chips) 
Seat 5: pimpoza ($57.97 in chips) 
Seat 7: matiko09 ($165.05 in chips) 
Seat 8: simoniustin ($126.36 in chips) 
Seat 9: Ouga Buga ($126.57 in chips) 
simoniustin: posts small blind $0.50
Ouga Buga: posts big blind $1
*** HOLE CARDS ***
Dealt to matiko09 [7d 2d]
apfush: folds 
Effort92: raises $2 to $3
sebaaastian: folds 
Venomous100%: folds 
pimpoza: calls $3
matiko09: folds 
simoniustin: folds 
Ouga Buga: folds 
*** FLOP *** [4s As 4h]
Effort92: bets $4.72
pimpoza: calls $4.72
*** TURN *** [4s As 4h] [5c]
Effort92: bets $12
pimpoza: calls $12
*** RIVER *** [4s As 4h 5c] [9s]
Effort92: bets $39
pimpoza: calls $38.25 and is all-in
Uncalled bet ($0.75) returned to Effort92
*** SHOW DOWN ***
Effort92: shows [Qc Ad] (two pair, Aces and Fours)
pimpoza: mucks hand 
Effort92 collected $114.64 from pot
*** SUMMARY ***
Total pot $117.44 | Rake $2.80 
Board [4s As 4h 5c 9s]
Seat 1: apfush folded before Flop (didn't bet)
Seat 2: Effort92 showed [Qc Ad] and won ($114.64) with two pair, Aces and Fours
Seat 3: sebaaastian folded before Flop (didn't bet)
Seat 4: Venomous100% folded before Flop (didn't bet)
Seat 5: pimpoza mucked [Ah 3s]
Seat 7: matiko09 (button) folded before Flop (didn't bet)
Seat 8: simoniustin (small blind) folded before Flop
Seat 9: Ouga Buga (big blind) folded before Flop





PokerStars Hand #149393982708:  Hold'em No Limit ($0.50/$1.00 USD) - 2016/02/25 17:23:12 CET [2016/02/25 11:23:12 ET]
Table 'Zeuxo II' 9-max Seat #9 is the button
Seat 1: forsmthgood ($109.79 in chips) 
Seat 4: sebaaastian ($108.61 in chips) 
Seat 6: Cogss ($99.30 in chips) 
Seat 7: djammusic ($50.50 in chips) 
Seat 8: matiko09 ($108.09 in chips) 
Seat 9: Sreshta222 ($200.64 in chips) 
forsmthgood: posts small blind $0.50
sebaaastian: posts big blind $1
*** HOLE CARDS ***
Dealt to matiko09 [8s 3h]
Cogss: folds 
djammusic: folds 
matiko09: folds 
Sreshta222: raises $1.09 to $2.09
forsmthgood: raises $5.41 to $7.50
sebaaastian: folds 
Sreshta222: folds 
Uncalled bet ($5.41) returned to forsmthgood
forsmthgood collected $5.18 from pot
forsmthgood: doesn't show hand 
*** SUMMARY ***
Total pot $5.18 | Rake $0 
Seat 1: forsmthgood (small blind) collected ($5.18)
Seat 4: sebaaastian (big blind) folded before Flop
Seat 6: Cogss folded before Flop (didn't bet)
Seat 7: djammusic folded before Flop (didn't bet)
Seat 8: matiko09 folded before Flop (didn't bet)
Seat 9: Sreshta222 (button) folded before Flop





PokerStars Hand #149393987544:  Hold'em No Limit ($0.50/$1.00 USD) - 2016/02/25 17:23:18 CET [2016/02/25 11:23:18 ET]
Table 'Isa' 9-max Seat #2 is the button
Seat 1: matiko09 ($124.58 in chips) 
Seat 2: mycka86 ($100 in chips) 
Seat 3: sebaaastian ($139.25 in chips) 
Seat 4: hammerwife ($108.91 in chips) 
Seat 7: bilukm ($99.28 in chips) 
Seat 8: Venomous100% ($109.03 in chips) 
Seat 9: HomerrrJay ($169.61 in chips) 
sebaaastian: posts small blind $0.50
hammerwife: posts big blind $1
*** HOLE CARDS ***
Dealt to matiko09 [Js Jc]
bilukm: folds 
Venomous100%: folds 
HomerrrJay: folds 
matiko09: raises $1.50 to $2.50
mycka86: folds 
sebaaastian: folds 
hammerwife: folds 
Uncalled bet ($1.50) returned to matiko09
matiko09 collected $2.50 from pot
matiko09: doesn't show hand 
*** SUMMARY ***
Total pot $2.50 | Rake $0 
Seat 1: matiko09 collected ($2.50)
Seat 2: mycka86 (button) folded before Flop (didn't bet)
Seat 3: sebaaastian (small blind) folded before Flop
Seat 4: hammerwife (big blind) folded before Flop
Seat 7: bilukm folded before Flop (didn't bet)
Seat 8: Venomous100% folded before Flop (didn't bet)
Seat 9: HomerrrJay folded before Flop (didn't bet)





PokerStars Hand #149393988747:  Hold'em No Limit ($0.50/$1.00 USD) - 2016/02/25 17:23:20 CET [2016/02/25 11:23:20 ET]
Table 'Badenia II' 9-max Seat #2 is the button
Seat 1: matiko09 ($100 in chips) 
Seat 2: Stibitzkie ($53.33 in chips) 
Seat 3: sebaaastian ($147.50 in chips) 
Seat 5: djammusic ($126.45 in chips) 
Seat 7: forsmthgood ($100 in chips) 
Seat 9: waisanen ($248.36 in chips) 
sebaaastian: posts small blind $0.50
hammerwife: is sitting out 
djammusic: posts big blind $1
*** HOLE CARDS ***
Dealt to matiko09 [2d 3h]
forsmthgood: folds 
waisanen: folds 
matiko09: folds 
Stibitzkie: calls $1
sebaaastian: folds 
djammusic: checks 
*** FLOP *** [2s Kh Td]
djammusic: checks 
Stibitzkie: bets $2.39
djammusic: folds 
Uncalled bet ($2.39) returned to Stibitzkie
Stibitzkie collected $2.39 from pot
*** SUMMARY ***
Total pot $2.50 | Rake $0.11 
Board [2s Kh Td]
Seat 1: matiko09 folded before Flop (didn't bet)
Seat 2: Stibitzkie (button) collected ($2.39)
Seat 3: sebaaastian (small blind) folded before Flop
Seat 5: djammusic (big blind) folded on the Flop
Seat 7: forsmthgood folded before Flop (didn't bet)
Seat 9: waisanen folded before Flop (didn't bet)





PokerStars Hand #149393991878:  Hold'em No Limit ($0.50/$1.00 USD) - 2016/02/25 17:23:24 CET [2016/02/25 11:23:24 ET]
Table 'Nerthus II' 9-max Seat #1 is the button
Seat 1: DUkalisUA ($101.71 in chips) 
Seat 2: matiko09 ($215.79 in chips) 
Seat 3: simoniustin ($100 in chips) 
Seat 4: Ilov3NBA ($101.25 in chips) 
Seat 6: mycka86 ($137.74 in chips) 
Seat 7: Venomous100% ($116.11 in chips) 
Seat 8: Kelvin sai ($53.28 in chips) 
Seat 9: hammerwife ($102 in chips) 
matiko09: posts small blind $0.50
simoniustin: posts big blind $1
*** HOLE CARDS ***
Dealt to matiko09 [As 6s]
Ilov3NBA: folds 
mycka86: folds 
Venomous100%: folds 
Kelvin sai: raises $1 to $2
hammerwife: folds 
DUkalisUA: folds 
matiko09: folds 
simoniustin: folds 
Uncalled bet ($1) returned to Kelvin sai
Kelvin sai collected $2.50 from pot
Kelvin sai: doesn't show hand 
*** SUMMARY ***
Total pot $2.50 | Rake $0 
Seat 1: DUkalisUA (button) folded before Flop (didn't bet)
Seat 2: matiko09 (small blind) folded before Flop
Seat 3: simoniustin (big blind) folded before Flop
Seat 4: Ilov3NBA folded before Flop (didn't bet)
Seat 6: mycka86 folded before Flop (didn't bet)
Seat 7: Venomous100% folded before Flop (didn't bet)
Seat 8: Kelvin sai collected ($2.50)
Seat 9: hammerwife folded before Flop (didn't bet)





PokerStars Hand #149393997042:  Hold'em No Limit ($0.50/$1.00 USD) - 2016/02/25 17:23:30 CET [2016/02/25 11:23:30 ET]
Table 'Eurysaces II' 9-max Seat #7 is the button
Seat 5: keessie93 ($64.52 in chips) 
Seat 6: J0rmungund ($40 in chips) 
Seat 7: $-Twackle-$ ($101.50 in chips) 
Seat 8: HomerrrJay ($100 in chips) 
Seat 9: matiko09 ($101.50 in chips) 
HomerrrJay: posts small blind $0.50
matiko09: posts big blind $1
lysandrafly: sits out 
sebaaastian: sits out 
nickreason17: sits out 
Hujiafeng: sits out 
J0rmungund: posts big blind $1
*** HOLE CARDS ***
Dealt to matiko09 [9s 5s]
keessie93: folds 
J0rmungund: checks 
$-Twackle-$: folds 
HomerrrJay: folds 
matiko09: checks 
*** FLOP *** [2d 7d 2s]
matiko09: checks 
J0rmungund: checks 
*** TURN *** [2d 7d 2s] [5d]
matiko09: bets $1
J0rmungund: folds 
Uncalled bet ($1) returned to matiko09
matiko09 collected $2.39 from pot
matiko09: doesn't show hand 
*** SUMMARY ***
Total pot $2.50 | Rake $0.11 
Board [2d 7d 2s 5d]
Seat 5: keessie93 folded before Flop (didn't bet)
Seat 6: J0rmungund folded on the Turn
Seat 7: $-Twackle-$ (button) folded before Flop (didn't bet)
Seat 8: HomerrrJay (small blind) folded before Flop
Seat 9: matiko09 (big blind) collected ($2.39)





PokerStars Hand #149393997148:  Hold'em No Limit ($0.50/$1.00 USD) - 2016/02/25 17:23:30 CET [2016/02/25 11:23:30 ET]
Table 'Ebella II' 9-max Seat #3 is the button
Seat 1: nickreason17 ($104.46 in chips) 
Seat 3: fanmtZ ($40 in chips) 
Seat 5: matiko09 ($100 in chips) 
Seat 6: gabi_igna ($105.05 in chips) 
Seat 8: ZMPOUTSAM140 ($81.18 in chips) 
Seat 9: simoniustin ($113.63 in chips) 
matiko09: posts small blind $0.50
gabi_igna: posts big blind $1
$-Twackle-$: sits out 
*** HOLE CARDS ***
Dealt to matiko09 [8s Kd]
ZMPOUTSAM140: folds 
simoniustin: folds 
nickreason17: folds 
fanmtZ: folds 
matiko09: raises $1.50 to $2.50
gabi_igna: folds 
Uncalled bet ($1.50) returned to matiko09
matiko09 collected $2 from pot
matiko09: doesn't show hand 
*** SUMMARY ***
Total pot $2 | Rake $0 
Seat 1: nickreason17 folded before Flop (didn't bet)
Seat 3: fanmtZ (button) folded before Flop (didn't bet)
Seat 5: matiko09 (small blind) collected ($2)
Seat 6: gabi_igna (big blind) folded before Flop
Seat 8: ZMPOUTSAM140 folded before Flop (didn't bet)
Seat 9: simoniustin folded before Flop (didn't bet)





PokerStars Hand #149393998120:  Hold'em No Limit ($0.50/$1.00 USD) - 2016/02/25 17:23:31 CET [2016/02/25 11:23:31 ET]
Table 'Hercules IV' 9-max Seat #3 is the button
Seat 1: matiko09 ($100 in chips) 
Seat 3: HomerrrJay ($100 in chips) 
Seat 6: kuanhung0903 ($58.89 in chips) 
Seat 7: Ouga Buga ($114.06 in chips) 
Seat 8: brokat77 ($124.39 in chips) 
Seat 9: djammusic ($47.89 in chips) 
kuanhung0903: posts small blind $0.50
Ouga Buga: posts big blind $1
simoniustin: sits out 
*** HOLE CARDS ***
Dealt to matiko09 [Js Qd]
brokat77: folds 
djammusic: folds 
matiko09: raises $1.50 to $2.50
HomerrrJay: raises $6.50 to $9
kuanhung0903: folds 
Ouga Buga: folds 
matiko09: folds 
Uncalled bet ($6.50) returned to HomerrrJay
HomerrrJay collected $6.50 from pot
HomerrrJay: doesn't show hand 
*** SUMMARY ***
Total pot $6.50 | Rake $0 
Seat 1: matiko09 folded before Flop
Seat 3: HomerrrJay (button) collected ($6.50)
Seat 6: kuanhung0903 (small blind) folded before Flop
Seat 7: Ouga Buga (big blind) folded before Flop
Seat 8: brokat77 folded before Flop (didn't bet)
Seat 9: djammusic folded before Flop (didn't bet)





PokerStars Hand #149394006668:  Hold'em No Limit ($0.50/$1.00 USD) - 2016/02/25 17:23:42 CET [2016/02/25 11:23:42 ET]
Table 'Zerbinetta II' 9-max Seat #5 is the button
Seat 2: lysandrafly ($100 in chips) 
Seat 3: matiko09 ($100 in chips) 
Seat 4: sebaaastian ($100 in chips) 
Seat 5: hammerwife ($100 in chips) 
Seat 6: nickreason17 ($107.27 in chips) 
Seat 7: HomerrrJay ($100 in chips) 
Seat 9: with-w ($53.73 in chips) 
nickreason17: posts small blind $0.50
HomerrrJay: posts big blind $1
gabi_igna: sits out 
$-Twackle-$: sits out 
*** HOLE CARDS ***
Dealt to matiko09 [Th Ts]
with-w: calls $1
lysandrafly: folds 
matiko09: raises $3 to $4
sebaaastian: folds 
hammerwife: raises $7.50 to $11.50
nickreason17: folds 
HomerrrJay: folds 
with-w: folds 
matiko09: calls $7.50
*** FLOP *** [8s 2s 2c]
matiko09: checks 
hammerwife: bets $12
matiko09: calls $12
*** TURN *** [8s 2s 2c] [2h]
matiko09: checks 
hammerwife: bets $21.50
matiko09: folds 
Uncalled bet ($21.50) returned to hammerwife
hammerwife collected $47.27 from pot
hammerwife: doesn't show hand 
*** SUMMARY ***
Total pot $49.50 | Rake $2.23 
Board [8s 2s 2c 2h]
Seat 2: lysandrafly folded before Flop (didn't bet)
Seat 3: matiko09 folded on the Turn
Seat 4: sebaaastian folded before Flop (didn't bet)
Seat 5: hammerwife (button) collected ($47.27)
Seat 6: nickreason17 (small blind) folded before Flop
Seat 7: HomerrrJay (big blind) folded before Flop
Seat 9: with-w folded before Flop





PokerStars Hand #149394009839:  Hold'em No Limit ($0.50/$1.00 USD) - 2016/02/25 17:23:46 CET [2016/02/25 11:23:46 ET]
Table 'Isa' 9-max Seat #3 is the button
Seat 1: matiko09 ($126.08 in chips) 
Seat 2: mycka86 ($100 in chips) 
Seat 3: sebaaastian ($138.75 in chips) 
Seat 4: hammerwife ($107.91 in chips) 
Seat 7: bilukm ($99.28 in chips) 
Seat 8: Venomous100% ($109.03 in chips) 
Seat 9: HomerrrJay ($169.61 in chips) 
hammerwife: posts small blind $0.50
bilukm: posts big blind $1
*** HOLE CARDS ***
Dealt to matiko09 [6s Th]
Venomous100%: folds 
HomerrrJay: raises $2 to $3
matiko09: folds 
mycka86: raises $6 to $9
sebaaastian: folds 
hammerwife: folds 
bilukm: calls $8
HomerrrJay: calls $6
*** FLOP *** [Qc Ts 9d]
bilukm: checks 
HomerrrJay: checks 
mycka86: checks 
*** TURN *** [Qc Ts 9d] [3c]
bilukm: checks 
HomerrrJay: checks 
mycka86: bets $15.50
bilukm: calls $15.50
HomerrrJay: folds 
*** RIVER *** [Qc Ts 9d 3c] [7c]
bilukm: checks 
mycka86: bets $30.72
bilukm: calls $30.72
*** SHOW DOWN ***
mycka86: shows [Ah Ac] (a pair of Aces)
bilukm: mucks hand 
mycka86 collected $117.14 from pot
*** SUMMARY ***
Total pot $119.94 | Rake $2.80 
Board [Qc Ts 9d 3c 7c]
Seat 1: matiko09 folded before Flop (didn't bet)
Seat 2: mycka86 showed [Ah Ac] and won ($117.14) with a pair of Aces
Seat 3: sebaaastian (button) folded before Flop (didn't bet)
Seat 4: hammerwife (small blind) folded before Flop
Seat 7: bilukm (big blind) mucked [8d 8c]
Seat 8: Venomous100% folded before Flop (didn't bet)
Seat 9: HomerrrJay folded on the Turn





PokerStars Hand #149394009625:  Hold'em No Limit ($0.50/$1.00 USD) - 2016/02/25 17:23:46 CET [2016/02/25 11:23:46 ET]
Table 'Zeuxo II' 9-max Seat #1 is the button
Seat 1: forsmthgood ($112.88 in chips) 
Seat 4: sebaaastian ($107.61 in chips) 
Seat 6: Cogss ($99.30 in chips) 
Seat 7: djammusic ($50.50 in chips) 
Seat 8: matiko09 ($108.09 in chips) 
Seat 9: Sreshta222 ($198.55 in chips) 
sebaaastian: posts small blind $0.50
Cogss: posts big blind $1
*** HOLE CARDS ***
Dealt to matiko09 [8c 9h]
djammusic: folds 
matiko09: folds 
Sreshta222: folds 
forsmthgood: folds 
sebaaastian: raises $2 to $3
Cogss: raises $5 to $8
sebaaastian: calls $5
*** FLOP *** [4h Qs 4s]
sebaaastian: checks 
Cogss: bets $15.28
sebaaastian: folds 
Uncalled bet ($15.28) returned to Cogss
Cogss collected $15.28 from pot
*** SUMMARY ***
Total pot $16 | Rake $0.72 
Board [4h Qs 4s]
Seat 1: forsmthgood (button) folded before Flop (didn't bet)
Seat 4: sebaaastian (small blind) folded on the Flop
Seat 6: Cogss (big blind) collected ($15.28)
Seat 7: djammusic folded before Flop (didn't bet)
Seat 8: matiko09 folded before Flop (didn't bet)
Seat 9: Sreshta222 folded before Flop (didn't bet)





PokerStars Hand #149394011756:  Hold'em No Limit ($0.50/$1.00 USD) - 2016/02/25 17:23:49 CET [2016/02/25 11:23:49 ET]
Table 'Ebella II' 9-max Seat #5 is the button
Seat 1: nickreason17 ($104.46 in chips) 
Seat 3: fanmtZ ($40 in chips) 
Seat 5: matiko09 ($101 in chips) 
Seat 6: gabi_igna ($104.05 in chips) 
Seat 7: $-Twackle-$ ($100 in chips) 
Seat 8: ZMPOUTSAM140 ($81.18 in chips) 
Seat 9: simoniustin ($113.63 in chips) 
gabi_igna: posts small blind $0.50
$-Twackle-$: posts big blind $1
*** HOLE CARDS ***
Dealt to matiko09 [Ts Th]
ZMPOUTSAM140: raises $2 to $3
simoniustin: folds 
nickreason17: calls $3
fanmtZ: folds 
matiko09: raises $9 to $12
gabi_igna: folds 
$-Twackle-$: folds 
ZMPOUTSAM140: raises $69.18 to $81.18 and is all-in
nickreason17: folds 
matiko09: folds 
Uncalled bet ($69.18) returned to ZMPOUTSAM140
ZMPOUTSAM140 collected $28.50 from pot
*** SUMMARY ***
Total pot $28.50 | Rake $0 
Seat 1: nickreason17 folded before Flop
Seat 3: fanmtZ folded before Flop (didn't bet)
Seat 5: matiko09 (button) folded before Flop
Seat 6: gabi_igna (small blind) folded before Flop
Seat 7: $-Twackle-$ (big blind) folded before Flop
Seat 8: ZMPOUTSAM140 collected ($28.50)
Seat 9: simoniustin folded before Flop (didn't bet)





PokerStars Hand #149394012838:  Hold'em No Limit ($0.25/$0.50 USD) - 2016/02/25 17:23:50 CET [2016/02/25 11:23:50 ET]
Table 'Lohja II' 9-max Seat #3 is the button
Seat 1: MoonJimmy ($137.18 in chips) 
Seat 3: guvalc1952 ($196.14 in chips) 
Seat 4: payback11 ($50 in chips) 
Seat 7: matiko09 ($119.14 in chips) 
Seat 8: jamba83 ($70.59 in chips) 
Seat 9: Al3xAnd3r22 ($99.81 in chips) 
payback11: posts small blind $0.25
111STAVR111: is sitting out 
111STAVR111 leaves the table
matiko09: posts big blind $0.50
MoonJimmy: posts the ante $0.10
guvalc1952: posts the ante $0.10
payback11: posts the ante $0.10
matiko09: posts the ante $0.10
jamba83: posts the ante $0.10
Al3xAnd3r22: posts the ante $0.10
*** HOLE CARDS ***
Dealt to matiko09 [4s 3c]
Effort92 joins the table at seat #5 
jamba83: folds 
Al3xAnd3r22: folds 
MoonJimmy: raises $1 to $1.50
guvalc1952: folds 
payback11: folds 
matiko09: folds 
Uncalled bet ($1) returned to MoonJimmy
MoonJimmy collected $1.85 from pot
MoonJimmy: doesn't show hand 
*** SUMMARY ***
Total pot $1.85 | Rake $0 
Seat 1: MoonJimmy collected ($1.85)
Seat 3: guvalc1952 (button) folded before Flop (didn't bet)
Seat 4: payback11 (small blind) folded before Flop
Seat 7: matiko09 (big blind) folded before Flop
Seat 8: jamba83 folded before Flop (didn't bet)
Seat 9: Al3xAnd3r22 folded before Flop (didn't bet)





PokerStars Hand #149394013855:  Hold'em No Limit ($0.50/$1.00 USD) - 2016/02/25 17:23:51 CET [2016/02/25 11:23:51 ET]
Table 'Badenia II' 9-max Seat #3 is the button
Seat 1: matiko09 ($100 in chips) 
Seat 2: Stibitzkie ($54.72 in chips) 
Seat 3: sebaaastian ($147 in chips) 
Seat 5: djammusic ($125.45 in chips) 
Seat 7: forsmthgood ($100 in chips) 
Seat 9: waisanen ($248.36 in chips) 
djammusic: posts small blind $0.50
forsmthgood: posts big blind $1
*** HOLE CARDS ***
Dealt to matiko09 [Jh Ad]
waisanen: folds 
matiko09: raises $2 to $3
Stibitzkie: calls $3
sebaaastian: folds 
djammusic: calls $2.50
forsmthgood: folds 
*** FLOP *** [8d 6h Qc]
djammusic: checks 
matiko09: checks 
Stibitzkie: bets $9.55
djammusic: folds 
matiko09: folds 
Uncalled bet ($9.55) returned to Stibitzkie
Stibitzkie collected $9.55 from pot
*** SUMMARY ***
Total pot $10 | Rake $0.45 
Board [8d 6h Qc]
Seat 1: matiko09 folded on the Flop
Seat 2: Stibitzkie collected ($9.55)
Seat 3: sebaaastian (button) folded before Flop (didn't bet)
Seat 5: djammusic (small blind) folded on the Flop
Seat 7: forsmthgood (big blind) folded before Flop
Seat 9: waisanen folded before Flop (didn't bet)





PokerStars Hand #149394015588:  Hold'em No Limit ($0.50/$1.00 USD) - 2016/02/25 17:23:54 CET [2016/02/25 11:23:54 ET]
Table 'Mayall II' 9-max Seat #5 is the button
Seat 1: matiko09 ($121.75 in chips) 
Seat 3: simoniustin ($100 in chips) 
Seat 4: Ouga Buga ($109.62 in chips) 
Seat 5: HomerrrJay ($100 in chips) 
Seat 6: apfush ($104.35 in chips) 
Seat 7: r.pol218 ($48.50 in chips) 
Seat 8: kuanhung0903 ($87.43 in chips) 
apfush: posts small blind $0.50
r.pol218: posts big blind $1
*** HOLE CARDS ***
Dealt to matiko09 [7d As]
kuanhung0903: calls $1
matiko09: folds 
simoniustin: folds 
Ouga Buga: folds 
HomerrrJay: folds 
apfush: raises $4 to $5
r.pol218: calls $4
kuanhung0903: calls $4
*** FLOP *** [4d 2d 2s]
apfush: bets $9.50
r.pol218: folds 
kuanhung0903: folds 
Uncalled bet ($9.50) returned to apfush
apfush collected $14.32 from pot
apfush: doesn't show hand 
*** SUMMARY ***
Total pot $15 | Rake $0.68 
Board [4d 2d 2s]
Seat 1: matiko09 folded before Flop (didn't bet)
Seat 3: simoniustin folded before Flop (didn't bet)
Seat 4: Ouga Buga folded before Flop (didn't bet)
Seat 5: HomerrrJay (button) folded before Flop (didn't bet)
Seat 6: apfush (small blind) collected ($14.32)
Seat 7: r.pol218 (big blind) folded on the Flop
Seat 8: kuanhung0903 folded on the Flop





PokerStars Hand #149394025924:  Hold'em No Limit ($0.50/$1.00 USD) - 2016/02/25 17:24:07 CET [2016/02/25 11:24:07 ET]
Table 'Sabine' 9-max Seat #9 is the button
Seat 1: Aalleekks ($102.50 in chips) 
Seat 2: apfush ($132.20 in chips) 
Seat 3: Ouga Buga ($111.06 in chips) 
Seat 5: Venomous100% ($108.54 in chips) 
Seat 6: ffac ($100 in chips) 
Seat 7: clayshmert ($77.76 in chips) 
Seat 8: matiko09 ($124.97 in chips) 
Seat 9: djammusic ($56.42 in chips) 
Aalleekks: posts small blind $0.50
apfush: posts big blind $1
simoniustin: sits out 
*** HOLE CARDS ***
Dealt to matiko09 [7h 8c]
Ouga Buga: folds 
Venomous100%: folds 
ffac: raises $2 to $3
clayshmert: folds 
matiko09: folds 
djammusic: folds 
Aalleekks: calls $2.50
apfush: folds 
*** FLOP *** [Ac Ks Tc]
Aalleekks: checks 
ffac: checks 
*** TURN *** [Ac Ks Tc] [5h]
Aalleekks: checks 
ffac: checks 
*** RIVER *** [Ac Ks Tc 5h] [2c]
Aalleekks: checks 
ffac: checks 
*** SHOW DOWN ***
Aalleekks: shows [4c 4h] (a pair of Fours)
ffac: shows [Jh Js] (a pair of Jacks)
ffac collected $6.68 from pot
*** SUMMARY ***
Total pot $7 | Rake $0.32 
Board [Ac Ks Tc 5h 2c]
Seat 1: Aalleekks (small blind) showed [4c 4h] and lost with a pair of Fours
Seat 2: apfush (big blind) folded before Flop
Seat 3: Ouga Buga folded before Flop (didn't bet)
Seat 5: Venomous100% folded before Flop (didn't bet)
Seat 6: ffac showed [Jh Js] and won ($6.68) with a pair of Jacks
Seat 7: clayshmert folded before Flop (didn't bet)
Seat 8: matiko09 folded before Flop (didn't bet)
Seat 9: djammusic (button) folded before Flop (didn't bet)





PokerStars Hand #149394026095:  Hold'em No Limit ($0.50/$1.00 USD) - 2016/02/25 17:24:07 CET [2016/02/25 11:24:07 ET]
Table 'Nerthus II' 9-max Seat #2 is the button
Seat 1: DUkalisUA ($101.71 in chips) 
Seat 2: matiko09 ($215.29 in chips) 
Seat 3: simoniustin ($100 in chips) 
Seat 4: Ilov3NBA ($101.25 in chips) 
Seat 6: mycka86 ($137.74 in chips) 
Seat 7: Venomous100% ($116.11 in chips) 
Seat 8: Kelvin sai ($54.78 in chips) 
Seat 9: hammerwife ($102 in chips) 
simoniustin: posts small blind $0.50
Ilov3NBA: posts big blind $1
*** HOLE CARDS ***
Dealt to matiko09 [Qs 3c]
mycka86: raises $2 to $3
Venomous100%: folds 
Kelvin sai: folds 
hammerwife: folds 
DUkalisUA: folds 
matiko09: folds 
simoniustin: folds 
Ilov3NBA: folds 
Uncalled bet ($2) returned to mycka86
mycka86 collected $2.50 from pot
*** SUMMARY ***
Total pot $2.50 | Rake $0 
Seat 1: DUkalisUA folded before Flop (didn't bet)
Seat 2: matiko09 (button) folded before Flop (didn't bet)
Seat 3: simoniustin (small blind) folded before Flop
Seat 4: Ilov3NBA (big blind) folded before Flop
Seat 6: mycka86 collected ($2.50)
Seat 7: Venomous100% folded before Flop (didn't bet)
Seat 8: Kelvin sai folded before Flop (didn't bet)
Seat 9: hammerwife folded before Flop (didn't bet)





PokerStars Hand #149394039986:  Hold'em No Limit ($0.50/$1.00 USD) - 2016/02/25 17:24:24 CET [2016/02/25 11:24:24 ET]
Table 'Zeuxo II' 9-max Seat #4 is the button
Seat 1: forsmthgood ($112.88 in chips) 
Seat 4: sebaaastian ($100 in chips) 
Seat 6: Cogss ($106.58 in chips) 
Seat 7: djammusic ($50.50 in chips) 
Seat 8: matiko09 ($108.09 in chips) 
Seat 9: Sreshta222 ($198.55 in chips) 
Cogss: posts small blind $0.50
djammusic: posts big blind $1
*** HOLE CARDS ***
Dealt to matiko09 [9c Jd]
matiko09: folds 
Sreshta222: folds 
forsmthgood: raises $1.50 to $2.50
sebaaastian: folds 
Cogss: folds 
djammusic: folds 
Uncalled bet ($1.50) returned to forsmthgood
forsmthgood collected $2.50 from pot
forsmthgood: doesn't show hand 
*** SUMMARY ***
Total pot $2.50 | Rake $0 
Seat 1: forsmthgood collected ($2.50)
Seat 4: sebaaastian (button) folded before Flop (didn't bet)
Seat 6: Cogss (small blind) folded before Flop
Seat 7: djammusic (big blind) folded before Flop
Seat 8: matiko09 folded before Flop (didn't bet)
Seat 9: Sreshta222 folded before Flop (didn't bet)





PokerStars Hand #149394041902:  Hold'em No Limit ($0.50/$1.00 USD) - 2016/02/25 17:24:27 CET [2016/02/25 11:24:27 ET]
Table 'Hercules IV' 9-max Seat #6 is the button
Seat 1: matiko09 ($100 in chips) 
Seat 3: HomerrrJay ($104 in chips) 
Seat 6: kuanhung0903 ($58.39 in chips) 
Seat 7: Ouga Buga ($113.06 in chips) 
Seat 8: brokat77 ($124.39 in chips) 
Seat 9: djammusic ($47.89 in chips) 
Ouga Buga: posts small blind $0.50
brokat77: posts big blind $1
simoniustin: sits out 
*** HOLE CARDS ***
Dealt to matiko09 [7h 3d]
djammusic: folds 
matiko09: folds 
HomerrrJay: raises $2 to $3
kuanhung0903: calls $3
Ouga Buga: folds 
brokat77: folds 
*** FLOP *** [Ad 8s Td]
HomerrrJay: bets $5.37
kuanhung0903: calls $5.37
*** TURN *** [Ad 8s Td] [2s]
HomerrrJay: checks 
kuanhung0903: bets $9
HomerrrJay: raises $86.63 to $95.63 and is all-in
kuanhung0903: folds 
Uncalled bet ($86.63) returned to HomerrrJay
HomerrrJay collected $34.61 from pot
HomerrrJay: doesn't show hand 
*** SUMMARY ***
Total pot $36.24 | Rake $1.63 
Board [Ad 8s Td 2s]
Seat 1: matiko09 folded before Flop (didn't bet)
Seat 3: HomerrrJay collected ($34.61)
Seat 6: kuanhung0903 (button) folded on the Turn
Seat 7: Ouga Buga (small blind) folded before Flop
Seat 8: brokat77 (big blind) folded before Flop
Seat 9: djammusic folded before Flop (didn't bet)





PokerStars Hand #149394041955:  Hold'em No Limit ($0.50/$1.00 USD) - 2016/02/25 17:24:27 CET [2016/02/25 11:24:27 ET]
Table 'Morosovia II' 9-max Seat #8 is the button
Seat 1: apfush ($194.58 in chips) 
Seat 2: Effort92 ($156.67 in chips) 
Seat 3: sebaaastian ($217.86 in chips) 
Seat 4: Venomous100% ($154.02 in chips) 
Seat 7: matiko09 ($165.05 in chips) 
Seat 8: simoniustin ($125.86 in chips) 
Seat 9: Ouga Buga ($125.57 in chips) 
Ouga Buga: posts small blind $0.50
apfush: posts big blind $1
*** HOLE CARDS ***
Dealt to matiko09 [Kc Jc]
Effort92: folds 
sebaaastian: folds 
Venomous100%: folds 
matiko09: raises $1.50 to $2.50
simoniustin: folds 
Ouga Buga: folds 
apfush: folds 
Uncalled bet ($1.50) returned to matiko09
matiko09 collected $2.50 from pot
matiko09: doesn't show hand 
*** SUMMARY ***
Total pot $2.50 | Rake $0 
Seat 1: apfush (big blind) folded before Flop
Seat 2: Effort92 folded before Flop (didn't bet)
Seat 3: sebaaastian folded before Flop (didn't bet)
Seat 4: Venomous100% folded before Flop (didn't bet)
Seat 7: matiko09 collected ($2.50)
Seat 8: simoniustin (button) folded before Flop (didn't bet)
Seat 9: Ouga Buga (small blind) folded before Flop





PokerStars Hand #149394048327:  Hold'em No Limit ($0.25/$0.50 USD) - 2016/02/25 17:24:35 CET [2016/02/25 11:24:35 ET]
Table 'Lohja II' 9-max Seat #4 is the button
Seat 1: MoonJimmy ($138.43 in chips) 
Seat 3: guvalc1952 ($196.04 in chips) 
Seat 4: payback11 ($50 in chips) 
Seat 7: matiko09 ($118.54 in chips) 
Seat 8: jamba83 ($70.49 in chips) 
Seat 9: Al3xAnd3r22 ($99.71 in chips) 
Effort92 will be allowed to play after the button
matiko09: posts small blind $0.25
jamba83: posts big blind $0.50
MoonJimmy: posts the ante $0.10
guvalc1952: posts the ante $0.10
payback11: posts the ante $0.10
matiko09: posts the ante $0.10
jamba83: posts the ante $0.10
Al3xAnd3r22: posts the ante $0.10
*** HOLE CARDS ***
Dealt to matiko09 [4c Ac]
Al3xAnd3r22: folds 
MoonJimmy: folds 
guvalc1952: calls $0.50
payback11: raises $1.50 to $2
matiko09: raises $4.50 to $6.50
jamba83: folds 
guvalc1952: folds 
payback11: folds 
Uncalled bet ($4.50) returned to matiko09
matiko09 collected $5.60 from pot
matiko09: doesn't show hand 
*** SUMMARY ***
Total pot $5.60 | Rake $0 
Seat 1: MoonJimmy folded before Flop (didn't bet)
Seat 3: guvalc1952 folded before Flop
Seat 4: payback11 (button) folded before Flop
Seat 7: matiko09 (small blind) collected ($5.60)
Seat 8: jamba83 (big blind) folded before Flop
Seat 9: Al3xAnd3r22 folded before Flop (didn't bet)





PokerStars Hand #149394055038:  Hold'em No Limit ($0.50/$1.00 USD) - 2016/02/25 17:24:44 CET [2016/02/25 11:24:44 ET]
Table 'Nerthus II' 9-max Seat #3 is the button
Seat 1: DUkalisUA ($101.71 in chips) 
Seat 2: matiko09 ($215.29 in chips) 
Seat 3: simoniustin ($100 in chips) 
Seat 4: Ilov3NBA ($100.25 in chips) 
Seat 6: mycka86 ($139.24 in chips) 
Seat 7: Venomous100% ($116.11 in chips) 
Seat 8: Kelvin sai ($54.78 in chips) 
Seat 9: hammerwife ($102 in chips) 
Ilov3NBA: posts small blind $0.50
mycka86: posts big blind $1
*** HOLE CARDS ***
Dealt to matiko09 [Kc 2s]
Venomous100%: folds 
Kelvin sai: raises $1 to $2
hammerwife: folds 
DUkalisUA: folds 
matiko09: folds 
simoniustin: folds 
Ilov3NBA: folds 
mycka86: calls $1
*** FLOP *** [3c Ks Qd]
mycka86: checks 
Kelvin sai: checks 
*** TURN *** [3c Ks Qd] [8s]
mycka86: checks 
Kelvin sai: bets $2
mycka86: folds 
Uncalled bet ($2) returned to Kelvin sai
Kelvin sai collected $4.30 from pot
Kelvin sai: doesn't show hand 
*** SUMMARY ***
Total pot $4.50 | Rake $0.20 
Board [3c Ks Qd 8s]
Seat 1: DUkalisUA folded before Flop (didn't bet)
Seat 2: matiko09 folded before Flop (didn't bet)
Seat 3: simoniustin (button) folded before Flop (didn't bet)
Seat 4: Ilov3NBA (small blind) folded before Flop
Seat 6: mycka86 (big blind) folded on the Turn
Seat 7: Venomous100% folded before Flop (didn't bet)
Seat 8: Kelvin sai collected ($4.30)
Seat 9: hammerwife folded before Flop (didn't bet)





PokerStars Hand #149394061407:  Hold'em No Limit ($0.50/$1.00 USD) - 2016/02/25 17:24:52 CET [2016/02/25 11:24:52 ET]
Table 'Eurysaces II' 9-max Seat #8 is the button
Seat 1: lysandrafly ($100 in chips) 
Seat 5: keessie93 ($64.52 in chips) 
Seat 6: J0rmungund ($39 in chips) 
Seat 7: $-Twackle-$ ($101.50 in chips) 
Seat 8: HomerrrJay ($100 in chips) 
Seat 9: matiko09 ($102.89 in chips) 
matiko09: posts small blind $0.50
lysandrafly: posts big blind $1
sebaaastian: sits out 
nickreason17: sits out 
Hujiafeng: sits out 
*** HOLE CARDS ***
Dealt to matiko09 [4h 5c]
keessie93: folds 
J0rmungund: folds 
$-Twackle-$: folds 
HomerrrJay: folds 
matiko09: folds 
Uncalled bet ($0.50) returned to lysandrafly
lysandrafly collected $1 from pot
lysandrafly: doesn't show hand 
*** SUMMARY ***
Total pot $1 | Rake $0 
Seat 1: lysandrafly (big blind) collected ($1)
Seat 5: keessie93 folded before Flop (didn't bet)
Seat 6: J0rmungund folded before Flop (didn't bet)
Seat 7: $-Twackle-$ folded before Flop (didn't bet)
Seat 8: HomerrrJay (button) folded before Flop (didn't bet)
Seat 9: matiko09 (small blind) folded before Flop





PokerStars Hand #149394063077:  Hold'em No Limit ($0.50/$1.00 USD) - 2016/02/25 17:24:54 CET [2016/02/25 11:24:54 ET]
Table 'Zeuxo II' 9-max Seat #6 is the button
Seat 1: forsmthgood ($114.38 in chips) 
Seat 4: sebaaastian ($100 in chips) 
Seat 6: Cogss ($106.08 in chips) 
Seat 7: djammusic ($49.50 in chips) 
Seat 8: matiko09 ($108.09 in chips) 
Seat 9: Sreshta222 ($198.55 in chips) 
djammusic: posts small blind $0.50
matiko09: posts big blind $1
hammerwife: sits out 
*** HOLE CARDS ***
Dealt to matiko09 [6s 7d]
Sreshta222: folds 
forsmthgood: folds 
sebaaastian: folds 
Cogss: raises $1 to $2
djammusic: folds 
matiko09: folds 
Uncalled bet ($1) returned to Cogss
Cogss collected $2.50 from pot
*** SUMMARY ***
Total pot $2.50 | Rake $0 
Seat 1: forsmthgood folded before Flop (didn't bet)
Seat 4: sebaaastian folded before Flop (didn't bet)
Seat 6: Cogss (button) collected ($2.50)
Seat 7: djammusic (small blind) folded before Flop
Seat 8: matiko09 (big blind) folded before Flop
Seat 9: Sreshta222 folded before Flop (didn't bet)





PokerStars Hand #149394064671:  Hold'em No Limit ($0.50/$1.00 USD) - 2016/02/25 17:24:56 CET [2016/02/25 11:24:56 ET]
Table 'Badenia II' 9-max Seat #5 is the button
Seat 1: matiko09 ($100 in chips) 
Seat 2: Stibitzkie ($61.27 in chips) 
Seat 3: sebaaastian ($147 in chips) 
Seat 5: djammusic ($122.45 in chips) 
Seat 7: forsmthgood ($100 in chips) 
Seat 9: waisanen ($248.36 in chips) 
forsmthgood: posts small blind $0.50
waisanen: posts big blind $1
hammerwife: sits out 
*** HOLE CARDS ***
Dealt to matiko09 [4d Qs]
matiko09: folds 
Stibitzkie: folds 
sebaaastian: folds 
djammusic: raises $1.02 to $2.02
forsmthgood: calls $1.52
waisanen: folds 
*** FLOP *** [9s 5h Kc]
forsmthgood: checks 
djammusic: checks 
*** TURN *** [9s 5h Kc] [2c]
forsmthgood: bets $3.27
djammusic: folds 
Uncalled bet ($3.27) returned to forsmthgood
forsmthgood collected $4.81 from pot
forsmthgood: doesn't show hand 
*** SUMMARY ***
Total pot $5.04 | Rake $0.23 
Board [9s 5h Kc 2c]
Seat 1: matiko09 folded before Flop (didn't bet)
Seat 2: Stibitzkie folded before Flop (didn't bet)
Seat 3: sebaaastian folded before Flop (didn't bet)
Seat 5: djammusic (button) folded on the Turn
Seat 7: forsmthgood (small blind) collected ($4.81)
Seat 9: waisanen (big blind) folded before Flop





PokerStars Hand #149394073547:  Hold'em No Limit ($0.50/$1.00 USD) - 2016/02/25 17:25:07 CET [2016/02/25 11:25:07 ET]
Table 'Ebella II' 9-max Seat #6 is the button
Seat 1: nickreason17 ($101.46 in chips) 
Seat 3: fanmtZ ($40 in chips) 
Seat 5: matiko09 ($100 in chips) 
Seat 6: gabi_igna ($103.55 in chips) 
Seat 7: $-Twackle-$ ($100 in chips) 
Seat 8: ZMPOUTSAM140 ($97.68 in chips) 
Seat 9: simoniustin ($113.63 in chips) 
$-Twackle-$: posts small blind $0.50
ZMPOUTSAM140: posts big blind $1
*** HOLE CARDS ***
Dealt to matiko09 [Td 6d]
simoniustin: folds 
nickreason17: raises $2 to $3
fanmtZ: folds 
matiko09: folds 
gabi_igna: folds 
$-Twackle-$: folds 
ZMPOUTSAM140: folds 
Uncalled bet ($2) returned to nickreason17
nickreason17 collected $2.50 from pot
*** SUMMARY ***
Total pot $2.50 | Rake $0 
Seat 1: nickreason17 collected ($2.50)
Seat 3: fanmtZ folded before Flop (didn't bet)
Seat 5: matiko09 folded before Flop (didn't bet)
Seat 6: gabi_igna (button) folded before Flop (didn't bet)
Seat 7: $-Twackle-$ (small blind) folded before Flop
Seat 8: ZMPOUTSAM140 (big blind) folded before Flop
Seat 9: simoniustin folded before Flop (didn't bet)





PokerStars Hand #149394074427:  Hold'em No Limit ($0.50/$1.00 USD) - 2016/02/25 17:25:08 CET [2016/02/25 11:25:08 ET]
Table 'Mayall II' 9-max Seat #6 is the button
Seat 1: matiko09 ($121.75 in chips) 
Seat 3: simoniustin ($100 in chips) 
Seat 4: Ouga Buga ($109.62 in chips) 
Seat 5: HomerrrJay ($100 in chips) 
Seat 6: apfush ($113.67 in chips) 
Seat 7: r.pol218 ($43.50 in chips) 
Seat 8: kuanhung0903 ($82.43 in chips) 
r.pol218: posts small blind $0.50
kuanhung0903: posts big blind $1
*** HOLE CARDS ***
Dealt to matiko09 [Th Jd]
matiko09: folds 
simoniustin: folds 
Ouga Buga: folds 
HomerrrJay: raises $2 to $3
apfush: folds 
r.pol218: folds 
kuanhung0903: folds 
Uncalled bet ($2) returned to HomerrrJay
HomerrrJay collected $2.50 from pot
HomerrrJay: doesn't show hand 
*** SUMMARY ***
Total pot $2.50 | Rake $0 
Seat 1: matiko09 folded before Flop (didn't bet)
Seat 3: simoniustin folded before Flop (didn't bet)
Seat 4: Ouga Buga folded before Flop (didn't bet)
Seat 5: HomerrrJay collected ($2.50)
Seat 6: apfush (button) folded before Flop (didn't bet)
Seat 7: r.pol218 (small blind) folded before Flop
Seat 8: kuanhung0903 (big blind) folded before Flop





PokerStars Hand #149394077381:  Hold'em No Limit ($0.50/$1.00 USD) - 2016/02/25 17:25:12 CET [2016/02/25 11:25:12 ET]
Table 'Morosovia II' 9-max Seat #9 is the button
Seat 1: apfush ($193.58 in chips) 
Seat 2: Effort92 ($156.67 in chips) 
Seat 3: sebaaastian ($217.86 in chips) 
Seat 4: Venomous100% ($154.02 in chips) 
Seat 7: matiko09 ($166.55 in chips) 
Seat 8: simoniustin ($125.86 in chips) 
Seat 9: Ouga Buga ($125.07 in chips) 
apfush: posts small blind $0.50
Effort92: posts big blind $1
*** HOLE CARDS ***
Dealt to matiko09 [Td 8h]
sebaaastian: folds 
Venomous100%: folds 
matiko09: folds 
simoniustin: folds 
Ouga Buga: folds 
apfush: folds 
Uncalled bet ($0.50) returned to Effort92
Effort92 collected $1 from pot
Effort92: doesn't show hand 
*** SUMMARY ***
Total pot $1 | Rake $0 
Seat 1: apfush (small blind) folded before Flop
Seat 2: Effort92 (big blind) collected ($1)
Seat 3: sebaaastian folded before Flop (didn't bet)
Seat 4: Venomous100% folded before Flop (didn't bet)
Seat 7: matiko09 folded before Flop (didn't bet)
Seat 8: simoniustin folded before Flop (didn't bet)
Seat 9: Ouga Buga (button) folded before Flop (didn't bet)





PokerStars Hand #149394082284:  Hold'em No Limit ($0.50/$1.00 USD) - 2016/02/25 17:25:18 CET [2016/02/25 11:25:18 ET]
Table 'Zeuxo II' 9-max Seat #7 is the button
Seat 1: forsmthgood ($114.38 in chips) 
Seat 4: sebaaastian ($100 in chips) 
Seat 6: Cogss ($107.58 in chips) 
Seat 7: djammusic ($49 in chips) 
Seat 8: matiko09 ($107.09 in chips) 
Seat 9: Sreshta222 ($198.55 in chips) 
matiko09: posts small blind $0.50
Sreshta222: posts big blind $1
hammerwife: sits out 
*** HOLE CARDS ***
Dealt to matiko09 [Kc 5d]
forsmthgood: folds 
sebaaastian: folds 
Cogss: raises $1 to $2
djammusic: folds 
matiko09: folds 
Sreshta222: folds 
Uncalled bet ($1) returned to Cogss
Cogss collected $2.50 from pot
*** SUMMARY ***
Total pot $2.50 | Rake $0 
Seat 1: forsmthgood folded before Flop (didn't bet)
Seat 4: sebaaastian folded before Flop (didn't bet)
Seat 6: Cogss collected ($2.50)
Seat 7: djammusic (button) folded before Flop (didn't bet)
Seat 8: matiko09 (small blind) folded before Flop
Seat 9: Sreshta222 (big blind) folded before Flop





PokerStars Hand #149394084576:  Hold'em No Limit ($0.25/$0.50 USD) - 2016/02/25 17:25:21 CET [2016/02/25 11:25:21 ET]
Table 'Lohja II' 9-max Seat #7 is the button
Seat 1: MoonJimmy ($138.33 in chips) 
Seat 3: guvalc1952 ($195.44 in chips) 
Seat 4: payback11 ($50 in chips) 
Seat 7: matiko09 ($122.04 in chips) 
Seat 8: jamba83 ($69.89 in chips) 
Seat 9: Al3xAnd3r22 ($99.61 in chips) 
jamba83: posts small blind $0.25
Al3xAnd3r22: posts big blind $0.50
Effort92: sits out 
MoonJimmy: posts the ante $0.10
guvalc1952: posts the ante $0.10
payback11: posts the ante $0.10
matiko09: posts the ante $0.10
jamba83: posts the ante $0.10
Al3xAnd3r22: posts the ante $0.10
*** HOLE CARDS ***
Dealt to matiko09 [5h Kc]
MoonJimmy: folds 
guvalc1952: calls $0.50
payback11: raises $1.50 to $2
matiko09: folds 
jamba83: folds 
Al3xAnd3r22: folds 
guvalc1952: calls $1.50
*** FLOP *** [2c Qh 6d]
guvalc1952: checks 
payback11: bets $3.37
guvalc1952: calls $3.37
*** TURN *** [2c Qh 6d] [4c]
guvalc1952: checks 
payback11: bets $6
guvalc1952: calls $6
*** RIVER *** [2c Qh 6d 4c] [9h]
guvalc1952: checks 
payback11: bets $9
guvalc1952: calls $9
*** SHOW DOWN ***
payback11: shows [Qc Ts] (a pair of Queens)
guvalc1952: shows [Ks Qd] (a pair of Queens - King kicker)
guvalc1952 collected $40.20 from pot
*** SUMMARY ***
Total pot $42.09 | Rake $1.89 
Board [2c Qh 6d 4c 9h]
Seat 1: MoonJimmy folded before Flop (didn't bet)
Seat 3: guvalc1952 showed [Ks Qd] and won ($40.20) with a pair of Queens
Seat 4: payback11 showed [Qc Ts] and lost with a pair of Queens
Seat 7: matiko09 (button) folded before Flop (didn't bet)
Seat 8: jamba83 (small blind) folded before Flop
Seat 9: Al3xAnd3r22 (big blind) folded before Flop





PokerStars Hand #149394088929:  Hold'em No Limit ($0.50/$1.00 USD) - 2016/02/25 17:25:26 CET [2016/02/25 11:25:26 ET]
Table 'Eurysaces II' 9-max Seat #9 is the button
Seat 1: lysandrafly ($100.50 in chips) 
Seat 2: sebaaastian ($100 in chips) 
Seat 5: keessie93 ($64.52 in chips) 
Seat 6: J0rmungund ($39 in chips) 
Seat 7: $-Twackle-$ ($101.50 in chips) 
Seat 8: HomerrrJay ($100 in chips) 
Seat 9: matiko09 ($102.39 in chips) 
lysandrafly: posts small blind $0.50
sebaaastian: posts big blind $1
nickreason17: sits out 
Hujiafeng: sits out 
*** HOLE CARDS ***
Dealt to matiko09 [Jc 4c]
keessie93: raises $2 to $3
J0rmungund: folds 
$-Twackle-$: folds 
HomerrrJay: folds 
matiko09: folds 
lysandrafly: folds 
sebaaastian: folds 
Uncalled bet ($2) returned to keessie93
keessie93 collected $2.50 from pot
keessie93: doesn't show hand 
*** SUMMARY ***
Total pot $2.50 | Rake $0 
Seat 1: lysandrafly (small blind) folded before Flop
Seat 2: sebaaastian (big blind) folded before Flop
Seat 5: keessie93 collected ($2.50)
Seat 6: J0rmungund folded before Flop (didn't bet)
Seat 7: $-Twackle-$ folded before Flop (didn't bet)
Seat 8: HomerrrJay folded before Flop (didn't bet)
Seat 9: matiko09 (button) folded before Flop (didn't bet)





PokerStars Hand #149394088361:  Hold'em No Limit ($0.50/$1.00 USD) - 2016/02/25 17:25:26 CET [2016/02/25 11:25:26 ET]
Table 'Ebella II' 9-max Seat #7 is the button
Seat 1: nickreason17 ($102.96 in chips) 
Seat 3: fanmtZ ($40 in chips) 
Seat 5: matiko09 ($100 in chips) 
Seat 6: gabi_igna ($103.55 in chips) 
Seat 7: $-Twackle-$ ($100 in chips) 
Seat 8: ZMPOUTSAM140 ($96.68 in chips) 
Seat 9: simoniustin ($113.63 in chips) 
ZMPOUTSAM140: posts small blind $0.50
simoniustin: posts big blind $1
*** HOLE CARDS ***
Dealt to matiko09 [8c 3d]
nickreason17: folds 
fanmtZ: folds 
matiko09: folds 
gabi_igna: folds 
$-Twackle-$: raises $1 to $2
ZMPOUTSAM140: calls $1.50
simoniustin: folds 
*** FLOP *** [6s 8d Qh]
ZMPOUTSAM140: checks 
$-Twackle-$: checks 
*** TURN *** [6s 8d Qh] [5h]
ZMPOUTSAM140: checks 
$-Twackle-$: checks 
*** RIVER *** [6s 8d Qh 5h] [9d]
ZMPOUTSAM140: checks 
$-Twackle-$: checks 
*** SHOW DOWN ***
ZMPOUTSAM140: shows [3s Qs] (a pair of Queens)
$-Twackle-$: mucks hand 
ZMPOUTSAM140 collected $4.78 from pot
*** SUMMARY ***
Total pot $5 | Rake $0.22 
Board [6s 8d Qh 5h 9d]
Seat 1: nickreason17 folded before Flop (didn't bet)
Seat 3: fanmtZ folded before Flop (didn't bet)
Seat 5: matiko09 folded before Flop (didn't bet)
Seat 6: gabi_igna folded before Flop (didn't bet)
Seat 7: $-Twackle-$ (button) mucked [Ah 5d]
Seat 8: ZMPOUTSAM140 (small blind) showed [3s Qs] and won ($4.78) with a pair of Queens
Seat 9: simoniustin (big blind) folded before Flop





PokerStars Hand #149394089296:  Hold'em No Limit ($0.50/$1.00 USD) - 2016/02/25 17:25:27 CET [2016/02/25 11:25:27 ET]
Table 'Sabine' 9-max Seat #1 is the button
Seat 1: Aalleekks ($100 in chips) 
Seat 2: apfush ($131.20 in chips) 
Seat 3: Ouga Buga ($111.06 in chips) 
Seat 5: Venomous100% ($108.54 in chips) 
Seat 6: ffac ($103.68 in chips) 
Seat 7: clayshmert ($77.76 in chips) 
Seat 8: matiko09 ($124.97 in chips) 
Seat 9: djammusic ($56.42 in chips) 
apfush: posts small blind $0.50
Ouga Buga: posts big blind $1
simoniustin: sits out 
*** HOLE CARDS ***
Dealt to matiko09 [6s 2c]
Venomous100%: folds 
ffac: folds 
clayshmert: folds 
matiko09: folds 
djammusic: folds 
Aalleekks: folds 
apfush: raises $2 to $3
Ouga Buga: calls $2
*** FLOP *** [Kd Ks 8d]
apfush: checks 
Ouga Buga: checks 
*** TURN *** [Kd Ks 8d] [5c]
apfush: checks 
Ouga Buga: checks 
*** RIVER *** [Kd Ks 8d 5c] [4h]
apfush: bets $3.50
Ouga Buga: folds 
Uncalled bet ($3.50) returned to apfush
apfush collected $5.73 from pot
apfush: doesn't show hand 
*** SUMMARY ***
Total pot $6 | Rake $0.27 
Board [Kd Ks 8d 5c 4h]
Seat 1: Aalleekks (button) folded before Flop (didn't bet)
Seat 2: apfush (small blind) collected ($5.73)
Seat 3: Ouga Buga (big blind) folded on the River
Seat 5: Venomous100% folded before Flop (didn't bet)
Seat 6: ffac folded before Flop (didn't bet)
Seat 7: clayshmert folded before Flop (didn't bet)
Seat 8: matiko09 folded before Flop (didn't bet)
Seat 9: djammusic folded before Flop (didn't bet)





PokerStars Hand #149394092131:  Hold'em No Limit ($0.50/$1.00 USD) - 2016/02/25 17:25:30 CET [2016/02/25 11:25:30 ET]
Table 'Morosovia II' 9-max Seat #1 is the button
Seat 1: apfush ($193.08 in chips) 
Seat 2: Effort92 ($157.17 in chips) 
Seat 3: sebaaastian ($217.86 in chips) 
Seat 4: Venomous100% ($154.02 in chips) 
Seat 7: matiko09 ($166.55 in chips) 
Seat 8: simoniustin ($125.86 in chips) 
Seat 9: Ouga Buga ($125.07 in chips) 
Effort92: posts small blind $0.50
sebaaastian: posts big blind $1
*** HOLE CARDS ***
Dealt to matiko09 [Qs Qd]
Venomous100%: folds 
matiko09: raises $2 to $3
simoniustin: folds 
Ouga Buga: folds 
apfush: folds 
Effort92: calls $2.50
sebaaastian: folds 
*** FLOP *** [4h 6s 3c]
Effort92: checks 
matiko09: bets $4.34
Effort92: calls $4.34
*** TURN *** [4h 6s 3c] [3d]
Effort92: checks 
matiko09: bets $9.73
Effort92: calls $9.73
*** RIVER *** [4h 6s 3c 3d] [Jd]
Effort92: checks 
matiko09: checks 
*** SHOW DOWN ***
Effort92: shows [Js Jc] (a full house, Jacks full of Threes)
matiko09: mucks hand 
Effort92 collected $33.56 from pot
*** SUMMARY ***
Total pot $35.14 | Rake $1.58 
Board [4h 6s 3c 3d Jd]
Seat 1: apfush (button) folded before Flop (didn't bet)
Seat 2: Effort92 (small blind) showed [Js Jc] and won ($33.56) with a full house, Jacks full of Threes
Seat 3: sebaaastian (big blind) folded before Flop
Seat 4: Venomous100% folded before Flop (didn't bet)
Seat 7: matiko09 mucked [Qs Qd]
Seat 8: simoniustin folded before Flop (didn't bet)
Seat 9: Ouga Buga folded before Flop (didn't bet)





PokerStars Hand #149394106245:  Hold'em No Limit ($0.50/$1.00 USD) - 2016/02/25 17:25:48 CET [2016/02/25 11:25:48 ET]
Table 'Zerbinetta II' 9-max Seat #6 is the button
Seat 2: lysandrafly ($100 in chips) 
Seat 3: matiko09 ($100 in chips) 
Seat 4: sebaaastian ($100 in chips) 
Seat 5: hammerwife ($123.77 in chips) 
Seat 6: nickreason17 ($106.77 in chips) 
Seat 7: HomerrrJay ($100 in chips) 
Seat 8: gabi_igna ($100 in chips) 
Seat 9: with-w ($52.73 in chips) 
HomerrrJay: posts small blind $0.50
gabi_igna: posts big blind $1
$-Twackle-$: sits out 
*** HOLE CARDS ***
Dealt to matiko09 [Jc 2s]
with-w: calls $1
lysandrafly: folds 
matiko09: folds 
sebaaastian: folds 
hammerwife: folds 
nickreason17: folds 
HomerrrJay: calls $0.50
gabi_igna: checks 
*** FLOP *** [4s 2h Ac]
HomerrrJay: checks 
gabi_igna: checks 
with-w: bets $2.86
HomerrrJay: folds 
gabi_igna: folds 
Uncalled bet ($2.86) returned to with-w
with-w collected $2.86 from pot
with-w: doesn't show hand 
*** SUMMARY ***
Total pot $3 | Rake $0.14 
Board [4s 2h Ac]
Seat 2: lysandrafly folded before Flop (didn't bet)
Seat 3: matiko09 folded before Flop (didn't bet)
Seat 4: sebaaastian folded before Flop (didn't bet)
Seat 5: hammerwife folded before Flop (didn't bet)
Seat 6: nickreason17 (button) folded before Flop (didn't bet)
Seat 7: HomerrrJay (small blind) folded on the Flop
Seat 8: gabi_igna (big blind) folded on the Flop
Seat 9: with-w collected ($2.86)





PokerStars Hand #149394108289:  Hold'em No Limit ($0.50/$1.00 USD) - 2016/02/25 17:25:51 CET [2016/02/25 11:25:51 ET]
Table 'Eurysaces II' 9-max Seat #1 is the button
Seat 1: lysandrafly ($100 in chips) 
Seat 2: sebaaastian ($100 in chips) 
Seat 3: nickreason17 ($100 in chips) 
Seat 5: keessie93 ($66.02 in chips) 
Seat 6: J0rmungund ($39 in chips) 
Seat 7: $-Twackle-$ ($101.50 in chips) 
Seat 8: HomerrrJay ($100 in chips) 
Seat 9: matiko09 ($102.39 in chips) 
sebaaastian: posts small blind $0.50
nickreason17: posts big blind $1
Hujiafeng: sits out 
*** HOLE CARDS ***
Dealt to matiko09 [Jc 5d]
keessie93: calls $1
J0rmungund: folds 
$-Twackle-$: folds 
HomerrrJay: folds 
matiko09: folds 
lysandrafly: folds 
sebaaastian: folds 
nickreason17: checks 
*** FLOP *** [4c As Th]
nickreason17: checks 
keessie93: bets $3
nickreason17: folds 
Uncalled bet ($3) returned to keessie93
keessie93 collected $2.39 from pot
keessie93: doesn't show hand 
*** SUMMARY ***
Total pot $2.50 | Rake $0.11 
Board [4c As Th]
Seat 1: lysandrafly (button) folded before Flop (didn't bet)
Seat 2: sebaaastian (small blind) folded before Flop
Seat 3: nickreason17 (big blind) folded on the Flop
Seat 5: keessie93 collected ($2.39)
Seat 6: J0rmungund folded before Flop (didn't bet)
Seat 7: $-Twackle-$ folded before Flop (didn't bet)
Seat 8: HomerrrJay folded before Flop (didn't bet)
Seat 9: matiko09 folded before Flop (didn't bet)





PokerStars Hand #149394108719:  Hold'em No Limit ($0.50/$1.00 USD) - 2016/02/25 17:25:51 CET [2016/02/25 11:25:51 ET]
Table 'Zeuxo II' 9-max Seat #8 is the button
Seat 1: forsmthgood ($114.38 in chips) 
Seat 4: sebaaastian ($100 in chips) 
Seat 6: Cogss ($109.08 in chips) 
Seat 7: djammusic ($49 in chips) 
Seat 8: matiko09 ($106.59 in chips) 
Seat 9: Sreshta222 ($197.55 in chips) 
Sreshta222: posts small blind $0.50
forsmthgood: posts big blind $1
hammerwife: sits out 
*** HOLE CARDS ***
Dealt to matiko09 [7c 7d]
sebaaastian: folds 
Cogss: raises $1 to $2
djammusic: folds 
matiko09: raises $4 to $6
Sreshta222: folds 
forsmthgood: folds 
Cogss: calls $4
*** FLOP *** [8h 4d 3s]
Cogss: checks 
matiko09: bets $7
Cogss: calls $7
*** TURN *** [8h 4d 3s] [2d]
Cogss: checks 
matiko09: bets $13
Cogss: calls $13
*** RIVER *** [8h 4d 3s 2d] [2h]
Cogss: checks 
matiko09: checks 
*** SHOW DOWN ***
Cogss: shows [Jc Ac] (a pair of Deuces)
matiko09: shows [7c 7d] (two pair, Sevens and Deuces)
matiko09 collected $51.09 from pot
*** SUMMARY ***
Total pot $53.50 | Rake $2.41 
Board [8h 4d 3s 2d 2h]
Seat 1: forsmthgood (big blind) folded before Flop
Seat 4: sebaaastian folded before Flop (didn't bet)
Seat 6: Cogss showed [Jc Ac] and lost with a pair of Deuces
Seat 7: djammusic folded before Flop (didn't bet)
Seat 8: matiko09 (button) showed [7c 7d] and won ($51.09) with two pair, Sevens and Deuces
Seat 9: Sreshta222 (small blind) folded before Flop





PokerStars Hand #149394109353:  Hold'em No Limit ($0.50/$1.00 USD) - 2016/02/25 17:25:52 CET [2016/02/25 11:25:52 ET]
Table 'Mayall II' 9-max Seat #7 is the button
Seat 1: matiko09 ($121.75 in chips) 
Seat 3: simoniustin ($100 in chips) 
Seat 4: Ouga Buga ($109.62 in chips) 
Seat 5: HomerrrJay ($101.50 in chips) 
Seat 6: apfush ($113.67 in chips) 
Seat 7: r.pol218 ($43 in chips) 
Seat 8: kuanhung0903 ($81.43 in chips) 
kuanhung0903: posts small blind $0.50
matiko09: posts big blind $1
*** HOLE CARDS ***
Dealt to matiko09 [5c 6d]
simoniustin: raises $2 to $3
Ouga Buga: folds 
HomerrrJay: folds 
apfush: folds 
r.pol218: folds 
kuanhung0903: folds 
matiko09: folds 
Uncalled bet ($2) returned to simoniustin
simoniustin collected $2.50 from pot
simoniustin: doesn't show hand 
*** SUMMARY ***
Total pot $2.50 | Rake $0 
Seat 1: matiko09 (big blind) folded before Flop
Seat 3: simoniustin collected ($2.50)
Seat 4: Ouga Buga folded before Flop (didn't bet)
Seat 5: HomerrrJay folded before Flop (didn't bet)
Seat 6: apfush folded before Flop (didn't bet)
Seat 7: r.pol218 (button) folded before Flop (didn't bet)
Seat 8: kuanhung0903 (small blind) folded before Flop





PokerStars Hand #149394111149:  Hold'em No Limit ($0.50/$1.00 USD) - 2016/02/25 17:25:54 CET [2016/02/25 11:25:54 ET]
Table 'Isa' 9-max Seat #4 is the button
Seat 1: matiko09 ($126.08 in chips) 
Seat 2: mycka86 ($161.92 in chips) 
Seat 3: sebaaastian ($138.75 in chips) 
Seat 4: hammerwife ($107.41 in chips) 
Seat 7: bilukm ($44.06 in chips) 
Seat 8: Venomous100% ($109.03 in chips) 
Seat 9: HomerrrJay ($160.61 in chips) 
bilukm: posts small blind $0.50
Venomous100%: posts big blind $1
*** HOLE CARDS ***
Dealt to matiko09 [Js 8s]
HomerrrJay: folds 
matiko09: folds 
mycka86: folds 
sebaaastian: folds 
hammerwife: folds 
bilukm: calls $0.50
Venomous100%: raises $5 to $6
bilukm: folds 
Uncalled bet ($5) returned to Venomous100%
Venomous100% collected $2 from pot
Venomous100%: doesn't show hand 
*** SUMMARY ***
Total pot $2 | Rake $0 
Seat 1: matiko09 folded before Flop (didn't bet)
Seat 2: mycka86 folded before Flop (didn't bet)
Seat 3: sebaaastian folded before Flop (didn't bet)
Seat 4: hammerwife (button) folded before Flop (didn't bet)
Seat 7: bilukm (small blind) folded before Flop
Seat 8: Venomous100% (big blind) collected ($2)
Seat 9: HomerrrJay folded before Flop (didn't bet)





PokerStars Hand #149394116288:  Hold'em No Limit ($0.50/$1.00 USD) - 2016/02/25 17:26:01 CET [2016/02/25 11:26:01 ET]
Table 'Badenia II' 9-max Seat #7 is the button
Seat 1: matiko09 ($100 in chips) 
Seat 2: Stibitzkie ($61.27 in chips) 
Seat 3: sebaaastian ($147 in chips) 
Seat 5: djammusic ($120.43 in chips) 
Seat 7: forsmthgood ($102.79 in chips) 
Seat 9: waisanen ($247.36 in chips) 
waisanen: posts small blind $0.50
matiko09: posts big blind $1
hammerwife: sits out 
*** HOLE CARDS ***
Dealt to matiko09 [As 5h]
Stibitzkie: raises $2.50 to $3.50
sebaaastian: folds 
djammusic: folds 
forsmthgood: folds 
waisanen: folds 
matiko09: folds 
Uncalled bet ($2.50) returned to Stibitzkie
Stibitzkie collected $2.50 from pot
*** SUMMARY ***
Total pot $2.50 | Rake $0 
Seat 1: matiko09 (big blind) folded before Flop
Seat 2: Stibitzkie collected ($2.50)
Seat 3: sebaaastian folded before Flop (didn't bet)
Seat 5: djammusic folded before Flop (didn't bet)
Seat 7: forsmthgood (button) folded before Flop (didn't bet)
Seat 9: waisanen (small blind) folded before Flop





PokerStars Hand #149394117098:  Hold'em No Limit ($0.50/$1.00 USD) - 2016/02/25 17:26:02 CET [2016/02/25 11:26:02 ET]
Table 'Nerthus II' 9-max Seat #4 is the button
Seat 1: DUkalisUA ($101.71 in chips) 
Seat 2: matiko09 ($215.29 in chips) 
Seat 3: simoniustin ($100 in chips) 
Seat 4: Ilov3NBA ($100 in chips) 
Seat 6: mycka86 ($137.24 in chips) 
Seat 7: Venomous100% ($116.11 in chips) 
Seat 8: Kelvin sai ($57.08 in chips) 
Seat 9: hammerwife ($102 in chips) 
mycka86: posts small blind $0.50
Venomous100%: posts big blind $1
*** HOLE CARDS ***
Dealt to matiko09 [Js Jh]
Kelvin sai: raises $1 to $2
hammerwife: folds 
DUkalisUA: folds 
matiko09: raises $4 to $6
simoniustin: folds 
Ilov3NBA: folds 
mycka86: folds 
Venomous100%: folds 
Kelvin sai: calls $4
*** FLOP *** [Kd Kh 5h]
Kelvin sai: checks 
matiko09: checks 
*** TURN *** [Kd Kh 5h] [6d]
Kelvin sai: checks 
matiko09: bets $7
Kelvin sai: folds 
Uncalled bet ($7) returned to matiko09
matiko09 collected $12.89 from pot
matiko09: doesn't show hand 
*** SUMMARY ***
Total pot $13.50 | Rake $0.61 
Board [Kd Kh 5h 6d]
Seat 1: DUkalisUA folded before Flop (didn't bet)
Seat 2: matiko09 collected ($12.89)
Seat 3: simoniustin folded before Flop (didn't bet)
Seat 4: Ilov3NBA (button) folded before Flop (didn't bet)
Seat 6: mycka86 (small blind) folded before Flop
Seat 7: Venomous100% (big blind) folded before Flop
Seat 8: Kelvin sai folded on the Turn
Seat 9: hammerwife folded before Flop (didn't bet)





PokerStars Hand #149394132116:  Hold'em No Limit ($0.25/$0.50 USD) - 2016/02/25 17:26:21 CET [2016/02/25 11:26:21 ET]
Table 'Lohja II' 9-max Seat #8 is the button
Seat 1: MoonJimmy ($138.23 in chips) 
Seat 3: guvalc1952 ($215.17 in chips) 
Seat 4: payback11 ($50 in chips) 
Seat 7: matiko09 ($121.94 in chips) 
Seat 8: jamba83 ($69.54 in chips) 
Seat 9: Al3xAnd3r22 ($99.01 in chips) 
Al3xAnd3r22: posts small blind $0.25
MoonJimmy: posts big blind $0.50
Effort92: sits out 
MoonJimmy: posts the ante $0.10
guvalc1952: posts the ante $0.10
payback11: posts the ante $0.10
matiko09: posts the ante $0.10
jamba83: posts the ante $0.10
Al3xAnd3r22: posts the ante $0.10
*** HOLE CARDS ***
Dealt to matiko09 [Qh Ks]
guvalc1952: calls $0.50
payback11: folds 
matiko09: raises $1.50 to $2
jamba83: folds 
Al3xAnd3r22: folds 
MoonJimmy: folds 
guvalc1952: calls $1.50
*** FLOP *** [Qc 3d Tc]
guvalc1952: checks 
matiko09: bets $3.32
guvalc1952: calls $3.32
*** TURN *** [Qc 3d Tc] [9s]
guvalc1952: checks 
matiko09: bets $7.44
guvalc1952: calls $7.44
*** RIVER *** [Qc 3d Tc 9s] [7s]
guvalc1952: checks 
matiko09: checks 
*** SHOW DOWN ***
guvalc1952: shows [Qd Th] (two pair, Queens and Tens)
matiko09: mucks hand 
guvalc1952 collected $25.66 from pot
*** SUMMARY ***
Total pot $26.87 | Rake $1.21 
Board [Qc 3d Tc 9s 7s]
Seat 1: MoonJimmy (big blind) folded before Flop
Seat 3: guvalc1952 showed [Qd Th] and won ($25.66) with two pair, Queens and Tens
Seat 4: payback11 folded before Flop (didn't bet)
Seat 7: matiko09 mucked [Qh Ks]
Seat 8: jamba83 (button) folded before Flop (didn't bet)
Seat 9: Al3xAnd3r22 (small blind) folded before Flop





PokerStars Hand #149394134878:  Hold'em No Limit ($0.50/$1.00 USD) - 2016/02/25 17:26:24 CET [2016/02/25 11:26:24 ET]
Table 'Hercules IV' 9-max Seat #7 is the button
Seat 1: matiko09 ($100 in chips) 
Seat 3: HomerrrJay ($121.24 in chips) 
Seat 6: kuanhung0903 ($41.02 in chips) 
Seat 7: Ouga Buga ($112.56 in chips) 
Seat 8: brokat77 ($123.39 in chips) 
Seat 9: djammusic ($47.89 in chips) 
brokat77: posts small blind $0.50
djammusic: posts big blind $1
simoniustin: sits out 
*** HOLE CARDS ***
Dealt to matiko09 [2c 7c]
matiko09: folds 
HomerrrJay: raises $1.50 to $2.50
kuanhung0903: folds 
Ouga Buga: folds 
brokat77: calls $2
djammusic: folds 
*** FLOP *** [Qc 7s 5d]
brokat77: checks 
HomerrrJay: bets $2.86
brokat77: folds 
Uncalled bet ($2.86) returned to HomerrrJay
HomerrrJay collected $5.73 from pot
HomerrrJay: doesn't show hand 
*** SUMMARY ***
Total pot $6 | Rake $0.27 
Board [Qc 7s 5d]
Seat 1: matiko09 folded before Flop (didn't bet)
Seat 3: HomerrrJay collected ($5.73)
Seat 6: kuanhung0903 folded before Flop (didn't bet)
Seat 7: Ouga Buga (button) folded before Flop (didn't bet)
Seat 8: brokat77 (small blind) folded on the Flop
Seat 9: djammusic (big blind) folded before Flop





PokerStars Hand #149394136223:  Hold'em No Limit ($0.50/$1.00 USD) - 2016/02/25 17:26:26 CET [2016/02/25 11:26:26 ET]
Table 'Zerbinetta II' 9-max Seat #7 is the button
Seat 2: lysandrafly ($100 in chips) 
Seat 3: matiko09 ($100 in chips) 
Seat 4: sebaaastian ($100 in chips) 
Seat 5: hammerwife ($123.77 in chips) 
Seat 6: nickreason17 ($106.77 in chips) 
Seat 7: HomerrrJay ($100 in chips) 
Seat 8: gabi_igna ($100 in chips) 
Seat 9: with-w ($54.59 in chips) 
gabi_igna: posts small blind $0.50
with-w: posts big blind $1
$-Twackle-$: sits out 
*** HOLE CARDS ***
Dealt to matiko09 [4h 3c]
lysandrafly: folds 
matiko09: folds 
sebaaastian: folds 
hammerwife: folds 
nickreason17: folds 
HomerrrJay: folds 
gabi_igna: raises $2 to $3
with-w: folds 
Uncalled bet ($2) returned to gabi_igna
gabi_igna collected $2 from pot
gabi_igna: doesn't show hand 
*** SUMMARY ***
Total pot $2 | Rake $0 
Seat 2: lysandrafly folded before Flop (didn't bet)
Seat 3: matiko09 folded before Flop (didn't bet)
Seat 4: sebaaastian folded before Flop (didn't bet)
Seat 5: hammerwife folded before Flop (didn't bet)
Seat 6: nickreason17 folded before Flop (didn't bet)
Seat 7: HomerrrJay (button) folded before Flop (didn't bet)
Seat 8: gabi_igna (small blind) collected ($2)
Seat 9: with-w (big blind) folded before Flop





PokerStars Hand #149394141170:  Hold'em No Limit ($0.50/$1.00 USD) - 2016/02/25 17:26:32 CET [2016/02/25 11:26:32 ET]
Table 'Badenia II' 9-max Seat #9 is the button
Seat 1: matiko09 ($100 in chips) 
Seat 2: Stibitzkie ($62.77 in chips) 
Seat 3: sebaaastian ($147 in chips) 
Seat 5: djammusic ($120.43 in chips) 
Seat 7: forsmthgood ($102.79 in chips) 
Seat 9: waisanen ($246.86 in chips) 
matiko09: posts small blind $0.50
Stibitzkie: posts big blind $1
hammerwife: sits out 
*** HOLE CARDS ***
Dealt to matiko09 [Js Qd]
sebaaastian: folds 
djammusic: folds 
forsmthgood: folds 
waisanen: folds 
matiko09: raises $1.50 to $2.50
Stibitzkie: folds 
Uncalled bet ($1.50) returned to matiko09
matiko09 collected $2 from pot
matiko09: doesn't show hand 
*** SUMMARY ***
Total pot $2 | Rake $0 
Seat 1: matiko09 (small blind) collected ($2)
Seat 2: Stibitzkie (big blind) folded before Flop
Seat 3: sebaaastian folded before Flop (didn't bet)
Seat 5: djammusic folded before Flop (didn't bet)
Seat 7: forsmthgood folded before Flop (didn't bet)
Seat 9: waisanen (button) folded before Flop (didn't bet)





PokerStars Hand #149394142231:  Hold'em No Limit ($0.50/$1.00 USD) - 2016/02/25 17:26:34 CET [2016/02/25 11:26:34 ET]
Table 'Mayall II' 9-max Seat #8 is the button
Seat 1: matiko09 ($120.75 in chips) 
Seat 3: simoniustin ($101.50 in chips) 
Seat 4: Ouga Buga ($109.62 in chips) 
Seat 5: HomerrrJay ($101.50 in chips) 
Seat 6: apfush ($113.67 in chips) 
Seat 7: r.pol218 ($43 in chips) 
Seat 8: kuanhung0903 ($80.93 in chips) 
matiko09: posts small blind $0.50
simoniustin: posts big blind $1
*** HOLE CARDS ***
Dealt to matiko09 [9s 4d]
Ouga Buga: folds 
HomerrrJay: folds 
apfush: folds 
r.pol218: calls $1
kuanhung0903: raises $3 to $4
matiko09: folds 
simoniustin: folds 
r.pol218: calls $3
*** FLOP *** [7d 9d 5h]
r.pol218: checks 
kuanhung0903: bets $6
r.pol218: calls $6
*** TURN *** [7d 9d 5h] [Ah]
r.pol218: checks 
kuanhung0903: checks 
*** RIVER *** [7d 9d 5h Ah] [Ks]
r.pol218: checks 
kuanhung0903: checks 
*** SHOW DOWN ***
r.pol218: shows [Th 8h] (high card Ace)
kuanhung0903: shows [Qh Jc] (high card Ace - King+Queen kicker)
kuanhung0903 collected $20.53 from pot
*** SUMMARY ***
Total pot $21.50 | Rake $0.97 
Board [7d 9d 5h Ah Ks]
Seat 1: matiko09 (small blind) folded before Flop
Seat 3: simoniustin (big blind) folded before Flop
Seat 4: Ouga Buga folded before Flop (didn't bet)
Seat 5: HomerrrJay folded before Flop (didn't bet)
Seat 6: apfush folded before Flop (didn't bet)
Seat 7: r.pol218 showed [Th 8h] and lost with high card Ace
Seat 8: kuanhung0903 (button) showed [Qh Jc] and won ($20.53) with high card Ace





PokerStars Hand #149394143121:  Hold'em No Limit ($0.50/$1.00 USD) - 2016/02/25 17:26:35 CET [2016/02/25 11:26:35 ET]
Table 'Zeuxo II' 9-max Seat #9 is the button
Seat 1: forsmthgood ($113.38 in chips) 
Seat 4: sebaaastian ($100 in chips) 
Seat 6: Cogss ($83.08 in chips) 
Seat 7: djammusic ($49 in chips) 
Seat 8: matiko09 ($131.68 in chips) 
Seat 9: Sreshta222 ($197.05 in chips) 
forsmthgood: posts small blind $0.50
sebaaastian: posts big blind $1
hammerwife: sits out 
*** HOLE CARDS ***
Dealt to matiko09 [4d 6h]
Cogss: folds 
djammusic: folds 
matiko09: folds 
Sreshta222: raises $1.09 to $2.09
forsmthgood: raises $5.41 to $7.50
sebaaastian: folds 
Sreshta222: raises $10 to $17.50
forsmthgood: raises $95.88 to $113.38 and is all-in
Sreshta222: calls $95.88
*** FIRST FLOP *** [7s 9d 6c]
*** FIRST TURN *** [7s 9d 6c] [4h]
*** FIRST RIVER *** [7s 9d 6c 4h] [4s]
*** SECOND FLOP *** [2c 4c Tc]
*** SECOND TURN *** [2c 4c Tc] [Jd]
*** SECOND RIVER *** [2c 4c Tc Jd] [Td]
*** FIRST SHOW DOWN ***
forsmthgood: shows [Qc Qd] (two pair, Queens and Fours)
Sreshta222: shows [Ks Kh] (two pair, Kings and Fours)
Sreshta222 collected $112.48 from pot
*** SECOND SHOW DOWN ***
forsmthgood: shows [Qc Qd] (two pair, Queens and Tens)
Sreshta222: shows [Ks Kh] (two pair, Kings and Tens)
Sreshta222 collected $112.48 from pot
*** SUMMARY ***
Total pot $227.76 | Rake $2.80 
Hand was run twice
FIRST Board [7s 9d 6c 4h 4s]
SECOND Board [2c 4c Tc Jd Td]
Seat 1: forsmthgood (small blind) showed [Qc Qd] and lost with two pair, Queens and Fours, and lost with two pair, Queens and Tens
Seat 4: sebaaastian (big blind) folded before Flop
Seat 6: Cogss folded before Flop (didn't bet)
Seat 7: djammusic folded before Flop (didn't bet)
Seat 8: matiko09 folded before Flop (didn't bet)
Seat 9: Sreshta222 (button) showed [Ks Kh] and won ($112.48) with two pair, Kings and Fours, and won ($112.48) with two pair, Kings and Tens





PokerStars Hand #149394149335:  Hold'em No Limit ($0.50/$1.00 USD) - 2016/02/25 17:26:43 CET [2016/02/25 11:26:43 ET]
Table 'Morosovia II' 9-max Seat #2 is the button
Seat 1: apfush ($193.08 in chips) 
Seat 2: Effort92 ($173.66 in chips) 
Seat 3: sebaaastian ($216.86 in chips) 
Seat 7: matiko09 ($149.48 in chips) 
Seat 8: simoniustin ($125.86 in chips) 
Seat 9: Ouga Buga ($125.07 in chips) 
sebaaastian: posts small blind $0.50
Venomous100%: is sitting out 
matiko09: posts big blind $1
*** HOLE CARDS ***
Dealt to matiko09 [8h Qs]
simoniustin: folds 
Ouga Buga: folds 
apfush: raises $1.50 to $2.50
Effort92: folds 
sebaaastian: folds 
pimpoza leaves the table
matiko09: folds 
Uncalled bet ($1.50) returned to apfush
apfush collected $2.50 from pot
apfush: doesn't show hand 
*** SUMMARY ***
Total pot $2.50 | Rake $0 
Seat 1: apfush collected ($2.50)
Seat 2: Effort92 (button) folded before Flop (didn't bet)
Seat 3: sebaaastian (small blind) folded before Flop
Seat 7: matiko09 (big blind) folded before Flop
Seat 8: simoniustin folded before Flop (didn't bet)
Seat 9: Ouga Buga folded before Flop (didn't bet)





PokerStars Hand #149394153155:  Hold'em No Limit ($0.50/$1.00 USD) - 2016/02/25 17:26:47 CET [2016/02/25 11:26:47 ET]
Table 'Ebella II' 9-max Seat #8 is the button
Seat 1: nickreason17 ($102.96 in chips) 
Seat 3: fanmtZ ($40 in chips) 
Seat 5: matiko09 ($100 in chips) 
Seat 6: gabi_igna ($103.55 in chips) 
Seat 7: $-Twackle-$ ($100 in chips) 
Seat 8: ZMPOUTSAM140 ($99.46 in chips) 
Seat 9: simoniustin ($112.63 in chips) 
simoniustin: posts small blind $0.50
nickreason17: posts big blind $1
*** HOLE CARDS ***
Dealt to matiko09 [6h Qh]
fanmtZ: raises $1.38 to $2.38
matiko09: folds 
gabi_igna: folds 
$-Twackle-$: folds 
ZMPOUTSAM140: folds 
simoniustin: folds 
nickreason17: folds 
Uncalled bet ($1.38) returned to fanmtZ
fanmtZ collected $2.50 from pot
fanmtZ: doesn't show hand 
*** SUMMARY ***
Total pot $2.50 | Rake $0 
Seat 1: nickreason17 (big blind) folded before Flop
Seat 3: fanmtZ collected ($2.50)
Seat 5: matiko09 folded before Flop (didn't bet)
Seat 6: gabi_igna folded before Flop (didn't bet)
Seat 7: $-Twackle-$ folded before Flop (didn't bet)
Seat 8: ZMPOUTSAM140 (button) folded before Flop (didn't bet)
Seat 9: simoniustin (small blind) folded before Flop





PokerStars Hand #149394152622:  Hold'em No Limit ($0.50/$1.00 USD) - 2016/02/25 17:26:47 CET [2016/02/25 11:26:47 ET]
Table 'Eurysaces II' 9-max Seat #2 is the button
Seat 1: lysandrafly ($100 in chips) 
Seat 2: sebaaastian ($100 in chips) 
Seat 3: nickreason17 ($100 in chips) 
Seat 4: Hujiafeng ($100 in chips) 
Seat 5: keessie93 ($67.41 in chips) 
Seat 6: J0rmungund ($39 in chips) 
Seat 7: $-Twackle-$ ($101.50 in chips) 
Seat 8: HomerrrJay ($100 in chips) 
Seat 9: matiko09 ($102.39 in chips) 
nickreason17: posts small blind $0.50
Hujiafeng: posts big blind $1
*** HOLE CARDS ***
Dealt to matiko09 [6h Ts]
keessie93: folds 
J0rmungund: calls $1
$-Twackle-$: folds 
HomerrrJay: calls $1
matiko09: folds 
lysandrafly: folds 
sebaaastian: calls $1
nickreason17: calls $0.50
Hujiafeng: checks 
*** FLOP *** [Jd Ah 9c]
nickreason17: checks 
Hujiafeng: checks 
J0rmungund: checks 
HomerrrJay: checks 
sebaaastian: bets $3
nickreason17: folds 
Hujiafeng: folds 
J0rmungund: folds 
HomerrrJay: folds 
Uncalled bet ($3) returned to sebaaastian
sebaaastian collected $4.78 from pot
sebaaastian: doesn't show hand 
*** SUMMARY ***
Total pot $5 | Rake $0.22 
Board [Jd Ah 9c]
Seat 1: lysandrafly folded before Flop (didn't bet)
Seat 2: sebaaastian (button) collected ($4.78)
Seat 3: nickreason17 (small blind) folded on the Flop
Seat 4: Hujiafeng (big blind) folded on the Flop
Seat 5: keessie93 folded before Flop (didn't bet)
Seat 6: J0rmungund folded on the Flop
Seat 7: $-Twackle-$ folded before Flop (didn't bet)
Seat 8: HomerrrJay folded on the Flop
Seat 9: matiko09 folded before Flop (didn't bet)





PokerStars Hand #149394153399:  Hold'em No Limit ($0.50/$1.00 USD) - 2016/02/25 17:26:48 CET [2016/02/25 11:26:48 ET]
Table 'Isa' 9-max Seat #7 is the button
Seat 1: matiko09 ($126.08 in chips) 
Seat 2: mycka86 ($161.92 in chips) 
Seat 3: sebaaastian ($138.75 in chips) 
Seat 4: hammerwife ($107.41 in chips) 
Seat 7: bilukm ($43.06 in chips) 
Seat 8: Venomous100% ($110.03 in chips) 
Seat 9: HomerrrJay ($160.61 in chips) 
Venomous100%: posts small blind $0.50
HomerrrJay: posts big blind $1
*** HOLE CARDS ***
Dealt to matiko09 [Tc 5s]
matiko09: folds 
mycka86: folds 
sebaaastian: folds 
hammerwife: folds 
bilukm has timed out
bilukm: folds 
Venomous100%: raises $2 to $3
HomerrrJay: folds 
Uncalled bet ($2) returned to Venomous100%
Venomous100% collected $2 from pot
Venomous100%: doesn't show hand 
*** SUMMARY ***
Total pot $2 | Rake $0 
Seat 1: matiko09 folded before Flop (didn't bet)
Seat 2: mycka86 folded before Flop (didn't bet)
Seat 3: sebaaastian folded before Flop (didn't bet)
Seat 4: hammerwife folded before Flop (didn't bet)
Seat 7: bilukm (button) folded before Flop (didn't bet)
Seat 8: Venomous100% (small blind) collected ($2)
Seat 9: HomerrrJay (big blind) folded before Flop





PokerStars Hand #149394163250:  Hold'em No Limit ($0.50/$1.00 USD) - 2016/02/25 17:27:00 CET [2016/02/25 11:27:00 ET]
Table 'Badenia II' 9-max Seat #1 is the button
Seat 1: matiko09 ($101 in chips) 
Seat 2: Stibitzkie ($61.77 in chips) 
Seat 3: sebaaastian ($147 in chips) 
Seat 5: djammusic ($120.43 in chips) 
Seat 7: forsmthgood ($102.79 in chips) 
Seat 9: waisanen ($246.86 in chips) 
Stibitzkie: posts small blind $0.50
sebaaastian: posts big blind $1
hammerwife: sits out 
*** HOLE CARDS ***
Dealt to matiko09 [8c Ks]
djammusic: folds 
forsmthgood: raises $2 to $3
waisanen: calls $3
matiko09: folds 
Stibitzkie: folds 
sebaaastian: folds 
*** FLOP *** [9h 2d 6s]
forsmthgood: bets $4.38
waisanen: calls $4.38
*** TURN *** [9h 2d 6s] [Qd]
forsmthgood: bets $10.56
waisanen: folds 
Uncalled bet ($10.56) returned to forsmthgood
forsmthgood collected $15.53 from pot
forsmthgood: doesn't show hand 
*** SUMMARY ***
Total pot $16.26 | Rake $0.73 
Board [9h 2d 6s Qd]
Seat 1: matiko09 (button) folded before Flop (didn't bet)
Seat 2: Stibitzkie (small blind) folded before Flop
Seat 3: sebaaastian (big blind) folded before Flop
Seat 5: djammusic folded before Flop (didn't bet)
Seat 7: forsmthgood collected ($15.53)
Seat 9: waisanen folded on the Turn





PokerStars Hand #149394166622:  Hold'em No Limit ($0.50/$1.00 USD) - 2016/02/25 17:27:04 CET [2016/02/25 11:27:04 ET]
Table 'Sabine' 9-max Seat #2 is the button
Seat 1: Aalleekks ($100 in chips) 
Seat 2: apfush ($133.93 in chips) 
Seat 3: Ouga Buga ($108.06 in chips) 
Seat 4: simoniustin ($100 in chips) 
Seat 5: Venomous100% ($108.54 in chips) 
Seat 6: ffac ($103.68 in chips) 
Seat 7: clayshmert ($77.76 in chips) 
Seat 8: matiko09 ($124.97 in chips) 
Seat 9: djammusic ($56.42 in chips) 
Ouga Buga: posts small blind $0.50
simoniustin: posts big blind $1
*** HOLE CARDS ***
Dealt to matiko09 [6d 8h]
Venomous100%: folds 
ffac: raises $2 to $3
clayshmert: folds 
matiko09: folds 
djammusic: folds 
Aalleekks: folds 
apfush: folds 
Ouga Buga: folds 
simoniustin: folds 
Uncalled bet ($2) returned to ffac
ffac collected $2.50 from pot
ffac: doesn't show hand 
*** SUMMARY ***
Total pot $2.50 | Rake $0 
Seat 1: Aalleekks folded before Flop (didn't bet)
Seat 2: apfush (button) folded before Flop (didn't bet)
Seat 3: Ouga Buga (small blind) folded before Flop
Seat 4: simoniustin (big blind) folded before Flop
Seat 5: Venomous100% folded before Flop (didn't bet)
Seat 6: ffac collected ($2.50)
Seat 7: clayshmert folded before Flop (didn't bet)
Seat 8: matiko09 folded before Flop (didn't bet)
Seat 9: djammusic folded before Flop (didn't bet)





PokerStars Hand #149394167094:  Hold'em No Limit ($0.50/$1.00 USD) - 2016/02/25 17:27:05 CET [2016/02/25 11:27:05 ET]
Table 'Hercules IV' 9-max Seat #8 is the button
Seat 1: matiko09 ($100 in chips) 
Seat 3: HomerrrJay ($124.47 in chips) 
Seat 6: kuanhung0903 ($41.02 in chips) 
Seat 7: Ouga Buga ($112.56 in chips) 
Seat 8: brokat77 ($120.89 in chips) 
Seat 9: djammusic ($46.89 in chips) 
djammusic: posts small blind $0.50
matiko09: posts big blind $1
simoniustin: sits out 
*** HOLE CARDS ***
Dealt to matiko09 [9h 5s]
HomerrrJay: folds 
kuanhung0903: folds 
Ouga Buga: folds 
brokat77: folds 
brokat77 leaves the table
djammusic: raises $1.25 to $2.25
matiko09: folds 
Uncalled bet ($1.25) returned to djammusic
djammusic collected $2 from pot
djammusic: doesn't show hand 
*** SUMMARY ***
Total pot $2 | Rake $0 
Seat 1: matiko09 (big blind) folded before Flop
Seat 3: HomerrrJay folded before Flop (didn't bet)
Seat 6: kuanhung0903 folded before Flop (didn't bet)
Seat 7: Ouga Buga folded before Flop (didn't bet)
Seat 8: brokat77 (button) folded before Flop (didn't bet)
Seat 9: djammusic (small blind) collected ($2)





PokerStars Hand #149394173354:  Hold'em No Limit ($0.50/$1.00 USD) - 2016/02/25 17:27:12 CET [2016/02/25 11:27:12 ET]
Table 'Zerbinetta II' 9-max Seat #8 is the button
Seat 1: $-Twackle-$ ($100 in chips) 
Seat 2: lysandrafly ($100 in chips) 
Seat 3: matiko09 ($100 in chips) 
Seat 4: sebaaastian ($100 in chips) 
Seat 5: hammerwife ($123.77 in chips) 
Seat 6: nickreason17 ($106.77 in chips) 
Seat 7: HomerrrJay ($100 in chips) 
Seat 8: gabi_igna ($101 in chips) 
Seat 9: with-w ($53.59 in chips) 
with-w: posts small blind $0.50
$-Twackle-$: posts big blind $1
*** HOLE CARDS ***
Dealt to matiko09 [6d Jh]
lysandrafly: raises $2.10 to $3.10
matiko09: folds 
sebaaastian: folds 
hammerwife: folds 
nickreason17: folds 
HomerrrJay: folds 
gabi_igna: folds 
with-w: calls $2.60
$-Twackle-$: folds 
*** FLOP *** [Tc Ah 7s]
with-w: checks 
lysandrafly: bets $4.54
with-w: folds 
Uncalled bet ($4.54) returned to lysandrafly
lysandrafly collected $6.88 from pot
lysandrafly: doesn't show hand 
*** SUMMARY ***
Total pot $7.20 | Rake $0.32 
Board [Tc Ah 7s]
Seat 1: $-Twackle-$ (big blind) folded before Flop
Seat 2: lysandrafly collected ($6.88)
Seat 3: matiko09 folded before Flop (didn't bet)
Seat 4: sebaaastian folded before Flop (didn't bet)
Seat 5: hammerwife folded before Flop (didn't bet)
Seat 6: nickreason17 folded before Flop (didn't bet)
Seat 7: HomerrrJay folded before Flop (didn't bet)
Seat 8: gabi_igna (button) folded before Flop (didn't bet)
Seat 9: with-w (small blind) folded on the Flop





PokerStars Hand #149394177210:  Hold'em No Limit ($0.25/$0.50 USD) - 2016/02/25 17:27:17 CET [2016/02/25 11:27:17 ET]
Table 'Lohja II' 9-max Seat #9 is the button
Seat 1: MoonJimmy ($137.63 in chips) 
Seat 3: guvalc1952 ($227.97 in chips) 
Seat 4: payback11 ($50 in chips) 
Seat 7: matiko09 ($109.08 in chips) 
Seat 8: jamba83 ($69.44 in chips) 
Seat 9: Al3xAnd3r22 ($98.66 in chips) 
MoonJimmy: posts small blind $0.25
guvalc1952: posts big blind $0.50
Effort92: sits out 
MoonJimmy: posts the ante $0.10
guvalc1952: posts the ante $0.10
payback11: posts the ante $0.10
matiko09: posts the ante $0.10
jamba83: posts the ante $0.10
Al3xAnd3r22: posts the ante $0.10
*** HOLE CARDS ***
Dealt to matiko09 [Jd Td]
payback11: folds 
matiko09: raises $1 to $1.50
jamba83: folds 
Al3xAnd3r22: folds 
MoonJimmy: calls $1.25
guvalc1952: calls $1
*** FLOP *** [3d 2s Kc]
MoonJimmy: checks 
guvalc1952: checks 
matiko09: bets $3.17
MoonJimmy: calls $3.17
guvalc1952: calls $3.17
*** TURN *** [3d 2s Kc] [Qd]
MoonJimmy: checks 
guvalc1952: checks 
matiko09: bets $9
MoonJimmy: calls $9
guvalc1952: folds 
*** RIVER *** [3d 2s Kc Qd] [Kh]
MoonJimmy: checks 
matiko09: checks 
*** SHOW DOWN ***
MoonJimmy: shows [Kd Qh] (a full house, Kings full of Queens)
matiko09: mucks hand 
MoonJimmy collected $31.14 from pot
*** SUMMARY ***
Total pot $32.61 | Rake $1.47 
Board [3d 2s Kc Qd Kh]
Seat 1: MoonJimmy (small blind) showed [Kd Qh] and won ($31.14) with a full house, Kings full of Queens
Seat 3: guvalc1952 (big blind) folded on the Turn
Seat 4: payback11 folded before Flop (didn't bet)
Seat 7: matiko09 mucked [Jd Td]
Seat 8: jamba83 folded before Flop (didn't bet)
Seat 9: Al3xAnd3r22 (button) folded before Flop (didn't bet)





PokerStars Hand #149394178862:  Hold'em No Limit ($0.50/$1.00 USD) - 2016/02/25 17:27:19 CET [2016/02/25 11:27:19 ET]
Table 'Morosovia II' 9-max Seat #3 is the button
Seat 1: apfush ($194.58 in chips) 
Seat 2: Effort92 ($173.66 in chips) 
Seat 3: sebaaastian ($216.36 in chips) 
Seat 7: matiko09 ($148.48 in chips) 
Seat 8: simoniustin ($125.86 in chips) 
Seat 9: Ouga Buga ($125.07 in chips) 
matiko09: posts small blind $0.50
simoniustin: posts big blind $1
*** HOLE CARDS ***
Dealt to matiko09 [Ac 2c]
Ouga Buga: folds 
apfush: folds 
Effort92: folds 
sebaaastian: folds 
matiko09: raises $1.50 to $2.50
simoniustin: folds 
Uncalled bet ($1.50) returned to matiko09
matiko09 collected $2 from pot
matiko09: doesn't show hand 
*** SUMMARY ***
Total pot $2 | Rake $0 
Seat 1: apfush folded before Flop (didn't bet)
Seat 2: Effort92 folded before Flop (didn't bet)
Seat 3: sebaaastian (button) folded before Flop (didn't bet)
Seat 7: matiko09 (small blind) collected ($2)
Seat 8: simoniustin (big blind) folded before Flop
Seat 9: Ouga Buga folded before Flop (didn't bet)





PokerStars Hand #149394179176:  Hold'em No Limit ($0.50/$1.00 USD) - 2016/02/25 17:27:20 CET [2016/02/25 11:27:20 ET]
Table 'Nerthus II' 9-max Seat #6 is the button
Seat 1: DUkalisUA ($101.71 in chips) 
Seat 2: matiko09 ($222.18 in chips) 
Seat 3: simoniustin ($100 in chips) 
Seat 4: Ilov3NBA ($100 in chips) 
Seat 6: mycka86 ($136.74 in chips) 
Seat 7: Venomous100% ($115.11 in chips) 
Seat 8: Kelvin sai ($51.08 in chips) 
Seat 9: hammerwife ($102 in chips) 
Venomous100%: posts small blind $0.50
Kelvin sai: posts big blind $1
*** HOLE CARDS ***
Dealt to matiko09 [Js 2h]
hammerwife: raises $2 to $3
DUkalisUA: folds 
matiko09: folds 
simoniustin: folds 
Ilov3NBA: folds 
mycka86: folds 
Venomous100%: folds 
Kelvin sai: folds 
Uncalled bet ($2) returned to hammerwife
hammerwife collected $2.50 from pot
hammerwife: doesn't show hand 
*** SUMMARY ***
Total pot $2.50 | Rake $0 
Seat 1: DUkalisUA folded before Flop (didn't bet)
Seat 2: matiko09 folded before Flop (didn't bet)
Seat 3: simoniustin folded before Flop (didn't bet)
Seat 4: Ilov3NBA folded before Flop (didn't bet)
Seat 6: mycka86 (button) folded before Flop (didn't bet)
Seat 7: Venomous100% (small blind) folded before Flop
Seat 8: Kelvin sai (big blind) folded before Flop
Seat 9: hammerwife collected ($2.50)





PokerStars Hand #149394187174:  Hold'em No Limit ($0.50/$1.00 USD) - 2016/02/25 17:27:30 CET [2016/02/25 11:27:30 ET]
Table 'Isa' 9-max Seat #8 is the button
Seat 1: matiko09 ($126.08 in chips) 
Seat 2: mycka86 ($161.92 in chips) 
Seat 3: sebaaastian ($138.75 in chips) 
Seat 4: hammerwife ($107.41 in chips) 
Seat 7: bilukm ($43.06 in chips) 
Seat 8: Venomous100% ($111.03 in chips) 
Seat 9: HomerrrJay ($159.61 in chips) 
HomerrrJay: posts small blind $0.50
matiko09: posts big blind $1
*** HOLE CARDS ***
Dealt to matiko09 [8d 3s]
mycka86: folds 
sebaaastian: folds 
hammerwife: folds 
bilukm: folds 
Venomous100%: raises $1 to $2
HomerrrJay: folds 
matiko09: folds 
Uncalled bet ($1) returned to Venomous100%
Venomous100% collected $2.50 from pot
Venomous100%: doesn't show hand 
*** SUMMARY ***
Total pot $2.50 | Rake $0 
Seat 1: matiko09 (big blind) folded before Flop
Seat 2: mycka86 folded before Flop (didn't bet)
Seat 3: sebaaastian folded before Flop (didn't bet)
Seat 4: hammerwife folded before Flop (didn't bet)
Seat 7: bilukm folded before Flop (didn't bet)
Seat 8: Venomous100% (button) collected ($2.50)
Seat 9: HomerrrJay (small blind) folded before Flop





PokerStars Hand #149394192456:  Hold'em No Limit ($0.50/$1.00 USD) - 2016/02/25 17:27:36 CET [2016/02/25 11:27:36 ET]
Table 'Ebella II' 9-max Seat #9 is the button
Seat 1: nickreason17 ($101.96 in chips) 
Seat 3: fanmtZ ($41.50 in chips) 
Seat 5: matiko09 ($100 in chips) 
Seat 6: gabi_igna ($103.55 in chips) 
Seat 7: $-Twackle-$ ($100 in chips) 
Seat 8: ZMPOUTSAM140 ($99.46 in chips) 
Seat 9: simoniustin ($112.13 in chips) 
nickreason17: posts small blind $0.50
fanmtZ: posts big blind $1
*** HOLE CARDS ***
Dealt to matiko09 [9h Qd]
matiko09: folds 
gabi_igna: folds 
$-Twackle-$: folds 
ZMPOUTSAM140: folds 
simoniustin: folds 
nickreason17: raises $1.04 to $2.04
fanmtZ: raises $4.46 to $6.50
nickreason17: calls $4.46
*** FLOP *** [Jc 9d 8h]
nickreason17: checks 
fanmtZ: checks 
*** TURN *** [Jc 9d 8h] [Jd]
nickreason17: bets $7.45
fanmtZ: calls $7.45
*** RIVER *** [Jc 9d 8h Jd] [Ts]
nickreason17: bets $15.98
fanmtZ: folds 
Uncalled bet ($15.98) returned to nickreason17
nickreason17 collected $26.64 from pot
*** SUMMARY ***
Total pot $27.90 | Rake $1.26 
Board [Jc 9d 8h Jd Ts]
Seat 1: nickreason17 (small blind) collected ($26.64)
Seat 3: fanmtZ (big blind) folded on the River
Seat 5: matiko09 folded before Flop (didn't bet)
Seat 6: gabi_igna folded before Flop (didn't bet)
Seat 7: $-Twackle-$ folded before Flop (didn't bet)
Seat 8: ZMPOUTSAM140 folded before Flop (didn't bet)
Seat 9: simoniustin (button) folded before Flop (didn't bet)





PokerStars Hand #149394196613:  Hold'em No Limit ($0.50/$1.00 USD) - 2016/02/25 17:27:42 CET [2016/02/25 11:27:42 ET]
Table 'Hercules IV' 9-max Seat #9 is the button
Seat 1: matiko09 ($100 in chips) 
Seat 2: simoniustin ($100 in chips) 
Seat 3: HomerrrJay ($124.47 in chips) 
Seat 6: kuanhung0903 ($41.02 in chips) 
Seat 7: Ouga Buga ($112.56 in chips) 
Seat 9: djammusic ($47.89 in chips) 
matiko09: posts small blind $0.50
simoniustin: posts big blind $1
*** HOLE CARDS ***
Dealt to matiko09 [4d 5h]
HomerrrJay: folds 
kuanhung0903: folds 
Ouga Buga: raises $1.50 to $2.50
djammusic: folds 
matiko09: folds 
gabi_igna joins the table at seat #8 
simoniustin: folds 
Uncalled bet ($1.50) returned to Ouga Buga
Ouga Buga collected $2.50 from pot
Ouga Buga: doesn't show hand 
*** SUMMARY ***
Total pot $2.50 | Rake $0 
Seat 1: matiko09 (small blind) folded before Flop
Seat 2: simoniustin (big blind) folded before Flop
Seat 3: HomerrrJay folded before Flop (didn't bet)
Seat 6: kuanhung0903 folded before Flop (didn't bet)
Seat 7: Ouga Buga collected ($2.50)
Seat 9: djammusic (button) folded before Flop (didn't bet)





PokerStars Hand #149394196795:  Hold'em No Limit ($0.50/$1.00 USD) - 2016/02/25 17:27:42 CET [2016/02/25 11:27:42 ET]
Table 'Morosovia II' 9-max Seat #7 is the button
Seat 1: apfush ($194.58 in chips) 
Seat 2: Effort92 ($173.66 in chips) 
Seat 3: sebaaastian ($216.36 in chips) 
Seat 7: matiko09 ($149.48 in chips) 
Seat 8: simoniustin ($124.86 in chips) 
Seat 9: Ouga Buga ($125.07 in chips) 
simoniustin: posts small blind $0.50
Ouga Buga: posts big blind $1
*** HOLE CARDS ***
Dealt to matiko09 [Td 5d]
apfush: folds 
Effort92: folds 
sebaaastian: folds 
matiko09: folds 
simoniustin: raises $1.02 to $2.02
Ouga Buga: raises $5.98 to $8
simoniustin: folds 
Uncalled bet ($5.98) returned to Ouga Buga
Ouga Buga collected $4.04 from pot
Ouga Buga: doesn't show hand 
*** SUMMARY ***
Total pot $4.04 | Rake $0 
Seat 1: apfush folded before Flop (didn't bet)
Seat 2: Effort92 folded before Flop (didn't bet)
Seat 3: sebaaastian folded before Flop (didn't bet)
Seat 7: matiko09 (button) folded before Flop (didn't bet)
Seat 8: simoniustin (small blind) folded before Flop
Seat 9: Ouga Buga (big blind) collected ($4.04)





PokerStars Hand #149394202717:  Hold'em No Limit ($0.50/$1.00 USD) - 2016/02/25 17:27:49 CET [2016/02/25 11:27:49 ET]
Table 'Mayall II' 9-max Seat #1 is the button
Seat 1: matiko09 ($120.25 in chips) 
Seat 3: simoniustin ($100.50 in chips) 
Seat 4: Ouga Buga ($109.62 in chips) 
Seat 5: HomerrrJay ($101.50 in chips) 
Seat 6: apfush ($113.67 in chips) 
Seat 7: r.pol218 ($33 in chips) 
Seat 8: kuanhung0903 ($91.46 in chips) 
simoniustin: posts small blind $0.50
Ouga Buga: posts big blind $1
*** HOLE CARDS ***
Dealt to matiko09 [Th Tc]
HomerrrJay: folds 
apfush: folds 
r.pol218: folds 
kuanhung0903 has timed out
kuanhung0903: folds 
matiko09: raises $1.27 to $2.27
simoniustin: folds 
Ouga Buga: calls $1.27
*** FLOP *** [4s 8s Ks]
Ouga Buga: checks 
matiko09: checks 
*** TURN *** [4s 8s Ks] [8d]
Ouga Buga: bets $3.43
matiko09: calls $3.43
*** RIVER *** [4s 8s Ks 8d] [3d]
Ouga Buga: checks 
matiko09: checks 
*** SHOW DOWN ***
Ouga Buga: shows [Ts 9h] (a pair of Eights)
matiko09: shows [Th Tc] (two pair, Tens and Eights)
matiko09 collected $11.36 from pot
*** SUMMARY ***
Total pot $11.90 | Rake $0.54 
Board [4s 8s Ks 8d 3d]
Seat 1: matiko09 (button) showed [Th Tc] and won ($11.36) with two pair, Tens and Eights
Seat 3: simoniustin (small blind) folded before Flop
Seat 4: Ouga Buga (big blind) showed [Ts 9h] and lost with a pair of Eights
Seat 5: HomerrrJay folded before Flop (didn't bet)
Seat 6: apfush folded before Flop (didn't bet)
Seat 7: r.pol218 folded before Flop (didn't bet)
Seat 8: kuanhung0903 folded before Flop (didn't bet)





PokerStars Hand #149394203089:  Hold'em No Limit ($0.50/$1.00 USD) - 2016/02/25 17:27:50 CET [2016/02/25 11:27:50 ET]
Table 'Zeuxo II' 9-max Seat #1 is the button
Seat 1: forsmthgood ($100 in chips) 
Seat 4: sebaaastian ($100 in chips) 
Seat 5: hammerwife ($100 in chips) 
Seat 6: Cogss ($83.08 in chips) 
Seat 7: djammusic ($49 in chips) 
Seat 8: matiko09 ($131.68 in chips) 
Seat 9: Sreshta222 ($308.63 in chips) 
sebaaastian: posts small blind $0.50
hammerwife: posts big blind $1
*** HOLE CARDS ***
Dealt to matiko09 [Qd 3h]
Cogss: raises $1 to $2
djammusic: folds 
matiko09: folds 
Sreshta222: folds 
forsmthgood: folds 
sebaaastian: folds 
hammerwife: folds 
Uncalled bet ($1) returned to Cogss
Cogss collected $2.50 from pot
*** SUMMARY ***
Total pot $2.50 | Rake $0 
Seat 1: forsmthgood (button) folded before Flop (didn't bet)
Seat 4: sebaaastian (small blind) folded before Flop
Seat 5: hammerwife (big blind) folded before Flop
Seat 6: Cogss collected ($2.50)
Seat 7: djammusic folded before Flop (didn't bet)
Seat 8: matiko09 folded before Flop (didn't bet)
Seat 9: Sreshta222 folded before Flop (didn't bet)





PokerStars Hand #149394206074:  Hold'em No Limit ($0.50/$1.00 USD) - 2016/02/25 17:27:53 CET [2016/02/25 11:27:53 ET]
Table 'Sabine' 9-max Seat #3 is the button
Seat 1: Aalleekks ($100 in chips) 
Seat 2: apfush ($133.93 in chips) 
Seat 3: Ouga Buga ($107.56 in chips) 
Seat 4: simoniustin ($100 in chips) 
Seat 5: Venomous100% ($108.54 in chips) 
Seat 6: ffac ($105.18 in chips) 
Seat 7: clayshmert ($77.76 in chips) 
Seat 8: matiko09 ($124.97 in chips) 
Seat 9: djammusic ($56.42 in chips) 
simoniustin: posts small blind $0.50
Venomous100%: posts big blind $1
*** HOLE CARDS ***
Dealt to matiko09 [6h As]
ffac: raises $2 to $3
clayshmert: folds 
matiko09: folds 
djammusic: folds 
Aalleekks: folds 
apfush: folds 
Ouga Buga: folds 
simoniustin: folds 
Venomous100%: folds 
Uncalled bet ($2) returned to ffac
ffac collected $2.50 from pot
ffac: doesn't show hand 
*** SUMMARY ***
Total pot $2.50 | Rake $0 
Seat 1: Aalleekks folded before Flop (didn't bet)
Seat 2: apfush folded before Flop (didn't bet)
Seat 3: Ouga Buga (button) folded before Flop (didn't bet)
Seat 4: simoniustin (small blind) folded before Flop
Seat 5: Venomous100% (big blind) folded before Flop
Seat 6: ffac collected ($2.50)
Seat 7: clayshmert folded before Flop (didn't bet)
Seat 8: matiko09 folded before Flop (didn't bet)
Seat 9: djammusic folded before Flop (didn't bet)





PokerStars Hand #149394214870:  Hold'em No Limit ($0.50/$1.00 USD) - 2016/02/25 17:28:04 CET [2016/02/25 11:28:04 ET]
Table 'Badenia II' 9-max Seat #2 is the button
Seat 1: matiko09 ($101 in chips) 
Seat 2: Stibitzkie ($61.27 in chips) 
Seat 3: sebaaastian ($146 in chips) 
Seat 4: hammerwife ($100 in chips) 
Seat 5: djammusic ($120.43 in chips) 
Seat 7: forsmthgood ($110.94 in chips) 
Seat 9: waisanen ($239.48 in chips) 
sebaaastian: posts small blind $0.50
hammerwife: posts big blind $1
*** HOLE CARDS ***
Dealt to matiko09 [9h 8d]
djammusic: folds 
forsmthgood: folds 
waisanen: calls $1
matiko09: folds 
Stibitzkie: folds 
sebaaastian: folds 
hammerwife: raises $4 to $5
waisanen: folds 
Uncalled bet ($4) returned to hammerwife
hammerwife collected $2.50 from pot
hammerwife: doesn't show hand 
*** SUMMARY ***
Total pot $2.50 | Rake $0 
Seat 1: matiko09 folded before Flop (didn't bet)
Seat 2: Stibitzkie (button) folded before Flop (didn't bet)
Seat 3: sebaaastian (small blind) folded before Flop
Seat 4: hammerwife (big blind) collected ($2.50)
Seat 5: djammusic folded before Flop (didn't bet)
Seat 7: forsmthgood folded before Flop (didn't bet)
Seat 9: waisanen folded before Flop





PokerStars Hand #149394217873:  Hold'em No Limit ($0.50/$1.00 USD) - 2016/02/25 17:28:08 CET [2016/02/25 11:28:08 ET]
Table 'Nerthus II' 9-max Seat #7 is the button
Seat 1: DUkalisUA ($101.71 in chips) 
Seat 2: matiko09 ($222.18 in chips) 
Seat 3: simoniustin ($100 in chips) 
Seat 4: Ilov3NBA ($100 in chips) 
Seat 6: mycka86 ($136.74 in chips) 
Seat 7: Venomous100% ($114.61 in chips) 
Seat 8: Kelvin sai ($50.08 in chips) 
Seat 9: hammerwife ($103.50 in chips) 
Kelvin sai: posts small blind $0.50
hammerwife: posts big blind $1
*** HOLE CARDS ***
Dealt to matiko09 [6d 5c]
DUkalisUA: folds 
matiko09: folds 
simoniustin has timed out
simoniustin: folds 
Ilov3NBA: folds 
mycka86: raises $1.10 to $2.10
Venomous100%: folds 
Kelvin sai: calls $1.60
hammerwife: folds 
*** FLOP *** [5s As Jh]
Kelvin sai: checks 
mycka86: bets $3.60
Kelvin sai: calls $3.60
*** TURN *** [5s As Jh] [7h]
Kelvin sai: checks 
mycka86: bets $7.50
Kelvin sai: folds 
Uncalled bet ($7.50) returned to mycka86
mycka86 collected $11.84 from pot
*** SUMMARY ***
Total pot $12.40 | Rake $0.56 
Board [5s As Jh 7h]
Seat 1: DUkalisUA folded before Flop (didn't bet)
Seat 2: matiko09 folded before Flop (didn't bet)
Seat 3: simoniustin folded before Flop (didn't bet)
Seat 4: Ilov3NBA folded before Flop (didn't bet)
Seat 6: mycka86 collected ($11.84)
Seat 7: Venomous100% (button) folded before Flop (didn't bet)
Seat 8: Kelvin sai (small blind) folded on the Turn
Seat 9: hammerwife (big blind) folded before Flop





PokerStars Hand #149394221968:  Hold'em No Limit ($0.50/$1.00 USD) - 2016/02/25 17:28:13 CET [2016/02/25 11:28:13 ET]
Table 'Hercules IV' 9-max Seat #1 is the button
Seat 1: matiko09 ($100 in chips) 
Seat 2: simoniustin ($100 in chips) 
Seat 6: kuanhung0903 ($41.02 in chips) 
Seat 7: Ouga Buga ($114.06 in chips) 
Seat 9: djammusic ($47.89 in chips) 
simoniustin: posts small blind $0.50
HomerrrJay: is sitting out 
kuanhung0903: posts big blind $1
gabi_igna: sits out 
*** HOLE CARDS ***
Dealt to matiko09 [Jh 3h]
HomerrrJay leaves the table
Ouga Buga: folds 
djammusic: folds 
Dachish joins the table at seat #3 
matiko09: folds 
Dachish leaves the table
simoniustin: folds 
Uncalled bet ($0.50) returned to kuanhung0903
kuanhung0903 collected $1 from pot
kuanhung0903: doesn't show hand 
*** SUMMARY ***
Total pot $1 | Rake $0 
Seat 1: matiko09 (button) folded before Flop (didn't bet)
Seat 2: simoniustin (small blind) folded before Flop
Seat 6: kuanhung0903 (big blind) collected ($1)
Seat 7: Ouga Buga folded before Flop (didn't bet)
Seat 9: djammusic folded before Flop (didn't bet)





PokerStars Hand #149394222260:  Hold'em No Limit ($0.50/$1.00 USD) - 2016/02/25 17:28:14 CET [2016/02/25 11:28:14 ET]
Table 'Zeuxo II' 9-max Seat #4 is the button
Seat 1: forsmthgood ($100 in chips) 
Seat 4: sebaaastian ($100 in chips) 
Seat 5: hammerwife ($100 in chips) 
Seat 6: Cogss ($84.58 in chips) 
Seat 7: djammusic ($49 in chips) 
Seat 8: matiko09 ($131.68 in chips) 
Seat 9: Sreshta222 ($308.63 in chips) 
hammerwife: posts small blind $0.50
Cogss: posts big blind $1
*** HOLE CARDS ***
Dealt to matiko09 [7s Ad]
djammusic: folds 
matiko09: folds 
Sreshta222: folds 
forsmthgood: folds 
sebaaastian: folds 
hammerwife: raises $1.60 to $2.60
Cogss: calls $1.60
*** FLOP *** [8h 3c 4d]
hammerwife: bets $2
Cogss: raises $2 to $4
hammerwife: folds 
Uncalled bet ($2) returned to Cogss
Cogss collected $8.79 from pot
*** SUMMARY ***
Total pot $9.20 | Rake $0.41 
Board [8h 3c 4d]
Seat 1: forsmthgood folded before Flop (didn't bet)
Seat 4: sebaaastian (button) folded before Flop (didn't bet)
Seat 5: hammerwife (small blind) folded on the Flop
Seat 6: Cogss (big blind) collected ($8.79)
Seat 7: djammusic folded before Flop (didn't bet)
Seat 8: matiko09 folded before Flop (didn't bet)
Seat 9: Sreshta222 folded before Flop (didn't bet)





PokerStars Hand #149394223048:  Hold'em No Limit ($0.50/$1.00 USD) - 2016/02/25 17:28:15 CET [2016/02/25 11:28:15 ET]
Table 'Zerbinetta II' 9-max Seat #9 is the button
Seat 1: $-Twackle-$ ($100 in chips) 
Seat 2: lysandrafly ($103.78 in chips) 
Seat 3: matiko09 ($100 in chips) 
Seat 4: sebaaastian ($100 in chips) 
Seat 5: hammerwife ($123.77 in chips) 
Seat 6: nickreason17 ($106.77 in chips) 
Seat 7: HomerrrJay ($100 in chips) 
Seat 8: gabi_igna ($101 in chips) 
Seat 9: with-w ($50.49 in chips) 
$-Twackle-$: posts small blind $0.50
lysandrafly: posts big blind $1
*** HOLE CARDS ***
Dealt to matiko09 [4s 8h]
matiko09: folds 
sebaaastian: folds 
hammerwife: folds 
nickreason17: raises $2 to $3
HomerrrJay: raises $6 to $9
gabi_igna: folds 
with-w: folds 
$-Twackle-$: folds 
lysandrafly: folds 
nickreason17: calls $6
*** FLOP *** [4h 5s 8s]
nickreason17: checks 
HomerrrJay: checks 
*** TURN *** [4h 5s 8s] [Tc]
nickreason17: bets $12
HomerrrJay: folds 
Uncalled bet ($12) returned to nickreason17
nickreason17 collected $18.62 from pot
*** SUMMARY ***
Total pot $19.50 | Rake $0.88 
Board [4h 5s 8s Tc]
Seat 1: $-Twackle-$ (small blind) folded before Flop
Seat 2: lysandrafly (big blind) folded before Flop
Seat 3: matiko09 folded before Flop (didn't bet)
Seat 4: sebaaastian folded before Flop (didn't bet)
Seat 5: hammerwife folded before Flop (didn't bet)
Seat 6: nickreason17 collected ($18.62)
Seat 7: HomerrrJay folded on the Turn
Seat 8: gabi_igna folded before Flop (didn't bet)
Seat 9: with-w (button) folded before Flop (didn't bet)





PokerStars Hand #149394224822:  Hold'em No Limit ($0.50/$1.00 USD) - 2016/02/25 17:28:17 CET [2016/02/25 11:28:17 ET]
Table 'Sabine' 9-max Seat #4 is the button
Seat 1: Aalleekks ($100 in chips) 
Seat 2: apfush ($133.93 in chips) 
Seat 3: Ouga Buga ($107.56 in chips) 
Seat 4: simoniustin ($100 in chips) 
Seat 5: Venomous100% ($107.54 in chips) 
Seat 6: ffac ($106.68 in chips) 
Seat 7: clayshmert ($77.76 in chips) 
Seat 8: matiko09 ($124.97 in chips) 
Seat 9: djammusic ($56.42 in chips) 
Venomous100%: posts small blind $0.50
ffac: posts big blind $1
*** HOLE CARDS ***
Dealt to matiko09 [4h Th]
clayshmert: calls $1
matiko09: folds 
djammusic: raises $3 to $4
Aalleekks: folds 
apfush: folds 
Ouga Buga: folds 
simoniustin: folds 
Venomous100%: folds 
ffac: folds 
clayshmert: calls $3
*** FLOP *** [5c 5s 2h]
clayshmert: checks 
djammusic: bets $5.50
clayshmert: folds 
Uncalled bet ($5.50) returned to djammusic
djammusic collected $9.07 from pot
djammusic: doesn't show hand 
*** SUMMARY ***
Total pot $9.50 | Rake $0.43 
Board [5c 5s 2h]
Seat 1: Aalleekks folded before Flop (didn't bet)
Seat 2: apfush folded before Flop (didn't bet)
Seat 3: Ouga Buga folded before Flop (didn't bet)
Seat 4: simoniustin (button) folded before Flop (didn't bet)
Seat 5: Venomous100% (small blind) folded before Flop
Seat 6: ffac (big blind) folded before Flop
Seat 7: clayshmert folded on the Flop
Seat 8: matiko09 folded before Flop (didn't bet)
Seat 9: djammusic collected ($9.07)





PokerStars Hand #149394226309:  Hold'em No Limit ($0.50/$1.00 USD) - 2016/02/25 17:28:19 CET [2016/02/25 11:28:19 ET]
Table 'Isa' 9-max Seat #9 is the button
Seat 1: matiko09 ($125.08 in chips) 
Seat 2: mycka86 ($161.92 in chips) 
Seat 3: sebaaastian ($138.75 in chips) 
Seat 4: hammerwife ($107.41 in chips) 
Seat 7: bilukm ($43.06 in chips) 
Seat 8: Venomous100% ($112.53 in chips) 
Seat 9: HomerrrJay ($159.11 in chips) 
matiko09: posts small blind $0.50
mycka86: posts big blind $1
*** HOLE CARDS ***
Dealt to matiko09 [Ts 8c]
sebaaastian: folds 
hammerwife: folds 
bilukm has timed out
bilukm: folds 
Venomous100%: raises $1.50 to $2.50
HomerrrJay: calls $2.50
matiko09: folds 
mycka86: folds 
*** FLOP *** [2d 2s Ah]
Venomous100%: bets $4.10
HomerrrJay: folds 
Uncalled bet ($4.10) returned to Venomous100%
Venomous100% collected $6.21 from pot
Venomous100%: doesn't show hand 
*** SUMMARY ***
Total pot $6.50 | Rake $0.29 
Board [2d 2s Ah]
Seat 1: matiko09 (small blind) folded before Flop
Seat 2: mycka86 (big blind) folded before Flop
Seat 3: sebaaastian folded before Flop (didn't bet)
Seat 4: hammerwife folded before Flop (didn't bet)
Seat 7: bilukm folded before Flop (didn't bet)
Seat 8: Venomous100% collected ($6.21)
Seat 9: HomerrrJay (button) folded on the Flop





PokerStars Hand #149394231887:  Hold'em No Limit ($0.50/$1.00 USD) - 2016/02/25 17:28:26 CET [2016/02/25 11:28:26 ET]
Table 'Morosovia II' 9-max Seat #8 is the button
Seat 2: Effort92 ($173.66 in chips) 
Seat 3: sebaaastian ($216.36 in chips) 
Seat 7: matiko09 ($149.48 in chips) 
Seat 8: simoniustin ($122.84 in chips) 
Seat 9: Ouga Buga ($127.09 in chips) 
Ouga Buga: posts small blind $0.50
apfush: is sitting out 
Effort92: posts big blind $1
*** HOLE CARDS ***
Dealt to matiko09 [Ac 4h]
apfush leaves the table
gabi_igna joins the table at seat #5 
sebaaastian: folds 
matiko09: folds 
simoniustin: folds 
Ouga Buga: raises $2 to $3
Effort92: folds 
Uncalled bet ($2) returned to Ouga Buga
Ouga Buga collected $2 from pot
Ouga Buga: doesn't show hand 
*** SUMMARY ***
Total pot $2 | Rake $0 
Seat 2: Effort92 (big blind) folded before Flop
Seat 3: sebaaastian folded before Flop (didn't bet)
Seat 7: matiko09 folded before Flop (didn't bet)
Seat 8: simoniustin (button) folded before Flop (didn't bet)
Seat 9: Ouga Buga (small blind) collected ($2)





PokerStars Hand #149394239427:  Hold'em No Limit ($0.50/$1.00 USD) - 2016/02/25 17:28:36 CET [2016/02/25 11:28:36 ET]
Table 'Badenia II' 9-max Seat #3 is the button
Seat 1: matiko09 ($101 in chips) 
Seat 2: Stibitzkie ($61.27 in chips) 
Seat 3: sebaaastian ($145.50 in chips) 
Seat 4: hammerwife ($101.50 in chips) 
Seat 5: djammusic ($120.43 in chips) 
Seat 7: forsmthgood ($110.94 in chips) 
Seat 9: waisanen ($238.48 in chips) 
hammerwife: posts small blind $0.50
djammusic: posts big blind $1
*** HOLE CARDS ***
Dealt to matiko09 [8s Tc]
forsmthgood: folds 
waisanen: folds 
matiko09: folds 
Stibitzkie: folds 
sebaaastian: folds 
hammerwife: folds 
Uncalled bet ($0.50) returned to djammusic
djammusic collected $1 from pot
djammusic: doesn't show hand 
*** SUMMARY ***
Total pot $1 | Rake $0 
Seat 1: matiko09 folded before Flop (didn't bet)
Seat 2: Stibitzkie folded before Flop (didn't bet)
Seat 3: sebaaastian (button) folded before Flop (didn't bet)
Seat 4: hammerwife (small blind) folded before Flop
Seat 5: djammusic (big blind) collected ($1)
Seat 7: forsmthgood folded before Flop (didn't bet)
Seat 9: waisanen folded before Flop (didn't bet)





PokerStars Hand #149394240324:  Hold'em No Limit ($0.50/$1.00 USD) - 2016/02/25 17:28:37 CET [2016/02/25 11:28:37 ET]
Table 'Hercules IV' 9-max Seat #2 is the button
Seat 1: matiko09 ($100 in chips) 
Seat 2: simoniustin ($100 in chips) 
Seat 6: kuanhung0903 ($41.52 in chips) 
Seat 7: Ouga Buga ($114.06 in chips) 
Seat 9: djammusic ($47.89 in chips) 
kuanhung0903: posts small blind $0.50
Ouga Buga: posts big blind $1
gabi_igna: sits out 
*** HOLE CARDS ***
Dealt to matiko09 [9d 4d]
djammusic: folds 
birdie1970 joins the table at seat #3 
matiko09: folds 
simoniustin: raises $1.50 to $2.50
kuanhung0903: folds 
Ouga Buga: folds 
Uncalled bet ($1.50) returned to simoniustin
simoniustin collected $2.50 from pot
simoniustin: doesn't show hand 
*** SUMMARY ***
Total pot $2.50 | Rake $0 
Seat 1: matiko09 folded before Flop (didn't bet)
Seat 2: simoniustin (button) collected ($2.50)
Seat 6: kuanhung0903 (small blind) folded before Flop
Seat 7: Ouga Buga (big blind) folded before Flop
Seat 9: djammusic folded before Flop (didn't bet)





PokerStars Hand #149394243742:  Hold'em No Limit ($0.25/$0.50 USD) - 2016/02/25 17:28:41 CET [2016/02/25 11:28:41 ET]
Table 'Lohja II' 9-max Seat #1 is the button
Seat 1: MoonJimmy ($155 in chips) 
Seat 3: guvalc1952 ($223.20 in chips) 
Seat 4: payback11 ($50 in chips) 
Seat 7: matiko09 ($95.31 in chips) 
Seat 8: jamba83 ($69.34 in chips) 
Seat 9: Al3xAnd3r22 ($98.56 in chips) 
guvalc1952: posts small blind $0.25
payback11: posts big blind $0.50
Effort92: sits out 
MoonJimmy: posts the ante $0.10
guvalc1952: posts the ante $0.10
payback11: posts the ante $0.10
matiko09: posts the ante $0.10
jamba83: posts the ante $0.10
Al3xAnd3r22: posts the ante $0.10
*** HOLE CARDS ***
Dealt to matiko09 [Qd 8c]
matiko09: folds 
jamba83: folds 
Al3xAnd3r22: raises $0.72 to $1.22
MoonJimmy: calls $1.22
guvalc1952: calls $0.97
payback11: folds 
*** FLOP *** [6c 2c 7d]
guvalc1952: checks 
Al3xAnd3r22: checks 
MoonJimmy: bets $2.27
guvalc1952: calls $2.27
Al3xAnd3r22: folds 
*** TURN *** [6c 2c 7d] [Ts]
guvalc1952: checks 
MoonJimmy: bets $4.44
guvalc1952: calls $4.44
*** RIVER *** [6c 2c 7d Ts] [Js]
guvalc1952: checks 
MoonJimmy: checks 
*** SHOW DOWN ***
guvalc1952: shows [7h As] (a pair of Sevens)
MoonJimmy: shows [9c 9s] (a pair of Nines)
MoonJimmy collected $17.36 from pot
*** SUMMARY ***
Total pot $18.18 | Rake $0.82 
Board [6c 2c 7d Ts Js]
Seat 1: MoonJimmy (button) showed [9c 9s] and won ($17.36) with a pair of Nines
Seat 3: guvalc1952 (small blind) showed [7h As] and lost with a pair of Sevens
Seat 4: payback11 (big blind) folded before Flop
Seat 7: matiko09 folded before Flop (didn't bet)
Seat 8: jamba83 folded before Flop (didn't bet)
Seat 9: Al3xAnd3r22 folded on the Flop





PokerStars Hand #149394252607:  Hold'em No Limit ($0.50/$1.00 USD) - 2016/02/25 17:28:52 CET [2016/02/25 11:28:52 ET]
Table 'Ebella II' 9-max Seat #1 is the button
Seat 1: nickreason17 ($114.65 in chips) 
Seat 3: fanmtZ ($40 in chips) 
Seat 5: matiko09 ($100 in chips) 
Seat 6: gabi_igna ($103.55 in chips) 
Seat 7: $-Twackle-$ ($100 in chips) 
Seat 8: ZMPOUTSAM140 ($99.46 in chips) 
Seat 9: simoniustin ($112.13 in chips) 
fanmtZ: posts small blind $0.50
matiko09: posts big blind $1
*** HOLE CARDS ***
Dealt to matiko09 [7s 4s]
gabi_igna: raises $2 to $3
$-Twackle-$: folds 
ZMPOUTSAM140: calls $3
simoniustin: folds 
nickreason17: folds 
fanmtZ: folds 
matiko09: folds 
*** FLOP *** [8s Jc Js]
gabi_igna: bets $4
ZMPOUTSAM140: folds 
Uncalled bet ($4) returned to gabi_igna
gabi_igna collected $7.16 from pot
gabi_igna: doesn't show hand 
*** SUMMARY ***
Total pot $7.50 | Rake $0.34 
Board [8s Jc Js]
Seat 1: nickreason17 (button) folded before Flop (didn't bet)
Seat 3: fanmtZ (small blind) folded before Flop
Seat 5: matiko09 (big blind) folded before Flop
Seat 6: gabi_igna collected ($7.16)
Seat 7: $-Twackle-$ folded before Flop (didn't bet)
Seat 8: ZMPOUTSAM140 folded on the Flop
Seat 9: simoniustin folded before Flop (didn't bet)





PokerStars Hand #149394253727:  Hold'em No Limit ($0.50/$1.00 USD) - 2016/02/25 17:28:54 CET [2016/02/25 11:28:54 ET]
Table 'Badenia II' 9-max Seat #4 is the button
Seat 1: matiko09 ($101 in chips) 
Seat 2: Stibitzkie ($61.27 in chips) 
Seat 3: sebaaastian ($145.50 in chips) 
Seat 4: hammerwife ($101 in chips) 
Seat 5: djammusic ($120.93 in chips) 
Seat 7: forsmthgood ($110.94 in chips) 
Seat 9: waisanen ($238.48 in chips) 
djammusic: posts small blind $0.50
forsmthgood: posts big blind $1
*** HOLE CARDS ***
Dealt to matiko09 [2c 2h]
waisanen: folds 
matiko09: folds 
Stibitzkie: folds 
sebaaastian: folds 
hammerwife: folds 
djammusic: folds 
Uncalled bet ($0.50) returned to forsmthgood
forsmthgood collected $1 from pot
forsmthgood: doesn't show hand 
*** SUMMARY ***
Total pot $1 | Rake $0 
Seat 1: matiko09 folded before Flop (didn't bet)
Seat 2: Stibitzkie folded before Flop (didn't bet)
Seat 3: sebaaastian folded before Flop (didn't bet)
Seat 4: hammerwife (button) folded before Flop (didn't bet)
Seat 5: djammusic (small blind) folded before Flop
Seat 7: forsmthgood (big blind) collected ($1)
Seat 9: waisanen folded before Flop (didn't bet)





PokerStars Hand #149394256563:  Hold'em No Limit ($0.50/$1.00 USD) - 2016/02/25 17:28:57 CET [2016/02/25 11:28:57 ET]
Table 'Hercules IV' 9-max Seat #6 is the button
Seat 1: matiko09 ($100 in chips) 
Seat 2: simoniustin ($101.50 in chips) 
Seat 6: kuanhung0903 ($41.02 in chips) 
Seat 7: Ouga Buga ($113.06 in chips) 
Seat 8: gabi_igna ($100 in chips) 
Seat 9: djammusic ($47.89 in chips) 
Ouga Buga: posts small blind $0.50
gabi_igna: posts big blind $1
birdie1970: sits out 
*** HOLE CARDS ***
Dealt to matiko09 [5h 6h]
djammusic: folds 
djammusic leaves the table
matiko09: folds 
simoniustin: folds 
kuanhung0903: raises $2 to $3
Ouga Buga: folds 
gabi_igna: folds 
Uncalled bet ($2) returned to kuanhung0903
kuanhung0903 collected $2.50 from pot
*** SUMMARY ***
Total pot $2.50 | Rake $0 
Seat 1: matiko09 folded before Flop (didn't bet)
Seat 2: simoniustin folded before Flop (didn't bet)
Seat 6: kuanhung0903 (button) collected ($2.50)
Seat 7: Ouga Buga (small blind) folded before Flop
Seat 8: gabi_igna (big blind) folded before Flop
Seat 9: djammusic folded before Flop (didn't bet)





PokerStars Hand #149394260480:  Hold'em No Limit ($0.50/$1.00 USD) - 2016/02/25 17:29:02 CET [2016/02/25 11:29:02 ET]
Table 'Morosovia II' 9-max Seat #9 is the button
Seat 2: Effort92 ($172.66 in chips) 
Seat 3: sebaaastian ($216.36 in chips) 
Seat 7: matiko09 ($149.48 in chips) 
Seat 8: simoniustin ($122.84 in chips) 
Seat 9: Ouga Buga ($128.09 in chips) 
Effort92: posts small blind $0.50
sebaaastian: posts big blind $1
gabi_igna: sits out 
*** HOLE CARDS ***
Dealt to matiko09 [Qh Kd]
matiko09: raises $2 to $3
simoniustin: folds 
Ouga Buga: raises $6.50 to $9.50
Effort92: folds 
sebaaastian: folds 
matiko09: folds 
Uncalled bet ($6.50) returned to Ouga Buga
Ouga Buga collected $7.50 from pot
Ouga Buga: doesn't show hand 
*** SUMMARY ***
Total pot $7.50 | Rake $0 
Seat 2: Effort92 (small blind) folded before Flop
Seat 3: sebaaastian (big blind) folded before Flop
Seat 7: matiko09 folded before Flop
Seat 8: simoniustin folded before Flop (didn't bet)
Seat 9: Ouga Buga (button) collected ($7.50)





PokerStars Hand #149394266407:  Hold'em No Limit ($0.50/$1.00 USD) - 2016/02/25 17:29:10 CET [2016/02/25 11:29:10 ET]
Table 'Eurysaces II' 9-max Seat #3 is the button
Seat 1: lysandrafly ($100 in chips) 
Seat 2: sebaaastian ($103.78 in chips) 
Seat 3: nickreason17 ($100 in chips) 
Seat 4: Hujiafeng ($99 in chips) 
Seat 5: keessie93 ($67.41 in chips) 
Seat 6: J0rmungund ($38 in chips) 
Seat 7: $-Twackle-$ ($101.50 in chips) 
Seat 8: HomerrrJay ($100 in chips) 
Seat 9: matiko09 ($102.39 in chips) 
Hujiafeng: posts small blind $0.50
keessie93: posts big blind $1
*** HOLE CARDS ***
Dealt to matiko09 [Qc 8c]
J0rmungund: folds 
$-Twackle-$: folds 
HomerrrJay: folds 
matiko09: folds 
lysandrafly: folds 
sebaaastian: folds 
nickreason17: raises $1.04 to $2.04
Hujiafeng: calls $1.54
keessie93: calls $1.04
*** FLOP *** [2s Th Jc]
Hujiafeng: checks 
keessie93: bets $4.50
nickreason17: folds 
Hujiafeng: folds 
Uncalled bet ($4.50) returned to keessie93
keessie93 collected $5.84 from pot
keessie93: doesn't show hand 
*** SUMMARY ***
Total pot $6.12 | Rake $0.28 
Board [2s Th Jc]
Seat 1: lysandrafly folded before Flop (didn't bet)
Seat 2: sebaaastian folded before Flop (didn't bet)
Seat 3: nickreason17 (button) folded on the Flop
Seat 4: Hujiafeng (small blind) folded on the Flop
Seat 5: keessie93 (big blind) collected ($5.84)
Seat 6: J0rmungund folded before Flop (didn't bet)
Seat 7: $-Twackle-$ folded before Flop (didn't bet)
Seat 8: HomerrrJay folded before Flop (didn't bet)
Seat 9: matiko09 folded before Flop (didn't bet)





PokerStars Hand #149394268449:  Hold'em No Limit ($0.50/$1.00 USD) - 2016/02/25 17:29:12 CET [2016/02/25 11:29:12 ET]
Table 'Zeuxo II' 9-max Seat #5 is the button
Seat 1: forsmthgood ($100 in chips) 
Seat 4: sebaaastian ($100 in chips) 
Seat 5: hammerwife ($100 in chips) 
Seat 6: Cogss ($88.77 in chips) 
Seat 7: djammusic ($49 in chips) 
Seat 8: matiko09 ($131.68 in chips) 
Seat 9: Sreshta222 ($308.63 in chips) 
Cogss: posts small blind $0.50
djammusic: posts big blind $1
*** HOLE CARDS ***
Dealt to matiko09 [3s 5h]
matiko09: folds 
Sreshta222: folds 
forsmthgood: folds 
sebaaastian: folds 
hammerwife: folds 
Cogss: raises $1 to $2
djammusic: folds 
Uncalled bet ($1) returned to Cogss
Cogss collected $2 from pot
*** SUMMARY ***
Total pot $2 | Rake $0 
Seat 1: forsmthgood folded before Flop (didn't bet)
Seat 4: sebaaastian folded before Flop (didn't bet)
Seat 5: hammerwife (button) folded before Flop (didn't bet)
Seat 6: Cogss (small blind) collected ($2)
Seat 7: djammusic (big blind) folded before Flop
Seat 8: matiko09 folded before Flop (didn't bet)
Seat 9: Sreshta222 folded before Flop (didn't bet)





PokerStars Hand #149394269195:  Hold'em No Limit ($0.50/$1.00 USD) - 2016/02/25 17:29:13 CET [2016/02/25 11:29:13 ET]
Table 'Badenia II' 9-max Seat #5 is the button
Seat 1: matiko09 ($101 in chips) 
Seat 2: Stibitzkie ($61.27 in chips) 
Seat 3: sebaaastian ($145.50 in chips) 
Seat 4: hammerwife ($101 in chips) 
Seat 5: djammusic ($120.43 in chips) 
Seat 7: forsmthgood ($111.44 in chips) 
Seat 9: waisanen ($238.48 in chips) 
forsmthgood: posts small blind $0.50
waisanen: posts big blind $1
*** HOLE CARDS ***
Dealt to matiko09 [Ah 8s]
matiko09: folds 
Stibitzkie: folds 
sebaaastian: folds 
hammerwife: raises $1.50 to $2.50
djammusic: folds 
forsmthgood: folds 
waisanen: calls $1.50
*** FLOP *** [7d Jh 4c]
waisanen: checks 
hammerwife: checks 
*** TURN *** [7d Jh 4c] [5c]
waisanen: checks 
hammerwife: bets $4
waisanen: folds 
Uncalled bet ($4) returned to hammerwife
hammerwife collected $5.25 from pot
hammerwife: doesn't show hand 
*** SUMMARY ***
Total pot $5.50 | Rake $0.25 
Board [7d Jh 4c 5c]
Seat 1: matiko09 folded before Flop (didn't bet)
Seat 2: Stibitzkie folded before Flop (didn't bet)
Seat 3: sebaaastian folded before Flop (didn't bet)
Seat 4: hammerwife collected ($5.25)
Seat 5: djammusic (button) folded before Flop (didn't bet)
Seat 7: forsmthgood (small blind) folded before Flop
Seat 9: waisanen (big blind) folded on the Turn





PokerStars Hand #149394269771:  Hold'em No Limit ($0.50/$1.00 USD) - 2016/02/25 17:29:14 CET [2016/02/25 11:29:14 ET]
Table 'Isa' 9-max Seat #1 is the button
Seat 1: matiko09 ($124.58 in chips) 
Seat 2: mycka86 ($160.92 in chips) 
Seat 3: sebaaastian ($138.75 in chips) 
Seat 4: hammerwife ($107.41 in chips) 
Seat 7: bilukm ($93.06 in chips) 
Seat 8: Venomous100% ($116.24 in chips) 
Seat 9: HomerrrJay ($156.61 in chips) 
mycka86: posts small blind $0.50
sebaaastian: posts big blind $1
*** HOLE CARDS ***
Dealt to matiko09 [Th 6d]
hammerwife: raises $2 to $3
bilukm is connected 
bilukm: folds 
Venomous100%: folds 
HomerrrJay: folds 
matiko09: folds 
mycka86: folds 
sebaaastian: folds 
Uncalled bet ($2) returned to hammerwife
hammerwife collected $2.50 from pot
hammerwife: doesn't show hand 
*** SUMMARY ***
Total pot $2.50 | Rake $0 
Seat 1: matiko09 (button) folded before Flop (didn't bet)
Seat 2: mycka86 (small blind) folded before Flop
Seat 3: sebaaastian (big blind) folded before Flop
Seat 4: hammerwife collected ($2.50)
Seat 7: bilukm folded before Flop (didn't bet)
Seat 8: Venomous100% folded before Flop (didn't bet)
Seat 9: HomerrrJay folded before Flop (didn't bet)





PokerStars Hand #149394276408:  Hold'em No Limit ($0.50/$1.00 USD) - 2016/02/25 17:29:23 CET [2016/02/25 11:29:23 ET]
Table 'Sabine' 9-max Seat #5 is the button
Seat 1: Aalleekks ($100 in chips) 
Seat 2: apfush ($133.93 in chips) 
Seat 3: Ouga Buga ($107.56 in chips) 
Seat 4: simoniustin ($100 in chips) 
Seat 5: Venomous100% ($107.04 in chips) 
Seat 6: ffac ($105.68 in chips) 
Seat 7: clayshmert ($73.76 in chips) 
Seat 8: matiko09 ($124.97 in chips) 
Seat 9: djammusic ($61.49 in chips) 
ffac: posts small blind $0.50
clayshmert: posts big blind $1
*** HOLE CARDS ***
Dealt to matiko09 [Th Qd]
matiko09: folds 
djammusic: folds 
Aalleekks has timed out
Aalleekks: folds 
apfush: folds 
Ouga Buga: raises $1.50 to $2.50
simoniustin: folds 
Venomous100%: folds 
ffac: folds 
clayshmert: calls $1.50
*** FLOP *** [5s Ac Qs]
clayshmert: checks 
Ouga Buga: checks 
*** TURN *** [5s Ac Qs] [3s]
clayshmert: checks 
Ouga Buga: bets $3.18
clayshmert: calls $3.18
*** RIVER *** [5s Ac Qs 3s] [9d]
clayshmert: checks 
Ouga Buga: checks 
*** SHOW DOWN ***
clayshmert: shows [5c 5h] (three of a kind, Fives)
Ouga Buga: mucks hand 
clayshmert collected $11.33 from pot
*** SUMMARY ***
Total pot $11.86 | Rake $0.53 
Board [5s Ac Qs 3s 9d]
Seat 1: Aalleekks folded before Flop (didn't bet)
Seat 2: apfush folded before Flop (didn't bet)
Seat 3: Ouga Buga mucked [Jd Qh]
Seat 4: simoniustin folded before Flop (didn't bet)
Seat 5: Venomous100% (button) folded before Flop (didn't bet)
Seat 6: ffac (small blind) folded before Flop
Seat 7: clayshmert (big blind) showed [5c 5h] and won ($11.33) with three of a kind, Fives
Seat 8: matiko09 folded before Flop (didn't bet)
Seat 9: djammusic folded before Flop (didn't bet)





PokerStars Hand #149394290144:  Hold'em No Limit ($0.50/$1.00 USD) - 2016/02/25 17:29:40 CET [2016/02/25 11:29:40 ET]
Table 'Ebella II' 9-max Seat #3 is the button
Seat 1: nickreason17 ($114.65 in chips) 
Seat 3: fanmtZ ($40 in chips) 
Seat 5: matiko09 ($100 in chips) 
Seat 6: gabi_igna ($107.71 in chips) 
Seat 7: $-Twackle-$ ($100 in chips) 
Seat 8: ZMPOUTSAM140 ($96.46 in chips) 
Seat 9: simoniustin ($112.13 in chips) 
matiko09: posts small blind $0.50
gabi_igna: posts big blind $1
*** HOLE CARDS ***
Dealt to matiko09 [2s As]
$-Twackle-$: folds 
ZMPOUTSAM140: folds 
simoniustin: raises $2 to $3
nickreason17: folds 
fanmtZ: folds 
matiko09: raises $7 to $10
gabi_igna: folds 
simoniustin: folds 
Uncalled bet ($7) returned to matiko09
matiko09 collected $7 from pot
matiko09: doesn't show hand 
*** SUMMARY ***
Total pot $7 | Rake $0 
Seat 1: nickreason17 folded before Flop (didn't bet)
Seat 3: fanmtZ (button) folded before Flop (didn't bet)
Seat 5: matiko09 (small blind) collected ($7)
Seat 6: gabi_igna (big blind) folded before Flop
Seat 7: $-Twackle-$ folded before Flop (didn't bet)
Seat 8: ZMPOUTSAM140 folded before Flop (didn't bet)
Seat 9: simoniustin folded before Flop





PokerStars Hand #149394293312:  Hold'em No Limit ($0.50/$1.00 USD) - 2016/02/25 17:29:44 CET [2016/02/25 11:29:44 ET]
Table 'Morosovia II' 9-max Seat #2 is the button
Seat 2: Effort92 ($172.16 in chips) 
Seat 3: sebaaastian ($215.36 in chips) 
Seat 5: gabi_igna ($100 in chips) 
Seat 7: matiko09 ($146.48 in chips) 
Seat 8: simoniustin ($122.84 in chips) 
Seat 9: Ouga Buga ($132.59 in chips) 
sebaaastian: posts small blind $0.50
gabi_igna: posts big blind $1
*** HOLE CARDS ***
Dealt to matiko09 [6c 5d]
matiko09: folds 
simoniustin: folds 
Ouga Buga: folds 
Effort92: raises $1 to $2
sebaaastian: folds 
gabi_igna: folds 
Uncalled bet ($1) returned to Effort92
Effort92 collected $2.50 from pot
Effort92: doesn't show hand 
*** SUMMARY ***
Total pot $2.50 | Rake $0 
Seat 2: Effort92 (button) collected ($2.50)
Seat 3: sebaaastian (small blind) folded before Flop
Seat 5: gabi_igna (big blind) folded before Flop
Seat 7: matiko09 folded before Flop (didn't bet)
Seat 8: simoniustin folded before Flop (didn't bet)
Seat 9: Ouga Buga folded before Flop (didn't bet)





PokerStars Hand #149394294048:  Hold'em No Limit ($0.50/$1.00 USD) - 2016/02/25 17:29:45 CET [2016/02/25 11:29:45 ET]
Table 'Mayall II' 9-max Seat #3 is the button
Seat 1: matiko09 ($125.91 in chips) 
Seat 3: simoniustin ($100 in chips) 
Seat 4: Ouga Buga ($103.92 in chips) 
Seat 5: HomerrrJay ($101.50 in chips) 
Seat 6: apfush ($113.67 in chips) 
Seat 7: r.pol218 ($33 in chips) 
Seat 8: kuanhung0903 ($91.46 in chips) 
Ouga Buga: posts small blind $0.50
HomerrrJay: posts big blind $1
*** HOLE CARDS ***
Dealt to matiko09 [Ah 3s]
apfush: folds 
kuanhung0903 is disconnected 
r.pol218: folds 
kuanhung0903: folds 
matiko09: folds 
simoniustin: folds 
Ouga Buga: folds 
Uncalled bet ($0.50) returned to HomerrrJay
HomerrrJay collected $1 from pot
HomerrrJay: doesn't show hand 
*** SUMMARY ***
Total pot $1 | Rake $0 
Seat 1: matiko09 folded before Flop (didn't bet)
Seat 3: simoniustin (button) folded before Flop (didn't bet)
Seat 4: Ouga Buga (small blind) folded before Flop
Seat 5: HomerrrJay (big blind) collected ($1)
Seat 6: apfush folded before Flop (didn't bet)
Seat 7: r.pol218 folded before Flop (didn't bet)
Seat 8: kuanhung0903 folded before Flop (didn't bet)





PokerStars Hand #149394295669:  Hold'em No Limit ($0.50/$1.00 USD) - 2016/02/25 17:29:47 CET [2016/02/25 11:29:47 ET]
Table 'Zerbinetta II' 9-max Seat #1 is the button
Seat 1: $-Twackle-$ ($100 in chips) 
Seat 2: lysandrafly ($102.78 in chips) 
Seat 3: matiko09 ($100 in chips) 
Seat 4: sebaaastian ($100 in chips) 
Seat 5: hammerwife ($123.77 in chips) 
Seat 6: nickreason17 ($116.39 in chips) 
Seat 7: HomerrrJay ($100 in chips) 
Seat 8: gabi_igna ($101 in chips) 
Seat 9: with-w ($50.49 in chips) 
lysandrafly: posts small blind $0.50
matiko09: posts big blind $1
*** HOLE CARDS ***
Dealt to matiko09 [Kh Ac]
sebaaastian: folds 
hammerwife: folds 
nickreason17: folds 
HomerrrJay: raises $1.50 to $2.50
gabi_igna: folds 
with-w: folds 
$-Twackle-$: folds 
lysandrafly: folds 
matiko09: calls $1.50
*** FLOP *** [6h 7s 2s]
matiko09: checks 
HomerrrJay: checks 
*** TURN *** [6h 7s 2s] [6c]
matiko09: checks 
HomerrrJay: checks 
*** RIVER *** [6h 7s 2s 6c] [2d]
matiko09: checks 
HomerrrJay: checks 
*** SHOW DOWN ***
matiko09: shows [Kh Ac] (two pair, Sixes and Deuces)
HomerrrJay: mucks hand 
matiko09 collected $5.25 from pot
*** SUMMARY ***
Total pot $5.50 | Rake $0.25 
Board [6h 7s 2s 6c 2d]
Seat 1: $-Twackle-$ (button) folded before Flop (didn't bet)
Seat 2: lysandrafly (small blind) folded before Flop
Seat 3: matiko09 (big blind) showed [Kh Ac] and won ($5.25) with two pair, Sixes and Deuces
Seat 4: sebaaastian folded before Flop (didn't bet)
Seat 5: hammerwife folded before Flop (didn't bet)
Seat 6: nickreason17 folded before Flop (didn't bet)
Seat 7: HomerrrJay mucked [Jc Tc]
Seat 8: gabi_igna folded before Flop (didn't bet)
Seat 9: with-w folded before Flop (didn't bet)





PokerStars Hand #149394296610:  Hold'em No Limit ($0.50/$1.00 USD) - 2016/02/25 17:29:48 CET [2016/02/25 11:29:48 ET]
Table 'Zeuxo II' 9-max Seat #6 is the button
Seat 1: forsmthgood ($100 in chips) 
Seat 4: sebaaastian ($100 in chips) 
Seat 5: hammerwife ($100 in chips) 
Seat 6: Cogss ($89.77 in chips) 
Seat 7: djammusic ($48 in chips) 
Seat 8: matiko09 ($131.68 in chips) 
Seat 9: Sreshta222 ($308.63 in chips) 
djammusic: posts small blind $0.50
matiko09: posts big blind $1
*** HOLE CARDS ***
Dealt to matiko09 [9s 8h]
Sreshta222: folds 
forsmthgood: folds 
sebaaastian: raises $2 to $3
hammerwife: folds 
Cogss: calls $3
djammusic: folds 
matiko09: folds 
*** FLOP *** [Ah Qs 9c]
sebaaastian: checks 
Cogss: bets $7.16
sebaaastian: folds 
Uncalled bet ($7.16) returned to Cogss
Cogss collected $7.16 from pot
*** SUMMARY ***
Total pot $7.50 | Rake $0.34 
Board [Ah Qs 9c]
Seat 1: forsmthgood folded before Flop (didn't bet)
Seat 4: sebaaastian folded on the Flop
Seat 5: hammerwife folded before Flop (didn't bet)
Seat 6: Cogss (button) collected ($7.16)
Seat 7: djammusic (small blind) folded before Flop
Seat 8: matiko09 (big blind) folded before Flop
Seat 9: Sreshta222 folded before Flop (didn't bet)





PokerStars Hand #149394297480:  Hold'em No Limit ($0.50/$1.00 USD) - 2016/02/25 17:29:49 CET [2016/02/25 11:29:49 ET]
Table 'Nerthus II' 9-max Seat #8 is the button
Seat 1: DUkalisUA ($101.71 in chips) 
Seat 2: matiko09 ($222.18 in chips) 
Seat 3: simoniustin ($100 in chips) 
Seat 4: Ilov3NBA ($100 in chips) 
Seat 6: mycka86 ($142.88 in chips) 
Seat 7: Venomous100% ($114.61 in chips) 
Seat 8: Kelvin sai ($44.38 in chips) 
Seat 9: hammerwife ($102.50 in chips) 
hammerwife: posts small blind $0.50
DUkalisUA: posts big blind $1
*** HOLE CARDS ***
Dealt to matiko09 [5h 5s]
matiko09: folds 
simoniustin: folds 
Ilov3NBA: folds 
mycka86: folds 
Venomous100%: raises $1.50 to $2.50
Kelvin sai: folds 
hammerwife: folds 
DUkalisUA: calls $1.50
*** FLOP *** [Qd 6h 2h]
DUkalisUA: checks 
Venomous100%: bets $3.46
DUkalisUA: raises $8.04 to $11.50
Venomous100%: folds 
Uncalled bet ($8.04) returned to DUkalisUA
DUkalisUA collected $11.86 from pot
DUkalisUA: doesn't show hand 
*** SUMMARY ***
Total pot $12.42 | Rake $0.56 
Board [Qd 6h 2h]
Seat 1: DUkalisUA (big blind) collected ($11.86)
Seat 2: matiko09 folded before Flop (didn't bet)
Seat 3: simoniustin folded before Flop (didn't bet)
Seat 4: Ilov3NBA folded before Flop (didn't bet)
Seat 6: mycka86 folded before Flop (didn't bet)
Seat 7: Venomous100% folded on the Flop
Seat 8: Kelvin sai (button) folded before Flop (didn't bet)
Seat 9: hammerwife (small blind) folded before Flop





PokerStars Hand #149394298884:  Hold'em No Limit ($0.25/$0.50 USD) - 2016/02/25 17:29:51 CET [2016/02/25 11:29:51 ET]
Table 'Lohja II' 9-max Seat #3 is the button
Seat 1: MoonJimmy ($164.33 in chips) 
Seat 3: guvalc1952 ($215.17 in chips) 
Seat 4: payback11 ($50 in chips) 
Seat 5: Effort92 ($50 in chips) 
Seat 7: matiko09 ($95.21 in chips) 
Seat 8: jamba83 ($69.24 in chips) 
Seat 9: Al3xAnd3r22 ($98 in chips) 
payback11: posts small blind $0.25
Effort92: posts big blind $0.50
MoonJimmy: posts the ante $0.10
guvalc1952: posts the ante $0.10
payback11: posts the ante $0.10
Effort92: posts the ante $0.10
matiko09: posts the ante $0.10
jamba83: posts the ante $0.10
Al3xAnd3r22: posts the ante $0.10
*** HOLE CARDS ***
Dealt to matiko09 [9c 8s]
matiko09: folds 
jamba83: folds 
Al3xAnd3r22: folds 
MoonJimmy: folds 
guvalc1952: calls $0.50
Apparat888 leaves the table
payback11: raises $2.50 to $3
mycka86 joins the table at seat #2 
Effort92: folds 
guvalc1952: calls $2.50
*** FLOP *** [3h 3c Js]
payback11: checks 
guvalc1952: checks 
*** TURN *** [3h 3c Js] [5c]
payback11: checks 
guvalc1952: bets $6.88
payback11: folds 
Uncalled bet ($6.88) returned to guvalc1952
guvalc1952 collected $6.88 from pot
guvalc1952: doesn't show hand 
*** SUMMARY ***
Total pot $7.20 | Rake $0.32 
Board [3h 3c Js 5c]
Seat 1: MoonJimmy folded before Flop (didn't bet)
Seat 3: guvalc1952 (button) collected ($6.88)
Seat 4: payback11 (small blind) folded on the Turn
Seat 5: Effort92 (big blind) folded before Flop
Seat 7: matiko09 folded before Flop (didn't bet)
Seat 8: jamba83 folded before Flop (didn't bet)
Seat 9: Al3xAnd3r22 folded before Flop (didn't bet)





PokerStars Hand #149394316510:  Hold'em No Limit ($0.50/$1.00 USD) - 2016/02/25 17:30:13 CET [2016/02/25 11:30:13 ET]
Table 'Ebella II' 9-max Seat #5 is the button
Seat 1: nickreason17 ($114.65 in chips) 
Seat 3: fanmtZ ($40 in chips) 
Seat 5: matiko09 ($104 in chips) 
Seat 6: gabi_igna ($106.71 in chips) 
Seat 7: $-Twackle-$ ($100 in chips) 
Seat 8: ZMPOUTSAM140 ($96.46 in chips) 
Seat 9: simoniustin ($109.13 in chips) 
gabi_igna: posts small blind $0.50
$-Twackle-$: posts big blind $1
*** HOLE CARDS ***
Dealt to matiko09 [Jd 3d]
ZMPOUTSAM140: folds 
simoniustin: folds 
nickreason17: folds 
fanmtZ: raises $1.38 to $2.38
matiko09: folds 
gabi_igna: folds 
$-Twackle-$: folds 
Uncalled bet ($1.38) returned to fanmtZ
fanmtZ collected $2.50 from pot
fanmtZ: doesn't show hand 
*** SUMMARY ***
Total pot $2.50 | Rake $0 
Seat 1: nickreason17 folded before Flop (didn't bet)
Seat 3: fanmtZ collected ($2.50)
Seat 5: matiko09 (button) folded before Flop (didn't bet)
Seat 6: gabi_igna (small blind) folded before Flop
Seat 7: $-Twackle-$ (big blind) folded before Flop
Seat 8: ZMPOUTSAM140 folded before Flop (didn't bet)
Seat 9: simoniustin folded before Flop (didn't bet)





PokerStars Hand #149394322238:  Hold'em No Limit ($0.50/$1.00 USD) - 2016/02/25 17:30:20 CET [2016/02/25 11:30:20 ET]
Table 'Isa' 9-max Seat #2 is the button
Seat 1: matiko09 ($124.58 in chips) 
Seat 2: mycka86 ($160.42 in chips) 
Seat 3: sebaaastian ($137.75 in chips) 
Seat 4: hammerwife ($108.91 in chips) 
Seat 7: bilukm ($93.06 in chips) 
Seat 8: Venomous100% ($116.24 in chips) 
Seat 9: HomerrrJay ($156.61 in chips) 
sebaaastian: posts small blind $0.50
hammerwife: posts big blind $1
*** HOLE CARDS ***
Dealt to matiko09 [5c 3c]
bilukm: raises $1 to $2
Venomous100%: folds 
HomerrrJay: folds 
matiko09: folds 
mycka86: folds 
sebaaastian: folds 
hammerwife: folds 
Uncalled bet ($1) returned to bilukm
bilukm collected $2.50 from pot
bilukm: doesn't show hand 
*** SUMMARY ***
Total pot $2.50 | Rake $0 
Seat 1: matiko09 folded before Flop (didn't bet)
Seat 2: mycka86 (button) folded before Flop (didn't bet)
Seat 3: sebaaastian (small blind) folded before Flop
Seat 4: hammerwife (big blind) folded before Flop
Seat 7: bilukm collected ($2.50)
Seat 8: Venomous100% folded before Flop (didn't bet)
Seat 9: HomerrrJay folded before Flop (didn't bet)





PokerStars Hand #149394325366:  Hold'em No Limit ($0.50/$1.00 USD) - 2016/02/25 17:30:24 CET [2016/02/25 11:30:24 ET]
Table 'Mayall II' 9-max Seat #4 is the button
Seat 1: matiko09 ($125.91 in chips) 
Seat 3: simoniustin ($100 in chips) 
Seat 4: Ouga Buga ($103.42 in chips) 
Seat 5: HomerrrJay ($102 in chips) 
Seat 6: apfush ($113.67 in chips) 
Seat 7: r.pol218 ($33 in chips) 
Seat 8: kuanhung0903 ($91.46 in chips) 
HomerrrJay: posts small blind $0.50
apfush: posts big blind $1
*** HOLE CARDS ***
Dealt to matiko09 [Qd Js]
r.pol218 has timed out
r.pol218: folds 
kuanhung0903: folds 
matiko09: folds 
simoniustin: raises $1.50 to $2.50
Ouga Buga: folds 
HomerrrJay: folds 
apfush: folds 
Uncalled bet ($1.50) returned to simoniustin
simoniustin collected $2.50 from pot
simoniustin: doesn't show hand 
*** SUMMARY ***
Total pot $2.50 | Rake $0 
Seat 1: matiko09 folded before Flop (didn't bet)
Seat 3: simoniustin collected ($2.50)
Seat 4: Ouga Buga (button) folded before Flop (didn't bet)
Seat 5: HomerrrJay (small blind) folded before Flop
Seat 6: apfush (big blind) folded before Flop
Seat 7: r.pol218 folded before Flop (didn't bet)
Seat 8: kuanhung0903 folded before Flop (didn't bet)





PokerStars Hand #149394328129:  Hold'em No Limit ($0.50/$1.00 USD) - 2016/02/25 17:30:28 CET [2016/02/25 11:30:28 ET]
Table 'Zeuxo II' 9-max Seat #7 is the button
Seat 1: forsmthgood ($100 in chips) 
Seat 4: sebaaastian ($100 in chips) 
Seat 5: hammerwife ($100 in chips) 
Seat 6: Cogss ($93.93 in chips) 
Seat 7: djammusic ($47.50 in chips) 
Seat 8: matiko09 ($130.68 in chips) 
Seat 9: Sreshta222 ($308.63 in chips) 
matiko09: posts small blind $0.50
Sreshta222: posts big blind $1
*** HOLE CARDS ***
Dealt to matiko09 [8h 2s]
forsmthgood: raises $2 to $3
sebaaastian: folds 
hammerwife: folds 
Cogss: raises $2 to $5
djammusic: folds 
matiko09: folds 
Sreshta222: folds 
forsmthgood: calls $2
*** FLOP *** [5h 7h 3s]
forsmthgood: checks 
Cogss: bets $10.98
forsmthgood: folds 
Uncalled bet ($10.98) returned to Cogss
Cogss collected $10.98 from pot
*** SUMMARY ***
Total pot $11.50 | Rake $0.52 
Board [5h 7h 3s]
Seat 1: forsmthgood folded on the Flop
Seat 4: sebaaastian folded before Flop (didn't bet)
Seat 5: hammerwife folded before Flop (didn't bet)
Seat 6: Cogss collected ($10.98)
Seat 7: djammusic (button) folded before Flop (didn't bet)
Seat 8: matiko09 (small blind) folded before Flop
Seat 9: Sreshta222 (big blind) folded before Flop





PokerStars Hand #149394328915:  Hold'em No Limit ($0.50/$1.00 USD) - 2016/02/25 17:30:29 CET [2016/02/25 11:30:29 ET]
Table 'Eurysaces II' 9-max Seat #4 is the button
Seat 1: lysandrafly ($100 in chips) 
Seat 2: sebaaastian ($103.78 in chips) 
Seat 3: nickreason17 ($100 in chips) 
Seat 4: Hujiafeng ($96.96 in chips) 
Seat 5: keessie93 ($71.21 in chips) 
Seat 6: J0rmungund ($38 in chips) 
Seat 7: $-Twackle-$ ($101.50 in chips) 
Seat 8: HomerrrJay ($100 in chips) 
Seat 9: matiko09 ($102.39 in chips) 
keessie93: posts small blind $0.50
J0rmungund: posts big blind $1
*** HOLE CARDS ***
Dealt to matiko09 [Ad 6s]
$-Twackle-$: folds 
HomerrrJay: folds 
matiko09: folds 
lysandrafly: folds 
sebaaastian: folds 
nickreason17: raises $1.50 to $2.50
Hujiafeng: folds 
keessie93: calls $2
Hujiafeng leaves the table
J0rmungund: calls $1.50
*** FLOP *** [7d 3s 6h]
keessie93: checks 
J0rmungund: bets $3.58
nickreason17: folds 
keessie93: folds 
Uncalled bet ($3.58) returned to J0rmungund
J0rmungund collected $7.16 from pot
*** SUMMARY ***
Total pot $7.50 | Rake $0.34 
Board [7d 3s 6h]
Seat 1: lysandrafly folded before Flop (didn't bet)
Seat 2: sebaaastian folded before Flop (didn't bet)
Seat 3: nickreason17 folded on the Flop
Seat 4: Hujiafeng (button) folded before Flop (didn't bet)
Seat 5: keessie93 (small blind) folded on the Flop
Seat 6: J0rmungund (big blind) collected ($7.16)
Seat 7: $-Twackle-$ folded before Flop (didn't bet)
Seat 8: HomerrrJay folded before Flop (didn't bet)
Seat 9: matiko09 folded before Flop (didn't bet)





PokerStars Hand #149394334246:  Hold'em No Limit ($0.50/$1.00 USD) - 2016/02/25 17:30:35 CET [2016/02/25 11:30:35 ET]
Table 'Zerbinetta II' 9-max Seat #2 is the button
Seat 1: $-Twackle-$ ($100 in chips) 
Seat 2: lysandrafly ($102.28 in chips) 
Seat 3: matiko09 ($102.75 in chips) 
Seat 4: sebaaastian ($100 in chips) 
Seat 5: hammerwife ($123.77 in chips) 
Seat 6: nickreason17 ($116.39 in chips) 
Seat 7: HomerrrJay ($100 in chips) 
Seat 8: gabi_igna ($101 in chips) 
Seat 9: with-w ($50.49 in chips) 
matiko09: posts small blind $0.50
sebaaastian: posts big blind $1
*** HOLE CARDS ***
Dealt to matiko09 [Ac 4s]
hammerwife: folds 
nickreason17: folds 
HomerrrJay: folds 
gabi_igna: folds 
with-w: folds 
$-Twackle-$: folds 
lysandrafly: folds 
matiko09: raises $1.50 to $2.50
sebaaastian: folds 
Uncalled bet ($1.50) returned to matiko09
matiko09 collected $2 from pot
matiko09: doesn't show hand 
*** SUMMARY ***
Total pot $2 | Rake $0 
Seat 1: $-Twackle-$ folded before Flop (didn't bet)
Seat 2: lysandrafly (button) folded before Flop (didn't bet)
Seat 3: matiko09 (small blind) collected ($2)
Seat 4: sebaaastian (big blind) folded before Flop
Seat 5: hammerwife folded before Flop (didn't bet)
Seat 6: nickreason17 folded before Flop (didn't bet)
Seat 7: HomerrrJay folded before Flop (didn't bet)
Seat 8: gabi_igna folded before Flop (didn't bet)
Seat 9: with-w folded before Flop (didn't bet)





PokerStars Hand #149394341130:  Hold'em No Limit ($0.50/$1.00 USD) - 2016/02/25 17:30:44 CET [2016/02/25 11:30:44 ET]
Table 'Nerthus II' 9-max Seat #9 is the button
Seat 1: DUkalisUA ($107.61 in chips) 
Seat 2: matiko09 ($222.18 in chips) 
Seat 3: simoniustin ($100 in chips) 
Seat 4: Ilov3NBA ($100 in chips) 
Seat 6: mycka86 ($142.88 in chips) 
Seat 7: Venomous100% ($108.65 in chips) 
Seat 8: Kelvin sai ($44.38 in chips) 
Seat 9: hammerwife ($102 in chips) 
DUkalisUA: posts small blind $0.50
matiko09: posts big blind $1
*** HOLE CARDS ***
Dealt to matiko09 [6s 5d]
simoniustin: folds 
Ilov3NBA: folds 
mycka86: raises $2 to $3
Venomous100%: folds 
Kelvin sai: folds 
hammerwife: folds 
DUkalisUA: folds 
matiko09: folds 
Uncalled bet ($2) returned to mycka86
mycka86 collected $2.50 from pot
*** SUMMARY ***
Total pot $2.50 | Rake $0 
Seat 1: DUkalisUA (small blind) folded before Flop
Seat 2: matiko09 (big blind) folded before Flop
Seat 3: simoniustin folded before Flop (didn't bet)
Seat 4: Ilov3NBA folded before Flop (didn't bet)
Seat 6: mycka86 collected ($2.50)
Seat 7: Venomous100% folded before Flop (didn't bet)
Seat 8: Kelvin sai folded before Flop (didn't bet)
Seat 9: hammerwife (button) folded before Flop (didn't bet)





PokerStars Hand #149394340956:  Hold'em No Limit ($0.50/$1.00 USD) - 2016/02/25 17:30:44 CET [2016/02/25 11:30:44 ET]
Table 'Ebella II' 9-max Seat #6 is the button
Seat 1: nickreason17 ($114.65 in chips) 
Seat 3: fanmtZ ($41.50 in chips) 
Seat 5: matiko09 ($104 in chips) 
Seat 6: gabi_igna ($106.21 in chips) 
Seat 7: $-Twackle-$ ($100 in chips) 
Seat 8: ZMPOUTSAM140 ($96.46 in chips) 
Seat 9: simoniustin ($109.13 in chips) 
$-Twackle-$: posts small blind $0.50
ZMPOUTSAM140: posts big blind $1
*** HOLE CARDS ***
Dealt to matiko09 [Td 9s]
simoniustin: folds 
nickreason17: folds 
fanmtZ: folds 
matiko09: raises $1.50 to $2.50
gabi_igna: folds 
$-Twackle-$: folds 
ZMPOUTSAM140: calls $1.50
*** FLOP *** [3c 7d Jh]
ZMPOUTSAM140: checks 
matiko09: bets $3.41
ZMPOUTSAM140: calls $3.41
*** TURN *** [3c 7d Jh] [Qs]
ZMPOUTSAM140: checks 
matiko09: bets $7.65
ZMPOUTSAM140: folds 
Uncalled bet ($7.65) returned to matiko09
matiko09 collected $11.77 from pot
matiko09: doesn't show hand 
*** SUMMARY ***
Total pot $12.32 | Rake $0.55 
Board [3c 7d Jh Qs]
Seat 1: nickreason17 folded before Flop (didn't bet)
Seat 3: fanmtZ folded before Flop (didn't bet)
Seat 5: matiko09 collected ($11.77)
Seat 6: gabi_igna (button) folded before Flop (didn't bet)
Seat 7: $-Twackle-$ (small blind) folded before Flop
Seat 8: ZMPOUTSAM140 (big blind) folded on the Turn
Seat 9: simoniustin folded before Flop (didn't bet)





PokerStars Hand #149394342529:  Hold'em No Limit ($0.50/$1.00 USD) - 2016/02/25 17:30:46 CET [2016/02/25 11:30:46 ET]
Table 'Badenia II' 9-max Seat #7 is the button
Seat 1: matiko09 ($101 in chips) 
Seat 2: Stibitzkie ($61.27 in chips) 
Seat 3: sebaaastian ($145.50 in chips) 
Seat 4: hammerwife ($103.75 in chips) 
Seat 5: djammusic ($120.43 in chips) 
Seat 7: forsmthgood ($110.94 in chips) 
Seat 9: waisanen ($235.98 in chips) 
waisanen: posts small blind $0.50
matiko09: posts big blind $1
*** HOLE CARDS ***
Dealt to matiko09 [Td Qc]
Stibitzkie: raises $2.50 to $3.50
sebaaastian: folds 
hammerwife: folds 
djammusic: folds 
forsmthgood: folds 
waisanen: calls $3
matiko09: folds 
*** FLOP *** [Tc 2c 5s]
waisanen: checks 
Stibitzkie: bets $1
waisanen: calls $1
*** TURN *** [Tc 2c 5s] [6d]
waisanen: checks 
Stibitzkie: checks 
*** RIVER *** [Tc 2c 5s 6d] [8c]
waisanen: bets $9.55
Stibitzkie: folds 
Uncalled bet ($9.55) returned to waisanen
waisanen collected $9.55 from pot
*** SUMMARY ***
Total pot $10 | Rake $0.45 
Board [Tc 2c 5s 6d 8c]
Seat 1: matiko09 (big blind) folded before Flop
Seat 2: Stibitzkie folded on the River
Seat 3: sebaaastian folded before Flop (didn't bet)
Seat 4: hammerwife folded before Flop (didn't bet)
Seat 5: djammusic folded before Flop (didn't bet)
Seat 7: forsmthgood (button) folded before Flop (didn't bet)
Seat 9: waisanen (small blind) collected ($9.55)





PokerStars Hand #149394343930:  Hold'em No Limit ($0.50/$1.00 USD) - 2016/02/25 17:30:48 CET [2016/02/25 11:30:48 ET]
Table 'Isa' 9-max Seat #3 is the button
Seat 1: matiko09 ($124.58 in chips) 
Seat 2: mycka86 ($160.42 in chips) 
Seat 3: sebaaastian ($137.25 in chips) 
Seat 4: hammerwife ($107.91 in chips) 
Seat 7: bilukm ($94.56 in chips) 
Seat 8: Venomous100% ($116.24 in chips) 
Seat 9: HomerrrJay ($156.61 in chips) 
hammerwife: posts small blind $0.50
bilukm: posts big blind $1
*** HOLE CARDS ***
Dealt to matiko09 [4d Tc]
Venomous100%: folds 
HomerrrJay: folds 
matiko09: folds 
mycka86: folds 
sebaaastian: folds 
hammerwife: folds 
Uncalled bet ($0.50) returned to bilukm
bilukm collected $1 from pot
bilukm: doesn't show hand 
*** SUMMARY ***
Total pot $1 | Rake $0 
Seat 1: matiko09 folded before Flop (didn't bet)
Seat 2: mycka86 folded before Flop (didn't bet)
Seat 3: sebaaastian (button) folded before Flop (didn't bet)
Seat 4: hammerwife (small blind) folded before Flop
Seat 7: bilukm (big blind) collected ($1)
Seat 8: Venomous100% folded before Flop (didn't bet)
Seat 9: HomerrrJay folded before Flop (didn't bet)





PokerStars Hand #149394355745:  Hold'em No Limit ($0.50/$1.00 USD) - 2016/02/25 17:31:02 CET [2016/02/25 11:31:02 ET]
Table 'Nerthus II' 9-max Seat #1 is the button
Seat 1: DUkalisUA ($107.11 in chips) 
Seat 2: matiko09 ($221.18 in chips) 
Seat 3: simoniustin ($100 in chips) 
Seat 4: Ilov3NBA ($100 in chips) 
Seat 6: mycka86 ($144.38 in chips) 
Seat 7: Venomous100% ($108.65 in chips) 
Seat 8: Kelvin sai ($44.38 in chips) 
Seat 9: hammerwife ($102 in chips) 
matiko09: posts small blind $0.50
simoniustin: posts big blind $1
*** HOLE CARDS ***
Dealt to matiko09 [Jh Kc]
Ilov3NBA: folds 
mycka86: folds 
Venomous100%: folds 
Kelvin sai: folds 
hammerwife: folds 
DUkalisUA: raises $1 to $2
matiko09: folds 
simoniustin: folds 
Uncalled bet ($1) returned to DUkalisUA
DUkalisUA collected $2.50 from pot
DUkalisUA: doesn't show hand 
*** SUMMARY ***
Total pot $2.50 | Rake $0 
Seat 1: DUkalisUA (button) collected ($2.50)
Seat 2: matiko09 (small blind) folded before Flop
Seat 3: simoniustin (big blind) folded before Flop
Seat 4: Ilov3NBA folded before Flop (didn't bet)
Seat 6: mycka86 folded before Flop (didn't bet)
Seat 7: Venomous100% folded before Flop (didn't bet)
Seat 8: Kelvin sai folded before Flop (didn't bet)
Seat 9: hammerwife folded before Flop (didn't bet)





PokerStars Hand #149394359274:  Hold'em No Limit ($0.50/$1.00 USD) - 2016/02/25 17:31:07 CET [2016/02/25 11:31:07 ET]
Table 'Sabine' 9-max Seat #6 is the button
Seat 1: Aalleekks ($100 in chips) 
Seat 2: apfush ($133.93 in chips) 
Seat 3: Ouga Buga ($101.88 in chips) 
Seat 4: simoniustin ($100 in chips) 
Seat 5: Venomous100% ($107.04 in chips) 
Seat 6: ffac ($105.18 in chips) 
Seat 7: clayshmert ($79.41 in chips) 
Seat 8: matiko09 ($124.97 in chips) 
Seat 9: djammusic ($61.49 in chips) 
clayshmert: posts small blind $0.50
matiko09: posts big blind $1
*** HOLE CARDS ***
Dealt to matiko09 [As 8c]
djammusic: folds 
Aalleekks: folds 
apfush: folds 
Ouga Buga: raises $1.50 to $2.50
simoniustin: folds 
Venomous100%: folds 
ffac: folds 
clayshmert: folds 
matiko09: folds 
Uncalled bet ($1.50) returned to Ouga Buga
Ouga Buga collected $2.50 from pot
Ouga Buga: doesn't show hand 
*** SUMMARY ***
Total pot $2.50 | Rake $0 
Seat 1: Aalleekks folded before Flop (didn't bet)
Seat 2: apfush folded before Flop (didn't bet)
Seat 3: Ouga Buga collected ($2.50)
Seat 4: simoniustin folded before Flop (didn't bet)
Seat 5: Venomous100% folded before Flop (didn't bet)
Seat 6: ffac (button) folded before Flop (didn't bet)
Seat 7: clayshmert (small blind) folded before Flop
Seat 8: matiko09 (big blind) folded before Flop
Seat 9: djammusic folded before Flop (didn't bet)





PokerStars Hand #149394360629:  Hold'em No Limit ($0.25/$0.50 USD) - 2016/02/25 17:31:09 CET [2016/02/25 11:31:09 ET]
Table 'Lohja II' 9-max Seat #4 is the button
Seat 1: MoonJimmy ($164.23 in chips) 
Seat 3: guvalc1952 ($218.95 in chips) 
Seat 4: payback11 ($50 in chips) 
Seat 5: Effort92 ($50 in chips) 
Seat 7: matiko09 ($95.11 in chips) 
Seat 8: jamba83 ($69.14 in chips) 
Seat 9: Al3xAnd3r22 ($98 in chips) 
Effort92: posts small blind $0.25
matiko09: posts big blind $0.50
mycka86: sits out 
MoonJimmy: posts the ante $0.10
guvalc1952: posts the ante $0.10
payback11: posts the ante $0.10
Effort92: posts the ante $0.10
matiko09: posts the ante $0.10
jamba83: posts the ante $0.10
Al3xAnd3r22: posts the ante $0.10
*** HOLE CARDS ***
Dealt to matiko09 [Kh 9d]
jamba83: folds 
Al3xAnd3r22: raises $1 to $1.50
MoonJimmy: folds 
guvalc1952: folds 
payback11: folds 
Effort92: folds 
matiko09: folds 
Uncalled bet ($1) returned to Al3xAnd3r22
Al3xAnd3r22 collected $1.95 from pot
*** SUMMARY ***
Total pot $1.95 | Rake $0 
Seat 1: MoonJimmy folded before Flop (didn't bet)
Seat 3: guvalc1952 folded before Flop (didn't bet)
Seat 4: payback11 (button) folded before Flop (didn't bet)
Seat 5: Effort92 (small blind) folded before Flop
Seat 7: matiko09 (big blind) folded before Flop
Seat 8: jamba83 folded before Flop (didn't bet)
Seat 9: Al3xAnd3r22 collected ($1.95)





PokerStars Hand #149394363433:  Hold'em No Limit ($0.50/$1.00 USD) - 2016/02/25 17:31:12 CET [2016/02/25 11:31:12 ET]
Table 'Isa' 9-max Seat #4 is the button
Seat 1: matiko09 ($124.58 in chips) 
Seat 2: mycka86 ($160.42 in chips) 
Seat 3: sebaaastian ($137.25 in chips) 
Seat 4: hammerwife ($107.41 in chips) 
Seat 7: bilukm ($95.06 in chips) 
Seat 8: Venomous100% ($116.24 in chips) 
Seat 9: HomerrrJay ($156.61 in chips) 
bilukm: posts small blind $0.50
Venomous100%: posts big blind $1
*** HOLE CARDS ***
Dealt to matiko09 [6c Qs]
HomerrrJay: folds 
matiko09: folds 
mycka86: folds 
sebaaastian: folds 
hammerwife: raises $2 to $3
bilukm: folds 
Venomous100%: raises $6 to $9
hammerwife: raises $13 to $22
Venomous100%: folds 
Uncalled bet ($13) returned to hammerwife
hammerwife collected $18.50 from pot
hammerwife: doesn't show hand 
*** SUMMARY ***
Total pot $18.50 | Rake $0 
Seat 1: matiko09 folded before Flop (didn't bet)
Seat 2: mycka86 folded before Flop (didn't bet)
Seat 3: sebaaastian folded before Flop (didn't bet)
Seat 4: hammerwife (button) collected ($18.50)
Seat 7: bilukm (small blind) folded before Flop
Seat 8: Venomous100% (big blind) folded before Flop
Seat 9: HomerrrJay folded before Flop (didn't bet)





PokerStars Hand #149394367375:  Hold'em No Limit ($0.50/$1.00 USD) - 2016/02/25 17:31:17 CET [2016/02/25 11:31:17 ET]
Table 'Mayall II' 9-max Seat #5 is the button
Seat 1: matiko09 ($125.91 in chips) 
Seat 3: simoniustin ($101.50 in chips) 
Seat 4: Ouga Buga ($103.42 in chips) 
Seat 5: HomerrrJay ($101.50 in chips) 
Seat 6: apfush ($112.67 in chips) 
Seat 8: kuanhung0903 ($91.46 in chips) 
apfush: posts small blind $0.50
kuanhung0903: posts big blind $1
*** HOLE CARDS ***
Dealt to matiko09 [7c As]
matiko09: folds 
simoniustin: folds 
Ouga Buga: folds 
HomerrrJay: folds 
apfush: raises $2 to $3
kuanhung0903: folds 
Uncalled bet ($2) returned to apfush
apfush collected $2 from pot
apfush: doesn't show hand 
*** SUMMARY ***
Total pot $2 | Rake $0 
Seat 1: matiko09 folded before Flop (didn't bet)
Seat 3: simoniustin folded before Flop (didn't bet)
Seat 4: Ouga Buga folded before Flop (didn't bet)
Seat 5: HomerrrJay (button) folded before Flop (didn't bet)
Seat 6: apfush (small blind) collected ($2)
Seat 8: kuanhung0903 (big blind) folded before Flop





PokerStars Hand #149394368619:  Hold'em No Limit ($0.50/$1.00 USD) - 2016/02/25 17:31:19 CET [2016/02/25 11:31:19 ET]
Table 'Eurysaces II' 9-max Seat #5 is the button
Seat 1: lysandrafly ($100 in chips) 
Seat 2: sebaaastian ($103.78 in chips) 
Seat 3: nickreason17 ($100 in chips) 
Seat 5: keessie93 ($68.71 in chips) 
Seat 6: J0rmungund ($42.66 in chips) 
Seat 7: $-Twackle-$ ($101.50 in chips) 
Seat 8: HomerrrJay ($100 in chips) 
Seat 9: matiko09 ($102.39 in chips) 
J0rmungund: posts small blind $0.50
$-Twackle-$: posts big blind $1
*** HOLE CARDS ***
Dealt to matiko09 [6h 9c]
HomerrrJay: folds 
matiko09: folds 
lysandrafly: folds 
gabi_igna joins the table at seat #4 
sebaaastian: folds 
nickreason17: raises $1.50 to $2.50
keessie93: folds 
J0rmungund: folds 
$-Twackle-$: folds 
Uncalled bet ($1.50) returned to nickreason17
nickreason17 collected $2.50 from pot
*** SUMMARY ***
Total pot $2.50 | Rake $0 
Seat 1: lysandrafly folded before Flop (didn't bet)
Seat 2: sebaaastian folded before Flop (didn't bet)
Seat 3: nickreason17 collected ($2.50)
Seat 5: keessie93 (button) folded before Flop (didn't bet)
Seat 6: J0rmungund (small blind) folded before Flop
Seat 7: $-Twackle-$ (big blind) folded before Flop
Seat 8: HomerrrJay folded before Flop (didn't bet)
Seat 9: matiko09 folded before Flop (didn't bet)





PokerStars Hand #149394378484:  Hold'em No Limit ($0.50/$1.00 USD) - 2016/02/25 17:31:31 CET [2016/02/25 11:31:31 ET]
Table 'Zeuxo II' 9-max Seat #8 is the button
Seat 1: forsmthgood ($100 in chips) 
Seat 4: sebaaastian ($100 in chips) 
Seat 5: hammerwife ($100 in chips) 
Seat 6: Cogss ($99.91 in chips) 
Seat 7: djammusic ($47.50 in chips) 
Seat 8: matiko09 ($130.18 in chips) 
Seat 9: Sreshta222 ($307.63 in chips) 
Sreshta222: posts small blind $0.50
forsmthgood: posts big blind $1
*** HOLE CARDS ***
Dealt to matiko09 [2c Kc]
sebaaastian: folds 
hammerwife: folds 
Cogss: folds 
djammusic: folds 
matiko09: raises $1.27 to $2.27
Sreshta222: folds 
forsmthgood: calls $1.27
*** FLOP *** [5h Qd 9s]
forsmthgood: checks 
matiko09: checks 
*** TURN *** [5h Qd 9s] [8s]
forsmthgood: bets $3.27
matiko09: folds 
Uncalled bet ($3.27) returned to forsmthgood
forsmthgood collected $4.81 from pot
*** SUMMARY ***
Total pot $5.04 | Rake $0.23 
Board [5h Qd 9s 8s]
Seat 1: forsmthgood (big blind) collected ($4.81)
Seat 4: sebaaastian folded before Flop (didn't bet)
Seat 5: hammerwife folded before Flop (didn't bet)
Seat 6: Cogss folded before Flop (didn't bet)
Seat 7: djammusic folded before Flop (didn't bet)
Seat 8: matiko09 (button) folded on the Turn
Seat 9: Sreshta222 (small blind) folded before Flop





PokerStars Hand #149394378814:  Hold'em No Limit ($0.50/$1.00 USD) - 2016/02/25 17:31:31 CET [2016/02/25 11:31:31 ET]
Table 'Nerthus II' 9-max Seat #2 is the button
Seat 1: DUkalisUA ($108.61 in chips) 
Seat 2: matiko09 ($220.68 in chips) 
Seat 3: simoniustin ($100 in chips) 
Seat 4: Ilov3NBA ($100 in chips) 
Seat 6: mycka86 ($144.38 in chips) 
Seat 7: Venomous100% ($108.65 in chips) 
Seat 8: Kelvin sai ($44.38 in chips) 
Seat 9: hammerwife ($102 in chips) 
simoniustin: posts small blind $0.50
Ilov3NBA: posts big blind $1
*** HOLE CARDS ***
Dealt to matiko09 [Kd Jh]
mycka86: folds 
Venomous100%: folds 
Kelvin sai: raises $1 to $2
hammerwife: folds 
DUkalisUA: calls $2
matiko09: calls $2
simoniustin: folds 
Ilov3NBA: calls $1
*** FLOP *** [2d 7d 5c]
Ilov3NBA: checks 
Kelvin sai: checks 
DUkalisUA: checks 
matiko09: checks 
*** TURN *** [2d 7d 5c] [7c]
Ilov3NBA: checks 
Kelvin sai: checks 
DUkalisUA: checks 
matiko09: checks 
*** RIVER *** [2d 7d 5c 7c] [7s]
Ilov3NBA: checks 
Kelvin sai: checks 
DUkalisUA: checks 
matiko09: checks 
*** SHOW DOWN ***
Ilov3NBA: shows [3s 3c] (a full house, Sevens full of Threes)
Kelvin sai: mucks hand 
DUkalisUA: mucks hand 
matiko09: mucks hand 
Ilov3NBA collected $8.12 from pot
*** SUMMARY ***
Total pot $8.50 | Rake $0.38 
Board [2d 7d 5c 7c 7s]
Seat 1: DUkalisUA mucked [Th Ah]
Seat 2: matiko09 (button) mucked [Kd Jh]
Seat 3: simoniustin (small blind) folded before Flop
Seat 4: Ilov3NBA (big blind) showed [3s 3c] and won ($8.12) with a full house, Sevens full of Threes
Seat 6: mycka86 folded before Flop (didn't bet)
Seat 7: Venomous100% folded before Flop (didn't bet)
Seat 8: Kelvin sai mucked [9s 4s]
Seat 9: hammerwife folded before Flop (didn't bet)





PokerStars Hand #149394384796:  Hold'em No Limit ($0.50/$1.00 USD) - 2016/02/25 17:31:39 CET [2016/02/25 11:31:39 ET]
Table 'Ebella II' 9-max Seat #7 is the button
Seat 1: nickreason17 ($114.65 in chips) 
Seat 3: fanmtZ ($41.50 in chips) 
Seat 5: matiko09 ($109.86 in chips) 
Seat 6: gabi_igna ($106.21 in chips) 
Seat 7: $-Twackle-$ ($100 in chips) 
Seat 8: ZMPOUTSAM140 ($90.55 in chips) 
Seat 9: simoniustin ($109.13 in chips) 
ZMPOUTSAM140: posts small blind $0.50
simoniustin: posts big blind $1
*** HOLE CARDS ***
Dealt to matiko09 [6d Td]
nickreason17: folds 
fanmtZ: folds 
nickreason17 leaves the table
matiko09: folds 
hammerwife joins the table at seat #1 
gabi_igna: folds 
$-Twackle-$: folds 
ZMPOUTSAM140: folds 
Uncalled bet ($0.50) returned to simoniustin
simoniustin collected $1 from pot
simoniustin: doesn't show hand 
*** SUMMARY ***
Total pot $1 | Rake $0 
Seat 1: nickreason17 folded before Flop (didn't bet)
Seat 3: fanmtZ folded before Flop (didn't bet)
Seat 5: matiko09 folded before Flop (didn't bet)
Seat 6: gabi_igna folded before Flop (didn't bet)
Seat 7: $-Twackle-$ (button) folded before Flop (didn't bet)
Seat 8: ZMPOUTSAM140 (small blind) folded before Flop
Seat 9: simoniustin (big blind) collected ($1)





PokerStars Hand #149394385862:  Hold'em No Limit ($0.25/$0.50 USD) - 2016/02/25 17:31:40 CET [2016/02/25 11:31:40 ET]
Table 'Lohja II' 9-max Seat #5 is the button
Seat 1: MoonJimmy ($164.13 in chips) 
Seat 3: guvalc1952 ($218.85 in chips) 
Seat 4: payback11 ($50 in chips) 
Seat 5: Effort92 ($50 in chips) 
Seat 7: matiko09 ($94.51 in chips) 
Seat 8: jamba83 ($69.04 in chips) 
Seat 9: Al3xAnd3r22 ($99.35 in chips) 
matiko09: posts small blind $0.25
jamba83: posts big blind $0.50
mycka86: sits out 
MoonJimmy: posts the ante $0.10
guvalc1952: posts the ante $0.10
payback11: posts the ante $0.10
Effort92: posts the ante $0.10
matiko09: posts the ante $0.10
jamba83: posts the ante $0.10
Al3xAnd3r22: posts the ante $0.10
*** HOLE CARDS ***
Dealt to matiko09 [3h 2s]
Al3xAnd3r22: raises $1 to $1.50
MoonJimmy: folds 
guvalc1952: calls $1.50
payback11: folds 
Effort92: folds 
matiko09: folds 
jamba83: folds 
*** FLOP *** [5c Jc 3d]
Al3xAnd3r22: checks 
guvalc1952: checks 
*** TURN *** [5c Jc 3d] [Kc]
Al3xAnd3r22: bets $2.38
guvalc1952: raises $9.01 to $11.39
Al3xAnd3r22: folds 
Uncalled bet ($9.01) returned to guvalc1952
guvalc1952 collected $8.80 from pot
guvalc1952: doesn't show hand 
*** SUMMARY ***
Total pot $9.21 | Rake $0.41 
Board [5c Jc 3d Kc]
Seat 1: MoonJimmy folded before Flop (didn't bet)
Seat 3: guvalc1952 collected ($8.80)
Seat 4: payback11 folded before Flop (didn't bet)
Seat 5: Effort92 (button) folded before Flop (didn't bet)
Seat 7: matiko09 (small blind) folded before Flop
Seat 8: jamba83 (big blind) folded before Flop
Seat 9: Al3xAnd3r22 folded on the Turn





PokerStars Hand #149394386629:  Hold'em No Limit ($0.50/$1.00 USD) - 2016/02/25 17:31:41 CET [2016/02/25 11:31:41 ET]
Table 'Zerbinetta II' 9-max Seat #3 is the button
Seat 1: $-Twackle-$ ($100 in chips) 
Seat 2: lysandrafly ($102.28 in chips) 
Seat 3: matiko09 ($103.75 in chips) 
Seat 4: sebaaastian ($100 in chips) 
Seat 5: hammerwife ($123.77 in chips) 
Seat 6: nickreason17 ($116.39 in chips) 
Seat 7: HomerrrJay ($100 in chips) 
Seat 8: gabi_igna ($101 in chips) 
Seat 9: with-w ($50.49 in chips) 
sebaaastian: posts small blind $0.50
hammerwife: posts big blind $1
*** HOLE CARDS ***
Dealt to matiko09 [Jd 6c]
nickreason17: raises $2 to $3
HomerrrJay: calls $3
gabi_igna: folds 
with-w: folds 
$-Twackle-$: folds 
lysandrafly: folds 
matiko09: folds 
sebaaastian: folds 
hammerwife: folds 
*** FLOP *** [2s 9h 9s]
nickreason17: checks 
HomerrrJay: checks 
*** TURN *** [2s 9h 9s] [9d]
nickreason17: bets $4.50
HomerrrJay: calls $4.50
*** RIVER *** [2s 9h 9s 9d] [Qd]
nickreason17: bets $5
HomerrrJay: folds 
Uncalled bet ($5) returned to nickreason17
nickreason17 collected $15.76 from pot
*** SUMMARY ***
Total pot $16.50 | Rake $0.74 
Board [2s 9h 9s 9d Qd]
Seat 1: $-Twackle-$ folded before Flop (didn't bet)
Seat 2: lysandrafly folded before Flop (didn't bet)
Seat 3: matiko09 (button) folded before Flop (didn't bet)
Seat 4: sebaaastian (small blind) folded before Flop
Seat 5: hammerwife (big blind) folded before Flop
Seat 6: nickreason17 collected ($15.76)
Seat 7: HomerrrJay folded on the River
Seat 8: gabi_igna folded before Flop (didn't bet)
Seat 9: with-w folded before Flop (didn't bet)





PokerStars Hand #149394387623:  Hold'em No Limit ($0.50/$1.00 USD) - 2016/02/25 17:31:42 CET [2016/02/25 11:31:42 ET]
Table 'Sabine' 9-max Seat #7 is the button
Seat 1: Aalleekks ($100 in chips) 
Seat 2: apfush ($133.93 in chips) 
Seat 3: Ouga Buga ($103.38 in chips) 
Seat 4: simoniustin ($100 in chips) 
Seat 5: Venomous100% ($107.04 in chips) 
Seat 6: ffac ($105.18 in chips) 
Seat 7: clayshmert ($78.91 in chips) 
Seat 8: matiko09 ($123.97 in chips) 
Seat 9: djammusic ($61.49 in chips) 
matiko09: posts small blind $0.50
djammusic: posts big blind $1
*** HOLE CARDS ***
Dealt to matiko09 [6c Kh]
Aalleekks: folds 
apfush: folds 
Ouga Buga: folds 
simoniustin: folds 
Venomous100%: folds 
ffac: folds 
clayshmert: folds 
matiko09: folds 
Uncalled bet ($0.50) returned to djammusic
djammusic collected $1 from pot
djammusic: doesn't show hand 
*** SUMMARY ***
Total pot $1 | Rake $0 
Seat 1: Aalleekks folded before Flop (didn't bet)
Seat 2: apfush folded before Flop (didn't bet)
Seat 3: Ouga Buga folded before Flop (didn't bet)
Seat 4: simoniustin folded before Flop (didn't bet)
Seat 5: Venomous100% folded before Flop (didn't bet)
Seat 6: ffac folded before Flop (didn't bet)
Seat 7: clayshmert (button) folded before Flop (didn't bet)
Seat 8: matiko09 (small blind) folded before Flop
Seat 9: djammusic (big blind) collected ($1)





PokerStars Hand #149394388343:  Hold'em No Limit ($0.50/$1.00 USD) - 2016/02/25 17:31:43 CET [2016/02/25 11:31:43 ET]
Table 'Badenia II' 9-max Seat #9 is the button
Seat 1: matiko09 ($100 in chips) 
Seat 2: Stibitzkie ($56.77 in chips) 
Seat 3: sebaaastian ($145.50 in chips) 
Seat 4: hammerwife ($103.75 in chips) 
Seat 5: djammusic ($120.43 in chips) 
Seat 7: forsmthgood ($110.94 in chips) 
Seat 9: waisanen ($241.03 in chips) 
matiko09: posts small blind $0.50
Stibitzkie: posts big blind $1
*** HOLE CARDS ***
Dealt to matiko09 [As Kc]
sebaaastian: folds 
hammerwife: folds 
djammusic: raises $2 to $3
forsmthgood: calls $3
waisanen: calls $3
matiko09: raises $12 to $15
Stibitzkie: calls $14
djammusic: folds 
forsmthgood: calls $12
waisanen: folds 
*** FLOP *** [6s 8h 2h]
matiko09: checks 
Stibitzkie: checks 
forsmthgood: bets $24.35
matiko09: folds 
Stibitzkie: calls $24.35
*** TURN *** [6s 8h 2h] [3c]
Stibitzkie: checks 
forsmthgood: bets $48.45
Stibitzkie: calls $17.42 and is all-in
Uncalled bet ($31.03) returned to forsmthgood
*** RIVER *** [6s 8h 2h 3c] [3h]
*** SHOW DOWN ***
Stibitzkie: shows [5h 5d] (two pair, Fives and Threes)
forsmthgood: shows [9s 8s] (two pair, Eights and Threes)
forsmthgood collected $131.74 from pot
*** SUMMARY ***
Total pot $134.54 | Rake $2.80 
Board [6s 8h 2h 3c 3h]
Seat 1: matiko09 (small blind) folded on the Flop
Seat 2: Stibitzkie (big blind) showed [5h 5d] and lost with two pair, Fives and Threes
Seat 3: sebaaastian folded before Flop (didn't bet)
Seat 4: hammerwife folded before Flop (didn't bet)
Seat 5: djammusic folded before Flop
Seat 7: forsmthgood showed [9s 8s] and won ($131.74) with two pair, Eights and Threes
Seat 9: waisanen (button) folded before Flop





PokerStars Hand #149394391706:  Hold'em No Limit ($0.50/$1.00 USD) - 2016/02/25 17:31:48 CET [2016/02/25 11:31:48 ET]
Table 'Isa' 9-max Seat #7 is the button
Seat 1: matiko09 ($124.58 in chips) 
Seat 2: mycka86 ($160.42 in chips) 
Seat 3: sebaaastian ($137.25 in chips) 
Seat 4: hammerwife ($116.91 in chips) 
Seat 7: bilukm ($94.56 in chips) 
Seat 8: Venomous100% ($107.24 in chips) 
Seat 9: HomerrrJay ($156.61 in chips) 
Venomous100%: posts small blind $0.50
HomerrrJay: posts big blind $1
*** HOLE CARDS ***
Dealt to matiko09 [2c Jd]
matiko09: folds 
mycka86: raises $2 to $3
sebaaastian: folds 
hammerwife: raises $6 to $9
bilukm: folds 
Venomous100%: folds 
HomerrrJay: folds 
mycka86: folds 
Uncalled bet ($6) returned to hammerwife
hammerwife collected $7.50 from pot
hammerwife: doesn't show hand 
*** SUMMARY ***
Total pot $7.50 | Rake $0 
Seat 1: matiko09 folded before Flop (didn't bet)
Seat 2: mycka86 folded before Flop
Seat 3: sebaaastian folded before Flop (didn't bet)
Seat 4: hammerwife collected ($7.50)
Seat 7: bilukm (button) folded before Flop (didn't bet)
Seat 8: Venomous100% (small blind) folded before Flop
Seat 9: HomerrrJay (big blind) folded before Flop





PokerStars Hand #149394393390:  Hold'em No Limit ($0.50/$1.00 USD) - 2016/02/25 17:31:50 CET [2016/02/25 11:31:50 ET]
Table 'Mayall II' 9-max Seat #6 is the button
Seat 1: matiko09 ($125.91 in chips) 
Seat 3: simoniustin ($101.50 in chips) 
Seat 4: Ouga Buga ($103.42 in chips) 
Seat 5: HomerrrJay ($101.50 in chips) 
Seat 6: apfush ($113.67 in chips) 
Seat 8: kuanhung0903 ($90.46 in chips) 
r.pol218 will be allowed to play after the button
kuanhung0903 is connected 
kuanhung0903: posts small blind $0.50
matiko09: posts big blind $1
*** HOLE CARDS ***
Dealt to matiko09 [Ad Kh]
simoniustin: folds 
Ouga Buga: raises $1.50 to $2.50
HomerrrJay: folds 
apfush: folds 
kuanhung0903: folds 
matiko09: calls $1.50
*** FLOP *** [7c 9d 5c]
matiko09: checks 
Ouga Buga: bets $3.17
matiko09: folds 
Uncalled bet ($3.17) returned to Ouga Buga
Ouga Buga collected $5.25 from pot
Ouga Buga: doesn't show hand 
*** SUMMARY ***
Total pot $5.50 | Rake $0.25 
Board [7c 9d 5c]
Seat 1: matiko09 (big blind) folded on the Flop
Seat 3: simoniustin folded before Flop (didn't bet)
Seat 4: Ouga Buga collected ($5.25)
Seat 5: HomerrrJay folded before Flop (didn't bet)
Seat 6: apfush (button) folded before Flop (didn't bet)
Seat 8: kuanhung0903 (small blind) folded before Flop





PokerStars Hand #149394396334:  Hold'em No Limit ($0.50/$1.00 USD) - 2016/02/25 17:31:54 CET [2016/02/25 11:31:54 ET]
Table 'Eurysaces II' 9-max Seat #6 is the button
Seat 1: lysandrafly ($100 in chips) 
Seat 2: sebaaastian ($103.78 in chips) 
Seat 3: nickreason17 ($101.50 in chips) 
Seat 5: keessie93 ($68.71 in chips) 
Seat 6: J0rmungund ($42.16 in chips) 
Seat 7: $-Twackle-$ ($100.50 in chips) 
Seat 9: matiko09 ($102.39 in chips) 
$-Twackle-$: posts small blind $0.50
HomerrrJay: is sitting out 
matiko09: posts big blind $1
gabi_igna: sits out 
*** HOLE CARDS ***
Dealt to matiko09 [Kc Jc]
lysandrafly: folds 
HomerrrJay leaves the table
hammerwife joins the table at seat #8 
sebaaastian: folds 
nickreason17: folds 
keessie93: folds 
J0rmungund: raises $2 to $3
$-Twackle-$: folds 
matiko09: calls $2
*** FLOP *** [8c 6s As]
matiko09: checks 
J0rmungund: bets $4
matiko09: folds 
Uncalled bet ($4) returned to J0rmungund
J0rmungund collected $6.21 from pot
*** SUMMARY ***
Total pot $6.50 | Rake $0.29 
Board [8c 6s As]
Seat 1: lysandrafly folded before Flop (didn't bet)
Seat 2: sebaaastian folded before Flop (didn't bet)
Seat 3: nickreason17 folded before Flop (didn't bet)
Seat 5: keessie93 folded before Flop (didn't bet)
Seat 6: J0rmungund (button) collected ($6.21)
Seat 7: $-Twackle-$ (small blind) folded before Flop
Seat 9: matiko09 (big blind) folded on the Flop





PokerStars Hand #149394406792:  Hold'em No Limit ($0.50/$1.00 USD) - 2016/02/25 17:32:06 CET [2016/02/25 11:32:06 ET]
Table 'Sabine' 9-max Seat #8 is the button
Seat 1: Aalleekks ($100 in chips) 
Seat 2: apfush ($133.93 in chips) 
Seat 3: Ouga Buga ($103.38 in chips) 
Seat 4: simoniustin ($100 in chips) 
Seat 5: Venomous100% ($107.04 in chips) 
Seat 6: ffac ($105.18 in chips) 
Seat 7: clayshmert ($78.91 in chips) 
Seat 8: matiko09 ($123.47 in chips) 
Seat 9: djammusic ($61.99 in chips) 
djammusic: posts small blind $0.50
Aalleekks: posts big blind $1
*** HOLE CARDS ***
Dealt to matiko09 [Jd Js]
apfush: folds 
Ouga Buga: folds 
simoniustin: folds 
Venomous100%: folds 
ffac: raises $2 to $3
clayshmert: folds 
matiko09: calls $3
djammusic: raises $9 to $12
Aalleekks: folds 
ffac: folds 
matiko09: raises $111.47 to $123.47 and is all-in
djammusic: calls $49.99 and is all-in
Uncalled bet ($61.48) returned to matiko09
*** FLOP *** [Jh Th Tc]
*** TURN *** [Jh Th Tc] [7d]
*** RIVER *** [Jh Th Tc 7d] [As]
*** SHOW DOWN ***
djammusic: shows [Kc Ac] (two pair, Aces and Tens)
matiko09: shows [Jd Js] (a full house, Jacks full of Tens)
matiko09 collected $125.18 from pot
*** SUMMARY ***
Total pot $127.98 | Rake $2.80 
Board [Jh Th Tc 7d As]
Seat 1: Aalleekks (big blind) folded before Flop
Seat 2: apfush folded before Flop (didn't bet)
Seat 3: Ouga Buga folded before Flop (didn't bet)
Seat 4: simoniustin folded before Flop (didn't bet)
Seat 5: Venomous100% folded before Flop (didn't bet)
Seat 6: ffac folded before Flop
Seat 7: clayshmert folded before Flop (didn't bet)
Seat 8: matiko09 (button) showed [Jd Js] and won ($125.18) with a full house, Jacks full of Tens
Seat 9: djammusic (small blind) showed [Kc Ac] and lost with two pair, Aces and Tens





PokerStars Hand #149394410261:  Hold'em No Limit ($0.50/$1.00 USD) - 2016/02/25 17:32:11 CET [2016/02/25 11:32:11 ET]
Table 'Ebella II' 9-max Seat #8 is the button
Seat 3: fanmtZ ($41.50 in chips) 
Seat 5: matiko09 ($109.86 in chips) 
Seat 6: gabi_igna ($106.21 in chips) 
Seat 7: $-Twackle-$ ($100 in chips) 
Seat 8: ZMPOUTSAM140 ($90.05 in chips) 
Seat 9: simoniustin ($109.63 in chips) 
simoniustin: posts small blind $0.50
fanmtZ: posts big blind $1
*** HOLE CARDS ***
Dealt to matiko09 [Th 3h]
matiko09: folds 
gabi_igna: raises $2 to $3
$-Twackle-$: folds 
ZMPOUTSAM140: raises $7.50 to $10.50
simoniustin: folds 
fanmtZ: folds 
gabi_igna: folds 
Uncalled bet ($7.50) returned to ZMPOUTSAM140
ZMPOUTSAM140 collected $7.50 from pot
*** SUMMARY ***
Total pot $7.50 | Rake $0 
Seat 3: fanmtZ (big blind) folded before Flop
Seat 5: matiko09 folded before Flop (didn't bet)
Seat 6: gabi_igna folded before Flop
Seat 7: $-Twackle-$ folded before Flop (didn't bet)
Seat 8: ZMPOUTSAM140 (button) collected ($7.50)
Seat 9: simoniustin (small blind) folded before Flop





PokerStars Hand #149394417472:  Hold'em No Limit ($0.50/$1.00 USD) - 2016/02/25 17:32:20 CET [2016/02/25 11:32:20 ET]
Table 'Isa' 9-max Seat #8 is the button
Seat 1: matiko09 ($124.58 in chips) 
Seat 2: mycka86 ($157.42 in chips) 
Seat 3: sebaaastian ($137.25 in chips) 
Seat 4: hammerwife ($121.41 in chips) 
Seat 7: bilukm ($94.56 in chips) 
Seat 8: Venomous100% ($106.74 in chips) 
Seat 9: HomerrrJay ($155.61 in chips) 
HomerrrJay: posts small blind $0.50
matiko09: posts big blind $1
*** HOLE CARDS ***
Dealt to matiko09 [8d 3s]
mycka86: folds 
sebaaastian: folds 
hammerwife: folds 
bilukm: raises $1 to $2
Venomous100%: folds 
HomerrrJay: calls $1.50
matiko09: folds 
*** FLOP *** [7h 9s Jd]
HomerrrJay: checks 
bilukm: checks 
*** TURN *** [7h 9s Jd] [As]
HomerrrJay: checks 
bilukm: bets $2.39
HomerrrJay: folds 
Uncalled bet ($2.39) returned to bilukm
bilukm collected $4.78 from pot
bilukm: doesn't show hand 
*** SUMMARY ***
Total pot $5 | Rake $0.22 
Board [7h 9s Jd As]
Seat 1: matiko09 (big blind) folded before Flop
Seat 2: mycka86 folded before Flop (didn't bet)
Seat 3: sebaaastian folded before Flop (didn't bet)
Seat 4: hammerwife folded before Flop (didn't bet)
Seat 7: bilukm collected ($4.78)
Seat 8: Venomous100% (button) folded before Flop (didn't bet)
Seat 9: HomerrrJay (small blind) folded on the Turn





PokerStars Hand #149394425081:  Hold'em No Limit ($0.50/$1.00 USD) - 2016/02/25 17:32:29 CET [2016/02/25 11:32:29 ET]
Table 'Eurysaces II' 9-max Seat #7 is the button
Seat 1: lysandrafly ($100 in chips) 
Seat 2: sebaaastian ($103.78 in chips) 
Seat 3: nickreason17 ($101.50 in chips) 
Seat 5: keessie93 ($68.71 in chips) 
Seat 6: J0rmungund ($45.37 in chips) 
Seat 7: $-Twackle-$ ($100 in chips) 
Seat 9: matiko09 ($100 in chips) 
hammerwife will be allowed to play after the button
matiko09: posts small blind $0.50
lysandrafly: posts big blind $1
gabi_igna: sits out 
*** HOLE CARDS ***
Dealt to matiko09 [4d 8d]
sebaaastian: folds 
nickreason17: folds 
keessie93: folds 
J0rmungund: folds 
$-Twackle-$: raises $1 to $2
matiko09: folds 
lysandrafly: folds 
Uncalled bet ($1) returned to $-Twackle-$
$-Twackle-$ collected $2.50 from pot
$-Twackle-$: doesn't show hand 
*** SUMMARY ***
Total pot $2.50 | Rake $0 
Seat 1: lysandrafly (big blind) folded before Flop
Seat 2: sebaaastian folded before Flop (didn't bet)
Seat 3: nickreason17 folded before Flop (didn't bet)
Seat 5: keessie93 folded before Flop (didn't bet)
Seat 6: J0rmungund folded before Flop (didn't bet)
Seat 7: $-Twackle-$ (button) collected ($2.50)
Seat 9: matiko09 (small blind) folded before Flop





PokerStars Hand #149394432292:  Hold'em No Limit ($0.50/$1.00 USD) - 2016/02/25 17:32:38 CET [2016/02/25 11:32:38 ET]
Table 'Zeuxo II' 9-max Seat #9 is the button
Seat 1: forsmthgood ($102.54 in chips) 
Seat 4: sebaaastian ($100 in chips) 
Seat 5: hammerwife ($100 in chips) 
Seat 6: Cogss ($99.91 in chips) 
Seat 7: djammusic ($47.50 in chips) 
Seat 8: matiko09 ($127.91 in chips) 
Seat 9: Sreshta222 ($307.13 in chips) 
forsmthgood: posts small blind $0.50
sebaaastian: posts big blind $1
*** HOLE CARDS ***
Dealt to matiko09 [3h Ah]
hammerwife: folds 
Cogss: raises $1 to $2
djammusic: folds 
matiko09: folds 
Sreshta222: folds 
forsmthgood: folds 
sebaaastian: folds 
Uncalled bet ($1) returned to Cogss
Cogss collected $2.50 from pot
*** SUMMARY ***
Total pot $2.50 | Rake $0 
Seat 1: forsmthgood (small blind) folded before Flop
Seat 4: sebaaastian (big blind) folded before Flop
Seat 5: hammerwife folded before Flop (didn't bet)
Seat 6: Cogss collected ($2.50)
Seat 7: djammusic folded before Flop (didn't bet)
Seat 8: matiko09 folded before Flop (didn't bet)
Seat 9: Sreshta222 (button) folded before Flop (didn't bet)





PokerStars Hand #149394437134:  Hold'em No Limit ($0.25/$0.50 USD) - 2016/02/25 17:32:44 CET [2016/02/25 11:32:44 ET]
Table 'Lohja II' 9-max Seat #7 is the button
Seat 1: MoonJimmy ($164.03 in chips) 
Seat 3: guvalc1952 ($223.67 in chips) 
Seat 4: payback11 ($50 in chips) 
Seat 5: Effort92 ($50 in chips) 
Seat 7: matiko09 ($94.16 in chips) 
Seat 8: jamba83 ($68.44 in chips) 
Seat 9: Al3xAnd3r22 ($98 in chips) 
jamba83: posts small blind $0.25
Al3xAnd3r22: posts big blind $0.50
mycka86: sits out 
MoonJimmy: posts the ante $0.10
guvalc1952: posts the ante $0.10
payback11: posts the ante $0.10
Effort92: posts the ante $0.10
matiko09: posts the ante $0.10
jamba83: posts the ante $0.10
Al3xAnd3r22: posts the ante $0.10
*** HOLE CARDS ***
Dealt to matiko09 [Qs Tc]
MoonJimmy: folds 
guvalc1952: calls $0.50
payback11: folds 
Effort92: folds 
matiko09: raises $2 to $2.50
jamba83: folds 
Al3xAnd3r22: folds 
guvalc1952: folds 
Uncalled bet ($2) returned to matiko09
matiko09 collected $2.45 from pot
matiko09: doesn't show hand 
*** SUMMARY ***
Total pot $2.45 | Rake $0 
Seat 1: MoonJimmy folded before Flop (didn't bet)
Seat 3: guvalc1952 folded before Flop
Seat 4: payback11 folded before Flop (didn't bet)
Seat 5: Effort92 folded before Flop (didn't bet)
Seat 7: matiko09 (button) collected ($2.45)
Seat 8: jamba83 (small blind) folded before Flop
Seat 9: Al3xAnd3r22 (big blind) folded before Flop





PokerStars Hand #149394441075:  Hold'em No Limit ($0.50/$1.00 USD) - 2016/02/25 17:32:49 CET [2016/02/25 11:32:49 ET]
Table 'Eurysaces II' 9-max Seat #9 is the button
Seat 1: lysandrafly ($100 in chips) 
Seat 2: sebaaastian ($103.78 in chips) 
Seat 3: nickreason17 ($101.50 in chips) 
Seat 5: keessie93 ($68.71 in chips) 
Seat 6: J0rmungund ($45.37 in chips) 
Seat 7: $-Twackle-$ ($101.50 in chips) 
Seat 9: matiko09 ($100 in chips) 
lysandrafly: posts small blind $0.50
sebaaastian: posts big blind $1
gabi_igna: sits out 
hammerwife: sits out 
*** HOLE CARDS ***
Dealt to matiko09 [Qs 8c]
nickreason17: folds 
keessie93: folds 
J0rmungund: raises $2 to $3
$-Twackle-$: folds 
matiko09: folds 
lysandrafly: folds 
sebaaastian: folds 
Uncalled bet ($2) returned to J0rmungund
J0rmungund collected $2.50 from pot
*** SUMMARY ***
Total pot $2.50 | Rake $0 
Seat 1: lysandrafly (small blind) folded before Flop
Seat 2: sebaaastian (big blind) folded before Flop
Seat 3: nickreason17 folded before Flop (didn't bet)
Seat 5: keessie93 folded before Flop (didn't bet)
Seat 6: J0rmungund collected ($2.50)
Seat 7: $-Twackle-$ folded before Flop (didn't bet)
Seat 9: matiko09 (button) folded before Flop (didn't bet)





PokerStars Hand #149394453472:  Hold'em No Limit ($0.25/$0.50 USD) - 2016/02/25 17:33:04 CET [2016/02/25 11:33:04 ET]
Table 'Lohja II' 9-max Seat #8 is the button
Seat 1: MoonJimmy ($163.93 in chips) 
Seat 3: guvalc1952 ($223.07 in chips) 
Seat 4: payback11 ($50 in chips) 
Seat 5: Effort92 ($50 in chips) 
Seat 7: matiko09 ($96.01 in chips) 
Seat 8: jamba83 ($68.09 in chips) 
Seat 9: Al3xAnd3r22 ($98 in chips) 
Al3xAnd3r22: posts small blind $0.25
MoonJimmy: posts big blind $0.50
mycka86: sits out 
MoonJimmy: posts the ante $0.10
guvalc1952: posts the ante $0.10
payback11: posts the ante $0.10
Effort92: posts the ante $0.10
matiko09: posts the ante $0.10
jamba83: posts the ante $0.10
Al3xAnd3r22: posts the ante $0.10
*** HOLE CARDS ***
Dealt to matiko09 [7c Th]
guvalc1952: folds 
payback11: folds 
Effort92: raises $1 to $1.50
matiko09: folds 
jamba83: calls $1.50
Al3xAnd3r22: folds 
MoonJimmy: folds 
*** FLOP *** [Kc Tc 4d]
Effort92: bets $2.80
jamba83: folds 
Uncalled bet ($2.80) returned to Effort92
Effort92 collected $4.25 from pot
Effort92: doesn't show hand 
*** SUMMARY ***
Total pot $4.45 | Rake $0.20 
Board [Kc Tc 4d]
Seat 1: MoonJimmy (big blind) folded before Flop
Seat 3: guvalc1952 folded before Flop (didn't bet)
Seat 4: payback11 folded before Flop (didn't bet)
Seat 5: Effort92 collected ($4.25)
Seat 7: matiko09 folded before Flop (didn't bet)
Seat 8: jamba83 (button) folded on the Flop
Seat 9: Al3xAnd3r22 (small blind) folded before Flop





PokerStars Hand #149394454250:  Hold'em No Limit ($0.50/$1.00 USD) - 2016/02/25 17:33:05 CET [2016/02/25 11:33:05 ET]
Table 'Zerbinetta II' 9-max Seat #4 is the button
Seat 1: $-Twackle-$ ($100 in chips) 
Seat 2: lysandrafly ($102.28 in chips) 
Seat 3: matiko09 ($103.75 in chips) 
Seat 4: sebaaastian ($100 in chips) 
Seat 5: hammerwife ($122.77 in chips) 
Seat 7: HomerrrJay ($100 in chips) 
Seat 8: gabi_igna ($101 in chips) 
Seat 9: with-w ($50.49 in chips) 
hammerwife: posts small blind $0.50
nickreason17: is sitting out 
HomerrrJay: posts big blind $1
*** HOLE CARDS ***
Dealt to matiko09 [5d 6c]
nickreason17 leaves the table
Aalleekks joins the table at seat #6 
gabi_igna: raises $2 to $3
with-w: calls $3
$-Twackle-$: folds 
Aalleekks leaves the table
simoniustin joins the table at seat #6 
lysandrafly: folds 
matiko09: folds 
sebaaastian: folds 
hammerwife: folds 
HomerrrJay: folds 
*** FLOP *** [2h 9s Qc]
gabi_igna: bets $4
with-w: calls $4
*** TURN *** [2h 9s Qc] [7d]
gabi_igna: bets $9
with-w: calls $9
*** RIVER *** [2h 9s Qc 7d] [5c]
gabi_igna: checks 
with-w: bets $16
gabi_igna: calls $16
*** SHOW DOWN ***
with-w: shows [Jc Ts] (high card Queen)
gabi_igna: shows [Qs Ks] (a pair of Queens)
gabi_igna collected $62.70 from pot
*** SUMMARY ***
Total pot $65.50 | Rake $2.80 
Board [2h 9s Qc 7d 5c]
Seat 1: $-Twackle-$ folded before Flop (didn't bet)
Seat 2: lysandrafly folded before Flop (didn't bet)
Seat 3: matiko09 folded before Flop (didn't bet)
Seat 4: sebaaastian (button) folded before Flop (didn't bet)
Seat 5: hammerwife (small blind) folded before Flop
Seat 7: HomerrrJay (big blind) folded before Flop
Seat 8: gabi_igna showed [Qs Ks] and won ($62.70) with a pair of Queens
Seat 9: with-w showed [Jc Ts] and lost with high card Queen





PokerStars Hand #149394454029:  Hold'em No Limit ($0.50/$1.00 USD) - 2016/02/25 17:33:05 CET [2016/02/25 11:33:05 ET]
Table 'Ebella II' 9-max Seat #9 is the button
Seat 3: fanmtZ ($40.50 in chips) 
Seat 4: xAndorx ($100 in chips) 
Seat 5: matiko09 ($109.86 in chips) 
Seat 6: gabi_igna ($103.21 in chips) 
Seat 7: $-Twackle-$ ($100 in chips) 
Seat 8: ZMPOUTSAM140 ($94.55 in chips) 
Seat 9: simoniustin ($109.13 in chips) 
fanmtZ: posts small blind $0.50
xAndorx: posts big blind $1
*** HOLE CARDS ***
Dealt to matiko09 [Jd 8s]
matiko09: folds 
gabi_igna: folds 
$-Twackle-$: folds 
ZMPOUTSAM140: raises $2 to $3
simoniustin: folds 
fanmtZ: folds 
xAndorx: folds 
Uncalled bet ($2) returned to ZMPOUTSAM140
ZMPOUTSAM140 collected $2.50 from pot
*** SUMMARY ***
Total pot $2.50 | Rake $0 
Seat 3: fanmtZ (small blind) folded before Flop
Seat 4: xAndorx (big blind) folded before Flop
Seat 5: matiko09 folded before Flop (didn't bet)
Seat 6: gabi_igna folded before Flop (didn't bet)
Seat 7: $-Twackle-$ folded before Flop (didn't bet)
Seat 8: ZMPOUTSAM140 collected ($2.50)
Seat 9: simoniustin (button) folded before Flop (didn't bet)





PokerStars Hand #149394458433:  Hold'em No Limit ($0.50/$1.00 USD) - 2016/02/25 17:33:10 CET [2016/02/25 11:33:10 ET]
Table 'Badenia II' 9-max Seat #1 is the button
Seat 1: matiko09 ($100 in chips) 
Seat 3: sebaaastian ($145.50 in chips) 
Seat 4: hammerwife ($103.75 in chips) 
Seat 5: djammusic ($117.43 in chips) 
Seat 7: forsmthgood ($185.91 in chips) 
Seat 9: waisanen ($238.03 in chips) 
sebaaastian: posts small blind $0.50
hammerwife: posts big blind $1
xAndorx: sits out 
*** HOLE CARDS ***
Dealt to matiko09 [5s Tc]
djammusic: folds 
forsmthgood: folds 
waisanen: folds 
matiko09: folds 
Stibitzkie leaves the table
sebaaastian: folds 
Uncalled bet ($0.50) returned to hammerwife
Venomous100% joins the table at seat #2 
hammerwife collected $1 from pot
hammerwife: doesn't show hand 
*** SUMMARY ***
Total pot $1 | Rake $0 
Seat 1: matiko09 (button) folded before Flop (didn't bet)
Seat 3: sebaaastian (small blind) folded before Flop
Seat 4: hammerwife (big blind) collected ($1)
Seat 5: djammusic folded before Flop (didn't bet)
Seat 7: forsmthgood folded before Flop (didn't bet)
Seat 9: waisanen folded before Flop (didn't bet)





PokerStars Hand #149394464308:  Hold'em No Limit ($0.50/$1.00 USD) - 2016/02/25 17:33:18 CET [2016/02/25 11:33:18 ET]
Table 'Isa' 9-max Seat #9 is the button
Seat 1: matiko09 ($123.58 in chips) 
Seat 2: mycka86 ($157.42 in chips) 
Seat 3: sebaaastian ($137.25 in chips) 
Seat 4: hammerwife ($121.41 in chips) 
Seat 7: bilukm ($100 in chips) 
Seat 8: Venomous100% ($106.74 in chips) 
Seat 9: HomerrrJay ($153.61 in chips) 
matiko09: posts small blind $0.50
mycka86: posts big blind $1
xAndorx: sits out 
*** HOLE CARDS ***
Dealt to matiko09 [2h 2d]
sebaaastian: folds 
hammerwife: folds 
bilukm: folds 
Venomous100%: raises $1.50 to $2.50
HomerrrJay: folds 
matiko09: folds 
mycka86: folds 
Uncalled bet ($1.50) returned to Venomous100%
Venomous100% collected $2.50 from pot
Venomous100%: doesn't show hand 
*** SUMMARY ***
Total pot $2.50 | Rake $0 
Seat 1: matiko09 (small blind) folded before Flop
Seat 2: mycka86 (big blind) folded before Flop
Seat 3: sebaaastian folded before Flop (didn't bet)
Seat 4: hammerwife folded before Flop (didn't bet)
Seat 7: bilukm folded before Flop (didn't bet)
Seat 8: Venomous100% collected ($2.50)
Seat 9: HomerrrJay (button) folded before Flop (didn't bet)





PokerStars Hand #149394468789:  Hold'em No Limit ($0.50/$1.00 USD) - 2016/02/25 17:33:23 CET [2016/02/25 11:33:23 ET]
Table 'Eurysaces II' 9-max Seat #1 is the button
Seat 1: lysandrafly ($100 in chips) 
Seat 2: sebaaastian ($102.78 in chips) 
Seat 4: gabi_igna ($100 in chips) 
Seat 5: keessie93 ($68.71 in chips) 
Seat 6: J0rmungund ($46.87 in chips) 
Seat 7: $-Twackle-$ ($101.50 in chips) 
Seat 9: matiko09 ($100 in chips) 
sebaaastian: posts small blind $0.50
nickreason17: is sitting out 
nickreason17 leaves the table
gabi_igna: posts big blind $1
hammerwife: sits out 
*** HOLE CARDS ***
Dealt to matiko09 [3s 2d]
keessie93: raises $2 to $3
J0rmungund: folds 
Aalleekks joins the table at seat #3 
$-Twackle-$: folds 
matiko09: folds 
lysandrafly: folds 
sebaaastian: folds 
gabi_igna: raises $6.50 to $9.50
keessie93: calls $6.50
*** FLOP *** [3d 5c Ad]
gabi_igna: bets $9
keessie93: raises $18 to $27
gabi_igna: calls $18
*** TURN *** [3d 5c Ad] [5d]
gabi_igna: checks 
keessie93: bets $32.21 and is all-in
gabi_igna: calls $32.21
*** RIVER *** [3d 5c Ad 5d] [6c]
*** SHOW DOWN ***
gabi_igna: shows [Ks Ah] (two pair, Aces and Fives)
keessie93: shows [3c 3h] (a full house, Threes full of Fives)
keessie93 collected $135.12 from pot
*** SUMMARY ***
Total pot $137.92 | Rake $2.80 
Board [3d 5c Ad 5d 6c]
Seat 1: lysandrafly (button) folded before Flop (didn't bet)
Seat 2: sebaaastian (small blind) folded before Flop
Seat 4: gabi_igna (big blind) showed [Ks Ah] and lost with two pair, Aces and Fives
Seat 5: keessie93 showed [3c 3h] and won ($135.12) with a full house, Threes full of Fives
Seat 6: J0rmungund folded before Flop (didn't bet)
Seat 7: $-Twackle-$ folded before Flop (didn't bet)
Seat 9: matiko09 folded before Flop (didn't bet)





PokerStars Hand #149394470443:  Hold'em No Limit ($0.50/$1.00 USD) - 2016/02/25 17:33:25 CET [2016/02/25 11:33:25 ET]
Table 'Mayall II' 9-max Seat #8 is the button
Seat 1: matiko09 ($123.41 in chips) 
Seat 3: simoniustin ($101.50 in chips) 
Seat 4: Ouga Buga ($106.17 in chips) 
Seat 5: HomerrrJay ($101.50 in chips) 
Seat 6: apfush ($113.67 in chips) 
Seat 7: r.pol218 ($33 in chips) 
Seat 8: kuanhung0903 ($89.96 in chips) 
xAndorx will be allowed to play after the button
matiko09: posts small blind $0.50
simoniustin: posts big blind $1
r.pol218: posts small & big blinds $1.50
*** HOLE CARDS ***
Dealt to matiko09 [6h 6c]
Ouga Buga: folds 
HomerrrJay: folds 
apfush: folds 
r.pol218: checks 
kuanhung0903: folds 
matiko09: raises $4 to $5
simoniustin: folds 
r.pol218: calls $4
*** FLOP *** [As 9h Ks]
matiko09: checks 
r.pol218: bets $3
matiko09: folds 
Uncalled bet ($3) returned to r.pol218
r.pol218 collected $10.98 from pot
r.pol218: doesn't show hand 
*** SUMMARY ***
Total pot $11.50 | Rake $0.52 
Board [As 9h Ks]
Seat 1: matiko09 (small blind) folded on the Flop
Seat 3: simoniustin (big blind) folded before Flop
Seat 4: Ouga Buga folded before Flop (didn't bet)
Seat 5: HomerrrJay folded before Flop (didn't bet)
Seat 6: apfush folded before Flop (didn't bet)
Seat 7: r.pol218 collected ($10.98)
Seat 8: kuanhung0903 (button) folded before Flop (didn't bet)





PokerStars Hand #149394471512:  Hold'em No Limit ($0.50/$1.00 USD) - 2016/02/25 17:33:27 CET [2016/02/25 11:33:27 ET]
Table 'Sabine' 9-max Seat #9 is the button
Seat 1: Aalleekks ($100 in chips) 
Seat 2: apfush ($133.93 in chips) 
Seat 3: Ouga Buga ($103.38 in chips) 
Seat 4: simoniustin ($100 in chips) 
Seat 5: Venomous100% ($107.04 in chips) 
Seat 6: ffac ($102.18 in chips) 
Seat 7: clayshmert ($78.91 in chips) 
Seat 8: matiko09 ($186.66 in chips) 
Seat 9: djammusic ($40 in chips) 
Aalleekks: posts small blind $0.50
apfush: posts big blind $1
*** HOLE CARDS ***
Dealt to matiko09 [3d 4h]
Ouga Buga: folds 
simoniustin: raises $2 to $3
Venomous100%: folds 
ffac: folds 
clayshmert: folds 
matiko09: folds 
djammusic: folds 
Aalleekks: folds 
apfush: folds 
Uncalled bet ($2) returned to simoniustin
simoniustin collected $2.50 from pot
simoniustin: doesn't show hand 
*** SUMMARY ***
Total pot $2.50 | Rake $0 
Seat 1: Aalleekks (small blind) folded before Flop
Seat 2: apfush (big blind) folded before Flop
Seat 3: Ouga Buga folded before Flop (didn't bet)
Seat 4: simoniustin collected ($2.50)
Seat 5: Venomous100% folded before Flop (didn't bet)
Seat 6: ffac folded before Flop (didn't bet)
Seat 7: clayshmert folded before Flop (didn't bet)
Seat 8: matiko09 folded before Flop (didn't bet)
Seat 9: djammusic (button) folded before Flop (didn't bet)





PokerStars Hand #149394475327:  Hold'em No Limit ($0.50/$1.00 USD) - 2016/02/25 17:33:32 CET [2016/02/25 11:33:32 ET]
Table 'Zeuxo II' 9-max Seat #1 is the button
Seat 1: forsmthgood ($102.04 in chips) 
Seat 4: sebaaastian ($100 in chips) 
Seat 5: hammerwife ($100 in chips) 
Seat 6: Cogss ($101.41 in chips) 
Seat 7: djammusic ($47.50 in chips) 
Seat 8: matiko09 ($127.91 in chips) 
Seat 9: Sreshta222 ($307.13 in chips) 
xAndorx will be allowed to play after the button
sebaaastian: posts small blind $0.50
hammerwife: posts big blind $1
*** HOLE CARDS ***
Dealt to matiko09 [2s Ah]
Cogss: folds 
djammusic: folds 
matiko09: folds 
Sreshta222: raises $1.50 to $2.50
forsmthgood: folds 
sebaaastian: folds 
hammerwife: folds 
Uncalled bet ($1.50) returned to Sreshta222
Sreshta222 collected $2.50 from pot
Sreshta222: doesn't show hand 
*** SUMMARY ***
Total pot $2.50 | Rake $0 
Seat 1: forsmthgood (button) folded before Flop (didn't bet)
Seat 4: sebaaastian (small blind) folded before Flop
Seat 5: hammerwife (big blind) folded before Flop
Seat 6: Cogss folded before Flop (didn't bet)
Seat 7: djammusic folded before Flop (didn't bet)
Seat 8: matiko09 folded before Flop (didn't bet)
Seat 9: Sreshta222 collected ($2.50)





PokerStars Hand #149394485060:  Hold'em No Limit ($0.50/$1.00 USD) - 2016/02/25 17:33:43 CET [2016/02/25 11:33:43 ET]
Table 'Nerthus II' 9-max Seat #3 is the button
Seat 1: DUkalisUA ($106.61 in chips) 
Seat 2: matiko09 ($218.68 in chips) 
Seat 3: simoniustin ($100 in chips) 
Seat 4: Ilov3NBA ($106.12 in chips) 
Seat 6: mycka86 ($144.38 in chips) 
Seat 7: Venomous100% ($108.65 in chips) 
Seat 8: Kelvin sai ($42.38 in chips) 
Seat 9: hammerwife ($102 in chips) 
Ilov3NBA: posts small blind $0.50
mycka86: posts big blind $1
*** HOLE CARDS ***
Dealt to matiko09 [Kd 5s]
Venomous100%: folds 
Kelvin sai: folds 
hammerwife: folds 
DUkalisUA: folds 
matiko09: folds 
simoniustin: raises $1.50 to $2.50
Ilov3NBA: folds 
mycka86: folds 
Uncalled bet ($1.50) returned to simoniustin
simoniustin collected $2.50 from pot
simoniustin: doesn't show hand 
*** SUMMARY ***
Total pot $2.50 | Rake $0 
Seat 1: DUkalisUA folded before Flop (didn't bet)
Seat 2: matiko09 folded before Flop (didn't bet)
Seat 3: simoniustin (button) collected ($2.50)
Seat 4: Ilov3NBA (small blind) folded before Flop
Seat 6: mycka86 (big blind) folded before Flop
Seat 7: Venomous100% folded before Flop (didn't bet)
Seat 8: Kelvin sai folded before Flop (didn't bet)
Seat 9: hammerwife folded before Flop (didn't bet)





PokerStars Hand #149394484401:  Hold'em No Limit ($0.50/$1.00 USD) - 2016/02/25 17:33:43 CET [2016/02/25 11:33:43 ET]
Table 'Ebella II' 9-max Seat #3 is the button
Seat 3: fanmtZ ($40 in chips) 
Seat 4: xAndorx ($100 in chips) 
Seat 5: matiko09 ($109.86 in chips) 
Seat 6: gabi_igna ($103.21 in chips) 
Seat 7: $-Twackle-$ ($100 in chips) 
Seat 8: ZMPOUTSAM140 ($96.05 in chips) 
Seat 9: simoniustin ($109.13 in chips) 
xAndorx: posts small blind $0.50
matiko09: posts big blind $1
*** HOLE CARDS ***
Dealt to matiko09 [7s As]
gabi_igna: folds 
$-Twackle-$: folds 
ZMPOUTSAM140: folds 
simoniustin: folds 
fanmtZ: raises $1.02 to $2.02
xAndorx: folds 
matiko09: calls $1.02
*** FLOP *** [Kd 9c 5c]
matiko09: checks 
fanmtZ: checks 
*** TURN *** [Kd 9c 5c] [8c]
matiko09: checks 
fanmtZ: checks 
*** RIVER *** [Kd 9c 5c 8c] [8d]
matiko09: checks 
fanmtZ: checks 
*** SHOW DOWN ***
matiko09: shows [7s As] (a pair of Eights)
fanmtZ: shows [9h Qs] (two pair, Nines and Eights)
fanmtZ collected $4.34 from pot
*** SUMMARY ***
Total pot $4.54 | Rake $0.20 
Board [Kd 9c 5c 8c 8d]
Seat 3: fanmtZ (button) showed [9h Qs] and won ($4.34) with two pair, Nines and Eights
Seat 4: xAndorx (small blind) folded before Flop
Seat 5: matiko09 (big blind) showed [7s As] and lost with a pair of Eights
Seat 6: gabi_igna folded before Flop (didn't bet)
Seat 7: $-Twackle-$ folded before Flop (didn't bet)
Seat 8: ZMPOUTSAM140 folded before Flop (didn't bet)
Seat 9: simoniustin folded before Flop (didn't bet)





PokerStars Hand #149394490196:  Hold'em No Limit ($0.50/$1.00 USD) - 2016/02/25 17:33:50 CET [2016/02/25 11:33:50 ET]
Table 'Badenia II' 9-max Seat #3 is the button
Seat 1: matiko09 ($100 in chips) 
Seat 3: sebaaastian ($145 in chips) 
Seat 4: hammerwife ($104.25 in chips) 
Seat 6: xAndorx ($119.80 in chips) 
Seat 7: forsmthgood ($185.91 in chips) 
Seat 9: waisanen ($238.03 in chips) 
hammerwife: posts small blind $0.50
djammusic: is sitting out 
xAndorx: posts big blind $1
Venomous100%: sits out 
*** HOLE CARDS ***
Dealt to matiko09 [Jd 7d]
forsmthgood: folds 
djammusic leaves the table
waisanen: folds 
matiko09: folds 
sebaaastian: folds 
hammerwife: folds 
Uncalled bet ($0.50) returned to xAndorx
xAndorx collected $1 from pot
xAndorx: doesn't show hand 
*** SUMMARY ***
Total pot $1 | Rake $0 
Seat 1: matiko09 folded before Flop (didn't bet)
Seat 3: sebaaastian (button) folded before Flop (didn't bet)
Seat 4: hammerwife (small blind) folded before Flop
Seat 6: xAndorx (big blind) collected ($1)
Seat 7: forsmthgood folded before Flop (didn't bet)
Seat 9: waisanen folded before Flop (didn't bet)





PokerStars Hand #149394493361:  Hold'em No Limit ($0.25/$0.50 USD) - 2016/02/25 17:33:54 CET [2016/02/25 11:33:54 ET]
Table 'Lohja II' 9-max Seat #9 is the button
Seat 1: MoonJimmy ($163.33 in chips) 
Seat 2: mycka86 ($50 in chips) 
Seat 3: guvalc1952 ($222.97 in chips) 
Seat 4: payback11 ($50 in chips) 
Seat 5: Effort92 ($52.65 in chips) 
Seat 7: matiko09 ($95.91 in chips) 
Seat 8: jamba83 ($66.49 in chips) 
Seat 9: Al3xAnd3r22 ($98 in chips) 
MoonJimmy: posts small blind $0.25
mycka86: posts big blind $0.50
xAndorx: sits out 
MoonJimmy: posts the ante $0.10
mycka86: posts the ante $0.10
guvalc1952: posts the ante $0.10
payback11: posts the ante $0.10
Effort92: posts the ante $0.10
matiko09: posts the ante $0.10
jamba83: posts the ante $0.10
Al3xAnd3r22: posts the ante $0.10
*** HOLE CARDS ***
Dealt to matiko09 [2s 9c]
guvalc1952: folds 
payback11: raises $0.80 to $1.30
Effort92: folds 
matiko09: folds 
jamba83: folds 
Al3xAnd3r22: folds 
MoonJimmy: folds 
mycka86: folds 
Uncalled bet ($0.80) returned to payback11
payback11 collected $2.05 from pot
payback11: doesn't show hand 
*** SUMMARY ***
Total pot $2.05 | Rake $0 
Seat 1: MoonJimmy (small blind) folded before Flop
Seat 2: mycka86 (big blind) folded before Flop
Seat 3: guvalc1952 folded before Flop (didn't bet)
Seat 4: payback11 collected ($2.05)
Seat 5: Effort92 folded before Flop (didn't bet)
Seat 7: matiko09 folded before Flop (didn't bet)
Seat 8: jamba83 folded before Flop (didn't bet)
Seat 9: Al3xAnd3r22 (button) folded before Flop (didn't bet)





PokerStars Hand #149394496623:  Hold'em No Limit ($0.50/$1.00 USD) - 2016/02/25 17:33:58 CET [2016/02/25 11:33:58 ET]
Table 'Zeuxo II' 9-max Seat #4 is the button
Seat 1: forsmthgood ($102.04 in chips) 
Seat 4: sebaaastian ($100 in chips) 
Seat 5: hammerwife ($100 in chips) 
Seat 6: Cogss ($101.41 in chips) 
Seat 7: djammusic ($47.50 in chips) 
Seat 8: matiko09 ($127.91 in chips) 
Seat 9: Sreshta222 ($308.63 in chips) 
hammerwife: posts small blind $0.50
Cogss: posts big blind $1
xAndorx: sits out 
*** HOLE CARDS ***
Dealt to matiko09 [4s 7c]
djammusic: folds 
matiko09: folds 
Sreshta222: folds 
forsmthgood: raises $1.50 to $2.50
sebaaastian: folds 
hammerwife: folds 
Cogss: folds 
Uncalled bet ($1.50) returned to forsmthgood
forsmthgood collected $2.50 from pot
forsmthgood: doesn't show hand 
*** SUMMARY ***
Total pot $2.50 | Rake $0 
Seat 1: forsmthgood collected ($2.50)
Seat 4: sebaaastian (button) folded before Flop (didn't bet)
Seat 5: hammerwife (small blind) folded before Flop
Seat 6: Cogss (big blind) folded before Flop
Seat 7: djammusic folded before Flop (didn't bet)
Seat 8: matiko09 folded before Flop (didn't bet)
Seat 9: Sreshta222 folded before Flop (didn't bet)





PokerStars Hand #149394503362:  Hold'em No Limit ($0.50/$1.00 USD) - 2016/02/25 17:34:06 CET [2016/02/25 11:34:06 ET]
Table 'Badenia II' 9-max Seat #4 is the button
Seat 1: matiko09 ($100 in chips) 
Seat 3: sebaaastian ($145 in chips) 
Seat 4: hammerwife ($103.75 in chips) 
Seat 6: xAndorx ($120.30 in chips) 
Seat 9: waisanen ($238.03 in chips) 
xAndorx: posts small blind $0.50
forsmthgood: is sitting out 
waisanen: posts big blind $1
forsmthgood leaves the table
Venomous100%: sits out 
*** HOLE CARDS ***
Dealt to matiko09 [7s 7d]
Ilov3NBA joins the table at seat #5 
matiko09: raises $2 to $3
sebaaastian: folds 
hammerwife: folds 
xAndorx: folds 
waisanen: folds 
Uncalled bet ($2) returned to matiko09
matiko09 collected $2.50 from pot
matiko09: doesn't show hand 
*** SUMMARY ***
Total pot $2.50 | Rake $0 
Seat 1: matiko09 collected ($2.50)
Seat 3: sebaaastian folded before Flop (didn't bet)
Seat 4: hammerwife (button) folded before Flop (didn't bet)
Seat 6: xAndorx (small blind) folded before Flop
Seat 9: waisanen (big blind) folded before Flop





PokerStars Hand #149394508379:  Hold'em No Limit ($0.50/$1.00 USD) - 2016/02/25 17:34:12 CET [2016/02/25 11:34:12 ET]
Table 'Nerthus II' 9-max Seat #4 is the button
Seat 1: DUkalisUA ($106.61 in chips) 
Seat 2: matiko09 ($218.68 in chips) 
Seat 3: simoniustin ($101.50 in chips) 
Seat 4: Ilov3NBA ($105.62 in chips) 
Seat 6: mycka86 ($143.38 in chips) 
Seat 7: Venomous100% ($108.65 in chips) 
Seat 8: Kelvin sai ($42.38 in chips) 
Seat 9: hammerwife ($102 in chips) 
mycka86: posts small blind $0.50
Venomous100%: posts big blind $1
*** HOLE CARDS ***
Dealt to matiko09 [4s 6h]
Kelvin sai: folds 
hammerwife: folds 
DUkalisUA: folds 
matiko09: folds 
simoniustin: folds 
Ilov3NBA: folds 
mycka86: folds 
Uncalled bet ($0.50) returned to Venomous100%
Venomous100% collected $1 from pot
Venomous100%: doesn't show hand 
*** SUMMARY ***
Total pot $1 | Rake $0 
Seat 1: DUkalisUA folded before Flop (didn't bet)
Seat 2: matiko09 folded before Flop (didn't bet)
Seat 3: simoniustin folded before Flop (didn't bet)
Seat 4: Ilov3NBA (button) folded before Flop (didn't bet)
Seat 6: mycka86 (small blind) folded before Flop
Seat 7: Venomous100% (big blind) collected ($1)
Seat 8: Kelvin sai folded before Flop (didn't bet)
Seat 9: hammerwife folded before Flop (didn't bet)





PokerStars Hand #149394509896:  Hold'em No Limit ($0.50/$1.00 USD) - 2016/02/25 17:34:14 CET [2016/02/25 11:34:14 ET]
Table 'Zeuxo II' 9-max Seat #5 is the button
Seat 1: forsmthgood ($103.54 in chips) 
Seat 4: sebaaastian ($100 in chips) 
Seat 5: hammerwife ($100 in chips) 
Seat 6: Cogss ($100.41 in chips) 
Seat 8: matiko09 ($127.91 in chips) 
Seat 9: Sreshta222 ($308.63 in chips) 
Cogss: posts small blind $0.50
djammusic: is sitting out 
matiko09: posts big blind $1
xAndorx: sits out 
*** HOLE CARDS ***
Dealt to matiko09 [Th Jd]
Sreshta222: folds 
forsmthgood: raises $2 to $3
sebaaastian: folds 
djammusic leaves the table
hammerwife: folds 
Cogss: folds 
matiko09: folds 
Uncalled bet ($2) returned to forsmthgood
forsmthgood collected $2.50 from pot
forsmthgood: doesn't show hand 
Venomous100% joins the table at seat #7 
*** SUMMARY ***
Total pot $2.50 | Rake $0 
Seat 1: forsmthgood collected ($2.50)
Seat 4: sebaaastian folded before Flop (didn't bet)
Seat 5: hammerwife (button) folded before Flop (didn't bet)
Seat 6: Cogss (small blind) folded before Flop
Seat 8: matiko09 (big blind) folded before Flop
Seat 9: Sreshta222 folded before Flop (didn't bet)





PokerStars Hand #149394509994:  Hold'em No Limit ($0.50/$1.00 USD) - 2016/02/25 17:34:14 CET [2016/02/25 11:34:14 ET]
Table 'Sabine' 9-max Seat #1 is the button
Seat 1: Aalleekks ($100 in chips) 
Seat 2: apfush ($132.93 in chips) 
Seat 3: Ouga Buga ($103.38 in chips) 
Seat 4: simoniustin ($101.50 in chips) 
Seat 5: Venomous100% ($107.04 in chips) 
Seat 6: ffac ($102.18 in chips) 
Seat 7: clayshmert ($78.91 in chips) 
Seat 8: matiko09 ($186.66 in chips) 
Seat 9: djammusic ($40 in chips) 
apfush: posts small blind $0.50
Ouga Buga: posts big blind $1
*** HOLE CARDS ***
Dealt to matiko09 [6c 8h]
simoniustin: folds 
Venomous100%: folds 
ffac: folds 
clayshmert has timed out
clayshmert: folds 
matiko09: folds 
djammusic: folds 
Aalleekks: folds 
apfush: folds 
Uncalled bet ($0.50) returned to Ouga Buga
Ouga Buga collected $1 from pot
Ouga Buga: doesn't show hand 
*** SUMMARY ***
Total pot $1 | Rake $0 
Seat 1: Aalleekks (button) folded before Flop (didn't bet)
Seat 2: apfush (small blind) folded before Flop
Seat 3: Ouga Buga (big blind) collected ($1)
Seat 4: simoniustin folded before Flop (didn't bet)
Seat 5: Venomous100% folded before Flop (didn't bet)
Seat 6: ffac folded before Flop (didn't bet)
Seat 7: clayshmert folded before Flop (didn't bet)
Seat 8: matiko09 folded before Flop (didn't bet)
Seat 9: djammusic folded before Flop (didn't bet)





PokerStars Hand #149394511273:  Hold'em No Limit ($0.50/$1.00 USD) - 2016/02/25 17:34:16 CET [2016/02/25 11:34:16 ET]
Table 'Isa' 9-max Seat #1 is the button
Seat 1: matiko09 ($123.08 in chips) 
Seat 2: mycka86 ($156.42 in chips) 
Seat 3: sebaaastian ($137.25 in chips) 
Seat 4: hammerwife ($121.41 in chips) 
Seat 7: bilukm ($100 in chips) 
Seat 8: Venomous100% ($108.24 in chips) 
Seat 9: HomerrrJay ($153.61 in chips) 
mycka86: posts small blind $0.50
sebaaastian: posts big blind $1
xAndorx: sits out 
*** HOLE CARDS ***
Dealt to matiko09 [4c Ad]
hammerwife: folds 
bilukm: folds 
Venomous100%: folds 
HomerrrJay: folds 
matiko09: raises $1.27 to $2.27
mycka86: folds 
sebaaastian: folds 
Uncalled bet ($1.27) returned to matiko09
matiko09 collected $2.50 from pot
matiko09: doesn't show hand 
*** SUMMARY ***
Total pot $2.50 | Rake $0 
Seat 1: matiko09 (button) collected ($2.50)
Seat 2: mycka86 (small blind) folded before Flop
Seat 3: sebaaastian (big blind) folded before Flop
Seat 4: hammerwife folded before Flop (didn't bet)
Seat 7: bilukm folded before Flop (didn't bet)
Seat 8: Venomous100% folded before Flop (didn't bet)
Seat 9: HomerrrJay folded before Flop (didn't bet)





PokerStars Hand #149394518749:  Hold'em No Limit ($0.50/$1.00 USD) - 2016/02/25 17:34:25 CET [2016/02/25 11:34:25 ET]
Table 'Mayall II' 9-max Seat #1 is the button
Seat 1: matiko09 ($118.41 in chips) 
Seat 3: simoniustin ($100.50 in chips) 
Seat 4: Ouga Buga ($106.17 in chips) 
Seat 5: HomerrrJay ($101.50 in chips) 
Seat 6: apfush ($113.67 in chips) 
Seat 7: r.pol218 ($38.48 in chips) 
Seat 8: kuanhung0903 ($89.96 in chips) 
simoniustin: posts small blind $0.50
Ouga Buga: posts big blind $1
xAndorx: sits out 
*** HOLE CARDS ***
Dealt to matiko09 [Kh Qc]
HomerrrJay: folds 
HomerrrJay leaves the table
apfush: folds 
r.pol218: folds 
kuanhung0903: folds 
matiko09: raises $1.27 to $2.27
simoniustin: raises $6.73 to $9
Ouga Buga: folds 
matiko09: calls $6.73
*** FLOP *** [Ad Jc 2h]
simoniustin: bets $12
matiko09: folds 
Uncalled bet ($12) returned to simoniustin
simoniustin collected $18.14 from pot
simoniustin: doesn't show hand 
*** SUMMARY ***
Total pot $19 | Rake $0.86 
Board [Ad Jc 2h]
Seat 1: matiko09 (button) folded on the Flop
Seat 3: simoniustin (small blind) collected ($18.14)
Seat 4: Ouga Buga (big blind) folded before Flop
Seat 5: HomerrrJay folded before Flop (didn't bet)
Seat 6: apfush folded before Flop (didn't bet)
Seat 7: r.pol218 folded before Flop (didn't bet)
Seat 8: kuanhung0903 folded before Flop (didn't bet)





PokerStars Hand #149394522158:  Hold'em No Limit ($0.50/$1.00 USD) - 2016/02/25 17:34:29 CET [2016/02/25 11:34:29 ET]
Table 'Badenia II' 9-max Seat #6 is the button
Seat 1: matiko09 ($101.50 in chips) 
Seat 3: sebaaastian ($145 in chips) 
Seat 4: hammerwife ($103.75 in chips) 
Seat 6: xAndorx ($119.80 in chips) 
Seat 9: waisanen ($237.03 in chips) 
waisanen: posts small blind $0.50
matiko09: posts big blind $1
Venomous100%: sits out 
Ilov3NBA: sits out 
*** HOLE CARDS ***
Dealt to matiko09 [Jh Th]
sebaaastian: folds 
hammerwife: folds 
xAndorx: folds 
waisanen: raises $3 to $4
matiko09: calls $3
*** FLOP *** [Kc 7d 8s]
waisanen: bets $3.82
matiko09: folds 
Uncalled bet ($3.82) returned to waisanen
waisanen collected $7.64 from pot
*** SUMMARY ***
Total pot $8 | Rake $0.36 
Board [Kc 7d 8s]
Seat 1: matiko09 (big blind) folded on the Flop
Seat 3: sebaaastian folded before Flop (didn't bet)
Seat 4: hammerwife folded before Flop (didn't bet)
Seat 6: xAndorx (button) folded before Flop (didn't bet)
Seat 9: waisanen (small blind) collected ($7.64)





PokerStars Hand #149394526097:  Hold'em No Limit ($0.50/$1.00 USD) - 2016/02/25 17:34:34 CET [2016/02/25 11:34:34 ET]
Table 'Ebella II' 9-max Seat #4 is the button
Seat 3: fanmtZ ($42.32 in chips) 
Seat 4: xAndorx ($100 in chips) 
Seat 5: matiko09 ($107.84 in chips) 
Seat 6: gabi_igna ($103.21 in chips) 
Seat 7: $-Twackle-$ ($100 in chips) 
Seat 8: ZMPOUTSAM140 ($96.05 in chips) 
Seat 9: simoniustin ($109.13 in chips) 
matiko09: posts small blind $0.50
gabi_igna: posts big blind $1
*** HOLE CARDS ***
Dealt to matiko09 [Ks 2h]
$-Twackle-$: folds 
ZMPOUTSAM140: folds 
simoniustin: raises $2 to $3
fanmtZ: folds 
xAndorx: folds 
matiko09: folds 
gabi_igna: folds 
Uncalled bet ($2) returned to simoniustin
simoniustin collected $2.50 from pot
simoniustin: doesn't show hand 
*** SUMMARY ***
Total pot $2.50 | Rake $0 
Seat 3: fanmtZ folded before Flop (didn't bet)
Seat 4: xAndorx (button) folded before Flop (didn't bet)
Seat 5: matiko09 (small blind) folded before Flop
Seat 6: gabi_igna (big blind) folded before Flop
Seat 7: $-Twackle-$ folded before Flop (didn't bet)
Seat 8: ZMPOUTSAM140 folded before Flop (didn't bet)
Seat 9: simoniustin collected ($2.50)





PokerStars Hand #149394528103:  Hold'em No Limit ($0.50/$1.00 USD) - 2016/02/25 17:34:37 CET [2016/02/25 11:34:37 ET]
Table 'Nerthus II' 9-max Seat #6 is the button
Seat 1: DUkalisUA ($106.61 in chips) 
Seat 2: matiko09 ($218.68 in chips) 
Seat 3: simoniustin ($101.50 in chips) 
Seat 4: Ilov3NBA ($105.62 in chips) 
Seat 6: mycka86 ($142.88 in chips) 
Seat 7: Venomous100% ($109.15 in chips) 
Seat 8: Kelvin sai ($42.38 in chips) 
Seat 9: hammerwife ($102 in chips) 
Venomous100%: posts small blind $0.50
Kelvin sai: posts big blind $1
*** HOLE CARDS ***
Dealt to matiko09 [4d Qh]
hammerwife: folds 
DUkalisUA: raises $2 to $3
matiko09: folds 
simoniustin: folds 
Ilov3NBA: folds 
mycka86: folds 
Venomous100%: folds 
Kelvin sai: folds 
Uncalled bet ($2) returned to DUkalisUA
DUkalisUA collected $2.50 from pot
DUkalisUA: doesn't show hand 
*** SUMMARY ***
Total pot $2.50 | Rake $0 
Seat 1: DUkalisUA collected ($2.50)
Seat 2: matiko09 folded before Flop (didn't bet)
Seat 3: simoniustin folded before Flop (didn't bet)
Seat 4: Ilov3NBA folded before Flop (didn't bet)
Seat 6: mycka86 (button) folded before Flop (didn't bet)
Seat 7: Venomous100% (small blind) folded before Flop
Seat 8: Kelvin sai (big blind) folded before Flop
Seat 9: hammerwife folded before Flop (didn't bet)





PokerStars Hand #149394529605:  Hold'em No Limit ($0.50/$1.00 USD) - 2016/02/25 17:34:39 CET [2016/02/25 11:34:39 ET]
Table 'Eurysaces II' 9-max Seat #2 is the button
Seat 1: lysandrafly ($100 in chips) 
Seat 2: sebaaastian ($102.28 in chips) 
Seat 4: gabi_igna ($100 in chips) 
Seat 5: keessie93 ($135.12 in chips) 
Seat 6: J0rmungund ($46.87 in chips) 
Seat 7: $-Twackle-$ ($101.50 in chips) 
Seat 9: matiko09 ($100 in chips) 
Aalleekks will be allowed to play after the button
gabi_igna: posts small blind $0.50
keessie93: posts big blind $1
hammerwife: sits out 
*** HOLE CARDS ***
Dealt to matiko09 [9d 2s]
J0rmungund: raises $2 to $3
$-Twackle-$: folds 
matiko09: folds 
lysandrafly: folds 
sebaaastian: folds 
gabi_igna: folds 
keessie93: folds 
Uncalled bet ($2) returned to J0rmungund
J0rmungund collected $2.50 from pot
*** SUMMARY ***
Total pot $2.50 | Rake $0 
Seat 1: lysandrafly folded before Flop (didn't bet)
Seat 2: sebaaastian (button) folded before Flop (didn't bet)
Seat 4: gabi_igna (small blind) folded before Flop
Seat 5: keessie93 (big blind) folded before Flop
Seat 6: J0rmungund collected ($2.50)
Seat 7: $-Twackle-$ folded before Flop (didn't bet)
Seat 9: matiko09 folded before Flop (didn't bet)





PokerStars Hand #149394530078:  Hold'em No Limit ($0.50/$1.00 USD) - 2016/02/25 17:34:39 CET [2016/02/25 11:34:39 ET]
Table 'Zeuxo II' 9-max Seat #6 is the button
Seat 1: forsmthgood ($105.04 in chips) 
Seat 4: sebaaastian ($100 in chips) 
Seat 5: hammerwife ($100 in chips) 
Seat 6: Cogss ($99.91 in chips) 
Seat 8: matiko09 ($126.91 in chips) 
Seat 9: Sreshta222 ($308.63 in chips) 
Venomous100% will be allowed to play after the button
matiko09: posts small blind $0.50
Sreshta222: posts big blind $1
xAndorx: sits out 
*** HOLE CARDS ***
Dealt to matiko09 [Tc Qh]
forsmthgood: folds 
sebaaastian: folds 
hammerwife: folds 
Cogss: raises $1 to $2
matiko09: folds 
Sreshta222: calls $1
*** FLOP *** [2c 7c Ac]
Sreshta222: checks 
Cogss: checks 
*** TURN *** [2c 7c Ac] [3d]
Sreshta222: checks 
Cogss: bets $4.30
Sreshta222: folds 
Uncalled bet ($4.30) returned to Cogss
Cogss collected $4.30 from pot
*** SUMMARY ***
Total pot $4.50 | Rake $0.20 
Board [2c 7c Ac 3d]
Seat 1: forsmthgood folded before Flop (didn't bet)
Seat 4: sebaaastian folded before Flop (didn't bet)
Seat 5: hammerwife folded before Flop (didn't bet)
Seat 6: Cogss (button) collected ($4.30)
Seat 8: matiko09 (small blind) folded before Flop
Seat 9: Sreshta222 (big blind) folded on the Turn





PokerStars Hand #149394530406:  Hold'em No Limit ($0.25/$0.50 USD) - 2016/02/25 17:34:40 CET [2016/02/25 11:34:40 ET]
Table 'Lohja II' 9-max Seat #1 is the button
Seat 1: MoonJimmy ($162.98 in chips) 
Seat 2: mycka86 ($50 in chips) 
Seat 4: payback11 ($51.45 in chips) 
Seat 5: Effort92 ($52.55 in chips) 
Seat 7: matiko09 ($95.81 in chips) 
Seat 8: jamba83 ($66.39 in chips) 
Seat 9: Al3xAnd3r22 ($98 in chips) 
mycka86: posts small blind $0.25
guvalc1952: is sitting out 
payback11: posts big blind $0.50
xAndorx: sits out 
MoonJimmy: posts the ante $0.10
mycka86: posts the ante $0.10
payback11: posts the ante $0.10
Effort92: posts the ante $0.10
matiko09: posts the ante $0.10
jamba83: posts the ante $0.10
Al3xAnd3r22: posts the ante $0.10
*** HOLE CARDS ***
Dealt to matiko09 [Qh Jd]
Effort92: folds 
matiko09: folds 
jamba83: folds 
Al3xAnd3r22: raises $0.72 to $1.22
MoonJimmy: folds 
mycka86: raises $3.28 to $4.50
payback11: folds 
Al3xAnd3r22: raises $6 to $10.50
mycka86: calls $6
*** FLOP *** [Ks Qd 7h]
mycka86: checks 
Al3xAnd3r22: bets $7.42
mycka86: calls $7.42
*** TURN *** [Ks Qd 7h] [5s]
mycka86: checks 
Al3xAnd3r22: checks 
*** RIVER *** [Ks Qd 7h 5s] [Qs]
mycka86: bets $31.98 and is all-in
Al3xAnd3r22: calls $31.98
*** SHOW DOWN ***
mycka86: shows [Ac Ad] (two pair, Aces and Queens)
Al3xAnd3r22: shows [Kd Kh] (a full house, Kings full of Queens)
Al3xAnd3r22 collected $98.50 from pot
*** SUMMARY ***
Total pot $101 | Rake $2.50 
Board [Ks Qd 7h 5s Qs]
Seat 1: MoonJimmy (button) folded before Flop (didn't bet)
Seat 2: mycka86 (small blind) showed [Ac Ad] and lost with two pair, Aces and Queens
Seat 4: payback11 (big blind) folded before Flop
Seat 5: Effort92 folded before Flop (didn't bet)
Seat 7: matiko09 folded before Flop (didn't bet)
Seat 8: jamba83 folded before Flop (didn't bet)
Seat 9: Al3xAnd3r22 showed [Kd Kh] and won ($98.50) with a full house, Kings full of Queens





PokerStars Hand #149394540182:  Hold'em No Limit ($0.50/$1.00 USD) - 2016/02/25 17:34:52 CET [2016/02/25 11:34:52 ET]
Table 'Isa' 9-max Seat #2 is the button
Seat 1: matiko09 ($124.58 in chips) 
Seat 2: mycka86 ($155.92 in chips) 
Seat 3: sebaaastian ($136.25 in chips) 
Seat 4: hammerwife ($121.41 in chips) 
Seat 7: bilukm ($100 in chips) 
Seat 8: Venomous100% ($108.24 in chips) 
Seat 9: HomerrrJay ($153.61 in chips) 
sebaaastian: posts small blind $0.50
hammerwife: posts big blind $1
xAndorx: sits out 
*** HOLE CARDS ***
Dealt to matiko09 [Ts 4d]
bilukm: calls $1
Venomous100%: folds 
HomerrrJay: calls $1
matiko09: folds 
mycka86: raises $4.50 to $5.50
sebaaastian: folds 
hammerwife: folds 
bilukm: calls $4.50
HomerrrJay: folds 
*** FLOP *** [Jh 5c 9c]
bilukm: checks 
mycka86: bets $9.40
bilukm: folds 
Uncalled bet ($9.40) returned to mycka86
mycka86 collected $12.89 from pot
*** SUMMARY ***
Total pot $13.50 | Rake $0.61 
Board [Jh 5c 9c]
Seat 1: matiko09 folded before Flop (didn't bet)
Seat 2: mycka86 (button) collected ($12.89)
Seat 3: sebaaastian (small blind) folded before Flop
Seat 4: hammerwife (big blind) folded before Flop
Seat 7: bilukm folded on the Flop
Seat 8: Venomous100% folded before Flop (didn't bet)
Seat 9: HomerrrJay folded before Flop





PokerStars Hand #149394542481:  Hold'em No Limit ($0.50/$1.00 USD) - 2016/02/25 17:34:54 CET [2016/02/25 11:34:54 ET]
Table 'Zerbinetta II' 9-max Seat #5 is the button
Seat 1: $-Twackle-$ ($100 in chips) 
Seat 2: lysandrafly ($102.28 in chips) 
Seat 3: matiko09 ($103.75 in chips) 
Seat 4: sebaaastian ($100 in chips) 
Seat 5: hammerwife ($122.27 in chips) 
Seat 7: HomerrrJay ($100 in chips) 
Seat 8: gabi_igna ($131.70 in chips) 
Seat 9: with-w ($18.49 in chips) 
simoniustin will be allowed to play after the button
HomerrrJay: posts small blind $0.50
gabi_igna: posts big blind $1
*** HOLE CARDS ***
Dealt to matiko09 [Kd Jc]
with-w: raises $2 to $3
$-Twackle-$: folds 
lysandrafly: folds 
matiko09: folds 
sebaaastian: folds 
hammerwife: folds 
HomerrrJay: folds 
gabi_igna: folds 
Uncalled bet ($2) returned to with-w
with-w collected $2.50 from pot
with-w: doesn't show hand 
*** SUMMARY ***
Total pot $2.50 | Rake $0 
Seat 1: $-Twackle-$ folded before Flop (didn't bet)
Seat 2: lysandrafly folded before Flop (didn't bet)
Seat 3: matiko09 folded before Flop (didn't bet)
Seat 4: sebaaastian folded before Flop (didn't bet)
Seat 5: hammerwife (button) folded before Flop (didn't bet)
Seat 7: HomerrrJay (small blind) folded before Flop
Seat 8: gabi_igna (big blind) folded before Flop
Seat 9: with-w collected ($2.50)





PokerStars Hand #149394546479:  Hold'em No Limit ($0.50/$1.00 USD) - 2016/02/25 17:34:59 CET [2016/02/25 11:34:59 ET]
Table 'Badenia II' 9-max Seat #9 is the button
Seat 1: matiko09 ($100 in chips) 
Seat 2: Venomous100% ($100 in chips) 
Seat 3: sebaaastian ($145 in chips) 
Seat 4: hammerwife ($103.75 in chips) 
Seat 6: xAndorx ($119.80 in chips) 
Seat 9: waisanen ($240.67 in chips) 
matiko09: posts small blind $0.50
Venomous100%: posts big blind $1
Ilov3NBA: sits out 
*** HOLE CARDS ***
Dealt to matiko09 [9s 4d]
sebaaastian: folds 
hammerwife: folds 
xAndorx: folds 
waisanen: folds 
matiko09: folds 
Uncalled bet ($0.50) returned to Venomous100%
Venomous100% collected $1 from pot
Venomous100%: doesn't show hand 
*** SUMMARY ***
Total pot $1 | Rake $0 
Seat 1: matiko09 (small blind) folded before Flop
Seat 2: Venomous100% (big blind) collected ($1)
Seat 3: sebaaastian folded before Flop (didn't bet)
Seat 4: hammerwife folded before Flop (didn't bet)
Seat 6: xAndorx folded before Flop (didn't bet)
Seat 9: waisanen (button) folded before Flop (didn't bet)





PokerStars Hand #149394546085:  Hold'em No Limit ($0.50/$1.00 USD) - 2016/02/25 17:34:59 CET [2016/02/25 11:34:59 ET]
Table 'Sabine' 9-max Seat #2 is the button
Seat 1: Aalleekks ($100 in chips) 
Seat 2: apfush ($132.43 in chips) 
Seat 3: Ouga Buga ($103.88 in chips) 
Seat 4: simoniustin ($101.50 in chips) 
Seat 5: Venomous100% ($107.04 in chips) 
Seat 6: ffac ($102.18 in chips) 
Seat 8: matiko09 ($186.66 in chips) 
Seat 9: djammusic ($40 in chips) 
Ouga Buga: posts small blind $0.50
simoniustin: posts big blind $1
*** HOLE CARDS ***
Dealt to matiko09 [As 7d]
Venomous100%: folds 
ffac: folds 
matiko09: folds 
djammusic: folds 
Aalleekks: folds 
apfush: raises $1.20 to $2.20
Ouga Buga: folds 
simoniustin: calls $1.20
*** FLOP *** [5h Td 2h]
simoniustin: checks 
apfush: checks 
*** TURN *** [5h Td 2h] [3c]
simoniustin: bets $4
apfush: calls $4
*** RIVER *** [5h Td 2h 3c] [6c]
simoniustin: checks 
apfush: checks 
*** SHOW DOWN ***
simoniustin: shows [Ks Ts] (a pair of Tens)
apfush: mucks hand 
simoniustin collected $12.32 from pot
*** SUMMARY ***
Total pot $12.90 | Rake $0.58 
Board [5h Td 2h 3c 6c]
Seat 1: Aalleekks folded before Flop (didn't bet)
Seat 2: apfush (button) mucked [Kd Ah]
Seat 3: Ouga Buga (small blind) folded before Flop
Seat 4: simoniustin (big blind) showed [Ks Ts] and won ($12.32) with a pair of Tens
Seat 5: Venomous100% folded before Flop (didn't bet)
Seat 6: ffac folded before Flop (didn't bet)
Seat 8: matiko09 folded before Flop (didn't bet)
Seat 9: djammusic folded before Flop (didn't bet)





PokerStars Hand #149394554606:  Hold'em No Limit ($0.50/$1.00 USD) - 2016/02/25 17:35:09 CET [2016/02/25 11:35:09 ET]
Table 'Ebella II' 9-max Seat #5 is the button
Seat 3: fanmtZ ($42.32 in chips) 
Seat 4: xAndorx ($100 in chips) 
Seat 5: matiko09 ($107.34 in chips) 
Seat 6: gabi_igna ($102.21 in chips) 
Seat 7: $-Twackle-$ ($100 in chips) 
Seat 8: ZMPOUTSAM140 ($96.05 in chips) 
Seat 9: simoniustin ($110.63 in chips) 
gabi_igna: posts small blind $0.50
$-Twackle-$: posts big blind $1
*** HOLE CARDS ***
Dealt to matiko09 [8h Jc]
ZMPOUTSAM140: folds 
simoniustin: raises $2 to $3
fanmtZ: folds 
hammerwife leaves the table
xAndorx: folds 
matiko09: folds 
gabi_igna: folds 
$-Twackle-$: calls $2
*** FLOP *** [4c Th 4d]
$-Twackle-$: checks 
simoniustin: bets $4
$-Twackle-$: folds 
Uncalled bet ($4) returned to simoniustin
simoniustin collected $6.21 from pot
simoniustin: doesn't show hand 
*** SUMMARY ***
Total pot $6.50 | Rake $0.29 
Board [4c Th 4d]
Seat 3: fanmtZ folded before Flop (didn't bet)
Seat 4: xAndorx folded before Flop (didn't bet)
Seat 5: matiko09 (button) folded before Flop (didn't bet)
Seat 6: gabi_igna (small blind) folded before Flop
Seat 7: $-Twackle-$ (big blind) folded on the Flop
Seat 8: ZMPOUTSAM140 folded before Flop (didn't bet)
Seat 9: simoniustin collected ($6.21)





PokerStars Hand #149394561509:  Hold'em No Limit ($0.50/$1.00 USD) - 2016/02/25 17:35:18 CET [2016/02/25 11:35:18 ET]
Table 'Badenia II' 9-max Seat #1 is the button
Seat 1: matiko09 ($100 in chips) 
Seat 2: Venomous100% ($100.50 in chips) 
Seat 3: sebaaastian ($145 in chips) 
Seat 4: hammerwife ($103.75 in chips) 
Seat 6: xAndorx ($119.80 in chips) 
Seat 9: waisanen ($240.67 in chips) 
Venomous100%: posts small blind $0.50
sebaaastian: posts big blind $1
Ilov3NBA: sits out 
*** HOLE CARDS ***
Dealt to matiko09 [6d 5s]
hammerwife: folds 
xAndorx: folds 
waisanen: folds 
matiko09: folds 
Venomous100%: folds 
Uncalled bet ($0.50) returned to sebaaastian
sebaaastian collected $1 from pot
sebaaastian: doesn't show hand 
*** SUMMARY ***
Total pot $1 | Rake $0 
Seat 1: matiko09 (button) folded before Flop (didn't bet)
Seat 2: Venomous100% (small blind) folded before Flop
Seat 3: sebaaastian (big blind) collected ($1)
Seat 4: hammerwife folded before Flop (didn't bet)
Seat 6: xAndorx folded before Flop (didn't bet)
Seat 9: waisanen folded before Flop (didn't bet)





PokerStars Hand #149394564024:  Hold'em No Limit ($0.50/$1.00 USD) - 2016/02/25 17:35:21 CET [2016/02/25 11:35:21 ET]
Table 'Nerthus II' 9-max Seat #7 is the button
Seat 1: DUkalisUA ($108.11 in chips) 
Seat 2: matiko09 ($218.68 in chips) 
Seat 3: simoniustin ($101.50 in chips) 
Seat 4: Ilov3NBA ($105.62 in chips) 
Seat 6: mycka86 ($142.88 in chips) 
Seat 7: Venomous100% ($108.65 in chips) 
Seat 8: Kelvin sai ($41.38 in chips) 
Seat 9: hammerwife ($102 in chips) 
Kelvin sai: posts small blind $0.50
hammerwife: posts big blind $1
*** HOLE CARDS ***
Dealt to matiko09 [Kd 2h]
DUkalisUA: folds 
matiko09: folds 
DUkalisUA leaves the table
simoniustin: raises $2 to $3
Ilov3NBA: folds 
Effort92 joins the table at seat #1 
Effort92 leaves the table
mycka86: folds 
Venomous100%: folds 
Kelvin sai: folds 
hammerwife: calls $2
*** FLOP *** [8c 2s 5s]
hammerwife: checks 
simoniustin: bets $4
hammerwife: folds 
Uncalled bet ($4) returned to simoniustin
simoniustin collected $6.21 from pot
simoniustin: doesn't show hand 
*** SUMMARY ***
Total pot $6.50 | Rake $0.29 
Board [8c 2s 5s]
Seat 1: DUkalisUA folded before Flop (didn't bet)
Seat 2: matiko09 folded before Flop (didn't bet)
Seat 3: simoniustin collected ($6.21)
Seat 4: Ilov3NBA folded before Flop (didn't bet)
Seat 6: mycka86 folded before Flop (didn't bet)
Seat 7: Venomous100% (button) folded before Flop (didn't bet)
Seat 8: Kelvin sai (small blind) folded before Flop
Seat 9: hammerwife (big blind) folded on the Flop





PokerStars Hand #149394564623:  Hold'em No Limit ($0.50/$1.00 USD) - 2016/02/25 17:35:22 CET [2016/02/25 11:35:22 ET]
Table 'Mayall II' 9-max Seat #3 is the button
Seat 1: matiko09 ($109.41 in chips) 
Seat 3: simoniustin ($109.64 in chips) 
Seat 4: Ouga Buga ($105.17 in chips) 
Seat 6: apfush ($113.67 in chips) 
Seat 7: r.pol218 ($38.48 in chips) 
Seat 8: kuanhung0903 ($89.96 in chips) 
Ouga Buga: posts small blind $0.50
apfush: posts big blind $1
xAndorx: sits out 
*** HOLE CARDS ***
Dealt to matiko09 [3s 5h]
r.pol218: folds 
kuanhung0903: folds 
matiko09: folds 
simoniustin: raises $1.50 to $2.50
Ouga Buga: folds 
apfush: calls $1.50
*** FLOP *** [2s Ts Js]
apfush: checks 
simoniustin: bets $3
apfush: calls $3
*** TURN *** [2s Ts Js] [Tc]
apfush: checks 
Dachish joins the table at seat #5 
simoniustin: bets $6
Dachish leaves the table
apfush: calls $6
*** RIVER *** [2s Ts Js Tc] [Kd]
apfush: checks 
McFussball81 joins the table at seat #5 
simoniustin: bets $16
apfush: calls $16
*** SHOW DOWN ***
simoniustin: shows [Jd Th] (a full house, Tens full of Jacks)
apfush: mucks hand 
simoniustin collected $53 from pot
*** SUMMARY ***
Total pot $55.50 | Rake $2.50 
Board [2s Ts Js Tc Kd]
Seat 1: matiko09 folded before Flop (didn't bet)
Seat 3: simoniustin (button) showed [Jd Th] and won ($53) with a full house, Tens full of Jacks
Seat 4: Ouga Buga (small blind) folded before Flop
Seat 6: apfush (big blind) mucked [Td As]
Seat 7: r.pol218 folded before Flop (didn't bet)
Seat 8: kuanhung0903 folded before Flop (didn't bet)





PokerStars Hand #149394567361:  Hold'em No Limit ($0.50/$1.00 USD) - 2016/02/25 17:35:25 CET [2016/02/25 11:35:25 ET]
Table 'Zeuxo II' 9-max Seat #8 is the button
Seat 1: forsmthgood ($105.04 in chips) 
Seat 4: sebaaastian ($100 in chips) 
Seat 5: hammerwife ($100 in chips) 
Seat 6: Cogss ($102.21 in chips) 
Seat 8: matiko09 ($126.41 in chips) 
Seat 9: Sreshta222 ($306.63 in chips) 
Sreshta222: posts small blind $0.50
forsmthgood: posts big blind $1
xAndorx: sits out 
Venomous100%: sits out 
*** HOLE CARDS ***
Dealt to matiko09 [9h 8s]
sebaaastian: folds 
hammerwife: folds 
Cogss: folds 
matiko09: folds 
Sreshta222: folds 
Uncalled bet ($0.50) returned to forsmthgood
forsmthgood collected $1 from pot
forsmthgood: doesn't show hand 
*** SUMMARY ***
Total pot $1 | Rake $0 
Seat 1: forsmthgood (big blind) collected ($1)
Seat 4: sebaaastian folded before Flop (didn't bet)
Seat 5: hammerwife folded before Flop (didn't bet)
Seat 6: Cogss folded before Flop (didn't bet)
Seat 8: matiko09 (button) folded before Flop (didn't bet)
Seat 9: Sreshta222 (small blind) folded before Flop





PokerStars Hand #149394570326:  Hold'em No Limit ($0.50/$1.00 USD) - 2016/02/25 17:35:29 CET [2016/02/25 11:35:29 ET]
Table 'Eurysaces II' 9-max Seat #4 is the button
Seat 1: lysandrafly ($100 in chips) 
Seat 2: sebaaastian ($102.28 in chips) 
Seat 4: gabi_igna ($100 in chips) 
Seat 5: keessie93 ($134.12 in chips) 
Seat 6: J0rmungund ($48.37 in chips) 
Seat 7: $-Twackle-$ ($101.50 in chips) 
Seat 9: matiko09 ($100 in chips) 
keessie93: posts small blind $0.50
J0rmungund: posts big blind $1
hammerwife: sits out 
Aalleekks: sits out 
*** HOLE CARDS ***
Dealt to matiko09 [5c 9d]
$-Twackle-$: folds 
matiko09: folds 
lysandrafly: folds 
sebaaastian: folds 
gabi_igna: raises $1.50 to $2.50
keessie93: folds 
J0rmungund: calls $1.50
*** FLOP *** [5s 2h Th]
J0rmungund: checks 
gabi_igna: bets $3
J0rmungund: folds 
Uncalled bet ($3) returned to gabi_igna
gabi_igna collected $5.25 from pot
gabi_igna: doesn't show hand 
*** SUMMARY ***
Total pot $5.50 | Rake $0.25 
Board [5s 2h Th]
Seat 1: lysandrafly folded before Flop (didn't bet)
Seat 2: sebaaastian folded before Flop (didn't bet)
Seat 4: gabi_igna (button) collected ($5.25)
Seat 5: keessie93 (small blind) folded before Flop
Seat 6: J0rmungund (big blind) folded on the Flop
Seat 7: $-Twackle-$ folded before Flop (didn't bet)
Seat 9: matiko09 folded before Flop (didn't bet)





PokerStars Hand #149394577708:  Hold'em No Limit ($0.50/$1.00 USD) - 2016/02/25 17:35:38 CET [2016/02/25 11:35:38 ET]
Table 'Zerbinetta II' 9-max Seat #7 is the button
Seat 1: $-Twackle-$ ($100 in chips) 
Seat 2: lysandrafly ($102.28 in chips) 
Seat 3: matiko09 ($103.75 in chips) 
Seat 4: sebaaastian ($100 in chips) 
Seat 5: hammerwife ($122.27 in chips) 
Seat 7: HomerrrJay ($100 in chips) 
Seat 8: gabi_igna ($130.70 in chips) 
Seat 9: with-w ($19.99 in chips) 
gabi_igna: posts small blind $0.50
with-w: posts big blind $1
simoniustin: sits out 
*** HOLE CARDS ***
Dealt to matiko09 [3c 2c]
$-Twackle-$: folds 
lysandrafly: folds 
matiko09: folds 
sebaaastian: folds 
hammerwife: folds 
HomerrrJay: raises $1.50 to $2.50
gabi_igna: folds 
with-w: folds 
Uncalled bet ($1.50) returned to HomerrrJay
HomerrrJay collected $2.50 from pot
HomerrrJay: doesn't show hand 
*** SUMMARY ***
Total pot $2.50 | Rake $0 
Seat 1: $-Twackle-$ folded before Flop (didn't bet)
Seat 2: lysandrafly folded before Flop (didn't bet)
Seat 3: matiko09 folded before Flop (didn't bet)
Seat 4: sebaaastian folded before Flop (didn't bet)
Seat 5: hammerwife folded before Flop (didn't bet)
Seat 7: HomerrrJay (button) collected ($2.50)
Seat 8: gabi_igna (small blind) folded before Flop
Seat 9: with-w (big blind) folded before Flop





PokerStars Hand #149394580829:  Hold'em No Limit ($0.50/$1.00 USD) - 2016/02/25 17:35:42 CET [2016/02/25 11:35:42 ET]
Table 'Isa' 9-max Seat #3 is the button
Seat 1: matiko09 ($124.58 in chips) 
Seat 2: mycka86 ($163.31 in chips) 
Seat 3: sebaaastian ($135.75 in chips) 
Seat 4: hammerwife ($120.41 in chips) 
Seat 6: xAndorx ($100 in chips) 
Seat 7: bilukm ($98.18 in chips) 
Seat 8: Venomous100% ($108.24 in chips) 
Seat 9: HomerrrJay ($152.61 in chips) 
hammerwife: posts small blind $0.50
xAndorx: posts big blind $1
*** HOLE CARDS ***
Dealt to matiko09 [3h Td]
bilukm: folds 
Venomous100%: folds 
HomerrrJay: folds 
matiko09: folds 
mycka86: folds 
sebaaastian: raises $1.50 to $2.50
hammerwife: folds 
xAndorx: folds 
Uncalled bet ($1.50) returned to sebaaastian
sebaaastian collected $2.50 from pot
sebaaastian: doesn't show hand 
*** SUMMARY ***
Total pot $2.50 | Rake $0 
Seat 1: matiko09 folded before Flop (didn't bet)
Seat 2: mycka86 folded before Flop (didn't bet)
Seat 3: sebaaastian (button) collected ($2.50)
Seat 4: hammerwife (small blind) folded before Flop
Seat 6: xAndorx (big blind) folded before Flop
Seat 7: bilukm folded before Flop (didn't bet)
Seat 8: Venomous100% folded before Flop (didn't bet)
Seat 9: HomerrrJay folded before Flop (didn't bet)





PokerStars Hand #149394581657:  Hold'em No Limit ($0.50/$1.00 USD) - 2016/02/25 17:35:43 CET [2016/02/25 11:35:43 ET]
Table 'Badenia II' 9-max Seat #2 is the button
Seat 1: matiko09 ($100 in chips) 
Seat 2: Venomous100% ($100 in chips) 
Seat 3: sebaaastian ($145.50 in chips) 
Seat 4: hammerwife ($103.75 in chips) 
Seat 6: xAndorx ($119.80 in chips) 
Seat 9: waisanen ($240.67 in chips) 
sebaaastian: posts small blind $0.50
hammerwife: posts big blind $1
Ilov3NBA: sits out 
*** HOLE CARDS ***
Dealt to matiko09 [4d Ac]
xAndorx: folds 
xAndorx leaves the table
Dachish joins the table at seat #6 
waisanen: folds 
matiko09: folds 
Venomous100%: raises $1 to $2
sebaaastian: folds 
HomerrrJay joins the table at seat #7 
hammerwife: calls $1
*** FLOP *** [7d 2c Jd]
hammerwife: checks 
Venomous100%: bets $2.84
hammerwife: calls $2.84
*** TURN *** [7d 2c Jd] [9d]
hammerwife: checks 
Venomous100%: checks 
*** RIVER *** [7d 2c Jd 9d] [9c]
hammerwife: checks 
Venomous100%: checks 
*** SHOW DOWN ***
hammerwife: shows [Qc Jh] (two pair, Jacks and Nines)
Venomous100%: mucks hand 
hammerwife collected $9.72 from pot
*** SUMMARY ***
Total pot $10.18 | Rake $0.46 
Board [7d 2c Jd 9d 9c]
Seat 1: matiko09 folded before Flop (didn't bet)
Seat 2: Venomous100% (button) mucked [3d 3c]
Seat 3: sebaaastian (small blind) folded before Flop
Seat 4: hammerwife (big blind) showed [Qc Jh] and won ($9.72) with two pair, Jacks and Nines
Seat 6: xAndorx folded before Flop (didn't bet)
Seat 9: waisanen folded before Flop (didn't bet)





PokerStars Hand #149394589960:  Hold'em No Limit ($0.50/$1.00 USD) - 2016/02/25 17:35:53 CET [2016/02/25 11:35:53 ET]
Table 'Zeuxo II' 9-max Seat #9 is the button
Seat 1: forsmthgood ($105.54 in chips) 
Seat 3: xAndorx ($133.20 in chips) 
Seat 4: sebaaastian ($100 in chips) 
Seat 5: hammerwife ($100 in chips) 
Seat 6: Cogss ($102.21 in chips) 
Seat 8: matiko09 ($126.41 in chips) 
Seat 9: Sreshta222 ($306.13 in chips) 
forsmthgood: posts small blind $0.50
xAndorx: posts big blind $1
Venomous100%: sits out 
*** HOLE CARDS ***
Dealt to matiko09 [4c Kh]
sebaaastian: folds 
hammerwife: folds 
Cogss: raises $1 to $2
matiko09: folds 
Sreshta222: folds 
forsmthgood: folds 
xAndorx: calls $1
*** FLOP *** [5h As Ac]
xAndorx: checks 
Cogss: checks 
*** TURN *** [5h As Ac] [6c]
xAndorx: checks 
Cogss: bets $4.30
xAndorx: folds 
Uncalled bet ($4.30) returned to Cogss
Cogss collected $4.30 from pot
*** SUMMARY ***
Total pot $4.50 | Rake $0.20 
Board [5h As Ac 6c]
Seat 1: forsmthgood (small blind) folded before Flop
Seat 3: xAndorx (big blind) folded on the Turn
Seat 4: sebaaastian folded before Flop (didn't bet)
Seat 5: hammerwife folded before Flop (didn't bet)
Seat 6: Cogss collected ($4.30)
Seat 8: matiko09 folded before Flop (didn't bet)
Seat 9: Sreshta222 (button) folded before Flop (didn't bet)





PokerStars Hand #149394594638:  Hold'em No Limit ($0.50/$1.00 USD) - 2016/02/25 17:35:59 CET [2016/02/25 11:35:59 ET]
Table 'Sabine' 9-max Seat #3 is the button
Seat 1: Aalleekks ($100 in chips) 
Seat 2: apfush ($126.23 in chips) 
Seat 3: Ouga Buga ($103.38 in chips) 
Seat 4: simoniustin ($107.62 in chips) 
Seat 5: Venomous100% ($107.04 in chips) 
Seat 6: ffac ($102.18 in chips) 
Seat 8: matiko09 ($186.66 in chips) 
Seat 9: djammusic ($40 in chips) 
simoniustin: posts small blind $0.50
Venomous100%: posts big blind $1
*** HOLE CARDS ***
Dealt to matiko09 [5c As]
ffac: folds 
matiko09: folds 
djammusic: folds 
Aalleekks: folds 
apfush: folds 
Ouga Buga: folds 
simoniustin: raises $1.02 to $2.02
Venomous100%: folds 
Uncalled bet ($1.02) returned to simoniustin
simoniustin collected $2 from pot
simoniustin: doesn't show hand 
*** SUMMARY ***
Total pot $2 | Rake $0 
Seat 1: Aalleekks folded before Flop (didn't bet)
Seat 2: apfush folded before Flop (didn't bet)
Seat 3: Ouga Buga (button) folded before Flop (didn't bet)
Seat 4: simoniustin (small blind) collected ($2)
Seat 5: Venomous100% (big blind) folded before Flop
Seat 6: ffac folded before Flop (didn't bet)
Seat 8: matiko09 folded before Flop (didn't bet)
Seat 9: djammusic folded before Flop (didn't bet)





PokerStars Hand #149394606807:  Hold'em No Limit ($0.50/$1.00 USD) - 2016/02/25 17:36:14 CET [2016/02/25 11:36:14 ET]
Table 'Isa' 9-max Seat #4 is the button
Seat 1: matiko09 ($124.58 in chips) 
Seat 2: mycka86 ($163.31 in chips) 
Seat 3: sebaaastian ($137.25 in chips) 
Seat 4: hammerwife ($119.91 in chips) 
Seat 6: xAndorx ($100 in chips) 
Seat 7: bilukm ($98.18 in chips) 
Seat 8: Venomous100% ($108.24 in chips) 
Seat 9: HomerrrJay ($152.61 in chips) 
xAndorx: posts small blind $0.50
bilukm: posts big blind $1
*** HOLE CARDS ***
Dealt to matiko09 [Js 5c]
Venomous100%: folds 
HomerrrJay: folds 
matiko09: folds 
mycka86: raises $1.50 to $2.50
sebaaastian: folds 
hammerwife: folds 
xAndorx: calls $2
bilukm: calls $1.50
*** FLOP *** [Jh Th Ks]
xAndorx: checks 
bilukm: checks 
mycka86: checks 
*** TURN *** [Jh Th Ks] [9d]
xAndorx: bets $4
bilukm: raises $4 to $8
mycka86: folds 
xAndorx: calls $4
*** RIVER *** [Jh Th Ks 9d] [Ts]
xAndorx: checks 
bilukm: checks 
*** SHOW DOWN ***
xAndorx: shows [Qs Qc] (a straight, Nine to King)
bilukm: shows [Qd 3d] (a straight, Nine to King)
xAndorx collected $11.22 from pot
bilukm collected $11.22 from pot
*** SUMMARY ***
Total pot $23.50 | Rake $1.06 
Board [Jh Th Ks 9d Ts]
Seat 1: matiko09 folded before Flop (didn't bet)
Seat 2: mycka86 folded on the Turn
Seat 3: sebaaastian folded before Flop (didn't bet)
Seat 4: hammerwife (button) folded before Flop (didn't bet)
Seat 6: xAndorx (small blind) showed [Qs Qc] and won ($11.22) with a straight, Nine to King
Seat 7: bilukm (big blind) showed [Qd 3d] and won ($11.22) with a straight, Nine to King
Seat 8: Venomous100% folded before Flop (didn't bet)
Seat 9: HomerrrJay folded before Flop (didn't bet)





PokerStars Hand #149394607620:  Hold'em No Limit ($0.50/$1.00 USD) - 2016/02/25 17:36:15 CET [2016/02/25 11:36:15 ET]
Table 'Nerthus II' 9-max Seat #8 is the button
Seat 2: matiko09 ($218.68 in chips) 
Seat 3: simoniustin ($104.71 in chips) 
Seat 4: Ilov3NBA ($105.62 in chips) 
Seat 6: mycka86 ($142.88 in chips) 
Seat 7: Venomous100% ($108.65 in chips) 
Seat 8: Kelvin sai ($40.88 in chips) 
Seat 9: hammerwife ($100 in chips) 
hammerwife: posts small blind $0.50
matiko09: posts big blind $1
*** HOLE CARDS ***
Dealt to matiko09 [9s 6s]
simoniustin: raises $2 to $3
Ilov3NBA: folds 
mycka86: folds 
Venomous100%: folds 
Kelvin sai: calls $3
hammerwife: folds 
matiko09: folds 
*** FLOP *** [3h 8s 6h]
simoniustin: checks 
Kelvin sai: checks 
*** TURN *** [3h 8s 6h] [7c]
simoniustin: checks 
Kelvin sai: checks 
*** RIVER *** [3h 8s 6h 7c] [Kc]
simoniustin: checks 
Kelvin sai: checks 
*** SHOW DOWN ***
simoniustin: shows [Qh Ac] (high card Ace)
Kelvin sai: mucks hand 
simoniustin collected $7.16 from pot
*** SUMMARY ***
Total pot $7.50 | Rake $0.34 
Board [3h 8s 6h 7c Kc]
Seat 2: matiko09 (big blind) folded before Flop
Seat 3: simoniustin showed [Qh Ac] and won ($7.16) with high card Ace
Seat 4: Ilov3NBA folded before Flop (didn't bet)
Seat 6: mycka86 folded before Flop (didn't bet)
Seat 7: Venomous100% folded before Flop (didn't bet)
Seat 8: Kelvin sai (button) mucked [Jh Qs]
Seat 9: hammerwife (small blind) folded before Flop





PokerStars Hand #149394615875:  Hold'em No Limit ($0.50/$1.00 USD) - 2016/02/25 17:36:25 CET [2016/02/25 11:36:25 ET]
Table 'Zerbinetta II' 9-max Seat #8 is the button
Seat 1: $-Twackle-$ ($100 in chips) 
Seat 2: lysandrafly ($102.28 in chips) 
Seat 3: matiko09 ($103.75 in chips) 
Seat 4: sebaaastian ($100 in chips) 
Seat 5: hammerwife ($122.27 in chips) 
Seat 7: HomerrrJay ($101.50 in chips) 
Seat 8: gabi_igna ($130.20 in chips) 
Seat 9: with-w ($18.99 in chips) 
with-w: posts small blind $0.50
$-Twackle-$: posts big blind $1
simoniustin: sits out 
*** HOLE CARDS ***
Dealt to matiko09 [7c Qs]
lysandrafly: folds 
lysandrafly leaves the table
ffac joins the table at seat #2 
matiko09: folds 
sebaaastian: folds 
hammerwife: raises $1.50 to $2.50
HomerrrJay: folds 
gabi_igna: folds 
with-w: calls $2
$-Twackle-$: folds 
*** FLOP *** [6s 8h 8c]
with-w: bets $2.86
hammerwife: folds 
Uncalled bet ($2.86) returned to with-w
with-w collected $5.73 from pot
with-w: doesn't show hand 
*** SUMMARY ***
Total pot $6 | Rake $0.27 
Board [6s 8h 8c]
Seat 1: $-Twackle-$ (big blind) folded before Flop
Seat 2: lysandrafly folded before Flop (didn't bet)
Seat 3: matiko09 folded before Flop (didn't bet)
Seat 4: sebaaastian folded before Flop (didn't bet)
Seat 5: hammerwife folded on the Flop
Seat 7: HomerrrJay folded before Flop (didn't bet)
Seat 8: gabi_igna (button) folded before Flop (didn't bet)
Seat 9: with-w (small blind) collected ($5.73)





PokerStars Hand #149394619316:  Hold'em No Limit ($0.50/$1.00 USD) - 2016/02/25 17:36:29 CET [2016/02/25 11:36:29 ET]
Table 'Ebella II' 9-max Seat #6 is the button
Seat 3: fanmtZ ($42.32 in chips) 
Seat 4: xAndorx ($100 in chips) 
Seat 5: matiko09 ($107.34 in chips) 
Seat 6: gabi_igna ($101.71 in chips) 
Seat 7: $-Twackle-$ ($100 in chips) 
Seat 8: ZMPOUTSAM140 ($96.05 in chips) 
Seat 9: simoniustin ($113.84 in chips) 
$-Twackle-$: posts small blind $0.50
ZMPOUTSAM140: posts big blind $1
*** HOLE CARDS ***
Dealt to matiko09 [Th 4d]
simoniustin: raises $2 to $3
fanmtZ: folds 
xAndorx: calls $3
matiko09: folds 
gabi_igna: calls $3
$-Twackle-$: folds 
ZMPOUTSAM140: folds 
*** FLOP *** [2h Kc 3d]
simoniustin: bets $6
xAndorx: calls $6
gabi_igna: folds 
*** TURN *** [2h Kc 3d] [7d]
simoniustin: checks 
Dachish joins the table at seat #1 
xAndorx: bets $14.50
simoniustin: folds 
Uncalled bet ($14.50) returned to xAndorx
xAndorx collected $21.49 from pot
xAndorx: doesn't show hand 
*** SUMMARY ***
Total pot $22.50 | Rake $1.01 
Board [2h Kc 3d 7d]
Seat 3: fanmtZ folded before Flop (didn't bet)
Seat 4: xAndorx collected ($21.49)
Seat 5: matiko09 folded before Flop (didn't bet)
Seat 6: gabi_igna (button) folded on the Flop
Seat 7: $-Twackle-$ (small blind) folded before Flop
Seat 8: ZMPOUTSAM140 (big blind) folded before Flop
Seat 9: simoniustin folded on the Turn





PokerStars Hand #149394621797:  Hold'em No Limit ($0.50/$1.00 USD) - 2016/02/25 17:36:32 CET [2016/02/25 11:36:32 ET]
Table 'Sabine' 9-max Seat #4 is the button
Seat 1: Aalleekks ($100 in chips) 
Seat 2: apfush ($126.23 in chips) 
Seat 3: Ouga Buga ($103.38 in chips) 
Seat 4: simoniustin ($108.62 in chips) 
Seat 5: Venomous100% ($106.04 in chips) 
Seat 8: matiko09 ($186.66 in chips) 
Seat 9: djammusic ($40 in chips) 
Venomous100%: posts small blind $0.50
ffac: is sitting out 
matiko09: posts big blind $1
*** HOLE CARDS ***
Dealt to matiko09 [Ad 9c]
djammusic: folds 
Aalleekks: folds 
djammusic leaves the table
apfush: folds 
Ouga Buga: raises $1.50 to $2.50
simoniustin: folds 
Dachish joins the table at seat #9 
Venomous100%: folds 
matiko09: folds 
Uncalled bet ($1.50) returned to Ouga Buga
Ouga Buga collected $2.50 from pot
Ouga Buga: doesn't show hand 
*** SUMMARY ***
Total pot $2.50 | Rake $0 
Seat 1: Aalleekks folded before Flop (didn't bet)
Seat 2: apfush folded before Flop (didn't bet)
Seat 3: Ouga Buga collected ($2.50)
Seat 4: simoniustin (button) folded before Flop (didn't bet)
Seat 5: Venomous100% (small blind) folded before Flop
Seat 8: matiko09 (big blind) folded before Flop
Seat 9: djammusic folded before Flop (didn't bet)





PokerStars Hand #149394625369:  Hold'em No Limit ($0.50/$1.00 USD) - 2016/02/25 17:36:37 CET [2016/02/25 11:36:37 ET]
Table 'Eurysaces II' 9-max Seat #5 is the button
Seat 1: lysandrafly ($100 in chips) 
Seat 2: sebaaastian ($102.28 in chips) 
Seat 4: gabi_igna ($102.75 in chips) 
Seat 5: keessie93 ($133.62 in chips) 
Seat 6: J0rmungund ($45.87 in chips) 
Seat 7: $-Twackle-$ ($101.50 in chips) 
Seat 9: matiko09 ($100 in chips) 
J0rmungund: posts small blind $0.50
$-Twackle-$: posts big blind $1
hammerwife: sits out 
Aalleekks: sits out 
*** HOLE CARDS ***
Dealt to matiko09 [Qs 2c]
matiko09: folds 
lysandrafly: folds 
sebaaastian: folds 
gabi_igna: raises $1.50 to $2.50
keessie93: calls $2.50
J0rmungund: raises $7.50 to $10
$-Twackle-$: folds 
gabi_igna: folds 
keessie93: folds 
Uncalled bet ($7.50) returned to J0rmungund
J0rmungund collected $8.50 from pot
*** SUMMARY ***
Total pot $8.50 | Rake $0 
Seat 1: lysandrafly folded before Flop (didn't bet)
Seat 2: sebaaastian folded before Flop (didn't bet)
Seat 4: gabi_igna folded before Flop
Seat 5: keessie93 (button) folded before Flop
Seat 6: J0rmungund (small blind) collected ($8.50)
Seat 7: $-Twackle-$ (big blind) folded before Flop
Seat 9: matiko09 folded before Flop (didn't bet)





PokerStars Hand #149394639943:  Hold'em No Limit ($0.50/$1.00 USD) - 2016/02/25 17:36:55 CET [2016/02/25 11:36:55 ET]
Table 'Sabine' 9-max Seat #5 is the button
Seat 1: Aalleekks ($100 in chips) 
Seat 2: apfush ($126.23 in chips) 
Seat 3: Ouga Buga ($104.88 in chips) 
Seat 4: simoniustin ($108.62 in chips) 
Seat 5: Venomous100% ($105.54 in chips) 
Seat 8: matiko09 ($185.66 in chips) 
Seat 9: Dachish ($70 in chips) 
matiko09: posts small blind $0.50
Dachish: posts big blind $1
*** HOLE CARDS ***
Dealt to matiko09 [7c 2c]
ffac leaves the table
Aalleekks: folds 
Aalleekks leaves the table
gabi_igna joins the table at seat #6 
apfush: folds 
Ouga Buga: raises $1.50 to $2.50
simoniustin: folds 
Venomous100%: folds 
matiko09: folds 
Dachish: calls $1.50
*** FLOP *** [8h Td Qs]
Dachish: checks 
Ouga Buga: bets $3.46
Dachish: raises $8.64 to $12.10
Ouga Buga: calls $8.64
*** TURN *** [8h Td Qs] [Qc]
Dachish: bets $19.50
Ouga Buga: folds 
Uncalled bet ($19.50) returned to Dachish
Dachish collected $28.36 from pot
Dachish: doesn't show hand 
*** SUMMARY ***
Total pot $29.70 | Rake $1.34 
Board [8h Td Qs Qc]
Seat 1: Aalleekks folded before Flop (didn't bet)
Seat 2: apfush folded before Flop (didn't bet)
Seat 3: Ouga Buga folded on the Turn
Seat 4: simoniustin folded before Flop (didn't bet)
Seat 5: Venomous100% (button) folded before Flop (didn't bet)
Seat 8: matiko09 (small blind) folded before Flop
Seat 9: Dachish (big blind) collected ($28.36)





PokerStars Hand #149394642519:  Hold'em No Limit ($0.50/$1.00 USD) - 2016/02/25 17:36:58 CET [2016/02/25 11:36:58 ET]
Table 'Mayall II' 9-max Seat #4 is the button
Seat 1: matiko09 ($109.41 in chips) 
Seat 3: simoniustin ($135.14 in chips) 
Seat 4: Ouga Buga ($104.67 in chips) 
Seat 6: apfush ($100 in chips) 
Seat 7: r.pol218 ($38.48 in chips) 
Seat 8: kuanhung0903 ($89.96 in chips) 
McFussball81 will be allowed to play after the button
apfush: posts small blind $0.50
r.pol218: posts big blind $1
xAndorx: sits out 
*** HOLE CARDS ***
Dealt to matiko09 [2d 6d]
kuanhung0903: folds 
matiko09: folds 
simoniustin: raises $1.50 to $2.50
Ouga Buga: folds 
apfush: folds 
r.pol218: folds 
Uncalled bet ($1.50) returned to simoniustin
simoniustin collected $2.50 from pot
simoniustin: doesn't show hand 
*** SUMMARY ***
Total pot $2.50 | Rake $0 
Seat 1: matiko09 folded before Flop (didn't bet)
Seat 3: simoniustin collected ($2.50)
Seat 4: Ouga Buga (button) folded before Flop (didn't bet)
Seat 6: apfush (small blind) folded before Flop
Seat 7: r.pol218 (big blind) folded before Flop
Seat 8: kuanhung0903 folded before Flop (didn't bet)





PokerStars Hand #149394642850:  Hold'em No Limit ($0.50/$1.00 USD) - 2016/02/25 17:36:58 CET [2016/02/25 11:36:58 ET]
Table 'Zeuxo II' 9-max Seat #1 is the button
Seat 1: forsmthgood ($105.04 in chips) 
Seat 3: xAndorx ($131.20 in chips) 
Seat 4: sebaaastian ($100 in chips) 
Seat 5: hammerwife ($100 in chips) 
Seat 6: Cogss ($104.51 in chips) 
Seat 8: matiko09 ($126.41 in chips) 
Seat 9: Sreshta222 ($306.13 in chips) 
xAndorx: posts small blind $0.50
sebaaastian: posts big blind $1
Venomous100%: sits out 
*** HOLE CARDS ***
Dealt to matiko09 [2h 6s]
hammerwife: folds 
Cogss: raises $1 to $2
matiko09: folds 
Sreshta222: folds 
forsmthgood: folds 
xAndorx: folds 
sebaaastian: folds 
Uncalled bet ($1) returned to Cogss
Cogss collected $2.50 from pot
*** SUMMARY ***
Total pot $2.50 | Rake $0 
Seat 1: forsmthgood (button) folded before Flop (didn't bet)
Seat 3: xAndorx (small blind) folded before Flop
Seat 4: sebaaastian (big blind) folded before Flop
Seat 5: hammerwife folded before Flop (didn't bet)
Seat 6: Cogss collected ($2.50)
Seat 8: matiko09 folded before Flop (didn't bet)
Seat 9: Sreshta222 folded before Flop (didn't bet)





PokerStars Hand #149394645441:  Hold'em No Limit ($0.50/$1.00 USD) - 2016/02/25 17:37:01 CET [2016/02/25 11:37:01 ET]
Table 'Badenia II' 9-max Seat #3 is the button
Seat 1: matiko09 ($100 in chips) 
Seat 2: Venomous100% ($100 in chips) 
Seat 3: sebaaastian ($145 in chips) 
Seat 4: hammerwife ($108.63 in chips) 
Seat 5: Ilov3NBA ($100 in chips) 
Seat 9: waisanen ($240.67 in chips) 
hammerwife: posts small blind $0.50
Ilov3NBA: posts big blind $1
Dachish: sits out 
HomerrrJay: sits out 
*** HOLE CARDS ***
Dealt to matiko09 [2h 6c]
waisanen: folds 
matiko09: folds 
Venomous100%: folds 
sebaaastian: folds 
hammerwife: folds 
Uncalled bet ($0.50) returned to Ilov3NBA
Ilov3NBA collected $1 from pot
Ilov3NBA: doesn't show hand 
*** SUMMARY ***
Total pot $1 | Rake $0 
Seat 1: matiko09 folded before Flop (didn't bet)
Seat 2: Venomous100% folded before Flop (didn't bet)
Seat 3: sebaaastian (button) folded before Flop (didn't bet)
Seat 4: hammerwife (small blind) folded before Flop
Seat 5: Ilov3NBA (big blind) collected ($1)
Seat 9: waisanen folded before Flop (didn't bet)





PokerStars Hand #149394651647:  Hold'em No Limit ($0.25/$0.50 USD) - 2016/02/25 17:37:09 CET [2016/02/25 11:37:09 ET]
Table 'Lohja II' 9-max Seat #2 is the button
Seat 1: MoonJimmy ($162.88 in chips) 
Seat 2: mycka86 ($50 in chips) 
Seat 4: payback11 ($50.85 in chips) 
Seat 6: xAndorx ($61.89 in chips) 
Seat 7: matiko09 ($95.71 in chips) 
Seat 8: jamba83 ($66.29 in chips) 
Seat 9: Al3xAnd3r22 ($146.50 in chips) 
guvalc1952 will be allowed to play after the button
payback11: posts small blind $0.25
Effort92: is sitting out 
xAndorx: posts big blind $0.50
MoonJimmy: posts the ante $0.10
mycka86: posts the ante $0.10
payback11: posts the ante $0.10
xAndorx: posts the ante $0.10
matiko09: posts the ante $0.10
jamba83: posts the ante $0.10
Al3xAnd3r22: posts the ante $0.10
*** HOLE CARDS ***
Dealt to matiko09 [6c 9s]
mycka86 said, "<3"
matiko09: folds 
jamba83: folds 
Al3xAnd3r22: folds 
MoonJimmy: folds 
mycka86: raises $1 to $1.50
payback11: folds 
xAndorx: folds 
Uncalled bet ($1) returned to mycka86
mycka86 collected $1.95 from pot
*** SUMMARY ***
Total pot $1.95 | Rake $0 
Seat 1: MoonJimmy folded before Flop (didn't bet)
Seat 2: mycka86 (button) collected ($1.95)
Seat 4: payback11 (small blind) folded before Flop
Seat 6: xAndorx (big blind) folded before Flop
Seat 7: matiko09 folded before Flop (didn't bet)
Seat 8: jamba83 folded before Flop (didn't bet)
Seat 9: Al3xAnd3r22 folded before Flop (didn't bet)





PokerStars Hand #149394660148:  Hold'em No Limit ($0.50/$1.00 USD) - 2016/02/25 17:37:20 CET [2016/02/25 11:37:20 ET]
Table 'Mayall II' 9-max Seat #6 is the button
Seat 1: matiko09 ($109.41 in chips) 
Seat 3: simoniustin ($136.64 in chips) 
Seat 4: Ouga Buga ($104.67 in chips) 
Seat 5: McFussball81 ($58 in chips) 
Seat 6: apfush ($100 in chips) 
Seat 7: r.pol218 ($37.48 in chips) 
Seat 8: kuanhung0903 ($89.96 in chips) 
r.pol218: posts small blind $0.50
kuanhung0903: posts big blind $1
xAndorx: sits out 
McFussball81: posts big blind $1
*** HOLE CARDS ***
Dealt to matiko09 [Tc 6s]
matiko09: folds 
simoniustin: folds 
Ouga Buga: folds 
McFussball81: raises $2 to $3
apfush: folds 
r.pol218: raises $34.48 to $37.48 and is all-in
kuanhung0903: folds 
McFussball81: folds 
Uncalled bet ($34.48) returned to r.pol218
r.pol218 collected $7 from pot
r.pol218: doesn't show hand 
*** SUMMARY ***
Total pot $7 | Rake $0 
Seat 1: matiko09 folded before Flop (didn't bet)
Seat 3: simoniustin folded before Flop (didn't bet)
Seat 4: Ouga Buga folded before Flop (didn't bet)
Seat 5: McFussball81 folded before Flop
Seat 6: apfush (button) folded before Flop (didn't bet)
Seat 7: r.pol218 (small blind) collected ($7)
Seat 8: kuanhung0903 (big blind) folded before Flop





PokerStars Hand #149394661160:  Hold'em No Limit ($0.50/$1.00 USD) - 2016/02/25 17:37:21 CET [2016/02/25 11:37:21 ET]
Table 'Nerthus II' 9-max Seat #9 is the button
Seat 2: matiko09 ($217.68 in chips) 
Seat 3: simoniustin ($108.87 in chips) 
Seat 4: Ilov3NBA ($105.62 in chips) 
Seat 6: mycka86 ($142.88 in chips) 
Seat 7: Venomous100% ($108.65 in chips) 
Seat 8: Kelvin sai ($37.88 in chips) 
Seat 9: hammerwife ($100 in chips) 
matiko09: posts small blind $0.50
simoniustin: posts big blind $1
*** HOLE CARDS ***
Dealt to matiko09 [9d 6c]
Ilov3NBA: folds 
mycka86: folds 
Venomous100%: folds 
Kelvin sai: raises $1 to $2
hammerwife: folds 
matiko09: folds 
volwebni4ek joins the table at seat #1 
simoniustin: folds 
Uncalled bet ($1) returned to Kelvin sai
Kelvin sai collected $2.50 from pot
Kelvin sai: doesn't show hand 
*** SUMMARY ***
Total pot $2.50 | Rake $0 
Seat 2: matiko09 (small blind) folded before Flop
Seat 3: simoniustin (big blind) folded before Flop
Seat 4: Ilov3NBA folded before Flop (didn't bet)
Seat 6: mycka86 folded before Flop (didn't bet)
Seat 7: Venomous100% folded before Flop (didn't bet)
Seat 8: Kelvin sai collected ($2.50)
Seat 9: hammerwife (button) folded before Flop (didn't bet)





PokerStars Hand #149394661390:  Hold'em No Limit ($0.50/$1.00 USD) - 2016/02/25 17:37:21 CET [2016/02/25 11:37:21 ET]
Table 'Eurysaces II' 9-max Seat #6 is the button
Seat 1: lysandrafly ($100 in chips) 
Seat 2: sebaaastian ($102.28 in chips) 
Seat 4: gabi_igna ($100.25 in chips) 
Seat 5: keessie93 ($131.12 in chips) 
Seat 6: J0rmungund ($51.87 in chips) 
Seat 7: $-Twackle-$ ($100.50 in chips) 
Seat 8: hammerwife ($100 in chips) 
Seat 9: matiko09 ($100 in chips) 
$-Twackle-$: posts small blind $0.50
hammerwife: posts big blind $1
Aalleekks: sits out 
*** HOLE CARDS ***
Dealt to matiko09 [5c 8c]
matiko09: folds 
lysandrafly: folds 
sebaaastian: folds 
gabi_igna: raises $2 to $3
keessie93: folds 
J0rmungund: folds 
$-Twackle-$: raises $6.50 to $9.50
hammerwife: folds 
gabi_igna: raises $10.50 to $20
$-Twackle-$: folds 
Uncalled bet ($10.50) returned to gabi_igna
gabi_igna collected $20 from pot
gabi_igna: doesn't show hand 
*** SUMMARY ***
Total pot $20 | Rake $0 
Seat 1: lysandrafly folded before Flop (didn't bet)
Seat 2: sebaaastian folded before Flop (didn't bet)
Seat 4: gabi_igna collected ($20)
Seat 5: keessie93 folded before Flop (didn't bet)
Seat 6: J0rmungund (button) folded before Flop (didn't bet)
Seat 7: $-Twackle-$ (small blind) folded before Flop
Seat 8: hammerwife (big blind) folded before Flop
Seat 9: matiko09 folded before Flop (didn't bet)





PokerStars Hand #149394662173:  Hold'em No Limit ($0.50/$1.00 USD) - 2016/02/25 17:37:22 CET [2016/02/25 11:37:22 ET]
Table 'Badenia II' 9-max Seat #4 is the button
Seat 1: matiko09 ($100 in chips) 
Seat 2: Venomous100% ($100 in chips) 
Seat 3: sebaaastian ($145 in chips) 
Seat 4: hammerwife ($108.13 in chips) 
Seat 5: Ilov3NBA ($100.50 in chips) 
Seat 6: Dachish ($70 in chips) 
Seat 9: waisanen ($240.67 in chips) 
Ilov3NBA: posts small blind $0.50
Dachish: posts big blind $1
HomerrrJay: sits out 
*** HOLE CARDS ***
Dealt to matiko09 [Qs 8s]
waisanen: folds 
matiko09: folds 
Venomous100%: folds 
sebaaastian: folds 
hammerwife: raises $1.01 to $2.01
Ilov3NBA: folds 
Dachish: calls $1.01
*** FLOP *** [Kd 8c 5c]
Dachish: checks 
hammerwife: bets $2.50
Dachish: calls $2.50
*** TURN *** [Kd 8c 5c] [3h]
Dachish: checks 
hammerwife: checks 
*** RIVER *** [Kd 8c 5c 3h] [Tc]
Dachish: checks 
hammerwife: checks 
*** SHOW DOWN ***
Dachish: shows [9h 9s] (a pair of Nines)
hammerwife: mucks hand 
Dachish collected $9.09 from pot
*** SUMMARY ***
Total pot $9.52 | Rake $0.43 
Board [Kd 8c 5c 3h Tc]
Seat 1: matiko09 folded before Flop (didn't bet)
Seat 2: Venomous100% folded before Flop (didn't bet)
Seat 3: sebaaastian folded before Flop (didn't bet)
Seat 4: hammerwife (button) mucked [7s Js]
Seat 5: Ilov3NBA (small blind) folded before Flop
Seat 6: Dachish (big blind) showed [9h 9s] and won ($9.09) with a pair of Nines
Seat 9: waisanen folded before Flop (didn't bet)





PokerStars Hand #149394664844:  Hold'em No Limit ($0.50/$1.00 USD) - 2016/02/25 17:37:25 CET [2016/02/25 11:37:25 ET]
Table 'Zerbinetta II' 9-max Seat #9 is the button
Seat 1: $-Twackle-$ ($100 in chips) 
Seat 2: ffac ($100 in chips) 
Seat 3: matiko09 ($103.75 in chips) 
Seat 4: sebaaastian ($100 in chips) 
Seat 5: hammerwife ($119.77 in chips) 
Seat 7: HomerrrJay ($101.50 in chips) 
Seat 8: gabi_igna ($130.20 in chips) 
Seat 9: with-w ($22.22 in chips) 
$-Twackle-$: posts small blind $0.50
ffac: posts big blind $1
simoniustin: sits out 
*** HOLE CARDS ***
Dealt to matiko09 [3h As]
matiko09: folds 
sebaaastian: folds 
hammerwife: folds 
HomerrrJay: folds 
gabi_igna: raises $1.50 to $2.50
with-w: calls $2.50
$-Twackle-$: folds 
ffac: folds 
*** FLOP *** [3d 9h Ac]
gabi_igna: bets $4
with-w: calls $4
*** TURN *** [3d 9h Ac] [7d]
gabi_igna: checks 
with-w: bets $6.92
gabi_igna: folds 
Uncalled bet ($6.92) returned to with-w
with-w collected $13.85 from pot
with-w: doesn't show hand 
*** SUMMARY ***
Total pot $14.50 | Rake $0.65 
Board [3d 9h Ac 7d]
Seat 1: $-Twackle-$ (small blind) folded before Flop
Seat 2: ffac (big blind) folded before Flop
Seat 3: matiko09 folded before Flop (didn't bet)
Seat 4: sebaaastian folded before Flop (didn't bet)
Seat 5: hammerwife folded before Flop (didn't bet)
Seat 7: HomerrrJay folded before Flop (didn't bet)
Seat 8: gabi_igna folded on the Turn
Seat 9: with-w (button) collected ($13.85)





PokerStars Hand #149394671242:  Hold'em No Limit ($0.50/$1.00 USD) - 2016/02/25 17:37:33 CET [2016/02/25 11:37:33 ET]
Table 'Morosovia II' 9-max Seat #4 is the button
Seat 1: $-Twackle-$ ($100 in chips) 
Seat 2: Effort92 ($175.16 in chips) 
Seat 3: sebaaastian ($208 in chips) 
Seat 4: renechris ($84.83 in chips) 
Seat 5: gabi_igna ($144.07 in chips) 
Seat 7: matiko09 ($146.48 in chips) 
Seat 8: simoniustin ($119.09 in chips) 
Seat 9: lysandrafly ($120.94 in chips) 
gabi_igna: posts small blind $0.50
Sweden_Pound was removed from the table for failing to post
matiko09: posts big blind $1
*** HOLE CARDS ***
Dealt to matiko09 [2s 3s]
Dachish joins the table at seat #6 
simoniustin: folds 
lysandrafly: folds 
$-Twackle-$: folds 
Effort92: raises $2 to $3
sebaaastian: folds 
renechris: folds 
gabi_igna: folds 
matiko09: folds 
Uncalled bet ($2) returned to Effort92
Effort92 collected $2.50 from pot
Effort92: doesn't show hand 
*** SUMMARY ***
Total pot $2.50 | Rake $0 
Seat 1: $-Twackle-$ folded before Flop (didn't bet)
Seat 2: Effort92 collected ($2.50)
Seat 3: sebaaastian folded before Flop (didn't bet)
Seat 4: renechris (button) folded before Flop (didn't bet)
Seat 5: gabi_igna (small blind) folded before Flop
Seat 7: matiko09 (big blind) folded before Flop
Seat 8: simoniustin folded before Flop (didn't bet)
Seat 9: lysandrafly folded before Flop (didn't bet)





PokerStars Hand #149394673134:  Hold'em No Limit ($0.25/$0.50 USD) - 2016/02/25 17:37:36 CET [2016/02/25 11:37:36 ET]
Table 'Lohja II' 9-max Seat #4 is the button
Seat 1: MoonJimmy ($162.78 in chips) 
Seat 2: mycka86 ($51.35 in chips) 
Seat 3: guvalc1952 ($222.87 in chips) 
Seat 4: payback11 ($50.50 in chips) 
Seat 6: xAndorx ($61.29 in chips) 
Seat 7: matiko09 ($95.61 in chips) 
Seat 8: jamba83 ($66.19 in chips) 
Seat 9: Al3xAnd3r22 ($146.40 in chips) 
xAndorx: posts small blind $0.25
matiko09: posts big blind $0.50
guvalc1952: posts small & big blinds $0.75
MoonJimmy: posts the ante $0.10
mycka86: posts the ante $0.10
guvalc1952: posts the ante $0.10
payback11: posts the ante $0.10
xAndorx: posts the ante $0.10
matiko09: posts the ante $0.10
jamba83: posts the ante $0.10
Al3xAnd3r22: posts the ante $0.10
*** HOLE CARDS ***
Dealt to matiko09 [4d 2c]
jamba83: folds 
Al3xAnd3r22: folds 
MoonJimmy: folds 
mycka86: folds 
guvalc1952: checks 
payback11: folds 
xAndorx: calls $0.25
matiko09: checks 
*** FLOP *** [4h 9s 3c]
xAndorx: checks 
matiko09: bets $1.59
guvalc1952: raises $1.59 to $3.18
mycka86 said, "how to win a single pot this week ?"
xAndorx: folds 
matiko09: folds 
Uncalled bet ($1.59) returned to guvalc1952
guvalc1952 collected $5.47 from pot
guvalc1952: doesn't show hand 
*** SUMMARY ***
Total pot $5.73 | Rake $0.26 
Board [4h 9s 3c]
Seat 1: MoonJimmy folded before Flop (didn't bet)
Seat 2: mycka86 folded before Flop (didn't bet)
Seat 3: guvalc1952 collected ($5.47)
Seat 4: payback11 (button) folded before Flop (didn't bet)
Seat 6: xAndorx (small blind) folded on the Flop
Seat 7: matiko09 (big blind) folded on the Flop
Seat 8: jamba83 folded before Flop (didn't bet)
Seat 9: Al3xAnd3r22 folded before Flop (didn't bet)





PokerStars Hand #149394674552:  Hold'em No Limit ($0.50/$1.00 USD) - 2016/02/25 17:37:37 CET [2016/02/25 11:37:37 ET]
Table 'Zeuxo II' 9-max Seat #3 is the button
Seat 1: forsmthgood ($105.04 in chips) 
Seat 3: xAndorx ($130.70 in chips) 
Seat 4: sebaaastian ($100 in chips) 
Seat 5: hammerwife ($100 in chips) 
Seat 6: Cogss ($106.01 in chips) 
Seat 8: matiko09 ($126.41 in chips) 
Seat 9: Sreshta222 ($306.13 in chips) 
sebaaastian: posts small blind $0.50
hammerwife: posts big blind $1
Venomous100%: sits out 
*** HOLE CARDS ***
Dealt to matiko09 [7d 8d]
Cogss: folds 
matiko09: raises $2 to $3
Sreshta222: folds 
forsmthgood: folds 
xAndorx: folds 
sebaaastian: folds 
hammerwife: folds 
Uncalled bet ($2) returned to matiko09
matiko09 collected $2.50 from pot
matiko09: doesn't show hand 
*** SUMMARY ***
Total pot $2.50 | Rake $0 
Seat 1: forsmthgood folded before Flop (didn't bet)
Seat 3: xAndorx (button) folded before Flop (didn't bet)
Seat 4: sebaaastian (small blind) folded before Flop
Seat 5: hammerwife (big blind) folded before Flop
Seat 6: Cogss folded before Flop (didn't bet)
Seat 8: matiko09 collected ($2.50)
Seat 9: Sreshta222 folded before Flop (didn't bet)





PokerStars Hand #149394680801:  Hold'em No Limit ($0.50/$1.00 USD) - 2016/02/25 17:37:45 CET [2016/02/25 11:37:45 ET]
Table 'Isa' 9-max Seat #6 is the button
Seat 1: matiko09 ($124.58 in chips) 
Seat 2: mycka86 ($160.81 in chips) 
Seat 3: sebaaastian ($137.25 in chips) 
Seat 4: hammerwife ($119.91 in chips) 
Seat 6: xAndorx ($100.72 in chips) 
Seat 7: bilukm ($98.90 in chips) 
Seat 8: Venomous100% ($108.24 in chips) 
Seat 9: HomerrrJay ($152.61 in chips) 
bilukm: posts small blind $0.50
Venomous100%: posts big blind $1
*** HOLE CARDS ***
Dealt to matiko09 [2s 4c]
HomerrrJay: folds 
matiko09: folds 
mycka86: folds 
sebaaastian: folds 
hammerwife: raises $1.50 to $2.50
xAndorx: folds 
bilukm: folds 
Venomous100%: folds 
Uncalled bet ($1.50) returned to hammerwife
hammerwife collected $2.50 from pot
hammerwife: doesn't show hand 
*** SUMMARY ***
Total pot $2.50 | Rake $0 
Seat 1: matiko09 folded before Flop (didn't bet)
Seat 2: mycka86 folded before Flop (didn't bet)
Seat 3: sebaaastian folded before Flop (didn't bet)
Seat 4: hammerwife collected ($2.50)
Seat 6: xAndorx (button) folded before Flop (didn't bet)
Seat 7: bilukm (small blind) folded before Flop
Seat 8: Venomous100% (big blind) folded before Flop
Seat 9: HomerrrJay folded before Flop (didn't bet)





PokerStars Hand #149394682158:  Hold'em No Limit ($0.50/$1.00 USD) - 2016/02/25 17:37:47 CET [2016/02/25 11:37:47 ET]
Table 'Ebella II' 9-max Seat #7 is the button
Seat 3: fanmtZ ($42.32 in chips) 
Seat 4: xAndorx ($112.49 in chips) 
Seat 5: matiko09 ($107.34 in chips) 
Seat 6: gabi_igna ($100 in chips) 
Seat 7: $-Twackle-$ ($100 in chips) 
Seat 8: ZMPOUTSAM140 ($95.05 in chips) 
Seat 9: simoniustin ($104.84 in chips) 
ZMPOUTSAM140: posts small blind $0.50
simoniustin: posts big blind $1
Dachish: sits out 
*** HOLE CARDS ***
Dealt to matiko09 [4d Th]
fanmtZ: folds 
xAndorx: folds 
matiko09: folds 
gabi_igna: folds 
$-Twackle-$: folds 
ZMPOUTSAM140: raises $1 to $2
simoniustin: raises $8 to $10
ZMPOUTSAM140: calls $8
*** FLOP *** [6d 2h 7s]
ZMPOUTSAM140: checks 
simoniustin: bets $14
ZMPOUTSAM140: calls $14
*** TURN *** [6d 2h 7s] [9h]
ZMPOUTSAM140: checks 
simoniustin: bets $32
ZMPOUTSAM140: raises $39.05 to $71.05 and is all-in
simoniustin: calls $39.05
*** RIVER *** [6d 2h 7s 9h] [5d]
*** SHOW DOWN ***
ZMPOUTSAM140: shows [7d 6s] (two pair, Sevens and Sixes)
simoniustin: shows [Qc Qh] (a pair of Queens)
ZMPOUTSAM140 collected $187.30 from pot
*** SUMMARY ***
Total pot $190.10 | Rake $2.80 
Board [6d 2h 7s 9h 5d]
Seat 3: fanmtZ folded before Flop (didn't bet)
Seat 4: xAndorx folded before Flop (didn't bet)
Seat 5: matiko09 folded before Flop (didn't bet)
Seat 6: gabi_igna folded before Flop (didn't bet)
Seat 7: $-Twackle-$ (button) folded before Flop (didn't bet)
Seat 8: ZMPOUTSAM140 (small blind) showed [7d 6s] and won ($187.30) with two pair, Sevens and Sixes
Seat 9: simoniustin (big blind) showed [Qc Qh] and lost with a pair of Queens





PokerStars Hand #149394684313:  Hold'em No Limit ($0.25/$0.50 USD) - 2016/02/25 17:37:49 CET [2016/02/25 11:37:49 ET]
Table 'Vladimir' 9-max Seat #6 is the button
Seat 1: matiko09 ($50 in chips) 
Seat 2: lysandrafly ($59.84 in chips) 
Seat 3: JustR82 ($51.55 in chips) 
Seat 4: ffac ($58.85 in chips) 
Seat 5: Al3xAnd3r22 ($53.85 in chips) 
Seat 6: ihami ($45 in chips) 
Seat 7: myllow1 ($50.58 in chips) 
myllow1: posts small blind $0.25
matiko09: posts big blind $0.50
*** HOLE CARDS ***
Dealt to matiko09 [5s Qd]
lysandrafly: folds 
JustR82: folds 
ffac: folds 
Al3xAnd3r22: folds 
ihami: folds 
myllow1: calls $0.25
matiko09: checks 
*** FLOP *** [4d 5d As]
myllow1: checks 
matiko09: checks 
*** TURN *** [4d 5d As] [Ah]
myllow1: checks 
matiko09: bets $0.62
myllow1: calls $0.62
*** RIVER *** [4d 5d As Ah] [6s]
myllow1: checks 
matiko09: checks 
*** SHOW DOWN ***
myllow1: shows [Ks Jh] (a pair of Aces)
matiko09: shows [5s Qd] (two pair, Aces and Fives)
matiko09 collected $2.14 from pot
*** SUMMARY ***
Total pot $2.24 | Rake $0.10 
Board [4d 5d As Ah 6s]
Seat 1: matiko09 (big blind) showed [5s Qd] and won ($2.14) with two pair, Aces and Fives
Seat 2: lysandrafly folded before Flop (didn't bet)
Seat 3: JustR82 folded before Flop (didn't bet)
Seat 4: ffac folded before Flop (didn't bet)
Seat 5: Al3xAnd3r22 folded before Flop (didn't bet)
Seat 6: ihami (button) folded before Flop (didn't bet)
Seat 7: myllow1 (small blind) showed [Ks Jh] and lost with a pair of Aces





PokerStars Hand #149394691713:  Hold'em No Limit ($0.50/$1.00 USD) - 2016/02/25 17:37:59 CET [2016/02/25 11:37:59 ET]
Table 'Nerthus II' 9-max Seat #2 is the button
Seat 2: matiko09 ($217.18 in chips) 
Seat 3: simoniustin ($107.87 in chips) 
Seat 4: Ilov3NBA ($105.62 in chips) 
Seat 6: mycka86 ($142.88 in chips) 
Seat 7: Venomous100% ($108.65 in chips) 
Seat 8: Kelvin sai ($39.38 in chips) 
Seat 9: hammerwife ($100 in chips) 
simoniustin: posts small blind $0.50
Ilov3NBA: posts big blind $1
volwebni4ek: sits out 
*** HOLE CARDS ***
Dealt to matiko09 [Ac Qs]
mycka86: folds 
Venomous100%: folds 
Kelvin sai: folds 
hammerwife: folds 
matiko09: raises $1.27 to $2.27
simoniustin: folds 
Ilov3NBA: folds 
Uncalled bet ($1.27) returned to matiko09
matiko09 collected $2.50 from pot
matiko09: doesn't show hand 
*** SUMMARY ***
Total pot $2.50 | Rake $0 
Seat 2: matiko09 (button) collected ($2.50)
Seat 3: simoniustin (small blind) folded before Flop
Seat 4: Ilov3NBA (big blind) folded before Flop
Seat 6: mycka86 folded before Flop (didn't bet)
Seat 7: Venomous100% folded before Flop (didn't bet)
Seat 8: Kelvin sai folded before Flop (didn't bet)
Seat 9: hammerwife folded before Flop (didn't bet)





PokerStars Hand #149394693567:  Hold'em No Limit ($0.50/$1.00 USD) - 2016/02/25 17:38:01 CET [2016/02/25 11:38:01 ET]
Table 'Mayall II' 9-max Seat #7 is the button
Seat 1: matiko09 ($109.41 in chips) 
Seat 3: simoniustin ($136.64 in chips) 
Seat 4: Ouga Buga ($104.67 in chips) 
Seat 5: McFussball81 ($55 in chips) 
Seat 6: apfush ($100 in chips) 
Seat 7: r.pol218 ($41.48 in chips) 
Seat 8: kuanhung0903 ($88.96 in chips) 
Seat 9: xAndorx ($133.34 in chips) 
kuanhung0903: posts small blind $0.50
xAndorx: posts big blind $1
*** HOLE CARDS ***
Dealt to matiko09 [7h 4s]
matiko09: folds 
simoniustin: folds 
Ouga Buga: folds 
McFussball81: folds 
apfush: raises $1.50 to $2.50
r.pol218: folds 
kuanhung0903: folds 
xAndorx: folds 
Uncalled bet ($1.50) returned to apfush
apfush collected $2.50 from pot
apfush: doesn't show hand 
*** SUMMARY ***
Total pot $2.50 | Rake $0 
Seat 1: matiko09 folded before Flop (didn't bet)
Seat 3: simoniustin folded before Flop (didn't bet)
Seat 4: Ouga Buga folded before Flop (didn't bet)
Seat 5: McFussball81 folded before Flop (didn't bet)
Seat 6: apfush collected ($2.50)
Seat 7: r.pol218 (button) folded before Flop (didn't bet)
Seat 8: kuanhung0903 (small blind) folded before Flop
Seat 9: xAndorx (big blind) folded before Flop





PokerStars Hand #149394698806:  Hold'em No Limit ($0.50/$1.00 USD) - 2016/02/25 17:38:07 CET [2016/02/25 11:38:07 ET]
Table 'Sabine' 9-max Seat #8 is the button
Seat 2: apfush ($126.23 in chips) 
Seat 3: Ouga Buga ($100 in chips) 
Seat 4: simoniustin ($108.62 in chips) 
Seat 5: Venomous100% ($105.54 in chips) 
Seat 8: matiko09 ($185.16 in chips) 
Seat 9: Dachish ($83.76 in chips) 
Dachish: posts small blind $0.50
apfush: posts big blind $1
gabi_igna: sits out 
*** HOLE CARDS ***
Dealt to matiko09 [5s 5h]
Ouga Buga: folds 
simoniustin: folds 
Venomous100%: folds 
matiko09: raises $1.27 to $2.27
Dachish: folds 
apfush: folds 
Uncalled bet ($1.27) returned to matiko09
matiko09 collected $2.50 from pot
matiko09: doesn't show hand 
*** SUMMARY ***
Total pot $2.50 | Rake $0 
Seat 2: apfush (big blind) folded before Flop
Seat 3: Ouga Buga folded before Flop (didn't bet)
Seat 4: simoniustin folded before Flop (didn't bet)
Seat 5: Venomous100% folded before Flop (didn't bet)
Seat 8: matiko09 (button) collected ($2.50)
Seat 9: Dachish (small blind) folded before Flop





PokerStars Hand #149394700281:  Hold'em No Limit ($0.50/$1.00 USD) - 2016/02/25 17:38:09 CET [2016/02/25 11:38:09 ET]
Table 'Eurysaces II' 9-max Seat #7 is the button
Seat 1: lysandrafly ($100 in chips) 
Seat 2: sebaaastian ($102.28 in chips) 
Seat 4: gabi_igna ($110.75 in chips) 
Seat 5: keessie93 ($131.12 in chips) 
Seat 6: J0rmungund ($51.87 in chips) 
Seat 7: $-Twackle-$ ($100 in chips) 
Seat 8: hammerwife ($100 in chips) 
Seat 9: matiko09 ($100 in chips) 
hammerwife: posts small blind $0.50
matiko09: posts big blind $1
Aalleekks: sits out 
*** HOLE CARDS ***
Dealt to matiko09 [3c 9d]
lysandrafly: folds 
sebaaastian: folds 
gabi_igna: folds 
keessie93: folds 
J0rmungund: raises $2 to $3
$-Twackle-$: folds 
hammerwife: folds 
matiko09: folds 
Uncalled bet ($2) returned to J0rmungund
J0rmungund collected $2.50 from pot
*** SUMMARY ***
Total pot $2.50 | Rake $0 
Seat 1: lysandrafly folded before Flop (didn't bet)
Seat 2: sebaaastian folded before Flop (didn't bet)
Seat 4: gabi_igna folded before Flop (didn't bet)
Seat 5: keessie93 folded before Flop (didn't bet)
Seat 6: J0rmungund collected ($2.50)
Seat 7: $-Twackle-$ (button) folded before Flop (didn't bet)
Seat 8: hammerwife (small blind) folded before Flop
Seat 9: matiko09 (big blind) folded before Flop





PokerStars Hand #149394702442:  Hold'em No Limit ($0.50/$1.00 USD) - 2016/02/25 17:38:12 CET [2016/02/25 11:38:12 ET]
Table 'Badenia II' 9-max Seat #5 is the button
Seat 1: matiko09 ($100 in chips) 
Seat 2: Venomous100% ($100 in chips) 
Seat 3: sebaaastian ($145 in chips) 
Seat 4: hammerwife ($103.62 in chips) 
Seat 5: Ilov3NBA ($100 in chips) 
Seat 6: Dachish ($74.58 in chips) 
Seat 7: HomerrrJay ($100 in chips) 
Seat 9: waisanen ($240.67 in chips) 
Dachish: posts small blind $0.50
HomerrrJay: posts big blind $1
*** HOLE CARDS ***
Dealt to matiko09 [7h Kh]
waisanen: folds 
matiko09: folds 
Venomous100%: folds 
sebaaastian: folds 
hammerwife: folds 
Ilov3NBA: raises $1 to $2
Dachish: calls $1.50
HomerrrJay: folds 
*** FLOP *** [5c Ts Kc]
Dachish: checks 
Ilov3NBA: bets $3.53
Dachish: folds 
Uncalled bet ($3.53) returned to Ilov3NBA
Ilov3NBA collected $4.78 from pot
Ilov3NBA: doesn't show hand 
*** SUMMARY ***
Total pot $5 | Rake $0.22 
Board [5c Ts Kc]
Seat 1: matiko09 folded before Flop (didn't bet)
Seat 2: Venomous100% folded before Flop (didn't bet)
Seat 3: sebaaastian folded before Flop (didn't bet)
Seat 4: hammerwife folded before Flop (didn't bet)
Seat 5: Ilov3NBA (button) collected ($4.78)
Seat 6: Dachish (small blind) folded on the Flop
Seat 7: HomerrrJay (big blind) folded before Flop
Seat 9: waisanen folded before Flop (didn't bet)





PokerStars Hand #149394707801:  Hold'em No Limit ($0.50/$1.00 USD) - 2016/02/25 17:38:18 CET [2016/02/25 11:38:18 ET]
Table 'Zeuxo II' 9-max Seat #4 is the button
Seat 1: forsmthgood ($105.04 in chips) 
Seat 3: xAndorx ($130.70 in chips) 
Seat 4: sebaaastian ($100 in chips) 
Seat 5: hammerwife ($100 in chips) 
Seat 6: Cogss ($106.01 in chips) 
Seat 8: matiko09 ($127.91 in chips) 
Seat 9: Sreshta222 ($306.13 in chips) 
hammerwife: posts small blind $0.50
Cogss: posts big blind $1
Venomous100%: sits out 
*** HOLE CARDS ***
Dealt to matiko09 [5c 8h]
matiko09: folds 
Sreshta222: folds 
forsmthgood: folds 
xAndorx: folds 
sebaaastian: folds 
hammerwife: raises $1.60 to $2.60
Cogss: folds 
Uncalled bet ($1.60) returned to hammerwife
hammerwife collected $2 from pot
hammerwife: doesn't show hand 
*** SUMMARY ***
Total pot $2 | Rake $0 
Seat 1: forsmthgood folded before Flop (didn't bet)
Seat 3: xAndorx folded before Flop (didn't bet)
Seat 4: sebaaastian (button) folded before Flop (didn't bet)
Seat 5: hammerwife (small blind) collected ($2)
Seat 6: Cogss (big blind) folded before Flop
Seat 8: matiko09 folded before Flop (didn't bet)
Seat 9: Sreshta222 folded before Flop (didn't bet)





PokerStars Hand #149394708909:  Hold'em No Limit ($0.25/$0.50 USD) - 2016/02/25 17:38:20 CET [2016/02/25 11:38:20 ET]
Table 'Lohja II' 9-max Seat #6 is the button
Seat 1: MoonJimmy ($162.68 in chips) 
Seat 2: mycka86 ($51.25 in chips) 
Seat 3: guvalc1952 ($225.90 in chips) 
Seat 4: payback11 ($50.40 in chips) 
Seat 6: xAndorx ($60.69 in chips) 
Seat 7: matiko09 ($93.42 in chips) 
Seat 9: Al3xAnd3r22 ($146.30 in chips) 
matiko09: posts small blind $0.25
jamba83: is sitting out 
jamba83 leaves the table
Al3xAnd3r22: posts big blind $0.50
MoonJimmy: posts the ante $0.10
mycka86: posts the ante $0.10
guvalc1952: posts the ante $0.10
payback11: posts the ante $0.10
xAndorx: posts the ante $0.10
matiko09: posts the ante $0.10
Al3xAnd3r22: posts the ante $0.10
*** HOLE CARDS ***
Dealt to matiko09 [Qh 4d]
MoonJimmy: folds 
mycka86: folds 
guvalc1952: calls $0.50
payback11: folds 
xAndorx: folds 
matiko09: folds 
Al3xAnd3r22: raises $2 to $2.50
guvalc1952: calls $2
*** FLOP *** [3d 8s Th]
JustR82 joins the table at seat #8 
Al3xAnd3r22: checks 
JustR82 leaves the table
guvalc1952: checks 
*** TURN *** [3d 8s Th] [2h]
Al3xAnd3r22: bets $1.98
guvalc1952: calls $1.98
*** RIVER *** [3d 8s Th 2h] [Td]
Al3xAnd3r22: checks 
guvalc1952: checks 
*** SHOW DOWN ***
Al3xAnd3r22: shows [Jd Ah] (a pair of Tens)
guvalc1952: shows [2c Kd] (two pair, Tens and Deuces)
guvalc1952 collected $9.46 from pot
*** SUMMARY ***
Total pot $9.91 | Rake $0.45 
Board [3d 8s Th 2h Td]
Seat 1: MoonJimmy folded before Flop (didn't bet)
Seat 2: mycka86 folded before Flop (didn't bet)
Seat 3: guvalc1952 showed [2c Kd] and won ($9.46) with two pair, Tens and Deuces
Seat 4: payback11 folded before Flop (didn't bet)
Seat 6: xAndorx (button) folded before Flop (didn't bet)
Seat 7: matiko09 (small blind) folded before Flop
Seat 9: Al3xAnd3r22 (big blind) showed [Jd Ah] and lost with a pair of Tens





PokerStars Hand #149394717101:  Hold'em No Limit ($0.50/$1.00 USD) - 2016/02/25 17:38:30 CET [2016/02/25 11:38:30 ET]
Table 'Sabine' 9-max Seat #9 is the button
Seat 2: apfush ($125.23 in chips) 
Seat 4: simoniustin ($108.62 in chips) 
Seat 5: Venomous100% ($105.54 in chips) 
Seat 8: matiko09 ($186.66 in chips) 
Seat 9: Dachish ($83.26 in chips) 
apfush: posts small blind $0.50
Ouga Buga: is sitting out 
Ouga Buga leaves the table
simoniustin: posts big blind $1
gabi_igna: sits out 
*** HOLE CARDS ***
Dealt to matiko09 [Jd 6c]
Venomous100%: raises $2 to $3
lysandrafly joins the table at seat #1 
matiko09: folds 
Dachish: folds 
FTPbannedMe joins the table at seat #3 
apfush: folds 
simoniustin: folds 
Uncalled bet ($2) returned to Venomous100%
Venomous100% collected $2.50 from pot
Venomous100%: doesn't show hand 
FTPbannedMe leaves the table
*** SUMMARY ***
Total pot $2.50 | Rake $0 
Seat 2: apfush (small blind) folded before Flop
Seat 4: simoniustin (big blind) folded before Flop
Seat 5: Venomous100% collected ($2.50)
Seat 8: matiko09 folded before Flop (didn't bet)
Seat 9: Dachish (button) folded before Flop (didn't bet)





PokerStars Hand #149394717247:  Hold'em No Limit ($0.50/$1.00 USD) - 2016/02/25 17:38:30 CET [2016/02/25 11:38:30 ET]
Table 'Morosovia II' 9-max Seat #5 is the button
Seat 1: $-Twackle-$ ($100 in chips) 
Seat 2: Effort92 ($176.66 in chips) 
Seat 3: sebaaastian ($208 in chips) 
Seat 4: renechris ($84.83 in chips) 
Seat 5: gabi_igna ($143.57 in chips) 
Seat 7: matiko09 ($145.48 in chips) 
Seat 8: simoniustin ($119.09 in chips) 
Seat 9: lysandrafly ($120.94 in chips) 
Dachish will be allowed to play after the button
matiko09: posts small blind $0.50
simoniustin: posts big blind $1
*** HOLE CARDS ***
Dealt to matiko09 [Th 5s]
lysandrafly: folds 
$-Twackle-$: folds 
Effort92: folds 
sebaaastian: folds 
renechris: calls $1
gabi_igna: folds 
matiko09: folds 
simoniustin: checks 
*** FLOP *** [Tc Ts 7s]
simoniustin: checks 
renechris: bets $2.39
simoniustin: folds 
Uncalled bet ($2.39) returned to renechris
renechris collected $2.39 from pot
*** SUMMARY ***
Total pot $2.50 | Rake $0.11 
Board [Tc Ts 7s]
Seat 1: $-Twackle-$ folded before Flop (didn't bet)
Seat 2: Effort92 folded before Flop (didn't bet)
Seat 3: sebaaastian folded before Flop (didn't bet)
Seat 4: renechris collected ($2.39)
Seat 5: gabi_igna (button) folded before Flop (didn't bet)
Seat 7: matiko09 (small blind) folded before Flop
Seat 8: simoniustin (big blind) folded on the Flop
Seat 9: lysandrafly folded before Flop (didn't bet)





PokerStars Hand #149394721158:  Hold'em No Limit ($0.50/$1.00 USD) - 2016/02/25 17:38:35 CET [2016/02/25 11:38:35 ET]
Table 'Zerbinetta II' 9-max Seat #1 is the button
Seat 1: $-Twackle-$ ($100 in chips) 
Seat 2: ffac ($100 in chips) 
Seat 3: matiko09 ($103.75 in chips) 
Seat 4: sebaaastian ($100 in chips) 
Seat 5: hammerwife ($119.77 in chips) 
Seat 7: HomerrrJay ($101.50 in chips) 
Seat 8: gabi_igna ($123.70 in chips) 
Seat 9: with-w ($29.57 in chips) 
ffac: posts small blind $0.50
matiko09: posts big blind $1
simoniustin: sits out 
*** HOLE CARDS ***
Dealt to matiko09 [6c Qs]
sebaaastian: folds 
hammerwife: folds 
HomerrrJay: folds 
gabi_igna: folds 
with-w: calls $1
$-Twackle-$: folds 
ffac: folds 
matiko09: checks 
*** FLOP *** [4s 5c Ac]
matiko09: checks 
with-w: checks 
*** TURN *** [4s 5c Ac] [Kh]
matiko09: checks 
with-w: bets $2.39
matiko09: folds 
Uncalled bet ($2.39) returned to with-w
with-w collected $2.39 from pot
with-w: doesn't show hand 
*** SUMMARY ***
Total pot $2.50 | Rake $0.11 
Board [4s 5c Ac Kh]
Seat 1: $-Twackle-$ (button) folded before Flop (didn't bet)
Seat 2: ffac (small blind) folded before Flop
Seat 3: matiko09 (big blind) folded on the Turn
Seat 4: sebaaastian folded before Flop (didn't bet)
Seat 5: hammerwife folded before Flop (didn't bet)
Seat 7: HomerrrJay folded before Flop (didn't bet)
Seat 8: gabi_igna folded before Flop (didn't bet)
Seat 9: with-w collected ($2.39)





PokerStars Hand #149394725827:  Hold'em No Limit ($0.50/$1.00 USD) - 2016/02/25 17:38:41 CET [2016/02/25 11:38:41 ET]
Table 'Nerthus II' 9-max Seat #3 is the button
Seat 2: matiko09 ($218.68 in chips) 
Seat 3: simoniustin ($107.37 in chips) 
Seat 4: Ilov3NBA ($104.62 in chips) 
Seat 6: mycka86 ($142.88 in chips) 
Seat 7: Venomous100% ($108.65 in chips) 
Seat 8: Kelvin sai ($39.38 in chips) 
Seat 9: hammerwife ($100 in chips) 
Ilov3NBA: posts small blind $0.50
mycka86: posts big blind $1
volwebni4ek: sits out 
*** HOLE CARDS ***
Dealt to matiko09 [Ts Qh]
Venomous100%: folds 
Kelvin sai: folds 
hammerwife: folds 
matiko09: raises $2 to $3
simoniustin: folds 
Ilov3NBA: folds 
mycka86: folds 
Uncalled bet ($2) returned to matiko09
matiko09 collected $2.50 from pot
matiko09: doesn't show hand 
*** SUMMARY ***
Total pot $2.50 | Rake $0 
Seat 2: matiko09 collected ($2.50)
Seat 3: simoniustin (button) folded before Flop (didn't bet)
Seat 4: Ilov3NBA (small blind) folded before Flop
Seat 6: mycka86 (big blind) folded before Flop
Seat 7: Venomous100% folded before Flop (didn't bet)
Seat 8: Kelvin sai folded before Flop (didn't bet)
Seat 9: hammerwife folded before Flop (didn't bet)





PokerStars Hand #149394731436:  Hold'em No Limit ($0.50/$1.00 USD) - 2016/02/25 17:38:47 CET [2016/02/25 11:38:47 ET]
Table 'Isa' 9-max Seat #7 is the button
Seat 1: matiko09 ($124.58 in chips) 
Seat 2: mycka86 ($160.81 in chips) 
Seat 3: sebaaastian ($137.25 in chips) 
Seat 4: hammerwife ($121.41 in chips) 
Seat 6: xAndorx ($100.72 in chips) 
Seat 7: bilukm ($98.40 in chips) 
Seat 8: Venomous100% ($107.24 in chips) 
Venomous100%: posts small blind $0.50
HomerrrJay: is sitting out 
matiko09: posts big blind $1
*** HOLE CARDS ***
Dealt to matiko09 [Ts 5c]
HomerrrJay leaves the table
mycka86: folds 
sebaaastian: folds 
hammerwife: folds 
xAndorx: raises $2 to $3
bilukm: folds 
Venomous100%: calls $2.50
matiko09: folds 
*** FLOP *** [3h 8h 6h]
Venomous100%: checks 
xAndorx: bets $4
Venomous100%: folds 
Uncalled bet ($4) returned to xAndorx
xAndorx collected $6.68 from pot
xAndorx: doesn't show hand 
*** SUMMARY ***
Total pot $7 | Rake $0.32 
Board [3h 8h 6h]
Seat 1: matiko09 (big blind) folded before Flop
Seat 2: mycka86 folded before Flop (didn't bet)
Seat 3: sebaaastian folded before Flop (didn't bet)
Seat 4: hammerwife folded before Flop (didn't bet)
Seat 6: xAndorx collected ($6.68)
Seat 7: bilukm (button) folded before Flop (didn't bet)
Seat 8: Venomous100% (small blind) folded on the Flop





PokerStars Hand #149394731594:  Hold'em No Limit ($0.50/$1.00 USD) - 2016/02/25 17:38:48 CET [2016/02/25 11:38:48 ET]
Table 'Mayall II' 9-max Seat #8 is the button
Seat 1: matiko09 ($109.41 in chips) 
Seat 3: simoniustin ($136.64 in chips) 
Seat 4: Ouga Buga ($104.67 in chips) 
Seat 5: McFussball81 ($55 in chips) 
Seat 6: apfush ($101.50 in chips) 
Seat 7: r.pol218 ($41.48 in chips) 
Seat 8: kuanhung0903 ($88.46 in chips) 
Seat 9: xAndorx ($132.34 in chips) 
xAndorx: posts small blind $0.50
matiko09: posts big blind $1
*** HOLE CARDS ***
Dealt to matiko09 [As 9s]
simoniustin: raises $2 to $3
Ouga Buga: folds 
McFussball81: folds 
apfush: folds 
r.pol218: folds 
kuanhung0903: folds 
xAndorx: folds 
matiko09: raises $7 to $10
simoniustin: folds 
Uncalled bet ($7) returned to matiko09
matiko09 collected $6.50 from pot
matiko09: doesn't show hand 
*** SUMMARY ***
Total pot $6.50 | Rake $0 
Seat 1: matiko09 (big blind) collected ($6.50)
Seat 3: simoniustin folded before Flop
Seat 4: Ouga Buga folded before Flop (didn't bet)
Seat 5: McFussball81 folded before Flop (didn't bet)
Seat 6: apfush folded before Flop (didn't bet)
Seat 7: r.pol218 folded before Flop (didn't bet)
Seat 8: kuanhung0903 (button) folded before Flop (didn't bet)
Seat 9: xAndorx (small blind) folded before Flop





PokerStars Hand #149394738372:  Hold'em No Limit ($0.50/$1.00 USD) - 2016/02/25 17:38:56 CET [2016/02/25 11:38:56 ET]
Table 'Sabine' 9-max Seat #2 is the button
Seat 2: apfush ($124.73 in chips) 
Seat 4: simoniustin ($107.62 in chips) 
Seat 6: gabi_igna ($100 in chips) 
Seat 8: matiko09 ($186.66 in chips) 
Seat 9: Dachish ($83.26 in chips) 
simoniustin: posts small blind $0.50
Venomous100%: is sitting out 
gabi_igna: posts big blind $1
*** HOLE CARDS ***
Dealt to matiko09 [8c Ks]
matiko09: folds 
Dachish: raises $1 to $2
apfush: folds 
simoniustin: folds 
gabi_igna: calls $1
*** FLOP *** [2s Qd 5s]
gabi_igna: checks 
Dachish: checks 
*** TURN *** [2s Qd 5s] [5h]
gabi_igna: bets $4.30
Dachish: folds 
Uncalled bet ($4.30) returned to gabi_igna
gabi_igna collected $4.30 from pot
gabi_igna: doesn't show hand 
*** SUMMARY ***
Total pot $4.50 | Rake $0.20 
Board [2s Qd 5s 5h]
Seat 2: apfush (button) folded before Flop (didn't bet)
Seat 4: simoniustin (small blind) folded before Flop
Seat 6: gabi_igna (big blind) collected ($4.30)
Seat 8: matiko09 folded before Flop (didn't bet)
Seat 9: Dachish folded on the Turn





PokerStars Hand #149394738448:  Hold'em No Limit ($0.50/$1.00 USD) - 2016/02/25 17:38:56 CET [2016/02/25 11:38:56 ET]
Table 'Zeuxo II' 9-max Seat #5 is the button
Seat 1: forsmthgood ($105.04 in chips) 
Seat 3: xAndorx ($130.70 in chips) 
Seat 4: sebaaastian ($100 in chips) 
Seat 5: hammerwife ($101 in chips) 
Seat 6: Cogss ($105.01 in chips) 
Seat 7: Venomous100% ($100 in chips) 
Seat 8: matiko09 ($127.91 in chips) 
Seat 9: Sreshta222 ($306.13 in chips) 
Cogss: posts small blind $0.50
Venomous100%: posts big blind $1
*** HOLE CARDS ***
Dealt to matiko09 [Ad 9h]
matiko09: folds 
Sreshta222: folds 
forsmthgood: folds 
xAndorx: raises $2 to $3
sebaaastian: folds 
hammerwife: folds 
Cogss: calls $2.50
Venomous100%: folds 
*** FLOP *** [6d Js 4d]
Cogss: checks 
xAndorx: bets $5
Cogss: folds 
Uncalled bet ($5) returned to xAndorx
xAndorx collected $6.68 from pot
xAndorx: doesn't show hand 
*** SUMMARY ***
Total pot $7 | Rake $0.32 
Board [6d Js 4d]
Seat 1: forsmthgood folded before Flop (didn't bet)
Seat 3: xAndorx collected ($6.68)
Seat 4: sebaaastian folded before Flop (didn't bet)
Seat 5: hammerwife (button) folded before Flop (didn't bet)
Seat 6: Cogss (small blind) folded on the Flop
Seat 7: Venomous100% (big blind) folded before Flop
Seat 8: matiko09 folded before Flop (didn't bet)
Seat 9: Sreshta222 folded before Flop (didn't bet)





PokerStars Hand #149394739307:  Hold'em No Limit ($0.25/$0.50 USD) - 2016/02/25 17:38:57 CET [2016/02/25 11:38:57 ET]
Table 'Vladimir' 9-max Seat #7 is the button
Seat 1: matiko09 ($51.02 in chips) 
Seat 2: lysandrafly ($59.84 in chips) 
Seat 3: JustR82 ($51.55 in chips) 
Seat 4: ffac ($58.85 in chips) 
Seat 5: Al3xAnd3r22 ($53.85 in chips) 
Seat 6: ihami ($45 in chips) 
Seat 7: myllow1 ($49.46 in chips) 
earthensnake will be allowed to play after the button
matiko09: posts small blind $0.25
lysandrafly: posts big blind $0.50
*** HOLE CARDS ***
Dealt to matiko09 [2h 7h]
JustR82: folds 
ffac: folds 
Al3xAnd3r22: raises $1 to $1.50
ihami: folds 
myllow1: calls $1.50
matiko09: folds 
lysandrafly: calls $1
*** FLOP *** [As 3h Kd]
lysandrafly: checks 
Al3xAnd3r22: bets $2.54
myllow1: calls $2.54
lysandrafly: folds 
*** TURN *** [As 3h Kd] [3d]
Al3xAnd3r22: checks 
myllow1: bets $2
Al3xAnd3r22: calls $2
*** RIVER *** [As 3h Kd 3d] [7d]
Al3xAnd3r22: checks 
myllow1: bets $2
Al3xAnd3r22: calls $2
*** SHOW DOWN ***
myllow1: shows [Ac Js] (two pair, Aces and Threes)
Al3xAnd3r22: shows [Ad Jc] (two pair, Aces and Threes)
Al3xAnd3r22 collected $8.52 from pot
myllow1 collected $8.51 from pot
*** SUMMARY ***
Total pot $17.83 | Rake $0.80 
Board [As 3h Kd 3d 7d]
Seat 1: matiko09 (small blind) folded before Flop
Seat 2: lysandrafly (big blind) folded on the Flop
Seat 3: JustR82 folded before Flop (didn't bet)
Seat 4: ffac folded before Flop (didn't bet)
Seat 5: Al3xAnd3r22 showed [Ad Jc] and won ($8.52) with two pair, Aces and Threes
Seat 6: ihami folded before Flop (didn't bet)
Seat 7: myllow1 (button) showed [Ac Js] and won ($8.51) with two pair, Aces and Threes





PokerStars Hand #149394746314:  Hold'em No Limit ($0.50/$1.00 USD) - 2016/02/25 17:39:06 CET [2016/02/25 11:39:06 ET]
Table 'Eurysaces II' 9-max Seat #8 is the button
Seat 1: lysandrafly ($100 in chips) 
Seat 2: sebaaastian ($102.28 in chips) 
Seat 4: gabi_igna ($110.75 in chips) 
Seat 5: keessie93 ($131.12 in chips) 
Seat 6: J0rmungund ($53.37 in chips) 
Seat 7: $-Twackle-$ ($100 in chips) 
Seat 8: hammerwife ($100 in chips) 
Seat 9: matiko09 ($100 in chips) 
matiko09: posts small blind $0.50
lysandrafly: posts big blind $1
Aalleekks: sits out 
*** HOLE CARDS ***
Dealt to matiko09 [Ks 3c]
sebaaastian: folds 
gabi_igna: folds 
keessie93: folds 
J0rmungund: folds 
$-Twackle-$: raises $1.50 to $2.50
hammerwife: folds 
matiko09: folds 
lysandrafly: raises $7.50 to $10
$-Twackle-$: calls $7.50
*** FLOP *** [8h Th 2c]
lysandrafly: bets $12
$-Twackle-$: folds 
Uncalled bet ($12) returned to lysandrafly
lysandrafly collected $19.58 from pot
lysandrafly: doesn't show hand 
*** SUMMARY ***
Total pot $20.50 | Rake $0.92 
Board [8h Th 2c]
Seat 1: lysandrafly (big blind) collected ($19.58)
Seat 2: sebaaastian folded before Flop (didn't bet)
Seat 4: gabi_igna folded before Flop (didn't bet)
Seat 5: keessie93 folded before Flop (didn't bet)
Seat 6: J0rmungund folded before Flop (didn't bet)
Seat 7: $-Twackle-$ folded on the Flop
Seat 8: hammerwife (button) folded before Flop (didn't bet)
Seat 9: matiko09 (small blind) folded before Flop





PokerStars Hand #149394747128:  Hold'em No Limit ($0.50/$1.00 USD) - 2016/02/25 17:39:07 CET [2016/02/25 11:39:07 ET]
Table 'Badenia II' 9-max Seat #6 is the button
Seat 1: matiko09 ($100 in chips) 
Seat 2: Venomous100% ($100 in chips) 
Seat 3: sebaaastian ($145 in chips) 
Seat 4: hammerwife ($103.62 in chips) 
Seat 5: Ilov3NBA ($102.78 in chips) 
Seat 6: Dachish ($72.58 in chips) 
Seat 7: HomerrrJay ($100 in chips) 
Seat 9: waisanen ($240.67 in chips) 
HomerrrJay: posts small blind $0.50
Sweden_Pound was removed from the table for failing to post
waisanen: posts big blind $1
*** HOLE CARDS ***
Dealt to matiko09 [2h Js]
matiko09: folds 
Venomous100%: folds 
McFussball81 joins the table at seat #8 
sebaaastian: folds 
hammerwife: folds 
Ilov3NBA: folds 
Dachish: raises $1.50 to $2.50
HomerrrJay: folds 
waisanen: calls $1.50
*** FLOP *** [Ks 9h Ts]
waisanen: checks 
Dachish: checks 
*** TURN *** [Ks 9h Ts] [3h]
waisanen: bets $2
Dachish: folds 
Uncalled bet ($2) returned to waisanen
waisanen collected $5.25 from pot
*** SUMMARY ***
Total pot $5.50 | Rake $0.25 
Board [Ks 9h Ts 3h]
Seat 1: matiko09 folded before Flop (didn't bet)
Seat 2: Venomous100% folded before Flop (didn't bet)
Seat 3: sebaaastian folded before Flop (didn't bet)
Seat 4: hammerwife folded before Flop (didn't bet)
Seat 5: Ilov3NBA folded before Flop (didn't bet)
Seat 6: Dachish (button) folded on the Turn
Seat 7: HomerrrJay (small blind) folded before Flop
Seat 9: waisanen (big blind) collected ($5.25)





PokerStars Hand #149394755070:  Hold'em No Limit ($0.50/$1.00 USD) - 2016/02/25 17:39:17 CET [2016/02/25 11:39:17 ET]
Table 'Ebella II' 9-max Seat #8 is the button
Seat 1: Dachish ($70 in chips) 
Seat 3: fanmtZ ($42.32 in chips) 
Seat 4: xAndorx ($112.49 in chips) 
Seat 5: matiko09 ($107.34 in chips) 
Seat 6: gabi_igna ($100 in chips) 
Seat 7: $-Twackle-$ ($100 in chips) 
Seat 8: ZMPOUTSAM140 ($187.30 in chips) 
Seat 9: simoniustin ($100 in chips) 
simoniustin: posts small blind $0.50
Dachish: posts big blind $1
*** HOLE CARDS ***
Dealt to matiko09 [As Kd]
fanmtZ: folds 
xAndorx: raises $2 to $3
matiko09: calls $3
gabi_igna: raises $8 to $11
$-Twackle-$: folds 
ZMPOUTSAM140: folds 
simoniustin: folds 
Dachish: folds 
xAndorx: calls $8
matiko09: raises $21 to $32
gabi_igna: raises $68 to $100 and is all-in
ZMPOUTSAM140 leaves the table
xAndorx: folds 
matiko09: calls $68
*** FLOP *** [6d 3h Kc]
*** TURN *** [6d 3h Kc] [7s]
*** RIVER *** [6d 3h Kc 7s] [Qc]
*** SHOW DOWN ***
matiko09: shows [As Kd] (a pair of Kings)
gabi_igna: shows [Ad Ks] (a pair of Kings)
matiko09 collected $104.85 from pot
gabi_igna collected $104.85 from pot
*** SUMMARY ***
Total pot $212.50 | Rake $2.80 
Board [6d 3h Kc 7s Qc]
Seat 1: Dachish (big blind) folded before Flop
Seat 3: fanmtZ folded before Flop (didn't bet)
Seat 4: xAndorx folded before Flop
Seat 5: matiko09 showed [As Kd] and won ($104.85) with a pair of Kings
Seat 6: gabi_igna showed [Ad Ks] and won ($104.85) with a pair of Kings
Seat 7: $-Twackle-$ folded before Flop (didn't bet)
Seat 8: ZMPOUTSAM140 (button) folded before Flop (didn't bet)
Seat 9: simoniustin (small blind) folded before Flop





PokerStars Hand #149394761014:  Hold'em No Limit ($0.50/$1.00 USD) - 2016/02/25 17:39:24 CET [2016/02/25 11:39:24 ET]
Table 'Nerthus II' 9-max Seat #4 is the button
Seat 2: matiko09 ($220.18 in chips) 
Seat 3: simoniustin ($107.37 in chips) 
Seat 4: Ilov3NBA ($104.12 in chips) 
Seat 6: mycka86 ($141.88 in chips) 
Seat 7: Venomous100% ($108.65 in chips) 
Seat 8: Kelvin sai ($39.38 in chips) 
Seat 9: hammerwife ($100 in chips) 
mycka86: posts small blind $0.50
Venomous100%: posts big blind $1
volwebni4ek: sits out 
*** HOLE CARDS ***
Dealt to matiko09 [4c 8s]
Kelvin sai: raises $1 to $2
hammerwife: folds 
matiko09: folds 
simoniustin: calls $2
Ilov3NBA: calls $2
mycka86: folds 
Venomous100%: folds 
*** FLOP *** [3h Jd Th]
Kelvin sai: checks 
simoniustin: bets $5
Ilov3NBA: calls $5
Kelvin sai: calls $5
*** TURN *** [3h Jd Th] [Ks]
Kelvin sai: checks 
simoniustin: bets $18
Ilov3NBA: folds 
Kelvin sai: folds 
Uncalled bet ($18) returned to simoniustin
simoniustin collected $21.49 from pot
simoniustin: doesn't show hand 
*** SUMMARY ***
Total pot $22.50 | Rake $1.01 
Board [3h Jd Th Ks]
Seat 2: matiko09 folded before Flop (didn't bet)
Seat 3: simoniustin collected ($21.49)
Seat 4: Ilov3NBA (button) folded on the Turn
Seat 6: mycka86 (small blind) folded before Flop
Seat 7: Venomous100% (big blind) folded before Flop
Seat 8: Kelvin sai folded on the Turn
Seat 9: hammerwife folded before Flop (didn't bet)





PokerStars Hand #149394766547:  Hold'em No Limit ($0.50/$1.00 USD) - 2016/02/25 17:39:31 CET [2016/02/25 11:39:31 ET]
Table 'Sabine' 9-max Seat #4 is the button
Seat 2: apfush ($124.73 in chips) 
Seat 4: simoniustin ($107.12 in chips) 
Seat 6: gabi_igna ($102.30 in chips) 
Seat 8: matiko09 ($186.66 in chips) 
Seat 9: Dachish ($81.26 in chips) 
gabi_igna: posts small blind $0.50
matiko09: posts big blind $1
*** HOLE CARDS ***
Dealt to matiko09 [2c Kd]
Dachish: raises $2 to $3
apfush: folds 
simoniustin: folds 
gabi_igna: folds 
matiko09: folds 
Uncalled bet ($2) returned to Dachish
Dachish collected $2.50 from pot
Dachish: doesn't show hand 
*** SUMMARY ***
Total pot $2.50 | Rake $0 
Seat 2: apfush folded before Flop (didn't bet)
Seat 4: simoniustin (button) folded before Flop (didn't bet)
Seat 6: gabi_igna (small blind) folded before Flop
Seat 8: matiko09 (big blind) folded before Flop
Seat 9: Dachish collected ($2.50)





PokerStars Hand #149394769170:  Hold'em No Limit ($0.50/$1.00 USD) - 2016/02/25 17:39:34 CET [2016/02/25 11:39:34 ET]
Table 'Isa' 9-max Seat #8 is the button
Seat 1: matiko09 ($123.58 in chips) 
Seat 2: mycka86 ($160.81 in chips) 
Seat 3: sebaaastian ($137.25 in chips) 
Seat 4: hammerwife ($121.41 in chips) 
Seat 6: xAndorx ($104.40 in chips) 
Seat 7: bilukm ($98.40 in chips) 
Seat 8: Venomous100% ($104.24 in chips) 
matiko09: posts small blind $0.50
mycka86: posts big blind $1
*** HOLE CARDS ***
Dealt to matiko09 [Kc 3c]
sebaaastian: folds 
hammerwife: folds 
xAndorx: raises $2 to $3
bilukm: calls $3
volwebni4ek joins the table at seat #9 
Venomous100%: raises $14 to $17
matiko09: folds 
mycka86: folds 
xAndorx: folds 
bilukm: folds 
Uncalled bet ($14) returned to Venomous100%
Venomous100% collected $10.50 from pot
Venomous100%: doesn't show hand 
*** SUMMARY ***
Total pot $10.50 | Rake $0 
Seat 1: matiko09 (small blind) folded before Flop
Seat 2: mycka86 (big blind) folded before Flop
Seat 3: sebaaastian folded before Flop (didn't bet)
Seat 4: hammerwife folded before Flop (didn't bet)
Seat 6: xAndorx folded before Flop
Seat 7: bilukm folded before Flop
Seat 8: Venomous100% (button) collected ($10.50)





PokerStars Hand #149394770265:  Hold'em No Limit ($0.50/$1.00 USD) - 2016/02/25 17:39:35 CET [2016/02/25 11:39:35 ET]
Table 'Morosovia II' 9-max Seat #7 is the button
Seat 1: $-Twackle-$ ($100 in chips) 
Seat 2: Effort92 ($176.66 in chips) 
Seat 3: sebaaastian ($208 in chips) 
Seat 4: renechris ($86.22 in chips) 
Seat 5: gabi_igna ($143.57 in chips) 
Seat 6: Dachish ($70 in chips) 
Seat 7: matiko09 ($144.98 in chips) 
Seat 8: simoniustin ($118.09 in chips) 
Seat 9: lysandrafly ($120.94 in chips) 
simoniustin: posts small blind $0.50
lysandrafly: posts big blind $1
Dachish: posts big blind $1
*** HOLE CARDS ***
Dealt to matiko09 [6c Qc]
$-Twackle-$: folds 
Effort92: folds 
sebaaastian: folds 
renechris: folds 
gabi_igna: folds 
Dachish: checks 
matiko09: raises $2.50 to $3.50
simoniustin: folds 
lysandrafly: folds 
Dachish: folds 
Uncalled bet ($2.50) returned to matiko09
matiko09 collected $3.50 from pot
matiko09: doesn't show hand 
*** SUMMARY ***
Total pot $3.50 | Rake $0 
Seat 1: $-Twackle-$ folded before Flop (didn't bet)
Seat 2: Effort92 folded before Flop (didn't bet)
Seat 3: sebaaastian folded before Flop (didn't bet)
Seat 4: renechris folded before Flop (didn't bet)
Seat 5: gabi_igna folded before Flop (didn't bet)
Seat 6: Dachish folded before Flop
Seat 7: matiko09 (button) collected ($3.50)
Seat 8: simoniustin (small blind) folded before Flop
Seat 9: lysandrafly (big blind) folded before Flop





PokerStars Hand #149394771851:  Hold'em No Limit ($0.50/$1.00 USD) - 2016/02/25 17:39:37 CET [2016/02/25 11:39:37 ET]
Table 'Zeuxo II' 9-max Seat #6 is the button
Seat 1: forsmthgood ($105.04 in chips) 
Seat 3: xAndorx ($134.38 in chips) 
Seat 4: sebaaastian ($100 in chips) 
Seat 5: hammerwife ($101 in chips) 
Seat 6: Cogss ($102.01 in chips) 
Seat 7: Venomous100% ($100 in chips) 
Seat 8: matiko09 ($127.91 in chips) 
Seat 9: Sreshta222 ($306.13 in chips) 
Venomous100%: posts small blind $0.50
matiko09: posts big blind $1
*** HOLE CARDS ***
Dealt to matiko09 [6d Ks]
Sreshta222: folds 
forsmthgood: folds 
xAndorx: folds 
sebaaastian: folds 
hammerwife: folds 
Cogss: raises $1 to $2
Venomous100%: folds 
matiko09: folds 
Uncalled bet ($1) returned to Cogss
Cogss collected $2.50 from pot
*** SUMMARY ***
Total pot $2.50 | Rake $0 
Seat 1: forsmthgood folded before Flop (didn't bet)
Seat 3: xAndorx folded before Flop (didn't bet)
Seat 4: sebaaastian folded before Flop (didn't bet)
Seat 5: hammerwife folded before Flop (didn't bet)
Seat 6: Cogss (button) collected ($2.50)
Seat 7: Venomous100% (small blind) folded before Flop
Seat 8: matiko09 (big blind) folded before Flop
Seat 9: Sreshta222 folded before Flop (didn't bet)





PokerStars Hand #149394774602:  Hold'em No Limit ($0.50/$1.00 USD) - 2016/02/25 17:39:41 CET [2016/02/25 11:39:41 ET]
Table 'Zerbinetta II' 9-max Seat #2 is the button
Seat 1: $-Twackle-$ ($100 in chips) 
Seat 2: ffac ($100 in chips) 
Seat 3: matiko09 ($102.75 in chips) 
Seat 4: sebaaastian ($100 in chips) 
Seat 5: hammerwife ($119.77 in chips) 
Seat 7: HomerrrJay ($101.50 in chips) 
Seat 8: gabi_igna ($123.70 in chips) 
Seat 9: with-w ($30.96 in chips) 
matiko09: posts small blind $0.50
sebaaastian: posts big blind $1
simoniustin: sits out 
*** HOLE CARDS ***
Dealt to matiko09 [Js 4s]
hammerwife: folds 
HomerrrJay: folds 
gabi_igna: folds 
with-w: calls $1
$-Twackle-$: folds 
ffac: folds 
matiko09: folds 
sebaaastian: checks 
*** FLOP *** [Qc 8s 3s]
sebaaastian: checks 
with-w: bets $2
sebaaastian: calls $2
*** TURN *** [Qc 8s 3s] [5h]
sebaaastian: checks 
with-w: bets $5
sebaaastian: folds 
Uncalled bet ($5) returned to with-w
with-w collected $6.21 from pot
with-w: doesn't show hand 
*** SUMMARY ***
Total pot $6.50 | Rake $0.29 
Board [Qc 8s 3s 5h]
Seat 1: $-Twackle-$ folded before Flop (didn't bet)
Seat 2: ffac (button) folded before Flop (didn't bet)
Seat 3: matiko09 (small blind) folded before Flop
Seat 4: sebaaastian (big blind) folded on the Turn
Seat 5: hammerwife folded before Flop (didn't bet)
Seat 7: HomerrrJay folded before Flop (didn't bet)
Seat 8: gabi_igna folded before Flop (didn't bet)
Seat 9: with-w collected ($6.21)





PokerStars Hand #149394774425:  Hold'em No Limit ($0.25/$0.50 USD) - 2016/02/25 17:39:41 CET [2016/02/25 11:39:41 ET]
Table 'Lohja II' 9-max Seat #7 is the button
Seat 1: MoonJimmy ($162.58 in chips) 
Seat 2: mycka86 ($51.15 in chips) 
Seat 3: guvalc1952 ($230.78 in chips) 
Seat 4: payback11 ($50.30 in chips) 
Seat 6: xAndorx ($60.59 in chips) 
Seat 7: matiko09 ($93.07 in chips) 
Seat 9: Al3xAnd3r22 ($141.72 in chips) 
Al3xAnd3r22: posts small blind $0.25
MoonJimmy: posts big blind $0.50
MoonJimmy: posts the ante $0.10
mycka86: posts the ante $0.10
guvalc1952: posts the ante $0.10
payback11: posts the ante $0.10
xAndorx: posts the ante $0.10
matiko09: posts the ante $0.10
Al3xAnd3r22: posts the ante $0.10
*** HOLE CARDS ***
Dealt to matiko09 [3d As]
mycka86: folds 
guvalc1952: folds 
payback11: folds 
xAndorx: folds 
matiko09: raises $0.63 to $1.13
Al3xAnd3r22: folds 
MoonJimmy: folds 
Uncalled bet ($0.63) returned to matiko09
matiko09 collected $1.95 from pot
matiko09: doesn't show hand 
*** SUMMARY ***
Total pot $1.95 | Rake $0 
Seat 1: MoonJimmy (big blind) folded before Flop
Seat 2: mycka86 folded before Flop (didn't bet)
Seat 3: guvalc1952 folded before Flop (didn't bet)
Seat 4: payback11 folded before Flop (didn't bet)
Seat 6: xAndorx folded before Flop (didn't bet)
Seat 7: matiko09 (button) collected ($1.95)
Seat 9: Al3xAnd3r22 (small blind) folded before Flop





PokerStars Hand #149394783903:  Hold'em No Limit ($0.50/$1.00 USD) - 2016/02/25 17:39:52 CET [2016/02/25 11:39:52 ET]
Table 'Sabine' 9-max Seat #6 is the button
Seat 2: apfush ($124.73 in chips) 
Seat 4: simoniustin ($107.12 in chips) 
Seat 6: gabi_igna ($101.80 in chips) 
Seat 8: matiko09 ($185.66 in chips) 
Seat 9: Dachish ($82.76 in chips) 
matiko09: posts small blind $0.50
Dachish: posts big blind $1
*** HOLE CARDS ***
Dealt to matiko09 [Qh 4h]
apfush: raises $2 to $3
simoniustin: folds 
gabi_igna: folds 
matiko09: folds 
Dachish: folds 
Uncalled bet ($2) returned to apfush
apfush collected $2.50 from pot
apfush: doesn't show hand 
*** SUMMARY ***
Total pot $2.50 | Rake $0 
Seat 2: apfush collected ($2.50)
Seat 4: simoniustin folded before Flop (didn't bet)
Seat 6: gabi_igna (button) folded before Flop (didn't bet)
Seat 8: matiko09 (small blind) folded before Flop
Seat 9: Dachish (big blind) folded before Flop





PokerStars Hand #149394786126:  Hold'em No Limit ($0.50/$1.00 USD) - 2016/02/25 17:39:55 CET [2016/02/25 11:39:55 ET]
Table 'Mayall II' 9-max Seat #9 is the button
Seat 1: matiko09 ($112.91 in chips) 
Seat 3: simoniustin ($133.64 in chips) 
Seat 4: Ouga Buga ($104.67 in chips) 
Seat 5: McFussball81 ($55 in chips) 
Seat 6: apfush ($101.50 in chips) 
Seat 7: r.pol218 ($41.48 in chips) 
Seat 8: kuanhung0903 ($88.46 in chips) 
Seat 9: xAndorx ($131.84 in chips) 
matiko09: posts small blind $0.50
simoniustin: posts big blind $1
*** HOLE CARDS ***
Dealt to matiko09 [5c 9s]
Ouga Buga: folds 
McFussball81: calls $1
apfush: folds 
r.pol218: calls $1
kuanhung0903: folds 
xAndorx: folds 
matiko09: folds 
simoniustin: checks 
*** FLOP *** [3c 8d 7c]
simoniustin: checks 
McFussball81: checks 
r.pol218: checks 
*** TURN *** [3c 8d 7c] [As]
simoniustin: checks 
McFussball81: bets $3
r.pol218: folds 
simoniustin: calls $3
*** RIVER *** [3c 8d 7c As] [3s]
simoniustin: checks 
McFussball81: bets $6
simoniustin: folds 
Uncalled bet ($6) returned to McFussball81
McFussball81 collected $9.07 from pot
McFussball81: doesn't show hand 
*** SUMMARY ***
Total pot $9.50 | Rake $0.43 
Board [3c 8d 7c As 3s]
Seat 1: matiko09 (small blind) folded before Flop
Seat 3: simoniustin (big blind) folded on the River
Seat 4: Ouga Buga folded before Flop (didn't bet)
Seat 5: McFussball81 collected ($9.07)
Seat 6: apfush folded before Flop (didn't bet)
Seat 7: r.pol218 folded on the Turn
Seat 8: kuanhung0903 folded before Flop (didn't bet)
Seat 9: xAndorx (button) folded before Flop (didn't bet)





PokerStars Hand #149394791781:  Hold'em No Limit ($0.50/$1.00 USD) - 2016/02/25 17:40:02 CET [2016/02/25 11:40:02 ET]
Table 'Zeuxo II' 9-max Seat #7 is the button
Seat 1: forsmthgood ($105.04 in chips) 
Seat 3: xAndorx ($134.38 in chips) 
Seat 4: sebaaastian ($100 in chips) 
Seat 5: hammerwife ($101 in chips) 
Seat 6: Cogss ($103.51 in chips) 
Seat 7: Venomous100% ($100 in chips) 
Seat 8: matiko09 ($126.91 in chips) 
Seat 9: Sreshta222 ($306.13 in chips) 
matiko09: posts small blind $0.50
Sreshta222: posts big blind $1
*** HOLE CARDS ***
Dealt to matiko09 [Tc Jh]
forsmthgood: folds 
xAndorx: folds 
sebaaastian: folds 
hammerwife: folds 
Cogss: folds 
Venomous100%: raises $1 to $2
matiko09: folds 
Sreshta222: calls $1
*** FLOP *** [5c 2h Jc]
Sreshta222: checks 
Venomous100%: bets $3
Sreshta222: calls $3
*** TURN *** [5c 2h Jc] [7s]
Sreshta222: checks 
Venomous100%: checks 
*** RIVER *** [5c 2h Jc 7s] [Qc]
Sreshta222: checks 
Venomous100%: checks 
*** SHOW DOWN ***
Sreshta222: shows [4s Js] (a pair of Jacks)
Venomous100%: mucks hand 
Sreshta222 collected $10.03 from pot
*** SUMMARY ***
Total pot $10.50 | Rake $0.47 
Board [5c 2h Jc 7s Qc]
Seat 1: forsmthgood folded before Flop (didn't bet)
Seat 3: xAndorx folded before Flop (didn't bet)
Seat 4: sebaaastian folded before Flop (didn't bet)
Seat 5: hammerwife folded before Flop (didn't bet)
Seat 6: Cogss folded before Flop (didn't bet)
Seat 7: Venomous100% (button) mucked [Ah 4h]
Seat 8: matiko09 (small blind) folded before Flop
Seat 9: Sreshta222 (big blind) showed [4s Js] and won ($10.03) with a pair of Jacks





PokerStars Hand #149394791605:  Hold'em No Limit ($0.50/$1.00 USD) - 2016/02/25 17:40:02 CET [2016/02/25 11:40:02 ET]
Table 'Eurysaces II' 9-max Seat #9 is the button
Seat 1: lysandrafly ($109.58 in chips) 
Seat 2: sebaaastian ($102.28 in chips) 
Seat 4: gabi_igna ($110.75 in chips) 
Seat 5: keessie93 ($131.12 in chips) 
Seat 6: J0rmungund ($53.37 in chips) 
Seat 7: $-Twackle-$ ($100 in chips) 
Seat 8: hammerwife ($100 in chips) 
Seat 9: matiko09 ($100 in chips) 
lysandrafly: posts small blind $0.50
sebaaastian: posts big blind $1
Aalleekks: sits out 
*** HOLE CARDS ***
Dealt to matiko09 [4c Qh]
gabi_igna: folds 
keessie93: calls $1
J0rmungund: calls $1
$-Twackle-$: folds 
hammerwife: folds 
matiko09: folds 
lysandrafly: folds 
sebaaastian: checks 
*** FLOP *** [Ts 8h 3s]
sebaaastian: checks 
keessie93: checks 
J0rmungund: bets $1.67
sebaaastian: folds 
keessie93: folds 
Uncalled bet ($1.67) returned to J0rmungund
J0rmungund collected $3.34 from pot
*** SUMMARY ***
Total pot $3.50 | Rake $0.16 
Board [Ts 8h 3s]
Seat 1: lysandrafly (small blind) folded before Flop
Seat 2: sebaaastian (big blind) folded on the Flop
Seat 4: gabi_igna folded before Flop (didn't bet)
Seat 5: keessie93 folded on the Flop
Seat 6: J0rmungund collected ($3.34)
Seat 7: $-Twackle-$ folded before Flop (didn't bet)
Seat 8: hammerwife folded before Flop (didn't bet)
Seat 9: matiko09 (button) folded before Flop (didn't bet)





PokerStars Hand #149394797945:  Hold'em No Limit ($0.50/$1.00 USD) - 2016/02/25 17:40:10 CET [2016/02/25 11:40:10 ET]
Table 'Sabine' 9-max Seat #8 is the button
Seat 2: apfush ($126.23 in chips) 
Seat 4: simoniustin ($107.12 in chips) 
Seat 6: gabi_igna ($101.80 in chips) 
Seat 8: matiko09 ($185.16 in chips) 
Seat 9: Dachish ($81.76 in chips) 
Dachish: posts small blind $0.50
oscarleon joins the table at seat #3 
apfush: posts big blind $1
*** HOLE CARDS ***
Dealt to matiko09 [6s 7c]
simoniustin: folds 
gabi_igna: folds 
matiko09: folds 
Dachish: folds 
Uncalled bet ($0.50) returned to apfush
apfush collected $1 from pot
apfush: doesn't show hand 
*** SUMMARY ***
Total pot $1 | Rake $0 
Seat 2: apfush (big blind) collected ($1)
Seat 4: simoniustin folded before Flop (didn't bet)
Seat 6: gabi_igna folded before Flop (didn't bet)
Seat 8: matiko09 (button) folded before Flop (didn't bet)
Seat 9: Dachish (small blind) folded before Flop





PokerStars Hand #149394797688:  Hold'em No Limit ($0.25/$0.50 USD) - 2016/02/25 17:40:10 CET [2016/02/25 11:40:10 ET]
Table 'Lohja II' 9-max Seat #9 is the button
Seat 1: MoonJimmy ($161.98 in chips) 
Seat 2: mycka86 ($51.05 in chips) 
Seat 3: guvalc1952 ($230.68 in chips) 
Seat 4: payback11 ($50.20 in chips) 
Seat 6: xAndorx ($60.49 in chips) 
Seat 7: matiko09 ($94.42 in chips) 
Seat 9: Al3xAnd3r22 ($141.37 in chips) 
MoonJimmy: posts small blind $0.25
mycka86: posts big blind $0.50
MoonJimmy: posts the ante $0.10
mycka86: posts the ante $0.10
guvalc1952: posts the ante $0.10
payback11: posts the ante $0.10
xAndorx: posts the ante $0.10
matiko09: posts the ante $0.10
Al3xAnd3r22: posts the ante $0.10
*** HOLE CARDS ***
Dealt to matiko09 [Kc 8s]
guvalc1952: calls $0.50
payback11: folds 
xAndorx: raises $1.50 to $2
matiko09: folds 
Al3xAnd3r22: folds 
MoonJimmy: folds 
mycka86: folds 
guvalc1952: calls $1.50
*** FLOP *** [9c 4d 3c]
pasa132 joins the table at seat #8 
guvalc1952: checks 
xAndorx: checks 
*** TURN *** [9c 4d 3c] [Jc]
guvalc1952: bets $2.60
xAndorx: calls $2.60
*** RIVER *** [9c 4d 3c Jc] [2c]
guvalc1952: checks 
xAndorx: bets $7
guvalc1952: folds 
Uncalled bet ($7) returned to xAndorx
xAndorx collected $10.17 from pot
xAndorx: doesn't show hand 
*** SUMMARY ***
Total pot $10.65 | Rake $0.48 
Board [9c 4d 3c Jc 2c]
Seat 1: MoonJimmy (small blind) folded before Flop
Seat 2: mycka86 (big blind) folded before Flop
Seat 3: guvalc1952 folded on the River
Seat 4: payback11 folded before Flop (didn't bet)
Seat 6: xAndorx collected ($10.17)
Seat 7: matiko09 folded before Flop (didn't bet)
Seat 9: Al3xAnd3r22 (button) folded before Flop (didn't bet)





PokerStars Hand #149394803076:  Hold'em No Limit ($0.50/$1.00 USD) - 2016/02/25 17:40:16 CET [2016/02/25 11:40:16 ET]
Table 'Morosovia II' 9-max Seat #8 is the button
Seat 1: $-Twackle-$ ($100 in chips) 
Seat 2: Effort92 ($176.66 in chips) 
Seat 3: sebaaastian ($208 in chips) 
Seat 4: renechris ($86.22 in chips) 
Seat 5: gabi_igna ($143.57 in chips) 
Seat 6: Dachish ($69 in chips) 
Seat 7: matiko09 ($147.48 in chips) 
Seat 8: simoniustin ($117.59 in chips) 
Seat 9: lysandrafly ($119.94 in chips) 
lysandrafly: posts small blind $0.50
$-Twackle-$: posts big blind $1
*** HOLE CARDS ***
Dealt to matiko09 [Jc Ad]
Effort92: folds 
sebaaastian: folds 
renechris: folds 
gabi_igna: raises $2 to $3
Dachish: folds 
matiko09: folds 
simoniustin: folds 
lysandrafly: folds 
$-Twackle-$: folds 
Uncalled bet ($2) returned to gabi_igna
gabi_igna collected $2.50 from pot
gabi_igna: doesn't show hand 
*** SUMMARY ***
Total pot $2.50 | Rake $0 
Seat 1: $-Twackle-$ (big blind) folded before Flop
Seat 2: Effort92 folded before Flop (didn't bet)
Seat 3: sebaaastian folded before Flop (didn't bet)
Seat 4: renechris folded before Flop (didn't bet)
Seat 5: gabi_igna collected ($2.50)
Seat 6: Dachish folded before Flop (didn't bet)
Seat 7: matiko09 folded before Flop (didn't bet)
Seat 8: simoniustin (button) folded before Flop (didn't bet)
Seat 9: lysandrafly (small blind) folded before Flop





PokerStars Hand #149394806784:  Hold'em No Limit ($0.25/$0.50 USD) - 2016/02/25 17:40:21 CET [2016/02/25 11:40:21 ET]
Table 'Vladimir' 9-max Seat #1 is the button
Seat 1: matiko09 ($50.77 in chips) 
Seat 2: lysandrafly ($58.34 in chips) 
Seat 3: JustR82 ($51.55 in chips) 
Seat 4: ffac ($58.85 in chips) 
Seat 5: Al3xAnd3r22 ($54.33 in chips) 
Seat 6: ihami ($45 in chips) 
Seat 7: myllow1 ($49.93 in chips) 
Seat 9: earthensnake ($17.50 in chips) 
lysandrafly: posts small blind $0.25
JustR82: posts big blind $0.50
earthensnake: posts small & big blinds $0.75
*** HOLE CARDS ***
Dealt to matiko09 [3h Td]
ffac: folds 
Al3xAnd3r22: folds 
ihami has timed out
ihami: folds 
myllow1: folds 
earthensnake: raises $1 to $1.50
matiko09: folds 
lysandrafly: folds 
JustR82: folds 
Uncalled bet ($1) returned to earthensnake
earthensnake collected $1.50 from pot
earthensnake: doesn't show hand 
*** SUMMARY ***
Total pot $1.50 | Rake $0 
Seat 1: matiko09 (button) folded before Flop (didn't bet)
Seat 2: lysandrafly (small blind) folded before Flop
Seat 3: JustR82 (big blind) folded before Flop
Seat 4: ffac folded before Flop (didn't bet)
Seat 5: Al3xAnd3r22 folded before Flop (didn't bet)
Seat 6: ihami folded before Flop (didn't bet)
Seat 7: myllow1 folded before Flop (didn't bet)
Seat 9: earthensnake collected ($1.50)





PokerStars Hand #149394809660:  Hold'em No Limit ($0.50/$1.00 USD) - 2016/02/25 17:40:24 CET [2016/02/25 11:40:24 ET]
Table 'Isa' 9-max Seat #1 is the button
Seat 1: matiko09 ($123.08 in chips) 
Seat 2: mycka86 ($159.81 in chips) 
Seat 3: sebaaastian ($137.25 in chips) 
Seat 4: hammerwife ($121.41 in chips) 
Seat 6: xAndorx ($101.40 in chips) 
Seat 7: bilukm ($95.40 in chips) 
Seat 8: Venomous100% ($111.74 in chips) 
mycka86: posts small blind $0.50
sebaaastian: posts big blind $1
volwebni4ek: sits out 
*** HOLE CARDS ***
Dealt to matiko09 [4d 2s]
hammerwife: folds 
xAndorx: folds 
bilukm: folds 
Venomous100%: folds 
matiko09: folds 
mycka86: raises $1.75 to $2.75
sebaaastian: folds 
Uncalled bet ($1.75) returned to mycka86
mycka86 collected $2 from pot
*** SUMMARY ***
Total pot $2 | Rake $0 
Seat 1: matiko09 (button) folded before Flop (didn't bet)
Seat 2: mycka86 (small blind) collected ($2)
Seat 3: sebaaastian (big blind) folded before Flop
Seat 4: hammerwife folded before Flop (didn't bet)
Seat 6: xAndorx folded before Flop (didn't bet)
Seat 7: bilukm folded before Flop (didn't bet)
Seat 8: Venomous100% folded before Flop (didn't bet)





PokerStars Hand #149394816386:  Hold'em No Limit ($0.50/$1.00 USD) - 2016/02/25 17:40:33 CET [2016/02/25 11:40:33 ET]
Table 'Badenia II' 9-max Seat #7 is the button
Seat 1: matiko09 ($100 in chips) 
Seat 2: Venomous100% ($100 in chips) 
Seat 3: sebaaastian ($145 in chips) 
Seat 4: hammerwife ($103.62 in chips) 
Seat 5: Ilov3NBA ($102.78 in chips) 
Seat 6: Dachish ($70.08 in chips) 
Seat 7: HomerrrJay ($100 in chips) 
Seat 9: waisanen ($243.42 in chips) 
McFussball81 will be allowed to play after the button
waisanen: posts small blind $0.50
matiko09: posts big blind $1
*** HOLE CARDS ***
Dealt to matiko09 [4d Qc]
Venomous100%: folds 
sebaaastian: folds 
Venomous100% leaves the table
hammerwife: raises $1.50 to $2.50
Ilov3NBA: folds 
Dachish: folds 
HomerrrJay: folds 
waisanen: folds 
matiko09: folds 
Uncalled bet ($1.50) returned to hammerwife
hammerwife collected $2.50 from pot
hammerwife: doesn't show hand 
*** SUMMARY ***
Total pot $2.50 | Rake $0 
Seat 1: matiko09 (big blind) folded before Flop
Seat 2: Venomous100% folded before Flop (didn't bet)
Seat 3: sebaaastian folded before Flop (didn't bet)
Seat 4: hammerwife collected ($2.50)
Seat 5: Ilov3NBA folded before Flop (didn't bet)
Seat 6: Dachish folded before Flop (didn't bet)
Seat 7: HomerrrJay (button) folded before Flop (didn't bet)
Seat 9: waisanen (small blind) folded before Flop





PokerStars Hand #149394816941:  Hold'em No Limit ($0.50/$1.00 USD) - 2016/02/25 17:40:34 CET [2016/02/25 11:40:34 ET]
Table 'Sabine' 9-max Seat #9 is the button
Seat 2: apfush ($126.73 in chips) 
Seat 3: oscarleon ($100 in chips) 
Seat 4: simoniustin ($107.12 in chips) 
Seat 6: gabi_igna ($101.80 in chips) 
Seat 8: matiko09 ($185.16 in chips) 
Seat 9: Dachish ($81.26 in chips) 
apfush: posts small blind $0.50
oscarleon: posts big blind $1
*** HOLE CARDS ***
Dealt to matiko09 [Ks 9c]
lysandrafly leaves the table
simoniustin: folds 
gabi_igna: folds 
matiko09: folds 
Dachish: raises $1 to $2
apfush: folds 
oscarleon: folds 
Uncalled bet ($1) returned to Dachish
Dachish collected $2.50 from pot
Dachish: doesn't show hand 
*** SUMMARY ***
Total pot $2.50 | Rake $0 
Seat 2: apfush (small blind) folded before Flop
Seat 3: oscarleon (big blind) folded before Flop
Seat 4: simoniustin folded before Flop (didn't bet)
Seat 6: gabi_igna folded before Flop (didn't bet)
Seat 8: matiko09 folded before Flop (didn't bet)
Seat 9: Dachish (button) collected ($2.50)





PokerStars Hand #149394827498:  Hold'em No Limit ($0.50/$1.00 USD) - 2016/02/25 17:40:47 CET [2016/02/25 11:40:47 ET]
Table 'Zerbinetta II' 9-max Seat #3 is the button
Seat 1: $-Twackle-$ ($100 in chips) 
Seat 2: ffac ($100 in chips) 
Seat 3: matiko09 ($102.25 in chips) 
Seat 4: sebaaastian ($100 in chips) 
Seat 5: hammerwife ($119.77 in chips) 
Seat 7: HomerrrJay ($101.50 in chips) 
Seat 8: gabi_igna ($123.70 in chips) 
Seat 9: with-w ($34.17 in chips) 
sebaaastian: posts small blind $0.50
hammerwife: posts big blind $1
simoniustin: sits out 
*** HOLE CARDS ***
Dealt to matiko09 [Ad Th]
HomerrrJay: folds 
gabi_igna: folds 
with-w: raises $2 to $3
$-Twackle-$: folds 
ffac: folds 
matiko09: folds 
sebaaastian: folds 
hammerwife: folds 
Uncalled bet ($2) returned to with-w
with-w collected $2.50 from pot
with-w: doesn't show hand 
*** SUMMARY ***
Total pot $2.50 | Rake $0 
Seat 1: $-Twackle-$ folded before Flop (didn't bet)
Seat 2: ffac folded before Flop (didn't bet)
Seat 3: matiko09 (button) folded before Flop (didn't bet)
Seat 4: sebaaastian (small blind) folded before Flop
Seat 5: hammerwife (big blind) folded before Flop
Seat 7: HomerrrJay folded before Flop (didn't bet)
Seat 8: gabi_igna folded before Flop (didn't bet)
Seat 9: with-w collected ($2.50)





PokerStars Hand #149394828561:  Hold'em No Limit ($0.50/$1.00 USD) - 2016/02/25 17:40:48 CET [2016/02/25 11:40:48 ET]
Table 'Eurysaces II' 9-max Seat #1 is the button
Seat 1: lysandrafly ($109.08 in chips) 
Seat 2: sebaaastian ($101.28 in chips) 
Seat 3: Aalleekks ($100 in chips) 
Seat 4: gabi_igna ($110.75 in chips) 
Seat 5: keessie93 ($130.12 in chips) 
Seat 6: J0rmungund ($55.71 in chips) 
Seat 7: $-Twackle-$ ($100 in chips) 
Seat 8: hammerwife ($100 in chips) 
Seat 9: matiko09 ($100 in chips) 
sebaaastian: posts small blind $0.50
Aalleekks: posts big blind $1
*** HOLE CARDS ***
Dealt to matiko09 [8s Jc]
gabi_igna: folds 
keessie93: folds 
J0rmungund: calls $1
$-Twackle-$: folds 
hammerwife: raises $3 to $4
matiko09: folds 
lysandrafly: folds 
sebaaastian: raises $9 to $13
Aalleekks: folds 
J0rmungund: folds 
hammerwife: folds 
Uncalled bet ($9) returned to sebaaastian
sebaaastian collected $10 from pot
sebaaastian: doesn't show hand 
*** SUMMARY ***
Total pot $10 | Rake $0 
Seat 1: lysandrafly (button) folded before Flop (didn't bet)
Seat 2: sebaaastian (small blind) collected ($10)
Seat 3: Aalleekks (big blind) folded before Flop
Seat 4: gabi_igna folded before Flop (didn't bet)
Seat 5: keessie93 folded before Flop (didn't bet)
Seat 6: J0rmungund folded before Flop
Seat 7: $-Twackle-$ folded before Flop (didn't bet)
Seat 8: hammerwife folded before Flop
Seat 9: matiko09 folded before Flop (didn't bet)





PokerStars Hand #149394830039:  Hold'em No Limit ($0.50/$1.00 USD) - 2016/02/25 17:40:50 CET [2016/02/25 11:40:50 ET]
Table 'Isa' 9-max Seat #2 is the button
Seat 1: matiko09 ($123.08 in chips) 
Seat 2: mycka86 ($160.81 in chips) 
Seat 3: sebaaastian ($136.25 in chips) 
Seat 4: hammerwife ($121.41 in chips) 
Seat 6: xAndorx ($101.40 in chips) 
Seat 7: bilukm ($95.40 in chips) 
Seat 8: Venomous100% ($111.74 in chips) 
sebaaastian: posts small blind $0.50
hammerwife: posts big blind $1
volwebni4ek: sits out 
*** HOLE CARDS ***
Dealt to matiko09 [Ac Ts]
xAndorx: folds 
bilukm: raises $1 to $2
Venomous100%: folds 
matiko09: calls $2
mycka86: folds 
sebaaastian: folds 
hammerwife: calls $1
*** FLOP *** [2d 3h Qd]
hammerwife: bets $4.50
bilukm: calls $4.50
matiko09: folds 
*** TURN *** [2d 3h Qd] [2s]
hammerwife: checks 
bilukm: bets $7.40
hammerwife: calls $7.40
*** RIVER *** [2d 3h Qd 2s] [8c]
hammerwife: checks 
bilukm: checks 
*** SHOW DOWN ***
hammerwife: shows [Kd Qs] (two pair, Queens and Deuces)
bilukm: mucks hand 
hammerwife collected $28.94 from pot
*** SUMMARY ***
Total pot $30.30 | Rake $1.36 
Board [2d 3h Qd 2s 8c]
Seat 1: matiko09 folded on the Flop
Seat 2: mycka86 (button) folded before Flop (didn't bet)
Seat 3: sebaaastian (small blind) folded before Flop
Seat 4: hammerwife (big blind) showed [Kd Qs] and won ($28.94) with two pair, Queens and Deuces
Seat 6: xAndorx folded before Flop (didn't bet)
Seat 7: bilukm mucked [3d Ah]
Seat 8: Venomous100% folded before Flop (didn't bet)





PokerStars Hand #149394835862:  Hold'em No Limit ($0.50/$1.00 USD) - 2016/02/25 17:40:57 CET [2016/02/25 11:40:57 ET]
Table 'Zeuxo II' 9-max Seat #8 is the button
Seat 3: xAndorx ($134.38 in chips) 
Seat 4: sebaaastian ($100 in chips) 
Seat 5: hammerwife ($101 in chips) 
Seat 6: Cogss ($103.51 in chips) 
Seat 7: Venomous100% ($100 in chips) 
Seat 8: matiko09 ($126.41 in chips) 
Seat 9: Sreshta222 ($311.16 in chips) 
Sreshta222: posts small blind $0.50
forsmthgood: is sitting out 
Sweden_Pound was removed from the table for failing to post
xAndorx: posts big blind $1
*** HOLE CARDS ***
Dealt to matiko09 [Jh 3h]
forsmthgood leaves the table
Aalleekks joins the table at seat #1 
sebaaastian: folds 
hammerwife: folds 
Ilov3NBA joins the table at seat #2 
Cogss: folds 
Venomous100%: raises $1.50 to $2.50
matiko09: folds 
Sreshta222: folds 
xAndorx: folds 
Uncalled bet ($1.50) returned to Venomous100%
Venomous100% collected $2.50 from pot
Venomous100%: doesn't show hand 
*** SUMMARY ***
Total pot $2.50 | Rake $0 
Seat 3: xAndorx (big blind) folded before Flop
Seat 4: sebaaastian folded before Flop (didn't bet)
Seat 5: hammerwife folded before Flop (didn't bet)
Seat 6: Cogss folded before Flop (didn't bet)
Seat 7: Venomous100% collected ($2.50)
Seat 8: matiko09 (button) folded before Flop (didn't bet)
Seat 9: Sreshta222 (small blind) folded before Flop





PokerStars Hand #149394837534:  Hold'em No Limit ($0.50/$1.00 USD) - 2016/02/25 17:40:59 CET [2016/02/25 11:40:59 ET]
Table 'Nerthus II' 9-max Seat #6 is the button
Seat 2: matiko09 ($220.18 in chips) 
Seat 3: simoniustin ($121.86 in chips) 
Seat 4: Ilov3NBA ($100 in chips) 
Seat 6: mycka86 ($141.38 in chips) 
Seat 7: Venomous100% ($107.65 in chips) 
Seat 8: Kelvin sai ($32.38 in chips) 
Seat 9: hammerwife ($100 in chips) 
Venomous100%: posts small blind $0.50
Kelvin sai: posts big blind $1
volwebni4ek: sits out 
*** HOLE CARDS ***
Dealt to matiko09 [8c 8d]
hammerwife: folds 
matiko09: raises $2 to $3
simoniustin: folds 
Ilov3NBA: folds 
mycka86: folds 
Venomous100%: folds 
Kelvin sai: folds 
Uncalled bet ($2) returned to matiko09
matiko09 collected $2.50 from pot
matiko09: doesn't show hand 
*** SUMMARY ***
Total pot $2.50 | Rake $0 
Seat 2: matiko09 collected ($2.50)
Seat 3: simoniustin folded before Flop (didn't bet)
Seat 4: Ilov3NBA folded before Flop (didn't bet)
Seat 6: mycka86 (button) folded before Flop (didn't bet)
Seat 7: Venomous100% (small blind) folded before Flop
Seat 8: Kelvin sai (big blind) folded before Flop
Seat 9: hammerwife folded before Flop (didn't bet)





PokerStars Hand #149394837310:  Hold'em No Limit ($0.50/$1.00 USD) - 2016/02/25 17:40:59 CET [2016/02/25 11:40:59 ET]
Table 'Badenia II' 9-max Seat #9 is the button
Seat 1: matiko09 ($100 in chips) 
Seat 3: sebaaastian ($145 in chips) 
Seat 4: hammerwife ($105.12 in chips) 
Seat 5: Ilov3NBA ($102.78 in chips) 
Seat 6: Dachish ($70.08 in chips) 
Seat 7: HomerrrJay ($100 in chips) 
Seat 8: McFussball81 ($60.54 in chips) 
Seat 9: waisanen ($242.92 in chips) 
matiko09: posts small blind $0.50
sebaaastian: posts big blind $1
McFussball81: posts big blind $1
*** HOLE CARDS ***
Dealt to matiko09 [Jh Qc]
hammerwife: folds 
Ilov3NBA: folds 
Dachish: folds 
HomerrrJay: folds 
McFussball81: checks 
$-Twackle-$ joins the table at seat #2 
waisanen: folds 
matiko09: raises $4 to $5
sebaaastian: raises $9 to $14
McFussball81: folds 
matiko09: folds 
Uncalled bet ($9) returned to sebaaastian
sebaaastian collected $11 from pot
sebaaastian: doesn't show hand 
*** SUMMARY ***
Total pot $11 | Rake $0 
Seat 1: matiko09 (small blind) folded before Flop
Seat 3: sebaaastian (big blind) collected ($11)
Seat 4: hammerwife folded before Flop (didn't bet)
Seat 5: Ilov3NBA folded before Flop (didn't bet)
Seat 6: Dachish folded before Flop (didn't bet)
Seat 7: HomerrrJay folded before Flop (didn't bet)
Seat 8: McFussball81 folded before Flop
Seat 9: waisanen (button) folded before Flop (didn't bet)





PokerStars Hand #149394840536:  Hold'em No Limit ($0.50/$1.00 USD) - 2016/02/25 17:41:03 CET [2016/02/25 11:41:03 ET]
Table 'Sabine' 9-max Seat #2 is the button
Seat 2: apfush ($126.23 in chips) 
Seat 3: oscarleon ($100 in chips) 
Seat 4: simoniustin ($107.12 in chips) 
Seat 6: gabi_igna ($101.80 in chips) 
Seat 8: matiko09 ($185.16 in chips) 
Seat 9: Dachish ($82.76 in chips) 
oscarleon: posts small blind $0.50
simoniustin: posts big blind $1
*** HOLE CARDS ***
Dealt to matiko09 [Ad 6h]
gabi_igna: folds 
matiko09: folds 
Dachish: folds 
apfush: raises $1.20 to $2.20
oscarleon: folds 
simoniustin: raises $7.80 to $10
apfush: folds 
Uncalled bet ($7.80) returned to simoniustin
simoniustin collected $4.90 from pot
simoniustin: doesn't show hand 
*** SUMMARY ***
Total pot $4.90 | Rake $0 
Seat 2: apfush (button) folded before Flop
Seat 3: oscarleon (small blind) folded before Flop
Seat 4: simoniustin (big blind) collected ($4.90)
Seat 6: gabi_igna folded before Flop (didn't bet)
Seat 8: matiko09 folded before Flop (didn't bet)
Seat 9: Dachish folded before Flop (didn't bet)





PokerStars Hand #149394840719:  Hold'em No Limit ($0.25/$0.50 USD) - 2016/02/25 17:41:03 CET [2016/02/25 11:41:03 ET]
Table 'Vladimir' 9-max Seat #2 is the button
Seat 1: matiko09 ($50.77 in chips) 
Seat 2: lysandrafly ($58.09 in chips) 
Seat 3: JustR82 ($51.05 in chips) 
Seat 5: Al3xAnd3r22 ($54.33 in chips) 
Seat 6: ihami ($45 in chips) 
Seat 7: myllow1 ($49.93 in chips) 
Seat 9: earthensnake ($18.25 in chips) 
JustR82: posts small blind $0.25
ffac: is sitting out 
Al3xAnd3r22: posts big blind $0.50
*** HOLE CARDS ***
Dealt to matiko09 [Kc 8h]
ihami: folds 
myllow1: raises $1 to $1.50
earthensnake: calls $1.50
matiko09: folds 
lysandrafly: folds 
JustR82: folds 
Al3xAnd3r22: folds 
*** FLOP *** [Ks 5d Js]
myllow1: bets $1.50
earthensnake: raises $1.50 to $3
myllow1: calls $1.50
*** TURN *** [Ks 5d Js] [4c]
myllow1: checks 
earthensnake: bets $5.50
myllow1: raises $5.50 to $11
earthensnake: raises $2.75 to $13.75 and is all-in
myllow1: calls $2.75
*** RIVER *** [Ks 5d Js 4c] [3c]
*** SHOW DOWN ***
myllow1: shows [As Ah] (a pair of Aces)
earthensnake: shows [Kh Qc] (a pair of Kings)
myllow1 collected $35.57 from pot
*** SUMMARY ***
Total pot $37.25 | Rake $1.68 
Board [Ks 5d Js 4c 3c]
Seat 1: matiko09 folded before Flop (didn't bet)
Seat 2: lysandrafly (button) folded before Flop (didn't bet)
Seat 3: JustR82 (small blind) folded before Flop
Seat 5: Al3xAnd3r22 (big blind) folded before Flop
Seat 6: ihami folded before Flop (didn't bet)
Seat 7: myllow1 showed [As Ah] and won ($35.57) with a pair of Aces
Seat 9: earthensnake showed [Kh Qc] and lost with a pair of Kings





PokerStars Hand #149394847860:  Hold'em No Limit ($0.25/$0.50 USD) - 2016/02/25 17:41:12 CET [2016/02/25 11:41:12 ET]
Table 'Lohja II' 9-max Seat #1 is the button
Seat 1: MoonJimmy ($161.63 in chips) 
Seat 2: mycka86 ($50.45 in chips) 
Seat 3: guvalc1952 ($225.98 in chips) 
Seat 4: payback11 ($50.10 in chips) 
Seat 6: xAndorx ($65.96 in chips) 
Seat 7: matiko09 ($94.32 in chips) 
Seat 9: Al3xAnd3r22 ($141.27 in chips) 
mycka86: posts small blind $0.25
guvalc1952: posts big blind $0.50
pasa132: sits out 
MoonJimmy: posts the ante $0.10
mycka86: posts the ante $0.10
guvalc1952: posts the ante $0.10
payback11: posts the ante $0.10
xAndorx: posts the ante $0.10
matiko09: posts the ante $0.10
Al3xAnd3r22: posts the ante $0.10
*** HOLE CARDS ***
Dealt to matiko09 [5s Qd]
payback11: folds 
xAndorx: folds 
matiko09: folds 
Al3xAnd3r22: folds 
MoonJimmy: raises $1 to $1.50
mycka86: folds 
guvalc1952: calls $1
*** FLOP *** [Tc Ks 6s]
guvalc1952: checks 
MoonJimmy: bets $1.50
guvalc1952: folds 
Uncalled bet ($1.50) returned to MoonJimmy
MoonJimmy collected $3.77 from pot
MoonJimmy: doesn't show hand 
*** SUMMARY ***
Total pot $3.95 | Rake $0.18 
Board [Tc Ks 6s]
Seat 1: MoonJimmy (button) collected ($3.77)
Seat 2: mycka86 (small blind) folded before Flop
Seat 3: guvalc1952 (big blind) folded on the Flop
Seat 4: payback11 folded before Flop (didn't bet)
Seat 6: xAndorx folded before Flop (didn't bet)
Seat 7: matiko09 folded before Flop (didn't bet)
Seat 9: Al3xAnd3r22 folded before Flop (didn't bet)





PokerStars Hand #149394848420:  Hold'em No Limit ($0.50/$1.00 USD) - 2016/02/25 17:41:13 CET [2016/02/25 11:41:13 ET]
Table 'Mayall II' 9-max Seat #1 is the button
Seat 1: matiko09 ($112.41 in chips) 
Seat 3: simoniustin ($129.64 in chips) 
Seat 5: McFussball81 ($60.07 in chips) 
Seat 6: apfush ($101.50 in chips) 
Seat 7: r.pol218 ($40.48 in chips) 
Seat 8: kuanhung0903 ($88.46 in chips) 
Seat 9: xAndorx ($131.84 in chips) 
simoniustin: posts small blind $0.50
Ouga Buga: is sitting out 
Ouga Buga leaves the table
McFussball81: posts big blind $1
*** HOLE CARDS ***
Dealt to matiko09 [2d Kc]
apfush: folds 
r.pol218: folds 
kuanhung0903: folds 
xAndorx: folds 
matiko09: folds 
C. Duke 19 joins the table at seat #4 
simoniustin: folds 
Uncalled bet ($0.50) returned to McFussball81
McFussball81 collected $1 from pot
McFussball81: doesn't show hand 
*** SUMMARY ***
Total pot $1 | Rake $0 
Seat 1: matiko09 (button) folded before Flop (didn't bet)
Seat 3: simoniustin (small blind) folded before Flop
Seat 5: McFussball81 (big blind) collected ($1)
Seat 6: apfush folded before Flop (didn't bet)
Seat 7: r.pol218 folded before Flop (didn't bet)
Seat 8: kuanhung0903 folded before Flop (didn't bet)
Seat 9: xAndorx folded before Flop (didn't bet)





PokerStars Hand #149394852180:  Hold'em No Limit ($0.50/$1.00 USD) - 2016/02/25 17:41:17 CET [2016/02/25 11:41:17 ET]
Table 'Morosovia II' 9-max Seat #9 is the button
Seat 1: $-Twackle-$ ($100 in chips) 
Seat 3: sebaaastian ($208 in chips) 
Seat 4: renechris ($86.22 in chips) 
Seat 5: gabi_igna ($145.07 in chips) 
Seat 6: Dachish ($69 in chips) 
Seat 7: matiko09 ($147.48 in chips) 
Seat 8: simoniustin ($117.59 in chips) 
Seat 9: lysandrafly ($119.44 in chips) 
$-Twackle-$: posts small blind $0.50
Effort92: is sitting out 
sebaaastian: posts big blind $1
*** HOLE CARDS ***
Dealt to matiko09 [Jh Qd]
renechris: calls $1
gabi_igna: raises $3 to $4
Dachish: folds 
matiko09: folds 
simoniustin: folds 
lysandrafly: folds 
$-Twackle-$: folds 
sebaaastian: folds 
renechris: calls $3
*** FLOP *** [8s 2s 4s]
renechris: checks 
gabi_igna: bets $5
renechris: folds 
Uncalled bet ($5) returned to gabi_igna
gabi_igna collected $9.07 from pot
gabi_igna: doesn't show hand 
*** SUMMARY ***
Total pot $9.50 | Rake $0.43 
Board [8s 2s 4s]
Seat 1: $-Twackle-$ (small blind) folded before Flop
Seat 3: sebaaastian (big blind) folded before Flop
Seat 4: renechris folded on the Flop
Seat 5: gabi_igna collected ($9.07)
Seat 6: Dachish folded before Flop (didn't bet)
Seat 7: matiko09 folded before Flop (didn't bet)
Seat 8: simoniustin folded before Flop (didn't bet)
Seat 9: lysandrafly (button) folded before Flop (didn't bet)





PokerStars Hand #149394859690:  Hold'em No Limit ($0.50/$1.00 USD) - 2016/02/25 17:41:27 CET [2016/02/25 11:41:27 ET]
Table 'Nerthus II' 9-max Seat #7 is the button
Seat 2: matiko09 ($221.68 in chips) 
Seat 3: simoniustin ($121.86 in chips) 
Seat 4: Ilov3NBA ($100 in chips) 
Seat 6: mycka86 ($141.38 in chips) 
Seat 7: Venomous100% ($107.15 in chips) 
Seat 8: Kelvin sai ($31.38 in chips) 
Seat 9: hammerwife ($100 in chips) 
Kelvin sai: posts small blind $0.50
hammerwife: posts big blind $1
volwebni4ek: sits out 
*** HOLE CARDS ***
Dealt to matiko09 [Ks Qh]
matiko09: raises $2 to $3
simoniustin: folds 
Ilov3NBA: raises $6 to $9
mycka86: folds 
Venomous100%: folds 
Kelvin sai: folds 
hammerwife: folds 
matiko09: folds 
Uncalled bet ($6) returned to Ilov3NBA
Ilov3NBA collected $7.50 from pot
Ilov3NBA: doesn't show hand 
*** SUMMARY ***
Total pot $7.50 | Rake $0 
Seat 2: matiko09 folded before Flop
Seat 3: simoniustin folded before Flop (didn't bet)
Seat 4: Ilov3NBA collected ($7.50)
Seat 6: mycka86 folded before Flop (didn't bet)
Seat 7: Venomous100% (button) folded before Flop (didn't bet)
Seat 8: Kelvin sai (small blind) folded before Flop
Seat 9: hammerwife (big blind) folded before Flop





PokerStars Hand #149394866296:  Hold'em No Limit ($0.50/$1.00 USD) - 2016/02/25 17:41:35 CET [2016/02/25 11:41:35 ET]
Table 'Zeuxo II' 9-max Seat #9 is the button
Seat 3: xAndorx ($133.38 in chips) 
Seat 4: sebaaastian ($100 in chips) 
Seat 5: hammerwife ($101 in chips) 
Seat 6: Cogss ($103.51 in chips) 
Seat 7: Venomous100% ($101.50 in chips) 
Seat 8: matiko09 ($126.41 in chips) 
Seat 9: Sreshta222 ($310.66 in chips) 
Aalleekks will be allowed to play after the button
Ilov3NBA will be allowed to play after the button
xAndorx: posts small blind $0.50
sebaaastian: posts big blind $1
*** HOLE CARDS ***
Dealt to matiko09 [8h 8c]
hammerwife: raises $2 to $3
Cogss: calls $3
Venomous100%: folds 
matiko09: calls $3
Sreshta222: folds 
xAndorx: folds 
sebaaastian: calls $2
*** FLOP *** [Td 8s Qd]
sebaaastian: checks 
hammerwife: checks 
Cogss: bets $11.94
matiko09: raises $15.06 to $27
sebaaastian: folds 
hammerwife: folds 
Cogss: calls $15.06
*** TURN *** [Td 8s Qd] [4h]
Cogss: checks 
matiko09: bets $40
Cogss: raises $33.51 to $73.51 and is all-in
matiko09: calls $33.51
*** RIVER *** [Td 8s Qd 4h] [Ac]
*** SHOW DOWN ***
Cogss: shows [Qs Ah] (two pair, Aces and Queens)
matiko09: shows [8h 8c] (three of a kind, Eights)
matiko09 collected $210.72 from pot
*** SUMMARY ***
Total pot $213.52 | Rake $2.80 
Board [Td 8s Qd 4h Ac]
Seat 3: xAndorx (small blind) folded before Flop
Seat 4: sebaaastian (big blind) folded on the Flop
Seat 5: hammerwife folded on the Flop
Seat 6: Cogss showed [Qs Ah] and lost with two pair, Aces and Queens
Seat 7: Venomous100% folded before Flop (didn't bet)
Seat 8: matiko09 showed [8h 8c] and won ($210.72) with three of a kind, Eights
Seat 9: Sreshta222 (button) folded before Flop (didn't bet)





PokerStars Hand #149394869536:  Hold'em No Limit ($0.50/$1.00 USD) - 2016/02/25 17:41:39 CET [2016/02/25 11:41:39 ET]
Table 'Sabine' 9-max Seat #3 is the button
Seat 2: apfush ($124.03 in chips) 
Seat 3: oscarleon ($100 in chips) 
Seat 4: simoniustin ($109.82 in chips) 
Seat 8: matiko09 ($185.16 in chips) 
Seat 9: Dachish ($82.76 in chips) 
simoniustin: posts small blind $0.50
gabi_igna: is sitting out 
matiko09: posts big blind $1
*** HOLE CARDS ***
Dealt to matiko09 [5d Qc]
Dachish: raises $1.50 to $2.50
gabi_igna leaves the table
apfush: folds 
oscarleon: folds 
simoniustin: folds 
matiko09: folds 
Uncalled bet ($1.50) returned to Dachish
Dachish collected $2.50 from pot
Dachish: doesn't show hand 
*** SUMMARY ***
Total pot $2.50 | Rake $0 
Seat 2: apfush folded before Flop (didn't bet)
Seat 3: oscarleon (button) folded before Flop (didn't bet)
Seat 4: simoniustin (small blind) folded before Flop
Seat 8: matiko09 (big blind) folded before Flop
Seat 9: Dachish collected ($2.50)





PokerStars Hand #149394872122:  Hold'em No Limit ($0.50/$1.00 USD) - 2016/02/25 17:41:42 CET [2016/02/25 11:41:42 ET]
Table 'Badenia II' 9-max Seat #1 is the button
Seat 1: matiko09 ($100 in chips) 
Seat 3: sebaaastian ($151 in chips) 
Seat 4: hammerwife ($105.12 in chips) 
Seat 5: Ilov3NBA ($102.78 in chips) 
Seat 6: Dachish ($70.08 in chips) 
Seat 7: HomerrrJay ($100 in chips) 
Seat 8: McFussball81 ($59.54 in chips) 
Seat 9: waisanen ($242.92 in chips) 
$-Twackle-$ will be allowed to play after the button
sebaaastian: posts small blind $0.50
hammerwife: posts big blind $1
*** HOLE CARDS ***
Dealt to matiko09 [Td 2c]
Ilov3NBA: folds 
Dachish: folds 
HomerrrJay: raises $2 to $3
McFussball81: folds 
waisanen: folds 
matiko09: folds 
sebaaastian: folds 
hammerwife: folds 
Uncalled bet ($2) returned to HomerrrJay
HomerrrJay collected $2.50 from pot
HomerrrJay: doesn't show hand 
*** SUMMARY ***
Total pot $2.50 | Rake $0 
Seat 1: matiko09 (button) folded before Flop (didn't bet)
Seat 3: sebaaastian (small blind) folded before Flop
Seat 4: hammerwife (big blind) folded before Flop
Seat 5: Ilov3NBA folded before Flop (didn't bet)
Seat 6: Dachish folded before Flop (didn't bet)
Seat 7: HomerrrJay collected ($2.50)
Seat 8: McFussball81 folded before Flop (didn't bet)
Seat 9: waisanen folded before Flop (didn't bet)





PokerStars Hand #149394879544:  Hold'em No Limit ($0.50/$1.00 USD) - 2016/02/25 17:41:51 CET [2016/02/25 11:41:51 ET]
Table 'Mayall II' 9-max Seat #3 is the button
Seat 1: matiko09 ($112.41 in chips) 
Seat 3: simoniustin ($129.14 in chips) 
Seat 5: McFussball81 ($60.57 in chips) 
Seat 6: apfush ($101.50 in chips) 
Seat 7: r.pol218 ($40.48 in chips) 
Seat 8: kuanhung0903 ($88.46 in chips) 
Seat 9: xAndorx ($131.84 in chips) 
C. Duke 19 will be allowed to play after the button
McFussball81: posts small blind $0.50
apfush: posts big blind $1
*** HOLE CARDS ***
Dealt to matiko09 [Kd Ks]
r.pol218: folds 
kuanhung0903: calls $1
xAndorx: folds 
matiko09: raises $3 to $4
simoniustin: folds 
McFussball81: folds 
apfush: folds 
kuanhung0903: calls $3
*** FLOP *** [Qc Jc 4h]
kuanhung0903: bets $6
matiko09: calls $6
*** TURN *** [Qc Jc 4h] [Js]
kuanhung0903: checks 
matiko09: bets $12
kuanhung0903: folds 
Uncalled bet ($12) returned to matiko09
matiko09 collected $20.53 from pot
matiko09: doesn't show hand 
*** SUMMARY ***
Total pot $21.50 | Rake $0.97 
Board [Qc Jc 4h Js]
Seat 1: matiko09 collected ($20.53)
Seat 3: simoniustin (button) folded before Flop (didn't bet)
Seat 5: McFussball81 (small blind) folded before Flop
Seat 6: apfush (big blind) folded before Flop
Seat 7: r.pol218 folded before Flop (didn't bet)
Seat 8: kuanhung0903 folded on the Turn
Seat 9: xAndorx folded before Flop (didn't bet)





PokerStars Hand #149394879594:  Hold'em No Limit ($0.50/$1.00 USD) - 2016/02/25 17:41:51 CET [2016/02/25 11:41:51 ET]
Table 'Zerbinetta II' 9-max Seat #4 is the button
Seat 1: $-Twackle-$ ($100 in chips) 
Seat 2: ffac ($100 in chips) 
Seat 3: matiko09 ($102.25 in chips) 
Seat 4: sebaaastian ($100 in chips) 
Seat 5: hammerwife ($118.77 in chips) 
Seat 6: simoniustin ($100 in chips) 
Seat 7: HomerrrJay ($101.50 in chips) 
Seat 8: gabi_igna ($123.70 in chips) 
Seat 9: with-w ($35.67 in chips) 
hammerwife: posts small blind $0.50
simoniustin: posts big blind $1
*** HOLE CARDS ***
Dealt to matiko09 [Kh 9h]
HomerrrJay: raises $1.50 to $2.50
gabi_igna: folds 
with-w: folds 
$-Twackle-$: folds 
ffac: folds 
matiko09: folds 
sebaaastian: folds 
hammerwife: folds 
simoniustin: folds 
Uncalled bet ($1.50) returned to HomerrrJay
HomerrrJay collected $2.50 from pot
HomerrrJay: doesn't show hand 
*** SUMMARY ***
Total pot $2.50 | Rake $0 
Seat 1: $-Twackle-$ folded before Flop (didn't bet)
Seat 2: ffac folded before Flop (didn't bet)
Seat 3: matiko09 folded before Flop (didn't bet)
Seat 4: sebaaastian (button) folded before Flop (didn't bet)
Seat 5: hammerwife (small blind) folded before Flop
Seat 6: simoniustin (big blind) folded before Flop
Seat 7: HomerrrJay collected ($2.50)
Seat 8: gabi_igna folded before Flop (didn't bet)
Seat 9: with-w folded before Flop (didn't bet)





PokerStars Hand #149394883746:  Hold'em No Limit ($0.50/$1.00 USD) - 2016/02/25 17:41:56 CET [2016/02/25 11:41:56 ET]
Table 'Sabine' 9-max Seat #4 is the button
Seat 2: apfush ($124.03 in chips) 
Seat 3: oscarleon ($100 in chips) 
Seat 4: simoniustin ($109.32 in chips) 
Seat 8: matiko09 ($184.16 in chips) 
Seat 9: Dachish ($84.26 in chips) 
matiko09: posts small blind $0.50
Dachish: posts big blind $1
*** HOLE CARDS ***
Dealt to matiko09 [4d Jc]
MGMmacca joins the table at seat #1 
apfush: folds 
oscarleon: raises $2 to $3
simoniustin: raises $7 to $10
matiko09: folds 
Dachish: folds 
oscarleon: calls $7
*** FLOP *** [3d 6h 9d]
oscarleon: checks 
simoniustin: bets $12
oscarleon: raises $13 to $25
simoniustin: folds 
Uncalled bet ($13) returned to oscarleon
oscarleon collected $43.45 from pot
oscarleon: doesn't show hand 
*** SUMMARY ***
Total pot $45.50 | Rake $2.05 
Board [3d 6h 9d]
Seat 2: apfush folded before Flop (didn't bet)
Seat 3: oscarleon collected ($43.45)
Seat 4: simoniustin (button) folded on the Flop
Seat 8: matiko09 (small blind) folded before Flop
Seat 9: Dachish (big blind) folded before Flop





PokerStars Hand #149394897772:  Hold'em No Limit ($0.25/$0.50 USD) - 2016/02/25 17:42:13 CET [2016/02/25 11:42:13 ET]
Table 'Lohja II' 9-max Seat #2 is the button
Seat 1: MoonJimmy ($163.80 in chips) 
Seat 2: mycka86 ($50.10 in chips) 
Seat 3: guvalc1952 ($224.38 in chips) 
Seat 4: payback11 ($50 in chips) 
Seat 6: xAndorx ($65.86 in chips) 
Seat 7: matiko09 ($94.22 in chips) 
Seat 9: Al3xAnd3r22 ($141.17 in chips) 
guvalc1952: posts small blind $0.25
payback11: posts big blind $0.50
pasa132: sits out 
MoonJimmy: posts the ante $0.10
mycka86: posts the ante $0.10
guvalc1952: posts the ante $0.10
payback11: posts the ante $0.10
xAndorx: posts the ante $0.10
matiko09: posts the ante $0.10
Al3xAnd3r22: posts the ante $0.10
*** HOLE CARDS ***
Dealt to matiko09 [2c 2d]
xAndorx: folds 
matiko09: raises $1 to $1.50
Al3xAnd3r22: folds 
MoonJimmy: folds 
mycka86: folds 
guvalc1952: raises $1 to $2.50
payback11: folds 
matiko09: calls $1
*** FLOP *** [6h 9h As]
guvalc1952: bets $5.92
matiko09: folds 
Uncalled bet ($5.92) returned to guvalc1952
guvalc1952 collected $5.92 from pot
guvalc1952: doesn't show hand 
*** SUMMARY ***
Total pot $6.20 | Rake $0.28 
Board [6h 9h As]
Seat 1: MoonJimmy folded before Flop (didn't bet)
Seat 2: mycka86 (button) folded before Flop (didn't bet)
Seat 3: guvalc1952 (small blind) collected ($5.92)
Seat 4: payback11 (big blind) folded before Flop
Seat 6: xAndorx folded before Flop (didn't bet)
Seat 7: matiko09 folded on the Flop
Seat 9: Al3xAnd3r22 folded before Flop (didn't bet)





PokerStars Hand #149394899935:  Hold'em No Limit ($0.50/$1.00 USD) - 2016/02/25 17:42:16 CET [2016/02/25 11:42:16 ET]
Table 'Morosovia II' 9-max Seat #1 is the button
Seat 1: $-Twackle-$ ($100 in chips) 
Seat 3: sebaaastian ($207 in chips) 
Seat 4: renechris ($82.22 in chips) 
Seat 5: gabi_igna ($150.14 in chips) 
Seat 6: Dachish ($69 in chips) 
Seat 7: matiko09 ($147.48 in chips) 
Seat 8: simoniustin ($117.59 in chips) 
Seat 9: lysandrafly ($119.44 in chips) 
sebaaastian: posts small blind $0.50
renechris: posts big blind $1
*** HOLE CARDS ***
Dealt to matiko09 [4s Ad]
gabi_igna: folds 
Dachish: folds 
matiko09: folds 
simoniustin: folds 
lysandrafly: folds 
$-Twackle-$: folds 
sebaaastian: folds 
Uncalled bet ($0.50) returned to renechris
renechris collected $1 from pot
*** SUMMARY ***
Total pot $1 | Rake $0 
Seat 1: $-Twackle-$ (button) folded before Flop (didn't bet)
Seat 3: sebaaastian (small blind) folded before Flop
Seat 4: renechris (big blind) collected ($1)
Seat 5: gabi_igna folded before Flop (didn't bet)
Seat 6: Dachish folded before Flop (didn't bet)
Seat 7: matiko09 folded before Flop (didn't bet)
Seat 8: simoniustin folded before Flop (didn't bet)
Seat 9: lysandrafly folded before Flop (didn't bet)





PokerStars Hand #149394902938:  Hold'em No Limit ($0.50/$1.00 USD) - 2016/02/25 17:42:20 CET [2016/02/25 11:42:20 ET]
Table 'Nerthus II' 9-max Seat #8 is the button
Seat 1: volwebni4ek ($49.07 in chips) 
Seat 2: matiko09 ($218.68 in chips) 
Seat 3: simoniustin ($121.86 in chips) 
Seat 4: Ilov3NBA ($104.50 in chips) 
Seat 6: mycka86 ($141.38 in chips) 
Seat 7: Venomous100% ($107.15 in chips) 
Seat 8: Kelvin sai ($30.88 in chips) 
Seat 9: hammerwife ($100 in chips) 
hammerwife: posts small blind $0.50
volwebni4ek: posts big blind $1
*** HOLE CARDS ***
Dealt to matiko09 [Qd 3s]
matiko09: folds 
simoniustin: folds 
Ilov3NBA: folds 
mycka86: raises $1.50 to $2.50
Venomous100%: folds 
Kelvin sai: folds 
hammerwife: folds 
volwebni4ek: folds 
Uncalled bet ($1.50) returned to mycka86
mycka86 collected $2.50 from pot
*** SUMMARY ***
Total pot $2.50 | Rake $0 
Seat 1: volwebni4ek (big blind) folded before Flop
Seat 2: matiko09 folded before Flop (didn't bet)
Seat 3: simoniustin folded before Flop (didn't bet)
Seat 4: Ilov3NBA folded before Flop (didn't bet)
Seat 6: mycka86 collected ($2.50)
Seat 7: Venomous100% folded before Flop (didn't bet)
Seat 8: Kelvin sai (button) folded before Flop (didn't bet)
Seat 9: hammerwife (small blind) folded before Flop





PokerStars Hand #149394906110:  Hold'em No Limit ($0.50/$1.00 USD) - 2016/02/25 17:42:24 CET [2016/02/25 11:42:24 ET]
Table 'Isa' 9-max Seat #3 is the button
Seat 1: matiko09 ($121.08 in chips) 
Seat 2: mycka86 ($160.81 in chips) 
Seat 3: sebaaastian ($135.75 in chips) 
Seat 4: hammerwife ($136.45 in chips) 
Seat 6: xAndorx ($101.40 in chips) 
Seat 7: bilukm ($81.50 in chips) 
Seat 8: Venomous100% ($111.74 in chips) 
hammerwife: posts small blind $0.50
Sweden_Pound was removed from the table for failing to post
xAndorx: posts big blind $1
volwebni4ek: sits out 
*** HOLE CARDS ***
Dealt to matiko09 [Qd Ac]
bilukm: raises $1 to $2
Venomous100%: folds 
matiko09: raises $4 to $6
gabi_igna joins the table at seat #5 
mycka86: folds 
sebaaastian: folds 
hammerwife: folds 
xAndorx: folds 
bilukm: folds 
Uncalled bet ($4) returned to matiko09
matiko09 collected $5.50 from pot
matiko09: doesn't show hand 
*** SUMMARY ***
Total pot $5.50 | Rake $0 
Seat 1: matiko09 collected ($5.50)
Seat 2: mycka86 folded before Flop (didn't bet)
Seat 3: sebaaastian (button) folded before Flop (didn't bet)
Seat 4: hammerwife (small blind) folded before Flop
Seat 6: xAndorx (big blind) folded before Flop
Seat 7: bilukm folded before Flop
Seat 8: Venomous100% folded before Flop (didn't bet)





PokerStars Hand #149394912839:  Hold'em No Limit ($0.50/$1.00 USD) - 2016/02/25 17:42:32 CET [2016/02/25 11:42:32 ET]
Table 'Badenia II' 9-max Seat #3 is the button
Seat 1: matiko09 ($100 in chips) 
Seat 3: sebaaastian ($150.50 in chips) 
Seat 4: hammerwife ($104.12 in chips) 
Seat 5: Ilov3NBA ($102.78 in chips) 
Seat 6: Dachish ($70.08 in chips) 
Seat 7: HomerrrJay ($101.50 in chips) 
Seat 8: McFussball81 ($59.54 in chips) 
Seat 9: waisanen ($242.92 in chips) 
hammerwife: posts small blind $0.50
Ilov3NBA: posts big blind $1
$-Twackle-$: sits out 
*** HOLE CARDS ***
Dealt to matiko09 [7h 4s]
Dachish: folds 
HomerrrJay: folds 
McFussball81: folds 
waisanen: folds 
matiko09: folds 
sebaaastian: folds 
hammerwife: raises $1.60 to $2.60
Ilov3NBA: calls $1.60
*** FLOP *** [3s 4d Jh]
hammerwife: checks 
Ilov3NBA: checks 
*** TURN *** [3s 4d Jh] [Js]
hammerwife: bets $4.50
Ilov3NBA: folds 
Uncalled bet ($4.50) returned to hammerwife
hammerwife collected $4.97 from pot
hammerwife: doesn't show hand 
*** SUMMARY ***
Total pot $5.20 | Rake $0.23 
Board [3s 4d Jh Js]
Seat 1: matiko09 folded before Flop (didn't bet)
Seat 3: sebaaastian (button) folded before Flop (didn't bet)
Seat 4: hammerwife (small blind) collected ($4.97)
Seat 5: Ilov3NBA (big blind) folded on the Turn
Seat 6: Dachish folded before Flop (didn't bet)
Seat 7: HomerrrJay folded before Flop (didn't bet)
Seat 8: McFussball81 folded before Flop (didn't bet)
Seat 9: waisanen folded before Flop (didn't bet)





PokerStars Hand #149394913250:  Hold'em No Limit ($0.25/$0.50 USD) - 2016/02/25 17:42:33 CET [2016/02/25 11:42:33 ET]
Table 'Vladimir' 9-max Seat #3 is the button
Seat 1: matiko09 ($50.77 in chips) 
Seat 2: lysandrafly ($58.09 in chips) 
Seat 3: JustR82 ($50.80 in chips) 
Seat 5: Al3xAnd3r22 ($53.83 in chips) 
Seat 6: ihami ($45 in chips) 
Seat 7: myllow1 ($67.25 in chips) 
ffac will be allowed to play after the button
Al3xAnd3r22: posts small blind $0.25
ihami: posts big blind $0.50
*** HOLE CARDS ***
Dealt to matiko09 [Ts 3c]
myllow1: folds 
matiko09: folds 
earthensnake leaves the table
lysandrafly: folds 
JustR82: raises $0.50 to $1
Al3xAnd3r22: folds 
ihami: folds 
Uncalled bet ($0.50) returned to JustR82
JustR82 collected $1.25 from pot
JustR82: doesn't show hand 
*** SUMMARY ***
Total pot $1.25 | Rake $0 
Seat 1: matiko09 folded before Flop (didn't bet)
Seat 2: lysandrafly folded before Flop (didn't bet)
Seat 3: JustR82 (button) collected ($1.25)
Seat 5: Al3xAnd3r22 (small blind) folded before Flop
Seat 6: ihami (big blind) folded before Flop
Seat 7: myllow1 folded before Flop (didn't bet)





PokerStars Hand #149394915686:  Hold'em No Limit ($0.50/$1.00 USD) - 2016/02/25 17:42:36 CET [2016/02/25 11:42:36 ET]
Table 'Zerbinetta II' 9-max Seat #5 is the button
Seat 1: $-Twackle-$ ($100 in chips) 
Seat 2: ffac ($100 in chips) 
Seat 3: matiko09 ($102.25 in chips) 
Seat 4: sebaaastian ($100 in chips) 
Seat 5: hammerwife ($118.27 in chips) 
Seat 6: simoniustin ($100 in chips) 
Seat 8: gabi_igna ($123.70 in chips) 
Seat 9: with-w ($35.67 in chips) 
simoniustin: posts small blind $0.50
HomerrrJay: is sitting out 
gabi_igna: posts big blind $1
*** HOLE CARDS ***
Dealt to matiko09 [4c Ks]
HomerrrJay leaves the table
with-w: calls $1
Venomous100% joins the table at seat #7 
$-Twackle-$: folds 
ffac: folds 
matiko09: folds 
sebaaastian: folds 
hammerwife: folds 
simoniustin: folds 
gabi_igna: checks 
*** FLOP *** [5d Qc 8h]
gabi_igna: checks 
with-w: checks 
*** TURN *** [5d Qc 8h] [4h]
gabi_igna: bets $1
with-w: calls $1
*** RIVER *** [5d Qc 8h 4h] [Jd]
gabi_igna: checks 
with-w: bets $4.30
gabi_igna: calls $4.30
*** SHOW DOWN ***
with-w: shows [3c Jc] (a pair of Jacks)
gabi_igna: mucks hand 
with-w collected $12.51 from pot
*** SUMMARY ***
Total pot $13.10 | Rake $0.59 
Board [5d Qc 8h 4h Jd]
Seat 1: $-Twackle-$ folded before Flop (didn't bet)
Seat 2: ffac folded before Flop (didn't bet)
Seat 3: matiko09 folded before Flop (didn't bet)
Seat 4: sebaaastian folded before Flop (didn't bet)
Seat 5: hammerwife (button) folded before Flop (didn't bet)
Seat 6: simoniustin (small blind) folded before Flop
Seat 8: gabi_igna (big blind) mucked [8d 7d]
Seat 9: with-w showed [3c Jc] and won ($12.51) with a pair of Jacks





PokerStars Hand #149394917226:  Hold'em No Limit ($0.50/$1.00 USD) - 2016/02/25 17:42:37 CET [2016/02/25 11:42:37 ET]
Table 'Eurysaces II' 9-max Seat #2 is the button
Seat 1: lysandrafly ($109.08 in chips) 
Seat 2: sebaaastian ($107.28 in chips) 
Seat 3: Aalleekks ($100 in chips) 
Seat 4: gabi_igna ($110.75 in chips) 
Seat 5: keessie93 ($130.12 in chips) 
Seat 6: J0rmungund ($54.71 in chips) 
Seat 7: $-Twackle-$ ($100 in chips) 
Seat 8: hammerwife ($100 in chips) 
Seat 9: matiko09 ($100 in chips) 
Aalleekks: posts small blind $0.50
gabi_igna: posts big blind $1
*** HOLE CARDS ***
Dealt to matiko09 [Ac 7s]
keessie93: folds 
J0rmungund: folds 
$-Twackle-$: folds 
hammerwife: folds 
matiko09: folds 
lysandrafly: folds 
sebaaastian: raises $1.50 to $2.50
Aalleekks: raises $6.50 to $9
gabi_igna: folds 
sebaaastian: raises $11 to $20
Aalleekks: raises $80 to $100 and is all-in
sebaaastian: calls $80
*** FLOP *** [4h Jd Kh]
*** TURN *** [4h Jd Kh] [3s]
*** RIVER *** [4h Jd Kh 3s] [Ks]
*** SHOW DOWN ***
Aalleekks: shows [9c 9s] (two pair, Kings and Nines)
sebaaastian: shows [Kd As] (three of a kind, Kings)
sebaaastian collected $198.20 from pot
*** SUMMARY ***
Total pot $201 | Rake $2.80 
Board [4h Jd Kh 3s Ks]
Seat 1: lysandrafly folded before Flop (didn't bet)
Seat 2: sebaaastian (button) showed [Kd As] and won ($198.20) with three of a kind, Kings
Seat 3: Aalleekks (small blind) showed [9c 9s] and lost with two pair, Kings and Nines
Seat 4: gabi_igna (big blind) folded before Flop
Seat 5: keessie93 folded before Flop (didn't bet)
Seat 6: J0rmungund folded before Flop (didn't bet)
Seat 7: $-Twackle-$ folded before Flop (didn't bet)
Seat 8: hammerwife folded before Flop (didn't bet)
Seat 9: matiko09 folded before Flop (didn't bet)





PokerStars Hand #149394928519:  Hold'em No Limit ($0.50/$1.00 USD) - 2016/02/25 17:42:52 CET [2016/02/25 11:42:52 ET]
Table 'Morosovia II' 9-max Seat #3 is the button
Seat 1: $-Twackle-$ ($100 in chips) 
Seat 3: sebaaastian ($206.50 in chips) 
Seat 4: renechris ($82.72 in chips) 
Seat 5: gabi_igna ($150.14 in chips) 
Seat 6: Dachish ($69 in chips) 
Seat 7: matiko09 ($147.48 in chips) 
Seat 8: simoniustin ($117.59 in chips) 
Seat 9: lysandrafly ($119.44 in chips) 
renechris: posts small blind $0.50
gabi_igna: posts big blind $1
*** HOLE CARDS ***
Dealt to matiko09 [Ac 5d]
Dachish: folds 
matiko09: folds 
simoniustin: raises $2 to $3
lysandrafly: folds 
$-Twackle-$: folds 
sebaaastian: calls $3
renechris: calls $2.50
gabi_igna: folds 
*** FLOP *** [2c 8s Tc]
renechris: checks 
simoniustin: checks 
sebaaastian: checks 
*** TURN *** [2c 8s Tc] [4h]
renechris: bets $4.77
simoniustin: folds 
sebaaastian: calls $4.77
*** RIVER *** [2c 8s Tc 4h] [5h]
renechris: bets $18.66
sebaaastian: folds 
Uncalled bet ($18.66) returned to renechris
renechris collected $18.66 from pot
renechris: doesn't show hand 
*** SUMMARY ***
Total pot $19.54 | Rake $0.88 
Board [2c 8s Tc 4h 5h]
Seat 1: $-Twackle-$ folded before Flop (didn't bet)
Seat 3: sebaaastian (button) folded on the River
Seat 4: renechris (small blind) collected ($18.66)
Seat 5: gabi_igna (big blind) folded before Flop
Seat 6: Dachish folded before Flop (didn't bet)
Seat 7: matiko09 folded before Flop (didn't bet)
Seat 8: simoniustin folded on the Turn
Seat 9: lysandrafly folded before Flop (didn't bet)





PokerStars Hand #149394931425:  Hold'em No Limit ($0.50/$1.00 USD) - 2016/02/25 17:42:55 CET [2016/02/25 11:42:55 ET]
Table 'Sabine' 9-max Seat #8 is the button
Seat 1: MGMmacca ($53 in chips) 
Seat 2: apfush ($124.03 in chips) 
Seat 3: oscarleon ($121.45 in chips) 
Seat 4: simoniustin ($100 in chips) 
Seat 8: matiko09 ($183.66 in chips) 
Seat 9: Dachish ($83.26 in chips) 
Dachish: posts small blind $0.50
MGMmacca: posts big blind $1
*** HOLE CARDS ***
Dealt to matiko09 [3h 9c]
apfush: folds 
oscarleon: folds 
simoniustin: folds 
matiko09: folds 
Dachish: folds 
Uncalled bet ($0.50) returned to MGMmacca
MGMmacca collected $1 from pot
MGMmacca: doesn't show hand 
*** SUMMARY ***
Total pot $1 | Rake $0 
Seat 1: MGMmacca (big blind) collected ($1)
Seat 2: apfush folded before Flop (didn't bet)
Seat 3: oscarleon folded before Flop (didn't bet)
Seat 4: simoniustin folded before Flop (didn't bet)
Seat 8: matiko09 (button) folded before Flop (didn't bet)
Seat 9: Dachish (small blind) folded before Flop





PokerStars Hand #149394932836:  Hold'em No Limit ($0.25/$0.50 USD) - 2016/02/25 17:42:57 CET [2016/02/25 11:42:57 ET]
Table 'Lohja II' 9-max Seat #3 is the button
Seat 1: MoonJimmy ($163.70 in chips) 
Seat 2: mycka86 ($50 in chips) 
Seat 3: guvalc1952 ($227.70 in chips) 
Seat 4: payback11 ($50 in chips) 
Seat 6: xAndorx ($65.76 in chips) 
Seat 7: matiko09 ($91.62 in chips) 
Seat 9: Al3xAnd3r22 ($141.07 in chips) 
payback11: posts small blind $0.25
xAndorx: posts big blind $0.50
pasa132: sits out 
MoonJimmy: posts the ante $0.10
mycka86: posts the ante $0.10
guvalc1952: posts the ante $0.10
payback11: posts the ante $0.10
xAndorx: posts the ante $0.10
matiko09: posts the ante $0.10
Al3xAnd3r22: posts the ante $0.10
*** HOLE CARDS ***
Dealt to matiko09 [8c 2h]
matiko09: folds 
Al3xAnd3r22: folds 
MoonJimmy: folds 
mycka86: raises $1 to $1.50
guvalc1952: folds 
payback11: folds 
xAndorx: folds 
Uncalled bet ($1) returned to mycka86
mycka86 collected $1.95 from pot
*** SUMMARY ***
Total pot $1.95 | Rake $0 
Seat 1: MoonJimmy folded before Flop (didn't bet)
Seat 2: mycka86 collected ($1.95)
Seat 3: guvalc1952 (button) folded before Flop (didn't bet)
Seat 4: payback11 (small blind) folded before Flop
Seat 6: xAndorx (big blind) folded before Flop
Seat 7: matiko09 folded before Flop (didn't bet)
Seat 9: Al3xAnd3r22 folded before Flop (didn't bet)





PokerStars Hand #149394932977:  Hold'em No Limit ($0.50/$1.00 USD) - 2016/02/25 17:42:57 CET [2016/02/25 11:42:57 ET]
Table 'Nerthus II' 9-max Seat #9 is the button
Seat 1: volwebni4ek ($48.07 in chips) 
Seat 2: matiko09 ($218.68 in chips) 
Seat 3: simoniustin ($121.86 in chips) 
Seat 4: Ilov3NBA ($104.50 in chips) 
Seat 6: mycka86 ($142.88 in chips) 
Seat 7: Venomous100% ($107.15 in chips) 
Seat 8: Kelvin sai ($30.88 in chips) 
Seat 9: hammerwife ($100 in chips) 
volwebni4ek: posts small blind $0.50
matiko09: posts big blind $1
*** HOLE CARDS ***
Dealt to matiko09 [Kh 6s]
simoniustin: folds 
Ilov3NBA: raises $2 to $3
mycka86: folds 
Venomous100%: folds 
Kelvin sai: calls $3
hammerwife: folds 
volwebni4ek: raises $8 to $11
matiko09: folds 
Ilov3NBA: folds 
Kelvin sai: raises $19.88 to $30.88 and is all-in
volwebni4ek: calls $19.88
*** FLOP *** [3c 9c 2c]
*** TURN *** [3c 9c 2c] [8h]
*** RIVER *** [3c 9c 2c 8h] [8c]
*** SHOW DOWN ***
volwebni4ek: shows [Qd Qc] (a flush, Queen high)
Kelvin sai: shows [Td Kd] (a pair of Eights)
volwebni4ek collected $62.96 from pot
*** SUMMARY ***
Total pot $65.76 | Rake $2.80 
Board [3c 9c 2c 8h 8c]
Seat 1: volwebni4ek (small blind) showed [Qd Qc] and won ($62.96) with a flush, Queen high
Seat 2: matiko09 (big blind) folded before Flop
Seat 3: simoniustin folded before Flop (didn't bet)
Seat 4: Ilov3NBA folded before Flop
Seat 6: mycka86 folded before Flop (didn't bet)
Seat 7: Venomous100% folded before Flop (didn't bet)
Seat 8: Kelvin sai showed [Td Kd] and lost with a pair of Eights
Seat 9: hammerwife (button) folded before Flop (didn't bet)





PokerStars Hand #149394935200:  Hold'em No Limit ($0.25/$0.50 USD) - 2016/02/25 17:43:00 CET [2016/02/25 11:43:00 ET]
Table 'Vladimir' 9-max Seat #5 is the button
Seat 1: matiko09 ($50.77 in chips) 
Seat 2: lysandrafly ($58.09 in chips) 
Seat 3: JustR82 ($51.55 in chips) 
Seat 5: Al3xAnd3r22 ($53.58 in chips) 
Seat 6: ihami ($44.50 in chips) 
Seat 7: myllow1 ($67.25 in chips) 
ihami: posts small blind $0.25
myllow1: posts big blind $0.50
ffac: sits out 
*** HOLE CARDS ***
Dealt to matiko09 [Ah 9h]
matiko09: folds 
Bailey Dew joins the table at seat #9 
lysandrafly: folds 
Bailey Dew leaves the table
JustR82: folds 
Al3xAnd3r22: folds 
ihami: raises $0.50 to $1
myllow1: folds 
Uncalled bet ($0.50) returned to ihami
ihami collected $1 from pot
*** SUMMARY ***
Total pot $1 | Rake $0 
Seat 1: matiko09 folded before Flop (didn't bet)
Seat 2: lysandrafly folded before Flop (didn't bet)
Seat 3: JustR82 folded before Flop (didn't bet)
Seat 5: Al3xAnd3r22 (button) folded before Flop (didn't bet)
Seat 6: ihami (small blind) collected ($1)
Seat 7: myllow1 (big blind) folded before Flop





PokerStars Hand #149394936466:  Hold'em No Limit ($0.50/$1.00 USD) - 2016/02/25 17:43:01 CET [2016/02/25 11:43:01 ET]
Table 'Isa' 9-max Seat #4 is the button
Seat 1: matiko09 ($124.58 in chips) 
Seat 2: mycka86 ($160.81 in chips) 
Seat 3: sebaaastian ($135.75 in chips) 
Seat 4: hammerwife ($135.95 in chips) 
Seat 6: xAndorx ($100.40 in chips) 
Seat 7: bilukm ($79.50 in chips) 
Seat 8: Venomous100% ($111.74 in chips) 
gabi_igna will be allowed to play after the button
xAndorx: posts small blind $0.50
bilukm: posts big blind $1
volwebni4ek: sits out 
*** HOLE CARDS ***
Dealt to matiko09 [9d 3c]
Venomous100%: folds 
matiko09: folds 
mycka86: raises $1.50 to $2.50
sebaaastian: calls $2.50
hammerwife: folds 
xAndorx: folds 
bilukm: calls $1.50
*** FLOP *** [Jc 9s 9h]
bilukm: bets $1
mycka86: folds 
sebaaastian: raises $3 to $4
bilukm: calls $3
*** TURN *** [Jc 9s 9h] [5s]
bilukm: bets $1
sebaaastian: raises $8.64 to $9.64
bilukm: calls $8.64
*** RIVER *** [Jc 9s 9h 5s] [4d]
bilukm: checks 
sebaaastian: bets $28
bilukm: folds 
Uncalled bet ($28) returned to sebaaastian
sebaaastian collected $33.69 from pot
sebaaastian: doesn't show hand 
*** SUMMARY ***
Total pot $35.28 | Rake $1.59 
Board [Jc 9s 9h 5s 4d]
Seat 1: matiko09 folded before Flop (didn't bet)
Seat 2: mycka86 folded on the Flop
Seat 3: sebaaastian collected ($33.69)
Seat 4: hammerwife (button) folded before Flop (didn't bet)
Seat 6: xAndorx (small blind) folded before Flop
Seat 7: bilukm (big blind) folded on the River
Seat 8: Venomous100% folded before Flop (didn't bet)





PokerStars Hand #149394947601:  Hold'em No Limit ($0.50/$1.00 USD) - 2016/02/25 17:43:15 CET [2016/02/25 11:43:15 ET]
Table 'Zeuxo II' 9-max Seat #3 is the button
Seat 3: xAndorx ($132.88 in chips) 
Seat 4: sebaaastian ($100 in chips) 
Seat 5: hammerwife ($100 in chips) 
Seat 7: Venomous100% ($101.50 in chips) 
Seat 8: matiko09 ($233.62 in chips) 
Seat 9: Sreshta222 ($310.66 in chips) 
sebaaastian: posts small blind $0.50
hammerwife: posts big blind $1
Aalleekks: sits out 
Ilov3NBA: sits out 
*** HOLE CARDS ***
Dealt to matiko09 [2c Kh]
Venomous100%: folds 
matiko09: folds 
Cogss leaves the table
Sreshta222: folds 
xAndorx: raises $1 to $2
sebaaastian: raises $6 to $8
hammerwife: folds 
xAndorx: raises $9.50 to $17.50
sebaaastian: calls $9.50
*** FLOP *** [Kd Jc 7h]
sebaaastian: checks 
xAndorx: bets $16.50
sebaaastian: folds 
Uncalled bet ($16.50) returned to xAndorx
xAndorx collected $34.38 from pot
xAndorx: doesn't show hand 
*** SUMMARY ***
Total pot $36 | Rake $1.62 
Board [Kd Jc 7h]
Seat 3: xAndorx (button) collected ($34.38)
Seat 4: sebaaastian (small blind) folded on the Flop
Seat 5: hammerwife (big blind) folded before Flop
Seat 7: Venomous100% folded before Flop (didn't bet)
Seat 8: matiko09 folded before Flop (didn't bet)
Seat 9: Sreshta222 folded before Flop (didn't bet)





PokerStars Hand #149394950399:  Hold'em No Limit ($0.50/$1.00 USD) - 2016/02/25 17:43:18 CET [2016/02/25 11:43:18 ET]
Table 'Sabine' 9-max Seat #9 is the button
Seat 1: MGMmacca ($53.50 in chips) 
Seat 2: apfush ($124.03 in chips) 
Seat 3: oscarleon ($121.45 in chips) 
Seat 4: simoniustin ($100 in chips) 
Seat 8: matiko09 ($183.66 in chips) 
Seat 9: Dachish ($82.76 in chips) 
MGMmacca: posts small blind $0.50
apfush: posts big blind $1
*** HOLE CARDS ***
Dealt to matiko09 [9d 4d]
oscarleon: folds 
simoniustin: folds 
matiko09: folds 
Dachish: raises $1.50 to $2.50
MGMmacca: calls $2
apfush: calls $1.50
*** FLOP *** [Tc 5d 3s]
MGMmacca: checks 
apfush: checks 
Dachish: checks 
*** TURN *** [Tc 5d 3s] [4c]
MGMmacca: bets $3.58
$-Twackle-$ joins the table at seat #6 
apfush: calls $3.58
Dachish: folds 
*** RIVER *** [Tc 5d 3s 4c] [8c]
MGMmacca: checks 
apfush: checks 
*** SHOW DOWN ***
MGMmacca: shows [Js 8s] (a pair of Eights)
apfush: mucks hand 
MGMmacca collected $14 from pot
*** SUMMARY ***
Total pot $14.66 | Rake $0.66 
Board [Tc 5d 3s 4c 8c]
Seat 1: MGMmacca (small blind) showed [Js 8s] and won ($14) with a pair of Eights
Seat 2: apfush (big blind) mucked [8h 6h]
Seat 3: oscarleon folded before Flop (didn't bet)
Seat 4: simoniustin folded before Flop (didn't bet)
Seat 8: matiko09 folded before Flop (didn't bet)
Seat 9: Dachish (button) folded on the Turn





PokerStars Hand #149394951115:  Hold'em No Limit ($0.50/$1.00 USD) - 2016/02/25 17:43:19 CET [2016/02/25 11:43:19 ET]
Table 'Mayall II' 9-max Seat #5 is the button
Seat 1: matiko09 ($122.94 in chips) 
Seat 3: simoniustin ($129.14 in chips) 
Seat 4: C. Duke 19 ($100 in chips) 
Seat 5: McFussball81 ($60.07 in chips) 
Seat 6: apfush ($100.50 in chips) 
Seat 7: r.pol218 ($40.48 in chips) 
Seat 8: kuanhung0903 ($78.46 in chips) 
Seat 9: xAndorx ($131.84 in chips) 
apfush: posts small blind $0.50
r.pol218: posts big blind $1
C. Duke 19: posts big blind $1
*** HOLE CARDS ***
Dealt to matiko09 [Jh Tc]
kuanhung0903: folds 
xAndorx: folds 
matiko09: folds 
simoniustin: raises $4 to $5
C. Duke 19: calls $4
McFussball81: folds 
apfush: folds 
r.pol218: folds 
*** FLOP *** [8d 2c Qs]
simoniustin: checks 
C. Duke 19: bets $10.98
simoniustin: folds 
Uncalled bet ($10.98) returned to C. Duke 19
C. Duke 19 collected $10.98 from pot
C. Duke 19: doesn't show hand 
*** SUMMARY ***
Total pot $11.50 | Rake $0.52 
Board [8d 2c Qs]
Seat 1: matiko09 folded before Flop (didn't bet)
Seat 3: simoniustin folded on the Flop
Seat 4: C. Duke 19 collected ($10.98)
Seat 5: McFussball81 (button) folded before Flop (didn't bet)
Seat 6: apfush (small blind) folded before Flop
Seat 7: r.pol218 (big blind) folded before Flop
Seat 8: kuanhung0903 folded before Flop (didn't bet)
Seat 9: xAndorx folded before Flop (didn't bet)





PokerStars Hand #149394960013:  Hold'em No Limit ($0.25/$0.50 USD) - 2016/02/25 17:43:30 CET [2016/02/25 11:43:30 ET]
Table 'Lohja II' 9-max Seat #4 is the button
Seat 1: MoonJimmy ($163.60 in chips) 
Seat 2: mycka86 ($51.35 in chips) 
Seat 3: guvalc1952 ($227.60 in chips) 
Seat 4: payback11 ($50 in chips) 
Seat 6: xAndorx ($65.16 in chips) 
Seat 7: matiko09 ($91.52 in chips) 
Seat 9: Al3xAnd3r22 ($140.97 in chips) 
xAndorx: posts small blind $0.25
matiko09: posts big blind $0.50
pasa132: sits out 
MoonJimmy: posts the ante $0.10
mycka86: posts the ante $0.10
guvalc1952: posts the ante $0.10
payback11: posts the ante $0.10
xAndorx: posts the ante $0.10
matiko09: posts the ante $0.10
Al3xAnd3r22: posts the ante $0.10
*** HOLE CARDS ***
Dealt to matiko09 [Jc 8d]
Al3xAnd3r22: folds 
MoonJimmy: folds 
mycka86: folds 
guvalc1952: folds 
payback11: folds 
xAndorx: folds 
Uncalled bet ($0.25) returned to matiko09
matiko09 collected $1.20 from pot
matiko09: doesn't show hand 
*** SUMMARY ***
Total pot $1.20 | Rake $0 
Seat 1: MoonJimmy folded before Flop (didn't bet)
Seat 2: mycka86 folded before Flop (didn't bet)
Seat 3: guvalc1952 folded before Flop (didn't bet)
Seat 4: payback11 (button) folded before Flop (didn't bet)
Seat 6: xAndorx (small blind) folded before Flop
Seat 7: matiko09 (big blind) collected ($1.20)
Seat 9: Al3xAnd3r22 folded before Flop (didn't bet)





PokerStars Hand #149394967735:  Hold'em No Limit ($0.25/$0.50 USD) - 2016/02/25 17:43:40 CET [2016/02/25 11:43:40 ET]
Table 'Vladimir' 9-max Seat #6 is the button
Seat 1: matiko09 ($50.77 in chips) 
Seat 2: lysandrafly ($58.09 in chips) 
Seat 3: JustR82 ($51.55 in chips) 
Seat 5: Al3xAnd3r22 ($53.58 in chips) 
Seat 6: ihami ($45 in chips) 
Seat 7: myllow1 ($66.75 in chips) 
myllow1: posts small blind $0.25
matiko09: posts big blind $0.50
ffac: sits out 
*** HOLE CARDS ***
Dealt to matiko09 [2c 5c]
lysandrafly: folds 
lysandrafly leaves the table
JustR82: folds 
JustR82 leaves the table
Al3xAnd3r22: folds 
Vedpapa joins the table at seat #2 
Troll8989 joins the table at seat #3 
AceFarky joins the table at seat #9 
ihami: folds 
myllow1: raises $1 to $1.50
matiko09: folds 
Uncalled bet ($1) returned to myllow1
myllow1 collected $1 from pot
*** SUMMARY ***
Total pot $1 | Rake $0 
Seat 1: matiko09 (big blind) folded before Flop
Seat 2: lysandrafly folded before Flop (didn't bet)
Seat 3: JustR82 folded before Flop (didn't bet)
Seat 5: Al3xAnd3r22 folded before Flop (didn't bet)
Seat 6: ihami (button) folded before Flop (didn't bet)
Seat 7: myllow1 (small blind) collected ($1)





PokerStars Hand #149394968466:  Hold'em No Limit ($0.50/$1.00 USD) - 2016/02/25 17:43:41 CET [2016/02/25 11:43:41 ET]
Table 'Zerbinetta II' 9-max Seat #6 is the button
Seat 1: $-Twackle-$ ($100 in chips) 
Seat 2: ffac ($100 in chips) 
Seat 3: matiko09 ($102.25 in chips) 
Seat 4: sebaaastian ($100 in chips) 
Seat 5: hammerwife ($118.27 in chips) 
Seat 6: simoniustin ($100 in chips) 
Seat 8: gabi_igna ($117.40 in chips) 
Seat 9: with-w ($41.88 in chips) 
gabi_igna: posts small blind $0.50
with-w: posts big blind $1
*** HOLE CARDS ***
Dealt to matiko09 [Td 7c]
$-Twackle-$: folds 
ffac: raises $2 to $3
matiko09: folds 
sebaaastian: folds 
hammerwife: folds 
simoniustin: calls $3
gabi_igna: folds 
with-w: calls $2
*** FLOP *** [3s Ad 9h]
with-w: checks 
ffac: bets $5
simoniustin: folds 
with-w: calls $5
*** TURN *** [3s Ad 9h] [Ah]
with-w: checks 
ffac: bets $9.80
with-w: calls $9.80
*** RIVER *** [3s Ad 9h Ah] [Ts]
with-w: checks 
ffac: bets $24.03
with-w: raises $0.05 to $24.08 and is all-in
ffac: calls $0.05
*** SHOW DOWN ***
with-w: shows [5s Ac] (three of a kind, Aces)
ffac: shows [As Kd] (three of a kind, Aces - King kicker)
ffac collected $84.46 from pot
*** SUMMARY ***
Total pot $87.26 | Rake $2.80 
Board [3s Ad 9h Ah Ts]
Seat 1: $-Twackle-$ folded before Flop (didn't bet)
Seat 2: ffac showed [As Kd] and won ($84.46) with three of a kind, Aces
Seat 3: matiko09 folded before Flop (didn't bet)
Seat 4: sebaaastian folded before Flop (didn't bet)
Seat 5: hammerwife folded before Flop (didn't bet)
Seat 6: simoniustin (button) folded on the Flop
Seat 8: gabi_igna (small blind) folded before Flop
Seat 9: with-w (big blind) showed [5s Ac] and lost with three of a kind, Aces





PokerStars Hand #149394980282:  Hold'em No Limit ($0.25/$0.50 USD) - 2016/02/25 17:43:55 CET [2016/02/25 11:43:55 ET]
Table 'Lohja II' 9-max Seat #6 is the button
Seat 1: MoonJimmy ($163.50 in chips) 
Seat 2: mycka86 ($51.25 in chips) 
Seat 3: guvalc1952 ($227.50 in chips) 
Seat 4: payback11 ($50 in chips) 
Seat 6: xAndorx ($64.81 in chips) 
Seat 7: matiko09 ($92.37 in chips) 
Seat 8: pasa132 ($65 in chips) 
Seat 9: Al3xAnd3r22 ($140.87 in chips) 
matiko09: posts small blind $0.25
pasa132: posts big blind $0.50
MoonJimmy: posts the ante $0.10
mycka86: posts the ante $0.10
guvalc1952: posts the ante $0.10
payback11: posts the ante $0.10
xAndorx: posts the ante $0.10
matiko09: posts the ante $0.10
pasa132: posts the ante $0.10
Al3xAnd3r22: posts the ante $0.10
*** HOLE CARDS ***
Dealt to matiko09 [3h 2c]
Al3xAnd3r22: folds 
MoonJimmy: raises $1 to $1.50
mycka86: calls $1.50
guvalc1952 has timed out
guvalc1952: folds 
payback11: folds 
xAndorx: calls $1.50
matiko09: folds 
pasa132: calls $1
*** FLOP *** [8c Kh 5d]
pasa132: checks 
MoonJimmy: checks 
mycka86: bets $4.25
xAndorx: folds 
pasa132: folds 
MoonJimmy: folds 
Uncalled bet ($4.25) returned to mycka86
mycka86 collected $6.73 from pot
*** SUMMARY ***
Total pot $7.05 | Rake $0.32 
Board [8c Kh 5d]
Seat 1: MoonJimmy folded on the Flop
Seat 2: mycka86 collected ($6.73)
Seat 3: guvalc1952 folded before Flop (didn't bet)
Seat 4: payback11 folded before Flop (didn't bet)
Seat 6: xAndorx (button) folded on the Flop
Seat 7: matiko09 (small blind) folded before Flop
Seat 8: pasa132 (big blind) folded on the Flop
Seat 9: Al3xAnd3r22 folded before Flop (didn't bet)





PokerStars Hand #149394983541:  Hold'em No Limit ($0.50/$1.00 USD) - 2016/02/25 17:43:59 CET [2016/02/25 11:43:59 ET]
Table 'Badenia II' 9-max Seat #4 is the button
Seat 1: matiko09 ($100 in chips) 
Seat 3: sebaaastian ($150.50 in chips) 
Seat 4: hammerwife ($106.49 in chips) 
Seat 5: Ilov3NBA ($100.18 in chips) 
Seat 6: Dachish ($70.08 in chips) 
Seat 7: HomerrrJay ($101.50 in chips) 
Seat 8: McFussball81 ($59.54 in chips) 
Seat 9: waisanen ($242.92 in chips) 
Ilov3NBA: posts small blind $0.50
Dachish: posts big blind $1
$-Twackle-$: sits out 
*** HOLE CARDS ***
Dealt to matiko09 [9d Qc]
HomerrrJay: folds 
McFussball81: folds 
waisanen: folds 
matiko09: folds 
sebaaastian: folds 
hammerwife: folds 
Ilov3NBA: folds 
Uncalled bet ($0.50) returned to Dachish
Dachish collected $1 from pot
Dachish: doesn't show hand 
*** SUMMARY ***
Total pot $1 | Rake $0 
Seat 1: matiko09 folded before Flop (didn't bet)
Seat 3: sebaaastian folded before Flop (didn't bet)
Seat 4: hammerwife (button) folded before Flop (didn't bet)
Seat 5: Ilov3NBA (small blind) folded before Flop
Seat 6: Dachish (big blind) collected ($1)
Seat 7: HomerrrJay folded before Flop (didn't bet)
Seat 8: McFussball81 folded before Flop (didn't bet)
Seat 9: waisanen folded before Flop (didn't bet)





PokerStars Hand #149394986871:  Hold'em No Limit ($0.50/$1.00 USD) - 2016/02/25 17:44:03 CET [2016/02/25 11:44:03 ET]
Table 'Mayall II' 9-max Seat #6 is the button
Seat 1: matiko09 ($122.94 in chips) 
Seat 3: simoniustin ($124.14 in chips) 
Seat 4: C. Duke 19 ($105.98 in chips) 
Seat 5: McFussball81 ($60.07 in chips) 
Seat 6: apfush ($100 in chips) 
Seat 7: r.pol218 ($39.48 in chips) 
Seat 8: kuanhung0903 ($78.46 in chips) 
Seat 9: xAndorx ($131.84 in chips) 
r.pol218: posts small blind $0.50
kuanhung0903: posts big blind $1
*** HOLE CARDS ***
Dealt to matiko09 [7h Ac]
xAndorx: folds 
matiko09: folds 
simoniustin: folds 
C. Duke 19: folds 
McFussball81: folds 
apfush: folds 
r.pol218: calls $0.50
kuanhung0903: checks 
*** FLOP *** [Jd Jc Tc]
r.pol218: checks 
kuanhung0903: checks 
*** TURN *** [Jd Jc Tc] [Qh]
r.pol218: checks 
kuanhung0903: checks 
*** RIVER *** [Jd Jc Tc Qh] [Ts]
r.pol218: checks 
kuanhung0903: checks 
*** SHOW DOWN ***
r.pol218: shows [Ad 5d] (two pair, Jacks and Tens)
kuanhung0903: shows [8d Qd] (two pair, Queens and Jacks)
kuanhung0903 collected $1.91 from pot
*** SUMMARY ***
Total pot $2 | Rake $0.09 
Board [Jd Jc Tc Qh Ts]
Seat 1: matiko09 folded before Flop (didn't bet)
Seat 3: simoniustin folded before Flop (didn't bet)
Seat 4: C. Duke 19 folded before Flop (didn't bet)
Seat 5: McFussball81 folded before Flop (didn't bet)
Seat 6: apfush (button) folded before Flop (didn't bet)
Seat 7: r.pol218 (small blind) showed [Ad 5d] and lost with two pair, Jacks and Tens
Seat 8: kuanhung0903 (big blind) showed [8d Qd] and won ($1.91) with two pair, Queens and Jacks
Seat 9: xAndorx folded before Flop (didn't bet)





PokerStars Hand #149394988847:  Hold'em No Limit ($0.50/$1.00 USD) - 2016/02/25 17:44:06 CET [2016/02/25 11:44:06 ET]
Table 'Eurysaces II' 9-max Seat #3 is the button
Seat 1: lysandrafly ($109.08 in chips) 
Seat 2: sebaaastian ($205.48 in chips) 
Seat 3: Aalleekks ($100 in chips) 
Seat 4: gabi_igna ($109.75 in chips) 
Seat 5: keessie93 ($130.12 in chips) 
Seat 6: J0rmungund ($54.71 in chips) 
Seat 7: $-Twackle-$ ($100 in chips) 
Seat 8: hammerwife ($100 in chips) 
Seat 9: matiko09 ($100 in chips) 
gabi_igna: posts small blind $0.50
keessie93: posts big blind $1
*** HOLE CARDS ***
Dealt to matiko09 [2d 5s]
J0rmungund: folds 
$-Twackle-$: folds 
hammerwife: folds 
matiko09: folds 
lysandrafly: folds 
sebaaastian: folds 
Aalleekks: folds 
gabi_igna: folds 
Uncalled bet ($0.50) returned to keessie93
keessie93 collected $1 from pot
keessie93: doesn't show hand 
*** SUMMARY ***
Total pot $1 | Rake $0 
Seat 1: lysandrafly folded before Flop (didn't bet)
Seat 2: sebaaastian folded before Flop (didn't bet)
Seat 3: Aalleekks (button) folded before Flop (didn't bet)
Seat 4: gabi_igna (small blind) folded before Flop
Seat 5: keessie93 (big blind) collected ($1)
Seat 6: J0rmungund folded before Flop (didn't bet)
Seat 7: $-Twackle-$ folded before Flop (didn't bet)
Seat 8: hammerwife folded before Flop (didn't bet)
Seat 9: matiko09 folded before Flop (didn't bet)





PokerStars Hand #149394991479:  Hold'em No Limit ($0.50/$1.00 USD) - 2016/02/25 17:44:09 CET [2016/02/25 11:44:09 ET]
Table 'Nerthus II' 9-max Seat #1 is the button
Seat 1: volwebni4ek ($80.15 in chips) 
Seat 2: matiko09 ($217.68 in chips) 
Seat 3: simoniustin ($121.86 in chips) 
Seat 4: Ilov3NBA ($101.50 in chips) 
Seat 6: mycka86 ($142.88 in chips) 
Seat 7: Venomous100% ($107.15 in chips) 
Seat 9: hammerwife ($100 in chips) 
matiko09: posts small blind $0.50
simoniustin: posts big blind $1
*** HOLE CARDS ***
Dealt to matiko09 [5h Qh]
Ilov3NBA: folds 
mycka86: folds 
Venomous100%: folds 
hammerwife: folds 
Kelvin sai leaves the table
volwebni4ek: raises $1 to $2
Dachish joins the table at seat #8 
Dachish leaves the table
matiko09: folds 
simoniustin: folds 
Uncalled bet ($1) returned to volwebni4ek
volwebni4ek collected $2.50 from pot
volwebni4ek: doesn't show hand 
*** SUMMARY ***
Total pot $2.50 | Rake $0 
Seat 1: volwebni4ek (button) collected ($2.50)
Seat 2: matiko09 (small blind) folded before Flop
Seat 3: simoniustin (big blind) folded before Flop
Seat 4: Ilov3NBA folded before Flop (didn't bet)
Seat 6: mycka86 folded before Flop (didn't bet)
Seat 7: Venomous100% folded before Flop (didn't bet)
Seat 9: hammerwife folded before Flop (didn't bet)





PokerStars Hand #149395005718:  Hold'em No Limit ($0.25/$0.50 USD) - 2016/02/25 17:44:27 CET [2016/02/25 11:44:27 ET]
Table 'Vladimir' 9-max Seat #7 is the button
Seat 1: matiko09 ($50.27 in chips) 
Seat 2: Vedpapa ($50 in chips) 
Seat 5: Al3xAnd3r22 ($53.58 in chips) 
Seat 6: ihami ($45 in chips) 
Seat 7: myllow1 ($67.25 in chips) 
AceFarky will be allowed to play after the button
matiko09: posts small blind $0.25
Vedpapa: posts big blind $0.50
Troll8989: sits out 
ffac: sits out 
*** HOLE CARDS ***
Dealt to matiko09 [4c 2s]
Al3xAnd3r22: folds 
ihami: folds 
myllow1: folds 
matiko09: folds 
Uncalled bet ($0.25) returned to Vedpapa
Vedpapa collected $0.50 from pot
Vedpapa: doesn't show hand 
*** SUMMARY ***
Total pot $0.50 | Rake $0 
Seat 1: matiko09 (small blind) folded before Flop
Seat 2: Vedpapa (big blind) collected ($0.50)
Seat 5: Al3xAnd3r22 folded before Flop (didn't bet)
Seat 6: ihami folded before Flop (didn't bet)
Seat 7: myllow1 (button) folded before Flop (didn't bet)





PokerStars Hand #149395011739:  Hold'em No Limit ($0.50/$1.00 USD) - 2016/02/25 17:44:35 CET [2016/02/25 11:44:35 ET]
Table 'Syrma II' 9-max Seat #4 is the button
Seat 3: shayu 9988 ($81.12 in chips) 
Seat 4: volwebni4ek ($64.20 in chips) 
Seat 5: BIGWIN2016 ($98.30 in chips) 
Seat 6: matiko09 ($100 in chips) 
Seat 7: lysandrafly ($100 in chips) 
BIGWIN2016: posts small blind $0.50
matiko09: posts big blind $1
xAndorx: sits out 
Venomous100%: sits out 
$-Twackle-$: sits out 
*** HOLE CARDS ***
Dealt to matiko09 [4s Js]
lysandrafly: folds 
shayu 9988: folds 
volwebni4ek: raises $1 to $2
BIGWIN2016: calls $1.50
matiko09: folds 
*** FLOP *** [2s 8d 7d]
BIGWIN2016: bets $3
volwebni4ek: raises $4 to $7
BIGWIN2016: calls $4
*** TURN *** [2s 8d 7d] [4c]
BIGWIN2016: checks 
volwebni4ek: checks 
*** RIVER *** [2s 8d 7d 4c] [Jd]
BIGWIN2016: checks 
volwebni4ek: checks 
*** SHOW DOWN ***
BIGWIN2016: shows [7h 6h] (a pair of Sevens)
volwebni4ek: shows [Ts 8c] (a pair of Eights)
volwebni4ek collected $18.14 from pot
*** SUMMARY ***
Total pot $19 | Rake $0.86 
Board [2s 8d 7d 4c Jd]
Seat 3: shayu 9988 folded before Flop (didn't bet)
Seat 4: volwebni4ek (button) showed [Ts 8c] and won ($18.14) with a pair of Eights
Seat 5: BIGWIN2016 (small blind) showed [7h 6h] and lost with a pair of Sevens
Seat 6: matiko09 (big blind) folded before Flop
Seat 7: lysandrafly folded before Flop (didn't bet)





PokerStars Hand #149395015032:  Hold'em No Limit ($0.50/$1.00 USD) - 2016/02/25 17:44:39 CET [2016/02/25 11:44:39 ET]
Table 'Sabine' 9-max Seat #1 is the button
Seat 1: MGMmacca ($61.42 in chips) 
Seat 2: apfush ($117.95 in chips) 
Seat 3: oscarleon ($121.45 in chips) 
Seat 4: simoniustin ($100 in chips) 
Seat 8: matiko09 ($183.66 in chips) 
Seat 9: Dachish ($80.26 in chips) 
apfush: posts small blind $0.50
oscarleon: posts big blind $1
$-Twackle-$: sits out 
*** HOLE CARDS ***
Dealt to matiko09 [Ts Kc]
simoniustin: folds 
matiko09: folds 
Dachish: folds 
MGMmacca: raises $2 to $3
apfush: folds 
oscarleon: calls $2
*** FLOP *** [3c 9h 4c]
oscarleon: checks 
MGMmacca: bets $6.21
oscarleon: folds 
Uncalled bet ($6.21) returned to MGMmacca
MGMmacca collected $6.21 from pot
MGMmacca: doesn't show hand 
*** SUMMARY ***
Total pot $6.50 | Rake $0.29 
Board [3c 9h 4c]
Seat 1: MGMmacca (button) collected ($6.21)
Seat 2: apfush (small blind) folded before Flop
Seat 3: oscarleon (big blind) folded on the Flop
Seat 4: simoniustin folded before Flop (didn't bet)
Seat 8: matiko09 folded before Flop (didn't bet)
Seat 9: Dachish folded before Flop (didn't bet)





PokerStars Hand #149395016324:  Hold'em No Limit ($0.50/$1.00 USD) - 2016/02/25 17:44:40 CET [2016/02/25 11:44:40 ET]
Table 'Badenia II' 9-max Seat #5 is the button
Seat 1: matiko09 ($100 in chips) 
Seat 3: sebaaastian ($150.50 in chips) 
Seat 4: hammerwife ($106.49 in chips) 
Seat 5: Ilov3NBA ($100 in chips) 
Seat 6: Dachish ($70.58 in chips) 
Seat 7: HomerrrJay ($101.50 in chips) 
Seat 8: McFussball81 ($59.54 in chips) 
Seat 9: waisanen ($242.92 in chips) 
Dachish: posts small blind $0.50
HomerrrJay: posts big blind $1
$-Twackle-$: sits out 
*** HOLE CARDS ***
Dealt to matiko09 [5h 4d]
McFussball81: folds 
waisanen: calls $1
matiko09: folds 
sebaaastian: raises $3 to $4
hammerwife: folds 
Ilov3NBA: folds 
Dachish: folds 
HomerrrJay: folds 
waisanen: calls $3
*** FLOP *** [Qd 5c 6h]
waisanen: checks 
sebaaastian: bets $5
waisanen: folds 
Uncalled bet ($5) returned to sebaaastian
sebaaastian collected $9.07 from pot
sebaaastian: doesn't show hand 
*** SUMMARY ***
Total pot $9.50 | Rake $0.43 
Board [Qd 5c 6h]
Seat 1: matiko09 folded before Flop (didn't bet)
Seat 3: sebaaastian collected ($9.07)
Seat 4: hammerwife folded before Flop (didn't bet)
Seat 5: Ilov3NBA (button) folded before Flop (didn't bet)
Seat 6: Dachish (small blind) folded before Flop
Seat 7: HomerrrJay (big blind) folded before Flop
Seat 8: McFussball81 folded before Flop (didn't bet)
Seat 9: waisanen folded on the Flop





PokerStars Hand #149395019629:  Hold'em No Limit ($0.50/$1.00 USD) - 2016/02/25 17:44:44 CET [2016/02/25 11:44:44 ET]
Table 'Eurysaces II' 9-max Seat #4 is the button
Seat 1: lysandrafly ($109.08 in chips) 
Seat 2: sebaaastian ($205.48 in chips) 
Seat 3: Aalleekks ($100 in chips) 
Seat 4: gabi_igna ($109.25 in chips) 
Seat 5: keessie93 ($130.62 in chips) 
Seat 6: J0rmungund ($54.71 in chips) 
Seat 7: $-Twackle-$ ($100 in chips) 
Seat 8: hammerwife ($100 in chips) 
Seat 9: matiko09 ($100 in chips) 
keessie93: posts small blind $0.50
J0rmungund: posts big blind $1
*** HOLE CARDS ***
Dealt to matiko09 [Qd 2c]
$-Twackle-$: folds 
hammerwife: folds 
matiko09: folds 
lysandrafly: raises $2 to $3
sebaaastian: folds 
Aalleekks: folds 
gabi_igna: folds 
keessie93: folds 
J0rmungund: folds 
Uncalled bet ($2) returned to lysandrafly
lysandrafly collected $2.50 from pot
lysandrafly: doesn't show hand 
*** SUMMARY ***
Total pot $2.50 | Rake $0 
Seat 1: lysandrafly collected ($2.50)
Seat 2: sebaaastian folded before Flop (didn't bet)
Seat 3: Aalleekks folded before Flop (didn't bet)
Seat 4: gabi_igna (button) folded before Flop (didn't bet)
Seat 5: keessie93 (small blind) folded before Flop
Seat 6: J0rmungund (big blind) folded before Flop
Seat 7: $-Twackle-$ folded before Flop (didn't bet)
Seat 8: hammerwife folded before Flop (didn't bet)
Seat 9: matiko09 folded before Flop (didn't bet)





PokerStars Hand #149395025111:  Hold'em No Limit ($0.50/$1.00 USD) - 2016/02/25 17:44:51 CET [2016/02/25 11:44:51 ET]
Table 'Isa' 9-max Seat #6 is the button
Seat 1: matiko09 ($124.58 in chips) 
Seat 2: mycka86 ($158.31 in chips) 
Seat 3: sebaaastian ($153.30 in chips) 
Seat 4: hammerwife ($135.95 in chips) 
Seat 6: xAndorx ($99.90 in chips) 
Seat 7: bilukm ($63.36 in chips) 
Seat 8: Venomous100% ($111.74 in chips) 
bilukm: posts small blind $0.50
Venomous100%: posts big blind $1
volwebni4ek: sits out 
gabi_igna: sits out 
*** HOLE CARDS ***
Dealt to matiko09 [5s 7d]
matiko09: folds 
mycka86: folds 
sebaaastian: folds 
hammerwife: raises $1.50 to $2.50
xAndorx: folds 
bilukm: calls $2
Venomous100%: folds 
*** FLOP *** [8c 2s 3s]
bilukm: bets $2.86
hammerwife: folds 
Uncalled bet ($2.86) returned to bilukm
bilukm collected $5.73 from pot
bilukm: doesn't show hand 
*** SUMMARY ***
Total pot $6 | Rake $0.27 
Board [8c 2s 3s]
Seat 1: matiko09 folded before Flop (didn't bet)
Seat 2: mycka86 folded before Flop (didn't bet)
Seat 3: sebaaastian folded before Flop (didn't bet)
Seat 4: hammerwife folded on the Flop
Seat 6: xAndorx (button) folded before Flop (didn't bet)
Seat 7: bilukm (small blind) collected ($5.73)
Seat 8: Venomous100% (big blind) folded before Flop





PokerStars Hand #149395028702:  Hold'em No Limit ($0.25/$0.50 USD) - 2016/02/25 17:44:56 CET [2016/02/25 11:44:56 ET]
Table 'Vladimir' 9-max Seat #1 is the button
Seat 1: matiko09 ($50.02 in chips) 
Seat 2: Vedpapa ($50.25 in chips) 
Seat 3: Troll8989 ($50 in chips) 
Seat 5: Al3xAnd3r22 ($53.58 in chips) 
Seat 6: ihami ($45 in chips) 
Seat 7: myllow1 ($67.25 in chips) 
Vedpapa: posts small blind $0.25
Troll8989: posts big blind $0.50
ffac: sits out 
AceFarky: sits out 
*** HOLE CARDS ***
Dealt to matiko09 [9s Qh]
Al3xAnd3r22: raises $1 to $1.50
ihami: folds 
myllow1: folds 
matiko09: folds 
Vedpapa: calls $1.25
Troll8989: folds 
*** FLOP *** [5s Kh 4c]
Vedpapa: bets $2
Al3xAnd3r22: folds 
Uncalled bet ($2) returned to Vedpapa
Vedpapa collected $3.34 from pot
Vedpapa: doesn't show hand 
*** SUMMARY ***
Total pot $3.50 | Rake $0.16 
Board [5s Kh 4c]
Seat 1: matiko09 (button) folded before Flop (didn't bet)
Seat 2: Vedpapa (small blind) collected ($3.34)
Seat 3: Troll8989 (big blind) folded before Flop
Seat 5: Al3xAnd3r22 folded on the Flop
Seat 6: ihami folded before Flop (didn't bet)
Seat 7: myllow1 folded before Flop (didn't bet)





PokerStars Hand #149395031390:  Hold'em No Limit ($0.50/$1.00 USD) - 2016/02/25 17:44:59 CET [2016/02/25 11:44:59 ET]
Table 'Nerthus II' 9-max Seat #2 is the button
Seat 1: volwebni4ek ($81.65 in chips) 
Seat 2: matiko09 ($217.18 in chips) 
Seat 3: simoniustin ($120.86 in chips) 
Seat 4: Ilov3NBA ($101.50 in chips) 
Seat 6: mycka86 ($142.88 in chips) 
Seat 7: Venomous100% ($107.15 in chips) 
Seat 9: hammerwife ($100 in chips) 
simoniustin: posts small blind $0.50
Ilov3NBA: posts big blind $1
*** HOLE CARDS ***
Dealt to matiko09 [Kh Ad]
mycka86: folds 
Venomous100%: folds 
hammerwife: folds 
volwebni4ek: folds 
matiko09: raises $1.27 to $2.27
simoniustin: raises $8.73 to $11
Ilov3NBA: folds 
meischt94 joins the table at seat #8 
matiko09: raises $13 to $24
simoniustin: raises $96.86 to $120.86 and is all-in
matiko09: calls $96.86
*** FLOP *** [7c Ts 6h]
*** TURN *** [7c Ts 6h] [Js]
*** RIVER *** [7c Ts 6h Js] [Tc]
*** SHOW DOWN ***
simoniustin: shows [As Kc] (a pair of Tens)
matiko09: shows [Kh Ad] (a pair of Tens)
simoniustin collected $119.96 from pot
matiko09 collected $119.96 from pot
*** SUMMARY ***
Total pot $242.72 | Rake $2.80 
Board [7c Ts 6h Js Tc]
Seat 1: volwebni4ek folded before Flop (didn't bet)
Seat 2: matiko09 (button) showed [Kh Ad] and won ($119.96) with a pair of Tens
Seat 3: simoniustin (small blind) showed [As Kc] and won ($119.96) with a pair of Tens
Seat 4: Ilov3NBA (big blind) folded before Flop
Seat 6: mycka86 folded before Flop (didn't bet)
Seat 7: Venomous100% folded before Flop (didn't bet)
Seat 9: hammerwife folded before Flop (didn't bet)





PokerStars Hand #149395038410:  Hold'em No Limit ($0.50/$1.00 USD) - 2016/02/25 17:45:07 CET [2016/02/25 11:45:07 ET]
Table 'Mayall II' 9-max Seat #7 is the button
Seat 1: matiko09 ($122.94 in chips) 
Seat 3: simoniustin ($124.14 in chips) 
Seat 4: C. Duke 19 ($105.98 in chips) 
Seat 5: McFussball81 ($60.07 in chips) 
Seat 6: apfush ($100 in chips) 
Seat 7: r.pol218 ($38.48 in chips) 
Seat 8: kuanhung0903 ($79.37 in chips) 
Seat 9: xAndorx ($131.84 in chips) 
kuanhung0903: posts small blind $0.50
xAndorx: posts big blind $1
*** HOLE CARDS ***
Dealt to matiko09 [As 5d]
matiko09: folds 
simoniustin: folds 
C. Duke 19: folds 
McFussball81: raises $2 to $3
apfush: folds 
r.pol218: folds 
kuanhung0903: folds 
xAndorx: calls $2
*** FLOP *** [4c Jh Kc]
xAndorx: checks 
McFussball81: checks 
*** TURN *** [4c Jh Kc] [Qc]
xAndorx: bets $4
McFussball81: calls $4
*** RIVER *** [4c Jh Kc Qc] [Qh]
xAndorx: checks 
McFussball81: checks 
*** SHOW DOWN ***
xAndorx: shows [Ks 7s] (two pair, Kings and Queens)
McFussball81: shows [Qd Ad] (three of a kind, Queens)
McFussball81 collected $13.85 from pot
*** SUMMARY ***
Total pot $14.50 | Rake $0.65 
Board [4c Jh Kc Qc Qh]
Seat 1: matiko09 folded before Flop (didn't bet)
Seat 3: simoniustin folded before Flop (didn't bet)
Seat 4: C. Duke 19 folded before Flop (didn't bet)
Seat 5: McFussball81 showed [Qd Ad] and won ($13.85) with three of a kind, Queens
Seat 6: apfush folded before Flop (didn't bet)
Seat 7: r.pol218 (button) folded before Flop (didn't bet)
Seat 8: kuanhung0903 (small blind) folded before Flop
Seat 9: xAndorx (big blind) showed [Ks 7s] and lost with two pair, Kings and Queens





PokerStars Hand #149395040697:  Hold'em No Limit ($0.50/$1.00 USD) - 2016/02/25 17:45:10 CET [2016/02/25 11:45:10 ET]
Table 'Morosovia II' 9-max Seat #4 is the button
Seat 1: $-Twackle-$ ($100 in chips) 
Seat 3: sebaaastian ($198.73 in chips) 
Seat 4: renechris ($93.61 in chips) 
Seat 5: gabi_igna ($149.14 in chips) 
Seat 6: Dachish ($69 in chips) 
Seat 7: matiko09 ($147.48 in chips) 
Seat 8: simoniustin ($114.59 in chips) 
Seat 9: lysandrafly ($119.44 in chips) 
gabi_igna: posts small blind $0.50
Dachish: posts big blind $1
*** HOLE CARDS ***
Dealt to matiko09 [7h 8h]
matiko09: raises $2 to $3
simoniustin: folds 
lysandrafly: folds 
$-Twackle-$: folds 
sebaaastian: folds 
renechris: folds 
gabi_igna: calls $2.50
Dachish: folds 
*** FLOP *** [4s 3d 8d]
gabi_igna: checks 
matiko09: bets $4.34
gabi_igna: raises $10.66 to $15
matiko09: folds 
Uncalled bet ($10.66) returned to gabi_igna
gabi_igna collected $14.97 from pot
gabi_igna: doesn't show hand 
*** SUMMARY ***
Total pot $15.68 | Rake $0.71 
Board [4s 3d 8d]
Seat 1: $-Twackle-$ folded before Flop (didn't bet)
Seat 3: sebaaastian folded before Flop (didn't bet)
Seat 4: renechris (button) folded before Flop (didn't bet)
Seat 5: gabi_igna (small blind) collected ($14.97)
Seat 6: Dachish (big blind) folded before Flop
Seat 7: matiko09 folded on the Flop
Seat 8: simoniustin folded before Flop (didn't bet)
Seat 9: lysandrafly folded before Flop (didn't bet)





PokerStars Hand #149395041647:  Hold'em No Limit ($0.50/$1.00 USD) - 2016/02/25 17:45:11 CET [2016/02/25 11:45:11 ET]
Table 'Sabine' 9-max Seat #2 is the button
Seat 1: MGMmacca ($64.63 in chips) 
Seat 2: apfush ($117.45 in chips) 
Seat 3: oscarleon ($118.45 in chips) 
Seat 4: simoniustin ($100 in chips) 
Seat 8: matiko09 ($183.66 in chips) 
Seat 9: Dachish ($80.26 in chips) 
oscarleon: posts small blind $0.50
simoniustin: posts big blind $1
$-Twackle-$: sits out 
*** HOLE CARDS ***
Dealt to matiko09 [7s 9c]
matiko09: folds 
Dachish: folds 
MGMmacca: raises $2.50 to $3.50
apfush: folds 
oscarleon: raises $6.50 to $10
simoniustin: calls $9
MGMmacca: raises $54.63 to $64.63 and is all-in
oscarleon: calls $54.63
simoniustin: folds 
*** FLOP *** [Qh 8h Qc]
*** TURN *** [Qh 8h Qc] [7h]
*** RIVER *** [Qh 8h Qc 7h] [4d]
*** SHOW DOWN ***
oscarleon: shows [Jh Js] (two pair, Queens and Jacks)
MGMmacca: shows [Ts Th] (two pair, Queens and Tens)
oscarleon collected $136.46 from pot
*** SUMMARY ***
Total pot $139.26 | Rake $2.80 
Board [Qh 8h Qc 7h 4d]
Seat 1: MGMmacca showed [Ts Th] and lost with two pair, Queens and Tens
Seat 2: apfush (button) folded before Flop (didn't bet)
Seat 3: oscarleon (small blind) showed [Jh Js] and won ($136.46) with two pair, Queens and Jacks
Seat 4: simoniustin (big blind) folded before Flop
Seat 8: matiko09 folded before Flop (didn't bet)
Seat 9: Dachish folded before Flop (didn't bet)





PokerStars Hand #149395041484:  Hold'em No Limit (€0.25/€0.50 EUR) - 2016/02/25 17:45:11 CET [2016/02/25 11:45:11 ET]
Table 'Diadem IV' 9-max Seat #1 is the button
Seat 1: Ganador79 (€44.43 in chips) 
Seat 3: timbo_5563 (€23 in chips) 
Seat 5: matiko09 (€50 in chips) 
timbo_5563: posts small blind €0.25
matiko09: posts big blind €0.50
*** HOLE CARDS ***
Dealt to matiko09 [2s Jh]
Ganador79: folds 
timbo_5563: raises €0.50 to €1
matiko09: folds 
Uncalled bet (€0.50) returned to timbo_5563
timbo_5563 collected €1 from pot
timbo_5563: doesn't show hand 
*** SUMMARY ***
Total pot €1 | Rake €0 
Seat 1: Ganador79 (button) folded before Flop (didn't bet)
Seat 3: timbo_5563 (small blind) collected (€1)
Seat 5: matiko09 (big blind) folded before Flop





PokerStars Hand #149395048836:  Hold'em No Limit (€0.25/€0.50 EUR) - 2016/02/25 17:45:20 CET [2016/02/25 11:45:20 ET]
Table 'Diadem IV' 9-max Seat #3 is the button
Seat 1: Ganador79 (€44.43 in chips) 
Seat 3: timbo_5563 (€23.50 in chips) 
Seat 5: matiko09 (€50 in chips) 
matiko09: posts small blind €0.25
Ganador79: posts big blind €0.50
*** HOLE CARDS ***
Dealt to matiko09 [5c 7d]
timbo_5563: raises €0.50 to €1
Al3xAnd3r22 joins the table at seat #6 
matiko09: folds 
Ganador79: folds 
Uncalled bet (€0.50) returned to timbo_5563
timbo_5563 collected €1.25 from pot
timbo_5563: doesn't show hand 
*** SUMMARY ***
Total pot €1.25 | Rake €0 
Seat 1: Ganador79 (big blind) folded before Flop
Seat 3: timbo_5563 (button) collected (€1.25)
Seat 5: matiko09 (small blind) folded before Flop





PokerStars Hand #149395055380:  Hold'em No Limit (€0.25/€0.50 EUR) - 2016/02/25 17:45:28 CET [2016/02/25 11:45:28 ET]
Table 'Diadem IV' 9-max Seat #5 is the button
Seat 1: Ganador79 (€43.93 in chips) 
Seat 3: timbo_5563 (€24.25 in chips) 
Seat 5: matiko09 (€50 in chips) 
Al3xAnd3r22 will be allowed to play after the button
Ganador79: posts small blind €0.25
timbo_5563: posts big blind €0.50
*** HOLE CARDS ***
Dealt to matiko09 [2c Qd]
matiko09: folds 
Ganador79: folds 
Uncalled bet (€0.25) returned to timbo_5563
timbo_5563 collected €0.50 from pot
timbo_5563: doesn't show hand 
*** SUMMARY ***
Total pot €0.50 | Rake €0 
Seat 1: Ganador79 (small blind) folded before Flop
Seat 3: timbo_5563 (big blind) collected (€0.50)
Seat 5: matiko09 (button) folded before Flop (didn't bet)





PokerStars Hand #149395061349:  Hold'em No Limit ($0.50/$1.00 USD) - 2016/02/25 17:45:36 CET [2016/02/25 11:45:36 ET]
Table 'Syrma II' 9-max Seat #5 is the button
Seat 3: shayu 9988 ($81.12 in chips) 
Seat 4: volwebni4ek ($73.34 in chips) 
Seat 5: BIGWIN2016 ($89.30 in chips) 
Seat 6: matiko09 ($100 in chips) 
Seat 7: lysandrafly ($100 in chips) 
matiko09: posts small blind $0.50
lysandrafly: posts big blind $1
xAndorx: sits out 
Venomous100%: sits out 
$-Twackle-$: sits out 
*** HOLE CARDS ***
Dealt to matiko09 [7c Ad]
shayu 9988: folds 
volwebni4ek: folds 
BIGWIN2016: folds 
matiko09: raises $1.50 to $2.50
lysandrafly: raises $6.50 to $9
matiko09: folds 
Uncalled bet ($6.50) returned to lysandrafly
lysandrafly collected $5 from pot
lysandrafly: doesn't show hand 
*** SUMMARY ***
Total pot $5 | Rake $0 
Seat 3: shayu 9988 folded before Flop (didn't bet)
Seat 4: volwebni4ek folded before Flop (didn't bet)
Seat 5: BIGWIN2016 (button) folded before Flop (didn't bet)
Seat 6: matiko09 (small blind) folded before Flop
Seat 7: lysandrafly (big blind) collected ($5)





PokerStars Hand #149395062284:  Hold'em No Limit (€0.25/€0.50 EUR) - 2016/02/25 17:45:37 CET [2016/02/25 11:45:37 ET]
Table 'Prokne II' 9-max Seat #4 is the button
Seat 1: Al3xAnd3r22 (€61.95 in chips) 
Seat 2: payback11 (€50 in chips) 
Seat 3: JustR82 (€51.16 in chips) 
Seat 4: carlito cri (€32.28 in chips) 
Seat 5: Makitra (€52.49 in chips) 
Seat 6: matiko09 (€50 in chips) 
Seat 7: lysandrafly (€64.10 in chips) 
Seat 9: ihami (€55.10 in chips) 
Makitra: posts small blind €0.25
matiko09: posts big blind €0.50
*** HOLE CARDS ***
Dealt to matiko09 [Jc 3s]
lysandrafly: folds 
ihami: folds 
Al3xAnd3r22: folds 
payback11: folds 
JustR82: folds 
carlito cri: calls €0.50
Makitra: folds 
matiko09: checks 
*** FLOP *** [8d Jh Ah]
matiko09: checks 
carlito cri: checks 
*** TURN *** [8d Jh Ah] [Tc]
matiko09: checks 
carlito cri: bets €0.50
matiko09: calls €0.50
*** RIVER *** [8d Jh Ah Tc] [7h]
matiko09: checks 
carlito cri: bets €1.50
matiko09: folds 
Uncalled bet (€1.50) returned to carlito cri
carlito cri collected €2.15 from pot
carlito cri: doesn't show hand 
*** SUMMARY ***
Total pot €2.25 | Rake €0.10 
Board [8d Jh Ah Tc 7h]
Seat 1: Al3xAnd3r22 folded before Flop (didn't bet)
Seat 2: payback11 folded before Flop (didn't bet)
Seat 3: JustR82 folded before Flop (didn't bet)
Seat 4: carlito cri (button) collected (€2.15)
Seat 5: Makitra (small blind) folded before Flop
Seat 6: matiko09 (big blind) folded on the River
Seat 7: lysandrafly folded before Flop (didn't bet)
Seat 9: ihami folded before Flop (didn't bet)





PokerStars Hand #149395064062:  Hold'em No Limit (€0.25/€0.50 EUR) - 2016/02/25 17:45:39 CET [2016/02/25 11:45:39 ET]
Table 'Diadem IV' 9-max Seat #1 is the button
Seat 1: Ganador79 (€43.68 in chips) 
Seat 3: timbo_5563 (€24.50 in chips) 
Seat 5: matiko09 (€50 in chips) 
timbo_5563: posts small blind €0.25
matiko09: posts big blind €0.50
Al3xAnd3r22: sits out 
*** HOLE CARDS ***
Dealt to matiko09 [6c Tc]
Ganador79: folds 
timbo_5563: folds 
Uncalled bet (€0.25) returned to matiko09
matiko09 collected €0.50 from pot
matiko09: doesn't show hand 
*** SUMMARY ***
Total pot €0.50 | Rake €0 
Seat 1: Ganador79 (button) folded before Flop (didn't bet)
Seat 3: timbo_5563 (small blind) folded before Flop
Seat 5: matiko09 (big blind) collected (€0.50)





PokerStars Hand #149395064199:  Hold'em No Limit ($0.50/$1.00 USD) - 2016/02/25 17:45:39 CET [2016/02/25 11:45:39 ET]
Table 'Eurysaces II' 9-max Seat #5 is the button
Seat 1: lysandrafly ($110.58 in chips) 
Seat 2: sebaaastian ($205.48 in chips) 
Seat 3: Aalleekks ($100 in chips) 
Seat 4: gabi_igna ($109.25 in chips) 
Seat 5: keessie93 ($130.12 in chips) 
Seat 6: J0rmungund ($53.71 in chips) 
Seat 7: $-Twackle-$ ($100 in chips) 
Seat 8: hammerwife ($100 in chips) 
Seat 9: matiko09 ($100 in chips) 
J0rmungund: posts small blind $0.50
$-Twackle-$: posts big blind $1
*** HOLE CARDS ***
Dealt to matiko09 [5h 6c]
hammerwife: folds 
matiko09: folds 
lysandrafly: raises $2 to $3
sebaaastian: folds 
Aalleekks: folds 
gabi_igna: folds 
keessie93: folds 
J0rmungund: folds 
$-Twackle-$: raises $6.50 to $9.50
lysandrafly: folds 
Uncalled bet ($6.50) returned to $-Twackle-$
$-Twackle-$ collected $6.50 from pot
$-Twackle-$: doesn't show hand 
*** SUMMARY ***
Total pot $6.50 | Rake $0 
Seat 1: lysandrafly folded before Flop
Seat 2: sebaaastian folded before Flop (didn't bet)
Seat 3: Aalleekks folded before Flop (didn't bet)
Seat 4: gabi_igna folded before Flop (didn't bet)
Seat 5: keessie93 (button) folded before Flop (didn't bet)
Seat 6: J0rmungund (small blind) folded before Flop
Seat 7: $-Twackle-$ (big blind) collected ($6.50)
Seat 8: hammerwife folded before Flop (didn't bet)
Seat 9: matiko09 folded before Flop (didn't bet)





PokerStars Hand #149395067057:  Hold'em No Limit ($0.25/$0.50 USD) - 2016/02/25 17:45:42 CET [2016/02/25 11:45:42 ET]
Table 'Lohja II' 9-max Seat #7 is the button
Seat 1: MoonJimmy ($161.90 in chips) 
Seat 2: mycka86 ($56.38 in chips) 
Seat 4: payback11 ($50 in chips) 
Seat 6: xAndorx ($63.21 in chips) 
Seat 7: matiko09 ($92.02 in chips) 
Seat 8: pasa132 ($65 in chips) 
Seat 9: Al3xAnd3r22 ($140.77 in chips) 
pasa132: posts small blind $0.25
Al3xAnd3r22: posts big blind $0.50
MoonJimmy: posts the ante $0.10
mycka86: posts the ante $0.10
payback11: posts the ante $0.10
xAndorx: posts the ante $0.10
matiko09: posts the ante $0.10
pasa132: posts the ante $0.10
Al3xAnd3r22: posts the ante $0.10
*** HOLE CARDS ***
Dealt to matiko09 [Qc Qh]
MoonJimmy: folds 
mycka86: folds 
payback11: folds 
xAndorx: folds 
matiko09: raises $1 to $1.50
pasa132: folds 
Al3xAnd3r22: folds 
Uncalled bet ($1) returned to matiko09
matiko09 collected $1.95 from pot
matiko09: doesn't show hand 
*** SUMMARY ***
Total pot $1.95 | Rake $0 
Seat 1: MoonJimmy folded before Flop (didn't bet)
Seat 2: mycka86 folded before Flop (didn't bet)
Seat 4: payback11 folded before Flop (didn't bet)
Seat 6: xAndorx folded before Flop (didn't bet)
Seat 7: matiko09 (button) collected ($1.95)
Seat 8: pasa132 (small blind) folded before Flop
Seat 9: Al3xAnd3r22 (big blind) folded before Flop





PokerStars Hand #149395068438:  Hold'em No Limit (€0.25/€0.50 EUR) - 2016/02/25 17:45:44 CET [2016/02/25 11:45:44 ET]
Table 'Diadem IV' 9-max Seat #3 is the button
Seat 1: Ganador79 (€43.68 in chips) 
Seat 3: timbo_5563 (€24.25 in chips) 
Seat 5: matiko09 (€50.25 in chips) 
Seat 6: Al3xAnd3r22 (€61.24 in chips) 
matiko09: posts small blind €0.25
Al3xAnd3r22: posts big blind €0.50
*** HOLE CARDS ***
Dealt to matiko09 [Tc 6s]
Ganador79: folds 
timbo_5563: calls €0.50
matiko09: folds 
JustR82 joins the table at seat #7 
Al3xAnd3r22: checks 
*** FLOP *** [3c Th Qs]
Al3xAnd3r22: checks 
timbo_5563: checks 
*** TURN *** [3c Th Qs] [5c]
Al3xAnd3r22: bets €0.66
timbo_5563: calls €0.66
*** RIVER *** [3c Th Qs 5c] [Ah]
Al3xAnd3r22: checks 
timbo_5563: bets €0.50
Troll8989 joins the table at seat #8 
Al3xAnd3r22: folds 
Uncalled bet (€0.50) returned to timbo_5563
timbo_5563 collected €2.45 from pot
timbo_5563: doesn't show hand 
*** SUMMARY ***
Total pot €2.57 | Rake €0.12 
Board [3c Th Qs 5c Ah]
Seat 1: Ganador79 folded before Flop (didn't bet)
Seat 3: timbo_5563 (button) collected (€2.45)
Seat 5: matiko09 (small blind) folded before Flop
Seat 6: Al3xAnd3r22 (big blind) folded on the River





PokerStars Hand #149395072290:  Hold'em No Limit ($0.25/$0.50 USD) - 2016/02/25 17:45:49 CET [2016/02/25 11:45:49 ET]
Table 'Vladimir' 9-max Seat #2 is the button
Seat 1: matiko09 ($50.02 in chips) 
Seat 2: Vedpapa ($52.09 in chips) 
Seat 3: Troll8989 ($50 in chips) 
Seat 4: ffac ($58.85 in chips) 
Seat 5: Al3xAnd3r22 ($52.08 in chips) 
Seat 6: ihami ($45 in chips) 
Seat 7: myllow1 ($67.25 in chips) 
Troll8989: posts small blind $0.25
ffac: posts big blind $0.50
Effort92: sits out 
AceFarky: sits out 
*** HOLE CARDS ***
Dealt to matiko09 [Td 4h]
Al3xAnd3r22: folds 
ihami: raises $0.50 to $1
myllow1: folds 
matiko09: folds 
Vedpapa: folds 
Troll8989: folds 
ffac: folds 
Uncalled bet ($0.50) returned to ihami
ihami collected $1.25 from pot
*** SUMMARY ***
Total pot $1.25 | Rake $0 
Seat 1: matiko09 folded before Flop (didn't bet)
Seat 2: Vedpapa (button) folded before Flop (didn't bet)
Seat 3: Troll8989 (small blind) folded before Flop
Seat 4: ffac (big blind) folded before Flop
Seat 5: Al3xAnd3r22 folded before Flop (didn't bet)
Seat 6: ihami collected ($1.25)
Seat 7: myllow1 folded before Flop (didn't bet)





PokerStars Hand #149395073574:  Hold'em No Limit ($0.50/$1.00 USD) - 2016/02/25 17:45:50 CET [2016/02/25 11:45:50 ET]
Table 'Zerbinetta II' 9-max Seat #8 is the button
Seat 1: $-Twackle-$ ($100 in chips) 
Seat 3: matiko09 ($102.25 in chips) 
Seat 4: sebaaastian ($100 in chips) 
Seat 5: hammerwife ($118.27 in chips) 
Seat 6: simoniustin ($100 in chips) 
Seat 8: gabi_igna ($116.90 in chips) 
$-Twackle-$: posts small blind $0.50
ffac: is sitting out 
matiko09: posts big blind $1
*** HOLE CARDS ***
Dealt to matiko09 [9s 4h]
sebaaastian: raises $2 to $3
hammerwife: folds 
with-w leaves the table
volwebni4ek joins the table at seat #9 
volwebni4ek leaves the table
ffac leaves the table
simoniustin: folds 
gabi_igna: calls $3
$-Twackle-$: folds 
matiko09: folds 
*** FLOP *** [8s Td 3c]
sebaaastian: bets $4
gabi_igna: calls $4
*** TURN *** [8s Td 3c] [2c]
sebaaastian: checks 
gabi_igna: bets $4
sebaaastian: raises $7 to $11
gabi_igna: calls $7
*** RIVER *** [8s Td 3c 2c] [5h]
sebaaastian: bets $21
gabi_igna: folds 
Uncalled bet ($21) returned to sebaaastian
sebaaastian collected $35.81 from pot
sebaaastian: doesn't show hand 
*** SUMMARY ***
Total pot $37.50 | Rake $1.69 
Board [8s Td 3c 2c 5h]
Seat 1: $-Twackle-$ (small blind) folded before Flop
Seat 3: matiko09 (big blind) folded before Flop
Seat 4: sebaaastian collected ($35.81)
Seat 5: hammerwife folded before Flop (didn't bet)
Seat 6: simoniustin folded before Flop (didn't bet)
Seat 8: gabi_igna (button) folded on the River





PokerStars Hand #149395075582:  Hold'em No Limit ($0.50/$1.00 USD) - 2016/02/25 17:45:53 CET [2016/02/25 11:45:53 ET]
Table 'Isa' 9-max Seat #7 is the button
Seat 1: matiko09 ($124.58 in chips) 
Seat 2: mycka86 ($158.31 in chips) 
Seat 3: sebaaastian ($153.30 in chips) 
Seat 4: hammerwife ($133.45 in chips) 
Seat 6: xAndorx ($100 in chips) 
Seat 7: bilukm ($66.59 in chips) 
Seat 8: Venomous100% ($110.74 in chips) 
Seat 9: volwebni4ek ($53.36 in chips) 
Venomous100%: posts small blind $0.50
volwebni4ek: posts big blind $1
gabi_igna: sits out 
*** HOLE CARDS ***
Dealt to matiko09 [7d Qd]
matiko09: folds 
mycka86: folds 
sebaaastian: folds 
hammerwife: folds 
xAndorx: raises $1.50 to $2.50
bilukm: folds 
Venomous100%: folds 
volwebni4ek: folds 
Uncalled bet ($1.50) returned to xAndorx
xAndorx collected $2.50 from pot
xAndorx: doesn't show hand 
*** SUMMARY ***
Total pot $2.50 | Rake $0 
Seat 1: matiko09 folded before Flop (didn't bet)
Seat 2: mycka86 folded before Flop (didn't bet)
Seat 3: sebaaastian folded before Flop (didn't bet)
Seat 4: hammerwife folded before Flop (didn't bet)
Seat 6: xAndorx collected ($2.50)
Seat 7: bilukm (button) folded before Flop (didn't bet)
Seat 8: Venomous100% (small blind) folded before Flop
Seat 9: volwebni4ek (big blind) folded before Flop





PokerStars Hand #149395076373:  Hold'em No Limit ($0.50/$1.00 USD) - 2016/02/25 17:45:54 CET [2016/02/25 11:45:54 ET]
Table 'Badenia II' 9-max Seat #6 is the button
Seat 1: matiko09 ($100 in chips) 
Seat 3: sebaaastian ($155.57 in chips) 
Seat 4: hammerwife ($106.49 in chips) 
Seat 5: Ilov3NBA ($100 in chips) 
Seat 6: Dachish ($70.08 in chips) 
Seat 8: McFussball81 ($59.54 in chips) 
Seat 9: waisanen ($238.92 in chips) 
McFussball81: posts small blind $0.50
waisanen: posts big blind $1
$-Twackle-$: sits out 
*** HOLE CARDS ***
Dealt to matiko09 [2h 9c]
matiko09: folds 
sebaaastian: folds 
hammerwife: folds 
Ilov3NBA: folds 
Dachish: folds 
McFussball81: raises $1 to $2
waisanen: calls $1
*** FLOP *** [9d Th Ks]
McFussball81: checks 
waisanen: checks 
*** TURN *** [9d Th Ks] [Ad]
McFussball81: checks 
waisanen: bets $3.82
McFussball81: calls $3.82
*** RIVER *** [9d Th Ks Ad] [8s]
McFussball81: checks 
waisanen: bets $11.12
McFussball81: folds 
Uncalled bet ($11.12) returned to waisanen
waisanen collected $11.12 from pot
*** SUMMARY ***
Total pot $11.64 | Rake $0.52 
Board [9d Th Ks Ad 8s]
Seat 1: matiko09 folded before Flop (didn't bet)
Seat 3: sebaaastian folded before Flop (didn't bet)
Seat 4: hammerwife folded before Flop (didn't bet)
Seat 5: Ilov3NBA folded before Flop (didn't bet)
Seat 6: Dachish (button) folded before Flop (didn't bet)
Seat 8: McFussball81 (small blind) folded on the River
Seat 9: waisanen (big blind) collected ($11.12)





PokerStars Hand #149395077049:  Hold'em No Limit ($0.50/$1.00 USD) - 2016/02/25 17:45:55 CET [2016/02/25 11:45:55 ET]
Table 'Sabine' 9-max Seat #3 is the button
Seat 2: apfush ($117.45 in chips) 
Seat 3: oscarleon ($190.28 in chips) 
Seat 4: simoniustin ($100 in chips) 
Seat 6: $-Twackle-$ ($100 in chips) 
Seat 8: matiko09 ($183.66 in chips) 
Seat 9: Dachish ($80.26 in chips) 
simoniustin: posts small blind $0.50
$-Twackle-$: posts big blind $1
*** HOLE CARDS ***
Dealt to matiko09 [Kh 9d]
matiko09: folds 
Dachish: folds 
apfush: raises $1.50 to $2.50
oscarleon: folds 
simoniustin: folds 
$-Twackle-$: raises $6.50 to $9
apfush: raises $10 to $19
$-Twackle-$: folds 
Uncalled bet ($10) returned to apfush
apfush collected $18.50 from pot
apfush: doesn't show hand 
*** SUMMARY ***
Total pot $18.50 | Rake $0 
Seat 2: apfush collected ($18.50)
Seat 3: oscarleon (button) folded before Flop (didn't bet)
Seat 4: simoniustin (small blind) folded before Flop
Seat 6: $-Twackle-$ (big blind) folded before Flop
Seat 8: matiko09 folded before Flop (didn't bet)
Seat 9: Dachish folded before Flop (didn't bet)





PokerStars Hand #149395080354:  Hold'em No Limit ($0.50/$1.00 USD) - 2016/02/25 17:45:59 CET [2016/02/25 11:45:59 ET]
Table 'Morosovia II' 9-max Seat #5 is the button
Seat 1: $-Twackle-$ ($100 in chips) 
Seat 3: sebaaastian ($198.73 in chips) 
Seat 4: renechris ($93.61 in chips) 
Seat 5: gabi_igna ($156.77 in chips) 
Seat 6: Dachish ($68 in chips) 
Seat 7: matiko09 ($140.14 in chips) 
Seat 8: simoniustin ($114.59 in chips) 
Seat 9: lysandrafly ($119.44 in chips) 
Dachish: posts small blind $0.50
matiko09: posts big blind $1
Effort92: sits out 
*** HOLE CARDS ***
Dealt to matiko09 [5s 5h]
simoniustin has timed out
simoniustin: folds 
lysandrafly: folds 
$-Twackle-$: raises $2 to $3
sebaaastian: folds 
renechris has timed out
renechris: folds 
gabi_igna: folds 
Dachish: folds 
matiko09: calls $2
*** FLOP *** [2s Jc 6c]
matiko09: checks 
$-Twackle-$: bets $4.50
matiko09: folds 
Uncalled bet ($4.50) returned to $-Twackle-$
$-Twackle-$ collected $6.21 from pot
$-Twackle-$: doesn't show hand 
*** SUMMARY ***
Total pot $6.50 | Rake $0.29 
Board [2s Jc 6c]
Seat 1: $-Twackle-$ collected ($6.21)
Seat 3: sebaaastian folded before Flop (didn't bet)
Seat 4: renechris folded before Flop (didn't bet)
Seat 5: gabi_igna (button) folded before Flop (didn't bet)
Seat 6: Dachish (small blind) folded before Flop
Seat 7: matiko09 (big blind) folded on the Flop
Seat 8: simoniustin folded before Flop (didn't bet)
Seat 9: lysandrafly folded before Flop (didn't bet)





PokerStars Hand #149395086401:  Hold'em No Limit ($0.50/$1.00 USD) - 2016/02/25 17:46:06 CET [2016/02/25 11:46:06 ET]
Table 'Nerthus II' 9-max Seat #3 is the button
Seat 1: volwebni4ek ($81.65 in chips) 
Seat 2: matiko09 ($216.28 in chips) 
Seat 3: simoniustin ($119.96 in chips) 
Seat 4: Ilov3NBA ($100.50 in chips) 
Seat 6: mycka86 ($142.88 in chips) 
Seat 7: Venomous100% ($107.15 in chips) 
Seat 9: hammerwife ($100 in chips) 
Ilov3NBA: posts small blind $0.50
mycka86: posts big blind $1
meischt94: sits out 
*** HOLE CARDS ***
Dealt to matiko09 [7c 4d]
Venomous100%: folds 
hammerwife: folds 
volwebni4ek: folds 
matiko09: folds 
simoniustin: folds 
Ilov3NBA: raises $2.50 to $3.50
mycka86: calls $2.50
*** FLOP *** [5s 9h 7h]
Ilov3NBA: checks 
mycka86: bets $4.80
Ilov3NBA: folds 
Uncalled bet ($4.80) returned to mycka86
mycka86 collected $6.68 from pot
*** SUMMARY ***
Total pot $7 | Rake $0.32 
Board [5s 9h 7h]
Seat 1: volwebni4ek folded before Flop (didn't bet)
Seat 2: matiko09 folded before Flop (didn't bet)
Seat 3: simoniustin (button) folded before Flop (didn't bet)
Seat 4: Ilov3NBA (small blind) folded on the Flop
Seat 6: mycka86 (big blind) collected ($6.68)
Seat 7: Venomous100% folded before Flop (didn't bet)
Seat 9: hammerwife folded before Flop (didn't bet)





PokerStars Hand #149395092204:  Hold'em No Limit ($0.50/$1.00 USD) - 2016/02/25 17:46:13 CET [2016/02/25 11:46:13 ET]
Table 'Mayall II' 9-max Seat #8 is the button
Seat 1: matiko09 ($122.94 in chips) 
Seat 3: simoniustin ($124.14 in chips) 
Seat 4: C. Duke 19 ($105.98 in chips) 
Seat 5: McFussball81 ($66.92 in chips) 
Seat 6: apfush ($100 in chips) 
Seat 7: r.pol218 ($38.48 in chips) 
Seat 8: kuanhung0903 ($78.87 in chips) 
Seat 9: xAndorx ($124.84 in chips) 
xAndorx: posts small blind $0.50
matiko09: posts big blind $1
*** HOLE CARDS ***
Dealt to matiko09 [2d 3s]
simoniustin: folds 
C. Duke 19: raises $2 to $3
McFussball81: folds 
apfush: folds 
r.pol218: calls $3
kuanhung0903: folds 
xAndorx: folds 
matiko09: folds 
*** FLOP *** [Td Ad As]
C. Duke 19: bets $3.58
r.pol218: calls $3.58
*** TURN *** [Td Ad As] [8s]
C. Duke 19: checks 
r.pol218: bets $3
C. Duke 19: folds 
Uncalled bet ($3) returned to r.pol218
r.pol218 collected $14 from pot
r.pol218: doesn't show hand 
*** SUMMARY ***
Total pot $14.66 | Rake $0.66 
Board [Td Ad As 8s]
Seat 1: matiko09 (big blind) folded before Flop
Seat 3: simoniustin folded before Flop (didn't bet)
Seat 4: C. Duke 19 folded on the Turn
Seat 5: McFussball81 folded before Flop (didn't bet)
Seat 6: apfush folded before Flop (didn't bet)
Seat 7: r.pol218 collected ($14)
Seat 8: kuanhung0903 (button) folded before Flop (didn't bet)
Seat 9: xAndorx (small blind) folded before Flop





PokerStars Hand #149395096896:  Hold'em No Limit ($0.25/$0.50 USD) - 2016/02/25 17:46:19 CET [2016/02/25 11:46:19 ET]
Table 'Vladimir' 9-max Seat #3 is the button
Seat 1: matiko09 ($50.02 in chips) 
Seat 2: Vedpapa ($52.09 in chips) 
Seat 3: Troll8989 ($50 in chips) 
Seat 4: ffac ($58.35 in chips) 
Seat 5: Al3xAnd3r22 ($52.08 in chips) 
Seat 6: ihami ($45.75 in chips) 
Seat 7: myllow1 ($67.25 in chips) 
ffac: posts small blind $0.25
Al3xAnd3r22: posts big blind $0.50
Effort92: sits out 
AceFarky: sits out 
*** HOLE CARDS ***
Dealt to matiko09 [Qs Qc]
ihami: folds 
ihami leaves the table
myllow1: folds 
matiko09: raises $1 to $1.50
Vedpapa: folds 
Troll8989: folds 
ffac: folds 
Al3xAnd3r22: raises $3.50 to $5
dkafgankush joins the table at seat #6 
matiko09: calls $3.50
*** FLOP *** [6h Td Th]
Al3xAnd3r22: bets $5.48
matiko09: calls $5.48
*** TURN *** [6h Td Th] [9h]
Al3xAnd3r22: bets $11.34
matiko09: folds 
Uncalled bet ($11.34) returned to Al3xAnd3r22
Al3xAnd3r22 collected $20.26 from pot
Al3xAnd3r22: doesn't show hand 
*** SUMMARY ***
Total pot $21.21 | Rake $0.95 
Board [6h Td Th 9h]
Seat 1: matiko09 folded on the Turn
Seat 2: Vedpapa folded before Flop (didn't bet)
Seat 3: Troll8989 (button) folded before Flop (didn't bet)
Seat 4: ffac (small blind) folded before Flop
Seat 5: Al3xAnd3r22 (big blind) collected ($20.26)
Seat 6: ihami folded before Flop (didn't bet)
Seat 7: myllow1 folded before Flop (didn't bet)





PokerStars Hand #149395097347:  Hold'em No Limit ($0.50/$1.00 USD) - 2016/02/25 17:46:20 CET [2016/02/25 11:46:20 ET]
Table 'Eurysaces II' 9-max Seat #6 is the button
Seat 1: lysandrafly ($107.58 in chips) 
Seat 2: sebaaastian ($205.48 in chips) 
Seat 3: Aalleekks ($100 in chips) 
Seat 4: gabi_igna ($109.25 in chips) 
Seat 5: keessie93 ($130.12 in chips) 
Seat 6: J0rmungund ($53.21 in chips) 
Seat 7: $-Twackle-$ ($103.50 in chips) 
Seat 8: hammerwife ($100 in chips) 
Seat 9: matiko09 ($100 in chips) 
$-Twackle-$: posts small blind $0.50
hammerwife: posts big blind $1
*** HOLE CARDS ***
Dealt to matiko09 [9h 6s]
matiko09: folds 
lysandrafly: folds 
sebaaastian: folds 
Aalleekks: folds 
gabi_igna: folds 
keessie93: folds 
J0rmungund: folds 
$-Twackle-$: raises $2 to $3
hammerwife: folds 
Uncalled bet ($2) returned to $-Twackle-$
$-Twackle-$ collected $2 from pot
$-Twackle-$: doesn't show hand 
*** SUMMARY ***
Total pot $2 | Rake $0 
Seat 1: lysandrafly folded before Flop (didn't bet)
Seat 2: sebaaastian folded before Flop (didn't bet)
Seat 3: Aalleekks folded before Flop (didn't bet)
Seat 4: gabi_igna folded before Flop (didn't bet)
Seat 5: keessie93 folded before Flop (didn't bet)
Seat 6: J0rmungund (button) folded before Flop (didn't bet)
Seat 7: $-Twackle-$ (small blind) collected ($2)
Seat 8: hammerwife (big blind) folded before Flop
Seat 9: matiko09 folded before Flop (didn't bet)





PokerStars Hand #149395097871:  Hold'em No Limit ($0.50/$1.00 USD) - 2016/02/25 17:46:20 CET [2016/02/25 11:46:20 ET]
Table 'Syrma II' 9-max Seat #6 is the button
Seat 3: shayu 9988 ($81.12 in chips) 
Seat 4: volwebni4ek ($73.34 in chips) 
Seat 5: BIGWIN2016 ($89.30 in chips) 
Seat 6: matiko09 ($100 in chips) 
Seat 7: lysandrafly ($102.50 in chips) 
Seat 9: xAndorx ($100 in chips) 
lysandrafly: posts small blind $0.50
xAndorx: posts big blind $1
Venomous100%: sits out 
$-Twackle-$: sits out 
*** HOLE CARDS ***
Dealt to matiko09 [8h Qs]
shayu 9988: raises $1 to $2
volwebni4ek: folds 
BIGWIN2016: calls $2
matiko09: folds 
lysandrafly: calls $1.50
xAndorx: folds 
*** FLOP *** [2s 3c Ah]
lysandrafly: checks 
shayu 9988: checks 
BIGWIN2016 is disconnected 
BIGWIN2016 has timed out while disconnected
BIGWIN2016: checks 
*** TURN *** [2s 3c Ah] [5h]
lysandrafly: bets $3.34
shayu 9988: folds 
BIGWIN2016 has timed out while disconnected
BIGWIN2016: folds 
Uncalled bet ($3.34) returned to lysandrafly
lysandrafly collected $6.68 from pot
lysandrafly: doesn't show hand 
*** SUMMARY ***
Total pot $7 | Rake $0.32 
Board [2s 3c Ah 5h]
Seat 3: shayu 9988 folded on the Turn
Seat 4: volwebni4ek folded before Flop (didn't bet)
Seat 5: BIGWIN2016 folded on the Turn
Seat 6: matiko09 (button) folded before Flop (didn't bet)
Seat 7: lysandrafly (small blind) collected ($6.68)
Seat 9: xAndorx (big blind) folded before Flop





PokerStars Hand #149395101762:  Hold'em No Limit ($0.25/$0.50 USD) - 2016/02/25 17:46:25 CET [2016/02/25 11:46:25 ET]
Table 'Lohja II' 9-max Seat #8 is the button
Seat 1: MoonJimmy ($161.80 in chips) 
Seat 2: mycka86 ($56.28 in chips) 
Seat 4: payback11 ($50 in chips) 
Seat 6: xAndorx ($63.11 in chips) 
Seat 7: matiko09 ($93.37 in chips) 
Seat 8: pasa132 ($65 in chips) 
Seat 9: Al3xAnd3r22 ($140.17 in chips) 
Al3xAnd3r22: posts small blind $0.25
MoonJimmy: posts big blind $0.50
Effort92: sits out 
MoonJimmy: posts the ante $0.10
mycka86: posts the ante $0.10
payback11: posts the ante $0.10
xAndorx: posts the ante $0.10
matiko09: posts the ante $0.10
pasa132: posts the ante $0.10
Al3xAnd3r22: posts the ante $0.10
*** HOLE CARDS ***
Dealt to matiko09 [9s Th]
mycka86: folds 
payback11: folds 
xAndorx: raises $1 to $1.50
matiko09: folds 
pasa132: folds 
Al3xAnd3r22: folds 
MoonJimmy: folds 
Uncalled bet ($1) returned to xAndorx
xAndorx collected $1.95 from pot
xAndorx: doesn't show hand 
*** SUMMARY ***
Total pot $1.95 | Rake $0 
Seat 1: MoonJimmy (big blind) folded before Flop
Seat 2: mycka86 folded before Flop (didn't bet)
Seat 4: payback11 folded before Flop (didn't bet)
Seat 6: xAndorx collected ($1.95)
Seat 7: matiko09 folded before Flop (didn't bet)
Seat 8: pasa132 (button) folded before Flop (didn't bet)
Seat 9: Al3xAnd3r22 (small blind) folded before Flop





PokerStars Hand #149395118562:  Hold'em No Limit (€0.25/€0.50 EUR) - 2016/02/25 17:46:46 CET [2016/02/25 11:46:46 ET]
Table 'Diadem IV' 9-max Seat #5 is the button
Seat 1: Ganador79 (€43.68 in chips) 
Seat 3: timbo_5563 (€25.54 in chips) 
Seat 5: matiko09 (€50 in chips) 
Seat 6: Al3xAnd3r22 (€60.08 in chips) 
Seat 7: JustR82 (€71.87 in chips) 
Al3xAnd3r22: posts small blind €0.25
JustR82: posts big blind €0.50
Troll8989: sits out 
Effort92: sits out 
*** HOLE CARDS ***
Dealt to matiko09 [6c 3c]
Ganador79: folds 
timbo_5563: folds 
matiko09: folds 
Al3xAnd3r22: folds 
Uncalled bet (€0.25) returned to JustR82
JustR82 collected €0.50 from pot
JustR82: doesn't show hand 
*** SUMMARY ***
Total pot €0.50 | Rake €0 
Seat 1: Ganador79 folded before Flop (didn't bet)
Seat 3: timbo_5563 folded before Flop (didn't bet)
Seat 5: matiko09 (button) folded before Flop (didn't bet)
Seat 6: Al3xAnd3r22 (small blind) folded before Flop
Seat 7: JustR82 (big blind) collected (€0.50)





PokerStars Hand #149395123609:  Hold'em No Limit ($0.50/$1.00 USD) - 2016/02/25 17:46:52 CET [2016/02/25 11:46:52 ET]
Table 'Nerthus II' 9-max Seat #4 is the button
Seat 1: volwebni4ek ($81.65 in chips) 
Seat 2: matiko09 ($216.28 in chips) 
Seat 3: simoniustin ($119.96 in chips) 
Seat 4: Ilov3NBA ($100 in chips) 
Seat 6: mycka86 ($146.06 in chips) 
Seat 7: Venomous100% ($107.15 in chips) 
Seat 9: hammerwife ($100 in chips) 
mycka86: posts small blind $0.50
Venomous100%: posts big blind $1
meischt94: sits out 
*** HOLE CARDS ***
Dealt to matiko09 [Qh 8d]
hammerwife: folds 
volwebni4ek: folds 
matiko09: folds 
simoniustin: raises $1.50 to $2.50
Ilov3NBA: folds 
mycka86: raises $6.50 to $9
Venomous100%: folds 
simoniustin: calls $6.50
*** FLOP *** [Jh 2s Qc]
mycka86: bets $10.97
simoniustin: folds 
Uncalled bet ($10.97) returned to mycka86
mycka86 collected $18.14 from pot
*** SUMMARY ***
Total pot $19 | Rake $0.86 
Board [Jh 2s Qc]
Seat 1: volwebni4ek folded before Flop (didn't bet)
Seat 2: matiko09 folded before Flop (didn't bet)
Seat 3: simoniustin folded on the Flop
Seat 4: Ilov3NBA (button) folded before Flop (didn't bet)
Seat 6: mycka86 (small blind) collected ($18.14)
Seat 7: Venomous100% (big blind) folded before Flop
Seat 9: hammerwife folded before Flop (didn't bet)





PokerStars Hand #149395124643:  Hold'em No Limit ($0.50/$1.00 USD) - 2016/02/25 17:46:53 CET [2016/02/25 11:46:53 ET]
Table 'Isa' 9-max Seat #8 is the button
Seat 1: matiko09 ($124.58 in chips) 
Seat 2: mycka86 ($158.31 in chips) 
Seat 3: sebaaastian ($153.30 in chips) 
Seat 4: hammerwife ($133.45 in chips) 
Seat 6: xAndorx ($101.50 in chips) 
Seat 7: bilukm ($66.59 in chips) 
Seat 8: Venomous100% ($110.24 in chips) 
Seat 9: volwebni4ek ($52.36 in chips) 
volwebni4ek: posts small blind $0.50
matiko09: posts big blind $1
gabi_igna: sits out 
*** HOLE CARDS ***
Dealt to matiko09 [8d Td]
mycka86: folds 
sebaaastian: folds 
hammerwife: folds 
xAndorx: folds 
bilukm: folds 
Venomous100%: raises $1 to $2
volwebni4ek: folds 
matiko09: calls $1
*** FLOP *** [5d Th Qc]
matiko09: checks 
Venomous100%: checks 
*** TURN *** [5d Th Qc] [9h]
matiko09: checks 
Venomous100%: checks 
*** RIVER *** [5d Th Qc 9h] [Ts]
matiko09: bets $2.80
Venomous100%: folds 
Uncalled bet ($2.80) returned to matiko09
matiko09 collected $4.30 from pot
matiko09: doesn't show hand 
*** SUMMARY ***
Total pot $4.50 | Rake $0.20 
Board [5d Th Qc 9h Ts]
Seat 1: matiko09 (big blind) collected ($4.30)
Seat 2: mycka86 folded before Flop (didn't bet)
Seat 3: sebaaastian folded before Flop (didn't bet)
Seat 4: hammerwife folded before Flop (didn't bet)
Seat 6: xAndorx folded before Flop (didn't bet)
Seat 7: bilukm folded before Flop (didn't bet)
Seat 8: Venomous100% (button) folded on the River
Seat 9: volwebni4ek (small blind) folded before Flop





PokerStars Hand #149395125583:  Hold'em No Limit (€0.25/€0.50 EUR) - 2016/02/25 17:46:54 CET [2016/02/25 11:46:54 ET]
Table 'Prokne II' 9-max Seat #5 is the button
Seat 1: Al3xAnd3r22 (€61.95 in chips) 
Seat 2: payback11 (€50 in chips) 
Seat 3: JustR82 (€51.16 in chips) 
Seat 4: carlito cri (€33.43 in chips) 
Seat 5: Makitra (€52.24 in chips) 
Seat 6: matiko09 (€50 in chips) 
Seat 7: lysandrafly (€64.10 in chips) 
Seat 9: ihami (€55.10 in chips) 
matiko09: posts small blind €0.25
lysandrafly: posts big blind €0.50
*** HOLE CARDS ***
Dealt to matiko09 [7s 4s]
ihami: folds 
Al3xAnd3r22: folds 
payback11: folds 
JustR82: folds 
carlito cri: calls €0.50
Makitra: folds 
matiko09: folds 
lysandrafly: checks 
*** FLOP *** [3s Jh 5c]
lysandrafly: checks 
carlito cri: bets €0.50
lysandrafly: calls €0.50
*** TURN *** [3s Jh 5c] [Th]
lysandrafly: checks 
carlito cri: bets €1
lysandrafly: folds 
Uncalled bet (€1) returned to carlito cri
carlito cri collected €2.15 from pot
carlito cri: doesn't show hand 
*** SUMMARY ***
Total pot €2.25 | Rake €0.10 
Board [3s Jh 5c Th]
Seat 1: Al3xAnd3r22 folded before Flop (didn't bet)
Seat 2: payback11 folded before Flop (didn't bet)
Seat 3: JustR82 folded before Flop (didn't bet)
Seat 4: carlito cri collected (€2.15)
Seat 5: Makitra (button) folded before Flop (didn't bet)
Seat 6: matiko09 (small blind) folded before Flop
Seat 7: lysandrafly (big blind) folded on the Turn
Seat 9: ihami folded before Flop (didn't bet)





PokerStars Hand #149395130533:  Hold'em No Limit ($0.25/$0.50 USD) - 2016/02/25 17:47:00 CET [2016/02/25 11:47:00 ET]
Table 'Lohja II' 9-max Seat #9 is the button
Seat 1: MoonJimmy ($161.20 in chips) 
Seat 2: mycka86 ($56.18 in chips) 
Seat 4: payback11 ($50 in chips) 
Seat 6: xAndorx ($64.46 in chips) 
Seat 7: matiko09 ($93.27 in chips) 
Seat 8: pasa132 ($65 in chips) 
Seat 9: Al3xAnd3r22 ($139.82 in chips) 
MoonJimmy: posts small blind $0.25
mycka86: posts big blind $0.50
Effort92: sits out 
MoonJimmy: posts the ante $0.10
mycka86: posts the ante $0.10
payback11: posts the ante $0.10
xAndorx: posts the ante $0.10
matiko09: posts the ante $0.10
pasa132: posts the ante $0.10
Al3xAnd3r22: posts the ante $0.10
*** HOLE CARDS ***
Dealt to matiko09 [7c 3h]
payback11: folds 
xAndorx: folds 
matiko09: folds 
pasa132: folds 
Al3xAnd3r22: folds 
MoonJimmy: folds 
Uncalled bet ($0.25) returned to mycka86
mycka86 collected $1.20 from pot
*** SUMMARY ***
Total pot $1.20 | Rake $0 
Seat 1: MoonJimmy (small blind) folded before Flop
Seat 2: mycka86 (big blind) collected ($1.20)
Seat 4: payback11 folded before Flop (didn't bet)
Seat 6: xAndorx folded before Flop (didn't bet)
Seat 7: matiko09 folded before Flop (didn't bet)
Seat 8: pasa132 folded before Flop (didn't bet)
Seat 9: Al3xAnd3r22 (button) folded before Flop (didn't bet)





PokerStars Hand #149395132540:  Hold'em No Limit ($0.50/$1.00 USD) - 2016/02/25 17:47:03 CET [2016/02/25 11:47:03 ET]
Table 'Eurysaces II' 9-max Seat #7 is the button
Seat 1: lysandrafly ($107.58 in chips) 
Seat 2: sebaaastian ($205.48 in chips) 
Seat 3: Aalleekks ($100 in chips) 
Seat 4: gabi_igna ($109.25 in chips) 
Seat 5: keessie93 ($130.12 in chips) 
Seat 6: J0rmungund ($53.21 in chips) 
Seat 7: $-Twackle-$ ($104.50 in chips) 
Seat 8: hammerwife ($100 in chips) 
Seat 9: matiko09 ($100 in chips) 
hammerwife: posts small blind $0.50
matiko09: posts big blind $1
*** HOLE CARDS ***
Dealt to matiko09 [2h Qs]
lysandrafly: folds 
sebaaastian: folds 
Aalleekks: raises $2 to $3
gabi_igna: folds 
keessie93: calls $3
J0rmungund: calls $3
$-Twackle-$: folds 
hammerwife: folds 
matiko09: folds 
*** FLOP *** [Ks 5d 4d]
Aalleekks: checks 
keessie93: checks 
J0rmungund: bets $7
Aalleekks: calls $7
keessie93: folds 
*** TURN *** [Ks 5d 4d] [Qh]
Aalleekks: checks 
J0rmungund: checks 
*** RIVER *** [Ks 5d 4d Qh] [2d]
Aalleekks: bets $12.49
J0rmungund: calls $12.49
*** SHOW DOWN ***
Aalleekks: shows [Kc Kd] (three of a kind, Kings)
J0rmungund: mucks hand 
Aalleekks collected $47.25 from pot
*** SUMMARY ***
Total pot $49.48 | Rake $2.23 
Board [Ks 5d 4d Qh 2d]
Seat 1: lysandrafly folded before Flop (didn't bet)
Seat 2: sebaaastian folded before Flop (didn't bet)
Seat 3: Aalleekks showed [Kc Kd] and won ($47.25) with three of a kind, Kings
Seat 4: gabi_igna folded before Flop (didn't bet)
Seat 5: keessie93 folded on the Flop
Seat 6: J0rmungund mucked [Tc Qc]
Seat 7: $-Twackle-$ (button) folded before Flop (didn't bet)
Seat 8: hammerwife (small blind) folded before Flop
Seat 9: matiko09 (big blind) folded before Flop





PokerStars Hand #149395141087:  Hold'em No Limit (€0.25/€0.50 EUR) - 2016/02/25 17:47:13 CET [2016/02/25 11:47:13 ET]
Table 'Diadem IV' 9-max Seat #6 is the button
Seat 1: Ganador79 (€43.68 in chips) 
Seat 3: timbo_5563 (€25.54 in chips) 
Seat 5: matiko09 (€50 in chips) 
Seat 6: Al3xAnd3r22 (€59.83 in chips) 
Seat 7: JustR82 (€72.12 in chips) 
Seat 8: Troll8989 (€50 in chips) 
JustR82: posts small blind €0.25
Troll8989: posts big blind €0.50
Effort92: sits out 
*** HOLE CARDS ***
Dealt to matiko09 [Kc 9c]
Ganador79: folds 
timbo_5563: raises €0.50 to €1
matiko09: folds 
Al3xAnd3r22: folds 
JustR82: folds 
Troll8989: calls €0.50
*** FLOP *** [Jh 6d 2s]
Troll8989: checks 
timbo_5563: bets €0.50
Troll8989: calls €0.50
*** TURN *** [Jh 6d 2s] [Ts]
Bailey Dew leaves the table
Troll8989: bets €2.50
timbo_5563: folds 
Uncalled bet (€2.50) returned to Troll8989
Troll8989 collected €3.10 from pot
Troll8989: doesn't show hand 
*** SUMMARY ***
Total pot €3.25 | Rake €0.15 
Board [Jh 6d 2s Ts]
Seat 1: Ganador79 folded before Flop (didn't bet)
Seat 3: timbo_5563 folded on the Turn
Seat 5: matiko09 folded before Flop (didn't bet)
Seat 6: Al3xAnd3r22 (button) folded before Flop (didn't bet)
Seat 7: JustR82 (small blind) folded before Flop
Seat 8: Troll8989 (big blind) collected (€3.10)





PokerStars Hand #149395143742:  Hold'em No Limit ($0.50/$1.00 USD) - 2016/02/25 17:47:16 CET [2016/02/25 11:47:16 ET]
Table 'Mayall II' 9-max Seat #9 is the button
Seat 1: matiko09 ($121.94 in chips) 
Seat 3: simoniustin ($124.14 in chips) 
Seat 4: C. Duke 19 ($99.40 in chips) 
Seat 5: McFussball81 ($66.92 in chips) 
Seat 6: apfush ($100 in chips) 
Seat 7: r.pol218 ($45.90 in chips) 
Seat 8: kuanhung0903 ($78.87 in chips) 
Seat 9: xAndorx ($124.34 in chips) 
matiko09: posts small blind $0.50
Sweden_Pound was removed from the table for failing to post
simoniustin: posts big blind $1
*** HOLE CARDS ***
Dealt to matiko09 [3h Kc]
C. Duke 19: folds 
McFussball81: raises $1 to $2
apfush: folds 
r.pol218: calls $2
kuanhung0903: folds 
xAndorx: folds 
matiko09: folds 
simoniustin: folds 
*** FLOP *** [3d Td Qd]
McFussball81: bets $2.62
r.pol218: calls $2.62
*** TURN *** [3d Td Qd] [Kd]
McFussball81: checks 
r.pol218: checks 
*** RIVER *** [3d Td Qd Kd] [Ad]
McFussball81: bets $7
r.pol218: folds 
Uncalled bet ($7) returned to McFussball81
McFussball81 collected $10.26 from pot
McFussball81: doesn't show hand 
*** SUMMARY ***
Total pot $10.74 | Rake $0.48 
Board [3d Td Qd Kd Ad]
Seat 1: matiko09 (small blind) folded before Flop
Seat 3: simoniustin (big blind) folded before Flop
Seat 4: C. Duke 19 folded before Flop (didn't bet)
Seat 5: McFussball81 collected ($10.26)
Seat 6: apfush folded before Flop (didn't bet)
Seat 7: r.pol218 folded on the River
Seat 8: kuanhung0903 folded before Flop (didn't bet)
Seat 9: xAndorx (button) folded before Flop (didn't bet)





PokerStars Hand #149395145727:  Hold'em No Limit ($0.50/$1.00 USD) - 2016/02/25 17:47:19 CET [2016/02/25 11:47:19 ET]
Table 'Morosovia II' 9-max Seat #6 is the button
Seat 1: $-Twackle-$ ($103.21 in chips) 
Seat 3: sebaaastian ($198.73 in chips) 
Seat 5: gabi_igna ($156.77 in chips) 
Seat 6: Dachish ($67.50 in chips) 
Seat 7: matiko09 ($137.14 in chips) 
Seat 8: simoniustin ($114.59 in chips) 
Seat 9: lysandrafly ($119.44 in chips) 
matiko09: posts small blind $0.50
simoniustin: posts big blind $1
Effort92: sits out 
*** HOLE CARDS ***
Dealt to matiko09 [6c Qs]
lysandrafly: folds 
$-Twackle-$: folds 
sebaaastian: folds 
gabi_igna: folds 
Dachish: folds 
matiko09: folds 
Uncalled bet ($0.50) returned to simoniustin
simoniustin collected $1 from pot
simoniustin: doesn't show hand 
*** SUMMARY ***
Total pot $1 | Rake $0 
Seat 1: $-Twackle-$ folded before Flop (didn't bet)
Seat 3: sebaaastian folded before Flop (didn't bet)
Seat 5: gabi_igna folded before Flop (didn't bet)
Seat 6: Dachish (button) folded before Flop (didn't bet)
Seat 7: matiko09 (small blind) folded before Flop
Seat 8: simoniustin (big blind) collected ($1)
Seat 9: lysandrafly folded before Flop (didn't bet)





PokerStars Hand #149395147209:  Hold'em No Limit ($0.50/$1.00 USD) - 2016/02/25 17:47:21 CET [2016/02/25 11:47:21 ET]
Table 'Badenia II' 9-max Seat #8 is the button
Seat 1: matiko09 ($100 in chips) 
Seat 3: sebaaastian ($155.57 in chips) 
Seat 4: hammerwife ($106.49 in chips) 
Seat 5: Ilov3NBA ($100 in chips) 
Seat 6: Dachish ($70.08 in chips) 
Seat 8: McFussball81 ($53.72 in chips) 
Seat 9: waisanen ($244.22 in chips) 
waisanen: posts small blind $0.50
matiko09: posts big blind $1
$-Twackle-$: sits out 
*** HOLE CARDS ***
Dealt to matiko09 [Th Ad]
sebaaastian: folds 
hammerwife: folds 
Ilov3NBA: folds 
Dachish: folds 
McFussball81: raises $1 to $2
waisanen: calls $1.50
matiko09: calls $1
*** FLOP *** [6h 8h 9d]
waisanen: bets $2
matiko09: folds 
McFussball81: folds 
Uncalled bet ($2) returned to waisanen
waisanen collected $5.73 from pot
*** SUMMARY ***
Total pot $6 | Rake $0.27 
Board [6h 8h 9d]
Seat 1: matiko09 (big blind) folded on the Flop
Seat 3: sebaaastian folded before Flop (didn't bet)
Seat 4: hammerwife folded before Flop (didn't bet)
Seat 5: Ilov3NBA folded before Flop (didn't bet)
Seat 6: Dachish folded before Flop (didn't bet)
Seat 8: McFussball81 (button) folded on the Flop
Seat 9: waisanen (small blind) collected ($5.73)





PokerStars Hand #149395160003:  Hold'em No Limit ($0.25/$0.50 USD) - 2016/02/25 17:47:36 CET [2016/02/25 11:47:36 ET]
Table 'Lohja II' 9-max Seat #1 is the button
Seat 1: MoonJimmy ($160.85 in chips) 
Seat 2: mycka86 ($57.03 in chips) 
Seat 4: payback11 ($50 in chips) 
Seat 6: xAndorx ($64.36 in chips) 
Seat 7: matiko09 ($93.17 in chips) 
Seat 8: pasa132 ($65 in chips) 
Seat 9: Al3xAnd3r22 ($139.72 in chips) 
mycka86: posts small blind $0.25
payback11: posts big blind $0.50
Effort92: sits out 
MoonJimmy: posts the ante $0.10
mycka86: posts the ante $0.10
payback11: posts the ante $0.10
xAndorx: posts the ante $0.10
matiko09: posts the ante $0.10
pasa132: posts the ante $0.10
Al3xAnd3r22: posts the ante $0.10
*** HOLE CARDS ***
Dealt to matiko09 [4s 6s]
xAndorx: folds 
matiko09: folds 
pasa132: folds 
Al3xAnd3r22: raises $0.72 to $1.22
MoonJimmy: folds 
mycka86: folds 
payback11: calls $0.72
*** FLOP *** [Ah Td Js]
payback11: checks 
Al3xAnd3r22: checks 
*** TURN *** [Ah Td Js] [5s]
payback11: checks 
Al3xAnd3r22: bets $1.13
payback11: calls $1.13
*** RIVER *** [Ah Td Js 5s] [8h]
payback11: checks 
Al3xAnd3r22: checks 
*** SHOW DOWN ***
payback11: shows [Kh Jc] (a pair of Jacks)
Al3xAnd3r22: shows [Qd Qs] (a pair of Queens)
Al3xAnd3r22 collected $5.40 from pot
*** SUMMARY ***
Total pot $5.65 | Rake $0.25 
Board [Ah Td Js 5s 8h]
Seat 1: MoonJimmy (button) folded before Flop (didn't bet)
Seat 2: mycka86 (small blind) folded before Flop
Seat 4: payback11 (big blind) showed [Kh Jc] and lost with a pair of Jacks
Seat 6: xAndorx folded before Flop (didn't bet)
Seat 7: matiko09 folded before Flop (didn't bet)
Seat 8: pasa132 folded before Flop (didn't bet)
Seat 9: Al3xAnd3r22 showed [Qd Qs] and won ($5.40) with a pair of Queens





PokerStars Hand #149395160998:  Hold'em No Limit ($0.50/$1.00 USD) - 2016/02/25 17:47:37 CET [2016/02/25 11:47:37 ET]
Table 'Zerbinetta II' 9-max Seat #1 is the button
Seat 1: $-Twackle-$ ($100 in chips) 
Seat 3: matiko09 ($101.25 in chips) 
Seat 5: hammerwife ($118.27 in chips) 
Seat 6: simoniustin ($100 in chips) 
Seat 8: gabi_igna ($100 in chips) 
matiko09: posts small blind $0.50
sebaaastian: is sitting out 
sebaaastian leaves the table
hammerwife: posts big blind $1
*** HOLE CARDS ***
Dealt to matiko09 [5h 8h]
simoniustin: folds 
gabi_igna: folds 
$-Twackle-$: raises $1 to $2
matiko09: folds 
hammerwife: calls $1
*** FLOP *** [2c Ks Tc]
hammerwife: checks 
$-Twackle-$: bets $3
hammerwife: folds 
Uncalled bet ($3) returned to $-Twackle-$
$-Twackle-$ collected $4.30 from pot
$-Twackle-$: doesn't show hand 
*** SUMMARY ***
Total pot $4.50 | Rake $0.20 
Board [2c Ks Tc]
Seat 1: $-Twackle-$ (button) collected ($4.30)
Seat 3: matiko09 (small blind) folded before Flop
Seat 5: hammerwife (big blind) folded on the Flop
Seat 6: simoniustin folded before Flop (didn't bet)
Seat 8: gabi_igna folded before Flop (didn't bet)





PokerStars Hand #149395166821:  Hold'em No Limit ($0.50/$1.00 USD) - 2016/02/25 17:47:45 CET [2016/02/25 11:47:45 ET]
Table 'Isa' 9-max Seat #9 is the button
Seat 1: matiko09 ($126.88 in chips) 
Seat 2: mycka86 ($158.31 in chips) 
Seat 3: sebaaastian ($153.30 in chips) 
Seat 4: hammerwife ($133.45 in chips) 
Seat 6: xAndorx ($101.50 in chips) 
Seat 7: bilukm ($66.59 in chips) 
Seat 8: Venomous100% ($108.24 in chips) 
Seat 9: volwebni4ek ($51.86 in chips) 
matiko09: posts small blind $0.50
mycka86: posts big blind $1
gabi_igna: sits out 
*** HOLE CARDS ***
Dealt to matiko09 [5s Th]
sebaaastian: folds 
hammerwife: folds 
xAndorx: folds 
bilukm is disconnected 
bilukm is connected 
bilukm: folds 
Venomous100%: folds 
volwebni4ek: raises $1 to $2
matiko09: folds 
mycka86: folds 
Uncalled bet ($1) returned to volwebni4ek
volwebni4ek collected $2.50 from pot
volwebni4ek: doesn't show hand 
*** SUMMARY ***
Total pot $2.50 | Rake $0 
Seat 1: matiko09 (small blind) folded before Flop
Seat 2: mycka86 (big blind) folded before Flop
Seat 3: sebaaastian folded before Flop (didn't bet)
Seat 4: hammerwife folded before Flop (didn't bet)
Seat 6: xAndorx folded before Flop (didn't bet)
Seat 7: bilukm folded before Flop (didn't bet)
Seat 8: Venomous100% folded before Flop (didn't bet)
Seat 9: volwebni4ek (button) collected ($2.50)





PokerStars Hand #149395171661:  Hold'em No Limit ($0.50/$1.00 USD) - 2016/02/25 17:47:50 CET [2016/02/25 11:47:50 ET]
Table 'Morosovia II' 9-max Seat #7 is the button
Seat 1: $-Twackle-$ ($103.21 in chips) 
Seat 3: sebaaastian ($198.73 in chips) 
Seat 5: gabi_igna ($156.77 in chips) 
Seat 6: Dachish ($67.50 in chips) 
Seat 7: matiko09 ($136.64 in chips) 
Seat 8: simoniustin ($115.09 in chips) 
Seat 9: lysandrafly ($119.44 in chips) 
simoniustin: posts small blind $0.50
lysandrafly: posts big blind $1
Effort92: sits out 
*** HOLE CARDS ***
Dealt to matiko09 [2d Ad]
$-Twackle-$: folds 
sebaaastian: folds 
gabi_igna: raises $2 to $3
Dachish: folds 
matiko09: folds 
simoniustin: folds 
lysandrafly: folds 
Uncalled bet ($2) returned to gabi_igna
gabi_igna collected $2.50 from pot
gabi_igna: doesn't show hand 
*** SUMMARY ***
Total pot $2.50 | Rake $0 
Seat 1: $-Twackle-$ folded before Flop (didn't bet)
Seat 3: sebaaastian folded before Flop (didn't bet)
Seat 5: gabi_igna collected ($2.50)
Seat 6: Dachish folded before Flop (didn't bet)
Seat 7: matiko09 (button) folded before Flop (didn't bet)
Seat 8: simoniustin (small blind) folded before Flop
Seat 9: lysandrafly (big blind) folded before Flop





PokerStars Hand #149395173934:  Hold'em No Limit ($0.25/$0.50 USD) - 2016/02/25 17:47:53 CET [2016/02/25 11:47:53 ET]
Table 'Vladimir' 9-max Seat #4 is the button
Seat 1: matiko09 ($50 in chips) 
Seat 2: Vedpapa ($52.09 in chips) 
Seat 3: Troll8989 ($50 in chips) 
Seat 4: ffac ($58.10 in chips) 
Seat 5: Al3xAnd3r22 ($61.86 in chips) 
Seat 6: dkafgankush ($20 in chips) 
Seat 7: myllow1 ($67.25 in chips) 
Al3xAnd3r22: posts small blind $0.25
dkafgankush: posts big blind $0.50
Effort92: sits out 
AceFarky: sits out 
*** HOLE CARDS ***
Dealt to matiko09 [6s 3d]
myllow1: raises $1.50 to $2
matiko09: folds 
Vedpapa: folds 
Troll8989: folds 
ffac: folds 
Al3xAnd3r22: calls $1.75
dkafgankush: folds 
*** FLOP *** [Td Kc Tc]
Al3xAnd3r22: bets $2.40
myllow1: calls $2.40
*** TURN *** [Td Kc Tc] [Ts]
Al3xAnd3r22: checks 
myllow1: bets $3
Al3xAnd3r22: folds 
Uncalled bet ($3) returned to myllow1
myllow1 collected $8.88 from pot
*** SUMMARY ***
Total pot $9.30 | Rake $0.42 
Board [Td Kc Tc Ts]
Seat 1: matiko09 folded before Flop (didn't bet)
Seat 2: Vedpapa folded before Flop (didn't bet)
Seat 3: Troll8989 folded before Flop (didn't bet)
Seat 4: ffac (button) folded before Flop (didn't bet)
Seat 5: Al3xAnd3r22 (small blind) folded on the Turn
Seat 6: dkafgankush (big blind) folded before Flop
Seat 7: myllow1 collected ($8.88)





PokerStars Hand #149395179650:  Hold'em No Limit ($0.50/$1.00 USD) - 2016/02/25 17:48:00 CET [2016/02/25 11:48:00 ET]
Table 'Badenia II' 9-max Seat #9 is the button
Seat 1: matiko09 ($100 in chips) 
Seat 2: $-Twackle-$ ($100 in chips) 
Seat 3: sebaaastian ($155.57 in chips) 
Seat 4: hammerwife ($106.49 in chips) 
Seat 5: Ilov3NBA ($100 in chips) 
Seat 6: Dachish ($70.08 in chips) 
Seat 8: McFussball81 ($51.72 in chips) 
Seat 9: waisanen ($247.95 in chips) 
matiko09: posts small blind $0.50
$-Twackle-$: posts big blind $1
*** HOLE CARDS ***
Dealt to matiko09 [2h 8c]
sebaaastian: folds 
hammerwife: folds 
Ilov3NBA: folds 
Dachish: folds 
McFussball81: folds 
waisanen: folds 
matiko09: folds 
Uncalled bet ($0.50) returned to $-Twackle-$
$-Twackle-$ collected $1 from pot
$-Twackle-$: doesn't show hand 
*** SUMMARY ***
Total pot $1 | Rake $0 
Seat 1: matiko09 (small blind) folded before Flop
Seat 2: $-Twackle-$ (big blind) collected ($1)
Seat 3: sebaaastian folded before Flop (didn't bet)
Seat 4: hammerwife folded before Flop (didn't bet)
Seat 5: Ilov3NBA folded before Flop (didn't bet)
Seat 6: Dachish folded before Flop (didn't bet)
Seat 8: McFussball81 folded before Flop (didn't bet)
Seat 9: waisanen (button) folded before Flop (didn't bet)





PokerStars Hand #149395186675:  Hold'em No Limit (€0.25/€0.50 EUR) - 2016/02/25 17:48:09 CET [2016/02/25 11:48:09 ET]
Table 'Prokne II' 9-max Seat #6 is the button
Seat 1: Al3xAnd3r22 (€61.95 in chips) 
Seat 2: payback11 (€50 in chips) 
Seat 3: JustR82 (€51.16 in chips) 
Seat 4: carlito cri (€34.58 in chips) 
Seat 5: Makitra (€52.24 in chips) 
Seat 6: matiko09 (€50 in chips) 
Seat 7: lysandrafly (€63.10 in chips) 
Seat 9: ihami (€55.10 in chips) 
lysandrafly: posts small blind €0.25
ihami: posts big blind €0.50
*** HOLE CARDS ***
Dealt to matiko09 [5h 3h]
Al3xAnd3r22: folds 
payback11: folds 
JustR82: folds 
carlito cri: calls €0.50
Makitra: folds 
matiko09: folds 
lysandrafly: calls €0.25
ihami: checks 
*** FLOP *** [9h Tc 6c]
lysandrafly: checks 
ihami: checks 
carlito cri: bets €0.50
lysandrafly: calls €0.50
ihami: folds 
*** TURN *** [9h Tc 6c] [Ts]
lysandrafly: checks 
carlito cri: bets €1
lysandrafly: calls €1
*** RIVER *** [9h Tc 6c Ts] [Ks]
lysandrafly: checks 
carlito cri: bets €1.50
lysandrafly: folds 
Uncalled bet (€1.50) returned to carlito cri
carlito cri collected €4.30 from pot
carlito cri: doesn't show hand 
*** SUMMARY ***
Total pot €4.50 | Rake €0.20 
Board [9h Tc 6c Ts Ks]
Seat 1: Al3xAnd3r22 folded before Flop (didn't bet)
Seat 2: payback11 folded before Flop (didn't bet)
Seat 3: JustR82 folded before Flop (didn't bet)
Seat 4: carlito cri collected (€4.30)
Seat 5: Makitra folded before Flop (didn't bet)
Seat 6: matiko09 (button) folded before Flop (didn't bet)
Seat 7: lysandrafly (small blind) folded on the River
Seat 9: ihami (big blind) folded on the Flop





PokerStars Hand #149395188179:  Hold'em No Limit (€0.25/€0.50 EUR) - 2016/02/25 17:48:11 CET [2016/02/25 11:48:11 ET]
Table 'Diadem IV' 9-max Seat #7 is the button
Seat 1: Ganador79 (€43.68 in chips) 
Seat 3: timbo_5563 (€24.04 in chips) 
Seat 5: matiko09 (€50 in chips) 
Seat 6: Al3xAnd3r22 (€59.83 in chips) 
Seat 7: JustR82 (€71.87 in chips) 
Seat 8: Troll8989 (€51.60 in chips) 
Troll8989: posts small blind €0.25
Ganador79: posts big blind €0.50
Effort92: sits out 
*** HOLE CARDS ***
Dealt to matiko09 [Qh As]
timbo_5563: raises €0.50 to €1
matiko09: raises €1.50 to €2.50
Al3xAnd3r22: folds 
JustR82: folds 
Troll8989: folds 
Ganador79: folds 
timbo_5563: calls €1.50
*** FLOP *** [Ad 4s Td]
timbo_5563: bets €0.50
matiko09: raises €3.50 to €4
timbo_5563: folds 
Uncalled bet (€3.50) returned to matiko09
matiko09 collected €6.45 from pot
matiko09: doesn't show hand 
*** SUMMARY ***
Total pot €6.75 | Rake €0.30 
Board [Ad 4s Td]
Seat 1: Ganador79 (big blind) folded before Flop
Seat 3: timbo_5563 folded on the Flop
Seat 5: matiko09 collected (€6.45)
Seat 6: Al3xAnd3r22 folded before Flop (didn't bet)
Seat 7: JustR82 (button) folded before Flop (didn't bet)
Seat 8: Troll8989 (small blind) folded before Flop





PokerStars Hand #149395191909:  Hold'em No Limit ($0.50/$1.00 USD) - 2016/02/25 17:48:15 CET [2016/02/25 11:48:15 ET]
Table 'Eurysaces II' 9-max Seat #8 is the button
Seat 1: lysandrafly ($107.58 in chips) 
Seat 2: sebaaastian ($205.48 in chips) 
Seat 3: Aalleekks ($124.76 in chips) 
Seat 4: gabi_igna ($109.25 in chips) 
Seat 5: keessie93 ($127.12 in chips) 
Seat 6: J0rmungund ($30.72 in chips) 
Seat 7: $-Twackle-$ ($104.50 in chips) 
Seat 8: hammerwife ($100 in chips) 
Seat 9: matiko09 ($100 in chips) 
matiko09: posts small blind $0.50
lysandrafly: posts big blind $1
*** HOLE CARDS ***
Dealt to matiko09 [9d Ks]
sebaaastian: folds 
Aalleekks: folds 
gabi_igna: folds 
keessie93: raises $6 to $7
J0rmungund: folds 
$-Twackle-$: folds 
hammerwife: folds 
matiko09: folds 
lysandrafly: folds 
Uncalled bet ($6) returned to keessie93
keessie93 collected $2.50 from pot
keessie93: doesn't show hand 
*** SUMMARY ***
Total pot $2.50 | Rake $0 
Seat 1: lysandrafly (big blind) folded before Flop
Seat 2: sebaaastian folded before Flop (didn't bet)
Seat 3: Aalleekks folded before Flop (didn't bet)
Seat 4: gabi_igna folded before Flop (didn't bet)
Seat 5: keessie93 collected ($2.50)
Seat 6: J0rmungund folded before Flop (didn't bet)
Seat 7: $-Twackle-$ folded before Flop (didn't bet)
Seat 8: hammerwife (button) folded before Flop (didn't bet)
Seat 9: matiko09 (small blind) folded before Flop





PokerStars Hand #149395191611:  Hold'em No Limit ($0.50/$1.00 USD) - 2016/02/25 17:48:15 CET [2016/02/25 11:48:15 ET]
Table 'Fiducia II' 9-max Seat #2 is the button
Seat 1: Venomous100% ($103.34 in chips) 
Seat 2: brokat77 ($92.84 in chips) 
Seat 3: Oldemester ($99 in chips) 
Seat 4: matiko09 ($100 in chips) 
Seat 5: Dachish ($72.59 in chips) 
Seat 6: Yaaaazz ($127.88 in chips) 
Seat 7: gabi_igna ($105.37 in chips) 
Seat 8: simoniustin ($217.60 in chips) 
Oldemester: posts small blind $0.50
matiko09: posts big blind $1
apfush: sits out 
*** HOLE CARDS ***
Dealt to matiko09 [3c 3d]
Dachish: folds 
Yaaaazz: folds 
gabi_igna: raises $2 to $3
simoniustin: folds 
Venomous100%: folds 
brokat77: folds 
Oldemester: folds 
matiko09: folds 
Uncalled bet ($2) returned to gabi_igna
gabi_igna collected $2.50 from pot
gabi_igna: doesn't show hand 
*** SUMMARY ***
Total pot $2.50 | Rake $0 
Seat 1: Venomous100% folded before Flop (didn't bet)
Seat 2: brokat77 (button) folded before Flop (didn't bet)
Seat 3: Oldemester (small blind) folded before Flop
Seat 4: matiko09 (big blind) folded before Flop
Seat 5: Dachish folded before Flop (didn't bet)
Seat 6: Yaaaazz folded before Flop (didn't bet)
Seat 7: gabi_igna collected ($2.50)
Seat 8: simoniustin folded before Flop (didn't bet)





PokerStars Hand #149395202068:  Hold'em No Limit ($0.50/$1.00 USD) - 2016/02/25 17:48:28 CET [2016/02/25 11:48:28 ET]
Table 'Isa' 9-max Seat #1 is the button
Seat 1: matiko09 ($126.38 in chips) 
Seat 2: mycka86 ($157.31 in chips) 
Seat 3: sebaaastian ($153.30 in chips) 
Seat 4: hammerwife ($133.45 in chips) 
Seat 6: xAndorx ($101.50 in chips) 
Seat 7: bilukm ($66.59 in chips) 
Seat 8: Venomous100% ($108.24 in chips) 
Seat 9: volwebni4ek ($53.36 in chips) 
mycka86: posts small blind $0.50
sebaaastian: posts big blind $1
*** HOLE CARDS ***
Dealt to matiko09 [9s Tc]
hammerwife: folds 
xAndorx: raises $2 to $3
bilukm: folds 
Venomous100%: folds 
volwebni4ek: folds 
matiko09: folds 
mycka86: folds 
sebaaastian: folds 
Uncalled bet ($2) returned to xAndorx
xAndorx collected $2.50 from pot
xAndorx: doesn't show hand 
*** SUMMARY ***
Total pot $2.50 | Rake $0 
Seat 1: matiko09 (button) folded before Flop (didn't bet)
Seat 2: mycka86 (small blind) folded before Flop
Seat 3: sebaaastian (big blind) folded before Flop
Seat 4: hammerwife folded before Flop (didn't bet)
Seat 6: xAndorx collected ($2.50)
Seat 7: bilukm folded before Flop (didn't bet)
Seat 8: Venomous100% folded before Flop (didn't bet)
Seat 9: volwebni4ek folded before Flop (didn't bet)





PokerStars Hand #149395202804:  Hold'em No Limit ($0.50/$1.00 USD) - 2016/02/25 17:48:29 CET [2016/02/25 11:48:29 ET]
Table 'Badenia II' 9-max Seat #1 is the button
Seat 1: matiko09 ($100 in chips) 
Seat 2: $-Twackle-$ ($100.50 in chips) 
Seat 3: sebaaastian ($155.57 in chips) 
Seat 4: hammerwife ($106.49 in chips) 
Seat 5: Ilov3NBA ($100 in chips) 
Seat 6: Dachish ($70.08 in chips) 
Seat 8: McFussball81 ($51.72 in chips) 
Seat 9: waisanen ($247.95 in chips) 
$-Twackle-$: posts small blind $0.50
sebaaastian: posts big blind $1
*** HOLE CARDS ***
Dealt to matiko09 [3h Tc]
hammerwife: folds 
Ilov3NBA: raises $2 to $3
Dachish: calls $3
McFussball81: calls $3
waisanen: raises $4 to $7
matiko09: folds 
$-Twackle-$: folds 
sebaaastian: calls $6
Ilov3NBA: calls $4
Dachish: calls $4
McFussball81: calls $4
*** FLOP *** [As 2d 6h]
sebaaastian: checks 
Ilov3NBA: checks 
Dachish: bets $13
McFussball81: folds 
waisanen: folds 
sebaaastian: raises $15 to $28
Ilov3NBA: folds 
Dachish: folds 
Uncalled bet ($15) returned to sebaaastian
sebaaastian collected $58.73 from pot
sebaaastian: doesn't show hand 
*** SUMMARY ***
Total pot $61.50 | Rake $2.77 
Board [As 2d 6h]
Seat 1: matiko09 (button) folded before Flop (didn't bet)
Seat 2: $-Twackle-$ (small blind) folded before Flop
Seat 3: sebaaastian (big blind) collected ($58.73)
Seat 4: hammerwife folded before Flop (didn't bet)
Seat 5: Ilov3NBA folded on the Flop
Seat 6: Dachish folded on the Flop
Seat 8: McFussball81 folded on the Flop
Seat 9: waisanen folded on the Flop





PokerStars Hand #149395203608:  Hold'em No Limit ($0.50/$1.00 USD) - 2016/02/25 17:48:30 CET [2016/02/25 11:48:30 ET]
Table 'Nerthus II' 9-max Seat #6 is the button
Seat 1: volwebni4ek ($81.65 in chips) 
Seat 2: matiko09 ($216.28 in chips) 
Seat 3: simoniustin ($110.96 in chips) 
Seat 4: Ilov3NBA ($100 in chips) 
Seat 6: mycka86 ($155.20 in chips) 
Seat 7: Venomous100% ($106.15 in chips) 
Seat 8: meischt94 ($56.54 in chips) 
Seat 9: hammerwife ($100 in chips) 
Venomous100%: posts small blind $0.50
meischt94: posts big blind $1
*** HOLE CARDS ***
Dealt to matiko09 [8c 2h]
hammerwife: folds 
volwebni4ek: folds 
matiko09: folds 
simoniustin: raises $2 to $3
Ilov3NBA: folds 
mycka86: folds 
Venomous100%: folds 
meischt94: folds 
Uncalled bet ($2) returned to simoniustin
simoniustin collected $2.50 from pot
simoniustin: doesn't show hand 
*** SUMMARY ***
Total pot $2.50 | Rake $0 
Seat 1: volwebni4ek folded before Flop (didn't bet)
Seat 2: matiko09 folded before Flop (didn't bet)
Seat 3: simoniustin collected ($2.50)
Seat 4: Ilov3NBA folded before Flop (didn't bet)
Seat 6: mycka86 (button) folded before Flop (didn't bet)
Seat 7: Venomous100% (small blind) folded before Flop
Seat 8: meischt94 (big blind) folded before Flop
Seat 9: hammerwife folded before Flop (didn't bet)





PokerStars Hand #149395211867:  Hold'em No Limit ($0.50/$1.00 USD) - 2016/02/25 17:48:40 CET [2016/02/25 11:48:40 ET]
Table 'Fiducia II' 9-max Seat #3 is the button
Seat 1: Venomous100% ($103.34 in chips) 
Seat 2: brokat77 ($92.84 in chips) 
Seat 3: Oldemester ($98.50 in chips) 
Seat 4: matiko09 ($100 in chips) 
Seat 5: Dachish ($72.59 in chips) 
Seat 6: Yaaaazz ($127.88 in chips) 
Seat 7: gabi_igna ($106.87 in chips) 
Seat 8: simoniustin ($217.60 in chips) 
matiko09: posts small blind $0.50
Dachish: posts big blind $1
apfush: sits out 
*** HOLE CARDS ***
Dealt to matiko09 [8c Qd]
Yaaaazz: raises $2 to $3
gabi_igna: folds 
simoniustin: folds 
Venomous100%: folds 
brokat77: folds 
Oldemester: folds 
matiko09: folds 
Dachish: folds 
Uncalled bet ($2) returned to Yaaaazz
Yaaaazz collected $2.50 from pot
*** SUMMARY ***
Total pot $2.50 | Rake $0 
Seat 1: Venomous100% folded before Flop (didn't bet)
Seat 2: brokat77 folded before Flop (didn't bet)
Seat 3: Oldemester (button) folded before Flop (didn't bet)
Seat 4: matiko09 (small blind) folded before Flop
Seat 5: Dachish (big blind) folded before Flop
Seat 6: Yaaaazz collected ($2.50)
Seat 7: gabi_igna folded before Flop (didn't bet)
Seat 8: simoniustin folded before Flop (didn't bet)





PokerStars Hand #149395214146:  Hold'em No Limit ($0.50/$1.00 USD) - 2016/02/25 17:48:42 CET [2016/02/25 11:48:42 ET]
Table 'Mayall II' 9-max Seat #1 is the button
Seat 1: matiko09 ($121.44 in chips) 
Seat 3: simoniustin ($123.14 in chips) 
Seat 4: C. Duke 19 ($99.40 in chips) 
Seat 5: McFussball81 ($72.56 in chips) 
Seat 6: apfush ($100 in chips) 
Seat 7: r.pol218 ($41.28 in chips) 
Seat 8: kuanhung0903 ($78.87 in chips) 
Seat 9: xAndorx ($124.34 in chips) 
simoniustin: posts small blind $0.50
C. Duke 19: posts big blind $1
*** HOLE CARDS ***
Dealt to matiko09 [Th 4h]
McFussball81: raises $1 to $2
apfush: folds 
r.pol218: folds 
Venomous100% joins the table at seat #2 
kuanhung0903: folds 
xAndorx: folds 
matiko09: folds 
Venomous100% leaves the table
simoniustin: folds 
marrajon joins the table at seat #2 
C. Duke 19: calls $1
*** FLOP *** [6s 7s Ad]
C. Duke 19: checks 
McFussball81: checks 
*** TURN *** [6s 7s Ad] [Js]
C. Duke 19: checks 
McFussball81: checks 
*** RIVER *** [6s 7s Ad Js] [Qh]
C. Duke 19: checks 
McFussball81: checks 
*** SHOW DOWN ***
C. Duke 19: shows [Qs 9d] (a pair of Queens)
McFussball81: shows [Qd Td] (a pair of Queens - Ace+Jack+Ten kicker)
McFussball81 collected $4.30 from pot
*** SUMMARY ***
Total pot $4.50 | Rake $0.20 
Board [6s 7s Ad Js Qh]
Seat 1: matiko09 (button) folded before Flop (didn't bet)
Seat 3: simoniustin (small blind) folded before Flop
Seat 4: C. Duke 19 (big blind) showed [Qs 9d] and lost with a pair of Queens
Seat 5: McFussball81 showed [Qd Td] and won ($4.30) with a pair of Queens
Seat 6: apfush folded before Flop (didn't bet)
Seat 7: r.pol218 folded before Flop (didn't bet)
Seat 8: kuanhung0903 folded before Flop (didn't bet)
Seat 9: xAndorx folded before Flop (didn't bet)





PokerStars Hand #149395214957:  Hold'em No Limit ($0.50/$1.00 USD) - 2016/02/25 17:48:43 CET [2016/02/25 11:48:43 ET]
Table 'Morosovia II' 9-max Seat #8 is the button
Seat 1: $-Twackle-$ ($103.21 in chips) 
Seat 3: sebaaastian ($198.73 in chips) 
Seat 4: renechris ($93.61 in chips) 
Seat 5: gabi_igna ($158.27 in chips) 
Seat 6: Dachish ($67.50 in chips) 
Seat 7: matiko09 ($136.64 in chips) 
Seat 8: simoniustin ($114.59 in chips) 
Seat 9: lysandrafly ($118.44 in chips) 
lysandrafly: posts small blind $0.50
$-Twackle-$: posts big blind $1
Effort92: sits out 
*** HOLE CARDS ***
Dealt to matiko09 [Kc 5s]
sebaaastian: folds 
renechris: raises $2 to $3
gabi_igna: folds 
Dachish: folds 
matiko09: folds 
simoniustin: folds 
lysandrafly: calls $2.50
$-Twackle-$: calls $2
*** FLOP *** [8s 8c 6h]
lysandrafly: checks 
$-Twackle-$: checks 
renechris: checks 
*** TURN *** [8s 8c 6h] [9d]
lysandrafly: checks 
$-Twackle-$: bets $6
renechris: calls $6
lysandrafly: folds 
*** RIVER *** [8s 8c 6h 9d] [Ac]
$-Twackle-$: bets $14
renechris: raises $14 to $28
$-Twackle-$: raises $66.21 to $94.21 and is all-in
renechris: calls $56.61 and is all-in
Uncalled bet ($9.60) returned to $-Twackle-$
*** SHOW DOWN ***
$-Twackle-$: shows [6s 6c] (a full house, Sixes full of Eights)
renechris: shows [9h 9s] (a full house, Nines full of Eights)
renechris collected $187.42 from pot
*** SUMMARY ***
Total pot $190.22 | Rake $2.80 
Board [8s 8c 6h 9d Ac]
Seat 1: $-Twackle-$ (big blind) showed [6s 6c] and lost with a full house, Sixes full of Eights
Seat 3: sebaaastian folded before Flop (didn't bet)
Seat 4: renechris showed [9h 9s] and won ($187.42) with a full house, Nines full of Eights
Seat 5: gabi_igna folded before Flop (didn't bet)
Seat 6: Dachish folded before Flop (didn't bet)
Seat 7: matiko09 folded before Flop (didn't bet)
Seat 8: simoniustin (button) folded before Flop (didn't bet)
Seat 9: lysandrafly (small blind) folded on the Turn





PokerStars Hand #149395215618:  Hold'em No Limit ($0.50/$1.00 USD) - 2016/02/25 17:48:44 CET [2016/02/25 11:48:44 ET]
Table 'Nerthus II' 9-max Seat #7 is the button
Seat 1: volwebni4ek ($81.65 in chips) 
Seat 2: matiko09 ($216.28 in chips) 
Seat 3: simoniustin ($112.46 in chips) 
Seat 4: Ilov3NBA ($100 in chips) 
Seat 6: mycka86 ($155.20 in chips) 
Seat 7: Venomous100% ($105.65 in chips) 
Seat 8: meischt94 ($55.54 in chips) 
Seat 9: hammerwife ($100 in chips) 
meischt94: posts small blind $0.50
hammerwife: posts big blind $1
*** HOLE CARDS ***
Dealt to matiko09 [5h 4d]
volwebni4ek: folds 
matiko09: folds 
simoniustin: folds 
Ilov3NBA: folds 
mycka86: folds 
Venomous100%: raises $1 to $2
meischt94: folds 
hammerwife: calls $1
*** FLOP *** [Ts 7s 8s]
hammerwife: checks 
Venomous100%: checks 
*** TURN *** [Ts 7s 8s] [3h]
hammerwife: checks 
Venomous100%: checks 
*** RIVER *** [Ts 7s 8s 3h] [Qh]
hammerwife: checks 
Venomous100%: checks 
*** SHOW DOWN ***
hammerwife: shows [Ah 9d] (high card Ace)
Venomous100%: shows [Ks 3c] (a pair of Threes)
Venomous100% collected $4.30 from pot
*** SUMMARY ***
Total pot $4.50 | Rake $0.20 
Board [Ts 7s 8s 3h Qh]
Seat 1: volwebni4ek folded before Flop (didn't bet)
Seat 2: matiko09 folded before Flop (didn't bet)
Seat 3: simoniustin folded before Flop (didn't bet)
Seat 4: Ilov3NBA folded before Flop (didn't bet)
Seat 6: mycka86 folded before Flop (didn't bet)
Seat 7: Venomous100% (button) showed [Ks 3c] and won ($4.30) with a pair of Threes
Seat 8: meischt94 (small blind) folded before Flop
Seat 9: hammerwife (big blind) showed [Ah 9d] and lost with high card Ace





PokerStars Hand #149395219135:  Hold'em No Limit ($0.50/$1.00 USD) - 2016/02/25 17:48:49 CET [2016/02/25 11:48:49 ET]
Table 'Eurysaces II' 9-max Seat #9 is the button
Seat 1: lysandrafly ($106.58 in chips) 
Seat 2: sebaaastian ($205.48 in chips) 
Seat 3: Aalleekks ($124.76 in chips) 
Seat 4: gabi_igna ($109.25 in chips) 
Seat 5: keessie93 ($128.62 in chips) 
Seat 6: J0rmungund ($30.72 in chips) 
Seat 7: $-Twackle-$ ($104.50 in chips) 
Seat 8: hammerwife ($100 in chips) 
Seat 9: matiko09 ($100 in chips) 
lysandrafly: posts small blind $0.50
sebaaastian: posts big blind $1
*** HOLE CARDS ***
Dealt to matiko09 [7h Qh]
Aalleekks: folds 
gabi_igna: folds 
keessie93: folds 
J0rmungund: calls $1
$-Twackle-$: folds 
hammerwife: folds 
matiko09: raises $2 to $3
lysandrafly: folds 
sebaaastian: folds 
J0rmungund: calls $2
*** FLOP *** [8s 9s Kd]
J0rmungund: checks 
matiko09: checks 
*** TURN *** [8s 9s Kd] [Ks]
J0rmungund: checks 
matiko09: checks 
*** RIVER *** [8s 9s Kd Ks] [2s]
J0rmungund: bets $3.58
matiko09: folds 
Uncalled bet ($3.58) returned to J0rmungund
J0rmungund collected $7.16 from pot
*** SUMMARY ***
Total pot $7.50 | Rake $0.34 
Board [8s 9s Kd Ks 2s]
Seat 1: lysandrafly (small blind) folded before Flop
Seat 2: sebaaastian (big blind) folded before Flop
Seat 3: Aalleekks folded before Flop (didn't bet)
Seat 4: gabi_igna folded before Flop (didn't bet)
Seat 5: keessie93 folded before Flop (didn't bet)
Seat 6: J0rmungund collected ($7.16)
Seat 7: $-Twackle-$ folded before Flop (didn't bet)
Seat 8: hammerwife folded before Flop (didn't bet)
Seat 9: matiko09 (button) folded on the River





PokerStars Hand #149395225312:  Hold'em No Limit ($0.50/$1.00 USD) - 2016/02/25 17:48:56 CET [2016/02/25 11:48:56 ET]
Table 'Zerbinetta II' 9-max Seat #3 is the button
Seat 1: $-Twackle-$ ($102.30 in chips) 
Seat 3: matiko09 ($100.75 in chips) 
Seat 5: hammerwife ($116.27 in chips) 
Seat 6: simoniustin ($100 in chips) 
Seat 8: gabi_igna ($100 in chips) 
hammerwife: posts small blind $0.50
simoniustin: posts big blind $1
*** HOLE CARDS ***
Dealt to matiko09 [9s 4h]
gabi_igna: raises $2 to $3
$-Twackle-$: folds 
matiko09: folds 
hammerwife: folds 
simoniustin: folds 
Uncalled bet ($2) returned to gabi_igna
gabi_igna collected $2.50 from pot
gabi_igna: doesn't show hand 
*** SUMMARY ***
Total pot $2.50 | Rake $0 
Seat 1: $-Twackle-$ folded before Flop (didn't bet)
Seat 3: matiko09 (button) folded before Flop (didn't bet)
Seat 5: hammerwife (small blind) folded before Flop
Seat 6: simoniustin (big blind) folded before Flop
Seat 8: gabi_igna collected ($2.50)





PokerStars Hand #149395226384:  Hold'em No Limit ($0.50/$1.00 USD) - 2016/02/25 17:48:57 CET [2016/02/25 11:48:57 ET]
Table 'Isa' 9-max Seat #2 is the button
Seat 1: matiko09 ($126.38 in chips) 
Seat 2: mycka86 ($156.81 in chips) 
Seat 3: sebaaastian ($152.30 in chips) 
Seat 4: hammerwife ($133.45 in chips) 
Seat 6: xAndorx ($103 in chips) 
Seat 7: bilukm ($66.59 in chips) 
Seat 8: Venomous100% ($108.24 in chips) 
Seat 9: volwebni4ek ($53.36 in chips) 
sebaaastian: posts small blind $0.50
hammerwife: posts big blind $1
*** HOLE CARDS ***
Dealt to matiko09 [Td 3c]
xAndorx: folds 
bilukm: raises $1 to $2
Venomous100%: folds 
volwebni4ek: folds 
matiko09: folds 
mycka86: folds 
sebaaastian: calls $1.50
hammerwife: folds 
*** FLOP *** [6s Ah 8d]
sebaaastian: checks 
bilukm: bets $2.39
sebaaastian: folds 
Uncalled bet ($2.39) returned to bilukm
bilukm collected $4.78 from pot
bilukm: doesn't show hand 
*** SUMMARY ***
Total pot $5 | Rake $0.22 
Board [6s Ah 8d]
Seat 1: matiko09 folded before Flop (didn't bet)
Seat 2: mycka86 (button) folded before Flop (didn't bet)
Seat 3: sebaaastian (small blind) folded on the Flop
Seat 4: hammerwife (big blind) folded before Flop
Seat 6: xAndorx folded before Flop (didn't bet)
Seat 7: bilukm collected ($4.78)
Seat 8: Venomous100% folded before Flop (didn't bet)
Seat 9: volwebni4ek folded before Flop (didn't bet)





PokerStars Hand #149395232910:  Hold'em No Limit ($0.50/$1.00 USD) - 2016/02/25 17:49:05 CET [2016/02/25 11:49:05 ET]
Table 'Fiducia II' 9-max Seat #4 is the button
Seat 1: Venomous100% ($103.34 in chips) 
Seat 2: brokat77 ($92.84 in chips) 
Seat 3: Oldemester ($98.50 in chips) 
Seat 4: matiko09 ($100 in chips) 
Seat 5: Dachish ($71.59 in chips) 
Seat 6: Yaaaazz ($129.38 in chips) 
Seat 7: gabi_igna ($106.87 in chips) 
Seat 8: simoniustin ($217.60 in chips) 
Dachish: posts small blind $0.50
Yaaaazz: posts big blind $1
apfush: sits out 
*** HOLE CARDS ***
Dealt to matiko09 [Qs 3s]
gabi_igna: folds 
simoniustin: folds 
Venomous100%: folds 
brokat77: folds 
Oldemester: folds 
matiko09: raises $1.27 to $2.27
Dachish: calls $1.77
Yaaaazz: calls $1.27
*** FLOP *** [Th 2s 5h]
Dachish: checks 
Yaaaazz: checks 
matiko09: bets $4.23
Dachish: folds 
Yaaaazz: raises $9.77 to $14
matiko09: folds 
Uncalled bet ($9.77) returned to Yaaaazz
Yaaaazz collected $14.58 from pot
*** SUMMARY ***
Total pot $15.27 | Rake $0.69 
Board [Th 2s 5h]
Seat 1: Venomous100% folded before Flop (didn't bet)
Seat 2: brokat77 folded before Flop (didn't bet)
Seat 3: Oldemester folded before Flop (didn't bet)
Seat 4: matiko09 (button) folded on the Flop
Seat 5: Dachish (small blind) folded on the Flop
Seat 6: Yaaaazz (big blind) collected ($14.58)
Seat 7: gabi_igna folded before Flop (didn't bet)
Seat 8: simoniustin folded before Flop (didn't bet)





PokerStars Hand #149395234176:  Hold'em No Limit ($0.50/$1.00 USD) - 2016/02/25 17:49:07 CET [2016/02/25 11:49:07 ET]
Table 'Syrma II' 9-max Seat #7 is the button
Seat 1: Venomous100% ($100 in chips) 
Seat 3: shayu 9988 ($79.12 in chips) 
Seat 4: volwebni4ek ($73.34 in chips) 
Seat 6: matiko09 ($100 in chips) 
Seat 7: lysandrafly ($107.18 in chips) 
Seat 9: xAndorx ($100 in chips) 
xAndorx: posts small blind $0.50
Venomous100%: posts big blind $1
$-Twackle-$: sits out 
*** HOLE CARDS ***
Dealt to matiko09 [Jh Kc]
shayu 9988: folds 
volwebni4ek: folds 
matiko09: raises $1.50 to $2.50
lysandrafly: folds 
xAndorx: folds 
Venomous100%: folds 
Uncalled bet ($1.50) returned to matiko09
matiko09 collected $2.50 from pot
matiko09: doesn't show hand 
*** SUMMARY ***
Total pot $2.50 | Rake $0 
Seat 1: Venomous100% (big blind) folded before Flop
Seat 3: shayu 9988 folded before Flop (didn't bet)
Seat 4: volwebni4ek folded before Flop (didn't bet)
Seat 6: matiko09 collected ($2.50)
Seat 7: lysandrafly (button) folded before Flop (didn't bet)
Seat 9: xAndorx (small blind) folded before Flop





PokerStars Hand #149395242542:  Hold'em No Limit ($0.25/$0.50 USD) - 2016/02/25 17:49:17 CET [2016/02/25 11:49:17 ET]
Table 'Lohja II' 9-max Seat #2 is the button
Seat 1: MoonJimmy ($160.75 in chips) 
Seat 2: mycka86 ($56.68 in chips) 
Seat 4: payback11 ($50 in chips) 
Seat 5: Effort92 ($52.45 in chips) 
Seat 6: xAndorx ($64.26 in chips) 
Seat 7: matiko09 ($93.07 in chips) 
Seat 8: pasa132 ($65 in chips) 
Seat 9: Al3xAnd3r22 ($142.67 in chips) 
payback11: posts small blind $0.25
Effort92: posts big blind $0.50
MoonJimmy: posts the ante $0.10
mycka86: posts the ante $0.10
payback11: posts the ante $0.10
Effort92: posts the ante $0.10
xAndorx: posts the ante $0.10
matiko09: posts the ante $0.10
pasa132: posts the ante $0.10
Al3xAnd3r22: posts the ante $0.10
*** HOLE CARDS ***
Dealt to matiko09 [3h Js]
xAndorx: raises $1 to $1.50
matiko09: folds 
pasa132: folds 
Al3xAnd3r22: folds 
MoonJimmy: folds 
mycka86: calls $1.50
payback11: folds 
Effort92: folds 
*** FLOP *** [Ad Qd 2d]
xAndorx: checks 
mycka86: checks 
*** TURN *** [Ad Qd 2d] [Qs]
xAndorx: bets $3
mycka86: folds 
Uncalled bet ($3) returned to xAndorx
xAndorx collected $4.35 from pot
xAndorx: doesn't show hand 
*** SUMMARY ***
Total pot $4.55 | Rake $0.20 
Board [Ad Qd 2d Qs]
Seat 1: MoonJimmy folded before Flop (didn't bet)
Seat 2: mycka86 (button) folded on the Turn
Seat 4: payback11 (small blind) folded before Flop
Seat 5: Effort92 (big blind) folded before Flop
Seat 6: xAndorx collected ($4.35)
Seat 7: matiko09 folded before Flop (didn't bet)
Seat 8: pasa132 folded before Flop (didn't bet)
Seat 9: Al3xAnd3r22 folded before Flop (didn't bet)





PokerStars Hand #149395245870:  Hold'em No Limit (€0.25/€0.50 EUR) - 2016/02/25 17:49:21 CET [2016/02/25 11:49:21 ET]
Table 'Diadem IV' 9-max Seat #8 is the button
Seat 1: Ganador79 (€43.18 in chips) 
Seat 3: timbo_5563 (€21.04 in chips) 
Seat 5: matiko09 (€53.45 in chips) 
Seat 6: Al3xAnd3r22 (€59.83 in chips) 
Seat 7: JustR82 (€71.87 in chips) 
Seat 8: Troll8989 (€51.35 in chips) 
Ganador79: posts small blind €0.25
timbo_5563: posts big blind €0.50
Effort92: sits out 
*** HOLE CARDS ***
Dealt to matiko09 [Tc 8d]
matiko09: folds 
Al3xAnd3r22: folds 
JustR82: folds 
Troll8989: raises €1 to €1.50
Ganador79: calls €1.25
timbo_5563: folds 
*** FLOP *** [3d 9c 2h]
Ganador79: checks 
Troll8989: bets €2
Ganador79: folds 
Uncalled bet (€2) returned to Troll8989
Troll8989 collected €3.34 from pot
Troll8989: doesn't show hand 
*** SUMMARY ***
Total pot €3.50 | Rake €0.16 
Board [3d 9c 2h]
Seat 1: Ganador79 (small blind) folded on the Flop
Seat 3: timbo_5563 (big blind) folded before Flop
Seat 5: matiko09 folded before Flop (didn't bet)
Seat 6: Al3xAnd3r22 folded before Flop (didn't bet)
Seat 7: JustR82 folded before Flop (didn't bet)
Seat 8: Troll8989 (button) collected (€3.34)





PokerStars Hand #149395255863:  Hold'em No Limit ($0.50/$1.00 USD) - 2016/02/25 17:49:34 CET [2016/02/25 11:49:34 ET]
Table 'Isa' 9-max Seat #3 is the button
Seat 1: matiko09 ($126.38 in chips) 
Seat 2: mycka86 ($156.81 in chips) 
Seat 3: sebaaastian ($150.30 in chips) 
Seat 4: hammerwife ($132.45 in chips) 
Seat 6: xAndorx ($103 in chips) 
Seat 7: bilukm ($69.37 in chips) 
Seat 8: Venomous100% ($108.24 in chips) 
Seat 9: volwebni4ek ($53.36 in chips) 
hammerwife: posts small blind $0.50
xAndorx: posts big blind $1
*** HOLE CARDS ***
Dealt to matiko09 [7h 7d]
bilukm: calls $1
Venomous100%: folds 
volwebni4ek: folds 
matiko09: raises $3 to $4
mycka86: folds 
sebaaastian: folds 
hammerwife: folds 
xAndorx: folds 
bilukm: calls $3
*** FLOP *** [9s 5c 9d]
bilukm: checks 
matiko09: bets $5
bilukm: folds 
Uncalled bet ($5) returned to matiko09
matiko09 collected $9.07 from pot
matiko09: doesn't show hand 
*** SUMMARY ***
Total pot $9.50 | Rake $0.43 
Board [9s 5c 9d]
Seat 1: matiko09 collected ($9.07)
Seat 2: mycka86 folded before Flop (didn't bet)
Seat 3: sebaaastian (button) folded before Flop (didn't bet)
Seat 4: hammerwife (small blind) folded before Flop
Seat 6: xAndorx (big blind) folded before Flop
Seat 7: bilukm folded on the Flop
Seat 8: Venomous100% folded before Flop (didn't bet)
Seat 9: volwebni4ek folded before Flop (didn't bet)





PokerStars Hand #149395259240:  Hold'em No Limit ($0.25/$0.50 USD) - 2016/02/25 17:49:38 CET [2016/02/25 11:49:38 ET]
Table 'Vladimir' 9-max Seat #5 is the button
Seat 1: matiko09 ($50 in chips) 
Seat 2: Vedpapa ($52.09 in chips) 
Seat 3: Troll8989 ($50 in chips) 
Seat 4: ffac ($58.10 in chips) 
Seat 5: Al3xAnd3r22 ($57.46 in chips) 
Seat 6: dkafgankush ($19.50 in chips) 
Seat 7: myllow1 ($71.73 in chips) 
dkafgankush: posts small blind $0.25
myllow1: posts big blind $0.50
Effort92: sits out 
AceFarky: sits out 
*** HOLE CARDS ***
Dealt to matiko09 [Th 5h]
matiko09: folds 
Vedpapa has timed out
Vedpapa: folds 
Troll8989: folds 
ffac: raises $0.75 to $1.25
Al3xAnd3r22: folds 
dkafgankush: calls $1
myllow1: folds 
*** FLOP *** [2h Js As]
dkafgankush: checks 
ffac: checks 
*** TURN *** [2h Js As] [Kc]
dkafgankush: checks 
ffac: checks 
*** RIVER *** [2h Js As Kc] [Jc]
dkafgankush: bets $3
ffac: calls $3
*** SHOW DOWN ***
dkafgankush: shows [9d 8s] (a pair of Jacks)
ffac: shows [Jh 8h] (three of a kind, Jacks)
ffac collected $8.60 from pot
*** SUMMARY ***
Total pot $9 | Rake $0.40 
Board [2h Js As Kc Jc]
Seat 1: matiko09 folded before Flop (didn't bet)
Seat 2: Vedpapa folded before Flop (didn't bet)
Seat 3: Troll8989 folded before Flop (didn't bet)
Seat 4: ffac showed [Jh 8h] and won ($8.60) with three of a kind, Jacks
Seat 5: Al3xAnd3r22 (button) folded before Flop (didn't bet)
Seat 6: dkafgankush (small blind) showed [9d 8s] and lost with a pair of Jacks
Seat 7: myllow1 (big blind) folded before Flop





PokerStars Hand #149395264003:  Hold'em No Limit ($0.50/$1.00 USD) - 2016/02/25 17:49:44 CET [2016/02/25 11:49:44 ET]
Table 'Syrma II' 9-max Seat #9 is the button
Seat 1: Venomous100% ($100 in chips) 
Seat 2: $-Twackle-$ ($100 in chips) 
Seat 3: shayu 9988 ($79.12 in chips) 
Seat 4: volwebni4ek ($73.34 in chips) 
Seat 5: BIGWIN2016 ($87.30 in chips) 
Seat 6: matiko09 ($101.50 in chips) 
Seat 7: lysandrafly ($107.18 in chips) 
Seat 9: xAndorx ($100 in chips) 
Venomous100%: posts small blind $0.50
$-Twackle-$: posts big blind $1
*** HOLE CARDS ***
Dealt to matiko09 [3d Ac]
shayu 9988: folds 
volwebni4ek: folds 
BIGWIN2016: folds 
matiko09: folds 
lysandrafly: folds 
xAndorx: raises $1 to $2
Venomous100%: folds 
$-Twackle-$: folds 
Uncalled bet ($1) returned to xAndorx
xAndorx collected $2.50 from pot
xAndorx: doesn't show hand 
*** SUMMARY ***
Total pot $2.50 | Rake $0 
Seat 1: Venomous100% (small blind) folded before Flop
Seat 2: $-Twackle-$ (big blind) folded before Flop
Seat 3: shayu 9988 folded before Flop (didn't bet)
Seat 4: volwebni4ek folded before Flop (didn't bet)
Seat 5: BIGWIN2016 folded before Flop (didn't bet)
Seat 6: matiko09 folded before Flop (didn't bet)
Seat 7: lysandrafly folded before Flop (didn't bet)
Seat 9: xAndorx (button) collected ($2.50)





PokerStars Hand #149395265417:  Hold'em No Limit ($0.50/$1.00 USD) - 2016/02/25 17:49:45 CET [2016/02/25 11:49:45 ET]
Table 'Nerthus II' 9-max Seat #8 is the button
Seat 2: matiko09 ($216.28 in chips) 
Seat 3: simoniustin ($112.46 in chips) 
Seat 4: Ilov3NBA ($100 in chips) 
Seat 6: mycka86 ($155.20 in chips) 
Seat 7: Venomous100% ($107.95 in chips) 
Seat 8: meischt94 ($55.04 in chips) 
Seat 9: hammerwife ($100 in chips) 
hammerwife: posts small blind $0.50
volwebni4ek: is sitting out 
matiko09: posts big blind $1
*** HOLE CARDS ***
Dealt to matiko09 [Jc Qd]
simoniustin: folds 
Ilov3NBA: folds 
mycka86: folds 
Venomous100%: folds 
meischt94: raises $1 to $2
hammerwife: raises $6 to $8
volwebni4ek leaves the table
matiko09: folds 
meischt94: folds 
Uncalled bet ($6) returned to hammerwife
Pacifistas joins the table at seat #1 
hammerwife collected $5 from pot
hammerwife: doesn't show hand 
*** SUMMARY ***
Total pot $5 | Rake $0 
Seat 2: matiko09 (big blind) folded before Flop
Seat 3: simoniustin folded before Flop (didn't bet)
Seat 4: Ilov3NBA folded before Flop (didn't bet)
Seat 6: mycka86 folded before Flop (didn't bet)
Seat 7: Venomous100% folded before Flop (didn't bet)
Seat 8: meischt94 (button) folded before Flop
Seat 9: hammerwife (small blind) collected ($5)





PokerStars Hand #149395270559:  Hold'em No Limit (€0.25/€0.50 EUR) - 2016/02/25 17:49:52 CET [2016/02/25 11:49:52 ET]
Table 'Prokne II' 9-max Seat #7 is the button
Seat 1: Al3xAnd3r22 (€61.95 in chips) 
Seat 2: payback11 (€50 in chips) 
Seat 3: JustR82 (€51.16 in chips) 
Seat 4: carlito cri (€36.88 in chips) 
Seat 5: Makitra (€52.24 in chips) 
Seat 6: matiko09 (€50 in chips) 
Seat 7: lysandrafly (€61.10 in chips) 
Seat 9: ihami (€54.60 in chips) 
HomerrrJay will be allowed to play after the button
ihami: posts small blind €0.25
Al3xAnd3r22: posts big blind €0.50
*** HOLE CARDS ***
Dealt to matiko09 [8d 8c]
payback11: folds 
JustR82: raises €1 to €1.50
carlito cri: folds 
Makitra: folds 
matiko09: calls €1.50
lysandrafly: folds 
ihami: folds 
Al3xAnd3r22: folds 
*** FLOP *** [Jh Jc 7d]
JustR82: bets €2.25
matiko09: calls €2.25
*** TURN *** [Jh Jc 7d] [Qd]
JustR82: bets €5.50
matiko09: folds 
Uncalled bet (€5.50) returned to JustR82
JustR82 collected €7.88 from pot
JustR82: doesn't show hand 
*** SUMMARY ***
Total pot €8.25 | Rake €0.37 
Board [Jh Jc 7d Qd]
Seat 1: Al3xAnd3r22 (big blind) folded before Flop
Seat 2: payback11 folded before Flop (didn't bet)
Seat 3: JustR82 collected (€7.88)
Seat 4: carlito cri folded before Flop (didn't bet)
Seat 5: Makitra folded before Flop (didn't bet)
Seat 6: matiko09 folded on the Turn
Seat 7: lysandrafly (button) folded before Flop (didn't bet)
Seat 9: ihami (small blind) folded before Flop





PokerStars Hand #149395273286:  Hold'em No Limit (€0.25/€0.50 EUR) - 2016/02/25 17:49:55 CET [2016/02/25 11:49:55 ET]
Table 'Diadem IV' 9-max Seat #1 is the button
Seat 1: Ganador79 (€41.68 in chips) 
Seat 3: timbo_5563 (€20.54 in chips) 
Seat 4: Effort92 (€55.71 in chips) 
Seat 5: matiko09 (€53.45 in chips) 
Seat 6: Al3xAnd3r22 (€59.83 in chips) 
Seat 7: JustR82 (€71.87 in chips) 
Seat 8: Troll8989 (€53.19 in chips) 
timbo_5563: posts small blind €0.25
Effort92: posts big blind €0.50
*** HOLE CARDS ***
Dealt to matiko09 [Jc 4s]
matiko09: folds 
Al3xAnd3r22: folds 
JustR82: folds 
Troll8989: raises €1 to €1.50
Ganador79: folds 
timbo_5563: folds 
Effort92: folds 
Uncalled bet (€1) returned to Troll8989
Troll8989 collected €1.25 from pot
Troll8989: doesn't show hand 
*** SUMMARY ***
Total pot €1.25 | Rake €0 
Seat 1: Ganador79 (button) folded before Flop (didn't bet)
Seat 3: timbo_5563 (small blind) folded before Flop
Seat 4: Effort92 (big blind) folded before Flop
Seat 5: matiko09 folded before Flop (didn't bet)
Seat 6: Al3xAnd3r22 folded before Flop (didn't bet)
Seat 7: JustR82 folded before Flop (didn't bet)
Seat 8: Troll8989 collected (€1.25)





PokerStars Hand #149395274570:  Hold'em No Limit ($0.50/$1.00 USD) - 2016/02/25 17:49:57 CET [2016/02/25 11:49:57 ET]
Table 'Eurysaces II' 9-max Seat #1 is the button
Seat 1: lysandrafly ($106.08 in chips) 
Seat 2: sebaaastian ($204.48 in chips) 
Seat 5: keessie93 ($128.62 in chips) 
Seat 6: J0rmungund ($34.88 in chips) 
Seat 7: $-Twackle-$ ($104.50 in chips) 
Seat 8: hammerwife ($100 in chips) 
Seat 9: matiko09 ($100 in chips) 
sebaaastian: posts small blind $0.50
Aalleekks: is sitting out 
gabi_igna: is sitting out 
keessie93: posts big blind $1
*** HOLE CARDS ***
Dealt to matiko09 [As 4d]
J0rmungund: calls $1
$-Twackle-$: folds 
hammerwife: folds 
matiko09: folds 
lysandrafly: folds 
sebaaastian: folds 
keessie93: checks 
*** FLOP *** [7h Kd Td]
keessie93: checks 
J0rmungund: bets $1.19
keessie93: folds 
Uncalled bet ($1.19) returned to J0rmungund
J0rmungund collected $2.39 from pot
*** SUMMARY ***
Total pot $2.50 | Rake $0.11 
Board [7h Kd Td]
Seat 1: lysandrafly (button) folded before Flop (didn't bet)
Seat 2: sebaaastian (small blind) folded before Flop
Seat 5: keessie93 (big blind) folded on the Flop
Seat 6: J0rmungund collected ($2.39)
Seat 7: $-Twackle-$ folded before Flop (didn't bet)
Seat 8: hammerwife folded before Flop (didn't bet)
Seat 9: matiko09 folded before Flop (didn't bet)





PokerStars Hand #149395280054:  Hold'em No Limit ($0.25/$0.50 USD) - 2016/02/25 17:50:03 CET [2016/02/25 11:50:03 ET]
Table 'Lohja II' 9-max Seat #4 is the button
Seat 1: MoonJimmy ($160.65 in chips) 
Seat 2: mycka86 ($55.08 in chips) 
Seat 4: payback11 ($50 in chips) 
Seat 5: Effort92 ($51.85 in chips) 
Seat 6: xAndorx ($67.01 in chips) 
Seat 7: matiko09 ($92.97 in chips) 
Seat 8: pasa132 ($65 in chips) 
Seat 9: Al3xAnd3r22 ($142.57 in chips) 
Effort92: posts small blind $0.25
xAndorx: posts big blind $0.50
MoonJimmy: posts the ante $0.10
mycka86: posts the ante $0.10
payback11: posts the ante $0.10
Effort92: posts the ante $0.10
xAndorx: posts the ante $0.10
matiko09: posts the ante $0.10
pasa132: posts the ante $0.10
Al3xAnd3r22: posts the ante $0.10
*** HOLE CARDS ***
Dealt to matiko09 [4s Js]
matiko09: folds 
pasa132: folds 
Al3xAnd3r22: folds 
MoonJimmy: folds 
mycka86: folds 
payback11: folds 
Effort92: raises $1 to $1.50
xAndorx: folds 
Uncalled bet ($1) returned to Effort92
Effort92 collected $1.80 from pot
Effort92: doesn't show hand 
*** SUMMARY ***
Total pot $1.80 | Rake $0 
Seat 1: MoonJimmy folded before Flop (didn't bet)
Seat 2: mycka86 folded before Flop (didn't bet)
Seat 4: payback11 (button) folded before Flop (didn't bet)
Seat 5: Effort92 (small blind) collected ($1.80)
Seat 6: xAndorx (big blind) folded before Flop
Seat 7: matiko09 folded before Flop (didn't bet)
Seat 8: pasa132 folded before Flop (didn't bet)
Seat 9: Al3xAnd3r22 folded before Flop (didn't bet)





PokerStars Hand #149395280924:  Hold'em No Limit ($0.50/$1.00 USD) - 2016/02/25 17:50:04 CET [2016/02/25 11:50:04 ET]
Table 'Mayall II' 9-max Seat #3 is the button
Seat 1: matiko09 ($121.44 in chips) 
Seat 3: simoniustin ($122.64 in chips) 
Seat 4: C. Duke 19 ($97.40 in chips) 
Seat 5: McFussball81 ($74.86 in chips) 
Seat 6: apfush ($100 in chips) 
Seat 7: r.pol218 ($41.28 in chips) 
Seat 8: kuanhung0903 ($78.87 in chips) 
Seat 9: xAndorx ($124.34 in chips) 
C. Duke 19: posts small blind $0.50
McFussball81: posts big blind $1
marrajon: sits out 
*** HOLE CARDS ***
Dealt to matiko09 [Qs Ac]
apfush: folds 
r.pol218: folds 
kuanhung0903: folds 
xAndorx: folds 
matiko09: raises $1.50 to $2.50
simoniustin: folds 
C. Duke 19: folds 
McFussball81: folds 
Uncalled bet ($1.50) returned to matiko09
matiko09 collected $2.50 from pot
matiko09: doesn't show hand 
*** SUMMARY ***
Total pot $2.50 | Rake $0 
Seat 1: matiko09 collected ($2.50)
Seat 3: simoniustin (button) folded before Flop (didn't bet)
Seat 4: C. Duke 19 (small blind) folded before Flop
Seat 5: McFussball81 (big blind) folded before Flop
Seat 6: apfush folded before Flop (didn't bet)
Seat 7: r.pol218 folded before Flop (didn't bet)
Seat 8: kuanhung0903 folded before Flop (didn't bet)
Seat 9: xAndorx folded before Flop (didn't bet)





PokerStars Hand #149395286053:  Hold'em No Limit ($0.50/$1.00 USD) - 2016/02/25 17:50:11 CET [2016/02/25 11:50:11 ET]
Table 'Nerthus II' 9-max Seat #9 is the button
Seat 2: matiko09 ($215.28 in chips) 
Seat 3: simoniustin ($112.46 in chips) 
Seat 4: Ilov3NBA ($100 in chips) 
Seat 6: mycka86 ($155.20 in chips) 
Seat 7: Venomous100% ($107.95 in chips) 
Seat 8: meischt94 ($53.04 in chips) 
Seat 9: hammerwife ($103 in chips) 
matiko09: posts small blind $0.50
simoniustin: posts big blind $1
*** HOLE CARDS ***
Dealt to matiko09 [4s Tc]
Ilov3NBA: folds 
mycka86: folds 
Venomous100%: raises $2 to $3
meischt94: folds 
hammerwife: folds 
matiko09: folds 
simoniustin: folds 
Uncalled bet ($2) returned to Venomous100%
Venomous100% collected $2.50 from pot
Venomous100%: doesn't show hand 
*** SUMMARY ***
Total pot $2.50 | Rake $0 
Seat 2: matiko09 (small blind) folded before Flop
Seat 3: simoniustin (big blind) folded before Flop
Seat 4: Ilov3NBA folded before Flop (didn't bet)
Seat 6: mycka86 folded before Flop (didn't bet)
Seat 7: Venomous100% collected ($2.50)
Seat 8: meischt94 folded before Flop (didn't bet)
Seat 9: hammerwife (button) folded before Flop (didn't bet)





PokerStars Hand #149395285851:  Hold'em No Limit ($0.50/$1.00 USD) - 2016/02/25 17:50:11 CET [2016/02/25 11:50:11 ET]
Table 'Morosovia II' 9-max Seat #9 is the button
Seat 1: $-Twackle-$ ($100 in chips) 
Seat 2: Effort92 ($176.66 in chips) 
Seat 3: sebaaastian ($198.73 in chips) 
Seat 4: renechris ($187.42 in chips) 
Seat 5: gabi_igna ($158.27 in chips) 
Seat 6: Dachish ($67.50 in chips) 
Seat 7: matiko09 ($136.64 in chips) 
Seat 8: simoniustin ($114.59 in chips) 
Seat 9: lysandrafly ($115.44 in chips) 
$-Twackle-$: posts small blind $0.50
Effort92: posts big blind $1
*** HOLE CARDS ***
Dealt to matiko09 [6c Jh]
sebaaastian: folds 
renechris: folds 
gabi_igna: folds 
Dachish: folds 
matiko09: folds 
simoniustin: folds 
lysandrafly: raises $1.40 to $2.40
$-Twackle-$: folds 
Effort92: folds 
Uncalled bet ($1.40) returned to lysandrafly
lysandrafly collected $2.50 from pot
lysandrafly: doesn't show hand 
*** SUMMARY ***
Total pot $2.50 | Rake $0 
Seat 1: $-Twackle-$ (small blind) folded before Flop
Seat 2: Effort92 (big blind) folded before Flop
Seat 3: sebaaastian folded before Flop (didn't bet)
Seat 4: renechris folded before Flop (didn't bet)
Seat 5: gabi_igna folded before Flop (didn't bet)
Seat 6: Dachish folded before Flop (didn't bet)
Seat 7: matiko09 folded before Flop (didn't bet)
Seat 8: simoniustin folded before Flop (didn't bet)
Seat 9: lysandrafly (button) collected ($2.50)





PokerStars Hand #149395287840:  Hold'em No Limit ($0.50/$1.00 USD) - 2016/02/25 17:50:13 CET [2016/02/25 11:50:13 ET]
Table 'Fiducia II' 9-max Seat #5 is the button
Seat 1: Venomous100% ($103.34 in chips) 
Seat 2: brokat77 ($92.84 in chips) 
Seat 3: Oldemester ($98.50 in chips) 
Seat 4: matiko09 ($100 in chips) 
Seat 5: Dachish ($69.32 in chips) 
Seat 6: Yaaaazz ($137.46 in chips) 
Seat 8: simoniustin ($217.60 in chips) 
Yaaaazz: posts small blind $0.50
gabi_igna: is sitting out 
simoniustin: posts big blind $1
apfush: sits out 
*** HOLE CARDS ***
Dealt to matiko09 [5s 3h]
Venomous100%: folds 
brokat77: folds 
Oldemester: calls $1
matiko09: folds 
Dachish: folds 
Yaaaazz: folds 
simoniustin: checks 
*** FLOP *** [Qc 6c Qh]
simoniustin: checks 
Oldemester: bets $2
simoniustin: calls $2
*** TURN *** [Qc 6c Qh] [3c]
simoniustin: checks 
Oldemester: bets $4.13
simoniustin: calls $4.13
*** RIVER *** [Qc 6c Qh 3c] [4c]
simoniustin: checks 
Oldemester: checks 
*** SHOW DOWN ***
simoniustin: shows [6s 9h] (two pair, Queens and Sixes)
Oldemester: shows [8c 9c] (a flush, Queen high)
Oldemester collected $14.10 from pot
*** SUMMARY ***
Total pot $14.76 | Rake $0.66 
Board [Qc 6c Qh 3c 4c]
Seat 1: Venomous100% folded before Flop (didn't bet)
Seat 2: brokat77 folded before Flop (didn't bet)
Seat 3: Oldemester showed [8c 9c] and won ($14.10) with a flush, Queen high
Seat 4: matiko09 folded before Flop (didn't bet)
Seat 5: Dachish (button) folded before Flop (didn't bet)
Seat 6: Yaaaazz (small blind) folded before Flop
Seat 8: simoniustin (big blind) showed [6s 9h] and lost with two pair, Queens and Sixes





PokerStars Hand #149395293135:  Hold'em No Limit ($0.50/$1.00 USD) - 2016/02/25 17:50:19 CET [2016/02/25 11:50:19 ET]
Table 'Isa' 9-max Seat #4 is the button
Seat 1: matiko09 ($131.45 in chips) 
Seat 2: mycka86 ($156.81 in chips) 
Seat 3: sebaaastian ($150.30 in chips) 
Seat 4: hammerwife ($131.95 in chips) 
Seat 6: xAndorx ($102 in chips) 
Seat 7: bilukm ($65.37 in chips) 
Seat 8: Venomous100% ($108.24 in chips) 
Seat 9: volwebni4ek ($53.36 in chips) 
xAndorx: posts small blind $0.50
bilukm: posts big blind $1
*** HOLE CARDS ***
Dealt to matiko09 [Ts 2h]
Venomous100%: folds 
volwebni4ek: folds 
matiko09: folds 
mycka86: folds 
sebaaastian: folds 
hammerwife: raises $1.01 to $2.01
xAndorx: folds 
bilukm: calls $1.01
*** FLOP *** [8c Tc 3c]
bilukm: bets $1
hammerwife: raises $3.50 to $4.50
bilukm: folds 
Uncalled bet ($3.50) returned to hammerwife
hammerwife collected $6.23 from pot
*** SUMMARY ***
Total pot $6.52 | Rake $0.29 
Board [8c Tc 3c]
Seat 1: matiko09 folded before Flop (didn't bet)
Seat 2: mycka86 folded before Flop (didn't bet)
Seat 3: sebaaastian folded before Flop (didn't bet)
Seat 4: hammerwife (button) collected ($6.23)
Seat 6: xAndorx (small blind) folded before Flop
Seat 7: bilukm (big blind) folded on the Flop
Seat 8: Venomous100% folded before Flop (didn't bet)
Seat 9: volwebni4ek folded before Flop (didn't bet)





PokerStars Hand #149395294883:  Hold'em No Limit ($0.50/$1.00 USD) - 2016/02/25 17:50:22 CET [2016/02/25 11:50:22 ET]
Table 'Syrma II' 9-max Seat #1 is the button
Seat 1: Venomous100% ($100 in chips) 
Seat 2: $-Twackle-$ ($100 in chips) 
Seat 3: shayu 9988 ($79.12 in chips) 
Seat 4: volwebni4ek ($73.34 in chips) 
Seat 5: BIGWIN2016 ($87.30 in chips) 
Seat 6: matiko09 ($101.50 in chips) 
Seat 7: lysandrafly ($107.18 in chips) 
Seat 9: xAndorx ($101.50 in chips) 
$-Twackle-$: posts small blind $0.50
shayu 9988: posts big blind $1
*** HOLE CARDS ***
Dealt to matiko09 [Js 4h]
volwebni4ek: folds 
BIGWIN2016: folds 
matiko09: folds 
lysandrafly: folds 
xAndorx: raises $1.50 to $2.50
BIGWIN2016 is disconnected 
Venomous100%: raises $4.50 to $7
$-Twackle-$: folds 
shayu 9988: folds 
xAndorx: folds 
Uncalled bet ($4.50) returned to Venomous100%
Venomous100% collected $6.50 from pot
Venomous100%: doesn't show hand 
*** SUMMARY ***
Total pot $6.50 | Rake $0 
Seat 1: Venomous100% (button) collected ($6.50)
Seat 2: $-Twackle-$ (small blind) folded before Flop
Seat 3: shayu 9988 (big blind) folded before Flop
Seat 4: volwebni4ek folded before Flop (didn't bet)
Seat 5: BIGWIN2016 folded before Flop (didn't bet)
Seat 6: matiko09 folded before Flop (didn't bet)
Seat 7: lysandrafly folded before Flop (didn't bet)
Seat 9: xAndorx folded before Flop





PokerStars Hand #149395296410:  Hold'em No Limit ($0.50/$1.00 USD) - 2016/02/25 17:50:23 CET [2016/02/25 11:50:23 ET]
Table 'Eurysaces II' 9-max Seat #2 is the button
Seat 1: lysandrafly ($106.08 in chips) 
Seat 2: sebaaastian ($203.98 in chips) 
Seat 5: keessie93 ($127.62 in chips) 
Seat 6: J0rmungund ($36.27 in chips) 
Seat 7: $-Twackle-$ ($104.50 in chips) 
Seat 8: hammerwife ($100 in chips) 
Seat 9: matiko09 ($100 in chips) 
keessie93: posts small blind $0.50
J0rmungund: posts big blind $1
*** HOLE CARDS ***
Dealt to matiko09 [3h Jh]
Aalleekks leaves the table
$-Twackle-$: folds 
ffac joins the table at seat #3 
hammerwife: folds 
matiko09: folds 
lysandrafly: raises $1.80 to $2.80
sebaaastian: folds 
keessie93: folds 
J0rmungund: calls $1.80
*** FLOP *** [9h 4d 5h]
J0rmungund: checks 
lysandrafly: checks 
*** TURN *** [9h 4d 5h] [9c]
J0rmungund: bets $3
lysandrafly: calls $3
*** RIVER *** [9h 4d 5h 9c] [9d]
J0rmungund: bets $8.67
lysandrafly: folds 
Uncalled bet ($8.67) returned to J0rmungund
J0rmungund collected $11.56 from pot
*** SUMMARY ***
Total pot $12.10 | Rake $0.54 
Board [9h 4d 5h 9c 9d]
Seat 1: lysandrafly folded on the River
Seat 2: sebaaastian (button) folded before Flop (didn't bet)
Seat 5: keessie93 (small blind) folded before Flop
Seat 6: J0rmungund (big blind) collected ($11.56)
Seat 7: $-Twackle-$ folded before Flop (didn't bet)
Seat 8: hammerwife folded before Flop (didn't bet)
Seat 9: matiko09 folded before Flop (didn't bet)





PokerStars Hand #149395297373:  Hold'em No Limit ($0.50/$1.00 USD) - 2016/02/25 17:50:25 CET [2016/02/25 11:50:25 ET]
Table 'Badenia II' 9-max Seat #2 is the button
Seat 1: matiko09 ($100 in chips) 
Seat 2: $-Twackle-$ ($100 in chips) 
Seat 3: sebaaastian ($194.30 in chips) 
Seat 4: hammerwife ($106.49 in chips) 
Seat 5: Ilov3NBA ($100 in chips) 
Seat 6: Dachish ($70 in chips) 
Seat 8: McFussball81 ($44.72 in chips) 
Seat 9: waisanen ($240.95 in chips) 
sebaaastian: posts small blind $0.50
hammerwife: posts big blind $1
HomerrrJay: sits out 
*** HOLE CARDS ***
Dealt to matiko09 [Ts Ac]
Ilov3NBA: folds 
Dachish: folds 
McFussball81: folds 
waisanen: raises $3 to $4
matiko09: folds 
$-Twackle-$: folds 
sebaaastian: folds 
hammerwife: folds 
Uncalled bet ($3) returned to waisanen
waisanen collected $2.50 from pot
*** SUMMARY ***
Total pot $2.50 | Rake $0 
Seat 1: matiko09 folded before Flop (didn't bet)
Seat 2: $-Twackle-$ (button) folded before Flop (didn't bet)
Seat 3: sebaaastian (small blind) folded before Flop
Seat 4: hammerwife (big blind) folded before Flop
Seat 5: Ilov3NBA folded before Flop (didn't bet)
Seat 6: Dachish folded before Flop (didn't bet)
Seat 8: McFussball81 folded before Flop (didn't bet)
Seat 9: waisanen collected ($2.50)





PokerStars Hand #149395300123:  Hold'em No Limit (€0.25/€0.50 EUR) - 2016/02/25 17:50:28 CET [2016/02/25 11:50:28 ET]
Table 'Diadem IV' 9-max Seat #3 is the button
Seat 1: Ganador79 (€41.68 in chips) 
Seat 3: timbo_5563 (€20.29 in chips) 
Seat 4: Effort92 (€55.21 in chips) 
Seat 5: matiko09 (€53.45 in chips) 
Seat 6: Al3xAnd3r22 (€59.83 in chips) 
Seat 7: JustR82 (€71.87 in chips) 
Seat 8: Troll8989 (€53.94 in chips) 
Effort92: posts small blind €0.25
matiko09: posts big blind €0.50
*** HOLE CARDS ***
Dealt to matiko09 [8h Jc]
Al3xAnd3r22: folds 
JustR82: folds 
Troll8989: folds 
Ganador79: folds 
beluccix joins the table at seat #9 
timbo_5563: raises €0.50 to €1
Effort92: folds 
matiko09: folds 
Uncalled bet (€0.50) returned to timbo_5563
timbo_5563 collected €1.25 from pot
timbo_5563: doesn't show hand 
*** SUMMARY ***
Total pot €1.25 | Rake €0 
Seat 1: Ganador79 folded before Flop (didn't bet)
Seat 3: timbo_5563 (button) collected (€1.25)
Seat 4: Effort92 (small blind) folded before Flop
Seat 5: matiko09 (big blind) folded before Flop
Seat 6: Al3xAnd3r22 folded before Flop (didn't bet)
Seat 7: JustR82 folded before Flop (didn't bet)
Seat 8: Troll8989 folded before Flop (didn't bet)





PokerStars Hand #149395314204:  Hold'em No Limit ($0.50/$1.00 USD) - 2016/02/25 17:50:45 CET [2016/02/25 11:50:45 ET]
Table 'Mayall II' 9-max Seat #4 is the button
Seat 1: matiko09 ($122.94 in chips) 
Seat 3: simoniustin ($122.64 in chips) 
Seat 4: C. Duke 19 ($96.90 in chips) 
Seat 5: McFussball81 ($73.86 in chips) 
Seat 6: apfush ($100 in chips) 
Seat 7: r.pol218 ($41.28 in chips) 
Seat 8: kuanhung0903 ($78.87 in chips) 
Seat 9: xAndorx ($124.34 in chips) 
McFussball81: posts small blind $0.50
apfush: posts big blind $1
marrajon: sits out 
*** HOLE CARDS ***
Dealt to matiko09 [Tc Ks]
r.pol218: folds 
kuanhung0903: folds 
xAndorx: folds 
matiko09: folds 
simoniustin: folds 
C. Duke 19: folds 
McFussball81: folds 
Uncalled bet ($0.50) returned to apfush
apfush collected $1 from pot
apfush: doesn't show hand 
*** SUMMARY ***
Total pot $1 | Rake $0 
Seat 1: matiko09 folded before Flop (didn't bet)
Seat 3: simoniustin folded before Flop (didn't bet)
Seat 4: C. Duke 19 (button) folded before Flop (didn't bet)
Seat 5: McFussball81 (small blind) folded before Flop
Seat 6: apfush (big blind) collected ($1)
Seat 7: r.pol218 folded before Flop (didn't bet)
Seat 8: kuanhung0903 folded before Flop (didn't bet)
Seat 9: xAndorx folded before Flop (didn't bet)





PokerStars Hand #149395317304:  Hold'em No Limit ($0.50/$1.00 USD) - 2016/02/25 17:50:49 CET [2016/02/25 11:50:49 ET]
Table 'Nerthus II' 9-max Seat #2 is the button
Seat 2: matiko09 ($214.78 in chips) 
Seat 3: simoniustin ($111.46 in chips) 
Seat 6: mycka86 ($155.20 in chips) 
Seat 7: Venomous100% ($109.45 in chips) 
Seat 8: meischt94 ($53.04 in chips) 
Seat 9: hammerwife ($103 in chips) 
simoniustin: posts small blind $0.50
Ilov3NBA: is sitting out 
Sweden_Pound was removed from the table for failing to post
mycka86: posts big blind $1
*** HOLE CARDS ***
Dealt to matiko09 [Tc 6c]
Ilov3NBA leaves the table
$-Twackle-$ joins the table at seat #4 
Venomous100%: raises $2 to $3
meischt94: folds 
hammerwife: folds 
matiko09: folds 
simoniustin: folds 
mycka86: folds 
Uncalled bet ($2) returned to Venomous100%
Venomous100% collected $2.50 from pot
Venomous100%: doesn't show hand 
*** SUMMARY ***
Total pot $2.50 | Rake $0 
Seat 2: matiko09 (button) folded before Flop (didn't bet)
Seat 3: simoniustin (small blind) folded before Flop
Seat 6: mycka86 (big blind) folded before Flop
Seat 7: Venomous100% collected ($2.50)
Seat 8: meischt94 folded before Flop (didn't bet)
Seat 9: hammerwife folded before Flop (didn't bet)





PokerStars Hand #149395320794:  Hold'em No Limit (€0.25/€0.50 EUR) - 2016/02/25 17:50:53 CET [2016/02/25 11:50:53 ET]
Table 'Diadem IV' 9-max Seat #4 is the button
Seat 1: Ganador79 (€41.68 in chips) 
Seat 3: timbo_5563 (€21.04 in chips) 
Seat 4: Effort92 (€54.96 in chips) 
Seat 5: matiko09 (€52.95 in chips) 
Seat 6: Al3xAnd3r22 (€59.83 in chips) 
Seat 7: JustR82 (€71.87 in chips) 
Seat 8: Troll8989 (€53.94 in chips) 
matiko09: posts small blind €0.25
Al3xAnd3r22: posts big blind €0.50
beluccix: sits out 
*** HOLE CARDS ***
Dealt to matiko09 [9s Qs]
JustR82: folds 
Troll8989: folds 
Ganador79: folds 
timbo_5563: calls €0.50
Effort92: folds 
matiko09: calls €0.25
Al3xAnd3r22: checks 
*** FLOP *** [9d Kc Kd]
matiko09: bets €0.50
Al3xAnd3r22: folds 
timbo_5563: raises €0.50 to €1
matiko09: calls €0.50
*** TURN *** [9d Kc Kd] [2d]
matiko09: checks 
timbo_5563: bets €0.50
matiko09: calls €0.50
*** RIVER *** [9d Kc Kd 2d] [4d]
matiko09: checks 
timbo_5563: bets €0.50
matiko09: raises €3 to €3.50
timbo_5563: calls €3
*** SHOW DOWN ***
matiko09: shows [9s Qs] (two pair, Kings and Nines)
timbo_5563: mucks hand 
matiko09 collected €10.98 from pot
*** SUMMARY ***
Total pot €11.50 | Rake €0.52 
Board [9d Kc Kd 2d 4d]
Seat 1: Ganador79 folded before Flop (didn't bet)
Seat 3: timbo_5563 mucked [Ac 3h]
Seat 4: Effort92 (button) folded before Flop (didn't bet)
Seat 5: matiko09 (small blind) showed [9s Qs] and won (€10.98) with two pair, Kings and Nines
Seat 6: Al3xAnd3r22 (big blind) folded on the Flop
Seat 7: JustR82 folded before Flop (didn't bet)
Seat 8: Troll8989 folded before Flop (didn't bet)





PokerStars Hand #149395320518:  Hold'em No Limit ($0.50/$1.00 USD) - 2016/02/25 17:50:53 CET [2016/02/25 11:50:53 ET]
Table 'Badenia II' 9-max Seat #3 is the button
Seat 1: matiko09 ($100 in chips) 
Seat 2: $-Twackle-$ ($100 in chips) 
Seat 3: sebaaastian ($193.80 in chips) 
Seat 4: hammerwife ($105.49 in chips) 
Seat 6: Dachish ($70 in chips) 
Seat 8: McFussball81 ($44.72 in chips) 
Seat 9: waisanen ($242.45 in chips) 
hammerwife: posts small blind $0.50
Ilov3NBA: is sitting out 
Ilov3NBA leaves the table
Dachish: posts big blind $1
HomerrrJay: sits out 
*** HOLE CARDS ***
Dealt to matiko09 [Js 8d]
McFussball81: folds 
waisanen: folds 
matiko09: folds 
$-Twackle-$: folds 
sebaaastian: folds 
hammerwife: folds 
Uncalled bet ($0.50) returned to Dachish
Dachish collected $1 from pot
Dachish: doesn't show hand 
simoniustin joins the table at seat #5 
*** SUMMARY ***
Total pot $1 | Rake $0 
Seat 1: matiko09 folded before Flop (didn't bet)
Seat 2: $-Twackle-$ folded before Flop (didn't bet)
Seat 3: sebaaastian (button) folded before Flop (didn't bet)
Seat 4: hammerwife (small blind) folded before Flop
Seat 6: Dachish (big blind) collected ($1)
Seat 8: McFussball81 folded before Flop (didn't bet)
Seat 9: waisanen folded before Flop (didn't bet)





PokerStars Hand #149395327056:  Hold'em No Limit ($0.50/$1.00 USD) - 2016/02/25 17:51:01 CET [2016/02/25 11:51:01 ET]
Table 'Isa' 9-max Seat #6 is the button
Seat 1: matiko09 ($131.45 in chips) 
Seat 2: mycka86 ($156.81 in chips) 
Seat 3: sebaaastian ($150.30 in chips) 
Seat 4: hammerwife ($135.17 in chips) 
Seat 6: xAndorx ($101.50 in chips) 
Seat 7: bilukm ($62.36 in chips) 
Seat 8: Venomous100% ($108.24 in chips) 
Seat 9: volwebni4ek ($53.36 in chips) 
bilukm: posts small blind $0.50
Venomous100%: posts big blind $1
*** HOLE CARDS ***
Dealt to matiko09 [4c 8s]
volwebni4ek: raises $2 to $3
matiko09: folds 
mycka86: folds 
sebaaastian: folds 
hammerwife: folds 
xAndorx: folds 
bilukm: calls $2.50
Venomous100%: folds 
*** FLOP *** [7c Tc 8h]
bilukm: bets $3.34
volwebni4ek: raises $6.66 to $10
bilukm: calls $6.66
*** TURN *** [7c Tc 8h] [Ts]
bilukm: bets $1
volwebni4ek: calls $1
*** RIVER *** [7c Tc 8h Ts] [2c]
bilukm: checks 
volwebni4ek: checks 
*** SHOW DOWN ***
bilukm: shows [Jd Qs] (a pair of Tens)
volwebni4ek: shows [7d 8d] (two pair, Tens and Eights)
volwebni4ek collected $27.70 from pot
*** SUMMARY ***
Total pot $29 | Rake $1.30 
Board [7c Tc 8h Ts 2c]
Seat 1: matiko09 folded before Flop (didn't bet)
Seat 2: mycka86 folded before Flop (didn't bet)
Seat 3: sebaaastian folded before Flop (didn't bet)
Seat 4: hammerwife folded before Flop (didn't bet)
Seat 6: xAndorx (button) folded before Flop (didn't bet)
Seat 7: bilukm (small blind) showed [Jd Qs] and lost with a pair of Tens
Seat 8: Venomous100% (big blind) folded before Flop
Seat 9: volwebni4ek showed [7d 8d] and won ($27.70) with two pair, Tens and Eights





PokerStars Hand #149395329939:  Hold'em No Limit (€0.25/€0.50 EUR) - 2016/02/25 17:51:05 CET [2016/02/25 11:51:05 ET]
Table 'Prokne II' 9-max Seat #9 is the button
Seat 1: Al3xAnd3r22 (€61.45 in chips) 
Seat 2: payback11 (€50 in chips) 
Seat 3: JustR82 (€55.29 in chips) 
Seat 4: carlito cri (€36.88 in chips) 
Seat 5: Makitra (€52.24 in chips) 
Seat 6: matiko09 (€50 in chips) 
Seat 7: lysandrafly (€61.10 in chips) 
Seat 9: ihami (€54.35 in chips) 
Al3xAnd3r22: posts small blind €0.25
payback11: posts big blind €0.50
HomerrrJay: sits out 
*** HOLE CARDS ***
Dealt to matiko09 [9c 7h]
JustR82: folds 
carlito cri: raises €1 to €1.50
Makitra: folds 
matiko09: folds 
lysandrafly: folds 
ihami: folds 
Al3xAnd3r22: folds 
payback11: folds 
Uncalled bet (€1) returned to carlito cri
carlito cri collected €1.25 from pot
carlito cri: doesn't show hand 
*** SUMMARY ***
Total pot €1.25 | Rake €0 
Seat 1: Al3xAnd3r22 (small blind) folded before Flop
Seat 2: payback11 (big blind) folded before Flop
Seat 3: JustR82 folded before Flop (didn't bet)
Seat 4: carlito cri collected (€1.25)
Seat 5: Makitra folded before Flop (didn't bet)
Seat 6: matiko09 folded before Flop (didn't bet)
Seat 7: lysandrafly folded before Flop (didn't bet)
Seat 9: ihami (button) folded before Flop (didn't bet)





PokerStars Hand #149395335037:  Hold'em No Limit ($0.50/$1.00 USD) - 2016/02/25 17:51:11 CET [2016/02/25 11:51:11 ET]
Table 'Morosovia II' 9-max Seat #1 is the button
Seat 1: $-Twackle-$ ($100 in chips) 
Seat 2: Effort92 ($175.66 in chips) 
Seat 3: sebaaastian ($198.73 in chips) 
Seat 4: renechris ($187.42 in chips) 
Seat 5: gabi_igna ($158.27 in chips) 
Seat 6: Dachish ($67.50 in chips) 
Seat 7: matiko09 ($136.64 in chips) 
Seat 8: simoniustin ($114.59 in chips) 
Seat 9: lysandrafly ($116.94 in chips) 
Effort92: posts small blind $0.50
sebaaastian: posts big blind $1
*** HOLE CARDS ***
Dealt to matiko09 [As Kh]
renechris: folds 
gabi_igna: folds 
Dachish: raises $2 to $3
matiko09: calls $3
simoniustin: folds 
lysandrafly: folds 
$-Twackle-$: folds 
Effort92: folds 
sebaaastian: folds 
*** FLOP *** [6s Kd 6c]
Dachish: bets $4
matiko09: calls $4
*** TURN *** [6s Kd 6c] [Tc]
Dachish: bets $10
matiko09: calls $10
*** RIVER *** [6s Kd 6c Tc] [8d]
Dachish: bets $24.50
matiko09: folds 
Uncalled bet ($24.50) returned to Dachish
Dachish collected $33.90 from pot
Dachish: doesn't show hand 
*** SUMMARY ***
Total pot $35.50 | Rake $1.60 
Board [6s Kd 6c Tc 8d]
Seat 1: $-Twackle-$ (button) folded before Flop (didn't bet)
Seat 2: Effort92 (small blind) folded before Flop
Seat 3: sebaaastian (big blind) folded before Flop
Seat 4: renechris folded before Flop (didn't bet)
Seat 5: gabi_igna folded before Flop (didn't bet)
Seat 6: Dachish collected ($33.90)
Seat 7: matiko09 folded on the River
Seat 8: simoniustin folded before Flop (didn't bet)
Seat 9: lysandrafly folded before Flop (didn't bet)





PokerStars Hand #149395338344:  Hold'em No Limit ($0.50/$1.00 USD) - 2016/02/25 17:51:15 CET [2016/02/25 11:51:15 ET]
Table 'Nerthus II' 9-max Seat #3 is the button
Seat 2: matiko09 ($214.78 in chips) 
Seat 3: simoniustin ($110.96 in chips) 
Seat 6: mycka86 ($154.20 in chips) 
Seat 7: Venomous100% ($110.95 in chips) 
Seat 8: meischt94 ($53.04 in chips) 
Seat 9: hammerwife ($103 in chips) 
$-Twackle-$ will be allowed to play after the button
mycka86: posts small blind $0.50
Venomous100%: posts big blind $1
*** HOLE CARDS ***
Dealt to matiko09 [Tc 7d]
meischt94: folds 
hammerwife: folds 
matiko09: folds 
simoniustin: folds 
mycka86: raises $1.75 to $2.75
Venomous100%: calls $1.75
*** FLOP *** [7c Qc 5h]
mycka86: checks 
Venomous100%: bets $4
mycka86: calls $4
*** TURN *** [7c Qc 5h] [4s]
mycka86: checks 
Venomous100%: checks 
*** RIVER *** [7c Qc 5h 4s] [Ad]
mycka86: checks 
Venomous100%: checks 
*** SHOW DOWN ***
mycka86: shows [Kc 7h] (a pair of Sevens)
Venomous100%: mucks hand 
mycka86 collected $12.89 from pot
*** SUMMARY ***
Total pot $13.50 | Rake $0.61 
Board [7c Qc 5h 4s Ad]
Seat 2: matiko09 folded before Flop (didn't bet)
Seat 3: simoniustin (button) folded before Flop (didn't bet)
Seat 6: mycka86 (small blind) showed [Kc 7h] and won ($12.89) with a pair of Sevens
Seat 7: Venomous100% (big blind) mucked [9d Kh]
Seat 8: meischt94 folded before Flop (didn't bet)
Seat 9: hammerwife folded before Flop (didn't bet)





PokerStars Hand #149395338241:  Hold'em No Limit ($0.50/$1.00 USD) - 2016/02/25 17:51:15 CET [2016/02/25 11:51:15 ET]
Table 'Syrma II' 9-max Seat #2 is the button
Seat 1: Venomous100% ($104 in chips) 
Seat 2: $-Twackle-$ ($100 in chips) 
Seat 3: shayu 9988 ($78.12 in chips) 
Seat 4: volwebni4ek ($73.34 in chips) 
Seat 5: BIGWIN2016 ($87.30 in chips) 
Seat 6: matiko09 ($101.50 in chips) 
Seat 7: lysandrafly ($107.18 in chips) 
Seat 9: xAndorx ($100 in chips) 
shayu 9988: posts small blind $0.50
volwebni4ek: posts big blind $1
*** HOLE CARDS ***
Dealt to matiko09 [3s Th]
BIGWIN2016 has timed out while disconnected
BIGWIN2016: folds 
matiko09: folds 
lysandrafly: folds 
xAndorx: folds 
Venomous100%: folds 
$-Twackle-$: folds 
shayu 9988: folds 
Uncalled bet ($0.50) returned to volwebni4ek
volwebni4ek collected $1 from pot
volwebni4ek: doesn't show hand 
*** SUMMARY ***
Total pot $1 | Rake $0 
Seat 1: Venomous100% folded before Flop (didn't bet)
Seat 2: $-Twackle-$ (button) folded before Flop (didn't bet)
Seat 3: shayu 9988 (small blind) folded before Flop
Seat 4: volwebni4ek (big blind) collected ($1)
Seat 5: BIGWIN2016 folded before Flop (didn't bet)
Seat 6: matiko09 folded before Flop (didn't bet)
Seat 7: lysandrafly folded before Flop (didn't bet)
Seat 9: xAndorx folded before Flop (didn't bet)





PokerStars Hand #149395342939:  Hold'em No Limit ($0.50/$1.00 USD) - 2016/02/25 17:51:21 CET [2016/02/25 11:51:21 ET]
Table 'Fiducia II' 9-max Seat #6 is the button
Seat 1: Venomous100% ($103.34 in chips) 
Seat 2: brokat77 ($92.84 in chips) 
Seat 3: Oldemester ($105.47 in chips) 
Seat 4: matiko09 ($100 in chips) 
Seat 5: Dachish ($69.32 in chips) 
Seat 6: Yaaaazz ($136.96 in chips) 
Seat 8: simoniustin ($210.47 in chips) 
Seat 9: apfush ($100 in chips) 
simoniustin: posts small blind $0.50
apfush: posts big blind $1
*** HOLE CARDS ***
Dealt to matiko09 [3h Jh]
Venomous100%: raises $2 to $3
brokat77: folds 
Oldemester: folds 
matiko09: folds 
Dachish: folds 
Yaaaazz: folds 
simoniustin: folds 
apfush: folds 
Uncalled bet ($2) returned to Venomous100%
Venomous100% collected $2.50 from pot
Venomous100%: doesn't show hand 
*** SUMMARY ***
Total pot $2.50 | Rake $0 
Seat 1: Venomous100% collected ($2.50)
Seat 2: brokat77 folded before Flop (didn't bet)
Seat 3: Oldemester folded before Flop (didn't bet)
Seat 4: matiko09 folded before Flop (didn't bet)
Seat 5: Dachish folded before Flop (didn't bet)
Seat 6: Yaaaazz (button) folded before Flop (didn't bet)
Seat 8: simoniustin (small blind) folded before Flop
Seat 9: apfush (big blind) folded before Flop





PokerStars Hand #149395343402:  Hold'em No Limit ($0.25/$0.50 USD) - 2016/02/25 17:51:21 CET [2016/02/25 11:51:21 ET]
Table 'Vladimir' 9-max Seat #6 is the button
Seat 1: matiko09 ($50 in chips) 
Seat 2: Vedpapa ($52.09 in chips) 
Seat 3: Troll8989 ($50 in chips) 
Seat 4: ffac ($62.45 in chips) 
Seat 5: Al3xAnd3r22 ($57.46 in chips) 
Seat 6: dkafgankush ($15.25 in chips) 
Seat 7: myllow1 ($71.23 in chips) 
Seat 8: Effort92 ($50 in chips) 
myllow1: posts small blind $0.25
Effort92: posts big blind $0.50
AceFarky: sits out 
*** HOLE CARDS ***
Dealt to matiko09 [Jd 4c]
matiko09: folds 
Vedpapa: folds 
Troll8989: folds 
ffac: folds 
Al3xAnd3r22: raises $0.72 to $1.22
dkafgankush: folds 
myllow1: folds 
Effort92: folds 
Uncalled bet ($0.72) returned to Al3xAnd3r22
Al3xAnd3r22 collected $1.25 from pot
Al3xAnd3r22: doesn't show hand 
*** SUMMARY ***
Total pot $1.25 | Rake $0 
Seat 1: matiko09 folded before Flop (didn't bet)
Seat 2: Vedpapa folded before Flop (didn't bet)
Seat 3: Troll8989 folded before Flop (didn't bet)
Seat 4: ffac folded before Flop (didn't bet)
Seat 5: Al3xAnd3r22 collected ($1.25)
Seat 6: dkafgankush (button) folded before Flop (didn't bet)
Seat 7: myllow1 (small blind) folded before Flop
Seat 8: Effort92 (big blind) folded before Flop





PokerStars Hand #149395355539:  Hold'em No Limit ($0.50/$1.00 USD) - 2016/02/25 17:51:36 CET [2016/02/25 11:51:36 ET]
Table 'Mayall II' 9-max Seat #5 is the button
Seat 1: matiko09 ($122.94 in chips) 
Seat 3: simoniustin ($122.64 in chips) 
Seat 4: C. Duke 19 ($96.90 in chips) 
Seat 5: McFussball81 ($73.36 in chips) 
Seat 6: apfush ($100.50 in chips) 
Seat 7: r.pol218 ($41.28 in chips) 
Seat 8: kuanhung0903 ($78.87 in chips) 
Seat 9: xAndorx ($124.34 in chips) 
apfush: posts small blind $0.50
r.pol218: posts big blind $1
marrajon: sits out 
*** HOLE CARDS ***
Dealt to matiko09 [2h Ks]
kuanhung0903: calls $1
xAndorx: folds 
matiko09: folds 
simoniustin: folds 
C. Duke 19: folds 
McFussball81: folds 
apfush: calls $0.50
r.pol218: checks 
*** FLOP *** [Jd Th 4s]
apfush: checks 
r.pol218: checks 
kuanhung0903: checks 
*** TURN *** [Jd Th 4s] [7s]
apfush: checks 
r.pol218: bets $1
kuanhung0903: raises $1 to $2
apfush: folds 
r.pol218: calls $1
*** RIVER *** [Jd Th 4s 7s] [Ad]
r.pol218: folds 
kuanhung0903 collected $6.68 from pot
kuanhung0903: doesn't show hand 
*** SUMMARY ***
Total pot $7 | Rake $0.32 
Board [Jd Th 4s 7s Ad]
Seat 1: matiko09 folded before Flop (didn't bet)
Seat 3: simoniustin folded before Flop (didn't bet)
Seat 4: C. Duke 19 folded before Flop (didn't bet)
Seat 5: McFussball81 (button) folded before Flop (didn't bet)
Seat 6: apfush (small blind) folded on the Turn
Seat 7: r.pol218 (big blind) folded on the River
Seat 8: kuanhung0903 collected ($6.68)
Seat 9: xAndorx folded before Flop (didn't bet)





PokerStars Hand #149395359121:  Hold'em No Limit ($0.50/$1.00 USD) - 2016/02/25 17:51:40 CET [2016/02/25 11:51:40 ET]
Table 'Badenia II' 9-max Seat #4 is the button
Seat 1: matiko09 ($100 in chips) 
Seat 2: $-Twackle-$ ($100 in chips) 
Seat 3: sebaaastian ($193.80 in chips) 
Seat 4: hammerwife ($104.99 in chips) 
Seat 6: Dachish ($70.50 in chips) 
Seat 7: HomerrrJay ($100.50 in chips) 
Seat 8: McFussball81 ($44.72 in chips) 
Seat 9: waisanen ($242.45 in chips) 
simoniustin will be allowed to play after the button
Dachish: posts small blind $0.50
HomerrrJay: posts big blind $1
*** HOLE CARDS ***
Dealt to matiko09 [2s Qh]
McFussball81: folds 
waisanen: folds 
matiko09: folds 
$-Twackle-$: folds 
sebaaastian: folds 
hammerwife: folds 
Dachish: folds 
Uncalled bet ($0.50) returned to HomerrrJay
HomerrrJay collected $1 from pot
HomerrrJay: doesn't show hand 
*** SUMMARY ***
Total pot $1 | Rake $0 
Seat 1: matiko09 folded before Flop (didn't bet)
Seat 2: $-Twackle-$ folded before Flop (didn't bet)
Seat 3: sebaaastian folded before Flop (didn't bet)
Seat 4: hammerwife (button) folded before Flop (didn't bet)
Seat 6: Dachish (small blind) folded before Flop
Seat 7: HomerrrJay (big blind) collected ($1)
Seat 8: McFussball81 folded before Flop (didn't bet)
Seat 9: waisanen folded before Flop (didn't bet)





PokerStars Hand #149395367229:  Hold'em No Limit ($0.50/$1.00 USD) - 2016/02/25 17:51:50 CET [2016/02/25 11:51:50 ET]
Table 'Eurysaces II' 9-max Seat #5 is the button
Seat 1: lysandrafly ($100.28 in chips) 
Seat 2: sebaaastian ($203.98 in chips) 
Seat 5: keessie93 ($127.12 in chips) 
Seat 6: J0rmungund ($42.03 in chips) 
Seat 7: $-Twackle-$ ($104.50 in chips) 
Seat 8: hammerwife ($100 in chips) 
Seat 9: matiko09 ($100 in chips) 
J0rmungund: posts small blind $0.50
$-Twackle-$: posts big blind $1
ffac: sits out 
*** HOLE CARDS ***
Dealt to matiko09 [Js Ad]
hammerwife: folds 
matiko09: raises $2 to $3
lysandrafly: folds 
sebaaastian: folds 
keessie93: folds 
J0rmungund: folds 
$-Twackle-$: folds 
Uncalled bet ($2) returned to matiko09
matiko09 collected $2.50 from pot
matiko09: doesn't show hand 
*** SUMMARY ***
Total pot $2.50 | Rake $0 
Seat 1: lysandrafly folded before Flop (didn't bet)
Seat 2: sebaaastian folded before Flop (didn't bet)
Seat 5: keessie93 (button) folded before Flop (didn't bet)
Seat 6: J0rmungund (small blind) folded before Flop
Seat 7: $-Twackle-$ (big blind) folded before Flop
Seat 8: hammerwife folded before Flop (didn't bet)
Seat 9: matiko09 collected ($2.50)





PokerStars Hand #149395371423:  Hold'em No Limit (€0.25/€0.50 EUR) - 2016/02/25 17:51:55 CET [2016/02/25 11:51:55 ET]
Table 'Prokne II' 9-max Seat #1 is the button
Seat 1: Al3xAnd3r22 (€61.20 in chips) 
Seat 2: payback11 (€50 in chips) 
Seat 3: JustR82 (€55.29 in chips) 
Seat 4: carlito cri (€37.63 in chips) 
Seat 5: Makitra (€52.24 in chips) 
Seat 6: matiko09 (€50 in chips) 
Seat 7: lysandrafly (€61.10 in chips) 
Seat 9: ihami (€54.35 in chips) 
payback11: posts small blind €0.25
JustR82: posts big blind €0.50
HomerrrJay: sits out 
*** HOLE CARDS ***
Dealt to matiko09 [Js Jh]
carlito cri: calls €0.50
Makitra: folds 
matiko09: raises €1.50 to €2
lysandrafly: folds 
ihami: folds 
Al3xAnd3r22: calls €2
payback11: folds 
JustR82: folds 
carlito cri: calls €1.50
*** FLOP *** [Ac 3d Kd]
carlito cri: checks 
matiko09: checks 
Al3xAnd3r22: checks 
*** TURN *** [Ac 3d Kd] [8s]
carlito cri: checks 
matiko09: checks 
Al3xAnd3r22: checks 
*** RIVER *** [Ac 3d Kd 8s] [Kc]
carlito cri: bets €3.50
matiko09: folds 
Al3xAnd3r22: folds 
Uncalled bet (€3.50) returned to carlito cri
carlito cri collected €6.45 from pot
carlito cri: doesn't show hand 
*** SUMMARY ***
Total pot €6.75 | Rake €0.30 
Board [Ac 3d Kd 8s Kc]
Seat 1: Al3xAnd3r22 (button) folded on the River
Seat 2: payback11 (small blind) folded before Flop
Seat 3: JustR82 (big blind) folded before Flop
Seat 4: carlito cri collected (€6.45)
Seat 5: Makitra folded before Flop (didn't bet)
Seat 6: matiko09 folded on the River
Seat 7: lysandrafly folded before Flop (didn't bet)
Seat 9: ihami folded before Flop (didn't bet)





PokerStars Hand #149395377214:  Hold'em No Limit ($0.25/$0.50 USD) - 2016/02/25 17:52:02 CET [2016/02/25 11:52:02 ET]
Table 'Vladimir' 9-max Seat #7 is the button
Seat 1: matiko09 ($50 in chips) 
Seat 2: Vedpapa ($52.09 in chips) 
Seat 3: Troll8989 ($50 in chips) 
Seat 4: ffac ($62.45 in chips) 
Seat 5: Al3xAnd3r22 ($58.21 in chips) 
Seat 6: dkafgankush ($15.25 in chips) 
Seat 7: myllow1 ($70.98 in chips) 
Seat 8: Effort92 ($50 in chips) 
Seat 9: AceFarky ($50 in chips) 
Effort92: posts small blind $0.25
AceFarky: posts big blind $0.50
*** HOLE CARDS ***
Dealt to matiko09 [3h Js]
matiko09: folds 
Vedpapa: folds 
Troll8989: folds 
ffac: folds 
Al3xAnd3r22: folds 
dkafgankush: calls $0.50
myllow1: calls $0.50
Effort92: folds 
AceFarky: checks 
*** FLOP *** [7d Td 4c]
AceFarky: checks 
dkafgankush: bets $1.50
myllow1: calls $1.50
AceFarky: folds 
*** TURN *** [7d Td 4c] [6h]
dkafgankush: bets $3.50
myllow1: calls $3.50
*** RIVER *** [7d Td 4c 6h] [4h]
dkafgankush: bets $7.50
myllow1: calls $7.50
*** SHOW DOWN ***
dkafgankush: shows [As Ah] (two pair, Aces and Fours)
myllow1: mucks hand 
dkafgankush collected $25.55 from pot
*** SUMMARY ***
Total pot $26.75 | Rake $1.20 
Board [7d Td 4c 6h 4h]
Seat 1: matiko09 folded before Flop (didn't bet)
Seat 2: Vedpapa folded before Flop (didn't bet)
Seat 3: Troll8989 folded before Flop (didn't bet)
Seat 4: ffac folded before Flop (didn't bet)
Seat 5: Al3xAnd3r22 folded before Flop (didn't bet)
Seat 6: dkafgankush showed [As Ah] and won ($25.55) with two pair, Aces and Fours
Seat 7: myllow1 (button) mucked [Ts Jc]
Seat 8: Effort92 (small blind) folded before Flop
Seat 9: AceFarky (big blind) folded on the Flop





PokerStars Hand #149395377610:  Hold'em No Limit ($0.50/$1.00 USD) - 2016/02/25 17:52:03 CET [2016/02/25 11:52:03 ET]
Table 'Syrma II' 9-max Seat #3 is the button
Seat 1: Venomous100% ($104 in chips) 
Seat 2: $-Twackle-$ ($100 in chips) 
Seat 3: shayu 9988 ($77.62 in chips) 
Seat 4: volwebni4ek ($73.84 in chips) 
Seat 6: matiko09 ($101.50 in chips) 
Seat 7: lysandrafly ($107.18 in chips) 
Seat 9: xAndorx ($100 in chips) 
volwebni4ek: posts small blind $0.50
matiko09: posts big blind $1
*** HOLE CARDS ***
Dealt to matiko09 [3h 6d]
lysandrafly: folds 
xAndorx: folds 
Venomous100%: folds 
$-Twackle-$: folds 
shayu 9988: folds 
volwebni4ek: folds 
Uncalled bet ($0.50) returned to matiko09
matiko09 collected $1 from pot
matiko09: doesn't show hand 
*** SUMMARY ***
Total pot $1 | Rake $0 
Seat 1: Venomous100% folded before Flop (didn't bet)
Seat 2: $-Twackle-$ folded before Flop (didn't bet)
Seat 3: shayu 9988 (button) folded before Flop (didn't bet)
Seat 4: volwebni4ek (small blind) folded before Flop
Seat 6: matiko09 (big blind) collected ($1)
Seat 7: lysandrafly folded before Flop (didn't bet)
Seat 9: xAndorx folded before Flop (didn't bet)





PokerStars Hand #149395382510:  Hold'em No Limit ($0.50/$1.00 USD) - 2016/02/25 17:52:09 CET [2016/02/25 11:52:09 ET]
Table 'Fiducia II' 9-max Seat #8 is the button
Seat 1: Venomous100% ($104.84 in chips) 
Seat 2: brokat77 ($92.84 in chips) 
Seat 3: Oldemester ($105.47 in chips) 
Seat 4: matiko09 ($100 in chips) 
Seat 5: Dachish ($69.32 in chips) 
Seat 6: Yaaaazz ($136.96 in chips) 
Seat 8: simoniustin ($209.97 in chips) 
Seat 9: apfush ($100 in chips) 
apfush: posts small blind $0.50
Venomous100%: posts big blind $1
*** HOLE CARDS ***
Dealt to matiko09 [9h Th]
brokat77: calls $1
Oldemester: folds 
matiko09: raises $3 to $4
Dachish: folds 
Yaaaazz: folds 
simoniustin: folds 
apfush: raises $9 to $13
Venomous100%: folds 
brokat77: folds 
matiko09: folds 
Uncalled bet ($9) returned to apfush
apfush collected $10 from pot
apfush: doesn't show hand 
*** SUMMARY ***
Total pot $10 | Rake $0 
Seat 1: Venomous100% (big blind) folded before Flop
Seat 2: brokat77 folded before Flop
Seat 3: Oldemester folded before Flop (didn't bet)
Seat 4: matiko09 folded before Flop
Seat 5: Dachish folded before Flop (didn't bet)
Seat 6: Yaaaazz folded before Flop (didn't bet)
Seat 8: simoniustin (button) folded before Flop (didn't bet)
Seat 9: apfush (small blind) collected ($10)





PokerStars Hand #149395383021:  Hold'em No Limit ($0.50/$1.00 USD) - 2016/02/25 17:52:09 CET [2016/02/25 11:52:09 ET]
Table 'Badenia II' 9-max Seat #6 is the button
Seat 1: matiko09 ($100 in chips) 
Seat 2: $-Twackle-$ ($100 in chips) 
Seat 3: sebaaastian ($193.80 in chips) 
Seat 4: hammerwife ($104.99 in chips) 
Seat 6: Dachish ($70 in chips) 
Seat 7: HomerrrJay ($101 in chips) 
Seat 8: McFussball81 ($44.72 in chips) 
Seat 9: waisanen ($242.45 in chips) 
HomerrrJay: posts small blind $0.50
McFussball81: posts big blind $1
simoniustin: sits out 
*** HOLE CARDS ***
Dealt to matiko09 [8d 7c]
waisanen: folds 
matiko09: folds 
$-Twackle-$: folds 
sebaaastian: folds 
hammerwife: folds 
Dachish: folds 
HomerrrJay: raises $1.50 to $2.50
McFussball81: folds 
Uncalled bet ($1.50) returned to HomerrrJay
HomerrrJay collected $2 from pot
HomerrrJay: doesn't show hand 
*** SUMMARY ***
Total pot $2 | Rake $0 
Seat 1: matiko09 folded before Flop (didn't bet)
Seat 2: $-Twackle-$ folded before Flop (didn't bet)
Seat 3: sebaaastian folded before Flop (didn't bet)
Seat 4: hammerwife folded before Flop (didn't bet)
Seat 6: Dachish (button) folded before Flop (didn't bet)
Seat 7: HomerrrJay (small blind) collected ($2)
Seat 8: McFussball81 (big blind) folded before Flop
Seat 9: waisanen folded before Flop (didn't bet)





PokerStars Hand #149395393436:  Hold'em No Limit (€0.25/€0.50 EUR) - 2016/02/25 17:52:22 CET [2016/02/25 11:52:22 ET]
Table 'Diadem IV' 9-max Seat #5 is the button
Seat 1: Ganador79 (€41.68 in chips) 
Seat 3: timbo_5563 (€15.54 in chips) 
Seat 4: Effort92 (€54.96 in chips) 
Seat 5: matiko09 (€58.43 in chips) 
Seat 6: Al3xAnd3r22 (€59.33 in chips) 
Seat 7: JustR82 (€71.87 in chips) 
Seat 8: Troll8989 (€53.94 in chips) 
Al3xAnd3r22: posts small blind €0.25
JustR82: posts big blind €0.50
beluccix: sits out 
*** HOLE CARDS ***
Dealt to matiko09 [8d Qd]
Troll8989: folds 
Ganador79: folds 
timbo_5563: folds 
Effort92: folds 
matiko09: raises €0.63 to €1.13
Al3xAnd3r22: folds 
JustR82: folds 
Uncalled bet (€0.63) returned to matiko09
matiko09 collected €1.25 from pot
matiko09: doesn't show hand 
*** SUMMARY ***
Total pot €1.25 | Rake €0 
Seat 1: Ganador79 folded before Flop (didn't bet)
Seat 3: timbo_5563 folded before Flop (didn't bet)
Seat 4: Effort92 folded before Flop (didn't bet)
Seat 5: matiko09 (button) collected (€1.25)
Seat 6: Al3xAnd3r22 (small blind) folded before Flop
Seat 7: JustR82 (big blind) folded before Flop
Seat 8: Troll8989 folded before Flop (didn't bet)





PokerStars Hand #149395402534:  Hold'em No Limit ($0.50/$1.00 USD) - 2016/02/25 17:52:33 CET [2016/02/25 11:52:33 ET]
Table 'Nerthus II' 9-max Seat #6 is the button
Seat 2: matiko09 ($214.78 in chips) 
Seat 3: simoniustin ($110.96 in chips) 
Seat 6: mycka86 ($160.34 in chips) 
Seat 7: Venomous100% ($104.20 in chips) 
Seat 8: meischt94 ($53.04 in chips) 
Seat 9: hammerwife ($103 in chips) 
Venomous100%: posts small blind $0.50
meischt94: posts big blind $1
$-Twackle-$: sits out 
*** HOLE CARDS ***
Dealt to matiko09 [8d Kh]
hammerwife: folds 
matiko09: folds 
simoniustin: folds 
mycka86: folds 
Venomous100%: folds 
Uncalled bet ($0.50) returned to meischt94
meischt94 collected $1 from pot
meischt94: doesn't show hand 
*** SUMMARY ***
Total pot $1 | Rake $0 
Seat 2: matiko09 folded before Flop (didn't bet)
Seat 3: simoniustin folded before Flop (didn't bet)
Seat 6: mycka86 (button) folded before Flop (didn't bet)
Seat 7: Venomous100% (small blind) folded before Flop
Seat 8: meischt94 (big blind) collected ($1)
Seat 9: hammerwife folded before Flop (didn't bet)





PokerStars Hand #149395404838:  Hold'em No Limit ($0.50/$1.00 USD) - 2016/02/25 17:52:36 CET [2016/02/25 11:52:36 ET]
Table 'Eurysaces II' 9-max Seat #6 is the button
Seat 1: lysandrafly ($100.28 in chips) 
Seat 2: sebaaastian ($203.98 in chips) 
Seat 5: keessie93 ($127.12 in chips) 
Seat 6: J0rmungund ($41.53 in chips) 
Seat 7: $-Twackle-$ ($103.50 in chips) 
Seat 8: hammerwife ($100 in chips) 
Seat 9: matiko09 ($101.50 in chips) 
$-Twackle-$: posts small blind $0.50
hammerwife: posts big blind $1
ffac: sits out 
*** HOLE CARDS ***
Dealt to matiko09 [Qc Ah]
matiko09: raises $2 to $3
lysandrafly: folds 
sebaaastian: folds 
keessie93: folds 
J0rmungund: folds 
$-Twackle-$: folds 
hammerwife: folds 
Uncalled bet ($2) returned to matiko09
matiko09 collected $2.50 from pot
matiko09: doesn't show hand 
*** SUMMARY ***
Total pot $2.50 | Rake $0 
Seat 1: lysandrafly folded before Flop (didn't bet)
Seat 2: sebaaastian folded before Flop (didn't bet)
Seat 5: keessie93 folded before Flop (didn't bet)
Seat 6: J0rmungund (button) folded before Flop (didn't bet)
Seat 7: $-Twackle-$ (small blind) folded before Flop
Seat 8: hammerwife (big blind) folded before Flop
Seat 9: matiko09 collected ($2.50)





PokerStars Hand #149395405469:  Hold'em No Limit ($0.50/$1.00 USD) - 2016/02/25 17:52:37 CET [2016/02/25 11:52:37 ET]
Table 'Syrma II' 9-max Seat #4 is the button
Seat 1: Venomous100% ($104 in chips) 
Seat 2: $-Twackle-$ ($100 in chips) 
Seat 3: shayu 9988 ($77.62 in chips) 
Seat 4: volwebni4ek ($73.34 in chips) 
Seat 6: matiko09 ($102 in chips) 
Seat 7: lysandrafly ($107.18 in chips) 
Seat 9: xAndorx ($100 in chips) 
matiko09: posts small blind $0.50
lysandrafly: posts big blind $1
*** HOLE CARDS ***
Dealt to matiko09 [7h As]
xAndorx: folds 
Venomous100%: folds 
$-Twackle-$: folds 
shayu 9988: folds 
volwebni4ek: raises $1 to $2
matiko09: folds 
lysandrafly: calls $1
*** FLOP *** [7d Qs 6s]
lysandrafly: checks 
volwebni4ek: bets $2.50
BIGWIN2016 is disconnected 
lysandrafly: folds 
Uncalled bet ($2.50) returned to volwebni4ek
volwebni4ek collected $4.30 from pot
volwebni4ek: doesn't show hand 
*** SUMMARY ***
Total pot $4.50 | Rake $0.20 
Board [7d Qs 6s]
Seat 1: Venomous100% folded before Flop (didn't bet)
Seat 2: $-Twackle-$ folded before Flop (didn't bet)
Seat 3: shayu 9988 folded before Flop (didn't bet)
Seat 4: volwebni4ek (button) collected ($4.30)
Seat 6: matiko09 (small blind) folded before Flop
Seat 7: lysandrafly (big blind) folded on the Flop
Seat 9: xAndorx folded before Flop (didn't bet)





PokerStars Hand #149395410622:  Hold'em No Limit ($0.50/$1.00 USD) - 2016/02/25 17:52:43 CET [2016/02/25 11:52:43 ET]
Table 'Fiducia II' 9-max Seat #9 is the button
Seat 1: Venomous100% ($103.84 in chips) 
Seat 2: brokat77 ($91.84 in chips) 
Seat 3: Oldemester ($105.47 in chips) 
Seat 4: matiko09 ($100 in chips) 
Seat 5: Dachish ($69.32 in chips) 
Seat 6: Yaaaazz ($136.96 in chips) 
Seat 8: simoniustin ($209.97 in chips) 
Seat 9: apfush ($106 in chips) 
Venomous100%: posts small blind $0.50
brokat77: posts big blind $1
*** HOLE CARDS ***
Dealt to matiko09 [3s 3h]
Oldemester: folds 
matiko09: raises $2 to $3
Dachish: folds 
Yaaaazz: raises $6 to $9
simoniustin: folds 
apfush: folds 
Venomous100%: folds 
brokat77: folds 
matiko09: folds 
Uncalled bet ($6) returned to Yaaaazz
Yaaaazz collected $7.50 from pot
*** SUMMARY ***
Total pot $7.50 | Rake $0 
Seat 1: Venomous100% (small blind) folded before Flop
Seat 2: brokat77 (big blind) folded before Flop
Seat 3: Oldemester folded before Flop (didn't bet)
Seat 4: matiko09 folded before Flop
Seat 5: Dachish folded before Flop (didn't bet)
Seat 6: Yaaaazz collected ($7.50)
Seat 8: simoniustin folded before Flop (didn't bet)
Seat 9: apfush (button) folded before Flop (didn't bet)





PokerStars Hand #149395410955:  Hold'em No Limit ($0.50/$1.00 USD) - 2016/02/25 17:52:43 CET [2016/02/25 11:52:43 ET]
Table 'Isa' 9-max Seat #7 is the button
Seat 1: matiko09 ($131.45 in chips) 
Seat 2: mycka86 ($156.81 in chips) 
Seat 3: sebaaastian ($150.30 in chips) 
Seat 4: hammerwife ($135.17 in chips) 
Seat 6: xAndorx ($101.50 in chips) 
Seat 7: bilukm ($48.36 in chips) 
Seat 8: Venomous100% ($107.24 in chips) 
Seat 9: volwebni4ek ($67.06 in chips) 
Venomous100%: posts small blind $0.50
volwebni4ek: posts big blind $1
*** HOLE CARDS ***
Dealt to matiko09 [3c Ac]
matiko09: folds 
mycka86: folds 
sebaaastian: raises $2 to $3
hammerwife: folds 
xAndorx: folds 
bilukm: calls $3
Venomous100%: folds 
volwebni4ek: calls $2
*** FLOP *** [9s Kd 6d]
volwebni4ek: bets $7
sebaaastian: folds 
bilukm: folds 
Uncalled bet ($7) returned to volwebni4ek
volwebni4ek collected $9.07 from pot
volwebni4ek: doesn't show hand 
*** SUMMARY ***
Total pot $9.50 | Rake $0.43 
Board [9s Kd 6d]
Seat 1: matiko09 folded before Flop (didn't bet)
Seat 2: mycka86 folded before Flop (didn't bet)
Seat 3: sebaaastian folded on the Flop
Seat 4: hammerwife folded before Flop (didn't bet)
Seat 6: xAndorx folded before Flop (didn't bet)
Seat 7: bilukm (button) folded on the Flop
Seat 8: Venomous100% (small blind) folded before Flop
Seat 9: volwebni4ek (big blind) collected ($9.07)





PokerStars Hand #149395412189:  Hold'em No Limit (€0.25/€0.50 EUR) - 2016/02/25 17:52:45 CET [2016/02/25 11:52:45 ET]
Table 'Diadem IV' 9-max Seat #6 is the button
Seat 1: Ganador79 (€41.68 in chips) 
Seat 3: timbo_5563 (€15.54 in chips) 
Seat 4: Effort92 (€54.96 in chips) 
Seat 5: matiko09 (€59.18 in chips) 
Seat 6: Al3xAnd3r22 (€59.08 in chips) 
Seat 7: JustR82 (€71.37 in chips) 
Seat 8: Troll8989 (€53.94 in chips) 
JustR82: posts small blind €0.25
Troll8989: posts big blind €0.50
beluccix: sits out 
*** HOLE CARDS ***
Dealt to matiko09 [9h Th]
Ganador79: folds 
timbo_5563: calls €0.50
Effort92: folds 
matiko09: raises €1.50 to €2
Al3xAnd3r22: folds 
JustR82: folds 
Troll8989: calls €1.50
timbo_5563: calls €1.50
*** FLOP *** [7c Ac Qs]
Troll8989: checks 
timbo_5563: bets €0.50
matiko09: folds 
Troll8989: folds 
Uncalled bet (€0.50) returned to timbo_5563
timbo_5563 collected €5.97 from pot
timbo_5563: doesn't show hand 
*** SUMMARY ***
Total pot €6.25 | Rake €0.28 
Board [7c Ac Qs]
Seat 1: Ganador79 folded before Flop (didn't bet)
Seat 3: timbo_5563 collected (€5.97)
Seat 4: Effort92 folded before Flop (didn't bet)
Seat 5: matiko09 folded on the Flop
Seat 6: Al3xAnd3r22 (button) folded before Flop (didn't bet)
Seat 7: JustR82 (small blind) folded before Flop
Seat 8: Troll8989 (big blind) folded on the Flop





PokerStars Hand #149395413663:  Hold'em No Limit ($0.50/$1.00 USD) - 2016/02/25 17:52:46 CET [2016/02/25 11:52:46 ET]
Table 'Badenia II' 9-max Seat #7 is the button
Seat 1: matiko09 ($100 in chips) 
Seat 2: $-Twackle-$ ($100 in chips) 
Seat 3: sebaaastian ($193.80 in chips) 
Seat 4: hammerwife ($104.99 in chips) 
Seat 6: Dachish ($70 in chips) 
Seat 7: HomerrrJay ($102 in chips) 
Seat 8: McFussball81 ($43.72 in chips) 
Seat 9: waisanen ($242.45 in chips) 
McFussball81: posts small blind $0.50
waisanen: posts big blind $1
simoniustin: sits out 
*** HOLE CARDS ***
Dealt to matiko09 [8s 2d]
matiko09: folds 
$-Twackle-$: folds 
sebaaastian: folds 
hammerwife: folds 
Dachish: folds 
HomerrrJay: raises $1.50 to $2.50
McFussball81: calls $2
waisanen: calls $1.50
*** FLOP *** [3s Qd Kc]
McFussball81: checks 
waisanen: checks 
HomerrrJay: bets $3.58
McFussball81: folds 
waisanen: folds 
Uncalled bet ($3.58) returned to HomerrrJay
HomerrrJay collected $7.16 from pot
HomerrrJay: doesn't show hand 
*** SUMMARY ***
Total pot $7.50 | Rake $0.34 
Board [3s Qd Kc]
Seat 1: matiko09 folded before Flop (didn't bet)
Seat 2: $-Twackle-$ folded before Flop (didn't bet)
Seat 3: sebaaastian folded before Flop (didn't bet)
Seat 4: hammerwife folded before Flop (didn't bet)
Seat 6: Dachish folded before Flop (didn't bet)
Seat 7: HomerrrJay (button) collected ($7.16)
Seat 8: McFussball81 (small blind) folded on the Flop
Seat 9: waisanen (big blind) folded on the Flop





PokerStars Hand #149395422355:  Hold'em No Limit ($0.50/$1.00 USD) - 2016/02/25 17:52:57 CET [2016/02/25 11:52:57 ET]
Table 'Nerthus II' 9-max Seat #7 is the button
Seat 2: matiko09 ($214.78 in chips) 
Seat 3: simoniustin ($110.96 in chips) 
Seat 6: mycka86 ($160.34 in chips) 
Seat 7: Venomous100% ($103.70 in chips) 
Seat 8: meischt94 ($53.54 in chips) 
Seat 9: hammerwife ($103 in chips) 
meischt94: posts small blind $0.50
hammerwife: posts big blind $1
$-Twackle-$: sits out 
*** HOLE CARDS ***
Dealt to matiko09 [2d 5h]
matiko09: folds 
simoniustin: folds 
mycka86: folds 
Venomous100%: folds 
meischt94: raises $1 to $2
hammerwife: folds 
Uncalled bet ($1) returned to meischt94
meischt94 collected $2 from pot
meischt94: doesn't show hand 
*** SUMMARY ***
Total pot $2 | Rake $0 
Seat 2: matiko09 folded before Flop (didn't bet)
Seat 3: simoniustin folded before Flop (didn't bet)
Seat 6: mycka86 folded before Flop (didn't bet)
Seat 7: Venomous100% (button) folded before Flop (didn't bet)
Seat 8: meischt94 (small blind) collected ($2)
Seat 9: hammerwife (big blind) folded before Flop





PokerStars Hand #149395432494:  Hold'em No Limit ($0.50/$1.00 USD) - 2016/02/25 17:53:09 CET [2016/02/25 11:53:09 ET]
Table 'Mayall II' 9-max Seat #6 is the button
Seat 1: matiko09 ($122.94 in chips) 
Seat 3: simoniustin ($122.64 in chips) 
Seat 4: C. Duke 19 ($96.90 in chips) 
Seat 5: McFussball81 ($73.36 in chips) 
Seat 6: apfush ($100 in chips) 
Seat 7: r.pol218 ($38.28 in chips) 
Seat 8: kuanhung0903 ($82.55 in chips) 
Seat 9: xAndorx ($124.34 in chips) 
r.pol218: posts small blind $0.50
kuanhung0903: posts big blind $1
marrajon: sits out 
*** HOLE CARDS ***
Dealt to matiko09 [3s 6d]
xAndorx: folds 
matiko09: folds 
simoniustin: folds 
C. Duke 19: raises $2 to $3
marrajon leaves the table
McFussball81: folds 
apfush: folds 
PacPacBum joins the table at seat #2 
r.pol218: folds 
kuanhung0903: folds 
Uncalled bet ($2) returned to C. Duke 19
C. Duke 19 collected $2.50 from pot
C. Duke 19: doesn't show hand 
*** SUMMARY ***
Total pot $2.50 | Rake $0 
Seat 1: matiko09 folded before Flop (didn't bet)
Seat 3: simoniustin folded before Flop (didn't bet)
Seat 4: C. Duke 19 collected ($2.50)
Seat 5: McFussball81 folded before Flop (didn't bet)
Seat 6: apfush (button) folded before Flop (didn't bet)
Seat 7: r.pol218 (small blind) folded before Flop
Seat 8: kuanhung0903 (big blind) folded before Flop
Seat 9: xAndorx folded before Flop (didn't bet)





PokerStars Hand #149395437952:  Hold'em No Limit ($0.50/$1.00 USD) - 2016/02/25 17:53:16 CET [2016/02/25 11:53:16 ET]
Table 'Nerthus II' 9-max Seat #8 is the button
Seat 2: matiko09 ($214.78 in chips) 
Seat 3: simoniustin ($110.96 in chips) 
Seat 6: mycka86 ($160.34 in chips) 
Seat 7: Venomous100% ($103.70 in chips) 
Seat 8: meischt94 ($54.54 in chips) 
Seat 9: hammerwife ($102 in chips) 
hammerwife: posts small blind $0.50
matiko09: posts big blind $1
$-Twackle-$: sits out 
*** HOLE CARDS ***
Dealt to matiko09 [6d 2c]
simoniustin: folds 
mycka86: raises $1.50 to $2.50
Venomous100%: folds 
meischt94: folds 
hammerwife: folds 
matiko09: folds 
Uncalled bet ($1.50) returned to mycka86
mycka86 collected $2.50 from pot
*** SUMMARY ***
Total pot $2.50 | Rake $0 
Seat 2: matiko09 (big blind) folded before Flop
Seat 3: simoniustin folded before Flop (didn't bet)
Seat 6: mycka86 collected ($2.50)
Seat 7: Venomous100% folded before Flop (didn't bet)
Seat 8: meischt94 (button) folded before Flop (didn't bet)
Seat 9: hammerwife (small blind) folded before Flop





PokerStars Hand #149395439850:  Hold'em No Limit ($0.50/$1.00 USD) - 2016/02/25 17:53:18 CET [2016/02/25 11:53:18 ET]
Table 'Eurysaces II' 9-max Seat #7 is the button
Seat 1: lysandrafly ($100.28 in chips) 
Seat 2: sebaaastian ($203.98 in chips) 
Seat 5: keessie93 ($127.12 in chips) 
Seat 6: J0rmungund ($41.53 in chips) 
Seat 7: $-Twackle-$ ($103 in chips) 
Seat 8: hammerwife ($100 in chips) 
Seat 9: matiko09 ($103 in chips) 
hammerwife: posts small blind $0.50
matiko09: posts big blind $1
ffac: sits out 
*** HOLE CARDS ***
Dealt to matiko09 [6d 8d]
lysandrafly: folds 
sebaaastian: raises $2 to $3
keessie93: folds 
J0rmungund: calls $3
$-Twackle-$: folds 
hammerwife: folds 
matiko09: folds 
*** FLOP *** [7s Tc 6c]
sebaaastian: checks 
J0rmungund: checks 
*** TURN *** [7s Tc 6c] [4h]
sebaaastian: checks 
J0rmungund: checks 
*** RIVER *** [7s Tc 6c 4h] [Th]
sebaaastian: bets $3.58
J0rmungund: calls $3.58
*** SHOW DOWN ***
sebaaastian: shows [9d 9s] (two pair, Tens and Nines)
J0rmungund: mucks hand 
sebaaastian collected $14 from pot
*** SUMMARY ***
Total pot $14.66 | Rake $0.66 
Board [7s Tc 6c 4h Th]
Seat 1: lysandrafly folded before Flop (didn't bet)
Seat 2: sebaaastian showed [9d 9s] and won ($14) with two pair, Tens and Nines
Seat 5: keessie93 folded before Flop (didn't bet)
Seat 6: J0rmungund mucked [4c Ah]
Seat 7: $-Twackle-$ (button) folded before Flop (didn't bet)
Seat 8: hammerwife (small blind) folded before Flop
Seat 9: matiko09 (big blind) folded before Flop





PokerStars Hand #149395443200:  Hold'em No Limit ($0.25/$0.50 USD) - 2016/02/25 17:53:22 CET [2016/02/25 11:53:22 ET]
Table 'Vladimir' 9-max Seat #8 is the button
Seat 1: matiko09 ($50 in chips) 
Seat 2: Vedpapa ($52.09 in chips) 
Seat 3: Troll8989 ($50 in chips) 
Seat 4: ffac ($62.45 in chips) 
Seat 5: Al3xAnd3r22 ($58.21 in chips) 
Seat 6: dkafgankush ($27.80 in chips) 
Seat 7: myllow1 ($57.98 in chips) 
Seat 8: Effort92 ($50 in chips) 
Seat 9: AceFarky ($50 in chips) 
AceFarky: posts small blind $0.25
matiko09: posts big blind $0.50
*** HOLE CARDS ***
Dealt to matiko09 [3d Qh]
Vedpapa: folds 
Troll8989: folds 
ffac: folds 
Al3xAnd3r22: folds 
dkafgankush: calls $0.50
myllow1: folds 
myllow1 leaves the table
Effort92: folds 
AceFarky: folds 
v4n0v joins the table at seat #7 
matiko09: checks 
*** FLOP *** [8c Ad Td]
matiko09: checks 
dkafgankush: bets $2.50
matiko09: folds 
Uncalled bet ($2.50) returned to dkafgankush
dkafgankush collected $1.19 from pot
dkafgankush: doesn't show hand 
*** SUMMARY ***
Total pot $1.25 | Rake $0.06 
Board [8c Ad Td]
Seat 1: matiko09 (big blind) folded on the Flop
Seat 2: Vedpapa folded before Flop (didn't bet)
Seat 3: Troll8989 folded before Flop (didn't bet)
Seat 4: ffac folded before Flop (didn't bet)
Seat 5: Al3xAnd3r22 folded before Flop (didn't bet)
Seat 6: dkafgankush collected ($1.19)
Seat 7: myllow1 folded before Flop (didn't bet)
Seat 8: Effort92 (button) folded before Flop (didn't bet)
Seat 9: AceFarky (small blind) folded before Flop





PokerStars Hand #149395444007:  Hold'em No Limit ($0.50/$1.00 USD) - 2016/02/25 17:53:23 CET [2016/02/25 11:53:23 ET]
Table 'Morosovia II' 9-max Seat #2 is the button
Seat 1: $-Twackle-$ ($100 in chips) 
Seat 2: Effort92 ($175.16 in chips) 
Seat 3: sebaaastian ($197.73 in chips) 
Seat 4: renechris ($187.42 in chips) 
Seat 5: gabi_igna ($158.27 in chips) 
Seat 6: Dachish ($84.40 in chips) 
Seat 7: matiko09 ($119.64 in chips) 
Seat 8: simoniustin ($114.59 in chips) 
Seat 9: lysandrafly ($116.94 in chips) 
sebaaastian: posts small blind $0.50
renechris: posts big blind $1
*** HOLE CARDS ***
Dealt to matiko09 [Js 5c]
gabi_igna: folds 
Dachish: folds 
matiko09: folds 
simoniustin: raises $2 to $3
lysandrafly: folds 
$-Twackle-$: folds 
Effort92: folds 
sebaaastian: folds 
renechris: calls $2
*** FLOP *** [Qh 2h 8h]
renechris: checks 
simoniustin: bets $4
renechris: folds 
Uncalled bet ($4) returned to simoniustin
simoniustin collected $6.21 from pot
simoniustin: doesn't show hand 
*** SUMMARY ***
Total pot $6.50 | Rake $0.29 
Board [Qh 2h 8h]
Seat 1: $-Twackle-$ folded before Flop (didn't bet)
Seat 2: Effort92 (button) folded before Flop (didn't bet)
Seat 3: sebaaastian (small blind) folded before Flop
Seat 4: renechris (big blind) folded on the Flop
Seat 5: gabi_igna folded before Flop (didn't bet)
Seat 6: Dachish folded before Flop (didn't bet)
Seat 7: matiko09 folded before Flop (didn't bet)
Seat 8: simoniustin collected ($6.21)
Seat 9: lysandrafly folded before Flop (didn't bet)





PokerStars Hand #149395446457:  Hold'em No Limit (€0.25/€0.50 EUR) - 2016/02/25 17:53:26 CET [2016/02/25 11:53:26 ET]
Table 'Prokne II' 9-max Seat #2 is the button
Seat 1: Al3xAnd3r22 (€59.20 in chips) 
Seat 2: payback11 (€50 in chips) 
Seat 3: JustR82 (€54.79 in chips) 
Seat 4: carlito cri (€42.08 in chips) 
Seat 5: Makitra (€52.24 in chips) 
Seat 6: matiko09 (€50 in chips) 
Seat 7: lysandrafly (€61.10 in chips) 
Seat 9: ihami (€54.35 in chips) 
JustR82: posts small blind €0.25
carlito cri: posts big blind €0.50
HomerrrJay: sits out 
*** HOLE CARDS ***
Dealt to matiko09 [6d Qc]
Makitra: folds 
matiko09: folds 
lysandrafly: folds 
ihami: folds 
Al3xAnd3r22: folds 
payback11: folds 
JustR82: folds 
Uncalled bet (€0.25) returned to carlito cri
carlito cri collected €0.50 from pot
carlito cri: doesn't show hand 
*** SUMMARY ***
Total pot €0.50 | Rake €0 
Seat 1: Al3xAnd3r22 folded before Flop (didn't bet)
Seat 2: payback11 (button) folded before Flop (didn't bet)
Seat 3: JustR82 (small blind) folded before Flop
Seat 4: carlito cri (big blind) collected (€0.50)
Seat 5: Makitra folded before Flop (didn't bet)
Seat 6: matiko09 folded before Flop (didn't bet)
Seat 7: lysandrafly folded before Flop (didn't bet)
Seat 9: ihami folded before Flop (didn't bet)





