PokerStars Hand #155379318110:  Hold'em No Limit ($0.50/$1.00 USD) - 2016/06/30 13:22:09 CET [2016/06/30 7:22:09 ET]
Table 'Armisticia' 9-max Seat #4 is the button
Seat 1: di0d80 ($100 in chips) 
Seat 2: Rafaello18 ($204.14 in chips) 
Seat 4: DomiVY ($57.24 in chips) 
Seat 5: tipner ($100 in chips) 
Seat 6: matiko09 ($126.62 in chips) 
Seat 7: sanr23 ($102.93 in chips) 
Seat 8: techahn ($119 in chips) 
Seat 9: mbk88 ($114.38 in chips) 
tipner: posts small blind $0.50
matiko09: posts big blind $1
*** HOLE CARDS ***
Dealt to matiko09 [Td 7h]
sanr23: folds 
techahn: folds 
mbk88: folds 
di0d80: folds 
Rafaello18: raises $1.50 to $2.50
DomiVY: folds 
tipner: folds 
matiko09: folds 
Uncalled bet ($1.50) returned to Rafaello18
Rafaello18 collected $2.50 from pot
Rafaello18: doesn't show hand 
*** SUMMARY ***
Total pot $2.50 | Rake $0 
Seat 1: di0d80 folded before Flop (didn't bet)
Seat 2: Rafaello18 collected ($2.50)
Seat 4: DomiVY (button) folded before Flop (didn't bet)
Seat 5: tipner (small blind) folded before Flop
Seat 6: matiko09 (big blind) folded before Flop
Seat 7: sanr23 folded before Flop (didn't bet)
Seat 8: techahn folded before Flop (didn't bet)
Seat 9: mbk88 folded before Flop (didn't bet)





PokerStars Hand #155379318867:  Hold'em No Limit ($0.50/$1.00 USD) - 2016/06/30 13:22:11 CET [2016/06/30 7:22:11 ET]
Table 'California II' 9-max Seat #6 is the button
Seat 1: Rafaello18 ($100 in chips) 
Seat 2: tipner ($108.79 in chips) 
Seat 3: liakos120 ($61.75 in chips) 
Seat 4: mbk88 ($120.84 in chips) 
Seat 5: Rohitbarve ($101.36 in chips) 
Seat 6: matiko09 ($110.15 in chips) 
Seat 7: DomiVY ($85.50 in chips) 
Seat 8: picka4u ($39.25 in chips) 
Seat 9: di0d80 ($105.63 in chips) 
DomiVY: posts small blind $0.50
picka4u: posts big blind $1
*** HOLE CARDS ***
Dealt to matiko09 [6d 3d]
di0d80: raises $1.50 to $2.50
Rafaello18: folds 
tipner: folds 
liakos120: calls $2.50
mbk88: folds 
Rohitbarve: folds 
matiko09: folds 
DomiVY: folds 
picka4u: folds 
*** FLOP *** [7s 8s Tc]
di0d80: checks 
liakos120: checks 
*** TURN *** [7s 8s Tc] [2h]
di0d80: checks 
liakos120: checks 
*** RIVER *** [7s 8s Tc 2h] [Td]
di0d80: checks 
liakos120: checks 
*** SHOW DOWN ***
di0d80: shows [Ad 5d] (a pair of Tens)
liakos120: shows [Ac Js] (a pair of Tens - Ace+Jack kicker)
liakos120 collected $6.18 from pot
*** SUMMARY ***
Total pot $6.50 | Rake $0.32 
Board [7s 8s Tc 2h Td]
Seat 1: Rafaello18 folded before Flop (didn't bet)
Seat 2: tipner folded before Flop (didn't bet)
Seat 3: liakos120 showed [Ac Js] and won ($6.18) with a pair of Tens
Seat 4: mbk88 folded before Flop (didn't bet)
Seat 5: Rohitbarve folded before Flop (didn't bet)
Seat 6: matiko09 (button) folded before Flop (didn't bet)
Seat 7: DomiVY (small blind) folded before Flop
Seat 8: picka4u (big blind) folded before Flop
Seat 9: di0d80 showed [Ad 5d] and lost with a pair of Tens





PokerStars Hand #155379319734:  Hold'em No Limit ($0.50/$1.00 USD) - 2016/06/30 13:22:13 CET [2016/06/30 7:22:13 ET]
Table 'Askania' 9-max Seat #3 is the button
Seat 1: korlito69 ($44.95 in chips) 
Seat 2: Rafaello18 ($119.52 in chips) 
Seat 3: sasha197728 ($48.89 in chips) 
Seat 4: mbk88 ($118.12 in chips) 
Seat 5: tipner ($114 in chips) 
Seat 6: matiko09 ($215.63 in chips) 
Seat 7: ardo888 ($129.62 in chips) 
Seat 8: DomiVY ($71.50 in chips) 
Seat 9: picka4u ($51.62 in chips) 
mbk88: posts small blind $0.50
tipner: posts big blind $1
*** HOLE CARDS ***
Dealt to matiko09 [Kd 9s]
matiko09: folds 
ardo888: folds 
DomiVY: folds 
picka4u: folds 
korlito69: folds 
Rafaello18: folds 
sasha197728: raises $2 to $3
mbk88: folds 
tipner: calls $2
*** FLOP *** [Ah Jd 9c]
tipner: checks 
sasha197728: bets $5
tipner: folds 
Uncalled bet ($5) returned to sasha197728
sasha197728 collected $6.18 from pot
*** SUMMARY ***
Total pot $6.50 | Rake $0.32 
Board [Ah Jd 9c]
Seat 1: korlito69 folded before Flop (didn't bet)
Seat 2: Rafaello18 folded before Flop (didn't bet)
Seat 3: sasha197728 (button) collected ($6.18)
Seat 4: mbk88 (small blind) folded before Flop
Seat 5: tipner (big blind) folded on the Flop
Seat 6: matiko09 folded before Flop (didn't bet)
Seat 7: ardo888 folded before Flop (didn't bet)
Seat 8: DomiVY folded before Flop (didn't bet)
Seat 9: picka4u folded before Flop (didn't bet)





PokerStars Hand #155379323050:  Hold'em No Limit ($0.25/$0.50 USD) - 2016/06/30 13:22:21 CET [2016/06/30 7:22:21 ET]
Table 'Dorothea II' 9-max Seat #5 is the button
Seat 1: Vesnushca ($50 in chips) 
Seat 4: matiko09 ($84.29 in chips) 
Seat 5: Bailey Dew ($61.92 in chips) 
Seat 6: ivan100886 ($47.95 in chips) 
Seat 7: Alexey_Kim2 ($50 in chips) 
Seat 8: TheMinion ($50 in chips) 
Seat 9: ardo888 ($80.84 in chips) 
ivan100886: posts small blind $0.25
Alexey_Kim2: posts big blind $0.50
er13to: sits out 
Vesnushca: posts the ante $0.10
matiko09: posts the ante $0.10
Bailey Dew: posts the ante $0.10
ivan100886: posts the ante $0.10
Alexey_Kim2: posts the ante $0.10
TheMinion: posts the ante $0.10
ardo888: posts the ante $0.10
*** HOLE CARDS ***
Dealt to matiko09 [2c 4c]
TheMinion: folds 
ardo888: folds 
Vesnushca: folds 
matiko09: folds 
Bailey Dew: raises $0.50 to $1
ivan100886: folds 
Alexey_Kim2: folds 
Uncalled bet ($0.50) returned to Bailey Dew
Bailey Dew collected $1.95 from pot
Bailey Dew: doesn't show hand 
*** SUMMARY ***
Total pot $1.95 | Rake $0 
Seat 1: Vesnushca folded before Flop (didn't bet)
Seat 4: matiko09 folded before Flop (didn't bet)
Seat 5: Bailey Dew (button) collected ($1.95)
Seat 6: ivan100886 (small blind) folded before Flop
Seat 7: Alexey_Kim2 (big blind) folded before Flop
Seat 8: TheMinion folded before Flop (didn't bet)
Seat 9: ardo888 folded before Flop (didn't bet)





PokerStars Hand #155379323399:  Hold'em No Limit ($0.25/$0.50 USD) - 2016/06/30 13:22:22 CET [2016/06/30 7:22:22 ET]
Table 'Mentha II' 9-max Seat #4 is the button
Seat 1: geowin ($96.34 in chips) 
Seat 2: TheMinion ($50 in chips) 
Seat 3: Alexey_Kim2 ($64.26 in chips) 
Seat 4: DeathcorePkr ($51.03 in chips) 
Seat 5: matiko09 ($54.49 in chips) 
Seat 6: IceyyF91x ($40 in chips) 
Seat 7: ardo888 ($87.77 in chips) 
Seat 8: drlee77 ($45.05 in chips) 
matiko09: posts small blind $0.25
IceyyF91x: posts big blind $0.50
er13to: sits out 
geowin: posts the ante $0.10
TheMinion: posts the ante $0.10
Alexey_Kim2: posts the ante $0.10
DeathcorePkr: posts the ante $0.10
matiko09: posts the ante $0.10
IceyyF91x: posts the ante $0.10
ardo888: posts the ante $0.10
drlee77: posts the ante $0.10
*** HOLE CARDS ***
Dealt to matiko09 [Ks 4s]
ardo888: folds 
drlee77: raises $1 to $1.50
geowin: calls $1.50
TheMinion: folds 
Alexey_Kim2: folds 
DeathcorePkr: folds 
matiko09: folds 
IceyyF91x: calls $1
*** FLOP *** [8h As Qh]
IceyyF91x: bets $5
drlee77: folds 
geowin: calls $5
*** TURN *** [8h As Qh] [2s]
IceyyF91x: bets $15
geowin: folds 
Uncalled bet ($15) returned to IceyyF91x
IceyyF91x collected $14.77 from pot
IceyyF91x: doesn't show hand 
*** SUMMARY ***
Total pot $15.55 | Rake $0.78 
Board [8h As Qh 2s]
Seat 1: geowin folded on the Turn
Seat 2: TheMinion folded before Flop (didn't bet)
Seat 3: Alexey_Kim2 folded before Flop (didn't bet)
Seat 4: DeathcorePkr (button) folded before Flop (didn't bet)
Seat 5: matiko09 (small blind) folded before Flop
Seat 6: IceyyF91x (big blind) collected ($14.77)
Seat 7: ardo888 folded before Flop (didn't bet)
Seat 8: drlee77 folded on the Flop





PokerStars Hand #155379324573:  Hold'em No Limit ($0.50/$1.00 USD) - 2016/06/30 13:22:25 CET [2016/06/30 7:22:25 ET]
Table 'Tatjana' 9-max Seat #7 is the button
Seat 1: ardo888 ($121.24 in chips) 
Seat 2: picka4u ($64.19 in chips) 
Seat 3: Rafaello18 ($106.95 in chips) 
Seat 4: Konig26 ($146.08 in chips) 
Seat 5: matiko09 ($101.90 in chips) 
Seat 6: mbk88 ($100 in chips) 
Seat 7: DomiVY ($40 in chips) 
Seat 9: POTAPENKO700 ($100 in chips) 
POTAPENKO700: posts small blind $0.50
ardo888: posts big blind $1
*** HOLE CARDS ***
Dealt to matiko09 [5s Ac]
picka4u: folds 
Rafaello18: folds 
Konig26: folds 
matiko09: folds 
mbk88: folds 
DomiVY: folds 
POTAPENKO700: folds 
Uncalled bet ($0.50) returned to ardo888
ardo888 collected $1 from pot
ardo888: doesn't show hand 
*** SUMMARY ***
Total pot $1 | Rake $0 
Seat 1: ardo888 (big blind) collected ($1)
Seat 2: picka4u folded before Flop (didn't bet)
Seat 3: Rafaello18 folded before Flop (didn't bet)
Seat 4: Konig26 folded before Flop (didn't bet)
Seat 5: matiko09 folded before Flop (didn't bet)
Seat 6: mbk88 folded before Flop (didn't bet)
Seat 7: DomiVY (button) folded before Flop (didn't bet)
Seat 9: POTAPENKO700 (small blind) folded before Flop





PokerStars Hand #155379327432:  Hold'em No Limit ($0.50/$1.00 USD) - 2016/06/30 13:22:32 CET [2016/06/30 7:22:32 ET]
Table 'Scheila' 9-max Seat #8 is the button
Seat 1: mbk88 ($111.24 in chips) 
Seat 3: matiko09 ($100.50 in chips) 
Seat 4: DomiVY ($55.14 in chips) 
Seat 5: blackmont111 ($77.50 in chips) 
Seat 6: picka4u ($57.30 in chips) 
Seat 7: sanr23 ($199.22 in chips) 
Seat 8: Rafaello18 ($114.37 in chips) 
Seat 9: kalcumite ($180.67 in chips) 
kalcumite: posts small blind $0.50
mbk88: posts big blind $1
DIMAN_324: sits out 
*** HOLE CARDS ***
Dealt to matiko09 [As 9d]
matiko09: folds 
DomiVY: folds 
blackmont111: folds 
picka4u: folds 
sanr23: folds 
Rafaello18: folds 
kalcumite: raises $2 to $3
mbk88: calls $2
*** FLOP *** [5h 4s 3h]
kalcumite: checks 
mbk88: bets $4
kalcumite: folds 
Uncalled bet ($4) returned to mbk88
mbk88 collected $5.70 from pot
mbk88: doesn't show hand 
*** SUMMARY ***
Total pot $6 | Rake $0.30 
Board [5h 4s 3h]
Seat 1: mbk88 (big blind) collected ($5.70)
Seat 3: matiko09 folded before Flop (didn't bet)
Seat 4: DomiVY folded before Flop (didn't bet)
Seat 5: blackmont111 folded before Flop (didn't bet)
Seat 6: picka4u folded before Flop (didn't bet)
Seat 7: sanr23 folded before Flop (didn't bet)
Seat 8: Rafaello18 (button) folded before Flop (didn't bet)
Seat 9: kalcumite (small blind) folded on the Flop





PokerStars Hand #155379328049:  Hold'em No Limit ($0.50/$1.00 USD) - 2016/06/30 13:22:33 CET [2016/06/30 7:22:33 ET]
Table 'Sigrid' 9-max Seat #4 is the button
Seat 1: DomiVY ($40 in chips) 
Seat 2: bearlar ($116.75 in chips) 
Seat 3: Rafaello18 ($118.60 in chips) 
Seat 4: mbk88 ($100 in chips) 
Seat 5: DIMAN_324 ($129 in chips) 
Seat 6: di0d80 ($115.99 in chips) 
Seat 7: arctur17 ($34.50 in chips) 
Seat 8: techahn ($120.87 in chips) 
Seat 9: matiko09 ($110.52 in chips) 
DIMAN_324: posts small blind $0.50
di0d80: posts big blind $1
*** HOLE CARDS ***
Dealt to matiko09 [Kd 8h]
arctur17: folds 
techahn: raises $2 to $3
matiko09: folds 
DomiVY: folds 
bearlar: folds 
Rafaello18: folds 
mbk88: folds 
DIMAN_324: folds 
di0d80: folds 
Uncalled bet ($2) returned to techahn
techahn collected $2.50 from pot
techahn: doesn't show hand 
*** SUMMARY ***
Total pot $2.50 | Rake $0 
Seat 1: DomiVY folded before Flop (didn't bet)
Seat 2: bearlar folded before Flop (didn't bet)
Seat 3: Rafaello18 folded before Flop (didn't bet)
Seat 4: mbk88 (button) folded before Flop (didn't bet)
Seat 5: DIMAN_324 (small blind) folded before Flop
Seat 6: di0d80 (big blind) folded before Flop
Seat 7: arctur17 folded before Flop (didn't bet)
Seat 8: techahn collected ($2.50)
Seat 9: matiko09 folded before Flop (didn't bet)





PokerStars Hand #155379333112:  Hold'em No Limit ($0.50/$1.00 USD) - 2016/06/30 13:22:46 CET [2016/06/30 7:22:46 ET]
Table 'Armisticia' 9-max Seat #5 is the button
Seat 1: di0d80 ($100 in chips) 
Seat 2: Rafaello18 ($205.64 in chips) 
Seat 4: DomiVY ($57.24 in chips) 
Seat 5: tipner ($100 in chips) 
Seat 6: matiko09 ($125.62 in chips) 
Seat 7: sanr23 ($102.93 in chips) 
Seat 8: techahn ($119 in chips) 
Seat 9: mbk88 ($114.38 in chips) 
matiko09: posts small blind $0.50
sanr23: posts big blind $1
*** HOLE CARDS ***
Dealt to matiko09 [Jh 2h]
techahn: folds 
mbk88: folds 
di0d80: folds 
Rafaello18: folds 
DomiVY: raises $1.10 to $2.10
tipner: folds 
matiko09: folds 
sanr23: folds 
Uncalled bet ($1.10) returned to DomiVY
DomiVY collected $2.50 from pot
DomiVY: doesn't show hand 
*** SUMMARY ***
Total pot $2.50 | Rake $0 
Seat 1: di0d80 folded before Flop (didn't bet)
Seat 2: Rafaello18 folded before Flop (didn't bet)
Seat 4: DomiVY collected ($2.50)
Seat 5: tipner (button) folded before Flop (didn't bet)
Seat 6: matiko09 (small blind) folded before Flop
Seat 7: sanr23 (big blind) folded before Flop
Seat 8: techahn folded before Flop (didn't bet)
Seat 9: mbk88 folded before Flop (didn't bet)





PokerStars Hand #155379334788:  Hold'em No Limit ($0.50/$1.00 USD) - 2016/06/30 13:22:50 CET [2016/06/30 7:22:50 ET]
Table 'Tatjana' 9-max Seat #9 is the button
Seat 1: ardo888 ($121.74 in chips) 
Seat 3: Rafaello18 ($106.95 in chips) 
Seat 4: Konig26 ($146.08 in chips) 
Seat 5: matiko09 ($101.90 in chips) 
Seat 6: mbk88 ($100 in chips) 
Seat 7: DomiVY ($40 in chips) 
Seat 9: POTAPENKO700 ($100 in chips) 
ardo888: posts small blind $0.50
picka4u: is sitting out 
Rafaello18: posts big blind $1
*** HOLE CARDS ***
Dealt to matiko09 [Ks 6s]
Konig26: folds 
picka4u leaves the table
matiko09: folds 
mbk88: raises $2 to $3
DomiVY: folds 
POTAPENKO700: folds 
ardo888: folds 
DIMAN_324 joins the table at seat #2 
Rafaello18: folds 
Uncalled bet ($2) returned to mbk88
mbk88 collected $2.50 from pot
mbk88: doesn't show hand 
*** SUMMARY ***
Total pot $2.50 | Rake $0 
Seat 1: ardo888 (small blind) folded before Flop
Seat 3: Rafaello18 (big blind) folded before Flop
Seat 4: Konig26 folded before Flop (didn't bet)
Seat 5: matiko09 folded before Flop (didn't bet)
Seat 6: mbk88 collected ($2.50)
Seat 7: DomiVY folded before Flop (didn't bet)
Seat 9: POTAPENKO700 (button) folded before Flop (didn't bet)





PokerStars Hand #155379337600:  Hold'em No Limit ($0.50/$1.00 USD) - 2016/06/30 13:22:56 CET [2016/06/30 7:22:56 ET]
Table 'California II' 9-max Seat #7 is the button
Seat 1: Rafaello18 ($100 in chips) 
Seat 2: tipner ($108.79 in chips) 
Seat 3: liakos120 ($65.43 in chips) 
Seat 4: mbk88 ($120.84 in chips) 
Seat 5: Rohitbarve ($101.36 in chips) 
Seat 6: matiko09 ($110.15 in chips) 
Seat 7: DomiVY ($85 in chips) 
Seat 8: picka4u ($38.25 in chips) 
Seat 9: di0d80 ($103.13 in chips) 
picka4u: posts small blind $0.50
di0d80: posts big blind $1
*** HOLE CARDS ***
Dealt to matiko09 [Jd 5d]
Rafaello18: folds 
tipner: folds 
liakos120: folds 
mbk88: folds 
Rohitbarve: folds 
matiko09: folds 
DomiVY: folds 
picka4u: raises $1.25 to $2.25
di0d80: calls $1.25
*** FLOP *** [Ac 4c 4s]
picka4u: checks 
di0d80: checks 
*** TURN *** [Ac 4c 4s] [6s]
picka4u: checks 
di0d80: checks 
*** RIVER *** [Ac 4c 4s 6s] [9s]
picka4u: checks 
di0d80: checks 
*** SHOW DOWN ***
picka4u: shows [Ks 2c] (a pair of Fours)
di0d80: shows [3d 3c] (two pair, Fours and Threes)
di0d80 collected $4.28 from pot
*** SUMMARY ***
Total pot $4.50 | Rake $0.22 
Board [Ac 4c 4s 6s 9s]
Seat 1: Rafaello18 folded before Flop (didn't bet)
Seat 2: tipner folded before Flop (didn't bet)
Seat 3: liakos120 folded before Flop (didn't bet)
Seat 4: mbk88 folded before Flop (didn't bet)
Seat 5: Rohitbarve folded before Flop (didn't bet)
Seat 6: matiko09 folded before Flop (didn't bet)
Seat 7: DomiVY (button) folded before Flop (didn't bet)
Seat 8: picka4u (small blind) showed [Ks 2c] and lost with a pair of Fours
Seat 9: di0d80 (big blind) showed [3d 3c] and won ($4.28) with two pair, Fours and Threes





PokerStars Hand #155379338685:  Hold'em No Limit ($0.25/$0.50 USD) - 2016/06/30 13:22:59 CET [2016/06/30 7:22:59 ET]
Table 'Dorothea II' 9-max Seat #6 is the button
Seat 1: Vesnushca ($50 in chips) 
Seat 4: matiko09 ($84.19 in chips) 
Seat 5: Bailey Dew ($63.27 in chips) 
Seat 6: ivan100886 ($47.60 in chips) 
Seat 7: Alexey_Kim2 ($50 in chips) 
Seat 8: TheMinion ($50 in chips) 
Seat 9: ardo888 ($80.74 in chips) 
Alexey_Kim2: posts small blind $0.25
TheMinion: posts big blind $0.50
er13to: sits out 
Vesnushca: posts the ante $0.10
matiko09: posts the ante $0.10
Bailey Dew: posts the ante $0.10
ivan100886: posts the ante $0.10
Alexey_Kim2: posts the ante $0.10
TheMinion: posts the ante $0.10
ardo888: posts the ante $0.10
*** HOLE CARDS ***
Dealt to matiko09 [4s Td]
ardo888: folds 
Vesnushca: folds 
matiko09: folds 
Bailey Dew: folds 
ivan100886: folds 
Alexey_Kim2: raises $0.75 to $1.25
TheMinion: calls $0.75
*** FLOP *** [5s 5d 9d]
Alexey_Kim2: bets $2.02
TheMinion: calls $2.02
*** TURN *** [5s 5d 9d] [Tc]
Alexey_Kim2: checks 
TheMinion: checks 
*** RIVER *** [5s 5d 9d Tc] [Qd]
Alexey_Kim2: checks 
TheMinion: bets $4
Alexey_Kim2: folds 
Uncalled bet ($4) returned to TheMinion
TheMinion collected $6.88 from pot
TheMinion: doesn't show hand 
*** SUMMARY ***
Total pot $7.24 | Rake $0.36 
Board [5s 5d 9d Tc Qd]
Seat 1: Vesnushca folded before Flop (didn't bet)
Seat 4: matiko09 folded before Flop (didn't bet)
Seat 5: Bailey Dew folded before Flop (didn't bet)
Seat 6: ivan100886 (button) folded before Flop (didn't bet)
Seat 7: Alexey_Kim2 (small blind) folded on the River
Seat 8: TheMinion (big blind) collected ($6.88)
Seat 9: ardo888 folded before Flop (didn't bet)





PokerStars Hand #155379338757:  Hold'em No Limit ($0.50/$1.00 USD) - 2016/06/30 13:22:59 CET [2016/06/30 7:22:59 ET]
Table 'Sigrid' 9-max Seat #5 is the button
Seat 1: DomiVY ($40 in chips) 
Seat 2: bearlar ($116.75 in chips) 
Seat 3: Rafaello18 ($118.60 in chips) 
Seat 4: mbk88 ($100 in chips) 
Seat 5: DIMAN_324 ($128.50 in chips) 
Seat 6: di0d80 ($114.99 in chips) 
Seat 7: arctur17 ($34.50 in chips) 
Seat 8: techahn ($122.37 in chips) 
Seat 9: matiko09 ($110.52 in chips) 
di0d80: posts small blind $0.50
arctur17: posts big blind $1
*** HOLE CARDS ***
Dealt to matiko09 [3d Kc]
techahn: raises $2 to $3
matiko09: folds 
DomiVY: folds 
bearlar: folds 
Rafaello18: folds 
mbk88: folds 
DIMAN_324: raises $6 to $9
di0d80: folds 
arctur17: folds 
techahn: calls $6
*** FLOP *** [9c Td 7d]
techahn: checks 
DIMAN_324: checks 
*** TURN *** [9c Td 7d] [4s]
techahn: bets $9.26
DIMAN_324: calls $9.26
*** RIVER *** [9c Td 7d 4s] [7h]
techahn: checks 
DIMAN_324: checks 
*** SHOW DOWN ***
techahn: shows [Jd Jc] (two pair, Jacks and Sevens)
DIMAN_324: mucks hand 
techahn collected $36.12 from pot
*** SUMMARY ***
Total pot $38.02 | Rake $1.90 
Board [9c Td 7d 4s 7h]
Seat 1: DomiVY folded before Flop (didn't bet)
Seat 2: bearlar folded before Flop (didn't bet)
Seat 3: Rafaello18 folded before Flop (didn't bet)
Seat 4: mbk88 folded before Flop (didn't bet)
Seat 5: DIMAN_324 (button) mucked [Ac Kh]
Seat 6: di0d80 (small blind) folded before Flop
Seat 7: arctur17 (big blind) folded before Flop
Seat 8: techahn showed [Jd Jc] and won ($36.12) with two pair, Jacks and Sevens
Seat 9: matiko09 folded before Flop (didn't bet)





PokerStars Hand #155379343505:  Hold'em No Limit ($0.50/$1.00 USD) - 2016/06/30 13:23:11 CET [2016/06/30 7:23:11 ET]
Table 'Armisticia' 9-max Seat #6 is the button
Seat 1: di0d80 ($100 in chips) 
Seat 2: Rafaello18 ($205.64 in chips) 
Seat 4: DomiVY ($58.74 in chips) 
Seat 5: tipner ($100 in chips) 
Seat 6: matiko09 ($125.12 in chips) 
Seat 7: sanr23 ($101.93 in chips) 
Seat 8: techahn ($119 in chips) 
Seat 9: mbk88 ($114.38 in chips) 
sanr23: posts small blind $0.50
techahn: posts big blind $1
*** HOLE CARDS ***
Dealt to matiko09 [3c 9h]
mbk88: folds 
di0d80: raises $1.50 to $2.50
Rafaello18: folds 
DomiVY: folds 
tipner: folds 
matiko09: folds 
sanr23: folds 
techahn: folds 
Uncalled bet ($1.50) returned to di0d80
di0d80 collected $2.50 from pot
di0d80: doesn't show hand 
*** SUMMARY ***
Total pot $2.50 | Rake $0 
Seat 1: di0d80 collected ($2.50)
Seat 2: Rafaello18 folded before Flop (didn't bet)
Seat 4: DomiVY folded before Flop (didn't bet)
Seat 5: tipner folded before Flop (didn't bet)
Seat 6: matiko09 (button) folded before Flop (didn't bet)
Seat 7: sanr23 (small blind) folded before Flop
Seat 8: techahn (big blind) folded before Flop
Seat 9: mbk88 folded before Flop (didn't bet)





PokerStars Hand #155379346197:  Hold'em No Limit ($0.50/$1.00 USD) - 2016/06/30 13:23:17 CET [2016/06/30 7:23:17 ET]
Table 'Scheila' 9-max Seat #9 is the button
Seat 1: mbk88 ($113.94 in chips) 
Seat 2: DIMAN_324 ($100 in chips) 
Seat 3: matiko09 ($100.50 in chips) 
Seat 4: DomiVY ($55.14 in chips) 
Seat 5: blackmont111 ($77.50 in chips) 
Seat 6: picka4u ($57.30 in chips) 
Seat 7: sanr23 ($199.22 in chips) 
Seat 8: Rafaello18 ($114.37 in chips) 
Seat 9: kalcumite ($177.67 in chips) 
mbk88: posts small blind $0.50
DIMAN_324: posts big blind $1
*** HOLE CARDS ***
Dealt to matiko09 [Kh Jh]
matiko09: raises $2 to $3
DomiVY: folds 
blackmont111: folds 
picka4u: folds 
sanr23: folds 
Rafaello18: folds 
kalcumite: calls $3
mbk88: raises $8 to $11
DIMAN_324: folds 
matiko09: folds 
kalcumite: calls $8
*** FLOP *** [5c Th Kc]
mbk88: bets $16
kalcumite: folds 
Uncalled bet ($16) returned to mbk88
mbk88 collected $24.70 from pot
mbk88: doesn't show hand 
*** SUMMARY ***
Total pot $26 | Rake $1.30 
Board [5c Th Kc]
Seat 1: mbk88 (small blind) collected ($24.70)
Seat 2: DIMAN_324 (big blind) folded before Flop
Seat 3: matiko09 folded before Flop
Seat 4: DomiVY folded before Flop (didn't bet)
Seat 5: blackmont111 folded before Flop (didn't bet)
Seat 6: picka4u folded before Flop (didn't bet)
Seat 7: sanr23 folded before Flop (didn't bet)
Seat 8: Rafaello18 folded before Flop (didn't bet)
Seat 9: kalcumite (button) folded on the Flop





PokerStars Hand #155379348499:  Hold'em No Limit ($0.50/$1.00 USD) - 2016/06/30 13:23:22 CET [2016/06/30 7:23:22 ET]
Table 'Borrelly II' 9-max Seat #9 is the button
Seat 1: Rafaello18 ($119.45 in chips) 
Seat 2: tipner ($131.57 in chips) 
Seat 3: di0d80 ($102.50 in chips) 
Seat 4: DonRon_AT ($51.06 in chips) 
Seat 5: picka4u ($116 in chips) 
Seat 6: m_michalec ($164.88 in chips) 
Seat 7: matiko09 ($161.85 in chips) 
Seat 8: mbk88 ($100 in chips) 
Seat 9: makaveli978 ($42.34 in chips) 
Rafaello18: posts small blind $0.50
tipner: posts big blind $1
*** HOLE CARDS ***
Dealt to matiko09 [8h Kd]
di0d80: folds 
DonRon_AT: folds 
picka4u: folds 
m_michalec: folds 
matiko09: folds 
mbk88: folds 
makaveli978: raises $1 to $2
Rafaello18: raises $4 to $6
tipner: folds 
makaveli978: calls $4
*** FLOP *** [4s Ad 4d]
Rafaello18: bets $9
makaveli978: folds 
Uncalled bet ($9) returned to Rafaello18
Rafaello18 collected $12.35 from pot
Rafaello18: doesn't show hand 
*** SUMMARY ***
Total pot $13 | Rake $0.65 
Board [4s Ad 4d]
Seat 1: Rafaello18 (small blind) collected ($12.35)
Seat 2: tipner (big blind) folded before Flop
Seat 3: di0d80 folded before Flop (didn't bet)
Seat 4: DonRon_AT folded before Flop (didn't bet)
Seat 5: picka4u folded before Flop (didn't bet)
Seat 6: m_michalec folded before Flop (didn't bet)
Seat 7: matiko09 folded before Flop (didn't bet)
Seat 8: mbk88 folded before Flop (didn't bet)
Seat 9: makaveli978 (button) folded on the Flop





PokerStars Hand #155379351442:  Hold'em No Limit ($0.50/$1.00 USD) - 2016/06/30 13:23:30 CET [2016/06/30 7:23:30 ET]
Table 'Tatjana' 9-max Seat #1 is the button
Seat 1: ardo888 ($121.24 in chips) 
Seat 3: Rafaello18 ($105.95 in chips) 
Seat 4: Konig26 ($146.08 in chips) 
Seat 5: matiko09 ($101.90 in chips) 
Seat 6: mbk88 ($101.50 in chips) 
Seat 7: DomiVY ($40 in chips) 
Seat 9: POTAPENKO700 ($100 in chips) 
DIMAN_324 will be allowed to play after the button
Rafaello18: posts small blind $0.50
Konig26: posts big blind $1
*** HOLE CARDS ***
Dealt to matiko09 [Qc Kc]
matiko09: raises $2 to $3
mbk88: folds 
DomiVY: folds 
POTAPENKO700: folds 
ardo888: folds 
Rafaello18: folds 
Konig26: calls $2
*** FLOP *** [7c 5d 2d]
Konig26: checks 
matiko09: bets $4
Konig26: folds 
Uncalled bet ($4) returned to matiko09
matiko09 collected $6.18 from pot
matiko09: doesn't show hand 
*** SUMMARY ***
Total pot $6.50 | Rake $0.32 
Board [7c 5d 2d]
Seat 1: ardo888 (button) folded before Flop (didn't bet)
Seat 3: Rafaello18 (small blind) folded before Flop
Seat 4: Konig26 (big blind) folded on the Flop
Seat 5: matiko09 collected ($6.18)
Seat 6: mbk88 folded before Flop (didn't bet)
Seat 7: DomiVY folded before Flop (didn't bet)
Seat 9: POTAPENKO700 folded before Flop (didn't bet)





PokerStars Hand #155379351507:  Hold'em No Limit ($0.50/$1.00 USD) - 2016/06/30 13:23:30 CET [2016/06/30 7:23:30 ET]
Table 'Asmodeus' 9-max Seat #9 is the button
Seat 1: scollop ($87.27 in chips) 
Seat 2: picka4u ($49.52 in chips) 
Seat 3: matiko09 ($111.77 in chips) 
Seat 4: ardo888 ($143.28 in chips) 
Seat 5: sanr23 ($105.16 in chips) 
Seat 6: koutani7 ($92.50 in chips) 
Seat 7: aaronzzr ($149.11 in chips) 
Seat 8: Rafaello18 ($133.10 in chips) 
Seat 9: mbk88 ($163.50 in chips) 
scollop: posts small blind $0.50
picka4u: posts big blind $1
*** HOLE CARDS ***
Dealt to matiko09 [Ah 9h]
matiko09: folds 
ardo888: folds 
sanr23: folds 
koutani7: folds 
aaronzzr: folds 
Rafaello18: folds 
mbk88: folds 
scollop: raises $1 to $2
picka4u: calls $1
*** FLOP *** [4h 5s Ad]
scollop: checks 
picka4u: bets $2
scollop: calls $2
*** TURN *** [4h 5s Ad] [4c]
scollop: checks 
picka4u: checks 
*** RIVER *** [4h 5s Ad 4c] [Ts]
scollop: bets $2
picka4u: folds 
Uncalled bet ($2) returned to scollop
scollop collected $7.60 from pot
scollop: doesn't show hand 
*** SUMMARY ***
Total pot $8 | Rake $0.40 
Board [4h 5s Ad 4c Ts]
Seat 1: scollop (small blind) collected ($7.60)
Seat 2: picka4u (big blind) folded on the River
Seat 3: matiko09 folded before Flop (didn't bet)
Seat 4: ardo888 folded before Flop (didn't bet)
Seat 5: sanr23 folded before Flop (didn't bet)
Seat 6: koutani7 folded before Flop (didn't bet)
Seat 7: aaronzzr folded before Flop (didn't bet)
Seat 8: Rafaello18 folded before Flop (didn't bet)
Seat 9: mbk88 (button) folded before Flop (didn't bet)





PokerStars Hand #155379358213:  Hold'em No Limit ($0.50/$1.00 USD) - 2016/06/30 13:23:46 CET [2016/06/30 7:23:46 ET]
Table 'Askania' 9-max Seat #4 is the button
Seat 1: korlito69 ($44.95 in chips) 
Seat 2: Rafaello18 ($119.52 in chips) 
Seat 3: sasha197728 ($52.07 in chips) 
Seat 4: mbk88 ($117.62 in chips) 
Seat 5: tipner ($111 in chips) 
Seat 6: matiko09 ($215.63 in chips) 
Seat 7: ardo888 ($129.62 in chips) 
Seat 8: DomiVY ($71.50 in chips) 
Seat 9: picka4u ($51.62 in chips) 
tipner: posts small blind $0.50
matiko09: posts big blind $1
*** HOLE CARDS ***
Dealt to matiko09 [Td 4c]
ardo888: folds 
DomiVY: folds 
picka4u: folds 
korlito69: folds 
Rafaello18: folds 
sasha197728: calls $1
mbk88: folds 
tipner: raises $3 to $4
matiko09: folds 
sasha197728: calls $3
*** FLOP *** [6c Tc 7d]
tipner: checks 
sasha197728: bets $4
tipner: calls $4
*** TURN *** [6c Tc 7d] [2s]
tipner: checks 
sasha197728: bets $8
tipner: folds 
Uncalled bet ($8) returned to sasha197728
sasha197728 collected $16.15 from pot
*** SUMMARY ***
Total pot $17 | Rake $0.85 
Board [6c Tc 7d 2s]
Seat 1: korlito69 folded before Flop (didn't bet)
Seat 2: Rafaello18 folded before Flop (didn't bet)
Seat 3: sasha197728 collected ($16.15)
Seat 4: mbk88 (button) folded before Flop (didn't bet)
Seat 5: tipner (small blind) folded on the Turn
Seat 6: matiko09 (big blind) folded before Flop
Seat 7: ardo888 folded before Flop (didn't bet)
Seat 8: DomiVY folded before Flop (didn't bet)
Seat 9: picka4u folded before Flop (didn't bet)





PokerStars Hand #155379358895:  Hold'em No Limit ($0.50/$1.00 USD) - 2016/06/30 13:23:47 CET [2016/06/30 7:23:47 ET]
Table 'California II' 9-max Seat #8 is the button
Seat 1: Rafaello18 ($100 in chips) 
Seat 2: tipner ($108.79 in chips) 
Seat 3: liakos120 ($65.43 in chips) 
Seat 4: mbk88 ($120.84 in chips) 
Seat 5: Rohitbarve ($101.36 in chips) 
Seat 6: matiko09 ($110.15 in chips) 
Seat 7: DomiVY ($85 in chips) 
Seat 8: picka4u ($36 in chips) 
Seat 9: di0d80 ($105.16 in chips) 
di0d80: posts small blind $0.50
Rafaello18: posts big blind $1
*** HOLE CARDS ***
Dealt to matiko09 [9s 4c]
tipner: folds 
liakos120: folds 
mbk88: raises $2 to $3
Rohitbarve: folds 
matiko09: folds 
DomiVY: folds 
picka4u: folds 
di0d80: folds 
Rafaello18: calls $2
*** FLOP *** [5c Th 3h]
Rafaello18: checks 
mbk88: bets $3
Rafaello18: calls $3
*** TURN *** [5c Th 3h] [8d]
Rafaello18: checks 
mbk88: checks 
*** RIVER *** [5c Th 3h 8d] [6s]
Rafaello18: bets $8
mbk88: folds 
Uncalled bet ($8) returned to Rafaello18
Rafaello18 collected $11.88 from pot
Rafaello18: doesn't show hand 
*** SUMMARY ***
Total pot $12.50 | Rake $0.62 
Board [5c Th 3h 8d 6s]
Seat 1: Rafaello18 (big blind) collected ($11.88)
Seat 2: tipner folded before Flop (didn't bet)
Seat 3: liakos120 folded before Flop (didn't bet)
Seat 4: mbk88 folded on the River
Seat 5: Rohitbarve folded before Flop (didn't bet)
Seat 6: matiko09 folded before Flop (didn't bet)
Seat 7: DomiVY folded before Flop (didn't bet)
Seat 8: picka4u (button) folded before Flop (didn't bet)
Seat 9: di0d80 (small blind) folded before Flop





PokerStars Hand #155379358849:  Hold'em No Limit ($0.50/$1.00 USD) - 2016/06/30 13:23:47 CET [2016/06/30 7:23:47 ET]
Table 'Simeisa II' 9-max Seat #1 is the button
Seat 1: Crashiii ($43.98 in chips) 
Seat 2: Rafaello18 ($139.66 in chips) 
Seat 3: matiko09 ($102.78 in chips) 
Seat 4: di0d80 ($101.50 in chips) 
Seat 5: arctur17 ($58.98 in chips) 
Seat 6: ammit9021 ($37.50 in chips) 
Seat 7: DomiVY ($46.22 in chips) 
Seat 8: picka4u ($98.77 in chips) 
Seat 9: mbk88 ($100 in chips) 
Rafaello18: posts small blind $0.50
matiko09: posts big blind $1
*** HOLE CARDS ***
Dealt to matiko09 [7s Ks]
di0d80: folds 
arctur17: folds 
ammit9021: folds 
di0d80 leaves the table
DomiVY: folds 
tipner joins the table at seat #4 
picka4u: folds 
mbk88: raises $2 to $3
Crashiii: calls $3
Rafaello18: folds 
matiko09: calls $2
*** FLOP *** [Js Jh Ad]
matiko09: checks 
mbk88: bets $6
Crashiii: raises $7 to $13
matiko09: folds 
mbk88: raises $7 to $20
Crashiii: calls $7
*** TURN *** [Js Jh Ad] [6c]
mbk88: bets $9
Crashiii: raises $11.98 to $20.98 and is all-in
mbk88: calls $11.98
*** RIVER *** [Js Jh Ad 6c] [Qs]
*** SHOW DOWN ***
mbk88: shows [Qd Jd] (a full house, Jacks full of Queens)
Crashiii: shows [9c Ah] (two pair, Aces and Jacks)
mbk88 collected $88.96 from pot
*** SUMMARY ***
Total pot $91.46 | Rake $2.50 
Board [Js Jh Ad 6c Qs]
Seat 1: Crashiii (button) showed [9c Ah] and lost with two pair, Aces and Jacks
Seat 2: Rafaello18 (small blind) folded before Flop
Seat 3: matiko09 (big blind) folded on the Flop
Seat 4: di0d80 folded before Flop (didn't bet)
Seat 5: arctur17 folded before Flop (didn't bet)
Seat 6: ammit9021 folded before Flop (didn't bet)
Seat 7: DomiVY folded before Flop (didn't bet)
Seat 8: picka4u folded before Flop (didn't bet)
Seat 9: mbk88 showed [Qd Jd] and won ($88.96) with a full house, Jacks full of Queens





PokerStars Hand #155379362984:  Hold'em No Limit ($0.25/$0.50 USD) - 2016/06/30 13:23:57 CET [2016/06/30 7:23:57 ET]
Table 'Mentha II' 9-max Seat #5 is the button
Seat 1: geowin ($89.74 in chips) 
Seat 2: TheMinion ($50 in chips) 
Seat 3: Alexey_Kim2 ($64.16 in chips) 
Seat 4: DeathcorePkr ($50.93 in chips) 
Seat 5: matiko09 ($54.14 in chips) 
Seat 6: IceyyF91x ($48.17 in chips) 
Seat 7: ardo888 ($87.67 in chips) 
Seat 8: drlee77 ($43.45 in chips) 
IceyyF91x: posts small blind $0.25
ardo888: posts big blind $0.50
er13to: sits out 
geowin: posts the ante $0.10
TheMinion: posts the ante $0.10
Alexey_Kim2: posts the ante $0.10
DeathcorePkr: posts the ante $0.10
matiko09: posts the ante $0.10
IceyyF91x: posts the ante $0.10
ardo888: posts the ante $0.10
drlee77: posts the ante $0.10
*** HOLE CARDS ***
Dealt to matiko09 [4d 5h]
drlee77: folds 
geowin: folds 
TheMinion: folds 
geowin leaves the table
Alexey_Kim2: raises $1 to $1.50
DeathcorePkr: folds 
matiko09: folds 
IceyyF91x: calls $1.25
ardo888: calls $1
*** FLOP *** [8c Kh 6s]
IceyyF91x: bets $2
ardo888: folds 
Alexey_Kim2: calls $2
*** TURN *** [8c Kh 6s] [7c]
IceyyF91x: bets $9.50
Alexey_Kim2: raises $51.06 to $60.56 and is all-in
IceyyF91x: calls $35.07 and is all-in
Uncalled bet ($15.99) returned to Alexey_Kim2
Bailey Dew joins the table at seat #1 
*** RIVER *** [8c Kh 6s 7c] [Ts]
*** SHOW DOWN ***
IceyyF91x: shows [8d 5d] (a pair of Eights)
Alexey_Kim2: shows [Ac Qc] (high card Ace)
IceyyF91x collected $96.44 from pot
*** SUMMARY ***
Total pot $98.44 | Rake $2 
Board [8c Kh 6s 7c Ts]
Seat 1: geowin folded before Flop (didn't bet)
Seat 2: TheMinion folded before Flop (didn't bet)
Seat 3: Alexey_Kim2 showed [Ac Qc] and lost with high card Ace
Seat 4: DeathcorePkr folded before Flop (didn't bet)
Seat 5: matiko09 (button) folded before Flop (didn't bet)
Seat 6: IceyyF91x (small blind) showed [8d 5d] and won ($96.44) with a pair of Eights
Seat 7: ardo888 (big blind) folded on the Flop
Seat 8: drlee77 folded before Flop (didn't bet)





PokerStars Hand #155379364531:  Hold'em No Limit ($0.50/$1.00 USD) - 2016/06/30 13:24:01 CET [2016/06/30 7:24:01 ET]
Table 'Tatjana' 9-max Seat #3 is the button
Seat 1: ardo888 ($121.24 in chips) 
Seat 3: Rafaello18 ($105.45 in chips) 
Seat 4: Konig26 ($143.08 in chips) 
Seat 5: matiko09 ($105.08 in chips) 
Seat 6: mbk88 ($101.50 in chips) 
Seat 7: DomiVY ($40 in chips) 
Seat 9: POTAPENKO700 ($100 in chips) 
Konig26: posts small blind $0.50
matiko09: posts big blind $1
DIMAN_324: sits out 
*** HOLE CARDS ***
Dealt to matiko09 [7c As]
mbk88: folds 
DomiVY: folds 
POTAPENKO700: raises $1.50 to $2.50
ardo888: folds 
Rafaello18: folds 
Konig26: folds 
matiko09: folds 
Uncalled bet ($1.50) returned to POTAPENKO700
POTAPENKO700 collected $2.50 from pot
POTAPENKO700: doesn't show hand 
*** SUMMARY ***
Total pot $2.50 | Rake $0 
Seat 1: ardo888 folded before Flop (didn't bet)
Seat 3: Rafaello18 (button) folded before Flop (didn't bet)
Seat 4: Konig26 (small blind) folded before Flop
Seat 5: matiko09 (big blind) folded before Flop
Seat 6: mbk88 folded before Flop (didn't bet)
Seat 7: DomiVY folded before Flop (didn't bet)
Seat 9: POTAPENKO700 collected ($2.50)





PokerStars Hand #155379365806:  Hold'em No Limit ($0.50/$1.00 USD) - 2016/06/30 13:24:04 CET [2016/06/30 7:24:04 ET]
Table 'Armisticia' 9-max Seat #7 is the button
Seat 1: di0d80 ($101.50 in chips) 
Seat 2: Rafaello18 ($205.64 in chips) 
Seat 4: DomiVY ($58.74 in chips) 
Seat 5: tipner ($100 in chips) 
Seat 6: matiko09 ($125.12 in chips) 
Seat 7: sanr23 ($101.43 in chips) 
Seat 8: techahn ($118 in chips) 
Seat 9: mbk88 ($114.38 in chips) 
techahn: posts small blind $0.50
mbk88: posts big blind $1
*** HOLE CARDS ***
Dealt to matiko09 [Ah 6h]
di0d80: folds 
Rafaello18: folds 
DomiVY: raises $2 to $3
tipner: calls $3
matiko09: folds 
sanr23: folds 
techahn: folds 
mbk88: calls $2
*** FLOP *** [Kc Qc Ts]
mbk88: checks 
DomiVY: checks 
tipner: checks 
*** TURN *** [Kc Qc Ts] [Kd]
mbk88: checks 
DomiVY: checks 
tipner: checks 
*** RIVER *** [Kc Qc Ts Kd] [6d]
mbk88: checks 
DomiVY: checks 
tipner: checks 
*** SHOW DOWN ***
mbk88: shows [6c Tc] (two pair, Kings and Tens)
DomiVY: mucks hand 
tipner: mucks hand 
mbk88 collected $9.02 from pot
*** SUMMARY ***
Total pot $9.50 | Rake $0.48 
Board [Kc Qc Ts Kd 6d]
Seat 1: di0d80 folded before Flop (didn't bet)
Seat 2: Rafaello18 folded before Flop (didn't bet)
Seat 4: DomiVY mucked [8h 8s]
Seat 5: tipner mucked [7c 7s]
Seat 6: matiko09 folded before Flop (didn't bet)
Seat 7: sanr23 (button) folded before Flop (didn't bet)
Seat 8: techahn (small blind) folded before Flop
Seat 9: mbk88 (big blind) showed [6c Tc] and won ($9.02) with two pair, Kings and Tens





PokerStars Hand #155379365788:  Hold'em No Limit ($0.50/$1.00 USD) - 2016/06/30 13:24:04 CET [2016/06/30 7:24:04 ET]
Table 'Sigrid' 9-max Seat #6 is the button
Seat 1: DomiVY ($40 in chips) 
Seat 2: bearlar ($116.75 in chips) 
Seat 3: Rafaello18 ($118.60 in chips) 
Seat 4: mbk88 ($100 in chips) 
Seat 5: DIMAN_324 ($110.24 in chips) 
Seat 6: di0d80 ($114.49 in chips) 
Seat 7: arctur17 ($33.50 in chips) 
Seat 8: techahn ($140.23 in chips) 
Seat 9: matiko09 ($110.52 in chips) 
arctur17: posts small blind $0.50
techahn: posts big blind $1
*** HOLE CARDS ***
Dealt to matiko09 [7d 3h]
matiko09: folds 
DomiVY: folds 
bearlar: folds 
Rafaello18: folds 
mbk88: raises $2 to $3
DIMAN_324: folds 
di0d80: raises $6 to $9
arctur17: folds 
techahn: folds 
mbk88: folds 
Uncalled bet ($6) returned to di0d80
di0d80 collected $7.50 from pot
di0d80: doesn't show hand 
*** SUMMARY ***
Total pot $7.50 | Rake $0 
Seat 1: DomiVY folded before Flop (didn't bet)
Seat 2: bearlar folded before Flop (didn't bet)
Seat 3: Rafaello18 folded before Flop (didn't bet)
Seat 4: mbk88 folded before Flop
Seat 5: DIMAN_324 folded before Flop (didn't bet)
Seat 6: di0d80 (button) collected ($7.50)
Seat 7: arctur17 (small blind) folded before Flop
Seat 8: techahn (big blind) folded before Flop
Seat 9: matiko09 folded before Flop (didn't bet)





PokerStars Hand #155379372272:  Hold'em No Limit ($0.50/$1.00 USD) - 2016/06/30 13:24:19 CET [2016/06/30 7:24:19 ET]
Table 'Borrelly II' 9-max Seat #1 is the button
Seat 1: Rafaello18 ($125.80 in chips) 
Seat 2: tipner ($130.57 in chips) 
Seat 3: di0d80 ($102.50 in chips) 
Seat 4: DonRon_AT ($51.06 in chips) 
Seat 5: picka4u ($116 in chips) 
Seat 6: m_michalec ($164.88 in chips) 
Seat 7: matiko09 ($161.85 in chips) 
Seat 8: mbk88 ($100 in chips) 
Seat 9: makaveli978 ($36.34 in chips) 
tipner: posts small blind $0.50
di0d80: posts big blind $1
*** HOLE CARDS ***
Dealt to matiko09 [Kd 9c]
DonRon_AT: folds 
picka4u: folds 
m_michalec: folds 
matiko09: folds 
mbk88: folds 
makaveli978: calls $1
Rafaello18: raises $2.50 to $3.50
tipner: folds 
di0d80: folds 
makaveli978: calls $2.50
*** FLOP *** [Js Jh Tc]
makaveli978: checks 
Rafaello18: bets $4
makaveli978: folds 
Uncalled bet ($4) returned to Rafaello18
Rafaello18 collected $8.08 from pot
Rafaello18: doesn't show hand 
*** SUMMARY ***
Total pot $8.50 | Rake $0.42 
Board [Js Jh Tc]
Seat 1: Rafaello18 (button) collected ($8.08)
Seat 2: tipner (small blind) folded before Flop
Seat 3: di0d80 (big blind) folded before Flop
Seat 4: DonRon_AT folded before Flop (didn't bet)
Seat 5: picka4u folded before Flop (didn't bet)
Seat 6: m_michalec folded before Flop (didn't bet)
Seat 7: matiko09 folded before Flop (didn't bet)
Seat 8: mbk88 folded before Flop (didn't bet)
Seat 9: makaveli978 folded on the Flop





PokerStars Hand #155379379464:  Hold'em No Limit ($0.50/$1.00 USD) - 2016/06/30 13:24:36 CET [2016/06/30 7:24:36 ET]
Table 'Tatjana' 9-max Seat #4 is the button
Seat 1: ardo888 ($121.24 in chips) 
Seat 3: Rafaello18 ($105.45 in chips) 
Seat 4: Konig26 ($142.58 in chips) 
Seat 5: matiko09 ($104.08 in chips) 
Seat 6: mbk88 ($101.50 in chips) 
Seat 7: DomiVY ($40 in chips) 
Seat 9: POTAPENKO700 ($101.50 in chips) 
matiko09: posts small blind $0.50
mbk88: posts big blind $1
alhill86: sits out 
DIMAN_324: sits out 
*** HOLE CARDS ***
Dealt to matiko09 [Th 3s]
DomiVY: folds 
POTAPENKO700: folds 
ardo888: folds 
Rafaello18: folds 
Konig26: raises $2 to $3
matiko09: folds 
mbk88: folds 
Uncalled bet ($2) returned to Konig26
Konig26 collected $2.50 from pot
Konig26: doesn't show hand 
*** SUMMARY ***
Total pot $2.50 | Rake $0 
Seat 1: ardo888 folded before Flop (didn't bet)
Seat 3: Rafaello18 folded before Flop (didn't bet)
Seat 4: Konig26 (button) collected ($2.50)
Seat 5: matiko09 (small blind) folded before Flop
Seat 6: mbk88 (big blind) folded before Flop
Seat 7: DomiVY folded before Flop (didn't bet)
Seat 9: POTAPENKO700 folded before Flop (didn't bet)





PokerStars Hand #155379383580:  Hold'em No Limit ($0.50/$1.00 USD) - 2016/06/30 13:24:46 CET [2016/06/30 7:24:46 ET]
Table 'Asmodeus' 9-max Seat #1 is the button
Seat 1: scollop ($90.87 in chips) 
Seat 2: picka4u ($45.52 in chips) 
Seat 3: matiko09 ($111.77 in chips) 
Seat 4: ardo888 ($143.28 in chips) 
Seat 5: sanr23 ($105.16 in chips) 
Seat 6: koutani7 ($92.50 in chips) 
Seat 7: aaronzzr ($149.11 in chips) 
Seat 8: Rafaello18 ($133.10 in chips) 
Seat 9: mbk88 ($163.50 in chips) 
picka4u: posts small blind $0.50
matiko09: posts big blind $1
*** HOLE CARDS ***
Dealt to matiko09 [As Ts]
ardo888: folds 
sanr23: folds 
koutani7: raises $2 to $3
aaronzzr: folds 
Rafaello18: folds 
mbk88: folds 
scollop: calls $3
picka4u: folds 
matiko09: calls $2
*** FLOP *** [7d 4s 5s]
matiko09: checks 
koutani7 has timed out
koutani7: checks 
scollop: checks 
*** TURN *** [7d 4s 5s] [2d]
matiko09: bets $12
koutani7: folds 
scollop: calls $12
*** RIVER *** [7d 4s 5s 2d] [2h]
matiko09: checks 
scollop: bets $9
matiko09: folds 
Uncalled bet ($9) returned to scollop
scollop collected $31.82 from pot
scollop: doesn't show hand 
*** SUMMARY ***
Total pot $33.50 | Rake $1.68 
Board [7d 4s 5s 2d 2h]
Seat 1: scollop (button) collected ($31.82)
Seat 2: picka4u (small blind) folded before Flop
Seat 3: matiko09 (big blind) folded on the River
Seat 4: ardo888 folded before Flop (didn't bet)
Seat 5: sanr23 folded before Flop (didn't bet)
Seat 6: koutani7 folded on the Turn
Seat 7: aaronzzr folded before Flop (didn't bet)
Seat 8: Rafaello18 folded before Flop (didn't bet)
Seat 9: mbk88 folded before Flop (didn't bet)





PokerStars Hand #155379384485:  Hold'em No Limit ($0.50/$1.00 USD) - 2016/06/30 13:24:48 CET [2016/06/30 7:24:48 ET]
Table 'Askania' 9-max Seat #5 is the button
Seat 1: korlito69 ($44.95 in chips) 
Seat 2: Rafaello18 ($119.52 in chips) 
Seat 3: sasha197728 ($60.22 in chips) 
Seat 4: mbk88 ($117.62 in chips) 
Seat 5: tipner ($103 in chips) 
Seat 6: matiko09 ($214.63 in chips) 
Seat 7: ardo888 ($129.62 in chips) 
Seat 8: DomiVY ($71.50 in chips) 
Seat 9: picka4u ($51.62 in chips) 
matiko09: posts small blind $0.50
ardo888: posts big blind $1
*** HOLE CARDS ***
Dealt to matiko09 [Td Kh]
DomiVY: folds 
picka4u: folds 
korlito69: folds 
Rafaello18: folds 
sasha197728: raises $1 to $2
mbk88: folds 
tipner: folds 
matiko09: raises $4 to $6
ardo888: folds 
sasha197728: calls $4
*** FLOP *** [7c 2d 5h]
matiko09: bets $6.50
sasha197728: calls $6.50
*** TURN *** [7c 2d 5h] [Ts]
matiko09: bets $17
sasha197728: calls $17
*** RIVER *** [7c 2d 5h Ts] [3h]
matiko09: bets $38
sasha197728: folds 
Uncalled bet ($38) returned to matiko09
matiko09 collected $57.50 from pot
matiko09: doesn't show hand 
*** SUMMARY ***
Total pot $60 | Rake $2.50 
Board [7c 2d 5h Ts 3h]
Seat 1: korlito69 folded before Flop (didn't bet)
Seat 2: Rafaello18 folded before Flop (didn't bet)
Seat 3: sasha197728 folded on the River
Seat 4: mbk88 folded before Flop (didn't bet)
Seat 5: tipner (button) folded before Flop (didn't bet)
Seat 6: matiko09 (small blind) collected ($57.50)
Seat 7: ardo888 (big blind) folded before Flop
Seat 8: DomiVY folded before Flop (didn't bet)
Seat 9: picka4u folded before Flop (didn't bet)





PokerStars Hand #155379385110:  Hold'em No Limit ($0.25/$0.50 USD) - 2016/06/30 13:24:49 CET [2016/06/30 7:24:49 ET]
Table 'Dorothea II' 9-max Seat #7 is the button
Seat 1: Vesnushca ($50 in chips) 
Seat 3: Franky77200 ($66.71 in chips) 
Seat 4: matiko09 ($84.09 in chips) 
Seat 5: Bailey Dew ($63.17 in chips) 
Seat 6: ivan100886 ($47.50 in chips) 
Seat 7: Alexey_Kim2 ($50 in chips) 
Seat 8: TheMinion ($53.51 in chips) 
Seat 9: ardo888 ($80.64 in chips) 
TheMinion: posts small blind $0.25
ardo888: posts big blind $0.50
er13to: sits out 
Vesnushca: posts the ante $0.10
Franky77200: posts the ante $0.10
matiko09: posts the ante $0.10
Bailey Dew: posts the ante $0.10
ivan100886: posts the ante $0.10
Alexey_Kim2: posts the ante $0.10
TheMinion: posts the ante $0.10
ardo888: posts the ante $0.10
*** HOLE CARDS ***
Dealt to matiko09 [Th 8s]
Vesnushca: folds 
Franky77200: raises $1 to $1.50
matiko09: folds 
Bailey Dew: folds 
ivan100886: raises $3 to $4.50
Alexey_Kim2: folds 
TheMinion: folds 
ardo888: folds 
Franky77200: calls $3
*** FLOP *** [6s 3d 3h]
Franky77200: checks 
ivan100886: checks 
*** TURN *** [6s 3d 3h] [9d]
Franky77200: bets $5
ivan100886: calls $5
*** RIVER *** [6s 3d 3h 9d] [9s]
Franky77200: bets $12
ivan100886: folds 
Uncalled bet ($12) returned to Franky77200
Franky77200 collected $19.52 from pot
Franky77200: doesn't show hand 
*** SUMMARY ***
Total pot $20.55 | Rake $1.03 
Board [6s 3d 3h 9d 9s]
Seat 1: Vesnushca folded before Flop (didn't bet)
Seat 3: Franky77200 collected ($19.52)
Seat 4: matiko09 folded before Flop (didn't bet)
Seat 5: Bailey Dew folded before Flop (didn't bet)
Seat 6: ivan100886 folded on the River
Seat 7: Alexey_Kim2 (button) folded before Flop (didn't bet)
Seat 8: TheMinion (small blind) folded before Flop
Seat 9: ardo888 (big blind) folded before Flop





PokerStars Hand #155379385219:  Hold'em No Limit ($0.50/$1.00 USD) - 2016/06/30 13:24:50 CET [2016/06/30 7:24:50 ET]
Table 'Sigrid' 9-max Seat #7 is the button
Seat 1: DomiVY ($40 in chips) 
Seat 2: bearlar ($116.75 in chips) 
Seat 3: Rafaello18 ($118.60 in chips) 
Seat 4: mbk88 ($100 in chips) 
Seat 5: DIMAN_324 ($110.24 in chips) 
Seat 6: di0d80 ($118.99 in chips) 
Seat 7: arctur17 ($33 in chips) 
Seat 8: techahn ($139.23 in chips) 
Seat 9: matiko09 ($110.52 in chips) 
techahn: posts small blind $0.50
matiko09: posts big blind $1
*** HOLE CARDS ***
Dealt to matiko09 [8c Ks]
DomiVY: folds 
bearlar: folds 
Rafaello18: folds 
mbk88: raises $2 to $3
DIMAN_324: folds 
di0d80: folds 
arctur17: folds 
techahn: folds 
matiko09: folds 
Uncalled bet ($2) returned to mbk88
mbk88 collected $2.50 from pot
mbk88: doesn't show hand 
*** SUMMARY ***
Total pot $2.50 | Rake $0 
Seat 1: DomiVY folded before Flop (didn't bet)
Seat 2: bearlar folded before Flop (didn't bet)
Seat 3: Rafaello18 folded before Flop (didn't bet)
Seat 4: mbk88 collected ($2.50)
Seat 5: DIMAN_324 folded before Flop (didn't bet)
Seat 6: di0d80 folded before Flop (didn't bet)
Seat 7: arctur17 (button) folded before Flop (didn't bet)
Seat 8: techahn (small blind) folded before Flop
Seat 9: matiko09 (big blind) folded before Flop





PokerStars Hand #155379388345:  Hold'em No Limit ($0.50/$1.00 USD) - 2016/06/30 13:24:57 CET [2016/06/30 7:24:57 ET]
Table 'Prieska' 9-max Seat #4 is the button
Seat 4: matteo080613 ($80 in chips) 
Seat 5: ramzes160468 ($80 in chips) 
Seat 6: DIMAN_324 ($100 in chips) 
Seat 7: matiko09 ($100 in chips) 
ramzes160468: posts small blind $0.50
DIMAN_324: posts big blind $1
*** HOLE CARDS ***
Dealt to matiko09 [Jh 7d]
matiko09: folds 
matteo080613: folds 
ramzes160468: raises $2 to $3
tipner joins the table at seat #8 
DIMAN_324: folds 
Uncalled bet ($2) returned to ramzes160468
ramzes160468 collected $2 from pot
*** SUMMARY ***
Total pot $2 | Rake $0 
Seat 4: matteo080613 (button) folded before Flop (didn't bet)
Seat 5: ramzes160468 (small blind) collected ($2)
Seat 6: DIMAN_324 (big blind) folded before Flop
Seat 7: matiko09 folded before Flop (didn't bet)





PokerStars Hand #155379393073:  Hold'em No Limit ($0.50/$1.00 USD) - 2016/06/30 13:25:08 CET [2016/06/30 7:25:08 ET]
Table 'Simeisa II' 9-max Seat #2 is the button
Seat 2: Rafaello18 ($139.16 in chips) 
Seat 3: matiko09 ($100 in chips) 
Seat 4: tipner ($100 in chips) 
Seat 5: arctur17 ($58.98 in chips) 
Seat 6: ammit9021 ($37.50 in chips) 
Seat 7: DomiVY ($46.22 in chips) 
Seat 8: picka4u ($98.77 in chips) 
Seat 9: mbk88 ($144.98 in chips) 
matiko09: posts small blind $0.50
tipner: posts big blind $1
*** HOLE CARDS ***
Dealt to matiko09 [3d Jc]
arctur17: folds 
ammit9021: folds 
DomiVY: folds 
picka4u: raises $1.25 to $2.25
mbk88: folds 
Rafaello18: folds 
matiko09: folds 
Crashiii leaves the table
tipner: folds 
Uncalled bet ($1.25) returned to picka4u
picka4u collected $2.50 from pot
picka4u: doesn't show hand 
*** SUMMARY ***
Total pot $2.50 | Rake $0 
Seat 2: Rafaello18 (button) folded before Flop (didn't bet)
Seat 3: matiko09 (small blind) folded before Flop
Seat 4: tipner (big blind) folded before Flop
Seat 5: arctur17 folded before Flop (didn't bet)
Seat 6: ammit9021 folded before Flop (didn't bet)
Seat 7: DomiVY folded before Flop (didn't bet)
Seat 8: picka4u collected ($2.50)
Seat 9: mbk88 folded before Flop (didn't bet)





PokerStars Hand #155379393631:  Hold'em No Limit ($0.50/$1.00 USD) - 2016/06/30 13:25:10 CET [2016/06/30 7:25:10 ET]
Table 'Prieska' 9-max Seat #5 is the button
Seat 4: matteo080613 ($80 in chips) 
Seat 5: ramzes160468 ($81 in chips) 
Seat 6: DIMAN_324 ($100 in chips) 
Seat 7: matiko09 ($100 in chips) 
DIMAN_324: posts small blind $0.50
matiko09: posts big blind $1
*** HOLE CARDS ***
Dealt to matiko09 [Ah 2h]
matteo080613: folds 
ramzes160468: folds 
DIMAN_324: folds 
Uncalled bet ($0.50) returned to matiko09
matiko09 collected $1 from pot
matiko09: doesn't show hand 
*** SUMMARY ***
Total pot $1 | Rake $0 
Seat 4: matteo080613 folded before Flop (didn't bet)
Seat 5: ramzes160468 (button) folded before Flop (didn't bet)
Seat 6: DIMAN_324 (small blind) folded before Flop
Seat 7: matiko09 (big blind) collected ($1)





PokerStars Hand #155379399182:  Hold'em No Limit ($0.50/$1.00 USD) - 2016/06/30 13:25:23 CET [2016/06/30 7:25:23 ET]
Table 'Prieska' 9-max Seat #6 is the button
Seat 4: matteo080613 ($80 in chips) 
Seat 5: ramzes160468 ($81 in chips) 
Seat 6: DIMAN_324 ($100 in chips) 
Seat 7: matiko09 ($100.50 in chips) 
matiko09: posts small blind $0.50
matteo080613: posts big blind $1
*** HOLE CARDS ***
Dealt to matiko09 [Js 5d]
ramzes160468: folds 
KovIFish89 joins the table at seat #1 
DIMAN_324: folds 
B_style_cuz joins the table at seat #2 
Rafaello18 joins the table at seat #3 
matiko09: folds 
Uncalled bet ($0.50) returned to matteo080613
matteo080613 collected $1 from pot
matteo080613: doesn't show hand 
*** SUMMARY ***
Total pot $1 | Rake $0 
Seat 4: matteo080613 (big blind) collected ($1)
Seat 5: ramzes160468 folded before Flop (didn't bet)
Seat 6: DIMAN_324 (button) folded before Flop (didn't bet)
Seat 7: matiko09 (small blind) folded before Flop





PokerStars Hand #155379400337:  Hold'em No Limit ($0.50/$1.00 USD) - 2016/06/30 13:25:26 CET [2016/06/30 7:25:26 ET]
Table 'California II' 9-max Seat #9 is the button
Seat 1: Rafaello18 ($105.88 in chips) 
Seat 3: liakos120 ($65.43 in chips) 
Seat 4: mbk88 ($114.84 in chips) 
Seat 5: Rohitbarve ($101.36 in chips) 
Seat 6: matiko09 ($110.15 in chips) 
Seat 7: DomiVY ($85 in chips) 
Seat 8: picka4u ($36 in chips) 
Seat 9: di0d80 ($104.66 in chips) 
Rafaello18: posts small blind $0.50
tipner: is sitting out 
liakos120: posts big blind $1
*** HOLE CARDS ***
Dealt to matiko09 [5c Kc]
mbk88: folds 
Rohitbarve: folds 
tipner leaves the table
er13to joins the table at seat #2 
matiko09: folds 
DomiVY: folds 
picka4u: raises $1.25 to $2.25
di0d80: folds 
Rafaello18: folds 
liakos120: calls $1.25
*** FLOP *** [2c 4h 5s]
liakos120: bets $2.37
picka4u: calls $2.37
*** TURN *** [2c 4h 5s] [Th]
liakos120: bets $4.62
picka4u: calls $4.62
*** RIVER *** [2c 4h 5s Th] [Ah]
liakos120: checks 
picka4u: checks 
*** SHOW DOWN ***
liakos120: shows [6d 6s] (a pair of Sixes)
picka4u: mucks hand 
liakos120 collected $18.03 from pot
*** SUMMARY ***
Total pot $18.98 | Rake $0.95 
Board [2c 4h 5s Th Ah]
Seat 1: Rafaello18 (small blind) folded before Flop
Seat 3: liakos120 (big blind) showed [6d 6s] and won ($18.03) with a pair of Sixes
Seat 4: mbk88 folded before Flop (didn't bet)
Seat 5: Rohitbarve folded before Flop (didn't bet)
Seat 6: matiko09 folded before Flop (didn't bet)
Seat 7: DomiVY folded before Flop (didn't bet)
Seat 8: picka4u mucked [5d 7d]
Seat 9: di0d80 (button) folded before Flop (didn't bet)





PokerStars Hand #155379401637:  Hold'em No Limit ($0.50/$1.00 USD) - 2016/06/30 13:25:29 CET [2016/06/30 7:25:29 ET]
Table 'Borrelly II' 9-max Seat #2 is the button
Seat 1: Rafaello18 ($130.38 in chips) 
Seat 2: tipner ($130.07 in chips) 
Seat 3: di0d80 ($101.50 in chips) 
Seat 4: DonRon_AT ($51.06 in chips) 
Seat 5: picka4u ($116 in chips) 
Seat 6: m_michalec ($164.88 in chips) 
Seat 7: matiko09 ($161.85 in chips) 
Seat 8: mbk88 ($100 in chips) 
Seat 9: makaveli978 ($32.84 in chips) 
di0d80: posts small blind $0.50
DonRon_AT: posts big blind $1
*** HOLE CARDS ***
Dealt to matiko09 [7d 9s]
picka4u: raises $2 to $3
m_michalec: folds 
matiko09: folds 
mbk88: folds 
makaveli978: calls $3
Rafaello18: folds 
tipner: folds 
di0d80: folds 
DonRon_AT: folds 
*** FLOP *** [Ad 8d 2h]
picka4u: bets $5.29
makaveli978: calls $5.29
*** TURN *** [Ad 8d 2h] [2c]
picka4u: bets $12
makaveli978: folds 
Uncalled bet ($12) returned to picka4u
picka4u collected $17.18 from pot
picka4u: doesn't show hand 
*** SUMMARY ***
Total pot $18.08 | Rake $0.90 
Board [Ad 8d 2h 2c]
Seat 1: Rafaello18 folded before Flop (didn't bet)
Seat 2: tipner (button) folded before Flop (didn't bet)
Seat 3: di0d80 (small blind) folded before Flop
Seat 4: DonRon_AT (big blind) folded before Flop
Seat 5: picka4u collected ($17.18)
Seat 6: m_michalec folded before Flop (didn't bet)
Seat 7: matiko09 folded before Flop (didn't bet)
Seat 8: mbk88 folded before Flop (didn't bet)
Seat 9: makaveli978 folded on the Turn





PokerStars Hand #155379401803:  Hold'em No Limit ($0.50/$1.00 USD) - 2016/06/30 13:25:29 CET [2016/06/30 7:25:29 ET]
Table 'Tatjana' 9-max Seat #5 is the button
Seat 1: ardo888 ($121.24 in chips) 
Seat 3: Rafaello18 ($105.45 in chips) 
Seat 4: Konig26 ($144.08 in chips) 
Seat 5: matiko09 ($103.58 in chips) 
Seat 6: mbk88 ($100.50 in chips) 
Seat 7: DomiVY ($40 in chips) 
Seat 9: POTAPENKO700 ($101.50 in chips) 
mbk88: posts small blind $0.50
DomiVY: posts big blind $1
alhill86: sits out 
DIMAN_324: sits out 
*** HOLE CARDS ***
Dealt to matiko09 [2s Ts]
POTAPENKO700 has timed out
POTAPENKO700: folds 
ardo888: folds 
Rafaello18: folds 
Konig26: folds 
matiko09: folds 
mbk88: folds 
Uncalled bet ($0.50) returned to DomiVY
DomiVY collected $1 from pot
DomiVY: doesn't show hand 
*** SUMMARY ***
Total pot $1 | Rake $0 
Seat 1: ardo888 folded before Flop (didn't bet)
Seat 3: Rafaello18 folded before Flop (didn't bet)
Seat 4: Konig26 folded before Flop (didn't bet)
Seat 5: matiko09 (button) folded before Flop (didn't bet)
Seat 6: mbk88 (small blind) folded before Flop
Seat 7: DomiVY (big blind) collected ($1)
Seat 9: POTAPENKO700 folded before Flop (didn't bet)





PokerStars Hand #155379401851:  Hold'em No Limit ($0.25/$0.50 USD) - 2016/06/30 13:25:29 CET [2016/06/30 7:25:29 ET]
Table 'Mentha II' 9-max Seat #6 is the button
Seat 2: TheMinion ($50 in chips) 
Seat 3: Alexey_Kim2 ($50 in chips) 
Seat 4: DeathcorePkr ($50.83 in chips) 
Seat 5: matiko09 ($54.04 in chips) 
Seat 6: IceyyF91x ($96.44 in chips) 
Seat 7: ardo888 ($86.07 in chips) 
Seat 8: drlee77 ($43.35 in chips) 
ardo888: posts small blind $0.25
drlee77: posts big blind $0.50
er13to: sits out 
TheMinion: posts the ante $0.10
Alexey_Kim2: posts the ante $0.10
DeathcorePkr: posts the ante $0.10
matiko09: posts the ante $0.10
IceyyF91x: posts the ante $0.10
ardo888: posts the ante $0.10
drlee77: posts the ante $0.10
*** HOLE CARDS ***
Dealt to matiko09 [Kd 7d]
TheMinion: folds 
Alexey_Kim2: folds 
DeathcorePkr: folds 
matiko09: raises $1 to $1.50
IceyyF91x: calls $1.50
ardo888: folds 
drlee77: folds 
*** FLOP *** [Js 7h Qs]
matiko09: checks 
IceyyF91x: checks 
*** TURN *** [Js 7h Qs] [Tc]
matiko09: checks 
IceyyF91x: bets $1.50
matiko09: calls $1.50
*** RIVER *** [Js 7h Qs Tc] [9h]
matiko09: checks 
IceyyF91x: bets $3.50
matiko09: calls $3.50
*** SHOW DOWN ***
IceyyF91x: shows [3d Ks] (a straight, Nine to King)
matiko09: shows [Kd 7d] (a straight, Nine to King)
matiko09 collected $6.87 from pot
IceyyF91x collected $6.86 from pot
*** SUMMARY ***
Total pot $14.45 | Rake $0.72 
Board [Js 7h Qs Tc 9h]
Seat 2: TheMinion folded before Flop (didn't bet)
Seat 3: Alexey_Kim2 folded before Flop (didn't bet)
Seat 4: DeathcorePkr folded before Flop (didn't bet)
Seat 5: matiko09 showed [Kd 7d] and won ($6.87) with a straight, Nine to King
Seat 6: IceyyF91x (button) showed [3d Ks] and won ($6.86) with a straight, Nine to King
Seat 7: ardo888 (small blind) folded before Flop
Seat 8: drlee77 (big blind) folded before Flop





PokerStars Hand #155379403019:  Hold'em No Limit ($0.50/$1.00 USD) - 2016/06/30 13:25:32 CET [2016/06/30 7:25:32 ET]
Table 'Simeisa II' 9-max Seat #3 is the button
Seat 2: Rafaello18 ($139.16 in chips) 
Seat 3: matiko09 ($100 in chips) 
Seat 4: tipner ($100 in chips) 
Seat 5: arctur17 ($58.98 in chips) 
Seat 6: ammit9021 ($37.50 in chips) 
Seat 7: DomiVY ($46.22 in chips) 
Seat 8: picka4u ($100.27 in chips) 
Seat 9: mbk88 ($144.98 in chips) 
tipner: posts small blind $0.50
arctur17: posts big blind $1
*** HOLE CARDS ***
Dealt to matiko09 [5h Js]
ammit9021: calls $1
DomiVY: folds 
picka4u: folds 
mbk88: folds 
Rafaello18: folds 
KovIFish89 joins the table at seat #1 
matiko09: folds 
tipner: folds 
arctur17: checks 
*** FLOP *** [Ts 2s Jh]
arctur17: checks 
ammit9021: checks 
*** TURN *** [Ts 2s Jh] [Jc]
arctur17: checks 
ammit9021: checks 
*** RIVER *** [Ts 2s Jh Jc] [6h]
arctur17: checks 
ammit9021: checks 
*** SHOW DOWN ***
arctur17: shows [3h Kd] (a pair of Jacks)
ammit9021: shows [7d Ac] (a pair of Jacks - Ace kicker)
ammit9021 collected $2.38 from pot
*** SUMMARY ***
Total pot $2.50 | Rake $0.12 
Board [Ts 2s Jh Jc 6h]
Seat 2: Rafaello18 folded before Flop (didn't bet)
Seat 3: matiko09 (button) folded before Flop (didn't bet)
Seat 4: tipner (small blind) folded before Flop
Seat 5: arctur17 (big blind) showed [3h Kd] and lost with a pair of Jacks
Seat 6: ammit9021 showed [7d Ac] and won ($2.38) with a pair of Jacks
Seat 7: DomiVY folded before Flop (didn't bet)
Seat 8: picka4u folded before Flop (didn't bet)
Seat 9: mbk88 folded before Flop (didn't bet)





PokerStars Hand #155379407180:  Hold'em No Limit ($0.50/$1.00 USD) - 2016/06/30 13:25:42 CET [2016/06/30 7:25:42 ET]
Table 'Armisticia' 9-max Seat #8 is the button
Seat 1: di0d80 ($101.50 in chips) 
Seat 2: Rafaello18 ($205.64 in chips) 
Seat 4: DomiVY ($55.74 in chips) 
Seat 5: tipner ($100 in chips) 
Seat 6: matiko09 ($125.12 in chips) 
Seat 7: sanr23 ($101.43 in chips) 
Seat 8: techahn ($117.50 in chips) 
Seat 9: mbk88 ($120.40 in chips) 
mbk88: posts small blind $0.50
di0d80: posts big blind $1
*** HOLE CARDS ***
Dealt to matiko09 [7h Jc]
Rafaello18: folds 
DomiVY: folds 
tipner: folds 
matiko09: folds 
sanr23: raises $1.50 to $2.50
techahn: folds 
mbk88: folds 
di0d80: folds 
Uncalled bet ($1.50) returned to sanr23
sanr23 collected $2.50 from pot
sanr23: doesn't show hand 
*** SUMMARY ***
Total pot $2.50 | Rake $0 
Seat 1: di0d80 (big blind) folded before Flop
Seat 2: Rafaello18 folded before Flop (didn't bet)
Seat 4: DomiVY folded before Flop (didn't bet)
Seat 5: tipner folded before Flop (didn't bet)
Seat 6: matiko09 folded before Flop (didn't bet)
Seat 7: sanr23 collected ($2.50)
Seat 8: techahn (button) folded before Flop (didn't bet)
Seat 9: mbk88 (small blind) folded before Flop





PokerStars Hand #155379411626:  Hold'em No Limit ($0.50/$1.00 USD) - 2016/06/30 13:25:53 CET [2016/06/30 7:25:53 ET]
Table 'Sigrid' 9-max Seat #8 is the button
Seat 1: DomiVY ($40 in chips) 
Seat 2: bearlar ($116.75 in chips) 
Seat 3: Rafaello18 ($118.60 in chips) 
Seat 4: mbk88 ($101.50 in chips) 
Seat 5: DIMAN_324 ($110.24 in chips) 
Seat 6: di0d80 ($118.99 in chips) 
Seat 7: arctur17 ($33 in chips) 
Seat 8: techahn ($138.73 in chips) 
Seat 9: matiko09 ($109.52 in chips) 
matiko09: posts small blind $0.50
DomiVY: posts big blind $1
*** HOLE CARDS ***
Dealt to matiko09 [Qh 9d]
bearlar: raises $2 to $3
Rafaello18: folds 
mbk88: folds 
DIMAN_324: folds 
di0d80: folds 
arctur17: folds 
techahn: calls $3
matiko09: folds 
DomiVY: folds 
*** FLOP *** [3d 5s Kh]
bearlar: checks 
techahn: checks 
*** TURN *** [3d 5s Kh] [Tc]
bearlar: bets $3.56
techahn: calls $3.56
*** RIVER *** [3d 5s Kh Tc] [6h]
bearlar: checks 
techahn: bets $6.94
bearlar: folds 
Uncalled bet ($6.94) returned to techahn
techahn collected $13.89 from pot
techahn: doesn't show hand 
*** SUMMARY ***
Total pot $14.62 | Rake $0.73 
Board [3d 5s Kh Tc 6h]
Seat 1: DomiVY (big blind) folded before Flop
Seat 2: bearlar folded on the River
Seat 3: Rafaello18 folded before Flop (didn't bet)
Seat 4: mbk88 folded before Flop (didn't bet)
Seat 5: DIMAN_324 folded before Flop (didn't bet)
Seat 6: di0d80 folded before Flop (didn't bet)
Seat 7: arctur17 folded before Flop (didn't bet)
Seat 8: techahn (button) collected ($13.89)
Seat 9: matiko09 (small blind) folded before Flop





PokerStars Hand #155379412861:  Hold'em No Limit ($0.50/$1.00 USD) - 2016/06/30 13:25:56 CET [2016/06/30 7:25:56 ET]
Table 'Prieska' 9-max Seat #7 is the button
Seat 4: matteo080613 ($80.50 in chips) 
Seat 5: ramzes160468 ($81 in chips) 
Seat 6: DIMAN_324 ($100 in chips) 
Seat 7: matiko09 ($100 in chips) 
KovIFish89 will be allowed to play after the button
B_style_cuz will be allowed to play after the button
Rafaello18 will be allowed to play after the button
matteo080613: posts small blind $0.50
ramzes160468: posts big blind $1
*** HOLE CARDS ***
Dealt to matiko09 [Ts 8d]
DIMAN_324: folds 
matiko09: folds 
matteo080613: calls $0.50
ramzes160468: checks 
*** FLOP *** [6s Kh 9s]
matteo080613: checks 
ramzes160468: checks 
*** TURN *** [6s Kh 9s] [Ad]
matteo080613: checks 
ramzes160468: bets $1
matteo080613: folds 
Uncalled bet ($1) returned to ramzes160468
ramzes160468 collected $1.90 from pot
*** SUMMARY ***
Total pot $2 | Rake $0.10 
Board [6s Kh 9s Ad]
Seat 4: matteo080613 (small blind) folded on the Turn
Seat 5: ramzes160468 (big blind) collected ($1.90)
Seat 6: DIMAN_324 folded before Flop (didn't bet)
Seat 7: matiko09 (button) folded before Flop (didn't bet)





PokerStars Hand #155379418021:  Hold'em No Limit ($0.50/$1.00 USD) - 2016/06/30 13:26:08 CET [2016/06/30 7:26:08 ET]
Table 'Tatjana' 9-max Seat #6 is the button
Seat 1: ardo888 ($121.24 in chips) 
Seat 3: Rafaello18 ($105.45 in chips) 
Seat 4: Konig26 ($144.08 in chips) 
Seat 5: matiko09 ($103.58 in chips) 
Seat 6: mbk88 ($100 in chips) 
Seat 7: DomiVY ($40.50 in chips) 
Seat 8: alhill86 ($107.65 in chips) 
Seat 9: POTAPENKO700 ($101.50 in chips) 
DomiVY: posts small blind $0.50
alhill86: posts big blind $1
DIMAN_324: sits out 
*** HOLE CARDS ***
Dealt to matiko09 [4c Qh]
POTAPENKO700: folds 
ardo888: folds 
Rafaello18: folds 
Konig26: raises $1.50 to $2.50
matiko09: folds 
mbk88: folds 
DomiVY: folds 
alhill86: folds 
Uncalled bet ($1.50) returned to Konig26
Konig26 collected $2.50 from pot
Konig26: doesn't show hand 
*** SUMMARY ***
Total pot $2.50 | Rake $0 
Seat 1: ardo888 folded before Flop (didn't bet)
Seat 3: Rafaello18 folded before Flop (didn't bet)
Seat 4: Konig26 collected ($2.50)
Seat 5: matiko09 folded before Flop (didn't bet)
Seat 6: mbk88 (button) folded before Flop (didn't bet)
Seat 7: DomiVY (small blind) folded before Flop
Seat 8: alhill86 (big blind) folded before Flop
Seat 9: POTAPENKO700 folded before Flop (didn't bet)





PokerStars Hand #155379420443:  Hold'em No Limit ($0.50/$1.00 USD) - 2016/06/30 13:26:14 CET [2016/06/30 7:26:14 ET]
Table 'Armisticia' 9-max Seat #9 is the button
Seat 1: di0d80 ($100.50 in chips) 
Seat 2: Rafaello18 ($205.64 in chips) 
Seat 4: DomiVY ($55.74 in chips) 
Seat 5: tipner ($100 in chips) 
Seat 6: matiko09 ($125.12 in chips) 
Seat 7: sanr23 ($102.93 in chips) 
Seat 8: techahn ($117.50 in chips) 
Seat 9: mbk88 ($119.90 in chips) 
di0d80: posts small blind $0.50
Rafaello18: posts big blind $1
*** HOLE CARDS ***
Dealt to matiko09 [Ks 9d]
DomiVY: folds 
tipner: folds 
matiko09: folds 
sanr23: folds 
techahn: folds 
mbk88: folds 
di0d80: folds 
Uncalled bet ($0.50) returned to Rafaello18
Rafaello18 collected $1 from pot
Rafaello18: doesn't show hand 
*** SUMMARY ***
Total pot $1 | Rake $0 
Seat 1: di0d80 (small blind) folded before Flop
Seat 2: Rafaello18 (big blind) collected ($1)
Seat 4: DomiVY folded before Flop (didn't bet)
Seat 5: tipner folded before Flop (didn't bet)
Seat 6: matiko09 folded before Flop (didn't bet)
Seat 7: sanr23 folded before Flop (didn't bet)
Seat 8: techahn folded before Flop (didn't bet)
Seat 9: mbk88 (button) folded before Flop (didn't bet)





PokerStars Hand #155379421991:  Hold'em No Limit ($0.25/$0.50 USD) - 2016/06/30 13:26:17 CET [2016/06/30 7:26:17 ET]
Table 'Dorothea II' 9-max Seat #8 is the button
Seat 2: er13to ($50 in chips) 
Seat 3: Franky77200 ($76.63 in chips) 
Seat 4: matiko09 ($83.99 in chips) 
Seat 5: Bailey Dew ($63.07 in chips) 
Seat 6: ivan100886 ($37.90 in chips) 
Seat 7: Alexey_Kim2 ($50 in chips) 
Seat 8: TheMinion ($53.16 in chips) 
Seat 9: ardo888 ($80.04 in chips) 
ardo888: posts small blind $0.25
Vesnushca: is sitting out 
er13to: posts big blind $0.50
er13to: posts the ante $0.10
Franky77200: posts the ante $0.10
matiko09: posts the ante $0.10
Bailey Dew: posts the ante $0.10
ivan100886: posts the ante $0.10
Alexey_Kim2: posts the ante $0.10
TheMinion: posts the ante $0.10
ardo888: posts the ante $0.10
*** HOLE CARDS ***
Dealt to matiko09 [3c 5h]
Franky77200: calls $0.50
matiko09: folds 
Bailey Dew: folds 
ivan100886: folds 
Alexey_Kim2: folds 
TheMinion: folds 
ardo888: raises $2 to $2.50
er13to: folds 
Franky77200: calls $2
*** FLOP *** [3d Kh Qc]
ardo888: bets $3.88
Franky77200: folds 
Uncalled bet ($3.88) returned to ardo888
ardo888 collected $5.98 from pot
ardo888: doesn't show hand 
*** SUMMARY ***
Total pot $6.30 | Rake $0.32 
Board [3d Kh Qc]
Seat 2: er13to (big blind) folded before Flop
Seat 3: Franky77200 folded on the Flop
Seat 4: matiko09 folded before Flop (didn't bet)
Seat 5: Bailey Dew folded before Flop (didn't bet)
Seat 6: ivan100886 folded before Flop (didn't bet)
Seat 7: Alexey_Kim2 folded before Flop (didn't bet)
Seat 8: TheMinion (button) folded before Flop (didn't bet)
Seat 9: ardo888 (small blind) collected ($5.98)





PokerStars Hand #155379426688:  Hold'em No Limit ($0.50/$1.00 USD) - 2016/06/30 13:26:29 CET [2016/06/30 7:26:29 ET]
Table 'California II' 9-max Seat #1 is the button
Seat 1: Rafaello18 ($105.38 in chips) 
Seat 3: liakos120 ($74.22 in chips) 
Seat 4: mbk88 ($114.84 in chips) 
Seat 5: Rohitbarve ($101.36 in chips) 
Seat 6: matiko09 ($110.15 in chips) 
Seat 7: DomiVY ($85 in chips) 
Seat 8: picka4u ($40 in chips) 
Seat 9: di0d80 ($104.66 in chips) 
er13to will be allowed to play after the button
liakos120: posts small blind $0.50
mbk88: posts big blind $1
*** HOLE CARDS ***
Dealt to matiko09 [Kd 7s]
Rohitbarve: folds 
matiko09: folds 
DomiVY: folds 
picka4u: folds 
di0d80: raises $1.50 to $2.50
Rafaello18: folds 
liakos120: folds 
mbk88: folds 
Uncalled bet ($1.50) returned to di0d80
di0d80 collected $2.50 from pot
di0d80: doesn't show hand 
*** SUMMARY ***
Total pot $2.50 | Rake $0 
Seat 1: Rafaello18 (button) folded before Flop (didn't bet)
Seat 3: liakos120 (small blind) folded before Flop
Seat 4: mbk88 (big blind) folded before Flop
Seat 5: Rohitbarve folded before Flop (didn't bet)
Seat 6: matiko09 folded before Flop (didn't bet)
Seat 7: DomiVY folded before Flop (didn't bet)
Seat 8: picka4u folded before Flop (didn't bet)
Seat 9: di0d80 collected ($2.50)





PokerStars Hand #155379428095:  Hold'em No Limit ($0.50/$1.00 USD) - 2016/06/30 13:26:32 CET [2016/06/30 7:26:32 ET]
Table 'Prieska' 9-max Seat #4 is the button
Seat 4: matteo080613 ($79.50 in chips) 
Seat 5: ramzes160468 ($81.90 in chips) 
Seat 6: DIMAN_324 ($100 in chips) 
Seat 7: matiko09 ($100 in chips) 
ramzes160468: posts small blind $0.50
DIMAN_324: posts big blind $1
OMG Dardania: sits out 
KovIFish89: sits out 
B_style_cuz: sits out 
Rafaello18: sits out 
*** HOLE CARDS ***
Dealt to matiko09 [Ad 8c]
matiko09: folds 
matteo080613: folds 
ramzes160468: folds 
Uncalled bet ($0.50) returned to DIMAN_324
DIMAN_324 collected $1 from pot
DIMAN_324: doesn't show hand 
*** SUMMARY ***
Total pot $1 | Rake $0 
Seat 4: matteo080613 (button) folded before Flop (didn't bet)
Seat 5: ramzes160468 (small blind) folded before Flop
Seat 6: DIMAN_324 (big blind) collected ($1)
Seat 7: matiko09 folded before Flop (didn't bet)





PokerStars Hand #155379430416:  Hold'em No Limit ($0.50/$1.00 USD) - 2016/06/30 13:26:37 CET [2016/06/30 7:26:37 ET]
Table 'Askania' 9-max Seat #6 is the button
Seat 1: korlito69 ($44.95 in chips) 
Seat 2: Rafaello18 ($119.52 in chips) 
Seat 3: sasha197728 ($30.72 in chips) 
Seat 4: mbk88 ($117.62 in chips) 
Seat 5: tipner ($103 in chips) 
Seat 6: matiko09 ($242.63 in chips) 
Seat 7: ardo888 ($128.62 in chips) 
Seat 8: DomiVY ($71.50 in chips) 
Seat 9: picka4u ($51.62 in chips) 
ardo888: posts small blind $0.50
DomiVY: posts big blind $1
*** HOLE CARDS ***
Dealt to matiko09 [Ad Ts]
picka4u: folds 
korlito69: folds 
Rafaello18: folds 
sasha197728: raises $1 to $2
mbk88: folds 
tipner: folds 
matiko09: raises $4 to $6
ardo888: folds 
DomiVY: folds 
sasha197728: calls $4
*** FLOP *** [Ah Ac 8c]
sasha197728: bets $5
matiko09: calls $5
*** TURN *** [Ah Ac 8c] [Qs]
sasha197728: bets $5
matiko09: calls $5
*** RIVER *** [Ah Ac 8c Qs] [6c]
sasha197728: bets $14.72 and is all-in
matiko09: calls $14.72
*** SHOW DOWN ***
sasha197728: shows [9s Kc] (a pair of Aces)
matiko09: shows [Ad Ts] (three of a kind, Aces)
matiko09 collected $60.44 from pot
*** SUMMARY ***
Total pot $62.94 | Rake $2.50 
Board [Ah Ac 8c Qs 6c]
Seat 1: korlito69 folded before Flop (didn't bet)
Seat 2: Rafaello18 folded before Flop (didn't bet)
Seat 3: sasha197728 showed [9s Kc] and lost with a pair of Aces
Seat 4: mbk88 folded before Flop (didn't bet)
Seat 5: tipner folded before Flop (didn't bet)
Seat 6: matiko09 (button) showed [Ad Ts] and won ($60.44) with three of a kind, Aces
Seat 7: ardo888 (small blind) folded before Flop
Seat 8: DomiVY (big blind) folded before Flop
Seat 9: picka4u folded before Flop (didn't bet)





PokerStars Hand #155379431101:  Hold'em No Limit ($0.50/$1.00 USD) - 2016/06/30 13:26:39 CET [2016/06/30 7:26:39 ET]
Table 'Tatjana' 9-max Seat #7 is the button
Seat 1: ardo888 ($121.24 in chips) 
Seat 3: Rafaello18 ($105.45 in chips) 
Seat 4: Konig26 ($145.58 in chips) 
Seat 5: matiko09 ($103.58 in chips) 
Seat 6: mbk88 ($100 in chips) 
Seat 7: DomiVY ($40 in chips) 
Seat 8: alhill86 ($106.65 in chips) 
Seat 9: POTAPENKO700 ($101.50 in chips) 
alhill86: posts small blind $0.50
POTAPENKO700: posts big blind $1
DIMAN_324: sits out 
*** HOLE CARDS ***
Dealt to matiko09 [3d Kc]
ardo888: folds 
Rafaello18: folds 
Konig26: folds 
matiko09: folds 
mbk88: folds 
DomiVY: folds 
alhill86: folds 
Uncalled bet ($0.50) returned to POTAPENKO700
POTAPENKO700 collected $1 from pot
POTAPENKO700: doesn't show hand 
*** SUMMARY ***
Total pot $1 | Rake $0 
Seat 1: ardo888 folded before Flop (didn't bet)
Seat 3: Rafaello18 folded before Flop (didn't bet)
Seat 4: Konig26 folded before Flop (didn't bet)
Seat 5: matiko09 folded before Flop (didn't bet)
Seat 6: mbk88 folded before Flop (didn't bet)
Seat 7: DomiVY (button) folded before Flop (didn't bet)
Seat 8: alhill86 (small blind) folded before Flop
Seat 9: POTAPENKO700 (big blind) collected ($1)





PokerStars Hand #155379432951:  Hold'em No Limit ($0.50/$1.00 USD) - 2016/06/30 13:26:43 CET [2016/06/30 7:26:43 ET]
Table 'Borrelly II' 9-max Seat #3 is the button
Seat 1: Rafaello18 ($130.38 in chips) 
Seat 2: tipner ($130.07 in chips) 
Seat 3: di0d80 ($101 in chips) 
Seat 4: DonRon_AT ($50.06 in chips) 
Seat 5: picka4u ($124.89 in chips) 
Seat 6: m_michalec ($164.88 in chips) 
Seat 7: matiko09 ($161.85 in chips) 
Seat 8: mbk88 ($100 in chips) 
Seat 9: makaveli978 ($24.55 in chips) 
DonRon_AT: posts small blind $0.50
picka4u: posts big blind $1
*** HOLE CARDS ***
Dealt to matiko09 [Js 3d]
m_michalec: folds 
matiko09: folds 
mbk88: folds 
makaveli978: folds 
Rafaello18: folds 
tipner: folds 
di0d80: raises $1 to $2
DonRon_AT: folds 
picka4u: calls $1
*** FLOP *** [2s Jh Kd]
picka4u: checks 
di0d80: checks 
*** TURN *** [2s Jh Kd] [Qs]
picka4u: bets $3
di0d80: folds 
Uncalled bet ($3) returned to picka4u
picka4u collected $4.28 from pot
picka4u: doesn't show hand 
*** SUMMARY ***
Total pot $4.50 | Rake $0.22 
Board [2s Jh Kd Qs]
Seat 1: Rafaello18 folded before Flop (didn't bet)
Seat 2: tipner folded before Flop (didn't bet)
Seat 3: di0d80 (button) folded on the Turn
Seat 4: DonRon_AT (small blind) folded before Flop
Seat 5: picka4u (big blind) collected ($4.28)
Seat 6: m_michalec folded before Flop (didn't bet)
Seat 7: matiko09 folded before Flop (didn't bet)
Seat 8: mbk88 folded before Flop (didn't bet)
Seat 9: makaveli978 folded before Flop (didn't bet)





PokerStars Hand #155379432929:  Hold'em No Limit ($0.50/$1.00 USD) - 2016/06/30 13:26:43 CET [2016/06/30 7:26:43 ET]
Table 'Prieska' 9-max Seat #5 is the button
Seat 4: matteo080613 ($79.50 in chips) 
Seat 5: ramzes160468 ($81.40 in chips) 
Seat 6: DIMAN_324 ($100.50 in chips) 
Seat 7: matiko09 ($100 in chips) 
DIMAN_324: posts small blind $0.50
matiko09: posts big blind $1
OMG Dardania: sits out 
KovIFish89: sits out 
B_style_cuz: sits out 
Rafaello18: sits out 
*** HOLE CARDS ***
Dealt to matiko09 [5d 8d]
matteo080613: folds 
ramzes160468: folds 
DIMAN_324: folds 
Uncalled bet ($0.50) returned to matiko09
matiko09 collected $1 from pot
matiko09: doesn't show hand 
*** SUMMARY ***
Total pot $1 | Rake $0 
Seat 4: matteo080613 folded before Flop (didn't bet)
Seat 5: ramzes160468 (button) folded before Flop (didn't bet)
Seat 6: DIMAN_324 (small blind) folded before Flop
Seat 7: matiko09 (big blind) collected ($1)





PokerStars Hand #155379432730:  Hold'em No Limit ($0.50/$1.00 USD) - 2016/06/30 13:26:43 CET [2016/06/30 7:26:43 ET]
Table 'Armisticia' 9-max Seat #1 is the button
Seat 1: di0d80 ($100 in chips) 
Seat 2: Rafaello18 ($206.14 in chips) 
Seat 4: DomiVY ($55.74 in chips) 
Seat 5: tipner ($100 in chips) 
Seat 6: matiko09 ($125.12 in chips) 
Seat 7: sanr23 ($102.93 in chips) 
Seat 8: techahn ($117.50 in chips) 
Seat 9: mbk88 ($119.90 in chips) 
Rafaello18: posts small blind $0.50
DomiVY: posts big blind $1
*** HOLE CARDS ***
Dealt to matiko09 [2d Ts]
tipner: folds 
matiko09: folds 
sanr23: folds 
techahn: folds 
mbk88: folds 
di0d80: raises $1 to $2
Rafaello18: calls $1.50
DomiVY: folds 
*** FLOP *** [Ac 9h Ad]
Rafaello18: checks 
di0d80: checks 
*** TURN *** [Ac 9h Ad] [Tc]
Rafaello18: bets $2.50
di0d80: folds 
Uncalled bet ($2.50) returned to Rafaello18
Rafaello18 collected $4.75 from pot
Rafaello18: doesn't show hand 
*** SUMMARY ***
Total pot $5 | Rake $0.25 
Board [Ac 9h Ad Tc]
Seat 1: di0d80 (button) folded on the Turn
Seat 2: Rafaello18 (small blind) collected ($4.75)
Seat 4: DomiVY (big blind) folded before Flop
Seat 5: tipner folded before Flop (didn't bet)
Seat 6: matiko09 folded before Flop (didn't bet)
Seat 7: sanr23 folded before Flop (didn't bet)
Seat 8: techahn folded before Flop (didn't bet)
Seat 9: mbk88 folded before Flop (didn't bet)





PokerStars Hand #155379434174:  Hold'em No Limit ($0.50/$1.00 USD) - 2016/06/30 13:26:46 CET [2016/06/30 7:26:46 ET]
Table 'Simeisa II' 9-max Seat #4 is the button
Seat 2: Rafaello18 ($139.16 in chips) 
Seat 3: matiko09 ($100 in chips) 
Seat 4: tipner ($100 in chips) 
Seat 5: arctur17 ($57.98 in chips) 
Seat 6: ammit9021 ($38.88 in chips) 
Seat 7: DomiVY ($46.22 in chips) 
Seat 8: picka4u ($100.27 in chips) 
Seat 9: mbk88 ($144.98 in chips) 
arctur17: posts small blind $0.50
ammit9021: posts big blind $1
KovIFish89: sits out 
*** HOLE CARDS ***
Dealt to matiko09 [2d 8d]
DomiVY: folds 
picka4u: folds 
mbk88: folds 
Rafaello18: folds 
matiko09: folds 
tipner: folds 
arctur17: raises $2 to $3
ammit9021: folds 
Uncalled bet ($2) returned to arctur17
arctur17 collected $2 from pot
arctur17: doesn't show hand 
*** SUMMARY ***
Total pot $2 | Rake $0 
Seat 2: Rafaello18 folded before Flop (didn't bet)
Seat 3: matiko09 folded before Flop (didn't bet)
Seat 4: tipner (button) folded before Flop (didn't bet)
Seat 5: arctur17 (small blind) collected ($2)
Seat 6: ammit9021 (big blind) folded before Flop
Seat 7: DomiVY folded before Flop (didn't bet)
Seat 8: picka4u folded before Flop (didn't bet)
Seat 9: mbk88 folded before Flop (didn't bet)





PokerStars Hand #155379434729:  Hold'em No Limit ($0.50/$1.00 USD) - 2016/06/30 13:26:48 CET [2016/06/30 7:26:48 ET]
Table 'Sigrid' 9-max Seat #9 is the button
Seat 1: DomiVY ($40 in chips) 
Seat 2: bearlar ($110.19 in chips) 
Seat 3: Rafaello18 ($118.60 in chips) 
Seat 4: mbk88 ($101.50 in chips) 
Seat 5: DIMAN_324 ($110.24 in chips) 
Seat 6: di0d80 ($118.99 in chips) 
Seat 7: arctur17 ($33 in chips) 
Seat 8: techahn ($146.06 in chips) 
Seat 9: matiko09 ($109.02 in chips) 
DomiVY: posts small blind $0.50
bearlar: posts big blind $1
*** HOLE CARDS ***
Dealt to matiko09 [5d 3h]
Rafaello18: folds 
mbk88: folds 
DIMAN_324: folds 
di0d80: folds 
arctur17: folds 
techahn: folds 
matiko09: folds 
DomiVY: raises $1.10 to $2.10
bearlar: folds 
Uncalled bet ($1.10) returned to DomiVY
DomiVY collected $2 from pot
DomiVY: doesn't show hand 
*** SUMMARY ***
Total pot $2 | Rake $0 
Seat 1: DomiVY (small blind) collected ($2)
Seat 2: bearlar (big blind) folded before Flop
Seat 3: Rafaello18 folded before Flop (didn't bet)
Seat 4: mbk88 folded before Flop (didn't bet)
Seat 5: DIMAN_324 folded before Flop (didn't bet)
Seat 6: di0d80 folded before Flop (didn't bet)
Seat 7: arctur17 folded before Flop (didn't bet)
Seat 8: techahn folded before Flop (didn't bet)
Seat 9: matiko09 (button) folded before Flop (didn't bet)





PokerStars Hand #155379435402:  Hold'em No Limit ($0.50/$1.00 USD) - 2016/06/30 13:26:49 CET [2016/06/30 7:26:49 ET]
Table 'California II' 9-max Seat #3 is the button
Seat 1: Rafaello18 ($105.38 in chips) 
Seat 3: liakos120 ($73.72 in chips) 
Seat 4: mbk88 ($113.84 in chips) 
Seat 5: Rohitbarve ($101.36 in chips) 
Seat 6: matiko09 ($110.15 in chips) 
Seat 7: DomiVY ($85 in chips) 
Seat 8: picka4u ($40 in chips) 
Seat 9: di0d80 ($106.16 in chips) 
mbk88: posts small blind $0.50
Rohitbarve: posts big blind $1
er13to: sits out 
*** HOLE CARDS ***
Dealt to matiko09 [Ah 8d]
matiko09: folds 
DomiVY: raises $2 to $3
picka4u: folds 
di0d80: folds 
Rafaello18: folds 
liakos120: raises $3 to $6
mbk88: folds 
Rohitbarve: folds 
DomiVY: calls $3
*** FLOP *** [3h Qs 2c]
DomiVY: checks 
liakos120: bets $6
DomiVY: folds 
Uncalled bet ($6) returned to liakos120
liakos120 collected $12.82 from pot
liakos120: doesn't show hand 
*** SUMMARY ***
Total pot $13.50 | Rake $0.68 
Board [3h Qs 2c]
Seat 1: Rafaello18 folded before Flop (didn't bet)
Seat 3: liakos120 (button) collected ($12.82)
Seat 4: mbk88 (small blind) folded before Flop
Seat 5: Rohitbarve (big blind) folded before Flop
Seat 6: matiko09 folded before Flop (didn't bet)
Seat 7: DomiVY folded on the Flop
Seat 8: picka4u folded before Flop (didn't bet)
Seat 9: di0d80 folded before Flop (didn't bet)





PokerStars Hand #155379438897:  Hold'em No Limit ($0.50/$1.00 USD) - 2016/06/30 13:26:58 CET [2016/06/30 7:26:58 ET]
Table 'Prieska' 9-max Seat #6 is the button
Seat 4: matteo080613 ($79.50 in chips) 
Seat 5: ramzes160468 ($81.40 in chips) 
Seat 6: DIMAN_324 ($100 in chips) 
Seat 7: matiko09 ($100.50 in chips) 
Seat 9: OMG Dardania ($100 in chips) 
matiko09: posts small blind $0.50
OMG Dardania: posts big blind $1
KovIFish89: sits out 
B_style_cuz: sits out 
Rafaello18: sits out 
*** HOLE CARDS ***
Dealt to matiko09 [Kc Ts]
matteo080613: folds 
ramzes160468: folds 
DIMAN_324: raises $1.10 to $2.10
matiko09: folds 
tipner leaves the table
mbk88 joins the table at seat #8 
OMG Dardania: calls $1.10
*** FLOP *** [2s Tc 5d]
OMG Dardania: checks 
DIMAN_324: bets $2.23
OMG Dardania: calls $2.23
*** TURN *** [2s Tc 5d] [9c]
OMG Dardania: checks 
DIMAN_324: checks 
*** RIVER *** [2s Tc 5d 9c] [Ad]
OMG Dardania: checks 
DIMAN_324: bets $3.50
OMG Dardania: folds 
Uncalled bet ($3.50) returned to DIMAN_324
DIMAN_324 collected $8.70 from pot
DIMAN_324: doesn't show hand 
*** SUMMARY ***
Total pot $9.16 | Rake $0.46 
Board [2s Tc 5d 9c Ad]
Seat 4: matteo080613 folded before Flop (didn't bet)
Seat 5: ramzes160468 folded before Flop (didn't bet)
Seat 6: DIMAN_324 (button) collected ($8.70)
Seat 7: matiko09 (small blind) folded before Flop
Seat 9: OMG Dardania (big blind) folded on the River





PokerStars Hand #155379439462:  Hold'em No Limit ($0.25/$0.50 USD) - 2016/06/30 13:26:59 CET [2016/06/30 7:26:59 ET]
Table 'Dorothea II' 9-max Seat #9 is the button
Seat 2: er13to ($50 in chips) 
Seat 3: Franky77200 ($74.03 in chips) 
Seat 4: matiko09 ($83.89 in chips) 
Seat 5: Bailey Dew ($62.97 in chips) 
Seat 6: ivan100886 ($37.80 in chips) 
Seat 7: Alexey_Kim2 ($50 in chips) 
Seat 8: TheMinion ($53.06 in chips) 
Seat 9: ardo888 ($83.42 in chips) 
er13to: posts small blind $0.25
Franky77200: posts big blind $0.50
er13to: posts the ante $0.10
Franky77200: posts the ante $0.10
matiko09: posts the ante $0.10
Bailey Dew: posts the ante $0.10
ivan100886: posts the ante $0.10
Alexey_Kim2: posts the ante $0.10
TheMinion: posts the ante $0.10
ardo888: posts the ante $0.10
*** HOLE CARDS ***
Dealt to matiko09 [4d 7d]
matiko09: folds 
Bailey Dew: folds 
ivan100886: raises $0.75 to $1.25
Alexey_Kim2: folds 
TheMinion: folds 
ardo888: folds 
er13to: folds 
Franky77200: calls $0.75
*** FLOP *** [Td 6d Ad]
Franky77200: checks 
ivan100886: bets $2.35
Franky77200: calls $2.35
*** TURN *** [Td 6d Ad] [4s]
Franky77200: checks 
ivan100886: bets $5
Franky77200: calls $5
*** RIVER *** [Td 6d Ad 4s] [Qc]
Franky77200: checks 
ivan100886: checks 
*** SHOW DOWN ***
Franky77200: shows [Kd Jc] (a straight, Ten to Ace)
ivan100886: mucks hand 
Franky77200 collected $17.34 from pot
*** SUMMARY ***
Total pot $18.25 | Rake $0.91 
Board [Td 6d Ad 4s Qc]
Seat 2: er13to (small blind) folded before Flop
Seat 3: Franky77200 (big blind) showed [Kd Jc] and won ($17.34) with a straight, Ten to Ace
Seat 4: matiko09 folded before Flop (didn't bet)
Seat 5: Bailey Dew folded before Flop (didn't bet)
Seat 6: ivan100886 mucked [8c Tc]
Seat 7: Alexey_Kim2 folded before Flop (didn't bet)
Seat 8: TheMinion folded before Flop (didn't bet)
Seat 9: ardo888 (button) folded before Flop (didn't bet)





PokerStars Hand #155379440314:  Hold'em No Limit ($0.50/$1.00 USD) - 2016/06/30 13:27:01 CET [2016/06/30 7:27:01 ET]
Table 'Tatjana' 9-max Seat #8 is the button
Seat 1: ardo888 ($121.24 in chips) 
Seat 3: Rafaello18 ($105.45 in chips) 
Seat 4: Konig26 ($145.58 in chips) 
Seat 5: matiko09 ($103.58 in chips) 
Seat 6: mbk88 ($100 in chips) 
Seat 7: DomiVY ($40 in chips) 
Seat 8: alhill86 ($106.15 in chips) 
Seat 9: POTAPENKO700 ($102 in chips) 
POTAPENKO700: posts small blind $0.50
ardo888: posts big blind $1
DIMAN_324: sits out 
*** HOLE CARDS ***
Dealt to matiko09 [6c 3s]
Rafaello18: raises $1.50 to $2.50
Konig26: calls $2.50
matiko09: folds 
mbk88: folds 
DomiVY: folds 
alhill86: folds 
POTAPENKO700: folds 
ardo888: folds 
*** FLOP *** [2c Qh 2s]
Rafaello18: bets $3.15
Konig26: folds 
Uncalled bet ($3.15) returned to Rafaello18
Rafaello18 collected $6.18 from pot
Rafaello18: doesn't show hand 
*** SUMMARY ***
Total pot $6.50 | Rake $0.32 
Board [2c Qh 2s]
Seat 1: ardo888 (big blind) folded before Flop
Seat 3: Rafaello18 collected ($6.18)
Seat 4: Konig26 folded on the Flop
Seat 5: matiko09 folded before Flop (didn't bet)
Seat 6: mbk88 folded before Flop (didn't bet)
Seat 7: DomiVY folded before Flop (didn't bet)
Seat 8: alhill86 (button) folded before Flop (didn't bet)
Seat 9: POTAPENKO700 (small blind) folded before Flop





PokerStars Hand #155379442137:  Hold'em No Limit ($0.50/$1.00 USD) - 2016/06/30 13:27:05 CET [2016/06/30 7:27:05 ET]
Table 'Simeisa II' 9-max Seat #5 is the button
Seat 2: Rafaello18 ($139.16 in chips) 
Seat 3: matiko09 ($100 in chips) 
Seat 4: tipner ($100 in chips) 
Seat 5: arctur17 ($58.98 in chips) 
Seat 6: ammit9021 ($37.88 in chips) 
Seat 7: DomiVY ($46.22 in chips) 
Seat 8: picka4u ($100.27 in chips) 
Seat 9: mbk88 ($144.98 in chips) 
ammit9021: posts small blind $0.50
DomiVY: posts big blind $1
KovIFish89: sits out 
*** HOLE CARDS ***
Dealt to matiko09 [7h 4h]
picka4u: folds 
mbk88: folds 
Rafaello18: folds 
matiko09: folds 
tipner: folds 
arctur17: raises $2 to $3
ammit9021: folds 
DomiVY: folds 
Uncalled bet ($2) returned to arctur17
arctur17 collected $2.50 from pot
arctur17: doesn't show hand 
*** SUMMARY ***
Total pot $2.50 | Rake $0 
Seat 2: Rafaello18 folded before Flop (didn't bet)
Seat 3: matiko09 folded before Flop (didn't bet)
Seat 4: tipner folded before Flop (didn't bet)
Seat 5: arctur17 (button) collected ($2.50)
Seat 6: ammit9021 (small blind) folded before Flop
Seat 7: DomiVY (big blind) folded before Flop
Seat 8: picka4u folded before Flop (didn't bet)
Seat 9: mbk88 folded before Flop (didn't bet)





PokerStars Hand #155379447716:  Hold'em No Limit ($0.50/$1.00 USD) - 2016/06/30 13:27:19 CET [2016/06/30 7:27:19 ET]
Table 'Sigrid' 9-max Seat #1 is the button
Seat 1: DomiVY ($41 in chips) 
Seat 2: bearlar ($109.19 in chips) 
Seat 3: Rafaello18 ($118.60 in chips) 
Seat 4: mbk88 ($101.50 in chips) 
Seat 5: DIMAN_324 ($110.24 in chips) 
Seat 6: di0d80 ($118.99 in chips) 
Seat 7: arctur17 ($33 in chips) 
Seat 8: techahn ($146.06 in chips) 
Seat 9: matiko09 ($109.02 in chips) 
bearlar: posts small blind $0.50
Rafaello18: posts big blind $1
*** HOLE CARDS ***
Dealt to matiko09 [6c 9s]
mbk88: folds 
DIMAN_324: folds 
di0d80: folds 
arctur17: folds 
techahn: folds 
matiko09: folds 
DomiVY: raises $1.10 to $2.10
bearlar: folds 
Rafaello18: calls $1.10
*** FLOP *** [8d 3s 2c]
Rafaello18: checks 
DomiVY: bets $3
Rafaello18: folds 
Uncalled bet ($3) returned to DomiVY
DomiVY collected $4.46 from pot
DomiVY: doesn't show hand 
*** SUMMARY ***
Total pot $4.70 | Rake $0.24 
Board [8d 3s 2c]
Seat 1: DomiVY (button) collected ($4.46)
Seat 2: bearlar (small blind) folded before Flop
Seat 3: Rafaello18 (big blind) folded on the Flop
Seat 4: mbk88 folded before Flop (didn't bet)
Seat 5: DIMAN_324 folded before Flop (didn't bet)
Seat 6: di0d80 folded before Flop (didn't bet)
Seat 7: arctur17 folded before Flop (didn't bet)
Seat 8: techahn folded before Flop (didn't bet)
Seat 9: matiko09 folded before Flop (didn't bet)





PokerStars Hand #155379453638:  Hold'em No Limit ($0.50/$1.00 USD) - 2016/06/30 13:27:33 CET [2016/06/30 7:27:33 ET]
Table 'Askania' 9-max Seat #7 is the button
Seat 1: korlito69 ($44.95 in chips) 
Seat 2: Rafaello18 ($119.52 in chips) 
Seat 4: mbk88 ($117.62 in chips) 
Seat 5: tipner ($103 in chips) 
Seat 6: matiko09 ($272.35 in chips) 
Seat 7: ardo888 ($128.12 in chips) 
Seat 8: DomiVY ($70.50 in chips) 
Seat 9: picka4u ($51.62 in chips) 
DomiVY: posts small blind $0.50
picka4u: posts big blind $1
*** HOLE CARDS ***
Dealt to matiko09 [2h 2c]
sasha197728 leaves the table
korlito69: folds 
Rafaello18: folds 
mbk88: raises $2 to $3
tipner: folds 
matiko09: folds 
DIMAN_324 joins the table at seat #3 
ardo888: folds 
DomiVY: folds 
picka4u: folds 
Uncalled bet ($2) returned to mbk88
mbk88 collected $2.50 from pot
mbk88: doesn't show hand 
*** SUMMARY ***
Total pot $2.50 | Rake $0 
Seat 1: korlito69 folded before Flop (didn't bet)
Seat 2: Rafaello18 folded before Flop (didn't bet)
Seat 4: mbk88 collected ($2.50)
Seat 5: tipner folded before Flop (didn't bet)
Seat 6: matiko09 folded before Flop (didn't bet)
Seat 7: ardo888 (button) folded before Flop (didn't bet)
Seat 8: DomiVY (small blind) folded before Flop
Seat 9: picka4u (big blind) folded before Flop





PokerStars Hand #155379455721:  Hold'em No Limit ($0.25/$0.50 USD) - 2016/06/30 13:27:38 CET [2016/06/30 7:27:38 ET]
Table 'Mentha II' 9-max Seat #7 is the button
Seat 2: TheMinion ($50 in chips) 
Seat 3: Alexey_Kim2 ($50 in chips) 
Seat 5: matiko09 ($54.31 in chips) 
Seat 6: IceyyF91x ($96.70 in chips) 
Seat 7: ardo888 ($85.72 in chips) 
Seat 8: drlee77 ($42.75 in chips) 
Seat 9: er13to ($55.95 in chips) 
drlee77: posts small blind $0.25
er13to: posts big blind $0.50
Bailey Dew: sits out 
TheMinion: posts the ante $0.10
Alexey_Kim2: posts the ante $0.10
matiko09: posts the ante $0.10
IceyyF91x: posts the ante $0.10
ardo888: posts the ante $0.10
drlee77: posts the ante $0.10
er13to: posts the ante $0.10
*** HOLE CARDS ***
Dealt to matiko09 [5c 2d]
TheMinion: folds 
Alexey_Kim2: folds 
matiko09: folds 
IceyyF91x: raises $2 to $2.50
ardo888: folds 
DeathcorePkr leaves the table
drlee77: folds 
er13to: folds 
Uncalled bet ($2) returned to IceyyF91x
IceyyF91x collected $1.95 from pot
IceyyF91x: doesn't show hand 
*** SUMMARY ***
Total pot $1.95 | Rake $0 
Seat 2: TheMinion folded before Flop (didn't bet)
Seat 3: Alexey_Kim2 folded before Flop (didn't bet)
Seat 5: matiko09 folded before Flop (didn't bet)
Seat 6: IceyyF91x collected ($1.95)
Seat 7: ardo888 (button) folded before Flop (didn't bet)
Seat 8: drlee77 (small blind) folded before Flop
Seat 9: er13to (big blind) folded before Flop





PokerStars Hand #155379463639:  Hold'em No Limit ($0.50/$1.00 USD) - 2016/06/30 13:27:57 CET [2016/06/30 7:27:57 ET]
Table 'California II' 9-max Seat #4 is the button
Seat 1: Rafaello18 ($105.38 in chips) 
Seat 3: liakos120 ($80.54 in chips) 
Seat 4: mbk88 ($113.34 in chips) 
Seat 5: Rohitbarve ($100.36 in chips) 
Seat 6: matiko09 ($110.15 in chips) 
Seat 7: DomiVY ($79 in chips) 
Seat 8: picka4u ($40 in chips) 
Seat 9: di0d80 ($106.16 in chips) 
Rohitbarve: posts small blind $0.50
matiko09: posts big blind $1
er13to: sits out 
*** HOLE CARDS ***
Dealt to matiko09 [9c 4d]
DomiVY: folds 
picka4u: folds 
di0d80: folds 
Rafaello18: folds 
liakos120: folds 
mbk88: folds 
Rohitbarve: folds 
Uncalled bet ($0.50) returned to matiko09
matiko09 collected $1 from pot
matiko09: doesn't show hand 
*** SUMMARY ***
Total pot $1 | Rake $0 
Seat 1: Rafaello18 folded before Flop (didn't bet)
Seat 3: liakos120 folded before Flop (didn't bet)
Seat 4: mbk88 (button) folded before Flop (didn't bet)
Seat 5: Rohitbarve (small blind) folded before Flop
Seat 6: matiko09 (big blind) collected ($1)
Seat 7: DomiVY folded before Flop (didn't bet)
Seat 8: picka4u folded before Flop (didn't bet)
Seat 9: di0d80 folded before Flop (didn't bet)





PokerStars Hand #155379464285:  Hold'em No Limit ($0.50/$1.00 USD) - 2016/06/30 13:27:58 CET [2016/06/30 7:27:58 ET]
Table 'Simeisa II' 9-max Seat #6 is the button
Seat 2: Rafaello18 ($139.16 in chips) 
Seat 3: matiko09 ($100 in chips) 
Seat 4: tipner ($100 in chips) 
Seat 5: arctur17 ($60.48 in chips) 
Seat 6: ammit9021 ($37.38 in chips) 
Seat 7: DomiVY ($45.22 in chips) 
Seat 8: picka4u ($100.27 in chips) 
Seat 9: mbk88 ($144.98 in chips) 
DomiVY: posts small blind $0.50
picka4u: posts big blind $1
KovIFish89: sits out 
*** HOLE CARDS ***
Dealt to matiko09 [2c 2h]
mbk88: raises $2 to $3
Rafaello18: folds 
matiko09: folds 
tipner: folds 
arctur17: folds 
ammit9021: folds 
DomiVY: folds 
picka4u: folds 
Uncalled bet ($2) returned to mbk88
mbk88 collected $2.50 from pot
mbk88: doesn't show hand 
*** SUMMARY ***
Total pot $2.50 | Rake $0 
Seat 2: Rafaello18 folded before Flop (didn't bet)
Seat 3: matiko09 folded before Flop (didn't bet)
Seat 4: tipner folded before Flop (didn't bet)
Seat 5: arctur17 folded before Flop (didn't bet)
Seat 6: ammit9021 (button) folded before Flop (didn't bet)
Seat 7: DomiVY (small blind) folded before Flop
Seat 8: picka4u (big blind) folded before Flop
Seat 9: mbk88 collected ($2.50)





PokerStars Hand #155379464887:  Hold'em No Limit ($0.50/$1.00 USD) - 2016/06/30 13:27:59 CET [2016/06/30 7:27:59 ET]
Table 'Armisticia' 9-max Seat #2 is the button
Seat 1: di0d80 ($100 in chips) 
Seat 2: Rafaello18 ($208.89 in chips) 
Seat 4: DomiVY ($54.74 in chips) 
Seat 5: tipner ($100 in chips) 
Seat 6: matiko09 ($125.12 in chips) 
Seat 7: sanr23 ($102.93 in chips) 
Seat 8: techahn ($117.50 in chips) 
Seat 9: mbk88 ($119.90 in chips) 
DomiVY: posts small blind $0.50
tipner: posts big blind $1
*** HOLE CARDS ***
Dealt to matiko09 [2h Kc]
matiko09: folds 
sanr23: folds 
techahn: folds 
mbk88: folds 
di0d80: folds 
Rafaello18: folds 
DomiVY: raises $1.10 to $2.10
tipner: folds 
Uncalled bet ($1.10) returned to DomiVY
DomiVY collected $2 from pot
DomiVY: doesn't show hand 
*** SUMMARY ***
Total pot $2 | Rake $0 
Seat 1: di0d80 folded before Flop (didn't bet)
Seat 2: Rafaello18 (button) folded before Flop (didn't bet)
Seat 4: DomiVY (small blind) collected ($2)
Seat 5: tipner (big blind) folded before Flop
Seat 6: matiko09 folded before Flop (didn't bet)
Seat 7: sanr23 folded before Flop (didn't bet)
Seat 8: techahn folded before Flop (didn't bet)
Seat 9: mbk88 folded before Flop (didn't bet)





PokerStars Hand #155379466999:  Hold'em No Limit ($0.50/$1.00 USD) - 2016/06/30 13:28:04 CET [2016/06/30 7:28:04 ET]
Table 'Tatjana' 9-max Seat #9 is the button
Seat 1: ardo888 ($120.24 in chips) 
Seat 2: DIMAN_324 ($100 in chips) 
Seat 3: Rafaello18 ($109.13 in chips) 
Seat 4: Konig26 ($143.08 in chips) 
Seat 5: matiko09 ($103.58 in chips) 
Seat 6: mbk88 ($100 in chips) 
Seat 7: DomiVY ($40 in chips) 
Seat 8: alhill86 ($106.15 in chips) 
Seat 9: POTAPENKO700 ($101.50 in chips) 
ardo888: posts small blind $0.50
DIMAN_324: posts big blind $1
*** HOLE CARDS ***
Dealt to matiko09 [2c Kh]
Rafaello18: folds 
Konig26: folds 
matiko09: folds 
mbk88: folds 
DomiVY: folds 
alhill86: folds 
POTAPENKO700: folds 
ardo888: folds 
Uncalled bet ($0.50) returned to DIMAN_324
DIMAN_324 collected $1 from pot
DIMAN_324: doesn't show hand 
*** SUMMARY ***
Total pot $1 | Rake $0 
Seat 1: ardo888 (small blind) folded before Flop
Seat 2: DIMAN_324 (big blind) collected ($1)
Seat 3: Rafaello18 folded before Flop (didn't bet)
Seat 4: Konig26 folded before Flop (didn't bet)
Seat 5: matiko09 folded before Flop (didn't bet)
Seat 6: mbk88 folded before Flop (didn't bet)
Seat 7: DomiVY folded before Flop (didn't bet)
Seat 8: alhill86 folded before Flop (didn't bet)
Seat 9: POTAPENKO700 (button) folded before Flop (didn't bet)





PokerStars Hand #155379469674:  Hold'em No Limit ($0.50/$1.00 USD) - 2016/06/30 13:28:11 CET [2016/06/30 7:28:11 ET]
Table 'Asmodeus' 9-max Seat #2 is the button
Seat 1: scollop ($107.69 in chips) 
Seat 2: picka4u ($45.02 in chips) 
Seat 3: matiko09 ($100 in chips) 
Seat 4: ardo888 ($143.28 in chips) 
Seat 5: sanr23 ($105.16 in chips) 
Seat 6: koutani7 ($89.50 in chips) 
Seat 7: aaronzzr ($149.11 in chips) 
Seat 8: Rafaello18 ($133.10 in chips) 
Seat 9: mbk88 ($163.50 in chips) 
matiko09: posts small blind $0.50
ardo888: posts big blind $1
*** HOLE CARDS ***
Dealt to matiko09 [Qh 6h]
sanr23: folds 
koutani7: folds 
aaronzzr: folds 
Rafaello18: raises $1.50 to $2.50
mbk88: calls $2.50
scollop: folds 
picka4u: folds 
matiko09: folds 
ardo888: folds 
*** FLOP *** [7s 8c 6d]
Rafaello18: checks 
mbk88: bets $3
Rafaello18: folds 
Uncalled bet ($3) returned to mbk88
mbk88 collected $6.18 from pot
mbk88: doesn't show hand 
*** SUMMARY ***
Total pot $6.50 | Rake $0.32 
Board [7s 8c 6d]
Seat 1: scollop folded before Flop (didn't bet)
Seat 2: picka4u (button) folded before Flop (didn't bet)
Seat 3: matiko09 (small blind) folded before Flop
Seat 4: ardo888 (big blind) folded before Flop
Seat 5: sanr23 folded before Flop (didn't bet)
Seat 6: koutani7 folded before Flop (didn't bet)
Seat 7: aaronzzr folded before Flop (didn't bet)
Seat 8: Rafaello18 folded on the Flop
Seat 9: mbk88 collected ($6.18)





PokerStars Hand #155379469534:  Hold'em No Limit ($0.50/$1.00 USD) - 2016/06/30 13:28:11 CET [2016/06/30 7:28:11 ET]
Table 'Borrelly II' 9-max Seat #4 is the button
Seat 1: Rafaello18 ($130.38 in chips) 
Seat 2: tipner ($130.07 in chips) 
Seat 3: di0d80 ($100 in chips) 
Seat 4: DonRon_AT ($49.56 in chips) 
Seat 5: picka4u ($127.17 in chips) 
Seat 6: m_michalec ($164.88 in chips) 
Seat 7: matiko09 ($161.85 in chips) 
Seat 8: mbk88 ($100 in chips) 
Seat 9: makaveli978 ($24.55 in chips) 
picka4u: posts small blind $0.50
m_michalec: posts big blind $1
*** HOLE CARDS ***
Dealt to matiko09 [6s Jc]
matiko09: folds 
mbk88: folds 
makaveli978 is disconnected 
makaveli978 is connected 
makaveli978: raises $1 to $2
Rafaello18: folds 
tipner: folds 
di0d80: folds 
DonRon_AT: folds 
picka4u: folds 
m_michalec: folds 
Uncalled bet ($1) returned to makaveli978
makaveli978 collected $2.50 from pot
*** SUMMARY ***
Total pot $2.50 | Rake $0 
Seat 1: Rafaello18 folded before Flop (didn't bet)
Seat 2: tipner folded before Flop (didn't bet)
Seat 3: di0d80 folded before Flop (didn't bet)
Seat 4: DonRon_AT (button) folded before Flop (didn't bet)
Seat 5: picka4u (small blind) folded before Flop
Seat 6: m_michalec (big blind) folded before Flop
Seat 7: matiko09 folded before Flop (didn't bet)
Seat 8: mbk88 folded before Flop (didn't bet)
Seat 9: makaveli978 collected ($2.50)





PokerStars Hand #155379470280:  Hold'em No Limit ($0.25/$0.50 USD) - 2016/06/30 13:28:12 CET [2016/06/30 7:28:12 ET]
Table 'Mentha II' 9-max Seat #8 is the button
Seat 1: Bailey Dew ($97.90 in chips) 
Seat 2: TheMinion ($50 in chips) 
Seat 3: Alexey_Kim2 ($50 in chips) 
Seat 5: matiko09 ($54.21 in chips) 
Seat 6: IceyyF91x ($98.05 in chips) 
Seat 7: ardo888 ($85.62 in chips) 
Seat 8: drlee77 ($42.40 in chips) 
Seat 9: er13to ($55.35 in chips) 
er13to: posts small blind $0.25
Bailey Dew: posts big blind $0.50
Bailey Dew: posts the ante $0.10
TheMinion: posts the ante $0.10
Alexey_Kim2: posts the ante $0.10
matiko09: posts the ante $0.10
IceyyF91x: posts the ante $0.10
ardo888: posts the ante $0.10
drlee77: posts the ante $0.10
er13to: posts the ante $0.10
*** HOLE CARDS ***
Dealt to matiko09 [Qd 8s]
TheMinion: folds 
Alexey_Kim2: folds 
matiko09: folds 
IceyyF91x: raises $0.50 to $1
ardo888: folds 
drlee77: raises $3 to $4
er13to: folds 
Bailey Dew: folds 
IceyyF91x: calls $3
*** FLOP *** [6d Kc 9c]
IceyyF91x: checks 
drlee77: checks 
*** TURN *** [6d Kc 9c] [7s]
IceyyF91x: checks 
drlee77: checks 
*** RIVER *** [6d Kc 9c 7s] [5d]
IceyyF91x: bets $1.50
drlee77: calls $1.50
*** SHOW DOWN ***
IceyyF91x: shows [4h 6h] (a pair of Sixes)
drlee77: shows [Ac 7d] (a pair of Sevens)
drlee77 collected $11.92 from pot
*** SUMMARY ***
Total pot $12.55 | Rake $0.63 
Board [6d Kc 9c 7s 5d]
Seat 1: Bailey Dew (big blind) folded before Flop
Seat 2: TheMinion folded before Flop (didn't bet)
Seat 3: Alexey_Kim2 folded before Flop (didn't bet)
Seat 5: matiko09 folded before Flop (didn't bet)
Seat 6: IceyyF91x showed [4h 6h] and lost with a pair of Sixes
Seat 7: ardo888 folded before Flop (didn't bet)
Seat 8: drlee77 (button) showed [Ac 7d] and won ($11.92) with a pair of Sevens
Seat 9: er13to (small blind) folded before Flop





PokerStars Hand #155379470663:  Hold'em No Limit ($0.50/$1.00 USD) - 2016/06/30 13:28:13 CET [2016/06/30 7:28:13 ET]
Table 'Prieska' 9-max Seat #7 is the button
Seat 1: KovIFish89 ($100 in chips) 
Seat 4: matteo080613 ($79.50 in chips) 
Seat 5: ramzes160468 ($81.40 in chips) 
Seat 6: DIMAN_324 ($104.37 in chips) 
Seat 7: matiko09 ($100 in chips) 
Seat 9: OMG Dardania ($100 in chips) 
mbk88 will be allowed to play after the button
OMG Dardania: posts small blind $0.50
KovIFish89: posts big blind $1
B_style_cuz: sits out 
Rafaello18: sits out 
*** HOLE CARDS ***
Dealt to matiko09 [Qc 9s]
matteo080613: folds 
ramzes160468: folds 
DIMAN_324: folds 
matiko09: raises $1.27 to $2.27
OMG Dardania: folds 
KovIFish89: calls $1.27
*** FLOP *** [Kd Jd 7d]
KovIFish89: checks 
matiko09: bets $3
KovIFish89: calls $3
*** TURN *** [Kd Jd 7d] [Ks]
KovIFish89: checks 
matiko09: checks 
*** RIVER *** [Kd Jd 7d Ks] [3h]
KovIFish89: bets $6.99
matiko09: folds 
Uncalled bet ($6.99) returned to KovIFish89
KovIFish89 collected $10.49 from pot
KovIFish89: doesn't show hand 
*** SUMMARY ***
Total pot $11.04 | Rake $0.55 
Board [Kd Jd 7d Ks 3h]
Seat 1: KovIFish89 (big blind) collected ($10.49)
Seat 4: matteo080613 folded before Flop (didn't bet)
Seat 5: ramzes160468 folded before Flop (didn't bet)
Seat 6: DIMAN_324 folded before Flop (didn't bet)
Seat 7: matiko09 (button) folded on the River
Seat 9: OMG Dardania (small blind) folded before Flop





PokerStars Hand #155379475262:  Hold'em No Limit ($0.50/$1.00 USD) - 2016/06/30 13:28:24 CET [2016/06/30 7:28:24 ET]
Table 'California II' 9-max Seat #5 is the button
Seat 1: Rafaello18 ($105.38 in chips) 
Seat 3: liakos120 ($80.54 in chips) 
Seat 4: mbk88 ($113.34 in chips) 
Seat 5: Rohitbarve ($99.86 in chips) 
Seat 6: matiko09 ($110.65 in chips) 
Seat 7: DomiVY ($79 in chips) 
Seat 8: picka4u ($40 in chips) 
Seat 9: di0d80 ($106.16 in chips) 
matiko09: posts small blind $0.50
DomiVY: posts big blind $1
er13to: sits out 
*** HOLE CARDS ***
Dealt to matiko09 [8s 4s]
picka4u: folds 
di0d80: folds 
Rafaello18: folds 
liakos120: folds 
mbk88: raises $2 to $3
Rohitbarve: folds 
matiko09: folds 
DomiVY: folds 
Uncalled bet ($2) returned to mbk88
mbk88 collected $2.50 from pot
mbk88: doesn't show hand 
*** SUMMARY ***
Total pot $2.50 | Rake $0 
Seat 1: Rafaello18 folded before Flop (didn't bet)
Seat 3: liakos120 folded before Flop (didn't bet)
Seat 4: mbk88 collected ($2.50)
Seat 5: Rohitbarve (button) folded before Flop (didn't bet)
Seat 6: matiko09 (small blind) folded before Flop
Seat 7: DomiVY (big blind) folded before Flop
Seat 8: picka4u folded before Flop (didn't bet)
Seat 9: di0d80 folded before Flop (didn't bet)





PokerStars Hand #155379479165:  Hold'em No Limit ($0.50/$1.00 USD) - 2016/06/30 13:28:33 CET [2016/06/30 7:28:33 ET]
Table 'Sigrid' 9-max Seat #2 is the button
Seat 1: DomiVY ($43.36 in chips) 
Seat 2: bearlar ($108.69 in chips) 
Seat 3: Rafaello18 ($116.50 in chips) 
Seat 4: mbk88 ($101.50 in chips) 
Seat 5: DIMAN_324 ($110.24 in chips) 
Seat 6: di0d80 ($118.99 in chips) 
Seat 7: arctur17 ($40 in chips) 
Seat 8: techahn ($146.06 in chips) 
Seat 9: matiko09 ($109.02 in chips) 
Rafaello18: posts small blind $0.50
mbk88: posts big blind $1
*** HOLE CARDS ***
Dealt to matiko09 [4d 7h]
DIMAN_324: folds 
di0d80: folds 
arctur17: folds 
techahn: folds 
matiko09: folds 
DomiVY: folds 
bearlar: folds 
Rafaello18: folds 
Uncalled bet ($0.50) returned to mbk88
mbk88 collected $1 from pot
mbk88: doesn't show hand 
*** SUMMARY ***
Total pot $1 | Rake $0 
Seat 1: DomiVY folded before Flop (didn't bet)
Seat 2: bearlar (button) folded before Flop (didn't bet)
Seat 3: Rafaello18 (small blind) folded before Flop
Seat 4: mbk88 (big blind) collected ($1)
Seat 5: DIMAN_324 folded before Flop (didn't bet)
Seat 6: di0d80 folded before Flop (didn't bet)
Seat 7: arctur17 folded before Flop (didn't bet)
Seat 8: techahn folded before Flop (didn't bet)
Seat 9: matiko09 folded before Flop (didn't bet)





PokerStars Hand #155379481680:  Hold'em No Limit ($0.50/$1.00 USD) - 2016/06/30 13:28:39 CET [2016/06/30 7:28:39 ET]
Table 'Armisticia' 9-max Seat #4 is the button
Seat 1: di0d80 ($100 in chips) 
Seat 2: Rafaello18 ($208.89 in chips) 
Seat 4: DomiVY ($55.74 in chips) 
Seat 5: tipner ($100 in chips) 
Seat 6: matiko09 ($125.12 in chips) 
Seat 7: sanr23 ($102.93 in chips) 
Seat 8: techahn ($117.50 in chips) 
Seat 9: mbk88 ($119.90 in chips) 
tipner: posts small blind $0.50
matiko09: posts big blind $1
*** HOLE CARDS ***
Dealt to matiko09 [5d 8d]
sanr23: folds 
techahn: folds 
mbk88: folds 
di0d80: raises $1.50 to $2.50
Rafaello18: folds 
DomiVY: folds 
tipner: folds 
matiko09: folds 
Uncalled bet ($1.50) returned to di0d80
di0d80 collected $2.50 from pot
di0d80: doesn't show hand 
*** SUMMARY ***
Total pot $2.50 | Rake $0 
Seat 1: di0d80 collected ($2.50)
Seat 2: Rafaello18 folded before Flop (didn't bet)
Seat 4: DomiVY (button) folded before Flop (didn't bet)
Seat 5: tipner (small blind) folded before Flop
Seat 6: matiko09 (big blind) folded before Flop
Seat 7: sanr23 folded before Flop (didn't bet)
Seat 8: techahn folded before Flop (didn't bet)
Seat 9: mbk88 folded before Flop (didn't bet)





PokerStars Hand #155379482386:  Hold'em No Limit ($0.50/$1.00 USD) - 2016/06/30 13:28:41 CET [2016/06/30 7:28:41 ET]
Table 'Tatjana' 9-max Seat #1 is the button
Seat 1: ardo888 ($119.74 in chips) 
Seat 2: DIMAN_324 ($100.50 in chips) 
Seat 3: Rafaello18 ($109.13 in chips) 
Seat 4: Konig26 ($143.08 in chips) 
Seat 5: matiko09 ($103.58 in chips) 
Seat 6: mbk88 ($100 in chips) 
Seat 7: DomiVY ($40 in chips) 
Seat 8: alhill86 ($106.15 in chips) 
Seat 9: POTAPENKO700 ($101.50 in chips) 
DIMAN_324: posts small blind $0.50
Rafaello18: posts big blind $1
*** HOLE CARDS ***
Dealt to matiko09 [Qc 8s]
Konig26: folds 
matiko09: folds 
mbk88: folds 
DomiVY: folds 
alhill86: folds 
POTAPENKO700: folds 
ardo888: raises $1.50 to $2.50
DIMAN_324: folds 
Rafaello18: calls $1.50
*** FLOP *** [8d 2c Kh]
Rafaello18: checks 
ardo888: bets $3.39
Rafaello18: folds 
Uncalled bet ($3.39) returned to ardo888
ardo888 collected $5.22 from pot
ardo888: doesn't show hand 
*** SUMMARY ***
Total pot $5.50 | Rake $0.28 
Board [8d 2c Kh]
Seat 1: ardo888 (button) collected ($5.22)
Seat 2: DIMAN_324 (small blind) folded before Flop
Seat 3: Rafaello18 (big blind) folded on the Flop
Seat 4: Konig26 folded before Flop (didn't bet)
Seat 5: matiko09 folded before Flop (didn't bet)
Seat 6: mbk88 folded before Flop (didn't bet)
Seat 7: DomiVY folded before Flop (didn't bet)
Seat 8: alhill86 folded before Flop (didn't bet)
Seat 9: POTAPENKO700 folded before Flop (didn't bet)





PokerStars Hand #155379482176:  Hold'em No Limit ($0.25/$0.50 USD) - 2016/06/30 13:28:41 CET [2016/06/30 7:28:41 ET]
Table 'Dorothea II' 9-max Seat #2 is the button
Seat 2: er13to ($50 in chips) 
Seat 3: Franky77200 ($82.67 in chips) 
Seat 4: matiko09 ($83.79 in chips) 
Seat 5: Bailey Dew ($62.87 in chips) 
Seat 6: ivan100886 ($29.10 in chips) 
Seat 7: Alexey_Kim2 ($50 in chips) 
Seat 8: TheMinion ($52.96 in chips) 
Seat 9: ardo888 ($83.32 in chips) 
Franky77200: posts small blind $0.25
matiko09: posts big blind $0.50
er13to: posts the ante $0.10
Franky77200: posts the ante $0.10
matiko09: posts the ante $0.10
Bailey Dew: posts the ante $0.10
ivan100886: posts the ante $0.10
Alexey_Kim2: posts the ante $0.10
TheMinion: posts the ante $0.10
ardo888: posts the ante $0.10
*** HOLE CARDS ***
Dealt to matiko09 [5c 5s]
Bailey Dew: folds 
ivan100886: folds 
Alexey_Kim2: raises $1 to $1.50
TheMinion: folds 
ardo888: folds 
er13to: folds 
Franky77200: folds 
matiko09: folds 
Uncalled bet ($1) returned to Alexey_Kim2
Alexey_Kim2 collected $2.05 from pot
Alexey_Kim2: doesn't show hand 
*** SUMMARY ***
Total pot $2.05 | Rake $0 
Seat 2: er13to (button) folded before Flop (didn't bet)
Seat 3: Franky77200 (small blind) folded before Flop
Seat 4: matiko09 (big blind) folded before Flop
Seat 5: Bailey Dew folded before Flop (didn't bet)
Seat 6: ivan100886 folded before Flop (didn't bet)
Seat 7: Alexey_Kim2 collected ($2.05)
Seat 8: TheMinion folded before Flop (didn't bet)
Seat 9: ardo888 folded before Flop (didn't bet)





PokerStars Hand #155379482457:  Hold'em No Limit ($0.50/$1.00 USD) - 2016/06/30 13:28:41 CET [2016/06/30 7:28:41 ET]
Table 'Askania' 9-max Seat #8 is the button
Seat 1: korlito69 ($44.95 in chips) 
Seat 2: Rafaello18 ($119.52 in chips) 
Seat 4: mbk88 ($119.12 in chips) 
Seat 5: tipner ($103 in chips) 
Seat 6: matiko09 ($272.35 in chips) 
Seat 7: ardo888 ($128.12 in chips) 
Seat 8: DomiVY ($70 in chips) 
Seat 9: picka4u ($50.62 in chips) 
picka4u: posts small blind $0.50
korlito69: posts big blind $1
DIMAN_324: sits out 
*** HOLE CARDS ***
Dealt to matiko09 [Ac 7d]
Rafaello18: folds 
mbk88: folds 
tipner: folds 
matiko09: folds 
ardo888: folds 
DomiVY: folds 
picka4u: raises $1.25 to $2.25
korlito69: folds 
Uncalled bet ($1.25) returned to picka4u
picka4u collected $2 from pot
picka4u: doesn't show hand 
*** SUMMARY ***
Total pot $2 | Rake $0 
Seat 1: korlito69 (big blind) folded before Flop
Seat 2: Rafaello18 folded before Flop (didn't bet)
Seat 4: mbk88 folded before Flop (didn't bet)
Seat 5: tipner folded before Flop (didn't bet)
Seat 6: matiko09 folded before Flop (didn't bet)
Seat 7: ardo888 folded before Flop (didn't bet)
Seat 8: DomiVY (button) folded before Flop (didn't bet)
Seat 9: picka4u (small blind) collected ($2)





PokerStars Hand #155379487397:  Hold'em No Limit ($0.50/$1.00 USD) - 2016/06/30 13:28:53 CET [2016/06/30 7:28:53 ET]
Table 'Simeisa II' 9-max Seat #7 is the button
Seat 2: Rafaello18 ($139.16 in chips) 
Seat 3: matiko09 ($100 in chips) 
Seat 4: tipner ($100 in chips) 
Seat 5: arctur17 ($60.48 in chips) 
Seat 6: ammit9021 ($37.38 in chips) 
Seat 7: DomiVY ($44.72 in chips) 
Seat 8: picka4u ($99.27 in chips) 
Seat 9: mbk88 ($146.48 in chips) 
picka4u: posts small blind $0.50
mbk88: posts big blind $1
KovIFish89: sits out 
*** HOLE CARDS ***
Dealt to matiko09 [8c 2h]
Rafaello18: folds 
matiko09: folds 
tipner: folds 
arctur17: raises $2 to $3
ammit9021: calls $3
DomiVY: folds 
picka4u: folds 
mbk88: calls $2
*** FLOP *** [Kc 4c 2c]
mbk88: checks 
arctur17: checks 
ammit9021: checks 
*** TURN *** [Kc 4c 2c] [Qs]
mbk88: checks 
arctur17: bets $6
ammit9021: folds 
mbk88: folds 
Uncalled bet ($6) returned to arctur17
arctur17 collected $9.02 from pot
arctur17: doesn't show hand 
*** SUMMARY ***
Total pot $9.50 | Rake $0.48 
Board [Kc 4c 2c Qs]
Seat 2: Rafaello18 folded before Flop (didn't bet)
Seat 3: matiko09 folded before Flop (didn't bet)
Seat 4: tipner folded before Flop (didn't bet)
Seat 5: arctur17 collected ($9.02)
Seat 6: ammit9021 folded on the Turn
Seat 7: DomiVY (button) folded before Flop (didn't bet)
Seat 8: picka4u (small blind) folded before Flop
Seat 9: mbk88 (big blind) folded on the Turn





PokerStars Hand #155379492745:  Hold'em No Limit ($0.50/$1.00 USD) - 2016/06/30 13:29:06 CET [2016/06/30 7:29:06 ET]
Table 'Prieska' 9-max Seat #9 is the button
Seat 1: KovIFish89 ($105.22 in chips) 
Seat 2: B_style_cuz ($100 in chips) 
Seat 4: matteo080613 ($79.50 in chips) 
Seat 5: ramzes160468 ($81.40 in chips) 
Seat 6: DIMAN_324 ($104.37 in chips) 
Seat 7: matiko09 ($100 in chips) 
Seat 9: OMG Dardania ($100 in chips) 
KovIFish89: posts small blind $0.50
B_style_cuz: posts big blind $1
Rafaello18: sits out 
mbk88: sits out 
*** HOLE CARDS ***
Dealt to matiko09 [3c 9h]
matteo080613: raises $1 to $2
ramzes160468: folds 
DIMAN_324: folds 
matiko09: folds 
OMG Dardania: folds 
KovIFish89: folds 
B_style_cuz: folds 
Uncalled bet ($1) returned to matteo080613
matteo080613 collected $2.50 from pot
matteo080613: doesn't show hand 
*** SUMMARY ***
Total pot $2.50 | Rake $0 
Seat 1: KovIFish89 (small blind) folded before Flop
Seat 2: B_style_cuz (big blind) folded before Flop
Seat 4: matteo080613 collected ($2.50)
Seat 5: ramzes160468 folded before Flop (didn't bet)
Seat 6: DIMAN_324 folded before Flop (didn't bet)
Seat 7: matiko09 folded before Flop (didn't bet)
Seat 9: OMG Dardania (button) folded before Flop (didn't bet)





PokerStars Hand #155379494458:  Hold'em No Limit ($0.50/$1.00 USD) - 2016/06/30 13:29:10 CET [2016/06/30 7:29:10 ET]
Table 'Asmodeus' 9-max Seat #3 is the button
Seat 1: scollop ($107.69 in chips) 
Seat 2: picka4u ($45.02 in chips) 
Seat 3: matiko09 ($100 in chips) 
Seat 4: ardo888 ($142.28 in chips) 
Seat 5: sanr23 ($105.16 in chips) 
Seat 6: koutani7 ($89.50 in chips) 
Seat 7: aaronzzr ($149.11 in chips) 
Seat 8: Rafaello18 ($130.60 in chips) 
Seat 9: mbk88 ($167.18 in chips) 
ardo888: posts small blind $0.50
sanr23: posts big blind $1
*** HOLE CARDS ***
Dealt to matiko09 [Td Kd]
koutani7: raises $2 to $3
aaronzzr: folds 
Rafaello18: folds 
mbk88: folds 
scollop: folds 
picka4u: folds 
matiko09: folds 
ardo888: folds 
sanr23: folds 
Uncalled bet ($2) returned to koutani7
koutani7 collected $2.50 from pot
koutani7: doesn't show hand 
*** SUMMARY ***
Total pot $2.50 | Rake $0 
Seat 1: scollop folded before Flop (didn't bet)
Seat 2: picka4u folded before Flop (didn't bet)
Seat 3: matiko09 (button) folded before Flop (didn't bet)
Seat 4: ardo888 (small blind) folded before Flop
Seat 5: sanr23 (big blind) folded before Flop
Seat 6: koutani7 collected ($2.50)
Seat 7: aaronzzr folded before Flop (didn't bet)
Seat 8: Rafaello18 folded before Flop (didn't bet)
Seat 9: mbk88 folded before Flop (didn't bet)





PokerStars Hand #155379497015:  Hold'em No Limit ($0.50/$1.00 USD) - 2016/06/30 13:29:16 CET [2016/06/30 7:29:16 ET]
Table 'Sigrid' 9-max Seat #3 is the button
Seat 1: DomiVY ($43.36 in chips) 
Seat 2: bearlar ($108.69 in chips) 
Seat 3: Rafaello18 ($116 in chips) 
Seat 4: mbk88 ($102 in chips) 
Seat 5: DIMAN_324 ($110.24 in chips) 
Seat 6: di0d80 ($118.99 in chips) 
Seat 7: arctur17 ($40 in chips) 
Seat 8: techahn ($146.06 in chips) 
Seat 9: matiko09 ($109.02 in chips) 
mbk88: posts small blind $0.50
DIMAN_324: posts big blind $1
*** HOLE CARDS ***
Dealt to matiko09 [8d Js]
di0d80: folds 
arctur17: folds 
techahn: folds 
matiko09: folds 
DomiVY: folds 
bearlar: folds 
Rafaello18: raises $1.50 to $2.50
mbk88: folds 
DIMAN_324: folds 
Uncalled bet ($1.50) returned to Rafaello18
Rafaello18 collected $2.50 from pot
Rafaello18: doesn't show hand 
*** SUMMARY ***
Total pot $2.50 | Rake $0 
Seat 1: DomiVY folded before Flop (didn't bet)
Seat 2: bearlar folded before Flop (didn't bet)
Seat 3: Rafaello18 (button) collected ($2.50)
Seat 4: mbk88 (small blind) folded before Flop
Seat 5: DIMAN_324 (big blind) folded before Flop
Seat 6: di0d80 folded before Flop (didn't bet)
Seat 7: arctur17 folded before Flop (didn't bet)
Seat 8: techahn folded before Flop (didn't bet)
Seat 9: matiko09 folded before Flop (didn't bet)





PokerStars Hand #155379498423:  Hold'em No Limit ($0.50/$1.00 USD) - 2016/06/30 13:29:19 CET [2016/06/30 7:29:19 ET]
Table 'California II' 9-max Seat #6 is the button
Seat 1: Rafaello18 ($105.38 in chips) 
Seat 3: liakos120 ($80.54 in chips) 
Seat 4: mbk88 ($114.84 in chips) 
Seat 5: Rohitbarve ($99.86 in chips) 
Seat 6: matiko09 ($110.15 in chips) 
Seat 7: DomiVY ($78 in chips) 
Seat 8: picka4u ($40 in chips) 
Seat 9: di0d80 ($106.16 in chips) 
DomiVY: posts small blind $0.50
picka4u: posts big blind $1
er13to: sits out 
*** HOLE CARDS ***
Dealt to matiko09 [6s 5d]
di0d80: folds 
Rafaello18: folds 
liakos120: raises $1 to $2
mbk88: folds 
Rohitbarve: folds 
matiko09: folds 
DomiVY: folds 
picka4u: calls $1
*** FLOP *** [9d 3s 2c]
picka4u: checks 
liakos120: bets $1
picka4u: folds 
Uncalled bet ($1) returned to liakos120
liakos120 collected $4.28 from pot
liakos120: doesn't show hand 
*** SUMMARY ***
Total pot $4.50 | Rake $0.22 
Board [9d 3s 2c]
Seat 1: Rafaello18 folded before Flop (didn't bet)
Seat 3: liakos120 collected ($4.28)
Seat 4: mbk88 folded before Flop (didn't bet)
Seat 5: Rohitbarve folded before Flop (didn't bet)
Seat 6: matiko09 (button) folded before Flop (didn't bet)
Seat 7: DomiVY (small blind) folded before Flop
Seat 8: picka4u (big blind) folded on the Flop
Seat 9: di0d80 folded before Flop (didn't bet)





PokerStars Hand #155379498622:  Hold'em No Limit ($0.50/$1.00 USD) - 2016/06/30 13:29:20 CET [2016/06/30 7:29:20 ET]
Table 'Borrelly II' 9-max Seat #5 is the button
Seat 1: Rafaello18 ($130.38 in chips) 
Seat 2: tipner ($130.07 in chips) 
Seat 3: di0d80 ($100 in chips) 
Seat 4: DonRon_AT ($49.56 in chips) 
Seat 5: picka4u ($126.67 in chips) 
Seat 6: m_michalec ($163.88 in chips) 
Seat 7: matiko09 ($161.85 in chips) 
Seat 8: mbk88 ($100 in chips) 
Seat 9: makaveli978 ($26.05 in chips) 
m_michalec: posts small blind $0.50
matiko09: posts big blind $1
*** HOLE CARDS ***
Dealt to matiko09 [4h 3h]
mbk88: raises $2 to $3
makaveli978: calls $3
Rafaello18: folds 
tipner: raises $10 to $13
di0d80: folds 
DonRon_AT: folds 
picka4u: folds 
m_michalec: folds 
matiko09: folds 
mbk88: folds 
makaveli978: raises $13.05 to $26.05 and is all-in
tipner: calls $13.05
*** FLOP *** [2s 5s 8h]
*** TURN *** [2s 5s 8h] [Qs]
*** RIVER *** [2s 5s 8h Qs] [3d]
*** SHOW DOWN ***
makaveli978: shows [2c 2d] (three of a kind, Deuces)
tipner: shows [Js Ah] (high card Ace)
makaveli978 collected $54.10 from pot
*** SUMMARY ***
Total pot $56.60 | Rake $2.50 
Board [2s 5s 8h Qs 3d]
Seat 1: Rafaello18 folded before Flop (didn't bet)
Seat 2: tipner showed [Js Ah] and lost with high card Ace
Seat 3: di0d80 folded before Flop (didn't bet)
Seat 4: DonRon_AT folded before Flop (didn't bet)
Seat 5: picka4u (button) folded before Flop (didn't bet)
Seat 6: m_michalec (small blind) folded before Flop
Seat 7: matiko09 (big blind) folded before Flop
Seat 8: mbk88 folded before Flop
Seat 9: makaveli978 showed [2c 2d] and won ($54.10) with three of a kind, Deuces





PokerStars Hand #155379498843:  Hold'em No Limit ($0.50/$1.00 USD) - 2016/06/30 13:29:20 CET [2016/06/30 7:29:20 ET]
Table 'Armisticia' 9-max Seat #5 is the button
Seat 1: di0d80 ($101.50 in chips) 
Seat 2: Rafaello18 ($208.89 in chips) 
Seat 4: DomiVY ($55.74 in chips) 
Seat 5: tipner ($100 in chips) 
Seat 6: matiko09 ($124.12 in chips) 
Seat 7: sanr23 ($102.93 in chips) 
Seat 8: techahn ($117.50 in chips) 
Seat 9: mbk88 ($119.90 in chips) 
matiko09: posts small blind $0.50
sanr23: posts big blind $1
*** HOLE CARDS ***
Dealt to matiko09 [7c 5s]
techahn: raises $2 to $3
mbk88: folds 
di0d80: folds 
Rafaello18: folds 
DomiVY: folds 
tipner: folds 
matiko09: folds 
sanr23: folds 
Uncalled bet ($2) returned to techahn
techahn collected $2.50 from pot
techahn: doesn't show hand 
*** SUMMARY ***
Total pot $2.50 | Rake $0 
Seat 1: di0d80 folded before Flop (didn't bet)
Seat 2: Rafaello18 folded before Flop (didn't bet)
Seat 4: DomiVY folded before Flop (didn't bet)
Seat 5: tipner (button) folded before Flop (didn't bet)
Seat 6: matiko09 (small blind) folded before Flop
Seat 7: sanr23 (big blind) folded before Flop
Seat 8: techahn collected ($2.50)
Seat 9: mbk88 folded before Flop (didn't bet)





PokerStars Hand #155379499593:  Hold'em No Limit ($0.25/$0.50 USD) - 2016/06/30 13:29:22 CET [2016/06/30 7:29:22 ET]
Table 'Dorothea II' 9-max Seat #3 is the button
Seat 2: er13to ($50 in chips) 
Seat 3: Franky77200 ($82.32 in chips) 
Seat 4: matiko09 ($83.19 in chips) 
Seat 5: Bailey Dew ($62.77 in chips) 
Seat 6: ivan100886 ($29 in chips) 
Seat 7: Alexey_Kim2 ($51.45 in chips) 
Seat 8: TheMinion ($52.86 in chips) 
Seat 9: ardo888 ($83.22 in chips) 
matiko09: posts small blind $0.25
Bailey Dew: posts big blind $0.50
er13to: posts the ante $0.10
Franky77200: posts the ante $0.10
matiko09: posts the ante $0.10
Bailey Dew: posts the ante $0.10
ivan100886: posts the ante $0.10
Alexey_Kim2: posts the ante $0.10
TheMinion: posts the ante $0.10
ardo888: posts the ante $0.10
*** HOLE CARDS ***
Dealt to matiko09 [Jd Kd]
ivan100886: raises $0.75 to $1.25
Alexey_Kim2: folds 
TheMinion: folds 
ardo888: calls $1.25
er13to: folds 
Franky77200: raises $3.25 to $4.50
matiko09: folds 
Bailey Dew: folds 
ivan100886: folds 
ardo888: calls $3.25
*** FLOP *** [4h Qd Tc]
ardo888: checks 
Franky77200: bets $7
ardo888: folds 
Uncalled bet ($7) returned to Franky77200
Franky77200 collected $11.21 from pot
Franky77200: doesn't show hand 
*** SUMMARY ***
Total pot $11.80 | Rake $0.59 
Board [4h Qd Tc]
Seat 2: er13to folded before Flop (didn't bet)
Seat 3: Franky77200 (button) collected ($11.21)
Seat 4: matiko09 (small blind) folded before Flop
Seat 5: Bailey Dew (big blind) folded before Flop
Seat 6: ivan100886 folded before Flop
Seat 7: Alexey_Kim2 folded before Flop (didn't bet)
Seat 8: TheMinion folded before Flop (didn't bet)
Seat 9: ardo888 folded on the Flop





PokerStars Hand #155379502703:  Hold'em No Limit ($0.50/$1.00 USD) - 2016/06/30 13:29:30 CET [2016/06/30 7:29:30 ET]
Table 'Askania' 9-max Seat #9 is the button
Seat 1: korlito69 ($43.95 in chips) 
Seat 2: Rafaello18 ($119.52 in chips) 
Seat 4: mbk88 ($119.12 in chips) 
Seat 5: tipner ($103 in chips) 
Seat 6: matiko09 ($272.35 in chips) 
Seat 7: ardo888 ($128.12 in chips) 
Seat 8: DomiVY ($70 in chips) 
Seat 9: picka4u ($51.62 in chips) 
korlito69: posts small blind $0.50
Rafaello18: posts big blind $1
DIMAN_324: sits out 
*** HOLE CARDS ***
Dealt to matiko09 [8d 2h]
mbk88: folds 
tipner: folds 
matiko09: folds 
ardo888: folds 
DomiVY: raises $2 to $3
picka4u: folds 
korlito69: folds 
Rafaello18: folds 
Uncalled bet ($2) returned to DomiVY
DomiVY collected $2.50 from pot
DomiVY: doesn't show hand 
*** SUMMARY ***
Total pot $2.50 | Rake $0 
Seat 1: korlito69 (small blind) folded before Flop
Seat 2: Rafaello18 (big blind) folded before Flop
Seat 4: mbk88 folded before Flop (didn't bet)
Seat 5: tipner folded before Flop (didn't bet)
Seat 6: matiko09 folded before Flop (didn't bet)
Seat 7: ardo888 folded before Flop (didn't bet)
Seat 8: DomiVY collected ($2.50)
Seat 9: picka4u (button) folded before Flop (didn't bet)





PokerStars Hand #155379504666:  Hold'em No Limit ($0.50/$1.00 USD) - 2016/06/30 13:29:34 CET [2016/06/30 7:29:34 ET]
Table 'Tatjana' 9-max Seat #2 is the button
Seat 1: ardo888 ($122.46 in chips) 
Seat 2: DIMAN_324 ($100 in chips) 
Seat 3: Rafaello18 ($106.63 in chips) 
Seat 4: Konig26 ($143.08 in chips) 
Seat 5: matiko09 ($103.58 in chips) 
Seat 6: mbk88 ($100 in chips) 
Seat 7: DomiVY ($40 in chips) 
Seat 8: alhill86 ($106.15 in chips) 
Seat 9: POTAPENKO700 ($101.50 in chips) 
Rafaello18: posts small blind $0.50
Konig26: posts big blind $1
*** HOLE CARDS ***
Dealt to matiko09 [Ts 6h]
matiko09: folds 
mbk88: raises $2 to $3
DomiVY: folds 
alhill86: folds 
POTAPENKO700: folds 
ardo888: folds 
DIMAN_324: calls $3
Rafaello18: folds 
Konig26: calls $2
*** FLOP *** [3s 9h 2d]
Konig26: checks 
mbk88: bets $6
DIMAN_324: calls $6
Konig26: calls $6
*** TURN *** [3s 9h 2d] [9c]
Konig26: checks 
mbk88: checks 
DIMAN_324: bets $13.06
Konig26: calls $13.06
mbk88: calls $13.06
*** RIVER *** [3s 9h 2d 9c] [3c]
Konig26: checks 
mbk88: checks 
DIMAN_324: checks 
*** SHOW DOWN ***
Konig26: shows [8c 9d] (a full house, Nines full of Threes)
mbk88: mucks hand 
DIMAN_324: mucks hand 
Konig26 collected $64.18 from pot
*** SUMMARY ***
Total pot $66.68 | Rake $2.50 
Board [3s 9h 2d 9c 3c]
Seat 1: ardo888 folded before Flop (didn't bet)
Seat 2: DIMAN_324 (button) mucked [2c 2h]
Seat 3: Rafaello18 (small blind) folded before Flop
Seat 4: Konig26 (big blind) showed [8c 9d] and won ($64.18) with a full house, Nines full of Threes
Seat 5: matiko09 folded before Flop (didn't bet)
Seat 6: mbk88 mucked [Ac As]
Seat 7: DomiVY folded before Flop (didn't bet)
Seat 8: alhill86 folded before Flop (didn't bet)
Seat 9: POTAPENKO700 folded before Flop (didn't bet)





PokerStars Hand #155379509127:  Hold'em No Limit ($0.50/$1.00 USD) - 2016/06/30 13:29:45 CET [2016/06/30 7:29:45 ET]
Table 'Prieska' 9-max Seat #1 is the button
Seat 1: KovIFish89 ($104.72 in chips) 
Seat 2: B_style_cuz ($99 in chips) 
Seat 3: Rafaello18 ($100 in chips) 
Seat 4: matteo080613 ($81 in chips) 
Seat 5: ramzes160468 ($81.40 in chips) 
Seat 6: DIMAN_324 ($104.37 in chips) 
Seat 7: matiko09 ($100 in chips) 
Seat 9: OMG Dardania ($100 in chips) 
B_style_cuz: posts small blind $0.50
Rafaello18: posts big blind $1
mbk88: sits out 
*** HOLE CARDS ***
Dealt to matiko09 [Jh 5c]
matteo080613: folds 
ramzes160468: folds 
DIMAN_324: folds 
matiko09: folds 
OMG Dardania: raises $1.50 to $2.50
KovIFish89: folds 
B_style_cuz: folds 
Rafaello18: folds 
Uncalled bet ($1.50) returned to OMG Dardania
OMG Dardania collected $2.50 from pot
OMG Dardania: doesn't show hand 
*** SUMMARY ***
Total pot $2.50 | Rake $0 
Seat 1: KovIFish89 (button) folded before Flop (didn't bet)
Seat 2: B_style_cuz (small blind) folded before Flop
Seat 3: Rafaello18 (big blind) folded before Flop
Seat 4: matteo080613 folded before Flop (didn't bet)
Seat 5: ramzes160468 folded before Flop (didn't bet)
Seat 6: DIMAN_324 folded before Flop (didn't bet)
Seat 7: matiko09 folded before Flop (didn't bet)
Seat 9: OMG Dardania collected ($2.50)





PokerStars Hand #155379514302:  Hold'em No Limit ($0.50/$1.00 USD) - 2016/06/30 13:29:57 CET [2016/06/30 7:29:57 ET]
Table 'Armisticia' 9-max Seat #6 is the button
Seat 1: di0d80 ($101.50 in chips) 
Seat 2: Rafaello18 ($208.89 in chips) 
Seat 4: DomiVY ($55.74 in chips) 
Seat 5: tipner ($100 in chips) 
Seat 6: matiko09 ($123.62 in chips) 
Seat 7: sanr23 ($101.93 in chips) 
Seat 8: techahn ($119 in chips) 
Seat 9: mbk88 ($119.90 in chips) 
sanr23: posts small blind $0.50
techahn: posts big blind $1
*** HOLE CARDS ***
Dealt to matiko09 [Jh Qh]
mbk88: folds 
di0d80: folds 
Rafaello18: folds 
DomiVY: folds 
tipner has timed out
tipner: folds 
matiko09: raises $1.27 to $2.27
sanr23: folds 
techahn: folds 
Uncalled bet ($1.27) returned to matiko09
matiko09 collected $2.50 from pot
matiko09: doesn't show hand 
*** SUMMARY ***
Total pot $2.50 | Rake $0 
Seat 1: di0d80 folded before Flop (didn't bet)
Seat 2: Rafaello18 folded before Flop (didn't bet)
Seat 4: DomiVY folded before Flop (didn't bet)
Seat 5: tipner folded before Flop (didn't bet)
Seat 6: matiko09 (button) collected ($2.50)
Seat 7: sanr23 (small blind) folded before Flop
Seat 8: techahn (big blind) folded before Flop
Seat 9: mbk88 folded before Flop (didn't bet)





PokerStars Hand #155379514465:  Hold'em No Limit ($0.50/$1.00 USD) - 2016/06/30 13:29:58 CET [2016/06/30 7:29:58 ET]
Table 'Asmodeus' 9-max Seat #4 is the button
Seat 1: scollop ($107.69 in chips) 
Seat 2: picka4u ($45.02 in chips) 
Seat 3: matiko09 ($100 in chips) 
Seat 4: ardo888 ($141.78 in chips) 
Seat 5: sanr23 ($104.16 in chips) 
Seat 6: koutani7 ($91 in chips) 
Seat 7: aaronzzr ($149.11 in chips) 
Seat 8: Rafaello18 ($130.60 in chips) 
Seat 9: mbk88 ($167.18 in chips) 
sanr23: posts small blind $0.50
koutani7: posts big blind $1
*** HOLE CARDS ***
Dealt to matiko09 [5c 8h]
aaronzzr: folds 
Rafaello18: folds 
mbk88: folds 
scollop: folds 
picka4u: folds 
matiko09: folds 
ardo888: raises $1.50 to $2.50
sanr23: raises $6.50 to $9
koutani7: folds 
ardo888: folds 
Uncalled bet ($6.50) returned to sanr23
sanr23 collected $6 from pot
sanr23: doesn't show hand 
*** SUMMARY ***
Total pot $6 | Rake $0 
Seat 1: scollop folded before Flop (didn't bet)
Seat 2: picka4u folded before Flop (didn't bet)
Seat 3: matiko09 folded before Flop (didn't bet)
Seat 4: ardo888 (button) folded before Flop
Seat 5: sanr23 (small blind) collected ($6)
Seat 6: koutani7 (big blind) folded before Flop
Seat 7: aaronzzr folded before Flop (didn't bet)
Seat 8: Rafaello18 folded before Flop (didn't bet)
Seat 9: mbk88 folded before Flop (didn't bet)





PokerStars Hand #155379519398:  Hold'em No Limit ($0.50/$1.00 USD) - 2016/06/30 13:30:08 CET [2016/06/30 7:30:08 ET]
Table 'Askania' 9-max Seat #1 is the button
Seat 1: korlito69 ($43.45 in chips) 
Seat 2: Rafaello18 ($118.52 in chips) 
Seat 3: DIMAN_324 ($100 in chips) 
Seat 4: mbk88 ($119.12 in chips) 
Seat 5: tipner ($103 in chips) 
Seat 6: matiko09 ($272.35 in chips) 
Seat 7: ardo888 ($128.12 in chips) 
Seat 8: DomiVY ($71.50 in chips) 
Seat 9: picka4u ($51.62 in chips) 
Rafaello18: posts small blind $0.50
DIMAN_324: posts big blind $1
*** HOLE CARDS ***
Dealt to matiko09 [4s Th]
mbk88: folds 
tipner: folds 
matiko09: folds 
ardo888: raises $2 to $3
DomiVY: folds 
picka4u: folds 
korlito69: folds 
Rafaello18: folds 
DIMAN_324: raises $7.50 to $10.50
ardo888: calls $7.50
*** FLOP *** [9d Jh 9s]
DIMAN_324: bets $7.50
ardo888: calls $7.50
*** TURN *** [9d Jh 9s] [Td]
DIMAN_324: checks 
ardo888: bets $19.03
DIMAN_324: folds 
Uncalled bet ($19.03) returned to ardo888
ardo888 collected $34.68 from pot
ardo888: doesn't show hand 
*** SUMMARY ***
Total pot $36.50 | Rake $1.82 
Board [9d Jh 9s Td]
Seat 1: korlito69 (button) folded before Flop (didn't bet)
Seat 2: Rafaello18 (small blind) folded before Flop
Seat 3: DIMAN_324 (big blind) folded on the Turn
Seat 4: mbk88 folded before Flop (didn't bet)
Seat 5: tipner folded before Flop (didn't bet)
Seat 6: matiko09 folded before Flop (didn't bet)
Seat 7: ardo888 collected ($34.68)
Seat 8: DomiVY folded before Flop (didn't bet)
Seat 9: picka4u folded before Flop (didn't bet)





PokerStars Hand #155379520722:  Hold'em No Limit ($0.50/$1.00 USD) - 2016/06/30 13:30:11 CET [2016/06/30 7:30:11 ET]
Table 'Sigrid' 9-max Seat #4 is the button
Seat 1: DomiVY ($43.36 in chips) 
Seat 2: bearlar ($108.69 in chips) 
Seat 3: Rafaello18 ($117.50 in chips) 
Seat 4: mbk88 ($101.50 in chips) 
Seat 5: DIMAN_324 ($109.24 in chips) 
Seat 7: arctur17 ($40 in chips) 
Seat 8: techahn ($146.06 in chips) 
Seat 9: matiko09 ($109.02 in chips) 
DIMAN_324: posts small blind $0.50
di0d80: is sitting out 
arctur17: posts big blind $1
*** HOLE CARDS ***
Dealt to matiko09 [Qd 7s]
techahn: folds 
matiko09: folds 
DomiVY: folds 
bearlar: folds 
Rafaello18: folds 
mbk88: folds 
DIMAN_324: raises $2 to $3
arctur17: calls $2
*** FLOP *** [2h 2c Ah]
DIMAN_324: checks 
arctur17: bets $3
DIMAN_324: calls $3
*** TURN *** [2h 2c Ah] [7c]
DIMAN_324: checks 
arctur17: bets $11.40
DIMAN_324: folds 
Uncalled bet ($11.40) returned to arctur17
arctur17 collected $11.40 from pot
arctur17: doesn't show hand 
*** SUMMARY ***
Total pot $12 | Rake $0.60 
Board [2h 2c Ah 7c]
Seat 1: DomiVY folded before Flop (didn't bet)
Seat 2: bearlar folded before Flop (didn't bet)
Seat 3: Rafaello18 folded before Flop (didn't bet)
Seat 4: mbk88 (button) folded before Flop (didn't bet)
Seat 5: DIMAN_324 (small blind) folded on the Turn
Seat 7: arctur17 (big blind) collected ($11.40)
Seat 8: techahn folded before Flop (didn't bet)
Seat 9: matiko09 folded before Flop (didn't bet)





PokerStars Hand #155379523005:  Hold'em No Limit ($0.25/$0.50 USD) - 2016/06/30 13:30:16 CET [2016/06/30 7:30:16 ET]
Table 'Mentha II' 9-max Seat #9 is the button
Seat 1: Bailey Dew ($97.30 in chips) 
Seat 2: TheMinion ($50 in chips) 
Seat 3: Alexey_Kim2 ($50 in chips) 
Seat 5: matiko09 ($54.11 in chips) 
Seat 6: IceyyF91x ($92.45 in chips) 
Seat 7: ardo888 ($85.52 in chips) 
Seat 8: drlee77 ($48.72 in chips) 
Seat 9: er13to ($55 in chips) 
Bailey Dew: posts small blind $0.25
TheMinion: posts big blind $0.50
Bailey Dew: posts the ante $0.10
TheMinion: posts the ante $0.10
Alexey_Kim2: posts the ante $0.10
matiko09: posts the ante $0.10
IceyyF91x: posts the ante $0.10
ardo888: posts the ante $0.10
drlee77: posts the ante $0.10
er13to: posts the ante $0.10
*** HOLE CARDS ***
Dealt to matiko09 [3h Kc]
Alexey_Kim2: folds 
matiko09: folds 
IceyyF91x: raises $1 to $1.50
ardo888: folds 
drlee77: folds 
er13to: folds 
Bailey Dew: folds 
TheMinion: folds 
Uncalled bet ($1) returned to IceyyF91x
IceyyF91x collected $2.05 from pot
IceyyF91x: doesn't show hand 
*** SUMMARY ***
Total pot $2.05 | Rake $0 
Seat 1: Bailey Dew (small blind) folded before Flop
Seat 2: TheMinion (big blind) folded before Flop
Seat 3: Alexey_Kim2 folded before Flop (didn't bet)
Seat 5: matiko09 folded before Flop (didn't bet)
Seat 6: IceyyF91x collected ($2.05)
Seat 7: ardo888 folded before Flop (didn't bet)
Seat 8: drlee77 folded before Flop (didn't bet)
Seat 9: er13to (button) folded before Flop (didn't bet)





PokerStars Hand #155379522896:  Hold'em No Limit ($0.50/$1.00 USD) - 2016/06/30 13:30:16 CET [2016/06/30 7:30:16 ET]
Table 'California II' 9-max Seat #7 is the button
Seat 1: Rafaello18 ($105.38 in chips) 
Seat 3: liakos120 ($82.82 in chips) 
Seat 4: mbk88 ($114.84 in chips) 
Seat 5: Rohitbarve ($99.86 in chips) 
Seat 6: matiko09 ($110.15 in chips) 
Seat 7: DomiVY ($77.50 in chips) 
Seat 8: picka4u ($38 in chips) 
picka4u: posts small blind $0.50
di0d80: is sitting out 
Rafaello18: posts big blind $1
er13to: sits out 
*** HOLE CARDS ***
Dealt to matiko09 [Th Qh]
liakos120: folds 
mbk88: folds 
Rohitbarve: folds 
matiko09: raises $1.50 to $2.50
DomiVY: folds 
picka4u: folds 
Rafaello18: raises $6.50 to $9
matiko09: calls $6.50
*** FLOP *** [5s 3c Tc]
Rafaello18: bets $8.96
matiko09: calls $8.96
*** TURN *** [5s 3c Tc] [Ah]
Rafaello18: bets $17.64
matiko09: folds 
Uncalled bet ($17.64) returned to Rafaello18
Rafaello18 collected $34.60 from pot
Rafaello18: doesn't show hand 
*** SUMMARY ***
Total pot $36.42 | Rake $1.82 
Board [5s 3c Tc Ah]
Seat 1: Rafaello18 (big blind) collected ($34.60)
Seat 3: liakos120 folded before Flop (didn't bet)
Seat 4: mbk88 folded before Flop (didn't bet)
Seat 5: Rohitbarve folded before Flop (didn't bet)
Seat 6: matiko09 folded on the Turn
Seat 7: DomiVY (button) folded before Flop (didn't bet)
Seat 8: picka4u (small blind) folded before Flop





PokerStars Hand #155379524916:  Hold'em No Limit ($0.50/$1.00 USD) - 2016/06/30 13:30:21 CET [2016/06/30 7:30:21 ET]
Table 'Simeisa II' 9-max Seat #8 is the button
Seat 1: KovIFish89 ($100 in chips) 
Seat 2: Rafaello18 ($139.16 in chips) 
Seat 3: matiko09 ($100 in chips) 
Seat 4: tipner ($100 in chips) 
Seat 5: arctur17 ($66.50 in chips) 
Seat 6: ammit9021 ($34.38 in chips) 
Seat 7: DomiVY ($44.72 in chips) 
Seat 8: picka4u ($98.77 in chips) 
Seat 9: mbk88 ($143.48 in chips) 
mbk88: posts small blind $0.50
KovIFish89: posts big blind $1
*** HOLE CARDS ***
Dealt to matiko09 [5d Tc]
Rafaello18: folds 
matiko09: folds 
tipner: folds 
arctur17: folds 
ammit9021: folds 
DomiVY: folds 
picka4u: raises $1.05 to $2.05
mbk88: folds 
KovIFish89: raises $5.95 to $8
picka4u: folds 
Uncalled bet ($5.95) returned to KovIFish89
KovIFish89 collected $4.60 from pot
KovIFish89: doesn't show hand 
*** SUMMARY ***
Total pot $4.60 | Rake $0 
Seat 1: KovIFish89 (big blind) collected ($4.60)
Seat 2: Rafaello18 folded before Flop (didn't bet)
Seat 3: matiko09 folded before Flop (didn't bet)
Seat 4: tipner folded before Flop (didn't bet)
Seat 5: arctur17 folded before Flop (didn't bet)
Seat 6: ammit9021 folded before Flop (didn't bet)
Seat 7: DomiVY folded before Flop (didn't bet)
Seat 8: picka4u (button) folded before Flop
Seat 9: mbk88 (small blind) folded before Flop





PokerStars Hand #155379526378:  Hold'em No Limit ($0.50/$1.00 USD) - 2016/06/30 13:30:24 CET [2016/06/30 7:30:24 ET]
Table 'Prieska' 9-max Seat #2 is the button
Seat 1: KovIFish89 ($104.72 in chips) 
Seat 2: B_style_cuz ($98.50 in chips) 
Seat 3: Rafaello18 ($100 in chips) 
Seat 4: matteo080613 ($81 in chips) 
Seat 5: ramzes160468 ($81.40 in chips) 
Seat 6: DIMAN_324 ($104.37 in chips) 
Seat 7: matiko09 ($100 in chips) 
Seat 9: OMG Dardania ($101.50 in chips) 
Rafaello18: posts small blind $0.50
matteo080613: posts big blind $1
mbk88: sits out 
*** HOLE CARDS ***
Dealt to matiko09 [2s 4s]
ramzes160468: folds 
DIMAN_324: folds 
matiko09: folds 
OMG Dardania: folds 
KovIFish89: folds 
B_style_cuz: raises $2 to $3
Rafaello18: calls $2.50
matteo080613: calls $2
*** FLOP *** [6s 3c 7d]
Rafaello18: checks 
matteo080613: bets $9
B_style_cuz: folds 
Rafaello18: calls $9
*** TURN *** [6s 3c 7d] [Js]
Rafaello18: checks 
matteo080613: bets $13
Rafaello18: calls $13
*** RIVER *** [6s 3c 7d Js] [4c]
Rafaello18: checks 
matteo080613: checks 
*** SHOW DOWN ***
Rafaello18: shows [9c 9h] (a pair of Nines)
matteo080613: mucks hand 
Rafaello18 collected $50.50 from pot
*** SUMMARY ***
Total pot $53 | Rake $2.50 
Board [6s 3c 7d Js 4c]
Seat 1: KovIFish89 folded before Flop (didn't bet)
Seat 2: B_style_cuz (button) folded on the Flop
Seat 3: Rafaello18 (small blind) showed [9c 9h] and won ($50.50) with a pair of Nines
Seat 4: matteo080613 (big blind) mucked [8d 8h]
Seat 5: ramzes160468 folded before Flop (didn't bet)
Seat 6: DIMAN_324 folded before Flop (didn't bet)
Seat 7: matiko09 folded before Flop (didn't bet)
Seat 9: OMG Dardania folded before Flop (didn't bet)





PokerStars Hand #155379526786:  Hold'em No Limit ($0.25/$0.50 USD) - 2016/06/30 13:30:25 CET [2016/06/30 7:30:25 ET]
Table 'Dorothea II' 9-max Seat #4 is the button
Seat 2: er13to ($50 in chips) 
Seat 3: Franky77200 ($88.93 in chips) 
Seat 4: matiko09 ($82.84 in chips) 
Seat 5: Bailey Dew ($62.17 in chips) 
Seat 6: ivan100886 ($27.65 in chips) 
Seat 7: Alexey_Kim2 ($51.35 in chips) 
Seat 8: TheMinion ($52.76 in chips) 
Seat 9: ardo888 ($78.62 in chips) 
Bailey Dew: posts small blind $0.25
ivan100886: posts big blind $0.50
er13to: posts the ante $0.10
Franky77200: posts the ante $0.10
matiko09: posts the ante $0.10
Bailey Dew: posts the ante $0.10
ivan100886: posts the ante $0.10
Alexey_Kim2: posts the ante $0.10
TheMinion: posts the ante $0.10
ardo888: posts the ante $0.10
*** HOLE CARDS ***
Dealt to matiko09 [7s 5s]
Alexey_Kim2: folds 
TheMinion: folds 
ardo888: folds 
er13to: raises $0.86 to $1.36
Franky77200: folds 
matiko09: folds 
Bailey Dew: folds 
ivan100886: raises $2.64 to $4
er13to: folds 
Uncalled bet ($2.64) returned to ivan100886
ivan100886 collected $3.77 from pot
*** SUMMARY ***
Total pot $3.77 | Rake $0 
Seat 2: er13to folded before Flop
Seat 3: Franky77200 folded before Flop (didn't bet)
Seat 4: matiko09 (button) folded before Flop (didn't bet)
Seat 5: Bailey Dew (small blind) folded before Flop
Seat 6: ivan100886 (big blind) collected ($3.77)
Seat 7: Alexey_Kim2 folded before Flop (didn't bet)
Seat 8: TheMinion folded before Flop (didn't bet)
Seat 9: ardo888 folded before Flop (didn't bet)





PokerStars Hand #155379527702:  Hold'em No Limit ($0.50/$1.00 USD) - 2016/06/30 13:30:27 CET [2016/06/30 7:30:27 ET]
Table 'Borrelly II' 9-max Seat #6 is the button
Seat 1: Rafaello18 ($130.38 in chips) 
Seat 2: tipner ($104.02 in chips) 
Seat 3: di0d80 ($100 in chips) 
Seat 4: DonRon_AT ($49.56 in chips) 
Seat 5: picka4u ($126.67 in chips) 
Seat 6: m_michalec ($163.38 in chips) 
Seat 7: matiko09 ($160.85 in chips) 
Seat 8: mbk88 ($100 in chips) 
Seat 9: makaveli978 ($54.10 in chips) 
matiko09: posts small blind $0.50
mbk88: posts big blind $1
*** HOLE CARDS ***
Dealt to matiko09 [8s Qs]
makaveli978: raises $2 to $3
Rafaello18: folds 
tipner: folds 
di0d80: folds 
DonRon_AT: folds 
picka4u: folds 
m_michalec: folds 
matiko09: folds 
mbk88: folds 
Uncalled bet ($2) returned to makaveli978
makaveli978 collected $2.50 from pot
makaveli978: doesn't show hand 
*** SUMMARY ***
Total pot $2.50 | Rake $0 
Seat 1: Rafaello18 folded before Flop (didn't bet)
Seat 2: tipner folded before Flop (didn't bet)
Seat 3: di0d80 folded before Flop (didn't bet)
Seat 4: DonRon_AT folded before Flop (didn't bet)
Seat 5: picka4u folded before Flop (didn't bet)
Seat 6: m_michalec (button) folded before Flop (didn't bet)
Seat 7: matiko09 (small blind) folded before Flop
Seat 8: mbk88 (big blind) folded before Flop
Seat 9: makaveli978 collected ($2.50)





PokerStars Hand #155379531568:  Hold'em No Limit ($0.50/$1.00 USD) - 2016/06/30 13:30:37 CET [2016/06/30 7:30:37 ET]
Table 'Armisticia' 9-max Seat #7 is the button
Seat 1: di0d80 ($101.50 in chips) 
Seat 2: Rafaello18 ($208.89 in chips) 
Seat 4: DomiVY ($55.74 in chips) 
Seat 6: matiko09 ($125.12 in chips) 
Seat 7: sanr23 ($101.43 in chips) 
Seat 8: techahn ($118 in chips) 
Seat 9: mbk88 ($119.90 in chips) 
techahn: posts small blind $0.50
mbk88: posts big blind $1
*** HOLE CARDS ***
Dealt to matiko09 [5d 3h]
di0d80: folds 
Rafaello18: folds 
DomiVY: folds 
matiko09: folds 
sanr23: folds 
techahn: raises $2 to $3
mbk88: raises $7 to $10
techahn: calls $7
*** FLOP *** [9d Jd 3d]
techahn: checks 
mbk88: checks 
*** TURN *** [9d Jd 3d] [Jh]
techahn: checks 
mbk88: checks 
*** RIVER *** [9d Jd 3d Jh] [Td]
techahn: bets $9.50
mbk88: folds 
Uncalled bet ($9.50) returned to techahn
techahn collected $19 from pot
techahn: doesn't show hand 
*** SUMMARY ***
Total pot $20 | Rake $1 
Board [9d Jd 3d Jh Td]
Seat 1: di0d80 folded before Flop (didn't bet)
Seat 2: Rafaello18 folded before Flop (didn't bet)
Seat 4: DomiVY folded before Flop (didn't bet)
Seat 6: matiko09 folded before Flop (didn't bet)
Seat 7: sanr23 (button) folded before Flop (didn't bet)
Seat 8: techahn (small blind) collected ($19)
Seat 9: mbk88 (big blind) folded on the River





PokerStars Hand #155379533431:  Hold'em No Limit ($0.25/$0.50 USD) - 2016/06/30 13:30:41 CET [2016/06/30 7:30:41 ET]
Table 'Mentha II' 9-max Seat #1 is the button
Seat 1: Bailey Dew ($96.95 in chips) 
Seat 2: TheMinion ($50 in chips) 
Seat 3: Alexey_Kim2 ($50 in chips) 
Seat 5: matiko09 ($54.01 in chips) 
Seat 6: IceyyF91x ($93.90 in chips) 
Seat 7: ardo888 ($85.42 in chips) 
Seat 8: drlee77 ($48.62 in chips) 
Seat 9: er13to ($54.90 in chips) 
TheMinion: posts small blind $0.25
Alexey_Kim2: posts big blind $0.50
Bailey Dew: posts the ante $0.10
TheMinion: posts the ante $0.10
Alexey_Kim2: posts the ante $0.10
matiko09: posts the ante $0.10
IceyyF91x: posts the ante $0.10
ardo888: posts the ante $0.10
drlee77: posts the ante $0.10
er13to: posts the ante $0.10
*** HOLE CARDS ***
Dealt to matiko09 [Th Jh]
matiko09: raises $1 to $1.50
IceyyF91x: calls $1.50
ardo888: folds 
drlee77: folds 
er13to: raises $6 to $7.50
Bailey Dew: folds 
TheMinion: folds 
Alexey_Kim2: folds 
matiko09: folds 
IceyyF91x: calls $6
*** FLOP *** [6d 3s 6c]
matiko09 leaves the table
IceyyF91x: checks 
er13to: bets $6.25
IceyyF91x: raises $6.25 to $12.50
er13to: folds 
Uncalled bet ($6.25) returned to IceyyF91x
IceyyF91x collected $29.02 from pot
IceyyF91x: doesn't show hand 
*** SUMMARY ***
Total pot $30.55 | Rake $1.53 
Board [6d 3s 6c]
Seat 1: Bailey Dew (button) folded before Flop (didn't bet)
Seat 2: TheMinion (small blind) folded before Flop
Seat 3: Alexey_Kim2 (big blind) folded before Flop
Seat 5: matiko09 folded before Flop
Seat 6: IceyyF91x collected ($29.02)
Seat 7: ardo888 folded before Flop (didn't bet)
Seat 8: drlee77 folded before Flop (didn't bet)
Seat 9: er13to folded on the Flop





PokerStars Hand #155379536544:  Hold'em No Limit ($0.50/$1.00 USD) - 2016/06/30 13:30:48 CET [2016/06/30 7:30:48 ET]
Table 'Asmodeus' 9-max Seat #5 is the button
Seat 1: scollop ($107.69 in chips) 
Seat 2: picka4u ($45.02 in chips) 
Seat 3: matiko09 ($100 in chips) 
Seat 4: ardo888 ($139.28 in chips) 
Seat 5: sanr23 ($107.66 in chips) 
Seat 6: koutani7 ($90 in chips) 
Seat 7: aaronzzr ($149.11 in chips) 
Seat 8: Rafaello18 ($130.60 in chips) 
Seat 9: mbk88 ($167.18 in chips) 
koutani7: posts small blind $0.50
aaronzzr: posts big blind $1
*** HOLE CARDS ***
Dealt to matiko09 [5c Jc]
Rafaello18: folds 
mbk88: folds 
scollop: folds 
picka4u: raises $1.25 to $2.25
matiko09: folds 
ardo888: folds 
sanr23: folds 
koutani7: folds 
aaronzzr: folds 
Uncalled bet ($1.25) returned to picka4u
picka4u collected $2.50 from pot
picka4u: doesn't show hand 
*** SUMMARY ***
Total pot $2.50 | Rake $0 
Seat 1: scollop folded before Flop (didn't bet)
Seat 2: picka4u collected ($2.50)
Seat 3: matiko09 folded before Flop (didn't bet)
Seat 4: ardo888 folded before Flop (didn't bet)
Seat 5: sanr23 (button) folded before Flop (didn't bet)
Seat 6: koutani7 (small blind) folded before Flop
Seat 7: aaronzzr (big blind) folded before Flop
Seat 8: Rafaello18 folded before Flop (didn't bet)
Seat 9: mbk88 folded before Flop (didn't bet)





PokerStars Hand #155379542615:  Hold'em No Limit ($0.50/$1.00 USD) - 2016/06/30 13:31:02 CET [2016/06/30 7:31:02 ET]
Table 'Sigrid' 9-max Seat #5 is the button
Seat 1: DomiVY ($43.36 in chips) 
Seat 2: bearlar ($108.69 in chips) 
Seat 3: Rafaello18 ($117.50 in chips) 
Seat 4: mbk88 ($101.50 in chips) 
Seat 5: DIMAN_324 ($103.24 in chips) 
Seat 7: arctur17 ($45.40 in chips) 
Seat 8: techahn ($146.06 in chips) 
Seat 9: matiko09 ($109.02 in chips) 
arctur17: posts small blind $0.50
techahn: posts big blind $1
*** HOLE CARDS ***
Dealt to matiko09 [Ks 2h]
matiko09: folds 
DomiVY: folds 
bearlar: folds 
Rafaello18: folds 
mbk88: raises $1.02 to $2.02
DIMAN_324: folds 
arctur17: folds 
techahn: calls $1.02
*** FLOP *** [Tc 6h Js]
techahn: checks 
mbk88: bets $4
techahn: folds 
Uncalled bet ($4) returned to mbk88
mbk88 collected $4.31 from pot
mbk88: doesn't show hand 
*** SUMMARY ***
Total pot $4.54 | Rake $0.23 
Board [Tc 6h Js]
Seat 1: DomiVY folded before Flop (didn't bet)
Seat 2: bearlar folded before Flop (didn't bet)
Seat 3: Rafaello18 folded before Flop (didn't bet)
Seat 4: mbk88 collected ($4.31)
Seat 5: DIMAN_324 (button) folded before Flop (didn't bet)
Seat 7: arctur17 (small blind) folded before Flop
Seat 8: techahn (big blind) folded on the Flop
Seat 9: matiko09 folded before Flop (didn't bet)





PokerStars Hand #155379547399:  Hold'em No Limit ($0.50/$1.00 USD) - 2016/06/30 13:31:13 CET [2016/06/30 7:31:13 ET]
Table 'Borrelly II' 9-max Seat #7 is the button
Seat 1: Rafaello18 ($130.38 in chips) 
Seat 2: tipner ($104.02 in chips) 
Seat 3: di0d80 ($100 in chips) 
Seat 4: DonRon_AT ($49.56 in chips) 
Seat 5: picka4u ($126.67 in chips) 
Seat 6: m_michalec ($163.38 in chips) 
Seat 7: matiko09 ($160.35 in chips) 
Seat 8: mbk88 ($100 in chips) 
Seat 9: makaveli978 ($55.60 in chips) 
mbk88: posts small blind $0.50
makaveli978: posts big blind $1
*** HOLE CARDS ***
Dealt to matiko09 [Qs 4c]
Rafaello18: folds 
tipner: raises $2 to $3
di0d80: folds 
DonRon_AT: calls $3
picka4u: calls $3
m_michalec: folds 
matiko09: folds 
mbk88: folds 
makaveli978: folds 
*** FLOP *** [Qc 4h 7d]
tipner: checks 
DonRon_AT: checks 
picka4u: bets $5
tipner: folds 
DonRon_AT: calls $5
*** TURN *** [Qc 4h 7d] [2h]
DonRon_AT: checks 
picka4u: checks 
*** RIVER *** [Qc 4h 7d 2h] [8c]
DonRon_AT: checks 
picka4u: checks 
*** SHOW DOWN ***
DonRon_AT: shows [6h 7h] (a pair of Sevens)
picka4u: shows [7c 9c] (a pair of Sevens - Queen+Nine kicker)
picka4u collected $19.48 from pot
*** SUMMARY ***
Total pot $20.50 | Rake $1.02 
Board [Qc 4h 7d 2h 8c]
Seat 1: Rafaello18 folded before Flop (didn't bet)
Seat 2: tipner folded on the Flop
Seat 3: di0d80 folded before Flop (didn't bet)
Seat 4: DonRon_AT showed [6h 7h] and lost with a pair of Sevens
Seat 5: picka4u showed [7c 9c] and won ($19.48) with a pair of Sevens
Seat 6: m_michalec folded before Flop (didn't bet)
Seat 7: matiko09 (button) folded before Flop (didn't bet)
Seat 8: mbk88 (small blind) folded before Flop
Seat 9: makaveli978 (big blind) folded before Flop





PokerStars Hand #155379550225:  Hold'em No Limit ($0.25/$0.50 USD) - 2016/06/30 13:31:20 CET [2016/06/30 7:31:20 ET]
Table 'Dorothea II' 9-max Seat #5 is the button
Seat 2: er13to ($50 in chips) 
Seat 3: Franky77200 ($88.83 in chips) 
Seat 4: matiko09 ($82.74 in chips) 
Seat 5: Bailey Dew ($61.82 in chips) 
Seat 6: ivan100886 ($29.96 in chips) 
Seat 7: Alexey_Kim2 ($51.25 in chips) 
Seat 8: TheMinion ($52.66 in chips) 
Seat 9: ardo888 ($78.52 in chips) 
ivan100886: posts small blind $0.25
Alexey_Kim2: posts big blind $0.50
er13to: posts the ante $0.10
Franky77200: posts the ante $0.10
matiko09: posts the ante $0.10
Bailey Dew: posts the ante $0.10
ivan100886: posts the ante $0.10
Alexey_Kim2: posts the ante $0.10
TheMinion: posts the ante $0.10
ardo888: posts the ante $0.10
*** HOLE CARDS ***
Dealt to matiko09 [Kd Ad]
TheMinion: folds 
ardo888: folds 
er13to: folds 
Franky77200: raises $1 to $1.50
matiko09: raises $5.50 to $7
Bailey Dew: calls $7
ivan100886: folds 
Alexey_Kim2: folds 
Franky77200: calls $5.50
*** FLOP *** [8c 8h Qh]
Franky77200: checks 
matiko09: checks 
Bailey Dew: bets $11.13
Franky77200: folds 
matiko09: folds 
Uncalled bet ($11.13) returned to Bailey Dew
Bailey Dew collected $21.42 from pot
Bailey Dew: doesn't show hand 
*** SUMMARY ***
Total pot $22.55 | Rake $1.13 
Board [8c 8h Qh]
Seat 2: er13to folded before Flop (didn't bet)
Seat 3: Franky77200 folded on the Flop
Seat 4: matiko09 folded on the Flop
Seat 5: Bailey Dew (button) collected ($21.42)
Seat 6: ivan100886 (small blind) folded before Flop
Seat 7: Alexey_Kim2 (big blind) folded before Flop
Seat 8: TheMinion folded before Flop (didn't bet)
Seat 9: ardo888 folded before Flop (didn't bet)





PokerStars Hand #155379554360:  Hold'em No Limit ($0.50/$1.00 USD) - 2016/06/30 13:31:29 CET [2016/06/30 7:31:29 ET]
Table 'Asmodeus' 9-max Seat #6 is the button
Seat 1: scollop ($107.69 in chips) 
Seat 2: picka4u ($46.52 in chips) 
Seat 3: matiko09 ($100 in chips) 
Seat 4: ardo888 ($139.28 in chips) 
Seat 5: sanr23 ($107.66 in chips) 
Seat 6: koutani7 ($89.50 in chips) 
Seat 7: aaronzzr ($148.11 in chips) 
Seat 8: Rafaello18 ($130.60 in chips) 
Seat 9: mbk88 ($167.18 in chips) 
aaronzzr: posts small blind $0.50
Rafaello18: posts big blind $1
*** HOLE CARDS ***
Dealt to matiko09 [As 4s]
mbk88: folds 
scollop: folds 
picka4u: folds 
matiko09: raises $2 to $3
ardo888: folds 
sanr23: folds 
koutani7: raises $7.50 to $10.50
aaronzzr: folds 
Rafaello18: folds 
matiko09: folds 
Uncalled bet ($7.50) returned to koutani7
koutani7 collected $7.50 from pot
koutani7: doesn't show hand 
*** SUMMARY ***
Total pot $7.50 | Rake $0 
Seat 1: scollop folded before Flop (didn't bet)
Seat 2: picka4u folded before Flop (didn't bet)
Seat 3: matiko09 folded before Flop
Seat 4: ardo888 folded before Flop (didn't bet)
Seat 5: sanr23 folded before Flop (didn't bet)
Seat 6: koutani7 (button) collected ($7.50)
Seat 7: aaronzzr (small blind) folded before Flop
Seat 8: Rafaello18 (big blind) folded before Flop
Seat 9: mbk88 folded before Flop (didn't bet)





PokerStars Hand #155379554702:  Hold'em No Limit ($0.50/$1.00 USD) - 2016/06/30 13:31:30 CET [2016/06/30 7:31:30 ET]
Table 'California II' 9-max Seat #8 is the button
Seat 1: Rafaello18 ($122.02 in chips) 
Seat 2: er13to ($100 in chips) 
Seat 3: liakos120 ($82.82 in chips) 
Seat 4: mbk88 ($114.84 in chips) 
Seat 5: Rohitbarve ($99.86 in chips) 
Seat 6: matiko09 ($100 in chips) 
Seat 7: DomiVY ($77.50 in chips) 
Seat 8: picka4u ($37.50 in chips) 
Rafaello18: posts small blind $0.50
er13to: posts big blind $1
*** HOLE CARDS ***
Dealt to matiko09 [9h 5c]
liakos120: folds 
mbk88: folds 
Rohitbarve: folds 
matiko09: folds 
DomiVY: raises $1.10 to $2.10
picka4u: folds 
Rafaello18: folds 
er13to: folds 
Uncalled bet ($1.10) returned to DomiVY
DomiVY collected $2.50 from pot
DomiVY: doesn't show hand 
*** SUMMARY ***
Total pot $2.50 | Rake $0 
Seat 1: Rafaello18 (small blind) folded before Flop
Seat 2: er13to (big blind) folded before Flop
Seat 3: liakos120 folded before Flop (didn't bet)
Seat 4: mbk88 folded before Flop (didn't bet)
Seat 5: Rohitbarve folded before Flop (didn't bet)
Seat 6: matiko09 folded before Flop (didn't bet)
Seat 7: DomiVY collected ($2.50)
Seat 8: picka4u (button) folded before Flop (didn't bet)





PokerStars Hand #155379554992:  Hold'em No Limit ($0.50/$1.00 USD) - 2016/06/30 13:31:31 CET [2016/06/30 7:31:31 ET]
Table 'Armisticia' 9-max Seat #8 is the button
Seat 2: Rafaello18 ($208.89 in chips) 
Seat 4: DomiVY ($55.74 in chips) 
Seat 6: matiko09 ($125.12 in chips) 
Seat 7: sanr23 ($101.43 in chips) 
Seat 8: techahn ($127 in chips) 
Seat 9: mbk88 ($109.90 in chips) 
mbk88: posts small blind $0.50
di0d80: is sitting out 
Rafaello18: posts big blind $1
*** HOLE CARDS ***
Dealt to matiko09 [Qc As]
DomiVY: folds 
matiko09: raises $2 to $3
sanr23: folds 
techahn: calls $3
mbk88: calls $2.50
Rafaello18: folds 
*** FLOP *** [5d 9s 3h]
mbk88: checks 
matiko09: bets $6
techahn: folds 
mbk88: folds 
Uncalled bet ($6) returned to matiko09
matiko09 collected $9.50 from pot
matiko09: doesn't show hand 
*** SUMMARY ***
Total pot $10 | Rake $0.50 
Board [5d 9s 3h]
Seat 2: Rafaello18 (big blind) folded before Flop
Seat 4: DomiVY folded before Flop (didn't bet)
Seat 6: matiko09 collected ($9.50)
Seat 7: sanr23 folded before Flop (didn't bet)
Seat 8: techahn (button) folded on the Flop
Seat 9: mbk88 (small blind) folded on the Flop





PokerStars Hand #155379556927:  Hold'em No Limit ($0.50/$1.00 USD) - 2016/06/30 13:31:36 CET [2016/06/30 7:31:36 ET]
Table 'Tatjana' 9-max Seat #3 is the button
Seat 1: ardo888 ($122.46 in chips) 
Seat 2: DIMAN_324 ($100 in chips) 
Seat 3: Rafaello18 ($106.13 in chips) 
Seat 4: Konig26 ($185.20 in chips) 
Seat 5: matiko09 ($103.58 in chips) 
Seat 6: mbk88 ($100 in chips) 
Seat 7: DomiVY ($40 in chips) 
Seat 8: alhill86 ($106.15 in chips) 
Seat 9: POTAPENKO700 ($101.50 in chips) 
Konig26: posts small blind $0.50
matiko09: posts big blind $1
*** HOLE CARDS ***
Dealt to matiko09 [6s 7s]
mbk88: folds 
DomiVY: folds 
alhill86: folds 
POTAPENKO700: folds 
ardo888: folds 
DIMAN_324: raises $1.40 to $2.40
Rafaello18: folds 
Konig26: calls $1.90
matiko09: calls $1.40
*** FLOP *** [Jc 6d Ks]
Konig26: checks 
matiko09: checks 
DIMAN_324: checks 
*** TURN *** [Jc 6d Ks] [2h]
Konig26: checks 
matiko09: checks 
DIMAN_324: checks 
*** RIVER *** [Jc 6d Ks 2h] [5c]
Konig26: bets $3.42
matiko09: folds 
DIMAN_324: folds 
Uncalled bet ($3.42) returned to Konig26
Konig26 collected $6.84 from pot
Konig26: doesn't show hand 
*** SUMMARY ***
Total pot $7.20 | Rake $0.36 
Board [Jc 6d Ks 2h 5c]
Seat 1: ardo888 folded before Flop (didn't bet)
Seat 2: DIMAN_324 folded on the River
Seat 3: Rafaello18 (button) folded before Flop (didn't bet)
Seat 4: Konig26 (small blind) collected ($6.84)
Seat 5: matiko09 (big blind) folded on the River
Seat 6: mbk88 folded before Flop (didn't bet)
Seat 7: DomiVY folded before Flop (didn't bet)
Seat 8: alhill86 folded before Flop (didn't bet)
Seat 9: POTAPENKO700 folded before Flop (didn't bet)





PokerStars Hand #155379562166:  Hold'em No Limit ($0.50/$1.00 USD) - 2016/06/30 13:31:48 CET [2016/06/30 7:31:48 ET]
Table 'Askania' 9-max Seat #2 is the button
Seat 1: korlito69 ($43.45 in chips) 
Seat 2: Rafaello18 ($118.02 in chips) 
Seat 3: DIMAN_324 ($100 in chips) 
Seat 4: mbk88 ($119.12 in chips) 
Seat 5: tipner ($103 in chips) 
Seat 6: matiko09 ($272.35 in chips) 
Seat 7: ardo888 ($144.80 in chips) 
Seat 8: DomiVY ($71.50 in chips) 
Seat 9: picka4u ($51.62 in chips) 
DIMAN_324: posts small blind $0.50
mbk88: posts big blind $1
*** HOLE CARDS ***
Dealt to matiko09 [Jd Jc]
tipner: folds 
matiko09: raises $2 to $3
ardo888: folds 
DomiVY: folds 
picka4u: folds 
korlito69: folds 
Rafaello18: folds 
DIMAN_324: folds 
mbk88: folds 
Uncalled bet ($2) returned to matiko09
matiko09 collected $2.50 from pot
matiko09: doesn't show hand 
*** SUMMARY ***
Total pot $2.50 | Rake $0 
Seat 1: korlito69 folded before Flop (didn't bet)
Seat 2: Rafaello18 (button) folded before Flop (didn't bet)
Seat 3: DIMAN_324 (small blind) folded before Flop
Seat 4: mbk88 (big blind) folded before Flop
Seat 5: tipner folded before Flop (didn't bet)
Seat 6: matiko09 collected ($2.50)
Seat 7: ardo888 folded before Flop (didn't bet)
Seat 8: DomiVY folded before Flop (didn't bet)
Seat 9: picka4u folded before Flop (didn't bet)





PokerStars Hand #155379568628:  Hold'em No Limit ($0.50/$1.00 USD) - 2016/06/30 13:32:03 CET [2016/06/30 7:32:03 ET]
Table 'California II' 9-max Seat #1 is the button
Seat 1: Rafaello18 ($121.52 in chips) 
Seat 2: er13to ($100 in chips) 
Seat 3: liakos120 ($82.82 in chips) 
Seat 4: mbk88 ($114.84 in chips) 
Seat 5: Rohitbarve ($99.86 in chips) 
Seat 6: matiko09 ($100 in chips) 
Seat 7: DomiVY ($79 in chips) 
Seat 8: picka4u ($37.50 in chips) 
er13to: posts small blind $0.50
liakos120: posts big blind $1
*** HOLE CARDS ***
Dealt to matiko09 [Ks Ac]
mbk88: folds 
Rohitbarve: folds 
matiko09: raises $2 to $3
DomiVY: folds 
picka4u: folds 
Rafaello18: folds 
er13to: folds 
liakos120: folds 
Uncalled bet ($2) returned to matiko09
matiko09 collected $2.50 from pot
matiko09: doesn't show hand 
*** SUMMARY ***
Total pot $2.50 | Rake $0 
Seat 1: Rafaello18 (button) folded before Flop (didn't bet)
Seat 2: er13to (small blind) folded before Flop
Seat 3: liakos120 (big blind) folded before Flop
Seat 4: mbk88 folded before Flop (didn't bet)
Seat 5: Rohitbarve folded before Flop (didn't bet)
Seat 6: matiko09 collected ($2.50)
Seat 7: DomiVY folded before Flop (didn't bet)
Seat 8: picka4u folded before Flop (didn't bet)





PokerStars Hand #155379570747:  Hold'em No Limit ($0.25/$0.50 USD) - 2016/06/30 13:32:08 CET [2016/06/30 7:32:08 ET]
Table 'Elektra II' 9-max Seat #2 is the button
Seat 1: drlee77 ($48.27 in chips) 
Seat 2: TheMinion ($54.13 in chips) 
Seat 3: mojtabagol ($60.74 in chips) 
Seat 4: matiko09 ($50 in chips) 
Seat 5: Rafaello18 ($60.74 in chips) 
Seat 6: pfunkolstar ($50 in chips) 
Seat 7: MuddyDance ($50 in chips) 
Seat 8: sanr23 ($61.65 in chips) 
Seat 9: Dantistcopra ($54.84 in chips) 
mojtabagol: posts small blind $0.25
matiko09: posts big blind $0.50
*** HOLE CARDS ***
Dealt to matiko09 [5c Ah]
Rafaello18: folds 
pfunkolstar: folds 
MuddyDance: folds 
sanr23: folds 
Dantistcopra: folds 
drlee77: folds 
TheMinion: folds 
mojtabagol: raises $1 to $1.50
matiko09: calls $1
*** FLOP *** [9d 3s 6d]
mojtabagol: bets $2.85
matiko09: folds 
Uncalled bet ($2.85) returned to mojtabagol
mojtabagol collected $2.85 from pot
*** SUMMARY ***
Total pot $3 | Rake $0.15 
Board [9d 3s 6d]
Seat 1: drlee77 folded before Flop (didn't bet)
Seat 2: TheMinion (button) folded before Flop (didn't bet)
Seat 3: mojtabagol (small blind) collected ($2.85)
Seat 4: matiko09 (big blind) folded on the Flop
Seat 5: Rafaello18 folded before Flop (didn't bet)
Seat 6: pfunkolstar folded before Flop (didn't bet)
Seat 7: MuddyDance folded before Flop (didn't bet)
Seat 8: sanr23 folded before Flop (didn't bet)
Seat 9: Dantistcopra folded before Flop (didn't bet)





PokerStars Hand #155379575075:  Hold'em No Limit ($0.50/$1.00 USD) - 2016/06/30 13:32:18 CET [2016/06/30 7:32:18 ET]
Table 'Asmodeus' 9-max Seat #7 is the button
Seat 1: scollop ($107.69 in chips) 
Seat 2: picka4u ($46.52 in chips) 
Seat 3: matiko09 ($100 in chips) 
Seat 4: ardo888 ($139.28 in chips) 
Seat 5: sanr23 ($107.66 in chips) 
Seat 6: koutani7 ($94 in chips) 
Seat 7: aaronzzr ($147.61 in chips) 
Seat 8: Rafaello18 ($129.60 in chips) 
Seat 9: mbk88 ($167.18 in chips) 
Rafaello18: posts small blind $0.50
mbk88: posts big blind $1
*** HOLE CARDS ***
Dealt to matiko09 [7h 8h]
scollop: folds 
picka4u: folds 
matiko09: raises $2 to $3
ardo888: folds 
sanr23: folds 
koutani7: folds 
aaronzzr: folds 
Rafaello18: folds 
mbk88: folds 
Uncalled bet ($2) returned to matiko09
matiko09 collected $2.50 from pot
matiko09: doesn't show hand 
*** SUMMARY ***
Total pot $2.50 | Rake $0 
Seat 1: scollop folded before Flop (didn't bet)
Seat 2: picka4u folded before Flop (didn't bet)
Seat 3: matiko09 collected ($2.50)
Seat 4: ardo888 folded before Flop (didn't bet)
Seat 5: sanr23 folded before Flop (didn't bet)
Seat 6: koutani7 folded before Flop (didn't bet)
Seat 7: aaronzzr (button) folded before Flop (didn't bet)
Seat 8: Rafaello18 (small blind) folded before Flop
Seat 9: mbk88 (big blind) folded before Flop





PokerStars Hand #155379575051:  Hold'em No Limit ($0.50/$1.00 USD) - 2016/06/30 13:32:18 CET [2016/06/30 7:32:18 ET]
Table 'Armisticia' 9-max Seat #9 is the button
Seat 2: Rafaello18 ($207.89 in chips) 
Seat 4: DomiVY ($55.74 in chips) 
Seat 6: matiko09 ($131.62 in chips) 
Seat 7: sanr23 ($101.43 in chips) 
Seat 8: techahn ($124 in chips) 
Seat 9: mbk88 ($106.90 in chips) 
Rafaello18: posts small blind $0.50
DomiVY: posts big blind $1
*** HOLE CARDS ***
Dealt to matiko09 [Qs Kd]
matiko09: raises $2 to $3
sanr23: folds 
techahn: folds 
mbk88: folds 
Rafaello18: folds 
DomiVY: folds 
Uncalled bet ($2) returned to matiko09
matiko09 collected $2.50 from pot
matiko09: doesn't show hand 
*** SUMMARY ***
Total pot $2.50 | Rake $0 
Seat 2: Rafaello18 (small blind) folded before Flop
Seat 4: DomiVY (big blind) folded before Flop
Seat 6: matiko09 collected ($2.50)
Seat 7: sanr23 folded before Flop (didn't bet)
Seat 8: techahn folded before Flop (didn't bet)
Seat 9: mbk88 (button) folded before Flop (didn't bet)





PokerStars Hand #155379575682:  Hold'em No Limit ($0.50/$1.00 USD) - 2016/06/30 13:32:19 CET [2016/06/30 7:32:19 ET]
Table 'Prieska' 9-max Seat #3 is the button
Seat 1: KovIFish89 ($104.72 in chips) 
Seat 2: B_style_cuz ($95.50 in chips) 
Seat 3: Rafaello18 ($125.50 in chips) 
Seat 4: matteo080613 ($56 in chips) 
Seat 5: ramzes160468 ($81.40 in chips) 
Seat 6: DIMAN_324 ($104.37 in chips) 
Seat 7: matiko09 ($100 in chips) 
Seat 9: OMG Dardania ($101.50 in chips) 
matteo080613: posts small blind $0.50
ramzes160468: posts big blind $1
mbk88: sits out 
*** HOLE CARDS ***
Dealt to matiko09 [9s Kc]
DIMAN_324: folds 
matiko09: folds 
OMG Dardania: folds 
KovIFish89: folds 
B_style_cuz: raises $2.50 to $3.50
Rafaello18: folds 
matteo080613: calls $3
ramzes160468: folds 
*** FLOP *** [8c Jc 6s]
matteo080613: checks 
B_style_cuz: bets $5
matteo080613: folds 
Uncalled bet ($5) returned to B_style_cuz
B_style_cuz collected $7.60 from pot
*** SUMMARY ***
Total pot $8 | Rake $0.40 
Board [8c Jc 6s]
Seat 1: KovIFish89 folded before Flop (didn't bet)
Seat 2: B_style_cuz collected ($7.60)
Seat 3: Rafaello18 (button) folded before Flop (didn't bet)
Seat 4: matteo080613 (small blind) folded on the Flop
Seat 5: ramzes160468 (big blind) folded before Flop
Seat 6: DIMAN_324 folded before Flop (didn't bet)
Seat 7: matiko09 folded before Flop (didn't bet)
Seat 9: OMG Dardania folded before Flop (didn't bet)





PokerStars Hand #155379577566:  Hold'em No Limit ($0.50/$1.00 USD) - 2016/06/30 13:32:24 CET [2016/06/30 7:32:24 ET]
Table 'Borrelly II' 9-max Seat #8 is the button
Seat 1: Rafaello18 ($130.38 in chips) 
Seat 2: tipner ($101.02 in chips) 
Seat 3: di0d80 ($100 in chips) 
Seat 4: DonRon_AT ($41.56 in chips) 
Seat 5: picka4u ($138.15 in chips) 
Seat 6: m_michalec ($163.38 in chips) 
Seat 7: matiko09 ($160.35 in chips) 
Seat 8: mbk88 ($100 in chips) 
Seat 9: makaveli978 ($54.60 in chips) 
makaveli978: posts small blind $0.50
Rafaello18: posts big blind $1
*** HOLE CARDS ***
Dealt to matiko09 [8d 2d]
tipner: folds 
di0d80: folds 
DonRon_AT: calls $1
picka4u: folds 
m_michalec: folds 
matiko09: folds 
mbk88: folds 
makaveli978: raises $2 to $3
Rafaello18: folds 
DonRon_AT: calls $2
*** FLOP *** [3d 4c 4s]
makaveli978: bets $6
DonRon_AT: folds 
Uncalled bet ($6) returned to makaveli978
makaveli978 collected $6.65 from pot
*** SUMMARY ***
Total pot $7 | Rake $0.35 
Board [3d 4c 4s]
Seat 1: Rafaello18 (big blind) folded before Flop
Seat 2: tipner folded before Flop (didn't bet)
Seat 3: di0d80 folded before Flop (didn't bet)
Seat 4: DonRon_AT folded on the Flop
Seat 5: picka4u folded before Flop (didn't bet)
Seat 6: m_michalec folded before Flop (didn't bet)
Seat 7: matiko09 folded before Flop (didn't bet)
Seat 8: mbk88 (button) folded before Flop (didn't bet)
Seat 9: makaveli978 (small blind) collected ($6.65)





PokerStars Hand #155379578733:  Hold'em No Limit ($0.50/$1.00 USD) - 2016/06/30 13:32:27 CET [2016/06/30 7:32:27 ET]
Table 'California II' 9-max Seat #2 is the button
Seat 1: Rafaello18 ($121.52 in chips) 
Seat 2: er13to ($100 in chips) 
Seat 3: liakos120 ($81.82 in chips) 
Seat 4: mbk88 ($114.84 in chips) 
Seat 5: Rohitbarve ($99.86 in chips) 
Seat 6: matiko09 ($101.50 in chips) 
Seat 7: DomiVY ($79 in chips) 
Seat 8: picka4u ($37.50 in chips) 
liakos120: posts small blind $0.50
mbk88: posts big blind $1
*** HOLE CARDS ***
Dealt to matiko09 [7s 3h]
Rohitbarve: folds 
matiko09: folds 
DomiVY: raises $2 to $3
picka4u: folds 
Rafaello18: folds 
er13to: folds 
liakos120: folds 
mbk88: folds 
Uncalled bet ($2) returned to DomiVY
DomiVY collected $2.50 from pot
DomiVY: doesn't show hand 
*** SUMMARY ***
Total pot $2.50 | Rake $0 
Seat 1: Rafaello18 folded before Flop (didn't bet)
Seat 2: er13to (button) folded before Flop (didn't bet)
Seat 3: liakos120 (small blind) folded before Flop
Seat 4: mbk88 (big blind) folded before Flop
Seat 5: Rohitbarve folded before Flop (didn't bet)
Seat 6: matiko09 folded before Flop (didn't bet)
Seat 7: DomiVY collected ($2.50)
Seat 8: picka4u folded before Flop (didn't bet)





PokerStars Hand #155379581347:  Hold'em No Limit ($0.25/$0.50 USD) - 2016/06/30 13:32:33 CET [2016/06/30 7:32:33 ET]
Table 'Dorothea II' 9-max Seat #6 is the button
Seat 2: er13to ($50 in chips) 
Seat 3: Franky77200 ($81.73 in chips) 
Seat 4: matiko09 ($75.64 in chips) 
Seat 5: Bailey Dew ($76.14 in chips) 
Seat 6: ivan100886 ($29.61 in chips) 
Seat 7: Alexey_Kim2 ($50.65 in chips) 
Seat 8: TheMinion ($52.56 in chips) 
Seat 9: ardo888 ($78.42 in chips) 
Alexey_Kim2: posts small blind $0.25
TheMinion: posts big blind $0.50
er13to: posts the ante $0.10
Franky77200: posts the ante $0.10
matiko09: posts the ante $0.10
Bailey Dew: posts the ante $0.10
ivan100886: posts the ante $0.10
Alexey_Kim2: posts the ante $0.10
TheMinion: posts the ante $0.10
ardo888: posts the ante $0.10
*** HOLE CARDS ***
Dealt to matiko09 [3d Td]
ardo888: folds 
er13to: raises $0.86 to $1.36
Franky77200: calls $1.36
matiko09: folds 
Bailey Dew: folds 
ivan100886: folds 
Alexey_Kim2: folds 
TheMinion: folds 
*** FLOP *** [Jd 2c 4d]
er13to: checks 
Franky77200: bets $3
er13to: calls $3
*** TURN *** [Jd 2c 4d] [3c]
er13to: checks 
Franky77200: checks 
*** RIVER *** [Jd 2c 4d 3c] [7s]
er13to: checks 
Franky77200: bets $8
er13to: folds 
Uncalled bet ($8) returned to Franky77200
Franky77200 collected $9.76 from pot
Franky77200: doesn't show hand 
*** SUMMARY ***
Total pot $10.27 | Rake $0.51 
Board [Jd 2c 4d 3c 7s]
Seat 2: er13to folded on the River
Seat 3: Franky77200 collected ($9.76)
Seat 4: matiko09 folded before Flop (didn't bet)
Seat 5: Bailey Dew folded before Flop (didn't bet)
Seat 6: ivan100886 (button) folded before Flop (didn't bet)
Seat 7: Alexey_Kim2 (small blind) folded before Flop
Seat 8: TheMinion (big blind) folded before Flop
Seat 9: ardo888 folded before Flop (didn't bet)





PokerStars Hand #155379585430:  Hold'em No Limit ($0.50/$1.00 USD) - 2016/06/30 13:32:42 CET [2016/06/30 7:32:42 ET]
Table 'Tatjana' 9-max Seat #4 is the button
Seat 1: ardo888 ($122.46 in chips) 
Seat 2: DIMAN_324 ($100 in chips) 
Seat 3: Rafaello18 ($106.13 in chips) 
Seat 4: Konig26 ($189.64 in chips) 
Seat 5: matiko09 ($101.18 in chips) 
Seat 6: mbk88 ($100 in chips) 
Seat 7: DomiVY ($40 in chips) 
Seat 8: alhill86 ($106.15 in chips) 
Seat 9: POTAPENKO700 ($101.50 in chips) 
matiko09: posts small blind $0.50
mbk88: posts big blind $1
*** HOLE CARDS ***
Dealt to matiko09 [9h Td]
DomiVY: folds 
alhill86: folds 
POTAPENKO700: folds 
ardo888: folds 
DIMAN_324: raises $2 to $3
Rafaello18: folds 
Konig26: calls $3
matiko09: folds 
mbk88: raises $9 to $12
DIMAN_324: calls $9
Konig26: calls $9
*** FLOP *** [Qh 6c Qc]
mbk88: bets $12
DIMAN_324: folds 
Konig26: calls $12
*** TURN *** [Qh 6c Qc] [Js]
mbk88: bets $23
Konig26: raises $27 to $50
mbk88: folds 
Uncalled bet ($27) returned to Konig26
Konig26 collected $104 from pot
Konig26: doesn't show hand 
*** SUMMARY ***
Total pot $106.50 | Rake $2.50 
Board [Qh 6c Qc Js]
Seat 1: ardo888 folded before Flop (didn't bet)
Seat 2: DIMAN_324 folded on the Flop
Seat 3: Rafaello18 folded before Flop (didn't bet)
Seat 4: Konig26 (button) collected ($104)
Seat 5: matiko09 (small blind) folded before Flop
Seat 6: mbk88 (big blind) folded on the Turn
Seat 7: DomiVY folded before Flop (didn't bet)
Seat 8: alhill86 folded before Flop (didn't bet)
Seat 9: POTAPENKO700 folded before Flop (didn't bet)





PokerStars Hand #155379585382:  Hold'em No Limit ($0.50/$1.00 USD) - 2016/06/30 13:32:42 CET [2016/06/30 7:32:42 ET]
Table 'Armisticia' 9-max Seat #2 is the button
Seat 2: Rafaello18 ($207.39 in chips) 
Seat 4: DomiVY ($54.74 in chips) 
Seat 6: matiko09 ($133.12 in chips) 
Seat 7: sanr23 ($101.43 in chips) 
Seat 8: techahn ($124 in chips) 
Seat 9: mbk88 ($106.90 in chips) 
DomiVY: posts small blind $0.50
matiko09: posts big blind $1
*** HOLE CARDS ***
Dealt to matiko09 [3c Ts]
sanr23: folds 
techahn: raises $2 to $3
mbk88: folds 
Rafaello18: folds 
DomiVY: folds 
matiko09: folds 
Uncalled bet ($2) returned to techahn
techahn collected $2.50 from pot
techahn: doesn't show hand 
*** SUMMARY ***
Total pot $2.50 | Rake $0 
Seat 2: Rafaello18 (button) folded before Flop (didn't bet)
Seat 4: DomiVY (small blind) folded before Flop
Seat 6: matiko09 (big blind) folded before Flop
Seat 7: sanr23 folded before Flop (didn't bet)
Seat 8: techahn collected ($2.50)
Seat 9: mbk88 folded before Flop (didn't bet)





PokerStars Hand #155379589795:  Hold'em No Limit ($0.25/$0.50 USD) - 2016/06/30 13:32:52 CET [2016/06/30 7:32:52 ET]
Table 'Elektra II' 9-max Seat #3 is the button
Seat 1: drlee77 ($48.27 in chips) 
Seat 2: TheMinion ($54.13 in chips) 
Seat 3: mojtabagol ($62.09 in chips) 
Seat 4: matiko09 ($50 in chips) 
Seat 5: Rafaello18 ($60.74 in chips) 
Seat 6: pfunkolstar ($50 in chips) 
Seat 7: MuddyDance ($50 in chips) 
Seat 8: sanr23 ($61.65 in chips) 
Seat 9: Dantistcopra ($54.84 in chips) 
matiko09: posts small blind $0.25
Rafaello18: posts big blind $0.50
*** HOLE CARDS ***
Dealt to matiko09 [Kc Ks]
pfunkolstar: folds 
MuddyDance: folds 
sanr23: folds 
Dantistcopra: raises $1 to $1.50
drlee77: folds 
TheMinion: folds 
mojtabagol: folds 
matiko09: raises $4 to $5.50
Rafaello18: folds 
Dantistcopra: calls $4
*** FLOP *** [Ah Kh Jc]
matiko09: bets $5.67
Dantistcopra: calls $5.67
*** TURN *** [Ah Kh Jc] [9h]
matiko09: bets $11.50
Dantistcopra: folds 
Uncalled bet ($11.50) returned to matiko09
matiko09 collected $21.70 from pot
matiko09: doesn't show hand 
*** SUMMARY ***
Total pot $22.84 | Rake $1.14 
Board [Ah Kh Jc 9h]
Seat 1: drlee77 folded before Flop (didn't bet)
Seat 2: TheMinion folded before Flop (didn't bet)
Seat 3: mojtabagol (button) folded before Flop (didn't bet)
Seat 4: matiko09 (small blind) collected ($21.70)
Seat 5: Rafaello18 (big blind) folded before Flop
Seat 6: pfunkolstar folded before Flop (didn't bet)
Seat 7: MuddyDance folded before Flop (didn't bet)
Seat 8: sanr23 folded before Flop (didn't bet)
Seat 9: Dantistcopra folded on the Turn





PokerStars Hand #155379593655:  Hold'em No Limit ($0.50/$1.00 USD) - 2016/06/30 13:33:01 CET [2016/06/30 7:33:01 ET]
Table 'California II' 9-max Seat #3 is the button
Seat 1: Rafaello18 ($121.52 in chips) 
Seat 2: er13to ($100 in chips) 
Seat 3: liakos120 ($81.32 in chips) 
Seat 4: mbk88 ($113.84 in chips) 
Seat 5: Rohitbarve ($99.86 in chips) 
Seat 6: matiko09 ($101.50 in chips) 
Seat 7: DomiVY ($80.50 in chips) 
Seat 8: picka4u ($37.50 in chips) 
mbk88: posts small blind $0.50
Rohitbarve: posts big blind $1
*** HOLE CARDS ***
Dealt to matiko09 [3s 9h]
matiko09: folds 
DomiVY has timed out
DomiVY: folds 
picka4u: folds 
liakos120 is disconnected 
Rafaello18: folds 
er13to: folds 
liakos120 has timed out while disconnected
liakos120: folds 
mbk88: calls $0.50
Rohitbarve: checks 
*** FLOP *** [2h Ac Kc]
mbk88: checks 
Rohitbarve: bets $1
mbk88: calls $1
*** TURN *** [2h Ac Kc] [4c]
mbk88: checks 
Rohitbarve: checks 
*** RIVER *** [2h Ac Kc 4c] [6s]
mbk88: bets $4
Rohitbarve: folds 
Uncalled bet ($4) returned to mbk88
mbk88 collected $3.80 from pot
mbk88: doesn't show hand 
*** SUMMARY ***
Total pot $4 | Rake $0.20 
Board [2h Ac Kc 4c 6s]
Seat 1: Rafaello18 folded before Flop (didn't bet)
Seat 2: er13to folded before Flop (didn't bet)
Seat 3: liakos120 (button) folded before Flop (didn't bet)
Seat 4: mbk88 (small blind) collected ($3.80)
Seat 5: Rohitbarve (big blind) folded on the River
Seat 6: matiko09 folded before Flop (didn't bet)
Seat 7: DomiVY folded before Flop (didn't bet)
Seat 8: picka4u folded before Flop (didn't bet)





PokerStars Hand #155379596312:  Hold'em No Limit ($0.50/$1.00 USD) - 2016/06/30 13:33:07 CET [2016/06/30 7:33:07 ET]
Table 'Prieska' 9-max Seat #4 is the button
Seat 1: KovIFish89 ($104.72 in chips) 
Seat 2: B_style_cuz ($99.60 in chips) 
Seat 3: Rafaello18 ($125.50 in chips) 
Seat 4: matteo080613 ($52.50 in chips) 
Seat 5: ramzes160468 ($80.40 in chips) 
Seat 6: DIMAN_324 ($104.37 in chips) 
Seat 7: matiko09 ($100 in chips) 
Seat 9: OMG Dardania ($101.50 in chips) 
ramzes160468: posts small blind $0.50
DIMAN_324: posts big blind $1
mbk88: sits out 
*** HOLE CARDS ***
Dealt to matiko09 [Kc Tc]
matiko09: raises $2 to $3
OMG Dardania: folds 
KovIFish89: folds 
B_style_cuz: folds 
Rafaello18: folds 
matteo080613: folds 
ramzes160468: folds 
DIMAN_324: calls $2
*** FLOP *** [8s 8h Kh]
DIMAN_324: checks 
matiko09: bets $4
DIMAN_324: calls $4
*** TURN *** [8s 8h Kh] [8c]
DIMAN_324: checks 
matiko09: checks 
*** RIVER *** [8s 8h Kh 8c] [2h]
DIMAN_324: checks 
matiko09: bets $4.27
DIMAN_324: calls $4.27
*** SHOW DOWN ***
matiko09: shows [Kc Tc] (a full house, Eights full of Kings)
DIMAN_324: mucks hand 
matiko09 collected $21.89 from pot
*** SUMMARY ***
Total pot $23.04 | Rake $1.15 
Board [8s 8h Kh 8c 2h]
Seat 1: KovIFish89 folded before Flop (didn't bet)
Seat 2: B_style_cuz folded before Flop (didn't bet)
Seat 3: Rafaello18 folded before Flop (didn't bet)
Seat 4: matteo080613 (button) folded before Flop (didn't bet)
Seat 5: ramzes160468 (small blind) folded before Flop
Seat 6: DIMAN_324 (big blind) mucked [Qh Qs]
Seat 7: matiko09 showed [Kc Tc] and won ($21.89) with a full house, Eights full of Kings
Seat 9: OMG Dardania folded before Flop (didn't bet)





PokerStars Hand #155379598686:  Hold'em No Limit ($0.50/$1.00 USD) - 2016/06/30 13:33:13 CET [2016/06/30 7:33:13 ET]
Table 'Asmodeus' 9-max Seat #8 is the button
Seat 1: scollop ($107.69 in chips) 
Seat 2: picka4u ($46.52 in chips) 
Seat 3: matiko09 ($101.50 in chips) 
Seat 4: ardo888 ($139.28 in chips) 
Seat 5: sanr23 ($107.66 in chips) 
Seat 6: koutani7 ($94 in chips) 
Seat 7: aaronzzr ($147.61 in chips) 
Seat 8: Rafaello18 ($129.10 in chips) 
Seat 9: mbk88 ($166.18 in chips) 
mbk88: posts small blind $0.50
scollop: posts big blind $1
*** HOLE CARDS ***
Dealt to matiko09 [5h 6s]
picka4u: folds 
matiko09: folds 
ardo888: folds 
sanr23: raises $2 to $3
koutani7: folds 
aaronzzr: folds 
Rafaello18: raises $6 to $9
mbk88: folds 
scollop: calls $8
sanr23: calls $6
*** FLOP *** [7s 4s Tc]
scollop: checks 
sanr23: checks 
Rafaello18: bets $17
scollop: calls $17
sanr23: folds 
*** TURN *** [7s 4s Tc] [8d]
scollop: checks 
Rafaello18: bets $103.10 and is all-in
scollop: folds 
Uncalled bet ($103.10) returned to Rafaello18
Rafaello18 collected $59 from pot
Rafaello18: doesn't show hand 
*** SUMMARY ***
Total pot $61.50 | Rake $2.50 
Board [7s 4s Tc 8d]
Seat 1: scollop (big blind) folded on the Turn
Seat 2: picka4u folded before Flop (didn't bet)
Seat 3: matiko09 folded before Flop (didn't bet)
Seat 4: ardo888 folded before Flop (didn't bet)
Seat 5: sanr23 folded on the Flop
Seat 6: koutani7 folded before Flop (didn't bet)
Seat 7: aaronzzr folded before Flop (didn't bet)
Seat 8: Rafaello18 (button) collected ($59)
Seat 9: mbk88 (small blind) folded before Flop





PokerStars Hand #155379603128:  Hold'em No Limit ($0.50/$1.00 USD) - 2016/06/30 13:33:23 CET [2016/06/30 7:33:23 ET]
Table 'Borrelly II' 9-max Seat #9 is the button
Seat 1: Rafaello18 ($129.38 in chips) 
Seat 2: tipner ($101.02 in chips) 
Seat 3: di0d80 ($100 in chips) 
Seat 4: DonRon_AT ($38.56 in chips) 
Seat 5: picka4u ($138.15 in chips) 
Seat 6: m_michalec ($163.38 in chips) 
Seat 7: matiko09 ($160.35 in chips) 
Seat 8: mbk88 ($100 in chips) 
Seat 9: makaveli978 ($58.25 in chips) 
Rafaello18: posts small blind $0.50
tipner: posts big blind $1
*** HOLE CARDS ***
Dealt to matiko09 [Ac Ts]
di0d80: folds 
DonRon_AT: folds 
picka4u: folds 
m_michalec: folds 
matiko09: raises $2 to $3
mbk88: folds 
makaveli978: raises $7 to $10
Rafaello18: folds 
tipner: folds 
matiko09: folds 
Uncalled bet ($7) returned to makaveli978
makaveli978 collected $7.50 from pot
makaveli978: doesn't show hand 
*** SUMMARY ***
Total pot $7.50 | Rake $0 
Seat 1: Rafaello18 (small blind) folded before Flop
Seat 2: tipner (big blind) folded before Flop
Seat 3: di0d80 folded before Flop (didn't bet)
Seat 4: DonRon_AT folded before Flop (didn't bet)
Seat 5: picka4u folded before Flop (didn't bet)
Seat 6: m_michalec folded before Flop (didn't bet)
Seat 7: matiko09 folded before Flop
Seat 8: mbk88 folded before Flop (didn't bet)
Seat 9: makaveli978 (button) collected ($7.50)





PokerStars Hand #155379604262:  Hold'em No Limit ($0.50/$1.00 USD) - 2016/06/30 13:33:26 CET [2016/06/30 7:33:26 ET]
Table 'Armisticia' 9-max Seat #4 is the button
Seat 2: Rafaello18 ($207.39 in chips) 
Seat 4: DomiVY ($54.24 in chips) 
Seat 6: matiko09 ($132.12 in chips) 
Seat 7: sanr23 ($101.43 in chips) 
Seat 8: techahn ($125.50 in chips) 
Seat 9: mbk88 ($106.90 in chips) 
matiko09: posts small blind $0.50
sanr23: posts big blind $1
*** HOLE CARDS ***
Dealt to matiko09 [3c 5d]
techahn: folds 
mbk88: folds 
Rafaello18: raises $1.50 to $2.50
DomiVY: folds 
matiko09: folds 
sanr23: folds 
Uncalled bet ($1.50) returned to Rafaello18
Rafaello18 collected $2.50 from pot
Rafaello18: doesn't show hand 
*** SUMMARY ***
Total pot $2.50 | Rake $0 
Seat 2: Rafaello18 collected ($2.50)
Seat 4: DomiVY (button) folded before Flop (didn't bet)
Seat 6: matiko09 (small blind) folded before Flop
Seat 7: sanr23 (big blind) folded before Flop
Seat 8: techahn folded before Flop (didn't bet)
Seat 9: mbk88 folded before Flop (didn't bet)





PokerStars Hand #155379604630:  Hold'em No Limit ($0.50/$1.00 USD) - 2016/06/30 13:33:27 CET [2016/06/30 7:33:27 ET]
Table 'Eucharis' 9-max Seat #4 is the button
Seat 1: er13to ($100 in chips) 
Seat 2: sanr23 ($167.28 in chips) 
Seat 3: ramzes160468 ($86.40 in chips) 
Seat 4: nordzan ($32.76 in chips) 
Seat 5: Rafaello18 ($102 in chips) 
Seat 6: matiko09 ($100 in chips) 
Seat 7: Vikulja1993 ($103.55 in chips) 
Seat 8: anfisa.irk ($42.65 in chips) 
Rafaello18: posts small blind $0.50
matiko09: posts big blind $1
*** HOLE CARDS ***
Dealt to matiko09 [Qh 2c]
Vikulja1993: folds 
Vikulja1993 leaves the table
anfisa.irk: raises $2 to $3
er13to: folds 
sanr23: folds 
ramzes160468: folds 
nordzan: folds 
DIMAN_324 joins the table at seat #7 
Rafaello18: folds 
matiko09: folds 
Uncalled bet ($2) returned to anfisa.irk
anfisa.irk collected $2.50 from pot
anfisa.irk: doesn't show hand 
*** SUMMARY ***
Total pot $2.50 | Rake $0 
Seat 1: er13to folded before Flop (didn't bet)
Seat 2: sanr23 folded before Flop (didn't bet)
Seat 3: ramzes160468 folded before Flop (didn't bet)
Seat 4: nordzan (button) folded before Flop (didn't bet)
Seat 5: Rafaello18 (small blind) folded before Flop
Seat 6: matiko09 (big blind) folded before Flop
Seat 7: Vikulja1993 folded before Flop (didn't bet)
Seat 8: anfisa.irk collected ($2.50)





PokerStars Hand #155379614495:  Hold'em No Limit ($0.50/$1.00 USD) - 2016/06/30 13:33:50 CET [2016/06/30 7:33:50 ET]
Table 'Apisaon II' 9-max Seat #5 is the button
Seat 1: OMG Dardania ($168.27 in chips) 
Seat 3: matteo080613 ($103.93 in chips) 
Seat 4: mbk88 ($109.51 in chips) 
Seat 5: riccfch ($97.10 in chips) 
Seat 6: tipner ($100 in chips) 
Seat 7: matiko09 ($100 in chips) 
tipner: posts small blind $0.50
matiko09: posts big blind $1
OMG Dardania: posts the ante $0.20
matteo080613: posts the ante $0.20
mbk88: posts the ante $0.20
riccfch: posts the ante $0.20
tipner: posts the ante $0.20
matiko09: posts the ante $0.20
*** HOLE CARDS ***
Dealt to matiko09 [7s Qd]
OMG Dardania: folds 
matteo080613: folds 
mbk88: raises $2 to $3
riccfch: calls $3
tipner: raises $10 to $13
matiko09: folds 
ardo888 joins the table at seat #8 
mbk88: folds 
riccfch: folds 
Uncalled bet ($10) returned to tipner
tipner collected $11.20 from pot
tipner: doesn't show hand 
*** SUMMARY ***
Total pot $11.20 | Rake $0 
Seat 1: OMG Dardania folded before Flop (didn't bet)
Seat 3: matteo080613 folded before Flop (didn't bet)
Seat 4: mbk88 folded before Flop
Seat 5: riccfch (button) folded before Flop
Seat 6: tipner (small blind) collected ($11.20)
Seat 7: matiko09 (big blind) folded before Flop





PokerStars Hand #155379617529:  Hold'em No Limit ($0.50/$1.00 USD) - 2016/06/30 13:33:57 CET [2016/06/30 7:33:57 ET]
Table 'Eucharis' 9-max Seat #5 is the button
Seat 1: er13to ($100 in chips) 
Seat 2: sanr23 ($167.28 in chips) 
Seat 3: ramzes160468 ($86.40 in chips) 
Seat 4: nordzan ($32.76 in chips) 
Seat 5: Rafaello18 ($101.50 in chips) 
Seat 6: matiko09 ($100 in chips) 
Seat 7: DIMAN_324 ($100 in chips) 
Seat 8: anfisa.irk ($44.15 in chips) 
matiko09: posts small blind $0.50
DIMAN_324: posts big blind $1
*** HOLE CARDS ***
Dealt to matiko09 [Tc 6d]
anfisa.irk: folds 
er13to: folds 
sanr23: raises $2 to $3
ramzes160468: calls $3
nordzan: folds 
Rafaello18: folds 
matiko09: folds 
DIMAN_324: calls $2
*** FLOP *** [Qh 6c Qd]
DIMAN_324: checks 
sanr23: bets $5.23
ramzes160468: calls $5.23
DIMAN_324: folds 
*** TURN *** [Qh 6c Qd] [9c]
sanr23: bets $7.77
ramzes160468: calls $7.77
*** RIVER *** [Qh 6c Qd 9c] [Js]
sanr23: checks 
ramzes160468: bets $17
sanr23: calls $17
*** SHOW DOWN ***
ramzes160468: shows [Ts Qs] (three of a kind, Queens)
sanr23: mucks hand 
ramzes160468 collected $67 from pot
*** SUMMARY ***
Total pot $69.50 | Rake $2.50 
Board [Qh 6c Qd 9c Js]
Seat 1: er13to folded before Flop (didn't bet)
Seat 2: sanr23 mucked [Kd Jd]
Seat 3: ramzes160468 showed [Ts Qs] and won ($67) with three of a kind, Queens
Seat 4: nordzan folded before Flop (didn't bet)
Seat 5: Rafaello18 (button) folded before Flop (didn't bet)
Seat 6: matiko09 (small blind) folded before Flop
Seat 7: DIMAN_324 (big blind) folded on the Flop
Seat 8: anfisa.irk folded before Flop (didn't bet)





PokerStars Hand #155379622258:  Hold'em No Limit ($0.25/$0.50 USD) - 2016/06/30 13:34:08 CET [2016/06/30 7:34:08 ET]
Table 'Dorothea II' 9-max Seat #7 is the button
Seat 2: er13to ($50 in chips) 
Seat 3: Franky77200 ($87.03 in chips) 
Seat 4: matiko09 ($75.54 in chips) 
Seat 5: Bailey Dew ($76.04 in chips) 
Seat 6: ivan100886 ($29.51 in chips) 
Seat 7: Alexey_Kim2 ($50.30 in chips) 
Seat 8: TheMinion ($51.96 in chips) 
Seat 9: ardo888 ($78.32 in chips) 
TheMinion: posts small blind $0.25
ardo888: posts big blind $0.50
er13to: posts the ante $0.10
Franky77200: posts the ante $0.10
matiko09: posts the ante $0.10
Bailey Dew: posts the ante $0.10
ivan100886: posts the ante $0.10
Alexey_Kim2: posts the ante $0.10
TheMinion: posts the ante $0.10
ardo888: posts the ante $0.10
*** HOLE CARDS ***
Dealt to matiko09 [2h 9c]
er13to: folds 
Franky77200: folds 
matiko09: folds 
Bailey Dew: folds 
ivan100886: raises $0.75 to $1.25
Alexey_Kim2: folds 
TheMinion: folds 
ardo888: folds 
Uncalled bet ($0.75) returned to ivan100886
ivan100886 collected $2.05 from pot
*** SUMMARY ***
Total pot $2.05 | Rake $0 
Seat 2: er13to folded before Flop (didn't bet)
Seat 3: Franky77200 folded before Flop (didn't bet)
Seat 4: matiko09 folded before Flop (didn't bet)
Seat 5: Bailey Dew folded before Flop (didn't bet)
Seat 6: ivan100886 collected ($2.05)
Seat 7: Alexey_Kim2 (button) folded before Flop (didn't bet)
Seat 8: TheMinion (small blind) folded before Flop
Seat 9: ardo888 (big blind) folded before Flop





PokerStars Hand #155379623854:  Hold'em No Limit ($0.25/$0.50 USD) - 2016/06/30 13:34:11 CET [2016/06/30 7:34:11 ET]
Table 'Elektra II' 9-max Seat #4 is the button
Seat 1: drlee77 ($48.27 in chips) 
Seat 2: TheMinion ($54.13 in chips) 
Seat 3: mojtabagol ($62.09 in chips) 
Seat 4: matiko09 ($60.53 in chips) 
Seat 5: Rafaello18 ($60.24 in chips) 
Seat 6: pfunkolstar ($50 in chips) 
Seat 7: MuddyDance ($50 in chips) 
Seat 8: sanr23 ($61.65 in chips) 
Seat 9: Dantistcopra ($50 in chips) 
Rafaello18: posts small blind $0.25
pfunkolstar: posts big blind $0.50
*** HOLE CARDS ***
Dealt to matiko09 [6c Qd]
MuddyDance: folds 
sanr23: raises $1 to $1.50
Dantistcopra: folds 
drlee77: calls $1.50
TheMinion: folds 
mojtabagol: folds 
matiko09: folds 
Rafaello18: folds 
pfunkolstar: calls $1
*** FLOP *** [Ac Th 5d]
pfunkolstar: checks 
sanr23: checks 
drlee77: checks 
*** TURN *** [Ac Th 5d] [6d]
pfunkolstar: checks 
sanr23: checks 
drlee77: bets $3
pfunkolstar: folds 
sanr23: folds 
Uncalled bet ($3) returned to drlee77
drlee77 collected $4.51 from pot
drlee77: doesn't show hand 
*** SUMMARY ***
Total pot $4.75 | Rake $0.24 
Board [Ac Th 5d 6d]
Seat 1: drlee77 collected ($4.51)
Seat 2: TheMinion folded before Flop (didn't bet)
Seat 3: mojtabagol folded before Flop (didn't bet)
Seat 4: matiko09 (button) folded before Flop (didn't bet)
Seat 5: Rafaello18 (small blind) folded before Flop
Seat 6: pfunkolstar (big blind) folded on the Turn
Seat 7: MuddyDance folded before Flop (didn't bet)
Seat 8: sanr23 folded on the Turn
Seat 9: Dantistcopra folded before Flop (didn't bet)





PokerStars Hand #155379623776:  Hold'em No Limit ($0.50/$1.00 USD) - 2016/06/30 13:34:11 CET [2016/06/30 7:34:11 ET]
Table 'Prieska' 9-max Seat #5 is the button
Seat 1: KovIFish89 ($104.72 in chips) 
Seat 2: B_style_cuz ($99.60 in chips) 
Seat 3: Rafaello18 ($125.50 in chips) 
Seat 4: matteo080613 ($52.50 in chips) 
Seat 5: ramzes160468 ($79.90 in chips) 
Seat 6: DIMAN_324 ($100 in chips) 
Seat 7: matiko09 ($110.62 in chips) 
Seat 9: OMG Dardania ($101.50 in chips) 
DIMAN_324: posts small blind $0.50
matiko09: posts big blind $1
mbk88: sits out 
*** HOLE CARDS ***
Dealt to matiko09 [2h Jh]
OMG Dardania: folds 
KovIFish89: folds 
B_style_cuz: folds 
Rafaello18: folds 
matteo080613: folds 
ramzes160468: raises $2 to $3
DIMAN_324: folds 
matiko09: folds 
Uncalled bet ($2) returned to ramzes160468
ramzes160468 collected $2.50 from pot
*** SUMMARY ***
Total pot $2.50 | Rake $0 
Seat 1: KovIFish89 folded before Flop (didn't bet)
Seat 2: B_style_cuz folded before Flop (didn't bet)
Seat 3: Rafaello18 folded before Flop (didn't bet)
Seat 4: matteo080613 folded before Flop (didn't bet)
Seat 5: ramzes160468 (button) collected ($2.50)
Seat 6: DIMAN_324 (small blind) folded before Flop
Seat 7: matiko09 (big blind) folded before Flop
Seat 9: OMG Dardania folded before Flop (didn't bet)





PokerStars Hand #155379623946:  Hold'em No Limit ($0.50/$1.00 USD) - 2016/06/30 13:34:12 CET [2016/06/30 7:34:12 ET]
Table 'Borrelly II' 9-max Seat #1 is the button
Seat 1: Rafaello18 ($128.88 in chips) 
Seat 2: tipner ($100.02 in chips) 
Seat 4: DonRon_AT ($38.56 in chips) 
Seat 5: picka4u ($138.15 in chips) 
Seat 6: m_michalec ($163.38 in chips) 
Seat 7: matiko09 ($157.35 in chips) 
Seat 8: mbk88 ($100 in chips) 
Seat 9: makaveli978 ($62.75 in chips) 
tipner: posts small blind $0.50
di0d80: is sitting out 
DonRon_AT: posts big blind $1
*** HOLE CARDS ***
Dealt to matiko09 [7s 6c]
picka4u: folds 
m_michalec: folds 
matiko09: folds 
mbk88: folds 
makaveli978: folds 
Rafaello18: folds 
tipner: raises $2 to $3
DonRon_AT: calls $2
*** FLOP *** [2h 3h Qc]
tipner: checks 
DonRon_AT: checks 
*** TURN *** [2h 3h Qc] [4h]
tipner: bets $3
DonRon_AT: folds 
Uncalled bet ($3) returned to tipner
tipner collected $5.70 from pot
tipner: doesn't show hand 
*** SUMMARY ***
Total pot $6 | Rake $0.30 
Board [2h 3h Qc 4h]
Seat 1: Rafaello18 (button) folded before Flop (didn't bet)
Seat 2: tipner (small blind) collected ($5.70)
Seat 4: DonRon_AT (big blind) folded on the Turn
Seat 5: picka4u folded before Flop (didn't bet)
Seat 6: m_michalec folded before Flop (didn't bet)
Seat 7: matiko09 folded before Flop (didn't bet)
Seat 8: mbk88 folded before Flop (didn't bet)
Seat 9: makaveli978 folded before Flop (didn't bet)





PokerStars Hand #155379624111:  Hold'em No Limit ($0.50/$1.00 USD) - 2016/06/30 13:34:12 CET [2016/06/30 7:34:12 ET]
Table 'Armisticia' 9-max Seat #6 is the button
Seat 2: Rafaello18 ($208.89 in chips) 
Seat 4: DomiVY ($54.24 in chips) 
Seat 6: matiko09 ($131.62 in chips) 
Seat 7: sanr23 ($100.43 in chips) 
Seat 8: techahn ($125.50 in chips) 
Seat 9: mbk88 ($106.90 in chips) 
sanr23: posts small blind $0.50
techahn: posts big blind $1
*** HOLE CARDS ***
Dealt to matiko09 [4h 2d]
mbk88: folds 
Rafaello18: raises $1.50 to $2.50
DomiVY: folds 
matiko09: folds 
sanr23: folds 
techahn: folds 
Uncalled bet ($1.50) returned to Rafaello18
Rafaello18 collected $2.50 from pot
Rafaello18: doesn't show hand 
*** SUMMARY ***
Total pot $2.50 | Rake $0 
Seat 2: Rafaello18 collected ($2.50)
Seat 4: DomiVY folded before Flop (didn't bet)
Seat 6: matiko09 (button) folded before Flop (didn't bet)
Seat 7: sanr23 (small blind) folded before Flop
Seat 8: techahn (big blind) folded before Flop
Seat 9: mbk88 folded before Flop (didn't bet)





PokerStars Hand #155379631369:  Hold'em No Limit ($0.50/$1.00 USD) - 2016/06/30 13:34:29 CET [2016/06/30 7:34:29 ET]
Table 'Prieska' 9-max Seat #6 is the button
Seat 1: KovIFish89 ($104.72 in chips) 
Seat 2: B_style_cuz ($99.60 in chips) 
Seat 3: Rafaello18 ($125.50 in chips) 
Seat 4: matteo080613 ($52.50 in chips) 
Seat 5: ramzes160468 ($81.40 in chips) 
Seat 6: DIMAN_324 ($100 in chips) 
Seat 7: matiko09 ($109.62 in chips) 
Seat 8: mbk88 ($100 in chips) 
Seat 9: OMG Dardania ($101.50 in chips) 
matiko09: posts small blind $0.50
mbk88: posts big blind $1
*** HOLE CARDS ***
Dealt to matiko09 [Kh 4h]
OMG Dardania: folds 
KovIFish89: folds 
B_style_cuz: calls $1
Rafaello18: folds 
matteo080613: folds 
ramzes160468: folds 
DIMAN_324: folds 
OMG Dardania leaves the table
matiko09: calls $0.50
mbk88: checks 
*** FLOP *** [4c 2d 4s]
matiko09: bets $1.85
mbk88: folds 
B_style_cuz: folds 
Uncalled bet ($1.85) returned to matiko09
matiko09 collected $2.85 from pot
matiko09: doesn't show hand 
picka4u joins the table at seat #9 
*** SUMMARY ***
Total pot $3 | Rake $0.15 
Board [4c 2d 4s]
Seat 1: KovIFish89 folded before Flop (didn't bet)
Seat 2: B_style_cuz folded on the Flop
Seat 3: Rafaello18 folded before Flop (didn't bet)
Seat 4: matteo080613 folded before Flop (didn't bet)
Seat 5: ramzes160468 folded before Flop (didn't bet)
Seat 6: DIMAN_324 (button) folded before Flop (didn't bet)
Seat 7: matiko09 (small blind) collected ($2.85)
Seat 8: mbk88 (big blind) folded on the Flop
Seat 9: OMG Dardania folded before Flop (didn't bet)





PokerStars Hand #155379631580:  Hold'em No Limit ($0.50/$1.00 USD) - 2016/06/30 13:34:30 CET [2016/06/30 7:34:30 ET]
Table 'Apisaon II' 9-max Seat #6 is the button
Seat 1: OMG Dardania ($168.07 in chips) 
Seat 3: matteo080613 ($103.73 in chips) 
Seat 4: mbk88 ($106.31 in chips) 
Seat 5: riccfch ($93.90 in chips) 
Seat 6: tipner ($108 in chips) 
Seat 7: matiko09 ($100 in chips) 
Seat 8: ardo888 ($100 in chips) 
matiko09: posts small blind $0.50
ardo888: posts big blind $1
OMG Dardania: posts the ante $0.20
matteo080613: posts the ante $0.20
mbk88: posts the ante $0.20
riccfch: posts the ante $0.20
tipner: posts the ante $0.20
matiko09: posts the ante $0.20
ardo888: posts the ante $0.20
*** HOLE CARDS ***
Dealt to matiko09 [3h 3s]
OMG Dardania: folds 
matteo080613: folds 
mbk88: folds 
riccfch: folds 
tipner: folds 
matiko09: raises $2 to $3
ardo888: calls $2
*** FLOP *** [7d 5h 6d]
matiko09: checks 
ardo888: bets $4.56
matiko09: folds 
Uncalled bet ($4.56) returned to ardo888
ardo888 collected $7.03 from pot
ardo888: doesn't show hand 
*** SUMMARY ***
Total pot $7.40 | Rake $0.37 
Board [7d 5h 6d]
Seat 1: OMG Dardania folded before Flop (didn't bet)
Seat 3: matteo080613 folded before Flop (didn't bet)
Seat 4: mbk88 folded before Flop (didn't bet)
Seat 5: riccfch folded before Flop (didn't bet)
Seat 6: tipner (button) folded before Flop (didn't bet)
Seat 7: matiko09 (small blind) folded on the Flop
Seat 8: ardo888 (big blind) collected ($7.03)





PokerStars Hand #155379632358:  Hold'em No Limit ($0.50/$1.00 USD) - 2016/06/30 13:34:31 CET [2016/06/30 7:34:31 ET]
Table 'Armisticia' 9-max Seat #7 is the button
Seat 2: Rafaello18 ($210.39 in chips) 
Seat 4: DomiVY ($54.24 in chips) 
Seat 6: matiko09 ($131.62 in chips) 
Seat 7: sanr23 ($100 in chips) 
Seat 8: techahn ($124.50 in chips) 
Seat 9: mbk88 ($106.90 in chips) 
techahn: posts small blind $0.50
mbk88: posts big blind $1
*** HOLE CARDS ***
Dealt to matiko09 [2s 2h]
Rafaello18: raises $1.50 to $2.50
DomiVY: folds 
matiko09: folds 
sanr23: folds 
techahn: calls $2
mbk88: folds 
*** FLOP *** [7c Td Ks]
techahn: checks 
Rafaello18: bets $2.90
techahn: raises $4.10 to $7
thetuan vn leaves the table
Rafaello18: calls $4.10
*** TURN *** [7c Td Ks] [4s]
techahn: bets $9.50
Rafaello18: folds 
Uncalled bet ($9.50) returned to techahn
techahn collected $19 from pot
techahn: doesn't show hand 
*** SUMMARY ***
Total pot $20 | Rake $1 
Board [7c Td Ks 4s]
Seat 2: Rafaello18 folded on the Turn
Seat 4: DomiVY folded before Flop (didn't bet)
Seat 6: matiko09 folded before Flop (didn't bet)
Seat 7: sanr23 (button) folded before Flop (didn't bet)
Seat 8: techahn (small blind) collected ($19)
Seat 9: mbk88 (big blind) folded before Flop





PokerStars Hand #155379637506:  Hold'em No Limit ($0.50/$1.00 USD) - 2016/06/30 13:34:43 CET [2016/06/30 7:34:43 ET]
Table 'California II' 9-max Seat #4 is the button
Seat 1: Rafaello18 ($121.52 in chips) 
Seat 2: er13to ($100 in chips) 
Seat 3: liakos120 ($81.32 in chips) 
Seat 4: mbk88 ($115.64 in chips) 
Seat 5: Rohitbarve ($97.86 in chips) 
Seat 6: matiko09 ($101.50 in chips) 
Seat 7: DomiVY ($80.50 in chips) 
Seat 8: picka4u ($37.50 in chips) 
Rohitbarve: posts small blind $0.50
matiko09: posts big blind $1
*** HOLE CARDS ***
Dealt to matiko09 [2c Kd]
DomiVY: folds 
picka4u: folds 
Rafaello18: folds 
er13to: folds 
liakos120: folds 
mbk88: raises $1.02 to $2.02
Rohitbarve: folds 
matiko09: folds 
Uncalled bet ($1.02) returned to mbk88
mbk88 collected $2.50 from pot
mbk88: doesn't show hand 
*** SUMMARY ***
Total pot $2.50 | Rake $0 
Seat 1: Rafaello18 folded before Flop (didn't bet)
Seat 2: er13to folded before Flop (didn't bet)
Seat 3: liakos120 folded before Flop (didn't bet)
Seat 4: mbk88 (button) collected ($2.50)
Seat 5: Rohitbarve (small blind) folded before Flop
Seat 6: matiko09 (big blind) folded before Flop
Seat 7: DomiVY folded before Flop (didn't bet)
Seat 8: picka4u folded before Flop (didn't bet)





PokerStars Hand #155379638825:  Hold'em No Limit ($0.50/$1.00 USD) - 2016/06/30 13:34:46 CET [2016/06/30 7:34:46 ET]
Table 'Tatjana' 9-max Seat #5 is the button
Seat 1: ardo888 ($122.46 in chips) 
Seat 2: DIMAN_324 ($100 in chips) 
Seat 3: Rafaello18 ($106.13 in chips) 
Seat 4: Konig26 ($246.64 in chips) 
Seat 5: matiko09 ($100.68 in chips) 
Seat 6: mbk88 ($100 in chips) 
Seat 7: DomiVY ($40 in chips) 
Seat 8: alhill86 ($106.15 in chips) 
Seat 9: POTAPENKO700 ($101.50 in chips) 
mbk88: posts small blind $0.50
DomiVY: posts big blind $1
*** HOLE CARDS ***
Dealt to matiko09 [2c 7h]
alhill86: folds 
POTAPENKO700: folds 
ardo888: folds 
DIMAN_324: folds 
Rafaello18: folds 
Konig26: folds 
matiko09: folds 
mbk88: calls $0.50
DomiVY: raises $3 to $4
mbk88: calls $3
*** FLOP *** [7d 8s 2h]
mbk88: checks 
DomiVY: bets $5
mbk88: calls $5
*** TURN *** [7d 8s 2h] [4s]
mbk88: checks 
DomiVY: checks 
*** RIVER *** [7d 8s 2h 4s] [Ts]
mbk88: bets $11
DomiVY: folds 
Uncalled bet ($11) returned to mbk88
mbk88 collected $17.10 from pot
mbk88: doesn't show hand 
*** SUMMARY ***
Total pot $18 | Rake $0.90 
Board [7d 8s 2h 4s Ts]
Seat 1: ardo888 folded before Flop (didn't bet)
Seat 2: DIMAN_324 folded before Flop (didn't bet)
Seat 3: Rafaello18 folded before Flop (didn't bet)
Seat 4: Konig26 folded before Flop (didn't bet)
Seat 5: matiko09 (button) folded before Flop (didn't bet)
Seat 6: mbk88 (small blind) collected ($17.10)
Seat 7: DomiVY (big blind) folded on the River
Seat 8: alhill86 folded before Flop (didn't bet)
Seat 9: POTAPENKO700 folded before Flop (didn't bet)





PokerStars Hand #155379640679:  Hold'em No Limit ($0.50/$1.00 USD) - 2016/06/30 13:34:51 CET [2016/06/30 7:34:51 ET]
Table 'Borrelly II' 9-max Seat #2 is the button
Seat 1: Rafaello18 ($128.88 in chips) 
Seat 2: tipner ($102.72 in chips) 
Seat 4: DonRon_AT ($35.56 in chips) 
Seat 5: picka4u ($138.15 in chips) 
Seat 6: m_michalec ($163.38 in chips) 
Seat 7: matiko09 ($157.35 in chips) 
Seat 8: mbk88 ($100 in chips) 
Seat 9: makaveli978 ($62.75 in chips) 
DonRon_AT: posts small blind $0.50
picka4u: posts big blind $1
*** HOLE CARDS ***
Dealt to matiko09 [Jd Ks]
m_michalec: folds 
matiko09: folds 
mbk88: folds 
makaveli978: calls $1
Rafaello18: raises $3 to $4
tipner: folds 
DonRon_AT: folds 
picka4u: folds 
makaveli978: calls $3
*** FLOP *** [8h 5d Th]
makaveli978: checks 
Rafaello18: bets $6
makaveli978: raises $6 to $12
Rafaello18: raises $112.88 to $124.88 and is all-in
makaveli978: calls $46.75 and is all-in
Uncalled bet ($66.13) returned to Rafaello18
*** TURN *** [8h 5d Th] [Ah]
*** RIVER *** [8h 5d Th Ah] [2c]
*** SHOW DOWN ***
makaveli978: shows [Tc 8c] (two pair, Tens and Eights)
Rafaello18: shows [Kc Kh] (a pair of Kings)
makaveli978 collected $124.50 from pot
*** SUMMARY ***
Total pot $127 | Rake $2.50 
Board [8h 5d Th Ah 2c]
Seat 1: Rafaello18 showed [Kc Kh] and lost with a pair of Kings
Seat 2: tipner (button) folded before Flop (didn't bet)
Seat 4: DonRon_AT (small blind) folded before Flop
Seat 5: picka4u (big blind) folded before Flop
Seat 6: m_michalec folded before Flop (didn't bet)
Seat 7: matiko09 folded before Flop (didn't bet)
Seat 8: mbk88 folded before Flop (didn't bet)
Seat 9: makaveli978 showed [Tc 8c] and won ($124.50) with two pair, Tens and Eights





PokerStars Hand #155379641420:  Hold'em No Limit ($0.25/$0.50 USD) - 2016/06/30 13:34:52 CET [2016/06/30 7:34:52 ET]
Table 'Dorothea II' 9-max Seat #8 is the button
Seat 2: er13to ($50 in chips) 
Seat 3: Franky77200 ($86.93 in chips) 
Seat 4: matiko09 ($75.44 in chips) 
Seat 5: Bailey Dew ($75.94 in chips) 
Seat 6: ivan100886 ($30.96 in chips) 
Seat 7: Alexey_Kim2 ($50.20 in chips) 
Seat 8: TheMinion ($51.61 in chips) 
Seat 9: ardo888 ($77.72 in chips) 
ardo888: posts small blind $0.25
er13to: posts big blind $0.50
er13to: posts the ante $0.10
Franky77200: posts the ante $0.10
matiko09: posts the ante $0.10
Bailey Dew: posts the ante $0.10
ivan100886: posts the ante $0.10
Alexey_Kim2: posts the ante $0.10
TheMinion: posts the ante $0.10
ardo888: posts the ante $0.10
*** HOLE CARDS ***
Dealt to matiko09 [Jd Kc]
Franky77200: folds 
matiko09: folds 
Bailey Dew: folds 
ivan100886: folds 
Alexey_Kim2: folds 
TheMinion: folds 
ardo888: folds 
Uncalled bet ($0.25) returned to er13to
er13to collected $1.30 from pot
*** SUMMARY ***
Total pot $1.30 | Rake $0 
Seat 2: er13to (big blind) collected ($1.30)
Seat 3: Franky77200 folded before Flop (didn't bet)
Seat 4: matiko09 folded before Flop (didn't bet)
Seat 5: Bailey Dew folded before Flop (didn't bet)
Seat 6: ivan100886 folded before Flop (didn't bet)
Seat 7: Alexey_Kim2 folded before Flop (didn't bet)
Seat 8: TheMinion (button) folded before Flop (didn't bet)
Seat 9: ardo888 (small blind) folded before Flop





PokerStars Hand #155379648168:  Hold'em No Limit ($0.50/$1.00 USD) - 2016/06/30 13:35:08 CET [2016/06/30 7:35:08 ET]
Table 'Apisaon II' 9-max Seat #7 is the button
Seat 1: OMG Dardania ($167.87 in chips) 
Seat 3: matteo080613 ($103.53 in chips) 
Seat 4: mbk88 ($106.11 in chips) 
Seat 5: riccfch ($93.70 in chips) 
Seat 6: tipner ($107.80 in chips) 
Seat 7: matiko09 ($100 in chips) 
Seat 8: ardo888 ($103.83 in chips) 
ardo888: posts small blind $0.50
OMG Dardania: posts big blind $1
OMG Dardania: posts the ante $0.20
matteo080613: posts the ante $0.20
mbk88: posts the ante $0.20
riccfch: posts the ante $0.20
tipner: posts the ante $0.20
matiko09: posts the ante $0.20
ardo888: posts the ante $0.20
*** HOLE CARDS ***
Dealt to matiko09 [Qs 2d]
matteo080613: calls $1
mbk88: folds 
riccfch: folds 
tipner: folds 
matiko09: folds 
ardo888: folds 
OMG Dardania: checks 
*** FLOP *** [5s 8s 4s]
OMG Dardania: checks 
matteo080613: bets $1
OMG Dardania: calls $1
*** TURN *** [5s 8s 4s] [8h]
OMG Dardania: checks 
matteo080613: checks 
*** RIVER *** [5s 8s 4s 8h] [Qd]
OMG Dardania: checks 
matteo080613: bets $6
OMG Dardania: calls $6
*** SHOW DOWN ***
matteo080613: shows [As 3d] (a pair of Eights)
OMG Dardania: shows [6h 5d] (two pair, Eights and Fives)
OMG Dardania collected $17 from pot
*** SUMMARY ***
Total pot $17.90 | Rake $0.90 
Board [5s 8s 4s 8h Qd]
Seat 1: OMG Dardania (big blind) showed [6h 5d] and won ($17) with two pair, Eights and Fives
Seat 3: matteo080613 showed [As 3d] and lost with a pair of Eights
Seat 4: mbk88 folded before Flop (didn't bet)
Seat 5: riccfch folded before Flop (didn't bet)
Seat 6: tipner folded before Flop (didn't bet)
Seat 7: matiko09 (button) folded before Flop (didn't bet)
Seat 8: ardo888 (small blind) folded before Flop





PokerStars Hand #155379648678:  Hold'em No Limit ($0.50/$1.00 USD) - 2016/06/30 13:35:09 CET [2016/06/30 7:35:09 ET]
Table 'California II' 9-max Seat #5 is the button
Seat 1: Rafaello18 ($121.52 in chips) 
Seat 2: er13to ($100 in chips) 
Seat 3: liakos120 ($81.32 in chips) 
Seat 4: mbk88 ($117.14 in chips) 
Seat 5: Rohitbarve ($97.36 in chips) 
Seat 6: matiko09 ($100.50 in chips) 
Seat 7: DomiVY ($80.50 in chips) 
Seat 8: picka4u ($37.50 in chips) 
matiko09: posts small blind $0.50
DomiVY: posts big blind $1
*** HOLE CARDS ***
Dealt to matiko09 [9c 9h]
picka4u: folds 
Rafaello18: folds 
er13to: folds 
liakos120: folds 
mbk88: folds 
Rohitbarve: folds 
matiko09: raises $2 to $3
DomiVY: raises $5 to $8
matiko09: calls $5
*** FLOP *** [6c Kc Ah]
matiko09: checks 
DomiVY: bets $6
matiko09: folds 
Uncalled bet ($6) returned to DomiVY
DomiVY collected $15.20 from pot
DomiVY: doesn't show hand 
*** SUMMARY ***
Total pot $16 | Rake $0.80 
Board [6c Kc Ah]
Seat 1: Rafaello18 folded before Flop (didn't bet)
Seat 2: er13to folded before Flop (didn't bet)
Seat 3: liakos120 folded before Flop (didn't bet)
Seat 4: mbk88 folded before Flop (didn't bet)
Seat 5: Rohitbarve (button) folded before Flop (didn't bet)
Seat 6: matiko09 (small blind) folded on the Flop
Seat 7: DomiVY (big blind) collected ($15.20)
Seat 8: picka4u folded before Flop (didn't bet)





PokerStars Hand #155379650837:  Hold'em No Limit ($0.50/$1.00 USD) - 2016/06/30 13:35:14 CET [2016/06/30 7:35:14 ET]
Table 'Prieska' 9-max Seat #7 is the button
Seat 1: KovIFish89 ($104.72 in chips) 
Seat 2: B_style_cuz ($98.60 in chips) 
Seat 3: Rafaello18 ($125.50 in chips) 
Seat 4: matteo080613 ($52.50 in chips) 
Seat 5: ramzes160468 ($81.40 in chips) 
Seat 6: DIMAN_324 ($100 in chips) 
Seat 7: matiko09 ($111.47 in chips) 
Seat 8: mbk88 ($100 in chips) 
Seat 9: picka4u ($45.58 in chips) 
mbk88: posts small blind $0.50
picka4u: posts big blind $1
*** HOLE CARDS ***
Dealt to matiko09 [9c Jh]
KovIFish89: folds 
B_style_cuz: raises $2 to $3
Rafaello18: folds 
matteo080613: folds 
ramzes160468: folds 
DIMAN_324: folds 
matiko09: folds 
mbk88: folds 
picka4u: calls $2
*** FLOP *** [Ah 9d 7h]
picka4u: checks 
B_style_cuz: bets $4
picka4u: folds 
Uncalled bet ($4) returned to B_style_cuz
B_style_cuz collected $6.18 from pot
B_style_cuz: doesn't show hand 
*** SUMMARY ***
Total pot $6.50 | Rake $0.32 
Board [Ah 9d 7h]
Seat 1: KovIFish89 folded before Flop (didn't bet)
Seat 2: B_style_cuz collected ($6.18)
Seat 3: Rafaello18 folded before Flop (didn't bet)
Seat 4: matteo080613 folded before Flop (didn't bet)
Seat 5: ramzes160468 folded before Flop (didn't bet)
Seat 6: DIMAN_324 folded before Flop (didn't bet)
Seat 7: matiko09 (button) folded before Flop (didn't bet)
Seat 8: mbk88 (small blind) folded before Flop
Seat 9: picka4u (big blind) folded on the Flop





PokerStars Hand #155379653705:  Hold'em No Limit ($0.25/$0.50 USD) - 2016/06/30 13:35:21 CET [2016/06/30 7:35:21 ET]
Table 'Dorothea II' 9-max Seat #9 is the button
Seat 2: er13to ($50.95 in chips) 
Seat 3: Franky77200 ($86.83 in chips) 
Seat 4: matiko09 ($75.34 in chips) 
Seat 5: Bailey Dew ($75.84 in chips) 
Seat 6: ivan100886 ($30.86 in chips) 
Seat 7: Alexey_Kim2 ($50.10 in chips) 
Seat 8: TheMinion ($51.51 in chips) 
Seat 9: ardo888 ($77.37 in chips) 
er13to: posts small blind $0.25
Franky77200: posts big blind $0.50
er13to: posts the ante $0.10
Franky77200: posts the ante $0.10
matiko09: posts the ante $0.10
Bailey Dew: posts the ante $0.10
ivan100886: posts the ante $0.10
Alexey_Kim2: posts the ante $0.10
TheMinion: posts the ante $0.10
ardo888: posts the ante $0.10
*** HOLE CARDS ***
Dealt to matiko09 [8s 5c]
matiko09: folds 
Bailey Dew: raises $1 to $1.50
ivan100886: folds 
Alexey_Kim2: raises $3 to $4.50
TheMinion: folds 
ardo888: folds 
er13to: folds 
Franky77200: folds 
Bailey Dew: raises $6 to $10.50
Alexey_Kim2: folds 
Uncalled bet ($6) returned to Bailey Dew
Bailey Dew collected $10.55 from pot
Bailey Dew: doesn't show hand 
*** SUMMARY ***
Total pot $10.55 | Rake $0 
Seat 2: er13to (small blind) folded before Flop
Seat 3: Franky77200 (big blind) folded before Flop
Seat 4: matiko09 folded before Flop (didn't bet)
Seat 5: Bailey Dew collected ($10.55)
Seat 6: ivan100886 folded before Flop (didn't bet)
Seat 7: Alexey_Kim2 folded before Flop
Seat 8: TheMinion folded before Flop (didn't bet)
Seat 9: ardo888 (button) folded before Flop (didn't bet)





PokerStars Hand #155379661574:  Hold'em No Limit ($0.50/$1.00 USD) - 2016/06/30 13:35:40 CET [2016/06/30 7:35:40 ET]
Table 'Altarf II' 9-max Seat #4 is the button
Seat 1: thecurv ($111.47 in chips) 
Seat 2: KovIFish89 ($100 in chips) 
Seat 3: sanr23 ($100 in chips) 
Seat 4: Greha999 ($82.16 in chips) 
Seat 6: mbk88 ($100 in chips) 
Seat 7: matiko09 ($100 in chips) 
Seat 8: Kertesh ($39.50 in chips) 
Seat 9: omanibemihum ($85.31 in chips) 
DIMAN_324 will be allowed to play after the button
mbk88: posts small blind $0.50
matiko09: posts big blind $1
*** HOLE CARDS ***
Dealt to matiko09 [Jc 6h]
Kertesh: folds 
omanibemihum: folds 
thecurv: folds 
KovIFish89: folds 
sanr23: folds 
Greha999: raises $2 to $3
mbk88: folds 
matiko09: folds 
Uncalled bet ($2) returned to Greha999
Greha999 collected $2.50 from pot
*** SUMMARY ***
Total pot $2.50 | Rake $0 
Seat 1: thecurv folded before Flop (didn't bet)
Seat 2: KovIFish89 folded before Flop (didn't bet)
Seat 3: sanr23 folded before Flop (didn't bet)
Seat 4: Greha999 (button) collected ($2.50)
Seat 6: mbk88 (small blind) folded before Flop
Seat 7: matiko09 (big blind) folded before Flop
Seat 8: Kertesh folded before Flop (didn't bet)
Seat 9: omanibemihum folded before Flop (didn't bet)





PokerStars Hand #155379665706:  Hold'em No Limit ($0.25/$0.50 USD) - 2016/06/30 13:35:49 CET [2016/06/30 7:35:49 ET]
Table 'Elektra II' 9-max Seat #5 is the button
Seat 1: drlee77 ($51.28 in chips) 
Seat 2: TheMinion ($54.13 in chips) 
Seat 3: mojtabagol ($62.09 in chips) 
Seat 4: matiko09 ($60.53 in chips) 
Seat 5: Rafaello18 ($59.99 in chips) 
Seat 6: pfunkolstar ($50 in chips) 
Seat 7: MuddyDance ($50 in chips) 
Seat 8: sanr23 ($60.15 in chips) 
Seat 9: Dantistcopra ($50 in chips) 
pfunkolstar: posts small blind $0.25
MuddyDance: posts big blind $0.50
*** HOLE CARDS ***
Dealt to matiko09 [9s 9h]
sanr23: raises $1 to $1.50
Dantistcopra: folds 
drlee77: folds 
TheMinion: raises $3 to $4.50
mojtabagol: folds 
matiko09: folds 
Rafaello18: folds 
pfunkolstar: folds 
MuddyDance: folds 
sanr23: calls $3
*** FLOP *** [8s Kc Td]
sanr23: checks 
TheMinion: bets $5.75
sanr23: calls $5.75
*** TURN *** [8s Kc Td] [5d]
sanr23: checks 
TheMinion: checks 
*** RIVER *** [8s Kc Td 5d] [8d]
sanr23: checks 
TheMinion: bets $43.88 and is all-in
sanr23: folds 
Uncalled bet ($43.88) returned to TheMinion
TheMinion collected $20.19 from pot
TheMinion: doesn't show hand 
*** SUMMARY ***
Total pot $21.25 | Rake $1.06 
Board [8s Kc Td 5d 8d]
Seat 1: drlee77 folded before Flop (didn't bet)
Seat 2: TheMinion collected ($20.19)
Seat 3: mojtabagol folded before Flop (didn't bet)
Seat 4: matiko09 folded before Flop (didn't bet)
Seat 5: Rafaello18 (button) folded before Flop (didn't bet)
Seat 6: pfunkolstar (small blind) folded before Flop
Seat 7: MuddyDance (big blind) folded before Flop
Seat 8: sanr23 folded on the River
Seat 9: Dantistcopra folded before Flop (didn't bet)





PokerStars Hand #155379666232:  Hold'em No Limit ($0.50/$1.00 USD) - 2016/06/30 13:35:50 CET [2016/06/30 7:35:50 ET]
Table 'Apisaon II' 9-max Seat #8 is the button
Seat 1: OMG Dardania ($176.67 in chips) 
Seat 3: matteo080613 ($95.33 in chips) 
Seat 4: mbk88 ($105.91 in chips) 
Seat 5: riccfch ($93.50 in chips) 
Seat 6: tipner ($107.60 in chips) 
Seat 7: matiko09 ($100 in chips) 
Seat 8: ardo888 ($103.13 in chips) 
OMG Dardania: posts small blind $0.50
matteo080613: posts big blind $1
OMG Dardania: posts the ante $0.20
matteo080613: posts the ante $0.20
mbk88: posts the ante $0.20
riccfch: posts the ante $0.20
tipner: posts the ante $0.20
matiko09: posts the ante $0.20
ardo888: posts the ante $0.20
*** HOLE CARDS ***
Dealt to matiko09 [Ks 4s]
mbk88: folds 
riccfch: raises $2 to $3
tipner: raises $6 to $9
matiko09: folds 
ardo888: folds 
OMG Dardania: folds 
matteo080613: folds 
riccfch: folds 
Uncalled bet ($6) returned to tipner
tipner collected $8.90 from pot
tipner: doesn't show hand 
*** SUMMARY ***
Total pot $8.90 | Rake $0 
Seat 1: OMG Dardania (small blind) folded before Flop
Seat 3: matteo080613 (big blind) folded before Flop
Seat 4: mbk88 folded before Flop (didn't bet)
Seat 5: riccfch folded before Flop
Seat 6: tipner collected ($8.90)
Seat 7: matiko09 folded before Flop (didn't bet)
Seat 8: ardo888 (button) folded before Flop (didn't bet)





PokerStars Hand #155379670155:  Hold'em No Limit ($0.50/$1.00 USD) - 2016/06/30 13:35:59 CET [2016/06/30 7:35:59 ET]
Table 'Tatjana' 9-max Seat #6 is the button
Seat 1: ardo888 ($122.46 in chips) 
Seat 2: DIMAN_324 ($100 in chips) 
Seat 3: Rafaello18 ($106.13 in chips) 
Seat 4: Konig26 ($246.64 in chips) 
Seat 5: matiko09 ($100.68 in chips) 
Seat 6: mbk88 ($108.10 in chips) 
Seat 7: DomiVY ($40 in chips) 
Seat 9: POTAPENKO700 ($101.50 in chips) 
DomiVY: posts small blind $0.50
alhill86: is sitting out 
POTAPENKO700: posts big blind $1
*** HOLE CARDS ***
Dealt to matiko09 [8h Ah]
ardo888: folds 
DIMAN_324: folds 
Rafaello18: folds 
Konig26: folds 
matiko09: raises $1.50 to $2.50
mbk88: folds 
DomiVY: folds 
POTAPENKO700: folds 
Uncalled bet ($1.50) returned to matiko09
matiko09 collected $2.50 from pot
matiko09: doesn't show hand 
*** SUMMARY ***
Total pot $2.50 | Rake $0 
Seat 1: ardo888 folded before Flop (didn't bet)
Seat 2: DIMAN_324 folded before Flop (didn't bet)
Seat 3: Rafaello18 folded before Flop (didn't bet)
Seat 4: Konig26 folded before Flop (didn't bet)
Seat 5: matiko09 collected ($2.50)
Seat 6: mbk88 (button) folded before Flop (didn't bet)
Seat 7: DomiVY (small blind) folded before Flop
Seat 9: POTAPENKO700 (big blind) folded before Flop





PokerStars Hand #155379674674:  Hold'em No Limit ($0.50/$1.00 USD) - 2016/06/30 13:36:10 CET [2016/06/30 7:36:10 ET]
Table 'Altarf II' 9-max Seat #6 is the button
Seat 1: thecurv ($111.47 in chips) 
Seat 2: KovIFish89 ($100 in chips) 
Seat 3: sanr23 ($100 in chips) 
Seat 4: Greha999 ($83.66 in chips) 
Seat 6: mbk88 ($100 in chips) 
Seat 7: matiko09 ($100 in chips) 
Seat 8: Kertesh ($39.50 in chips) 
Seat 9: omanibemihum ($85.31 in chips) 
matiko09: posts small blind $0.50
Kertesh: posts big blind $1
DIMAN_324: sits out 
*** HOLE CARDS ***
Dealt to matiko09 [Td 8h]
omanibemihum: folds 
thecurv: folds 
KovIFish89: raises $2.50 to $3.50
sanr23: folds 
Greha999: folds 
mbk88: folds 
matiko09: folds 
Kertesh: folds 
Uncalled bet ($2.50) returned to KovIFish89
KovIFish89 collected $2.50 from pot
KovIFish89: doesn't show hand 
*** SUMMARY ***
Total pot $2.50 | Rake $0 
Seat 1: thecurv folded before Flop (didn't bet)
Seat 2: KovIFish89 collected ($2.50)
Seat 3: sanr23 folded before Flop (didn't bet)
Seat 4: Greha999 folded before Flop (didn't bet)
Seat 6: mbk88 (button) folded before Flop (didn't bet)
Seat 7: matiko09 (small blind) folded before Flop
Seat 8: Kertesh (big blind) folded before Flop
Seat 9: omanibemihum folded before Flop (didn't bet)





PokerStars Hand #155379675555:  Hold'em No Limit ($0.50/$1.00 USD) - 2016/06/30 13:36:12 CET [2016/06/30 7:36:12 ET]
Table 'Borrelly II' 9-max Seat #4 is the button
Seat 1: Rafaello18 ($100 in chips) 
Seat 2: tipner ($102.72 in chips) 
Seat 4: DonRon_AT ($35.06 in chips) 
Seat 5: picka4u ($137.15 in chips) 
Seat 6: m_michalec ($163.38 in chips) 
Seat 7: matiko09 ($157.35 in chips) 
Seat 8: mbk88 ($100 in chips) 
Seat 9: makaveli978 ($124.50 in chips) 
picka4u: posts small blind $0.50
m_michalec: posts big blind $1
*** HOLE CARDS ***
Dealt to matiko09 [Td 3c]
matiko09: folds 
mbk88: raises $2 to $3
makaveli978: calls $3
Rafaello18: folds 
tipner: folds 
DonRon_AT: folds 
picka4u: folds 
m_michalec: folds 
*** FLOP *** [Jh Ad 3d]
mbk88: bets $5
makaveli978: folds 
Uncalled bet ($5) returned to mbk88
mbk88 collected $7.12 from pot
mbk88: doesn't show hand 
*** SUMMARY ***
Total pot $7.50 | Rake $0.38 
Board [Jh Ad 3d]
Seat 1: Rafaello18 folded before Flop (didn't bet)
Seat 2: tipner folded before Flop (didn't bet)
Seat 4: DonRon_AT (button) folded before Flop (didn't bet)
Seat 5: picka4u (small blind) folded before Flop
Seat 6: m_michalec (big blind) folded before Flop
Seat 7: matiko09 folded before Flop (didn't bet)
Seat 8: mbk88 collected ($7.12)
Seat 9: makaveli978 folded on the Flop





PokerStars Hand #155379676435:  Hold'em No Limit ($0.50/$1.00 USD) - 2016/06/30 13:36:14 CET [2016/06/30 7:36:14 ET]
Table 'Armisticia' 9-max Seat #8 is the button
Seat 2: Rafaello18 ($200.89 in chips) 
Seat 4: DomiVY ($54.24 in chips) 
Seat 6: matiko09 ($131.62 in chips) 
Seat 7: sanr23 ($100 in chips) 
Seat 8: techahn ($134 in chips) 
Seat 9: mbk88 ($105.90 in chips) 
mbk88: posts small blind $0.50
Rafaello18: posts big blind $1
*** HOLE CARDS ***
Dealt to matiko09 [9h 3s]
DomiVY: folds 
matiko09: folds 
sanr23: folds 
techahn: folds 
mbk88: folds 
Uncalled bet ($0.50) returned to Rafaello18
Rafaello18 collected $1 from pot
Rafaello18: doesn't show hand 
*** SUMMARY ***
Total pot $1 | Rake $0 
Seat 2: Rafaello18 (big blind) collected ($1)
Seat 4: DomiVY folded before Flop (didn't bet)
Seat 6: matiko09 folded before Flop (didn't bet)
Seat 7: sanr23 folded before Flop (didn't bet)
Seat 8: techahn (button) folded before Flop (didn't bet)
Seat 9: mbk88 (small blind) folded before Flop





PokerStars Hand #155379676497:  Hold'em No Limit ($0.50/$1.00 USD) - 2016/06/30 13:36:14 CET [2016/06/30 7:36:14 ET]
Table 'Eucharis' 9-max Seat #6 is the button
Seat 1: er13to ($100 in chips) 
Seat 2: sanr23 ($134.28 in chips) 
Seat 3: ramzes160468 ($120.40 in chips) 
Seat 4: nordzan ($32.76 in chips) 
Seat 5: Rafaello18 ($101.50 in chips) 
Seat 6: matiko09 ($100 in chips) 
Seat 7: DIMAN_324 ($100 in chips) 
Seat 8: anfisa.irk ($44.15 in chips) 
DIMAN_324: posts small blind $0.50
anfisa.irk: posts big blind $1
*** HOLE CARDS ***
Dealt to matiko09 [9h Ts]
er13to: folds 
sanr23: folds 
ramzes160468: folds 
nordzan: calls $1
Rafaello18: folds 
matiko09: raises $2 to $3
DIMAN_324: folds 
anfisa.irk: folds 
nordzan: calls $2
*** FLOP *** [6d 3c 7h]
nordzan: checks 
matiko09: bets $3.70
nordzan: folds 
Uncalled bet ($3.70) returned to matiko09
matiko09 collected $7.12 from pot
matiko09: doesn't show hand 
*** SUMMARY ***
Total pot $7.50 | Rake $0.38 
Board [6d 3c 7h]
Seat 1: er13to folded before Flop (didn't bet)
Seat 2: sanr23 folded before Flop (didn't bet)
Seat 3: ramzes160468 folded before Flop (didn't bet)
Seat 4: nordzan folded on the Flop
Seat 5: Rafaello18 folded before Flop (didn't bet)
Seat 6: matiko09 (button) collected ($7.12)
Seat 7: DIMAN_324 (small blind) folded before Flop
Seat 8: anfisa.irk (big blind) folded before Flop





PokerStars Hand #155379677899:  Hold'em No Limit ($0.50/$1.00 USD) - 2016/06/30 13:36:18 CET [2016/06/30 7:36:18 ET]
Table 'California II' 9-max Seat #6 is the button
Seat 1: Rafaello18 ($121.52 in chips) 
Seat 2: er13to ($100 in chips) 
Seat 3: liakos120 ($81.32 in chips) 
Seat 4: mbk88 ($117.14 in chips) 
Seat 5: Rohitbarve ($97.36 in chips) 
Seat 6: matiko09 ($100 in chips) 
Seat 7: DomiVY ($87.70 in chips) 
Seat 8: picka4u ($37.50 in chips) 
DomiVY: posts small blind $0.50
picka4u: posts big blind $1
*** HOLE CARDS ***
Dealt to matiko09 [Ts 4s]
Rafaello18: folds 
er13to: folds 
liakos120: folds 
mbk88: raises $2 to $3
Rohitbarve: folds 
matiko09: folds 
DomiVY: folds 
picka4u: folds 
Uncalled bet ($2) returned to mbk88
mbk88 collected $2.50 from pot
mbk88: doesn't show hand 
*** SUMMARY ***
Total pot $2.50 | Rake $0 
Seat 1: Rafaello18 folded before Flop (didn't bet)
Seat 2: er13to folded before Flop (didn't bet)
Seat 3: liakos120 folded before Flop (didn't bet)
Seat 4: mbk88 collected ($2.50)
Seat 5: Rohitbarve folded before Flop (didn't bet)
Seat 6: matiko09 (button) folded before Flop (didn't bet)
Seat 7: DomiVY (small blind) folded before Flop
Seat 8: picka4u (big blind) folded before Flop





PokerStars Hand #155379677845:  Hold'em No Limit ($0.50/$1.00 USD) - 2016/06/30 13:36:18 CET [2016/06/30 7:36:18 ET]
Table 'Prieska' 9-max Seat #8 is the button
Seat 1: KovIFish89 ($104.72 in chips) 
Seat 2: B_style_cuz ($101.78 in chips) 
Seat 3: Rafaello18 ($125.50 in chips) 
Seat 4: matteo080613 ($52.50 in chips) 
Seat 5: ramzes160468 ($81.40 in chips) 
Seat 6: DIMAN_324 ($100 in chips) 
Seat 7: matiko09 ($111.47 in chips) 
Seat 8: mbk88 ($100 in chips) 
Seat 9: picka4u ($42.58 in chips) 
picka4u: posts small blind $0.50
KovIFish89: posts big blind $1
*** HOLE CARDS ***
Dealt to matiko09 [Kc 9h]
B_style_cuz: folds 
Rafaello18: folds 
matteo080613: folds 
ramzes160468: raises $2 to $3
DIMAN_324: folds 
matiko09: folds 
mbk88: folds 
picka4u: folds 
KovIFish89: folds 
Uncalled bet ($2) returned to ramzes160468
ramzes160468 collected $2.50 from pot
*** SUMMARY ***
Total pot $2.50 | Rake $0 
Seat 1: KovIFish89 (big blind) folded before Flop
Seat 2: B_style_cuz folded before Flop (didn't bet)
Seat 3: Rafaello18 folded before Flop (didn't bet)
Seat 4: matteo080613 folded before Flop (didn't bet)
Seat 5: ramzes160468 collected ($2.50)
Seat 6: DIMAN_324 folded before Flop (didn't bet)
Seat 7: matiko09 folded before Flop (didn't bet)
Seat 8: mbk88 (button) folded before Flop (didn't bet)
Seat 9: picka4u (small blind) folded before Flop





PokerStars Hand #155379677850:  Hold'em No Limit ($0.50/$1.00 USD) - 2016/06/30 13:36:18 CET [2016/06/30 7:36:18 ET]
Table 'Apisaon II' 9-max Seat #1 is the button
Seat 1: OMG Dardania ($175.97 in chips) 
Seat 3: matteo080613 ($94.13 in chips) 
Seat 4: mbk88 ($105.71 in chips) 
Seat 5: riccfch ($90.30 in chips) 
Seat 6: tipner ($113.30 in chips) 
Seat 7: matiko09 ($100 in chips) 
Seat 8: ardo888 ($102.93 in chips) 
matteo080613: posts small blind $0.50
mbk88: posts big blind $1
OMG Dardania: posts the ante $0.20
matteo080613: posts the ante $0.20
mbk88: posts the ante $0.20
riccfch: posts the ante $0.20
tipner: posts the ante $0.20
matiko09: posts the ante $0.20
ardo888: posts the ante $0.20
*** HOLE CARDS ***
Dealt to matiko09 [5h 3s]
riccfch: raises $2 to $3
tipner: calls $3
matiko09: folds 
ardo888: folds 
OMG Dardania: folds 
matteo080613: folds 
mbk88: calls $2
*** FLOP *** [As 3h 9d]
mbk88: checks 
riccfch: bets $8
tipner: folds 
mbk88: folds 
Uncalled bet ($8) returned to riccfch
riccfch collected $10.36 from pot
riccfch: doesn't show hand 
*** SUMMARY ***
Total pot $10.90 | Rake $0.54 
Board [As 3h 9d]
Seat 1: OMG Dardania (button) folded before Flop (didn't bet)
Seat 3: matteo080613 (small blind) folded before Flop
Seat 4: mbk88 (big blind) folded on the Flop
Seat 5: riccfch collected ($10.36)
Seat 6: tipner folded on the Flop
Seat 7: matiko09 folded before Flop (didn't bet)
Seat 8: ardo888 folded before Flop (didn't bet)





PokerStars Hand #155379679408:  Hold'em No Limit ($0.25/$0.50 USD) - 2016/06/30 13:36:21 CET [2016/06/30 7:36:21 ET]
Table 'Dorothea II' 9-max Seat #2 is the button
Seat 2: er13to ($50.60 in chips) 
Seat 4: matiko09 ($75.24 in chips) 
Seat 5: Bailey Dew ($81.79 in chips) 
Seat 6: ivan100886 ($30.76 in chips) 
Seat 7: Alexey_Kim2 ($50 in chips) 
Seat 8: TheMinion ($51.41 in chips) 
Seat 9: ardo888 ($77.27 in chips) 
matiko09: posts small blind $0.25
Bailey Dew: posts big blind $0.50
er13to: posts the ante $0.10
matiko09: posts the ante $0.10
Bailey Dew: posts the ante $0.10
ivan100886: posts the ante $0.10
Alexey_Kim2: posts the ante $0.10
TheMinion: posts the ante $0.10
ardo888: posts the ante $0.10
*** HOLE CARDS ***
Dealt to matiko09 [2c Jc]
ivan100886: folds 
Alexey_Kim2: folds 
TheMinion: folds 
ardo888: folds 
er13to: folds 
matiko09: raises $1.50 to $2
Bailey Dew: raises $4.70 to $6.70
matiko09: folds 
Uncalled bet ($4.70) returned to Bailey Dew
Bailey Dew collected $4.70 from pot
Bailey Dew: doesn't show hand 
*** SUMMARY ***
Total pot $4.70 | Rake $0 
Seat 2: er13to (button) folded before Flop (didn't bet)
Seat 4: matiko09 (small blind) folded before Flop
Seat 5: Bailey Dew (big blind) collected ($4.70)
Seat 6: ivan100886 folded before Flop (didn't bet)
Seat 7: Alexey_Kim2 folded before Flop (didn't bet)
Seat 8: TheMinion folded before Flop (didn't bet)
Seat 9: ardo888 folded before Flop (didn't bet)





PokerStars Hand #155379686371:  Hold'em No Limit ($0.50/$1.00 USD) - 2016/06/30 13:36:38 CET [2016/06/30 7:36:38 ET]
Table 'Asmodeus' 9-max Seat #9 is the button
Seat 1: scollop ($81.69 in chips) 
Seat 2: picka4u ($46.52 in chips) 
Seat 3: matiko09 ($101.50 in chips) 
Seat 4: ardo888 ($139.28 in chips) 
Seat 5: sanr23 ($100 in chips) 
Seat 6: koutani7 ($94 in chips) 
Seat 7: aaronzzr ($147.61 in chips) 
Seat 8: Rafaello18 ($162.10 in chips) 
Seat 9: mbk88 ($165.68 in chips) 
scollop: posts small blind $0.50
picka4u: posts big blind $1
*** HOLE CARDS ***
Dealt to matiko09 [9s Th]
matiko09: folds 
ardo888: folds 
sanr23: folds 
koutani7: folds 
aaronzzr: raises $1 to $2
Rafaello18: folds 
mbk88: folds 
scollop: folds 
picka4u: calls $1
*** FLOP *** [5c 8c Ks]
picka4u: checks 
aaronzzr: bets $2
picka4u: calls $2
*** TURN *** [5c 8c Ks] [9d]
picka4u: checks 
aaronzzr: bets $4
picka4u: calls $4
*** RIVER *** [5c 8c Ks 9d] [4d]
picka4u: checks 
aaronzzr: bets $8
picka4u: folds 
Uncalled bet ($8) returned to aaronzzr
aaronzzr collected $15.68 from pot
aaronzzr: doesn't show hand 
*** SUMMARY ***
Total pot $16.50 | Rake $0.82 
Board [5c 8c Ks 9d 4d]
Seat 1: scollop (small blind) folded before Flop
Seat 2: picka4u (big blind) folded on the River
Seat 3: matiko09 folded before Flop (didn't bet)
Seat 4: ardo888 folded before Flop (didn't bet)
Seat 5: sanr23 folded before Flop (didn't bet)
Seat 6: koutani7 folded before Flop (didn't bet)
Seat 7: aaronzzr collected ($15.68)
Seat 8: Rafaello18 folded before Flop (didn't bet)
Seat 9: mbk88 (button) folded before Flop (didn't bet)





PokerStars Hand #155379688625:  Hold'em No Limit ($0.50/$1.00 USD) - 2016/06/30 13:36:43 CET [2016/06/30 7:36:43 ET]
Table 'Borrelly II' 9-max Seat #5 is the button
Seat 1: Rafaello18 ($100 in chips) 
Seat 2: tipner ($102.72 in chips) 
Seat 4: DonRon_AT ($35.06 in chips) 
Seat 5: picka4u ($136.65 in chips) 
Seat 6: m_michalec ($162.38 in chips) 
Seat 7: matiko09 ($157.35 in chips) 
Seat 8: mbk88 ($104.12 in chips) 
Seat 9: makaveli978 ($121.50 in chips) 
m_michalec: posts small blind $0.50
matiko09: posts big blind $1
*** HOLE CARDS ***
Dealt to matiko09 [9c Qh]
mbk88: folds 
makaveli978: folds 
Rafaello18: raises $1.50 to $2.50
tipner: folds 
DonRon_AT: folds 
picka4u: folds 
m_michalec: calls $2
matiko09: folds 
*** FLOP *** [6d Tc 5c]
m_michalec: bets $3
Rafaello18: calls $3
*** TURN *** [6d Tc 5c] [4d]
m_michalec: checks 
Rafaello18: bets $8
m_michalec: raises $11 to $19
Rafaello18: calls $11
*** RIVER *** [6d Tc 5c 4d] [6h]
m_michalec: checks 
Rafaello18: checks 
*** SHOW DOWN ***
m_michalec: shows [7c 8c] (a straight, Four to Eight)
Rafaello18: mucks hand 
m_michalec collected $47.50 from pot
*** SUMMARY ***
Total pot $50 | Rake $2.50 
Board [6d Tc 5c 4d 6h]
Seat 1: Rafaello18 mucked [Qc Jc]
Seat 2: tipner folded before Flop (didn't bet)
Seat 4: DonRon_AT folded before Flop (didn't bet)
Seat 5: picka4u (button) folded before Flop (didn't bet)
Seat 6: m_michalec (small blind) showed [7c 8c] and won ($47.50) with a straight, Four to Eight
Seat 7: matiko09 (big blind) folded before Flop
Seat 8: mbk88 folded before Flop (didn't bet)
Seat 9: makaveli978 folded before Flop (didn't bet)





PokerStars Hand #155379691831:  Hold'em No Limit ($0.50/$1.00 USD) - 2016/06/30 13:36:50 CET [2016/06/30 7:36:50 ET]
Table 'Prieska' 9-max Seat #9 is the button
Seat 1: KovIFish89 ($103.72 in chips) 
Seat 2: B_style_cuz ($101.78 in chips) 
Seat 3: Rafaello18 ($125.50 in chips) 
Seat 4: matteo080613 ($52.50 in chips) 
Seat 5: ramzes160468 ($82.90 in chips) 
Seat 6: DIMAN_324 ($100 in chips) 
Seat 7: matiko09 ($111.47 in chips) 
Seat 8: mbk88 ($100 in chips) 
Seat 9: picka4u ($42.08 in chips) 
KovIFish89: posts small blind $0.50
B_style_cuz: posts big blind $1
*** HOLE CARDS ***
Dealt to matiko09 [Jh 2c]
Rafaello18: folds 
matteo080613: calls $1
ramzes160468: folds 
DIMAN_324: raises $3 to $4
matiko09: folds 
mbk88: folds 
picka4u: folds 
KovIFish89: folds 
B_style_cuz: folds 
matteo080613: folds 
Uncalled bet ($3) returned to DIMAN_324
DIMAN_324 collected $3.50 from pot
DIMAN_324: doesn't show hand 
*** SUMMARY ***
Total pot $3.50 | Rake $0 
Seat 1: KovIFish89 (small blind) folded before Flop
Seat 2: B_style_cuz (big blind) folded before Flop
Seat 3: Rafaello18 folded before Flop (didn't bet)
Seat 4: matteo080613 folded before Flop
Seat 5: ramzes160468 folded before Flop (didn't bet)
Seat 6: DIMAN_324 collected ($3.50)
Seat 7: matiko09 folded before Flop (didn't bet)
Seat 8: mbk88 folded before Flop (didn't bet)
Seat 9: picka4u (button) folded before Flop (didn't bet)





PokerStars Hand #155379692950:  Hold'em No Limit ($0.25/$0.50 USD) - 2016/06/30 13:36:53 CET [2016/06/30 7:36:53 ET]
Table 'Dorothea II' 9-max Seat #4 is the button
Seat 2: er13to ($50.50 in chips) 
Seat 4: matiko09 ($73.14 in chips) 
Seat 5: Bailey Dew ($84.39 in chips) 
Seat 6: ivan100886 ($30.66 in chips) 
Seat 7: Alexey_Kim2 ($50 in chips) 
Seat 8: TheMinion ($51.31 in chips) 
Seat 9: ardo888 ($77.17 in chips) 
Bailey Dew: posts small blind $0.25
ivan100886: posts big blind $0.50
er13to: posts the ante $0.10
matiko09: posts the ante $0.10
Bailey Dew: posts the ante $0.10
ivan100886: posts the ante $0.10
Alexey_Kim2: posts the ante $0.10
TheMinion: posts the ante $0.10
ardo888: posts the ante $0.10
*** HOLE CARDS ***
Dealt to matiko09 [8h Kh]
Alexey_Kim2: folds 
TheMinion: folds 
ardo888: folds 
er13to: folds 
matiko09: raises $0.63 to $1.13
Bailey Dew: folds 
ivan100886: folds 
Uncalled bet ($0.63) returned to matiko09
matiko09 collected $1.95 from pot
matiko09: doesn't show hand 
*** SUMMARY ***
Total pot $1.95 | Rake $0 
Seat 2: er13to folded before Flop (didn't bet)
Seat 4: matiko09 (button) collected ($1.95)
Seat 5: Bailey Dew (small blind) folded before Flop
Seat 6: ivan100886 (big blind) folded before Flop
Seat 7: Alexey_Kim2 folded before Flop (didn't bet)
Seat 8: TheMinion folded before Flop (didn't bet)
Seat 9: ardo888 folded before Flop (didn't bet)





PokerStars Hand #155379693371:  Hold'em No Limit ($0.50/$1.00 USD) - 2016/06/30 13:36:54 CET [2016/06/30 7:36:54 ET]
Table 'Tatjana' 9-max Seat #7 is the button
Seat 1: ardo888 ($122.46 in chips) 
Seat 2: DIMAN_324 ($100 in chips) 
Seat 3: Rafaello18 ($106.13 in chips) 
Seat 4: Konig26 ($246.64 in chips) 
Seat 5: matiko09 ($102.18 in chips) 
Seat 6: mbk88 ($108.10 in chips) 
Seat 7: DomiVY ($40 in chips) 
Seat 9: POTAPENKO700 ($100.50 in chips) 
POTAPENKO700: posts small blind $0.50
ardo888: posts big blind $1
*** HOLE CARDS ***
Dealt to matiko09 [8d As]
DIMAN_324: folds 
Rafaello18: folds 
Konig26: raises $1.50 to $2.50
matiko09: folds 
mbk88: folds 
DomiVY: folds 
POTAPENKO700: folds 
ardo888: folds 
Uncalled bet ($1.50) returned to Konig26
Konig26 collected $2.50 from pot
Konig26: doesn't show hand 
*** SUMMARY ***
Total pot $2.50 | Rake $0 
Seat 1: ardo888 (big blind) folded before Flop
Seat 2: DIMAN_324 folded before Flop (didn't bet)
Seat 3: Rafaello18 folded before Flop (didn't bet)
Seat 4: Konig26 collected ($2.50)
Seat 5: matiko09 folded before Flop (didn't bet)
Seat 6: mbk88 folded before Flop (didn't bet)
Seat 7: DomiVY (button) folded before Flop (didn't bet)
Seat 9: POTAPENKO700 (small blind) folded before Flop





PokerStars Hand #155379694680:  Hold'em No Limit ($0.50/$1.00 USD) - 2016/06/30 13:36:57 CET [2016/06/30 7:36:57 ET]
Table 'Altarf II' 9-max Seat #7 is the button
Seat 1: thecurv ($111.47 in chips) 
Seat 2: KovIFish89 ($101.50 in chips) 
Seat 3: sanr23 ($100 in chips) 
Seat 4: Greha999 ($83.66 in chips) 
Seat 6: mbk88 ($100 in chips) 
Seat 7: matiko09 ($100 in chips) 
Seat 8: Kertesh ($38.50 in chips) 
Seat 9: omanibemihum ($85.31 in chips) 
Kertesh: posts small blind $0.50
omanibemihum: posts big blind $1
DIMAN_324: sits out 
*** HOLE CARDS ***
Dealt to matiko09 [Tc 3c]
thecurv: folds 
KovIFish89: folds 
sanr23: folds 
Greha999: folds 
mbk88: folds 
matiko09: folds 
Kertesh: raises $4 to $5
omanibemihum: folds 
Uncalled bet ($4) returned to Kertesh
Kertesh collected $2 from pot
Kertesh: doesn't show hand 
*** SUMMARY ***
Total pot $2 | Rake $0 
Seat 1: thecurv folded before Flop (didn't bet)
Seat 2: KovIFish89 folded before Flop (didn't bet)
Seat 3: sanr23 folded before Flop (didn't bet)
Seat 4: Greha999 folded before Flop (didn't bet)
Seat 6: mbk88 folded before Flop (didn't bet)
Seat 7: matiko09 (button) folded before Flop (didn't bet)
Seat 8: Kertesh (small blind) collected ($2)
Seat 9: omanibemihum (big blind) folded before Flop





PokerStars Hand #155379694749:  Hold'em No Limit ($0.50/$1.00 USD) - 2016/06/30 13:36:57 CET [2016/06/30 7:36:57 ET]
Table 'California II' 9-max Seat #7 is the button
Seat 1: Rafaello18 ($121.52 in chips) 
Seat 2: er13to ($100 in chips) 
Seat 3: liakos120 ($81.32 in chips) 
Seat 4: mbk88 ($118.64 in chips) 
Seat 5: Rohitbarve ($97.36 in chips) 
Seat 6: matiko09 ($100 in chips) 
Seat 7: DomiVY ($87.20 in chips) 
Seat 8: picka4u ($36.50 in chips) 
picka4u: posts small blind $0.50
Rafaello18: posts big blind $1
*** HOLE CARDS ***
Dealt to matiko09 [Ks Kh]
er13to: folds 
liakos120: folds 
mbk88: folds 
Rohitbarve: folds 
matiko09: raises $1.50 to $2.50
DomiVY: folds 
picka4u: raises $4 to $6.50
Rafaello18: folds 
matiko09: raises $4.50 to $11
picka4u: folds 
Uncalled bet ($4.50) returned to matiko09
matiko09 collected $14 from pot
matiko09: doesn't show hand 
*** SUMMARY ***
Total pot $14 | Rake $0 
Seat 1: Rafaello18 (big blind) folded before Flop
Seat 2: er13to folded before Flop (didn't bet)
Seat 3: liakos120 folded before Flop (didn't bet)
Seat 4: mbk88 folded before Flop (didn't bet)
Seat 5: Rohitbarve folded before Flop (didn't bet)
Seat 6: matiko09 collected ($14)
Seat 7: DomiVY (button) folded before Flop (didn't bet)
Seat 8: picka4u (small blind) folded before Flop





PokerStars Hand #155379695015:  Hold'em No Limit ($0.50/$1.00 USD) - 2016/06/30 13:36:58 CET [2016/06/30 7:36:58 ET]
Table 'Eucharis' 9-max Seat #7 is the button
Seat 1: er13to ($100 in chips) 
Seat 2: sanr23 ($134.28 in chips) 
Seat 3: ramzes160468 ($120.40 in chips) 
Seat 4: nordzan ($29.76 in chips) 
Seat 5: Rafaello18 ($101.50 in chips) 
Seat 6: matiko09 ($104.12 in chips) 
Seat 7: DIMAN_324 ($100 in chips) 
Seat 8: anfisa.irk ($43.15 in chips) 
anfisa.irk: posts small blind $0.50
er13to: posts big blind $1
*** HOLE CARDS ***
Dealt to matiko09 [4h Ah]
sanr23: folds 
ramzes160468: folds 
nordzan: folds 
Rafaello18: raises $1.50 to $2.50
matiko09: folds 
DIMAN_324: folds 
anfisa.irk: folds 
er13to: folds 
Uncalled bet ($1.50) returned to Rafaello18
Rafaello18 collected $2.50 from pot
Rafaello18: doesn't show hand 
*** SUMMARY ***
Total pot $2.50 | Rake $0 
Seat 1: er13to (big blind) folded before Flop
Seat 2: sanr23 folded before Flop (didn't bet)
Seat 3: ramzes160468 folded before Flop (didn't bet)
Seat 4: nordzan folded before Flop (didn't bet)
Seat 5: Rafaello18 collected ($2.50)
Seat 6: matiko09 folded before Flop (didn't bet)
Seat 7: DIMAN_324 (button) folded before Flop (didn't bet)
Seat 8: anfisa.irk (small blind) folded before Flop





PokerStars Hand #155379701113:  Hold'em No Limit ($0.25/$0.50 USD) - 2016/06/30 13:37:12 CET [2016/06/30 7:37:12 ET]
Table 'Dorothea II' 9-max Seat #5 is the button
Seat 2: er13to ($50.40 in chips) 
Seat 4: matiko09 ($74.49 in chips) 
Seat 5: Bailey Dew ($84.04 in chips) 
Seat 6: ivan100886 ($30.06 in chips) 
Seat 7: Alexey_Kim2 ($50 in chips) 
Seat 8: TheMinion ($51.21 in chips) 
Seat 9: ardo888 ($77.07 in chips) 
ivan100886: posts small blind $0.25
Alexey_Kim2: posts big blind $0.50
er13to: posts the ante $0.10
matiko09: posts the ante $0.10
Bailey Dew: posts the ante $0.10
ivan100886: posts the ante $0.10
Alexey_Kim2: posts the ante $0.10
TheMinion: posts the ante $0.10
ardo888: posts the ante $0.10
*** HOLE CARDS ***
Dealt to matiko09 [Ks Tc]
TheMinion: folds 
ardo888: folds 
er13to: folds 
matiko09: raises $1 to $1.50
Bailey Dew: folds 
ivan100886: folds 
Alexey_Kim2: calls $1
*** FLOP *** [Qh 4h 9c]
Alexey_Kim2: checks 
matiko09: bets $2.44
Alexey_Kim2: calls $2.44
*** TURN *** [Qh 4h 9c] [Th]
Alexey_Kim2: checks 
matiko09: checks 
*** RIVER *** [Qh 4h 9c Th] [Ad]
Alexey_Kim2: checks 
matiko09: checks 
*** SHOW DOWN ***
Alexey_Kim2: shows [Ah 5s] (a pair of Aces)
matiko09: mucks hand 
Alexey_Kim2 collected $8.39 from pot
*** SUMMARY ***
Total pot $8.83 | Rake $0.44 
Board [Qh 4h 9c Th Ad]
Seat 2: er13to folded before Flop (didn't bet)
Seat 4: matiko09 mucked [Ks Tc]
Seat 5: Bailey Dew (button) folded before Flop (didn't bet)
Seat 6: ivan100886 (small blind) folded before Flop
Seat 7: Alexey_Kim2 (big blind) showed [Ah 5s] and won ($8.39) with a pair of Aces
Seat 8: TheMinion folded before Flop (didn't bet)
Seat 9: ardo888 folded before Flop (didn't bet)





PokerStars Hand #155379702939:  Hold'em No Limit ($0.50/$1.00 USD) - 2016/06/30 13:37:16 CET [2016/06/30 7:37:16 ET]
Table 'Apisaon II' 9-max Seat #3 is the button
Seat 1: OMG Dardania ($175.77 in chips) 
Seat 3: matteo080613 ($93.43 in chips) 
Seat 4: mbk88 ($102.51 in chips) 
Seat 5: riccfch ($97.46 in chips) 
Seat 6: tipner ($110.10 in chips) 
Seat 7: matiko09 ($100 in chips) 
Seat 8: ardo888 ($102.73 in chips) 
mbk88: posts small blind $0.50
riccfch: posts big blind $1
OMG Dardania: posts the ante $0.20
matteo080613: posts the ante $0.20
mbk88: posts the ante $0.20
riccfch: posts the ante $0.20
tipner: posts the ante $0.20
matiko09: posts the ante $0.20
ardo888: posts the ante $0.20
*** HOLE CARDS ***
Dealt to matiko09 [Ts Td]
tipner: folds 
matiko09: raises $2 to $3
ardo888: folds 
OMG Dardania: folds 
matteo080613: folds 
mbk88: calls $2.50
riccfch: folds 
*** FLOP *** [Kh Kc Th]
mbk88: checks 
matiko09: bets $2.47
mbk88: calls $2.47
*** TURN *** [Kh Kc Th] [5s]
mbk88: checks 
matiko09: bets $6.58
mbk88: calls $6.58
*** RIVER *** [Kh Kc Th 5s] [6s]
mbk88: checks 
matiko09: bets $39
mbk88: folds 
Uncalled bet ($39) returned to matiko09
matiko09 collected $25.18 from pot
matiko09: doesn't show hand 
*** SUMMARY ***
Total pot $26.50 | Rake $1.32 
Board [Kh Kc Th 5s 6s]
Seat 1: OMG Dardania folded before Flop (didn't bet)
Seat 3: matteo080613 (button) folded before Flop (didn't bet)
Seat 4: mbk88 (small blind) folded on the River
Seat 5: riccfch (big blind) folded before Flop
Seat 6: tipner folded before Flop (didn't bet)
Seat 7: matiko09 collected ($25.18)
Seat 8: ardo888 folded before Flop (didn't bet)





PokerStars Hand #155379704463:  Hold'em No Limit ($0.50/$1.00 USD) - 2016/06/30 13:37:20 CET [2016/06/30 7:37:20 ET]
Table 'Prieska' 9-max Seat #1 is the button
Seat 1: KovIFish89 ($103.22 in chips) 
Seat 2: B_style_cuz ($100.78 in chips) 
Seat 3: Rafaello18 ($125.50 in chips) 
Seat 4: matteo080613 ($51.50 in chips) 
Seat 5: ramzes160468 ($82.90 in chips) 
Seat 6: DIMAN_324 ($102.50 in chips) 
Seat 7: matiko09 ($111.47 in chips) 
Seat 8: mbk88 ($100 in chips) 
Seat 9: picka4u ($42.08 in chips) 
B_style_cuz: posts small blind $0.50
Rafaello18: posts big blind $1
*** HOLE CARDS ***
Dealt to matiko09 [9h Jc]
matteo080613: folds 
ramzes160468: folds 
DIMAN_324: folds 
matiko09: folds 
mbk88: folds 
picka4u: raises $1.25 to $2.25
KovIFish89: raises $4.25 to $6.50
B_style_cuz: folds 
Rafaello18: folds 
picka4u: folds 
Uncalled bet ($4.25) returned to KovIFish89
KovIFish89 collected $6 from pot
KovIFish89: doesn't show hand 
*** SUMMARY ***
Total pot $6 | Rake $0 
Seat 1: KovIFish89 (button) collected ($6)
Seat 2: B_style_cuz (small blind) folded before Flop
Seat 3: Rafaello18 (big blind) folded before Flop
Seat 4: matteo080613 folded before Flop (didn't bet)
Seat 5: ramzes160468 folded before Flop (didn't bet)
Seat 6: DIMAN_324 folded before Flop (didn't bet)
Seat 7: matiko09 folded before Flop (didn't bet)
Seat 8: mbk88 folded before Flop (didn't bet)
Seat 9: picka4u folded before Flop





PokerStars Hand #155379706476:  Hold'em No Limit ($0.50/$1.00 USD) - 2016/06/30 13:37:25 CET [2016/06/30 7:37:25 ET]
Table 'Eucharis' 9-max Seat #8 is the button
Seat 1: er13to ($100 in chips) 
Seat 2: sanr23 ($134.28 in chips) 
Seat 3: ramzes160468 ($120.40 in chips) 
Seat 4: nordzan ($29.76 in chips) 
Seat 5: Rafaello18 ($103 in chips) 
Seat 6: matiko09 ($104.12 in chips) 
Seat 7: DIMAN_324 ($100 in chips) 
Seat 8: anfisa.irk ($42.65 in chips) 
er13to: posts small blind $0.50
sanr23: posts big blind $1
*** HOLE CARDS ***
Dealt to matiko09 [Ts 3d]
ramzes160468: folds 
nordzan: calls $1
Rafaello18: folds 
matiko09: folds 
DIMAN_324: folds 
anfisa.irk: folds 
er13to: folds 
sanr23: checks 
*** FLOP *** [6s 2d Ks]
sanr23: checks 
nordzan: bets $2
sanr23: folds 
Uncalled bet ($2) returned to nordzan
nordzan collected $2.38 from pot
nordzan: doesn't show hand 
*** SUMMARY ***
Total pot $2.50 | Rake $0.12 
Board [6s 2d Ks]
Seat 1: er13to (small blind) folded before Flop
Seat 2: sanr23 (big blind) folded on the Flop
Seat 3: ramzes160468 folded before Flop (didn't bet)
Seat 4: nordzan collected ($2.38)
Seat 5: Rafaello18 folded before Flop (didn't bet)
Seat 6: matiko09 folded before Flop (didn't bet)
Seat 7: DIMAN_324 folded before Flop (didn't bet)
Seat 8: anfisa.irk (button) folded before Flop (didn't bet)





PokerStars Hand #155379708003:  Hold'em No Limit ($0.50/$1.00 USD) - 2016/06/30 13:37:28 CET [2016/06/30 7:37:28 ET]
Table 'Asmodeus' 9-max Seat #1 is the button
Seat 1: scollop ($81.19 in chips) 
Seat 2: picka4u ($38.52 in chips) 
Seat 3: matiko09 ($101.50 in chips) 
Seat 4: ardo888 ($139.28 in chips) 
Seat 5: sanr23 ($100 in chips) 
Seat 6: koutani7 ($94 in chips) 
Seat 7: aaronzzr ($155.29 in chips) 
Seat 8: Rafaello18 ($162.10 in chips) 
Seat 9: mbk88 ($165.68 in chips) 
picka4u: posts small blind $0.50
matiko09: posts big blind $1
*** HOLE CARDS ***
Dealt to matiko09 [5h 8h]
ardo888: folds 
sanr23: raises $2 to $3
koutani7: folds 
aaronzzr: raises $6 to $9
Rafaello18: folds 
mbk88: folds 
scollop: folds 
picka4u: folds 
matiko09: folds 
sanr23: folds 
Uncalled bet ($6) returned to aaronzzr
aaronzzr collected $7.50 from pot
aaronzzr: doesn't show hand 
*** SUMMARY ***
Total pot $7.50 | Rake $0 
Seat 1: scollop (button) folded before Flop (didn't bet)
Seat 2: picka4u (small blind) folded before Flop
Seat 3: matiko09 (big blind) folded before Flop
Seat 4: ardo888 folded before Flop (didn't bet)
Seat 5: sanr23 folded before Flop
Seat 6: koutani7 folded before Flop (didn't bet)
Seat 7: aaronzzr collected ($7.50)
Seat 8: Rafaello18 folded before Flop (didn't bet)
Seat 9: mbk88 folded before Flop (didn't bet)





PokerStars Hand #155379710478:  Hold'em No Limit ($0.50/$1.00 USD) - 2016/06/30 13:37:34 CET [2016/06/30 7:37:34 ET]
Table 'Tatjana' 9-max Seat #9 is the button
Seat 1: ardo888 ($121.46 in chips) 
Seat 2: DIMAN_324 ($100 in chips) 
Seat 3: Rafaello18 ($106.13 in chips) 
Seat 4: Konig26 ($248.14 in chips) 
Seat 5: matiko09 ($102.18 in chips) 
Seat 6: mbk88 ($108.10 in chips) 
Seat 7: DomiVY ($40 in chips) 
Seat 9: POTAPENKO700 ($100 in chips) 
ardo888: posts small blind $0.50
DIMAN_324: posts big blind $1
*** HOLE CARDS ***
Dealt to matiko09 [7s Th]
Rafaello18: folds 
Konig26: folds 
matiko09: folds 
mbk88: folds 
DomiVY: folds 
POTAPENKO700: raises $1.50 to $2.50
ardo888: raises $7 to $9.50
DIMAN_324: folds 
POTAPENKO700: folds 
Uncalled bet ($7) returned to ardo888
ardo888 collected $6 from pot
ardo888: doesn't show hand 
*** SUMMARY ***
Total pot $6 | Rake $0 
Seat 1: ardo888 (small blind) collected ($6)
Seat 2: DIMAN_324 (big blind) folded before Flop
Seat 3: Rafaello18 folded before Flop (didn't bet)
Seat 4: Konig26 folded before Flop (didn't bet)
Seat 5: matiko09 folded before Flop (didn't bet)
Seat 6: mbk88 folded before Flop (didn't bet)
Seat 7: DomiVY folded before Flop (didn't bet)
Seat 9: POTAPENKO700 (button) folded before Flop





PokerStars Hand #155379713543:  Hold'em No Limit ($0.50/$1.00 USD) - 2016/06/30 13:37:41 CET [2016/06/30 7:37:41 ET]
Table 'Altarf II' 9-max Seat #8 is the button
Seat 1: thecurv ($111.47 in chips) 
Seat 2: KovIFish89 ($101.50 in chips) 
Seat 3: sanr23 ($100 in chips) 
Seat 4: Greha999 ($83.66 in chips) 
Seat 6: mbk88 ($100 in chips) 
Seat 7: matiko09 ($100 in chips) 
Seat 8: Kertesh ($39.50 in chips) 
Seat 9: omanibemihum ($84.31 in chips) 
omanibemihum: posts small blind $0.50
thecurv: posts big blind $1
DIMAN_324: sits out 
*** HOLE CARDS ***
Dealt to matiko09 [Kc Th]
KovIFish89: folds 
sanr23: raises $2 to $3
Greha999: folds 
mbk88: calls $3
matiko09: folds 
Kertesh: calls $3
omanibemihum: calls $2.50
thecurv: calls $2
*** FLOP *** [As Ac 5c]
omanibemihum: checks 
thecurv: checks 
sanr23: checks 
mbk88: checks 
Kertesh: checks 
*** TURN *** [As Ac 5c] [Ah]
omanibemihum: bets $7
thecurv: folds 
sanr23: folds 
mbk88: calls $7
Kertesh: folds 
*** RIVER *** [As Ac 5c Ah] [7c]
omanibemihum: checks 
mbk88: bets $14
omanibemihum: calls $14
*** SHOW DOWN ***
mbk88: shows [Qs Qc] (a full house, Aces full of Queens)
omanibemihum: mucks hand 
mbk88 collected $54.50 from pot
*** SUMMARY ***
Total pot $57 | Rake $2.50 
Board [As Ac 5c Ah 7c]
Seat 1: thecurv (big blind) folded on the Turn
Seat 2: KovIFish89 folded before Flop (didn't bet)
Seat 3: sanr23 folded on the Turn
Seat 4: Greha999 folded before Flop (didn't bet)
Seat 6: mbk88 showed [Qs Qc] and won ($54.50) with a full house, Aces full of Queens
Seat 7: matiko09 folded before Flop (didn't bet)
Seat 8: Kertesh (button) folded on the Turn
Seat 9: omanibemihum (small blind) mucked [6d 6c]





PokerStars Hand #155379715176:  Hold'em No Limit ($0.50/$1.00 USD) - 2016/06/30 13:37:45 CET [2016/06/30 7:37:45 ET]
Table 'California II' 9-max Seat #8 is the button
Seat 1: Rafaello18 ($120.52 in chips) 
Seat 2: er13to ($100 in chips) 
Seat 3: liakos120 ($81.32 in chips) 
Seat 4: mbk88 ($118.64 in chips) 
Seat 5: Rohitbarve ($97.36 in chips) 
Seat 6: matiko09 ($107.50 in chips) 
Seat 7: DomiVY ($87.20 in chips) 
Seat 8: picka4u ($40 in chips) 
Rafaello18: posts small blind $0.50
er13to: posts big blind $1
*** HOLE CARDS ***
Dealt to matiko09 [2c Ad]
liakos120: folds 
mbk88: folds 
Rohitbarve: folds 
matiko09: folds 
DomiVY: folds 
picka4u: folds 
Rafaello18: raises $1.50 to $2.50
er13to: folds 
Uncalled bet ($1.50) returned to Rafaello18
Rafaello18 collected $2 from pot
Rafaello18: doesn't show hand 
*** SUMMARY ***
Total pot $2 | Rake $0 
Seat 1: Rafaello18 (small blind) collected ($2)
Seat 2: er13to (big blind) folded before Flop
Seat 3: liakos120 folded before Flop (didn't bet)
Seat 4: mbk88 folded before Flop (didn't bet)
Seat 5: Rohitbarve folded before Flop (didn't bet)
Seat 6: matiko09 folded before Flop (didn't bet)
Seat 7: DomiVY folded before Flop (didn't bet)
Seat 8: picka4u (button) folded before Flop (didn't bet)





PokerStars Hand #155379723897:  Hold'em No Limit ($0.50/$1.00 USD) - 2016/06/30 13:38:05 CET [2016/06/30 7:38:05 ET]
Table 'Eucharis' 9-max Seat #1 is the button
Seat 1: er13to ($100 in chips) 
Seat 2: sanr23 ($133.28 in chips) 
Seat 3: ramzes160468 ($120.40 in chips) 
Seat 4: nordzan ($31.14 in chips) 
Seat 5: Rafaello18 ($103 in chips) 
Seat 6: matiko09 ($104.12 in chips) 
Seat 7: DIMAN_324 ($100 in chips) 
Seat 8: anfisa.irk ($42.65 in chips) 
sanr23: posts small blind $0.50
ramzes160468: posts big blind $1
*** HOLE CARDS ***
Dealt to matiko09 [9s 4h]
nordzan: folds 
Rafaello18: folds 
matiko09: folds 
DIMAN_324: folds 
anfisa.irk: folds 
er13to: folds 
sanr23: folds 
Uncalled bet ($0.50) returned to ramzes160468
ramzes160468 collected $1 from pot
*** SUMMARY ***
Total pot $1 | Rake $0 
Seat 1: er13to (button) folded before Flop (didn't bet)
Seat 2: sanr23 (small blind) folded before Flop
Seat 3: ramzes160468 (big blind) collected ($1)
Seat 4: nordzan folded before Flop (didn't bet)
Seat 5: Rafaello18 folded before Flop (didn't bet)
Seat 6: matiko09 folded before Flop (didn't bet)
Seat 7: DIMAN_324 folded before Flop (didn't bet)
Seat 8: anfisa.irk folded before Flop (didn't bet)





PokerStars Hand #155379725496:  Hold'em No Limit ($0.50/$1.00 USD) - 2016/06/30 13:38:09 CET [2016/06/30 7:38:09 ET]
Table 'Asmodeus' 9-max Seat #2 is the button
Seat 1: scollop ($81.19 in chips) 
Seat 2: picka4u ($38.02 in chips) 
Seat 3: matiko09 ($100.50 in chips) 
Seat 4: ardo888 ($139.28 in chips) 
Seat 5: sanr23 ($100 in chips) 
Seat 6: koutani7 ($94 in chips) 
Seat 7: aaronzzr ($159.79 in chips) 
Seat 8: Rafaello18 ($162.10 in chips) 
Seat 9: mbk88 ($165.68 in chips) 
matiko09: posts small blind $0.50
ardo888: posts big blind $1
*** HOLE CARDS ***
Dealt to matiko09 [5c 4h]
sanr23: folds 
koutani7: folds 
aaronzzr: calls $1
Rafaello18: folds 
mbk88: raises $3 to $4
scollop: folds 
picka4u: folds 
matiko09: folds 
ardo888: folds 
aaronzzr: folds 
Uncalled bet ($3) returned to mbk88
mbk88 collected $3.50 from pot
mbk88: doesn't show hand 
*** SUMMARY ***
Total pot $3.50 | Rake $0 
Seat 1: scollop folded before Flop (didn't bet)
Seat 2: picka4u (button) folded before Flop (didn't bet)
Seat 3: matiko09 (small blind) folded before Flop
Seat 4: ardo888 (big blind) folded before Flop
Seat 5: sanr23 folded before Flop (didn't bet)
Seat 6: koutani7 folded before Flop (didn't bet)
Seat 7: aaronzzr folded before Flop
Seat 8: Rafaello18 folded before Flop (didn't bet)
Seat 9: mbk88 collected ($3.50)





PokerStars Hand #155379726389:  Hold'em No Limit ($0.50/$1.00 USD) - 2016/06/30 13:38:11 CET [2016/06/30 7:38:11 ET]
Table 'California II' 9-max Seat #1 is the button
Seat 1: Rafaello18 ($121.52 in chips) 
Seat 2: er13to ($100 in chips) 
Seat 3: liakos120 ($81.32 in chips) 
Seat 4: mbk88 ($118.64 in chips) 
Seat 5: Rohitbarve ($97.36 in chips) 
Seat 6: matiko09 ($107.50 in chips) 
Seat 7: DomiVY ($87.20 in chips) 
Seat 8: picka4u ($40 in chips) 
er13to: posts small blind $0.50
liakos120: posts big blind $1
*** HOLE CARDS ***
Dealt to matiko09 [2s Ac]
mbk88: folds 
Rohitbarve: folds 
matiko09: folds 
DomiVY: folds 
picka4u: raises $1.25 to $2.25
Rafaello18: folds 
er13to: folds 
liakos120: folds 
Uncalled bet ($1.25) returned to picka4u
picka4u collected $2.50 from pot
picka4u: doesn't show hand 
*** SUMMARY ***
Total pot $2.50 | Rake $0 
Seat 1: Rafaello18 (button) folded before Flop (didn't bet)
Seat 2: er13to (small blind) folded before Flop
Seat 3: liakos120 (big blind) folded before Flop
Seat 4: mbk88 folded before Flop (didn't bet)
Seat 5: Rohitbarve folded before Flop (didn't bet)
Seat 6: matiko09 folded before Flop (didn't bet)
Seat 7: DomiVY folded before Flop (didn't bet)
Seat 8: picka4u collected ($2.50)





PokerStars Hand #155379729170:  Hold'em No Limit ($0.50/$1.00 USD) - 2016/06/30 13:38:18 CET [2016/06/30 7:38:18 ET]
Table 'Borrelly II' 9-max Seat #6 is the button
Seat 1: Rafaello18 ($100 in chips) 
Seat 2: tipner ($102.72 in chips) 
Seat 4: DonRon_AT ($35.06 in chips) 
Seat 5: picka4u ($136.65 in chips) 
Seat 6: m_michalec ($185.38 in chips) 
Seat 7: matiko09 ($156.35 in chips) 
Seat 9: makaveli978 ($121.50 in chips) 
matiko09: posts small blind $0.50
mbk88: is sitting out 
makaveli978: posts big blind $1
*** HOLE CARDS ***
Dealt to matiko09 [3h Ts]
Rafaello18: folds 
tipner: folds 
DonRon_AT: folds 
picka4u: folds 
m_michalec: folds 
matiko09: folds 
Uncalled bet ($0.50) returned to makaveli978
makaveli978 collected $1 from pot
makaveli978 leaves the table
*** SUMMARY ***
Total pot $1 | Rake $0 
Seat 1: Rafaello18 folded before Flop (didn't bet)
Seat 2: tipner folded before Flop (didn't bet)
Seat 4: DonRon_AT folded before Flop (didn't bet)
Seat 5: picka4u folded before Flop (didn't bet)
Seat 6: m_michalec (button) folded before Flop (didn't bet)
Seat 7: matiko09 (small blind) folded before Flop
Seat 9: makaveli978 (big blind) collected ($1)





PokerStars Hand #155379731233:  Hold'em No Limit ($0.25/$0.50 USD) - 2016/06/30 13:38:22 CET [2016/06/30 7:38:22 ET]
Table 'Dorothea II' 9-max Seat #6 is the button
Seat 2: er13to ($50.30 in chips) 
Seat 4: matiko09 ($70.45 in chips) 
Seat 5: Bailey Dew ($83.94 in chips) 
Seat 6: ivan100886 ($29.71 in chips) 
Seat 7: Alexey_Kim2 ($54.35 in chips) 
Seat 8: TheMinion ($51.11 in chips) 
Seat 9: ardo888 ($76.97 in chips) 
Alexey_Kim2: posts small blind $0.25
TheMinion: posts big blind $0.50
er13to: posts the ante $0.10
matiko09: posts the ante $0.10
Bailey Dew: posts the ante $0.10
ivan100886: posts the ante $0.10
Alexey_Kim2: posts the ante $0.10
TheMinion: posts the ante $0.10
ardo888: posts the ante $0.10
*** HOLE CARDS ***
Dealt to matiko09 [Ah Jh]
ardo888: folds 
er13to: folds 
matiko09: raises $1 to $1.50
Bailey Dew: folds 
ivan100886: folds 
Alexey_Kim2: folds 
TheMinion: folds 
Uncalled bet ($1) returned to matiko09
matiko09 collected $1.95 from pot
matiko09: doesn't show hand 
*** SUMMARY ***
Total pot $1.95 | Rake $0 
Seat 2: er13to folded before Flop (didn't bet)
Seat 4: matiko09 collected ($1.95)
Seat 5: Bailey Dew folded before Flop (didn't bet)
Seat 6: ivan100886 (button) folded before Flop (didn't bet)
Seat 7: Alexey_Kim2 (small blind) folded before Flop
Seat 8: TheMinion (big blind) folded before Flop
Seat 9: ardo888 folded before Flop (didn't bet)





PokerStars Hand #155379731258:  Hold'em No Limit ($0.50/$1.00 USD) - 2016/06/30 13:38:23 CET [2016/06/30 7:38:23 ET]
Table 'Prieska' 9-max Seat #2 is the button
Seat 1: KovIFish89 ($106.97 in chips) 
Seat 2: B_style_cuz ($100.28 in chips) 
Seat 3: Rafaello18 ($124.50 in chips) 
Seat 4: matteo080613 ($51.50 in chips) 
Seat 5: ramzes160468 ($82.90 in chips) 
Seat 6: DIMAN_324 ($102.50 in chips) 
Seat 7: matiko09 ($111.47 in chips) 
Seat 8: mbk88 ($100 in chips) 
Seat 9: picka4u ($39.83 in chips) 
Rafaello18: posts small blind $0.50
matteo080613: posts big blind $1
*** HOLE CARDS ***
Dealt to matiko09 [Kd Jh]
ramzes160468: folds 
DIMAN_324: folds 
matiko09: folds 
mbk88: folds 
picka4u: folds 
KovIFish89: raises $2 to $3
B_style_cuz: calls $3
Rafaello18: folds 
matteo080613: folds 
*** FLOP *** [Ks 2d Tc]
KovIFish89: checks 
B_style_cuz: checks 
*** TURN *** [Ks 2d Tc] [5s]
KovIFish89: bets $3
B_style_cuz: raises $7 to $10
KovIFish89: calls $7
*** RIVER *** [Ks 2d Tc 5s] [5d]
KovIFish89: checks 
B_style_cuz: checks 
*** SHOW DOWN ***
KovIFish89: shows [8s 8d] (two pair, Eights and Fives)
B_style_cuz: mucks hand 
KovIFish89 collected $26.12 from pot
*** SUMMARY ***
Total pot $27.50 | Rake $1.38 
Board [Ks 2d Tc 5s 5d]
Seat 1: KovIFish89 showed [8s 8d] and won ($26.12) with two pair, Eights and Fives
Seat 2: B_style_cuz (button) mucked [4h 4c]
Seat 3: Rafaello18 (small blind) folded before Flop
Seat 4: matteo080613 (big blind) folded before Flop
Seat 5: ramzes160468 folded before Flop (didn't bet)
Seat 6: DIMAN_324 folded before Flop (didn't bet)
Seat 7: matiko09 folded before Flop (didn't bet)
Seat 8: mbk88 folded before Flop (didn't bet)
Seat 9: picka4u folded before Flop (didn't bet)





PokerStars Hand #155379734074:  Hold'em No Limit ($0.50/$1.00 USD) - 2016/06/30 13:38:29 CET [2016/06/30 7:38:29 ET]
Table 'Eucharis' 9-max Seat #2 is the button
Seat 1: er13to ($100 in chips) 
Seat 2: sanr23 ($132.78 in chips) 
Seat 3: ramzes160468 ($120.90 in chips) 
Seat 4: nordzan ($31.14 in chips) 
Seat 5: Rafaello18 ($103 in chips) 
Seat 6: matiko09 ($104.12 in chips) 
Seat 7: DIMAN_324 ($100 in chips) 
Seat 8: anfisa.irk ($42.65 in chips) 
ramzes160468: posts small blind $0.50
nordzan: posts big blind $1
*** HOLE CARDS ***
Dealt to matiko09 [5c 8s]
Rafaello18: folds 
matiko09: folds 
DIMAN_324: folds 
anfisa.irk: folds 
er13to: folds 
sanr23: folds 
ramzes160468: raises $2 to $3
nordzan: folds 
Uncalled bet ($2) returned to ramzes160468
ramzes160468 collected $2 from pot
*** SUMMARY ***
Total pot $2 | Rake $0 
Seat 1: er13to folded before Flop (didn't bet)
Seat 2: sanr23 (button) folded before Flop (didn't bet)
Seat 3: ramzes160468 (small blind) collected ($2)
Seat 4: nordzan (big blind) folded before Flop
Seat 5: Rafaello18 folded before Flop (didn't bet)
Seat 6: matiko09 folded before Flop (didn't bet)
Seat 7: DIMAN_324 folded before Flop (didn't bet)
Seat 8: anfisa.irk folded before Flop (didn't bet)





PokerStars Hand #155379734926:  Hold'em No Limit ($0.50/$1.00 USD) - 2016/06/30 13:38:31 CET [2016/06/30 7:38:31 ET]
Table 'California II' 9-max Seat #2 is the button
Seat 1: Rafaello18 ($121.52 in chips) 
Seat 2: er13to ($100 in chips) 
Seat 3: liakos120 ($80.32 in chips) 
Seat 4: mbk88 ($118.64 in chips) 
Seat 5: Rohitbarve ($97.36 in chips) 
Seat 6: matiko09 ($107.50 in chips) 
Seat 7: DomiVY ($87.20 in chips) 
Seat 8: picka4u ($41.50 in chips) 
liakos120: posts small blind $0.50
mbk88: posts big blind $1
*** HOLE CARDS ***
Dealt to matiko09 [Kc Ah]
Rohitbarve: folds 
matiko09: raises $2 to $3
DomiVY: folds 
picka4u: folds 
Rafaello18: folds 
er13to: calls $3
liakos120: calls $2.50
mbk88: folds 
*** FLOP *** [7h Ts 4d]
liakos120: checks 
matiko09: checks 
er13to: bets $6.27
liakos120: calls $6.27
matiko09: folds 
*** TURN *** [7h Ts 4d] [Qc]
liakos120: bets $10.70
er13to: calls $10.70
*** RIVER *** [7h Ts 4d Qc] [9d]
liakos120: bets $41.74
er13to: folds 
Uncalled bet ($41.74) returned to liakos120
liakos120 collected $41.74 from pot
liakos120: doesn't show hand 
*** SUMMARY ***
Total pot $43.94 | Rake $2.20 
Board [7h Ts 4d Qc 9d]
Seat 1: Rafaello18 folded before Flop (didn't bet)
Seat 2: er13to (button) folded on the River
Seat 3: liakos120 (small blind) collected ($41.74)
Seat 4: mbk88 (big blind) folded before Flop
Seat 5: Rohitbarve folded before Flop (didn't bet)
Seat 6: matiko09 folded on the Flop
Seat 7: DomiVY folded before Flop (didn't bet)
Seat 8: picka4u folded before Flop (didn't bet)





PokerStars Hand #155379735191:  Hold'em No Limit ($0.25/$0.50 USD) - 2016/06/30 13:38:32 CET [2016/06/30 7:38:32 ET]
Table 'Elektra II' 9-max Seat #6 is the button
Seat 1: drlee77 ($51.28 in chips) 
Seat 2: TheMinion ($64.07 in chips) 
Seat 3: mojtabagol ($62.09 in chips) 
Seat 4: matiko09 ($60.53 in chips) 
Seat 5: Rafaello18 ($59.99 in chips) 
Seat 6: pfunkolstar ($50 in chips) 
Seat 7: MuddyDance ($49.50 in chips) 
Seat 8: sanr23 ($50 in chips) 
Seat 9: Dantistcopra ($50 in chips) 
MuddyDance: posts small blind $0.25
sanr23: posts big blind $0.50
*** HOLE CARDS ***
Dealt to matiko09 [Tc Qs]
Dantistcopra: folds 
drlee77: folds 
TheMinion: folds 
mojtabagol: raises $0.50 to $1
matiko09: folds 
Rafaello18: folds 
pfunkolstar: folds 
MuddyDance: folds 
sanr23: calls $0.50
*** FLOP *** [4h 7d 9d]
sanr23: checks 
mojtabagol: checks 
*** TURN *** [4h 7d 9d] [9h]
sanr23: bets $1.24
mojtabagol: folds 
Uncalled bet ($1.24) returned to sanr23
sanr23 collected $2.14 from pot
sanr23: doesn't show hand 
*** SUMMARY ***
Total pot $2.25 | Rake $0.11 
Board [4h 7d 9d 9h]
Seat 1: drlee77 folded before Flop (didn't bet)
Seat 2: TheMinion folded before Flop (didn't bet)
Seat 3: mojtabagol folded on the Turn
Seat 4: matiko09 folded before Flop (didn't bet)
Seat 5: Rafaello18 folded before Flop (didn't bet)
Seat 6: pfunkolstar (button) folded before Flop (didn't bet)
Seat 7: MuddyDance (small blind) folded before Flop
Seat 8: sanr23 (big blind) collected ($2.14)
Seat 9: Dantistcopra folded before Flop (didn't bet)





PokerStars Hand #155379736640:  Hold'em No Limit ($0.50/$1.00 USD) - 2016/06/30 13:38:35 CET [2016/06/30 7:38:35 ET]
Table 'Tatjana' 9-max Seat #1 is the button
Seat 1: ardo888 ($124.96 in chips) 
Seat 2: DIMAN_324 ($100 in chips) 
Seat 3: Rafaello18 ($106.13 in chips) 
Seat 4: Konig26 ($248.14 in chips) 
Seat 5: matiko09 ($102.18 in chips) 
Seat 6: mbk88 ($108.10 in chips) 
Seat 7: DomiVY ($40 in chips) 
Seat 9: POTAPENKO700 ($100 in chips) 
DIMAN_324: posts small blind $0.50
Rafaello18: posts big blind $1
*** HOLE CARDS ***
Dealt to matiko09 [5h 4c]
Konig26: raises $1.50 to $2.50
matiko09: folds 
mbk88: folds 
DomiVY: folds 
POTAPENKO700: raises $6 to $8.50
ardo888: folds 
DIMAN_324: folds 
Rafaello18: folds 
Konig26: calls $6
*** FLOP *** [3h 5s Qd]
Konig26: checks 
POTAPENKO700: bets $11.71
Konig26: calls $11.71
*** TURN *** [3h 5s Qd] [Ah]
Konig26: checks 
POTAPENKO700: bets $23.50
Konig26: calls $23.50
*** RIVER *** [3h 5s Qd Ah] [2s]
Konig26: checks 
POTAPENKO700: checks 
*** SHOW DOWN ***
Konig26: shows [Ad 8d] (a pair of Aces)
POTAPENKO700: shows [Jc Ac] (a pair of Aces - Queen+Jack kicker)
POTAPENKO700 collected $86.42 from pot
*** SUMMARY ***
Total pot $88.92 | Rake $2.50 
Board [3h 5s Qd Ah 2s]
Seat 1: ardo888 (button) folded before Flop (didn't bet)
Seat 2: DIMAN_324 (small blind) folded before Flop
Seat 3: Rafaello18 (big blind) folded before Flop
Seat 4: Konig26 showed [Ad 8d] and lost with a pair of Aces
Seat 5: matiko09 folded before Flop (didn't bet)
Seat 6: mbk88 folded before Flop (didn't bet)
Seat 7: DomiVY folded before Flop (didn't bet)
Seat 9: POTAPENKO700 showed [Jc Ac] and won ($86.42) with a pair of Aces





PokerStars Hand #155379736749:  Hold'em No Limit ($0.50/$1.00 USD) - 2016/06/30 13:38:36 CET [2016/06/30 7:38:36 ET]
Table 'Borrelly II' 9-max Seat #7 is the button
Seat 1: Rafaello18 ($100 in chips) 
Seat 2: tipner ($102.72 in chips) 
Seat 4: DonRon_AT ($35.06 in chips) 
Seat 5: picka4u ($136.65 in chips) 
Seat 6: m_michalec ($185.38 in chips) 
Seat 7: matiko09 ($155.85 in chips) 
Rafaello18: posts small blind $0.50
tipner: posts big blind $1
*** HOLE CARDS ***
Dealt to matiko09 [Js 2d]
alhill86 joins the table at seat #9 
DonRon_AT: calls $1
picka4u: folds 
m_michalec: folds 
matiko09: folds 
Rafaello18: calls $0.50
tipner: checks 
*** FLOP *** [2s Kc 4s]
Rafaello18: checks 
tipner: checks 
DonRon_AT: bets $2
Rafaello18: folds 
tipner: folds 
Uncalled bet ($2) returned to DonRon_AT
DonRon_AT collected $2.85 from pot
*** SUMMARY ***
Total pot $3 | Rake $0.15 
Board [2s Kc 4s]
Seat 1: Rafaello18 (small blind) folded on the Flop
Seat 2: tipner (big blind) folded on the Flop
Seat 4: DonRon_AT collected ($2.85)
Seat 5: picka4u folded before Flop (didn't bet)
Seat 6: m_michalec folded before Flop (didn't bet)
Seat 7: matiko09 (button) folded before Flop (didn't bet)





PokerStars Hand #155379741008:  Hold'em No Limit ($0.25/$0.50 USD) - 2016/06/30 13:38:46 CET [2016/06/30 7:38:46 ET]
Table 'Dorothea II' 9-max Seat #7 is the button
Seat 2: er13to ($50.20 in chips) 
Seat 4: matiko09 ($71.80 in chips) 
Seat 5: Bailey Dew ($83.84 in chips) 
Seat 6: ivan100886 ($29.61 in chips) 
Seat 7: Alexey_Kim2 ($54 in chips) 
Seat 8: TheMinion ($50.51 in chips) 
Seat 9: ardo888 ($76.87 in chips) 
TheMinion: posts small blind $0.25
ardo888: posts big blind $0.50
er13to: posts the ante $0.10
matiko09: posts the ante $0.10
Bailey Dew: posts the ante $0.10
ivan100886: posts the ante $0.10
Alexey_Kim2: posts the ante $0.10
TheMinion: posts the ante $0.10
ardo888: posts the ante $0.10
*** HOLE CARDS ***
Dealt to matiko09 [6s 7h]
er13to: folds 
matiko09: folds 
Bailey Dew: folds 
ivan100886: folds 
Alexey_Kim2: raises $0.50 to $1
TheMinion: folds 
ardo888: folds 
Uncalled bet ($0.50) returned to Alexey_Kim2
Alexey_Kim2 collected $1.95 from pot
Alexey_Kim2: doesn't show hand 
*** SUMMARY ***
Total pot $1.95 | Rake $0 
Seat 2: er13to folded before Flop (didn't bet)
Seat 4: matiko09 folded before Flop (didn't bet)
Seat 5: Bailey Dew folded before Flop (didn't bet)
Seat 6: ivan100886 folded before Flop (didn't bet)
Seat 7: Alexey_Kim2 (button) collected ($1.95)
Seat 8: TheMinion (small blind) folded before Flop
Seat 9: ardo888 (big blind) folded before Flop





PokerStars Hand #155379746745:  Hold'em No Limit ($0.50/$1.00 USD) - 2016/06/30 13:38:59 CET [2016/06/30 7:38:59 ET]
Table 'Apisaon II' 9-max Seat #4 is the button
Seat 1: OMG Dardania ($175.57 in chips) 
Seat 3: matteo080613 ($93.23 in chips) 
Seat 4: mbk88 ($100 in chips) 
Seat 5: riccfch ($96.26 in chips) 
Seat 7: matiko09 ($112.93 in chips) 
Seat 8: ardo888 ($102.53 in chips) 
riccfch: posts small blind $0.50
tipner: is sitting out 
matiko09: posts big blind $1
OMG Dardania: posts the ante $0.20
matteo080613: posts the ante $0.20
mbk88: posts the ante $0.20
riccfch: posts the ante $0.20
matiko09: posts the ante $0.20
ardo888: posts the ante $0.20
*** HOLE CARDS ***
Dealt to matiko09 [2h 9c]
ardo888: folds 
OMG Dardania: folds 
matteo080613: raises $1 to $2
mbk88: raises $6 to $8
riccfch: folds 
tipner leaves the table
matiko09: folds 
matteo080613: calls $6
*** FLOP *** [5s 3c 3s]
matteo080613: checks 
mbk88: bets $12
matteo080613: raises $12 to $24
mbk88: raises $12 to $36
matteo080613: calls $12
*** TURN *** [5s 3c 3s] [3d]
OMG Dardania leaves the table
matteo080613: bets $49.03 and is all-in
mbk88: calls $49.03
*** RIVER *** [5s 3c 3s 3d] [Ah]
*** SHOW DOWN ***
matteo080613: shows [9h 9d] (a full house, Threes full of Nines)
mbk88: shows [Kd Kc] (a full house, Threes full of Kings)
mbk88 collected $186.26 from pot
*** SUMMARY ***
Total pot $188.76 | Rake $2.50 
Board [5s 3c 3s 3d Ah]
Seat 1: OMG Dardania folded before Flop (didn't bet)
Seat 3: matteo080613 showed [9h 9d] and lost with a full house, Threes full of Nines
Seat 4: mbk88 (button) showed [Kd Kc] and won ($186.26) with a full house, Threes full of Kings
Seat 5: riccfch (small blind) folded before Flop
Seat 7: matiko09 (big blind) folded before Flop
Seat 8: ardo888 folded before Flop (didn't bet)





PokerStars Hand #155379747779:  Hold'em No Limit ($0.50/$1.00 USD) - 2016/06/30 13:39:01 CET [2016/06/30 7:39:01 ET]
Table 'Asmodeus' 9-max Seat #3 is the button
Seat 1: scollop ($81.19 in chips) 
Seat 2: picka4u ($38.02 in chips) 
Seat 3: matiko09 ($100 in chips) 
Seat 4: ardo888 ($138.28 in chips) 
Seat 5: sanr23 ($100 in chips) 
Seat 6: koutani7 ($94 in chips) 
Seat 7: aaronzzr ($158.79 in chips) 
Seat 8: Rafaello18 ($162.10 in chips) 
Seat 9: mbk88 ($168.18 in chips) 
ardo888: posts small blind $0.50
sanr23: posts big blind $1
*** HOLE CARDS ***
Dealt to matiko09 [3c Th]
koutani7: folds 
aaronzzr: folds 
Rafaello18: raises $1.50 to $2.50
mbk88: folds 
scollop: calls $2.50
picka4u: folds 
matiko09: folds 
ardo888: folds 
sanr23: folds 
*** FLOP *** [3s 5c Tc]
Rafaello18: bets $3.15
scollop: calls $3.15
*** TURN *** [3s 5c Tc] [As]
Rafaello18: checks 
scollop: bets $1
Rafaello18: calls $1
*** RIVER *** [3s 5c Tc As] [Qc]
Rafaello18: checks 
scollop: checks 
*** SHOW DOWN ***
Rafaello18: shows [6d 6h] (a pair of Sixes)
scollop: shows [Td Jc] (a pair of Tens)
scollop collected $14.06 from pot
*** SUMMARY ***
Total pot $14.80 | Rake $0.74 
Board [3s 5c Tc As Qc]
Seat 1: scollop showed [Td Jc] and won ($14.06) with a pair of Tens
Seat 2: picka4u folded before Flop (didn't bet)
Seat 3: matiko09 (button) folded before Flop (didn't bet)
Seat 4: ardo888 (small blind) folded before Flop
Seat 5: sanr23 (big blind) folded before Flop
Seat 6: koutani7 folded before Flop (didn't bet)
Seat 7: aaronzzr folded before Flop (didn't bet)
Seat 8: Rafaello18 showed [6d 6h] and lost with a pair of Sixes
Seat 9: mbk88 folded before Flop (didn't bet)





PokerStars Hand #155379750801:  Hold'em No Limit ($0.25/$0.50 USD) - 2016/06/30 13:39:09 CET [2016/06/30 7:39:09 ET]
Table 'Dorothea II' 9-max Seat #8 is the button
Seat 2: er13to ($50.10 in chips) 
Seat 4: matiko09 ($71.70 in chips) 
Seat 5: Bailey Dew ($83.74 in chips) 
Seat 6: ivan100886 ($29.51 in chips) 
Seat 7: Alexey_Kim2 ($55.35 in chips) 
Seat 8: TheMinion ($50.16 in chips) 
Seat 9: ardo888 ($76.27 in chips) 
ardo888: posts small blind $0.25
er13to: posts big blind $0.50
er13to: posts the ante $0.10
matiko09: posts the ante $0.10
Bailey Dew: posts the ante $0.10
ivan100886: posts the ante $0.10
Alexey_Kim2: posts the ante $0.10
TheMinion: posts the ante $0.10
ardo888: posts the ante $0.10
*** HOLE CARDS ***
Dealt to matiko09 [7h 7c]
matiko09: raises $1 to $1.50
Bailey Dew: folds 
ivan100886: folds 
Alexey_Kim2: folds 
TheMinion: folds 
ardo888: folds 
er13to: folds 
Uncalled bet ($1) returned to matiko09
matiko09 collected $1.95 from pot
matiko09: doesn't show hand 
*** SUMMARY ***
Total pot $1.95 | Rake $0 
Seat 2: er13to (big blind) folded before Flop
Seat 4: matiko09 collected ($1.95)
Seat 5: Bailey Dew folded before Flop (didn't bet)
Seat 6: ivan100886 folded before Flop (didn't bet)
Seat 7: Alexey_Kim2 folded before Flop (didn't bet)
Seat 8: TheMinion (button) folded before Flop (didn't bet)
Seat 9: ardo888 (small blind) folded before Flop





PokerStars Hand #155379757280:  Hold'em No Limit ($0.50/$1.00 USD) - 2016/06/30 13:39:24 CET [2016/06/30 7:39:24 ET]
Table 'Eucharis' 9-max Seat #3 is the button
Seat 1: er13to ($100 in chips) 
Seat 2: sanr23 ($132.78 in chips) 
Seat 3: ramzes160468 ($121.90 in chips) 
Seat 4: nordzan ($30.14 in chips) 
Seat 5: Rafaello18 ($103 in chips) 
Seat 6: matiko09 ($104.12 in chips) 
Seat 7: DIMAN_324 ($100 in chips) 
Seat 8: anfisa.irk ($42.65 in chips) 
nordzan: posts small blind $0.50
Rafaello18: posts big blind $1
*** HOLE CARDS ***
Dealt to matiko09 [Td 7s]
matiko09: folds 
DIMAN_324: folds 
anfisa.irk: folds 
er13to: folds 
sanr23: folds 
ramzes160468: folds 
nordzan: raises $1 to $2
Rafaello18: folds 
Uncalled bet ($1) returned to nordzan
nordzan collected $2 from pot
nordzan: doesn't show hand 
*** SUMMARY ***
Total pot $2 | Rake $0 
Seat 1: er13to folded before Flop (didn't bet)
Seat 2: sanr23 folded before Flop (didn't bet)
Seat 3: ramzes160468 (button) folded before Flop (didn't bet)
Seat 4: nordzan (small blind) collected ($2)
Seat 5: Rafaello18 (big blind) folded before Flop
Seat 6: matiko09 folded before Flop (didn't bet)
Seat 7: DIMAN_324 folded before Flop (didn't bet)
Seat 8: anfisa.irk folded before Flop (didn't bet)





PokerStars Hand #155379757635:  Hold'em No Limit ($0.25/$0.50 USD) - 2016/06/30 13:39:25 CET [2016/06/30 7:39:25 ET]
Table 'Dorothea II' 9-max Seat #9 is the button
Seat 2: er13to ($50 in chips) 
Seat 4: matiko09 ($73.05 in chips) 
Seat 5: Bailey Dew ($83.64 in chips) 
Seat 6: ivan100886 ($29.41 in chips) 
Seat 7: Alexey_Kim2 ($55.25 in chips) 
Seat 8: TheMinion ($50.06 in chips) 
Seat 9: ardo888 ($75.92 in chips) 
er13to: posts small blind $0.25
matiko09: posts big blind $0.50
er13to: posts the ante $0.10
matiko09: posts the ante $0.10
Bailey Dew: posts the ante $0.10
ivan100886: posts the ante $0.10
Alexey_Kim2: posts the ante $0.10
TheMinion: posts the ante $0.10
ardo888: posts the ante $0.10
*** HOLE CARDS ***
Dealt to matiko09 [Ac 4c]
Bailey Dew: folds 
ivan100886: folds 
Alexey_Kim2: folds 
TheMinion: folds 
ardo888: folds 
er13to: folds 
Uncalled bet ($0.25) returned to matiko09
matiko09 collected $1.20 from pot
matiko09: doesn't show hand 
*** SUMMARY ***
Total pot $1.20 | Rake $0 
Seat 2: er13to (small blind) folded before Flop
Seat 4: matiko09 (big blind) collected ($1.20)
Seat 5: Bailey Dew folded before Flop (didn't bet)
Seat 6: ivan100886 folded before Flop (didn't bet)
Seat 7: Alexey_Kim2 folded before Flop (didn't bet)
Seat 8: TheMinion folded before Flop (didn't bet)
Seat 9: ardo888 (button) folded before Flop (didn't bet)





PokerStars Hand #155379766338:  Hold'em No Limit ($0.50/$1.00 USD) - 2016/06/30 13:39:45 CET [2016/06/30 7:39:45 ET]
Table 'Eucharis' 9-max Seat #4 is the button
Seat 1: er13to ($100 in chips) 
Seat 2: sanr23 ($132.78 in chips) 
Seat 3: ramzes160468 ($121.90 in chips) 
Seat 4: nordzan ($31.14 in chips) 
Seat 5: Rafaello18 ($102 in chips) 
Seat 6: matiko09 ($104.12 in chips) 
Seat 7: DIMAN_324 ($100 in chips) 
Seat 8: anfisa.irk ($42.65 in chips) 
Rafaello18: posts small blind $0.50
matiko09: posts big blind $1
*** HOLE CARDS ***
Dealt to matiko09 [Ac 7h]
DIMAN_324: folds 
anfisa.irk: folds 
er13to: raises $1.72 to $2.72
sanr23: folds 
ramzes160468: folds 
nordzan: folds 
nordzan leaves the table
Rafaello18: folds 
matiko09: folds 
Uncalled bet ($1.72) returned to er13to
er13to collected $2.50 from pot
*** SUMMARY ***
Total pot $2.50 | Rake $0 
Seat 1: er13to collected ($2.50)
Seat 2: sanr23 folded before Flop (didn't bet)
Seat 3: ramzes160468 folded before Flop (didn't bet)
Seat 4: nordzan (button) folded before Flop (didn't bet)
Seat 5: Rafaello18 (small blind) folded before Flop
Seat 6: matiko09 (big blind) folded before Flop
Seat 7: DIMAN_324 folded before Flop (didn't bet)
Seat 8: anfisa.irk folded before Flop (didn't bet)





PokerStars Hand #155379766484:  Hold'em No Limit ($0.25/$0.50 USD) - 2016/06/30 13:39:45 CET [2016/06/30 7:39:45 ET]
Table 'Dorothea II' 9-max Seat #2 is the button
Seat 2: er13to ($50 in chips) 
Seat 4: matiko09 ($73.90 in chips) 
Seat 5: Bailey Dew ($83.54 in chips) 
Seat 6: ivan100886 ($29.31 in chips) 
Seat 7: Alexey_Kim2 ($55.15 in chips) 
Seat 8: TheMinion ($50 in chips) 
Seat 9: ardo888 ($75.82 in chips) 
matiko09: posts small blind $0.25
Bailey Dew: posts big blind $0.50
er13to: posts the ante $0.10
matiko09: posts the ante $0.10
Bailey Dew: posts the ante $0.10
ivan100886: posts the ante $0.10
Alexey_Kim2: posts the ante $0.10
TheMinion: posts the ante $0.10
ardo888: posts the ante $0.10
*** HOLE CARDS ***
Dealt to matiko09 [Js 7d]
ivan100886: folds 
Alexey_Kim2: folds 
TheMinion: folds 
ardo888: folds 
er13to: folds 
matiko09: folds 
Uncalled bet ($0.25) returned to Bailey Dew
Bailey Dew collected $1.20 from pot
Bailey Dew: doesn't show hand 
*** SUMMARY ***
Total pot $1.20 | Rake $0 
Seat 2: er13to (button) folded before Flop (didn't bet)
Seat 4: matiko09 (small blind) folded before Flop
Seat 5: Bailey Dew (big blind) collected ($1.20)
Seat 6: ivan100886 folded before Flop (didn't bet)
Seat 7: Alexey_Kim2 folded before Flop (didn't bet)
Seat 8: TheMinion folded before Flop (didn't bet)
Seat 9: ardo888 folded before Flop (didn't bet)





PokerStars Hand #155379767878:  Hold'em No Limit ($0.50/$1.00 USD) - 2016/06/30 13:39:48 CET [2016/06/30 7:39:48 ET]
Table 'Prieska' 9-max Seat #3 is the button
Seat 1: KovIFish89 ($120.09 in chips) 
Seat 2: B_style_cuz ($87.28 in chips) 
Seat 3: Rafaello18 ($124 in chips) 
Seat 4: matteo080613 ($50.50 in chips) 
Seat 5: ramzes160468 ($82.90 in chips) 
Seat 6: DIMAN_324 ($102.50 in chips) 
Seat 7: matiko09 ($111.47 in chips) 
Seat 8: mbk88 ($100 in chips) 
Seat 9: picka4u ($39.83 in chips) 
matteo080613: posts small blind $0.50
ramzes160468: posts big blind $1
*** HOLE CARDS ***
Dealt to matiko09 [Td 9d]
DIMAN_324: folds 
matiko09: raises $2 to $3
mbk88: folds 
picka4u: folds 
KovIFish89: folds 
B_style_cuz: folds 
Rafaello18: folds 
matteo080613: folds 
ramzes160468: folds 
Uncalled bet ($2) returned to matiko09
matiko09 collected $2.50 from pot
matiko09: doesn't show hand 
*** SUMMARY ***
Total pot $2.50 | Rake $0 
Seat 1: KovIFish89 folded before Flop (didn't bet)
Seat 2: B_style_cuz folded before Flop (didn't bet)
Seat 3: Rafaello18 (button) folded before Flop (didn't bet)
Seat 4: matteo080613 (small blind) folded before Flop
Seat 5: ramzes160468 (big blind) folded before Flop
Seat 6: DIMAN_324 folded before Flop (didn't bet)
Seat 7: matiko09 collected ($2.50)
Seat 8: mbk88 folded before Flop (didn't bet)
Seat 9: picka4u folded before Flop (didn't bet)





PokerStars Hand #155379768225:  Hold'em No Limit ($0.50/$1.00 USD) - 2016/06/30 13:39:49 CET [2016/06/30 7:39:49 ET]
Table 'Borrelly II' 9-max Seat #1 is the button
Seat 1: Rafaello18 ($100 in chips) 
Seat 2: tipner ($101.72 in chips) 
Seat 4: DonRon_AT ($36.91 in chips) 
Seat 5: picka4u ($136.65 in chips) 
Seat 6: m_michalec ($185.38 in chips) 
Seat 7: matiko09 ($155.85 in chips) 
tipner: posts small blind $0.50
DonRon_AT: posts big blind $1
alhill86: sits out 
*** HOLE CARDS ***
Dealt to matiko09 [4d 3d]
picka4u: folds 
picka4u leaves the table
m_michalec: raises $2 to $3
matiko09: folds 
Rafaello18: calls $3
tipner: raises $10 to $13
DIMAN_324 joins the table at seat #5 
DonRon_AT: folds 
m_michalec: folds 
Rafaello18: folds 
Uncalled bet ($10) returned to tipner
tipner collected $10 from pot
tipner: doesn't show hand 
*** SUMMARY ***
Total pot $10 | Rake $0 
Seat 1: Rafaello18 (button) folded before Flop
Seat 2: tipner (small blind) collected ($10)
Seat 4: DonRon_AT (big blind) folded before Flop
Seat 5: picka4u folded before Flop (didn't bet)
Seat 6: m_michalec folded before Flop
Seat 7: matiko09 folded before Flop (didn't bet)





PokerStars Hand #155379769015:  Hold'em No Limit ($0.25/$0.50 USD) - 2016/06/30 13:39:51 CET [2016/06/30 7:39:51 ET]
Table 'Elektra II' 9-max Seat #7 is the button
Seat 1: drlee77 ($51.28 in chips) 
Seat 2: TheMinion ($64.07 in chips) 
Seat 3: mojtabagol ($61.09 in chips) 
Seat 4: matiko09 ($60.53 in chips) 
Seat 5: Rafaello18 ($59.99 in chips) 
Seat 6: pfunkolstar ($50 in chips) 
Seat 7: MuddyDance ($49.25 in chips) 
Seat 8: sanr23 ($51.14 in chips) 
Seat 9: Dantistcopra ($50 in chips) 
sanr23: posts small blind $0.25
Dantistcopra: posts big blind $0.50
*** HOLE CARDS ***
Dealt to matiko09 [9s Qs]
drlee77: folds 
TheMinion: folds 
mojtabagol: raises $1 to $1.50
matiko09: folds 
Rafaello18: folds 
pfunkolstar: folds 
MuddyDance: folds 
sanr23: folds 
Dantistcopra: calls $1
*** FLOP *** [7h 3s 5d]
Dantistcopra: checks 
mojtabagol: bets $3.09
Dantistcopra: calls $3.09
*** TURN *** [7h 3s 5d] [7c]
Dantistcopra: checks 
mojtabagol: checks 
*** RIVER *** [7h 3s 5d 7c] [Jc]
Dantistcopra: checks 
mojtabagol: bets $8.96
Dantistcopra: folds 
Uncalled bet ($8.96) returned to mojtabagol
mojtabagol collected $8.96 from pot
*** SUMMARY ***
Total pot $9.43 | Rake $0.47 
Board [7h 3s 5d 7c Jc]
Seat 1: drlee77 folded before Flop (didn't bet)
Seat 2: TheMinion folded before Flop (didn't bet)
Seat 3: mojtabagol collected ($8.96)
Seat 4: matiko09 folded before Flop (didn't bet)
Seat 5: Rafaello18 folded before Flop (didn't bet)
Seat 6: pfunkolstar folded before Flop (didn't bet)
Seat 7: MuddyDance (button) folded before Flop (didn't bet)
Seat 8: sanr23 (small blind) folded before Flop
Seat 9: Dantistcopra (big blind) folded on the River





PokerStars Hand #155379769780:  Hold'em No Limit ($0.50/$1.00 USD) - 2016/06/30 13:39:53 CET [2016/06/30 7:39:53 ET]
Table 'Asmodeus' 9-max Seat #4 is the button
Seat 1: scollop ($88.60 in chips) 
Seat 2: picka4u ($38.02 in chips) 
Seat 3: matiko09 ($100 in chips) 
Seat 4: ardo888 ($137.78 in chips) 
Seat 5: sanr23 ($100 in chips) 
Seat 6: koutani7 ($94 in chips) 
Seat 7: aaronzzr ($158.79 in chips) 
Seat 8: Rafaello18 ($155.45 in chips) 
Seat 9: mbk88 ($168.18 in chips) 
sanr23: posts small blind $0.50
koutani7: posts big blind $1
*** HOLE CARDS ***
Dealt to matiko09 [5c Th]
aaronzzr: calls $1
Rafaello18: raises $1.50 to $2.50
mbk88: calls $2.50
scollop: calls $2.50
picka4u: folds 
matiko09: folds 
ardo888: calls $2.50
sanr23: calls $2
koutani7: folds 
aaronzzr: calls $1.50
*** FLOP *** [4s As 7c]
sanr23: checks 
aaronzzr: checks 
Rafaello18: checks 
mbk88: bets $8
scollop: calls $8
ardo888: folds 
sanr23: folds 
aaronzzr: folds 
Rafaello18: folds 
*** TURN *** [4s As 7c] [Jd]
mbk88: checks 
scollop: bets $15
mbk88: folds 
Uncalled bet ($15) returned to scollop
scollop collected $30.40 from pot
scollop: doesn't show hand 
*** SUMMARY ***
Total pot $32 | Rake $1.60 
Board [4s As 7c Jd]
Seat 1: scollop collected ($30.40)
Seat 2: picka4u folded before Flop (didn't bet)
Seat 3: matiko09 folded before Flop (didn't bet)
Seat 4: ardo888 (button) folded on the Flop
Seat 5: sanr23 (small blind) folded on the Flop
Seat 6: koutani7 (big blind) folded before Flop
Seat 7: aaronzzr folded on the Flop
Seat 8: Rafaello18 folded on the Flop
Seat 9: mbk88 folded on the Turn





PokerStars Hand #155379771995:  Hold'em No Limit ($0.50/$1.00 USD) - 2016/06/30 13:39:58 CET [2016/06/30 7:39:58 ET]
Table 'Altarf II' 9-max Seat #9 is the button
Seat 1: thecurv ($108.47 in chips) 
Seat 2: KovIFish89 ($101.50 in chips) 
Seat 3: sanr23 ($100 in chips) 
Seat 4: Greha999 ($83.66 in chips) 
Seat 6: mbk88 ($130.50 in chips) 
Seat 7: matiko09 ($100 in chips) 
Seat 8: Kertesh ($36.50 in chips) 
Seat 9: omanibemihum ($60.31 in chips) 
thecurv: posts small blind $0.50
KovIFish89: posts big blind $1
DIMAN_324: sits out 
*** HOLE CARDS ***
Dealt to matiko09 [Ah 9h]
sanr23: folds 
Greha999: folds 
mbk88: folds 
matiko09: raises $2 to $3
Kertesh: folds 
omanibemihum: calls $3
thecurv: folds 
KovIFish89: folds 
*** FLOP *** [9c 9s 8h]
matiko09: checks 
omanibemihum: bets $4
matiko09: calls $4
*** TURN *** [9c 9s 8h] [Kh]
matiko09: checks 
omanibemihum: checks 
*** RIVER *** [9c 9s 8h Kh] [6d]
matiko09: bets $10
omanibemihum: folds 
Uncalled bet ($10) returned to matiko09
matiko09 collected $14.72 from pot
matiko09: doesn't show hand 
*** SUMMARY ***
Total pot $15.50 | Rake $0.78 
Board [9c 9s 8h Kh 6d]
Seat 1: thecurv (small blind) folded before Flop
Seat 2: KovIFish89 (big blind) folded before Flop
Seat 3: sanr23 folded before Flop (didn't bet)
Seat 4: Greha999 folded before Flop (didn't bet)
Seat 6: mbk88 folded before Flop (didn't bet)
Seat 7: matiko09 collected ($14.72)
Seat 8: Kertesh folded before Flop (didn't bet)
Seat 9: omanibemihum (button) folded on the River





PokerStars Hand #155379775527:  Hold'em No Limit ($0.50/$1.00 USD) - 2016/06/30 13:40:06 CET [2016/06/30 7:40:06 ET]
Table 'Eucharis' 9-max Seat #5 is the button
Seat 1: er13to ($101.50 in chips) 
Seat 2: sanr23 ($132.78 in chips) 
Seat 3: ramzes160468 ($121.90 in chips) 
Seat 5: Rafaello18 ($101.50 in chips) 
Seat 6: matiko09 ($103.12 in chips) 
Seat 7: DIMAN_324 ($100 in chips) 
Seat 8: anfisa.irk ($42.65 in chips) 
matiko09: posts small blind $0.50
DIMAN_324: posts big blind $1
*** HOLE CARDS ***
Dealt to matiko09 [8d Ts]
anfisa.irk: folds 
er13to: folds 
sanr23: folds 
ramzes160468: folds 
Rafaello18: folds 
matiko09: folds 
Uncalled bet ($0.50) returned to DIMAN_324
DIMAN_324 collected $1 from pot
DIMAN_324: doesn't show hand 
*** SUMMARY ***
Total pot $1 | Rake $0 
Seat 1: er13to folded before Flop (didn't bet)
Seat 2: sanr23 folded before Flop (didn't bet)
Seat 3: ramzes160468 folded before Flop (didn't bet)
Seat 5: Rafaello18 (button) folded before Flop (didn't bet)
Seat 6: matiko09 (small blind) folded before Flop
Seat 7: DIMAN_324 (big blind) collected ($1)
Seat 8: anfisa.irk folded before Flop (didn't bet)





PokerStars Hand #155379777469:  Hold'em No Limit ($0.50/$1.00 USD) - 2016/06/30 13:40:11 CET [2016/06/30 7:40:11 ET]
Table 'Apisaon II' 9-max Seat #5 is the button
Seat 4: mbk88 ($193.03 in chips) 
Seat 5: riccfch ($95.56 in chips) 
Seat 7: matiko09 ($111.73 in chips) 
Seat 8: ardo888 ($102.33 in chips) 
matiko09: posts small blind $0.50
ardo888: posts big blind $1
mbk88: posts the ante $0.20
riccfch: posts the ante $0.20
matiko09: posts the ante $0.20
ardo888: posts the ante $0.20
*** HOLE CARDS ***
Dealt to matiko09 [2s Jd]
mbk88: raises $1 to $2
riccfch: raises $6.30 to $8.30
matiko09: folds 
ardo888: folds 
mbk88: folds 
Uncalled bet ($6.30) returned to riccfch
riccfch collected $6.30 from pot
riccfch: doesn't show hand 
*** SUMMARY ***
Total pot $6.30 | Rake $0 
Seat 4: mbk88 folded before Flop
Seat 5: riccfch (button) collected ($6.30)
Seat 7: matiko09 (small blind) folded before Flop
Seat 8: ardo888 (big blind) folded before Flop





PokerStars Hand #155379777905:  Hold'em No Limit ($0.25/$0.50 USD) - 2016/06/30 13:40:12 CET [2016/06/30 7:40:12 ET]
Table 'Dorothea II' 9-max Seat #4 is the button
Seat 2: er13to ($50 in chips) 
Seat 4: matiko09 ($73.55 in chips) 
Seat 5: Bailey Dew ($84.39 in chips) 
Seat 6: ivan100886 ($29.21 in chips) 
Seat 7: Alexey_Kim2 ($55.05 in chips) 
Seat 8: TheMinion ($50 in chips) 
Seat 9: ardo888 ($75.72 in chips) 
Bailey Dew: posts small blind $0.25
ivan100886: posts big blind $0.50
er13to: posts the ante $0.10
matiko09: posts the ante $0.10
Bailey Dew: posts the ante $0.10
ivan100886: posts the ante $0.10
Alexey_Kim2: posts the ante $0.10
TheMinion: posts the ante $0.10
ardo888: posts the ante $0.10
*** HOLE CARDS ***
Dealt to matiko09 [Ac Qh]
Alexey_Kim2: folds 
TheMinion: folds 
ardo888: folds 
Alexey_Kim2 leaves the table
er13to: raises $0.86 to $1.36
matiko09: calls $1.36
Bailey Dew: folds 
ivan100886: folds 
*** FLOP *** [Ts Kc 8c]
er13to: checks 
matiko09: bets $2.57
er13to: calls $2.57
*** TURN *** [Ts Kc 8c] [Qd]
er13to: checks 
matiko09: checks 
*** RIVER *** [Ts Kc 8c Qd] [6d]
er13to: checks 
matiko09: checks 
*** SHOW DOWN ***
er13to: shows [Tc 9c] (a pair of Tens)
matiko09: shows [Ac Qh] (a pair of Queens)
matiko09 collected $8.84 from pot
*** SUMMARY ***
Total pot $9.31 | Rake $0.47 
Board [Ts Kc 8c Qd 6d]
Seat 2: er13to showed [Tc 9c] and lost with a pair of Tens
Seat 4: matiko09 (button) showed [Ac Qh] and won ($8.84) with a pair of Queens
Seat 5: Bailey Dew (small blind) folded before Flop
Seat 6: ivan100886 (big blind) folded before Flop
Seat 7: Alexey_Kim2 folded before Flop (didn't bet)
Seat 8: TheMinion folded before Flop (didn't bet)
Seat 9: ardo888 folded before Flop (didn't bet)





PokerStars Hand #155379778802:  Hold'em No Limit ($0.50/$1.00 USD) - 2016/06/30 13:40:14 CET [2016/06/30 7:40:14 ET]
Table 'Tatjana' 9-max Seat #2 is the button
Seat 1: ardo888 ($124.96 in chips) 
Seat 2: DIMAN_324 ($100 in chips) 
Seat 3: Rafaello18 ($105.13 in chips) 
Seat 5: matiko09 ($102.18 in chips) 
Seat 6: mbk88 ($108.10 in chips) 
Seat 7: DomiVY ($40 in chips) 
Seat 9: POTAPENKO700 ($142.71 in chips) 
Rafaello18: posts small blind $0.50
Konig26: is sitting out 
matiko09: posts big blind $1
alhill86: sits out 
*** HOLE CARDS ***
Dealt to matiko09 [Ts Js]
mbk88: folds 
DomiVY: folds 
POTAPENKO700: folds 
Konig26 leaves the table
ardo888: folds 
KovIFish89 joins the table at seat #4 
DIMAN_324: raises $1.10 to $2.10
Rafaello18: folds 
matiko09: calls $1.10
*** FLOP *** [4h Jh 7h]
KovIFish89 leaves the table
matiko09: checks 
DIMAN_324: checks 
*** TURN *** [4h Jh 7h] [9h]
matiko09: checks 
DIMAN_324: checks 
*** RIVER *** [4h Jh 7h 9h] [7d]
matiko09: checks 
DIMAN_324: checks 
*** SHOW DOWN ***
matiko09: shows [Ts Js] (two pair, Jacks and Sevens)
DIMAN_324: mucks hand 
matiko09 collected $4.46 from pot
*** SUMMARY ***
Total pot $4.70 | Rake $0.24 
Board [4h Jh 7h 9h 7d]
Seat 1: ardo888 folded before Flop (didn't bet)
Seat 2: DIMAN_324 (button) mucked [Jc 2c]
Seat 3: Rafaello18 (small blind) folded before Flop
Seat 5: matiko09 (big blind) showed [Ts Js] and won ($4.46) with two pair, Jacks and Sevens
Seat 6: mbk88 folded before Flop (didn't bet)
Seat 7: DomiVY folded before Flop (didn't bet)
Seat 9: POTAPENKO700 folded before Flop (didn't bet)





PokerStars Hand #155379780578:  Hold'em No Limit ($0.50/$1.00 USD) - 2016/06/30 13:40:18 CET [2016/06/30 7:40:18 ET]
Table 'California II' 9-max Seat #3 is the button
Seat 1: Rafaello18 ($121.52 in chips) 
Seat 2: er13to ($100 in chips) 
Seat 3: liakos120 ($102.09 in chips) 
Seat 4: mbk88 ($117.64 in chips) 
Seat 5: Rohitbarve ($97.36 in chips) 
Seat 6: matiko09 ($104.50 in chips) 
Seat 7: DomiVY ($87.20 in chips) 
Seat 8: picka4u ($41.50 in chips) 
mbk88: posts small blind $0.50
Rohitbarve: posts big blind $1
*** HOLE CARDS ***
Dealt to matiko09 [Jd Ts]
matiko09: folds 
DomiVY: folds 
picka4u: folds 
Rafaello18: folds 
er13to: folds 
liakos120: folds 
mbk88: calls $0.50
Rohitbarve: checks 
*** FLOP *** [3h 7c 9s]
mbk88: bets $2
Rohitbarve: folds 
Uncalled bet ($2) returned to mbk88
mbk88 collected $1.90 from pot
mbk88: doesn't show hand 
*** SUMMARY ***
Total pot $2 | Rake $0.10 
Board [3h 7c 9s]
Seat 1: Rafaello18 folded before Flop (didn't bet)
Seat 2: er13to folded before Flop (didn't bet)
Seat 3: liakos120 (button) folded before Flop (didn't bet)
Seat 4: mbk88 (small blind) collected ($1.90)
Seat 5: Rohitbarve (big blind) folded on the Flop
Seat 6: matiko09 folded before Flop (didn't bet)
Seat 7: DomiVY folded before Flop (didn't bet)
Seat 8: picka4u folded before Flop (didn't bet)





PokerStars Hand #155379780956:  Hold'em No Limit ($0.50/$1.00 USD) - 2016/06/30 13:40:19 CET [2016/06/30 7:40:19 ET]
Table 'Borrelly II' 9-max Seat #2 is the button
Seat 1: Rafaello18 ($100 in chips) 
Seat 2: tipner ($108.72 in chips) 
Seat 4: DonRon_AT ($35.91 in chips) 
Seat 5: DIMAN_324 ($100 in chips) 
Seat 6: m_michalec ($182.38 in chips) 
Seat 7: matiko09 ($155.85 in chips) 
DonRon_AT: posts small blind $0.50
DIMAN_324: posts big blind $1
alhill86: sits out 
*** HOLE CARDS ***
Dealt to matiko09 [8c Js]
m_michalec: folds 
matiko09: folds 
Rafaello18: folds 
tipner: raises $1.50 to $2.50
DonRon_AT: calls $2
mbk88 leaves the table
DIMAN_324: folds 
*** FLOP *** [7c 2s Jc]
DonRon_AT: checks 
tipner: checks 
*** TURN *** [7c 2s Jc] [7h]
DonRon_AT: checks 
tipner: checks 
*** RIVER *** [7c 2s Jc 7h] [8s]
DonRon_AT: checks 
Arjun A Raju joins the table at seat #8 
tipner: bets $3
DonRon_AT: calls $3
*** SHOW DOWN ***
tipner: shows [6s 4s] (a pair of Sevens)
DonRon_AT: shows [8d Th] (two pair, Eights and Sevens)
DonRon_AT collected $11.40 from pot
*** SUMMARY ***
Total pot $12 | Rake $0.60 
Board [7c 2s Jc 7h 8s]
Seat 1: Rafaello18 folded before Flop (didn't bet)
Seat 2: tipner (button) showed [6s 4s] and lost with a pair of Sevens
Seat 4: DonRon_AT (small blind) showed [8d Th] and won ($11.40) with two pair, Eights and Sevens
Seat 5: DIMAN_324 (big blind) folded before Flop
Seat 6: m_michalec folded before Flop (didn't bet)
Seat 7: matiko09 folded before Flop (didn't bet)





PokerStars Hand #155379782678:  Hold'em No Limit ($0.50/$1.00 USD) - 2016/06/30 13:40:23 CET [2016/06/30 7:40:23 ET]
Table 'Armisticia' 9-max Seat #4 is the button
Seat 2: atlant244 ($78.43 in chips) 
Seat 3: KovIFish89 ($101 in chips) 
Seat 4: ardo888 ($100 in chips) 
Seat 5: SonerWPT ($99.50 in chips) 
Seat 6: matiko09 ($131.62 in chips) 
Seat 8: techahn ($135.75 in chips) 
Seat 9: mbk88 ($106.51 in chips) 
SonerWPT: posts small blind $0.50
matiko09: posts big blind $1
ilaviiitech: sits out 
*** HOLE CARDS ***
Dealt to matiko09 [5c Th]
techahn: folds 
mbk88: folds 
atlant244: folds 
KovIFish89: raises $1.50 to $2.50
ardo888: folds 
SonerWPT: folds 
matiko09: folds 
Uncalled bet ($1.50) returned to KovIFish89
KovIFish89 collected $2.50 from pot
KovIFish89: doesn't show hand 
*** SUMMARY ***
Total pot $2.50 | Rake $0 
Seat 2: atlant244 folded before Flop (didn't bet)
Seat 3: KovIFish89 collected ($2.50)
Seat 4: ardo888 (button) folded before Flop (didn't bet)
Seat 5: SonerWPT (small blind) folded before Flop
Seat 6: matiko09 (big blind) folded before Flop
Seat 8: techahn folded before Flop (didn't bet)
Seat 9: mbk88 folded before Flop (didn't bet)





PokerStars Hand #155379784834:  Hold'em No Limit ($0.50/$1.00 USD) - 2016/06/30 13:40:28 CET [2016/06/30 7:40:28 ET]
Table 'Eucharis' 9-max Seat #6 is the button
Seat 1: er13to ($101.50 in chips) 
Seat 2: sanr23 ($132.78 in chips) 
Seat 3: ramzes160468 ($121.90 in chips) 
Seat 5: Rafaello18 ($101.50 in chips) 
Seat 6: matiko09 ($102.62 in chips) 
Seat 7: DIMAN_324 ($100.50 in chips) 
Seat 8: anfisa.irk ($42.65 in chips) 
DIMAN_324: posts small blind $0.50
anfisa.irk: posts big blind $1
*** HOLE CARDS ***
Dealt to matiko09 [4d 2h]
er13to: folds 
sanr23: raises $2 to $3
ramzes160468: folds 
Rafaello18: folds 
matiko09: folds 
DIMAN_324: calls $2.50
anfisa.irk: folds 
*** FLOP *** [6c 7s 9d]
DIMAN_324: checks 
sanr23: checks 
*** TURN *** [6c 7s 9d] [2s]
DIMAN_324: bets $4.43
mbk88 joins the table at seat #4 
sanr23: folds 
Uncalled bet ($4.43) returned to DIMAN_324
DIMAN_324 collected $6.65 from pot
DIMAN_324: doesn't show hand 
*** SUMMARY ***
Total pot $7 | Rake $0.35 
Board [6c 7s 9d 2s]
Seat 1: er13to folded before Flop (didn't bet)
Seat 2: sanr23 folded on the Turn
Seat 3: ramzes160468 folded before Flop (didn't bet)
Seat 5: Rafaello18 folded before Flop (didn't bet)
Seat 6: matiko09 (button) folded before Flop (didn't bet)
Seat 7: DIMAN_324 (small blind) collected ($6.65)
Seat 8: anfisa.irk (big blind) folded before Flop





PokerStars Hand #155379785960:  Hold'em No Limit ($0.50/$1.00 USD) - 2016/06/30 13:40:31 CET [2016/06/30 7:40:31 ET]
Table 'Prieska' 9-max Seat #4 is the button
Seat 1: KovIFish89 ($120.09 in chips) 
Seat 2: B_style_cuz ($87.28 in chips) 
Seat 3: Rafaello18 ($124 in chips) 
Seat 4: matteo080613 ($50 in chips) 
Seat 5: ramzes160468 ($81.90 in chips) 
Seat 6: DIMAN_324 ($102.50 in chips) 
Seat 7: matiko09 ($112.97 in chips) 
Seat 8: mbk88 ($100 in chips) 
Seat 9: picka4u ($39.83 in chips) 
ramzes160468: posts small blind $0.50
DIMAN_324: posts big blind $1
*** HOLE CARDS ***
Dealt to matiko09 [Qs 5h]
matiko09: folds 
mbk88: folds 
picka4u: folds 
KovIFish89: folds 
B_style_cuz: folds 
Rafaello18: raises $1.50 to $2.50
matteo080613: folds 
ramzes160468: folds 
DIMAN_324: folds 
Uncalled bet ($1.50) returned to Rafaello18
Rafaello18 collected $2.50 from pot
Rafaello18: doesn't show hand 
*** SUMMARY ***
Total pot $2.50 | Rake $0 
Seat 1: KovIFish89 folded before Flop (didn't bet)
Seat 2: B_style_cuz folded before Flop (didn't bet)
Seat 3: Rafaello18 collected ($2.50)
Seat 4: matteo080613 (button) folded before Flop (didn't bet)
Seat 5: ramzes160468 (small blind) folded before Flop
Seat 6: DIMAN_324 (big blind) folded before Flop
Seat 7: matiko09 folded before Flop (didn't bet)
Seat 8: mbk88 folded before Flop (didn't bet)
Seat 9: picka4u folded before Flop (didn't bet)





PokerStars Hand #155379788614:  Hold'em No Limit ($0.50/$1.00 USD) - 2016/06/30 13:40:37 CET [2016/06/30 7:40:37 ET]
Table 'Apisaon II' 9-max Seat #7 is the button
Seat 4: mbk88 ($190.83 in chips) 
Seat 5: riccfch ($99.66 in chips) 
Seat 7: matiko09 ($111.03 in chips) 
Seat 8: ardo888 ($101.13 in chips) 
ardo888: posts small blind $0.50
mbk88: posts big blind $1
mbk88: posts the ante $0.20
riccfch: posts the ante $0.20
matiko09: posts the ante $0.20
ardo888: posts the ante $0.20
*** HOLE CARDS ***
Dealt to matiko09 [2d As]
riccfch: folds 
matiko09: raises $1.27 to $2.27
ardo888: raises $6.73 to $9
mbk88: folds 
matiko09: folds 
Uncalled bet ($6.73) returned to ardo888
ardo888 collected $6.34 from pot
ardo888: doesn't show hand 
*** SUMMARY ***
Total pot $6.34 | Rake $0 
Seat 4: mbk88 (big blind) folded before Flop
Seat 5: riccfch folded before Flop (didn't bet)
Seat 7: matiko09 (button) folded before Flop
Seat 8: ardo888 (small blind) collected ($6.34)





PokerStars Hand #155379793773:  Hold'em No Limit ($0.50/$1.00 USD) - 2016/06/30 13:40:49 CET [2016/06/30 7:40:49 ET]
Table 'Armisticia' 9-max Seat #5 is the button
Seat 2: atlant244 ($78.43 in chips) 
Seat 3: KovIFish89 ($102.50 in chips) 
Seat 4: ardo888 ($100 in chips) 
Seat 5: SonerWPT ($99 in chips) 
Seat 6: matiko09 ($130.62 in chips) 
Seat 7: ilaviiitech ($100 in chips) 
Seat 8: techahn ($135.75 in chips) 
Seat 9: mbk88 ($106.51 in chips) 
matiko09: posts small blind $0.50
ilaviiitech: posts big blind $1
*** HOLE CARDS ***
Dealt to matiko09 [4c 3d]
techahn: folds 
mbk88: folds 
atlant244: raises $1 to $2
KovIFish89: folds 
ardo888: folds 
SonerWPT: folds 
matiko09: folds 
ilaviiitech: folds 
Uncalled bet ($1) returned to atlant244
atlant244 collected $2.50 from pot
atlant244: doesn't show hand 
*** SUMMARY ***
Total pot $2.50 | Rake $0 
Seat 2: atlant244 collected ($2.50)
Seat 3: KovIFish89 folded before Flop (didn't bet)
Seat 4: ardo888 folded before Flop (didn't bet)
Seat 5: SonerWPT (button) folded before Flop (didn't bet)
Seat 6: matiko09 (small blind) folded before Flop
Seat 7: ilaviiitech (big blind) folded before Flop
Seat 8: techahn folded before Flop (didn't bet)
Seat 9: mbk88 folded before Flop (didn't bet)





PokerStars Hand #155379795132:  Hold'em No Limit ($0.50/$1.00 USD) - 2016/06/30 13:40:52 CET [2016/06/30 7:40:52 ET]
Table 'California II' 9-max Seat #4 is the button
Seat 1: Rafaello18 ($121.52 in chips) 
Seat 2: er13to ($100 in chips) 
Seat 3: liakos120 ($102.09 in chips) 
Seat 4: mbk88 ($118.54 in chips) 
Seat 5: Rohitbarve ($96.36 in chips) 
Seat 6: matiko09 ($104.50 in chips) 
Seat 7: DomiVY ($87.20 in chips) 
Seat 8: picka4u ($41.50 in chips) 
Rohitbarve: posts small blind $0.50
matiko09: posts big blind $1
*** HOLE CARDS ***
Dealt to matiko09 [Jh Jc]
DomiVY: folds 
picka4u: folds 
Rafaello18: raises $1.50 to $2.50
er13to: folds 
liakos120: calls $2.50
mbk88: folds 
Rohitbarve: folds 
matiko09: calls $1.50
*** FLOP *** [4d Jd 2d]
matiko09: bets $5
Rafaello18: calls $5
liakos120: raises $10 to $15
matiko09: calls $10
Rafaello18: folds 
*** TURN *** [4d Jd 2d] [6d]
matiko09: checks 
liakos120: checks 
*** RIVER *** [4d Jd 2d 6d] [8s]
matiko09: checks 
liakos120: checks 
*** SHOW DOWN ***
matiko09: shows [Jh Jc] (three of a kind, Jacks)
liakos120: mucks hand 
matiko09 collected $40.85 from pot
*** SUMMARY ***
Total pot $43 | Rake $2.15 
Board [4d Jd 2d 6d 8s]
Seat 1: Rafaello18 folded on the Flop
Seat 2: er13to folded before Flop (didn't bet)
Seat 3: liakos120 mucked [4s 4h]
Seat 4: mbk88 (button) folded before Flop (didn't bet)
Seat 5: Rohitbarve (small blind) folded before Flop
Seat 6: matiko09 (big blind) showed [Jh Jc] and won ($40.85) with three of a kind, Jacks
Seat 7: DomiVY folded before Flop (didn't bet)
Seat 8: picka4u folded before Flop (didn't bet)





PokerStars Hand #155379797446:  Hold'em No Limit ($0.25/$0.50 USD) - 2016/06/30 13:40:58 CET [2016/06/30 7:40:58 ET]
Table 'Dorothea II' 9-max Seat #5 is the button
Seat 2: er13to ($50 in chips) 
Seat 4: matiko09 ($78.36 in chips) 
Seat 5: Bailey Dew ($84.04 in chips) 
Seat 6: ivan100886 ($28.61 in chips) 
Seat 8: TheMinion ($50 in chips) 
Seat 9: ardo888 ($75.62 in chips) 
ivan100886: posts small blind $0.25
TheMinion: posts big blind $0.50
er13to: posts the ante $0.10
matiko09: posts the ante $0.10
Bailey Dew: posts the ante $0.10
ivan100886: posts the ante $0.10
TheMinion: posts the ante $0.10
ardo888: posts the ante $0.10
*** HOLE CARDS ***
Dealt to matiko09 [4c 8d]
ardo888: folds 
er13to: folds 
ardo888 leaves the table
matiko09: folds 
Bailey Dew: folds 
ivan100886: folds 
Uncalled bet ($0.25) returned to TheMinion
TheMinion collected $1.10 from pot
TheMinion: doesn't show hand 
*** SUMMARY ***
Total pot $1.10 | Rake $0 
Seat 2: er13to folded before Flop (didn't bet)
Seat 4: matiko09 folded before Flop (didn't bet)
Seat 5: Bailey Dew (button) folded before Flop (didn't bet)
Seat 6: ivan100886 (small blind) folded before Flop
Seat 8: TheMinion (big blind) collected ($1.10)
Seat 9: ardo888 folded before Flop (didn't bet)





PokerStars Hand #155379798683:  Hold'em No Limit ($0.50/$1.00 USD) - 2016/06/30 13:41:01 CET [2016/06/30 7:41:01 ET]
Table 'Prieska' 9-max Seat #5 is the button
Seat 1: KovIFish89 ($120.09 in chips) 
Seat 2: B_style_cuz ($87.28 in chips) 
Seat 3: Rafaello18 ($125.50 in chips) 
Seat 4: matteo080613 ($50 in chips) 
Seat 5: ramzes160468 ($81.40 in chips) 
Seat 6: DIMAN_324 ($101.50 in chips) 
Seat 7: matiko09 ($112.97 in chips) 
Seat 8: mbk88 ($100 in chips) 
Seat 9: picka4u ($39.83 in chips) 
DIMAN_324: posts small blind $0.50
matiko09: posts big blind $1
*** HOLE CARDS ***
Dealt to matiko09 [7c Js]
mbk88: raises $2 to $3
picka4u: folds 
KovIFish89: folds 
B_style_cuz: folds 
Rafaello18: folds 
matteo080613: folds 
ramzes160468: calls $3
DIMAN_324: folds 
matiko09: folds 
*** FLOP *** [Jd Ad 9h]
mbk88: checks 
ramzes160468: checks 
*** TURN *** [Jd Ad 9h] [Kd]
mbk88: checks 
ramzes160468: checks 
*** RIVER *** [Jd Ad 9h Kd] [2h]
mbk88: checks 
ramzes160468: checks 
*** SHOW DOWN ***
mbk88: shows [Td Tc] (a pair of Tens)
ramzes160468: shows [Jh 8h] (a pair of Jacks)
ramzes160468 collected $7.12 from pot
*** SUMMARY ***
Total pot $7.50 | Rake $0.38 
Board [Jd Ad 9h Kd 2h]
Seat 1: KovIFish89 folded before Flop (didn't bet)
Seat 2: B_style_cuz folded before Flop (didn't bet)
Seat 3: Rafaello18 folded before Flop (didn't bet)
Seat 4: matteo080613 folded before Flop (didn't bet)
Seat 5: ramzes160468 (button) showed [Jh 8h] and won ($7.12) with a pair of Jacks
Seat 6: DIMAN_324 (small blind) folded before Flop
Seat 7: matiko09 (big blind) folded before Flop
Seat 8: mbk88 showed [Td Tc] and lost with a pair of Tens
Seat 9: picka4u folded before Flop (didn't bet)





PokerStars Hand #155379801160:  Hold'em No Limit ($0.25/$0.50 USD) - 2016/06/30 13:41:06 CET [2016/06/30 7:41:06 ET]
Table 'Elektra II' 9-max Seat #8 is the button
Seat 1: drlee77 ($51.28 in chips) 
Seat 2: TheMinion ($64.07 in chips) 
Seat 3: mojtabagol ($65.46 in chips) 
Seat 4: matiko09 ($60.53 in chips) 
Seat 5: Rafaello18 ($59.99 in chips) 
Seat 6: pfunkolstar ($50 in chips) 
Seat 7: MuddyDance ($49.25 in chips) 
Seat 8: sanr23 ($50.89 in chips) 
Seat 9: Dantistcopra ($50 in chips) 
Dantistcopra: posts small blind $0.25
drlee77: posts big blind $0.50
*** HOLE CARDS ***
Dealt to matiko09 [8h 3s]
TheMinion: folds 
mojtabagol: folds 
matiko09: folds 
Rafaello18: folds 
pfunkolstar: folds 
MuddyDance: folds 
sanr23: folds 
Dantistcopra: raises $0.52 to $1.02
drlee77: folds 
Uncalled bet ($0.52) returned to Dantistcopra
Dantistcopra collected $1 from pot
*** SUMMARY ***
Total pot $1 | Rake $0 
Seat 1: drlee77 (big blind) folded before Flop
Seat 2: TheMinion folded before Flop (didn't bet)
Seat 3: mojtabagol folded before Flop (didn't bet)
Seat 4: matiko09 folded before Flop (didn't bet)
Seat 5: Rafaello18 folded before Flop (didn't bet)
Seat 6: pfunkolstar folded before Flop (didn't bet)
Seat 7: MuddyDance folded before Flop (didn't bet)
Seat 8: sanr23 (button) folded before Flop (didn't bet)
Seat 9: Dantistcopra (small blind) collected ($1)





PokerStars Hand #155379803031:  Hold'em No Limit ($0.50/$1.00 USD) - 2016/06/30 13:41:11 CET [2016/06/30 7:41:11 ET]
Table 'Apisaon II' 9-max Seat #8 is the button
Seat 4: mbk88 ($189.63 in chips) 
Seat 5: riccfch ($99.46 in chips) 
Seat 7: matiko09 ($108.56 in chips) 
Seat 8: ardo888 ($105 in chips) 
mbk88: posts small blind $0.50
riccfch: posts big blind $1
mbk88: posts the ante $0.20
riccfch: posts the ante $0.20
matiko09: posts the ante $0.20
ardo888: posts the ante $0.20
*** HOLE CARDS ***
Dealt to matiko09 [Td 3d]
matiko09: folds 
ardo888: folds 
mbk88: folds 
Uncalled bet ($0.50) returned to riccfch
riccfch collected $1.80 from pot
riccfch: doesn't show hand 
*** SUMMARY ***
Total pot $1.80 | Rake $0 
Seat 4: mbk88 (small blind) folded before Flop
Seat 5: riccfch (big blind) collected ($1.80)
Seat 7: matiko09 folded before Flop (didn't bet)
Seat 8: ardo888 (button) folded before Flop (didn't bet)





PokerStars Hand #155379803099:  Hold'em No Limit ($0.50/$1.00 USD) - 2016/06/30 13:41:11 CET [2016/06/30 7:41:11 ET]
Table 'Altarf II' 9-max Seat #1 is the button
Seat 1: thecurv ($107.97 in chips) 
Seat 2: KovIFish89 ($100.50 in chips) 
Seat 3: sanr23 ($100 in chips) 
Seat 4: Greha999 ($83.66 in chips) 
Seat 6: mbk88 ($130.50 in chips) 
Seat 7: matiko09 ($107.72 in chips) 
Seat 8: Kertesh ($36.50 in chips) 
Seat 9: omanibemihum ($93 in chips) 
KovIFish89: posts small blind $0.50
sanr23: posts big blind $1
DIMAN_324: sits out 
*** HOLE CARDS ***
Dealt to matiko09 [9d Kh]
Greha999: folds 
mbk88: folds 
matiko09: folds 
Kertesh: folds 
omanibemihum: raises $2 to $3
thecurv: folds 
KovIFish89: folds 
sanr23: raises $7 to $10
omanibemihum: calls $7
*** FLOP *** [8s 8c 3d]
Kertesh leaves the table
sanr23: bets $11.29
omanibemihum: folds 
Uncalled bet ($11.29) returned to sanr23
sanr23 collected $19.48 from pot
sanr23: doesn't show hand 
*** SUMMARY ***
Total pot $20.50 | Rake $1.02 
Board [8s 8c 3d]
Seat 1: thecurv (button) folded before Flop (didn't bet)
Seat 2: KovIFish89 (small blind) folded before Flop
Seat 3: sanr23 (big blind) collected ($19.48)
Seat 4: Greha999 folded before Flop (didn't bet)
Seat 6: mbk88 folded before Flop (didn't bet)
Seat 7: matiko09 folded before Flop (didn't bet)
Seat 8: Kertesh folded before Flop (didn't bet)
Seat 9: omanibemihum folded on the Flop





PokerStars Hand #155379803927:  Hold'em No Limit ($0.25/$0.50 USD) - 2016/06/30 13:41:13 CET [2016/06/30 7:41:13 ET]
Table 'Dorothea II' 9-max Seat #6 is the button
Seat 2: er13to ($50 in chips) 
Seat 4: matiko09 ($78.26 in chips) 
Seat 5: Bailey Dew ($83.94 in chips) 
Seat 6: ivan100886 ($28.26 in chips) 
Seat 8: TheMinion ($50.75 in chips) 
TheMinion: posts small blind $0.25
er13to: posts big blind $0.50
er13to: posts the ante $0.10
matiko09: posts the ante $0.10
Bailey Dew: posts the ante $0.10
ivan100886: posts the ante $0.10
TheMinion: posts the ante $0.10
*** HOLE CARDS ***
Dealt to matiko09 [9d 8d]
matiko09: raises $1 to $1.50
Bailey Dew: raises $3.75 to $5.25
ivan100886: folds 
TheMinion: folds 
er13to: folds 
matiko09: folds 
Uncalled bet ($3.75) returned to Bailey Dew
Bailey Dew collected $4.25 from pot
Bailey Dew: doesn't show hand 
*** SUMMARY ***
Total pot $4.25 | Rake $0 
Seat 2: er13to (big blind) folded before Flop
Seat 4: matiko09 folded before Flop
Seat 5: Bailey Dew collected ($4.25)
Seat 6: ivan100886 (button) folded before Flop (didn't bet)
Seat 8: TheMinion (small blind) folded before Flop





PokerStars Hand #155379805007:  Hold'em No Limit ($0.50/$1.00 USD) - 2016/06/30 13:41:15 CET [2016/06/30 7:41:15 ET]
Table 'Tatjana' 9-max Seat #3 is the button
Seat 1: ardo888 ($124.96 in chips) 
Seat 2: DIMAN_324 ($100 in chips) 
Seat 3: Rafaello18 ($104.63 in chips) 
Seat 5: matiko09 ($104.54 in chips) 
Seat 6: mbk88 ($108.10 in chips) 
Seat 7: DomiVY ($40 in chips) 
Seat 9: POTAPENKO700 ($142.71 in chips) 
matiko09: posts small blind $0.50
mbk88: posts big blind $1
alhill86: sits out 
*** HOLE CARDS ***
Dealt to matiko09 [6h Ac]
DomiVY: folds 
DomiVY leaves the table
POTAPENKO700: folds 
ardo888: folds 
DIMAN_324: raises $1.40 to $2.40
Rafaello18: folds 
matiko09: folds 
mbk88: folds 
Uncalled bet ($1.40) returned to DIMAN_324
DIMAN_324 collected $2.50 from pot
DIMAN_324: doesn't show hand 
*** SUMMARY ***
Total pot $2.50 | Rake $0 
Seat 1: ardo888 folded before Flop (didn't bet)
Seat 2: DIMAN_324 collected ($2.50)
Seat 3: Rafaello18 (button) folded before Flop (didn't bet)
Seat 5: matiko09 (small blind) folded before Flop
Seat 6: mbk88 (big blind) folded before Flop
Seat 7: DomiVY folded before Flop (didn't bet)
Seat 9: POTAPENKO700 folded before Flop (didn't bet)





PokerStars Hand #155379806395:  Hold'em No Limit ($0.50/$1.00 USD) - 2016/06/30 13:41:19 CET [2016/06/30 7:41:19 ET]
Table 'Borrelly II' 9-max Seat #4 is the button
Seat 1: Rafaello18 ($100 in chips) 
Seat 2: tipner ($103.22 in chips) 
Seat 4: DonRon_AT ($41.81 in chips) 
Seat 5: DIMAN_324 ($100 in chips) 
Seat 6: m_michalec ($182.38 in chips) 
Seat 7: matiko09 ($155.85 in chips) 
DIMAN_324: posts small blind $0.50
m_michalec: posts big blind $1
Arjun A Raju: sits out 
alhill86: sits out 
*** HOLE CARDS ***
Dealt to matiko09 [Qc 7d]
matiko09: folds 
Rafaello18: raises $1.50 to $2.50
tipner: folds 
DonRon_AT: folds 
DIMAN_324: folds 
m_michalec: calls $1.50
*** FLOP *** [7s 8d Ks]
m_michalec: checks 
Rafaello18: checks 
*** TURN *** [7s 8d Ks] [9c]
m_michalec: checks 
Rafaello18: bets $3
m_michalec: calls $3
*** RIVER *** [7s 8d Ks 9c] [3s]
m_michalec: checks 
Rafaello18: bets $6
m_michalec: calls $6
*** SHOW DOWN ***
Rafaello18: shows [Jc Jh] (a pair of Jacks)
m_michalec: mucks hand 
Rafaello18 collected $22.32 from pot
*** SUMMARY ***
Total pot $23.50 | Rake $1.18 
Board [7s 8d Ks 9c 3s]
Seat 1: Rafaello18 showed [Jc Jh] and won ($22.32) with a pair of Jacks
Seat 2: tipner folded before Flop (didn't bet)
Seat 4: DonRon_AT (button) folded before Flop (didn't bet)
Seat 5: DIMAN_324 (small blind) folded before Flop
Seat 6: m_michalec (big blind) mucked [8c 6c]
Seat 7: matiko09 folded before Flop (didn't bet)





PokerStars Hand #155379807104:  Hold'em No Limit ($0.50/$1.00 USD) - 2016/06/30 13:41:20 CET [2016/06/30 7:41:20 ET]
Table 'Armisticia' 9-max Seat #6 is the button
Seat 2: atlant244 ($79.93 in chips) 
Seat 3: KovIFish89 ($102.50 in chips) 
Seat 4: ardo888 ($100 in chips) 
Seat 5: SonerWPT ($99 in chips) 
Seat 6: matiko09 ($130.12 in chips) 
Seat 7: ilaviiitech ($100 in chips) 
Seat 8: techahn ($135.75 in chips) 
Seat 9: mbk88 ($106.51 in chips) 
ilaviiitech: posts small blind $0.50
techahn: posts big blind $1
*** HOLE CARDS ***
Dealt to matiko09 [5h 2c]
mbk88: folds 
atlant244: folds 
KovIFish89: folds 
ardo888: folds 
SonerWPT: folds 
matiko09: folds 
ilaviiitech: folds 
Uncalled bet ($0.50) returned to techahn
techahn collected $1 from pot
techahn: doesn't show hand 
*** SUMMARY ***
Total pot $1 | Rake $0 
Seat 2: atlant244 folded before Flop (didn't bet)
Seat 3: KovIFish89 folded before Flop (didn't bet)
Seat 4: ardo888 folded before Flop (didn't bet)
Seat 5: SonerWPT folded before Flop (didn't bet)
Seat 6: matiko09 (button) folded before Flop (didn't bet)
Seat 7: ilaviiitech (small blind) folded before Flop
Seat 8: techahn (big blind) collected ($1)
Seat 9: mbk88 folded before Flop (didn't bet)





PokerStars Hand #155379809980:  Hold'em No Limit ($0.50/$1.00 USD) - 2016/06/30 13:41:27 CET [2016/06/30 7:41:27 ET]
Table 'Apisaon II' 9-max Seat #4 is the button
Seat 4: mbk88 ($188.93 in chips) 
Seat 5: riccfch ($100.56 in chips) 
Seat 7: matiko09 ($108.36 in chips) 
Seat 8: ardo888 ($104.80 in chips) 
riccfch: posts small blind $0.50
matiko09: posts big blind $1
mbk88: posts the ante $0.20
riccfch: posts the ante $0.20
matiko09: posts the ante $0.20
ardo888: posts the ante $0.20
*** HOLE CARDS ***
Dealt to matiko09 [5d Jc]
ardo888: folds 
mbk88: raises $1.02 to $2.02
riccfch: folds 
matiko09: folds 
Uncalled bet ($1.02) returned to mbk88
mbk88 collected $3.30 from pot
mbk88: doesn't show hand 
*** SUMMARY ***
Total pot $3.30 | Rake $0 
Seat 4: mbk88 (button) collected ($3.30)
Seat 5: riccfch (small blind) folded before Flop
Seat 7: matiko09 (big blind) folded before Flop
Seat 8: ardo888 folded before Flop (didn't bet)





PokerStars Hand #155379812066:  Hold'em No Limit ($0.50/$1.00 USD) - 2016/06/30 13:41:32 CET [2016/06/30 7:41:32 ET]
Table 'Eucharis' 9-max Seat #7 is the button
Seat 2: sanr23 ($129.78 in chips) 
Seat 3: ramzes160468 ($121.90 in chips) 
Seat 5: Rafaello18 ($101.50 in chips) 
Seat 6: matiko09 ($102.62 in chips) 
Seat 7: DIMAN_324 ($104.15 in chips) 
Seat 8: anfisa.irk ($41.65 in chips) 
anfisa.irk: posts small blind $0.50
er13to: is sitting out 
sanr23: posts big blind $1
er13to leaves the table
mbk88: sits out 
*** HOLE CARDS ***
Dealt to matiko09 [Jh 6d]
ramzes160468: raises $2 to $3
picka4u joins the table at seat #1 
Rafaello18: folds 
matiko09: folds 
DIMAN_324: calls $3
anfisa.irk: folds 
sanr23: folds 
*** FLOP *** [Jd 4s 6c]
ramzes160468: bets $5
DIMAN_324: folds 
Uncalled bet ($5) returned to ramzes160468
ramzes160468 collected $7.12 from pot
*** SUMMARY ***
Total pot $7.50 | Rake $0.38 
Board [Jd 4s 6c]
Seat 2: sanr23 (big blind) folded before Flop
Seat 3: ramzes160468 collected ($7.12)
Seat 5: Rafaello18 folded before Flop (didn't bet)
Seat 6: matiko09 folded before Flop (didn't bet)
Seat 7: DIMAN_324 (button) folded on the Flop
Seat 8: anfisa.irk (small blind) folded before Flop





PokerStars Hand #155379813519:  Hold'em No Limit ($0.25/$0.50 USD) - 2016/06/30 13:41:35 CET [2016/06/30 7:41:35 ET]
Table 'Elektra II' 9-max Seat #9 is the button
Seat 1: drlee77 ($50.78 in chips) 
Seat 2: TheMinion ($64.07 in chips) 
Seat 3: mojtabagol ($65.46 in chips) 
Seat 4: matiko09 ($60.53 in chips) 
Seat 5: Rafaello18 ($59.99 in chips) 
Seat 6: pfunkolstar ($50 in chips) 
Seat 7: MuddyDance ($49.25 in chips) 
Seat 8: sanr23 ($50.89 in chips) 
Seat 9: Dantistcopra ($50.50 in chips) 
drlee77: posts small blind $0.25
TheMinion: posts big blind $0.50
*** HOLE CARDS ***
Dealt to matiko09 [2h 9h]
mojtabagol: folds 
matiko09: folds 
Rafaello18: folds 
pfunkolstar: folds 
MuddyDance: folds 
sanr23: folds 
Dantistcopra: raises $0.75 to $1.25
drlee77: calls $1
TheMinion: folds 
*** FLOP *** [Qh Qs 3d]
drlee77: checks 
Dantistcopra: bets $2
drlee77: folds 
Uncalled bet ($2) returned to Dantistcopra
Dantistcopra collected $2.85 from pot
*** SUMMARY ***
Total pot $3 | Rake $0.15 
Board [Qh Qs 3d]
Seat 1: drlee77 (small blind) folded on the Flop
Seat 2: TheMinion (big blind) folded before Flop
Seat 3: mojtabagol folded before Flop (didn't bet)
Seat 4: matiko09 folded before Flop (didn't bet)
Seat 5: Rafaello18 folded before Flop (didn't bet)
Seat 6: pfunkolstar folded before Flop (didn't bet)
Seat 7: MuddyDance folded before Flop (didn't bet)
Seat 8: sanr23 folded before Flop (didn't bet)
Seat 9: Dantistcopra (button) collected ($2.85)





PokerStars Hand #155379813254:  Hold'em No Limit ($0.50/$1.00 USD) - 2016/06/30 13:41:35 CET [2016/06/30 7:41:35 ET]
Table 'Armisticia' 9-max Seat #7 is the button
Seat 2: atlant244 ($79.93 in chips) 
Seat 3: KovIFish89 ($102.50 in chips) 
Seat 4: ardo888 ($100 in chips) 
Seat 5: SonerWPT ($99 in chips) 
Seat 6: matiko09 ($130.12 in chips) 
Seat 7: ilaviiitech ($100 in chips) 
Seat 8: techahn ($136.25 in chips) 
Seat 9: mbk88 ($106.51 in chips) 
techahn: posts small blind $0.50
mbk88: posts big blind $1
*** HOLE CARDS ***
Dealt to matiko09 [Kc 6s]
atlant244: raises $1.50 to $2.50
KovIFish89: folds 
ardo888: folds 
SonerWPT: folds 
matiko09: folds 
ilaviiitech: folds 
techahn: folds 
mbk88: calls $1.50
*** FLOP *** [Ah 6h 7d]
mbk88: checks 
atlant244: bets $2.61
mbk88: raises $6.39 to $9
atlant244: calls $6.39
*** TURN *** [Ah 6h 7d] [3h]
mbk88: bets $14
atlant244: folds 
Uncalled bet ($14) returned to mbk88
mbk88 collected $22.32 from pot
mbk88: doesn't show hand 
*** SUMMARY ***
Total pot $23.50 | Rake $1.18 
Board [Ah 6h 7d 3h]
Seat 2: atlant244 folded on the Turn
Seat 3: KovIFish89 folded before Flop (didn't bet)
Seat 4: ardo888 folded before Flop (didn't bet)
Seat 5: SonerWPT folded before Flop (didn't bet)
Seat 6: matiko09 folded before Flop (didn't bet)
Seat 7: ilaviiitech (button) folded before Flop (didn't bet)
Seat 8: techahn (small blind) folded before Flop
Seat 9: mbk88 (big blind) collected ($22.32)





PokerStars Hand #155379819003:  Hold'em No Limit ($0.25/$0.50 USD) - 2016/06/30 13:41:48 CET [2016/06/30 7:41:48 ET]
Table 'Dorothea II' 9-max Seat #8 is the button
Seat 2: er13to ($50 in chips) 
Seat 4: matiko09 ($76.66 in chips) 
Seat 5: Bailey Dew ($86.59 in chips) 
Seat 6: ivan100886 ($28.16 in chips) 
Seat 8: TheMinion ($50.40 in chips) 
er13to: posts small blind $0.25
matiko09: posts big blind $0.50
er13to: posts the ante $0.10
matiko09: posts the ante $0.10
Bailey Dew: posts the ante $0.10
ivan100886: posts the ante $0.10
TheMinion: posts the ante $0.10
*** HOLE CARDS ***
Dealt to matiko09 [2s Qc]
Bailey Dew: raises $0.75 to $1.25
ivan100886: folds 
TheMinion: folds 
er13to: folds 
matiko09: folds 
Uncalled bet ($0.75) returned to Bailey Dew
Bailey Dew collected $1.75 from pot
Bailey Dew: doesn't show hand 
*** SUMMARY ***
Total pot $1.75 | Rake $0 
Seat 2: er13to (small blind) folded before Flop
Seat 4: matiko09 (big blind) folded before Flop
Seat 5: Bailey Dew collected ($1.75)
Seat 6: ivan100886 folded before Flop (didn't bet)
Seat 8: TheMinion (button) folded before Flop (didn't bet)





PokerStars Hand #155379820258:  Hold'em No Limit ($0.50/$1.00 USD) - 2016/06/30 13:41:51 CET [2016/06/30 7:41:51 ET]
Table 'Tatjana' 9-max Seat #5 is the button
Seat 1: ardo888 ($124.96 in chips) 
Seat 2: DIMAN_324 ($101.50 in chips) 
Seat 3: Rafaello18 ($104.63 in chips) 
Seat 5: matiko09 ($104.04 in chips) 
Seat 6: mbk88 ($107.10 in chips) 
Seat 8: alhill86 ($106.15 in chips) 
Seat 9: POTAPENKO700 ($142.71 in chips) 
mbk88: posts small blind $0.50
alhill86: posts big blind $1
*** HOLE CARDS ***
Dealt to matiko09 [Kc 6d]
daigodisco joins the table at seat #7 
POTAPENKO700: folds 
ardo888: folds 
DIMAN_324: folds 
Rafaello18: raises $1.50 to $2.50
matiko09: folds 
mbk88: folds 
alhill86: raises $5.50 to $8
Rafaello18: calls $5.50
*** FLOP *** [Kd 2d Qh]
alhill86: bets $10
Rafaello18: folds 
Uncalled bet ($10) returned to alhill86
alhill86 collected $15.68 from pot
alhill86: doesn't show hand 
*** SUMMARY ***
Total pot $16.50 | Rake $0.82 
Board [Kd 2d Qh]
Seat 1: ardo888 folded before Flop (didn't bet)
Seat 2: DIMAN_324 folded before Flop (didn't bet)
Seat 3: Rafaello18 folded on the Flop
Seat 5: matiko09 (button) folded before Flop (didn't bet)
Seat 6: mbk88 (small blind) folded before Flop
Seat 8: alhill86 (big blind) collected ($15.68)
Seat 9: POTAPENKO700 folded before Flop (didn't bet)





PokerStars Hand #155379820928:  Hold'em No Limit ($0.50/$1.00 USD) - 2016/06/30 13:41:53 CET [2016/06/30 7:41:53 ET]
Table 'Asmodeus' 9-max Seat #5 is the button
Seat 1: scollop ($108.50 in chips) 
Seat 2: picka4u ($38.02 in chips) 
Seat 3: matiko09 ($100 in chips) 
Seat 4: ardo888 ($135.28 in chips) 
Seat 5: sanr23 ($100 in chips) 
Seat 6: koutani7 ($93 in chips) 
Seat 7: aaronzzr ($156.29 in chips) 
Seat 8: Rafaello18 ($152.95 in chips) 
Seat 9: mbk88 ($157.68 in chips) 
koutani7: posts small blind $0.50
aaronzzr: posts big blind $1
*** HOLE CARDS ***
Dealt to matiko09 [As Qh]
Rafaello18: folds 
mbk88: folds 
scollop: folds 
picka4u: raises $1.25 to $2.25
matiko09: raises $5.75 to $8
ardo888: folds 
sanr23: folds 
koutani7: folds 
aaronzzr: folds 
picka4u: folds 
Uncalled bet ($5.75) returned to matiko09
matiko09 collected $6 from pot
matiko09: doesn't show hand 
*** SUMMARY ***
Total pot $6 | Rake $0 
Seat 1: scollop folded before Flop (didn't bet)
Seat 2: picka4u folded before Flop
Seat 3: matiko09 collected ($6)
Seat 4: ardo888 folded before Flop (didn't bet)
Seat 5: sanr23 (button) folded before Flop (didn't bet)
Seat 6: koutani7 (small blind) folded before Flop
Seat 7: aaronzzr (big blind) folded before Flop
Seat 8: Rafaello18 folded before Flop (didn't bet)
Seat 9: mbk88 folded before Flop (didn't bet)





PokerStars Hand #155379823018:  Hold'em No Limit ($0.50/$1.00 USD) - 2016/06/30 13:41:57 CET [2016/06/30 7:41:57 ET]
Table 'Prieska' 9-max Seat #6 is the button
Seat 1: KovIFish89 ($120.09 in chips) 
Seat 2: B_style_cuz ($87.28 in chips) 
Seat 3: Rafaello18 ($125.50 in chips) 
Seat 4: matteo080613 ($50 in chips) 
Seat 5: ramzes160468 ($85.52 in chips) 
Seat 6: DIMAN_324 ($101 in chips) 
Seat 7: matiko09 ($111.97 in chips) 
Seat 8: mbk88 ($100 in chips) 
Seat 9: picka4u ($39.83 in chips) 
matiko09: posts small blind $0.50
mbk88: posts big blind $1
*** HOLE CARDS ***
Dealt to matiko09 [6s 9s]
picka4u: folds 
KovIFish89: folds 
B_style_cuz: folds 
Rafaello18: folds 
matteo080613: folds 
ramzes160468: folds 
DIMAN_324: raises $1.10 to $2.10
matiko09: folds 
mbk88: folds 
Uncalled bet ($1.10) returned to DIMAN_324
DIMAN_324 collected $2.50 from pot
DIMAN_324: doesn't show hand 
*** SUMMARY ***
Total pot $2.50 | Rake $0 
Seat 1: KovIFish89 folded before Flop (didn't bet)
Seat 2: B_style_cuz folded before Flop (didn't bet)
Seat 3: Rafaello18 folded before Flop (didn't bet)
Seat 4: matteo080613 folded before Flop (didn't bet)
Seat 5: ramzes160468 folded before Flop (didn't bet)
Seat 6: DIMAN_324 (button) collected ($2.50)
Seat 7: matiko09 (small blind) folded before Flop
Seat 8: mbk88 (big blind) folded before Flop
Seat 9: picka4u folded before Flop (didn't bet)





PokerStars Hand #155379827937:  Hold'em No Limit ($0.50/$1.00 USD) - 2016/06/30 13:42:09 CET [2016/06/30 7:42:09 ET]
Table 'Apisaon II' 9-max Seat #5 is the button
Seat 4: mbk88 ($191.03 in chips) 
Seat 5: riccfch ($99.86 in chips) 
Seat 7: matiko09 ($107.16 in chips) 
Seat 8: ardo888 ($104.60 in chips) 
matiko09: posts small blind $0.50
ardo888: posts big blind $1
mbk88: posts the ante $0.20
riccfch: posts the ante $0.20
matiko09: posts the ante $0.20
ardo888: posts the ante $0.20
*** HOLE CARDS ***
Dealt to matiko09 [Jc 2s]
mbk88: folds 
riccfch: raises $2 to $3
matiko09: folds 
ardo888: calls $2
*** FLOP *** [Kc 7d Kh]
ardo888: checks 
riccfch: bets $4
ardo888: calls $4
*** TURN *** [Kc 7d Kh] [4c]
ardo888: checks 
riccfch: bets $9.50
ardo888: folds 
Uncalled bet ($9.50) returned to riccfch
riccfch collected $14.54 from pot
riccfch: doesn't show hand 
*** SUMMARY ***
Total pot $15.30 | Rake $0.76 
Board [Kc 7d Kh 4c]
Seat 4: mbk88 folded before Flop (didn't bet)
Seat 5: riccfch (button) collected ($14.54)
Seat 7: matiko09 (small blind) folded before Flop
Seat 8: ardo888 (big blind) folded on the Turn





PokerStars Hand #155379829567:  Hold'em No Limit ($0.25/$0.50 USD) - 2016/06/30 13:42:13 CET [2016/06/30 7:42:13 ET]
Table 'Dorothea II' 9-max Seat #2 is the button
Seat 2: er13to ($50 in chips) 
Seat 4: matiko09 ($76.06 in chips) 
Seat 5: Bailey Dew ($87.74 in chips) 
Seat 6: ivan100886 ($28.06 in chips) 
Seat 8: TheMinion ($50.30 in chips) 
matiko09: posts small blind $0.25
Bailey Dew: posts big blind $0.50
er13to: posts the ante $0.10
matiko09: posts the ante $0.10
Bailey Dew: posts the ante $0.10
ivan100886: posts the ante $0.10
TheMinion: posts the ante $0.10
*** HOLE CARDS ***
Dealt to matiko09 [7d Th]
ivan100886: folds 
TheMinion: folds 
er13to: raises $0.67 to $1.17
matiko09: folds 
Bailey Dew: folds 
Uncalled bet ($0.67) returned to er13to
er13to collected $1.75 from pot
*** SUMMARY ***
Total pot $1.75 | Rake $0 
Seat 2: er13to (button) collected ($1.75)
Seat 4: matiko09 (small blind) folded before Flop
Seat 5: Bailey Dew (big blind) folded before Flop
Seat 6: ivan100886 folded before Flop (didn't bet)
Seat 8: TheMinion folded before Flop (didn't bet)





PokerStars Hand #155379833679:  Hold'em No Limit ($0.50/$1.00 USD) - 2016/06/30 13:42:22 CET [2016/06/30 7:42:22 ET]
Table 'California II' 9-max Seat #5 is the button
Seat 1: Rafaello18 ($114.02 in chips) 
Seat 2: er13to ($100 in chips) 
Seat 3: liakos120 ($84.59 in chips) 
Seat 4: mbk88 ($118.54 in chips) 
Seat 5: Rohitbarve ($95.86 in chips) 
Seat 6: matiko09 ($127.85 in chips) 
Seat 7: DomiVY ($87.20 in chips) 
Seat 8: picka4u ($41.50 in chips) 
matiko09: posts small blind $0.50
DomiVY: posts big blind $1
*** HOLE CARDS ***
Dealt to matiko09 [Ks 2c]
picka4u: folds 
Rafaello18: folds 
er13to: folds 
liakos120: folds 
mbk88: folds 
Rohitbarve: raises $2 to $3
matiko09: folds 
DomiVY: folds 
Uncalled bet ($2) returned to Rohitbarve
Rohitbarve collected $2.50 from pot
Rohitbarve: doesn't show hand 
*** SUMMARY ***
Total pot $2.50 | Rake $0 
Seat 1: Rafaello18 folded before Flop (didn't bet)
Seat 2: er13to folded before Flop (didn't bet)
Seat 3: liakos120 folded before Flop (didn't bet)
Seat 4: mbk88 folded before Flop (didn't bet)
Seat 5: Rohitbarve (button) collected ($2.50)
Seat 6: matiko09 (small blind) folded before Flop
Seat 7: DomiVY (big blind) folded before Flop
Seat 8: picka4u folded before Flop (didn't bet)





PokerStars Hand #155379834317:  Hold'em No Limit ($0.50/$1.00 USD) - 2016/06/30 13:42:24 CET [2016/06/30 7:42:24 ET]
Table 'Altarf II' 9-max Seat #2 is the button
Seat 1: thecurv ($107.97 in chips) 
Seat 2: KovIFish89 ($100 in chips) 
Seat 3: sanr23 ($109.48 in chips) 
Seat 4: Greha999 ($83.66 in chips) 
Seat 6: mbk88 ($130.50 in chips) 
Seat 7: matiko09 ($107.72 in chips) 
Seat 9: omanibemihum ($83 in chips) 
sanr23: posts small blind $0.50
Greha999: posts big blind $1
DIMAN_324: sits out 
*** HOLE CARDS ***
Dealt to matiko09 [2d Kh]
mbk88: folds 
matiko09: folds 
omanibemihum: folds 
thecurv: folds 
KovIFish89: folds 
sanr23: folds 
Uncalled bet ($0.50) returned to Greha999
Greha999 collected $1 from pot
*** SUMMARY ***
Total pot $1 | Rake $0 
Seat 1: thecurv folded before Flop (didn't bet)
Seat 2: KovIFish89 (button) folded before Flop (didn't bet)
Seat 3: sanr23 (small blind) folded before Flop
Seat 4: Greha999 (big blind) collected ($1)
Seat 6: mbk88 folded before Flop (didn't bet)
Seat 7: matiko09 folded before Flop (didn't bet)
Seat 9: omanibemihum folded before Flop (didn't bet)





PokerStars Hand #155379834976:  Hold'em No Limit ($0.50/$1.00 USD) - 2016/06/30 13:42:25 CET [2016/06/30 7:42:25 ET]
Table 'Prieska' 9-max Seat #7 is the button
Seat 1: KovIFish89 ($120.09 in chips) 
Seat 2: B_style_cuz ($87.28 in chips) 
Seat 3: Rafaello18 ($125.50 in chips) 
Seat 4: matteo080613 ($50 in chips) 
Seat 5: ramzes160468 ($85.52 in chips) 
Seat 6: DIMAN_324 ($102.50 in chips) 
Seat 7: matiko09 ($111.47 in chips) 
Seat 8: mbk88 ($100 in chips) 
Seat 9: picka4u ($39.83 in chips) 
mbk88: posts small blind $0.50
picka4u: posts big blind $1
*** HOLE CARDS ***
Dealt to matiko09 [5d 8c]
KovIFish89: folds 
B_style_cuz: folds 
Rafaello18: folds 
matteo080613: folds 
ramzes160468: folds 
DIMAN_324: raises $1.40 to $2.40
matiko09: folds 
mbk88: folds 
picka4u: folds 
Uncalled bet ($1.40) returned to DIMAN_324
DIMAN_324 collected $2.50 from pot
DIMAN_324: doesn't show hand 
*** SUMMARY ***
Total pot $2.50 | Rake $0 
Seat 1: KovIFish89 folded before Flop (didn't bet)
Seat 2: B_style_cuz folded before Flop (didn't bet)
Seat 3: Rafaello18 folded before Flop (didn't bet)
Seat 4: matteo080613 folded before Flop (didn't bet)
Seat 5: ramzes160468 folded before Flop (didn't bet)
Seat 6: DIMAN_324 collected ($2.50)
Seat 7: matiko09 (button) folded before Flop (didn't bet)
Seat 8: mbk88 (small blind) folded before Flop
Seat 9: picka4u (big blind) folded before Flop





PokerStars Hand #155379835032:  Hold'em No Limit ($0.50/$1.00 USD) - 2016/06/30 13:42:25 CET [2016/06/30 7:42:25 ET]
Table 'Armisticia' 9-max Seat #8 is the button
Seat 2: atlant244 ($68.43 in chips) 
Seat 3: KovIFish89 ($102.50 in chips) 
Seat 4: ardo888 ($100 in chips) 
Seat 5: SonerWPT ($99 in chips) 
Seat 6: matiko09 ($130.12 in chips) 
Seat 7: ilaviiitech ($100 in chips) 
Seat 8: techahn ($135.75 in chips) 
Seat 9: mbk88 ($117.33 in chips) 
mbk88: posts small blind $0.50
di0d80 was removed from the table for failing to post
atlant244: posts big blind $1
*** HOLE CARDS ***
Dealt to matiko09 [4s Tc]
KovIFish89: folds 
ardo888: folds 
SonerWPT: folds 
matiko09: folds 
ilaviiitech: folds 
techahn: raises $2 to $3
mbk88: folds 
atlant244: calls $2
*** FLOP *** [5h 4c 8c]
atlant244: checks 
techahn: checks 
*** TURN *** [5h 4c 8c] [5c]
atlant244: checks 
techahn: bets $3.09
atlant244: calls $3.09
*** RIVER *** [5h 4c 8c 5c] [5s]
tipner joins the table at seat #1 
atlant244: checks 
techahn: checks 
*** SHOW DOWN ***
atlant244: shows [Ah 7h] (three of a kind, Fives)
techahn: mucks hand 
atlant244 collected $12.05 from pot
*** SUMMARY ***
Total pot $12.68 | Rake $0.63 
Board [5h 4c 8c 5c 5s]
Seat 2: atlant244 (big blind) showed [Ah 7h] and won ($12.05) with three of a kind, Fives
Seat 3: KovIFish89 folded before Flop (didn't bet)
Seat 4: ardo888 folded before Flop (didn't bet)
Seat 5: SonerWPT folded before Flop (didn't bet)
Seat 6: matiko09 folded before Flop (didn't bet)
Seat 7: ilaviiitech folded before Flop (didn't bet)
Seat 8: techahn (button) mucked [Kd Qc]
Seat 9: mbk88 (small blind) folded before Flop





PokerStars Hand #155379834851:  Hold'em No Limit ($0.25/$0.50 USD) - 2016/06/30 13:42:25 CET [2016/06/30 7:42:25 ET]
Table 'Dorothea II' 9-max Seat #4 is the button
Seat 2: er13to ($51.15 in chips) 
Seat 4: matiko09 ($75.71 in chips) 
Seat 5: Bailey Dew ($87.14 in chips) 
Seat 8: TheMinion ($50.20 in chips) 
Bailey Dew: posts small blind $0.25
ivan100886: is sitting out 
TheMinion: posts big blind $0.50
er13to: posts the ante $0.10
matiko09: posts the ante $0.10
Bailey Dew: posts the ante $0.10
TheMinion: posts the ante $0.10
*** HOLE CARDS ***
Dealt to matiko09 [3h 2d]
er13to: folds 
matiko09: folds 
Bailey Dew: raises $0.75 to $1.25
TheMinion: calls $0.75
*** FLOP *** [Qd Kh 8d]
Bailey Dew: checks 
TheMinion: checks 
*** TURN *** [Qd Kh 8d] [3s]
funXmun joins the table at seat #9 
Bailey Dew: bets $1.83
TheMinion: folds 
Uncalled bet ($1.83) returned to Bailey Dew
Bailey Dew collected $2.76 from pot
Bailey Dew: doesn't show hand 
*** SUMMARY ***
Total pot $2.90 | Rake $0.14 
Board [Qd Kh 8d 3s]
Seat 2: er13to folded before Flop (didn't bet)
Seat 4: matiko09 (button) folded before Flop (didn't bet)
Seat 5: Bailey Dew (small blind) collected ($2.76)
Seat 8: TheMinion (big blind) folded on the Turn





PokerStars Hand #155379835190:  Hold'em No Limit ($0.50/$1.00 USD) - 2016/06/30 13:42:26 CET [2016/06/30 7:42:26 ET]
Table 'Asmodeus' 9-max Seat #6 is the button
Seat 1: scollop ($108.50 in chips) 
Seat 2: picka4u ($35.77 in chips) 
Seat 3: matiko09 ($103.75 in chips) 
Seat 4: ardo888 ($135.28 in chips) 
Seat 5: sanr23 ($100 in chips) 
Seat 6: koutani7 ($92.50 in chips) 
Seat 7: aaronzzr ($155.29 in chips) 
Seat 8: Rafaello18 ($152.95 in chips) 
Seat 9: mbk88 ($157.68 in chips) 
aaronzzr: posts small blind $0.50
Rafaello18: posts big blind $1
*** HOLE CARDS ***
Dealt to matiko09 [Jh Ts]
mbk88: folds 
scollop: raises $1 to $2
picka4u: folds 
matiko09: folds 
ardo888: folds 
sanr23: folds 
koutani7: folds 
aaronzzr: calls $1.50
Rafaello18: calls $1
*** FLOP *** [6h 9s 5c]
aaronzzr: checks 
Rafaello18: checks 
scollop: bets $10
aaronzzr: folds 
Rafaello18: folds 
Uncalled bet ($10) returned to scollop
scollop collected $5.70 from pot
scollop: doesn't show hand 
*** SUMMARY ***
Total pot $6 | Rake $0.30 
Board [6h 9s 5c]
Seat 1: scollop collected ($5.70)
Seat 2: picka4u folded before Flop (didn't bet)
Seat 3: matiko09 folded before Flop (didn't bet)
Seat 4: ardo888 folded before Flop (didn't bet)
Seat 5: sanr23 folded before Flop (didn't bet)
Seat 6: koutani7 (button) folded before Flop (didn't bet)
Seat 7: aaronzzr (small blind) folded on the Flop
Seat 8: Rafaello18 (big blind) folded on the Flop
Seat 9: mbk88 folded before Flop (didn't bet)





PokerStars Hand #155379837125:  Hold'em No Limit ($0.50/$1.00 USD) - 2016/06/30 13:42:30 CET [2016/06/30 7:42:30 ET]
Table 'Eucharis' 9-max Seat #8 is the button
Seat 2: sanr23 ($128.78 in chips) 
Seat 3: ramzes160468 ($126.02 in chips) 
Seat 5: Rafaello18 ($101.50 in chips) 
Seat 6: matiko09 ($102.62 in chips) 
Seat 7: DIMAN_324 ($101.15 in chips) 
Seat 8: anfisa.irk ($41.15 in chips) 
picka4u will be allowed to play after the button
sanr23: posts small blind $0.50
ramzes160468: posts big blind $1
mbk88: sits out 
*** HOLE CARDS ***
Dealt to matiko09 [4h Qd]
Rafaello18: folds 
matiko09: folds 
DIMAN_324: folds 
anfisa.irk: folds 
sanr23: folds 
Uncalled bet ($0.50) returned to ramzes160468
ramzes160468 collected $1 from pot
*** SUMMARY ***
Total pot $1 | Rake $0 
Seat 2: sanr23 (small blind) folded before Flop
Seat 3: ramzes160468 (big blind) collected ($1)
Seat 5: Rafaello18 folded before Flop (didn't bet)
Seat 6: matiko09 folded before Flop (didn't bet)
Seat 7: DIMAN_324 folded before Flop (didn't bet)
Seat 8: anfisa.irk (button) folded before Flop (didn't bet)





PokerStars Hand #155379841065:  Hold'em No Limit ($0.25/$0.50 USD) - 2016/06/30 13:42:40 CET [2016/06/30 7:42:40 ET]
Table 'Elektra II' 9-max Seat #1 is the button
Seat 1: drlee77 ($49.53 in chips) 
Seat 2: TheMinion ($63.57 in chips) 
Seat 3: mojtabagol ($65.46 in chips) 
Seat 4: matiko09 ($60.53 in chips) 
Seat 5: Rafaello18 ($59.99 in chips) 
Seat 6: pfunkolstar ($50 in chips) 
Seat 7: MuddyDance ($49.25 in chips) 
Seat 8: sanr23 ($50.89 in chips) 
Seat 9: Dantistcopra ($52.10 in chips) 
TheMinion: posts small blind $0.25
mojtabagol: posts big blind $0.50
*** HOLE CARDS ***
Dealt to matiko09 [8h Jd]
matiko09: folds 
Rafaello18: folds 
pfunkolstar: folds 
MuddyDance: folds 
sanr23: folds 
Dantistcopra: folds 
drlee77: raises $1 to $1.50
TheMinion: folds 
mojtabagol: folds 
Uncalled bet ($1) returned to drlee77
drlee77 collected $1.25 from pot
drlee77: doesn't show hand 
*** SUMMARY ***
Total pot $1.25 | Rake $0 
Seat 1: drlee77 (button) collected ($1.25)
Seat 2: TheMinion (small blind) folded before Flop
Seat 3: mojtabagol (big blind) folded before Flop
Seat 4: matiko09 folded before Flop (didn't bet)
Seat 5: Rafaello18 folded before Flop (didn't bet)
Seat 6: pfunkolstar folded before Flop (didn't bet)
Seat 7: MuddyDance folded before Flop (didn't bet)
Seat 8: sanr23 folded before Flop (didn't bet)
Seat 9: Dantistcopra folded before Flop (didn't bet)





PokerStars Hand #155379844831:  Hold'em No Limit ($0.50/$1.00 USD) - 2016/06/30 13:42:48 CET [2016/06/30 7:42:48 ET]
Table 'Apisaon II' 9-max Seat #7 is the button
Seat 5: riccfch ($107.20 in chips) 
Seat 7: matiko09 ($106.46 in chips) 
Seat 8: ardo888 ($100 in chips) 
ardo888: posts small blind $0.50
mbk88: is sitting out 
riccfch: posts big blind $1
riccfch: posts the ante $0.20
matiko09: posts the ante $0.20
ardo888: posts the ante $0.20
*** HOLE CARDS ***
Dealt to matiko09 [2d 2s]
matiko09: raises $1.27 to $2.27
ardo888: folds 
riccfch: calls $1.27
*** FLOP *** [Jd 3d Js]
riccfch: checks 
matiko09: checks 
*** TURN *** [Jd 3d Js] [8h]
riccfch: bets $3
matiko09: calls $3
*** RIVER *** [Jd 3d Js 8h] [Td]
riccfch: bets $8
matiko09: folds 
Uncalled bet ($8) returned to riccfch
riccfch collected $11.06 from pot
riccfch: doesn't show hand 
*** SUMMARY ***
Total pot $11.64 | Rake $0.58 
Board [Jd 3d Js 8h Td]
Seat 5: riccfch (big blind) collected ($11.06)
Seat 7: matiko09 (button) folded on the River
Seat 8: ardo888 (small blind) folded before Flop





PokerStars Hand #155379845340:  Hold'em No Limit ($0.50/$1.00 USD) - 2016/06/30 13:42:49 CET [2016/06/30 7:42:49 ET]
Table 'Altarf II' 9-max Seat #3 is the button
Seat 1: thecurv ($107.97 in chips) 
Seat 2: KovIFish89 ($100 in chips) 
Seat 3: sanr23 ($108.98 in chips) 
Seat 4: Greha999 ($84.16 in chips) 
Seat 5: DIMAN_324 ($100 in chips) 
Seat 6: mbk88 ($130.50 in chips) 
Seat 7: matiko09 ($107.72 in chips) 
Seat 9: omanibemihum ($100 in chips) 
Greha999: posts small blind $0.50
DIMAN_324: posts big blind $1
*** HOLE CARDS ***
Dealt to matiko09 [Jc 6c]
mbk88: raises $2 to $3
matiko09: folds 
omanibemihum: folds 
thecurv: folds 
DomiVY joins the table at seat #8 
KovIFish89: folds 
sanr23: folds 
Greha999: folds 
DIMAN_324: folds 
Uncalled bet ($2) returned to mbk88
mbk88 collected $2.50 from pot
mbk88: doesn't show hand 
*** SUMMARY ***
Total pot $2.50 | Rake $0 
Seat 1: thecurv folded before Flop (didn't bet)
Seat 2: KovIFish89 folded before Flop (didn't bet)
Seat 3: sanr23 (button) folded before Flop (didn't bet)
Seat 4: Greha999 (small blind) folded before Flop
Seat 5: DIMAN_324 (big blind) folded before Flop
Seat 6: mbk88 collected ($2.50)
Seat 7: matiko09 folded before Flop (didn't bet)
Seat 9: omanibemihum folded before Flop (didn't bet)





PokerStars Hand #155379847481:  Hold'em No Limit ($0.50/$1.00 USD) - 2016/06/30 13:42:54 CET [2016/06/30 7:42:54 ET]
Table 'Borrelly II' 9-max Seat #5 is the button
Seat 1: Rafaello18 ($110.82 in chips) 
Seat 2: tipner ($103.22 in chips) 
Seat 4: DonRon_AT ($41.81 in chips) 
Seat 5: DIMAN_324 ($100 in chips) 
Seat 6: m_michalec ($170.88 in chips) 
Seat 7: matiko09 ($155.85 in chips) 
m_michalec: posts small blind $0.50
matiko09: posts big blind $1
Arjun A Raju: sits out 
alhill86: sits out 
*** HOLE CARDS ***
Dealt to matiko09 [9d 8c]
Rafaello18: folds 
tipner: folds 
DonRon_AT: folds 
DIMAN_324: raises $1.10 to $2.10
m_michalec: folds 
matiko09: folds 
Uncalled bet ($1.10) returned to DIMAN_324
DIMAN_324 collected $2.50 from pot
DIMAN_324: doesn't show hand 
*** SUMMARY ***
Total pot $2.50 | Rake $0 
Seat 1: Rafaello18 folded before Flop (didn't bet)
Seat 2: tipner folded before Flop (didn't bet)
Seat 4: DonRon_AT folded before Flop (didn't bet)
Seat 5: DIMAN_324 (button) collected ($2.50)
Seat 6: m_michalec (small blind) folded before Flop
Seat 7: matiko09 (big blind) folded before Flop





PokerStars Hand #155379849634:  Hold'em No Limit ($0.50/$1.00 USD) - 2016/06/30 13:42:59 CET [2016/06/30 7:42:59 ET]
Table 'Eucharis' 9-max Seat #2 is the button
Seat 2: sanr23 ($128.28 in chips) 
Seat 3: ramzes160468 ($126.52 in chips) 
Seat 4: mbk88 ($100 in chips) 
Seat 5: Rafaello18 ($101.50 in chips) 
Seat 6: matiko09 ($102.62 in chips) 
Seat 7: DIMAN_324 ($101.15 in chips) 
Seat 8: anfisa.irk ($41.15 in chips) 
ramzes160468: posts small blind $0.50
mbk88: posts big blind $1
picka4u: sits out 
*** HOLE CARDS ***
Dealt to matiko09 [4d Qs]
Rafaello18: folds 
matiko09: folds 
DIMAN_324: folds 
anfisa.irk: folds 
sanr23: folds 
ramzes160468: folds 
Uncalled bet ($0.50) returned to mbk88
mbk88 collected $1 from pot
mbk88: doesn't show hand 
*** SUMMARY ***
Total pot $1 | Rake $0 
Seat 2: sanr23 (button) folded before Flop (didn't bet)
Seat 3: ramzes160468 (small blind) folded before Flop
Seat 4: mbk88 (big blind) collected ($1)
Seat 5: Rafaello18 folded before Flop (didn't bet)
Seat 6: matiko09 folded before Flop (didn't bet)
Seat 7: DIMAN_324 folded before Flop (didn't bet)
Seat 8: anfisa.irk folded before Flop (didn't bet)





PokerStars Hand #155379855838:  Hold'em No Limit ($0.50/$1.00 USD) - 2016/06/30 13:43:14 CET [2016/06/30 7:43:14 ET]
Table 'Borrelly II' 9-max Seat #6 is the button
Seat 1: Rafaello18 ($110.82 in chips) 
Seat 2: tipner ($103.22 in chips) 
Seat 4: DonRon_AT ($41.81 in chips) 
Seat 5: DIMAN_324 ($101.50 in chips) 
Seat 6: m_michalec ($170.38 in chips) 
Seat 7: matiko09 ($154.85 in chips) 
Seat 8: Arjun A Raju ($100 in chips) 
matiko09: posts small blind $0.50
Arjun A Raju: posts big blind $1
alhill86: sits out 
*** HOLE CARDS ***
Dealt to matiko09 [6c 9c]
Rafaello18: folds 
tipner: folds 
DonRon_AT: folds 
DIMAN_324: folds 
m_michalec: folds 
matiko09: raises $2 to $3
Arjun A Raju: folds 
Uncalled bet ($2) returned to matiko09
matiko09 collected $2 from pot
matiko09: doesn't show hand 
*** SUMMARY ***
Total pot $2 | Rake $0 
Seat 1: Rafaello18 folded before Flop (didn't bet)
Seat 2: tipner folded before Flop (didn't bet)
Seat 4: DonRon_AT folded before Flop (didn't bet)
Seat 5: DIMAN_324 folded before Flop (didn't bet)
Seat 6: m_michalec (button) folded before Flop (didn't bet)
Seat 7: matiko09 (small blind) collected ($2)
Seat 8: Arjun A Raju (big blind) folded before Flop





PokerStars Hand #155379856375:  Hold'em No Limit ($0.50/$1.00 USD) - 2016/06/30 13:43:15 CET [2016/06/30 7:43:15 ET]
Table 'Armisticia' 9-max Seat #9 is the button
Seat 2: atlant244 ($74.39 in chips) 
Seat 3: KovIFish89 ($102.50 in chips) 
Seat 4: ardo888 ($100 in chips) 
Seat 5: SonerWPT ($99 in chips) 
Seat 6: matiko09 ($130.12 in chips) 
Seat 7: ilaviiitech ($100 in chips) 
Seat 8: techahn ($129.66 in chips) 
Seat 9: mbk88 ($116.83 in chips) 
tipner will be allowed to play after the button
atlant244: posts small blind $0.50
KovIFish89: posts big blind $1
*** HOLE CARDS ***
Dealt to matiko09 [Js Ad]
ardo888: folds 
SonerWPT: folds 
matiko09: raises $2 to $3
ilaviiitech: folds 
techahn: folds 
mbk88: folds 
atlant244: calls $2.50
KovIFish89: folds 
*** FLOP *** [3s Ah Kd]
atlant244: checks 
matiko09: checks 
*** TURN *** [3s Ah Kd] [5s]
atlant244: checks 
matiko09: bets $4.32
atlant244: calls $4.32
*** RIVER *** [3s Ah Kd 5s] [6s]
atlant244: bets $14.86
matiko09: folds 
Uncalled bet ($14.86) returned to atlant244
atlant244 collected $14.86 from pot
atlant244: doesn't show hand 
*** SUMMARY ***
Total pot $15.64 | Rake $0.78 
Board [3s Ah Kd 5s 6s]
Seat 2: atlant244 (small blind) collected ($14.86)
Seat 3: KovIFish89 (big blind) folded before Flop
Seat 4: ardo888 folded before Flop (didn't bet)
Seat 5: SonerWPT folded before Flop (didn't bet)
Seat 6: matiko09 folded on the River
Seat 7: ilaviiitech folded before Flop (didn't bet)
Seat 8: techahn folded before Flop (didn't bet)
Seat 9: mbk88 (button) folded before Flop (didn't bet)





PokerStars Hand #155379856268:  Hold'em No Limit ($0.50/$1.00 USD) - 2016/06/30 13:43:15 CET [2016/06/30 7:43:15 ET]
Table 'Prieska' 9-max Seat #8 is the button
Seat 1: KovIFish89 ($120.09 in chips) 
Seat 2: B_style_cuz ($87.28 in chips) 
Seat 3: Rafaello18 ($125.50 in chips) 
Seat 4: matteo080613 ($50 in chips) 
Seat 5: ramzes160468 ($85.52 in chips) 
Seat 6: DIMAN_324 ($104 in chips) 
Seat 7: matiko09 ($111.47 in chips) 
Seat 8: mbk88 ($100 in chips) 
Seat 9: picka4u ($38.83 in chips) 
picka4u: posts small blind $0.50
KovIFish89: posts big blind $1
*** HOLE CARDS ***
Dealt to matiko09 [2d 9h]
B_style_cuz: folds 
Rafaello18: folds 
matteo080613: folds 
ramzes160468: raises $2 to $3
DIMAN_324: folds 
matiko09: folds 
mbk88: folds 
picka4u: folds 
KovIFish89: folds 
Uncalled bet ($2) returned to ramzes160468
ramzes160468 collected $2.50 from pot
*** SUMMARY ***
Total pot $2.50 | Rake $0 
Seat 1: KovIFish89 (big blind) folded before Flop
Seat 2: B_style_cuz folded before Flop (didn't bet)
Seat 3: Rafaello18 folded before Flop (didn't bet)
Seat 4: matteo080613 folded before Flop (didn't bet)
Seat 5: ramzes160468 collected ($2.50)
Seat 6: DIMAN_324 folded before Flop (didn't bet)
Seat 7: matiko09 folded before Flop (didn't bet)
Seat 8: mbk88 (button) folded before Flop (didn't bet)
Seat 9: picka4u (small blind) folded before Flop





PokerStars Hand #155379857902:  Hold'em No Limit ($0.50/$1.00 USD) - 2016/06/30 13:43:18 CET [2016/06/30 7:43:18 ET]
Table 'California II' 9-max Seat #6 is the button
Seat 1: Rafaello18 ($114.02 in chips) 
Seat 2: er13to ($100 in chips) 
Seat 3: liakos120 ($84.59 in chips) 
Seat 4: mbk88 ($118.54 in chips) 
Seat 5: Rohitbarve ($97.36 in chips) 
Seat 6: matiko09 ($127.35 in chips) 
Seat 7: DomiVY ($86.20 in chips) 
Seat 8: picka4u ($41.50 in chips) 
DomiVY: posts small blind $0.50
picka4u: posts big blind $1
*** HOLE CARDS ***
Dealt to matiko09 [2d Jc]
Rafaello18: folds 
er13to: folds 
liakos120: folds 
mbk88: folds 
Rohitbarve: folds 
matiko09: folds 
DomiVY: folds 
Uncalled bet ($0.50) returned to picka4u
picka4u collected $1 from pot
picka4u: doesn't show hand 
*** SUMMARY ***
Total pot $1 | Rake $0 
Seat 1: Rafaello18 folded before Flop (didn't bet)
Seat 2: er13to folded before Flop (didn't bet)
Seat 3: liakos120 folded before Flop (didn't bet)
Seat 4: mbk88 folded before Flop (didn't bet)
Seat 5: Rohitbarve folded before Flop (didn't bet)
Seat 6: matiko09 (button) folded before Flop (didn't bet)
Seat 7: DomiVY (small blind) folded before Flop
Seat 8: picka4u (big blind) collected ($1)





PokerStars Hand #155379858820:  Hold'em No Limit ($0.50/$1.00 USD) - 2016/06/30 13:43:20 CET [2016/06/30 7:43:20 ET]
Table 'Tatjana' 9-max Seat #6 is the button
Seat 1: ardo888 ($124.96 in chips) 
Seat 2: DIMAN_324 ($101.50 in chips) 
Seat 3: Rafaello18 ($100 in chips) 
Seat 5: matiko09 ($104.04 in chips) 
Seat 6: mbk88 ($106.60 in chips) 
Seat 8: alhill86 ($113.83 in chips) 
Seat 9: POTAPENKO700 ($142.71 in chips) 
daigodisco will be allowed to play after the button
alhill86: posts small blind $0.50
POTAPENKO700: posts big blind $1
*** HOLE CARDS ***
Dealt to matiko09 [Jd Js]
ardo888: folds 
DIMAN_324: folds 
Rafaello18: raises $1.50 to $2.50
matiko09: calls $2.50
mbk88: raises $8.50 to $11
tipner joins the table at seat #4 
alhill86: folds 
POTAPENKO700: folds 
tipner leaves the table
Rafaello18: folds 
matiko09: calls $8.50
*** FLOP *** [7d Qd 5h]
matiko09: checks 
mbk88: bets $16
matiko09: calls $16
*** TURN *** [7d Qd 5h] [2h]
matiko09: checks 
mbk88: bets $25
matiko09: folds 
Uncalled bet ($25) returned to mbk88
mbk88 collected $55.50 from pot
mbk88: doesn't show hand 
*** SUMMARY ***
Total pot $58 | Rake $2.50 
Board [7d Qd 5h 2h]
Seat 1: ardo888 folded before Flop (didn't bet)
Seat 2: DIMAN_324 folded before Flop (didn't bet)
Seat 3: Rafaello18 folded before Flop
Seat 5: matiko09 folded on the Turn
Seat 6: mbk88 (button) collected ($55.50)
Seat 8: alhill86 (small blind) folded before Flop
Seat 9: POTAPENKO700 (big blind) folded before Flop





PokerStars Hand #155379859542:  Hold'em No Limit ($0.50/$1.00 USD) - 2016/06/30 13:43:22 CET [2016/06/30 7:43:22 ET]
Table 'Altarf II' 9-max Seat #4 is the button
Seat 1: thecurv ($107.97 in chips) 
Seat 2: KovIFish89 ($100 in chips) 
Seat 3: sanr23 ($108.98 in chips) 
Seat 4: Greha999 ($83.66 in chips) 
Seat 5: DIMAN_324 ($100 in chips) 
Seat 6: mbk88 ($132 in chips) 
Seat 7: matiko09 ($107.72 in chips) 
Seat 9: omanibemihum ($100 in chips) 
DIMAN_324: posts small blind $0.50
mbk88: posts big blind $1
DomiVY: sits out 
*** HOLE CARDS ***
Dealt to matiko09 [Kd 9d]
matiko09: folds 
omanibemihum: folds 
thecurv: folds 
KovIFish89 has timed out
KovIFish89: folds 
sanr23: raises $1.50 to $2.50
Greha999: folds 
DIMAN_324: folds 
mbk88: calls $1.50
*** FLOP *** [4h Td Qh]
mbk88: checks 
sanr23: bets $3.45
mbk88: calls $3.45
*** TURN *** [4h Td Qh] [5d]
mbk88: checks 
sanr23: bets $7.77
mbk88: raises $18.23 to $26
sanr23: calls $18.23
*** RIVER *** [4h Td Qh 5d] [4s]
mbk88: checks 
sanr23: checks 
*** SHOW DOWN ***
mbk88: shows [5h 7h] (two pair, Fives and Fours)
sanr23: shows [Qd Jc] (two pair, Queens and Fours)
sanr23 collected $61.90 from pot
*** SUMMARY ***
Total pot $64.40 | Rake $2.50 
Board [4h Td Qh 5d 4s]
Seat 1: thecurv folded before Flop (didn't bet)
Seat 2: KovIFish89 folded before Flop (didn't bet)
Seat 3: sanr23 showed [Qd Jc] and won ($61.90) with two pair, Queens and Fours
Seat 4: Greha999 (button) folded before Flop (didn't bet)
Seat 5: DIMAN_324 (small blind) folded before Flop
Seat 6: mbk88 (big blind) showed [5h 7h] and lost with two pair, Fives and Fours
Seat 7: matiko09 folded before Flop (didn't bet)
Seat 9: omanibemihum folded before Flop (didn't bet)





PokerStars Hand #155379862326:  Hold'em No Limit ($0.50/$1.00 USD) - 2016/06/30 13:43:28 CET [2016/06/30 7:43:28 ET]
Table 'Eucharis' 9-max Seat #3 is the button
Seat 2: sanr23 ($128.28 in chips) 
Seat 3: ramzes160468 ($126.02 in chips) 
Seat 4: mbk88 ($100.50 in chips) 
Seat 5: Rafaello18 ($101.50 in chips) 
Seat 6: matiko09 ($102.62 in chips) 
Seat 7: DIMAN_324 ($101.15 in chips) 
Seat 8: anfisa.irk ($41.15 in chips) 
mbk88: posts small blind $0.50
Rafaello18: posts big blind $1
picka4u: sits out 
*** HOLE CARDS ***
Dealt to matiko09 [Td 9h]
matiko09: folds 
DIMAN_324: folds 
anfisa.irk: raises $2 to $3
sanr23: folds 
ramzes160468: folds 
mbk88: folds 
Rafaello18: folds 
Uncalled bet ($2) returned to anfisa.irk
anfisa.irk collected $2.50 from pot
anfisa.irk: doesn't show hand 
*** SUMMARY ***
Total pot $2.50 | Rake $0 
Seat 2: sanr23 folded before Flop (didn't bet)
Seat 3: ramzes160468 (button) folded before Flop (didn't bet)
Seat 4: mbk88 (small blind) folded before Flop
Seat 5: Rafaello18 (big blind) folded before Flop
Seat 6: matiko09 folded before Flop (didn't bet)
Seat 7: DIMAN_324 folded before Flop (didn't bet)
Seat 8: anfisa.irk collected ($2.50)





PokerStars Hand #155379862444:  Hold'em No Limit ($0.50/$1.00 USD) - 2016/06/30 13:43:29 CET [2016/06/30 7:43:29 ET]
Table 'Apisaon II' 9-max Seat #8 is the button
Seat 5: riccfch ($112.79 in chips) 
Seat 7: matiko09 ($100.99 in chips) 
Seat 8: ardo888 ($100 in chips) 
riccfch: posts small blind $0.50
matiko09: posts big blind $1
riccfch: posts the ante $0.20
matiko09: posts the ante $0.20
ardo888: posts the ante $0.20
*** HOLE CARDS ***
Dealt to matiko09 [5s Jd]
ardo888: folds 
riccfch: raises $2 to $3
matiko09: folds 
Uncalled bet ($2) returned to riccfch
riccfch collected $2.60 from pot
riccfch: doesn't show hand 
*** SUMMARY ***
Total pot $2.60 | Rake $0 
Seat 5: riccfch (small blind) collected ($2.60)
Seat 7: matiko09 (big blind) folded before Flop
Seat 8: ardo888 (button) folded before Flop (didn't bet)





PokerStars Hand #155379867042:  Hold'em No Limit ($0.25/$0.50 USD) - 2016/06/30 13:43:39 CET [2016/06/30 7:43:39 ET]
Table 'Dorothea II' 9-max Seat #5 is the button
Seat 2: er13to ($51.05 in chips) 
Seat 4: matiko09 ($75.61 in chips) 
Seat 5: Bailey Dew ($88.55 in chips) 
Seat 8: TheMinion ($50 in chips) 
Seat 9: funXmun ($50 in chips) 
TheMinion: posts small blind $0.25
funXmun: posts big blind $0.50
er13to: posts the ante $0.10
matiko09: posts the ante $0.10
Bailey Dew: posts the ante $0.10
TheMinion: posts the ante $0.10
funXmun: posts the ante $0.10
*** HOLE CARDS ***
Dealt to matiko09 [5d Ad]
er13to: folds 
desmo465 joins the table at seat #7 
matiko09: raises $1 to $1.50
Bailey Dew: folds 
TheMinion: folds 
funXmun: folds 
Uncalled bet ($1) returned to matiko09
matiko09 collected $1.75 from pot
matiko09: doesn't show hand 
*** SUMMARY ***
Total pot $1.75 | Rake $0 
Seat 2: er13to folded before Flop (didn't bet)
Seat 4: matiko09 collected ($1.75)
Seat 5: Bailey Dew (button) folded before Flop (didn't bet)
Seat 8: TheMinion (small blind) folded before Flop
Seat 9: funXmun (big blind) folded before Flop





PokerStars Hand #155379867370:  Hold'em No Limit ($0.25/$0.50 USD) - 2016/06/30 13:43:40 CET [2016/06/30 7:43:40 ET]
Table 'Elektra II' 9-max Seat #2 is the button
Seat 1: drlee77 ($50.28 in chips) 
Seat 2: TheMinion ($63.32 in chips) 
Seat 3: mojtabagol ($64.96 in chips) 
Seat 4: matiko09 ($60.53 in chips) 
Seat 5: Rafaello18 ($59.99 in chips) 
Seat 6: pfunkolstar ($50 in chips) 
Seat 7: MuddyDance ($49.25 in chips) 
Seat 8: sanr23 ($50.89 in chips) 
Seat 9: Dantistcopra ($52.10 in chips) 
mojtabagol: posts small blind $0.25
matiko09: posts big blind $0.50
*** HOLE CARDS ***
Dealt to matiko09 [7c Ks]
Rafaello18: folds 
pfunkolstar: folds 
MuddyDance has timed out
MuddyDance: folds 
sanr23: folds 
Dantistcopra: folds 
drlee77: raises $1 to $1.50
TheMinion: folds 
mojtabagol: raises $2.50 to $4
matiko09: folds 
drlee77: folds 
Uncalled bet ($2.50) returned to mojtabagol
mojtabagol collected $3.50 from pot
*** SUMMARY ***
Total pot $3.50 | Rake $0 
Seat 1: drlee77 folded before Flop
Seat 2: TheMinion (button) folded before Flop (didn't bet)
Seat 3: mojtabagol (small blind) collected ($3.50)
Seat 4: matiko09 (big blind) folded before Flop
Seat 5: Rafaello18 folded before Flop (didn't bet)
Seat 6: pfunkolstar folded before Flop (didn't bet)
Seat 7: MuddyDance folded before Flop (didn't bet)
Seat 8: sanr23 folded before Flop (didn't bet)
Seat 9: Dantistcopra folded before Flop (didn't bet)





PokerStars Hand #155379868363:  Hold'em No Limit ($0.50/$1.00 USD) - 2016/06/30 13:43:43 CET [2016/06/30 7:43:43 ET]
Table 'California II' 9-max Seat #7 is the button
Seat 1: Rafaello18 ($114.02 in chips) 
Seat 2: er13to ($100 in chips) 
Seat 3: liakos120 ($84.59 in chips) 
Seat 4: mbk88 ($118.54 in chips) 
Seat 5: Rohitbarve ($97.36 in chips) 
Seat 6: matiko09 ($127.35 in chips) 
Seat 7: DomiVY ($85.70 in chips) 
Seat 8: picka4u ($42 in chips) 
picka4u: posts small blind $0.50
Rafaello18: posts big blind $1
*** HOLE CARDS ***
Dealt to matiko09 [Td 5s]
er13to: folds 
er13to leaves the table
liakos120: folds 
mbk88: folds 
Rohitbarve: raises $2 to $3
matiko09: folds 
DomiVY: folds 
picka4u: folds 
Rafaello18: folds 
Uncalled bet ($2) returned to Rohitbarve
Rohitbarve collected $2.50 from pot
Rohitbarve: doesn't show hand 
*** SUMMARY ***
Total pot $2.50 | Rake $0 
Seat 1: Rafaello18 (big blind) folded before Flop
Seat 2: er13to folded before Flop (didn't bet)
Seat 3: liakos120 folded before Flop (didn't bet)
Seat 4: mbk88 folded before Flop (didn't bet)
Seat 5: Rohitbarve collected ($2.50)
Seat 6: matiko09 folded before Flop (didn't bet)
Seat 7: DomiVY (button) folded before Flop (didn't bet)
Seat 8: picka4u (small blind) folded before Flop





PokerStars Hand #155379868970:  Hold'em No Limit ($0.50/$1.00 USD) - 2016/06/30 13:43:44 CET [2016/06/30 7:43:44 ET]
Table 'Apisaon II' 9-max Seat #5 is the button
Seat 5: riccfch ($114.19 in chips) 
Seat 7: matiko09 ($100 in chips) 
Seat 8: ardo888 ($100 in chips) 
matiko09: posts small blind $0.50
ardo888: posts big blind $1
riccfch: posts the ante $0.20
matiko09: posts the ante $0.20
ardo888: posts the ante $0.20
*** HOLE CARDS ***
Dealt to matiko09 [4d Jd]
riccfch: folds 
matiko09: folds 
Uncalled bet ($0.50) returned to ardo888
ardo888 collected $1.60 from pot
ardo888: doesn't show hand 
*** SUMMARY ***
Total pot $1.60 | Rake $0 
Seat 5: riccfch (button) folded before Flop (didn't bet)
Seat 7: matiko09 (small blind) folded before Flop
Seat 8: ardo888 (big blind) collected ($1.60)





PokerStars Hand #155379871782:  Hold'em No Limit ($0.50/$1.00 USD) - 2016/06/30 13:43:51 CET [2016/06/30 7:43:51 ET]
Table 'Borrelly II' 9-max Seat #7 is the button
Seat 1: Rafaello18 ($110.82 in chips) 
Seat 2: tipner ($103.22 in chips) 
Seat 4: DonRon_AT ($41.81 in chips) 
Seat 5: DIMAN_324 ($101.50 in chips) 
Seat 6: m_michalec ($170.38 in chips) 
Seat 7: matiko09 ($155.85 in chips) 
Seat 8: Arjun A Raju ($99 in chips) 
Seat 9: alhill86 ($80 in chips) 
Arjun A Raju: posts small blind $0.50
alhill86: posts big blind $1
*** HOLE CARDS ***
Dealt to matiko09 [3h Qh]
Rafaello18: folds 
tipner: folds 
DonRon_AT: folds 
DIMAN_324: folds 
m_michalec: folds 
matiko09: folds 
Arjun A Raju: raises $2 to $3
alhill86: folds 
Uncalled bet ($2) returned to Arjun A Raju
Arjun A Raju collected $2 from pot
Arjun A Raju: doesn't show hand 
*** SUMMARY ***
Total pot $2 | Rake $0 
Seat 1: Rafaello18 folded before Flop (didn't bet)
Seat 2: tipner folded before Flop (didn't bet)
Seat 4: DonRon_AT folded before Flop (didn't bet)
Seat 5: DIMAN_324 folded before Flop (didn't bet)
Seat 6: m_michalec folded before Flop (didn't bet)
Seat 7: matiko09 (button) folded before Flop (didn't bet)
Seat 8: Arjun A Raju (small blind) collected ($2)
Seat 9: alhill86 (big blind) folded before Flop





PokerStars Hand #155379873352:  Hold'em No Limit ($0.25/$0.50 USD) - 2016/06/30 13:43:54 CET [2016/06/30 7:43:54 ET]
Table 'Dorothea II' 9-max Seat #8 is the button
Seat 4: matiko09 ($76.76 in chips) 
Seat 5: Bailey Dew ($88.45 in chips) 
Seat 8: TheMinion ($50 in chips) 
Seat 9: funXmun ($50 in chips) 
funXmun: posts small blind $0.25
Vesnushca was removed from the table for failing to post
er13to: is sitting out 
matiko09: posts big blind $0.50
er13to leaves the table
desmo465: sits out 
matiko09: posts the ante $0.10
Bailey Dew: posts the ante $0.10
TheMinion: posts the ante $0.10
funXmun: posts the ante $0.10
*** HOLE CARDS ***
Dealt to matiko09 [6s Kd]
Bailey Dew: raises $0.75 to $1.25
TheMinion: folds 
funXmun: folds 
matiko09: folds 
Uncalled bet ($0.75) returned to Bailey Dew
Bailey Dew collected $1.65 from pot
Bailey Dew: doesn't show hand 
*** SUMMARY ***
Total pot $1.65 | Rake $0 
Seat 4: matiko09 (big blind) folded before Flop
Seat 5: Bailey Dew collected ($1.65)
Seat 8: TheMinion (button) folded before Flop (didn't bet)
Seat 9: funXmun (small blind) folded before Flop





PokerStars Hand #155379873954:  Hold'em No Limit ($0.50/$1.00 USD) - 2016/06/30 13:43:56 CET [2016/06/30 7:43:56 ET]
Table 'Apisaon II' 9-max Seat #7 is the button
Seat 5: riccfch ($113.99 in chips) 
Seat 7: matiko09 ($100 in chips) 
Seat 8: ardo888 ($100.90 in chips) 
ardo888: posts small blind $0.50
riccfch: posts big blind $1
riccfch: posts the ante $0.20
matiko09: posts the ante $0.20
ardo888: posts the ante $0.20
*** HOLE CARDS ***
Dealt to matiko09 [5h 3h]
matiko09: folds 
matiko09 leaves the table
ardo888: folds 
Uncalled bet ($0.50) returned to riccfch
riccfch collected $1.60 from pot
riccfch: doesn't show hand 
*** SUMMARY ***
Total pot $1.60 | Rake $0 
Seat 5: riccfch (big blind) collected ($1.60)
Seat 7: matiko09 (button) folded before Flop (didn't bet)
Seat 8: ardo888 (small blind) folded before Flop





PokerStars Hand #155379880092:  Hold'em No Limit ($0.25/$0.50 USD) - 2016/06/30 13:44:10 CET [2016/06/30 7:44:10 ET]
Table 'Dorothea II' 9-max Seat #9 is the button
Seat 4: matiko09 ($76.16 in chips) 
Seat 7: desmo465 ($50 in chips) 
Seat 8: TheMinion ($50 in chips) 
Seat 9: funXmun ($50 in chips) 
Franky77200 will be allowed to play after the button
matiko09: posts small blind $0.25
Bailey Dew: is sitting out 
desmo465: posts big blind $0.50
matiko09: posts the ante $0.10
desmo465: posts the ante $0.10
TheMinion: posts the ante $0.10
funXmun: posts the ante $0.10
*** HOLE CARDS ***
Dealt to matiko09 [2s 8s]
TheMinion: folds 
funXmun: folds 
matiko09: folds 
Uncalled bet ($0.25) returned to desmo465
desmo465 collected $0.90 from pot
*** SUMMARY ***
Total pot $0.90 | Rake $0 
Seat 4: matiko09 (small blind) folded before Flop
Seat 7: desmo465 (big blind) collected ($0.90)
Seat 8: TheMinion folded before Flop (didn't bet)
Seat 9: funXmun (button) folded before Flop (didn't bet)





PokerStars Hand #155379881173:  Hold'em No Limit ($0.50/$1.00 USD) - 2016/06/30 13:44:13 CET [2016/06/30 7:44:13 ET]
Table 'Asmodeus' 9-max Seat #7 is the button
Seat 1: scollop ($112.20 in chips) 
Seat 2: picka4u ($35.77 in chips) 
Seat 3: matiko09 ($103.75 in chips) 
Seat 4: ardo888 ($135.28 in chips) 
Seat 5: sanr23 ($100 in chips) 
Seat 6: koutani7 ($92.50 in chips) 
Seat 7: aaronzzr ($153.29 in chips) 
Seat 8: Rafaello18 ($150.95 in chips) 
Seat 9: mbk88 ($157.68 in chips) 
Rafaello18: posts small blind $0.50
mbk88: posts big blind $1
*** HOLE CARDS ***
Dealt to matiko09 [3d 4c]
scollop: folds 
picka4u: raises $1.25 to $2.25
matiko09: folds 
ardo888: folds 
sanr23: folds 
koutani7: folds 
aaronzzr: calls $2.25
Rafaello18: folds 
mbk88: folds 
*** FLOP *** [Th 4d Kh]
picka4u: bets $3
aaronzzr: folds 
Uncalled bet ($3) returned to picka4u
picka4u collected $5.70 from pot
picka4u: doesn't show hand 
*** SUMMARY ***
Total pot $6 | Rake $0.30 
Board [Th 4d Kh]
Seat 1: scollop folded before Flop (didn't bet)
Seat 2: picka4u collected ($5.70)
Seat 3: matiko09 folded before Flop (didn't bet)
Seat 4: ardo888 folded before Flop (didn't bet)
Seat 5: sanr23 folded before Flop (didn't bet)
Seat 6: koutani7 folded before Flop (didn't bet)
Seat 7: aaronzzr (button) folded on the Flop
Seat 8: Rafaello18 (small blind) folded before Flop
Seat 9: mbk88 (big blind) folded before Flop





PokerStars Hand #155379881479:  Hold'em No Limit ($0.50/$1.00 USD) - 2016/06/30 13:44:13 CET [2016/06/30 7:44:13 ET]
Table 'Eucharis' 9-max Seat #4 is the button
Seat 2: sanr23 ($128.28 in chips) 
Seat 3: ramzes160468 ($126.02 in chips) 
Seat 4: mbk88 ($100 in chips) 
Seat 5: Rafaello18 ($100.50 in chips) 
Seat 6: matiko09 ($102.62 in chips) 
Seat 7: DIMAN_324 ($101.15 in chips) 
Seat 8: anfisa.irk ($42.65 in chips) 
Rafaello18: posts small blind $0.50
matiko09: posts big blind $1
picka4u: sits out 
*** HOLE CARDS ***
Dealt to matiko09 [3s 6c]
DIMAN_324: folds 
anfisa.irk: folds 
sanr23: folds 
ramzes160468: raises $2 to $3
mbk88: folds 
Rafaello18: folds 
matiko09: folds 
Uncalled bet ($2) returned to ramzes160468
ramzes160468 collected $2.50 from pot
*** SUMMARY ***
Total pot $2.50 | Rake $0 
Seat 2: sanr23 folded before Flop (didn't bet)
Seat 3: ramzes160468 collected ($2.50)
Seat 4: mbk88 (button) folded before Flop (didn't bet)
Seat 5: Rafaello18 (small blind) folded before Flop
Seat 6: matiko09 (big blind) folded before Flop
Seat 7: DIMAN_324 folded before Flop (didn't bet)
Seat 8: anfisa.irk folded before Flop (didn't bet)





PokerStars Hand #155379881202:  Hold'em No Limit ($0.50/$1.00 USD) - 2016/06/30 13:44:13 CET [2016/06/30 7:44:13 ET]
Table 'Prieska' 9-max Seat #9 is the button
Seat 1: KovIFish89 ($119.09 in chips) 
Seat 2: B_style_cuz ($87.28 in chips) 
Seat 3: Rafaello18 ($125.50 in chips) 
Seat 4: matteo080613 ($50 in chips) 
Seat 5: ramzes160468 ($87.02 in chips) 
Seat 6: DIMAN_324 ($104 in chips) 
Seat 7: matiko09 ($111.47 in chips) 
Seat 8: mbk88 ($100 in chips) 
Seat 9: picka4u ($38.33 in chips) 
KovIFish89: posts small blind $0.50
B_style_cuz: posts big blind $1
*** HOLE CARDS ***
Dealt to matiko09 [6h Ks]
Rafaello18: folds 
matteo080613: raises $1 to $2
ramzes160468: folds 
DIMAN_324: folds 
matiko09: folds 
mbk88: folds 
picka4u: raises $5 to $7
KovIFish89: folds 
B_style_cuz: folds 
matteo080613: calls $5
*** FLOP *** [8s 9s 8c]
matteo080613: checks 
picka4u: bets $6
matteo080613: folds 
Uncalled bet ($6) returned to picka4u
picka4u collected $14.72 from pot
picka4u: doesn't show hand 
*** SUMMARY ***
Total pot $15.50 | Rake $0.78 
Board [8s 9s 8c]
Seat 1: KovIFish89 (small blind) folded before Flop
Seat 2: B_style_cuz (big blind) folded before Flop
Seat 3: Rafaello18 folded before Flop (didn't bet)
Seat 4: matteo080613 folded on the Flop
Seat 5: ramzes160468 folded before Flop (didn't bet)
Seat 6: DIMAN_324 folded before Flop (didn't bet)
Seat 7: matiko09 folded before Flop (didn't bet)
Seat 8: mbk88 folded before Flop (didn't bet)
Seat 9: picka4u (button) collected ($14.72)





PokerStars Hand #155379885044:  Hold'em No Limit ($0.50/$1.00 USD) - 2016/06/30 13:44:22 CET [2016/06/30 7:44:22 ET]
Table 'California II' 9-max Seat #8 is the button
Seat 1: Rafaello18 ($113.02 in chips) 
Seat 3: liakos120 ($84.59 in chips) 
Seat 4: mbk88 ($118.54 in chips) 
Seat 5: Rohitbarve ($98.86 in chips) 
Seat 6: matiko09 ($127.35 in chips) 
Seat 7: DomiVY ($85.70 in chips) 
Seat 8: picka4u ($41.50 in chips) 
Rafaello18: posts small blind $0.50
liakos120: posts big blind $1
*** HOLE CARDS ***
Dealt to matiko09 [6c 3c]
mbk88: folds 
Rohitbarve: folds 
matiko09: folds 
DomiVY: folds 
picka4u: raises $1.05 to $2.05
Rafaello18: folds 
liakos120: calls $1.05
*** FLOP *** [7c Kd 4d]
liakos120: checks 
picka4u: bets $3
liakos120: folds 
Uncalled bet ($3) returned to picka4u
picka4u collected $4.37 from pot
picka4u: doesn't show hand 
*** SUMMARY ***
Total pot $4.60 | Rake $0.23 
Board [7c Kd 4d]
Seat 1: Rafaello18 (small blind) folded before Flop
Seat 3: liakos120 (big blind) folded on the Flop
Seat 4: mbk88 folded before Flop (didn't bet)
Seat 5: Rohitbarve folded before Flop (didn't bet)
Seat 6: matiko09 folded before Flop (didn't bet)
Seat 7: DomiVY folded before Flop (didn't bet)
Seat 8: picka4u (button) collected ($4.37)





PokerStars Hand #155379885519:  Hold'em No Limit ($0.25/$0.50 USD) - 2016/06/30 13:44:23 CET [2016/06/30 7:44:23 ET]
Table 'Dorothea II' 9-max Seat #4 is the button
Seat 4: matiko09 ($75.81 in chips) 
Seat 7: desmo465 ($50.55 in chips) 
Seat 8: TheMinion ($50 in chips) 
Seat 9: funXmun ($50 in chips) 
Bailey Dew will be allowed to play after the button
ivan100886 will be allowed to play after the button
desmo465: posts small blind $0.25
TheMinion: posts big blind $0.50
Franky77200: sits out 
matiko09: posts the ante $0.10
desmo465: posts the ante $0.10
TheMinion: posts the ante $0.10
funXmun: posts the ante $0.10
*** HOLE CARDS ***
Dealt to matiko09 [Jd 3d]
funXmun: raises $0.75 to $1.25
matiko09: folds 
desmo465: folds 
TheMinion: folds 
Uncalled bet ($0.75) returned to funXmun
funXmun collected $1.65 from pot
funXmun: doesn't show hand 
*** SUMMARY ***
Total pot $1.65 | Rake $0 
Seat 4: matiko09 (button) folded before Flop (didn't bet)
Seat 7: desmo465 (small blind) folded before Flop
Seat 8: TheMinion (big blind) folded before Flop
Seat 9: funXmun collected ($1.65)





PokerStars Hand #155379888279:  Hold'em No Limit ($0.50/$1.00 USD) - 2016/06/30 13:44:29 CET [2016/06/30 7:44:29 ET]
Table 'Borrelly II' 9-max Seat #8 is the button
Seat 1: Rafaello18 ($110.82 in chips) 
Seat 2: tipner ($103.22 in chips) 
Seat 4: DonRon_AT ($41.81 in chips) 
Seat 5: DIMAN_324 ($101.50 in chips) 
Seat 6: m_michalec ($170.38 in chips) 
Seat 7: matiko09 ($155.85 in chips) 
Seat 8: Arjun A Raju ($100 in chips) 
Seat 9: alhill86 ($79 in chips) 
alhill86: posts small blind $0.50
Rafaello18: posts big blind $1
*** HOLE CARDS ***
Dealt to matiko09 [3d Tc]
tipner: raises $2 to $3
DonRon_AT: folds 
DIMAN_324: folds 
m_michalec: folds 
matiko09: folds 
Arjun A Raju: folds 
alhill86: folds 
Rafaello18: folds 
Uncalled bet ($2) returned to tipner
tipner collected $2.50 from pot
tipner: doesn't show hand 
*** SUMMARY ***
Total pot $2.50 | Rake $0 
Seat 1: Rafaello18 (big blind) folded before Flop
Seat 2: tipner collected ($2.50)
Seat 4: DonRon_AT folded before Flop (didn't bet)
Seat 5: DIMAN_324 folded before Flop (didn't bet)
Seat 6: m_michalec folded before Flop (didn't bet)
Seat 7: matiko09 folded before Flop (didn't bet)
Seat 8: Arjun A Raju (button) folded before Flop (didn't bet)
Seat 9: alhill86 (small blind) folded before Flop





PokerStars Hand #155379892593:  Hold'em No Limit ($0.50/$1.00 USD) - 2016/06/30 13:44:39 CET [2016/06/30 7:44:39 ET]
Table 'Armisticia' 9-max Seat #2 is the button
Seat 2: atlant244 ($81.93 in chips) 
Seat 3: KovIFish89 ($101.50 in chips) 
Seat 4: ardo888 ($100 in chips) 
Seat 5: SonerWPT ($99 in chips) 
Seat 6: matiko09 ($122.80 in chips) 
Seat 7: ilaviiitech ($100 in chips) 
Seat 8: techahn ($129.66 in chips) 
Seat 9: mbk88 ($116.83 in chips) 
KovIFish89: posts small blind $0.50
ardo888: posts big blind $1
tipner: sits out 
*** HOLE CARDS ***
Dealt to matiko09 [Jd Ts]
SonerWPT: folds 
matiko09: folds 
ilaviiitech: raises $2 to $3
techahn: folds 
mbk88: folds 
atlant244: folds 
KovIFish89: folds 
ardo888: folds 
Uncalled bet ($2) returned to ilaviiitech
ilaviiitech collected $2.50 from pot
ilaviiitech: doesn't show hand 
*** SUMMARY ***
Total pot $2.50 | Rake $0 
Seat 2: atlant244 (button) folded before Flop (didn't bet)
Seat 3: KovIFish89 (small blind) folded before Flop
Seat 4: ardo888 (big blind) folded before Flop
Seat 5: SonerWPT folded before Flop (didn't bet)
Seat 6: matiko09 folded before Flop (didn't bet)
Seat 7: ilaviiitech collected ($2.50)
Seat 8: techahn folded before Flop (didn't bet)
Seat 9: mbk88 folded before Flop (didn't bet)





PokerStars Hand #155379893218:  Hold'em No Limit ($0.25/$0.50 USD) - 2016/06/30 13:44:41 CET [2016/06/30 7:44:41 ET]
Table 'Dorothea II' 9-max Seat #7 is the button
Seat 4: matiko09 ($75.71 in chips) 
Seat 7: desmo465 ($50.20 in chips) 
Seat 8: TheMinion ($50 in chips) 
Seat 9: funXmun ($51.05 in chips) 
TheMinion: posts small blind $0.25
funXmun: posts big blind $0.50
Franky77200: sits out 
Bailey Dew: sits out 
ivan100886: sits out 
matiko09: posts the ante $0.10
desmo465: posts the ante $0.10
TheMinion: posts the ante $0.10
funXmun: posts the ante $0.10
*** HOLE CARDS ***
Dealt to matiko09 [As 8d]
matiko09: raises $0.75 to $1.25
desmo465: folds 
TheMinion: folds 
funXmun: folds 
Uncalled bet ($0.75) returned to matiko09
matiko09 collected $1.65 from pot
matiko09: doesn't show hand 
*** SUMMARY ***
Total pot $1.65 | Rake $0 
Seat 4: matiko09 collected ($1.65)
Seat 7: desmo465 (button) folded before Flop (didn't bet)
Seat 8: TheMinion (small blind) folded before Flop
Seat 9: funXmun (big blind) folded before Flop





PokerStars Hand #155379893587:  Hold'em No Limit ($0.25/$0.50 USD) - 2016/06/30 13:44:42 CET [2016/06/30 7:44:42 ET]
Table 'Elektra II' 9-max Seat #3 is the button
Seat 1: drlee77 ($48.78 in chips) 
Seat 2: TheMinion ($63.32 in chips) 
Seat 3: mojtabagol ($66.96 in chips) 
Seat 4: matiko09 ($60.03 in chips) 
Seat 5: Rafaello18 ($59.99 in chips) 
Seat 6: pfunkolstar ($50 in chips) 
Seat 8: sanr23 ($50.89 in chips) 
Seat 9: Dantistcopra ($52.10 in chips) 
matiko09: posts small blind $0.25
Rafaello18: posts big blind $0.50
*** HOLE CARDS ***
Dealt to matiko09 [2s Qc]
pfunkolstar: folds 
sanr23: folds 
Dantistcopra: folds 
drlee77: folds 
TheMinion: folds 
mojtabagol: raises $0.50 to $1
matiko09: folds 
Rafaello18: folds 
Uncalled bet ($0.50) returned to mojtabagol
mojtabagol collected $1.25 from pot
*** SUMMARY ***
Total pot $1.25 | Rake $0 
Seat 1: drlee77 folded before Flop (didn't bet)
Seat 2: TheMinion folded before Flop (didn't bet)
Seat 3: mojtabagol (button) collected ($1.25)
Seat 4: matiko09 (small blind) folded before Flop
Seat 5: Rafaello18 (big blind) folded before Flop
Seat 6: pfunkolstar folded before Flop (didn't bet)
Seat 8: sanr23 folded before Flop (didn't bet)
Seat 9: Dantistcopra folded before Flop (didn't bet)





PokerStars Hand #155379894113:  Hold'em No Limit ($0.50/$1.00 USD) - 2016/06/30 13:44:43 CET [2016/06/30 7:44:43 ET]
Table 'Eucharis' 9-max Seat #5 is the button
Seat 2: sanr23 ($128.28 in chips) 
Seat 3: ramzes160468 ($127.52 in chips) 
Seat 4: mbk88 ($100 in chips) 
Seat 5: Rafaello18 ($100 in chips) 
Seat 6: matiko09 ($101.62 in chips) 
Seat 8: anfisa.irk ($42.65 in chips) 
matiko09: posts small blind $0.50
DIMAN_324: is sitting out 
anfisa.irk: posts big blind $1
picka4u: sits out 
*** HOLE CARDS ***
Dealt to matiko09 [5c 8s]
sanr23: folds 
ramzes160468: folds 
DIMAN_324 leaves the table
mbk88: folds 
Rafaello18: raises $1.50 to $2.50
matiko09: folds 
anfisa.irk: folds 
Uncalled bet ($1.50) returned to Rafaello18
Rafaello18 collected $2.50 from pot
Rafaello18: doesn't show hand 
*** SUMMARY ***
Total pot $2.50 | Rake $0 
Seat 2: sanr23 folded before Flop (didn't bet)
Seat 3: ramzes160468 folded before Flop (didn't bet)
Seat 4: mbk88 folded before Flop (didn't bet)
Seat 5: Rafaello18 (button) collected ($2.50)
Seat 6: matiko09 (small blind) folded before Flop
Seat 8: anfisa.irk (big blind) folded before Flop





PokerStars Hand #155379896347:  Hold'em No Limit ($0.50/$1.00 USD) - 2016/06/30 13:44:48 CET [2016/06/30 7:44:48 ET]
Table 'Asmodeus' 9-max Seat #8 is the button
Seat 1: scollop ($112.20 in chips) 
Seat 2: picka4u ($39.22 in chips) 
Seat 3: matiko09 ($103.75 in chips) 
Seat 4: ardo888 ($135.28 in chips) 
Seat 5: sanr23 ($100 in chips) 
Seat 6: koutani7 ($92.50 in chips) 
Seat 7: aaronzzr ($151.04 in chips) 
Seat 8: Rafaello18 ($150.45 in chips) 
Seat 9: mbk88 ($156.68 in chips) 
mbk88: posts small blind $0.50
scollop: posts big blind $1
*** HOLE CARDS ***
Dealt to matiko09 [3d Ad]
picka4u: folds 
matiko09: folds 
ardo888: folds 
sanr23: folds 
koutani7: folds 
aaronzzr: raises $1 to $2
Rafaello18: folds 
mbk88: folds 
scollop: folds 
Uncalled bet ($1) returned to aaronzzr
aaronzzr collected $2.50 from pot
aaronzzr: doesn't show hand 
*** SUMMARY ***
Total pot $2.50 | Rake $0 
Seat 1: scollop (big blind) folded before Flop
Seat 2: picka4u folded before Flop (didn't bet)
Seat 3: matiko09 folded before Flop (didn't bet)
Seat 4: ardo888 folded before Flop (didn't bet)
Seat 5: sanr23 folded before Flop (didn't bet)
Seat 6: koutani7 folded before Flop (didn't bet)
Seat 7: aaronzzr collected ($2.50)
Seat 8: Rafaello18 (button) folded before Flop (didn't bet)
Seat 9: mbk88 (small blind) folded before Flop





PokerStars Hand #155379897298:  Hold'em No Limit ($0.50/$1.00 USD) - 2016/06/30 13:44:51 CET [2016/06/30 7:44:51 ET]
Table 'Borrelly II' 9-max Seat #9 is the button
Seat 1: Rafaello18 ($109.82 in chips) 
Seat 4: DonRon_AT ($41.81 in chips) 
Seat 5: DIMAN_324 ($101.50 in chips) 
Seat 6: m_michalec ($170.38 in chips) 
Seat 7: matiko09 ($155.85 in chips) 
Seat 8: Arjun A Raju ($100 in chips) 
Seat 9: alhill86 ($78.50 in chips) 
Rafaello18: posts small blind $0.50
tipner: is sitting out 
DonRon_AT: posts big blind $1
*** HOLE CARDS ***
Dealt to matiko09 [9h Kc]
tipner leaves the table
mbk88 joins the table at seat #2 
DIMAN_324: folds 
m_michalec: folds 
matiko09: folds 
Arjun A Raju: folds 
alhill86: folds 
Rafaello18: folds 
Uncalled bet ($0.50) returned to DonRon_AT
DonRon_AT collected $1 from pot
*** SUMMARY ***
Total pot $1 | Rake $0 
Seat 1: Rafaello18 (small blind) folded before Flop
Seat 4: DonRon_AT (big blind) collected ($1)
Seat 5: DIMAN_324 folded before Flop (didn't bet)
Seat 6: m_michalec folded before Flop (didn't bet)
Seat 7: matiko09 folded before Flop (didn't bet)
Seat 8: Arjun A Raju folded before Flop (didn't bet)
Seat 9: alhill86 (button) folded before Flop (didn't bet)





PokerStars Hand #155379898074:  Hold'em No Limit ($0.50/$1.00 USD) - 2016/06/30 13:44:52 CET [2016/06/30 7:44:52 ET]
Table 'California II' 9-max Seat #1 is the button
Seat 1: Rafaello18 ($112.52 in chips) 
Seat 3: liakos120 ($82.54 in chips) 
Seat 4: mbk88 ($118.54 in chips) 
Seat 5: Rohitbarve ($98.86 in chips) 
Seat 6: matiko09 ($127.35 in chips) 
Seat 7: DomiVY ($85.70 in chips) 
Seat 8: picka4u ($43.82 in chips) 
liakos120: posts small blind $0.50
mbk88: posts big blind $1
*** HOLE CARDS ***
Dealt to matiko09 [8c 5d]
Rohitbarve: folds 
matiko09: folds 
DomiVY: folds 
picka4u: folds 
kaanzai joins the table at seat #2 
Rafaello18: raises $1.50 to $2.50
liakos120: folds 
mbk88: folds 
Uncalled bet ($1.50) returned to Rafaello18
Rafaello18 collected $2.50 from pot
Rafaello18: doesn't show hand 
*** SUMMARY ***
Total pot $2.50 | Rake $0 
Seat 1: Rafaello18 (button) collected ($2.50)
Seat 3: liakos120 (small blind) folded before Flop
Seat 4: mbk88 (big blind) folded before Flop
Seat 5: Rohitbarve folded before Flop (didn't bet)
Seat 6: matiko09 folded before Flop (didn't bet)
Seat 7: DomiVY folded before Flop (didn't bet)
Seat 8: picka4u folded before Flop (didn't bet)





PokerStars Hand #155379898695:  Hold'em No Limit ($0.50/$1.00 USD) - 2016/06/30 13:44:54 CET [2016/06/30 7:44:54 ET]
Table 'Prieska' 9-max Seat #1 is the button
Seat 1: KovIFish89 ($118.59 in chips) 
Seat 2: B_style_cuz ($86.28 in chips) 
Seat 3: Rafaello18 ($125.50 in chips) 
Seat 4: matteo080613 ($43 in chips) 
Seat 5: ramzes160468 ($87.02 in chips) 
Seat 6: DIMAN_324 ($104 in chips) 
Seat 7: matiko09 ($111.47 in chips) 
Seat 8: mbk88 ($100 in chips) 
Seat 9: picka4u ($46.05 in chips) 
B_style_cuz: posts small blind $0.50
Rafaello18: posts big blind $1
*** HOLE CARDS ***
Dealt to matiko09 [2s 4d]
matteo080613: folds 
ramzes160468: folds 
DIMAN_324: folds 
matiko09: folds 
mbk88: folds 
picka4u: raises $1.25 to $2.25
KovIFish89: folds 
B_style_cuz: raises $5.75 to $8
Rafaello18: folds 
picka4u: folds 
Uncalled bet ($5.75) returned to B_style_cuz
B_style_cuz collected $5.50 from pot
*** SUMMARY ***
Total pot $5.50 | Rake $0 
Seat 1: KovIFish89 (button) folded before Flop (didn't bet)
Seat 2: B_style_cuz (small blind) collected ($5.50)
Seat 3: Rafaello18 (big blind) folded before Flop
Seat 4: matteo080613 folded before Flop (didn't bet)
Seat 5: ramzes160468 folded before Flop (didn't bet)
Seat 6: DIMAN_324 folded before Flop (didn't bet)
Seat 7: matiko09 folded before Flop (didn't bet)
Seat 8: mbk88 folded before Flop (didn't bet)
Seat 9: picka4u folded before Flop





PokerStars Hand #155379899748:  Hold'em No Limit ($0.25/$0.50 USD) - 2016/06/30 13:44:56 CET [2016/06/30 7:44:56 ET]
Table 'Dorothea II' 9-max Seat #8 is the button
Seat 3: Franky77200 ($86.23 in chips) 
Seat 4: matiko09 ($76.76 in chips) 
Seat 7: desmo465 ($50.10 in chips) 
Seat 8: TheMinion ($50 in chips) 
Seat 9: funXmun ($50.45 in chips) 
funXmun: posts small blind $0.25
Franky77200: posts big blind $0.50
Bailey Dew: sits out 
ivan100886: sits out 
Franky77200: posts the ante $0.10
matiko09: posts the ante $0.10
desmo465: posts the ante $0.10
TheMinion: posts the ante $0.10
funXmun: posts the ante $0.10
*** HOLE CARDS ***
Dealt to matiko09 [3c 3h]
matiko09: raises $1 to $1.50
desmo465: calls $1.50
TheMinion: folds 
funXmun: folds 
Franky77200: calls $1
*** FLOP *** [As Th 8c]
Franky77200: checks 
matiko09: checks 
desmo465: checks 
*** TURN *** [As Th 8c] [4h]
Franky77200: bets $4
hotterflush1 joins the table at seat #2 
matiko09: folds 
desmo465: folds 
Uncalled bet ($4) returned to Franky77200
Franky77200 collected $4.99 from pot
Franky77200: doesn't show hand 
*** SUMMARY ***
Total pot $5.25 | Rake $0.26 
Board [As Th 8c 4h]
Seat 3: Franky77200 (big blind) collected ($4.99)
Seat 4: matiko09 folded on the Turn
Seat 7: desmo465 folded on the Turn
Seat 8: TheMinion (button) folded before Flop (didn't bet)
Seat 9: funXmun (small blind) folded before Flop





PokerStars Hand #155379901468:  Hold'em No Limit ($0.50/$1.00 USD) - 2016/06/30 13:45:00 CET [2016/06/30 7:45:00 ET]
Table 'Armisticia' 9-max Seat #3 is the button
Seat 2: atlant244 ($81.93 in chips) 
Seat 3: KovIFish89 ($101 in chips) 
Seat 4: ardo888 ($100 in chips) 
Seat 5: SonerWPT ($99 in chips) 
Seat 6: matiko09 ($122.80 in chips) 
Seat 7: ilaviiitech ($101.50 in chips) 
Seat 8: techahn ($129.66 in chips) 
Seat 9: mbk88 ($116.83 in chips) 
ardo888: posts small blind $0.50
SonerWPT: posts big blind $1
tipner: sits out 
*** HOLE CARDS ***
Dealt to matiko09 [8c 4c]
matiko09: folds 
ilaviiitech: folds 
techahn: raises $2 to $3
mbk88: folds 
atlant244: calls $3
KovIFish89: folds 
ardo888: folds 
SonerWPT: folds 
*** FLOP *** [2h 4h Ts]
techahn: checks 
atlant244: bets $4
techahn: calls $4
*** TURN *** [2h 4h Ts] [Jc]
techahn: checks 
atlant244: checks 
*** RIVER *** [2h 4h Ts Jc] [Qd]
techahn: checks 
atlant244: checks 
*** SHOW DOWN ***
techahn: shows [Js Ac] (a pair of Jacks)
atlant244: mucks hand 
techahn collected $14.72 from pot
*** SUMMARY ***
Total pot $15.50 | Rake $0.78 
Board [2h 4h Ts Jc Qd]
Seat 2: atlant244 mucked [9s Ah]
Seat 3: KovIFish89 (button) folded before Flop (didn't bet)
Seat 4: ardo888 (small blind) folded before Flop
Seat 5: SonerWPT (big blind) folded before Flop
Seat 6: matiko09 folded before Flop (didn't bet)
Seat 7: ilaviiitech folded before Flop (didn't bet)
Seat 8: techahn showed [Js Ac] and won ($14.72) with a pair of Jacks
Seat 9: mbk88 folded before Flop (didn't bet)





PokerStars Hand #155379903540:  Hold'em No Limit ($0.50/$1.00 USD) - 2016/06/30 13:45:05 CET [2016/06/30 7:45:05 ET]
Table 'Tatjana' 9-max Seat #8 is the button
Seat 1: ardo888 ($124.96 in chips) 
Seat 2: DIMAN_324 ($101.50 in chips) 
Seat 3: Rafaello18 ($100 in chips) 
Seat 5: matiko09 ($100 in chips) 
Seat 6: mbk88 ($135.10 in chips) 
Seat 8: alhill86 ($113.33 in chips) 
Seat 9: POTAPENKO700 ($141.71 in chips) 
POTAPENKO700: posts small blind $0.50
ardo888: posts big blind $1
daigodisco: sits out 
*** HOLE CARDS ***
Dealt to matiko09 [Ah 2h]
DIMAN_324: raises $2 to $3
Rafaello18: folds 
matiko09: folds 
mbk88: folds 
alhill86: folds 
POTAPENKO700: folds 
ardo888: folds 
Uncalled bet ($2) returned to DIMAN_324
DIMAN_324 collected $2.50 from pot
DIMAN_324: doesn't show hand 
*** SUMMARY ***
Total pot $2.50 | Rake $0 
Seat 1: ardo888 (big blind) folded before Flop
Seat 2: DIMAN_324 collected ($2.50)
Seat 3: Rafaello18 folded before Flop (didn't bet)
Seat 5: matiko09 folded before Flop (didn't bet)
Seat 6: mbk88 folded before Flop (didn't bet)
Seat 8: alhill86 (button) folded before Flop (didn't bet)
Seat 9: POTAPENKO700 (small blind) folded before Flop





PokerStars Hand #155379904305:  Hold'em No Limit ($0.50/$1.00 USD) - 2016/06/30 13:45:07 CET [2016/06/30 7:45:07 ET]
Table 'Altarf II' 9-max Seat #5 is the button
Seat 1: thecurv ($107.97 in chips) 
Seat 2: KovIFish89 ($100 in chips) 
Seat 3: sanr23 ($138.93 in chips) 
Seat 4: Greha999 ($83.66 in chips) 
Seat 5: DIMAN_324 ($100 in chips) 
Seat 6: mbk88 ($100.05 in chips) 
Seat 7: matiko09 ($107.72 in chips) 
Seat 9: omanibemihum ($100 in chips) 
mbk88: posts small blind $0.50
matiko09: posts big blind $1
DomiVY: sits out 
*** HOLE CARDS ***
Dealt to matiko09 [2d 5c]
omanibemihum: raises $1 to $2
thecurv: folds 
KovIFish89: folds 
sanr23: calls $2
Greha999: calls $2
DIMAN_324: folds 
mbk88: folds 
matiko09: folds 
*** FLOP *** [Ac 6s 7c]
omanibemihum: checks 
sanr23: bets $4.12
Greha999: folds 
omanibemihum is disconnected 
omanibemihum is connected 
omanibemihum: folds 
Uncalled bet ($4.12) returned to sanr23
sanr23 collected $7.12 from pot
sanr23: doesn't show hand 
*** SUMMARY ***
Total pot $7.50 | Rake $0.38 
Board [Ac 6s 7c]
Seat 1: thecurv folded before Flop (didn't bet)
Seat 2: KovIFish89 folded before Flop (didn't bet)
Seat 3: sanr23 collected ($7.12)
Seat 4: Greha999 folded on the Flop
Seat 5: DIMAN_324 (button) folded before Flop (didn't bet)
Seat 6: mbk88 (small blind) folded before Flop
Seat 7: matiko09 (big blind) folded before Flop
Seat 9: omanibemihum folded on the Flop





PokerStars Hand #155379906864:  Hold'em No Limit ($0.50/$1.00 USD) - 2016/06/30 13:45:13 CET [2016/06/30 7:45:13 ET]
Table 'Eucharis' 9-max Seat #6 is the button
Seat 1: picka4u ($64.19 in chips) 
Seat 2: sanr23 ($128.28 in chips) 
Seat 3: ramzes160468 ($127.52 in chips) 
Seat 4: mbk88 ($100 in chips) 
Seat 5: Rafaello18 ($101.50 in chips) 
Seat 6: matiko09 ($101.12 in chips) 
Seat 8: anfisa.irk ($41.65 in chips) 
anfisa.irk: posts small blind $0.50
picka4u: posts big blind $1
*** HOLE CARDS ***
Dealt to matiko09 [8d 9c]
sanr23: folds 
ramzes160468: folds 
mbk88: raises $2 to $3
Rafaello18: folds 
matiko09: folds 
anfisa.irk: folds 
picka4u: folds 
Uncalled bet ($2) returned to mbk88
mbk88 collected $2.50 from pot
mbk88: doesn't show hand 
*** SUMMARY ***
Total pot $2.50 | Rake $0 
Seat 1: picka4u (big blind) folded before Flop
Seat 2: sanr23 folded before Flop (didn't bet)
Seat 3: ramzes160468 folded before Flop (didn't bet)
Seat 4: mbk88 collected ($2.50)
Seat 5: Rafaello18 folded before Flop (didn't bet)
Seat 6: matiko09 (button) folded before Flop (didn't bet)
Seat 8: anfisa.irk (small blind) folded before Flop





PokerStars Hand #155379908094:  Hold'em No Limit ($0.50/$1.00 USD) - 2016/06/30 13:45:16 CET [2016/06/30 7:45:16 ET]
Table 'Borrelly II' 9-max Seat #1 is the button
Seat 1: Rafaello18 ($109.32 in chips) 
Seat 4: DonRon_AT ($42.31 in chips) 
Seat 5: DIMAN_324 ($101.50 in chips) 
Seat 6: m_michalec ($170.38 in chips) 
Seat 7: matiko09 ($155.85 in chips) 
Seat 8: Arjun A Raju ($100 in chips) 
Seat 9: alhill86 ($78.50 in chips) 
mbk88 will be allowed to play after the button
DonRon_AT: posts small blind $0.50
DIMAN_324: posts big blind $1
*** HOLE CARDS ***
Dealt to matiko09 [4c Th]
m_michalec: folds 
matiko09: folds 
Arjun A Raju: folds 
alhill86: folds 
Rafaello18: raises $1.50 to $2.50
DonRon_AT: calls $2
DIMAN_324: folds 
*** FLOP *** [2d 8d 4h]
DonRon_AT: checks 
Rafaello18: bets $2.90
DonRon_AT: folds 
Uncalled bet ($2.90) returned to Rafaello18
Rafaello18 collected $5.70 from pot
Rafaello18: doesn't show hand 
*** SUMMARY ***
Total pot $6 | Rake $0.30 
Board [2d 8d 4h]
Seat 1: Rafaello18 (button) collected ($5.70)
Seat 4: DonRon_AT (small blind) folded on the Flop
Seat 5: DIMAN_324 (big blind) folded before Flop
Seat 6: m_michalec folded before Flop (didn't bet)
Seat 7: matiko09 folded before Flop (didn't bet)
Seat 8: Arjun A Raju folded before Flop (didn't bet)
Seat 9: alhill86 folded before Flop (didn't bet)





PokerStars Hand #155379908722:  Hold'em No Limit ($0.25/$0.50 USD) - 2016/06/30 13:45:17 CET [2016/06/30 7:45:17 ET]
Table 'Elektra II' 9-max Seat #4 is the button
Seat 1: drlee77 ($48.78 in chips) 
Seat 2: TheMinion ($63.32 in chips) 
Seat 3: mojtabagol ($67.71 in chips) 
Seat 4: matiko09 ($59.78 in chips) 
Seat 5: Rafaello18 ($59.49 in chips) 
Seat 6: pfunkolstar ($50 in chips) 
Seat 8: sanr23 ($50.89 in chips) 
Seat 9: Dantistcopra ($52.10 in chips) 
Rafaello18: posts small blind $0.25
pfunkolstar: posts big blind $0.50
*** HOLE CARDS ***
Dealt to matiko09 [7h 3h]
sanr23: folds 
Dantistcopra: folds 
drlee77: folds 
TheMinion: folds 
mojtabagol: calls $0.50
matiko09: folds 
Rafaello18: folds 
pfunkolstar: raises $2.50 to $3
mojtabagol: folds 
Uncalled bet ($2.50) returned to pfunkolstar
pfunkolstar collected $1.25 from pot
pfunkolstar: doesn't show hand 
*** SUMMARY ***
Total pot $1.25 | Rake $0 
Seat 1: drlee77 folded before Flop (didn't bet)
Seat 2: TheMinion folded before Flop (didn't bet)
Seat 3: mojtabagol folded before Flop
Seat 4: matiko09 (button) folded before Flop (didn't bet)
Seat 5: Rafaello18 (small blind) folded before Flop
Seat 6: pfunkolstar (big blind) collected ($1.25)
Seat 8: sanr23 folded before Flop (didn't bet)
Seat 9: Dantistcopra folded before Flop (didn't bet)





PokerStars Hand #155379911914:  Hold'em No Limit ($0.50/$1.00 USD) - 2016/06/30 13:45:24 CET [2016/06/30 7:45:24 ET]
Table 'Asmodeus' 9-max Seat #9 is the button
Seat 1: scollop ($111.20 in chips) 
Seat 2: picka4u ($39.22 in chips) 
Seat 3: matiko09 ($103.75 in chips) 
Seat 4: ardo888 ($135.28 in chips) 
Seat 5: sanr23 ($100 in chips) 
Seat 6: koutani7 ($92.50 in chips) 
Seat 7: aaronzzr ($152.54 in chips) 
Seat 8: Rafaello18 ($150.45 in chips) 
Seat 9: mbk88 ($156.18 in chips) 
scollop: posts small blind $0.50
picka4u: posts big blind $1
*** HOLE CARDS ***
Dealt to matiko09 [9c 8s]
matiko09: folds 
ardo888: raises $2 to $3
sanr23: folds 
koutani7: folds 
aaronzzr: folds 
Rafaello18: folds 
mbk88: folds 
scollop: folds 
picka4u: folds 
Uncalled bet ($2) returned to ardo888
ardo888 collected $2.50 from pot
ardo888: doesn't show hand 
*** SUMMARY ***
Total pot $2.50 | Rake $0 
Seat 1: scollop (small blind) folded before Flop
Seat 2: picka4u (big blind) folded before Flop
Seat 3: matiko09 folded before Flop (didn't bet)
Seat 4: ardo888 collected ($2.50)
Seat 5: sanr23 folded before Flop (didn't bet)
Seat 6: koutani7 folded before Flop (didn't bet)
Seat 7: aaronzzr folded before Flop (didn't bet)
Seat 8: Rafaello18 folded before Flop (didn't bet)
Seat 9: mbk88 (button) folded before Flop (didn't bet)





PokerStars Hand #155379912308:  Hold'em No Limit ($0.50/$1.00 USD) - 2016/06/30 13:45:25 CET [2016/06/30 7:45:25 ET]
Table 'Tatjana' 9-max Seat #9 is the button
Seat 1: ardo888 ($123.96 in chips) 
Seat 2: DIMAN_324 ($103 in chips) 
Seat 3: Rafaello18 ($100 in chips) 
Seat 5: matiko09 ($100 in chips) 
Seat 6: mbk88 ($135.10 in chips) 
Seat 8: alhill86 ($113.33 in chips) 
Seat 9: POTAPENKO700 ($141.21 in chips) 
ardo888: posts small blind $0.50
DIMAN_324: posts big blind $1
daigodisco: sits out 
*** HOLE CARDS ***
Dealt to matiko09 [Td 2d]
Rafaello18: folds 
matiko09: folds 
mbk88: folds 
alhill86: folds 
POTAPENKO700: folds 
ardo888: folds 
Uncalled bet ($0.50) returned to DIMAN_324
DIMAN_324 collected $1 from pot
DIMAN_324: doesn't show hand 
*** SUMMARY ***
Total pot $1 | Rake $0 
Seat 1: ardo888 (small blind) folded before Flop
Seat 2: DIMAN_324 (big blind) collected ($1)
Seat 3: Rafaello18 folded before Flop (didn't bet)
Seat 5: matiko09 folded before Flop (didn't bet)
Seat 6: mbk88 folded before Flop (didn't bet)
Seat 8: alhill86 folded before Flop (didn't bet)
Seat 9: POTAPENKO700 (button) folded before Flop (didn't bet)





PokerStars Hand #155379912740:  Hold'em No Limit ($0.50/$1.00 USD) - 2016/06/30 13:45:26 CET [2016/06/30 7:45:26 ET]
Table 'California II' 9-max Seat #3 is the button
Seat 1: Rafaello18 ($114.02 in chips) 
Seat 2: kaanzai ($100 in chips) 
Seat 3: liakos120 ($82.04 in chips) 
Seat 4: mbk88 ($117.54 in chips) 
Seat 5: Rohitbarve ($98.86 in chips) 
Seat 6: matiko09 ($127.35 in chips) 
Seat 7: DomiVY ($85.70 in chips) 
Seat 8: picka4u ($43.82 in chips) 
mbk88: posts small blind $0.50
Rohitbarve: posts big blind $1
kaanzai: posts big blind $1
*** HOLE CARDS ***
Dealt to matiko09 [3d Tc]
matiko09: folds 
DomiVY: folds 
picka4u: folds 
Rafaello18: folds 
kaanzai: checks 
liakos120: folds 
mbk88: folds 
Rohitbarve: checks 
*** FLOP *** [As Ah Kc]
Rohitbarve: checks 
kaanzai: checks 
*** TURN *** [As Ah Kc] [Ad]
Rohitbarve: bets $1
kaanzai: folds 
Uncalled bet ($1) returned to Rohitbarve
Rohitbarve collected $2.38 from pot
Rohitbarve: doesn't show hand 
*** SUMMARY ***
Total pot $2.50 | Rake $0.12 
Board [As Ah Kc Ad]
Seat 1: Rafaello18 folded before Flop (didn't bet)
Seat 2: kaanzai folded on the Turn
Seat 3: liakos120 (button) folded before Flop (didn't bet)
Seat 4: mbk88 (small blind) folded before Flop
Seat 5: Rohitbarve (big blind) collected ($2.38)
Seat 6: matiko09 folded before Flop (didn't bet)
Seat 7: DomiVY folded before Flop (didn't bet)
Seat 8: picka4u folded before Flop (didn't bet)





PokerStars Hand #155379914566:  Hold'em No Limit ($0.25/$0.50 USD) - 2016/06/30 13:45:31 CET [2016/06/30 7:45:31 ET]
Table 'Dorothea II' 9-max Seat #9 is the button
Seat 3: Franky77200 ($89.62 in chips) 
Seat 4: matiko09 ($75.16 in chips) 
Seat 7: desmo465 ($48.50 in chips) 
Seat 8: TheMinion ($50 in chips) 
Seat 9: funXmun ($50.10 in chips) 
hotterflush1 will be allowed to play after the button
Franky77200: posts small blind $0.25
matiko09: posts big blind $0.50
Bailey Dew: sits out 
ivan100886: sits out 
Franky77200: posts the ante $0.10
matiko09: posts the ante $0.10
desmo465: posts the ante $0.10
TheMinion: posts the ante $0.10
funXmun: posts the ante $0.10
*** HOLE CARDS ***
Dealt to matiko09 [Kc 7c]
desmo465: folds 
TheMinion: folds 
funXmun: raises $0.90 to $1.40
Franky77200: folds 
matiko09: calls $0.90
*** FLOP *** [3h Th 8s]
matiko09: checks 
funXmun: bets $1.71
matiko09: folds 
Uncalled bet ($1.71) returned to funXmun
funXmun collected $3.37 from pot
funXmun: doesn't show hand 
*** SUMMARY ***
Total pot $3.55 | Rake $0.18 
Board [3h Th 8s]
Seat 3: Franky77200 (small blind) folded before Flop
Seat 4: matiko09 (big blind) folded on the Flop
Seat 7: desmo465 folded before Flop (didn't bet)
Seat 8: TheMinion folded before Flop (didn't bet)
Seat 9: funXmun (button) collected ($3.37)





PokerStars Hand #155379916252:  Hold'em No Limit ($0.50/$1.00 USD) - 2016/06/30 13:45:34 CET [2016/06/30 7:45:34 ET]
Table 'Eucharis' 9-max Seat #8 is the button
Seat 1: picka4u ($63.19 in chips) 
Seat 2: sanr23 ($128.28 in chips) 
Seat 3: ramzes160468 ($127.52 in chips) 
Seat 4: mbk88 ($101.50 in chips) 
Seat 5: Rafaello18 ($101.50 in chips) 
Seat 6: matiko09 ($101.12 in chips) 
Seat 8: anfisa.irk ($41.15 in chips) 
picka4u: posts small blind $0.50
sanr23: posts big blind $1
*** HOLE CARDS ***
Dealt to matiko09 [Jc Qd]
ramzes160468: folds 
mbk88: folds 
Rafaello18: raises $1.50 to $2.50
matiko09: folds 
anfisa.irk: folds 
picka4u: folds 
sanr23: folds 
Uncalled bet ($1.50) returned to Rafaello18
Rafaello18 collected $2.50 from pot
Rafaello18: doesn't show hand 
*** SUMMARY ***
Total pot $2.50 | Rake $0 
Seat 1: picka4u (small blind) folded before Flop
Seat 2: sanr23 (big blind) folded before Flop
Seat 3: ramzes160468 folded before Flop (didn't bet)
Seat 4: mbk88 folded before Flop (didn't bet)
Seat 5: Rafaello18 collected ($2.50)
Seat 6: matiko09 folded before Flop (didn't bet)
Seat 8: anfisa.irk (button) folded before Flop (didn't bet)





PokerStars Hand #155379921655:  Hold'em No Limit ($0.50/$1.00 USD) - 2016/06/30 13:45:47 CET [2016/06/30 7:45:47 ET]
Table 'Tatjana' 9-max Seat #1 is the button
Seat 1: ardo888 ($123.46 in chips) 
Seat 2: DIMAN_324 ($103.50 in chips) 
Seat 3: Rafaello18 ($100 in chips) 
Seat 5: matiko09 ($100 in chips) 
Seat 6: mbk88 ($135.10 in chips) 
Seat 7: daigodisco ($40.63 in chips) 
Seat 8: alhill86 ($113.33 in chips) 
Seat 9: POTAPENKO700 ($141.21 in chips) 
DIMAN_324: posts small blind $0.50
Rafaello18: posts big blind $1
daigodisco: posts big blind $1
*** HOLE CARDS ***
Dealt to matiko09 [4s Ad]
matiko09: folds 
mopatron25 joins the table at seat #4 
mbk88: raises $3 to $4
daigodisco: folds 
alhill86: folds 
POTAPENKO700: folds 
ardo888: folds 
DIMAN_324: folds 
Rafaello18: folds 
Uncalled bet ($3) returned to mbk88
mbk88 collected $3.50 from pot
mbk88: doesn't show hand 
*** SUMMARY ***
Total pot $3.50 | Rake $0 
Seat 1: ardo888 (button) folded before Flop (didn't bet)
Seat 2: DIMAN_324 (small blind) folded before Flop
Seat 3: Rafaello18 (big blind) folded before Flop
Seat 5: matiko09 folded before Flop (didn't bet)
Seat 6: mbk88 collected ($3.50)
Seat 7: daigodisco folded before Flop
Seat 8: alhill86 folded before Flop (didn't bet)
Seat 9: POTAPENKO700 folded before Flop (didn't bet)





PokerStars Hand #155379923367:  Hold'em No Limit ($0.50/$1.00 USD) - 2016/06/30 13:45:51 CET [2016/06/30 7:45:51 ET]
Table 'Borrelly II' 9-max Seat #4 is the button
Seat 1: Rafaello18 ($112.52 in chips) 
Seat 4: DonRon_AT ($39.81 in chips) 
Seat 5: DIMAN_324 ($100.50 in chips) 
Seat 6: m_michalec ($170.38 in chips) 
Seat 7: matiko09 ($155.85 in chips) 
Seat 8: Arjun A Raju ($100 in chips) 
Seat 9: alhill86 ($78.50 in chips) 
DIMAN_324: posts small blind $0.50
m_michalec: posts big blind $1
mbk88: sits out 
*** HOLE CARDS ***
Dealt to matiko09 [9c Qh]
matiko09: folds 
Arjun A Raju: folds 
alhill86: folds 
Rafaello18: folds 
DonRon_AT: folds 
DIMAN_324: folds 
Uncalled bet ($0.50) returned to m_michalec
m_michalec collected $1 from pot
m_michalec: doesn't show hand 
*** SUMMARY ***
Total pot $1 | Rake $0 
Seat 1: Rafaello18 folded before Flop (didn't bet)
Seat 4: DonRon_AT (button) folded before Flop (didn't bet)
Seat 5: DIMAN_324 (small blind) folded before Flop
Seat 6: m_michalec (big blind) collected ($1)
Seat 7: matiko09 folded before Flop (didn't bet)
Seat 8: Arjun A Raju folded before Flop (didn't bet)
Seat 9: alhill86 folded before Flop (didn't bet)





PokerStars Hand #155379923575:  Hold'em No Limit ($0.50/$1.00 USD) - 2016/06/30 13:45:51 CET [2016/06/30 7:45:51 ET]
Table 'Asmodeus' 9-max Seat #1 is the button
Seat 1: scollop ($110.70 in chips) 
Seat 2: picka4u ($38.22 in chips) 
Seat 3: matiko09 ($103.75 in chips) 
Seat 4: ardo888 ($136.78 in chips) 
Seat 5: sanr23 ($100 in chips) 
Seat 6: koutani7 ($92.50 in chips) 
Seat 7: aaronzzr ($152.54 in chips) 
Seat 8: Rafaello18 ($150.45 in chips) 
Seat 9: mbk88 ($156.18 in chips) 
picka4u: posts small blind $0.50
matiko09: posts big blind $1
*** HOLE CARDS ***
Dealt to matiko09 [9s 4s]
ardo888: folds 
sanr23: folds 
koutani7: folds 
aaronzzr: calls $1
Rafaello18: folds 
mbk88: folds 
scollop: folds 
picka4u: raises $37.22 to $38.22 and is all-in
matiko09: folds 
aaronzzr: folds 
Uncalled bet ($37.22) returned to picka4u
picka4u collected $3 from pot
picka4u: doesn't show hand 
*** SUMMARY ***
Total pot $3 | Rake $0 
Seat 1: scollop (button) folded before Flop (didn't bet)
Seat 2: picka4u (small blind) collected ($3)
Seat 3: matiko09 (big blind) folded before Flop
Seat 4: ardo888 folded before Flop (didn't bet)
Seat 5: sanr23 folded before Flop (didn't bet)
Seat 6: koutani7 folded before Flop (didn't bet)
Seat 7: aaronzzr folded before Flop
Seat 8: Rafaello18 folded before Flop (didn't bet)
Seat 9: mbk88 folded before Flop (didn't bet)





PokerStars Hand #155379923947:  Hold'em No Limit ($0.50/$1.00 USD) - 2016/06/30 13:45:52 CET [2016/06/30 7:45:52 ET]
Table 'Eucharis' 9-max Seat #1 is the button
Seat 1: picka4u ($62.69 in chips) 
Seat 2: sanr23 ($127.28 in chips) 
Seat 3: ramzes160468 ($127.52 in chips) 
Seat 4: mbk88 ($101.50 in chips) 
Seat 5: Rafaello18 ($103 in chips) 
Seat 6: matiko09 ($101.12 in chips) 
Seat 8: anfisa.irk ($41.15 in chips) 
sanr23: posts small blind $0.50
ramzes160468: posts big blind $1
*** HOLE CARDS ***
Dealt to matiko09 [9c 8h]
mbk88: folds 
Rafaello18: raises $1.50 to $2.50
matiko09: folds 
anfisa.irk: folds 
picka4u: folds 
sanr23: folds 
ramzes160468: folds 
Uncalled bet ($1.50) returned to Rafaello18
Rafaello18 collected $2.50 from pot
Rafaello18: doesn't show hand 
*** SUMMARY ***
Total pot $2.50 | Rake $0 
Seat 1: picka4u (button) folded before Flop (didn't bet)
Seat 2: sanr23 (small blind) folded before Flop
Seat 3: ramzes160468 (big blind) folded before Flop
Seat 4: mbk88 folded before Flop (didn't bet)
Seat 5: Rafaello18 collected ($2.50)
Seat 6: matiko09 folded before Flop (didn't bet)
Seat 8: anfisa.irk folded before Flop (didn't bet)





PokerStars Hand #155379924288:  Hold'em No Limit ($0.50/$1.00 USD) - 2016/06/30 13:45:53 CET [2016/06/30 7:45:53 ET]
Table 'Prieska' 9-max Seat #2 is the button
Seat 1: KovIFish89 ($118.59 in chips) 
Seat 2: B_style_cuz ($89.53 in chips) 
Seat 3: Rafaello18 ($124.50 in chips) 
Seat 5: ramzes160468 ($87.02 in chips) 
Seat 6: DIMAN_324 ($104 in chips) 
Seat 7: matiko09 ($111.47 in chips) 
Seat 8: mbk88 ($100 in chips) 
Seat 9: picka4u ($43.80 in chips) 
Rafaello18: posts small blind $0.50
matteo080613: is sitting out 
ramzes160468: posts big blind $1
*** HOLE CARDS ***
Dealt to matiko09 [4h Tc]
DIMAN_324: folds 
matiko09: folds 
mbk88: folds 
picka4u: folds 
KovIFish89: folds 
B_style_cuz: folds 
Rafaello18: raises $1.50 to $2.50
ramzes160468: folds 
Uncalled bet ($1.50) returned to Rafaello18
Rafaello18 collected $2 from pot
Rafaello18: doesn't show hand 
*** SUMMARY ***
Total pot $2 | Rake $0 
Seat 1: KovIFish89 folded before Flop (didn't bet)
Seat 2: B_style_cuz (button) folded before Flop (didn't bet)
Seat 3: Rafaello18 (small blind) collected ($2)
Seat 5: ramzes160468 (big blind) folded before Flop
Seat 6: DIMAN_324 folded before Flop (didn't bet)
Seat 7: matiko09 folded before Flop (didn't bet)
Seat 8: mbk88 folded before Flop (didn't bet)
Seat 9: picka4u folded before Flop (didn't bet)





PokerStars Hand #155379925598:  Hold'em No Limit ($0.25/$0.50 USD) - 2016/06/30 13:45:56 CET [2016/06/30 7:45:56 ET]
Table 'Elektra II' 9-max Seat #5 is the button
Seat 1: drlee77 ($48.78 in chips) 
Seat 2: TheMinion ($63.32 in chips) 
Seat 3: mojtabagol ($67.21 in chips) 
Seat 4: matiko09 ($59.78 in chips) 
Seat 5: Rafaello18 ($59.24 in chips) 
Seat 6: pfunkolstar ($50.75 in chips) 
Seat 7: MuddyDance ($49.25 in chips) 
Seat 8: sanr23 ($50.89 in chips) 
Seat 9: Dantistcopra ($52.10 in chips) 
pfunkolstar: posts small blind $0.25
MuddyDance: posts big blind $0.50
*** HOLE CARDS ***
Dealt to matiko09 [7s 7d]
sanr23: folds 
Dantistcopra: folds 
drlee77: folds 
TheMinion: folds 
mojtabagol: raises $1 to $1.50
matiko09: calls $1.50
Rafaello18: folds 
pfunkolstar: folds 
MuddyDance: folds 
*** FLOP *** [3s Ks 5d]
mojtabagol: bets $3.56
matiko09: calls $3.56
*** TURN *** [3s Ks 5d] [6c]
mojtabagol: bets $9
matiko09: folds 
Uncalled bet ($9) returned to mojtabagol
mojtabagol collected $10.33 from pot
*** SUMMARY ***
Total pot $10.87 | Rake $0.54 
Board [3s Ks 5d 6c]
Seat 1: drlee77 folded before Flop (didn't bet)
Seat 2: TheMinion folded before Flop (didn't bet)
Seat 3: mojtabagol collected ($10.33)
Seat 4: matiko09 folded on the Turn
Seat 5: Rafaello18 (button) folded before Flop (didn't bet)
Seat 6: pfunkolstar (small blind) folded before Flop
Seat 7: MuddyDance (big blind) folded before Flop
Seat 8: sanr23 folded before Flop (didn't bet)
Seat 9: Dantistcopra folded before Flop (didn't bet)





PokerStars Hand #155379932784:  Hold'em No Limit ($0.50/$1.00 USD) - 2016/06/30 13:46:13 CET [2016/06/30 7:46:13 ET]
Table 'Armisticia' 9-max Seat #4 is the button
Seat 2: atlant244 ($74.93 in chips) 
Seat 3: KovIFish89 ($101 in chips) 
Seat 4: ardo888 ($100 in chips) 
Seat 5: SonerWPT ($98 in chips) 
Seat 6: matiko09 ($122.80 in chips) 
Seat 7: ilaviiitech ($101.50 in chips) 
Seat 8: techahn ($137.38 in chips) 
Seat 9: mbk88 ($116.83 in chips) 
SonerWPT: posts small blind $0.50
matiko09: posts big blind $1
tipner: sits out 
*** HOLE CARDS ***
Dealt to matiko09 [5c 8h]
ilaviiitech: folds 
techahn: folds 
mbk88: folds 
atlant244: folds 
KovIFish89: folds 
ardo888: raises $1.50 to $2.50
SonerWPT: raises $4.50 to $7
matiko09: folds 
ardo888: calls $4.50
*** FLOP *** [5s 2s Jd]
SonerWPT: bets $8
ardo888: folds 
Uncalled bet ($8) returned to SonerWPT
SonerWPT collected $14.25 from pot
SonerWPT: doesn't show hand 
*** SUMMARY ***
Total pot $15 | Rake $0.75 
Board [5s 2s Jd]
Seat 2: atlant244 folded before Flop (didn't bet)
Seat 3: KovIFish89 folded before Flop (didn't bet)
Seat 4: ardo888 (button) folded on the Flop
Seat 5: SonerWPT (small blind) collected ($14.25)
Seat 6: matiko09 (big blind) folded before Flop
Seat 7: ilaviiitech folded before Flop (didn't bet)
Seat 8: techahn folded before Flop (didn't bet)
Seat 9: mbk88 folded before Flop (didn't bet)





PokerStars Hand #155379932655:  Hold'em No Limit ($0.50/$1.00 USD) - 2016/06/30 13:46:13 CET [2016/06/30 7:46:13 ET]
Table 'California II' 9-max Seat #4 is the button
Seat 1: Rafaello18 ($114.02 in chips) 
Seat 2: kaanzai ($99 in chips) 
Seat 3: liakos120 ($82.04 in chips) 
Seat 4: mbk88 ($117.04 in chips) 
Seat 5: Rohitbarve ($100.24 in chips) 
Seat 6: matiko09 ($127.35 in chips) 
Seat 7: DomiVY ($85.70 in chips) 
Seat 8: picka4u ($43.82 in chips) 
Rohitbarve: posts small blind $0.50
matiko09: posts big blind $1
*** HOLE CARDS ***
Dealt to matiko09 [3h Qc]
DomiVY: raises $2 to $3
picka4u: folds 
Rafaello18: folds 
kaanzai: folds 
liakos120: folds 
mbk88: folds 
Rohitbarve: folds 
matiko09: folds 
Uncalled bet ($2) returned to DomiVY
DomiVY collected $2.50 from pot
DomiVY: doesn't show hand 
*** SUMMARY ***
Total pot $2.50 | Rake $0 
Seat 1: Rafaello18 folded before Flop (didn't bet)
Seat 2: kaanzai folded before Flop (didn't bet)
Seat 3: liakos120 folded before Flop (didn't bet)
Seat 4: mbk88 (button) folded before Flop (didn't bet)
Seat 5: Rohitbarve (small blind) folded before Flop
Seat 6: matiko09 (big blind) folded before Flop
Seat 7: DomiVY collected ($2.50)
Seat 8: picka4u folded before Flop (didn't bet)





PokerStars Hand #155379934690:  Hold'em No Limit ($0.25/$0.50 USD) - 2016/06/30 13:46:17 CET [2016/06/30 7:46:17 ET]
Table 'Dorothea II' 9-max Seat #3 is the button
Seat 2: hotterflush1 ($40 in chips) 
Seat 3: Franky77200 ($89.27 in chips) 
Seat 4: matiko09 ($73.66 in chips) 
Seat 5: Bailey Dew ($89.50 in chips) 
Seat 7: desmo465 ($48.40 in chips) 
Seat 8: TheMinion ($50 in chips) 
Seat 9: funXmun ($51.97 in chips) 
matiko09: posts small blind $0.25
Bailey Dew: posts big blind $0.50
ivan100886: sits out 
hotterflush1: posts big blind $0.50
hotterflush1: posts the ante $0.10
Franky77200: posts the ante $0.10
matiko09: posts the ante $0.10
Bailey Dew: posts the ante $0.10
desmo465: posts the ante $0.10
TheMinion: posts the ante $0.10
funXmun: posts the ante $0.10
*** HOLE CARDS ***
Dealt to matiko09 [2c 7c]
desmo465: folds 
TheMinion: folds 
funXmun: folds 
hotterflush1: raises $0.50 to $1
zapata 7777 joins the table at seat #1 
Franky77200: calls $1
matiko09: folds 
Bailey Dew: calls $0.50
*** FLOP *** [2d Qh 3h]
Bailey Dew: checks 
hotterflush1: bets $0.50
Franky77200: raises $3 to $3.50
Bailey Dew: folds 
hotterflush1: folds 
Uncalled bet ($3) returned to Franky77200
Franky77200 collected $4.70 from pot
Franky77200: doesn't show hand 
*** SUMMARY ***
Total pot $4.95 | Rake $0.25 
Board [2d Qh 3h]
Seat 2: hotterflush1 folded on the Flop
Seat 3: Franky77200 (button) collected ($4.70)
Seat 4: matiko09 (small blind) folded before Flop
Seat 5: Bailey Dew (big blind) folded on the Flop
Seat 7: desmo465 folded before Flop (didn't bet)
Seat 8: TheMinion folded before Flop (didn't bet)
Seat 9: funXmun folded before Flop (didn't bet)





PokerStars Hand #155379934877:  Hold'em No Limit ($0.50/$1.00 USD) - 2016/06/30 13:46:18 CET [2016/06/30 7:46:18 ET]
Table 'Prieska' 9-max Seat #3 is the button
Seat 1: KovIFish89 ($118.59 in chips) 
Seat 2: B_style_cuz ($89.53 in chips) 
Seat 3: Rafaello18 ($125.50 in chips) 
Seat 5: ramzes160468 ($86.02 in chips) 
Seat 6: DIMAN_324 ($104 in chips) 
Seat 7: matiko09 ($111.47 in chips) 
Seat 8: mbk88 ($100 in chips) 
Seat 9: picka4u ($43.80 in chips) 
ramzes160468: posts small blind $0.50
DIMAN_324: posts big blind $1
*** HOLE CARDS ***
Dealt to matiko09 [9s Qh]
matiko09: folds 
mbk88: folds 
picka4u: folds 
KovIFish89: folds 
B_style_cuz: folds 
Rafaello18: folds 
ramzes160468: raises $1 to $2
DIMAN_324: folds 
Uncalled bet ($1) returned to ramzes160468
ramzes160468 collected $2 from pot
*** SUMMARY ***
Total pot $2 | Rake $0 
Seat 1: KovIFish89 folded before Flop (didn't bet)
Seat 2: B_style_cuz folded before Flop (didn't bet)
Seat 3: Rafaello18 (button) folded before Flop (didn't bet)
Seat 5: ramzes160468 (small blind) collected ($2)
Seat 6: DIMAN_324 (big blind) folded before Flop
Seat 7: matiko09 folded before Flop (didn't bet)
Seat 8: mbk88 folded before Flop (didn't bet)
Seat 9: picka4u folded before Flop (didn't bet)





PokerStars Hand #155379935800:  Hold'em No Limit ($0.50/$1.00 USD) - 2016/06/30 13:46:20 CET [2016/06/30 7:46:20 ET]
Table 'Borrelly II' 9-max Seat #5 is the button
Seat 1: Rafaello18 ($112.52 in chips) 
Seat 4: DonRon_AT ($39.81 in chips) 
Seat 5: DIMAN_324 ($100 in chips) 
Seat 6: m_michalec ($170.88 in chips) 
Seat 7: matiko09 ($155.85 in chips) 
Seat 8: Arjun A Raju ($100 in chips) 
Seat 9: alhill86 ($78.50 in chips) 
m_michalec: posts small blind $0.50
matiko09: posts big blind $1
mbk88: sits out 
*** HOLE CARDS ***
Dealt to matiko09 [6c Ad]
Arjun A Raju: folds 
alhill86: folds 
Rafaello18: folds 
DonRon_AT: folds 
DIMAN_324: folds 
m_michalec: raises $2 to $3
matiko09: calls $2
*** FLOP *** [8h 4s 9s]
m_michalec: checks 
matiko09: checks 
*** TURN *** [8h 4s 9s] [2h]
m_michalec: checks 
matiko09: checks 
*** RIVER *** [8h 4s 9s 2h] [4h]
m_michalec: checks 
matiko09: checks 
*** SHOW DOWN ***
m_michalec: shows [5h 5c] (two pair, Fives and Fours)
matiko09: mucks hand 
m_michalec collected $5.70 from pot
*** SUMMARY ***
Total pot $6 | Rake $0.30 
Board [8h 4s 9s 2h 4h]
Seat 1: Rafaello18 folded before Flop (didn't bet)
Seat 4: DonRon_AT folded before Flop (didn't bet)
Seat 5: DIMAN_324 (button) folded before Flop (didn't bet)
Seat 6: m_michalec (small blind) showed [5h 5c] and won ($5.70) with two pair, Fives and Fours
Seat 7: matiko09 (big blind) mucked [6c Ad]
Seat 8: Arjun A Raju folded before Flop (didn't bet)
Seat 9: alhill86 folded before Flop (didn't bet)





PokerStars Hand #155379936449:  Hold'em No Limit ($0.50/$1.00 USD) - 2016/06/30 13:46:21 CET [2016/06/30 7:46:21 ET]
Table 'Tatjana' 9-max Seat #2 is the button
Seat 1: ardo888 ($123.46 in chips) 
Seat 2: DIMAN_324 ($103 in chips) 
Seat 3: Rafaello18 ($100 in chips) 
Seat 4: mopatron25 ($68.78 in chips) 
Seat 5: matiko09 ($100 in chips) 
Seat 6: mbk88 ($137.60 in chips) 
Seat 7: daigodisco ($39.63 in chips) 
Seat 8: alhill86 ($113.33 in chips) 
Seat 9: POTAPENKO700 ($141.21 in chips) 
Rafaello18: posts small blind $0.50
mopatron25: posts big blind $1
*** HOLE CARDS ***
Dealt to matiko09 [2s 2d]
matiko09: folds 
mbk88: folds 
daigodisco: folds 
alhill86: raises $2 to $3
POTAPENKO700: folds 
ardo888: folds 
DIMAN_324: folds 
Rafaello18: folds 
mopatron25: calls $2
*** FLOP *** [5d Qd 5s]
mopatron25: bets $1
alhill86: calls $1
*** TURN *** [5d Qd 5s] [4s]
mopatron25: checks 
alhill86: bets $8.08
mopatron25: folds 
Uncalled bet ($8.08) returned to alhill86
alhill86 collected $8.08 from pot
alhill86: doesn't show hand 
*** SUMMARY ***
Total pot $8.50 | Rake $0.42 
Board [5d Qd 5s 4s]
Seat 1: ardo888 folded before Flop (didn't bet)
Seat 2: DIMAN_324 (button) folded before Flop (didn't bet)
Seat 3: Rafaello18 (small blind) folded before Flop
Seat 4: mopatron25 (big blind) folded on the Turn
Seat 5: matiko09 folded before Flop (didn't bet)
Seat 6: mbk88 folded before Flop (didn't bet)
Seat 7: daigodisco folded before Flop (didn't bet)
Seat 8: alhill86 collected ($8.08)
Seat 9: POTAPENKO700 folded before Flop (didn't bet)





PokerStars Hand #155379937554:  Hold'em No Limit ($0.50/$1.00 USD) - 2016/06/30 13:46:24 CET [2016/06/30 7:46:24 ET]
Table 'Eucharis' 9-max Seat #2 is the button
Seat 1: picka4u ($62.69 in chips) 
Seat 2: sanr23 ($126.78 in chips) 
Seat 3: ramzes160468 ($126.52 in chips) 
Seat 4: mbk88 ($101.50 in chips) 
Seat 5: Rafaello18 ($104.50 in chips) 
Seat 6: matiko09 ($101.12 in chips) 
Seat 8: anfisa.irk ($41.15 in chips) 
ramzes160468: posts small blind $0.50
mbk88: posts big blind $1
*** HOLE CARDS ***
Dealt to matiko09 [2h Th]
Rafaello18: folds 
matiko09: folds 
anfisa.irk: folds 
picka4u: folds 
sanr23: folds 
ramzes160468: folds 
Uncalled bet ($0.50) returned to mbk88
mbk88 collected $1 from pot
mbk88: doesn't show hand 
*** SUMMARY ***
Total pot $1 | Rake $0 
Seat 1: picka4u folded before Flop (didn't bet)
Seat 2: sanr23 (button) folded before Flop (didn't bet)
Seat 3: ramzes160468 (small blind) folded before Flop
Seat 4: mbk88 (big blind) collected ($1)
Seat 5: Rafaello18 folded before Flop (didn't bet)
Seat 6: matiko09 folded before Flop (didn't bet)
Seat 8: anfisa.irk folded before Flop (didn't bet)





PokerStars Hand #155379943075:  Hold'em No Limit ($0.50/$1.00 USD) - 2016/06/30 13:46:37 CET [2016/06/30 7:46:37 ET]
Table 'California II' 9-max Seat #5 is the button
Seat 1: Rafaello18 ($114.02 in chips) 
Seat 2: kaanzai ($99 in chips) 
Seat 3: liakos120 ($82.04 in chips) 
Seat 4: mbk88 ($117.04 in chips) 
Seat 5: Rohitbarve ($99.74 in chips) 
Seat 6: matiko09 ($126.35 in chips) 
Seat 7: DomiVY ($87.20 in chips) 
Seat 8: picka4u ($43.82 in chips) 
matiko09: posts small blind $0.50
DomiVY: posts big blind $1
*** HOLE CARDS ***
Dealt to matiko09 [6d 7d]
picka4u: folds 
Rafaello18: folds 
kaanzai: folds 
liakos120: folds 
mbk88: folds 
Rohitbarve: raises $2 to $3
matiko09: folds 
DomiVY: folds 
Uncalled bet ($2) returned to Rohitbarve
Rohitbarve collected $2.50 from pot
Rohitbarve: doesn't show hand 
*** SUMMARY ***
Total pot $2.50 | Rake $0 
Seat 1: Rafaello18 folded before Flop (didn't bet)
Seat 2: kaanzai folded before Flop (didn't bet)
Seat 3: liakos120 folded before Flop (didn't bet)
Seat 4: mbk88 folded before Flop (didn't bet)
Seat 5: Rohitbarve (button) collected ($2.50)
Seat 6: matiko09 (small blind) folded before Flop
Seat 7: DomiVY (big blind) folded before Flop
Seat 8: picka4u folded before Flop (didn't bet)





PokerStars Hand #155379945434:  Hold'em No Limit ($0.50/$1.00 USD) - 2016/06/30 13:46:43 CET [2016/06/30 7:46:43 ET]
Table 'Eucharis' 9-max Seat #3 is the button
Seat 1: picka4u ($62.69 in chips) 
Seat 2: sanr23 ($126.78 in chips) 
Seat 3: ramzes160468 ($126.02 in chips) 
Seat 4: mbk88 ($102 in chips) 
Seat 5: Rafaello18 ($104.50 in chips) 
Seat 6: matiko09 ($101.12 in chips) 
Seat 8: anfisa.irk ($41.15 in chips) 
mbk88: posts small blind $0.50
Rafaello18: posts big blind $1
*** HOLE CARDS ***
Dealt to matiko09 [Ks 7c]
korlito69 joins the table at seat #7 
matiko09: folds 
anfisa.irk: folds 
picka4u: raises $1.25 to $2.25
sanr23: calls $2.25
ramzes160468: calls $2.25
mbk88: folds 
Rafaello18: folds 
*** FLOP *** [Js 8d 3c]
picka4u: checks 
sanr23: checks 
ramzes160468: bets $5
picka4u: folds 
sanr23: folds 
Uncalled bet ($5) returned to ramzes160468
ramzes160468 collected $7.84 from pot
*** SUMMARY ***
Total pot $8.25 | Rake $0.41 
Board [Js 8d 3c]
Seat 1: picka4u folded on the Flop
Seat 2: sanr23 folded on the Flop
Seat 3: ramzes160468 (button) collected ($7.84)
Seat 4: mbk88 (small blind) folded before Flop
Seat 5: Rafaello18 (big blind) folded before Flop
Seat 6: matiko09 folded before Flop (didn't bet)
Seat 8: anfisa.irk folded before Flop (didn't bet)





PokerStars Hand #155379946838:  Hold'em No Limit ($0.25/$0.50 USD) - 2016/06/30 13:46:46 CET [2016/06/30 7:46:46 ET]
Table 'Elektra II' 9-max Seat #6 is the button
Seat 1: drlee77 ($48.78 in chips) 
Seat 2: TheMinion ($63.32 in chips) 
Seat 3: mojtabagol ($72.48 in chips) 
Seat 4: matiko09 ($54.72 in chips) 
Seat 5: Rafaello18 ($59.24 in chips) 
Seat 6: pfunkolstar ($50.50 in chips) 
Seat 7: MuddyDance ($48.75 in chips) 
Seat 8: sanr23 ($50.89 in chips) 
Seat 9: Dantistcopra ($52.10 in chips) 
MuddyDance: posts small blind $0.25
sanr23: posts big blind $0.50
*** HOLE CARDS ***
Dealt to matiko09 [8h Qd]
Dantistcopra: folds 
drlee77: folds 
TheMinion: folds 
mojtabagol: folds 
matiko09: folds 
Rafaello18: folds 
pfunkolstar: raises $0.50 to $1
MuddyDance: folds 
sanr23: calls $0.50
*** FLOP *** [4c 5h 8c]
sanr23: checks 
pfunkolstar: bets $1.50
sanr23: calls $1.50
*** TURN *** [4c 5h 8c] [5s]
sanr23: checks 
pfunkolstar: checks 
*** RIVER *** [4c 5h 8c 5s] [Ad]
sanr23: checks 
pfunkolstar: bets $3.50
sanr23: folds 
Uncalled bet ($3.50) returned to pfunkolstar
pfunkolstar collected $4.99 from pot
pfunkolstar: doesn't show hand 
*** SUMMARY ***
Total pot $5.25 | Rake $0.26 
Board [4c 5h 8c 5s Ad]
Seat 1: drlee77 folded before Flop (didn't bet)
Seat 2: TheMinion folded before Flop (didn't bet)
Seat 3: mojtabagol folded before Flop (didn't bet)
Seat 4: matiko09 folded before Flop (didn't bet)
Seat 5: Rafaello18 folded before Flop (didn't bet)
Seat 6: pfunkolstar (button) collected ($4.99)
Seat 7: MuddyDance (small blind) folded before Flop
Seat 8: sanr23 (big blind) folded on the River
Seat 9: Dantistcopra folded before Flop (didn't bet)





PokerStars Hand #155379947156:  Hold'em No Limit ($0.50/$1.00 USD) - 2016/06/30 13:46:47 CET [2016/06/30 7:46:47 ET]
Table 'Asmodeus' 9-max Seat #2 is the button
Seat 1: scollop ($110.70 in chips) 
Seat 2: picka4u ($40.22 in chips) 
Seat 3: matiko09 ($102.75 in chips) 
Seat 4: ardo888 ($136.78 in chips) 
Seat 5: sanr23 ($100 in chips) 
Seat 6: koutani7 ($92.50 in chips) 
Seat 7: aaronzzr ($151.54 in chips) 
Seat 8: Rafaello18 ($150.45 in chips) 
Seat 9: mbk88 ($156.18 in chips) 
matiko09: posts small blind $0.50
ardo888: posts big blind $1
*** HOLE CARDS ***
Dealt to matiko09 [7s Qc]
sanr23: folds 
koutani7: folds 
aaronzzr: folds 
Rafaello18: folds 
mbk88: folds 
scollop: calls $1
picka4u: raises $2.50 to $3.50
matiko09: folds 
ardo888: folds 
scollop: calls $2.50
*** FLOP *** [Ad 6s 6c]
scollop: checks 
picka4u: bets $4.50
scollop: folds 
Uncalled bet ($4.50) returned to picka4u
picka4u collected $8.08 from pot
picka4u: doesn't show hand 
*** SUMMARY ***
Total pot $8.50 | Rake $0.42 
Board [Ad 6s 6c]
Seat 1: scollop folded on the Flop
Seat 2: picka4u (button) collected ($8.08)
Seat 3: matiko09 (small blind) folded before Flop
Seat 4: ardo888 (big blind) folded before Flop
Seat 5: sanr23 folded before Flop (didn't bet)
Seat 6: koutani7 folded before Flop (didn't bet)
Seat 7: aaronzzr folded before Flop (didn't bet)
Seat 8: Rafaello18 folded before Flop (didn't bet)
Seat 9: mbk88 folded before Flop (didn't bet)





PokerStars Hand #155379948132:  Hold'em No Limit ($0.50/$1.00 USD) - 2016/06/30 13:46:49 CET [2016/06/30 7:46:49 ET]
Table 'Prieska' 9-max Seat #5 is the button
Seat 1: KovIFish89 ($118.59 in chips) 
Seat 2: B_style_cuz ($89.53 in chips) 
Seat 3: Rafaello18 ($125.50 in chips) 
Seat 5: ramzes160468 ($87.02 in chips) 
Seat 6: DIMAN_324 ($103 in chips) 
Seat 7: matiko09 ($111.47 in chips) 
Seat 8: mbk88 ($100 in chips) 
Seat 9: picka4u ($43.80 in chips) 
DIMAN_324: posts small blind $0.50
matiko09: posts big blind $1
*** HOLE CARDS ***
Dealt to matiko09 [Ac Kd]
mbk88: folds 
picka4u: folds 
KovIFish89: folds 
B_style_cuz: raises $2 to $3
Rafaello18: folds 
ramzes160468: folds 
DIMAN_324: folds 
matiko09: raises $7 to $10
B_style_cuz: calls $7
*** FLOP *** [9h 6h 6d]
matiko09: bets $6.03
B_style_cuz: raises $11.97 to $18
matiko09: folds 
Uncalled bet ($11.97) returned to B_style_cuz
B_style_cuz collected $30.93 from pot
*** SUMMARY ***
Total pot $32.56 | Rake $1.63 
Board [9h 6h 6d]
Seat 1: KovIFish89 folded before Flop (didn't bet)
Seat 2: B_style_cuz collected ($30.93)
Seat 3: Rafaello18 folded before Flop (didn't bet)
Seat 5: ramzes160468 (button) folded before Flop (didn't bet)
Seat 6: DIMAN_324 (small blind) folded before Flop
Seat 7: matiko09 (big blind) folded on the Flop
Seat 8: mbk88 folded before Flop (didn't bet)
Seat 9: picka4u folded before Flop (didn't bet)





PokerStars Hand #155379952143:  Hold'em No Limit ($0.50/$1.00 USD) - 2016/06/30 13:46:58 CET [2016/06/30 7:46:58 ET]
Table 'Borrelly II' 9-max Seat #6 is the button
Seat 1: Rafaello18 ($112.52 in chips) 
Seat 4: DonRon_AT ($39.81 in chips) 
Seat 5: DIMAN_324 ($100 in chips) 
Seat 6: m_michalec ($173.58 in chips) 
Seat 7: matiko09 ($152.85 in chips) 
Seat 8: Arjun A Raju ($100 in chips) 
Seat 9: alhill86 ($78.50 in chips) 
matiko09: posts small blind $0.50
Arjun A Raju: posts big blind $1
mbk88: sits out 
*** HOLE CARDS ***
Dealt to matiko09 [Qc Ac]
alhill86: folds 
Rafaello18: folds 
DonRon_AT: folds 
DIMAN_324: raises $1.40 to $2.40
m_michalec: folds 
matiko09: raises $6.60 to $9
Arjun A Raju: folds 
DIMAN_324: calls $6.60
*** FLOP *** [3d 2c 9h]
matiko09: bets $9.38
DIMAN_324: calls $9.38
*** TURN *** [3d 2c 9h] [Qh]
matiko09: bets $18.65
DIMAN_324: folds 
Uncalled bet ($18.65) returned to matiko09
matiko09 collected $35.87 from pot
matiko09: doesn't show hand 
*** SUMMARY ***
Total pot $37.76 | Rake $1.89 
Board [3d 2c 9h Qh]
Seat 1: Rafaello18 folded before Flop (didn't bet)
Seat 4: DonRon_AT folded before Flop (didn't bet)
Seat 5: DIMAN_324 folded on the Turn
Seat 6: m_michalec (button) folded before Flop (didn't bet)
Seat 7: matiko09 (small blind) collected ($35.87)
Seat 8: Arjun A Raju (big blind) folded before Flop
Seat 9: alhill86 folded before Flop (didn't bet)





PokerStars Hand #155379955741:  Hold'em No Limit ($0.50/$1.00 USD) - 2016/06/30 13:47:07 CET [2016/06/30 7:47:07 ET]
Table 'Armisticia' 9-max Seat #5 is the button
Seat 2: atlant244 ($74.93 in chips) 
Seat 3: KovIFish89 ($101 in chips) 
Seat 4: ardo888 ($100 in chips) 
Seat 5: SonerWPT ($105.25 in chips) 
Seat 6: matiko09 ($121.80 in chips) 
Seat 7: ilaviiitech ($101.50 in chips) 
Seat 8: techahn ($137.38 in chips) 
Seat 9: mbk88 ($116.83 in chips) 
matiko09: posts small blind $0.50
ilaviiitech: posts big blind $1
tipner: sits out 
*** HOLE CARDS ***
Dealt to matiko09 [Ah 3h]
techahn: calls $1
mbk88: folds 
atlant244: raises $1.50 to $2.50
KovIFish89: folds 
ardo888: folds 
SonerWPT: folds 
matiko09: folds 
ilaviiitech: folds 
techahn: calls $1.50
*** FLOP *** [Qs Qd 6d]
techahn: checks 
atlant244: bets $3.09
techahn: folds 
Uncalled bet ($3.09) returned to atlant244
atlant244 collected $6.18 from pot
atlant244: doesn't show hand 
*** SUMMARY ***
Total pot $6.50 | Rake $0.32 
Board [Qs Qd 6d]
Seat 2: atlant244 collected ($6.18)
Seat 3: KovIFish89 folded before Flop (didn't bet)
Seat 4: ardo888 folded before Flop (didn't bet)
Seat 5: SonerWPT (button) folded before Flop (didn't bet)
Seat 6: matiko09 (small blind) folded before Flop
Seat 7: ilaviiitech (big blind) folded before Flop
Seat 8: techahn folded on the Flop
Seat 9: mbk88 folded before Flop (didn't bet)





PokerStars Hand #155379956032:  Hold'em No Limit ($0.50/$1.00 USD) - 2016/06/30 13:47:07 CET [2016/06/30 7:47:07 ET]
Table 'Altarf II' 9-max Seat #6 is the button
Seat 1: thecurv ($107.97 in chips) 
Seat 2: KovIFish89 ($100 in chips) 
Seat 3: sanr23 ($144.05 in chips) 
Seat 4: Greha999 ($81.66 in chips) 
Seat 5: DIMAN_324 ($100 in chips) 
Seat 6: mbk88 ($100 in chips) 
Seat 7: matiko09 ($106.72 in chips) 
Seat 8: DomiVY ($40 in chips) 
Seat 9: omanibemihum ($98 in chips) 
matiko09: posts small blind $0.50
DomiVY: posts big blind $1
*** HOLE CARDS ***
Dealt to matiko09 [6s 5d]
omanibemihum: raises $1 to $2
thecurv: folds 
KovIFish89: raises $5.50 to $7.50
sanr23: folds 
Greha999: folds 
DIMAN_324: folds 
mbk88: calls $7.50
matiko09: folds 
DomiVY: folds 
omanibemihum: calls $5.50
*** FLOP *** [7s 2h 9d]
omanibemihum: checks 
KovIFish89: bets $11.40
mbk88: calls $11.40
omanibemihum: calls $11.40
*** TURN *** [7s 2h 9d] [Jh]
omanibemihum: checks 
KovIFish89: bets $28
mbk88: calls $28
omanibemihum: calls $28
*** RIVER *** [7s 2h 9d Jh] [Tc]
omanibemihum: checks 
KovIFish89: checks 
mbk88: bets $53.10 and is all-in
omanibemihum: folds 
KovIFish89: folds 
Uncalled bet ($53.10) returned to mbk88
mbk88 collected $139.70 from pot
mbk88: doesn't show hand 
*** SUMMARY ***
Total pot $142.20 | Rake $2.50 
Board [7s 2h 9d Jh Tc]
Seat 1: thecurv folded before Flop (didn't bet)
Seat 2: KovIFish89 folded on the River
Seat 3: sanr23 folded before Flop (didn't bet)
Seat 4: Greha999 folded before Flop (didn't bet)
Seat 5: DIMAN_324 folded before Flop (didn't bet)
Seat 6: mbk88 (button) collected ($139.70)
Seat 7: matiko09 (small blind) folded before Flop
Seat 8: DomiVY (big blind) folded before Flop
Seat 9: omanibemihum folded on the River





PokerStars Hand #155379956645:  Hold'em No Limit ($0.50/$1.00 USD) - 2016/06/30 13:47:09 CET [2016/06/30 7:47:09 ET]
Table 'California II' 9-max Seat #6 is the button
Seat 1: Rafaello18 ($114.02 in chips) 
Seat 2: kaanzai ($99 in chips) 
Seat 3: liakos120 ($82.04 in chips) 
Seat 4: mbk88 ($117.04 in chips) 
Seat 5: Rohitbarve ($101.24 in chips) 
Seat 6: matiko09 ($125.85 in chips) 
Seat 7: DomiVY ($86.20 in chips) 
Seat 8: picka4u ($43.82 in chips) 
DomiVY: posts small blind $0.50
picka4u: posts big blind $1
*** HOLE CARDS ***
Dealt to matiko09 [3h 8d]
Rafaello18: folds 
kaanzai: folds 
kaanzai leaves the table
liakos120: raises $2 to $3
mbk88: raises $6 to $9
Rohitbarve: folds 
matiko09: folds 
DomiVY: folds 
picka4u: folds 
liakos120: calls $6
*** FLOP *** [3s Ks Jh]
liakos120: bets $9.26
mbk88: raises $15.74 to $25
liakos120: calls $15.74
*** TURN *** [3s Ks Jh] [2h]
Konig26 joins the table at seat #2 
liakos120: bets $33.50
mbk88: raises $33.50 to $67
liakos120: calls $14.54 and is all-in
Uncalled bet ($18.96) returned to mbk88
*** RIVER *** [3s Ks Jh 2h] [3d]
*** SHOW DOWN ***
liakos120: shows [Kh As] (two pair, Kings and Threes)
mbk88: shows [Js Kc] (two pair, Kings and Jacks)
mbk88 collected $163.08 from pot
*** SUMMARY ***
Total pot $165.58 | Rake $2.50 
Board [3s Ks Jh 2h 3d]
Seat 1: Rafaello18 folded before Flop (didn't bet)
Seat 2: kaanzai folded before Flop (didn't bet)
Seat 3: liakos120 showed [Kh As] and lost with two pair, Kings and Threes
Seat 4: mbk88 showed [Js Kc] and won ($163.08) with two pair, Kings and Jacks
Seat 5: Rohitbarve folded before Flop (didn't bet)
Seat 6: matiko09 (button) folded before Flop (didn't bet)
Seat 7: DomiVY (small blind) folded before Flop
Seat 8: picka4u (big blind) folded before Flop





PokerStars Hand #155379957950:  Hold'em No Limit ($0.25/$0.50 USD) - 2016/06/30 13:47:12 CET [2016/06/30 7:47:12 ET]
Table 'Dorothea II' 9-max Seat #4 is the button
Seat 2: hotterflush1 ($38.40 in chips) 
Seat 3: Franky77200 ($92.37 in chips) 
Seat 4: matiko09 ($73.31 in chips) 
Seat 5: Bailey Dew ($88.40 in chips) 
Seat 6: ivan100886 ($27.96 in chips) 
Seat 7: desmo465 ($48.30 in chips) 
Seat 8: TheMinion ($50 in chips) 
Seat 9: funXmun ($51.87 in chips) 
Bailey Dew: posts small blind $0.25
ivan100886: posts big blind $0.50
zapata 7777: sits out 
hotterflush1: posts the ante $0.10
Franky77200: posts the ante $0.10
matiko09: posts the ante $0.10
Bailey Dew: posts the ante $0.10
ivan100886: posts the ante $0.10
desmo465: posts the ante $0.10
TheMinion: posts the ante $0.10
funXmun: posts the ante $0.10
*** HOLE CARDS ***
Dealt to matiko09 [5h Kh]
desmo465: folds 
TheMinion: folds 
funXmun: folds 
hotterflush1: calls $0.50
Franky77200: raises $1.50 to $2
matiko09: folds 
Bailey Dew: folds 
ivan100886: folds 
hotterflush1: calls $1.50
*** FLOP *** [8s 6c 8h]
hotterflush1: bets $0.50
Franky77200: calls $0.50
*** TURN *** [8s 6c 8h] [Th]
hotterflush1: bets $3
Franky77200: calls $3
*** RIVER *** [8s 6c 8h Th] [Jh]
hotterflush1: bets $12
Franky77200: raises $35.92 to $47.92
hotterflush1: calls $20.80 and is all-in
Uncalled bet ($15.12) returned to Franky77200
*** SHOW DOWN ***
Franky77200: shows [Tc 8d] (a full house, Eights full of Tens)
hotterflush1: shows [Ts Jc] (two pair, Jacks and Tens)
Franky77200 collected $76.15 from pot
*** SUMMARY ***
Total pot $78.15 | Rake $2 
Board [8s 6c 8h Th Jh]
Seat 2: hotterflush1 showed [Ts Jc] and lost with two pair, Jacks and Tens
Seat 3: Franky77200 showed [Tc 8d] and won ($76.15) with a full house, Eights full of Tens
Seat 4: matiko09 (button) folded before Flop (didn't bet)
Seat 5: Bailey Dew (small blind) folded before Flop
Seat 6: ivan100886 (big blind) folded before Flop
Seat 7: desmo465 folded before Flop (didn't bet)
Seat 8: TheMinion folded before Flop (didn't bet)
Seat 9: funXmun folded before Flop (didn't bet)





PokerStars Hand #155379957931:  Hold'em No Limit ($0.50/$1.00 USD) - 2016/06/30 13:47:12 CET [2016/06/30 7:47:12 ET]
Table 'Tatjana' 9-max Seat #3 is the button
Seat 1: ardo888 ($123.46 in chips) 
Seat 2: DIMAN_324 ($103 in chips) 
Seat 3: Rafaello18 ($100 in chips) 
Seat 4: mopatron25 ($64.78 in chips) 
Seat 5: matiko09 ($100 in chips) 
Seat 6: mbk88 ($137.60 in chips) 
Seat 7: daigodisco ($39.63 in chips) 
Seat 8: alhill86 ($117.41 in chips) 
Seat 9: POTAPENKO700 ($141.21 in chips) 
mopatron25: posts small blind $0.50
matiko09: posts big blind $1
*** HOLE CARDS ***
Dealt to matiko09 [Js Ad]
mbk88: folds 
daigodisco: folds 
alhill86: folds 
POTAPENKO700: folds 
ardo888: folds 
DIMAN_324: folds 
Rafaello18: raises $1.50 to $2.50
mopatron25: folds 
matiko09: calls $1.50
*** FLOP *** [Jc 8d 4h]
matiko09: checks 
Rafaello18: bets $3.50
matiko09: calls $3.50
*** TURN *** [Jc 8d 4h] [Qd]
matiko09: checks 
Rafaello18: checks 
*** RIVER *** [Jc 8d 4h Qd] [2s]
matiko09: bets $6.17
Rafaello18: folds 
Uncalled bet ($6.17) returned to matiko09
matiko09 collected $11.88 from pot
matiko09: doesn't show hand 
*** SUMMARY ***
Total pot $12.50 | Rake $0.62 
Board [Jc 8d 4h Qd 2s]
Seat 1: ardo888 folded before Flop (didn't bet)
Seat 2: DIMAN_324 folded before Flop (didn't bet)
Seat 3: Rafaello18 (button) folded on the River
Seat 4: mopatron25 (small blind) folded before Flop
Seat 5: matiko09 (big blind) collected ($11.88)
Seat 6: mbk88 folded before Flop (didn't bet)
Seat 7: daigodisco folded before Flop (didn't bet)
Seat 8: alhill86 folded before Flop (didn't bet)
Seat 9: POTAPENKO700 folded before Flop (didn't bet)





PokerStars Hand #155379962578:  Hold'em No Limit ($0.25/$0.50 USD) - 2016/06/30 13:47:23 CET [2016/06/30 7:47:23 ET]
Table 'Mentha II' 9-max Seat #7 is the button
Seat 1: Bailey Dew ($174.67 in chips) 
Seat 2: TheMinion ($50 in chips) 
Seat 4: 55peter1 ($76.93 in chips) 
Seat 5: maxxmeister ($50 in chips) 
Seat 6: IceyyF91x ($73.43 in chips) 
Seat 7: ardo888 ($74.67 in chips) 
Seat 8: drlee77 ($46.25 in chips) 
Seat 9: matiko09 ($52.41 in chips) 
drlee77: posts small blind $0.25
matiko09: posts big blind $0.50
Bailey Dew: posts the ante $0.10
TheMinion: posts the ante $0.10
55peter1: posts the ante $0.10
maxxmeister: posts the ante $0.10
IceyyF91x: posts the ante $0.10
ardo888: posts the ante $0.10
drlee77: posts the ante $0.10
matiko09: posts the ante $0.10
*** HOLE CARDS ***
Dealt to matiko09 [2h 4c]
Bailey Dew: folds 
TheMinion: folds 
Sushka87 leaves the table
55peter1: folds 
maxxmeister: folds 
IceyyF91x: raises $2 to $2.50
ardo888: calls $2.50
drlee77: folds 
matiko09: folds 
*** FLOP *** [Ts Ac Kc]
IceyyF91x: bets $3
ardo888: raises $6.35 to $9.35
IceyyF91x: calls $6.35
*** TURN *** [Ts Ac Kc] [7d]
IceyyF91x: checks 
ardo888: bets $15.59
IceyyF91x: raises $45.89 to $61.48 and is all-in
ardo888: calls $45.89
*** RIVER *** [Ts Ac Kc 7d] [Js]
*** SHOW DOWN ***
IceyyF91x: shows [Ah 8c] (a pair of Aces)
ardo888: shows [Kd Tc] (two pair, Kings and Tens)
ardo888 collected $146.21 from pot
*** SUMMARY ***
Total pot $148.21 | Rake $2 
Board [Ts Ac Kc 7d Js]
Seat 1: Bailey Dew folded before Flop (didn't bet)
Seat 2: TheMinion folded before Flop (didn't bet)
Seat 4: 55peter1 folded before Flop (didn't bet)
Seat 5: maxxmeister folded before Flop (didn't bet)
Seat 6: IceyyF91x showed [Ah 8c] and lost with a pair of Aces
Seat 7: ardo888 (button) showed [Kd Tc] and won ($146.21) with two pair, Kings and Tens
Seat 8: drlee77 (small blind) folded before Flop
Seat 9: matiko09 (big blind) folded before Flop





PokerStars Hand #155379966960:  Hold'em No Limit ($0.50/$1.00 USD) - 2016/06/30 13:47:33 CET [2016/06/30 7:47:33 ET]
Table 'Asmodeus' 9-max Seat #3 is the button
Seat 1: scollop ($107.20 in chips) 
Seat 2: picka4u ($44.80 in chips) 
Seat 3: matiko09 ($102.25 in chips) 
Seat 4: ardo888 ($135.78 in chips) 
Seat 5: sanr23 ($100 in chips) 
Seat 6: koutani7 ($92.50 in chips) 
Seat 7: aaronzzr ($151.54 in chips) 
Seat 8: Rafaello18 ($150.45 in chips) 
Seat 9: mbk88 ($156.18 in chips) 
ardo888: posts small blind $0.50
sanr23: posts big blind $1
*** HOLE CARDS ***
Dealt to matiko09 [9c 3s]
koutani7: folds 
aaronzzr: folds 
Rafaello18: raises $1.50 to $2.50
mbk88: folds 
scollop: folds 
picka4u: folds 
matiko09: folds 
ardo888: folds 
sanr23: folds 
Uncalled bet ($1.50) returned to Rafaello18
Rafaello18 collected $2.50 from pot
Rafaello18: doesn't show hand 
*** SUMMARY ***
Total pot $2.50 | Rake $0 
Seat 1: scollop folded before Flop (didn't bet)
Seat 2: picka4u folded before Flop (didn't bet)
Seat 3: matiko09 (button) folded before Flop (didn't bet)
Seat 4: ardo888 (small blind) folded before Flop
Seat 5: sanr23 (big blind) folded before Flop
Seat 6: koutani7 folded before Flop (didn't bet)
Seat 7: aaronzzr folded before Flop (didn't bet)
Seat 8: Rafaello18 collected ($2.50)
Seat 9: mbk88 folded before Flop (didn't bet)





PokerStars Hand #155379969990:  Hold'em No Limit ($0.50/$1.00 USD) - 2016/06/30 13:47:40 CET [2016/06/30 7:47:40 ET]
Table 'Armisticia' 9-max Seat #6 is the button
Seat 2: atlant244 ($78.61 in chips) 
Seat 3: KovIFish89 ($101 in chips) 
Seat 4: ardo888 ($100 in chips) 
Seat 5: SonerWPT ($105.25 in chips) 
Seat 6: matiko09 ($121.30 in chips) 
Seat 7: ilaviiitech ($100.50 in chips) 
Seat 8: techahn ($134.88 in chips) 
Seat 9: mbk88 ($116.83 in chips) 
ilaviiitech: posts small blind $0.50
techahn: posts big blind $1
tipner: sits out 
*** HOLE CARDS ***
Dealt to matiko09 [8h 4s]
mbk88: folds 
atlant244: folds 
KovIFish89: folds 
ardo888: raises $2 to $3
SonerWPT: folds 
matiko09: folds 
ilaviiitech: calls $2.50
techahn: calls $2
*** FLOP *** [3d 3s 9h]
ilaviiitech: checks 
techahn: checks 
ardo888: checks 
*** TURN *** [3d 3s 9h] [2h]
ilaviiitech: checks 
techahn: checks 
ardo888: bets $5.55
ilaviiitech: folds 
techahn: folds 
Uncalled bet ($5.55) returned to ardo888
ardo888 collected $8.55 from pot
ardo888: doesn't show hand 
*** SUMMARY ***
Total pot $9 | Rake $0.45 
Board [3d 3s 9h 2h]
Seat 2: atlant244 folded before Flop (didn't bet)
Seat 3: KovIFish89 folded before Flop (didn't bet)
Seat 4: ardo888 collected ($8.55)
Seat 5: SonerWPT folded before Flop (didn't bet)
Seat 6: matiko09 (button) folded before Flop (didn't bet)
Seat 7: ilaviiitech (small blind) folded on the Turn
Seat 8: techahn (big blind) folded on the Turn
Seat 9: mbk88 folded before Flop (didn't bet)





PokerStars Hand #155379974883:  Hold'em No Limit ($0.50/$1.00 USD) - 2016/06/30 13:47:51 CET [2016/06/30 7:47:51 ET]
Table 'Borrelly II' 9-max Seat #7 is the button
Seat 1: Rafaello18 ($112.52 in chips) 
Seat 4: DonRon_AT ($39.81 in chips) 
Seat 5: DIMAN_324 ($100 in chips) 
Seat 6: m_michalec ($173.58 in chips) 
Seat 7: matiko09 ($170.34 in chips) 
Seat 8: Arjun A Raju ($99 in chips) 
Seat 9: alhill86 ($78.50 in chips) 
Arjun A Raju: posts small blind $0.50
alhill86: posts big blind $1
mbk88: sits out 
*** HOLE CARDS ***
Dealt to matiko09 [Th 7c]
Rafaello18: folds 
DonRon_AT: folds 
DIMAN_324: folds 
m_michalec: folds 
matiko09: folds 
Arjun A Raju: folds 
Uncalled bet ($0.50) returned to alhill86
alhill86 collected $1 from pot
alhill86: doesn't show hand 
*** SUMMARY ***
Total pot $1 | Rake $0 
Seat 1: Rafaello18 folded before Flop (didn't bet)
Seat 4: DonRon_AT folded before Flop (didn't bet)
Seat 5: DIMAN_324 folded before Flop (didn't bet)
Seat 6: m_michalec folded before Flop (didn't bet)
Seat 7: matiko09 (button) folded before Flop (didn't bet)
Seat 8: Arjun A Raju (small blind) folded before Flop
Seat 9: alhill86 (big blind) collected ($1)





PokerStars Hand #155379978926:  Hold'em No Limit ($0.50/$1.00 USD) - 2016/06/30 13:48:00 CET [2016/06/30 7:48:00 ET]
Table 'Asmodeus' 9-max Seat #4 is the button
Seat 1: scollop ($107.20 in chips) 
Seat 2: picka4u ($44.80 in chips) 
Seat 3: matiko09 ($102.25 in chips) 
Seat 4: ardo888 ($135.28 in chips) 
Seat 5: sanr23 ($100 in chips) 
Seat 6: koutani7 ($92.50 in chips) 
Seat 7: aaronzzr ($151.54 in chips) 
Seat 8: Rafaello18 ($151.95 in chips) 
Seat 9: mbk88 ($156.18 in chips) 
sanr23: posts small blind $0.50
koutani7: posts big blind $1
*** HOLE CARDS ***
Dealt to matiko09 [Ks 9d]
aaronzzr: folds 
Rafaello18: raises $1.50 to $2.50
mbk88: folds 
scollop: folds 
picka4u: folds 
matiko09: folds 
ardo888: folds 
sanr23: folds 
koutani7 has timed out
koutani7: folds 
Uncalled bet ($1.50) returned to Rafaello18
Rafaello18 collected $2.50 from pot
Rafaello18: doesn't show hand 
*** SUMMARY ***
Total pot $2.50 | Rake $0 
Seat 1: scollop folded before Flop (didn't bet)
Seat 2: picka4u folded before Flop (didn't bet)
Seat 3: matiko09 folded before Flop (didn't bet)
Seat 4: ardo888 (button) folded before Flop (didn't bet)
Seat 5: sanr23 (small blind) folded before Flop
Seat 6: koutani7 (big blind) folded before Flop
Seat 7: aaronzzr folded before Flop (didn't bet)
Seat 8: Rafaello18 collected ($2.50)
Seat 9: mbk88 folded before Flop (didn't bet)





PokerStars Hand #155379981324:  Hold'em No Limit ($0.50/$1.00 USD) - 2016/06/30 13:48:06 CET [2016/06/30 7:48:06 ET]
Table 'Borrelly II' 9-max Seat #8 is the button
Seat 1: Rafaello18 ($112.52 in chips) 
Seat 4: DonRon_AT ($39.81 in chips) 
Seat 5: DIMAN_324 ($100 in chips) 
Seat 6: m_michalec ($173.58 in chips) 
Seat 7: matiko09 ($170.34 in chips) 
Seat 8: Arjun A Raju ($98.50 in chips) 
Seat 9: alhill86 ($79 in chips) 
alhill86: posts small blind $0.50
Rafaello18: posts big blind $1
mbk88: sits out 
*** HOLE CARDS ***
Dealt to matiko09 [Kc Th]
DonRon_AT: folds 
DIMAN_324: raises $2 to $3
m_michalec: folds 
matiko09: folds 
Arjun A Raju: folds 
alhill86: folds 
Rafaello18: calls $2
*** FLOP *** [2h 4s Js]
Rafaello18: checks 
DIMAN_324: bets $4.11
Rafaello18: calls $4.11
*** TURN *** [2h 4s Js] [7d]
Rafaello18: checks 
DIMAN_324: checks 
*** RIVER *** [2h 4s Js 7d] [Qh]
Rafaello18: checks 
DIMAN_324: checks 
*** SHOW DOWN ***
Rafaello18: shows [8s 7s] (a pair of Sevens)
DIMAN_324: mucks hand 
Rafaello18 collected $13.98 from pot
*** SUMMARY ***
Total pot $14.72 | Rake $0.74 
Board [2h 4s Js 7d Qh]
Seat 1: Rafaello18 (big blind) showed [8s 7s] and won ($13.98) with a pair of Sevens
Seat 4: DonRon_AT folded before Flop (didn't bet)
Seat 5: DIMAN_324 mucked [3c Ac]
Seat 6: m_michalec folded before Flop (didn't bet)
Seat 7: matiko09 folded before Flop (didn't bet)
Seat 8: Arjun A Raju (button) folded before Flop (didn't bet)
Seat 9: alhill86 (small blind) folded before Flop





PokerStars Hand #155379987091:  Hold'em No Limit ($0.50/$1.00 USD) - 2016/06/30 13:48:19 CET [2016/06/30 7:48:19 ET]
Table 'Prieska' 9-max Seat #6 is the button
Seat 1: KovIFish89 ($118.59 in chips) 
Seat 2: B_style_cuz ($104.43 in chips) 
Seat 3: Rafaello18 ($125.50 in chips) 
Seat 5: ramzes160468 ($87.02 in chips) 
Seat 6: DIMAN_324 ($102.50 in chips) 
Seat 7: matiko09 ($100 in chips) 
Seat 8: mbk88 ($100 in chips) 
Seat 9: picka4u ($43.80 in chips) 
matiko09: posts small blind $0.50
mbk88: posts big blind $1
*** HOLE CARDS ***
Dealt to matiko09 [Js 9d]
picka4u: folds 
KovIFish89: folds 
B_style_cuz: folds 
picka4u leaves the table
Rafaello18: folds 
ramzes160468: raises $2 to $3
DIMAN_324: folds 
matiko09: folds 
mbk88: raises $7 to $10
ramzes160468: calls $7
*** FLOP *** [7d Ah 8c]
mbk88: bets $13
ramzes160468: calls $13
*** TURN *** [7d Ah 8c] [4c]
Konig26 joins the table at seat #9 
mbk88: bets $25
ramzes160468: folds 
Uncalled bet ($25) returned to mbk88
mbk88 collected $44.18 from pot
mbk88: doesn't show hand 
*** SUMMARY ***
Total pot $46.50 | Rake $2.32 
Board [7d Ah 8c 4c]
Seat 1: KovIFish89 folded before Flop (didn't bet)
Seat 2: B_style_cuz folded before Flop (didn't bet)
Seat 3: Rafaello18 folded before Flop (didn't bet)
Seat 5: ramzes160468 folded on the Turn
Seat 6: DIMAN_324 (button) folded before Flop (didn't bet)
Seat 7: matiko09 (small blind) folded before Flop
Seat 8: mbk88 (big blind) collected ($44.18)
Seat 9: picka4u folded before Flop (didn't bet)





PokerStars Hand #155379988368:  Hold'em No Limit ($0.50/$1.00 USD) - 2016/06/30 13:48:22 CET [2016/06/30 7:48:22 ET]
Table 'California II' 9-max Seat #7 is the button
Seat 1: Rafaello18 ($114.02 in chips) 
Seat 4: mbk88 ($198.08 in chips) 
Seat 5: Rohitbarve ($101.24 in chips) 
Seat 6: matiko09 ($125.85 in chips) 
Seat 7: DomiVY ($85.70 in chips) 
Seat 8: picka4u ($42.82 in chips) 
picka4u: posts small blind $0.50
Rafaello18: posts big blind $1
Konig26: sits out 
*** HOLE CARDS ***
Dealt to matiko09 [7h 7s]
mbk88: raises $2 to $3
Rohitbarve: folds 
matiko09: calls $3
DomiVY: folds 
picka4u: folds 
liakos120 leaves the table
KovIFish89 joins the table at seat #3 
Rafaello18: folds 
*** FLOP *** [5c Tc Th]
Konig26 leaves the table
mbk88: bets $5
matiko09: calls $5
*** TURN *** [5c Tc Th] [Qh]
mbk88: bets $11
velourleder joins the table at seat #2 
matiko09: folds 
Uncalled bet ($11) returned to mbk88
mbk88 collected $16.62 from pot
mbk88: doesn't show hand 
*** SUMMARY ***
Total pot $17.50 | Rake $0.88 
Board [5c Tc Th Qh]
Seat 1: Rafaello18 (big blind) folded before Flop
Seat 4: mbk88 collected ($16.62)
Seat 5: Rohitbarve folded before Flop (didn't bet)
Seat 6: matiko09 folded on the Turn
Seat 7: DomiVY (button) folded before Flop (didn't bet)
Seat 8: picka4u (small blind) folded before Flop





PokerStars Hand #155379990011:  Hold'em No Limit ($0.50/$1.00 USD) - 2016/06/30 13:48:26 CET [2016/06/30 7:48:26 ET]
Table 'Tatjana' 9-max Seat #4 is the button
Seat 1: ardo888 ($123.46 in chips) 
Seat 2: DIMAN_324 ($103 in chips) 
Seat 3: Rafaello18 ($100 in chips) 
Seat 4: mopatron25 ($64.28 in chips) 
Seat 5: matiko09 ($105.88 in chips) 
Seat 7: daigodisco ($39.63 in chips) 
Seat 8: alhill86 ($117.41 in chips) 
Seat 9: POTAPENKO700 ($141.21 in chips) 
matiko09: posts small blind $0.50
mbk88: is sitting out 
daigodisco: posts big blind $1
*** HOLE CARDS ***
Dealt to matiko09 [7c Kc]
alhill86: folds 
POTAPENKO700: folds 
ardo888: folds 
DIMAN_324: folds 
Rafaello18: folds 
mopatron25: calls $1
matiko09: raises $3.50 to $4.50
daigodisco: folds 
mopatron25: calls $3.50
*** FLOP *** [Ah Tc 4h]
matiko09: bets $4.94
mopatron25: calls $4.94
*** TURN *** [Ah Tc 4h] [Kh]
matiko09: checks 
mopatron25: bets $6
matiko09: folds 
Uncalled bet ($6) returned to mopatron25
mopatron25 collected $18.89 from pot
mopatron25: doesn't show hand 
*** SUMMARY ***
Total pot $19.88 | Rake $0.99 
Board [Ah Tc 4h Kh]
Seat 1: ardo888 folded before Flop (didn't bet)
Seat 2: DIMAN_324 folded before Flop (didn't bet)
Seat 3: Rafaello18 folded before Flop (didn't bet)
Seat 4: mopatron25 (button) collected ($18.89)
Seat 5: matiko09 (small blind) folded on the Turn
Seat 7: daigodisco (big blind) folded before Flop
Seat 8: alhill86 folded before Flop (didn't bet)
Seat 9: POTAPENKO700 folded before Flop (didn't bet)





PokerStars Hand #155379992178:  Hold'em No Limit ($0.25/$0.50 USD) - 2016/06/30 13:48:31 CET [2016/06/30 7:48:31 ET]
Table 'Dorothea II' 9-max Seat #5 is the button
Seat 3: Franky77200 ($130.12 in chips) 
Seat 4: matiko09 ($73.21 in chips) 
Seat 5: Bailey Dew ($88.05 in chips) 
Seat 6: ivan100886 ($27.36 in chips) 
Seat 7: desmo465 ($48.20 in chips) 
Seat 8: TheMinion ($50 in chips) 
Seat 9: funXmun ($51.77 in chips) 
ivan100886: posts small blind $0.25
desmo465: posts big blind $0.50
zapata 7777: sits out 
Franky77200: posts the ante $0.10
matiko09: posts the ante $0.10
Bailey Dew: posts the ante $0.10
ivan100886: posts the ante $0.10
desmo465: posts the ante $0.10
TheMinion: posts the ante $0.10
funXmun: posts the ante $0.10
*** HOLE CARDS ***
Dealt to matiko09 [Kh 7c]
TheMinion: folds 
hotterflush1 leaves the table
joker180785 joins the table at seat #2 
funXmun: raises $0.63 to $1.13
Franky77200: folds 
matiko09: folds 
Bailey Dew: folds 
ivan100886: folds 
desmo465: folds 
Uncalled bet ($0.63) returned to funXmun
funXmun collected $1.95 from pot
funXmun: doesn't show hand 
*** SUMMARY ***
Total pot $1.95 | Rake $0 
Seat 3: Franky77200 folded before Flop (didn't bet)
Seat 4: matiko09 folded before Flop (didn't bet)
Seat 5: Bailey Dew (button) folded before Flop (didn't bet)
Seat 6: ivan100886 (small blind) folded before Flop
Seat 7: desmo465 (big blind) folded before Flop
Seat 8: TheMinion folded before Flop (didn't bet)
Seat 9: funXmun collected ($1.95)





PokerStars Hand #155379995071:  Hold'em No Limit ($0.50/$1.00 USD) - 2016/06/30 13:48:38 CET [2016/06/30 7:48:38 ET]
Table 'Armisticia' 9-max Seat #7 is the button
Seat 2: atlant244 ($78.61 in chips) 
Seat 3: KovIFish89 ($101 in chips) 
Seat 4: ardo888 ($105.55 in chips) 
Seat 5: SonerWPT ($105.25 in chips) 
Seat 6: matiko09 ($121.30 in chips) 
Seat 7: ilaviiitech ($100 in chips) 
Seat 8: techahn ($131.88 in chips) 
Seat 9: mbk88 ($116.83 in chips) 
techahn: posts small blind $0.50
mbk88: posts big blind $1
tipner: sits out 
*** HOLE CARDS ***
Dealt to matiko09 [7c Qh]
atlant244: folds 
KovIFish89: folds 
ardo888: folds 
SonerWPT: folds 
matiko09: folds 
ilaviiitech: folds 
techahn: folds 
Uncalled bet ($0.50) returned to mbk88
mbk88 collected $1 from pot
mbk88: doesn't show hand 
*** SUMMARY ***
Total pot $1 | Rake $0 
Seat 2: atlant244 folded before Flop (didn't bet)
Seat 3: KovIFish89 folded before Flop (didn't bet)
Seat 4: ardo888 folded before Flop (didn't bet)
Seat 5: SonerWPT folded before Flop (didn't bet)
Seat 6: matiko09 folded before Flop (didn't bet)
Seat 7: ilaviiitech (button) folded before Flop (didn't bet)
Seat 8: techahn (small blind) folded before Flop
Seat 9: mbk88 (big blind) collected ($1)





PokerStars Hand #155379996459:  Hold'em No Limit ($0.25/$0.50 USD) - 2016/06/30 13:48:41 CET [2016/06/30 7:48:41 ET]
Table 'Elektra II' 9-max Seat #7 is the button
Seat 1: drlee77 ($48.78 in chips) 
Seat 2: TheMinion ($63.32 in chips) 
Seat 3: mojtabagol ($72.48 in chips) 
Seat 4: matiko09 ($54.72 in chips) 
Seat 5: Rafaello18 ($59.24 in chips) 
Seat 6: pfunkolstar ($52.99 in chips) 
Seat 7: MuddyDance ($48.50 in chips) 
Seat 8: sanr23 ($50 in chips) 
Seat 9: Dantistcopra ($52.10 in chips) 
sanr23: posts small blind $0.25
Dantistcopra: posts big blind $0.50
*** HOLE CARDS ***
Dealt to matiko09 [7c 4h]
drlee77: folds 
TheMinion: folds 
mojtabagol: folds 
matiko09: folds 
Rafaello18: raises $0.75 to $1.25
pfunkolstar: calls $1.25
MuddyDance: folds 
sanr23: folds 
Dantistcopra: calls $0.75
*** FLOP *** [7d 9s 2d]
Dantistcopra: checks 
Rafaello18: checks 
pfunkolstar: bets $2.50
Dantistcopra: folds 
Rafaello18: folds 
Uncalled bet ($2.50) returned to pfunkolstar
pfunkolstar collected $3.80 from pot
pfunkolstar: doesn't show hand 
*** SUMMARY ***
Total pot $4 | Rake $0.20 
Board [7d 9s 2d]
Seat 1: drlee77 folded before Flop (didn't bet)
Seat 2: TheMinion folded before Flop (didn't bet)
Seat 3: mojtabagol folded before Flop (didn't bet)
Seat 4: matiko09 folded before Flop (didn't bet)
Seat 5: Rafaello18 folded on the Flop
Seat 6: pfunkolstar collected ($3.80)
Seat 7: MuddyDance (button) folded before Flop (didn't bet)
Seat 8: sanr23 (small blind) folded before Flop
Seat 9: Dantistcopra (big blind) folded on the Flop





PokerStars Hand #155379997580:  Hold'em No Limit ($0.25/$0.50 USD) - 2016/06/30 13:48:44 CET [2016/06/30 7:48:44 ET]
Table 'Mentha II' 9-max Seat #8 is the button
Seat 1: Bailey Dew ($174.57 in chips) 
Seat 2: TheMinion ($50 in chips) 
Seat 4: 55peter1 ($76.83 in chips) 
Seat 5: maxxmeister ($50 in chips) 
Seat 7: ardo888 ($147.45 in chips) 
Seat 8: drlee77 ($45.90 in chips) 
Seat 9: matiko09 ($51.81 in chips) 
matiko09: posts small blind $0.25
Bailey Dew: posts big blind $0.50
Bailey Dew: posts the ante $0.10
TheMinion: posts the ante $0.10
55peter1: posts the ante $0.10
maxxmeister: posts the ante $0.10
ardo888: posts the ante $0.10
drlee77: posts the ante $0.10
matiko09: posts the ante $0.10
*** HOLE CARDS ***
Dealt to matiko09 [Ts 7s]
TheMinion: folds 
55peter1: folds 
maxxmeister: raises $1 to $1.50
ardo888: folds 
drlee77: folds 
matiko09: folds 
Bailey Dew: folds 
Uncalled bet ($1) returned to maxxmeister
maxxmeister collected $1.95 from pot
maxxmeister: doesn't show hand 
*** SUMMARY ***
Total pot $1.95 | Rake $0 
Seat 1: Bailey Dew (big blind) folded before Flop
Seat 2: TheMinion folded before Flop (didn't bet)
Seat 4: 55peter1 folded before Flop (didn't bet)
Seat 5: maxxmeister collected ($1.95)
Seat 7: ardo888 folded before Flop (didn't bet)
Seat 8: drlee77 (button) folded before Flop (didn't bet)
Seat 9: matiko09 (small blind) folded before Flop





PokerStars Hand #155380002832:  Hold'em No Limit ($0.50/$1.00 USD) - 2016/06/30 13:48:56 CET [2016/06/30 7:48:56 ET]
Table 'Armisticia' 9-max Seat #8 is the button
Seat 1: tipner ($100 in chips) 
Seat 2: atlant244 ($78.61 in chips) 
Seat 3: KovIFish89 ($101 in chips) 
Seat 4: ardo888 ($105.55 in chips) 
Seat 5: SonerWPT ($105.25 in chips) 
Seat 6: matiko09 ($121.30 in chips) 
Seat 7: ilaviiitech ($100 in chips) 
Seat 8: techahn ($131.38 in chips) 
Seat 9: mbk88 ($117.33 in chips) 
mbk88: posts small blind $0.50
tipner: posts big blind $1
*** HOLE CARDS ***
Dealt to matiko09 [9d Qs]
atlant244: folds 
KovIFish89: folds 
ardo888: folds 
SonerWPT: folds 
matiko09: folds 
ilaviiitech: folds 
techahn: raises $2 to $3
mbk88: folds 
tipner: folds 
Uncalled bet ($2) returned to techahn
techahn collected $2.50 from pot
techahn: doesn't show hand 
*** SUMMARY ***
Total pot $2.50 | Rake $0 
Seat 1: tipner (big blind) folded before Flop
Seat 2: atlant244 folded before Flop (didn't bet)
Seat 3: KovIFish89 folded before Flop (didn't bet)
Seat 4: ardo888 folded before Flop (didn't bet)
Seat 5: SonerWPT folded before Flop (didn't bet)
Seat 6: matiko09 folded before Flop (didn't bet)
Seat 7: ilaviiitech folded before Flop (didn't bet)
Seat 8: techahn (button) collected ($2.50)
Seat 9: mbk88 (small blind) folded before Flop





PokerStars Hand #155380006144:  Hold'em No Limit ($0.25/$0.50 USD) - 2016/06/30 13:49:04 CET [2016/06/30 7:49:04 ET]
Table 'Dorothea II' 9-max Seat #6 is the button
Seat 3: Franky77200 ($130.02 in chips) 
Seat 4: matiko09 ($73.11 in chips) 
Seat 5: Bailey Dew ($87.95 in chips) 
Seat 6: ivan100886 ($27.01 in chips) 
Seat 7: desmo465 ($47.60 in chips) 
Seat 8: TheMinion ($50 in chips) 
Seat 9: funXmun ($53.12 in chips) 
desmo465: posts small blind $0.25
TheMinion: posts big blind $0.50
zapata 7777: sits out 
joker180785: sits out 
Franky77200: posts the ante $0.10
matiko09: posts the ante $0.10
Bailey Dew: posts the ante $0.10
ivan100886: posts the ante $0.10
desmo465: posts the ante $0.10
TheMinion: posts the ante $0.10
funXmun: posts the ante $0.10
*** HOLE CARDS ***
Dealt to matiko09 [8s Jh]
funXmun: folds 
Franky77200: raises $1 to $1.50
matiko09: folds 
Bailey Dew: folds 
ivan100886: folds 
desmo465: folds 
TheMinion: folds 
Uncalled bet ($1) returned to Franky77200
Franky77200 collected $1.95 from pot
Franky77200: doesn't show hand 
*** SUMMARY ***
Total pot $1.95 | Rake $0 
Seat 3: Franky77200 collected ($1.95)
Seat 4: matiko09 folded before Flop (didn't bet)
Seat 5: Bailey Dew folded before Flop (didn't bet)
Seat 6: ivan100886 (button) folded before Flop (didn't bet)
Seat 7: desmo465 (small blind) folded before Flop
Seat 8: TheMinion (big blind) folded before Flop
Seat 9: funXmun folded before Flop (didn't bet)





PokerStars Hand #155380010166:  Hold'em No Limit ($0.25/$0.50 USD) - 2016/06/30 13:49:13 CET [2016/06/30 7:49:13 ET]
Table 'Mentha II' 9-max Seat #9 is the button
Seat 1: Bailey Dew ($173.97 in chips) 
Seat 2: TheMinion ($50 in chips) 
Seat 4: 55peter1 ($76.73 in chips) 
Seat 5: maxxmeister ($51.35 in chips) 
Seat 7: ardo888 ($147.35 in chips) 
Seat 8: drlee77 ($45.80 in chips) 
Seat 9: matiko09 ($51.46 in chips) 
Bailey Dew: posts small blind $0.25
TheMinion: posts big blind $0.50
Bailey Dew: posts the ante $0.10
TheMinion: posts the ante $0.10
55peter1: posts the ante $0.10
maxxmeister: posts the ante $0.10
ardo888: posts the ante $0.10
drlee77: posts the ante $0.10
matiko09: posts the ante $0.10
*** HOLE CARDS ***
Dealt to matiko09 [Ac Js]
55peter1: folds 
maxxmeister: folds 
ardo888: folds 
drlee77: folds 
IceyyF91x leaves the table
joker180785 joins the table at seat #3 
matiko09: raises $0.63 to $1.13
Bailey Dew: folds 
TheMinion: calls $0.63
*** FLOP *** [Kh 7s Ad]
TheMinion: checks 
matiko09: checks 
*** TURN *** [Kh 7s Ad] [Qs]
TheMinion: bets $2
matiko09: calls $2
*** RIVER *** [Kh 7s Ad Qs] [Ks]
TheMinion: bets $4.35
matiko09: folds 
Uncalled bet ($4.35) returned to TheMinion
TheMinion collected $6.85 from pot
TheMinion: doesn't show hand 
*** SUMMARY ***
Total pot $7.21 | Rake $0.36 
Board [Kh 7s Ad Qs Ks]
Seat 1: Bailey Dew (small blind) folded before Flop
Seat 2: TheMinion (big blind) collected ($6.85)
Seat 4: 55peter1 folded before Flop (didn't bet)
Seat 5: maxxmeister folded before Flop (didn't bet)
Seat 7: ardo888 folded before Flop (didn't bet)
Seat 8: drlee77 folded before Flop (didn't bet)
Seat 9: matiko09 (button) folded on the River





PokerStars Hand #155380013635:  Hold'em No Limit ($0.50/$1.00 USD) - 2016/06/30 13:49:21 CET [2016/06/30 7:49:21 ET]
Table 'Asmodeus' 9-max Seat #5 is the button
Seat 1: scollop ($107.20 in chips) 
Seat 2: picka4u ($44.80 in chips) 
Seat 3: matiko09 ($102.25 in chips) 
Seat 4: ardo888 ($135.28 in chips) 
Seat 5: sanr23 ($100 in chips) 
Seat 6: koutani7 ($91.50 in chips) 
Seat 7: aaronzzr ($151.54 in chips) 
Seat 8: Rafaello18 ($153.45 in chips) 
Seat 9: mbk88 ($156.18 in chips) 
koutani7: posts small blind $0.50
aaronzzr: posts big blind $1
*** HOLE CARDS ***
Dealt to matiko09 [8s 8c]
Rafaello18: folds 
mbk88: folds 
scollop: folds 
picka4u: folds 
matiko09: raises $2 to $3
ardo888: folds 
sanr23: folds 
koutani7: folds 
aaronzzr: folds 
Uncalled bet ($2) returned to matiko09
matiko09 collected $2.50 from pot
matiko09: doesn't show hand 
*** SUMMARY ***
Total pot $2.50 | Rake $0 
Seat 1: scollop folded before Flop (didn't bet)
Seat 2: picka4u folded before Flop (didn't bet)
Seat 3: matiko09 collected ($2.50)
Seat 4: ardo888 folded before Flop (didn't bet)
Seat 5: sanr23 (button) folded before Flop (didn't bet)
Seat 6: koutani7 (small blind) folded before Flop
Seat 7: aaronzzr (big blind) folded before Flop
Seat 8: Rafaello18 folded before Flop (didn't bet)
Seat 9: mbk88 folded before Flop (didn't bet)





PokerStars Hand #155380013990:  Hold'em No Limit ($0.50/$1.00 USD) - 2016/06/30 13:49:22 CET [2016/06/30 7:49:22 ET]
Table 'Prieska' 9-max Seat #7 is the button
Seat 1: KovIFish89 ($118.59 in chips) 
Seat 2: B_style_cuz ($104.43 in chips) 
Seat 3: Rafaello18 ($125.50 in chips) 
Seat 5: ramzes160468 ($64.02 in chips) 
Seat 6: DIMAN_324 ($102.50 in chips) 
Seat 7: matiko09 ($100 in chips) 
Seat 8: mbk88 ($121.18 in chips) 
Seat 9: Konig26 ($100 in chips) 
mbk88: posts small blind $0.50
Konig26: posts big blind $1
*** HOLE CARDS ***
Dealt to matiko09 [3h 3c]
KovIFish89: folds 
B_style_cuz: folds 
Rafaello18: folds 
ramzes160468: folds 
DIMAN_324: folds 
matiko09: raises $1.27 to $2.27
mbk88: raises $5.73 to $8
Konig26: folds 
matiko09: folds 
Uncalled bet ($5.73) returned to mbk88
mbk88 collected $5.54 from pot
mbk88: doesn't show hand 
*** SUMMARY ***
Total pot $5.54 | Rake $0 
Seat 1: KovIFish89 folded before Flop (didn't bet)
Seat 2: B_style_cuz folded before Flop (didn't bet)
Seat 3: Rafaello18 folded before Flop (didn't bet)
Seat 5: ramzes160468 folded before Flop (didn't bet)
Seat 6: DIMAN_324 folded before Flop (didn't bet)
Seat 7: matiko09 (button) folded before Flop
Seat 8: mbk88 (small blind) collected ($5.54)
Seat 9: Konig26 (big blind) folded before Flop





PokerStars Hand #155380014793:  Hold'em No Limit ($0.25/$0.50 USD) - 2016/06/30 13:49:23 CET [2016/06/30 7:49:23 ET]
Table 'Dorothea II' 9-max Seat #7 is the button
Seat 3: Franky77200 ($131.37 in chips) 
Seat 4: matiko09 ($73.01 in chips) 
Seat 5: Bailey Dew ($87.85 in chips) 
Seat 6: ivan100886 ($26.91 in chips) 
Seat 7: desmo465 ($47.25 in chips) 
Seat 8: TheMinion ($50 in chips) 
Seat 9: funXmun ($53.02 in chips) 
TheMinion: posts small blind $0.25
funXmun: posts big blind $0.50
zapata 7777: sits out 
joker180785: sits out 
Franky77200: posts the ante $0.10
matiko09: posts the ante $0.10
Bailey Dew: posts the ante $0.10
ivan100886: posts the ante $0.10
desmo465: posts the ante $0.10
TheMinion: posts the ante $0.10
funXmun: posts the ante $0.10
*** HOLE CARDS ***
Dealt to matiko09 [5c 5d]
Franky77200: folds 
matiko09: raises $1 to $1.50
Bailey Dew: folds 
ivan100886: folds 
desmo465: folds 
TheMinion: folds 
funXmun: folds 
Uncalled bet ($1) returned to matiko09
matiko09 collected $1.95 from pot
matiko09: doesn't show hand 
*** SUMMARY ***
Total pot $1.95 | Rake $0 
Seat 3: Franky77200 folded before Flop (didn't bet)
Seat 4: matiko09 collected ($1.95)
Seat 5: Bailey Dew folded before Flop (didn't bet)
Seat 6: ivan100886 folded before Flop (didn't bet)
Seat 7: desmo465 (button) folded before Flop (didn't bet)
Seat 8: TheMinion (small blind) folded before Flop
Seat 9: funXmun (big blind) folded before Flop





PokerStars Hand #155380014983:  Hold'em No Limit ($0.50/$1.00 USD) - 2016/06/30 13:49:24 CET [2016/06/30 7:49:24 ET]
Table 'Armisticia' 9-max Seat #9 is the button
Seat 1: tipner ($100 in chips) 
Seat 2: atlant244 ($78.61 in chips) 
Seat 3: KovIFish89 ($101 in chips) 
Seat 4: ardo888 ($105.55 in chips) 
Seat 5: SonerWPT ($105.25 in chips) 
Seat 6: matiko09 ($121.30 in chips) 
Seat 7: ilaviiitech ($100 in chips) 
Seat 8: techahn ($132.88 in chips) 
Seat 9: mbk88 ($116.83 in chips) 
tipner: posts small blind $0.50
atlant244: posts big blind $1
*** HOLE CARDS ***
Dealt to matiko09 [5d Ks]
KovIFish89: folds 
ardo888: folds 
SonerWPT: folds 
matiko09: folds 
ilaviiitech: folds 
techahn: folds 
mbk88: raises $1.02 to $2.02
tipner: calls $1.52
atlant244: raises $6.06 to $8.08
mbk88: folds 
tipner: calls $6.06
*** FLOP *** [9c 5h Ad]
tipner: checks 
atlant244: checks 
*** TURN *** [9c 5h Ad] [6s]
tipner: checks 
atlant244: bets $4
tipner: calls $4
*** RIVER *** [9c 5h Ad 6s] [2s]
tipner: checks 
atlant244: bets $12.43
tipner: calls $12.43
*** SHOW DOWN ***
atlant244: shows [8d Js] (high card Ace)
tipner: shows [Ac 8c] (a pair of Aces)
tipner collected $48.54 from pot
*** SUMMARY ***
Total pot $51.04 | Rake $2.50 
Board [9c 5h Ad 6s 2s]
Seat 1: tipner (small blind) showed [Ac 8c] and won ($48.54) with a pair of Aces
Seat 2: atlant244 (big blind) showed [8d Js] and lost with high card Ace
Seat 3: KovIFish89 folded before Flop (didn't bet)
Seat 4: ardo888 folded before Flop (didn't bet)
Seat 5: SonerWPT folded before Flop (didn't bet)
Seat 6: matiko09 folded before Flop (didn't bet)
Seat 7: ilaviiitech folded before Flop (didn't bet)
Seat 8: techahn folded before Flop (didn't bet)
Seat 9: mbk88 (button) folded before Flop





PokerStars Hand #155380017242:  Hold'em No Limit ($0.50/$1.00 USD) - 2016/06/30 13:49:29 CET [2016/06/30 7:49:29 ET]
Table 'Altarf II' 9-max Seat #7 is the button
Seat 1: thecurv ($107.97 in chips) 
Seat 2: KovIFish89 ($100 in chips) 
Seat 3: sanr23 ($144.05 in chips) 
Seat 4: Greha999 ($81.66 in chips) 
Seat 5: DIMAN_324 ($100 in chips) 
Seat 6: mbk88 ($192.80 in chips) 
Seat 7: matiko09 ($106.22 in chips) 
Seat 8: DomiVY ($40 in chips) 
Seat 9: omanibemihum ($100 in chips) 
DomiVY: posts small blind $0.50
omanibemihum: posts big blind $1
*** HOLE CARDS ***
Dealt to matiko09 [6c 4c]
thecurv: folds 
KovIFish89: folds 
thecurv leaves the table
sanr23: folds 
Greha999: folds 
DIMAN_324: folds 
mbk88: folds 
matiko09: folds 
DomiVY: folds 
Uncalled bet ($0.50) returned to omanibemihum
omanibemihum collected $1 from pot
omanibemihum: doesn't show hand 
*** SUMMARY ***
Total pot $1 | Rake $0 
Seat 1: thecurv folded before Flop (didn't bet)
Seat 2: KovIFish89 folded before Flop (didn't bet)
Seat 3: sanr23 folded before Flop (didn't bet)
Seat 4: Greha999 folded before Flop (didn't bet)
Seat 5: DIMAN_324 folded before Flop (didn't bet)
Seat 6: mbk88 folded before Flop (didn't bet)
Seat 7: matiko09 (button) folded before Flop (didn't bet)
Seat 8: DomiVY (small blind) folded before Flop
Seat 9: omanibemihum (big blind) collected ($1)





PokerStars Hand #155380018998:  Hold'em No Limit ($0.50/$1.00 USD) - 2016/06/30 13:49:33 CET [2016/06/30 7:49:33 ET]
Table 'Tatjana' 9-max Seat #5 is the button
Seat 1: ardo888 ($123.46 in chips) 
Seat 2: DIMAN_324 ($103 in chips) 
Seat 3: Rafaello18 ($100 in chips) 
Seat 4: mopatron25 ($73.73 in chips) 
Seat 5: matiko09 ($100 in chips) 
Seat 7: daigodisco ($38.63 in chips) 
Seat 8: alhill86 ($117.41 in chips) 
Seat 9: POTAPENKO700 ($141.21 in chips) 
daigodisco: posts small blind $0.50
alhill86: posts big blind $1
*** HOLE CARDS ***
Dealt to matiko09 [3h Qc]
POTAPENKO700: folds 
ardo888: raises $2 to $3
DIMAN_324: folds 
Rafaello18: folds 
mopatron25: calls $3
matiko09: folds 
daigodisco: folds 
alhill86: folds 
*** FLOP *** [9c Qs 9h]
ardo888: checks 
mopatron25: bets $4
ardo888: calls $4
*** TURN *** [9c Qs 9h] [Ts]
ardo888: checks 
mopatron25: bets $4
ardo888: calls $4
*** RIVER *** [9c Qs 9h Ts] [5c]
ardo888: checks 
mopatron25: bets $6
ardo888: folds 
Uncalled bet ($6) returned to mopatron25
mopatron25 collected $22.32 from pot
mopatron25: doesn't show hand 
*** SUMMARY ***
Total pot $23.50 | Rake $1.18 
Board [9c Qs 9h Ts 5c]
Seat 1: ardo888 folded on the River
Seat 2: DIMAN_324 folded before Flop (didn't bet)
Seat 3: Rafaello18 folded before Flop (didn't bet)
Seat 4: mopatron25 collected ($22.32)
Seat 5: matiko09 (button) folded before Flop (didn't bet)
Seat 7: daigodisco (small blind) folded before Flop
Seat 8: alhill86 (big blind) folded before Flop
Seat 9: POTAPENKO700 folded before Flop (didn't bet)





PokerStars Hand #155380024235:  Hold'em No Limit ($0.50/$1.00 USD) - 2016/06/30 13:49:45 CET [2016/06/30 7:49:45 ET]
Table 'California II' 9-max Seat #8 is the button
Seat 1: Rafaello18 ($113.02 in chips) 
Seat 2: velourleder ($80 in chips) 
Seat 4: mbk88 ($206.70 in chips) 
Seat 5: Rohitbarve ($101.24 in chips) 
Seat 6: matiko09 ($117.85 in chips) 
Seat 7: DomiVY ($85.70 in chips) 
Seat 8: picka4u ($42.32 in chips) 
Rafaello18: posts small blind $0.50
velourleder: posts big blind $1
KovIFish89: sits out 
*** HOLE CARDS ***
Dealt to matiko09 [As 9d]
mbk88: folds 
Rohitbarve: raises $2 to $3
matiko09: folds 
DomiVY: folds 
picka4u: folds 
Rafaello18: folds 
velourleder: folds 
Uncalled bet ($2) returned to Rohitbarve
Rohitbarve collected $2.50 from pot
Rohitbarve: doesn't show hand 
*** SUMMARY ***
Total pot $2.50 | Rake $0 
Seat 1: Rafaello18 (small blind) folded before Flop
Seat 2: velourleder (big blind) folded before Flop
Seat 4: mbk88 folded before Flop (didn't bet)
Seat 5: Rohitbarve collected ($2.50)
Seat 6: matiko09 folded before Flop (didn't bet)
Seat 7: DomiVY folded before Flop (didn't bet)
Seat 8: picka4u (button) folded before Flop (didn't bet)





PokerStars Hand #155380026630:  Hold'em No Limit ($0.50/$1.00 USD) - 2016/06/30 13:49:51 CET [2016/06/30 7:49:51 ET]
Table 'Asmodeus' 9-max Seat #6 is the button
Seat 1: scollop ($107.20 in chips) 
Seat 2: picka4u ($44.80 in chips) 
Seat 3: matiko09 ($103.75 in chips) 
Seat 4: ardo888 ($135.28 in chips) 
Seat 5: sanr23 ($100 in chips) 
Seat 6: koutani7 ($91 in chips) 
Seat 7: aaronzzr ($150.54 in chips) 
Seat 8: Rafaello18 ($153.45 in chips) 
Seat 9: mbk88 ($156.18 in chips) 
aaronzzr: posts small blind $0.50
Rafaello18: posts big blind $1
*** HOLE CARDS ***
Dealt to matiko09 [7d 3s]
mbk88: folds 
scollop: calls $1
picka4u: raises $3 to $4
matiko09: folds 
ardo888: raises $10 to $14
sanr23: folds 
koutani7: folds 
aaronzzr: folds 
Rafaello18: folds 
scollop: raises $37 to $51
picka4u: folds 
ardo888: folds 
Uncalled bet ($37) returned to scollop
scollop collected $33.50 from pot
scollop: doesn't show hand 
*** SUMMARY ***
Total pot $33.50 | Rake $0 
Seat 1: scollop collected ($33.50)
Seat 2: picka4u folded before Flop
Seat 3: matiko09 folded before Flop (didn't bet)
Seat 4: ardo888 folded before Flop
Seat 5: sanr23 folded before Flop (didn't bet)
Seat 6: koutani7 (button) folded before Flop (didn't bet)
Seat 7: aaronzzr (small blind) folded before Flop
Seat 8: Rafaello18 (big blind) folded before Flop
Seat 9: mbk88 folded before Flop (didn't bet)





PokerStars Hand #155380028291:  Hold'em No Limit ($0.50/$1.00 USD) - 2016/06/30 13:49:54 CET [2016/06/30 7:49:54 ET]
Table 'Borrelly II' 9-max Seat #9 is the button
Seat 1: Rafaello18 ($119.39 in chips) 
Seat 2: mbk88 ($104.12 in chips) 
Seat 4: DonRon_AT ($39.81 in chips) 
Seat 5: DIMAN_324 ($100 in chips) 
Seat 6: m_michalec ($173.58 in chips) 
Seat 7: matiko09 ($170.34 in chips) 
Seat 8: Arjun A Raju ($98.50 in chips) 
Seat 9: alhill86 ($78.50 in chips) 
Rafaello18: posts small blind $0.50
mbk88: posts big blind $1
*** HOLE CARDS ***
Dealt to matiko09 [4d 2h]
DonRon_AT has timed out
DonRon_AT: folds 
DIMAN_324: folds 
m_michalec: folds 
matiko09: folds 
Arjun A Raju: folds 
alhill86: folds 
Rafaello18: folds 
Uncalled bet ($0.50) returned to mbk88
mbk88 collected $1 from pot
mbk88: doesn't show hand 
*** SUMMARY ***
Total pot $1 | Rake $0 
Seat 1: Rafaello18 (small blind) folded before Flop
Seat 2: mbk88 (big blind) collected ($1)
Seat 4: DonRon_AT folded before Flop (didn't bet)
Seat 5: DIMAN_324 folded before Flop (didn't bet)
Seat 6: m_michalec folded before Flop (didn't bet)
Seat 7: matiko09 folded before Flop (didn't bet)
Seat 8: Arjun A Raju folded before Flop (didn't bet)
Seat 9: alhill86 (button) folded before Flop (didn't bet)





PokerStars Hand #155380028018:  Hold'em No Limit ($0.25/$0.50 USD) - 2016/06/30 13:49:54 CET [2016/06/30 7:49:54 ET]
Table 'Elektra II' 9-max Seat #8 is the button
Seat 2: TheMinion ($63.32 in chips) 
Seat 3: mojtabagol ($72.48 in chips) 
Seat 4: matiko09 ($54.72 in chips) 
Seat 5: Rafaello18 ($57.99 in chips) 
Seat 6: pfunkolstar ($55.54 in chips) 
Seat 7: MuddyDance ($48.50 in chips) 
Seat 8: sanr23 ($50 in chips) 
Seat 9: Dantistcopra ($50.85 in chips) 
Dantistcopra: posts small blind $0.25
drlee77: is sitting out 
TheMinion: posts big blind $0.50
*** HOLE CARDS ***
Dealt to matiko09 [2s 4h]
mojtabagol: folds 
matiko09: folds 
Rafaello18: folds 
pfunkolstar: folds 
MuddyDance has timed out
MuddyDance: folds 
sanr23: raises $0.50 to $1
Dantistcopra has timed out
Dantistcopra: folds 
TheMinion: folds 
Uncalled bet ($0.50) returned to sanr23
sanr23 collected $1.25 from pot
sanr23: doesn't show hand 
*** SUMMARY ***
Total pot $1.25 | Rake $0 
Seat 2: TheMinion (big blind) folded before Flop
Seat 3: mojtabagol folded before Flop (didn't bet)
Seat 4: matiko09 folded before Flop (didn't bet)
Seat 5: Rafaello18 folded before Flop (didn't bet)
Seat 6: pfunkolstar folded before Flop (didn't bet)
Seat 7: MuddyDance folded before Flop (didn't bet)
Seat 8: sanr23 (button) collected ($1.25)
Seat 9: Dantistcopra (small blind) folded before Flop





PokerStars Hand #155380029108:  Hold'em No Limit ($0.25/$0.50 USD) - 2016/06/30 13:49:56 CET [2016/06/30 7:49:56 ET]
Table 'Dorothea II' 9-max Seat #8 is the button
Seat 1: zapata 7777 ($50 in chips) 
Seat 3: Franky77200 ($131.27 in chips) 
Seat 4: matiko09 ($74.36 in chips) 
Seat 5: Bailey Dew ($87.75 in chips) 
Seat 6: ivan100886 ($26.81 in chips) 
Seat 7: desmo465 ($47.15 in chips) 
Seat 8: TheMinion ($50 in chips) 
Seat 9: funXmun ($52.42 in chips) 
funXmun: posts small blind $0.25
zapata 7777: posts big blind $0.50
joker180785: sits out 
zapata 7777: posts the ante $0.10
Franky77200: posts the ante $0.10
matiko09: posts the ante $0.10
Bailey Dew: posts the ante $0.10
ivan100886: posts the ante $0.10
desmo465: posts the ante $0.10
TheMinion: posts the ante $0.10
funXmun: posts the ante $0.10
*** HOLE CARDS ***
Dealt to matiko09 [As Ac]
Franky77200: raises $1 to $1.50
matiko09: raises $6.50 to $8
Bailey Dew: folds 
ivan100886: folds 
desmo465: folds 
TheMinion: folds 
funXmun: folds 
zapata 7777: folds 
Franky77200: calls $6.50
*** FLOP *** [9d 6s Ad]
Franky77200: checks 
matiko09: bets $6.50
Franky77200: calls $6.50
*** TURN *** [9d 6s Ad] [6h]
Franky77200: checks 
matiko09: checks 
*** RIVER *** [9d 6s Ad 6h] [4s]
Franky77200: bets $25
matiko09: raises $34.76 to $59.76 and is all-in
Franky77200: calls $34.76
*** SHOW DOWN ***
matiko09: shows [As Ac] (a full house, Aces full of Sixes)
Franky77200: shows [9c 9s] (a full house, Nines full of Sixes)
matiko09 collected $148.07 from pot
*** SUMMARY ***
Total pot $150.07 | Rake $2 
Board [9d 6s Ad 6h 4s]
Seat 1: zapata 7777 (big blind) folded before Flop
Seat 3: Franky77200 showed [9c 9s] and lost with a full house, Nines full of Sixes
Seat 4: matiko09 showed [As Ac] and won ($148.07) with a full house, Aces full of Sixes
Seat 5: Bailey Dew folded before Flop (didn't bet)
Seat 6: ivan100886 folded before Flop (didn't bet)
Seat 7: desmo465 folded before Flop (didn't bet)
Seat 8: TheMinion (button) folded before Flop (didn't bet)
Seat 9: funXmun (small blind) folded before Flop





PokerStars Hand #155380030265:  Hold'em No Limit ($0.50/$1.00 USD) - 2016/06/30 13:49:59 CET [2016/06/30 7:49:59 ET]
Table 'Prieska' 9-max Seat #8 is the button
Seat 1: KovIFish89 ($118.59 in chips) 
Seat 2: B_style_cuz ($104.43 in chips) 
Seat 3: Rafaello18 ($125.50 in chips) 
Seat 5: ramzes160468 ($64.02 in chips) 
Seat 6: DIMAN_324 ($102.50 in chips) 
Seat 7: matiko09 ($100 in chips) 
Seat 8: mbk88 ($124.45 in chips) 
Seat 9: Konig26 ($99 in chips) 
Konig26: posts small blind $0.50
KovIFish89: posts big blind $1
matteo080613: sits out 
*** HOLE CARDS ***
Dealt to matiko09 [5d 8d]
B_style_cuz: folds 
Rafaello18: folds 
ramzes160468: folds 
DIMAN_324: folds 
matiko09: folds 
mbk88: folds 
Konig26: folds 
Uncalled bet ($0.50) returned to KovIFish89
KovIFish89 collected $1 from pot
KovIFish89: doesn't show hand 
*** SUMMARY ***
Total pot $1 | Rake $0 
Seat 1: KovIFish89 (big blind) collected ($1)
Seat 2: B_style_cuz folded before Flop (didn't bet)
Seat 3: Rafaello18 folded before Flop (didn't bet)
Seat 5: ramzes160468 folded before Flop (didn't bet)
Seat 6: DIMAN_324 folded before Flop (didn't bet)
Seat 7: matiko09 folded before Flop (didn't bet)
Seat 8: mbk88 (button) folded before Flop (didn't bet)
Seat 9: Konig26 (small blind) folded before Flop





PokerStars Hand #155380031311:  Hold'em No Limit ($0.50/$1.00 USD) - 2016/06/30 13:50:01 CET [2016/06/30 7:50:01 ET]
Table 'Altarf II' 9-max Seat #8 is the button
Seat 2: KovIFish89 ($100 in chips) 
Seat 3: sanr23 ($144.05 in chips) 
Seat 4: Greha999 ($81.66 in chips) 
Seat 5: DIMAN_324 ($100 in chips) 
Seat 6: mbk88 ($192.80 in chips) 
Seat 7: matiko09 ($106.22 in chips) 
Seat 8: DomiVY ($40 in chips) 
Seat 9: omanibemihum ($100.50 in chips) 
omanibemihum: posts small blind $0.50
KovIFish89: posts big blind $1
*** HOLE CARDS ***
Dealt to matiko09 [7d Kd]
sanr23: folds 
Greha999: folds 
DIMAN_324: raises $2 to $3
mbk88: folds 
matiko09: folds 
DomiVY: folds 
omanibemihum: folds 
Rafaello18 joins the table at seat #1 
KovIFish89 is disconnected 
KovIFish89 has timed out while disconnected
KovIFish89: folds 
Uncalled bet ($2) returned to DIMAN_324
DIMAN_324 collected $2.50 from pot
DIMAN_324: doesn't show hand 
*** SUMMARY ***
Total pot $2.50 | Rake $0 
Seat 2: KovIFish89 (big blind) folded before Flop
Seat 3: sanr23 folded before Flop (didn't bet)
Seat 4: Greha999 folded before Flop (didn't bet)
Seat 5: DIMAN_324 collected ($2.50)
Seat 6: mbk88 folded before Flop (didn't bet)
Seat 7: matiko09 folded before Flop (didn't bet)
Seat 8: DomiVY (button) folded before Flop (didn't bet)
Seat 9: omanibemihum (small blind) folded before Flop





PokerStars Hand #155380037825:  Hold'em No Limit ($0.50/$1.00 USD) - 2016/06/30 13:50:16 CET [2016/06/30 7:50:16 ET]
Table 'California II' 9-max Seat #1 is the button
Seat 1: Rafaello18 ($112.52 in chips) 
Seat 2: velourleder ($79 in chips) 
Seat 3: KovIFish89 ($100 in chips) 
Seat 4: mbk88 ($206.70 in chips) 
Seat 5: Rohitbarve ($102.74 in chips) 
Seat 6: matiko09 ($117.85 in chips) 
Seat 7: DomiVY ($85.70 in chips) 
Seat 8: picka4u ($42.32 in chips) 
velourleder: posts small blind $0.50
KovIFish89: posts big blind $1
*** HOLE CARDS ***
Dealt to matiko09 [Kc Ah]
mbk88: folds 
Rohitbarve: folds 
matiko09: raises $2 to $3
DomiVY: folds 
picka4u: folds 
Rafaello18: folds 
velourleder: folds 
KovIFish89 is disconnected 
KovIFish89 has timed out while disconnected
KovIFish89: folds 
Uncalled bet ($2) returned to matiko09
matiko09 collected $2.50 from pot
matiko09: doesn't show hand 
*** SUMMARY ***
Total pot $2.50 | Rake $0 
Seat 1: Rafaello18 (button) folded before Flop (didn't bet)
Seat 2: velourleder (small blind) folded before Flop
Seat 3: KovIFish89 (big blind) folded before Flop
Seat 4: mbk88 folded before Flop (didn't bet)
Seat 5: Rohitbarve folded before Flop (didn't bet)
Seat 6: matiko09 collected ($2.50)
Seat 7: DomiVY folded before Flop (didn't bet)
Seat 8: picka4u folded before Flop (didn't bet)





PokerStars Hand #155380039481:  Hold'em No Limit ($0.50/$1.00 USD) - 2016/06/30 13:50:20 CET [2016/06/30 7:50:20 ET]
Table 'Prieska' 9-max Seat #9 is the button
Seat 1: KovIFish89 ($119.09 in chips) 
Seat 2: B_style_cuz ($104.43 in chips) 
Seat 3: Rafaello18 ($125.50 in chips) 
Seat 5: ramzes160468 ($64.02 in chips) 
Seat 6: DIMAN_324 ($102.50 in chips) 
Seat 7: matiko09 ($100 in chips) 
Seat 8: mbk88 ($124.45 in chips) 
Seat 9: Konig26 ($98.50 in chips) 
KovIFish89: posts small blind $0.50
B_style_cuz: posts big blind $1
matteo080613: sits out 
*** HOLE CARDS ***
Dealt to matiko09 [Qc 7s]
Rafaello18: raises $1.50 to $2.50
ramzes160468: folds 
DIMAN_324: folds 
matiko09: folds 
mbk88: folds 
Konig26: folds 
matteo080613 leaves the table
KovIFish89 is disconnected 
KovIFish89 has timed out while disconnected
KovIFish89: folds 
nickreason17 joins the table at seat #4 
B_style_cuz: folds 
Uncalled bet ($1.50) returned to Rafaello18
Rafaello18 collected $2.50 from pot
Rafaello18: doesn't show hand 
*** SUMMARY ***
Total pot $2.50 | Rake $0 
Seat 1: KovIFish89 (small blind) folded before Flop
Seat 2: B_style_cuz (big blind) folded before Flop
Seat 3: Rafaello18 collected ($2.50)
Seat 5: ramzes160468 folded before Flop (didn't bet)
Seat 6: DIMAN_324 folded before Flop (didn't bet)
Seat 7: matiko09 folded before Flop (didn't bet)
Seat 8: mbk88 folded before Flop (didn't bet)
Seat 9: Konig26 (button) folded before Flop (didn't bet)





PokerStars Hand #155380040168:  Hold'em No Limit ($0.25/$0.50 USD) - 2016/06/30 13:50:22 CET [2016/06/30 7:50:22 ET]
Table 'Mentha II' 9-max Seat #1 is the button
Seat 1: Bailey Dew ($173.62 in chips) 
Seat 2: TheMinion ($53.62 in chips) 
Seat 3: joker180785 ($50 in chips) 
Seat 4: 55peter1 ($76.63 in chips) 
Seat 5: maxxmeister ($51.25 in chips) 
Seat 7: ardo888 ($147.25 in chips) 
Seat 8: drlee77 ($45.70 in chips) 
Seat 9: matiko09 ($50 in chips) 
TheMinion: posts small blind $0.25
joker180785: posts big blind $0.50
Bailey Dew: posts the ante $0.10
TheMinion: posts the ante $0.10
joker180785: posts the ante $0.10
55peter1: posts the ante $0.10
maxxmeister: posts the ante $0.10
ardo888: posts the ante $0.10
drlee77: posts the ante $0.10
matiko09: posts the ante $0.10
*** HOLE CARDS ***
Dealt to matiko09 [Ts Ah]
55peter1: folds 
Alexey_Kim2 joins the table at seat #6 
maxxmeister: folds 
ardo888: folds 
drlee77: raises $1 to $1.50
matiko09: folds 
Bailey Dew: folds 
TheMinion: folds 
joker180785: folds 
Uncalled bet ($1) returned to drlee77
drlee77 collected $2.05 from pot
drlee77: doesn't show hand 
*** SUMMARY ***
Total pot $2.05 | Rake $0 
Seat 1: Bailey Dew (button) folded before Flop (didn't bet)
Seat 2: TheMinion (small blind) folded before Flop
Seat 3: joker180785 (big blind) folded before Flop
Seat 4: 55peter1 folded before Flop (didn't bet)
Seat 5: maxxmeister folded before Flop (didn't bet)
Seat 7: ardo888 folded before Flop (didn't bet)
Seat 8: drlee77 collected ($2.05)
Seat 9: matiko09 folded before Flop (didn't bet)





PokerStars Hand #155380041114:  Hold'em No Limit ($0.50/$1.00 USD) - 2016/06/30 13:50:24 CET [2016/06/30 7:50:24 ET]
Table 'Tatjana' 9-max Seat #7 is the button
Seat 1: ardo888 ($112.46 in chips) 
Seat 2: DIMAN_324 ($103 in chips) 
Seat 3: Rafaello18 ($100 in chips) 
Seat 4: mopatron25 ($85.05 in chips) 
Seat 5: matiko09 ($100 in chips) 
Seat 7: daigodisco ($38.13 in chips) 
Seat 8: alhill86 ($116.41 in chips) 
Seat 9: POTAPENKO700 ($141.21 in chips) 
alhill86: posts small blind $0.50
POTAPENKO700: posts big blind $1
*** HOLE CARDS ***
Dealt to matiko09 [6h 8s]
ardo888: folds 
DIMAN_324: folds 
Rafaello18: raises $1.50 to $2.50
mopatron25: folds 
matiko09: folds 
daigodisco: folds 
alhill86: raises $5.50 to $8
POTAPENKO700: folds 
Rafaello18: calls $5.50
*** FLOP *** [7s Kh Td]
alhill86: checks 
Rafaello18: checks 
*** TURN *** [7s Kh Td] [Kd]
alhill86: bets $8.07
Rafaello18: calls $8.07
*** RIVER *** [7s Kh Td Kd] [5s]
alhill86: bets $20
Rafaello18: calls $20
*** SHOW DOWN ***
alhill86: shows [Qc Qd] (two pair, Kings and Queens)
Rafaello18: shows [Qs Ks] (three of a kind, Kings)
Rafaello18 collected $70.64 from pot
*** SUMMARY ***
Total pot $73.14 | Rake $2.50 
Board [7s Kh Td Kd 5s]
Seat 1: ardo888 folded before Flop (didn't bet)
Seat 2: DIMAN_324 folded before Flop (didn't bet)
Seat 3: Rafaello18 showed [Qs Ks] and won ($70.64) with three of a kind, Kings
Seat 4: mopatron25 folded before Flop (didn't bet)
Seat 5: matiko09 folded before Flop (didn't bet)
Seat 7: daigodisco (button) folded before Flop (didn't bet)
Seat 8: alhill86 (small blind) showed [Qc Qd] and lost with two pair, Kings and Queens
Seat 9: POTAPENKO700 (big blind) folded before Flop





PokerStars Hand #155380042337:  Hold'em No Limit ($0.50/$1.00 USD) - 2016/06/30 13:50:27 CET [2016/06/30 7:50:27 ET]
Table 'Armisticia' 9-max Seat #1 is the button
Seat 1: tipner ($124.03 in chips) 
Seat 2: atlant244 ($54.10 in chips) 
Seat 4: ardo888 ($105.55 in chips) 
Seat 5: SonerWPT ($105.25 in chips) 
Seat 6: matiko09 ($121.30 in chips) 
Seat 7: ilaviiitech ($100 in chips) 
Seat 8: techahn ($132.88 in chips) 
Seat 9: mbk88 ($114.81 in chips) 
atlant244: posts small blind $0.50
KovIFish89 has timed out while being disconnected
KovIFish89: is sitting out 
ardo888: posts big blind $1
*** HOLE CARDS ***
Dealt to matiko09 [3s 9h]
KovIFish89 is disconnected 
SonerWPT: calls $1
atlant244 said, ":)"
matiko09: folds 
ilaviiitech: folds 
techahn: calls $1
mbk88: folds 
tipner: raises $4 to $5
atlant244: folds 
ardo888: folds 
SonerWPT: raises $14 to $19
techahn: folds 
tipner: folds 
Uncalled bet ($14) returned to SonerWPT
atlant244 leaves the table
SonerWPT collected $12.50 from pot
SonerWPT: doesn't show hand 
*** SUMMARY ***
Total pot $12.50 | Rake $0 
Seat 1: tipner (button) folded before Flop
Seat 2: atlant244 (small blind) folded before Flop
Seat 4: ardo888 (big blind) folded before Flop
Seat 5: SonerWPT collected ($12.50)
Seat 6: matiko09 folded before Flop (didn't bet)
Seat 7: ilaviiitech folded before Flop (didn't bet)
Seat 8: techahn folded before Flop
Seat 9: mbk88 folded before Flop (didn't bet)





PokerStars Hand #155380044447:  Hold'em No Limit ($0.50/$1.00 USD) - 2016/06/30 13:50:32 CET [2016/06/30 7:50:32 ET]
Table 'Borrelly II' 9-max Seat #1 is the button
Seat 1: Rafaello18 ($118.89 in chips) 
Seat 2: mbk88 ($104.62 in chips) 
Seat 4: DonRon_AT ($39.81 in chips) 
Seat 5: DIMAN_324 ($100 in chips) 
Seat 6: m_michalec ($173.58 in chips) 
Seat 7: matiko09 ($170.34 in chips) 
Seat 8: Arjun A Raju ($98.50 in chips) 
Seat 9: alhill86 ($78.50 in chips) 
mbk88: posts small blind $0.50
DonRon_AT: posts big blind $1
*** HOLE CARDS ***
Dealt to matiko09 [Jh Qh]
DIMAN_324: folds 
m_michalec: folds 
matiko09: raises $2 to $3
Arjun A Raju: folds 
alhill86: calls $3
Rafaello18: folds 
mbk88: folds 
DonRon_AT: calls $2
*** FLOP *** [Kc 5h 6h]
DonRon_AT: checks 
matiko09: bets $5.86
alhill86: folds 
DonRon_AT: folds 
Uncalled bet ($5.86) returned to matiko09
matiko09 collected $9.02 from pot
matiko09: doesn't show hand 
*** SUMMARY ***
Total pot $9.50 | Rake $0.48 
Board [Kc 5h 6h]
Seat 1: Rafaello18 (button) folded before Flop (didn't bet)
Seat 2: mbk88 (small blind) folded before Flop
Seat 4: DonRon_AT (big blind) folded on the Flop
Seat 5: DIMAN_324 folded before Flop (didn't bet)
Seat 6: m_michalec folded before Flop (didn't bet)
Seat 7: matiko09 collected ($9.02)
Seat 8: Arjun A Raju folded before Flop (didn't bet)
Seat 9: alhill86 folded on the Flop





PokerStars Hand #155380061235:  Hold'em No Limit ($0.25/$0.50 USD) - 2016/06/30 13:50:47 CET [2016/06/30 7:50:47 ET]
Table 'Mentha II' 9-max Seat #2 is the button
Seat 1: Bailey Dew ($173.52 in chips) 
Seat 2: TheMinion ($53.27 in chips) 
Seat 3: joker180785 ($50 in chips) 
Seat 4: 55peter1 ($76.53 in chips) 
Seat 5: maxxmeister ($51.15 in chips) 
Seat 7: ardo888 ($147.15 in chips) 
Seat 8: drlee77 ($47.15 in chips) 
Seat 9: matiko09 ($50 in chips) 
joker180785: posts small blind $0.25
55peter1: posts big blind $0.50
Alexey_Kim2: sits out 
Bailey Dew: posts the ante $0.10
TheMinion: posts the ante $0.10
joker180785: posts the ante $0.10
55peter1: posts the ante $0.10
maxxmeister: posts the ante $0.10
ardo888: posts the ante $0.10
drlee77: posts the ante $0.10
matiko09: posts the ante $0.10
*** HOLE CARDS ***
Dealt to matiko09 [Kh 2s]
maxxmeister: folds 
maxxmeister leaves the table
ardo888: folds 
drlee77: folds 
matiko09: folds 
Bailey Dew: folds 
TheMinion: folds 
joker180785: folds 
Uncalled bet ($0.25) returned to 55peter1
55peter1 collected $1.30 from pot
55peter1: doesn't show hand 
*** SUMMARY ***
Total pot $1.30 | Rake $0 
Seat 1: Bailey Dew folded before Flop (didn't bet)
Seat 2: TheMinion (button) folded before Flop (didn't bet)
Seat 3: joker180785 (small blind) folded before Flop
Seat 4: 55peter1 (big blind) collected ($1.30)
Seat 5: maxxmeister folded before Flop (didn't bet)
Seat 7: ardo888 folded before Flop (didn't bet)
Seat 8: drlee77 folded before Flop (didn't bet)
Seat 9: matiko09 folded before Flop (didn't bet)





PokerStars Hand #155380062310:  Hold'em No Limit ($0.50/$1.00 USD) - 2016/06/30 13:50:50 CET [2016/06/30 7:50:50 ET]
Table 'Asmodeus' 9-max Seat #7 is the button
Seat 1: scollop ($126.70 in chips) 
Seat 2: picka4u ($40.80 in chips) 
Seat 3: matiko09 ($103.75 in chips) 
Seat 4: ardo888 ($121.28 in chips) 
Seat 5: sanr23 ($100 in chips) 
Seat 6: koutani7 ($91 in chips) 
Seat 7: aaronzzr ($150.04 in chips) 
Seat 8: Rafaello18 ($152.45 in chips) 
Seat 9: mbk88 ($156.18 in chips) 
Rafaello18: posts small blind $0.50
mbk88: posts big blind $1
*** HOLE CARDS ***
Dealt to matiko09 [Tc Qd]
scollop: folds 
picka4u: folds 
matiko09: folds 
ardo888: raises $2 to $3
sanr23: folds 
koutani7: folds 
aaronzzr: folds 
Rafaello18: folds 
mbk88: calls $2
*** FLOP *** [6s 8c Kc]
mbk88: checks 
ardo888: checks 
*** TURN *** [6s 8c Kc] [4d]
mbk88: bets $4
ardo888: folds 
Uncalled bet ($4) returned to mbk88
mbk88 collected $6.18 from pot
mbk88: doesn't show hand 
*** SUMMARY ***
Total pot $6.50 | Rake $0.32 
Board [6s 8c Kc 4d]
Seat 1: scollop folded before Flop (didn't bet)
Seat 2: picka4u folded before Flop (didn't bet)
Seat 3: matiko09 folded before Flop (didn't bet)
Seat 4: ardo888 folded on the Turn
Seat 5: sanr23 folded before Flop (didn't bet)
Seat 6: koutani7 folded before Flop (didn't bet)
Seat 7: aaronzzr (button) folded before Flop (didn't bet)
Seat 8: Rafaello18 (small blind) folded before Flop
Seat 9: mbk88 (big blind) collected ($6.18)





PokerStars Hand #155380067799:  Hold'em No Limit ($0.25/$0.50 USD) - 2016/06/30 13:51:05 CET [2016/06/30 7:51:05 ET]
Table 'Mentha II' 9-max Seat #3 is the button
Seat 1: Bailey Dew ($173.42 in chips) 
Seat 2: TheMinion ($53.17 in chips) 
Seat 3: joker180785 ($50 in chips) 
Seat 4: 55peter1 ($77.48 in chips) 
Seat 6: Alexey_Kim2 ($50 in chips) 
Seat 7: ardo888 ($147.05 in chips) 
Seat 8: drlee77 ($47.05 in chips) 
Seat 9: matiko09 ($50 in chips) 
55peter1: posts small blind $0.25
Alexey_Kim2: posts big blind $0.50
Bailey Dew: posts the ante $0.10
TheMinion: posts the ante $0.10
joker180785: posts the ante $0.10
55peter1: posts the ante $0.10
Alexey_Kim2: posts the ante $0.10
ardo888: posts the ante $0.10
drlee77: posts the ante $0.10
matiko09: posts the ante $0.10
*** HOLE CARDS ***
Dealt to matiko09 [8c 7d]
ardo888: folds 
drlee77: folds 
matiko09: folds 
Bailey Dew: folds 
TheMinion: raises $0.75 to $1.25
joker180785: folds 
55peter1: calls $1
Alexey_Kim2: folds 
*** FLOP *** [7c 4s 6c]
55peter1: checks 
TheMinion: checks 
*** TURN *** [7c 4s 6c] [Kd]
55peter1: checks 
TheMinion: checks 
*** RIVER *** [7c 4s 6c Kd] [3h]
55peter1: checks 
TheMinion: checks 
*** SHOW DOWN ***
55peter1: shows [Td 8s] (high card King)
TheMinion: shows [Ad Qs] (high card Ace)
TheMinion collected $3.61 from pot
*** SUMMARY ***
Total pot $3.80 | Rake $0.19 
Board [7c 4s 6c Kd 3h]
Seat 1: Bailey Dew folded before Flop (didn't bet)
Seat 2: TheMinion showed [Ad Qs] and won ($3.61) with high card Ace
Seat 3: joker180785 (button) folded before Flop (didn't bet)
Seat 4: 55peter1 (small blind) showed [Td 8s] and lost with high card King
Seat 6: Alexey_Kim2 (big blind) folded before Flop
Seat 7: ardo888 folded before Flop (didn't bet)
Seat 8: drlee77 folded before Flop (didn't bet)
Seat 9: matiko09 folded before Flop (didn't bet)





PokerStars Hand #155380071932:  Hold'em No Limit ($0.50/$1.00 USD) - 2016/06/30 13:51:12 CET [2016/06/30 7:51:12 ET]
Table 'California II' 9-max Seat #2 is the button
Seat 1: Rafaello18 ($112.52 in chips) 
Seat 2: velourleder ($78.50 in chips) 
Seat 4: mbk88 ($206.70 in chips) 
Seat 5: Rohitbarve ($102.74 in chips) 
Seat 6: matiko09 ($119.35 in chips) 
Seat 7: DomiVY ($85.70 in chips) 
Seat 8: picka4u ($42.32 in chips) 
mbk88: posts small blind $0.50
Rohitbarve: posts big blind $1
di0d80: sits out 
*** HOLE CARDS ***
Dealt to matiko09 [2s 3s]
matiko09: folds 
DomiVY: folds 
picka4u: raises $1.25 to $2.25
Rafaello18: folds 
velourleder: folds 
mbk88: folds 
Rohitbarve: folds 
Uncalled bet ($1.25) returned to picka4u
picka4u collected $2.50 from pot
picka4u: doesn't show hand 
*** SUMMARY ***
Total pot $2.50 | Rake $0 
Seat 1: Rafaello18 folded before Flop (didn't bet)
Seat 2: velourleder (button) folded before Flop (didn't bet)
Seat 4: mbk88 (small blind) folded before Flop
Seat 5: Rohitbarve (big blind) folded before Flop
Seat 6: matiko09 folded before Flop (didn't bet)
Seat 7: DomiVY folded before Flop (didn't bet)
Seat 8: picka4u collected ($2.50)





PokerStars Hand #155380073681:  Hold'em No Limit ($0.50/$1.00 USD) - 2016/06/30 13:51:17 CET [2016/06/30 7:51:17 ET]
Table 'Prieska' 9-max Seat #2 is the button
Seat 2: B_style_cuz ($103.43 in chips) 
Seat 3: Rafaello18 ($127 in chips) 
Seat 4: nickreason17 ($100 in chips) 
Seat 5: ramzes160468 ($64.02 in chips) 
Seat 6: DIMAN_324 ($102.50 in chips) 
Seat 7: matiko09 ($100 in chips) 
Seat 8: mbk88 ($124.45 in chips) 
Seat 9: Konig26 ($98.50 in chips) 
Rafaello18: posts small blind $0.50
nickreason17: posts big blind $1
*** HOLE CARDS ***
Dealt to matiko09 [Qc 3d]
ramzes160468: folds 
DIMAN_324: folds 
matiko09: folds 
mbk88: folds 
Konig26: folds 
B_style_cuz: folds 
Rafaello18: raises $1.50 to $2.50
nickreason17: folds 
Uncalled bet ($1.50) returned to Rafaello18
Rafaello18 collected $2 from pot
Rafaello18: doesn't show hand 
*** SUMMARY ***
Total pot $2 | Rake $0 
Seat 2: B_style_cuz (button) folded before Flop (didn't bet)
Seat 3: Rafaello18 (small blind) collected ($2)
Seat 4: nickreason17 (big blind) folded before Flop
Seat 5: ramzes160468 folded before Flop (didn't bet)
Seat 6: DIMAN_324 folded before Flop (didn't bet)
Seat 7: matiko09 folded before Flop (didn't bet)
Seat 8: mbk88 folded before Flop (didn't bet)
Seat 9: Konig26 folded before Flop (didn't bet)





PokerStars Hand #155380076404:  Hold'em No Limit ($0.50/$1.00 USD) - 2016/06/30 13:51:23 CET [2016/06/30 7:51:23 ET]
Table 'Altarf II' 9-max Seat #9 is the button
Seat 3: sanr23 ($144.05 in chips) 
Seat 4: Greha999 ($81.66 in chips) 
Seat 5: DIMAN_324 ($101.50 in chips) 
Seat 6: mbk88 ($192.80 in chips) 
Seat 7: matiko09 ($106.22 in chips) 
Seat 8: DomiVY ($40 in chips) 
Seat 9: omanibemihum ($100 in chips) 
Rafaello18 will be allowed to play after the button
sanr23: posts small blind $0.50
Greha999: posts big blind $1
*** HOLE CARDS ***
Dealt to matiko09 [2c Jc]
DIMAN_324: raises $2 to $3
mbk88: calls $3
matiko09: folds 
DomiVY: folds 
omanibemihum: folds 
sanr23: folds 
Greha999: folds 
*** FLOP *** [3h 6c Tc]
DIMAN_324: checks 
mbk88: checks 
*** TURN *** [3h 6c Tc] [Qd]
DIMAN_324: bets $5.34
mbk88: folds 
Uncalled bet ($5.34) returned to DIMAN_324
DIMAN_324 collected $7.12 from pot
DIMAN_324: doesn't show hand 
*** SUMMARY ***
Total pot $7.50 | Rake $0.38 
Board [3h 6c Tc Qd]
Seat 3: sanr23 (small blind) folded before Flop
Seat 4: Greha999 (big blind) folded before Flop
Seat 5: DIMAN_324 collected ($7.12)
Seat 6: mbk88 folded on the Turn
Seat 7: matiko09 folded before Flop (didn't bet)
Seat 8: DomiVY folded before Flop (didn't bet)
Seat 9: omanibemihum (button) folded before Flop (didn't bet)





PokerStars Hand #155380078006:  Hold'em No Limit ($0.50/$1.00 USD) - 2016/06/30 13:51:27 CET [2016/06/30 7:51:27 ET]
Table 'Tatjana' 9-max Seat #8 is the button
Seat 1: ardo888 ($112.46 in chips) 
Seat 2: DIMAN_324 ($103 in chips) 
Seat 3: Rafaello18 ($134.57 in chips) 
Seat 4: mopatron25 ($85.05 in chips) 
Seat 5: matiko09 ($100 in chips) 
Seat 7: daigodisco ($38.13 in chips) 
Seat 8: alhill86 ($80.34 in chips) 
Seat 9: POTAPENKO700 ($140.21 in chips) 
POTAPENKO700: posts small blind $0.50
ardo888: posts big blind $1
mbk88: sits out 
*** HOLE CARDS ***
Dealt to matiko09 [2s Td]
DIMAN_324: folds 
Rafaello18: folds 
mopatron25: folds 
matiko09: folds 
daigodisco has timed out
daigodisco: folds 
alhill86: folds 
POTAPENKO700: folds 
Uncalled bet ($0.50) returned to ardo888
ardo888 collected $1 from pot
ardo888: doesn't show hand 
*** SUMMARY ***
Total pot $1 | Rake $0 
Seat 1: ardo888 (big blind) collected ($1)
Seat 2: DIMAN_324 folded before Flop (didn't bet)
Seat 3: Rafaello18 folded before Flop (didn't bet)
Seat 4: mopatron25 folded before Flop (didn't bet)
Seat 5: matiko09 folded before Flop (didn't bet)
Seat 7: daigodisco folded before Flop (didn't bet)
Seat 8: alhill86 (button) folded before Flop (didn't bet)
Seat 9: POTAPENKO700 (small blind) folded before Flop





PokerStars Hand #155380078790:  Hold'em No Limit ($0.50/$1.00 USD) - 2016/06/30 13:51:29 CET [2016/06/30 7:51:29 ET]
Table 'Armisticia' 9-max Seat #4 is the button
Seat 1: tipner ($119.03 in chips) 
Seat 4: ardo888 ($104.55 in chips) 
Seat 5: SonerWPT ($112.75 in chips) 
Seat 6: matiko09 ($121.30 in chips) 
Seat 7: ilaviiitech ($100 in chips) 
Seat 8: techahn ($131.88 in chips) 
Seat 9: mbk88 ($114.81 in chips) 
SonerWPT: posts small blind $0.50
matiko09: posts big blind $1
*** HOLE CARDS ***
Dealt to matiko09 [Td Qc]
di0d80 joins the table at seat #2 
ilaviiitech: folds 
techahn: folds 
mbk88: folds 
tipner: folds 
ardo888: folds 
SonerWPT: calls $0.50
matiko09: raises $3 to $4
SonerWPT: folds 
Uncalled bet ($3) returned to matiko09
matiko09 collected $2 from pot
matiko09: doesn't show hand 
*** SUMMARY ***
Total pot $2 | Rake $0 
Seat 1: tipner folded before Flop (didn't bet)
Seat 4: ardo888 (button) folded before Flop (didn't bet)
Seat 5: SonerWPT (small blind) folded before Flop
Seat 6: matiko09 (big blind) collected ($2)
Seat 7: ilaviiitech folded before Flop (didn't bet)
Seat 8: techahn folded before Flop (didn't bet)
Seat 9: mbk88 folded before Flop (didn't bet)





PokerStars Hand #155380081383:  Hold'em No Limit ($0.50/$1.00 USD) - 2016/06/30 13:51:35 CET [2016/06/30 7:51:35 ET]
Table 'Asmodeus' 9-max Seat #8 is the button
Seat 1: scollop ($126.70 in chips) 
Seat 2: picka4u ($40.80 in chips) 
Seat 3: matiko09 ($103.75 in chips) 
Seat 4: ardo888 ($118.28 in chips) 
Seat 5: sanr23 ($100 in chips) 
Seat 6: koutani7 ($91 in chips) 
Seat 7: aaronzzr ($150.04 in chips) 
Seat 8: Rafaello18 ($151.95 in chips) 
Seat 9: mbk88 ($159.36 in chips) 
mbk88: posts small blind $0.50
scollop: posts big blind $1
*** HOLE CARDS ***
Dealt to matiko09 [Ad 9s]
picka4u: folds 
matiko09: folds 
ardo888: folds 
sanr23: folds 
koutani7: folds 
aaronzzr: folds 
Rafaello18: raises $1.50 to $2.50
mbk88: folds 
scollop: calls $1.50
*** FLOP *** [7h 5h 9h]
scollop: checks 
Rafaello18: checks 
*** TURN *** [7h 5h 9h] [3h]
scollop: checks 
Rafaello18: checks 
*** RIVER *** [7h 5h 9h 3h] [7s]
scollop: bets $1
Rafaello18: calls $1
*** SHOW DOWN ***
scollop: shows [Tc 7d] (three of a kind, Sevens)
Rafaello18: shows [Jd Th] (a flush, Ten high)
Rafaello18 collected $7.12 from pot
*** SUMMARY ***
Total pot $7.50 | Rake $0.38 
Board [7h 5h 9h 3h 7s]
Seat 1: scollop (big blind) showed [Tc 7d] and lost with three of a kind, Sevens
Seat 2: picka4u folded before Flop (didn't bet)
Seat 3: matiko09 folded before Flop (didn't bet)
Seat 4: ardo888 folded before Flop (didn't bet)
Seat 5: sanr23 folded before Flop (didn't bet)
Seat 6: koutani7 folded before Flop (didn't bet)
Seat 7: aaronzzr folded before Flop (didn't bet)
Seat 8: Rafaello18 (button) showed [Jd Th] and won ($7.12) with a flush, Ten high
Seat 9: mbk88 (small blind) folded before Flop





PokerStars Hand #155380082501:  Hold'em No Limit ($0.50/$1.00 USD) - 2016/06/30 13:51:37 CET [2016/06/30 7:51:37 ET]
Table 'Borrelly II' 9-max Seat #2 is the button
Seat 1: Rafaello18 ($118.89 in chips) 
Seat 2: mbk88 ($104.12 in chips) 
Seat 4: DonRon_AT ($36.81 in chips) 
Seat 5: DIMAN_324 ($100 in chips) 
Seat 6: m_michalec ($173.58 in chips) 
Seat 7: matiko09 ($176.36 in chips) 
Seat 8: Arjun A Raju ($98.50 in chips) 
Seat 9: alhill86 ($75.50 in chips) 
di0d80 will be allowed to play after the button
DonRon_AT: posts small blind $0.50
DIMAN_324: posts big blind $1
*** HOLE CARDS ***
Dealt to matiko09 [8c 4d]
m_michalec: folds 
matiko09: folds 
Arjun A Raju: folds 
alhill86: folds 
Rafaello18: folds 
mbk88: folds 
DonRon_AT: calls $0.50
DIMAN_324: checks 
*** FLOP *** [6d Kd 7s]
DonRon_AT: bets $2
DIMAN_324: calls $2
*** TURN *** [6d Kd 7s] [5c]
DonRon_AT: bets $4
DIMAN_324: folds 
Uncalled bet ($4) returned to DonRon_AT
DonRon_AT collected $5.70 from pot
*** SUMMARY ***
Total pot $6 | Rake $0.30 
Board [6d Kd 7s 5c]
Seat 1: Rafaello18 folded before Flop (didn't bet)
Seat 2: mbk88 (button) folded before Flop (didn't bet)
Seat 4: DonRon_AT (small blind) collected ($5.70)
Seat 5: DIMAN_324 (big blind) folded on the Turn
Seat 6: m_michalec folded before Flop (didn't bet)
Seat 7: matiko09 folded before Flop (didn't bet)
Seat 8: Arjun A Raju folded before Flop (didn't bet)
Seat 9: alhill86 folded before Flop (didn't bet)





PokerStars Hand #155380086144:  Hold'em No Limit ($0.50/$1.00 USD) - 2016/06/30 13:51:46 CET [2016/06/30 7:51:46 ET]
Table 'Prieska' 9-max Seat #3 is the button
Seat 2: B_style_cuz ($103.43 in chips) 
Seat 3: Rafaello18 ($128 in chips) 
Seat 4: nickreason17 ($100 in chips) 
Seat 5: ramzes160468 ($64.02 in chips) 
Seat 6: DIMAN_324 ($102.50 in chips) 
Seat 7: matiko09 ($100 in chips) 
Seat 8: mbk88 ($124.45 in chips) 
Seat 9: Konig26 ($98.50 in chips) 
nickreason17: posts small blind $0.50
ramzes160468: posts big blind $1
*** HOLE CARDS ***
Dealt to matiko09 [Jd 9c]
DIMAN_324: folds 
matiko09: folds 
mbk88: folds 
Konig26: folds 
B_style_cuz: raises $2.50 to $3.50
Rafaello18: folds 
nickreason17: folds 
ramzes160468: folds 
Uncalled bet ($2.50) returned to B_style_cuz
B_style_cuz collected $2.50 from pot
*** SUMMARY ***
Total pot $2.50 | Rake $0 
Seat 2: B_style_cuz collected ($2.50)
Seat 3: Rafaello18 (button) folded before Flop (didn't bet)
Seat 4: nickreason17 (small blind) folded before Flop
Seat 5: ramzes160468 (big blind) folded before Flop
Seat 6: DIMAN_324 folded before Flop (didn't bet)
Seat 7: matiko09 folded before Flop (didn't bet)
Seat 8: mbk88 folded before Flop (didn't bet)
Seat 9: Konig26 folded before Flop (didn't bet)





PokerStars Hand #155380087591:  Hold'em No Limit ($0.50/$1.00 USD) - 2016/06/30 13:51:49 CET [2016/06/30 7:51:49 ET]
Table 'California II' 9-max Seat #4 is the button
Seat 1: Rafaello18 ($112.52 in chips) 
Seat 2: velourleder ($78.50 in chips) 
Seat 4: mbk88 ($206.20 in chips) 
Seat 5: Rohitbarve ($101.74 in chips) 
Seat 6: matiko09 ($119.35 in chips) 
Seat 7: DomiVY ($85.70 in chips) 
Seat 8: picka4u ($43.82 in chips) 
Rohitbarve: posts small blind $0.50
matiko09: posts big blind $1
di0d80: sits out 
*** HOLE CARDS ***
Dealt to matiko09 [5h 3h]
DomiVY: folds 
picka4u: raises $1.25 to $2.25
Rafaello18: folds 
velourleder: folds 
mbk88: folds 
Rohitbarve: folds 
matiko09: folds 
Uncalled bet ($1.25) returned to picka4u
picka4u collected $2.50 from pot
picka4u: doesn't show hand 
*** SUMMARY ***
Total pot $2.50 | Rake $0 
Seat 1: Rafaello18 folded before Flop (didn't bet)
Seat 2: velourleder folded before Flop (didn't bet)
Seat 4: mbk88 (button) folded before Flop (didn't bet)
Seat 5: Rohitbarve (small blind) folded before Flop
Seat 6: matiko09 (big blind) folded before Flop
Seat 7: DomiVY folded before Flop (didn't bet)
Seat 8: picka4u collected ($2.50)





PokerStars Hand #155380087696:  Hold'em No Limit ($0.50/$1.00 USD) - 2016/06/30 13:51:49 CET [2016/06/30 7:51:49 ET]
Table 'Armisticia' 9-max Seat #5 is the button
Seat 1: tipner ($119.03 in chips) 
Seat 4: ardo888 ($104.55 in chips) 
Seat 5: SonerWPT ($111.75 in chips) 
Seat 6: matiko09 ($122.30 in chips) 
Seat 7: ilaviiitech ($100 in chips) 
Seat 8: techahn ($131.88 in chips) 
Seat 9: mbk88 ($114.81 in chips) 
matiko09: posts small blind $0.50
ilaviiitech: posts big blind $1
di0d80: sits out 
*** HOLE CARDS ***
Dealt to matiko09 [7c 4s]
techahn: folds 
techahn leaves the table
mbk88: folds 
tipner: raises $2 to $3
ardo888: folds 
SonerWPT: folds 
matiko09: folds 
ilaviiitech: folds 
Uncalled bet ($2) returned to tipner
tipner collected $2.50 from pot
tipner: doesn't show hand 
*** SUMMARY ***
Total pot $2.50 | Rake $0 
Seat 1: tipner collected ($2.50)
Seat 4: ardo888 folded before Flop (didn't bet)
Seat 5: SonerWPT (button) folded before Flop (didn't bet)
Seat 6: matiko09 (small blind) folded before Flop
Seat 7: ilaviiitech (big blind) folded before Flop
Seat 8: techahn folded before Flop (didn't bet)
Seat 9: mbk88 folded before Flop (didn't bet)





PokerStars Hand #155380089934:  Hold'em No Limit ($0.25/$0.50 USD) - 2016/06/30 13:51:54 CET [2016/06/30 7:51:54 ET]
Table 'Dorothea II' 9-max Seat #9 is the button
Seat 1: zapata 7777 ($49.40 in chips) 
Seat 2: joker180785 ($50 in chips) 
Seat 3: Franky77200 ($56.91 in chips) 
Seat 4: matiko09 ($148.07 in chips) 
Seat 5: Bailey Dew ($87.65 in chips) 
Seat 6: ivan100886 ($26.71 in chips) 
Seat 7: desmo465 ($47.05 in chips) 
Seat 8: TheMinion ($50 in chips) 
Seat 9: funXmun ($52.07 in chips) 
zapata 7777: posts small blind $0.25
joker180785: posts big blind $0.50
zapata 7777: posts the ante $0.10
joker180785: posts the ante $0.10
Franky77200: posts the ante $0.10
matiko09: posts the ante $0.10
Bailey Dew: posts the ante $0.10
ivan100886: posts the ante $0.10
desmo465: posts the ante $0.10
TheMinion: posts the ante $0.10
funXmun: posts the ante $0.10
*** HOLE CARDS ***
Dealt to matiko09 [8d 2d]
Franky77200: raises $1 to $1.50
matiko09: folds 
Bailey Dew: folds 
ivan100886: folds 
desmo465: folds 
TheMinion: folds 
funXmun: raises $2.25 to $3.75
zapata 7777: folds 
joker180785: folds 
Franky77200: calls $2.25
*** FLOP *** [4d 3c Kh]
Franky77200: checks 
funXmun: checks 
*** TURN *** [4d 3c Kh] [6d]
Franky77200: checks 
funXmun: checks 
*** RIVER *** [4d 3c Kh 6d] [4s]
Franky77200: bets $6
funXmun: folds 
Uncalled bet ($6) returned to Franky77200
Franky77200 collected $8.69 from pot
Franky77200: doesn't show hand 
*** SUMMARY ***
Total pot $9.15 | Rake $0.46 
Board [4d 3c Kh 6d 4s]
Seat 1: zapata 7777 (small blind) folded before Flop
Seat 2: joker180785 (big blind) folded before Flop
Seat 3: Franky77200 collected ($8.69)
Seat 4: matiko09 folded before Flop (didn't bet)
Seat 5: Bailey Dew folded before Flop (didn't bet)
Seat 6: ivan100886 folded before Flop (didn't bet)
Seat 7: desmo465 folded before Flop (didn't bet)
Seat 8: TheMinion folded before Flop (didn't bet)
Seat 9: funXmun (button) folded on the River





PokerStars Hand #155380092491:  Hold'em No Limit ($0.50/$1.00 USD) - 2016/06/30 13:52:00 CET [2016/06/30 7:52:00 ET]
Table 'Tatjana' 9-max Seat #9 is the button
Seat 1: ardo888 ($112.96 in chips) 
Seat 2: DIMAN_324 ($103 in chips) 
Seat 3: Rafaello18 ($134.57 in chips) 
Seat 4: mopatron25 ($85.05 in chips) 
Seat 5: matiko09 ($100 in chips) 
Seat 8: alhill86 ($80.34 in chips) 
Seat 9: POTAPENKO700 ($139.71 in chips) 
ardo888: posts small blind $0.50
DIMAN_324: posts big blind $1
mbk88: sits out 
*** HOLE CARDS ***
Dealt to matiko09 [Td Jd]
Rafaello18: folds 
mopatron25: calls $1
matiko09: raises $3.50 to $4.50
alhill86: folds 
POTAPENKO700: folds 
ardo888: folds 
DIMAN_324: folds 
mopatron25: calls $3.50
*** FLOP *** [2h 7h 4c]
mopatron25: bets $2
matiko09: folds 
Uncalled bet ($2) returned to mopatron25
mopatron25 collected $9.98 from pot
mopatron25: doesn't show hand 
*** SUMMARY ***
Total pot $10.50 | Rake $0.52 
Board [2h 7h 4c]
Seat 1: ardo888 (small blind) folded before Flop
Seat 2: DIMAN_324 (big blind) folded before Flop
Seat 3: Rafaello18 folded before Flop (didn't bet)
Seat 4: mopatron25 collected ($9.98)
Seat 5: matiko09 folded on the Flop
Seat 8: alhill86 folded before Flop (didn't bet)
Seat 9: POTAPENKO700 (button) folded before Flop (didn't bet)





PokerStars Hand #155380093907:  Hold'em No Limit ($0.25/$0.50 USD) - 2016/06/30 13:52:03 CET [2016/06/30 7:52:03 ET]
Table 'Elektra II' 9-max Seat #2 is the button
Seat 2: TheMinion ($62.82 in chips) 
Seat 3: mojtabagol ($72.48 in chips) 
Seat 4: matiko09 ($54.72 in chips) 
Seat 5: Rafaello18 ($57.99 in chips) 
Seat 6: pfunkolstar ($55.54 in chips) 
Seat 7: MuddyDance ($48.50 in chips) 
Seat 8: sanr23 ($50.75 in chips) 
mojtabagol: posts small blind $0.25
matiko09: posts big blind $0.50
*** HOLE CARDS ***
Dealt to matiko09 [8c Th]
Rafaello18: folds 
pfunkolstar: raises $1 to $1.50
MuddyDance: folds 
sanr23: folds 
TheMinion: folds 
mojtabagol: folds 
matiko09: folds 
Uncalled bet ($1) returned to pfunkolstar
pfunkolstar collected $1.25 from pot
pfunkolstar: doesn't show hand 
*** SUMMARY ***
Total pot $1.25 | Rake $0 
Seat 2: TheMinion (button) folded before Flop (didn't bet)
Seat 3: mojtabagol (small blind) folded before Flop
Seat 4: matiko09 (big blind) folded before Flop
Seat 5: Rafaello18 folded before Flop (didn't bet)
Seat 6: pfunkolstar collected ($1.25)
Seat 7: MuddyDance folded before Flop (didn't bet)
Seat 8: sanr23 folded before Flop (didn't bet)





PokerStars Hand #155380097734:  Hold'em No Limit ($0.25/$0.50 USD) - 2016/06/30 13:52:12 CET [2016/06/30 7:52:12 ET]
Table 'Mentha II' 9-max Seat #4 is the button
Seat 1: Bailey Dew ($173.32 in chips) 
Seat 2: TheMinion ($55.43 in chips) 
Seat 3: joker180785 ($50 in chips) 
Seat 4: 55peter1 ($76.13 in chips) 
Seat 6: Alexey_Kim2 ($50 in chips) 
Seat 7: ardo888 ($146.95 in chips) 
Seat 8: drlee77 ($46.95 in chips) 
Seat 9: matiko09 ($50 in chips) 
Alexey_Kim2: posts small blind $0.25
ardo888: posts big blind $0.50
Bailey Dew: posts the ante $0.10
TheMinion: posts the ante $0.10
joker180785: posts the ante $0.10
55peter1: posts the ante $0.10
Alexey_Kim2: posts the ante $0.10
ardo888: posts the ante $0.10
drlee77: posts the ante $0.10
matiko09: posts the ante $0.10
*** HOLE CARDS ***
Dealt to matiko09 [Qs Qc]
drlee77: raises $1 to $1.50
matiko09: calls $1.50
Bailey Dew: folds 
TheMinion: folds 
joker180785: calls $1.50
55peter1: folds 
Alexey_Kim2: folds 
ardo888: folds 
*** FLOP *** [2s 2h Qd]
drlee77: checks 
matiko09: checks 
joker180785: bets $3.62
drlee77: folds 
matiko09: calls $3.62
*** TURN *** [2s 2h Qd] [8h]
matiko09: checks 
joker180785: bets $7.95
matiko09: calls $7.95
*** RIVER *** [2s 2h Qd 8h] [Th]
matiko09: checks 
joker180785: bets $14.69
matiko09: raises $22.14 to $36.83 and is all-in
joker180785: calls $22.14 and is all-in
*** SHOW DOWN ***
matiko09: shows [Qs Qc] (a full house, Queens full of Deuces)
joker180785: shows [Kh Qh] (a flush, King high)
matiko09 collected $100.85 from pot
*** SUMMARY ***
Total pot $102.85 | Rake $2 
Board [2s 2h Qd 8h Th]
Seat 1: Bailey Dew folded before Flop (didn't bet)
Seat 2: TheMinion folded before Flop (didn't bet)
Seat 3: joker180785 showed [Kh Qh] and lost with a flush, King high
Seat 4: 55peter1 (button) folded before Flop (didn't bet)
Seat 6: Alexey_Kim2 (small blind) folded before Flop
Seat 7: ardo888 (big blind) folded before Flop
Seat 8: drlee77 folded on the Flop
Seat 9: matiko09 showed [Qs Qc] and won ($100.85) with a full house, Queens full of Deuces





PokerStars Hand #155380099554:  Hold'em No Limit ($0.50/$1.00 USD) - 2016/06/30 13:52:16 CET [2016/06/30 7:52:16 ET]
Table 'Armisticia' 9-max Seat #6 is the button
Seat 1: tipner ($120.53 in chips) 
Seat 4: ardo888 ($104.55 in chips) 
Seat 5: SonerWPT ($111.75 in chips) 
Seat 6: matiko09 ($121.80 in chips) 
Seat 7: ilaviiitech ($100 in chips) 
Seat 9: mbk88 ($114.81 in chips) 
ilaviiitech: posts small blind $0.50
mbk88: posts big blind $1
di0d80: sits out 
*** HOLE CARDS ***
Dealt to matiko09 [Kh Ad]
tipner: folds 
ardo888: raises $2 to $3
SonerWPT: folds 
Rafaello18 joins the table at seat #8 
matiko09: raises $7 to $10
ilaviiitech: folds 
mbk88: folds 
ardo888: folds 
Uncalled bet ($7) returned to matiko09
matiko09 collected $7.50 from pot
matiko09: doesn't show hand 
*** SUMMARY ***
Total pot $7.50 | Rake $0 
Seat 1: tipner folded before Flop (didn't bet)
Seat 4: ardo888 folded before Flop
Seat 5: SonerWPT folded before Flop (didn't bet)
Seat 6: matiko09 (button) collected ($7.50)
Seat 7: ilaviiitech (small blind) folded before Flop
Seat 9: mbk88 (big blind) folded before Flop





PokerStars Hand #155380100840:  Hold'em No Limit ($0.50/$1.00 USD) - 2016/06/30 13:52:19 CET [2016/06/30 7:52:19 ET]
Table 'Borrelly II' 9-max Seat #4 is the button
Seat 1: Rafaello18 ($118.89 in chips) 
Seat 2: mbk88 ($104.12 in chips) 
Seat 4: DonRon_AT ($39.51 in chips) 
Seat 5: DIMAN_324 ($100 in chips) 
Seat 6: m_michalec ($173.58 in chips) 
Seat 7: matiko09 ($176.36 in chips) 
Seat 8: Arjun A Raju ($98.50 in chips) 
Seat 9: alhill86 ($75.50 in chips) 
DIMAN_324: posts small blind $0.50
m_michalec: posts big blind $1
di0d80: sits out 
*** HOLE CARDS ***
Dealt to matiko09 [5s 9h]
matiko09: folds 
Arjun A Raju: folds 
alhill86: folds 
Rafaello18: folds 
mbk88: folds 
DonRon_AT: raises $1 to $2
DIMAN_324: folds 
m_michalec: calls $1
*** FLOP *** [9c 8s 2s]
m_michalec: checks 
DonRon_AT: bets $3
m_michalec: calls $3
*** TURN *** [9c 8s 2s] [4h]
m_michalec: checks 
DonRon_AT: bets $5
m_michalec: folds 
Uncalled bet ($5) returned to DonRon_AT
DonRon_AT collected $9.98 from pot
*** SUMMARY ***
Total pot $10.50 | Rake $0.52 
Board [9c 8s 2s 4h]
Seat 1: Rafaello18 folded before Flop (didn't bet)
Seat 2: mbk88 folded before Flop (didn't bet)
Seat 4: DonRon_AT (button) collected ($9.98)
Seat 5: DIMAN_324 (small blind) folded before Flop
Seat 6: m_michalec (big blind) folded on the Turn
Seat 7: matiko09 folded before Flop (didn't bet)
Seat 8: Arjun A Raju folded before Flop (didn't bet)
Seat 9: alhill86 folded before Flop (didn't bet)





PokerStars Hand #155380103125:  Hold'em No Limit ($0.50/$1.00 USD) - 2016/06/30 13:52:24 CET [2016/06/30 7:52:24 ET]
Table 'Prieska' 9-max Seat #4 is the button
Seat 2: B_style_cuz ($104.93 in chips) 
Seat 3: Rafaello18 ($128 in chips) 
Seat 4: nickreason17 ($100 in chips) 
Seat 5: ramzes160468 ($63.02 in chips) 
Seat 6: DIMAN_324 ($102.50 in chips) 
Seat 7: matiko09 ($100 in chips) 
Seat 8: mbk88 ($124.45 in chips) 
Seat 9: Konig26 ($98.50 in chips) 
ramzes160468: posts small blind $0.50
DIMAN_324: posts big blind $1
*** HOLE CARDS ***
Dealt to matiko09 [Ks 6c]
matiko09: folds 
mbk88: folds 
Konig26: raises $2 to $3
B_style_cuz: folds 
Rafaello18: calls $3
nickreason17: folds 
ramzes160468: folds 
DIMAN_324: folds 
*** FLOP *** [8c 5s 5d]
Konig26: bets $5
Rafaello18: folds 
Uncalled bet ($5) returned to Konig26
Konig26 collected $7.12 from pot
Konig26: doesn't show hand 
*** SUMMARY ***
Total pot $7.50 | Rake $0.38 
Board [8c 5s 5d]
Seat 2: B_style_cuz folded before Flop (didn't bet)
Seat 3: Rafaello18 folded on the Flop
Seat 4: nickreason17 (button) folded before Flop (didn't bet)
Seat 5: ramzes160468 (small blind) folded before Flop
Seat 6: DIMAN_324 (big blind) folded before Flop
Seat 7: matiko09 folded before Flop (didn't bet)
Seat 8: mbk88 folded before Flop (didn't bet)
Seat 9: Konig26 collected ($7.12)





PokerStars Hand #155380106297:  Hold'em No Limit ($0.25/$0.50 USD) - 2016/06/30 13:52:32 CET [2016/06/30 7:52:32 ET]
Table 'Elektra II' 9-max Seat #3 is the button
Seat 2: TheMinion ($62.82 in chips) 
Seat 3: mojtabagol ($72.23 in chips) 
Seat 4: matiko09 ($54.22 in chips) 
Seat 5: Rafaello18 ($57.99 in chips) 
Seat 6: pfunkolstar ($56.29 in chips) 
Seat 7: MuddyDance ($48.50 in chips) 
Seat 8: sanr23 ($50.75 in chips) 
matiko09: posts small blind $0.25
Rafaello18: posts big blind $0.50
*** HOLE CARDS ***
Dealt to matiko09 [6s 3c]
pfunkolstar: raises $1 to $1.50
MuddyDance: folds 
sanr23: folds 
TheMinion: folds 
mojtabagol: folds 
matiko09: folds 
Rafaello18: folds 
Uncalled bet ($1) returned to pfunkolstar
pfunkolstar collected $1.25 from pot
pfunkolstar: doesn't show hand 
*** SUMMARY ***
Total pot $1.25 | Rake $0 
Seat 2: TheMinion folded before Flop (didn't bet)
Seat 3: mojtabagol (button) folded before Flop (didn't bet)
Seat 4: matiko09 (small blind) folded before Flop
Seat 5: Rafaello18 (big blind) folded before Flop
Seat 6: pfunkolstar collected ($1.25)
Seat 7: MuddyDance folded before Flop (didn't bet)
Seat 8: sanr23 folded before Flop (didn't bet)





PokerStars Hand #155380110474:  Hold'em No Limit ($0.50/$1.00 USD) - 2016/06/30 13:52:41 CET [2016/06/30 7:52:41 ET]
Table 'California II' 9-max Seat #5 is the button
Seat 1: Rafaello18 ($112.52 in chips) 
Seat 2: velourleder ($78.50 in chips) 
Seat 4: mbk88 ($206.20 in chips) 
Seat 5: Rohitbarve ($101.24 in chips) 
Seat 6: matiko09 ($118.35 in chips) 
Seat 7: DomiVY ($85.70 in chips) 
Seat 8: picka4u ($45.32 in chips) 
matiko09: posts small blind $0.50
DomiVY: posts big blind $1
di0d80: sits out 
KovIFish89: sits out 
*** HOLE CARDS ***
Dealt to matiko09 [8h 4c]
picka4u: folds 
Rafaello18: folds 
velourleder: raises $2 to $3
mbk88: folds 
Rohitbarve: folds 
matiko09: folds 
DomiVY: folds 
Uncalled bet ($2) returned to velourleder
velourleder collected $2.50 from pot
*** SUMMARY ***
Total pot $2.50 | Rake $0 
Seat 1: Rafaello18 folded before Flop (didn't bet)
Seat 2: velourleder collected ($2.50)
Seat 4: mbk88 folded before Flop (didn't bet)
Seat 5: Rohitbarve (button) folded before Flop (didn't bet)
Seat 6: matiko09 (small blind) folded before Flop
Seat 7: DomiVY (big blind) folded before Flop
Seat 8: picka4u folded before Flop (didn't bet)





PokerStars Hand #155380111671:  Hold'em No Limit ($0.50/$1.00 USD) - 2016/06/30 13:52:44 CET [2016/06/30 7:52:44 ET]
Table 'Altarf II' 9-max Seat #3 is the button
Seat 3: sanr23 ($143.55 in chips) 
Seat 4: Greha999 ($80.66 in chips) 
Seat 5: DIMAN_324 ($105.62 in chips) 
Seat 6: mbk88 ($189.80 in chips) 
Seat 7: matiko09 ($106.22 in chips) 
Seat 8: DomiVY ($40 in chips) 
Seat 9: omanibemihum ($100 in chips) 
Greha999: posts small blind $0.50
DIMAN_324: posts big blind $1
Rafaello18: sits out 
KovIFish89: sits out 
*** HOLE CARDS ***
Dealt to matiko09 [Kh Kd]
mbk88: folds 
matiko09: raises $2 to $3
DomiVY: folds 
omanibemihum: folds 
sanr23: folds 
Greha999: folds 
DIMAN_324: calls $2
*** FLOP *** [9d 9c 6s]
DIMAN_324: checks 
matiko09: checks 
*** TURN *** [9d 9c 6s] [7c]
DIMAN_324: checks 
matiko09: bets $4.02
DIMAN_324: folds 
Uncalled bet ($4.02) returned to matiko09
matiko09 collected $6.18 from pot
matiko09: doesn't show hand 
*** SUMMARY ***
Total pot $6.50 | Rake $0.32 
Board [9d 9c 6s 7c]
Seat 3: sanr23 (button) folded before Flop (didn't bet)
Seat 4: Greha999 (small blind) folded before Flop
Seat 5: DIMAN_324 (big blind) folded on the Turn
Seat 6: mbk88 folded before Flop (didn't bet)
Seat 7: matiko09 collected ($6.18)
Seat 8: DomiVY folded before Flop (didn't bet)
Seat 9: omanibemihum folded before Flop (didn't bet)





PokerStars Hand #155380115617:  Hold'em No Limit ($0.50/$1.00 USD) - 2016/06/30 13:52:53 CET [2016/06/30 7:52:53 ET]
Table 'Armisticia' 9-max Seat #7 is the button
Seat 2: di0d80 ($101.50 in chips) 
Seat 4: ardo888 ($101.55 in chips) 
Seat 5: SonerWPT ($111.75 in chips) 
Seat 6: matiko09 ($126.30 in chips) 
Seat 7: ilaviiitech ($100 in chips) 
Seat 9: mbk88 ($113.81 in chips) 
Rafaello18 will be allowed to play after the button
mbk88: posts small blind $0.50
tipner: is sitting out 
di0d80: posts big blind $1
KovIFish89: sits out 
*** HOLE CARDS ***
Dealt to matiko09 [3c 5d]
tipner leaves the table
nickreason17 joins the table at seat #1 
ardo888: folds 
SonerWPT: raises $1.50 to $2.50
matiko09: folds 
ilaviiitech: calls $2.50
mbk88: folds 
di0d80: folds 
*** FLOP *** [Tc 8c 3d]
SonerWPT: checks 
ilaviiitech: checks 
*** TURN *** [Tc 8c 3d] [7c]
SonerWPT: bets $2
ilaviiitech: folds 
Uncalled bet ($2) returned to SonerWPT
SonerWPT collected $6.18 from pot
SonerWPT: doesn't show hand 
*** SUMMARY ***
Total pot $6.50 | Rake $0.32 
Board [Tc 8c 3d 7c]
Seat 2: di0d80 (big blind) folded before Flop
Seat 4: ardo888 folded before Flop (didn't bet)
Seat 5: SonerWPT collected ($6.18)
Seat 6: matiko09 folded before Flop (didn't bet)
Seat 7: ilaviiitech (button) folded on the Turn
Seat 9: mbk88 (small blind) folded before Flop





PokerStars Hand #155380117941:  Hold'em No Limit ($0.25/$0.50 USD) - 2016/06/30 13:52:58 CET [2016/06/30 7:52:58 ET]
Table 'Elektra II' 9-max Seat #4 is the button
Seat 2: TheMinion ($62.82 in chips) 
Seat 3: mojtabagol ($72.23 in chips) 
Seat 4: matiko09 ($53.97 in chips) 
Seat 5: Rafaello18 ($57.49 in chips) 
Seat 6: pfunkolstar ($57.04 in chips) 
Seat 7: MuddyDance ($48.50 in chips) 
Seat 8: sanr23 ($50.75 in chips) 
Rafaello18: posts small blind $0.25
pfunkolstar: posts big blind $0.50
*** HOLE CARDS ***
Dealt to matiko09 [8d Ks]
MuddyDance: folds 
sanr23: folds 
TheMinion: folds 
mojtabagol: folds 
matiko09: raises $0.63 to $1.13
Rafaello18: folds 
pfunkolstar: folds 
Uncalled bet ($0.63) returned to matiko09
matiko09 collected $1.25 from pot
matiko09: doesn't show hand 
*** SUMMARY ***
Total pot $1.25 | Rake $0 
Seat 2: TheMinion folded before Flop (didn't bet)
Seat 3: mojtabagol folded before Flop (didn't bet)
Seat 4: matiko09 (button) collected ($1.25)
Seat 5: Rafaello18 (small blind) folded before Flop
Seat 6: pfunkolstar (big blind) folded before Flop
Seat 7: MuddyDance folded before Flop (didn't bet)
Seat 8: sanr23 folded before Flop (didn't bet)





PokerStars Hand #155380118016:  Hold'em No Limit ($0.50/$1.00 USD) - 2016/06/30 13:52:58 CET [2016/06/30 7:52:58 ET]
Table 'Tatjana' 9-max Seat #1 is the button
Seat 1: ardo888 ($112.46 in chips) 
Seat 2: DIMAN_324 ($102 in chips) 
Seat 3: Rafaello18 ($134.57 in chips) 
Seat 4: mopatron25 ($90.53 in chips) 
Seat 5: matiko09 ($100 in chips) 
Seat 8: alhill86 ($80.34 in chips) 
Seat 9: POTAPENKO700 ($139.71 in chips) 
DIMAN_324: posts small blind $0.50
Rafaello18: posts big blind $1
mbk88: sits out 
*** HOLE CARDS ***
Dealt to matiko09 [Jh Qs]
mopatron25: folds 
matiko09: folds 
alhill86: folds 
POTAPENKO700: folds 
ardo888: raises $1.50 to $2.50
DIMAN_324: folds 
Rafaello18: calls $1.50
*** FLOP *** [Ad Ac 7c]
Rafaello18: checks 
ardo888: bets $2.50
Rafaello18: calls $2.50
*** TURN *** [Ad Ac 7c] [Ah]
Rafaello18: checks 
ardo888: checks 
*** RIVER *** [Ad Ac 7c Ah] [5d]
Rafaello18: checks 
ardo888: bets $6.48
Rafaello18: folds 
Uncalled bet ($6.48) returned to ardo888
ardo888 collected $9.98 from pot
ardo888: doesn't show hand 
*** SUMMARY ***
Total pot $10.50 | Rake $0.52 
Board [Ad Ac 7c Ah 5d]
Seat 1: ardo888 (button) collected ($9.98)
Seat 2: DIMAN_324 (small blind) folded before Flop
Seat 3: Rafaello18 (big blind) folded on the River
Seat 4: mopatron25 folded before Flop (didn't bet)
Seat 5: matiko09 folded before Flop (didn't bet)
Seat 8: alhill86 folded before Flop (didn't bet)
Seat 9: POTAPENKO700 folded before Flop (didn't bet)





PokerStars Hand #155380120871:  Hold'em No Limit ($0.50/$1.00 USD) - 2016/06/30 13:53:05 CET [2016/06/30 7:53:05 ET]
Table 'Asmodeus' 9-max Seat #9 is the button
Seat 1: scollop ($123.20 in chips) 
Seat 2: picka4u ($40.80 in chips) 
Seat 3: matiko09 ($103.75 in chips) 
Seat 4: ardo888 ($118.28 in chips) 
Seat 5: sanr23 ($100 in chips) 
Seat 6: koutani7 ($91 in chips) 
Seat 7: aaronzzr ($150.04 in chips) 
Seat 8: Rafaello18 ($155.57 in chips) 
Seat 9: mbk88 ($158.86 in chips) 
scollop: posts small blind $0.50
picka4u: posts big blind $1
*** HOLE CARDS ***
Dealt to matiko09 [9d 5h]
matiko09: folds 
ardo888: folds 
sanr23: folds 
koutani7: folds 
aaronzzr: raises $1 to $2
Rafaello18: folds 
mbk88: folds 
scollop: raises $1 to $3
picka4u: calls $2
aaronzzr: calls $1
*** FLOP *** [5c Qs 4s]
scollop: checks 
picka4u: bets $5
aaronzzr: folds 
scollop: calls $5
*** TURN *** [5c Qs 4s] [Ks]
scollop: checks 
picka4u: bets $6
scollop: calls $6
*** RIVER *** [5c Qs 4s Ks] [2c]
scollop: checks 
picka4u: checks 
*** SHOW DOWN ***
scollop: shows [Ad Ah] (a pair of Aces)
picka4u: mucks hand 
scollop collected $29.45 from pot
*** SUMMARY ***
Total pot $31 | Rake $1.55 
Board [5c Qs 4s Ks 2c]
Seat 1: scollop (small blind) showed [Ad Ah] and won ($29.45) with a pair of Aces
Seat 2: picka4u (big blind) mucked [9c Qc]
Seat 3: matiko09 folded before Flop (didn't bet)
Seat 4: ardo888 folded before Flop (didn't bet)
Seat 5: sanr23 folded before Flop (didn't bet)
Seat 6: koutani7 folded before Flop (didn't bet)
Seat 7: aaronzzr folded on the Flop
Seat 8: Rafaello18 folded before Flop (didn't bet)
Seat 9: mbk88 (button) folded before Flop (didn't bet)





PokerStars Hand #155380124106:  Hold'em No Limit ($0.50/$1.00 USD) - 2016/06/30 13:53:12 CET [2016/06/30 7:53:12 ET]
Table 'Borrelly II' 9-max Seat #5 is the button
Seat 1: Rafaello18 ($118.89 in chips) 
Seat 2: mbk88 ($104.12 in chips) 
Seat 4: DonRon_AT ($44.49 in chips) 
Seat 5: DIMAN_324 ($100 in chips) 
Seat 6: m_michalec ($168.58 in chips) 
Seat 7: matiko09 ($176.36 in chips) 
Seat 8: Arjun A Raju ($98.50 in chips) 
Seat 9: alhill86 ($75.50 in chips) 
m_michalec: posts small blind $0.50
matiko09: posts big blind $1
di0d80: sits out 
*** HOLE CARDS ***
Dealt to matiko09 [Qh 9c]
Arjun A Raju: raises $2 to $3
alhill86: calls $3
Rafaello18: folds 
mbk88: folds 
DonRon_AT: folds 
DIMAN_324: folds 
m_michalec: folds 
matiko09: folds 
*** FLOP *** [7s 8s 8d]
Arjun A Raju: bets $4.74
alhill86: folds 
Uncalled bet ($4.74) returned to Arjun A Raju
Arjun A Raju collected $7.12 from pot
Arjun A Raju: doesn't show hand 
*** SUMMARY ***
Total pot $7.50 | Rake $0.38 
Board [7s 8s 8d]
Seat 1: Rafaello18 folded before Flop (didn't bet)
Seat 2: mbk88 folded before Flop (didn't bet)
Seat 4: DonRon_AT folded before Flop (didn't bet)
Seat 5: DIMAN_324 (button) folded before Flop (didn't bet)
Seat 6: m_michalec (small blind) folded before Flop
Seat 7: matiko09 (big blind) folded before Flop
Seat 8: Arjun A Raju collected ($7.12)
Seat 9: alhill86 folded on the Flop





PokerStars Hand #155380126963:  Hold'em No Limit ($0.25/$0.50 USD) - 2016/06/30 13:53:19 CET [2016/06/30 7:53:19 ET]
Table 'Elektra II' 9-max Seat #5 is the button
Seat 2: TheMinion ($62.82 in chips) 
Seat 3: mojtabagol ($72.23 in chips) 
Seat 4: matiko09 ($54.72 in chips) 
Seat 5: Rafaello18 ($57.24 in chips) 
Seat 6: pfunkolstar ($56.54 in chips) 
Seat 7: MuddyDance ($48.50 in chips) 
Seat 8: sanr23 ($50.75 in chips) 
pfunkolstar: posts small blind $0.25
MuddyDance: posts big blind $0.50
*** HOLE CARDS ***
Dealt to matiko09 [7h 2h]
sanr23: folds 
TheMinion: folds 
mojtabagol: folds 
matiko09: folds 
Rafaello18: folds 
pfunkolstar: raises $1 to $1.50
MuddyDance: folds 
Uncalled bet ($1) returned to pfunkolstar
pfunkolstar collected $1 from pot
pfunkolstar: doesn't show hand 
*** SUMMARY ***
Total pot $1 | Rake $0 
Seat 2: TheMinion folded before Flop (didn't bet)
Seat 3: mojtabagol folded before Flop (didn't bet)
Seat 4: matiko09 folded before Flop (didn't bet)
Seat 5: Rafaello18 (button) folded before Flop (didn't bet)
Seat 6: pfunkolstar (small blind) collected ($1)
Seat 7: MuddyDance (big blind) folded before Flop
Seat 8: sanr23 folded before Flop (didn't bet)





PokerStars Hand #155380126894:  Hold'em No Limit ($0.50/$1.00 USD) - 2016/06/30 13:53:19 CET [2016/06/30 7:53:19 ET]
Table 'Altarf II' 9-max Seat #4 is the button
Seat 3: sanr23 ($143.55 in chips) 
Seat 4: Greha999 ($80.16 in chips) 
Seat 5: DIMAN_324 ($102.62 in chips) 
Seat 6: mbk88 ($189.80 in chips) 
Seat 7: matiko09 ($109.40 in chips) 
Seat 8: DomiVY ($40 in chips) 
Seat 9: omanibemihum ($100 in chips) 
DIMAN_324: posts small blind $0.50
mbk88: posts big blind $1
Rafaello18: sits out 
KovIFish89: sits out 
*** HOLE CARDS ***
Dealt to matiko09 [6h 8h]
matiko09: folds 
DomiVY: folds 
omanibemihum: raises $2 to $3
sanr23: folds 
Greha999: calls $3
DIMAN_324: folds 
mbk88: folds 
*** FLOP *** [Ad Jh 6c]
omanibemihum: bets $4
Greha999: folds 
Uncalled bet ($4) returned to omanibemihum
omanibemihum collected $7.12 from pot
omanibemihum: doesn't show hand 
*** SUMMARY ***
Total pot $7.50 | Rake $0.38 
Board [Ad Jh 6c]
Seat 3: sanr23 folded before Flop (didn't bet)
Seat 4: Greha999 (button) folded on the Flop
Seat 5: DIMAN_324 (small blind) folded before Flop
Seat 6: mbk88 (big blind) folded before Flop
Seat 7: matiko09 folded before Flop (didn't bet)
Seat 8: DomiVY folded before Flop (didn't bet)
Seat 9: omanibemihum collected ($7.12)





PokerStars Hand #155380127094:  Hold'em No Limit ($0.50/$1.00 USD) - 2016/06/30 13:53:19 CET [2016/06/30 7:53:19 ET]
Table 'California II' 9-max Seat #6 is the button
Seat 1: Rafaello18 ($112.52 in chips) 
Seat 2: velourleder ($80 in chips) 
Seat 4: mbk88 ($206.20 in chips) 
Seat 5: Rohitbarve ($101.24 in chips) 
Seat 6: matiko09 ($117.85 in chips) 
Seat 7: DomiVY ($84.70 in chips) 
Seat 8: picka4u ($45.32 in chips) 
DomiVY: posts small blind $0.50
picka4u: posts big blind $1
di0d80: sits out 
KovIFish89: sits out 
*** HOLE CARDS ***
Dealt to matiko09 [5h 7d]
Rafaello18: folds 
velourleder: raises $3 to $4
mbk88: raises $9 to $13
Rohitbarve: folds 
matiko09: folds 
DomiVY: folds 
picka4u: folds 
velourleder: calls $9
*** FLOP *** [9c 3s Qs]
velourleder: checks 
mbk88: bets $14
velourleder: calls $14
*** TURN *** [9c 3s Qs] [2s]
velourleder: bets $38
mbk88: folds 
Uncalled bet ($38) returned to velourleder
velourleder collected $53 from pot
velourleder: doesn't show hand 
*** SUMMARY ***
Total pot $55.50 | Rake $2.50 
Board [9c 3s Qs 2s]
Seat 1: Rafaello18 folded before Flop (didn't bet)
Seat 2: velourleder collected ($53)
Seat 4: mbk88 folded on the Turn
Seat 5: Rohitbarve folded before Flop (didn't bet)
Seat 6: matiko09 (button) folded before Flop (didn't bet)
Seat 7: DomiVY (small blind) folded before Flop
Seat 8: picka4u (big blind) folded before Flop





PokerStars Hand #155380127601:  Hold'em No Limit ($0.50/$1.00 USD) - 2016/06/30 13:53:20 CET [2016/06/30 7:53:20 ET]
Table 'Prieska' 9-max Seat #5 is the button
Seat 1: KovIFish89 ($118.59 in chips) 
Seat 2: B_style_cuz ($104.93 in chips) 
Seat 3: Rafaello18 ($125 in chips) 
Seat 4: nickreason17 ($100 in chips) 
Seat 5: ramzes160468 ($62.52 in chips) 
Seat 6: DIMAN_324 ($101.50 in chips) 
Seat 7: matiko09 ($100 in chips) 
Seat 8: mbk88 ($124.45 in chips) 
Seat 9: Konig26 ($102.62 in chips) 
DIMAN_324: posts small blind $0.50
matiko09: posts big blind $1
*** HOLE CARDS ***
Dealt to matiko09 [Jh Ac]
mbk88: folds 
Konig26: folds 
KovIFish89: folds 
B_style_cuz: folds 
Rafaello18: folds 
nickreason17: raises $1.50 to $2.50
ramzes160468: folds 
DIMAN_324: folds 
matiko09: calls $1.50
*** FLOP *** [5s Th 4d]
matiko09: checks 
nickreason17: bets $3.13
matiko09: folds 
Uncalled bet ($3.13) returned to nickreason17
nickreason17 collected $5.22 from pot
*** SUMMARY ***
Total pot $5.50 | Rake $0.28 
Board [5s Th 4d]
Seat 1: KovIFish89 folded before Flop (didn't bet)
Seat 2: B_style_cuz folded before Flop (didn't bet)
Seat 3: Rafaello18 folded before Flop (didn't bet)
Seat 4: nickreason17 collected ($5.22)
Seat 5: ramzes160468 (button) folded before Flop (didn't bet)
Seat 6: DIMAN_324 (small blind) folded before Flop
Seat 7: matiko09 (big blind) folded on the Flop
Seat 8: mbk88 folded before Flop (didn't bet)
Seat 9: Konig26 folded before Flop (didn't bet)





PokerStars Hand #155380134916:  Hold'em No Limit ($0.50/$1.00 USD) - 2016/06/30 13:53:37 CET [2016/06/30 7:53:37 ET]
Table 'Armisticia' 9-max Seat #9 is the button
Seat 2: di0d80 ($100.50 in chips) 
Seat 3: KovIFish89 ($101 in chips) 
Seat 4: ardo888 ($101.55 in chips) 
Seat 5: SonerWPT ($115.43 in chips) 
Seat 6: matiko09 ($126.30 in chips) 
Seat 7: ilaviiitech ($100 in chips) 
Seat 9: mbk88 ($113.31 in chips) 
nickreason17 will be allowed to play after the button
di0d80: posts small blind $0.50
KovIFish89: posts big blind $1
Rafaello18: sits out 
*** HOLE CARDS ***
Dealt to matiko09 [5h 4d]
ardo888: folds 
SonerWPT: folds 
matiko09: folds 
ilaviiitech: folds 
mbk88: raises $1.02 to $2.02
di0d80: folds 
KovIFish89: folds 
Uncalled bet ($1.02) returned to mbk88
mbk88 collected $2.50 from pot
mbk88: doesn't show hand 
*** SUMMARY ***
Total pot $2.50 | Rake $0 
Seat 2: di0d80 (small blind) folded before Flop
Seat 3: KovIFish89 (big blind) folded before Flop
Seat 4: ardo888 folded before Flop (didn't bet)
Seat 5: SonerWPT folded before Flop (didn't bet)
Seat 6: matiko09 folded before Flop (didn't bet)
Seat 7: ilaviiitech folded before Flop (didn't bet)
Seat 9: mbk88 (button) collected ($2.50)





PokerStars Hand #155380136277:  Hold'em No Limit ($0.50/$1.00 USD) - 2016/06/30 13:53:41 CET [2016/06/30 7:53:41 ET]
Table 'Borrelly II' 9-max Seat #6 is the button
Seat 1: Rafaello18 ($118.89 in chips) 
Seat 2: mbk88 ($104.12 in chips) 
Seat 4: DonRon_AT ($44.49 in chips) 
Seat 5: DIMAN_324 ($100 in chips) 
Seat 6: m_michalec ($168.08 in chips) 
Seat 7: matiko09 ($175.36 in chips) 
Seat 8: Arjun A Raju ($102.62 in chips) 
Seat 9: alhill86 ($72.50 in chips) 
matiko09: posts small blind $0.50
Arjun A Raju: posts big blind $1
di0d80: sits out 
*** HOLE CARDS ***
Dealt to matiko09 [Ks 5s]
alhill86: folds 
Rafaello18: folds 
mbk88: raises $2 to $3
DonRon_AT: folds 
DIMAN_324: folds 
m_michalec: folds 
matiko09: folds 
Arjun A Raju: folds 
Uncalled bet ($2) returned to mbk88
mbk88 collected $2.50 from pot
mbk88: doesn't show hand 
*** SUMMARY ***
Total pot $2.50 | Rake $0 
Seat 1: Rafaello18 folded before Flop (didn't bet)
Seat 2: mbk88 collected ($2.50)
Seat 4: DonRon_AT folded before Flop (didn't bet)
Seat 5: DIMAN_324 folded before Flop (didn't bet)
Seat 6: m_michalec (button) folded before Flop (didn't bet)
Seat 7: matiko09 (small blind) folded before Flop
Seat 8: Arjun A Raju (big blind) folded before Flop
Seat 9: alhill86 folded before Flop (didn't bet)





PokerStars Hand #155380141017:  Hold'em No Limit ($0.50/$1.00 USD) - 2016/06/30 13:53:52 CET [2016/06/30 7:53:52 ET]
Table 'Altarf II' 9-max Seat #5 is the button
Seat 3: sanr23 ($143.55 in chips) 
Seat 4: Greha999 ($77.16 in chips) 
Seat 5: DIMAN_324 ($102.12 in chips) 
Seat 6: mbk88 ($188.80 in chips) 
Seat 7: matiko09 ($109.40 in chips) 
Seat 8: DomiVY ($40 in chips) 
Seat 9: omanibemihum ($104.12 in chips) 
mbk88: posts small blind $0.50
matiko09: posts big blind $1
Rafaello18: sits out 
KovIFish89: sits out 
*** HOLE CARDS ***
Dealt to matiko09 [8c 6c]
DomiVY: folds 
omanibemihum: folds 
sanr23: raises $2 to $3
Greha999: folds 
DIMAN_324: raises $6 to $9
mbk88: raises $21 to $30
matiko09: folds 
sanr23: folds 
DIMAN_324: raises $72.12 to $102.12 and is all-in
mbk88: calls $72.12
*** FIRST FLOP *** [3c 3h 2s]
*** FIRST TURN *** [3c 3h 2s] [2d]
*** FIRST RIVER *** [3c 3h 2s 2d] [5s]
*** SECOND FLOP *** [Jh 3s 4h]
*** SECOND TURN *** [Jh 3s 4h] [8d]
*** SECOND RIVER *** [Jh 3s 4h 8d] [5d]
*** FIRST SHOW DOWN ***
mbk88: shows [Qs Qh] (two pair, Queens and Threes)
DIMAN_324: shows [Kc Ks] (two pair, Kings and Threes)
DIMAN_324 collected $102.87 from pot
*** SECOND SHOW DOWN ***
mbk88: shows [Qs Qh] (a pair of Queens)
DIMAN_324: shows [Kc Ks] (a pair of Kings)
DIMAN_324 collected $102.87 from pot
*** SUMMARY ***
Total pot $208.24 | Rake $2.50 
Hand was run twice
FIRST Board [3c 3h 2s 2d 5s]
SECOND Board [Jh 3s 4h 8d 5d]
Seat 3: sanr23 folded before Flop
Seat 4: Greha999 folded before Flop (didn't bet)
Seat 5: DIMAN_324 (button) showed [Kc Ks] and won ($102.87) with two pair, Kings and Threes, and won ($102.87) with a pair of Kings
Seat 6: mbk88 (small blind) showed [Qs Qh] and lost with two pair, Queens and Threes, and lost with a pair of Queens
Seat 7: matiko09 (big blind) folded before Flop
Seat 8: DomiVY folded before Flop (didn't bet)
Seat 9: omanibemihum folded before Flop (didn't bet)





PokerStars Hand #155380143037:  Hold'em No Limit ($0.25/$0.50 USD) - 2016/06/30 13:53:56 CET [2016/06/30 7:53:56 ET]
Table 'Elektra II' 9-max Seat #6 is the button
Seat 2: TheMinion ($62.82 in chips) 
Seat 3: mojtabagol ($72.23 in chips) 
Seat 4: matiko09 ($54.72 in chips) 
Seat 5: Rafaello18 ($57.24 in chips) 
Seat 6: pfunkolstar ($57.04 in chips) 
Seat 7: MuddyDance ($48 in chips) 
Seat 8: sanr23 ($50.75 in chips) 
MuddyDance: posts small blind $0.25
sanr23: posts big blind $0.50
*** HOLE CARDS ***
Dealt to matiko09 [7d As]
TheMinion: raises $0.75 to $1.25
mojtabagol: calls $1.25
matiko09: folds 
Rafaello18: folds 
pfunkolstar: folds 
MuddyDance: folds 
sanr23: folds 
*** FLOP *** [Jh 3h Jc]
TheMinion: checks 
mojtabagol: checks 
*** TURN *** [Jh 3h Jc] [9d]
TheMinion: checks 
mojtabagol: bets $1.54
TheMinion: folds 
Uncalled bet ($1.54) returned to mojtabagol
mojtabagol collected $3.09 from pot
*** SUMMARY ***
Total pot $3.25 | Rake $0.16 
Board [Jh 3h Jc 9d]
Seat 2: TheMinion folded on the Turn
Seat 3: mojtabagol collected ($3.09)
Seat 4: matiko09 folded before Flop (didn't bet)
Seat 5: Rafaello18 folded before Flop (didn't bet)
Seat 6: pfunkolstar (button) folded before Flop (didn't bet)
Seat 7: MuddyDance (small blind) folded before Flop
Seat 8: sanr23 (big blind) folded before Flop





PokerStars Hand #155380143386:  Hold'em No Limit ($0.25/$0.50 USD) - 2016/06/30 13:53:57 CET [2016/06/30 7:53:57 ET]
Table 'Dorothea II' 9-max Seat #1 is the button
Seat 1: zapata 7777 ($49.05 in chips) 
Seat 2: joker180785 ($50 in chips) 
Seat 3: Franky77200 ($61.75 in chips) 
Seat 4: matiko09 ($147.97 in chips) 
Seat 5: Bailey Dew ($87.55 in chips) 
Seat 6: ivan100886 ($26.61 in chips) 
Seat 7: desmo465 ($46.95 in chips) 
Seat 8: TheMinion ($50 in chips) 
Seat 9: funXmun ($50 in chips) 
joker180785: posts small blind $0.25
Franky77200: posts big blind $0.50
zapata 7777: posts the ante $0.10
joker180785: posts the ante $0.10
Franky77200: posts the ante $0.10
matiko09: posts the ante $0.10
Bailey Dew: posts the ante $0.10
ivan100886: posts the ante $0.10
desmo465: posts the ante $0.10
TheMinion: posts the ante $0.10
funXmun: posts the ante $0.10
*** HOLE CARDS ***
Dealt to matiko09 [7h Jc]
matiko09: folds 
Bailey Dew: folds 
ivan100886: raises $0.75 to $1.25
desmo465: calls $1.25
TheMinion: folds 
funXmun: calls $1.25
zapata 7777: folds 
joker180785: folds 
Franky77200: raises $2.75 to $4
ivan100886: raises $22.51 to $26.51 and is all-in
desmo465: folds 
funXmun: folds 
Franky77200: folds 
Uncalled bet ($22.51) returned to ivan100886
ivan100886 collected $11.65 from pot
*** SUMMARY ***
Total pot $11.65 | Rake $0 
Seat 1: zapata 7777 (button) folded before Flop (didn't bet)
Seat 2: joker180785 (small blind) folded before Flop
Seat 3: Franky77200 (big blind) folded before Flop
Seat 4: matiko09 folded before Flop (didn't bet)
Seat 5: Bailey Dew folded before Flop (didn't bet)
Seat 6: ivan100886 collected ($11.65)
Seat 7: desmo465 folded before Flop
Seat 8: TheMinion folded before Flop (didn't bet)
Seat 9: funXmun folded before Flop





PokerStars Hand #155380143384:  Hold'em No Limit ($0.25/$0.50 USD) - 2016/06/30 13:53:57 CET [2016/06/30 7:53:57 ET]
Table 'Mentha II' 9-max Seat #6 is the button
Seat 1: Bailey Dew ($173.22 in chips) 
Seat 2: TheMinion ($55.33 in chips) 
Seat 3: joker180785 ($50 in chips) 
Seat 4: 55peter1 ($76.03 in chips) 
Seat 6: Alexey_Kim2 ($50 in chips) 
Seat 7: ardo888 ($146.35 in chips) 
Seat 9: matiko09 ($100.85 in chips) 
ardo888: posts small blind $0.25
drlee77: is sitting out 
matiko09: posts big blind $0.50
Bailey Dew: posts the ante $0.10
TheMinion: posts the ante $0.10
joker180785: posts the ante $0.10
55peter1: posts the ante $0.10
Alexey_Kim2: posts the ante $0.10
ardo888: posts the ante $0.10
matiko09: posts the ante $0.10
*** HOLE CARDS ***
Dealt to matiko09 [Qh As]
Bailey Dew: folds 
TheMinion: folds 
joker180785: folds 
55peter1: folds 
Alexey_Kim2: folds 
Bailey Dew leaves the table
ardo888: folds 
Uncalled bet ($0.25) returned to matiko09
matiko09 collected $1.20 from pot
matiko09: doesn't show hand 
*** SUMMARY ***
Total pot $1.20 | Rake $0 
Seat 1: Bailey Dew folded before Flop (didn't bet)
Seat 2: TheMinion folded before Flop (didn't bet)
Seat 3: joker180785 folded before Flop (didn't bet)
Seat 4: 55peter1 folded before Flop (didn't bet)
Seat 6: Alexey_Kim2 (button) folded before Flop (didn't bet)
Seat 7: ardo888 (small blind) folded before Flop
Seat 9: matiko09 (big blind) collected ($1.20)





PokerStars Hand #155380145975:  Hold'em No Limit ($0.50/$1.00 USD) - 2016/06/30 13:54:03 CET [2016/06/30 7:54:03 ET]
Table 'Armisticia' 9-max Seat #2 is the button
Seat 2: di0d80 ($100 in chips) 
Seat 3: KovIFish89 ($100 in chips) 
Seat 4: ardo888 ($101.55 in chips) 
Seat 5: SonerWPT ($115.43 in chips) 
Seat 6: matiko09 ($126.30 in chips) 
Seat 7: ilaviiitech ($100 in chips) 
Seat 9: mbk88 ($114.81 in chips) 
KovIFish89: posts small blind $0.50
ardo888: posts big blind $1
Rafaello18: sits out 
nickreason17: sits out 
*** HOLE CARDS ***
Dealt to matiko09 [Td 8c]
SonerWPT: folds 
matiko09: folds 
ilaviiitech: folds 
mbk88: folds 
di0d80: raises $1 to $2
KovIFish89: folds 
ardo888: calls $1
*** FLOP *** [Jd 6d 8s]
ardo888: checks 
di0d80: checks 
*** TURN *** [Jd 6d 8s] [Ac]
ardo888: checks 
di0d80: bets $2.50
ardo888: folds 
Uncalled bet ($2.50) returned to di0d80
di0d80 collected $4.28 from pot
di0d80: doesn't show hand 
*** SUMMARY ***
Total pot $4.50 | Rake $0.22 
Board [Jd 6d 8s Ac]
Seat 2: di0d80 (button) collected ($4.28)
Seat 3: KovIFish89 (small blind) folded before Flop
Seat 4: ardo888 (big blind) folded on the Turn
Seat 5: SonerWPT folded before Flop (didn't bet)
Seat 6: matiko09 folded before Flop (didn't bet)
Seat 7: ilaviiitech folded before Flop (didn't bet)
Seat 9: mbk88 folded before Flop (didn't bet)





PokerStars Hand #155380148722:  Hold'em No Limit ($0.50/$1.00 USD) - 2016/06/30 13:54:09 CET [2016/06/30 7:54:09 ET]
Table 'Prieska' 9-max Seat #6 is the button
Seat 1: KovIFish89 ($118.59 in chips) 
Seat 2: B_style_cuz ($104.93 in chips) 
Seat 3: Rafaello18 ($125 in chips) 
Seat 4: nickreason17 ($102.72 in chips) 
Seat 5: ramzes160468 ($62.52 in chips) 
Seat 6: DIMAN_324 ($101 in chips) 
Seat 7: matiko09 ($100 in chips) 
Seat 8: mbk88 ($124.45 in chips) 
Seat 9: Konig26 ($102.62 in chips) 
matiko09: posts small blind $0.50
mbk88: posts big blind $1
*** HOLE CARDS ***
Dealt to matiko09 [Qs Ad]
Konig26: folds 
KovIFish89: folds 
B_style_cuz: folds 
Rafaello18: folds 
nickreason17: raises $1.50 to $2.50
ramzes160468: folds 
DIMAN_324: folds 
matiko09: raises $6.50 to $9
mbk88: folds 
nickreason17: folds 
Uncalled bet ($6.50) returned to matiko09
matiko09 collected $6 from pot
matiko09: doesn't show hand 
*** SUMMARY ***
Total pot $6 | Rake $0 
Seat 1: KovIFish89 folded before Flop (didn't bet)
Seat 2: B_style_cuz folded before Flop (didn't bet)
Seat 3: Rafaello18 folded before Flop (didn't bet)
Seat 4: nickreason17 folded before Flop
Seat 5: ramzes160468 folded before Flop (didn't bet)
Seat 6: DIMAN_324 (button) folded before Flop (didn't bet)
Seat 7: matiko09 (small blind) collected ($6)
Seat 8: mbk88 (big blind) folded before Flop
Seat 9: Konig26 folded before Flop (didn't bet)





PokerStars Hand #155380152439:  Hold'em No Limit ($0.25/$0.50 USD) - 2016/06/30 13:54:18 CET [2016/06/30 7:54:18 ET]
Table 'Mentha II' 9-max Seat #7 is the button
Seat 2: TheMinion ($55.23 in chips) 
Seat 3: joker180785 ($50 in chips) 
Seat 4: 55peter1 ($75.93 in chips) 
Seat 6: Alexey_Kim2 ($50 in chips) 
Seat 7: ardo888 ($146 in chips) 
Seat 9: matiko09 ($101.70 in chips) 
matiko09: posts small blind $0.25
TheMinion: posts big blind $0.50
TheMinion: posts the ante $0.10
joker180785: posts the ante $0.10
55peter1: posts the ante $0.10
Alexey_Kim2: posts the ante $0.10
ardo888: posts the ante $0.10
matiko09: posts the ante $0.10
*** HOLE CARDS ***
Dealt to matiko09 [3c 8d]
joker180785: folds 
55peter1: folds 
Alexey_Kim2: folds 
ardo888: raises $0.75 to $1.25
matiko09: folds 
TheMinion: folds 
Uncalled bet ($0.75) returned to ardo888
ardo888 collected $1.85 from pot
ardo888: doesn't show hand 
*** SUMMARY ***
Total pot $1.85 | Rake $0 
Seat 2: TheMinion (big blind) folded before Flop
Seat 3: joker180785 folded before Flop (didn't bet)
Seat 4: 55peter1 folded before Flop (didn't bet)
Seat 6: Alexey_Kim2 folded before Flop (didn't bet)
Seat 7: ardo888 (button) collected ($1.85)
Seat 9: matiko09 (small blind) folded before Flop





PokerStars Hand #155380157208:  Hold'em No Limit ($0.50/$1.00 USD) - 2016/06/30 13:54:29 CET [2016/06/30 7:54:29 ET]
Table 'California II' 9-max Seat #7 is the button
Seat 1: Rafaello18 ($112.52 in chips) 
Seat 2: velourleder ($106 in chips) 
Seat 4: mbk88 ($179.20 in chips) 
Seat 5: Rohitbarve ($101.24 in chips) 
Seat 6: matiko09 ($117.85 in chips) 
Seat 7: DomiVY ($84.20 in chips) 
Seat 8: picka4u ($44.32 in chips) 
Seat 9: di0d80 ($106.16 in chips) 
picka4u: posts small blind $0.50
di0d80: posts big blind $1
KovIFish89: sits out 
*** HOLE CARDS ***
Dealt to matiko09 [7d 8d]
Rafaello18: folds 
velourleder: folds 
mbk88: folds 
Rohitbarve has timed out
Rohitbarve: folds 
matiko09: raises $1.50 to $2.50
DomiVY: folds 
picka4u: folds 
di0d80: folds 
Uncalled bet ($1.50) returned to matiko09
matiko09 collected $2.50 from pot
matiko09: doesn't show hand 
*** SUMMARY ***
Total pot $2.50 | Rake $0 
Seat 1: Rafaello18 folded before Flop (didn't bet)
Seat 2: velourleder folded before Flop (didn't bet)
Seat 4: mbk88 folded before Flop (didn't bet)
Seat 5: Rohitbarve folded before Flop (didn't bet)
Seat 6: matiko09 collected ($2.50)
Seat 7: DomiVY (button) folded before Flop (didn't bet)
Seat 8: picka4u (small blind) folded before Flop
Seat 9: di0d80 (big blind) folded before Flop





PokerStars Hand #155380157907:  Hold'em No Limit ($0.50/$1.00 USD) - 2016/06/30 13:54:30 CET [2016/06/30 7:54:30 ET]
Table 'Tatjana' 9-max Seat #2 is the button
Seat 1: ardo888 ($117.44 in chips) 
Seat 2: DIMAN_324 ($101.50 in chips) 
Seat 3: Rafaello18 ($129.57 in chips) 
Seat 4: mopatron25 ($90.53 in chips) 
Seat 5: matiko09 ($100 in chips) 
Seat 8: alhill86 ($80.34 in chips) 
Seat 9: POTAPENKO700 ($139.71 in chips) 
Rafaello18: posts small blind $0.50
mopatron25: posts big blind $1
mbk88: sits out 
*** HOLE CARDS ***
Dealt to matiko09 [6h 6d]
matiko09: raises $2 to $3
alhill86: folds 
POTAPENKO700: folds 
ardo888: folds 
DIMAN_324: folds 
Rafaello18: folds 
mopatron25: calls $2
*** FLOP *** [2s Th Qh]
mopatron25: bets $2
matiko09: folds 
Uncalled bet ($2) returned to mopatron25
mopatron25 collected $6.18 from pot
mopatron25: doesn't show hand 
*** SUMMARY ***
Total pot $6.50 | Rake $0.32 
Board [2s Th Qh]
Seat 1: ardo888 folded before Flop (didn't bet)
Seat 2: DIMAN_324 (button) folded before Flop (didn't bet)
Seat 3: Rafaello18 (small blind) folded before Flop
Seat 4: mopatron25 (big blind) collected ($6.18)
Seat 5: matiko09 folded on the Flop
Seat 8: alhill86 folded before Flop (didn't bet)
Seat 9: POTAPENKO700 folded before Flop (didn't bet)





PokerStars Hand #155380160093:  Hold'em No Limit ($0.50/$1.00 USD) - 2016/06/30 13:54:35 CET [2016/06/30 7:54:35 ET]
Table 'Borrelly II' 9-max Seat #7 is the button
Seat 1: Rafaello18 ($118.89 in chips) 
Seat 2: mbk88 ($105.62 in chips) 
Seat 4: DonRon_AT ($44.49 in chips) 
Seat 5: DIMAN_324 ($100 in chips) 
Seat 6: m_michalec ($168.08 in chips) 
Seat 7: matiko09 ($174.86 in chips) 
Seat 8: Arjun A Raju ($101.62 in chips) 
Arjun A Raju: posts small blind $0.50
alhill86: is sitting out 
Rafaello18: posts big blind $1
di0d80: sits out 
*** HOLE CARDS ***
Dealt to matiko09 [5c 3d]
mbk88: folds 
DonRon_AT: calls $1
DIMAN_324: folds 
m_michalec: raises $3.50 to $4.50
matiko09: folds 
Arjun A Raju: folds 
Rafaello18: folds 
DonRon_AT: calls $3.50
*** FLOP *** [8d 8c 8h]
DonRon_AT: checks 
m_michalec: bets $5
DonRon_AT: folds 
Uncalled bet ($5) returned to m_michalec
m_michalec collected $9.98 from pot
m_michalec: doesn't show hand 
*** SUMMARY ***
Total pot $10.50 | Rake $0.52 
Board [8d 8c 8h]
Seat 1: Rafaello18 (big blind) folded before Flop
Seat 2: mbk88 folded before Flop (didn't bet)
Seat 4: DonRon_AT folded on the Flop
Seat 5: DIMAN_324 folded before Flop (didn't bet)
Seat 6: m_michalec collected ($9.98)
Seat 7: matiko09 (button) folded before Flop (didn't bet)
Seat 8: Arjun A Raju (small blind) folded before Flop





PokerStars Hand #155380164699:  Hold'em No Limit ($0.50/$1.00 USD) - 2016/06/30 13:54:46 CET [2016/06/30 7:54:46 ET]
Table 'Asmodeus' 9-max Seat #1 is the button
Seat 1: scollop ($138.65 in chips) 
Seat 2: picka4u ($40 in chips) 
Seat 3: matiko09 ($103.75 in chips) 
Seat 4: ardo888 ($118.28 in chips) 
Seat 5: sanr23 ($100 in chips) 
Seat 6: koutani7 ($91 in chips) 
Seat 7: aaronzzr ($147.04 in chips) 
Seat 8: Rafaello18 ($155.57 in chips) 
Seat 9: mbk88 ($158.86 in chips) 
picka4u: posts small blind $0.50
matiko09: posts big blind $1
*** HOLE CARDS ***
Dealt to matiko09 [As 7c]
ardo888: folds 
sanr23: raises $2 to $3
koutani7: folds 
aaronzzr: calls $3
Rafaello18: calls $3
mbk88: folds 
scollop: folds 
picka4u: folds 
matiko09: folds 
*** FLOP *** [Jd 9c 3d]
sanr23: checks 
aaronzzr: checks 
Rafaello18: bets $7
sanr23: calls $7
aaronzzr: folds 
*** TURN *** [Jd 9c 3d] [9d]
sanr23: checks 
Rafaello18: checks 
*** RIVER *** [Jd 9c 3d 9d] [Jh]
sanr23: checks 
Rafaello18: bets $14
sanr23: folds 
Uncalled bet ($14) returned to Rafaello18
Rafaello18 collected $23.28 from pot
Rafaello18: doesn't show hand 
*** SUMMARY ***
Total pot $24.50 | Rake $1.22 
Board [Jd 9c 3d 9d Jh]
Seat 1: scollop (button) folded before Flop (didn't bet)
Seat 2: picka4u (small blind) folded before Flop
Seat 3: matiko09 (big blind) folded before Flop
Seat 4: ardo888 folded before Flop (didn't bet)
Seat 5: sanr23 folded on the River
Seat 6: koutani7 folded before Flop (didn't bet)
Seat 7: aaronzzr folded on the Flop
Seat 8: Rafaello18 collected ($23.28)
Seat 9: mbk88 folded before Flop (didn't bet)





PokerStars Hand #155380165633:  Hold'em No Limit ($0.25/$0.50 USD) - 2016/06/30 13:54:48 CET [2016/06/30 7:54:48 ET]
Table 'Mentha II' 9-max Seat #9 is the button
Seat 2: TheMinion ($54.63 in chips) 
Seat 3: joker180785 ($50 in chips) 
Seat 4: 55peter1 ($75.83 in chips) 
Seat 6: Alexey_Kim2 ($50 in chips) 
Seat 7: ardo888 ($147.25 in chips) 
Seat 9: matiko09 ($101.35 in chips) 
TheMinion: posts small blind $0.25
joker180785: posts big blind $0.50
TheMinion: posts the ante $0.10
joker180785: posts the ante $0.10
55peter1: posts the ante $0.10
Alexey_Kim2: posts the ante $0.10
ardo888: posts the ante $0.10
matiko09: posts the ante $0.10
*** HOLE CARDS ***
Dealt to matiko09 [4c Jd]
55peter1: folds 
kotkas1000 joins the table at seat #5 
Alexey_Kim2: raises $1 to $1.50
ardo888: folds 
matiko09: folds 
TheMinion: calls $1.25
joker180785: folds 
*** FLOP *** [3c 8s Jc]
TheMinion: checks 
Alexey_Kim2: bets $2.59
TheMinion: raises $4.66 to $7.25
Alexey_Kim2: folds 
Uncalled bet ($4.66) returned to TheMinion
TheMinion collected $8.82 from pot
TheMinion: doesn't show hand 
*** SUMMARY ***
Total pot $9.28 | Rake $0.46 
Board [3c 8s Jc]
Seat 2: TheMinion (small blind) collected ($8.82)
Seat 3: joker180785 (big blind) folded before Flop
Seat 4: 55peter1 folded before Flop (didn't bet)
Seat 6: Alexey_Kim2 folded on the Flop
Seat 7: ardo888 folded before Flop (didn't bet)
Seat 9: matiko09 (button) folded before Flop (didn't bet)





PokerStars Hand #155380167138:  Hold'em No Limit ($0.25/$0.50 USD) - 2016/06/30 13:54:51 CET [2016/06/30 7:54:51 ET]
Table 'Elektra II' 9-max Seat #7 is the button
Seat 2: TheMinion ($61.57 in chips) 
Seat 3: mojtabagol ($74.07 in chips) 
Seat 4: matiko09 ($54.72 in chips) 
Seat 5: Rafaello18 ($57.24 in chips) 
Seat 6: pfunkolstar ($57.04 in chips) 
Seat 7: MuddyDance ($47.75 in chips) 
Seat 8: sanr23 ($50.25 in chips) 
sanr23: posts small blind $0.25
TheMinion: posts big blind $0.50
*** HOLE CARDS ***
Dealt to matiko09 [3s 6c]
mojtabagol: folds 
matiko09: folds 
Rafaello18: folds 
pfunkolstar: folds 
MuddyDance: raises $0.54 to $1.04
sanr23: raises $3.46 to $4.50
TheMinion: folds 
MuddyDance: folds 
Uncalled bet ($3.46) returned to sanr23
sanr23 collected $2.58 from pot
sanr23: doesn't show hand 
*** SUMMARY ***
Total pot $2.58 | Rake $0 
Seat 2: TheMinion (big blind) folded before Flop
Seat 3: mojtabagol folded before Flop (didn't bet)
Seat 4: matiko09 folded before Flop (didn't bet)
Seat 5: Rafaello18 folded before Flop (didn't bet)
Seat 6: pfunkolstar folded before Flop (didn't bet)
Seat 7: MuddyDance (button) folded before Flop
Seat 8: sanr23 (small blind) collected ($2.58)





PokerStars Hand #155380168950:  Hold'em No Limit ($0.50/$1.00 USD) - 2016/06/30 13:54:56 CET [2016/06/30 7:54:56 ET]
Table 'Altarf II' 9-max Seat #6 is the button
Seat 3: sanr23 ($140.55 in chips) 
Seat 4: Greha999 ($77.16 in chips) 
Seat 5: DIMAN_324 ($205.74 in chips) 
Seat 6: mbk88 ($100 in chips) 
Seat 7: matiko09 ($108.40 in chips) 
Seat 8: DomiVY ($40 in chips) 
Seat 9: omanibemihum ($104.12 in chips) 
matiko09: posts small blind $0.50
DomiVY: posts big blind $1
Rafaello18: sits out 
KovIFish89: sits out 
*** HOLE CARDS ***
Dealt to matiko09 [8h Qs]
omanibemihum: raises $2 to $3
sanr23: folds 
Greha999: folds 
DIMAN_324: folds 
mbk88: folds 
matiko09: folds 
DomiVY: folds 
Uncalled bet ($2) returned to omanibemihum
omanibemihum collected $2.50 from pot
omanibemihum: doesn't show hand 
*** SUMMARY ***
Total pot $2.50 | Rake $0 
Seat 3: sanr23 folded before Flop (didn't bet)
Seat 4: Greha999 folded before Flop (didn't bet)
Seat 5: DIMAN_324 folded before Flop (didn't bet)
Seat 6: mbk88 (button) folded before Flop (didn't bet)
Seat 7: matiko09 (small blind) folded before Flop
Seat 8: DomiVY (big blind) folded before Flop
Seat 9: omanibemihum collected ($2.50)





PokerStars Hand #155380169710:  Hold'em No Limit ($0.50/$1.00 USD) - 2016/06/30 13:54:57 CET [2016/06/30 7:54:57 ET]
Table 'Armisticia' 9-max Seat #3 is the button
Seat 2: di0d80 ($102.28 in chips) 
Seat 3: KovIFish89 ($100 in chips) 
Seat 4: ardo888 ($100 in chips) 
Seat 5: SonerWPT ($115.43 in chips) 
Seat 6: matiko09 ($126.30 in chips) 
Seat 7: ilaviiitech ($100 in chips) 
Seat 9: mbk88 ($114.81 in chips) 
ardo888: posts small blind $0.50
SonerWPT: posts big blind $1
Rafaello18: sits out 
nickreason17: sits out 
*** HOLE CARDS ***
Dealt to matiko09 [2c 7c]
matiko09: folds 
ilaviiitech: folds 
mbk88: folds 
di0d80: folds 
KovIFish89: folds 
ardo888: raises $2 to $3
SonerWPT: folds 
Uncalled bet ($2) returned to ardo888
ardo888 collected $2 from pot
ardo888: doesn't show hand 
*** SUMMARY ***
Total pot $2 | Rake $0 
Seat 2: di0d80 folded before Flop (didn't bet)
Seat 3: KovIFish89 (button) folded before Flop (didn't bet)
Seat 4: ardo888 (small blind) collected ($2)
Seat 5: SonerWPT (big blind) folded before Flop
Seat 6: matiko09 folded before Flop (didn't bet)
Seat 7: ilaviiitech folded before Flop (didn't bet)
Seat 9: mbk88 folded before Flop (didn't bet)





PokerStars Hand #155380170156:  Hold'em No Limit ($0.25/$0.50 USD) - 2016/06/30 13:54:58 CET [2016/06/30 7:54:58 ET]
Table 'Dorothea II' 9-max Seat #2 is the button
Seat 1: zapata 7777 ($48.95 in chips) 
Seat 2: joker180785 ($50 in chips) 
Seat 3: Franky77200 ($57.65 in chips) 
Seat 4: matiko09 ($147.87 in chips) 
Seat 5: Bailey Dew ($87.45 in chips) 
Seat 6: ivan100886 ($34.16 in chips) 
Seat 7: desmo465 ($45.60 in chips) 
Seat 8: TheMinion ($50 in chips) 
Seat 9: funXmun ($50 in chips) 
Franky77200: posts small blind $0.25
matiko09: posts big blind $0.50
zapata 7777: posts the ante $0.10
joker180785: posts the ante $0.10
Franky77200: posts the ante $0.10
matiko09: posts the ante $0.10
Bailey Dew: posts the ante $0.10
ivan100886: posts the ante $0.10
desmo465: posts the ante $0.10
TheMinion: posts the ante $0.10
funXmun: posts the ante $0.10
*** HOLE CARDS ***
Dealt to matiko09 [Jh Ah]
Bailey Dew: folds 
ivan100886: folds 
desmo465: folds 
TheMinion: folds 
funXmun: folds 
zapata 7777: raises $0.60 to $1.10
joker180785: folds 
Franky77200: calls $0.85
matiko09: raises $4.40 to $5.50
zapata 7777: calls $4.40
Franky77200: calls $4.40
*** FLOP *** [6s 7h 7c]
Franky77200: checks 
matiko09: bets $5.12
zapata 7777: raises $11.77 to $16.89
Franky77200: folds 
matiko09: folds 
Uncalled bet ($11.77) returned to zapata 7777
zapata 7777 collected $26.26 from pot
zapata 7777: doesn't show hand 
*** SUMMARY ***
Total pot $27.64 | Rake $1.38 
Board [6s 7h 7c]
Seat 1: zapata 7777 collected ($26.26)
Seat 2: joker180785 (button) folded before Flop (didn't bet)
Seat 3: Franky77200 (small blind) folded on the Flop
Seat 4: matiko09 (big blind) folded on the Flop
Seat 5: Bailey Dew folded before Flop (didn't bet)
Seat 6: ivan100886 folded before Flop (didn't bet)
Seat 7: desmo465 folded before Flop (didn't bet)
Seat 8: TheMinion folded before Flop (didn't bet)
Seat 9: funXmun folded before Flop (didn't bet)





PokerStars Hand #155380169807:  Hold'em No Limit ($0.50/$1.00 USD) - 2016/06/30 13:54:58 CET [2016/06/30 7:54:58 ET]
Table 'Prieska' 9-max Seat #7 is the button
Seat 1: KovIFish89 ($118.59 in chips) 
Seat 2: B_style_cuz ($104.93 in chips) 
Seat 3: Rafaello18 ($125 in chips) 
Seat 4: nickreason17 ($100.22 in chips) 
Seat 5: ramzes160468 ($62.52 in chips) 
Seat 6: DIMAN_324 ($101 in chips) 
Seat 7: matiko09 ($103.50 in chips) 
Seat 8: mbk88 ($123.45 in chips) 
Seat 9: Konig26 ($102.62 in chips) 
mbk88: posts small blind $0.50
Konig26: posts big blind $1
*** HOLE CARDS ***
Dealt to matiko09 [Ts Ah]
KovIFish89: folds 
B_style_cuz: folds 
Rafaello18: folds 
nickreason17: folds 
ramzes160468: folds 
DIMAN_324: folds 
matiko09: raises $1.27 to $2.27
mbk88: folds 
Konig26: calls $1.27
*** FLOP *** [Ad 8d Jd]
Konig26: checks 
matiko09: bets $3
Konig26: folds 
Uncalled bet ($3) returned to matiko09
matiko09 collected $4.79 from pot
matiko09: doesn't show hand 
*** SUMMARY ***
Total pot $5.04 | Rake $0.25 
Board [Ad 8d Jd]
Seat 1: KovIFish89 folded before Flop (didn't bet)
Seat 2: B_style_cuz folded before Flop (didn't bet)
Seat 3: Rafaello18 folded before Flop (didn't bet)
Seat 4: nickreason17 folded before Flop (didn't bet)
Seat 5: ramzes160468 folded before Flop (didn't bet)
Seat 6: DIMAN_324 folded before Flop (didn't bet)
Seat 7: matiko09 (button) collected ($4.79)
Seat 8: mbk88 (small blind) folded before Flop
Seat 9: Konig26 (big blind) folded on the Flop





PokerStars Hand #155380178254:  Hold'em No Limit ($0.50/$1.00 USD) - 2016/06/30 13:55:19 CET [2016/06/30 7:55:19 ET]
Table 'Tatjana' 9-max Seat #3 is the button
Seat 1: ardo888 ($117.44 in chips) 
Seat 2: DIMAN_324 ($101.50 in chips) 
Seat 3: Rafaello18 ($129.07 in chips) 
Seat 4: mopatron25 ($93.71 in chips) 
Seat 5: matiko09 ($100 in chips) 
Seat 8: alhill86 ($80.34 in chips) 
Seat 9: POTAPENKO700 ($139.71 in chips) 
mopatron25: posts small blind $0.50
matiko09: posts big blind $1
mbk88: sits out 
*** HOLE CARDS ***
Dealt to matiko09 [5s 3s]
alhill86: folds 
POTAPENKO700: folds 
ardo888: folds 
DIMAN_324: folds 
Rafaello18: raises $1.50 to $2.50
mopatron25: calls $2
matiko09: folds 
*** FLOP *** [Jd Tc 4d]
mopatron25: bets $3
Rafaello18: folds 
Uncalled bet ($3) returned to mopatron25
mopatron25 collected $5.70 from pot
mopatron25: doesn't show hand 
*** SUMMARY ***
Total pot $6 | Rake $0.30 
Board [Jd Tc 4d]
Seat 1: ardo888 folded before Flop (didn't bet)
Seat 2: DIMAN_324 folded before Flop (didn't bet)
Seat 3: Rafaello18 (button) folded on the Flop
Seat 4: mopatron25 (small blind) collected ($5.70)
Seat 5: matiko09 (big blind) folded before Flop
Seat 8: alhill86 folded before Flop (didn't bet)
Seat 9: POTAPENKO700 folded before Flop (didn't bet)





PokerStars Hand #155380178238:  Hold'em No Limit ($0.50/$1.00 USD) - 2016/06/30 13:55:19 CET [2016/06/30 7:55:19 ET]
Table 'Borrelly II' 9-max Seat #8 is the button
Seat 1: Rafaello18 ($117.89 in chips) 
Seat 3: di0d80 ($100 in chips) 
Seat 4: DonRon_AT ($39.99 in chips) 
Seat 5: DIMAN_324 ($100 in chips) 
Seat 6: m_michalec ($173.56 in chips) 
Seat 7: matiko09 ($174.86 in chips) 
Seat 8: Arjun A Raju ($101.12 in chips) 
Rafaello18: posts small blind $0.50
mbk88: is sitting out 
di0d80: posts big blind $1
*** HOLE CARDS ***
Dealt to matiko09 [Js Ac]
DonRon_AT: folds 
DIMAN_324: folds 
m_michalec: folds 
matiko09: raises $1.50 to $2.50
Arjun A Raju: folds 
Rafaello18: folds 
di0d80: folds 
Uncalled bet ($1.50) returned to matiko09
matiko09 collected $2.50 from pot
matiko09: doesn't show hand 
*** SUMMARY ***
Total pot $2.50 | Rake $0 
Seat 1: Rafaello18 (small blind) folded before Flop
Seat 3: di0d80 (big blind) folded before Flop
Seat 4: DonRon_AT folded before Flop (didn't bet)
Seat 5: DIMAN_324 folded before Flop (didn't bet)
Seat 6: m_michalec folded before Flop (didn't bet)
Seat 7: matiko09 collected ($2.50)
Seat 8: Arjun A Raju (button) folded before Flop (didn't bet)





PokerStars Hand #155380178507:  Hold'em No Limit ($0.50/$1.00 USD) - 2016/06/30 13:55:19 CET [2016/06/30 7:55:19 ET]
Table 'Altarf II' 9-max Seat #7 is the button
Seat 3: sanr23 ($140.55 in chips) 
Seat 4: Greha999 ($77.16 in chips) 
Seat 5: DIMAN_324 ($205.74 in chips) 
Seat 6: mbk88 ($100 in chips) 
Seat 7: matiko09 ($107.90 in chips) 
Seat 8: DomiVY ($40 in chips) 
Seat 9: omanibemihum ($105.62 in chips) 
DomiVY: posts small blind $0.50
omanibemihum: posts big blind $1
Rafaello18: sits out 
KovIFish89: sits out 
*** HOLE CARDS ***
Dealt to matiko09 [Kd Qs]
sanr23: folds 
Greha999: raises $1 to $2
DIMAN_324: folds 
mbk88: raises $6 to $8
matiko09: folds 
DomiVY: folds 
omanibemihum: raises $6 to $14
Greha999: folds 
mbk88: calls $6
*** FLOP *** [2d 2s 3c]
omanibemihum: bets $29
mbk88: folds 
Uncalled bet ($29) returned to omanibemihum
omanibemihum collected $28.98 from pot
omanibemihum: doesn't show hand 
*** SUMMARY ***
Total pot $30.50 | Rake $1.52 
Board [2d 2s 3c]
Seat 3: sanr23 folded before Flop (didn't bet)
Seat 4: Greha999 folded before Flop
Seat 5: DIMAN_324 folded before Flop (didn't bet)
Seat 6: mbk88 folded on the Flop
Seat 7: matiko09 (button) folded before Flop (didn't bet)
Seat 8: DomiVY (small blind) folded before Flop
Seat 9: omanibemihum (big blind) collected ($28.98)





PokerStars Hand #155380179184:  Hold'em No Limit ($0.50/$1.00 USD) - 2016/06/30 13:55:21 CET [2016/06/30 7:55:21 ET]
Table 'Armisticia' 9-max Seat #4 is the button
Seat 2: di0d80 ($102.28 in chips) 
Seat 3: KovIFish89 ($100 in chips) 
Seat 4: ardo888 ($101 in chips) 
Seat 5: SonerWPT ($114.43 in chips) 
Seat 6: matiko09 ($126.30 in chips) 
Seat 7: ilaviiitech ($100 in chips) 
Seat 9: mbk88 ($114.81 in chips) 
SonerWPT: posts small blind $0.50
matiko09: posts big blind $1
Rafaello18: sits out 
nickreason17: sits out 
*** HOLE CARDS ***
Dealt to matiko09 [6h 8d]
ilaviiitech: raises $2 to $3
mbk88: folds 
di0d80: folds 
KovIFish89: folds 
ardo888: folds 
SonerWPT: folds 
matiko09: folds 
Uncalled bet ($2) returned to ilaviiitech
ilaviiitech collected $2.50 from pot
ilaviiitech: doesn't show hand 
*** SUMMARY ***
Total pot $2.50 | Rake $0 
Seat 2: di0d80 folded before Flop (didn't bet)
Seat 3: KovIFish89 folded before Flop (didn't bet)
Seat 4: ardo888 (button) folded before Flop (didn't bet)
Seat 5: SonerWPT (small blind) folded before Flop
Seat 6: matiko09 (big blind) folded before Flop
Seat 7: ilaviiitech collected ($2.50)
Seat 9: mbk88 folded before Flop (didn't bet)





PokerStars Hand #155380182170:  Hold'em No Limit ($0.50/$1.00 USD) - 2016/06/30 13:55:29 CET [2016/06/30 7:55:29 ET]
Table 'California II' 9-max Seat #8 is the button
Seat 1: Rafaello18 ($112.52 in chips) 
Seat 2: velourleder ($106 in chips) 
Seat 4: mbk88 ($179.20 in chips) 
Seat 6: matiko09 ($119.35 in chips) 
Seat 7: DomiVY ($84.20 in chips) 
Seat 8: picka4u ($43.82 in chips) 
Seat 9: di0d80 ($105.16 in chips) 
di0d80: posts small blind $0.50
Rafaello18: posts big blind $1
KovIFish89: sits out 
*** HOLE CARDS ***
Dealt to matiko09 [4s 4c]
velourleder: calls $1
mbk88: folds 
matiko09: raises $2 to $3
DomiVY: folds 
picka4u: folds 
di0d80: folds 
Rafaello18: folds 
velourleder: calls $2
*** FLOP *** [Js Qs 9d]
velourleder: checks 
matiko09: checks 
*** TURN *** [Js Qs 9d] [7c]
velourleder: bets $7
matiko09: folds 
Uncalled bet ($7) returned to velourleder
velourleder collected $7.12 from pot
*** SUMMARY ***
Total pot $7.50 | Rake $0.38 
Board [Js Qs 9d 7c]
Seat 1: Rafaello18 (big blind) folded before Flop
Seat 2: velourleder collected ($7.12)
Seat 4: mbk88 folded before Flop (didn't bet)
Seat 6: matiko09 folded on the Turn
Seat 7: DomiVY folded before Flop (didn't bet)
Seat 8: picka4u (button) folded before Flop (didn't bet)
Seat 9: di0d80 (small blind) folded before Flop





PokerStars Hand #155380188732:  Hold'em No Limit ($0.25/$0.50 USD) - 2016/06/30 13:55:47 CET [2016/06/30 7:55:47 ET]
Table 'Mentha II' 9-max Seat #2 is the button
Seat 2: TheMinion ($59.26 in chips) 
Seat 3: joker180785 ($50 in chips) 
Seat 4: 55peter1 ($75.73 in chips) 
Seat 6: Alexey_Kim2 ($50 in chips) 
Seat 7: ardo888 ($147.15 in chips) 
Seat 9: matiko09 ($101.25 in chips) 
joker180785: posts small blind $0.25
55peter1: posts big blind $0.50
kotkas1000: sits out 
TheMinion: posts the ante $0.10
joker180785: posts the ante $0.10
55peter1: posts the ante $0.10
Alexey_Kim2: posts the ante $0.10
ardo888: posts the ante $0.10
matiko09: posts the ante $0.10
*** HOLE CARDS ***
Dealt to matiko09 [Ad 3d]
Alexey_Kim2: folds 
ardo888: folds 
matiko09: raises $1 to $1.50
TheMinion: folds 
joker180785: folds 
55peter1: folds 
Uncalled bet ($1) returned to matiko09
matiko09 collected $1.85 from pot
matiko09: doesn't show hand 
*** SUMMARY ***
Total pot $1.85 | Rake $0 
Seat 2: TheMinion (button) folded before Flop (didn't bet)
Seat 3: joker180785 (small blind) folded before Flop
Seat 4: 55peter1 (big blind) folded before Flop
Seat 6: Alexey_Kim2 folded before Flop (didn't bet)
Seat 7: ardo888 folded before Flop (didn't bet)
Seat 9: matiko09 collected ($1.85)





PokerStars Hand #155380188963:  Hold'em No Limit ($0.25/$0.50 USD) - 2016/06/30 13:55:47 CET [2016/06/30 7:55:47 ET]
Table 'Elektra II' 9-max Seat #8 is the button
Seat 2: TheMinion ($61.07 in chips) 
Seat 4: matiko09 ($54.72 in chips) 
Seat 5: Rafaello18 ($57.24 in chips) 
Seat 6: pfunkolstar ($57.04 in chips) 
Seat 7: MuddyDance ($50 in chips) 
Seat 8: sanr23 ($51.79 in chips) 
TheMinion: posts small blind $0.25
mojtabagol: is sitting out 
matiko09: posts big blind $0.50
*** HOLE CARDS ***
Dealt to matiko09 [4h Ks]
Rafaello18: folds 
pfunkolstar: folds 
MuddyDance: folds 
sanr23: raises $0.50 to $1
TheMinion: folds 
matiko09: folds 
Uncalled bet ($0.50) returned to sanr23
sanr23 collected $1.25 from pot
sanr23: doesn't show hand 
*** SUMMARY ***
Total pot $1.25 | Rake $0 
Seat 2: TheMinion (small blind) folded before Flop
Seat 4: matiko09 (big blind) folded before Flop
Seat 5: Rafaello18 folded before Flop (didn't bet)
Seat 6: pfunkolstar folded before Flop (didn't bet)
Seat 7: MuddyDance folded before Flop (didn't bet)
Seat 8: sanr23 (button) collected ($1.25)





PokerStars Hand #155380196172:  Hold'em No Limit ($0.50/$1.00 USD) - 2016/06/30 13:56:06 CET [2016/06/30 7:56:06 ET]
Table 'Armisticia' 9-max Seat #5 is the button
Seat 2: di0d80 ($102.28 in chips) 
Seat 3: KovIFish89 ($100 in chips) 
Seat 4: ardo888 ($101 in chips) 
Seat 5: SonerWPT ($113.93 in chips) 
Seat 6: matiko09 ($125.30 in chips) 
Seat 8: Rafaello18 ($199.89 in chips) 
Seat 9: mbk88 ($114.81 in chips) 
matiko09: posts small blind $0.50
ilaviiitech: is sitting out 
Rafaello18: posts big blind $1
nickreason17: sits out 
*** HOLE CARDS ***
Dealt to matiko09 [Jd 2c]
ilaviiitech leaves the table
mbk88: folds 
di0d80: folds 
KovIFish89: folds 
ardo888: raises $1.50 to $2.50
SonerWPT: folds 
matiko09: folds 
Rafaello18: folds 
Uncalled bet ($1.50) returned to ardo888
ardo888 collected $2.50 from pot
ardo888: doesn't show hand 
*** SUMMARY ***
Total pot $2.50 | Rake $0 
Seat 2: di0d80 folded before Flop (didn't bet)
Seat 3: KovIFish89 folded before Flop (didn't bet)
Seat 4: ardo888 collected ($2.50)
Seat 5: SonerWPT (button) folded before Flop (didn't bet)
Seat 6: matiko09 (small blind) folded before Flop
Seat 8: Rafaello18 (big blind) folded before Flop
Seat 9: mbk88 folded before Flop (didn't bet)





PokerStars Hand #155380196165:  Hold'em No Limit ($0.50/$1.00 USD) - 2016/06/30 13:56:06 CET [2016/06/30 7:56:06 ET]
Table 'Prieska' 9-max Seat #8 is the button
Seat 1: KovIFish89 ($118.59 in chips) 
Seat 2: B_style_cuz ($104.93 in chips) 
Seat 3: Rafaello18 ($125 in chips) 
Seat 4: nickreason17 ($100.22 in chips) 
Seat 5: ramzes160468 ($62.52 in chips) 
Seat 6: DIMAN_324 ($101 in chips) 
Seat 7: matiko09 ($106.02 in chips) 
Seat 8: mbk88 ($122.95 in chips) 
Seat 9: Konig26 ($100.35 in chips) 
Konig26: posts small blind $0.50
KovIFish89: posts big blind $1
*** HOLE CARDS ***
Dealt to matiko09 [5h 8s]
B_style_cuz: folds 
Rafaello18: folds 
nickreason17: folds 
ramzes160468: folds 
DIMAN_324: folds 
matiko09: folds 
mbk88: folds 
Konig26: folds 
Uncalled bet ($0.50) returned to KovIFish89
KovIFish89 collected $1 from pot
KovIFish89: doesn't show hand 
*** SUMMARY ***
Total pot $1 | Rake $0 
Seat 1: KovIFish89 (big blind) collected ($1)
Seat 2: B_style_cuz folded before Flop (didn't bet)
Seat 3: Rafaello18 folded before Flop (didn't bet)
Seat 4: nickreason17 folded before Flop (didn't bet)
Seat 5: ramzes160468 folded before Flop (didn't bet)
Seat 6: DIMAN_324 folded before Flop (didn't bet)
Seat 7: matiko09 folded before Flop (didn't bet)
Seat 8: mbk88 (button) folded before Flop (didn't bet)
Seat 9: Konig26 (small blind) folded before Flop





PokerStars Hand #155380197274:  Hold'em No Limit ($0.50/$1.00 USD) - 2016/06/30 13:56:09 CET [2016/06/30 7:56:09 ET]
Table 'Tatjana' 9-max Seat #4 is the button
Seat 1: ardo888 ($117.44 in chips) 
Seat 2: DIMAN_324 ($101.50 in chips) 
Seat 3: Rafaello18 ($126.57 in chips) 
Seat 4: mopatron25 ($96.91 in chips) 
Seat 5: matiko09 ($100 in chips) 
Seat 6: mbk88 ($137.60 in chips) 
Seat 8: alhill86 ($80.34 in chips) 
Seat 9: POTAPENKO700 ($139.71 in chips) 
matiko09: posts small blind $0.50
mbk88: posts big blind $1
*** HOLE CARDS ***
Dealt to matiko09 [8c Tc]
alhill86: folds 
POTAPENKO700: folds 
ardo888: folds 
DIMAN_324: folds 
Rafaello18: raises $1.50 to $2.50
mopatron25: folds 
matiko09: folds 
mbk88: calls $1.50
*** FLOP *** [Td Qc Qd]
mbk88: checks 
Rafaello18: bets $3.50
mbk88: folds 
Uncalled bet ($3.50) returned to Rafaello18
Rafaello18 collected $5.22 from pot
Rafaello18: doesn't show hand 
*** SUMMARY ***
Total pot $5.50 | Rake $0.28 
Board [Td Qc Qd]
Seat 1: ardo888 folded before Flop (didn't bet)
Seat 2: DIMAN_324 folded before Flop (didn't bet)
Seat 3: Rafaello18 collected ($5.22)
Seat 4: mopatron25 (button) folded before Flop (didn't bet)
Seat 5: matiko09 (small blind) folded before Flop
Seat 6: mbk88 (big blind) folded on the Flop
Seat 8: alhill86 folded before Flop (didn't bet)
Seat 9: POTAPENKO700 folded before Flop (didn't bet)





PokerStars Hand #155380197676:  Hold'em No Limit ($0.25/$0.50 USD) - 2016/06/30 13:56:10 CET [2016/06/30 7:56:10 ET]
Table 'Mentha II' 9-max Seat #3 is the button
Seat 2: TheMinion ($59.16 in chips) 
Seat 3: joker180785 ($50 in chips) 
Seat 4: 55peter1 ($75.13 in chips) 
Seat 6: Alexey_Kim2 ($50 in chips) 
Seat 7: ardo888 ($147.05 in chips) 
Seat 9: matiko09 ($102.50 in chips) 
55peter1: posts small blind $0.25
Alexey_Kim2: posts big blind $0.50
TheMinion: posts the ante $0.10
joker180785: posts the ante $0.10
55peter1: posts the ante $0.10
Alexey_Kim2: posts the ante $0.10
ardo888: posts the ante $0.10
matiko09: posts the ante $0.10
*** HOLE CARDS ***
Dealt to matiko09 [2d Qd]
ardo888: folds 
matiko09: folds 
drlee77 leaves the table
TheMinion: folds 
joker180785: raises $0.50 to $1
55peter1: folds 
Alexey_Kim2: folds 
Uncalled bet ($0.50) returned to joker180785
joker180785 collected $1.85 from pot
*** SUMMARY ***
Total pot $1.85 | Rake $0 
Seat 2: TheMinion folded before Flop (didn't bet)
Seat 3: joker180785 (button) collected ($1.85)
Seat 4: 55peter1 (small blind) folded before Flop
Seat 6: Alexey_Kim2 (big blind) folded before Flop
Seat 7: ardo888 folded before Flop (didn't bet)
Seat 9: matiko09 folded before Flop (didn't bet)





PokerStars Hand #155380199674:  Hold'em No Limit ($0.25/$0.50 USD) - 2016/06/30 13:56:15 CET [2016/06/30 7:56:15 ET]
Table 'Dorothea II' 9-max Seat #3 is the button
Seat 1: zapata 7777 ($64.49 in chips) 
Seat 2: joker180785 ($50 in chips) 
Seat 3: Franky77200 ($52.05 in chips) 
Seat 4: matiko09 ($137.15 in chips) 
Seat 5: Bailey Dew ($87.35 in chips) 
Seat 6: ivan100886 ($34.06 in chips) 
Seat 7: desmo465 ($45.50 in chips) 
Seat 8: TheMinion ($50 in chips) 
Seat 9: funXmun ($50 in chips) 
matiko09: posts small blind $0.25
Bailey Dew: posts big blind $0.50
zapata 7777: posts the ante $0.10
joker180785: posts the ante $0.10
Franky77200: posts the ante $0.10
matiko09: posts the ante $0.10
Bailey Dew: posts the ante $0.10
ivan100886: posts the ante $0.10
desmo465: posts the ante $0.10
TheMinion: posts the ante $0.10
funXmun: posts the ante $0.10
*** HOLE CARDS ***
Dealt to matiko09 [2s Jh]
ivan100886: folds 
desmo465: raises $1 to $1.50
TheMinion: folds 
funXmun: folds 
zapata 7777: calls $1.50
joker180785: calls $1.50
Franky77200: calls $1.50
matiko09: folds 
Bailey Dew: folds 
*** FLOP *** [3h 8d Th]
desmo465: checks 
zapata 7777: bets $3.19
joker180785: calls $3.19
Franky77200: folds 
desmo465: folds 
*** TURN *** [3h 8d Th] [6d]
zapata 7777: checks 
joker180785: bets $10.26
zapata 7777: calls $10.26
*** RIVER *** [3h 8d Th 6d] [4h]
zapata 7777: bets $14.44
joker180785: folds 
Uncalled bet ($14.44) returned to zapata 7777
zapata 7777 collected $32.82 from pot
zapata 7777: doesn't show hand 
*** SUMMARY ***
Total pot $34.55 | Rake $1.73 
Board [3h 8d Th 6d 4h]
Seat 1: zapata 7777 collected ($32.82)
Seat 2: joker180785 folded on the River
Seat 3: Franky77200 (button) folded on the Flop
Seat 4: matiko09 (small blind) folded before Flop
Seat 5: Bailey Dew (big blind) folded before Flop
Seat 6: ivan100886 folded before Flop (didn't bet)
Seat 7: desmo465 folded on the Flop
Seat 8: TheMinion folded before Flop (didn't bet)
Seat 9: funXmun folded before Flop (didn't bet)





PokerStars Hand #155380200226:  Hold'em No Limit ($0.50/$1.00 USD) - 2016/06/30 13:56:17 CET [2016/06/30 7:56:17 ET]
Table 'Borrelly II' 9-max Seat #1 is the button
Seat 1: Rafaello18 ($117.39 in chips) 
Seat 3: di0d80 ($100 in chips) 
Seat 4: DonRon_AT ($39.99 in chips) 
Seat 5: DIMAN_324 ($100 in chips) 
Seat 6: m_michalec ($173.56 in chips) 
Seat 7: matiko09 ($176.36 in chips) 
Seat 8: Arjun A Raju ($101.12 in chips) 
di0d80: posts small blind $0.50
DonRon_AT: posts big blind $1
*** HOLE CARDS ***
Dealt to matiko09 [8s 3c]
DIMAN_324: raises $2 to $3
m_michalec: folds 
matiko09: folds 
Arjun A Raju: calls $3
Rafaello18: folds 
di0d80: folds 
DonRon_AT: folds 
*** FLOP *** [Th 7s 5s]
DIMAN_324: checks 
Arjun A Raju: bets $7.12
DIMAN_324: folds 
Uncalled bet ($7.12) returned to Arjun A Raju
Arjun A Raju collected $7.12 from pot
Arjun A Raju: doesn't show hand 
*** SUMMARY ***
Total pot $7.50 | Rake $0.38 
Board [Th 7s 5s]
Seat 1: Rafaello18 (button) folded before Flop (didn't bet)
Seat 3: di0d80 (small blind) folded before Flop
Seat 4: DonRon_AT (big blind) folded before Flop
Seat 5: DIMAN_324 folded on the Flop
Seat 6: m_michalec folded before Flop (didn't bet)
Seat 7: matiko09 folded before Flop (didn't bet)
Seat 8: Arjun A Raju collected ($7.12)





PokerStars Hand #155380200309:  Hold'em No Limit ($0.25/$0.50 USD) - 2016/06/30 13:56:17 CET [2016/06/30 7:56:17 ET]
Table 'Elektra II' 9-max Seat #2 is the button
Seat 2: TheMinion ($60.82 in chips) 
Seat 4: matiko09 ($54.22 in chips) 
Seat 5: Rafaello18 ($57.24 in chips) 
Seat 6: pfunkolstar ($57.04 in chips) 
Seat 7: MuddyDance ($50 in chips) 
Seat 8: sanr23 ($52.54 in chips) 
matiko09: posts small blind $0.25
Rafaello18: posts big blind $0.50
*** HOLE CARDS ***
Dealt to matiko09 [Qs Jc]
pfunkolstar: folds 
MuddyDance: raises $1 to $1.50
sanr23: folds 
TheMinion: folds 
matiko09: folds 
Rafaello18: folds 
Uncalled bet ($1) returned to MuddyDance
MuddyDance collected $1.25 from pot
MuddyDance: doesn't show hand 
*** SUMMARY ***
Total pot $1.25 | Rake $0 
Seat 2: TheMinion (button) folded before Flop (didn't bet)
Seat 4: matiko09 (small blind) folded before Flop
Seat 5: Rafaello18 (big blind) folded before Flop
Seat 6: pfunkolstar folded before Flop (didn't bet)
Seat 7: MuddyDance collected ($1.25)
Seat 8: sanr23 folded before Flop (didn't bet)





PokerStars Hand #155380204599:  Hold'em No Limit ($0.50/$1.00 USD) - 2016/06/30 13:56:28 CET [2016/06/30 7:56:28 ET]
Table 'Altarf II' 9-max Seat #8 is the button
Seat 1: Rafaello18 ($100 in chips) 
Seat 3: sanr23 ($140.55 in chips) 
Seat 4: Greha999 ($75.16 in chips) 
Seat 5: DIMAN_324 ($205.74 in chips) 
Seat 6: mbk88 ($100 in chips) 
Seat 7: matiko09 ($107.90 in chips) 
Seat 8: DomiVY ($40 in chips) 
Seat 9: omanibemihum ($120.60 in chips) 
omanibemihum: posts small blind $0.50
Rafaello18: posts big blind $1
KovIFish89: sits out 
*** HOLE CARDS ***
Dealt to matiko09 [8s 4s]
sanr23: folds 
Greha999: folds 
DIMAN_324: folds 
mbk88: raises $2 to $3
matiko09: folds 
DomiVY: folds 
omanibemihum: calls $2.50
Rafaello18: folds 
*** FLOP *** [6s Kd Ad]
omanibemihum: bets $7
mbk88: calls $7
*** TURN *** [6s Kd Ad] [Qd]
omanibemihum: checks 
mbk88: checks 
*** RIVER *** [6s Kd Ad Qd] [Tc]
omanibemihum: bets $10
mbk88: folds 
Uncalled bet ($10) returned to omanibemihum
omanibemihum collected $19.95 from pot
omanibemihum: doesn't show hand 
*** SUMMARY ***
Total pot $21 | Rake $1.05 
Board [6s Kd Ad Qd Tc]
Seat 1: Rafaello18 (big blind) folded before Flop
Seat 3: sanr23 folded before Flop (didn't bet)
Seat 4: Greha999 folded before Flop (didn't bet)
Seat 5: DIMAN_324 folded before Flop (didn't bet)
Seat 6: mbk88 folded on the River
Seat 7: matiko09 folded before Flop (didn't bet)
Seat 8: DomiVY (button) folded before Flop (didn't bet)
Seat 9: omanibemihum (small blind) collected ($19.95)





PokerStars Hand #155380205134:  Hold'em No Limit ($0.50/$1.00 USD) - 2016/06/30 13:56:30 CET [2016/06/30 7:56:30 ET]
Table 'Prieska' 9-max Seat #9 is the button
Seat 1: KovIFish89 ($119.09 in chips) 
Seat 2: B_style_cuz ($104.93 in chips) 
Seat 3: Rafaello18 ($125 in chips) 
Seat 4: nickreason17 ($100.22 in chips) 
Seat 5: ramzes160468 ($62.52 in chips) 
Seat 6: DIMAN_324 ($101 in chips) 
Seat 7: matiko09 ($106.02 in chips) 
Seat 8: mbk88 ($122.95 in chips) 
Seat 9: Konig26 ($99.85 in chips) 
KovIFish89: posts small blind $0.50
B_style_cuz: posts big blind $1
*** HOLE CARDS ***
Dealt to matiko09 [Kh Jd]
Rafaello18: folds 
nickreason17: folds 
ramzes160468: folds 
DIMAN_324: folds 
matiko09: raises $2 to $3
mbk88: folds 
Konig26: folds 
KovIFish89: folds 
B_style_cuz: folds 
Uncalled bet ($2) returned to matiko09
matiko09 collected $2.50 from pot
matiko09: doesn't show hand 
*** SUMMARY ***
Total pot $2.50 | Rake $0 
Seat 1: KovIFish89 (small blind) folded before Flop
Seat 2: B_style_cuz (big blind) folded before Flop
Seat 3: Rafaello18 folded before Flop (didn't bet)
Seat 4: nickreason17 folded before Flop (didn't bet)
Seat 5: ramzes160468 folded before Flop (didn't bet)
Seat 6: DIMAN_324 folded before Flop (didn't bet)
Seat 7: matiko09 collected ($2.50)
Seat 8: mbk88 folded before Flop (didn't bet)
Seat 9: Konig26 (button) folded before Flop (didn't bet)





PokerStars Hand #155380206829:  Hold'em No Limit ($0.25/$0.50 USD) - 2016/06/30 13:56:34 CET [2016/06/30 7:56:34 ET]
Table 'Mentha II' 9-max Seat #4 is the button
Seat 2: TheMinion ($59.06 in chips) 
Seat 3: joker180785 ($51.25 in chips) 
Seat 4: 55peter1 ($74.78 in chips) 
Seat 6: Alexey_Kim2 ($50 in chips) 
Seat 7: ardo888 ($146.95 in chips) 
Seat 9: matiko09 ($102.40 in chips) 
Alexey_Kim2: posts small blind $0.25
ardo888: posts big blind $0.50
TheMinion: posts the ante $0.10
joker180785: posts the ante $0.10
55peter1: posts the ante $0.10
Alexey_Kim2: posts the ante $0.10
ardo888: posts the ante $0.10
matiko09: posts the ante $0.10
*** HOLE CARDS ***
Dealt to matiko09 [Kc 6s]
matiko09: folds 
TheMinion: folds 
joker180785: folds 
55peter1: calls $0.50
Clifftastic joins the table at seat #8 
Alexey_Kim2: folds 
ardo888: checks 
*** FLOP *** [Th 9s 4h]
ardo888: checks 
55peter1: checks 
*** TURN *** [Th 9s 4h] [3d]
ardo888: checks 
55peter1: bets $1
ardo888: folds 
Uncalled bet ($1) returned to 55peter1
55peter1 collected $1.76 from pot
55peter1: doesn't show hand 
*** SUMMARY ***
Total pot $1.85 | Rake $0.09 
Board [Th 9s 4h 3d]
Seat 2: TheMinion folded before Flop (didn't bet)
Seat 3: joker180785 folded before Flop (didn't bet)
Seat 4: 55peter1 (button) collected ($1.76)
Seat 6: Alexey_Kim2 (small blind) folded before Flop
Seat 7: ardo888 (big blind) folded on the Turn
Seat 9: matiko09 folded before Flop (didn't bet)





PokerStars Hand #155380211804:  Hold'em No Limit ($0.50/$1.00 USD) - 2016/06/30 13:56:47 CET [2016/06/30 7:56:47 ET]
Table 'California II' 9-max Seat #9 is the button
Seat 1: Rafaello18 ($111.52 in chips) 
Seat 2: velourleder ($110.12 in chips) 
Seat 4: mbk88 ($179.20 in chips) 
Seat 6: matiko09 ($116.35 in chips) 
Seat 7: DomiVY ($84.20 in chips) 
Seat 8: picka4u ($43.82 in chips) 
Seat 9: di0d80 ($104.66 in chips) 
Rafaello18: posts small blind $0.50
velourleder: posts big blind $1
KovIFish89: sits out 
*** HOLE CARDS ***
Dealt to matiko09 [Ts Ac]
mbk88: folds 
matiko09: raises $2 to $3
DomiVY: folds 
picka4u: calls $3
di0d80: folds 
Rafaello18: folds 
velourleder: folds 
*** FLOP *** [Ks 5c 8s]
matiko09: bets $4.15
picka4u: calls $4.15
*** TURN *** [Ks 5c 8s] [Kd]
matiko09: checks 
picka4u: bets $8.50
matiko09: folds 
Uncalled bet ($8.50) returned to picka4u
picka4u collected $15.01 from pot
picka4u: doesn't show hand 
*** SUMMARY ***
Total pot $15.80 | Rake $0.79 
Board [Ks 5c 8s Kd]
Seat 1: Rafaello18 (small blind) folded before Flop
Seat 2: velourleder (big blind) folded before Flop
Seat 4: mbk88 folded before Flop (didn't bet)
Seat 6: matiko09 folded on the Turn
Seat 7: DomiVY folded before Flop (didn't bet)
Seat 8: picka4u collected ($15.01)
Seat 9: di0d80 (button) folded before Flop (didn't bet)





PokerStars Hand #155380211978:  Hold'em No Limit ($0.50/$1.00 USD) - 2016/06/30 13:56:48 CET [2016/06/30 7:56:48 ET]
Table 'Armisticia' 9-max Seat #6 is the button
Seat 1: nickreason17 ($100 in chips) 
Seat 2: di0d80 ($102.28 in chips) 
Seat 3: KovIFish89 ($100 in chips) 
Seat 4: ardo888 ($102.50 in chips) 
Seat 5: SonerWPT ($113.93 in chips) 
Seat 6: matiko09 ($124.80 in chips) 
Seat 8: Rafaello18 ($198.89 in chips) 
Rafaello18: posts small blind $0.50
mbk88: is sitting out 
nickreason17: posts big blind $1
*** HOLE CARDS ***
Dealt to matiko09 [Ad 9d]
di0d80: raises $1.50 to $2.50
DIMAN_324 joins the table at seat #7 
KovIFish89: folds 
ardo888: folds 
SonerWPT: folds 
matiko09: folds 
Rafaello18: folds 
nickreason17: folds 
Uncalled bet ($1.50) returned to di0d80
di0d80 collected $2.50 from pot
di0d80: doesn't show hand 
*** SUMMARY ***
Total pot $2.50 | Rake $0 
Seat 1: nickreason17 (big blind) folded before Flop
Seat 2: di0d80 collected ($2.50)
Seat 3: KovIFish89 folded before Flop (didn't bet)
Seat 4: ardo888 folded before Flop (didn't bet)
Seat 5: SonerWPT folded before Flop (didn't bet)
Seat 6: matiko09 (button) folded before Flop (didn't bet)
Seat 8: Rafaello18 (small blind) folded before Flop





PokerStars Hand #155380214570:  Hold'em No Limit ($0.50/$1.00 USD) - 2016/06/30 13:56:54 CET [2016/06/30 7:56:54 ET]
Table 'Tatjana' 9-max Seat #5 is the button
Seat 1: ardo888 ($117.44 in chips) 
Seat 2: DIMAN_324 ($101.50 in chips) 
Seat 3: Rafaello18 ($129.29 in chips) 
Seat 4: mopatron25 ($96.91 in chips) 
Seat 5: matiko09 ($100 in chips) 
Seat 6: mbk88 ($135.10 in chips) 
Seat 9: POTAPENKO700 ($139.71 in chips) 
mbk88: posts small blind $0.50
alhill86: is sitting out 
POTAPENKO700: posts big blind $1
*** HOLE CARDS ***
Dealt to matiko09 [9d 4d]
ardo888: folds 
DIMAN_324: folds 
Rafaello18: folds 
mopatron25: folds 
matiko09: folds 
mbk88: raises $2 to $3
POTAPENKO700: folds 
Uncalled bet ($2) returned to mbk88
mbk88 collected $2 from pot
mbk88: doesn't show hand 
*** SUMMARY ***
Total pot $2 | Rake $0 
Seat 1: ardo888 folded before Flop (didn't bet)
Seat 2: DIMAN_324 folded before Flop (didn't bet)
Seat 3: Rafaello18 folded before Flop (didn't bet)
Seat 4: mopatron25 folded before Flop (didn't bet)
Seat 5: matiko09 (button) folded before Flop (didn't bet)
Seat 6: mbk88 (small blind) collected ($2)
Seat 9: POTAPENKO700 (big blind) folded before Flop





PokerStars Hand #155380219012:  Hold'em No Limit ($0.25/$0.50 USD) - 2016/06/30 13:57:06 CET [2016/06/30 7:57:06 ET]
Table 'Elektra II' 9-max Seat #4 is the button
Seat 2: TheMinion ($60.82 in chips) 
Seat 4: matiko09 ($53.97 in chips) 
Seat 5: Rafaello18 ($56.74 in chips) 
Seat 6: pfunkolstar ($57.04 in chips) 
Seat 7: MuddyDance ($50.75 in chips) 
Seat 8: sanr23 ($52.54 in chips) 
Rafaello18: posts small blind $0.25
pfunkolstar: posts big blind $0.50
drlee77: sits out 
mojtabagol: sits out 
*** HOLE CARDS ***
Dealt to matiko09 [8h Ks]
MuddyDance: folds 
sanr23: folds 
Dantistcopra leaves the table
TheMinion: folds 
matiko09: raises $0.63 to $1.13
Rafaello18: folds 
Bailey Dew joins the table at seat #9 
Bailey Dew leaves the table
KABAL_ua joins the table at seat #9 
pfunkolstar: folds 
Uncalled bet ($0.63) returned to matiko09
matiko09 collected $1.25 from pot
matiko09: doesn't show hand 
*** SUMMARY ***
Total pot $1.25 | Rake $0 
Seat 2: TheMinion folded before Flop (didn't bet)
Seat 4: matiko09 (button) collected ($1.25)
Seat 5: Rafaello18 (small blind) folded before Flop
Seat 6: pfunkolstar (big blind) folded before Flop
Seat 7: MuddyDance folded before Flop (didn't bet)
Seat 8: sanr23 folded before Flop (didn't bet)





PokerStars Hand #155380219650:  Hold'em No Limit ($0.50/$1.00 USD) - 2016/06/30 13:57:07 CET [2016/06/30 7:57:07 ET]
Table 'Prieska' 9-max Seat #1 is the button
Seat 1: KovIFish89 ($118.59 in chips) 
Seat 2: B_style_cuz ($103.93 in chips) 
Seat 3: Rafaello18 ($125 in chips) 
Seat 4: nickreason17 ($100.22 in chips) 
Seat 5: ramzes160468 ($62.52 in chips) 
Seat 6: DIMAN_324 ($101 in chips) 
Seat 7: matiko09 ($107.52 in chips) 
Seat 8: mbk88 ($122.95 in chips) 
Seat 9: Konig26 ($99.85 in chips) 
B_style_cuz: posts small blind $0.50
Rafaello18: posts big blind $1
*** HOLE CARDS ***
Dealt to matiko09 [Tc Kd]
nickreason17: raises $1.50 to $2.50
ramzes160468: folds 
DIMAN_324: folds 
matiko09: folds 
mbk88: folds 
Konig26: calls $2.50
KovIFish89: folds 
B_style_cuz: folds 
Rafaello18: folds 
*** FLOP *** [Ac 8c 9s]
nickreason17: checks 
Konig26: bets $3.09
nickreason17: calls $3.09
*** TURN *** [Ac 8c 9s] [As]
nickreason17: checks 
Konig26: checks 
*** RIVER *** [Ac 8c 9s As] [4c]
nickreason17: checks 
Konig26: checks 
*** SHOW DOWN ***
nickreason17: shows [Th 9h] (two pair, Aces and Nines)
Konig26: mucks hand 
nickreason17 collected $12.05 from pot
*** SUMMARY ***
Total pot $12.68 | Rake $0.63 
Board [Ac 8c 9s As 4c]
Seat 1: KovIFish89 (button) folded before Flop (didn't bet)
Seat 2: B_style_cuz (small blind) folded before Flop
Seat 3: Rafaello18 (big blind) folded before Flop
Seat 4: nickreason17 showed [Th 9h] and won ($12.05) with two pair, Aces and Nines
Seat 5: ramzes160468 folded before Flop (didn't bet)
Seat 6: DIMAN_324 folded before Flop (didn't bet)
Seat 7: matiko09 folded before Flop (didn't bet)
Seat 8: mbk88 folded before Flop (didn't bet)
Seat 9: Konig26 mucked [Kh 7h]





PokerStars Hand #155380220703:  Hold'em No Limit ($0.50/$1.00 USD) - 2016/06/30 13:57:10 CET [2016/06/30 7:57:10 ET]
Table 'Borrelly II' 9-max Seat #3 is the button
Seat 1: Rafaello18 ($117.39 in chips) 
Seat 3: di0d80 ($100 in chips) 
Seat 4: DonRon_AT ($38.99 in chips) 
Seat 5: DIMAN_324 ($100 in chips) 
Seat 6: m_michalec ($173.56 in chips) 
Seat 7: matiko09 ($176.36 in chips) 
Seat 8: Arjun A Raju ($105.24 in chips) 
DonRon_AT: posts small blind $0.50
DIMAN_324: posts big blind $1
alhill86: sits out 
*** HOLE CARDS ***
Dealt to matiko09 [6c Ah]
m_michalec: folds 
matiko09: folds 
Arjun A Raju: raises $2 to $3
Rafaello18: folds 
di0d80: raises $6 to $9
DonRon_AT: folds 
DIMAN_324: folds 
Arjun A Raju: calls $6
*** FLOP *** [2c Ad 7h]
Arjun A Raju: checks 
di0d80: bets $10
Arjun A Raju: folds 
Uncalled bet ($10) returned to di0d80
di0d80 collected $18.52 from pot
di0d80: doesn't show hand 
*** SUMMARY ***
Total pot $19.50 | Rake $0.98 
Board [2c Ad 7h]
Seat 1: Rafaello18 folded before Flop (didn't bet)
Seat 3: di0d80 (button) collected ($18.52)
Seat 4: DonRon_AT (small blind) folded before Flop
Seat 5: DIMAN_324 (big blind) folded before Flop
Seat 6: m_michalec folded before Flop (didn't bet)
Seat 7: matiko09 folded before Flop (didn't bet)
Seat 8: Arjun A Raju folded on the Flop





PokerStars Hand #155380221383:  Hold'em No Limit ($0.25/$0.50 USD) - 2016/06/30 13:57:12 CET [2016/06/30 7:57:12 ET]
Table 'Mentha II' 9-max Seat #6 is the button
Seat 2: TheMinion ($58.96 in chips) 
Seat 3: joker180785 ($51.15 in chips) 
Seat 4: 55peter1 ($75.94 in chips) 
Seat 6: Alexey_Kim2 ($50 in chips) 
Seat 7: ardo888 ($146.35 in chips) 
Seat 8: Clifftastic ($40 in chips) 
Seat 9: matiko09 ($102.30 in chips) 
ardo888: posts small blind $0.25
Clifftastic: posts big blind $0.50
TheMinion: posts the ante $0.10
joker180785: posts the ante $0.10
55peter1: posts the ante $0.10
Alexey_Kim2: posts the ante $0.10
ardo888: posts the ante $0.10
Clifftastic: posts the ante $0.10
matiko09: posts the ante $0.10
*** HOLE CARDS ***
Dealt to matiko09 [3d 8h]
matiko09: folds 
TheMinion: folds 
joker180785: raises $1 to $1.50
55peter1: folds 
Alexey_Kim2: folds 
ardo888: folds 
Clifftastic: folds 
Uncalled bet ($1) returned to joker180785
joker180785 collected $1.95 from pot
*** SUMMARY ***
Total pot $1.95 | Rake $0 
Seat 2: TheMinion folded before Flop (didn't bet)
Seat 3: joker180785 collected ($1.95)
Seat 4: 55peter1 folded before Flop (didn't bet)
Seat 6: Alexey_Kim2 (button) folded before Flop (didn't bet)
Seat 7: ardo888 (small blind) folded before Flop
Seat 8: Clifftastic (big blind) folded before Flop
Seat 9: matiko09 folded before Flop (didn't bet)





PokerStars Hand #155380224458:  Hold'em No Limit ($0.50/$1.00 USD) - 2016/06/30 13:57:20 CET [2016/06/30 7:57:20 ET]
Table 'Armisticia' 9-max Seat #8 is the button
Seat 1: nickreason17 ($100 in chips) 
Seat 2: di0d80 ($103.78 in chips) 
Seat 3: KovIFish89 ($100 in chips) 
Seat 4: ardo888 ($102.50 in chips) 
Seat 5: SonerWPT ($113.93 in chips) 
Seat 6: matiko09 ($124.80 in chips) 
Seat 8: Rafaello18 ($198.39 in chips) 
nickreason17: posts small blind $0.50
di0d80: posts big blind $1
DIMAN_324: sits out 
*** HOLE CARDS ***
Dealt to matiko09 [5c Jc]
KovIFish89: folds 
ardo888: folds 
SonerWPT: folds 
matiko09: folds 
Rafaello18: folds 
nickreason17: folds 
Uncalled bet ($0.50) returned to di0d80
di0d80 collected $1 from pot
di0d80: doesn't show hand 
*** SUMMARY ***
Total pot $1 | Rake $0 
Seat 1: nickreason17 (small blind) folded before Flop
Seat 2: di0d80 (big blind) collected ($1)
Seat 3: KovIFish89 folded before Flop (didn't bet)
Seat 4: ardo888 folded before Flop (didn't bet)
Seat 5: SonerWPT folded before Flop (didn't bet)
Seat 6: matiko09 folded before Flop (didn't bet)
Seat 8: Rafaello18 (button) folded before Flop (didn't bet)





PokerStars Hand #155380225951:  Hold'em No Limit ($0.50/$1.00 USD) - 2016/06/30 13:57:24 CET [2016/06/30 7:57:24 ET]
Table 'Tatjana' 9-max Seat #6 is the button
Seat 2: DIMAN_324 ($101.50 in chips) 
Seat 3: Rafaello18 ($129.29 in chips) 
Seat 4: mopatron25 ($96.91 in chips) 
Seat 5: matiko09 ($100 in chips) 
Seat 6: mbk88 ($136.10 in chips) 
Seat 9: POTAPENKO700 ($138.71 in chips) 
daigodisco will be allowed to play after the button
POTAPENKO700: posts small blind $0.50
ardo888: is sitting out 
DIMAN_324: posts big blind $1
*** HOLE CARDS ***
Dealt to matiko09 [Ks 7c]
ardo888 leaves the table
Rafaello18: raises $1.50 to $2.50
mopatron25: folds 
matiko09: folds 
mbk88: folds 
POTAPENKO700: folds 
tipner joins the table at seat #1 
DIMAN_324: folds 
Uncalled bet ($1.50) returned to Rafaello18
Rafaello18 collected $2.50 from pot
Rafaello18: doesn't show hand 
*** SUMMARY ***
Total pot $2.50 | Rake $0 
Seat 2: DIMAN_324 (big blind) folded before Flop
Seat 3: Rafaello18 collected ($2.50)
Seat 4: mopatron25 folded before Flop (didn't bet)
Seat 5: matiko09 folded before Flop (didn't bet)
Seat 6: mbk88 (button) folded before Flop (didn't bet)
Seat 9: POTAPENKO700 (small blind) folded before Flop





PokerStars Hand #155380228767:  Hold'em No Limit ($0.50/$1.00 USD) - 2016/06/30 13:57:31 CET [2016/06/30 7:57:31 ET]
Table 'Asmodeus' 9-max Seat #2 is the button
Seat 1: scollop ($138.65 in chips) 
Seat 2: picka4u ($39.50 in chips) 
Seat 3: matiko09 ($102.75 in chips) 
Seat 5: sanr23 ($100 in chips) 
Seat 6: koutani7 ($91 in chips) 
Seat 7: aaronzzr ($144.04 in chips) 
Seat 8: Rafaello18 ($168.85 in chips) 
Seat 9: mbk88 ($158.86 in chips) 
matiko09: posts small blind $0.50
ardo888: is sitting out 
ardo888 leaves the table
sanr23: posts big blind $1
*** HOLE CARDS ***
Dealt to matiko09 [Ad 3s]
koutani7: folds 
aaronzzr: folds 
Rafaello18: folds 
mbk88: folds 
scollop: calls $1
picka4u: folds 
matiko09: calls $0.50
DIMAN_324 joins the table at seat #4 
sanr23: raises $4 to $5
scollop: calls $4
matiko09: folds 
*** FLOP *** [Qs 4d Js]
sanr23: checks 
scollop: checks 
*** TURN *** [Qs 4d Js] [8s]
sanr23: bets $4.28
scollop: calls $4.28
*** RIVER *** [Qs 4d Js 8s] [6d]
sanr23: checks 
scollop: checks 
*** SHOW DOWN ***
sanr23: shows [Ts Th] (a pair of Tens)
scollop: mucks hand 
sanr23 collected $18.58 from pot
*** SUMMARY ***
Total pot $19.56 | Rake $0.98 
Board [Qs 4d Js 8s 6d]
Seat 1: scollop mucked [As 6h]
Seat 2: picka4u (button) folded before Flop (didn't bet)
Seat 3: matiko09 (small blind) folded before Flop
Seat 5: sanr23 (big blind) showed [Ts Th] and won ($18.58) with a pair of Tens
Seat 6: koutani7 folded before Flop (didn't bet)
Seat 7: aaronzzr folded before Flop (didn't bet)
Seat 8: Rafaello18 folded before Flop (didn't bet)
Seat 9: mbk88 folded before Flop (didn't bet)





PokerStars Hand #155380232346:  Hold'em No Limit ($0.25/$0.50 USD) - 2016/06/30 13:57:40 CET [2016/06/30 7:57:40 ET]
Table 'Dorothea II' 9-max Seat #4 is the button
Seat 1: zapata 7777 ($82.26 in chips) 
Seat 2: joker180785 ($50 in chips) 
Seat 3: Franky77200 ($50.45 in chips) 
Seat 4: matiko09 ($136.80 in chips) 
Seat 5: Bailey Dew ($86.75 in chips) 
Seat 6: ivan100886 ($33.96 in chips) 
Seat 7: desmo465 ($43.90 in chips) 
Seat 8: TheMinion ($50 in chips) 
Seat 9: funXmun ($50 in chips) 
Bailey Dew: posts small blind $0.25
ivan100886: posts big blind $0.50
zapata 7777: posts the ante $0.10
joker180785: posts the ante $0.10
Franky77200: posts the ante $0.10
matiko09: posts the ante $0.10
Bailey Dew: posts the ante $0.10
ivan100886: posts the ante $0.10
desmo465: posts the ante $0.10
TheMinion: posts the ante $0.10
funXmun: posts the ante $0.10
*** HOLE CARDS ***
Dealt to matiko09 [Kd 2c]
desmo465: raises $1 to $1.50
TheMinion: folds 
funXmun: folds 
zapata 7777: folds 
joker180785: folds 
Franky77200: raises $1.50 to $3
matiko09: folds 
Bailey Dew: folds 
ivan100886: folds 
desmo465: calls $1.50
*** FLOP *** [7h 6d 5s]
desmo465: checks 
Franky77200: checks 
*** TURN *** [7h 6d 5s] [Qc]
desmo465: checks 
Franky77200: bets $5.50
desmo465: calls $5.50
*** RIVER *** [7h 6d 5s Qc] [2s]
desmo465: bets $13
Franky77200: calls $13
*** SHOW DOWN ***
desmo465: shows [Ah Jh] (high card Ace)
Franky77200: mucks hand 
desmo465 collected $42.65 from pot
*** SUMMARY ***
Total pot $44.65 | Rake $2 
Board [7h 6d 5s Qc 2s]
Seat 1: zapata 7777 folded before Flop (didn't bet)
Seat 2: joker180785 folded before Flop (didn't bet)
Seat 3: Franky77200 mucked [Ac 8d]
Seat 4: matiko09 (button) folded before Flop (didn't bet)
Seat 5: Bailey Dew (small blind) folded before Flop
Seat 6: ivan100886 (big blind) folded before Flop
Seat 7: desmo465 showed [Ah Jh] and won ($42.65) with high card Ace
Seat 8: TheMinion folded before Flop (didn't bet)
Seat 9: funXmun folded before Flop (didn't bet)





PokerStars Hand #155380233336:  Hold'em No Limit ($0.50/$1.00 USD) - 2016/06/30 13:57:43 CET [2016/06/30 7:57:43 ET]
Table 'Tatjana' 9-max Seat #9 is the button
Seat 2: DIMAN_324 ($100.50 in chips) 
Seat 3: Rafaello18 ($130.79 in chips) 
Seat 4: mopatron25 ($96.91 in chips) 
Seat 5: matiko09 ($100 in chips) 
Seat 6: mbk88 ($136.10 in chips) 
Seat 7: daigodisco ($38.13 in chips) 
Seat 9: POTAPENKO700 ($138.21 in chips) 
tipner will be allowed to play after the button
DIMAN_324: posts small blind $0.50
Rafaello18: posts big blind $1
daigodisco: posts small & big blinds $1.50
*** HOLE CARDS ***
Dealt to matiko09 [3s 7c]
mopatron25: calls $1
matiko09: folds 
mbk88: folds 
daigodisco: checks 
POTAPENKO700: raises $5 to $6
DIMAN_324: raises $10.50 to $16.50
Rafaello18: folds 
mopatron25: folds 
daigodisco: folds 
POTAPENKO700: raises $121.71 to $138.21 and is all-in
DIMAN_324: calls $84 and is all-in
Uncalled bet ($37.71) returned to POTAPENKO700
*** FIRST FLOP *** [3h Jd Ts]
*** FIRST TURN *** [3h Jd Ts] [7s]
*** FIRST RIVER *** [3h Jd Ts 7s] [8h]
*** SECOND FLOP *** [4s Ad Ks]
*** SECOND TURN *** [4s Ad Ks] [6d]
*** SECOND RIVER *** [4s Ad Ks 6d] [2h]
*** FIRST SHOW DOWN ***
DIMAN_324: shows [Qh Qs] (a pair of Queens)
POTAPENKO700: shows [Ac As] (a pair of Aces)
POTAPENKO700 collected $101 from pot
*** SECOND SHOW DOWN ***
DIMAN_324: shows [Qh Qs] (a pair of Queens)
POTAPENKO700: shows [Ac As] (three of a kind, Aces)
POTAPENKO700 collected $101 from pot
*** SUMMARY ***
Total pot $204.50 | Rake $2.50 
Hand was run twice
FIRST Board [3h Jd Ts 7s 8h]
SECOND Board [4s Ad Ks 6d 2h]
Seat 2: DIMAN_324 (small blind) showed [Qh Qs] and lost with a pair of Queens, and lost with a pair of Queens
Seat 3: Rafaello18 (big blind) folded before Flop
Seat 4: mopatron25 folded before Flop
Seat 5: matiko09 folded before Flop (didn't bet)
Seat 6: mbk88 folded before Flop (didn't bet)
Seat 7: daigodisco folded before Flop
Seat 9: POTAPENKO700 (button) showed [Ac As] and won ($101) with a pair of Aces, and won ($101) with three of a kind, Aces





PokerStars Hand #155380233888:  Hold'em No Limit ($0.25/$0.50 USD) - 2016/06/30 13:57:44 CET [2016/06/30 7:57:44 ET]
Table 'Mentha II' 9-max Seat #7 is the button
Seat 2: TheMinion ($58.86 in chips) 
Seat 3: joker180785 ($52.50 in chips) 
Seat 4: 55peter1 ($75.84 in chips) 
Seat 6: Alexey_Kim2 ($50 in chips) 
Seat 7: ardo888 ($146 in chips) 
Seat 8: Clifftastic ($39.40 in chips) 
Seat 9: matiko09 ($102.20 in chips) 
Clifftastic: posts small blind $0.25
matiko09: posts big blind $0.50
kotkas1000: sits out 
TheMinion: posts the ante $0.10
joker180785: posts the ante $0.10
55peter1: posts the ante $0.10
Alexey_Kim2: posts the ante $0.10
ardo888: posts the ante $0.10
Clifftastic: posts the ante $0.10
matiko09: posts the ante $0.10
*** HOLE CARDS ***
Dealt to matiko09 [8d 4d]
TheMinion: folds 
joker180785: folds 
55peter1: folds 
Alexey_Kim2: folds 
ardo888: raises $0.75 to $1.25
Clifftastic: folds 
matiko09: folds 
Uncalled bet ($0.75) returned to ardo888
ardo888 collected $1.95 from pot
ardo888: doesn't show hand 
*** SUMMARY ***
Total pot $1.95 | Rake $0 
Seat 2: TheMinion folded before Flop (didn't bet)
Seat 3: joker180785 folded before Flop (didn't bet)
Seat 4: 55peter1 folded before Flop (didn't bet)
Seat 6: Alexey_Kim2 folded before Flop (didn't bet)
Seat 7: ardo888 (button) collected ($1.95)
Seat 8: Clifftastic (small blind) folded before Flop
Seat 9: matiko09 (big blind) folded before Flop





PokerStars Hand #155380234300:  Hold'em No Limit ($0.50/$1.00 USD) - 2016/06/30 13:57:45 CET [2016/06/30 7:57:45 ET]
Table 'California II' 9-max Seat #1 is the button
Seat 1: Rafaello18 ($111.02 in chips) 
Seat 2: velourleder ($109.12 in chips) 
Seat 3: KovIFish89 ($100 in chips) 
Seat 4: mbk88 ($179.20 in chips) 
Seat 6: matiko09 ($109.20 in chips) 
Seat 7: DomiVY ($84.20 in chips) 
Seat 8: picka4u ($51.68 in chips) 
Seat 9: di0d80 ($104.66 in chips) 
velourleder: posts small blind $0.50
KovIFish89: posts big blind $1
*** HOLE CARDS ***
Dealt to matiko09 [Qd 3d]
mbk88: folds 
matiko09: folds 
DomiVY: folds 
picka4u: folds 
di0d80: folds 
Rafaello18: raises $1.50 to $2.50
velourleder: folds 
KovIFish89: folds 
Uncalled bet ($1.50) returned to Rafaello18
Rafaello18 collected $2.50 from pot
Rafaello18: doesn't show hand 
*** SUMMARY ***
Total pot $2.50 | Rake $0 
Seat 1: Rafaello18 (button) collected ($2.50)
Seat 2: velourleder (small blind) folded before Flop
Seat 3: KovIFish89 (big blind) folded before Flop
Seat 4: mbk88 folded before Flop (didn't bet)
Seat 6: matiko09 folded before Flop (didn't bet)
Seat 7: DomiVY folded before Flop (didn't bet)
Seat 8: picka4u folded before Flop (didn't bet)
Seat 9: di0d80 folded before Flop (didn't bet)





PokerStars Hand #155380234166:  Hold'em No Limit ($0.50/$1.00 USD) - 2016/06/30 13:57:45 CET [2016/06/30 7:57:45 ET]
Table 'Altarf II' 9-max Seat #9 is the button
Seat 1: Rafaello18 ($100 in chips) 
Seat 2: KovIFish89 ($100 in chips) 
Seat 3: sanr23 ($140.55 in chips) 
Seat 4: Greha999 ($75.16 in chips) 
Seat 5: DIMAN_324 ($205.74 in chips) 
Seat 6: mbk88 ($100 in chips) 
Seat 7: matiko09 ($107.90 in chips) 
Seat 8: DomiVY ($40 in chips) 
Seat 9: omanibemihum ($130.55 in chips) 
Rafaello18: posts small blind $0.50
KovIFish89: posts big blind $1
*** HOLE CARDS ***
Dealt to matiko09 [6c 4d]
sanr23: folds 
Greha999: folds 
DIMAN_324: folds 
mbk88: folds 
matiko09: folds 
DomiVY: folds 
omanibemihum: raises $3 to $4
Rafaello18: folds 
KovIFish89: folds 
Uncalled bet ($3) returned to omanibemihum
omanibemihum collected $2.50 from pot
omanibemihum: doesn't show hand 
*** SUMMARY ***
Total pot $2.50 | Rake $0 
Seat 1: Rafaello18 (small blind) folded before Flop
Seat 2: KovIFish89 (big blind) folded before Flop
Seat 3: sanr23 folded before Flop (didn't bet)
Seat 4: Greha999 folded before Flop (didn't bet)
Seat 5: DIMAN_324 folded before Flop (didn't bet)
Seat 6: mbk88 folded before Flop (didn't bet)
Seat 7: matiko09 folded before Flop (didn't bet)
Seat 8: DomiVY folded before Flop (didn't bet)
Seat 9: omanibemihum (button) collected ($2.50)





PokerStars Hand #155380234869:  Hold'em No Limit ($0.50/$1.00 USD) - 2016/06/30 13:57:47 CET [2016/06/30 7:57:47 ET]
Table 'Armisticia' 9-max Seat #1 is the button
Seat 1: nickreason17 ($100 in chips) 
Seat 2: di0d80 ($104.28 in chips) 
Seat 3: KovIFish89 ($100 in chips) 
Seat 4: ardo888 ($102.50 in chips) 
Seat 5: SonerWPT ($113.93 in chips) 
Seat 6: matiko09 ($124.80 in chips) 
Seat 8: Rafaello18 ($198.39 in chips) 
di0d80: posts small blind $0.50
KovIFish89: posts big blind $1
DIMAN_324: sits out 
*** HOLE CARDS ***
Dealt to matiko09 [Qs 6d]
ardo888: folds 
SonerWPT: folds 
matiko09: folds 
Rafaello18: folds 
nickreason17: raises $1 to $2
di0d80: folds 
KovIFish89: calls $1
*** FLOP *** [Ac 8h 6s]
KovIFish89: checks 
nickreason17: bets $3.63
KovIFish89: calls $3.63
*** TURN *** [Ac 8h 6s] [Ad]
KovIFish89: checks 
nickreason17: checks 
*** RIVER *** [Ac 8h 6s Ad] [Tc]
KovIFish89: bets $7
nickreason17: raises $15.10 to $22.10
KovIFish89: folds 
Uncalled bet ($15.10) returned to nickreason17
nickreason17 collected $24.47 from pot
*** SUMMARY ***
Total pot $25.76 | Rake $1.29 
Board [Ac 8h 6s Ad Tc]
Seat 1: nickreason17 (button) collected ($24.47)
Seat 2: di0d80 (small blind) folded before Flop
Seat 3: KovIFish89 (big blind) folded on the River
Seat 4: ardo888 folded before Flop (didn't bet)
Seat 5: SonerWPT folded before Flop (didn't bet)
Seat 6: matiko09 folded before Flop (didn't bet)
Seat 8: Rafaello18 folded before Flop (didn't bet)





PokerStars Hand #155380239488:  Hold'em No Limit ($0.25/$0.50 USD) - 2016/06/30 13:57:59 CET [2016/06/30 7:57:59 ET]
Table 'Elektra II' 9-max Seat #5 is the button
Seat 2: TheMinion ($60.82 in chips) 
Seat 4: matiko09 ($54.72 in chips) 
Seat 5: Rafaello18 ($56.49 in chips) 
Seat 6: pfunkolstar ($56.54 in chips) 
Seat 7: MuddyDance ($50.75 in chips) 
Seat 8: sanr23 ($52.54 in chips) 
pfunkolstar: posts small blind $0.25
MuddyDance: posts big blind $0.50
KABAL_ua: sits out 
drlee77: sits out 
mojtabagol: sits out 
*** HOLE CARDS ***
Dealt to matiko09 [3c Ts]
sanr23: folds 
TheMinion: raises $0.75 to $1.25
matiko09: folds 
Rafaello18: folds 
pfunkolstar: folds 
MuddyDance: folds 
Uncalled bet ($0.75) returned to TheMinion
TheMinion collected $1.25 from pot
TheMinion: doesn't show hand 
*** SUMMARY ***
Total pot $1.25 | Rake $0 
Seat 2: TheMinion collected ($1.25)
Seat 4: matiko09 folded before Flop (didn't bet)
Seat 5: Rafaello18 (button) folded before Flop (didn't bet)
Seat 6: pfunkolstar (small blind) folded before Flop
Seat 7: MuddyDance (big blind) folded before Flop
Seat 8: sanr23 folded before Flop (didn't bet)





PokerStars Hand #155380241628:  Hold'em No Limit ($0.50/$1.00 USD) - 2016/06/30 13:58:04 CET [2016/06/30 7:58:04 ET]
Table 'California II' 9-max Seat #2 is the button
Seat 1: Rafaello18 ($112.52 in chips) 
Seat 2: velourleder ($108.62 in chips) 
Seat 3: KovIFish89 ($100 in chips) 
Seat 4: mbk88 ($179.20 in chips) 
Seat 6: matiko09 ($109.20 in chips) 
Seat 7: DomiVY ($84.20 in chips) 
Seat 8: picka4u ($51.68 in chips) 
Seat 9: di0d80 ($104.66 in chips) 
KovIFish89: posts small blind $0.50
mbk88: posts big blind $1
*** HOLE CARDS ***
Dealt to matiko09 [5d 5c]
matiko09: folds 
DomiVY: folds 
picka4u: folds 
di0d80: raises $1.50 to $2.50
Rafaello18: folds 
velourleder: folds 
KovIFish89: folds 
mbk88: calls $1.50
*** FLOP *** [Qd Jc Qs]
mbk88: checks 
di0d80: checks 
*** TURN *** [Qd Jc Qs] [5h]
mbk88: bets $3
di0d80: folds 
Uncalled bet ($3) returned to mbk88
mbk88 collected $5.22 from pot
mbk88: doesn't show hand 
*** SUMMARY ***
Total pot $5.50 | Rake $0.28 
Board [Qd Jc Qs 5h]
Seat 1: Rafaello18 folded before Flop (didn't bet)
Seat 2: velourleder (button) folded before Flop (didn't bet)
Seat 3: KovIFish89 (small blind) folded before Flop
Seat 4: mbk88 (big blind) collected ($5.22)
Seat 6: matiko09 folded before Flop (didn't bet)
Seat 7: DomiVY folded before Flop (didn't bet)
Seat 8: picka4u folded before Flop (didn't bet)
Seat 9: di0d80 folded on the Turn





PokerStars Hand #155380244442:  Hold'em No Limit ($0.50/$1.00 USD) - 2016/06/30 13:58:11 CET [2016/06/30 7:58:11 ET]
Table 'Altarf II' 9-max Seat #1 is the button
Seat 1: Rafaello18 ($100 in chips) 
Seat 2: KovIFish89 ($100 in chips) 
Seat 3: sanr23 ($140.55 in chips) 
Seat 4: Greha999 ($75.16 in chips) 
Seat 5: DIMAN_324 ($205.74 in chips) 
Seat 6: mbk88 ($100 in chips) 
Seat 7: matiko09 ($107.90 in chips) 
Seat 8: DomiVY ($40 in chips) 
Seat 9: omanibemihum ($132.05 in chips) 
KovIFish89: posts small blind $0.50
sanr23: posts big blind $1
*** HOLE CARDS ***
Dealt to matiko09 [Jd 5h]
Greha999: folds 
DIMAN_324: folds 
mbk88: folds 
matiko09: folds 
DomiVY: raises $2 to $3
omanibemihum: calls $3
Rafaello18: folds 
KovIFish89: folds 
sanr23: calls $2
*** FLOP *** [Kh 3c 4d]
sanr23: checks 
DomiVY: bets $6
omanibemihum: folds 
sanr23: calls $6
*** TURN *** [Kh 3c 4d] [8c]
sanr23: checks 
DomiVY: checks 
*** RIVER *** [Kh 3c 4d 8c] [Qs]
sanr23: bets $13.48
DomiVY: calls $13.48
*** SHOW DOWN ***
sanr23: shows [Qh Kd] (two pair, Kings and Queens)
DomiVY: mucks hand 
sanr23 collected $46.04 from pot
*** SUMMARY ***
Total pot $48.46 | Rake $2.42 
Board [Kh 3c 4d 8c Qs]
Seat 1: Rafaello18 (button) folded before Flop (didn't bet)
Seat 2: KovIFish89 (small blind) folded before Flop
Seat 3: sanr23 (big blind) showed [Qh Kd] and won ($46.04) with two pair, Kings and Queens
Seat 4: Greha999 folded before Flop (didn't bet)
Seat 5: DIMAN_324 folded before Flop (didn't bet)
Seat 6: mbk88 folded before Flop (didn't bet)
Seat 7: matiko09 folded before Flop (didn't bet)
Seat 8: DomiVY mucked [Kc As]
Seat 9: omanibemihum folded on the Flop





PokerStars Hand #155380245560:  Hold'em No Limit ($0.25/$0.50 USD) - 2016/06/30 13:58:14 CET [2016/06/30 7:58:14 ET]
Table 'Mentha II' 9-max Seat #8 is the button
Seat 2: TheMinion ($58.76 in chips) 
Seat 3: joker180785 ($52.40 in chips) 
Seat 4: 55peter1 ($75.74 in chips) 
Seat 6: Alexey_Kim2 ($50 in chips) 
Seat 7: ardo888 ($147.35 in chips) 
Seat 8: Clifftastic ($39.05 in chips) 
Seat 9: matiko09 ($101.60 in chips) 
matiko09: posts small blind $0.25
TheMinion: posts big blind $0.50
kotkas1000: sits out 
TheMinion: posts the ante $0.10
joker180785: posts the ante $0.10
55peter1: posts the ante $0.10
Alexey_Kim2: posts the ante $0.10
ardo888: posts the ante $0.10
Clifftastic: posts the ante $0.10
matiko09: posts the ante $0.10
*** HOLE CARDS ***
Dealt to matiko09 [3c 6s]
joker180785: folds 
55peter1: calls $0.50
Alexey_Kim2: folds 
ardo888: folds 
Clifftastic: raises $1 to $1.50
matiko09: folds 
TheMinion: folds 
55peter1: calls $1
*** FLOP *** [3h 4d 3s]
55peter1: checks 
Clifftastic: bets $2
fudzi joins the table at seat #1 
55peter1: folds 
Uncalled bet ($2) returned to Clifftastic
Clifftastic collected $4.23 from pot
Clifftastic: doesn't show hand 
*** SUMMARY ***
Total pot $4.45 | Rake $0.22 
Board [3h 4d 3s]
Seat 2: TheMinion (big blind) folded before Flop
Seat 3: joker180785 folded before Flop (didn't bet)
Seat 4: 55peter1 folded on the Flop
Seat 6: Alexey_Kim2 folded before Flop (didn't bet)
Seat 7: ardo888 folded before Flop (didn't bet)
Seat 8: Clifftastic (button) collected ($4.23)
Seat 9: matiko09 (small blind) folded before Flop





PokerStars Hand #155380246337:  Hold'em No Limit ($0.50/$1.00 USD) - 2016/06/30 13:58:16 CET [2016/06/30 7:58:16 ET]
Table 'Prieska' 9-max Seat #2 is the button
Seat 1: KovIFish89 ($118.59 in chips) 
Seat 2: B_style_cuz ($103.43 in chips) 
Seat 3: Rafaello18 ($124 in chips) 
Seat 4: nickreason17 ($106.68 in chips) 
Seat 5: ramzes160468 ($62.52 in chips) 
Seat 6: DIMAN_324 ($101 in chips) 
Seat 7: matiko09 ($107.52 in chips) 
Seat 8: mbk88 ($122.95 in chips) 
Seat 9: Konig26 ($94.26 in chips) 
Rafaello18: posts small blind $0.50
nickreason17: posts big blind $1
*** HOLE CARDS ***
Dealt to matiko09 [Qh Jd]
ramzes160468: folds 
DIMAN_324: raises $2 to $3
matiko09: folds 
mbk88: folds 
Konig26: calls $3
KovIFish89: folds 
B_style_cuz: folds 
Rafaello18: folds 
nickreason17: folds 
*** FLOP *** [Qc Th 2s]
DIMAN_324: bets $5.34
Konig26: folds 
Uncalled bet ($5.34) returned to DIMAN_324
DIMAN_324 collected $7.12 from pot
DIMAN_324: doesn't show hand 
*** SUMMARY ***
Total pot $7.50 | Rake $0.38 
Board [Qc Th 2s]
Seat 1: KovIFish89 folded before Flop (didn't bet)
Seat 2: B_style_cuz (button) folded before Flop (didn't bet)
Seat 3: Rafaello18 (small blind) folded before Flop
Seat 4: nickreason17 (big blind) folded before Flop
Seat 5: ramzes160468 folded before Flop (didn't bet)
Seat 6: DIMAN_324 collected ($7.12)
Seat 7: matiko09 folded before Flop (didn't bet)
Seat 8: mbk88 folded before Flop (didn't bet)
Seat 9: Konig26 folded on the Flop





PokerStars Hand #155380251282:  Hold'em No Limit ($0.50/$1.00 USD) - 2016/06/30 13:58:29 CET [2016/06/30 7:58:29 ET]
Table 'Borrelly II' 9-max Seat #4 is the button
Seat 1: Rafaello18 ($117.39 in chips) 
Seat 3: di0d80 ($109.52 in chips) 
Seat 4: DonRon_AT ($38.49 in chips) 
Seat 5: DIMAN_324 ($100 in chips) 
Seat 6: m_michalec ($173.56 in chips) 
Seat 7: matiko09 ($176.36 in chips) 
Seat 8: Arjun A Raju ($96.24 in chips) 
DIMAN_324: posts small blind $0.50
m_michalec: posts big blind $1
alhill86: sits out 
*** HOLE CARDS ***
Dealt to matiko09 [7s Jc]
matiko09: folds 
Arjun A Raju: raises $2 to $3
Rafaello18: folds 
di0d80: folds 
DonRon_AT: folds 
DIMAN_324: raises $7.50 to $10.50
m_michalec: folds 
Arjun A Raju: calls $7.50
*** FLOP *** [Ad 7d 6c]
DIMAN_324: checks 
Arjun A Raju: bets $20.90
DIMAN_324: calls $20.90
*** TURN *** [Ad 7d 6c] [Td]
DIMAN_324: checks 
Arjun A Raju: bets $61.30
DIMAN_324: folds 
Uncalled bet ($61.30) returned to Arjun A Raju
Arjun A Raju collected $61.30 from pot
Arjun A Raju: doesn't show hand 
*** SUMMARY ***
Total pot $63.80 | Rake $2.50 
Board [Ad 7d 6c Td]
Seat 1: Rafaello18 folded before Flop (didn't bet)
Seat 3: di0d80 folded before Flop (didn't bet)
Seat 4: DonRon_AT (button) folded before Flop (didn't bet)
Seat 5: DIMAN_324 (small blind) folded on the Turn
Seat 6: m_michalec (big blind) folded before Flop
Seat 7: matiko09 folded before Flop (didn't bet)
Seat 8: Arjun A Raju collected ($61.30)





PokerStars Hand #155380254165:  Hold'em No Limit ($0.25/$0.50 USD) - 2016/06/30 13:58:37 CET [2016/06/30 7:58:37 ET]
Table 'Elektra II' 9-max Seat #6 is the button
Seat 2: TheMinion ($61.57 in chips) 
Seat 4: matiko09 ($54.72 in chips) 
Seat 5: Rafaello18 ($56.49 in chips) 
Seat 6: pfunkolstar ($56.29 in chips) 
Seat 7: MuddyDance ($50.25 in chips) 
Seat 8: sanr23 ($52.54 in chips) 
MuddyDance: posts small blind $0.25
sanr23: posts big blind $0.50
KABAL_ua: sits out 
drlee77: sits out 
mojtabagol: sits out 
*** HOLE CARDS ***
Dealt to matiko09 [6d 6h]
TheMinion: folds 
matiko09: raises $1 to $1.50
Rafaello18: folds 
pfunkolstar: folds 
MuddyDance: raises $4 to $5.50
sanr23: raises $5.50 to $11
matiko09: folds 
MuddyDance: folds 
Uncalled bet ($5.50) returned to sanr23
sanr23 collected $12.50 from pot
sanr23: doesn't show hand 
*** SUMMARY ***
Total pot $12.50 | Rake $0 
Seat 2: TheMinion folded before Flop (didn't bet)
Seat 4: matiko09 folded before Flop
Seat 5: Rafaello18 folded before Flop (didn't bet)
Seat 6: pfunkolstar (button) folded before Flop (didn't bet)
Seat 7: MuddyDance (small blind) folded before Flop
Seat 8: sanr23 (big blind) collected ($12.50)





PokerStars Hand #155380258216:  Hold'em No Limit ($0.25/$0.50 USD) - 2016/06/30 13:58:47 CET [2016/06/30 7:58:47 ET]
Table 'Mentha II' 9-max Seat #9 is the button
Seat 2: TheMinion ($58.16 in chips) 
Seat 3: joker180785 ($52.30 in chips) 
Seat 4: 55peter1 ($74.14 in chips) 
Seat 6: Alexey_Kim2 ($50 in chips) 
Seat 7: ardo888 ($147.25 in chips) 
Seat 8: Clifftastic ($41.68 in chips) 
Seat 9: matiko09 ($101.25 in chips) 
fudzi will be allowed to play after the button
TheMinion: posts small blind $0.25
joker180785: posts big blind $0.50
kotkas1000: sits out 
TheMinion: posts the ante $0.10
joker180785: posts the ante $0.10
55peter1: posts the ante $0.10
Alexey_Kim2: posts the ante $0.10
ardo888: posts the ante $0.10
Clifftastic: posts the ante $0.10
matiko09: posts the ante $0.10
*** HOLE CARDS ***
Dealt to matiko09 [9d 8d]
55peter1: folds 
Alexey_Kim2: folds 
ardo888: folds 
Clifftastic: folds 
matiko09: raises $0.63 to $1.13
TheMinion: folds 
joker180785: folds 
Uncalled bet ($0.63) returned to matiko09
matiko09 collected $1.95 from pot
matiko09: doesn't show hand 
*** SUMMARY ***
Total pot $1.95 | Rake $0 
Seat 2: TheMinion (small blind) folded before Flop
Seat 3: joker180785 (big blind) folded before Flop
Seat 4: 55peter1 folded before Flop (didn't bet)
Seat 6: Alexey_Kim2 folded before Flop (didn't bet)
Seat 7: ardo888 folded before Flop (didn't bet)
Seat 8: Clifftastic folded before Flop (didn't bet)
Seat 9: matiko09 (button) collected ($1.95)





PokerStars Hand #155380259605:  Hold'em No Limit ($0.50/$1.00 USD) - 2016/06/30 13:58:51 CET [2016/06/30 7:58:51 ET]
Table 'Tatjana' 9-max Seat #2 is the button
Seat 2: DIMAN_324 ($100 in chips) 
Seat 3: Rafaello18 ($129.79 in chips) 
Seat 4: mopatron25 ($95.91 in chips) 
Seat 5: matiko09 ($100 in chips) 
Seat 6: mbk88 ($136.10 in chips) 
Seat 7: daigodisco ($36.63 in chips) 
Seat 9: POTAPENKO700 ($239.71 in chips) 
Rafaello18: posts small blind $0.50
mopatron25: posts big blind $1
alhill86: sits out 
tipner: sits out 
*** HOLE CARDS ***
Dealt to matiko09 [Td Th]
matiko09: raises $2 to $3
mbk88: calls $3
daigodisco: folds 
POTAPENKO700: folds 
DIMAN_324: folds 
Rafaello18: folds 
mopatron25: calls $2
*** FLOP *** [7c 4d 6d]
mopatron25: checks 
matiko09: bets $6
mbk88: calls $6
mopatron25: folds 
*** TURN *** [7c 4d 6d] [5s]
matiko09: checks 
mbk88: checks 
*** RIVER *** [7c 4d 6d 5s] [Kc]
matiko09: checks 
mbk88: bets $13
matiko09: folds 
Uncalled bet ($13) returned to mbk88
mbk88 collected $20.42 from pot
mbk88: doesn't show hand 
*** SUMMARY ***
Total pot $21.50 | Rake $1.08 
Board [7c 4d 6d 5s Kc]
Seat 2: DIMAN_324 (button) folded before Flop (didn't bet)
Seat 3: Rafaello18 (small blind) folded before Flop
Seat 4: mopatron25 (big blind) folded on the Flop
Seat 5: matiko09 folded on the River
Seat 6: mbk88 collected ($20.42)
Seat 7: daigodisco folded before Flop (didn't bet)
Seat 9: POTAPENKO700 folded before Flop (didn't bet)





PokerStars Hand #155380266756:  Hold'em No Limit ($0.50/$1.00 USD) - 2016/06/30 13:59:09 CET [2016/06/30 7:59:09 ET]
Table 'Prieska' 9-max Seat #3 is the button
Seat 1: KovIFish89 ($118.59 in chips) 
Seat 2: B_style_cuz ($103.43 in chips) 
Seat 3: Rafaello18 ($123.50 in chips) 
Seat 4: nickreason17 ($105.68 in chips) 
Seat 5: ramzes160468 ($62.52 in chips) 
Seat 6: DIMAN_324 ($105.12 in chips) 
Seat 7: matiko09 ($107.52 in chips) 
Seat 8: mbk88 ($122.95 in chips) 
Seat 9: Konig26 ($91.26 in chips) 
nickreason17: posts small blind $0.50
ramzes160468: posts big blind $1
*** HOLE CARDS ***
Dealt to matiko09 [4h Jh]
DIMAN_324: folds 
matiko09: folds 
DIMAN_324 leaves the table
Ty Nick 420 joins the table at seat #6 
mbk88: folds 
Konig26: folds 
KovIFish89: raises $2 to $3
B_style_cuz: folds 
Rafaello18: folds 
nickreason17: folds 
ramzes160468: folds 
Uncalled bet ($2) returned to KovIFish89
KovIFish89 collected $2.50 from pot
KovIFish89: doesn't show hand 
*** SUMMARY ***
Total pot $2.50 | Rake $0 
Seat 1: KovIFish89 collected ($2.50)
Seat 2: B_style_cuz folded before Flop (didn't bet)
Seat 3: Rafaello18 (button) folded before Flop (didn't bet)
Seat 4: nickreason17 (small blind) folded before Flop
Seat 5: ramzes160468 (big blind) folded before Flop
Seat 6: DIMAN_324 folded before Flop (didn't bet)
Seat 7: matiko09 folded before Flop (didn't bet)
Seat 8: mbk88 folded before Flop (didn't bet)
Seat 9: Konig26 folded before Flop (didn't bet)





PokerStars Hand #155380267281:  Hold'em No Limit ($0.25/$0.50 USD) - 2016/06/30 13:59:10 CET [2016/06/30 7:59:10 ET]
Table 'Mentha II' 9-max Seat #2 is the button
Seat 2: TheMinion ($57.81 in chips) 
Seat 3: joker180785 ($51.70 in chips) 
Seat 4: 55peter1 ($74.04 in chips) 
Seat 6: Alexey_Kim2 ($50 in chips) 
Seat 7: ardo888 ($147.15 in chips) 
Seat 8: Clifftastic ($41.58 in chips) 
Seat 9: matiko09 ($102.60 in chips) 
joker180785: posts small blind $0.25
55peter1: posts big blind $0.50
kotkas1000: sits out 
fudzi: sits out 
TheMinion: posts the ante $0.10
joker180785: posts the ante $0.10
55peter1: posts the ante $0.10
Alexey_Kim2: posts the ante $0.10
ardo888: posts the ante $0.10
Clifftastic: posts the ante $0.10
matiko09: posts the ante $0.10
*** HOLE CARDS ***
Dealt to matiko09 [Kc 9h]
Alexey_Kim2: folds 
ardo888: folds 
Clifftastic: folds 
matiko09: folds 
TheMinion: raises $0.52 to $1.02
joker180785: calls $0.77
55peter1: calls $0.52
*** FLOP *** [Qd Ah 5h]
joker180785: checks 
55peter1: checks 
TheMinion: checks 
*** TURN *** [Qd Ah 5h] [2d]
joker180785: checks 
55peter1: bets $2.50
TheMinion: folds 
joker180785: folds 
Uncalled bet ($2.50) returned to 55peter1
55peter1 collected $3.57 from pot
55peter1: doesn't show hand 
*** SUMMARY ***
Total pot $3.76 | Rake $0.19 
Board [Qd Ah 5h 2d]
Seat 2: TheMinion (button) folded on the Turn
Seat 3: joker180785 (small blind) folded on the Turn
Seat 4: 55peter1 (big blind) collected ($3.57)
Seat 6: Alexey_Kim2 folded before Flop (didn't bet)
Seat 7: ardo888 folded before Flop (didn't bet)
Seat 8: Clifftastic folded before Flop (didn't bet)
Seat 9: matiko09 folded before Flop (didn't bet)





PokerStars Hand #155380267188:  Hold'em No Limit ($0.50/$1.00 USD) - 2016/06/30 13:59:10 CET [2016/06/30 7:59:10 ET]
Table 'California II' 9-max Seat #3 is the button
Seat 1: Rafaello18 ($112.52 in chips) 
Seat 2: velourleder ($108.62 in chips) 
Seat 3: KovIFish89 ($100 in chips) 
Seat 4: mbk88 ($181.92 in chips) 
Seat 5: Rohitbarve ($101.24 in chips) 
Seat 6: matiko09 ($109.20 in chips) 
Seat 7: DomiVY ($84.20 in chips) 
Seat 8: picka4u ($51.68 in chips) 
Seat 9: di0d80 ($102.16 in chips) 
mbk88: posts small blind $0.50
Rohitbarve: posts big blind $1
*** HOLE CARDS ***
Dealt to matiko09 [3c 7d]
matiko09: folds 
DomiVY: folds 
picka4u: raises $1.50 to $2.50
di0d80: folds 
Rafaello18: calls $2.50
velourleder: calls $2.50
KovIFish89: folds 
mbk88: folds 
Rohitbarve: calls $1.50
*** FLOP *** [6h 4c Ah]
Rohitbarve: checks 
picka4u: bets $6
Rafaello18: folds 
velourleder: calls $6
Rohitbarve: folds 
*** TURN *** [6h 4c Ah] [2d]
picka4u: checks 
velourleder: bets $18
picka4u: raises $25.18 to $43.18 and is all-in
velourleder: calls $25.18
*** FIRST RIVER *** [6h 4c Ah 2d] [Jd]
*** SECOND RIVER *** [6h 4c Ah 2d] [9h]
*** FIRST SHOW DOWN ***
picka4u: shows [Ad Ac] (three of a kind, Aces)
velourleder: shows [Qc As] (a pair of Aces)
picka4u collected $53.18 from pot
*** SECOND SHOW DOWN ***
picka4u: shows [Ad Ac] (three of a kind, Aces)
velourleder: shows [Qc As] (a pair of Aces)
picka4u collected $53.18 from pot
*** SUMMARY ***
Total pot $108.86 | Rake $2.50 
Hand was run twice
FIRST Board [6h 4c Ah 2d Jd]
SECOND Board [6h 4c Ah 2d 9h]
Seat 1: Rafaello18 folded on the Flop
Seat 2: velourleder showed [Qc As] and lost with a pair of Aces, and lost with a pair of Aces
Seat 3: KovIFish89 (button) folded before Flop (didn't bet)
Seat 4: mbk88 (small blind) folded before Flop
Seat 5: Rohitbarve (big blind) folded on the Flop
Seat 6: matiko09 folded before Flop (didn't bet)
Seat 7: DomiVY folded before Flop (didn't bet)
Seat 8: picka4u showed [Ad Ac] and won ($53.18) with three of a kind, Aces, and won ($53.18) with three of a kind, Aces
Seat 9: di0d80 folded before Flop (didn't bet)





PokerStars Hand #155380267642:  Hold'em No Limit ($0.50/$1.00 USD) - 2016/06/30 13:59:11 CET [2016/06/30 7:59:11 ET]
Table 'Armisticia' 9-max Seat #2 is the button
Seat 1: nickreason17 ($111.84 in chips) 
Seat 2: di0d80 ($103.78 in chips) 
Seat 3: KovIFish89 ($100 in chips) 
Seat 5: SonerWPT ($113.93 in chips) 
Seat 6: matiko09 ($124.80 in chips) 
Seat 8: Rafaello18 ($198.39 in chips) 
KovIFish89: posts small blind $0.50
ardo888: is sitting out 
SonerWPT: posts big blind $1
ardo888 leaves the table
DIMAN_324: sits out 
*** HOLE CARDS ***
Dealt to matiko09 [Kc 9d]
matiko09: folds 
Rafaello18: folds 
nickreason17: folds 
matiko09 leaves the table
di0d80: folds 
kaanzai joins the table at seat #4 
KovIFish89: raises $2 to $3
SonerWPT: raises $110.93 to $113.93 and is all-in
KovIFish89: folds 
Uncalled bet ($110.93) returned to SonerWPT
SonerWPT collected $6 from pot
SonerWPT: doesn't show hand 
*** SUMMARY ***
Total pot $6 | Rake $0 
Seat 1: nickreason17 folded before Flop (didn't bet)
Seat 2: di0d80 (button) folded before Flop (didn't bet)
Seat 3: KovIFish89 (small blind) folded before Flop
Seat 5: SonerWPT (big blind) collected ($6)
Seat 6: matiko09 folded before Flop (didn't bet)
Seat 8: Rafaello18 folded before Flop (didn't bet)





PokerStars Hand #155380275826:  Hold'em No Limit ($0.25/$0.50 USD) - 2016/06/30 13:59:32 CET [2016/06/30 7:59:32 ET]
Table 'Dorothea II' 9-max Seat #5 is the button
Seat 1: zapata 7777 ($82.16 in chips) 
Seat 2: joker180785 ($50 in chips) 
Seat 3: Franky77200 ($28.85 in chips) 
Seat 4: matiko09 ($136.70 in chips) 
Seat 5: Bailey Dew ($86.40 in chips) 
Seat 6: ivan100886 ($33.36 in chips) 
Seat 7: desmo465 ($64.95 in chips) 
Seat 8: TheMinion ($50 in chips) 
Seat 9: funXmun ($50 in chips) 
ivan100886: posts small blind $0.25
desmo465: posts big blind $0.50
zapata 7777: posts the ante $0.10
joker180785: posts the ante $0.10
Franky77200: posts the ante $0.10
matiko09: posts the ante $0.10
Bailey Dew: posts the ante $0.10
ivan100886: posts the ante $0.10
desmo465: posts the ante $0.10
TheMinion: posts the ante $0.10
funXmun: posts the ante $0.10
*** HOLE CARDS ***
Dealt to matiko09 [9h Kc]
TheMinion: folds 
funXmun: raises $0.63 to $1.13
zapata 7777: folds 
joker180785: folds 
Franky77200: calls $1.13
matiko09: folds 
Bailey Dew: folds 
ivan100886: raises $3.87 to $5
desmo465: folds 
funXmun: folds 
Franky77200: calls $3.87
*** FLOP *** [3s Qh 7h]
ivan100886: bets $7.50
Franky77200: folds 
Uncalled bet ($7.50) returned to ivan100886
ivan100886 collected $11.90 from pot
*** SUMMARY ***
Total pot $12.53 | Rake $0.63 
Board [3s Qh 7h]
Seat 1: zapata 7777 folded before Flop (didn't bet)
Seat 2: joker180785 folded before Flop (didn't bet)
Seat 3: Franky77200 folded on the Flop
Seat 4: matiko09 folded before Flop (didn't bet)
Seat 5: Bailey Dew (button) folded before Flop (didn't bet)
Seat 6: ivan100886 (small blind) collected ($11.90)
Seat 7: desmo465 (big blind) folded before Flop
Seat 8: TheMinion folded before Flop (didn't bet)
Seat 9: funXmun folded before Flop





PokerStars Hand #155380278716:  Hold'em No Limit ($0.50/$1.00 USD) - 2016/06/30 13:59:39 CET [2016/06/30 7:59:39 ET]
Table 'Borrelly II' 9-max Seat #5 is the button
Seat 1: Rafaello18 ($117.39 in chips) 
Seat 3: di0d80 ($109.52 in chips) 
Seat 4: DonRon_AT ($38.49 in chips) 
Seat 5: DIMAN_324 ($100 in chips) 
Seat 6: m_michalec ($172.56 in chips) 
Seat 7: matiko09 ($176.36 in chips) 
Seat 8: Arjun A Raju ($126.14 in chips) 
m_michalec: posts small blind $0.50
matiko09: posts big blind $1
alhill86: sits out 
mbk88: sits out 
*** HOLE CARDS ***
Dealt to matiko09 [Qd 8s]
Arjun A Raju: folds 
Rafaello18: raises $1.50 to $2.50
di0d80: folds 
DonRon_AT: folds 
DIMAN_324: calls $2.50
m_michalec: folds 
matiko09: folds 
*** FLOP *** [Th 8h 7h]
Rafaello18: bets $4
DIMAN_324: folds 
Uncalled bet ($4) returned to Rafaello18
Rafaello18 collected $6.18 from pot
Rafaello18: doesn't show hand 
*** SUMMARY ***
Total pot $6.50 | Rake $0.32 
Board [Th 8h 7h]
Seat 1: Rafaello18 collected ($6.18)
Seat 3: di0d80 folded before Flop (didn't bet)
Seat 4: DonRon_AT folded before Flop (didn't bet)
Seat 5: DIMAN_324 (button) folded on the Flop
Seat 6: m_michalec (small blind) folded before Flop
Seat 7: matiko09 (big blind) folded before Flop
Seat 8: Arjun A Raju folded before Flop (didn't bet)





PokerStars Hand #155380283157:  Hold'em No Limit ($0.50/$1.00 USD) - 2016/06/30 13:59:51 CET [2016/06/30 7:59:51 ET]
Table 'Prieska' 9-max Seat #4 is the button
Seat 1: KovIFish89 ($120.09 in chips) 
Seat 2: B_style_cuz ($103.43 in chips) 
Seat 3: Rafaello18 ($123.50 in chips) 
Seat 4: nickreason17 ($105.18 in chips) 
Seat 5: ramzes160468 ($61.52 in chips) 
Seat 6: Ty Nick 420 ($100 in chips) 
Seat 7: matiko09 ($107.52 in chips) 
Seat 8: mbk88 ($122.95 in chips) 
Seat 9: Konig26 ($91.26 in chips) 
ramzes160468: posts small blind $0.50
Ty Nick 420: posts big blind $1
*** HOLE CARDS ***
Dealt to matiko09 [Th 3d]
matiko09: folds 
mbk88: folds 
Konig26: folds 
KovIFish89: folds 
B_style_cuz: folds 
Rafaello18: folds 
nickreason17: folds 
ramzes160468: folds 
Uncalled bet ($0.50) returned to Ty Nick 420
Ty Nick 420 collected $1 from pot
*** SUMMARY ***
Total pot $1 | Rake $0 
Seat 1: KovIFish89 folded before Flop (didn't bet)
Seat 2: B_style_cuz folded before Flop (didn't bet)
Seat 3: Rafaello18 folded before Flop (didn't bet)
Seat 4: nickreason17 (button) folded before Flop (didn't bet)
Seat 5: ramzes160468 (small blind) folded before Flop
Seat 6: Ty Nick 420 (big blind) collected ($1)
Seat 7: matiko09 folded before Flop (didn't bet)
Seat 8: mbk88 folded before Flop (didn't bet)
Seat 9: Konig26 folded before Flop (didn't bet)





PokerStars Hand #155380285972:  Hold'em No Limit ($0.25/$0.50 USD) - 2016/06/30 13:59:58 CET [2016/06/30 7:59:58 ET]
Table 'Elektra II' 9-max Seat #7 is the button
Seat 2: TheMinion ($61.57 in chips) 
Seat 3: mojtabagol ($74.07 in chips) 
Seat 4: matiko09 ($53.22 in chips) 
Seat 5: Rafaello18 ($56.49 in chips) 
Seat 6: pfunkolstar ($56.29 in chips) 
Seat 7: MuddyDance ($50 in chips) 
Seat 8: sanr23 ($59.54 in chips) 
Seat 9: KABAL_ua ($50 in chips) 
sanr23: posts small blind $0.25
KABAL_ua: posts big blind $0.50
drlee77: sits out 
mojtabagol: posts small & big blinds $0.75
*** HOLE CARDS ***
Dealt to matiko09 [2s 2c]
TheMinion: folds 
mojtabagol: checks 
matiko09: raises $1 to $1.50
Rafaello18: folds 
pfunkolstar: calls $1.50
MuddyDance: folds 
sanr23: folds 
KABAL_ua: folds 
mojtabagol: calls $1
*** FLOP *** [Jh 4s Js]
mojtabagol: checks 
matiko09: checks 
pfunkolstar: checks 
*** TURN *** [Jh 4s Js] [6h]
mojtabagol: bets $5.22
matiko09: folds 
pfunkolstar: calls $5.22
*** RIVER *** [Jh 4s Js 6h] [Kc]
mojtabagol: bets $7.57
pfunkolstar: folds 
Uncalled bet ($7.57) returned to mojtabagol
mojtabagol collected $15.14 from pot
*** SUMMARY ***
Total pot $15.94 | Rake $0.80 
Board [Jh 4s Js 6h Kc]
Seat 2: TheMinion folded before Flop (didn't bet)
Seat 3: mojtabagol collected ($15.14)
Seat 4: matiko09 folded on the Turn
Seat 5: Rafaello18 folded before Flop (didn't bet)
Seat 6: pfunkolstar folded on the River
Seat 7: MuddyDance (button) folded before Flop (didn't bet)
Seat 8: sanr23 (small blind) folded before Flop
Seat 9: KABAL_ua (big blind) folded before Flop





PokerStars Hand #155380286289:  Hold'em No Limit ($0.50/$1.00 USD) - 2016/06/30 13:59:58 CET [2016/06/30 7:59:58 ET]
Table 'Altarf II' 9-max Seat #2 is the button
Seat 1: Rafaello18 ($100 in chips) 
Seat 2: KovIFish89 ($100 in chips) 
Seat 3: sanr23 ($164.11 in chips) 
Seat 4: Greha999 ($75.16 in chips) 
Seat 5: DIMAN_324 ($205.74 in chips) 
Seat 6: mbk88 ($100 in chips) 
Seat 7: matiko09 ($107.90 in chips) 
Seat 8: DomiVY ($40 in chips) 
Seat 9: omanibemihum ($129.05 in chips) 
sanr23: posts small blind $0.50
Greha999: posts big blind $1
*** HOLE CARDS ***
Dealt to matiko09 [6s Jh]
DIMAN_324: folds 
mbk88: folds 
matiko09: folds 
DomiVY: folds 
omanibemihum: folds 
Rafaello18: folds 
KovIFish89: raises $1 to $2
sanr23: folds 
Greha999: folds 
Uncalled bet ($1) returned to KovIFish89
KovIFish89 collected $2.50 from pot
KovIFish89: doesn't show hand 
*** SUMMARY ***
Total pot $2.50 | Rake $0 
Seat 1: Rafaello18 folded before Flop (didn't bet)
Seat 2: KovIFish89 (button) collected ($2.50)
Seat 3: sanr23 (small blind) folded before Flop
Seat 4: Greha999 (big blind) folded before Flop
Seat 5: DIMAN_324 folded before Flop (didn't bet)
Seat 6: mbk88 folded before Flop (didn't bet)
Seat 7: matiko09 folded before Flop (didn't bet)
Seat 8: DomiVY folded before Flop (didn't bet)
Seat 9: omanibemihum folded before Flop (didn't bet)





PokerStars Hand #155380286987:  Hold'em No Limit ($0.50/$1.00 USD) - 2016/06/30 14:00:00 CET [2016/06/30 8:00:00 ET]
Table 'Asmodeus' 9-max Seat #3 is the button
Seat 1: scollop ($129.37 in chips) 
Seat 2: picka4u ($39.50 in chips) 
Seat 3: matiko09 ($101.75 in chips) 
Seat 5: sanr23 ($109.30 in chips) 
Seat 6: koutani7 ($91 in chips) 
Seat 7: aaronzzr ($144.04 in chips) 
Seat 8: Rafaello18 ($168.85 in chips) 
Seat 9: mbk88 ($158.86 in chips) 
DIMAN_324 will be allowed to play after the button
sanr23: posts small blind $0.50
koutani7: posts big blind $1
*** HOLE CARDS ***
Dealt to matiko09 [4d 8d]
aaronzzr: folds 
Rafaello18: folds 
mbk88: folds 
scollop: folds 
picka4u: folds 
matiko09: folds 
sanr23: raises $1.50 to $2.50
koutani7: folds 
Uncalled bet ($1.50) returned to sanr23
sanr23 collected $2 from pot
sanr23: doesn't show hand 
*** SUMMARY ***
Total pot $2 | Rake $0 
Seat 1: scollop folded before Flop (didn't bet)
Seat 2: picka4u folded before Flop (didn't bet)
Seat 3: matiko09 (button) folded before Flop (didn't bet)
Seat 5: sanr23 (small blind) collected ($2)
Seat 6: koutani7 (big blind) folded before Flop
Seat 7: aaronzzr folded before Flop (didn't bet)
Seat 8: Rafaello18 folded before Flop (didn't bet)
Seat 9: mbk88 folded before Flop (didn't bet)





PokerStars Hand #155380287678:  Hold'em No Limit ($0.25/$0.50 USD) - 2016/06/30 14:00:02 CET [2016/06/30 8:00:02 ET]
Table 'Mentha II' 9-max Seat #3 is the button
Seat 2: TheMinion ($56.69 in chips) 
Seat 3: joker180785 ($50.58 in chips) 
Seat 4: 55peter1 ($76.49 in chips) 
Seat 5: kotkas1000 ($50 in chips) 
Seat 6: Alexey_Kim2 ($50 in chips) 
Seat 7: ardo888 ($147.05 in chips) 
Seat 8: Clifftastic ($41.48 in chips) 
Seat 9: matiko09 ($102.50 in chips) 
55peter1: posts small blind $0.25
kotkas1000: posts big blind $0.50
fudzi: sits out 
TheMinion: posts the ante $0.10
joker180785: posts the ante $0.10
55peter1: posts the ante $0.10
kotkas1000: posts the ante $0.10
Alexey_Kim2: posts the ante $0.10
ardo888: posts the ante $0.10
Clifftastic: posts the ante $0.10
matiko09: posts the ante $0.10
*** HOLE CARDS ***
Dealt to matiko09 [Jh 9d]
Alexey_Kim2: raises $1 to $1.50
ardo888: folds 
Clifftastic: folds 
matiko09: folds 
TheMinion: folds 
joker180785: calls $1.50
55peter1: folds 
kotkas1000: folds 
*** FLOP *** [Jd 4h Td]
55peter1 leaves the table
Chanelado joins the table at seat #4 
Alexey_Kim2: bets $2.87
joker180785: folds 
Uncalled bet ($2.87) returned to Alexey_Kim2
Alexey_Kim2 collected $4.32 from pot
Alexey_Kim2: doesn't show hand 
*** SUMMARY ***
Total pot $4.55 | Rake $0.23 
Board [Jd 4h Td]
Seat 2: TheMinion folded before Flop (didn't bet)
Seat 3: joker180785 (button) folded on the Flop
Seat 4: 55peter1 (small blind) folded before Flop
Seat 5: kotkas1000 (big blind) folded before Flop
Seat 6: Alexey_Kim2 collected ($4.32)
Seat 7: ardo888 folded before Flop (didn't bet)
Seat 8: Clifftastic folded before Flop (didn't bet)
Seat 9: matiko09 folded before Flop (didn't bet)





PokerStars Hand #155380290447:  Hold'em No Limit ($0.50/$1.00 USD) - 2016/06/30 14:00:08 CET [2016/06/30 8:00:08 ET]
Table 'Tatjana' 9-max Seat #3 is the button
Seat 2: DIMAN_324 ($100 in chips) 
Seat 3: Rafaello18 ($129.29 in chips) 
Seat 4: mopatron25 ($92.91 in chips) 
Seat 5: matiko09 ($100 in chips) 
Seat 6: mbk88 ($147.52 in chips) 
Seat 7: daigodisco ($36.63 in chips) 
Seat 9: POTAPENKO700 ($239.71 in chips) 
mopatron25: posts small blind $0.50
matiko09: posts big blind $1
alhill86: sits out 
tipner: sits out 
*** HOLE CARDS ***
Dealt to matiko09 [Qd 2d]
mbk88: folds 
daigodisco: folds 
POTAPENKO700: folds 
DIMAN_324: raises $1.40 to $2.40
Rafaello18: folds 
mopatron25: calls $1.90
matiko09: folds 
*** FLOP *** [3c Ac 7s]
mopatron25: bets $3
DIMAN_324: raises $6 to $9
mopatron25: calls $6
*** TURN *** [3c Ac 7s] [3h]
mopatron25: bets $6
DIMAN_324: folds 
Uncalled bet ($6) returned to mopatron25
mopatron25 collected $22.61 from pot
mopatron25: doesn't show hand 
*** SUMMARY ***
Total pot $23.80 | Rake $1.19 
Board [3c Ac 7s 3h]
Seat 2: DIMAN_324 folded on the Turn
Seat 3: Rafaello18 (button) folded before Flop (didn't bet)
Seat 4: mopatron25 (small blind) collected ($22.61)
Seat 5: matiko09 (big blind) folded before Flop
Seat 6: mbk88 folded before Flop (didn't bet)
Seat 7: daigodisco folded before Flop (didn't bet)
Seat 9: POTAPENKO700 folded before Flop (didn't bet)





PokerStars Hand #155380292722:  Hold'em No Limit ($0.50/$1.00 USD) - 2016/06/30 14:00:14 CET [2016/06/30 8:00:14 ET]
Table 'Prieska' 9-max Seat #5 is the button
Seat 1: KovIFish89 ($120.09 in chips) 
Seat 2: B_style_cuz ($103.43 in chips) 
Seat 3: Rafaello18 ($123.50 in chips) 
Seat 4: nickreason17 ($105.18 in chips) 
Seat 5: ramzes160468 ($61.02 in chips) 
Seat 6: Ty Nick 420 ($100.50 in chips) 
Seat 7: matiko09 ($107.52 in chips) 
Seat 8: mbk88 ($122.95 in chips) 
Seat 9: Konig26 ($91.26 in chips) 
Ty Nick 420: posts small blind $0.50
matiko09: posts big blind $1
*** HOLE CARDS ***
Dealt to matiko09 [4d Ts]
mbk88: raises $2 to $3
Konig26: folds 
KovIFish89: folds 
B_style_cuz: folds 
Rafaello18: folds 
nickreason17: folds 
ramzes160468: folds 
Ty Nick 420: folds 
matiko09: folds 
Uncalled bet ($2) returned to mbk88
mbk88 collected $2.50 from pot
mbk88: doesn't show hand 
*** SUMMARY ***
Total pot $2.50 | Rake $0 
Seat 1: KovIFish89 folded before Flop (didn't bet)
Seat 2: B_style_cuz folded before Flop (didn't bet)
Seat 3: Rafaello18 folded before Flop (didn't bet)
Seat 4: nickreason17 folded before Flop (didn't bet)
Seat 5: ramzes160468 (button) folded before Flop (didn't bet)
Seat 6: Ty Nick 420 (small blind) folded before Flop
Seat 7: matiko09 (big blind) folded before Flop
Seat 8: mbk88 collected ($2.50)
Seat 9: Konig26 folded before Flop (didn't bet)





PokerStars Hand #155380295228:  Hold'em No Limit ($0.25/$0.50 USD) - 2016/06/30 14:00:21 CET [2016/06/30 8:00:21 ET]
Table 'Dorothea II' 9-max Seat #6 is the button
Seat 1: zapata 7777 ($82.06 in chips) 
Seat 2: joker180785 ($50 in chips) 
Seat 3: Franky77200 ($23.75 in chips) 
Seat 4: matiko09 ($136.60 in chips) 
Seat 5: Bailey Dew ($86.30 in chips) 
Seat 6: ivan100886 ($40.16 in chips) 
Seat 7: desmo465 ($64.35 in chips) 
Seat 8: TheMinion ($50 in chips) 
Seat 9: funXmun ($50 in chips) 
desmo465: posts small blind $0.25
TheMinion: posts big blind $0.50
zapata 7777: posts the ante $0.10
joker180785: posts the ante $0.10
Franky77200: posts the ante $0.10
matiko09: posts the ante $0.10
Bailey Dew: posts the ante $0.10
ivan100886: posts the ante $0.10
desmo465: posts the ante $0.10
TheMinion: posts the ante $0.10
funXmun: posts the ante $0.10
*** HOLE CARDS ***
Dealt to matiko09 [9s Js]
funXmun: folds 
zapata 7777: raises $0.50 to $1
joker180785: folds 
Franky77200: folds 
matiko09: folds 
Bailey Dew: folds 
ivan100886: calls $1
desmo465: folds 
TheMinion: folds 
*** FLOP *** [3c 3h 7d]
zapata 7777: bets $1.52
ivan100886: folds 
Uncalled bet ($1.52) returned to zapata 7777
zapata 7777 collected $3.47 from pot
zapata 7777: doesn't show hand 
*** SUMMARY ***
Total pot $3.65 | Rake $0.18 
Board [3c 3h 7d]
Seat 1: zapata 7777 collected ($3.47)
Seat 2: joker180785 folded before Flop (didn't bet)
Seat 3: Franky77200 folded before Flop (didn't bet)
Seat 4: matiko09 folded before Flop (didn't bet)
Seat 5: Bailey Dew folded before Flop (didn't bet)
Seat 6: ivan100886 (button) folded on the Flop
Seat 7: desmo465 (small blind) folded before Flop
Seat 8: TheMinion (big blind) folded before Flop
Seat 9: funXmun folded before Flop (didn't bet)





PokerStars Hand #155380299057:  Hold'em No Limit ($0.50/$1.00 USD) - 2016/06/30 14:00:30 CET [2016/06/30 8:00:30 ET]
Table 'Asmodeus' 9-max Seat #5 is the button
Seat 1: scollop ($129.37 in chips) 
Seat 2: picka4u ($39.50 in chips) 
Seat 3: matiko09 ($101.75 in chips) 
Seat 5: sanr23 ($110.30 in chips) 
Seat 6: koutani7 ($90 in chips) 
Seat 7: aaronzzr ($144.04 in chips) 
Seat 8: Rafaello18 ($168.85 in chips) 
Seat 9: mbk88 ($158.86 in chips) 
koutani7: posts small blind $0.50
aaronzzr: posts big blind $1
DIMAN_324: sits out 
*** HOLE CARDS ***
Dealt to matiko09 [Td Tc]
Rafaello18: folds 
mbk88: folds 
scollop: folds 
picka4u: folds 
matiko09: raises $1.50 to $2.50
sanr23: folds 
koutani7: folds 
aaronzzr: calls $1.50
*** FLOP *** [5c 6d 4c]
aaronzzr: checks 
matiko09: checks 
*** TURN *** [5c 6d 4c] [8c]
aaronzzr: checks 
matiko09: bets $2.71
aaronzzr: calls $2.71
*** RIVER *** [5c 6d 4c 8c] [Qc]
aaronzzr: checks 
matiko09: bets $5
aaronzzr: folds 
Uncalled bet ($5) returned to matiko09
matiko09 collected $10.37 from pot
matiko09: doesn't show hand 
*** SUMMARY ***
Total pot $10.92 | Rake $0.55 
Board [5c 6d 4c 8c Qc]
Seat 1: scollop folded before Flop (didn't bet)
Seat 2: picka4u folded before Flop (didn't bet)
Seat 3: matiko09 collected ($10.37)
Seat 5: sanr23 (button) folded before Flop (didn't bet)
Seat 6: koutani7 (small blind) folded before Flop
Seat 7: aaronzzr (big blind) folded on the River
Seat 8: Rafaello18 folded before Flop (didn't bet)
Seat 9: mbk88 folded before Flop (didn't bet)





PokerStars Hand #155380299749:  Hold'em No Limit ($0.50/$1.00 USD) - 2016/06/30 14:00:32 CET [2016/06/30 8:00:32 ET]
Table 'Borrelly II' 9-max Seat #6 is the button
Seat 1: Rafaello18 ($121.07 in chips) 
Seat 3: di0d80 ($109.52 in chips) 
Seat 4: DonRon_AT ($38.49 in chips) 
Seat 5: DIMAN_324 ($100 in chips) 
Seat 6: m_michalec ($172.06 in chips) 
Seat 7: matiko09 ($175.36 in chips) 
Seat 8: Arjun A Raju ($126.14 in chips) 
matiko09: posts small blind $0.50
Arjun A Raju: posts big blind $1
alhill86: sits out 
mbk88: sits out 
*** HOLE CARDS ***
Dealt to matiko09 [Td Qd]
Rafaello18: raises $1.50 to $2.50
di0d80: folds 
DonRon_AT: raises $5.50 to $8
DIMAN_324: folds 
m_michalec: folds 
matiko09: folds 
Arjun A Raju: folds 
Rafaello18: folds 
Uncalled bet ($5.50) returned to DonRon_AT
DonRon_AT collected $6.50 from pot
*** SUMMARY ***
Total pot $6.50 | Rake $0 
Seat 1: Rafaello18 folded before Flop
Seat 3: di0d80 folded before Flop (didn't bet)
Seat 4: DonRon_AT collected ($6.50)
Seat 5: DIMAN_324 folded before Flop (didn't bet)
Seat 6: m_michalec (button) folded before Flop (didn't bet)
Seat 7: matiko09 (small blind) folded before Flop
Seat 8: Arjun A Raju (big blind) folded before Flop





PokerStars Hand #155380300565:  Hold'em No Limit ($0.50/$1.00 USD) - 2016/06/30 14:00:34 CET [2016/06/30 8:00:34 ET]
Table 'Altarf II' 9-max Seat #3 is the button
Seat 1: Rafaello18 ($100 in chips) 
Seat 2: KovIFish89 ($101.50 in chips) 
Seat 3: sanr23 ($163.61 in chips) 
Seat 4: Greha999 ($74.16 in chips) 
Seat 5: DIMAN_324 ($205.74 in chips) 
Seat 6: mbk88 ($100 in chips) 
Seat 7: matiko09 ($107.90 in chips) 
Seat 8: DomiVY ($40 in chips) 
Seat 9: omanibemihum ($129.05 in chips) 
Greha999: posts small blind $0.50
DIMAN_324: posts big blind $1
*** HOLE CARDS ***
Dealt to matiko09 [Kc 7c]
mbk88: folds 
matiko09: folds 
DomiVY: folds 
omanibemihum: raises $2 to $3
Rafaello18: folds 
KovIFish89: folds 
sanr23: folds 
Greha999: folds 
DIMAN_324: folds 
Uncalled bet ($2) returned to omanibemihum
omanibemihum collected $2.50 from pot
omanibemihum: doesn't show hand 
*** SUMMARY ***
Total pot $2.50 | Rake $0 
Seat 1: Rafaello18 folded before Flop (didn't bet)
Seat 2: KovIFish89 folded before Flop (didn't bet)
Seat 3: sanr23 (button) folded before Flop (didn't bet)
Seat 4: Greha999 (small blind) folded before Flop
Seat 5: DIMAN_324 (big blind) folded before Flop
Seat 6: mbk88 folded before Flop (didn't bet)
Seat 7: matiko09 folded before Flop (didn't bet)
Seat 8: DomiVY folded before Flop (didn't bet)
Seat 9: omanibemihum collected ($2.50)





PokerStars Hand #155380304605:  Hold'em No Limit ($0.50/$1.00 USD) - 2016/06/30 14:00:43 CET [2016/06/30 8:00:43 ET]
Table 'California II' 9-max Seat #4 is the button
Seat 1: Rafaello18 ($110.02 in chips) 
Seat 2: velourleder ($56.94 in chips) 
Seat 3: KovIFish89 ($100 in chips) 
Seat 4: mbk88 ($181.42 in chips) 
Seat 5: Rohitbarve ($98.74 in chips) 
Seat 6: matiko09 ($109.20 in chips) 
Seat 7: DomiVY ($84.20 in chips) 
Seat 8: picka4u ($106.36 in chips) 
Seat 9: di0d80 ($102.16 in chips) 
Rohitbarve: posts small blind $0.50
matiko09: posts big blind $1
*** HOLE CARDS ***
Dealt to matiko09 [8c Jc]
DomiVY: folds 
picka4u: raises $1.25 to $2.25
di0d80: calls $2.25
Rafaello18: folds 
velourleder: folds 
KovIFish89: folds 
mbk88: folds 
Rohitbarve: calls $1.75
matiko09: calls $1.25
*** FLOP *** [Kc Ac 3s]
Rohitbarve: checks 
matiko09: checks 
picka4u: bets $6.50
di0d80: calls $6.50
Rohitbarve: folds 
matiko09: calls $6.50
*** TURN *** [Kc Ac 3s] [8s]
matiko09: checks 
picka4u: bets $18
di0d80: calls $18
matiko09: calls $18
*** RIVER *** [Kc Ac 3s 8s] [9s]
matiko09: checks 
picka4u: bets $79.61 and is all-in
di0d80: folds 
matiko09: folds 
Uncalled bet ($79.61) returned to picka4u
picka4u collected $80 from pot
picka4u: doesn't show hand 
*** SUMMARY ***
Total pot $82.50 | Rake $2.50 
Board [Kc Ac 3s 8s 9s]
Seat 1: Rafaello18 folded before Flop (didn't bet)
Seat 2: velourleder folded before Flop (didn't bet)
Seat 3: KovIFish89 folded before Flop (didn't bet)
Seat 4: mbk88 (button) folded before Flop (didn't bet)
Seat 5: Rohitbarve (small blind) folded on the Flop
Seat 6: matiko09 (big blind) folded on the River
Seat 7: DomiVY folded before Flop (didn't bet)
Seat 8: picka4u collected ($80)
Seat 9: di0d80 folded on the River





PokerStars Hand #155380305499:  Hold'em No Limit ($0.50/$1.00 USD) - 2016/06/30 14:00:45 CET [2016/06/30 8:00:45 ET]
Table 'Prieska' 9-max Seat #6 is the button
Seat 1: KovIFish89 ($120.09 in chips) 
Seat 2: B_style_cuz ($103.43 in chips) 
Seat 3: Rafaello18 ($123.50 in chips) 
Seat 4: nickreason17 ($105.18 in chips) 
Seat 5: ramzes160468 ($61.02 in chips) 
Seat 6: Ty Nick 420 ($100 in chips) 
Seat 7: matiko09 ($106.52 in chips) 
Seat 8: mbk88 ($124.45 in chips) 
Seat 9: Konig26 ($91.26 in chips) 
matiko09: posts small blind $0.50
mbk88: posts big blind $1
*** HOLE CARDS ***
Dealt to matiko09 [9s Kc]
Konig26: folds 
KovIFish89: folds 
B_style_cuz: folds 
Rafaello18: folds 
nickreason17: raises $1.50 to $2.50
ramzes160468: calls $2.50
Ty Nick 420: folds 
matiko09: folds 
mbk88: folds 
*** FLOP *** [Qh 7s 5h]
nickreason17: checks 
ramzes160468: checks 
*** TURN *** [Qh 7s 5h] [Qs]
nickreason17: bets $4
ramzes160468: calls $4
*** RIVER *** [Qh 7s 5h Qs] [9d]
nickreason17: bets $10
ramzes160468: calls $10
*** SHOW DOWN ***
nickreason17: shows [Jd Ad] (a pair of Queens)
ramzes160468: shows [9c Ac] (two pair, Queens and Nines)
ramzes160468 collected $32.78 from pot
*** SUMMARY ***
Total pot $34.50 | Rake $1.72 
Board [Qh 7s 5h Qs 9d]
Seat 1: KovIFish89 folded before Flop (didn't bet)
Seat 2: B_style_cuz folded before Flop (didn't bet)
Seat 3: Rafaello18 folded before Flop (didn't bet)
Seat 4: nickreason17 showed [Jd Ad] and lost with a pair of Queens
Seat 5: ramzes160468 showed [9c Ac] and won ($32.78) with two pair, Queens and Nines
Seat 6: Ty Nick 420 (button) folded before Flop (didn't bet)
Seat 7: matiko09 (small blind) folded before Flop
Seat 8: mbk88 (big blind) folded before Flop
Seat 9: Konig26 folded before Flop (didn't bet)





PokerStars Hand #155380305474:  Hold'em No Limit ($0.25/$0.50 USD) - 2016/06/30 14:00:45 CET [2016/06/30 8:00:45 ET]
Table 'Mentha II' 9-max Seat #5 is the button
Seat 2: TheMinion ($56.59 in chips) 
Seat 3: joker180785 ($50 in chips) 
Seat 4: Chanelado ($40 in chips) 
Seat 5: kotkas1000 ($50 in chips) 
Seat 6: Alexey_Kim2 ($52.72 in chips) 
Seat 8: Clifftastic ($41.38 in chips) 
Seat 9: matiko09 ($102.40 in chips) 
Alexey_Kim2: posts small blind $0.25
ardo888: is sitting out 
ardo888 leaves the table
Clifftastic: posts big blind $0.50
fudzi: sits out 
Chanelado: posts big blind $0.50
TheMinion: posts the ante $0.10
joker180785: posts the ante $0.10
Chanelado: posts the ante $0.10
kotkas1000: posts the ante $0.10
Alexey_Kim2: posts the ante $0.10
Clifftastic: posts the ante $0.10
matiko09: posts the ante $0.10
*** HOLE CARDS ***
Dealt to matiko09 [8c 2h]
matiko09: folds 
TheMinion: folds 
joker180785: folds 
Chanelado: checks 
kotkas1000: folds 
ivan100886 joins the table at seat #7 
Alexey_Kim2: calls $0.25
Clifftastic: checks 
*** FLOP *** [6s 7d 9c]
Alexey_Kim2: checks 
Clifftastic: checks 
Chanelado: checks 
*** TURN *** [6s 7d 9c] [7c]
Alexey_Kim2: bets $1.56
Clifftastic: calls $1.56
Chanelado: folds 
*** RIVER *** [6s 7d 9c 7c] [Jc]
Alexey_Kim2: checks 
Clifftastic: checks 
*** SHOW DOWN ***
Alexey_Kim2: shows [4d 4c] (two pair, Sevens and Fours)
Clifftastic: shows [Jh Td] (two pair, Jacks and Sevens)
Clifftastic collected $5.05 from pot
*** SUMMARY ***
Total pot $5.32 | Rake $0.27 
Board [6s 7d 9c 7c Jc]
Seat 2: TheMinion folded before Flop (didn't bet)
Seat 3: joker180785 folded before Flop (didn't bet)
Seat 4: Chanelado folded on the Turn
Seat 5: kotkas1000 (button) folded before Flop (didn't bet)
Seat 6: Alexey_Kim2 (small blind) showed [4d 4c] and lost with two pair, Sevens and Fours
Seat 8: Clifftastic (big blind) showed [Jh Td] and won ($5.05) with two pair, Jacks and Sevens
Seat 9: matiko09 folded before Flop (didn't bet)





PokerStars Hand #155380309215:  Hold'em No Limit ($0.50/$1.00 USD) - 2016/06/30 14:00:54 CET [2016/06/30 8:00:54 ET]
Table 'Altarf II' 9-max Seat #4 is the button
Seat 1: Rafaello18 ($100 in chips) 
Seat 2: KovIFish89 ($101.50 in chips) 
Seat 3: sanr23 ($163.61 in chips) 
Seat 4: Greha999 ($73.66 in chips) 
Seat 5: DIMAN_324 ($204.74 in chips) 
Seat 6: mbk88 ($100 in chips) 
Seat 7: matiko09 ($107.90 in chips) 
Seat 8: DomiVY ($40 in chips) 
Seat 9: omanibemihum ($130.55 in chips) 
DIMAN_324: posts small blind $0.50
mbk88: posts big blind $1
*** HOLE CARDS ***
Dealt to matiko09 [Ad 7d]
matiko09: folds 
DomiVY: folds 
omanibemihum: folds 
Rafaello18: folds 
KovIFish89: raises $2 to $3
sanr23: folds 
Greha999: folds 
DIMAN_324: raises $7.50 to $10.50
mbk88: folds 
KovIFish89: raises $13.50 to $24
DIMAN_324: raises $180.74 to $204.74 and is all-in
KovIFish89: folds 
Uncalled bet ($180.74) returned to DIMAN_324
DIMAN_324 collected $49 from pot
DIMAN_324: doesn't show hand 
*** SUMMARY ***
Total pot $49 | Rake $0 
Seat 1: Rafaello18 folded before Flop (didn't bet)
Seat 2: KovIFish89 folded before Flop
Seat 3: sanr23 folded before Flop (didn't bet)
Seat 4: Greha999 (button) folded before Flop (didn't bet)
Seat 5: DIMAN_324 (small blind) collected ($49)
Seat 6: mbk88 (big blind) folded before Flop
Seat 7: matiko09 folded before Flop (didn't bet)
Seat 8: DomiVY folded before Flop (didn't bet)
Seat 9: omanibemihum folded before Flop (didn't bet)





PokerStars Hand #155380311444:  Hold'em No Limit ($0.50/$1.00 USD) - 2016/06/30 14:00:59 CET [2016/06/30 8:00:59 ET]
Table 'Tatjana' 9-max Seat #4 is the button
Seat 2: DIMAN_324 ($100 in chips) 
Seat 3: Rafaello18 ($129.29 in chips) 
Seat 4: mopatron25 ($104.12 in chips) 
Seat 5: matiko09 ($100 in chips) 
Seat 6: mbk88 ($147.52 in chips) 
Seat 7: daigodisco ($36.63 in chips) 
Seat 9: POTAPENKO700 ($239.71 in chips) 
matiko09: posts small blind $0.50
mbk88: posts big blind $1
alhill86: sits out 
tipner: sits out 
*** HOLE CARDS ***
Dealt to matiko09 [Jc 7c]
daigodisco has timed out
daigodisco: folds 
POTAPENKO700: folds 
DIMAN_324: folds 
Rafaello18: raises $1.50 to $2.50
mopatron25: calls $2.50
matiko09: folds 
mbk88: folds 
*** FLOP *** [6d 9d Ts]
Rafaello18: bets $4
mopatron25: calls $4
*** TURN *** [6d 9d Ts] [Th]
Rafaello18: bets $9
mopatron25: calls $9
*** RIVER *** [6d 9d Ts Th] [7h]
Rafaello18: checks 
mopatron25: bets $11
Rafaello18: calls $11
*** SHOW DOWN ***
mopatron25: shows [Jd Tc] (three of a kind, Tens)
Rafaello18: mucks hand 
mopatron25 collected $52 from pot
*** SUMMARY ***
Total pot $54.50 | Rake $2.50 
Board [6d 9d Ts Th 7h]
Seat 2: DIMAN_324 folded before Flop (didn't bet)
Seat 3: Rafaello18 mucked [Qd Qs]
Seat 4: mopatron25 (button) showed [Jd Tc] and won ($52) with three of a kind, Tens
Seat 5: matiko09 (small blind) folded before Flop
Seat 6: mbk88 (big blind) folded before Flop
Seat 7: daigodisco folded before Flop (didn't bet)
Seat 9: POTAPENKO700 folded before Flop (didn't bet)





PokerStars Hand #155380313259:  Hold'em No Limit ($0.25/$0.50 USD) - 2016/06/30 14:01:04 CET [2016/06/30 8:01:04 ET]
Table 'Dorothea II' 9-max Seat #7 is the button
Seat 1: zapata 7777 ($84.43 in chips) 
Seat 2: joker180785 ($50 in chips) 
Seat 3: Franky77200 ($23.65 in chips) 
Seat 4: matiko09 ($136.50 in chips) 
Seat 5: Bailey Dew ($86.20 in chips) 
Seat 6: ivan100886 ($39.06 in chips) 
Seat 7: desmo465 ($64 in chips) 
Seat 8: TheMinion ($50 in chips) 
Seat 9: funXmun ($50 in chips) 
TheMinion: posts small blind $0.25
funXmun: posts big blind $0.50
zapata 7777: posts the ante $0.10
joker180785: posts the ante $0.10
Franky77200: posts the ante $0.10
matiko09: posts the ante $0.10
Bailey Dew: posts the ante $0.10
ivan100886: posts the ante $0.10
desmo465: posts the ante $0.10
TheMinion: posts the ante $0.10
funXmun: posts the ante $0.10
*** HOLE CARDS ***
Dealt to matiko09 [Kc 3c]
zapata 7777: folds 
joker180785: folds 
Franky77200: raises $1 to $1.50
matiko09: folds 
Bailey Dew: folds 
ivan100886: folds 
desmo465: folds 
TheMinion: folds 
funXmun: folds 
Uncalled bet ($1) returned to Franky77200
Franky77200 collected $2.15 from pot
Franky77200: doesn't show hand 
*** SUMMARY ***
Total pot $2.15 | Rake $0 
Seat 1: zapata 7777 folded before Flop (didn't bet)
Seat 2: joker180785 folded before Flop (didn't bet)
Seat 3: Franky77200 collected ($2.15)
Seat 4: matiko09 folded before Flop (didn't bet)
Seat 5: Bailey Dew folded before Flop (didn't bet)
Seat 6: ivan100886 folded before Flop (didn't bet)
Seat 7: desmo465 (button) folded before Flop (didn't bet)
Seat 8: TheMinion (small blind) folded before Flop
Seat 9: funXmun (big blind) folded before Flop





PokerStars Hand #155380316395:  Hold'em No Limit ($0.50/$1.00 USD) - 2016/06/30 14:01:11 CET [2016/06/30 8:01:11 ET]
Table 'Borrelly II' 9-max Seat #7 is the button
Seat 1: Rafaello18 ($118.57 in chips) 
Seat 3: di0d80 ($109.52 in chips) 
Seat 4: DonRon_AT ($42.49 in chips) 
Seat 5: DIMAN_324 ($100 in chips) 
Seat 6: m_michalec ($172.06 in chips) 
Seat 7: matiko09 ($174.86 in chips) 
Seat 8: Arjun A Raju ($125.14 in chips) 
Seat 9: alhill86 ($72.50 in chips) 
Arjun A Raju: posts small blind $0.50
alhill86: posts big blind $1
mbk88: sits out 
*** HOLE CARDS ***
Dealt to matiko09 [5c 2h]
Rafaello18: folds 
di0d80: folds 
DonRon_AT: folds 
DIMAN_324: folds 
m_michalec: folds 
matiko09: folds 
Arjun A Raju: folds 
Uncalled bet ($0.50) returned to alhill86
alhill86 collected $1 from pot
alhill86: doesn't show hand 
*** SUMMARY ***
Total pot $1 | Rake $0 
Seat 1: Rafaello18 folded before Flop (didn't bet)
Seat 3: di0d80 folded before Flop (didn't bet)
Seat 4: DonRon_AT folded before Flop (didn't bet)
Seat 5: DIMAN_324 folded before Flop (didn't bet)
Seat 6: m_michalec folded before Flop (didn't bet)
Seat 7: matiko09 (button) folded before Flop (didn't bet)
Seat 8: Arjun A Raju (small blind) folded before Flop
Seat 9: alhill86 (big blind) collected ($1)





PokerStars Hand #155380319077:  Hold'em No Limit ($0.25/$0.50 USD) - 2016/06/30 14:01:17 CET [2016/06/30 8:01:17 ET]
Table 'Elektra II' 9-max Seat #8 is the button
Seat 1: drlee77 ($48.78 in chips) 
Seat 2: TheMinion ($61.57 in chips) 
Seat 3: mojtabagol ($82.24 in chips) 
Seat 4: matiko09 ($51.72 in chips) 
Seat 5: Rafaello18 ($56.49 in chips) 
Seat 6: pfunkolstar ($50 in chips) 
Seat 7: MuddyDance ($50 in chips) 
Seat 8: sanr23 ($59.29 in chips) 
Seat 9: KABAL_ua ($50 in chips) 
KABAL_ua: posts small blind $0.25
drlee77: posts big blind $0.50
*** HOLE CARDS ***
Dealt to matiko09 [Ac 5h]
TheMinion: folds 
mojtabagol: folds 
matiko09: folds 
Rafaello18: raises $0.75 to $1.25
pfunkolstar: folds 
MuddyDance: folds 
sanr23: folds 
KABAL_ua: folds 
drlee77: folds 
Uncalled bet ($0.75) returned to Rafaello18
Rafaello18 collected $1.25 from pot
Rafaello18: doesn't show hand 
*** SUMMARY ***
Total pot $1.25 | Rake $0 
Seat 1: drlee77 (big blind) folded before Flop
Seat 2: TheMinion folded before Flop (didn't bet)
Seat 3: mojtabagol folded before Flop (didn't bet)
Seat 4: matiko09 folded before Flop (didn't bet)
Seat 5: Rafaello18 collected ($1.25)
Seat 6: pfunkolstar folded before Flop (didn't bet)
Seat 7: MuddyDance folded before Flop (didn't bet)
Seat 8: sanr23 (button) folded before Flop (didn't bet)
Seat 9: KABAL_ua (small blind) folded before Flop





PokerStars Hand #155380324682:  Hold'em No Limit ($0.50/$1.00 USD) - 2016/06/30 14:01:30 CET [2016/06/30 8:01:30 ET]
Table 'Borrelly II' 9-max Seat #8 is the button
Seat 2: mbk88 ($105.62 in chips) 
Seat 3: di0d80 ($109.52 in chips) 
Seat 4: DonRon_AT ($42.49 in chips) 
Seat 5: DIMAN_324 ($100 in chips) 
Seat 6: m_michalec ($172.06 in chips) 
Seat 7: matiko09 ($174.86 in chips) 
Seat 8: Arjun A Raju ($124.64 in chips) 
Seat 9: alhill86 ($73 in chips) 
alhill86: posts small blind $0.50
Rafaello18: is sitting out 
mbk88: posts big blind $1
*** HOLE CARDS ***
Dealt to matiko09 [3c Js]
di0d80: folds 
DonRon_AT: calls $1
DIMAN_324: folds 
m_michalec: folds 
matiko09: folds 
Arjun A Raju: folds 
alhill86: folds 
mbk88: checks 
*** FLOP *** [3d 7d Qd]
mbk88: checks 
DonRon_AT: checks 
*** TURN *** [3d 7d Qd] [Kc]
mbk88: checks 
DonRon_AT: checks 
*** RIVER *** [3d 7d Qd Kc] [7s]
mbk88: bets $3
DonRon_AT: folds 
Uncalled bet ($3) returned to mbk88
mbk88 collected $2.38 from pot
mbk88: doesn't show hand 
*** SUMMARY ***
Total pot $2.50 | Rake $0.12 
Board [3d 7d Qd Kc 7s]
Seat 2: mbk88 (big blind) collected ($2.38)
Seat 3: di0d80 folded before Flop (didn't bet)
Seat 4: DonRon_AT folded on the River
Seat 5: DIMAN_324 folded before Flop (didn't bet)
Seat 6: m_michalec folded before Flop (didn't bet)
Seat 7: matiko09 folded before Flop (didn't bet)
Seat 8: Arjun A Raju (button) folded before Flop (didn't bet)
Seat 9: alhill86 (small blind) folded before Flop





PokerStars Hand #155380326217:  Hold'em No Limit ($0.50/$1.00 USD) - 2016/06/30 14:01:33 CET [2016/06/30 8:01:33 ET]
Table 'Sigrid' 9-max Seat #9 is the button
Seat 1: Greha999 ($76.12 in chips) 
Seat 2: matiko09 ($109.02 in chips) 
Seat 3: Rafaello18 ($101.10 in chips) 
Seat 4: mbk88 ($122.37 in chips) 
Seat 5: DIMAN_324 ($103.58 in chips) 
Seat 6: di0d80 ($112.99 in chips) 
Seat 8: nickreason17 ($100 in chips) 
Seat 9: KovIFish89 ($100 in chips) 
Greha999: posts small blind $0.50
matiko09: posts big blind $1
arctur17: sits out 
*** HOLE CARDS ***
Dealt to matiko09 [6s 9h]
Rafaello18: folds 
mbk88: folds 
DIMAN_324: folds 
di0d80: folds 
nickreason17: folds 
KovIFish89: raises $1 to $2
Greha999: folds 
matiko09: folds 
Uncalled bet ($1) returned to KovIFish89
KovIFish89 collected $2.50 from pot
KovIFish89: doesn't show hand 
*** SUMMARY ***
Total pot $2.50 | Rake $0 
Seat 1: Greha999 (small blind) folded before Flop
Seat 2: matiko09 (big blind) folded before Flop
Seat 3: Rafaello18 folded before Flop (didn't bet)
Seat 4: mbk88 folded before Flop (didn't bet)
Seat 5: DIMAN_324 folded before Flop (didn't bet)
Seat 6: di0d80 folded before Flop (didn't bet)
Seat 8: nickreason17 folded before Flop (didn't bet)
Seat 9: KovIFish89 (button) collected ($2.50)





PokerStars Hand #155380327024:  Hold'em No Limit ($0.25/$0.50 USD) - 2016/06/30 14:01:35 CET [2016/06/30 8:01:35 ET]
Table 'Dorothea II' 9-max Seat #8 is the button
Seat 1: zapata 7777 ($84.33 in chips) 
Seat 2: joker180785 ($50 in chips) 
Seat 3: Franky77200 ($25.20 in chips) 
Seat 4: matiko09 ($136.40 in chips) 
Seat 5: Bailey Dew ($86.10 in chips) 
Seat 6: ivan100886 ($38.96 in chips) 
Seat 7: desmo465 ($63.90 in chips) 
Seat 8: TheMinion ($50 in chips) 
Seat 9: funXmun ($50 in chips) 
funXmun: posts small blind $0.25
zapata 7777: posts big blind $0.50
zapata 7777: posts the ante $0.10
joker180785: posts the ante $0.10
Franky77200: posts the ante $0.10
matiko09: posts the ante $0.10
Bailey Dew: posts the ante $0.10
ivan100886: posts the ante $0.10
desmo465: posts the ante $0.10
TheMinion: posts the ante $0.10
funXmun: posts the ante $0.10
*** HOLE CARDS ***
Dealt to matiko09 [2d Qd]
joker180785: folds 
Franky77200: calls $0.50
matiko09: folds 
Bailey Dew: folds 
ivan100886: folds 
desmo465: calls $0.50
TheMinion: folds 
funXmun: folds 
zapata 7777: checks 
*** FLOP *** [Qh 5s 9s]
zapata 7777: checks 
Franky77200: bets $2
desmo465: calls $2
zapata 7777: folds 
*** TURN *** [Qh 5s 9s] [3h]
Franky77200: checks 
desmo465: bets $3.16
Franky77200: calls $3.16
*** RIVER *** [Qh 5s 9s 3h] [Kd]
Franky77200: bets $19.44 and is all-in
desmo465: folds 
Uncalled bet ($19.44) returned to Franky77200
Franky77200 collected $12.32 from pot
Franky77200: doesn't show hand 
*** SUMMARY ***
Total pot $12.97 | Rake $0.65 
Board [Qh 5s 9s 3h Kd]
Seat 1: zapata 7777 (big blind) folded on the Flop
Seat 2: joker180785 folded before Flop (didn't bet)
Seat 3: Franky77200 collected ($12.32)
Seat 4: matiko09 folded before Flop (didn't bet)
Seat 5: Bailey Dew folded before Flop (didn't bet)
Seat 6: ivan100886 folded before Flop (didn't bet)
Seat 7: desmo465 folded on the River
Seat 8: TheMinion (button) folded before Flop (didn't bet)
Seat 9: funXmun (small blind) folded before Flop





PokerStars Hand #155380330858:  Hold'em No Limit ($0.50/$1.00 USD) - 2016/06/30 14:01:44 CET [2016/06/30 8:01:44 ET]
Table 'Prieska' 9-max Seat #7 is the button
Seat 1: KovIFish89 ($120.09 in chips) 
Seat 2: B_style_cuz ($103.43 in chips) 
Seat 3: Rafaello18 ($123.50 in chips) 
Seat 4: nickreason17 ($100 in chips) 
Seat 5: ramzes160468 ($77.30 in chips) 
Seat 6: Ty Nick 420 ($100 in chips) 
Seat 7: matiko09 ($106.02 in chips) 
Seat 8: mbk88 ($123.45 in chips) 
Seat 9: Konig26 ($91.26 in chips) 
mbk88: posts small blind $0.50
Konig26: posts big blind $1
*** HOLE CARDS ***
Dealt to matiko09 [Qc 8c]
nickreason17 said, "(y)"
KovIFish89: folds 
B_style_cuz: folds 
Rafaello18: raises $1.50 to $2.50
nickreason17: folds 
ramzes160468: folds 
Ty Nick 420: calls $2.50
matiko09: folds 
mbk88: folds 
Konig26: folds 
*** FLOP *** [As Ts Ah]
Rafaello18: checks 
Ty Nick 420: bets $3.50
Rafaello18: calls $3.50
*** TURN *** [As Ts Ah] [7d]
Rafaello18: checks 
Ty Nick 420: bets $8.33
Rafaello18: folds 
Uncalled bet ($8.33) returned to Ty Nick 420
Ty Nick 420 collected $12.82 from pot
*** SUMMARY ***
Total pot $13.50 | Rake $0.68 
Board [As Ts Ah 7d]
Seat 1: KovIFish89 folded before Flop (didn't bet)
Seat 2: B_style_cuz folded before Flop (didn't bet)
Seat 3: Rafaello18 folded on the Turn
Seat 4: nickreason17 folded before Flop (didn't bet)
Seat 5: ramzes160468 folded before Flop (didn't bet)
Seat 6: Ty Nick 420 collected ($12.82)
Seat 7: matiko09 (button) folded before Flop (didn't bet)
Seat 8: mbk88 (small blind) folded before Flop
Seat 9: Konig26 (big blind) folded before Flop





PokerStars Hand #155380331832:  Hold'em No Limit ($0.50/$1.00 USD) - 2016/06/30 14:01:46 CET [2016/06/30 8:01:46 ET]
Table 'Asmodeus' 9-max Seat #6 is the button
Seat 1: scollop ($129.37 in chips) 
Seat 2: picka4u ($39.50 in chips) 
Seat 3: matiko09 ($106.91 in chips) 
Seat 5: sanr23 ($110.30 in chips) 
Seat 6: koutani7 ($89.50 in chips) 
Seat 7: aaronzzr ($138.83 in chips) 
Seat 9: mbk88 ($158.86 in chips) 
aaronzzr: posts small blind $0.50
Rafaello18: is sitting out 
mbk88: posts big blind $1
DIMAN_324: sits out 
*** HOLE CARDS ***
Dealt to matiko09 [4c Ah]
scollop: calls $1
picka4u: folds 
matiko09: folds 
sanr23: folds 
koutani7: folds 
aaronzzr: folds 
mbk88: checks 
*** FLOP *** [Jh Ac 8h]
mbk88: checks 
scollop: checks 
*** TURN *** [Jh Ac 8h] [3c]
mbk88: checks 
scollop: bets $1
mbk88: folds 
Uncalled bet ($1) returned to scollop
scollop collected $2.38 from pot
scollop: doesn't show hand 
*** SUMMARY ***
Total pot $2.50 | Rake $0.12 
Board [Jh Ac 8h 3c]
Seat 1: scollop collected ($2.38)
Seat 2: picka4u folded before Flop (didn't bet)
Seat 3: matiko09 folded before Flop (didn't bet)
Seat 5: sanr23 folded before Flop (didn't bet)
Seat 6: koutani7 (button) folded before Flop (didn't bet)
Seat 7: aaronzzr (small blind) folded before Flop
Seat 9: mbk88 (big blind) folded on the Turn





PokerStars Hand #155380337201:  Hold'em No Limit ($0.25/$0.50 USD) - 2016/06/30 14:01:59 CET [2016/06/30 8:01:59 ET]
Table 'Mentha II' 9-max Seat #6 is the button
Seat 2: TheMinion ($56.49 in chips) 
Seat 3: joker180785 ($50 in chips) 
Seat 4: Chanelado ($39.40 in chips) 
Seat 5: kotkas1000 ($50 in chips) 
Seat 6: Alexey_Kim2 ($50.56 in chips) 
Seat 8: Clifftastic ($44.27 in chips) 
Seat 9: matiko09 ($102.30 in chips) 
ivan100886 will be allowed to play after the button
Clifftastic: posts small blind $0.25
matiko09: posts big blind $0.50
fudzi: sits out 
TheMinion: posts the ante $0.10
joker180785: posts the ante $0.10
Chanelado: posts the ante $0.10
kotkas1000: posts the ante $0.10
Alexey_Kim2: posts the ante $0.10
Clifftastic: posts the ante $0.10
matiko09: posts the ante $0.10
*** HOLE CARDS ***
Dealt to matiko09 [6d Ac]
TheMinion: folds 
joker180785: folds 
Chanelado: folds 
kotkas1000: raises $0.75 to $1.25
Alexey_Kim2: raises $2.75 to $4
Clifftastic: folds 
matiko09: folds 
kotkas1000: folds 
Uncalled bet ($2.75) returned to Alexey_Kim2
Alexey_Kim2 collected $3.95 from pot
Alexey_Kim2: doesn't show hand 
*** SUMMARY ***
Total pot $3.95 | Rake $0 
Seat 2: TheMinion folded before Flop (didn't bet)
Seat 3: joker180785 folded before Flop (didn't bet)
Seat 4: Chanelado folded before Flop (didn't bet)
Seat 5: kotkas1000 folded before Flop
Seat 6: Alexey_Kim2 (button) collected ($3.95)
Seat 8: Clifftastic (small blind) folded before Flop
Seat 9: matiko09 (big blind) folded before Flop





PokerStars Hand #155380339916:  Hold'em No Limit ($0.25/$0.50 USD) - 2016/06/30 14:02:05 CET [2016/06/30 8:02:05 ET]
Table 'Elektra II' 9-max Seat #9 is the button
Seat 1: drlee77 ($48.28 in chips) 
Seat 2: TheMinion ($61.57 in chips) 
Seat 3: mojtabagol ($82.24 in chips) 
Seat 4: matiko09 ($51.72 in chips) 
Seat 5: Rafaello18 ($57.24 in chips) 
Seat 6: pfunkolstar ($50 in chips) 
Seat 7: MuddyDance ($50 in chips) 
Seat 8: sanr23 ($59.29 in chips) 
Seat 9: KABAL_ua ($50 in chips) 
drlee77: posts small blind $0.25
TheMinion: posts big blind $0.50
*** HOLE CARDS ***
Dealt to matiko09 [6h Qs]
mojtabagol: folds 
matiko09: folds 
Rafaello18: folds 
pfunkolstar: folds 
MuddyDance has timed out
MuddyDance: folds 
sanr23: raises $0.75 to $1.25
KABAL_ua: calls $1.25
drlee77: folds 
TheMinion: folds 
*** FLOP *** [3h Td Ts]
sanr23: bets $1.79
KABAL_ua: calls $1.79
*** TURN *** [3h Td Ts] [Jc]
sanr23: checks 
KABAL_ua: bets $3.24
sanr23: folds 
Uncalled bet ($3.24) returned to KABAL_ua
KABAL_ua collected $6.49 from pot
KABAL_ua: doesn't show hand 
*** SUMMARY ***
Total pot $6.83 | Rake $0.34 
Board [3h Td Ts Jc]
Seat 1: drlee77 (small blind) folded before Flop
Seat 2: TheMinion (big blind) folded before Flop
Seat 3: mojtabagol folded before Flop (didn't bet)
Seat 4: matiko09 folded before Flop (didn't bet)
Seat 5: Rafaello18 folded before Flop (didn't bet)
Seat 6: pfunkolstar folded before Flop (didn't bet)
Seat 7: MuddyDance folded before Flop (didn't bet)
Seat 8: sanr23 folded on the Turn
Seat 9: KABAL_ua (button) collected ($6.49)





PokerStars Hand #155380342733:  Hold'em No Limit ($0.50/$1.00 USD) - 2016/06/30 14:02:11 CET [2016/06/30 8:02:11 ET]
Table 'Altarf II' 9-max Seat #5 is the button
Seat 1: Rafaello18 ($100 in chips) 
Seat 2: KovIFish89 ($100 in chips) 
Seat 3: sanr23 ($163.61 in chips) 
Seat 4: Greha999 ($73.66 in chips) 
Seat 5: DIMAN_324 ($229.74 in chips) 
Seat 6: mbk88 ($100 in chips) 
Seat 7: matiko09 ($107.90 in chips) 
Seat 8: DomiVY ($40 in chips) 
Seat 9: omanibemihum ($130.55 in chips) 
mbk88: posts small blind $0.50
matiko09: posts big blind $1
*** HOLE CARDS ***
Dealt to matiko09 [Qd Ks]
DomiVY: folds 
omanibemihum: folds 
Rafaello18: raises $1.50 to $2.50
KovIFish89: folds 
sanr23: calls $2.50
Greha999: folds 
DIMAN_324: folds 
mbk88: folds 
matiko09: calls $1.50
*** FLOP *** [5d 7s 6s]
matiko09: checks 
Rafaello18: checks 
sanr23: bets $5.02
matiko09: folds 
Rafaello18: folds 
Uncalled bet ($5.02) returned to sanr23
sanr23 collected $7.60 from pot
sanr23: doesn't show hand 
*** SUMMARY ***
Total pot $8 | Rake $0.40 
Board [5d 7s 6s]
Seat 1: Rafaello18 folded on the Flop
Seat 2: KovIFish89 folded before Flop (didn't bet)
Seat 3: sanr23 collected ($7.60)
Seat 4: Greha999 folded before Flop (didn't bet)
Seat 5: DIMAN_324 (button) folded before Flop (didn't bet)
Seat 6: mbk88 (small blind) folded before Flop
Seat 7: matiko09 (big blind) folded on the Flop
Seat 8: DomiVY folded before Flop (didn't bet)
Seat 9: omanibemihum folded before Flop (didn't bet)





PokerStars Hand #155380344779:  Hold'em No Limit ($0.50/$1.00 USD) - 2016/06/30 14:02:16 CET [2016/06/30 8:02:16 ET]
Table 'Sigrid' 9-max Seat #1 is the button
Seat 1: Greha999 ($75.62 in chips) 
Seat 2: matiko09 ($108.02 in chips) 
Seat 4: mbk88 ($122.37 in chips) 
Seat 5: DIMAN_324 ($103.58 in chips) 
Seat 6: di0d80 ($112.99 in chips) 
Seat 8: nickreason17 ($100 in chips) 
Seat 9: KovIFish89 ($101.50 in chips) 
matiko09: posts small blind $0.50
Rafaello18: is sitting out 
mbk88: posts big blind $1
arctur17: sits out 
*** HOLE CARDS ***
Dealt to matiko09 [7c 7d]
DIMAN_324: folds 
di0d80: folds 
nickreason17: raises $1.50 to $2.50
KovIFish89: folds 
Greha999: calls $2.50
matiko09: calls $2
mbk88: folds 
*** FLOP *** [Ts Jh 6s]
matiko09: checks 
nickreason17: checks 
Greha999: bets $5
matiko09: folds 
nickreason17: calls $5
*** TURN *** [Ts Jh 6s] [Js]
nickreason17: checks 
Greha999: checks 
*** RIVER *** [Ts Jh 6s Js] [3d]
nickreason17: bets $5.80
Greha999: calls $5.80
*** SHOW DOWN ***
nickreason17: shows [Jc Ac] (three of a kind, Jacks)
Greha999: mucks hand 
nickreason17 collected $28.60 from pot
*** SUMMARY ***
Total pot $30.10 | Rake $1.50 
Board [Ts Jh 6s Js 3d]
Seat 1: Greha999 (button) mucked [8d Th]
Seat 2: matiko09 (small blind) folded on the Flop
Seat 4: mbk88 (big blind) folded before Flop
Seat 5: DIMAN_324 folded before Flop (didn't bet)
Seat 6: di0d80 folded before Flop (didn't bet)
Seat 8: nickreason17 showed [Jc Ac] and won ($28.60) with three of a kind, Jacks
Seat 9: KovIFish89 folded before Flop (didn't bet)





PokerStars Hand #155380344781:  Hold'em No Limit ($0.25/$0.50 USD) - 2016/06/30 14:02:16 CET [2016/06/30 8:02:16 ET]
Table 'Arcturus' 9-max Seat #9 is the button
Seat 1: kourk250 ($122.82 in chips) 
Seat 3: matiko09 ($50 in chips) 
Seat 5: stockbridge8 ($46 in chips) 
Seat 6: statistik85 ($59.19 in chips) 
Seat 7: DaikenGF ($65.76 in chips) 
Seat 8: TheMinion ($62.96 in chips) 
Seat 9: pfunkolstar ($54.25 in chips) 
kourk250: posts small blind $0.25
Rafaello18: is sitting out 
matiko09: posts big blind $0.50
*** HOLE CARDS ***
Dealt to matiko09 [Kh 9h]
stockbridge8: folds 
statistik85: folds 
DaikenGF: raises $0.80 to $1.30
TheMinion: folds 
pfunkolstar: folds 
kourk250: folds 
matiko09: folds 
Uncalled bet ($0.80) returned to DaikenGF
DaikenGF collected $1.25 from pot
DaikenGF: doesn't show hand 
*** SUMMARY ***
Total pot $1.25 | Rake $0 
Seat 1: kourk250 (small blind) folded before Flop
Seat 3: matiko09 (big blind) folded before Flop
Seat 5: stockbridge8 folded before Flop (didn't bet)
Seat 6: statistik85 folded before Flop (didn't bet)
Seat 7: DaikenGF collected ($1.25)
Seat 8: TheMinion folded before Flop (didn't bet)
Seat 9: pfunkolstar (button) folded before Flop (didn't bet)





PokerStars Hand #155380348147:  Hold'em No Limit ($0.50/$1.00 USD) - 2016/06/30 14:02:24 CET [2016/06/30 8:02:24 ET]
Table 'Asmodeus' 9-max Seat #7 is the button
Seat 1: scollop ($130.75 in chips) 
Seat 2: picka4u ($39.50 in chips) 
Seat 3: matiko09 ($106.91 in chips) 
Seat 5: sanr23 ($110.30 in chips) 
Seat 6: koutani7 ($89.50 in chips) 
Seat 7: aaronzzr ($138.33 in chips) 
Seat 9: mbk88 ($157.86 in chips) 
mbk88: posts small blind $0.50
scollop: posts big blind $1
DIMAN_324: sits out 
*** HOLE CARDS ***
Dealt to matiko09 [3s Js]
picka4u: folds 
matiko09: folds 
sanr23: folds 
koutani7: raises $2 to $3
aaronzzr: folds 
mbk88: folds 
scollop: calls $2
*** FLOP *** [8d 5d 8h]
scollop: checks 
koutani7: bets $4
scollop: calls $4
*** TURN *** [8d 5d 8h] [7s]
scollop: checks 
koutani7: checks 
*** RIVER *** [8d 5d 8h 7s] [Ks]
scollop: checks 
koutani7: bets $11
scollop: folds 
Uncalled bet ($11) returned to koutani7
koutani7 collected $13.78 from pot
koutani7: doesn't show hand 
*** SUMMARY ***
Total pot $14.50 | Rake $0.72 
Board [8d 5d 8h 7s Ks]
Seat 1: scollop (big blind) folded on the River
Seat 2: picka4u folded before Flop (didn't bet)
Seat 3: matiko09 folded before Flop (didn't bet)
Seat 5: sanr23 folded before Flop (didn't bet)
Seat 6: koutani7 collected ($13.78)
Seat 7: aaronzzr (button) folded before Flop (didn't bet)
Seat 9: mbk88 (small blind) folded before Flop





PokerStars Hand #155380349615:  Hold'em No Limit ($0.50/$1.00 USD) - 2016/06/30 14:02:27 CET [2016/06/30 8:02:27 ET]
Table 'Borrelly II' 9-max Seat #9 is the button
Seat 2: mbk88 ($107 in chips) 
Seat 3: di0d80 ($109.52 in chips) 
Seat 4: DonRon_AT ($41.49 in chips) 
Seat 5: DIMAN_324 ($100 in chips) 
Seat 6: m_michalec ($172.06 in chips) 
Seat 7: matiko09 ($174.86 in chips) 
Seat 8: Arjun A Raju ($124.64 in chips) 
Seat 9: alhill86 ($72.50 in chips) 
mbk88: posts small blind $0.50
di0d80: posts big blind $1
*** HOLE CARDS ***
Dealt to matiko09 [Kd Ah]
DonRon_AT: folds 
DIMAN_324: folds 
m_michalec: folds 
matiko09: raises $2 to $3
Arjun A Raju: folds 
alhill86: folds 
mbk88: folds 
di0d80: folds 
Uncalled bet ($2) returned to matiko09
matiko09 collected $2.50 from pot
*** SUMMARY ***
Total pot $2.50 | Rake $0 
Seat 2: mbk88 (small blind) folded before Flop
Seat 3: di0d80 (big blind) folded before Flop
Seat 4: DonRon_AT folded before Flop (didn't bet)
Seat 5: DIMAN_324 folded before Flop (didn't bet)
Seat 6: m_michalec folded before Flop (didn't bet)
Seat 7: matiko09 collected ($2.50)
Seat 8: Arjun A Raju folded before Flop (didn't bet)
Seat 9: alhill86 (button) folded before Flop (didn't bet)





PokerStars Hand #155380355725:  Hold'em No Limit ($0.50/$1.00 USD) - 2016/06/30 14:02:42 CET [2016/06/30 8:02:42 ET]
Table 'Tatjana' 9-max Seat #5 is the button
Seat 2: DIMAN_324 ($100 in chips) 
Seat 3: Rafaello18 ($102.79 in chips) 
Seat 4: mopatron25 ($129.62 in chips) 
Seat 5: matiko09 ($100 in chips) 
Seat 6: mbk88 ($146.52 in chips) 
Seat 7: daigodisco ($36.63 in chips) 
Seat 9: POTAPENKO700 ($239.71 in chips) 
mbk88: posts small blind $0.50
daigodisco: posts big blind $1
alhill86: sits out 
tipner: sits out 
*** HOLE CARDS ***
Dealt to matiko09 [6h 7d]
POTAPENKO700: folds 
DIMAN_324: folds 
Rafaello18: folds 
mopatron25: calls $1
matiko09: folds 
mbk88: folds 
daigodisco: checks 
*** FLOP *** [Th Ts 9d]
daigodisco: bets $1
mopatron25: calls $1
*** TURN *** [Th Ts 9d] [8h]
daigodisco: bets $2.14
mopatron25: calls $2.14
*** RIVER *** [Th Ts 9d 8h] [7s]
daigodisco: bets $8.34
mopatron25: calls $8.34
*** SHOW DOWN ***
daigodisco: shows [6s 8d] (a straight, Six to Ten)
mopatron25: mucks hand 
daigodisco collected $24.19 from pot
*** SUMMARY ***
Total pot $25.46 | Rake $1.27 
Board [Th Ts 9d 8h 7s]
Seat 2: DIMAN_324 folded before Flop (didn't bet)
Seat 3: Rafaello18 folded before Flop (didn't bet)
Seat 4: mopatron25 mucked [9c Qs]
Seat 5: matiko09 (button) folded before Flop (didn't bet)
Seat 6: mbk88 (small blind) folded before Flop
Seat 7: daigodisco (big blind) showed [6s 8d] and won ($24.19) with a straight, Six to Ten
Seat 9: POTAPENKO700 folded before Flop (didn't bet)





PokerStars Hand #155380360026:  Hold'em No Limit ($0.25/$0.50 USD) - 2016/06/30 14:02:52 CET [2016/06/30 8:02:52 ET]
Table 'Mentha II' 9-max Seat #8 is the button
Seat 1: fudzi ($50 in chips) 
Seat 2: TheMinion ($56.39 in chips) 
Seat 3: joker180785 ($50 in chips) 
Seat 4: Chanelado ($39.30 in chips) 
Seat 5: kotkas1000 ($50 in chips) 
Seat 6: Alexey_Kim2 ($53.16 in chips) 
Seat 8: Clifftastic ($43.92 in chips) 
Seat 9: matiko09 ($101.70 in chips) 
matiko09: posts small blind $0.25
fudzi: posts big blind $0.50
ivan100886: sits out 
fudzi: posts the ante $0.10
TheMinion: posts the ante $0.10
joker180785: posts the ante $0.10
Chanelado: posts the ante $0.10
kotkas1000: posts the ante $0.10
Alexey_Kim2: posts the ante $0.10
Clifftastic: posts the ante $0.10
matiko09: posts the ante $0.10
*** HOLE CARDS ***
Dealt to matiko09 [4h 7d]
TheMinion: folds 
joker180785: folds 
Chanelado: raises $0.50 to $1
kotkas1000: folds 
Alexey_Kim2: folds 
Clifftastic: calls $1
matiko09: folds 
fudzi: folds 
*** FLOP *** [2h 5c Ts]
Chanelado: bets $1.50
Clifftastic: calls $1.50
*** TURN *** [2h 5c Ts] [7h]
Chanelado: bets $2.50
Clifftastic: folds 
Uncalled bet ($2.50) returned to Chanelado
Chanelado collected $6.22 from pot
Chanelado: doesn't show hand 
*** SUMMARY ***
Total pot $6.55 | Rake $0.33 
Board [2h 5c Ts 7h]
Seat 1: fudzi (big blind) folded before Flop
Seat 2: TheMinion folded before Flop (didn't bet)
Seat 3: joker180785 folded before Flop (didn't bet)
Seat 4: Chanelado collected ($6.22)
Seat 5: kotkas1000 folded before Flop (didn't bet)
Seat 6: Alexey_Kim2 folded before Flop (didn't bet)
Seat 8: Clifftastic (button) folded on the Turn
Seat 9: matiko09 (small blind) folded before Flop





PokerStars Hand #155380362749:  Hold'em No Limit ($0.25/$0.50 USD) - 2016/06/30 14:02:58 CET [2016/06/30 8:02:58 ET]
Table 'Arcturus' 9-max Seat #1 is the button
Seat 1: kourk250 ($122.57 in chips) 
Seat 3: matiko09 ($50 in chips) 
Seat 5: stockbridge8 ($46 in chips) 
Seat 6: statistik85 ($59.19 in chips) 
Seat 7: DaikenGF ($66.51 in chips) 
Seat 8: TheMinion ($62.96 in chips) 
Seat 9: pfunkolstar ($54.25 in chips) 
matiko09: posts small blind $0.25
stockbridge8: posts big blind $0.50
*** HOLE CARDS ***
Dealt to matiko09 [Ts Tc]
statistik85: folds 
DaikenGF: folds 
TheMinion: folds 
pfunkolstar: folds 
kourk250: raises $0.50 to $1
matiko09: raises $3 to $4
stockbridge8: folds 
maxxmeister leaves the table
kourk250: calls $3
*** FLOP *** [As 3h 3c]
matiko09: checks 
kourk250: checks 
*** TURN *** [As 3h 3c] [5h]
sanr23 joins the table at seat #4 
matiko09: bets $3
kourk250: calls $3
*** RIVER *** [As 3h 3c 5h] [7s]
matiko09: checks 
sanr23 leaves the table
kourk250: bets $7
Vedpapa joins the table at seat #4 
matiko09: folds 
Uncalled bet ($7) returned to kourk250
kourk250 collected $13.78 from pot
kourk250: doesn't show hand 
*** SUMMARY ***
Total pot $14.50 | Rake $0.72 
Board [As 3h 3c 5h 7s]
Seat 1: kourk250 (button) collected ($13.78)
Seat 3: matiko09 (small blind) folded on the River
Seat 5: stockbridge8 (big blind) folded before Flop
Seat 6: statistik85 folded before Flop (didn't bet)
Seat 7: DaikenGF folded before Flop (didn't bet)
Seat 8: TheMinion folded before Flop (didn't bet)
Seat 9: pfunkolstar folded before Flop (didn't bet)





PokerStars Hand #155380362679:  Hold'em No Limit ($0.50/$1.00 USD) - 2016/06/30 14:02:58 CET [2016/06/30 8:02:58 ET]
Table 'Borrelly II' 9-max Seat #2 is the button
Seat 2: mbk88 ($106.50 in chips) 
Seat 3: di0d80 ($108.52 in chips) 
Seat 4: DonRon_AT ($41.49 in chips) 
Seat 5: DIMAN_324 ($100 in chips) 
Seat 6: m_michalec ($172.06 in chips) 
Seat 7: matiko09 ($176.36 in chips) 
Seat 8: Arjun A Raju ($124.64 in chips) 
Seat 9: alhill86 ($72.50 in chips) 
di0d80: posts small blind $0.50
DonRon_AT: posts big blind $1
*** HOLE CARDS ***
Dealt to matiko09 [2d 3d]
DIMAN_324: folds 
m_michalec: folds 
matiko09: folds 
Arjun A Raju: folds 
alhill86: folds 
mbk88: folds 
di0d80: raises $2 to $3
DonRon_AT: calls $2
*** FLOP *** [Qs 8d 8c]
di0d80: checks 
DonRon_AT: bets $3
di0d80: folds 
Uncalled bet ($3) returned to DonRon_AT
DonRon_AT collected $5.70 from pot
*** SUMMARY ***
Total pot $6 | Rake $0.30 
Board [Qs 8d 8c]
Seat 2: mbk88 (button) folded before Flop (didn't bet)
Seat 3: di0d80 (small blind) folded on the Flop
Seat 4: DonRon_AT (big blind) collected ($5.70)
Seat 5: DIMAN_324 folded before Flop (didn't bet)
Seat 6: m_michalec folded before Flop (didn't bet)
Seat 7: matiko09 folded before Flop (didn't bet)
Seat 8: Arjun A Raju folded before Flop (didn't bet)
Seat 9: alhill86 folded before Flop (didn't bet)





PokerStars Hand #155380364178:  Hold'em No Limit ($0.50/$1.00 USD) - 2016/06/30 14:03:01 CET [2016/06/30 8:03:01 ET]
Table 'California II' 9-max Seat #5 is the button
Seat 1: Rafaello18 ($110.02 in chips) 
Seat 2: velourleder ($56.94 in chips) 
Seat 3: KovIFish89 ($100 in chips) 
Seat 4: mbk88 ($181.42 in chips) 
Seat 5: Rohitbarve ($96.49 in chips) 
Seat 6: matiko09 ($100 in chips) 
Seat 7: DomiVY ($84.20 in chips) 
Seat 8: picka4u ($159.61 in chips) 
Seat 9: di0d80 ($100 in chips) 
matiko09: posts small blind $0.50
DomiVY: posts big blind $1
*** HOLE CARDS ***
Dealt to matiko09 [Kh Jh]
picka4u: folds 
di0d80: folds 
Rafaello18: raises $1.50 to $2.50
velourleder: folds 
KovIFish89: folds 
mbk88: folds 
Rohitbarve: raises $6.50 to $9
matiko09: folds 
DomiVY: folds 
Rafaello18: calls $6.50
*** FLOP *** [Ah 9d 8c]
Rafaello18: checks 
Rohitbarve: checks 
*** TURN *** [Ah 9d 8c] [3d]
Rafaello18: checks 
Rohitbarve: bets $9.26
Rafaello18: folds 
Uncalled bet ($9.26) returned to Rohitbarve
Rohitbarve collected $18.52 from pot
Rohitbarve: doesn't show hand 
*** SUMMARY ***
Total pot $19.50 | Rake $0.98 
Board [Ah 9d 8c 3d]
Seat 1: Rafaello18 folded on the Turn
Seat 2: velourleder folded before Flop (didn't bet)
Seat 3: KovIFish89 folded before Flop (didn't bet)
Seat 4: mbk88 folded before Flop (didn't bet)
Seat 5: Rohitbarve (button) collected ($18.52)
Seat 6: matiko09 (small blind) folded before Flop
Seat 7: DomiVY (big blind) folded before Flop
Seat 8: picka4u folded before Flop (didn't bet)
Seat 9: di0d80 folded before Flop (didn't bet)





PokerStars Hand #155380371995:  Hold'em No Limit ($0.50/$1.00 USD) - 2016/06/30 14:03:19 CET [2016/06/30 8:03:19 ET]
Table 'Prieska' 9-max Seat #8 is the button
Seat 1: KovIFish89 ($120.09 in chips) 
Seat 2: B_style_cuz ($103.43 in chips) 
Seat 3: Rafaello18 ($117.50 in chips) 
Seat 4: nickreason17 ($100 in chips) 
Seat 5: ramzes160468 ($77.30 in chips) 
Seat 6: Ty Nick 420 ($106.82 in chips) 
Seat 7: matiko09 ($106.02 in chips) 
Seat 8: mbk88 ($122.95 in chips) 
Seat 9: Konig26 ($90.26 in chips) 
Konig26: posts small blind $0.50
KovIFish89: posts big blind $1
*** HOLE CARDS ***
Dealt to matiko09 [3d 6d]
B_style_cuz: folds 
Rafaello18: folds 
nickreason17: folds 
ramzes160468: folds 
Ty Nick 420: folds 
matiko09: folds 
mbk88: raises $1.02 to $2.02
Konig26: calls $1.52
KovIFish89: calls $1.02
*** FLOP *** [Kh 4h Ks]
Konig26: checks 
KovIFish89: checks 
mbk88: bets $3
Konig26: folds 
KovIFish89: folds 
Uncalled bet ($3) returned to mbk88
mbk88 collected $5.76 from pot
mbk88: doesn't show hand 
*** SUMMARY ***
Total pot $6.06 | Rake $0.30 
Board [Kh 4h Ks]
Seat 1: KovIFish89 (big blind) folded on the Flop
Seat 2: B_style_cuz folded before Flop (didn't bet)
Seat 3: Rafaello18 folded before Flop (didn't bet)
Seat 4: nickreason17 folded before Flop (didn't bet)
Seat 5: ramzes160468 folded before Flop (didn't bet)
Seat 6: Ty Nick 420 folded before Flop (didn't bet)
Seat 7: matiko09 folded before Flop (didn't bet)
Seat 8: mbk88 (button) collected ($5.76)
Seat 9: Konig26 (small blind) folded on the Flop





PokerStars Hand #155380372845:  Hold'em No Limit ($0.50/$1.00 USD) - 2016/06/30 14:03:21 CET [2016/06/30 8:03:21 ET]
Table 'Altarf II' 9-max Seat #6 is the button
Seat 1: Rafaello18 ($100 in chips) 
Seat 2: KovIFish89 ($100 in chips) 
Seat 3: sanr23 ($168.71 in chips) 
Seat 4: Greha999 ($73.66 in chips) 
Seat 5: DIMAN_324 ($229.74 in chips) 
Seat 6: mbk88 ($100 in chips) 
Seat 7: matiko09 ($105.40 in chips) 
Seat 8: DomiVY ($40 in chips) 
Seat 9: omanibemihum ($130.55 in chips) 
matiko09: posts small blind $0.50
DomiVY: posts big blind $1
*** HOLE CARDS ***
Dealt to matiko09 [9c Kd]
omanibemihum: folds 
Rafaello18: folds 
KovIFish89: folds 
sanr23: folds 
Greha999: raises $1 to $2
DIMAN_324: folds 
mbk88: folds 
matiko09: folds 
DomiVY: folds 
Uncalled bet ($1) returned to Greha999
Greha999 collected $2.50 from pot
*** SUMMARY ***
Total pot $2.50 | Rake $0 
Seat 1: Rafaello18 folded before Flop (didn't bet)
Seat 2: KovIFish89 folded before Flop (didn't bet)
Seat 3: sanr23 folded before Flop (didn't bet)
Seat 4: Greha999 collected ($2.50)
Seat 5: DIMAN_324 folded before Flop (didn't bet)
Seat 6: mbk88 (button) folded before Flop (didn't bet)
Seat 7: matiko09 (small blind) folded before Flop
Seat 8: DomiVY (big blind) folded before Flop
Seat 9: omanibemihum folded before Flop (didn't bet)





PokerStars Hand #155380375831:  Hold'em No Limit ($0.25/$0.50 USD) - 2016/06/30 14:03:28 CET [2016/06/30 8:03:28 ET]
Table 'Dorothea II' 9-max Seat #9 is the button
Seat 1: zapata 7777 ($83.73 in chips) 
Seat 2: joker180785 ($50 in chips) 
Seat 3: Franky77200 ($31.76 in chips) 
Seat 4: matiko09 ($136.30 in chips) 
Seat 5: Bailey Dew ($86 in chips) 
Seat 6: ivan100886 ($38.86 in chips) 
Seat 7: desmo465 ($58.14 in chips) 
Seat 8: TheMinion ($50 in chips) 
Seat 9: funXmun ($50 in chips) 
zapata 7777: posts small blind $0.25
joker180785: posts big blind $0.50
zapata 7777: posts the ante $0.10
joker180785: posts the ante $0.10
Franky77200: posts the ante $0.10
matiko09: posts the ante $0.10
Bailey Dew: posts the ante $0.10
ivan100886: posts the ante $0.10
desmo465: posts the ante $0.10
TheMinion: posts the ante $0.10
funXmun: posts the ante $0.10
*** HOLE CARDS ***
Dealt to matiko09 [Ah Tc]
Franky77200: calls $0.50
matiko09: raises $2 to $2.50
Bailey Dew: folds 
ivan100886: folds 
desmo465: folds 
TheMinion: folds 
funXmun: folds 
zapata 7777: folds 
joker180785: folds 
Franky77200: calls $2
*** FLOP *** [Th 5c 4c]
Franky77200: checks 
matiko09: bets $5.11
Franky77200: calls $5.11
*** TURN *** [Th 5c 4c] [6c]
Franky77200: bets $24.05 and is all-in
matiko09: calls $24.05
*** RIVER *** [Th 5c 4c 6c] [9s]
*** SHOW DOWN ***
Franky77200: shows [5h As] (a pair of Fives)
matiko09: shows [Ah Tc] (a pair of Tens)
matiko09 collected $62.97 from pot
*** SUMMARY ***
Total pot $64.97 | Rake $2 
Board [Th 5c 4c 6c 9s]
Seat 1: zapata 7777 (small blind) folded before Flop
Seat 2: joker180785 (big blind) folded before Flop
Seat 3: Franky77200 showed [5h As] and lost with a pair of Fives
Seat 4: matiko09 showed [Ah Tc] and won ($62.97) with a pair of Tens
Seat 5: Bailey Dew folded before Flop (didn't bet)
Seat 6: ivan100886 folded before Flop (didn't bet)
Seat 7: desmo465 folded before Flop (didn't bet)
Seat 8: TheMinion folded before Flop (didn't bet)
Seat 9: funXmun (button) folded before Flop (didn't bet)





PokerStars Hand #155380377237:  Hold'em No Limit ($0.50/$1.00 USD) - 2016/06/30 14:03:31 CET [2016/06/30 8:03:31 ET]
Table 'Sigrid' 9-max Seat #2 is the button
Seat 1: Greha999 ($62.32 in chips) 
Seat 2: matiko09 ($105.52 in chips) 
Seat 4: mbk88 ($121.37 in chips) 
Seat 5: DIMAN_324 ($103.58 in chips) 
Seat 6: di0d80 ($112.99 in chips) 
Seat 8: nickreason17 ($115.30 in chips) 
Seat 9: KovIFish89 ($101.50 in chips) 
mbk88: posts small blind $0.50
DIMAN_324: posts big blind $1
arctur17: sits out 
*** HOLE CARDS ***
Dealt to matiko09 [9s 6s]
di0d80: folds 
nickreason17: folds 
KovIFish89: raises $2 to $3
Greha999: folds 
matiko09: folds 
mbk88: folds 
DIMAN_324: calls $2
*** FLOP *** [8h Ts 9c]
DIMAN_324: checks 
KovIFish89: bets $4
DIMAN_324: calls $4
*** TURN *** [8h Ts 9c] [9d]
DIMAN_324: checks 
KovIFish89: bets $9.18
DIMAN_324: folds 
Uncalled bet ($9.18) returned to KovIFish89
KovIFish89 collected $13.78 from pot
KovIFish89: doesn't show hand 
*** SUMMARY ***
Total pot $14.50 | Rake $0.72 
Board [8h Ts 9c 9d]
Seat 1: Greha999 folded before Flop (didn't bet)
Seat 2: matiko09 (button) folded before Flop (didn't bet)
Seat 4: mbk88 (small blind) folded before Flop
Seat 5: DIMAN_324 (big blind) folded on the Turn
Seat 6: di0d80 folded before Flop (didn't bet)
Seat 8: nickreason17 folded before Flop (didn't bet)
Seat 9: KovIFish89 collected ($13.78)





PokerStars Hand #155380383800:  Hold'em No Limit ($0.50/$1.00 USD) - 2016/06/30 14:03:46 CET [2016/06/30 8:03:46 ET]
Table 'Borrelly II' 9-max Seat #3 is the button
Seat 2: mbk88 ($106.50 in chips) 
Seat 3: di0d80 ($105.52 in chips) 
Seat 4: DonRon_AT ($44.19 in chips) 
Seat 5: DIMAN_324 ($100 in chips) 
Seat 6: m_michalec ($172.06 in chips) 
Seat 7: matiko09 ($176.36 in chips) 
Seat 8: Arjun A Raju ($124.64 in chips) 
Seat 9: alhill86 ($72.50 in chips) 
DonRon_AT: posts small blind $0.50
DIMAN_324: posts big blind $1
*** HOLE CARDS ***
Dealt to matiko09 [5h 4h]
m_michalec: folds 
matiko09: folds 
Arjun A Raju: folds 
alhill86: folds 
mbk88: folds 
di0d80: folds 
DonRon_AT: calls $0.50
DIMAN_324: checks 
*** FLOP *** [6d As 3s]
DonRon_AT: checks 
DIMAN_324: checks 
*** TURN *** [6d As 3s] [3h]
DonRon_AT: checks 
DIMAN_324: checks 
*** RIVER *** [6d As 3s 3h] [Ah]
DonRon_AT: checks 
DIMAN_324: checks 
*** SHOW DOWN ***
DonRon_AT: shows [8c 7c] (two pair, Aces and Threes)
DIMAN_324: shows [7h 9c] (two pair, Aces and Threes - Nine kicker)
DIMAN_324 collected $1.90 from pot
*** SUMMARY ***
Total pot $2 | Rake $0.10 
Board [6d As 3s 3h Ah]
Seat 2: mbk88 folded before Flop (didn't bet)
Seat 3: di0d80 (button) folded before Flop (didn't bet)
Seat 4: DonRon_AT (small blind) showed [8c 7c] and lost with two pair, Aces and Threes
Seat 5: DIMAN_324 (big blind) showed [7h 9c] and won ($1.90) with two pair, Aces and Threes
Seat 6: m_michalec folded before Flop (didn't bet)
Seat 7: matiko09 folded before Flop (didn't bet)
Seat 8: Arjun A Raju folded before Flop (didn't bet)
Seat 9: alhill86 folded before Flop (didn't bet)





PokerStars Hand #155380385784:  Hold'em No Limit ($0.50/$1.00 USD) - 2016/06/30 14:03:50 CET [2016/06/30 8:03:50 ET]
Table 'Altarf II' 9-max Seat #7 is the button
Seat 1: Rafaello18 ($100 in chips) 
Seat 2: KovIFish89 ($100 in chips) 
Seat 3: sanr23 ($168.71 in chips) 
Seat 4: Greha999 ($75.16 in chips) 
Seat 5: DIMAN_324 ($229.74 in chips) 
Seat 6: mbk88 ($100 in chips) 
Seat 7: matiko09 ($104.90 in chips) 
Seat 8: DomiVY ($40 in chips) 
Seat 9: omanibemihum ($130.55 in chips) 
DomiVY: posts small blind $0.50
omanibemihum: posts big blind $1
*** HOLE CARDS ***
Dealt to matiko09 [7s 6d]
Rafaello18: folds 
KovIFish89: folds 
sanr23: folds 
Greha999: folds 
DIMAN_324: folds 
mbk88: folds 
matiko09: folds 
DomiVY: raises $1.10 to $2.10
omanibemihum: calls $1.10
*** FLOP *** [7h Ks Jd]
DomiVY: bets $3
omanibemihum: folds 
Uncalled bet ($3) returned to DomiVY
DomiVY collected $3.99 from pot
DomiVY: doesn't show hand 
*** SUMMARY ***
Total pot $4.20 | Rake $0.21 
Board [7h Ks Jd]
Seat 1: Rafaello18 folded before Flop (didn't bet)
Seat 2: KovIFish89 folded before Flop (didn't bet)
Seat 3: sanr23 folded before Flop (didn't bet)
Seat 4: Greha999 folded before Flop (didn't bet)
Seat 5: DIMAN_324 folded before Flop (didn't bet)
Seat 6: mbk88 folded before Flop (didn't bet)
Seat 7: matiko09 (button) folded before Flop (didn't bet)
Seat 8: DomiVY (small blind) collected ($3.99)
Seat 9: omanibemihum (big blind) folded on the Flop





PokerStars Hand #155380386845:  Hold'em No Limit ($0.25/$0.50 USD) - 2016/06/30 14:03:52 CET [2016/06/30 8:03:52 ET]
Table 'Arcturus' 9-max Seat #3 is the button
Seat 1: kourk250 ($129.35 in chips) 
Seat 3: matiko09 ($50 in chips) 
Seat 5: stockbridge8 ($45.50 in chips) 
Seat 6: statistik85 ($59.19 in chips) 
Seat 7: DaikenGF ($66.51 in chips) 
Seat 8: TheMinion ($62.96 in chips) 
Seat 9: pfunkolstar ($54.25 in chips) 
Vedpapa will be allowed to play after the button
stockbridge8: posts small blind $0.25
statistik85: posts big blind $0.50
*** HOLE CARDS ***
Dealt to matiko09 [Ah Ks]
DaikenGF: folds 
TheMinion: folds 
pfunkolstar: folds 
kourk250: raises $0.50 to $1
matiko09: raises $3 to $4
stockbridge8: folds 
statistik85: folds 
kourk250: calls $3
*** FLOP *** [Ac 2s 6s]
kourk250: checks 
matiko09: bets $5.40
kourk250: folds 
Uncalled bet ($5.40) returned to matiko09
matiko09 collected $8.31 from pot
matiko09: doesn't show hand 
*** SUMMARY ***
Total pot $8.75 | Rake $0.44 
Board [Ac 2s 6s]
Seat 1: kourk250 folded on the Flop
Seat 3: matiko09 (button) collected ($8.31)
Seat 5: stockbridge8 (small blind) folded before Flop
Seat 6: statistik85 (big blind) folded before Flop
Seat 7: DaikenGF folded before Flop (didn't bet)
Seat 8: TheMinion folded before Flop (didn't bet)
Seat 9: pfunkolstar folded before Flop (didn't bet)





PokerStars Hand #155380387843:  Hold'em No Limit ($0.50/$1.00 USD) - 2016/06/30 14:03:54 CET [2016/06/30 8:03:54 ET]
Table 'Tatjana' 9-max Seat #6 is the button
Seat 2: DIMAN_324 ($100 in chips) 
Seat 3: Rafaello18 ($102.79 in chips) 
Seat 4: mopatron25 ($117.14 in chips) 
Seat 5: matiko09 ($100 in chips) 
Seat 6: mbk88 ($146.02 in chips) 
Seat 7: daigodisco ($48.34 in chips) 
Seat 8: alhill86 ($80.34 in chips) 
Seat 9: POTAPENKO700 ($239.71 in chips) 
daigodisco: posts small blind $0.50
alhill86: posts big blind $1
tipner: sits out 
*** HOLE CARDS ***
Dealt to matiko09 [5c Td]
POTAPENKO700: folds 
DIMAN_324: folds 
Rafaello18: folds 
mopatron25: calls $1
matiko09: folds 
mbk88: raises $3 to $4
daigodisco: folds 
alhill86: folds 
mopatron25: calls $3
*** FLOP *** [7d Ac Qs]
mopatron25: bets $1
mbk88: raises $4 to $5
mopatron25: folds 
Uncalled bet ($4) returned to mbk88
mbk88 collected $10.92 from pot
mbk88: doesn't show hand 
*** SUMMARY ***
Total pot $11.50 | Rake $0.58 
Board [7d Ac Qs]
Seat 2: DIMAN_324 folded before Flop (didn't bet)
Seat 3: Rafaello18 folded before Flop (didn't bet)
Seat 4: mopatron25 folded on the Flop
Seat 5: matiko09 folded before Flop (didn't bet)
Seat 6: mbk88 (button) collected ($10.92)
Seat 7: daigodisco (small blind) folded before Flop
Seat 8: alhill86 (big blind) folded before Flop
Seat 9: POTAPENKO700 folded before Flop (didn't bet)





PokerStars Hand #155380391530:  Hold'em No Limit ($0.50/$1.00 USD) - 2016/06/30 14:04:02 CET [2016/06/30 8:04:02 ET]
Table 'California II' 9-max Seat #6 is the button
Seat 1: Rafaello18 ($101.02 in chips) 
Seat 2: velourleder ($56.94 in chips) 
Seat 3: KovIFish89 ($100 in chips) 
Seat 4: mbk88 ($181.42 in chips) 
Seat 5: Rohitbarve ($106.01 in chips) 
Seat 6: matiko09 ($100 in chips) 
Seat 7: DomiVY ($83.20 in chips) 
Seat 8: picka4u ($159.61 in chips) 
Seat 9: di0d80 ($100 in chips) 
DomiVY: posts small blind $0.50
picka4u: posts big blind $1
*** HOLE CARDS ***
Dealt to matiko09 [5d Kh]
di0d80: folds 
Rafaello18: folds 
velourleder: calls $1
KovIFish89: folds 
mbk88: folds 
Rohitbarve: folds 
matiko09: folds 
DomiVY: folds 
picka4u: raises $3 to $4
velourleder: calls $3
*** FLOP *** [5c Kc 4d]
picka4u: bets $4.50
velourleder: folds 
Uncalled bet ($4.50) returned to picka4u
picka4u collected $8.08 from pot
picka4u: doesn't show hand 
*** SUMMARY ***
Total pot $8.50 | Rake $0.42 
Board [5c Kc 4d]
Seat 1: Rafaello18 folded before Flop (didn't bet)
Seat 2: velourleder folded on the Flop
Seat 3: KovIFish89 folded before Flop (didn't bet)
Seat 4: mbk88 folded before Flop (didn't bet)
Seat 5: Rohitbarve folded before Flop (didn't bet)
Seat 6: matiko09 (button) folded before Flop (didn't bet)
Seat 7: DomiVY (small blind) folded before Flop
Seat 8: picka4u (big blind) collected ($8.08)
Seat 9: di0d80 folded before Flop (didn't bet)





PokerStars Hand #155380391587:  Hold'em No Limit ($0.50/$1.00 USD) - 2016/06/30 14:04:03 CET [2016/06/30 8:04:03 ET]
Table 'Prieska' 9-max Seat #9 is the button
Seat 1: KovIFish89 ($118.07 in chips) 
Seat 2: B_style_cuz ($103.43 in chips) 
Seat 3: Rafaello18 ($117.50 in chips) 
Seat 4: nickreason17 ($100 in chips) 
Seat 5: ramzes160468 ($77.30 in chips) 
Seat 6: Ty Nick 420 ($106.82 in chips) 
Seat 7: matiko09 ($106.02 in chips) 
Seat 8: mbk88 ($126.69 in chips) 
Seat 9: Konig26 ($88.24 in chips) 
KovIFish89: posts small blind $0.50
B_style_cuz: posts big blind $1
*** HOLE CARDS ***
Dealt to matiko09 [4c 2s]
Rafaello18: folds 
nickreason17: folds 
ramzes160468: raises $2 to $3
Ty Nick 420: calls $3
matiko09: folds 
mbk88: folds 
Konig26: calls $3
KovIFish89: calls $2.50
B_style_cuz: calls $2
*** FLOP *** [4h Ks Qs]
KovIFish89: checks 
B_style_cuz: checks 
ramzes160468: bets $8
Ty Nick 420: folds 
Konig26: folds 
KovIFish89: folds 
B_style_cuz: folds 
Uncalled bet ($8) returned to ramzes160468
ramzes160468 collected $14.25 from pot
*** SUMMARY ***
Total pot $15 | Rake $0.75 
Board [4h Ks Qs]
Seat 1: KovIFish89 (small blind) folded on the Flop
Seat 2: B_style_cuz (big blind) folded on the Flop
Seat 3: Rafaello18 folded before Flop (didn't bet)
Seat 4: nickreason17 folded before Flop (didn't bet)
Seat 5: ramzes160468 collected ($14.25)
Seat 6: Ty Nick 420 folded on the Flop
Seat 7: matiko09 folded before Flop (didn't bet)
Seat 8: mbk88 folded before Flop (didn't bet)
Seat 9: Konig26 (button) folded on the Flop





PokerStars Hand #155380393034:  Hold'em No Limit ($0.50/$1.00 USD) - 2016/06/30 14:04:06 CET [2016/06/30 8:04:06 ET]
Table 'Asmodeus' 9-max Seat #9 is the button
Seat 1: scollop ($123.75 in chips) 
Seat 2: picka4u ($39.50 in chips) 
Seat 3: matiko09 ($106.91 in chips) 
Seat 5: sanr23 ($110.30 in chips) 
Seat 6: koutani7 ($96.28 in chips) 
Seat 7: aaronzzr ($138.33 in chips) 
Seat 9: mbk88 ($157.36 in chips) 
scollop: posts small blind $0.50
picka4u: posts big blind $1
DIMAN_324: sits out 
*** HOLE CARDS ***
Dealt to matiko09 [7h 8s]
matiko09: folds 
sanr23: folds 
koutani7 has timed out
koutani7: folds 
aaronzzr: folds 
mbk88: raises $1.02 to $2.02
scollop: folds 
picka4u: folds 
Uncalled bet ($1.02) returned to mbk88
mbk88 collected $2.50 from pot
mbk88: doesn't show hand 
*** SUMMARY ***
Total pot $2.50 | Rake $0 
Seat 1: scollop (small blind) folded before Flop
Seat 2: picka4u (big blind) folded before Flop
Seat 3: matiko09 folded before Flop (didn't bet)
Seat 5: sanr23 folded before Flop (didn't bet)
Seat 6: koutani7 folded before Flop (didn't bet)
Seat 7: aaronzzr folded before Flop (didn't bet)
Seat 9: mbk88 (button) collected ($2.50)





PokerStars Hand #155380397197:  Hold'em No Limit ($0.25/$0.50 USD) - 2016/06/30 14:04:15 CET [2016/06/30 8:04:15 ET]
Table 'Mentha II' 9-max Seat #9 is the button
Seat 1: fudzi ($50 in chips) 
Seat 2: TheMinion ($56.29 in chips) 
Seat 3: joker180785 ($50 in chips) 
Seat 4: Chanelado ($42.92 in chips) 
Seat 5: kotkas1000 ($50 in chips) 
Seat 6: Alexey_Kim2 ($53.06 in chips) 
Seat 8: Clifftastic ($41.32 in chips) 
Seat 9: matiko09 ($101.35 in chips) 
fudzi: posts small blind $0.25
TheMinion: posts big blind $0.50
ivan100886: sits out 
fudzi: posts the ante $0.10
TheMinion: posts the ante $0.10
joker180785: posts the ante $0.10
Chanelado: posts the ante $0.10
kotkas1000: posts the ante $0.10
Alexey_Kim2: posts the ante $0.10
Clifftastic: posts the ante $0.10
matiko09: posts the ante $0.10
*** HOLE CARDS ***
Dealt to matiko09 [Th Jc]
joker180785: folds 
Chanelado: folds 
kotkas1000: folds 
Alexey_Kim2: folds 
Clifftastic: folds 
matiko09: raises $0.63 to $1.13
fudzi: folds 
TheMinion: calls $0.63
*** FLOP *** [3h Ac 4h]
TheMinion: checks 
matiko09: checks 
*** TURN *** [3h Ac 4h] [7c]
TheMinion: bets $2.06
matiko09: folds 
Uncalled bet ($2.06) returned to TheMinion
TheMinion collected $3.14 from pot
TheMinion: doesn't show hand 
*** SUMMARY ***
Total pot $3.31 | Rake $0.17 
Board [3h Ac 4h 7c]
Seat 1: fudzi (small blind) folded before Flop
Seat 2: TheMinion (big blind) collected ($3.14)
Seat 3: joker180785 folded before Flop (didn't bet)
Seat 4: Chanelado folded before Flop (didn't bet)
Seat 5: kotkas1000 folded before Flop (didn't bet)
Seat 6: Alexey_Kim2 folded before Flop (didn't bet)
Seat 8: Clifftastic folded before Flop (didn't bet)
Seat 9: matiko09 (button) folded on the Turn





PokerStars Hand #155380400206:  Hold'em No Limit ($0.25/$0.50 USD) - 2016/06/30 14:04:22 CET [2016/06/30 8:04:22 ET]
Table 'Arcturus' 9-max Seat #5 is the button
Seat 1: kourk250 ($125.35 in chips) 
Seat 3: matiko09 ($54.31 in chips) 
Seat 5: stockbridge8 ($45.25 in chips) 
Seat 6: statistik85 ($58.69 in chips) 
Seat 7: DaikenGF ($66.51 in chips) 
Seat 8: TheMinion ($62.96 in chips) 
Seat 9: pfunkolstar ($54.25 in chips) 
statistik85: posts small blind $0.25
DaikenGF: posts big blind $0.50
Vedpapa: sits out 
*** HOLE CARDS ***
Dealt to matiko09 [7s 2h]
TheMinion: folds 
pfunkolstar: folds 
kourk250: folds 
matiko09: folds 
stockbridge8: folds 
statistik85: calls $0.25
DaikenGF: checks 
*** FLOP *** [8h Ah 4d]
statistik85: checks 
DaikenGF: bets $0.50
statistik85: raises $1.50 to $2
DaikenGF: folds 
Uncalled bet ($1.50) returned to statistik85
statistik85 collected $1.90 from pot
statistik85: doesn't show hand 
*** SUMMARY ***
Total pot $2 | Rake $0.10 
Board [8h Ah 4d]
Seat 1: kourk250 folded before Flop (didn't bet)
Seat 3: matiko09 folded before Flop (didn't bet)
Seat 5: stockbridge8 (button) folded before Flop (didn't bet)
Seat 6: statistik85 (small blind) collected ($1.90)
Seat 7: DaikenGF (big blind) folded on the Flop
Seat 8: TheMinion folded before Flop (didn't bet)
Seat 9: pfunkolstar folded before Flop (didn't bet)





PokerStars Hand #155380401415:  Hold'em No Limit ($0.25/$0.50 USD) - 2016/06/30 14:04:25 CET [2016/06/30 8:04:25 ET]
Table 'Elektra II' 9-max Seat #1 is the button
Seat 1: drlee77 ($48.03 in chips) 
Seat 2: TheMinion ($61.07 in chips) 
Seat 3: mojtabagol ($82.24 in chips) 
Seat 4: matiko09 ($51.72 in chips) 
Seat 5: Rafaello18 ($57.24 in chips) 
Seat 6: pfunkolstar ($50 in chips) 
Seat 7: MuddyDance ($50 in chips) 
Seat 8: sanr23 ($56.25 in chips) 
Seat 9: KABAL_ua ($53.45 in chips) 
TheMinion: posts small blind $0.25
mojtabagol: posts big blind $0.50
*** HOLE CARDS ***
Dealt to matiko09 [2s 9c]
matiko09: folds 
Rafaello18: folds 
pfunkolstar: folds 
MuddyDance: folds 
sanr23: folds 
KABAL_ua: raises $0.70 to $1.20
drlee77: folds 
TheMinion: folds 
mojtabagol: calls $0.70
*** FLOP *** [4c 5c 8d]
mojtabagol: checks 
KABAL_ua: bets $1.91
mojtabagol: folds 
Uncalled bet ($1.91) returned to KABAL_ua
KABAL_ua collected $2.52 from pot
KABAL_ua: doesn't show hand 
*** SUMMARY ***
Total pot $2.65 | Rake $0.13 
Board [4c 5c 8d]
Seat 1: drlee77 (button) folded before Flop (didn't bet)
Seat 2: TheMinion (small blind) folded before Flop
Seat 3: mojtabagol (big blind) folded on the Flop
Seat 4: matiko09 folded before Flop (didn't bet)
Seat 5: Rafaello18 folded before Flop (didn't bet)
Seat 6: pfunkolstar folded before Flop (didn't bet)
Seat 7: MuddyDance folded before Flop (didn't bet)
Seat 8: sanr23 folded before Flop (didn't bet)
Seat 9: KABAL_ua collected ($2.52)





PokerStars Hand #155380401699:  Hold'em No Limit ($0.50/$1.00 USD) - 2016/06/30 14:04:26 CET [2016/06/30 8:04:26 ET]
Table 'Sigrid' 9-max Seat #4 is the button
Seat 1: Greha999 ($62.32 in chips) 
Seat 2: matiko09 ($105.52 in chips) 
Seat 4: mbk88 ($120.87 in chips) 
Seat 5: DIMAN_324 ($100 in chips) 
Seat 6: di0d80 ($112.99 in chips) 
Seat 8: nickreason17 ($115.30 in chips) 
Seat 9: KovIFish89 ($108.28 in chips) 
DIMAN_324: posts small blind $0.50
di0d80: posts big blind $1
arctur17: sits out 
*** HOLE CARDS ***
Dealt to matiko09 [3d 4d]
nickreason17: folds 
KovIFish89: folds 
Greha999: raises $2 to $3
matiko09: folds 
mbk88: folds 
DIMAN_324: folds 
di0d80: raises $6 to $9
Greha999: calls $6
*** FLOP *** [5h 7d 8s]
di0d80: checks 
Greha999: bets $14
di0d80: folds 
Uncalled bet ($14) returned to Greha999
Greha999 collected $17.58 from pot
*** SUMMARY ***
Total pot $18.50 | Rake $0.92 
Board [5h 7d 8s]
Seat 1: Greha999 collected ($17.58)
Seat 2: matiko09 folded before Flop (didn't bet)
Seat 4: mbk88 (button) folded before Flop (didn't bet)
Seat 5: DIMAN_324 (small blind) folded before Flop
Seat 6: di0d80 (big blind) folded on the Flop
Seat 8: nickreason17 folded before Flop (didn't bet)
Seat 9: KovIFish89 folded before Flop (didn't bet)





PokerStars Hand #155380406320:  Hold'em No Limit ($0.25/$0.50 USD) - 2016/06/30 14:04:36 CET [2016/06/30 8:04:36 ET]
Table 'Dorothea II' 9-max Seat #1 is the button
Seat 1: zapata 7777 ($83.38 in chips) 
Seat 2: joker180785 ($50 in chips) 
Seat 4: matiko09 ($167.51 in chips) 
Seat 5: Bailey Dew ($85.90 in chips) 
Seat 6: ivan100886 ($38.76 in chips) 
Seat 7: desmo465 ($58.04 in chips) 
Seat 8: TheMinion ($50 in chips) 
Seat 9: funXmun ($50 in chips) 
joker180785: posts small blind $0.25
matiko09: posts big blind $0.50
zapata 7777: posts the ante $0.10
joker180785: posts the ante $0.10
matiko09: posts the ante $0.10
Bailey Dew: posts the ante $0.10
ivan100886: posts the ante $0.10
desmo465: posts the ante $0.10
TheMinion: posts the ante $0.10
funXmun: posts the ante $0.10
*** HOLE CARDS ***
Dealt to matiko09 [3s 8s]
Bailey Dew: folds 
Franky77200 leaves the table
ivan100886: folds 
desmo465: folds 
TheMinion: raises $1 to $1.50
funXmun: folds 
zapata 7777: calls $1.50
joker180785: folds 
matiko09: folds 
*** FLOP *** [6s 6c 4h]
TheMinion: checks 
zapata 7777: checks 
*** TURN *** [6s 6c 4h] [Tc]
TheMinion: bets $2
zapata 7777: calls $2
*** RIVER *** [6s 6c 4h Tc] [8d]
TheMinion: checks 
fudzi joins the table at seat #3 
zapata 7777: bets $3.57
TheMinion: folds 
Uncalled bet ($3.57) returned to zapata 7777
zapata 7777 collected $8.12 from pot
zapata 7777: doesn't show hand 
*** SUMMARY ***
Total pot $8.55 | Rake $0.43 
Board [6s 6c 4h Tc 8d]
Seat 1: zapata 7777 (button) collected ($8.12)
Seat 2: joker180785 (small blind) folded before Flop
Seat 4: matiko09 (big blind) folded before Flop
Seat 5: Bailey Dew folded before Flop (didn't bet)
Seat 6: ivan100886 folded before Flop (didn't bet)
Seat 7: desmo465 folded before Flop (didn't bet)
Seat 8: TheMinion folded on the River
Seat 9: funXmun folded before Flop (didn't bet)





PokerStars Hand #155380407508:  Hold'em No Limit ($0.50/$1.00 USD) - 2016/06/30 14:04:39 CET [2016/06/30 8:04:39 ET]
Table 'Altarf II' 9-max Seat #8 is the button
Seat 2: KovIFish89 ($100 in chips) 
Seat 3: sanr23 ($168.71 in chips) 
Seat 4: Greha999 ($75.16 in chips) 
Seat 5: DIMAN_324 ($229.74 in chips) 
Seat 6: mbk88 ($100 in chips) 
Seat 7: matiko09 ($104.90 in chips) 
Seat 8: DomiVY ($41.89 in chips) 
Seat 9: omanibemihum ($128.45 in chips) 
omanibemihum: posts small blind $0.50
Rafaello18: is sitting out 
KovIFish89: posts big blind $1
*** HOLE CARDS ***
Dealt to matiko09 [2d Qc]
sanr23: raises $2 to $3
Greha999: calls $3
DIMAN_324: folds 
mbk88: raises $9 to $12
matiko09: folds 
DomiVY: folds 
omanibemihum: folds 
KovIFish89: folds 
sanr23: raises $13 to $25
Greha999: folds 
mbk88: folds 
Uncalled bet ($13) returned to sanr23
sanr23 collected $28.50 from pot
sanr23: doesn't show hand 
*** SUMMARY ***
Total pot $28.50 | Rake $0 
Seat 2: KovIFish89 (big blind) folded before Flop
Seat 3: sanr23 collected ($28.50)
Seat 4: Greha999 folded before Flop
Seat 5: DIMAN_324 folded before Flop (didn't bet)
Seat 6: mbk88 folded before Flop
Seat 7: matiko09 folded before Flop (didn't bet)
Seat 8: DomiVY (button) folded before Flop (didn't bet)
Seat 9: omanibemihum (small blind) folded before Flop





PokerStars Hand #155380409057:  Hold'em No Limit ($0.50/$1.00 USD) - 2016/06/30 14:04:42 CET [2016/06/30 8:04:42 ET]
Table 'Borrelly II' 9-max Seat #4 is the button
Seat 2: mbk88 ($106.50 in chips) 
Seat 3: di0d80 ($105.52 in chips) 
Seat 4: DonRon_AT ($43.19 in chips) 
Seat 5: DIMAN_324 ($100.90 in chips) 
Seat 6: m_michalec ($172.06 in chips) 
Seat 7: matiko09 ($176.36 in chips) 
Seat 8: Arjun A Raju ($124.64 in chips) 
Seat 9: alhill86 ($72.50 in chips) 
DIMAN_324: posts small blind $0.50
m_michalec: posts big blind $1
*** HOLE CARDS ***
Dealt to matiko09 [9d 7s]
matiko09: folds 
Arjun A Raju: folds 
alhill86: raises $2 to $3
mbk88: folds 
di0d80: folds 
DonRon_AT: folds 
DIMAN_324: folds 
m_michalec: calls $2
*** FLOP *** [8h 8c 4s]
m_michalec: checks 
alhill86: bets $3.09
m_michalec: folds 
Uncalled bet ($3.09) returned to alhill86
alhill86 collected $6.18 from pot
alhill86: doesn't show hand 
*** SUMMARY ***
Total pot $6.50 | Rake $0.32 
Board [8h 8c 4s]
Seat 2: mbk88 folded before Flop (didn't bet)
Seat 3: di0d80 folded before Flop (didn't bet)
Seat 4: DonRon_AT (button) folded before Flop (didn't bet)
Seat 5: DIMAN_324 (small blind) folded before Flop
Seat 6: m_michalec (big blind) folded on the Flop
Seat 7: matiko09 folded before Flop (didn't bet)
Seat 8: Arjun A Raju folded before Flop (didn't bet)
Seat 9: alhill86 collected ($6.18)





PokerStars Hand #155380410225:  Hold'em No Limit ($0.50/$1.00 USD) - 2016/06/30 14:04:45 CET [2016/06/30 8:04:45 ET]
Table 'Asmodeus' 9-max Seat #1 is the button
Seat 1: scollop ($123.25 in chips) 
Seat 2: picka4u ($38.50 in chips) 
Seat 3: matiko09 ($106.91 in chips) 
Seat 5: sanr23 ($110.30 in chips) 
Seat 6: koutani7 ($96.28 in chips) 
Seat 7: aaronzzr ($138.33 in chips) 
Seat 9: mbk88 ($158.86 in chips) 
picka4u: posts small blind $0.50
matiko09: posts big blind $1
DIMAN_324: sits out 
*** HOLE CARDS ***
Dealt to matiko09 [4h 7h]
sanr23: folds 
koutani7: folds 
aaronzzr: folds 
mbk88: folds 
scollop: folds 
picka4u: raises $1.25 to $2.25
matiko09: folds 
Uncalled bet ($1.25) returned to picka4u
picka4u collected $2 from pot
picka4u: doesn't show hand 
*** SUMMARY ***
Total pot $2 | Rake $0 
Seat 1: scollop (button) folded before Flop (didn't bet)
Seat 2: picka4u (small blind) collected ($2)
Seat 3: matiko09 (big blind) folded before Flop
Seat 5: sanr23 folded before Flop (didn't bet)
Seat 6: koutani7 folded before Flop (didn't bet)
Seat 7: aaronzzr folded before Flop (didn't bet)
Seat 9: mbk88 folded before Flop (didn't bet)





PokerStars Hand #155380415114:  Hold'em No Limit ($0.50/$1.00 USD) - 2016/06/30 14:04:56 CET [2016/06/30 8:04:56 ET]
Table 'Tatjana' 9-max Seat #7 is the button
Seat 2: DIMAN_324 ($100 in chips) 
Seat 3: Rafaello18 ($102.79 in chips) 
Seat 4: mopatron25 ($112.14 in chips) 
Seat 5: matiko09 ($100 in chips) 
Seat 6: mbk88 ($151.94 in chips) 
Seat 7: daigodisco ($47.84 in chips) 
Seat 8: alhill86 ($79.34 in chips) 
Seat 9: POTAPENKO700 ($239.71 in chips) 
alhill86: posts small blind $0.50
POTAPENKO700: posts big blind $1
tipner: sits out 
*** HOLE CARDS ***
Dealt to matiko09 [Kc 6d]
DIMAN_324: folds 
Rafaello18: folds 
mopatron25: calls $1
matiko09: folds 
mbk88: raises $3 to $4
daigodisco: folds 
alhill86: folds 
POTAPENKO700: folds 
mopatron25: folds 
Uncalled bet ($3) returned to mbk88
mbk88 collected $3.50 from pot
mbk88: doesn't show hand 
*** SUMMARY ***
Total pot $3.50 | Rake $0 
Seat 2: DIMAN_324 folded before Flop (didn't bet)
Seat 3: Rafaello18 folded before Flop (didn't bet)
Seat 4: mopatron25 folded before Flop
Seat 5: matiko09 folded before Flop (didn't bet)
Seat 6: mbk88 collected ($3.50)
Seat 7: daigodisco (button) folded before Flop (didn't bet)
Seat 8: alhill86 (small blind) folded before Flop
Seat 9: POTAPENKO700 (big blind) folded before Flop





PokerStars Hand #155380418925:  Hold'em No Limit ($0.25/$0.50 USD) - 2016/06/30 14:05:04 CET [2016/06/30 8:05:04 ET]
Table 'Elektra II' 9-max Seat #2 is the button
Seat 1: drlee77 ($48.03 in chips) 
Seat 2: TheMinion ($60.82 in chips) 
Seat 3: mojtabagol ($81.04 in chips) 
Seat 4: matiko09 ($51.72 in chips) 
Seat 5: Rafaello18 ($57.24 in chips) 
Seat 6: pfunkolstar ($50 in chips) 
Seat 7: MuddyDance ($50 in chips) 
Seat 8: sanr23 ($56.25 in chips) 
Seat 9: KABAL_ua ($54.77 in chips) 
mojtabagol: posts small blind $0.25
matiko09: posts big blind $0.50
*** HOLE CARDS ***
Dealt to matiko09 [Th Ts]
Rafaello18: folds 
pfunkolstar: folds 
MuddyDance: folds 
sanr23: folds 
KABAL_ua: folds 
drlee77: raises $1 to $1.50
TheMinion: folds 
mojtabagol: folds 
matiko09: calls $1
*** FLOP *** [Td 3h 9h]
matiko09: checks 
drlee77: checks 
*** TURN *** [Td 3h 9h] [8s]
matiko09: checks 
drlee77: bets $2
matiko09: raises $7.50 to $9.50
drlee77: folds 
Uncalled bet ($7.50) returned to matiko09
matiko09 collected $6.89 from pot
matiko09: doesn't show hand 
*** SUMMARY ***
Total pot $7.25 | Rake $0.36 
Board [Td 3h 9h 8s]
Seat 1: drlee77 folded on the Turn
Seat 2: TheMinion (button) folded before Flop (didn't bet)
Seat 3: mojtabagol (small blind) folded before Flop
Seat 4: matiko09 (big blind) collected ($6.89)
Seat 5: Rafaello18 folded before Flop (didn't bet)
Seat 6: pfunkolstar folded before Flop (didn't bet)
Seat 7: MuddyDance folded before Flop (didn't bet)
Seat 8: sanr23 folded before Flop (didn't bet)
Seat 9: KABAL_ua folded before Flop (didn't bet)





PokerStars Hand #155380421243:  Hold'em No Limit ($0.50/$1.00 USD) - 2016/06/30 14:05:10 CET [2016/06/30 8:05:10 ET]
Table 'California II' 9-max Seat #7 is the button
Seat 1: Rafaello18 ($101.02 in chips) 
Seat 2: velourleder ($52.94 in chips) 
Seat 3: KovIFish89 ($100 in chips) 
Seat 4: mbk88 ($181.42 in chips) 
Seat 5: Rohitbarve ($106.01 in chips) 
Seat 6: matiko09 ($100 in chips) 
Seat 7: DomiVY ($82.70 in chips) 
Seat 8: picka4u ($163.69 in chips) 
Seat 9: di0d80 ($100 in chips) 
picka4u: posts small blind $0.50
di0d80: posts big blind $1
*** HOLE CARDS ***
Dealt to matiko09 [7d Qc]
Rafaello18: folds 
velourleder: folds 
KovIFish89: folds 
mbk88: folds 
Rohitbarve: raises $2 to $3
matiko09: folds 
DomiVY: folds 
picka4u: raises $7 to $10
di0d80: folds 
Rohitbarve: folds 
Uncalled bet ($7) returned to picka4u
picka4u collected $7 from pot
picka4u: doesn't show hand 
*** SUMMARY ***
Total pot $7 | Rake $0 
Seat 1: Rafaello18 folded before Flop (didn't bet)
Seat 2: velourleder folded before Flop (didn't bet)
Seat 3: KovIFish89 folded before Flop (didn't bet)
Seat 4: mbk88 folded before Flop (didn't bet)
Seat 5: Rohitbarve folded before Flop
Seat 6: matiko09 folded before Flop (didn't bet)
Seat 7: DomiVY (button) folded before Flop (didn't bet)
Seat 8: picka4u (small blind) collected ($7)
Seat 9: di0d80 (big blind) folded before Flop





PokerStars Hand #155380424713:  Hold'em No Limit ($0.25/$0.50 USD) - 2016/06/30 14:05:18 CET [2016/06/30 8:05:18 ET]
Table 'Mentha II' 9-max Seat #1 is the button
Seat 1: fudzi ($50 in chips) 
Seat 2: TheMinion ($58.20 in chips) 
Seat 3: joker180785 ($50 in chips) 
Seat 4: Chanelado ($42.82 in chips) 
Seat 5: kotkas1000 ($50 in chips) 
Seat 6: Alexey_Kim2 ($52.96 in chips) 
Seat 8: Clifftastic ($41.22 in chips) 
Seat 9: matiko09 ($100.12 in chips) 
TheMinion: posts small blind $0.25
joker180785: posts big blind $0.50
ivan100886: sits out 
fudzi: posts the ante $0.10
TheMinion: posts the ante $0.10
joker180785: posts the ante $0.10
Chanelado: posts the ante $0.10
kotkas1000: posts the ante $0.10
Alexey_Kim2: posts the ante $0.10
Clifftastic: posts the ante $0.10
matiko09: posts the ante $0.10
*** HOLE CARDS ***
Dealt to matiko09 [Ah 4s]
Chanelado: folds 
kotkas1000: folds 
Alexey_Kim2: raises $1 to $1.50
Clifftastic: folds 
matiko09: folds 
fudzi: folds 
TheMinion: folds 
joker180785: folds 
Uncalled bet ($1) returned to Alexey_Kim2
Alexey_Kim2 collected $2.05 from pot
Alexey_Kim2: doesn't show hand 
*** SUMMARY ***
Total pot $2.05 | Rake $0 
Seat 1: fudzi (button) folded before Flop (didn't bet)
Seat 2: TheMinion (small blind) folded before Flop
Seat 3: joker180785 (big blind) folded before Flop
Seat 4: Chanelado folded before Flop (didn't bet)
Seat 5: kotkas1000 folded before Flop (didn't bet)
Seat 6: Alexey_Kim2 collected ($2.05)
Seat 8: Clifftastic folded before Flop (didn't bet)
Seat 9: matiko09 folded before Flop (didn't bet)





PokerStars Hand #155380425759:  Hold'em No Limit ($0.50/$1.00 USD) - 2016/06/30 14:05:20 CET [2016/06/30 8:05:20 ET]
Table 'Asmodeus' 9-max Seat #2 is the button
Seat 1: scollop ($123.25 in chips) 
Seat 2: picka4u ($39.50 in chips) 
Seat 3: matiko09 ($105.91 in chips) 
Seat 4: DIMAN_324 ($100 in chips) 
Seat 5: sanr23 ($110.30 in chips) 
Seat 6: koutani7 ($96.28 in chips) 
Seat 7: aaronzzr ($138.33 in chips) 
Seat 9: mbk88 ($158.86 in chips) 
matiko09: posts small blind $0.50
DIMAN_324: posts big blind $1
*** HOLE CARDS ***
Dealt to matiko09 [6c Kd]
sanr23: folds 
koutani7: folds 
aaronzzr: folds 
mbk88: folds 
scollop: folds 
picka4u: folds 
matiko09: folds 
Uncalled bet ($0.50) returned to DIMAN_324
DIMAN_324 collected $1 from pot
DIMAN_324: doesn't show hand 
*** SUMMARY ***
Total pot $1 | Rake $0 
Seat 1: scollop folded before Flop (didn't bet)
Seat 2: picka4u (button) folded before Flop (didn't bet)
Seat 3: matiko09 (small blind) folded before Flop
Seat 4: DIMAN_324 (big blind) collected ($1)
Seat 5: sanr23 folded before Flop (didn't bet)
Seat 6: koutani7 folded before Flop (didn't bet)
Seat 7: aaronzzr folded before Flop (didn't bet)
Seat 9: mbk88 folded before Flop (didn't bet)





PokerStars Hand #155380425921:  Hold'em No Limit ($0.25/$0.50 USD) - 2016/06/30 14:05:20 CET [2016/06/30 8:05:20 ET]
Table 'Arcturus' 9-max Seat #6 is the button
Seat 1: kourk250 ($125.35 in chips) 
Seat 3: matiko09 ($54.31 in chips) 
Seat 5: stockbridge8 ($45.25 in chips) 
Seat 6: statistik85 ($59.59 in chips) 
Seat 7: DaikenGF ($65.51 in chips) 
Seat 8: TheMinion ($62.96 in chips) 
Seat 9: pfunkolstar ($54.25 in chips) 
DaikenGF: posts small blind $0.25
TheMinion: posts big blind $0.50
Vedpapa: sits out 
*** HOLE CARDS ***
Dealt to matiko09 [9c Qc]
pfunkolstar: raises $1 to $1.50
kourk250: calls $1.50
matiko09: folds 
stockbridge8: raises $4.50 to $6
statistik85: folds 
DaikenGF: folds 
TheMinion: folds 
pfunkolstar: folds 
kourk250: folds 
Uncalled bet ($4.50) returned to stockbridge8
stockbridge8 collected $5.25 from pot
stockbridge8: doesn't show hand 
*** SUMMARY ***
Total pot $5.25 | Rake $0 
Seat 1: kourk250 folded before Flop
Seat 3: matiko09 folded before Flop (didn't bet)
Seat 5: stockbridge8 collected ($5.25)
Seat 6: statistik85 (button) folded before Flop (didn't bet)
Seat 7: DaikenGF (small blind) folded before Flop
Seat 8: TheMinion (big blind) folded before Flop
Seat 9: pfunkolstar folded before Flop





PokerStars Hand #155380428411:  Hold'em No Limit ($0.50/$1.00 USD) - 2016/06/30 14:05:26 CET [2016/06/30 8:05:26 ET]
Table 'Sigrid' 9-max Seat #5 is the button
Seat 1: Greha999 ($70.90 in chips) 
Seat 2: matiko09 ($105.52 in chips) 
Seat 4: mbk88 ($120.87 in chips) 
Seat 5: DIMAN_324 ($100 in chips) 
Seat 6: di0d80 ($103.99 in chips) 
Seat 7: arctur17 ($40 in chips) 
Seat 8: nickreason17 ($115.30 in chips) 
Seat 9: KovIFish89 ($108.28 in chips) 
di0d80: posts small blind $0.50
arctur17: posts big blind $1
*** HOLE CARDS ***
Dealt to matiko09 [7c Kh]
nickreason17: folds 
nickreason17 leaves the table
KovIFish89: raises $2 to $3
Kukuryzka joins the table at seat #8 
Greha999: folds 
matiko09: folds 
mbk88: folds 
DIMAN_324: folds 
di0d80: folds 
arctur17: calls $2
*** FLOP *** [2s 7h Ad]
arctur17: checks 
KovIFish89: bets $3.50
arctur17: folds 
Uncalled bet ($3.50) returned to KovIFish89
KovIFish89 collected $6.18 from pot
KovIFish89: doesn't show hand 
*** SUMMARY ***
Total pot $6.50 | Rake $0.32 
Board [2s 7h Ad]
Seat 1: Greha999 folded before Flop (didn't bet)
Seat 2: matiko09 folded before Flop (didn't bet)
Seat 4: mbk88 folded before Flop (didn't bet)
Seat 5: DIMAN_324 (button) folded before Flop (didn't bet)
Seat 6: di0d80 (small blind) folded before Flop
Seat 7: arctur17 (big blind) folded on the Flop
Seat 8: nickreason17 folded before Flop (didn't bet)
Seat 9: KovIFish89 collected ($6.18)





PokerStars Hand #155380431982:  Hold'em No Limit ($0.50/$1.00 USD) - 2016/06/30 14:05:34 CET [2016/06/30 8:05:34 ET]
Table 'Prieska' 9-max Seat #1 is the button
Seat 1: KovIFish89 ($115.07 in chips) 
Seat 2: B_style_cuz ($100.43 in chips) 
Seat 4: nickreason17 ($100 in chips) 
Seat 5: ramzes160468 ($88.55 in chips) 
Seat 6: Ty Nick 420 ($103.82 in chips) 
Seat 7: matiko09 ($106.02 in chips) 
Seat 8: mbk88 ($126.69 in chips) 
Seat 9: Konig26 ($85.24 in chips) 
B_style_cuz: posts small blind $0.50
Rafaello18: is sitting out 
nickreason17: posts big blind $1
*** HOLE CARDS ***
Dealt to matiko09 [7c 2c]
ramzes160468: folds 
Ty Nick 420: folds 
matiko09: folds 
mbk88: folds 
Konig26: folds 
KovIFish89: folds 
B_style_cuz: folds 
Uncalled bet ($0.50) returned to nickreason17
nickreason17 collected $1 from pot
*** SUMMARY ***
Total pot $1 | Rake $0 
Seat 1: KovIFish89 (button) folded before Flop (didn't bet)
Seat 2: B_style_cuz (small blind) folded before Flop
Seat 4: nickreason17 (big blind) collected ($1)
Seat 5: ramzes160468 folded before Flop (didn't bet)
Seat 6: Ty Nick 420 folded before Flop (didn't bet)
Seat 7: matiko09 folded before Flop (didn't bet)
Seat 8: mbk88 folded before Flop (didn't bet)
Seat 9: Konig26 folded before Flop (didn't bet)





PokerStars Hand #155380433567:  Hold'em No Limit ($0.50/$1.00 USD) - 2016/06/30 14:05:37 CET [2016/06/30 8:05:37 ET]
Table 'Borrelly II' 9-max Seat #5 is the button
Seat 2: mbk88 ($106.50 in chips) 
Seat 3: di0d80 ($105.52 in chips) 
Seat 4: DonRon_AT ($43.19 in chips) 
Seat 5: DIMAN_324 ($100.40 in chips) 
Seat 6: m_michalec ($169.06 in chips) 
Seat 7: matiko09 ($176.36 in chips) 
Seat 8: Arjun A Raju ($124.64 in chips) 
Seat 9: alhill86 ($75.68 in chips) 
m_michalec: posts small blind $0.50
matiko09: posts big blind $1
*** HOLE CARDS ***
Dealt to matiko09 [5c As]
Arjun A Raju: folds 
alhill86: raises $2 to $3
mbk88: folds 
di0d80: folds 
DonRon_AT: folds 
DIMAN_324: folds 
m_michalec: folds 
matiko09: folds 
Uncalled bet ($2) returned to alhill86
alhill86 collected $2.50 from pot
alhill86: doesn't show hand 
*** SUMMARY ***
Total pot $2.50 | Rake $0 
Seat 2: mbk88 folded before Flop (didn't bet)
Seat 3: di0d80 folded before Flop (didn't bet)
Seat 4: DonRon_AT folded before Flop (didn't bet)
Seat 5: DIMAN_324 (button) folded before Flop (didn't bet)
Seat 6: m_michalec (small blind) folded before Flop
Seat 7: matiko09 (big blind) folded before Flop
Seat 8: Arjun A Raju folded before Flop (didn't bet)
Seat 9: alhill86 collected ($2.50)





PokerStars Hand #155380436475:  Hold'em No Limit ($0.50/$1.00 USD) - 2016/06/30 14:05:44 CET [2016/06/30 8:05:44 ET]
Table 'Asmodeus' 9-max Seat #3 is the button
Seat 1: scollop ($123.25 in chips) 
Seat 2: picka4u ($39.50 in chips) 
Seat 3: matiko09 ($105.41 in chips) 
Seat 4: DIMAN_324 ($100.50 in chips) 
Seat 6: koutani7 ($96.28 in chips) 
Seat 7: aaronzzr ($138.33 in chips) 
Seat 9: mbk88 ($158.86 in chips) 
DIMAN_324: posts small blind $0.50
sanr23: is sitting out 
koutani7: posts big blind $1
*** HOLE CARDS ***
Dealt to matiko09 [Qc 9c]
aaronzzr: folds 
mbk88: folds 
scollop: raises $1 to $2
picka4u: folds 
matiko09: folds 
DIMAN_324: calls $1.50
koutani7: folds 
*** FLOP *** [Jd 5h 9s]
DIMAN_324: bets $2.50
scollop: calls $2.50
*** TURN *** [Jd 5h 9s] [8s]
DIMAN_324: bets $5
scollop: calls $5
*** RIVER *** [Jd 5h 9s 8s] [Qh]
DIMAN_324: bets $14.25
scollop: folds 
Uncalled bet ($14.25) returned to DIMAN_324
DIMAN_324 collected $19 from pot
DIMAN_324: doesn't show hand 
*** SUMMARY ***
Total pot $20 | Rake $1 
Board [Jd 5h 9s 8s Qh]
Seat 1: scollop folded on the River
Seat 2: picka4u folded before Flop (didn't bet)
Seat 3: matiko09 (button) folded before Flop (didn't bet)
Seat 4: DIMAN_324 (small blind) collected ($19)
Seat 6: koutani7 (big blind) folded before Flop
Seat 7: aaronzzr folded before Flop (didn't bet)
Seat 9: mbk88 folded before Flop (didn't bet)





PokerStars Hand #155380437004:  Hold'em No Limit ($0.50/$1.00 USD) - 2016/06/30 14:05:45 CET [2016/06/30 8:05:45 ET]
Table 'California II' 9-max Seat #8 is the button
Seat 2: velourleder ($52.94 in chips) 
Seat 3: KovIFish89 ($100 in chips) 
Seat 4: mbk88 ($181.42 in chips) 
Seat 5: Rohitbarve ($103.01 in chips) 
Seat 6: matiko09 ($100 in chips) 
Seat 7: DomiVY ($82.70 in chips) 
Seat 8: picka4u ($167.69 in chips) 
Seat 9: di0d80 ($100 in chips) 
di0d80: posts small blind $0.50
Rafaello18: is sitting out 
velourleder: posts big blind $1
*** HOLE CARDS ***
Dealt to matiko09 [7s Qc]
KovIFish89: folds 
mbk88: raises $2 to $3
Rohitbarve: folds 
matiko09: folds 
DomiVY: folds 
picka4u: folds 
di0d80: folds 
velourleder: calls $2
*** FLOP *** [6s 7d 4d]
velourleder: bets $4
mbk88: folds 
Uncalled bet ($4) returned to velourleder
velourleder collected $6.18 from pot
*** SUMMARY ***
Total pot $6.50 | Rake $0.32 
Board [6s 7d 4d]
Seat 2: velourleder (big blind) collected ($6.18)
Seat 3: KovIFish89 folded before Flop (didn't bet)
Seat 4: mbk88 folded on the Flop
Seat 5: Rohitbarve folded before Flop (didn't bet)
Seat 6: matiko09 folded before Flop (didn't bet)
Seat 7: DomiVY folded before Flop (didn't bet)
Seat 8: picka4u (button) folded before Flop (didn't bet)
Seat 9: di0d80 (small blind) folded before Flop





PokerStars Hand #155380438696:  Hold'em No Limit ($0.25/$0.50 USD) - 2016/06/30 14:05:49 CET [2016/06/30 8:05:49 ET]
Table 'Dorothea II' 9-max Seat #2 is the button
Seat 1: zapata 7777 ($87.90 in chips) 
Seat 2: joker180785 ($50 in chips) 
Seat 4: matiko09 ($166.91 in chips) 
Seat 5: Bailey Dew ($85.80 in chips) 
Seat 6: ivan100886 ($38.66 in chips) 
Seat 7: desmo465 ($57.94 in chips) 
Seat 8: TheMinion ($50 in chips) 
Seat 9: funXmun ($50 in chips) 
fudzi will be allowed to play after the button
matiko09: posts small blind $0.25
Bailey Dew: posts big blind $0.50
zapata 7777: posts the ante $0.10
joker180785: posts the ante $0.10
matiko09: posts the ante $0.10
Bailey Dew: posts the ante $0.10
ivan100886: posts the ante $0.10
desmo465: posts the ante $0.10
TheMinion: posts the ante $0.10
funXmun: posts the ante $0.10
*** HOLE CARDS ***
Dealt to matiko09 [Ts 9h]
ivan100886: raises $0.75 to $1.25
desmo465: folds 
TheMinion: folds 
funXmun: folds 
zapata 7777: folds 
joker180785: folds 
matiko09: folds 
Bailey Dew: folds 
Uncalled bet ($0.75) returned to ivan100886
ivan100886 collected $2.05 from pot
*** SUMMARY ***
Total pot $2.05 | Rake $0 
Seat 1: zapata 7777 folded before Flop (didn't bet)
Seat 2: joker180785 (button) folded before Flop (didn't bet)
Seat 4: matiko09 (small blind) folded before Flop
Seat 5: Bailey Dew (big blind) folded before Flop
Seat 6: ivan100886 collected ($2.05)
Seat 7: desmo465 folded before Flop (didn't bet)
Seat 8: TheMinion folded before Flop (didn't bet)
Seat 9: funXmun folded before Flop (didn't bet)





PokerStars Hand #155380440704:  Hold'em No Limit ($0.25/$0.50 USD) - 2016/06/30 14:05:53 CET [2016/06/30 8:05:53 ET]
Table 'Mentha II' 9-max Seat #2 is the button
Seat 1: fudzi ($50 in chips) 
Seat 2: TheMinion ($57.85 in chips) 
Seat 3: joker180785 ($50 in chips) 
Seat 4: Chanelado ($42.72 in chips) 
Seat 5: kotkas1000 ($50 in chips) 
Seat 6: Alexey_Kim2 ($54.41 in chips) 
Seat 8: Clifftastic ($41.12 in chips) 
Seat 9: matiko09 ($100.02 in chips) 
joker180785: posts small blind $0.25
Chanelado: posts big blind $0.50
ivan100886: sits out 
fudzi: posts the ante $0.10
TheMinion: posts the ante $0.10
joker180785: posts the ante $0.10
Chanelado: posts the ante $0.10
kotkas1000: posts the ante $0.10
Alexey_Kim2: posts the ante $0.10
Clifftastic: posts the ante $0.10
matiko09: posts the ante $0.10
*** HOLE CARDS ***
Dealt to matiko09 [9s Tc]
kotkas1000: folds 
Alexey_Kim2: folds 
Clifftastic: folds 
matiko09: folds 
fudzi: folds 
TheMinion: folds 
joker180785: folds 
Uncalled bet ($0.25) returned to Chanelado
Chanelado collected $1.30 from pot
Chanelado: doesn't show hand 
*** SUMMARY ***
Total pot $1.30 | Rake $0 
Seat 1: fudzi folded before Flop (didn't bet)
Seat 2: TheMinion (button) folded before Flop (didn't bet)
Seat 3: joker180785 (small blind) folded before Flop
Seat 4: Chanelado (big blind) collected ($1.30)
Seat 5: kotkas1000 folded before Flop (didn't bet)
Seat 6: Alexey_Kim2 folded before Flop (didn't bet)
Seat 8: Clifftastic folded before Flop (didn't bet)
Seat 9: matiko09 folded before Flop (didn't bet)





PokerStars Hand #155380441058:  Hold'em No Limit ($0.50/$1.00 USD) - 2016/06/30 14:05:54 CET [2016/06/30 8:05:54 ET]
Table 'Tatjana' 9-max Seat #8 is the button
Seat 1: tipner ($100 in chips) 
Seat 2: DIMAN_324 ($100 in chips) 
Seat 3: Rafaello18 ($102.79 in chips) 
Seat 4: mopatron25 ($111.14 in chips) 
Seat 5: matiko09 ($100 in chips) 
Seat 6: mbk88 ($154.44 in chips) 
Seat 7: daigodisco ($47.84 in chips) 
Seat 8: alhill86 ($78.84 in chips) 
Seat 9: POTAPENKO700 ($238.71 in chips) 
POTAPENKO700: posts small blind $0.50
tipner: posts big blind $1
*** HOLE CARDS ***
Dealt to matiko09 [7h 8d]
DIMAN_324: folds 
Rafaello18: folds 
mopatron25: folds 
matiko09: folds 
mbk88: folds 
daigodisco: folds 
alhill86: folds 
POTAPENKO700: raises $2 to $3
tipner: calls $2
*** FLOP *** [9h 6s Jh]
POTAPENKO700: checks 
tipner: checks 
*** TURN *** [9h 6s Jh] [Th]
POTAPENKO700: checks 
tipner: checks 
*** RIVER *** [9h 6s Jh Th] [4c]
POTAPENKO700: checks 
tipner: checks 
*** SHOW DOWN ***
POTAPENKO700: shows [Ac Ks] (high card Ace)
tipner: shows [4h Ad] (a pair of Fours)
tipner collected $5.70 from pot
*** SUMMARY ***
Total pot $6 | Rake $0.30 
Board [9h 6s Jh Th 4c]
Seat 1: tipner (big blind) showed [4h Ad] and won ($5.70) with a pair of Fours
Seat 2: DIMAN_324 folded before Flop (didn't bet)
Seat 3: Rafaello18 folded before Flop (didn't bet)
Seat 4: mopatron25 folded before Flop (didn't bet)
Seat 5: matiko09 folded before Flop (didn't bet)
Seat 6: mbk88 folded before Flop (didn't bet)
Seat 7: daigodisco folded before Flop (didn't bet)
Seat 8: alhill86 (button) folded before Flop (didn't bet)
Seat 9: POTAPENKO700 (small blind) showed [Ac Ks] and lost with high card Ace





PokerStars Hand #155380443269:  Hold'em No Limit ($0.50/$1.00 USD) - 2016/06/30 14:05:59 CET [2016/06/30 8:05:59 ET]
Table 'Prieska' 9-max Seat #2 is the button
Seat 1: KovIFish89 ($115.07 in chips) 
Seat 2: B_style_cuz ($99.93 in chips) 
Seat 4: nickreason17 ($100.50 in chips) 
Seat 5: ramzes160468 ($88.55 in chips) 
Seat 6: Ty Nick 420 ($103.82 in chips) 
Seat 7: matiko09 ($106.02 in chips) 
Seat 8: mbk88 ($126.69 in chips) 
Seat 9: Konig26 ($85.24 in chips) 
nickreason17: posts small blind $0.50
ramzes160468: posts big blind $1
*** HOLE CARDS ***
Dealt to matiko09 [4c 7c]
Ty Nick 420: folds 
matiko09: folds 
mbk88: folds 
Konig26: folds 
KovIFish89: raises $1.50 to $2.50
B_style_cuz: folds 
nickreason17: folds 
ramzes160468: folds 
Uncalled bet ($1.50) returned to KovIFish89
KovIFish89 collected $2.50 from pot
KovIFish89: doesn't show hand 
*** SUMMARY ***
Total pot $2.50 | Rake $0 
Seat 1: KovIFish89 collected ($2.50)
Seat 2: B_style_cuz (button) folded before Flop (didn't bet)
Seat 4: nickreason17 (small blind) folded before Flop
Seat 5: ramzes160468 (big blind) folded before Flop
Seat 6: Ty Nick 420 folded before Flop (didn't bet)
Seat 7: matiko09 folded before Flop (didn't bet)
Seat 8: mbk88 folded before Flop (didn't bet)
Seat 9: Konig26 folded before Flop (didn't bet)





PokerStars Hand #155380443660:  Hold'em No Limit ($0.50/$1.00 USD) - 2016/06/30 14:06:00 CET [2016/06/30 8:06:00 ET]
Table 'Sigrid' 9-max Seat #6 is the button
Seat 1: Greha999 ($70.90 in chips) 
Seat 2: matiko09 ($105.52 in chips) 
Seat 4: mbk88 ($120.87 in chips) 
Seat 5: DIMAN_324 ($100 in chips) 
Seat 6: di0d80 ($103.49 in chips) 
Seat 7: arctur17 ($37 in chips) 
Seat 8: Kukuryzka ($100 in chips) 
Seat 9: KovIFish89 ($111.46 in chips) 
arctur17: posts small blind $0.50
Kukuryzka: posts big blind $1
*** HOLE CARDS ***
Dealt to matiko09 [Tc Ad]
KovIFish89: raises $2 to $3
Greha999: folds 
matiko09: folds 
mbk88: folds 
DIMAN_324: folds 
di0d80: calls $3
arctur17: calls $2.50
Kukuryzka: folds 
*** FLOP *** [As Ts 7d]
arctur17: checks 
KovIFish89: bets $6
di0d80: calls $6
arctur17: folds 
*** TURN *** [As Ts 7d] [Kc]
KovIFish89: checks 
di0d80: checks 
*** RIVER *** [As Ts 7d Kc] [Qs]
KovIFish89: checks 
di0d80: checks 
*** SHOW DOWN ***
KovIFish89: shows [Qc Kd] (two pair, Kings and Queens)
di0d80: shows [Qd Ac] (two pair, Aces and Queens)
di0d80 collected $20.90 from pot
*** SUMMARY ***
Total pot $22 | Rake $1.10 
Board [As Ts 7d Kc Qs]
Seat 1: Greha999 folded before Flop (didn't bet)
Seat 2: matiko09 folded before Flop (didn't bet)
Seat 4: mbk88 folded before Flop (didn't bet)
Seat 5: DIMAN_324 folded before Flop (didn't bet)
Seat 6: di0d80 (button) showed [Qd Ac] and won ($20.90) with two pair, Aces and Queens
Seat 7: arctur17 (small blind) folded on the Flop
Seat 8: Kukuryzka (big blind) folded before Flop
Seat 9: KovIFish89 showed [Qc Kd] and lost with two pair, Kings and Queens





PokerStars Hand #155380444393:  Hold'em No Limit ($0.25/$0.50 USD) - 2016/06/30 14:06:01 CET [2016/06/30 8:06:01 ET]
Table 'Arcturus' 9-max Seat #7 is the button
Seat 1: kourk250 ($123.85 in chips) 
Seat 3: matiko09 ($54.31 in chips) 
Seat 5: stockbridge8 ($49 in chips) 
Seat 6: statistik85 ($59.59 in chips) 
Seat 7: DaikenGF ($65.26 in chips) 
Seat 8: TheMinion ($62.46 in chips) 
Seat 9: pfunkolstar ($52.75 in chips) 
TheMinion: posts small blind $0.25
pfunkolstar: posts big blind $0.50
Vedpapa: sits out 
*** HOLE CARDS ***
Dealt to matiko09 [3h Th]
kourk250: folds 
matiko09: folds 
stockbridge8: raises $1 to $1.50
statistik85: folds 
DaikenGF: folds 
TheMinion: folds 
pfunkolstar: calls $1
*** FLOP *** [2c 6h 2h]
pfunkolstar: checks 
stockbridge8: bets $1.54
pfunkolstar: calls $1.54
*** TURN *** [2c 6h 2h] [5c]
pfunkolstar: checks 
stockbridge8: bets $3
pfunkolstar: raises $6.50 to $9.50
stockbridge8: folds 
Uncalled bet ($6.50) returned to pfunkolstar
pfunkolstar collected $11.71 from pot
pfunkolstar: doesn't show hand 
*** SUMMARY ***
Total pot $12.33 | Rake $0.62 
Board [2c 6h 2h 5c]
Seat 1: kourk250 folded before Flop (didn't bet)
Seat 3: matiko09 folded before Flop (didn't bet)
Seat 5: stockbridge8 folded on the Turn
Seat 6: statistik85 folded before Flop (didn't bet)
Seat 7: DaikenGF (button) folded before Flop (didn't bet)
Seat 8: TheMinion (small blind) folded before Flop
Seat 9: pfunkolstar (big blind) collected ($11.71)





PokerStars Hand #155380445972:  Hold'em No Limit ($0.50/$1.00 USD) - 2016/06/30 14:06:05 CET [2016/06/30 8:06:05 ET]
Table 'Borrelly II' 9-max Seat #6 is the button
Seat 2: mbk88 ($106.50 in chips) 
Seat 3: di0d80 ($105.52 in chips) 
Seat 4: DonRon_AT ($43.19 in chips) 
Seat 5: DIMAN_324 ($100.40 in chips) 
Seat 6: m_michalec ($168.56 in chips) 
Seat 7: matiko09 ($175.36 in chips) 
Seat 8: Arjun A Raju ($124.64 in chips) 
Seat 9: alhill86 ($77.18 in chips) 
matiko09: posts small blind $0.50
Arjun A Raju: posts big blind $1
*** HOLE CARDS ***
Dealt to matiko09 [4d 5s]
alhill86: folds 
mbk88: folds 
di0d80: raises $1.50 to $2.50
DonRon_AT: folds 
DIMAN_324: calls $2.50
m_michalec: folds 
matiko09: folds 
Arjun A Raju: raises $5 to $7.50
di0d80: folds 
DIMAN_324: calls $5
*** FLOP *** [4s 4h 7d]
Arjun A Raju: bets $11.39
DIMAN_324: folds 
Uncalled bet ($11.39) returned to Arjun A Raju
Arjun A Raju collected $17.10 from pot
Arjun A Raju: doesn't show hand 
*** SUMMARY ***
Total pot $18 | Rake $0.90 
Board [4s 4h 7d]
Seat 2: mbk88 folded before Flop (didn't bet)
Seat 3: di0d80 folded before Flop
Seat 4: DonRon_AT folded before Flop (didn't bet)
Seat 5: DIMAN_324 folded on the Flop
Seat 6: m_michalec (button) folded before Flop (didn't bet)
Seat 7: matiko09 (small blind) folded before Flop
Seat 8: Arjun A Raju (big blind) collected ($17.10)
Seat 9: alhill86 folded before Flop (didn't bet)





PokerStars Hand #155380447512:  Hold'em No Limit ($0.50/$1.00 USD) - 2016/06/30 14:06:08 CET [2016/06/30 8:06:08 ET]
Table 'Askania' 9-max Seat #1 is the button
Seat 1: chenconhaste ($100 in chips) 
Seat 2: DIMAN_324 ($100 in chips) 
Seat 3: matiko09 ($100 in chips) 
Seat 5: jezzaber ($104.20 in chips) 
Seat 8: kalcumite ($78.50 in chips) 
Seat 9: paul_007440 ($38.88 in chips) 
DIMAN_324: posts small blind $0.50
matiko09: posts big blind $1
Hvittingfoss: sits out 
ruslik_by: sits out 
*** HOLE CARDS ***
Dealt to matiko09 [5d 6d]
jezzaber: folds 
kalcumite: folds 
paul_007440: folds 
chenconhaste: raises $1.25 to $2.25
DIMAN_324: folds 
matiko09: calls $1.25
*** FLOP *** [5c As Jc]
matiko09: checks 
chenconhaste: bets $2
matiko09: folds 
Uncalled bet ($2) returned to chenconhaste
chenconhaste collected $4.75 from pot
*** SUMMARY ***
Total pot $5 | Rake $0.25 
Board [5c As Jc]
Seat 1: chenconhaste (button) collected ($4.75)
Seat 2: DIMAN_324 (small blind) folded before Flop
Seat 3: matiko09 (big blind) folded on the Flop
Seat 5: jezzaber folded before Flop (didn't bet)
Seat 8: kalcumite folded before Flop (didn't bet)
Seat 9: paul_007440 folded before Flop (didn't bet)





PokerStars Hand #155380448874:  Hold'em No Limit ($0.50/$1.00 USD) - 2016/06/30 14:06:11 CET [2016/06/30 8:06:11 ET]
Table 'Altarf II' 9-max Seat #9 is the button
Seat 2: KovIFish89 ($100 in chips) 
Seat 4: Greha999 ($72.16 in chips) 
Seat 5: DIMAN_324 ($229.74 in chips) 
Seat 6: mbk88 ($100 in chips) 
Seat 7: matiko09 ($104.90 in chips) 
Seat 8: DomiVY ($41.89 in chips) 
Seat 9: omanibemihum ($127.95 in chips) 
KovIFish89: posts small blind $0.50
sanr23: is sitting out 
Greha999: posts big blind $1
*** HOLE CARDS ***
Dealt to matiko09 [4h 5h]
DIMAN_324: folds 
mbk88: folds 
matiko09: folds 
DomiVY: raises $2 to $3
omanibemihum: calls $3
KovIFish89: folds 
Greha999: folds 
*** FLOP *** [2h 4d 7h]
DomiVY: checks 
omanibemihum: bets $4
DomiVY: folds 
Uncalled bet ($4) returned to omanibemihum
omanibemihum collected $7.12 from pot
omanibemihum: doesn't show hand 
*** SUMMARY ***
Total pot $7.50 | Rake $0.38 
Board [2h 4d 7h]
Seat 2: KovIFish89 (small blind) folded before Flop
Seat 4: Greha999 (big blind) folded before Flop
Seat 5: DIMAN_324 folded before Flop (didn't bet)
Seat 6: mbk88 folded before Flop (didn't bet)
Seat 7: matiko09 folded before Flop (didn't bet)
Seat 8: DomiVY folded on the Flop
Seat 9: omanibemihum (button) collected ($7.12)





PokerStars Hand #155380451564:  Hold'em No Limit ($0.25/$0.50 USD) - 2016/06/30 14:06:17 CET [2016/06/30 8:06:17 ET]
Table 'Mentha II' 9-max Seat #3 is the button
Seat 1: fudzi ($50 in chips) 
Seat 2: TheMinion ($57.75 in chips) 
Seat 3: joker180785 ($50 in chips) 
Seat 4: Chanelado ($43.67 in chips) 
Seat 5: kotkas1000 ($50 in chips) 
Seat 6: Alexey_Kim2 ($54.31 in chips) 
Seat 8: Clifftastic ($41.02 in chips) 
Seat 9: matiko09 ($99.92 in chips) 
Chanelado: posts small blind $0.25
kotkas1000: posts big blind $0.50
ivan100886: sits out 
fudzi: posts the ante $0.10
TheMinion: posts the ante $0.10
joker180785: posts the ante $0.10
Chanelado: posts the ante $0.10
kotkas1000: posts the ante $0.10
Alexey_Kim2: posts the ante $0.10
Clifftastic: posts the ante $0.10
matiko09: posts the ante $0.10
*** HOLE CARDS ***
Dealt to matiko09 [9s Qs]
Alexey_Kim2: raises $1 to $1.50
Clifftastic: folds 
matiko09: folds 
fudzi: folds 
TheMinion: folds 
joker180785: folds 
Chanelado: folds 
kotkas1000: folds 
Uncalled bet ($1) returned to Alexey_Kim2
Alexey_Kim2 collected $2.05 from pot
Alexey_Kim2: doesn't show hand 
*** SUMMARY ***
Total pot $2.05 | Rake $0 
Seat 1: fudzi folded before Flop (didn't bet)
Seat 2: TheMinion folded before Flop (didn't bet)
Seat 3: joker180785 (button) folded before Flop (didn't bet)
Seat 4: Chanelado (small blind) folded before Flop
Seat 5: kotkas1000 (big blind) folded before Flop
Seat 6: Alexey_Kim2 collected ($2.05)
Seat 8: Clifftastic folded before Flop (didn't bet)
Seat 9: matiko09 folded before Flop (didn't bet)





PokerStars Hand #155380452609:  Hold'em No Limit ($0.50/$1.00 USD) - 2016/06/30 14:06:20 CET [2016/06/30 8:06:20 ET]
Table 'California II' 9-max Seat #9 is the button
Seat 2: velourleder ($56.12 in chips) 
Seat 3: KovIFish89 ($100 in chips) 
Seat 4: mbk88 ($178.42 in chips) 
Seat 5: Rohitbarve ($103.01 in chips) 
Seat 6: matiko09 ($100 in chips) 
Seat 7: DomiVY ($82.70 in chips) 
Seat 8: picka4u ($167.69 in chips) 
Seat 9: di0d80 ($100 in chips) 
velourleder: posts small blind $0.50
KovIFish89: posts big blind $1
*** HOLE CARDS ***
Dealt to matiko09 [Kh 2s]
mbk88: folds 
Rohitbarve: folds 
matiko09: folds 
DomiVY: raises $2 to $3
picka4u: folds 
di0d80: folds 
velourleder: folds 
KovIFish89: folds 
Uncalled bet ($2) returned to DomiVY
DomiVY collected $2.50 from pot
DomiVY: doesn't show hand 
*** SUMMARY ***
Total pot $2.50 | Rake $0 
Seat 2: velourleder (small blind) folded before Flop
Seat 3: KovIFish89 (big blind) folded before Flop
Seat 4: mbk88 folded before Flop (didn't bet)
Seat 5: Rohitbarve folded before Flop (didn't bet)
Seat 6: matiko09 folded before Flop (didn't bet)
Seat 7: DomiVY collected ($2.50)
Seat 8: picka4u folded before Flop (didn't bet)
Seat 9: di0d80 (button) folded before Flop (didn't bet)





PokerStars Hand #155380458328:  Hold'em No Limit ($0.25/$0.50 USD) - 2016/06/30 14:06:32 CET [2016/06/30 8:06:32 ET]
Table 'Dorothea II' 9-max Seat #4 is the button
Seat 1: zapata 7777 ($87.80 in chips) 
Seat 2: joker180785 ($50 in chips) 
Seat 4: matiko09 ($166.56 in chips) 
Seat 5: Bailey Dew ($85.20 in chips) 
Seat 7: desmo465 ($57.84 in chips) 
Seat 8: TheMinion ($50 in chips) 
Seat 9: funXmun ($50 in chips) 
Bailey Dew: posts small blind $0.25
ivan100886: is sitting out 
desmo465: posts big blind $0.50
fudzi: sits out 
zapata 7777: posts the ante $0.10
joker180785: posts the ante $0.10
matiko09: posts the ante $0.10
Bailey Dew: posts the ante $0.10
desmo465: posts the ante $0.10
TheMinion: posts the ante $0.10
funXmun: posts the ante $0.10
*** HOLE CARDS ***
Dealt to matiko09 [Qc 3c]
TheMinion: folds 
funXmun: folds 
zapata 7777: raises $0.50 to $1
joker180785: folds 
matiko09: folds 
Bailey Dew: folds 
desmo465: folds 
Uncalled bet ($0.50) returned to zapata 7777
zapata 7777 collected $1.95 from pot
zapata 7777: doesn't show hand 
*** SUMMARY ***
Total pot $1.95 | Rake $0 
Seat 1: zapata 7777 collected ($1.95)
Seat 2: joker180785 folded before Flop (didn't bet)
Seat 4: matiko09 (button) folded before Flop (didn't bet)
Seat 5: Bailey Dew (small blind) folded before Flop
Seat 7: desmo465 (big blind) folded before Flop
Seat 8: TheMinion folded before Flop (didn't bet)
Seat 9: funXmun folded before Flop (didn't bet)





PokerStars Hand #155380461494:  Hold'em No Limit ($0.25/$0.50 USD) - 2016/06/30 14:06:39 CET [2016/06/30 8:06:39 ET]
Table 'Mentha II' 9-max Seat #4 is the button
Seat 1: fudzi ($50 in chips) 
Seat 2: TheMinion ($57.65 in chips) 
Seat 3: joker180785 ($50 in chips) 
Seat 4: Chanelado ($43.32 in chips) 
Seat 5: kotkas1000 ($50 in chips) 
Seat 7: ivan100886 ($50 in chips) 
Seat 8: Clifftastic ($40.92 in chips) 
Seat 9: matiko09 ($99.82 in chips) 
kotkas1000: posts small blind $0.25
Alexey_Kim2: is sitting out 
ivan100886: posts big blind $0.50
fudzi: posts the ante $0.10
TheMinion: posts the ante $0.10
joker180785: posts the ante $0.10
Chanelado: posts the ante $0.10
kotkas1000: posts the ante $0.10
ivan100886: posts the ante $0.10
Clifftastic: posts the ante $0.10
matiko09: posts the ante $0.10
*** HOLE CARDS ***
Dealt to matiko09 [8c Qc]
Clifftastic: folds 
matiko09: folds 
Alexey_Kim2 leaves the table
fudzi: folds 
Kukuryzka joins the table at seat #6 
Clifftastic leaves the table
TheMinion: folds 
joker180785: folds 
Chanelado: folds 
Vesnushca joins the table at seat #8 
kotkas1000: folds 
Uncalled bet ($0.25) returned to ivan100886
ivan100886 collected $1.30 from pot
*** SUMMARY ***
Total pot $1.30 | Rake $0 
Seat 1: fudzi folded before Flop (didn't bet)
Seat 2: TheMinion folded before Flop (didn't bet)
Seat 3: joker180785 folded before Flop (didn't bet)
Seat 4: Chanelado (button) folded before Flop (didn't bet)
Seat 5: kotkas1000 (small blind) folded before Flop
Seat 7: ivan100886 (big blind) collected ($1.30)
Seat 8: Clifftastic folded before Flop (didn't bet)
Seat 9: matiko09 folded before Flop (didn't bet)





PokerStars Hand #155380463580:  Hold'em No Limit ($0.25/$0.50 USD) - 2016/06/30 14:06:44 CET [2016/06/30 8:06:44 ET]
Table 'Elektra II' 9-max Seat #3 is the button
Seat 1: drlee77 ($44.53 in chips) 
Seat 2: TheMinion ($60.82 in chips) 
Seat 3: mojtabagol ($80.79 in chips) 
Seat 4: matiko09 ($55.11 in chips) 
Seat 6: pfunkolstar ($50 in chips) 
Seat 7: MuddyDance ($50 in chips) 
Seat 8: sanr23 ($56.25 in chips) 
Seat 9: KABAL_ua ($54.77 in chips) 
matiko09: posts small blind $0.25
Rafaello18: is sitting out 
pfunkolstar: posts big blind $0.50
*** HOLE CARDS ***
Dealt to matiko09 [2s 3h]
MuddyDance: folds 
sanr23: raises $1 to $1.50
KABAL_ua: folds 
drlee77: folds 
TheMinion: folds 
mojtabagol: folds 
matiko09: folds 
pfunkolstar: calls $1
*** FLOP *** [5h 4s As]
pfunkolstar: checks 
sanr23: checks 
*** TURN *** [5h 4s As] [6s]
pfunkolstar: checks 
sanr23: bets $1.54
pfunkolstar: folds 
Uncalled bet ($1.54) returned to sanr23
sanr23 collected $3.09 from pot
sanr23: doesn't show hand 
*** SUMMARY ***
Total pot $3.25 | Rake $0.16 
Board [5h 4s As 6s]
Seat 1: drlee77 folded before Flop (didn't bet)
Seat 2: TheMinion folded before Flop (didn't bet)
Seat 3: mojtabagol (button) folded before Flop (didn't bet)
Seat 4: matiko09 (small blind) folded before Flop
Seat 6: pfunkolstar (big blind) folded on the Turn
Seat 7: MuddyDance folded before Flop (didn't bet)
Seat 8: sanr23 collected ($3.09)
Seat 9: KABAL_ua folded before Flop (didn't bet)





PokerStars Hand #155380464205:  Hold'em No Limit ($0.50/$1.00 USD) - 2016/06/30 14:06:45 CET [2016/06/30 8:06:45 ET]
Table 'California II' 9-max Seat #2 is the button
Seat 2: velourleder ($55.62 in chips) 
Seat 3: KovIFish89 ($100 in chips) 
Seat 4: mbk88 ($178.42 in chips) 
Seat 5: Rohitbarve ($103.01 in chips) 
Seat 6: matiko09 ($100 in chips) 
Seat 7: DomiVY ($84.20 in chips) 
Seat 8: picka4u ($167.69 in chips) 
Seat 9: di0d80 ($100 in chips) 
KovIFish89: posts small blind $0.50
mbk88: posts big blind $1
*** HOLE CARDS ***
Dealt to matiko09 [Kh Th]
Rohitbarve: raises $2 to $3
matiko09: raises $5 to $8
DomiVY: folds 
picka4u: folds 
di0d80: folds 
velourleder: folds 
KovIFish89: folds 
mbk88: folds 
Rohitbarve: calls $5
*** FLOP *** [8d 2c 5s]
Rohitbarve: checks 
matiko09: bets $10.80
Rohitbarve: folds 
Uncalled bet ($10.80) returned to matiko09
matiko09 collected $16.62 from pot
matiko09: doesn't show hand 
*** SUMMARY ***
Total pot $17.50 | Rake $0.88 
Board [8d 2c 5s]
Seat 2: velourleder (button) folded before Flop (didn't bet)
Seat 3: KovIFish89 (small blind) folded before Flop
Seat 4: mbk88 (big blind) folded before Flop
Seat 5: Rohitbarve folded on the Flop
Seat 6: matiko09 collected ($16.62)
Seat 7: DomiVY folded before Flop (didn't bet)
Seat 8: picka4u folded before Flop (didn't bet)
Seat 9: di0d80 folded before Flop (didn't bet)





PokerStars Hand #155380464386:  Hold'em No Limit ($0.50/$1.00 USD) - 2016/06/30 14:06:46 CET [2016/06/30 8:06:46 ET]
Table 'Tatjana' 9-max Seat #9 is the button
Seat 1: tipner ($102.70 in chips) 
Seat 2: DIMAN_324 ($100 in chips) 
Seat 3: Rafaello18 ($102.79 in chips) 
Seat 4: mopatron25 ($111.14 in chips) 
Seat 5: matiko09 ($100 in chips) 
Seat 6: mbk88 ($154.44 in chips) 
Seat 7: daigodisco ($47.84 in chips) 
Seat 8: alhill86 ($78.84 in chips) 
Seat 9: POTAPENKO700 ($235.71 in chips) 
tipner: posts small blind $0.50
DIMAN_324: posts big blind $1
*** HOLE CARDS ***
Dealt to matiko09 [2s 5s]
Rafaello18: folds 
mopatron25 has timed out
mopatron25: folds 
matiko09: folds 
mbk88: folds 
daigodisco: folds 
alhill86: folds 
POTAPENKO700: folds 
tipner: raises $2 to $3
DIMAN_324: calls $2
*** FLOP *** [Kc 8c Kh]
tipner: bets $2.85
DIMAN_324: folds 
Uncalled bet ($2.85) returned to tipner
tipner collected $5.70 from pot
tipner: doesn't show hand 
*** SUMMARY ***
Total pot $6 | Rake $0.30 
Board [Kc 8c Kh]
Seat 1: tipner (small blind) collected ($5.70)
Seat 2: DIMAN_324 (big blind) folded on the Flop
Seat 3: Rafaello18 folded before Flop (didn't bet)
Seat 4: mopatron25 folded before Flop (didn't bet)
Seat 5: matiko09 folded before Flop (didn't bet)
Seat 6: mbk88 folded before Flop (didn't bet)
Seat 7: daigodisco folded before Flop (didn't bet)
Seat 8: alhill86 folded before Flop (didn't bet)
Seat 9: POTAPENKO700 (button) folded before Flop (didn't bet)





PokerStars Hand #155380466071:  Hold'em No Limit ($0.50/$1.00 USD) - 2016/06/30 14:06:50 CET [2016/06/30 8:06:50 ET]
Table 'Borrelly II' 9-max Seat #7 is the button
Seat 2: mbk88 ($106.50 in chips) 
Seat 3: di0d80 ($103.02 in chips) 
Seat 4: DonRon_AT ($43.19 in chips) 
Seat 5: DIMAN_324 ($100 in chips) 
Seat 6: m_michalec ($168.56 in chips) 
Seat 7: matiko09 ($174.86 in chips) 
Seat 8: Arjun A Raju ($134.24 in chips) 
Seat 9: alhill86 ($77.18 in chips) 
Arjun A Raju: posts small blind $0.50
alhill86: posts big blind $1
*** HOLE CARDS ***
Dealt to matiko09 [2s 3c]
mbk88: folds 
di0d80: folds 
DonRon_AT: folds 
DIMAN_324: folds 
m_michalec: folds 
matiko09: folds 
Arjun A Raju: folds 
Uncalled bet ($0.50) returned to alhill86
alhill86 collected $1 from pot
alhill86: doesn't show hand 
*** SUMMARY ***
Total pot $1 | Rake $0 
Seat 2: mbk88 folded before Flop (didn't bet)
Seat 3: di0d80 folded before Flop (didn't bet)
Seat 4: DonRon_AT folded before Flop (didn't bet)
Seat 5: DIMAN_324 folded before Flop (didn't bet)
Seat 6: m_michalec folded before Flop (didn't bet)
Seat 7: matiko09 (button) folded before Flop (didn't bet)
Seat 8: Arjun A Raju (small blind) folded before Flop
Seat 9: alhill86 (big blind) collected ($1)





PokerStars Hand #155380469400:  Hold'em No Limit ($0.25/$0.50 USD) - 2016/06/30 14:06:57 CET [2016/06/30 8:06:57 ET]
Table 'Dorothea II' 9-max Seat #5 is the button
Seat 1: zapata 7777 ($89.15 in chips) 
Seat 2: joker180785 ($50 in chips) 
Seat 4: matiko09 ($166.46 in chips) 
Seat 5: Bailey Dew ($84.85 in chips) 
Seat 7: desmo465 ($57.24 in chips) 
Seat 8: TheMinion ($50 in chips) 
Seat 9: funXmun ($50 in chips) 
desmo465: posts small blind $0.25
TheMinion: posts big blind $0.50
fudzi: sits out 
zapata 7777: posts the ante $0.10
joker180785: posts the ante $0.10
matiko09: posts the ante $0.10
Bailey Dew: posts the ante $0.10
desmo465: posts the ante $0.10
TheMinion: posts the ante $0.10
funXmun: posts the ante $0.10
*** HOLE CARDS ***
Dealt to matiko09 [2c Th]
funXmun: folds 
zapata 7777: folds 
joker180785: folds 
matiko09: folds 
Bailey Dew: raises $0.50 to $1
desmo465: raises $2.30 to $3.30
TheMinion: folds 
Bailey Dew: folds 
Uncalled bet ($2.30) returned to desmo465
desmo465 collected $3.20 from pot
desmo465: doesn't show hand 
*** SUMMARY ***
Total pot $3.20 | Rake $0 
Seat 1: zapata 7777 folded before Flop (didn't bet)
Seat 2: joker180785 folded before Flop (didn't bet)
Seat 4: matiko09 folded before Flop (didn't bet)
Seat 5: Bailey Dew (button) folded before Flop
Seat 7: desmo465 (small blind) collected ($3.20)
Seat 8: TheMinion (big blind) folded before Flop
Seat 9: funXmun folded before Flop (didn't bet)





PokerStars Hand #155380469586:  Hold'em No Limit ($0.50/$1.00 USD) - 2016/06/30 14:06:57 CET [2016/06/30 8:06:57 ET]
Table 'Askania' 9-max Seat #2 is the button
Seat 1: chenconhaste ($102.50 in chips) 
Seat 2: DIMAN_324 ($100 in chips) 
Seat 3: matiko09 ($100 in chips) 
Seat 4: Hvittingfoss ($40 in chips) 
Seat 5: jezzaber ($104.20 in chips) 
Seat 8: kalcumite ($78.50 in chips) 
Seat 9: paul_007440 ($38.88 in chips) 
matiko09: posts small blind $0.50
Hvittingfoss: posts big blind $1
ruslik_by: sits out 
*** HOLE CARDS ***
Dealt to matiko09 [9h 5s]
jezzaber: folds 
kalcumite: raises $2 to $3
paul_007440: folds 
chenconhaste: folds 
DIMAN_324: folds 
matiko09: folds 
Hvittingfoss: folds 
Uncalled bet ($2) returned to kalcumite
kalcumite collected $2.50 from pot
kalcumite: doesn't show hand 
*** SUMMARY ***
Total pot $2.50 | Rake $0 
Seat 1: chenconhaste folded before Flop (didn't bet)
Seat 2: DIMAN_324 (button) folded before Flop (didn't bet)
Seat 3: matiko09 (small blind) folded before Flop
Seat 4: Hvittingfoss (big blind) folded before Flop
Seat 5: jezzaber folded before Flop (didn't bet)
Seat 8: kalcumite collected ($2.50)
Seat 9: paul_007440 folded before Flop (didn't bet)





PokerStars Hand #155380472108:  Hold'em No Limit ($0.50/$1.00 USD) - 2016/06/30 14:07:03 CET [2016/06/30 8:07:03 ET]
Table 'Asmodeus' 9-max Seat #4 is the button
Seat 1: scollop ($113.75 in chips) 
Seat 2: picka4u ($39.50 in chips) 
Seat 3: matiko09 ($105.41 in chips) 
Seat 4: DIMAN_324 ($110 in chips) 
Seat 6: koutani7 ($95.28 in chips) 
Seat 7: aaronzzr ($138.33 in chips) 
Seat 9: mbk88 ($158.86 in chips) 
koutani7: posts small blind $0.50
aaronzzr: posts big blind $1
*** HOLE CARDS ***
Dealt to matiko09 [6s Qh]
mbk88: folds 
scollop: raises $1 to $2
picka4u: folds 
matiko09: folds 
DIMAN_324: folds 
koutani7: raises $5 to $7
aaronzzr: folds 
scollop: calls $5
*** FLOP *** [2d 7s 8d]
koutani7: bets $10
scollop: folds 
Uncalled bet ($10) returned to koutani7
koutani7 collected $14.25 from pot
koutani7: doesn't show hand 
*** SUMMARY ***
Total pot $15 | Rake $0.75 
Board [2d 7s 8d]
Seat 1: scollop folded on the Flop
Seat 2: picka4u folded before Flop (didn't bet)
Seat 3: matiko09 folded before Flop (didn't bet)
Seat 4: DIMAN_324 (button) folded before Flop (didn't bet)
Seat 6: koutani7 (small blind) collected ($14.25)
Seat 7: aaronzzr (big blind) folded before Flop
Seat 9: mbk88 folded before Flop (didn't bet)





PokerStars Hand #155380473427:  Hold'em No Limit ($0.25/$0.50 USD) - 2016/06/30 14:07:06 CET [2016/06/30 8:07:06 ET]
Table 'Arcturus' 9-max Seat #8 is the button
Seat 1: kourk250 ($123.85 in chips) 
Seat 3: matiko09 ($54.31 in chips) 
Seat 5: stockbridge8 ($42.96 in chips) 
Seat 6: statistik85 ($59.59 in chips) 
Seat 7: DaikenGF ($65.26 in chips) 
Seat 8: TheMinion ($62.21 in chips) 
Seat 9: pfunkolstar ($58.42 in chips) 
pfunkolstar: posts small blind $0.25
kourk250: posts big blind $0.50
Vedpapa: sits out 
*** HOLE CARDS ***
Dealt to matiko09 [4h 2h]
matiko09: folds 
stockbridge8: folds 
statistik85: folds 
DaikenGF: raises $0.75 to $1.25
TheMinion: calls $1.25
pfunkolstar: folds 
kourk250: folds 
*** FLOP *** [7d Th 8s]
DaikenGF: checks 
TheMinion: bets $1.93
DaikenGF: folds 
Uncalled bet ($1.93) returned to TheMinion
TheMinion collected $3.09 from pot
TheMinion: doesn't show hand 
*** SUMMARY ***
Total pot $3.25 | Rake $0.16 
Board [7d Th 8s]
Seat 1: kourk250 (big blind) folded before Flop
Seat 3: matiko09 folded before Flop (didn't bet)
Seat 5: stockbridge8 folded before Flop (didn't bet)
Seat 6: statistik85 folded before Flop (didn't bet)
Seat 7: DaikenGF folded on the Flop
Seat 8: TheMinion (button) collected ($3.09)
Seat 9: pfunkolstar (small blind) folded before Flop





PokerStars Hand #155380475120:  Hold'em No Limit ($0.50/$1.00 USD) - 2016/06/30 14:07:09 CET [2016/06/30 8:07:09 ET]
Table 'Borrelly II' 9-max Seat #8 is the button
Seat 2: mbk88 ($106.50 in chips) 
Seat 3: di0d80 ($103.02 in chips) 
Seat 4: DonRon_AT ($43.19 in chips) 
Seat 5: DIMAN_324 ($100 in chips) 
Seat 6: m_michalec ($168.56 in chips) 
Seat 7: matiko09 ($174.86 in chips) 
Seat 8: Arjun A Raju ($133.74 in chips) 
Seat 9: alhill86 ($77.68 in chips) 
alhill86: posts small blind $0.50
mbk88: posts big blind $1
*** HOLE CARDS ***
Dealt to matiko09 [Kc Ks]
di0d80: folds 
DonRon_AT: folds 
DIMAN_324: folds 
m_michalec: folds 
matiko09: raises $1.50 to $2.50
Arjun A Raju: folds 
alhill86: folds 
mbk88: folds 
Uncalled bet ($1.50) returned to matiko09
matiko09 collected $2.50 from pot
matiko09: doesn't show hand 
*** SUMMARY ***
Total pot $2.50 | Rake $0 
Seat 2: mbk88 (big blind) folded before Flop
Seat 3: di0d80 folded before Flop (didn't bet)
Seat 4: DonRon_AT folded before Flop (didn't bet)
Seat 5: DIMAN_324 folded before Flop (didn't bet)
Seat 6: m_michalec folded before Flop (didn't bet)
Seat 7: matiko09 collected ($2.50)
Seat 8: Arjun A Raju (button) folded before Flop (didn't bet)
Seat 9: alhill86 (small blind) folded before Flop





PokerStars Hand #155380475346:  Hold'em No Limit ($0.50/$1.00 USD) - 2016/06/30 14:07:10 CET [2016/06/30 8:07:10 ET]
Table 'Altarf II' 9-max Seat #2 is the button
Seat 2: KovIFish89 ($100 in chips) 
Seat 4: Greha999 ($71.16 in chips) 
Seat 5: DIMAN_324 ($229.74 in chips) 
Seat 6: mbk88 ($100 in chips) 
Seat 7: matiko09 ($104.90 in chips) 
Seat 8: DomiVY ($40 in chips) 
Seat 9: omanibemihum ($132.07 in chips) 
Greha999: posts small blind $0.50
DIMAN_324: posts big blind $1
*** HOLE CARDS ***
Dealt to matiko09 [Qc 7c]
mbk88: folds 
matiko09: folds 
DomiVY: folds 
omanibemihum: calls $1
KovIFish89: raises $3 to $4
Greha999: folds 
DIMAN_324: folds 
omanibemihum: folds 
Uncalled bet ($3) returned to KovIFish89
KovIFish89 collected $3.50 from pot
KovIFish89: doesn't show hand 
*** SUMMARY ***
Total pot $3.50 | Rake $0 
Seat 2: KovIFish89 (button) collected ($3.50)
Seat 4: Greha999 (small blind) folded before Flop
Seat 5: DIMAN_324 (big blind) folded before Flop
Seat 6: mbk88 folded before Flop (didn't bet)
Seat 7: matiko09 folded before Flop (didn't bet)
Seat 8: DomiVY folded before Flop (didn't bet)
Seat 9: omanibemihum folded before Flop





PokerStars Hand #155380480144:  Hold'em No Limit ($0.50/$1.00 USD) - 2016/06/30 14:07:21 CET [2016/06/30 8:07:21 ET]
Table 'Askania' 9-max Seat #3 is the button
Seat 1: chenconhaste ($102.50 in chips) 
Seat 2: DIMAN_324 ($100 in chips) 
Seat 3: matiko09 ($100 in chips) 
Seat 4: Hvittingfoss ($39 in chips) 
Seat 5: jezzaber ($104.20 in chips) 
Seat 8: kalcumite ($80 in chips) 
Seat 9: paul_007440 ($38.88 in chips) 
Hvittingfoss: posts small blind $0.50
jezzaber: posts big blind $1
ruslik_by: sits out 
*** HOLE CARDS ***
Dealt to matiko09 [6c 7h]
kalcumite: calls $1
paul_007440: folds 
chenconhaste: folds 
DIMAN_324: folds 
matiko09: folds 
Hvittingfoss: calls $0.50
jezzaber: checks 
*** FLOP *** [Jd 9c 5h]
Hvittingfoss: checks 
jezzaber: checks 
kalcumite: checks 
*** TURN *** [Jd 9c 5h] [Qc]
Hvittingfoss: checks 
jezzaber: checks 
kalcumite: bets $1
Hvittingfoss: calls $1
jezzaber: calls $1
*** RIVER *** [Jd 9c 5h Qc] [3d]
Hvittingfoss: checks 
jezzaber: checks 
kalcumite: checks 
*** SHOW DOWN ***
Hvittingfoss: shows [5c Ah] (a pair of Fives)
jezzaber: mucks hand 
kalcumite: mucks hand 
Hvittingfoss collected $5.70 from pot
*** SUMMARY ***
Total pot $6 | Rake $0.30 
Board [Jd 9c 5h Qc 3d]
Seat 1: chenconhaste folded before Flop (didn't bet)
Seat 2: DIMAN_324 folded before Flop (didn't bet)
Seat 3: matiko09 (button) folded before Flop (didn't bet)
Seat 4: Hvittingfoss (small blind) showed [5c Ah] and won ($5.70) with a pair of Fives
Seat 5: jezzaber (big blind) mucked [6h Th]
Seat 8: kalcumite mucked [Ac 7c]
Seat 9: paul_007440 folded before Flop (didn't bet)





PokerStars Hand #155380483480:  Hold'em No Limit ($0.50/$1.00 USD) - 2016/06/30 14:07:28 CET [2016/06/30 8:07:28 ET]
Table 'California II' 9-max Seat #3 is the button
Seat 2: velourleder ($55.62 in chips) 
Seat 3: KovIFish89 ($100 in chips) 
Seat 4: mbk88 ($177.42 in chips) 
Seat 5: Rohitbarve ($95.01 in chips) 
Seat 6: matiko09 ($108.62 in chips) 
Seat 7: DomiVY ($84.20 in chips) 
Seat 8: picka4u ($167.69 in chips) 
Seat 9: di0d80 ($100 in chips) 
mbk88: posts small blind $0.50
Rohitbarve: posts big blind $1
*** HOLE CARDS ***
Dealt to matiko09 [9c 4h]
matiko09: folds 
DomiVY: folds 
picka4u: folds 
di0d80: folds 
velourleder: calls $1
KovIFish89: folds 
mbk88: folds 
Rohitbarve: checks 
*** FLOP *** [Ad 4s 2c]
Rohitbarve: checks 
velourleder: checks 
*** TURN *** [Ad 4s 2c] [Ah]
Rohitbarve: checks 
velourleder: bets $3
Rohitbarve: folds 
Uncalled bet ($3) returned to velourleder
velourleder collected $2.38 from pot
velourleder: doesn't show hand 
*** SUMMARY ***
Total pot $2.50 | Rake $0.12 
Board [Ad 4s 2c Ah]
Seat 2: velourleder collected ($2.38)
Seat 3: KovIFish89 (button) folded before Flop (didn't bet)
Seat 4: mbk88 (small blind) folded before Flop
Seat 5: Rohitbarve (big blind) folded on the Turn
Seat 6: matiko09 folded before Flop (didn't bet)
Seat 7: DomiVY folded before Flop (didn't bet)
Seat 8: picka4u folded before Flop (didn't bet)
Seat 9: di0d80 folded before Flop (didn't bet)





PokerStars Hand #155380486165:  Hold'em No Limit ($0.25/$0.50 USD) - 2016/06/30 14:07:34 CET [2016/06/30 8:07:34 ET]
Table 'Dorothea II' 9-max Seat #7 is the button
Seat 1: zapata 7777 ($89.05 in chips) 
Seat 2: joker180785 ($50 in chips) 
Seat 4: matiko09 ($166.36 in chips) 
Seat 5: Bailey Dew ($83.75 in chips) 
Seat 7: desmo465 ($59.34 in chips) 
Seat 8: TheMinion ($50 in chips) 
Seat 9: funXmun ($50 in chips) 
TheMinion: posts small blind $0.25
funXmun: posts big blind $0.50
fudzi: sits out 
zapata 7777: posts the ante $0.10
joker180785: posts the ante $0.10
matiko09: posts the ante $0.10
Bailey Dew: posts the ante $0.10
desmo465: posts the ante $0.10
TheMinion: posts the ante $0.10
funXmun: posts the ante $0.10
*** HOLE CARDS ***
Dealt to matiko09 [Qs 9h]
zapata 7777: folds 
joker180785: raises $1 to $1.50
matiko09: folds 
Bailey Dew: folds 
desmo465: calls $1.50
TheMinion: folds 
funXmun: folds 
*** FLOP *** [3h Td 3c]
joker180785: bets $2.24
desmo465: calls $2.24
*** TURN *** [3h Td 3c] [4c]
joker180785: checks 
desmo465: bets $4.24
joker180785: folds 
Uncalled bet ($4.24) returned to desmo465
desmo465 collected $8.48 from pot
desmo465: doesn't show hand 
*** SUMMARY ***
Total pot $8.93 | Rake $0.45 
Board [3h Td 3c 4c]
Seat 1: zapata 7777 folded before Flop (didn't bet)
Seat 2: joker180785 folded on the Turn
Seat 4: matiko09 folded before Flop (didn't bet)
Seat 5: Bailey Dew folded before Flop (didn't bet)
Seat 7: desmo465 (button) collected ($8.48)
Seat 8: TheMinion (small blind) folded before Flop
Seat 9: funXmun (big blind) folded before Flop





PokerStars Hand #155380486129:  Hold'em No Limit ($0.50/$1.00 USD) - 2016/06/30 14:07:34 CET [2016/06/30 8:07:34 ET]
Table 'Borrelly II' 9-max Seat #9 is the button
Seat 2: mbk88 ($105.50 in chips) 
Seat 3: di0d80 ($103.02 in chips) 
Seat 4: DonRon_AT ($43.19 in chips) 
Seat 5: DIMAN_324 ($100 in chips) 
Seat 6: m_michalec ($168.56 in chips) 
Seat 7: matiko09 ($176.36 in chips) 
Seat 8: Arjun A Raju ($133.74 in chips) 
Seat 9: alhill86 ($77.18 in chips) 
mbk88: posts small blind $0.50
di0d80: posts big blind $1
*** HOLE CARDS ***
Dealt to matiko09 [Jc 7c]
DonRon_AT: calls $1
DIMAN_324: folds 
m_michalec: raises $2 to $3
matiko09: folds 
Arjun A Raju: folds 
alhill86: folds 
mbk88: folds 
di0d80: folds 
DonRon_AT: calls $2
*** FLOP *** [2s 2c Qh]
DonRon_AT: checks 
m_michalec: bets $4
DonRon_AT: folds 
Uncalled bet ($4) returned to m_michalec
m_michalec collected $7.12 from pot
m_michalec: doesn't show hand 
*** SUMMARY ***
Total pot $7.50 | Rake $0.38 
Board [2s 2c Qh]
Seat 2: mbk88 (small blind) folded before Flop
Seat 3: di0d80 (big blind) folded before Flop
Seat 4: DonRon_AT folded on the Flop
Seat 5: DIMAN_324 folded before Flop (didn't bet)
Seat 6: m_michalec collected ($7.12)
Seat 7: matiko09 folded before Flop (didn't bet)
Seat 8: Arjun A Raju folded before Flop (didn't bet)
Seat 9: alhill86 (button) folded before Flop (didn't bet)





PokerStars Hand #155380488732:  Hold'em No Limit ($0.50/$1.00 USD) - 2016/06/30 14:07:40 CET [2016/06/30 8:07:40 ET]
Table 'Tatjana' 9-max Seat #1 is the button
Seat 1: tipner ($105.40 in chips) 
Seat 2: DIMAN_324 ($100 in chips) 
Seat 5: matiko09 ($100 in chips) 
Seat 6: mbk88 ($154.44 in chips) 
Seat 7: daigodisco ($47.84 in chips) 
Seat 8: alhill86 ($78.84 in chips) 
Seat 9: POTAPENKO700 ($235.71 in chips) 
DIMAN_324: posts small blind $0.50
Rafaello18: is sitting out 
matiko09: posts big blind $1
*** HOLE CARDS ***
Dealt to matiko09 [6h Jd]
mbk88: folds 
daigodisco: folds 
alhill86: folds 
POTAPENKO700: folds 
tipner: raises $1.50 to $2.50
DIMAN_324: raises $6 to $8.50
matiko09: folds 
tipner: raises $13.50 to $22
DIMAN_324: folds 
Uncalled bet ($13.50) returned to tipner
tipner collected $18 from pot
tipner: doesn't show hand 
*** SUMMARY ***
Total pot $18 | Rake $0 
Seat 1: tipner (button) collected ($18)
Seat 2: DIMAN_324 (small blind) folded before Flop
Seat 5: matiko09 (big blind) folded before Flop
Seat 6: mbk88 folded before Flop (didn't bet)
Seat 7: daigodisco folded before Flop (didn't bet)
Seat 8: alhill86 folded before Flop (didn't bet)
Seat 9: POTAPENKO700 folded before Flop (didn't bet)





PokerStars Hand #155380492640:  Hold'em No Limit ($0.50/$1.00 USD) - 2016/06/30 14:07:49 CET [2016/06/30 8:07:49 ET]
Table 'Altarf II' 9-max Seat #4 is the button
Seat 2: KovIFish89 ($102.50 in chips) 
Seat 4: Greha999 ($70.66 in chips) 
Seat 5: DIMAN_324 ($228.74 in chips) 
Seat 6: mbk88 ($100 in chips) 
Seat 7: matiko09 ($104.90 in chips) 
Seat 8: DomiVY ($40 in chips) 
Seat 9: omanibemihum ($131.07 in chips) 
DIMAN_324: posts small blind $0.50
mbk88: posts big blind $1
*** HOLE CARDS ***
Dealt to matiko09 [7s Td]
matiko09: folds 
DomiVY: folds 
omanibemihum: folds 
KovIFish89: folds 
Greha999: raises $1 to $2
DIMAN_324: folds 
mbk88: folds 
Uncalled bet ($1) returned to Greha999
Greha999 collected $2.50 from pot
*** SUMMARY ***
Total pot $2.50 | Rake $0 
Seat 2: KovIFish89 folded before Flop (didn't bet)
Seat 4: Greha999 (button) collected ($2.50)
Seat 5: DIMAN_324 (small blind) folded before Flop
Seat 6: mbk88 (big blind) folded before Flop
Seat 7: matiko09 folded before Flop (didn't bet)
Seat 8: DomiVY folded before Flop (didn't bet)
Seat 9: omanibemihum folded before Flop (didn't bet)





PokerStars Hand #155380496541:  Hold'em No Limit ($0.50/$1.00 USD) - 2016/06/30 14:07:57 CET [2016/06/30 8:07:57 ET]
Table 'California II' 9-max Seat #4 is the button
Seat 2: velourleder ($57 in chips) 
Seat 3: KovIFish89 ($100 in chips) 
Seat 4: mbk88 ($176.92 in chips) 
Seat 5: Rohitbarve ($94.01 in chips) 
Seat 6: matiko09 ($108.62 in chips) 
Seat 7: DomiVY ($84.20 in chips) 
Seat 8: picka4u ($167.69 in chips) 
Seat 9: di0d80 ($100 in chips) 
Rohitbarve: posts small blind $0.50
matiko09: posts big blind $1
*** HOLE CARDS ***
Dealt to matiko09 [2h Jh]
DomiVY: folds 
picka4u: folds 
di0d80: folds 
velourleder: folds 
KovIFish89: folds 
mbk88: raises $1.02 to $2.02
Rohitbarve: folds 
matiko09: folds 
Uncalled bet ($1.02) returned to mbk88
mbk88 collected $2.50 from pot
mbk88: doesn't show hand 
*** SUMMARY ***
Total pot $2.50 | Rake $0 
Seat 2: velourleder folded before Flop (didn't bet)
Seat 3: KovIFish89 folded before Flop (didn't bet)
Seat 4: mbk88 (button) collected ($2.50)
Seat 5: Rohitbarve (small blind) folded before Flop
Seat 6: matiko09 (big blind) folded before Flop
Seat 7: DomiVY folded before Flop (didn't bet)
Seat 8: picka4u folded before Flop (didn't bet)
Seat 9: di0d80 folded before Flop (didn't bet)





PokerStars Hand #155380498426:  Hold'em No Limit ($0.50/$1.00 USD) - 2016/06/30 14:08:02 CET [2016/06/30 8:08:02 ET]
Table 'Sigrid' 9-max Seat #7 is the button
Seat 1: Greha999 ($70.90 in chips) 
Seat 2: matiko09 ($105.52 in chips) 
Seat 4: mbk88 ($120.87 in chips) 
Seat 5: DIMAN_324 ($100 in chips) 
Seat 6: di0d80 ($115.39 in chips) 
Seat 7: arctur17 ($34 in chips) 
Seat 8: Kukuryzka ($99 in chips) 
Seat 9: KovIFish89 ($102.46 in chips) 
Kukuryzka: posts small blind $0.50
KovIFish89: posts big blind $1
*** HOLE CARDS ***
Dealt to matiko09 [9c 8d]
Greha999: folds 
matiko09: folds 
mbk88: folds 
DIMAN_324: folds 
di0d80: folds 
arctur17: folds 
Kukuryzka: folds 
Uncalled bet ($0.50) returned to KovIFish89
KovIFish89 collected $1 from pot
KovIFish89: doesn't show hand 
*** SUMMARY ***
Total pot $1 | Rake $0 
Seat 1: Greha999 folded before Flop (didn't bet)
Seat 2: matiko09 folded before Flop (didn't bet)
Seat 4: mbk88 folded before Flop (didn't bet)
Seat 5: DIMAN_324 folded before Flop (didn't bet)
Seat 6: di0d80 folded before Flop (didn't bet)
Seat 7: arctur17 (button) folded before Flop (didn't bet)
Seat 8: Kukuryzka (small blind) folded before Flop
Seat 9: KovIFish89 (big blind) collected ($1)





PokerStars Hand #155380499743:  Hold'em No Limit ($0.50/$1.00 USD) - 2016/06/30 14:08:05 CET [2016/06/30 8:08:05 ET]
Table 'Asmodeus' 9-max Seat #6 is the button
Seat 1: scollop ($106.75 in chips) 
Seat 2: picka4u ($39.50 in chips) 
Seat 3: matiko09 ($105.41 in chips) 
Seat 4: DIMAN_324 ($110 in chips) 
Seat 6: koutani7 ($102.53 in chips) 
Seat 7: aaronzzr ($137.33 in chips) 
Seat 9: mbk88 ($158.86 in chips) 
aaronzzr: posts small blind $0.50
mbk88: posts big blind $1
*** HOLE CARDS ***
Dealt to matiko09 [7c As]
scollop: folds 
picka4u: folds 
matiko09: folds 
DIMAN_324: folds 
koutani7: folds 
aaronzzr: calls $0.50
mbk88: checks 
*** FLOP *** [8d 6c Ac]
aaronzzr: checks 
mbk88: bets $2
aaronzzr: folds 
Uncalled bet ($2) returned to mbk88
mbk88 collected $1.90 from pot
mbk88: doesn't show hand 
*** SUMMARY ***
Total pot $2 | Rake $0.10 
Board [8d 6c Ac]
Seat 1: scollop folded before Flop (didn't bet)
Seat 2: picka4u folded before Flop (didn't bet)
Seat 3: matiko09 folded before Flop (didn't bet)
Seat 4: DIMAN_324 folded before Flop (didn't bet)
Seat 6: koutani7 (button) folded before Flop (didn't bet)
Seat 7: aaronzzr (small blind) folded on the Flop
Seat 9: mbk88 (big blind) collected ($1.90)





PokerStars Hand #155380500981:  Hold'em No Limit ($0.50/$1.00 USD) - 2016/06/30 14:08:07 CET [2016/06/30 8:08:07 ET]
Table 'Askania' 9-max Seat #4 is the button
Seat 1: chenconhaste ($102.50 in chips) 
Seat 2: DIMAN_324 ($100 in chips) 
Seat 3: matiko09 ($100 in chips) 
Seat 4: Hvittingfoss ($42.70 in chips) 
Seat 5: jezzaber ($102.20 in chips) 
Seat 7: ruslik_by ($100 in chips) 
Seat 8: kalcumite ($78 in chips) 
Seat 9: paul_007440 ($38.88 in chips) 
jezzaber: posts small blind $0.50
ruslik_by: posts big blind $1
*** HOLE CARDS ***
Dealt to matiko09 [Qs 8c]
kalcumite: folds 
paul_007440: folds 
chenconhaste: folds 
DIMAN_324: raises $2 to $3
matiko09: folds 
Hvittingfoss: folds 
jezzaber: folds 
ruslik_by: folds 
Uncalled bet ($2) returned to DIMAN_324
DIMAN_324 collected $2.50 from pot
DIMAN_324: doesn't show hand 
*** SUMMARY ***
Total pot $2.50 | Rake $0 
Seat 1: chenconhaste folded before Flop (didn't bet)
Seat 2: DIMAN_324 collected ($2.50)
Seat 3: matiko09 folded before Flop (didn't bet)
Seat 4: Hvittingfoss (button) folded before Flop (didn't bet)
Seat 5: jezzaber (small blind) folded before Flop
Seat 7: ruslik_by (big blind) folded before Flop
Seat 8: kalcumite folded before Flop (didn't bet)
Seat 9: paul_007440 folded before Flop (didn't bet)





PokerStars Hand #155380502953:  Hold'em No Limit ($0.25/$0.50 USD) - 2016/06/30 14:08:12 CET [2016/06/30 8:08:12 ET]
Table 'Elektra II' 9-max Seat #4 is the button
Seat 1: drlee77 ($44.53 in chips) 
Seat 2: TheMinion ($60.82 in chips) 
Seat 3: mojtabagol ($80.79 in chips) 
Seat 4: matiko09 ($54.86 in chips) 
Seat 6: pfunkolstar ($50 in chips) 
Seat 7: MuddyDance ($50 in chips) 
Seat 8: sanr23 ($57.84 in chips) 
Seat 9: KABAL_ua ($54.77 in chips) 
pfunkolstar: posts small blind $0.25
MuddyDance: posts big blind $0.50
*** HOLE CARDS ***
Dealt to matiko09 [Qs Qc]
sanr23: raises $1 to $1.50
KABAL_ua: folds 
drlee77: folds 
TheMinion: folds 
mojtabagol: folds 
matiko09: calls $1.50
pfunkolstar: folds 
MuddyDance: folds 
*** FLOP *** [Kd Ah Jh]
sanr23: bets $2.35
matiko09: calls $2.35
*** TURN *** [Kd Ah Jh] [Td]
sanr23: checks 
matiko09: bets $6
sanr23: folds 
Uncalled bet ($6) returned to matiko09
matiko09 collected $8.03 from pot
matiko09: doesn't show hand 
*** SUMMARY ***
Total pot $8.45 | Rake $0.42 
Board [Kd Ah Jh Td]
Seat 1: drlee77 folded before Flop (didn't bet)
Seat 2: TheMinion folded before Flop (didn't bet)
Seat 3: mojtabagol folded before Flop (didn't bet)
Seat 4: matiko09 (button) collected ($8.03)
Seat 6: pfunkolstar (small blind) folded before Flop
Seat 7: MuddyDance (big blind) folded before Flop
Seat 8: sanr23 folded on the Turn
Seat 9: KABAL_ua folded before Flop (didn't bet)





PokerStars Hand #155380508844:  Hold'em No Limit ($0.50/$1.00 USD) - 2016/06/30 14:08:25 CET [2016/06/30 8:08:25 ET]
Table 'Tatjana' 9-max Seat #2 is the button
Seat 1: tipner ($114.90 in chips) 
Seat 2: DIMAN_324 ($100 in chips) 
Seat 5: matiko09 ($100 in chips) 
Seat 6: mbk88 ($154.44 in chips) 
Seat 7: daigodisco ($47.84 in chips) 
Seat 8: alhill86 ($78.84 in chips) 
Seat 9: POTAPENKO700 ($235.71 in chips) 
matiko09: posts small blind $0.50
mbk88: posts big blind $1
*** HOLE CARDS ***
Dealt to matiko09 [2s Tc]
daigodisco has timed out
daigodisco: folds 
alhill86: folds 
POTAPENKO700: folds 
tipner: raises $1 to $2
DIMAN_324: folds 
matiko09: folds 
mbk88: folds 
Uncalled bet ($1) returned to tipner
tipner collected $2.50 from pot
tipner: doesn't show hand 
*** SUMMARY ***
Total pot $2.50 | Rake $0 
Seat 1: tipner collected ($2.50)
Seat 2: DIMAN_324 (button) folded before Flop (didn't bet)
Seat 5: matiko09 (small blind) folded before Flop
Seat 6: mbk88 (big blind) folded before Flop
Seat 7: daigodisco folded before Flop (didn't bet)
Seat 8: alhill86 folded before Flop (didn't bet)
Seat 9: POTAPENKO700 folded before Flop (didn't bet)





PokerStars Hand #155380508891:  Hold'em No Limit ($0.50/$1.00 USD) - 2016/06/30 14:08:25 CET [2016/06/30 8:08:25 ET]
Table 'Askania' 9-max Seat #5 is the button
Seat 1: chenconhaste ($102.50 in chips) 
Seat 2: DIMAN_324 ($101.50 in chips) 
Seat 3: matiko09 ($100 in chips) 
Seat 4: Hvittingfoss ($42.70 in chips) 
Seat 5: jezzaber ($101.70 in chips) 
Seat 7: ruslik_by ($100 in chips) 
Seat 8: kalcumite ($78 in chips) 
Seat 9: paul_007440 ($38.88 in chips) 
ruslik_by: posts small blind $0.50
kalcumite: posts big blind $1
*** HOLE CARDS ***
Dealt to matiko09 [Kh 5h]
paul_007440: folds 
chenconhaste: folds 
DIMAN_324: folds 
matiko09: folds 
Hvittingfoss: folds 
jezzaber: folds 
ruslik_by: raises $2 to $3
kalcumite: raises $8 to $11
ruslik_by: folds 
Uncalled bet ($8) returned to kalcumite
kalcumite collected $6 from pot
kalcumite: doesn't show hand 
*** SUMMARY ***
Total pot $6 | Rake $0 
Seat 1: chenconhaste folded before Flop (didn't bet)
Seat 2: DIMAN_324 folded before Flop (didn't bet)
Seat 3: matiko09 folded before Flop (didn't bet)
Seat 4: Hvittingfoss folded before Flop (didn't bet)
Seat 5: jezzaber (button) folded before Flop (didn't bet)
Seat 7: ruslik_by (small blind) folded before Flop
Seat 8: kalcumite (big blind) collected ($6)
Seat 9: paul_007440 folded before Flop (didn't bet)





PokerStars Hand #155380510651:  Hold'em No Limit ($0.50/$1.00 USD) - 2016/06/30 14:08:29 CET [2016/06/30 8:08:29 ET]
Table 'Altarf II' 9-max Seat #5 is the button
Seat 2: KovIFish89 ($102.50 in chips) 
Seat 4: Greha999 ($72.16 in chips) 
Seat 5: DIMAN_324 ($228.24 in chips) 
Seat 6: mbk88 ($100 in chips) 
Seat 7: matiko09 ($104.90 in chips) 
Seat 8: DomiVY ($40 in chips) 
Seat 9: omanibemihum ($131.07 in chips) 
mbk88: posts small blind $0.50
matiko09: posts big blind $1
*** HOLE CARDS ***
Dealt to matiko09 [Tc 5c]
DomiVY: folds 
omanibemihum: raises $2 to $3
KovIFish89: folds 
Greha999: folds 
DIMAN_324: folds 
mbk88: folds 
matiko09: folds 
Uncalled bet ($2) returned to omanibemihum
omanibemihum collected $2.50 from pot
omanibemihum: doesn't show hand 
*** SUMMARY ***
Total pot $2.50 | Rake $0 
Seat 2: KovIFish89 folded before Flop (didn't bet)
Seat 4: Greha999 folded before Flop (didn't bet)
Seat 5: DIMAN_324 (button) folded before Flop (didn't bet)
Seat 6: mbk88 (small blind) folded before Flop
Seat 7: matiko09 (big blind) folded before Flop
Seat 8: DomiVY folded before Flop (didn't bet)
Seat 9: omanibemihum collected ($2.50)





PokerStars Hand #155380511356:  Hold'em No Limit ($0.50/$1.00 USD) - 2016/06/30 14:08:30 CET [2016/06/30 8:08:30 ET]
Table 'Borrelly II' 9-max Seat #2 is the button
Seat 2: mbk88 ($105 in chips) 
Seat 3: di0d80 ($102.02 in chips) 
Seat 4: DonRon_AT ($40.19 in chips) 
Seat 5: DIMAN_324 ($100 in chips) 
Seat 6: m_michalec ($172.68 in chips) 
Seat 7: matiko09 ($176.36 in chips) 
Seat 8: Arjun A Raju ($133.74 in chips) 
Seat 9: alhill86 ($77.18 in chips) 
di0d80: posts small blind $0.50
DonRon_AT: posts big blind $1
*** HOLE CARDS ***
Dealt to matiko09 [2h Th]
DIMAN_324: folds 
m_michalec: folds 
matiko09: folds 
Arjun A Raju: folds 
alhill86: folds 
mbk88: folds 
di0d80: folds 
Uncalled bet ($0.50) returned to DonRon_AT
DonRon_AT collected $1 from pot
DonRon_AT: doesn't show hand 
*** SUMMARY ***
Total pot $1 | Rake $0 
Seat 2: mbk88 (button) folded before Flop (didn't bet)
Seat 3: di0d80 (small blind) folded before Flop
Seat 4: DonRon_AT (big blind) collected ($1)
Seat 5: DIMAN_324 folded before Flop (didn't bet)
Seat 6: m_michalec folded before Flop (didn't bet)
Seat 7: matiko09 folded before Flop (didn't bet)
Seat 8: Arjun A Raju folded before Flop (didn't bet)
Seat 9: alhill86 folded before Flop (didn't bet)





PokerStars Hand #155380512331:  Hold'em No Limit ($0.25/$0.50 USD) - 2016/06/30 14:08:33 CET [2016/06/30 8:08:33 ET]
Table 'Dorothea II' 9-max Seat #8 is the button
Seat 1: zapata 7777 ($88.95 in chips) 
Seat 2: joker180785 ($50 in chips) 
Seat 4: matiko09 ($166.26 in chips) 
Seat 5: Bailey Dew ($83.65 in chips) 
Seat 7: desmo465 ($63.98 in chips) 
Seat 8: TheMinion ($50 in chips) 
Seat 9: funXmun ($50 in chips) 
funXmun: posts small blind $0.25
zapata 7777: posts big blind $0.50
fudzi: sits out 
zapata 7777: posts the ante $0.10
joker180785: posts the ante $0.10
matiko09: posts the ante $0.10
Bailey Dew: posts the ante $0.10
desmo465: posts the ante $0.10
TheMinion: posts the ante $0.10
funXmun: posts the ante $0.10
*** HOLE CARDS ***
Dealt to matiko09 [6s Qh]
joker180785: folds 
matiko09: folds 
Bailey Dew: folds 
desmo465: raises $1 to $1.50
TheMinion: folds 
funXmun: raises $3.50 to $5
zapata 7777: folds 
desmo465: calls $3.50
*** FLOP *** [3h 7h 9c]
funXmun: checks 
desmo465: checks 
*** TURN *** [3h 7h 9c] [5c]
ivan100886 leaves the table
funXmun: checks 
desmo465: bets $7.09
funXmun: folds 
Uncalled bet ($7.09) returned to desmo465
kotkas1000 joins the table at seat #6 
desmo465 collected $10.64 from pot
desmo465: doesn't show hand 
*** SUMMARY ***
Total pot $11.20 | Rake $0.56 
Board [3h 7h 9c 5c]
Seat 1: zapata 7777 (big blind) folded before Flop
Seat 2: joker180785 folded before Flop (didn't bet)
Seat 4: matiko09 folded before Flop (didn't bet)
Seat 5: Bailey Dew folded before Flop (didn't bet)
Seat 7: desmo465 collected ($10.64)
Seat 8: TheMinion (button) folded before Flop (didn't bet)
Seat 9: funXmun (small blind) folded on the Turn





PokerStars Hand #155380512916:  Hold'em No Limit ($0.50/$1.00 USD) - 2016/06/30 14:08:34 CET [2016/06/30 8:08:34 ET]
Table 'California II' 9-max Seat #5 is the button
Seat 2: velourleder ($57 in chips) 
Seat 3: KovIFish89 ($100 in chips) 
Seat 4: mbk88 ($178.42 in chips) 
Seat 5: Rohitbarve ($93.51 in chips) 
Seat 6: matiko09 ($107.62 in chips) 
Seat 7: DomiVY ($84.20 in chips) 
Seat 8: picka4u ($167.69 in chips) 
Seat 9: di0d80 ($100 in chips) 
matiko09: posts small blind $0.50
DomiVY: posts big blind $1
*** HOLE CARDS ***
Dealt to matiko09 [As Jd]
picka4u: folds 
picka4u leaves the table
sanr23 joins the table at seat #8 
di0d80: folds 
velourleder: folds 
KovIFish89: folds 
mbk88: folds 
Rohitbarve: raises $2 to $3
matiko09: raises $7 to $10
DomiVY: folds 
Rohitbarve: calls $7
*** FLOP *** [9c 9s 5c]
matiko09: bets $6.18
Rohitbarve: raises $8.82 to $15
matiko09: folds 
Uncalled bet ($8.82) returned to Rohitbarve
Rohitbarve collected $31.69 from pot
Rohitbarve: doesn't show hand 
*** SUMMARY ***
Total pot $33.36 | Rake $1.67 
Board [9c 9s 5c]
Seat 2: velourleder folded before Flop (didn't bet)
Seat 3: KovIFish89 folded before Flop (didn't bet)
Seat 4: mbk88 folded before Flop (didn't bet)
Seat 5: Rohitbarve (button) collected ($31.69)
Seat 6: matiko09 (small blind) folded on the Flop
Seat 7: DomiVY (big blind) folded before Flop
Seat 8: picka4u folded before Flop (didn't bet)
Seat 9: di0d80 folded before Flop (didn't bet)





PokerStars Hand #155380514448:  Hold'em No Limit ($0.50/$1.00 USD) - 2016/06/30 14:08:37 CET [2016/06/30 8:08:37 ET]
Table 'Sigrid' 9-max Seat #8 is the button
Seat 2: matiko09 ($105.52 in chips) 
Seat 4: mbk88 ($120.87 in chips) 
Seat 5: DIMAN_324 ($100 in chips) 
Seat 6: di0d80 ($115.39 in chips) 
Seat 7: arctur17 ($34 in chips) 
Seat 8: Kukuryzka ($100 in chips) 
Seat 9: KovIFish89 ($102.96 in chips) 
KovIFish89: posts small blind $0.50
matiko09: posts big blind $1
*** HOLE CARDS ***
Dealt to matiko09 [8d 5s]
mbk88: folds 
DIMAN_324: folds 
di0d80: folds 
arctur17: raises $2 to $3
Kukuryzka: raises $6 to $9
KovIFish89: folds 
matiko09: folds 
arctur17: calls $6
*** FLOP *** [2d Qd Td]
arctur17: checks 
Kukuryzka: checks 
*** TURN *** [2d Qd Td] [2h]
arctur17: checks 
Kukuryzka: bets $12.59
arctur17: calls $12.59
*** RIVER *** [2d Qd Td 2h] [7s]
arctur17: checks 
Kukuryzka: bets $78.41 and is all-in
arctur17: calls $12.41 and is all-in
Uncalled bet ($66) returned to Kukuryzka
*** SHOW DOWN ***
Kukuryzka: shows [Kc Ks] (two pair, Kings and Deuces)
arctur17: shows [9d 9s] (two pair, Nines and Deuces)
Kukuryzka collected $67 from pot
*** SUMMARY ***
Total pot $69.50 | Rake $2.50 
Board [2d Qd Td 2h 7s]
Seat 2: matiko09 (big blind) folded before Flop
Seat 4: mbk88 folded before Flop (didn't bet)
Seat 5: DIMAN_324 folded before Flop (didn't bet)
Seat 6: di0d80 folded before Flop (didn't bet)
Seat 7: arctur17 showed [9d 9s] and lost with two pair, Nines and Deuces
Seat 8: Kukuryzka (button) showed [Kc Ks] and won ($67) with two pair, Kings and Deuces
Seat 9: KovIFish89 (small blind) folded before Flop





PokerStars Hand #155380519256:  Hold'em No Limit ($0.50/$1.00 USD) - 2016/06/30 14:08:48 CET [2016/06/30 8:08:48 ET]
Table 'Asmodeus' 9-max Seat #7 is the button
Seat 1: scollop ($106.75 in chips) 
Seat 2: picka4u ($39.50 in chips) 
Seat 3: matiko09 ($105.41 in chips) 
Seat 4: DIMAN_324 ($110 in chips) 
Seat 6: koutani7 ($102.53 in chips) 
Seat 7: aaronzzr ($136.33 in chips) 
Seat 9: mbk88 ($159.76 in chips) 
mbk88: posts small blind $0.50
scollop: posts big blind $1
*** HOLE CARDS ***
Dealt to matiko09 [Th 3d]
picka4u: raises $1.25 to $2.25
matiko09: folds 
DIMAN_324: folds 
koutani7: folds 
aaronzzr: folds 
mbk88: folds 
scollop: calls $1.25
*** FLOP *** [Tc Ks 6s]
scollop: bets $1
picka4u: raises $4.50 to $5.50
scollop: folds 
Uncalled bet ($4.50) returned to picka4u
picka4u collected $6.65 from pot
picka4u: doesn't show hand 
*** SUMMARY ***
Total pot $7 | Rake $0.35 
Board [Tc Ks 6s]
Seat 1: scollop (big blind) folded on the Flop
Seat 2: picka4u collected ($6.65)
Seat 3: matiko09 folded before Flop (didn't bet)
Seat 4: DIMAN_324 folded before Flop (didn't bet)
Seat 6: koutani7 folded before Flop (didn't bet)
Seat 7: aaronzzr (button) folded before Flop (didn't bet)
Seat 9: mbk88 (small blind) folded before Flop





PokerStars Hand #155380520523:  Hold'em No Limit ($0.50/$1.00 USD) - 2016/06/30 14:08:51 CET [2016/06/30 8:08:51 ET]
Table 'Altarf II' 9-max Seat #6 is the button
Seat 2: KovIFish89 ($102.50 in chips) 
Seat 4: Greha999 ($72.16 in chips) 
Seat 5: DIMAN_324 ($228.24 in chips) 
Seat 6: mbk88 ($100 in chips) 
Seat 7: matiko09 ($103.90 in chips) 
Seat 8: DomiVY ($40 in chips) 
Seat 9: omanibemihum ($132.57 in chips) 
matiko09: posts small blind $0.50
DomiVY: posts big blind $1
*** HOLE CARDS ***
Dealt to matiko09 [4s Th]
omanibemihum: folds 
KovIFish89: folds 
Greha999: folds 
DIMAN_324: folds 
mbk88: raises $1.02 to $2.02
matiko09: folds 
DomiVY: folds 
Uncalled bet ($1.02) returned to mbk88
mbk88 collected $2.50 from pot
mbk88: doesn't show hand 
*** SUMMARY ***
Total pot $2.50 | Rake $0 
Seat 2: KovIFish89 folded before Flop (didn't bet)
Seat 4: Greha999 folded before Flop (didn't bet)
Seat 5: DIMAN_324 folded before Flop (didn't bet)
Seat 6: mbk88 (button) collected ($2.50)
Seat 7: matiko09 (small blind) folded before Flop
Seat 8: DomiVY (big blind) folded before Flop
Seat 9: omanibemihum folded before Flop (didn't bet)





PokerStars Hand #155380525517:  Hold'em No Limit ($0.50/$1.00 USD) - 2016/06/30 14:09:02 CET [2016/06/30 8:09:02 ET]
Table 'Askania' 9-max Seat #7 is the button
Seat 1: chenconhaste ($102.50 in chips) 
Seat 2: DIMAN_324 ($101.50 in chips) 
Seat 3: matiko09 ($100 in chips) 
Seat 4: Hvittingfoss ($42.70 in chips) 
Seat 5: jezzaber ($101.70 in chips) 
Seat 7: ruslik_by ($100 in chips) 
Seat 8: kalcumite ($81 in chips) 
Seat 9: paul_007440 ($38.88 in chips) 
kalcumite: posts small blind $0.50
paul_007440: posts big blind $1
*** HOLE CARDS ***
Dealt to matiko09 [Js 8c]
chenconhaste: folds 
DIMAN_324: raises $2 to $3
matiko09: folds 
Hvittingfoss: folds 
jezzaber: folds 
ruslik_by: folds 
kalcumite: folds 
paul_007440: folds 
Uncalled bet ($2) returned to DIMAN_324
DIMAN_324 collected $2.50 from pot
DIMAN_324: doesn't show hand 
*** SUMMARY ***
Total pot $2.50 | Rake $0 
Seat 1: chenconhaste folded before Flop (didn't bet)
Seat 2: DIMAN_324 collected ($2.50)
Seat 3: matiko09 folded before Flop (didn't bet)
Seat 4: Hvittingfoss folded before Flop (didn't bet)
Seat 5: jezzaber folded before Flop (didn't bet)
Seat 7: ruslik_by (button) folded before Flop (didn't bet)
Seat 8: kalcumite (small blind) folded before Flop
Seat 9: paul_007440 (big blind) folded before Flop





PokerStars Hand #155380526245:  Hold'em No Limit ($0.50/$1.00 USD) - 2016/06/30 14:09:04 CET [2016/06/30 8:09:04 ET]
Table 'Tatjana' 9-max Seat #5 is the button
Seat 1: tipner ($116.40 in chips) 
Seat 2: DIMAN_324 ($100 in chips) 
Seat 4: mopatron25 ($111.14 in chips) 
Seat 5: matiko09 ($100 in chips) 
Seat 6: mbk88 ($153.44 in chips) 
Seat 7: daigodisco ($47.84 in chips) 
Seat 8: alhill86 ($78.84 in chips) 
Seat 9: POTAPENKO700 ($235.71 in chips) 
mbk88: posts small blind $0.50
daigodisco: posts big blind $1
mopatron25: posts small & big blinds $1.50
*** HOLE CARDS ***
Dealt to matiko09 [Jh 4c]
alhill86: folds 
POTAPENKO700: folds 
tipner: folds 
DIMAN_324: folds 
mopatron25: checks 
matiko09: folds 
mbk88: calls $0.50
daigodisco: checks 
*** FLOP *** [6d 8s 3h]
mbk88: checks 
daigodisco: checks 
mopatron25: bets $1
mbk88: calls $1
daigodisco: calls $1
*** TURN *** [6d 8s 3h] [8c]
mbk88: checks 
daigodisco: checks 
mopatron25: bets $3
mbk88: calls $3
daigodisco: calls $3
*** RIVER *** [6d 8s 3h 8c] [Qs]
mbk88: checks 
daigodisco: checks 
mopatron25: bets $2
mbk88: calls $2
daigodisco: raises $2 to $4
mopatron25: folds 
mbk88: calls $2
*** SHOW DOWN ***
daigodisco: shows [7s 4h] (a pair of Eights)
mbk88: shows [6h Ah] (two pair, Eights and Sixes)
mbk88 collected $24.22 from pot
*** SUMMARY ***
Total pot $25.50 | Rake $1.28 
Board [6d 8s 3h 8c Qs]
Seat 1: tipner folded before Flop (didn't bet)
Seat 2: DIMAN_324 folded before Flop (didn't bet)
Seat 4: mopatron25 folded on the River
Seat 5: matiko09 (button) folded before Flop (didn't bet)
Seat 6: mbk88 (small blind) showed [6h Ah] and won ($24.22) with two pair, Eights and Sixes
Seat 7: daigodisco (big blind) showed [7s 4h] and lost with a pair of Eights
Seat 8: alhill86 folded before Flop (didn't bet)
Seat 9: POTAPENKO700 folded before Flop (didn't bet)





PokerStars Hand #155380527128:  Hold'em No Limit ($0.50/$1.00 USD) - 2016/06/30 14:09:05 CET [2016/06/30 8:09:05 ET]
Table 'Borrelly II' 9-max Seat #3 is the button
Seat 2: mbk88 ($105 in chips) 
Seat 3: di0d80 ($101.52 in chips) 
Seat 4: DonRon_AT ($40.69 in chips) 
Seat 5: DIMAN_324 ($100 in chips) 
Seat 6: m_michalec ($172.68 in chips) 
Seat 7: matiko09 ($176.36 in chips) 
Seat 8: Arjun A Raju ($133.74 in chips) 
Seat 9: alhill86 ($77.18 in chips) 
DonRon_AT: posts small blind $0.50
DIMAN_324: posts big blind $1
*** HOLE CARDS ***
Dealt to matiko09 [3h 2s]
m_michalec: folds 
matiko09: folds 
Arjun A Raju: folds 
alhill86: raises $2 to $3
mbk88: folds 
di0d80: raises $6 to $9
DonRon_AT: folds 
DIMAN_324: folds 
alhill86: folds 
Uncalled bet ($6) returned to di0d80
di0d80 collected $7.50 from pot
di0d80: doesn't show hand 
*** SUMMARY ***
Total pot $7.50 | Rake $0 
Seat 2: mbk88 folded before Flop (didn't bet)
Seat 3: di0d80 (button) collected ($7.50)
Seat 4: DonRon_AT (small blind) folded before Flop
Seat 5: DIMAN_324 (big blind) folded before Flop
Seat 6: m_michalec folded before Flop (didn't bet)
Seat 7: matiko09 folded before Flop (didn't bet)
Seat 8: Arjun A Raju folded before Flop (didn't bet)
Seat 9: alhill86 folded before Flop





PokerStars Hand #155380532072:  Hold'em No Limit ($0.50/$1.00 USD) - 2016/06/30 14:09:17 CET [2016/06/30 8:09:17 ET]
Table 'Altarf II' 9-max Seat #7 is the button
Seat 2: KovIFish89 ($102.50 in chips) 
Seat 4: Greha999 ($72.16 in chips) 
Seat 5: DIMAN_324 ($228.24 in chips) 
Seat 6: mbk88 ($101.50 in chips) 
Seat 7: matiko09 ($103.40 in chips) 
Seat 8: DomiVY ($40 in chips) 
Seat 9: omanibemihum ($132.57 in chips) 
DomiVY: posts small blind $0.50
omanibemihum: posts big blind $1
*** HOLE CARDS ***
Dealt to matiko09 [Td 3s]
KovIFish89: folds 
Greha999: raises $2 to $3
DIMAN_324: folds 
mbk88: folds 
matiko09: folds 
DomiVY: folds 
omanibemihum: raises $15 to $18
Greha999: folds 
Uncalled bet ($15) returned to omanibemihum
omanibemihum collected $6.50 from pot
omanibemihum: doesn't show hand 
*** SUMMARY ***
Total pot $6.50 | Rake $0 
Seat 2: KovIFish89 folded before Flop (didn't bet)
Seat 4: Greha999 folded before Flop
Seat 5: DIMAN_324 folded before Flop (didn't bet)
Seat 6: mbk88 folded before Flop (didn't bet)
Seat 7: matiko09 (button) folded before Flop (didn't bet)
Seat 8: DomiVY (small blind) folded before Flop
Seat 9: omanibemihum (big blind) collected ($6.50)





PokerStars Hand #155380533545:  Hold'em No Limit ($0.50/$1.00 USD) - 2016/06/30 14:09:20 CET [2016/06/30 8:09:20 ET]
Table 'California II' 9-max Seat #6 is the button
Seat 2: velourleder ($57 in chips) 
Seat 3: KovIFish89 ($100 in chips) 
Seat 4: mbk88 ($178.42 in chips) 
Seat 5: Rohitbarve ($109.02 in chips) 
Seat 6: matiko09 ($100 in chips) 
Seat 7: DomiVY ($83.20 in chips) 
Seat 9: di0d80 ($100 in chips) 
DomiVY: posts small blind $0.50
di0d80: posts big blind $1
*** HOLE CARDS ***
Dealt to matiko09 [2h 8c]
velourleder: calls $1
KovIFish89: raises $3 to $4
mbk88: folds 
Rohitbarve: folds 
matiko09: folds 
DomiVY: folds 
di0d80: folds 
velourleder: calls $3
*** FLOP *** [3c Ad Ah]
velourleder: checks 
KovIFish89: checks 
*** TURN *** [3c Ad Ah] [9h]
velourleder: checks 
KovIFish89: bets $6.01
velourleder: folds 
Uncalled bet ($6.01) returned to KovIFish89
KovIFish89 collected $9.02 from pot
KovIFish89: doesn't show hand 
*** SUMMARY ***
Total pot $9.50 | Rake $0.48 
Board [3c Ad Ah 9h]
Seat 2: velourleder folded on the Turn
Seat 3: KovIFish89 collected ($9.02)
Seat 4: mbk88 folded before Flop (didn't bet)
Seat 5: Rohitbarve folded before Flop (didn't bet)
Seat 6: matiko09 (button) folded before Flop (didn't bet)
Seat 7: DomiVY (small blind) folded before Flop
Seat 9: di0d80 (big blind) folded before Flop





PokerStars Hand #155380533512:  Hold'em No Limit ($0.25/$0.50 USD) - 2016/06/30 14:09:20 CET [2016/06/30 8:09:20 ET]
Table 'Elektra II' 9-max Seat #6 is the button
Seat 1: drlee77 ($44.53 in chips) 
Seat 2: TheMinion ($60.82 in chips) 
Seat 3: mojtabagol ($80.79 in chips) 
Seat 4: matiko09 ($59.04 in chips) 
Seat 6: pfunkolstar ($50 in chips) 
Seat 7: MuddyDance ($49.50 in chips) 
Seat 9: KABAL_ua ($54.77 in chips) 
MuddyDance: posts small blind $0.25
sanr23: is sitting out 
KABAL_ua: posts big blind $0.50
*** HOLE CARDS ***
Dealt to matiko09 [Jh 4h]
drlee77: folds 
TheMinion: folds 
mojtabagol: folds 
matiko09: folds 
pfunkolstar: folds 
MuddyDance: folds 
Uncalled bet ($0.25) returned to KABAL_ua
KABAL_ua collected $0.50 from pot
KABAL_ua: doesn't show hand 
*** SUMMARY ***
Total pot $0.50 | Rake $0 
Seat 1: drlee77 folded before Flop (didn't bet)
Seat 2: TheMinion folded before Flop (didn't bet)
Seat 3: mojtabagol folded before Flop (didn't bet)
Seat 4: matiko09 folded before Flop (didn't bet)
Seat 6: pfunkolstar (button) folded before Flop (didn't bet)
Seat 7: MuddyDance (small blind) folded before Flop
Seat 9: KABAL_ua (big blind) collected ($0.50)





PokerStars Hand #155380533988:  Hold'em No Limit ($0.50/$1.00 USD) - 2016/06/30 14:09:21 CET [2016/06/30 8:09:21 ET]
Table 'Askania' 9-max Seat #8 is the button
Seat 1: chenconhaste ($102.50 in chips) 
Seat 2: DIMAN_324 ($103 in chips) 
Seat 3: matiko09 ($100 in chips) 
Seat 4: Hvittingfoss ($42.70 in chips) 
Seat 5: jezzaber ($101.70 in chips) 
Seat 7: ruslik_by ($100 in chips) 
Seat 8: kalcumite ($80.50 in chips) 
Seat 9: paul_007440 ($37.88 in chips) 
paul_007440: posts small blind $0.50
chenconhaste: posts big blind $1
*** HOLE CARDS ***
Dealt to matiko09 [Qc Kd]
DIMAN_324: folds 
matiko09: raises $2 to $3
Hvittingfoss: folds 
jezzaber: raises $7.50 to $10.50
ruslik_by: folds 
kalcumite: folds 
paul_007440: folds 
chenconhaste: folds 
matiko09: folds 
Uncalled bet ($7.50) returned to jezzaber
jezzaber collected $7.50 from pot
jezzaber: doesn't show hand 
*** SUMMARY ***
Total pot $7.50 | Rake $0 
Seat 1: chenconhaste (big blind) folded before Flop
Seat 2: DIMAN_324 folded before Flop (didn't bet)
Seat 3: matiko09 folded before Flop
Seat 4: Hvittingfoss folded before Flop (didn't bet)
Seat 5: jezzaber collected ($7.50)
Seat 7: ruslik_by folded before Flop (didn't bet)
Seat 8: kalcumite (button) folded before Flop (didn't bet)
Seat 9: paul_007440 (small blind) folded before Flop





PokerStars Hand #155380537955:  Hold'em No Limit ($0.25/$0.50 USD) - 2016/06/30 14:09:30 CET [2016/06/30 8:09:30 ET]
Table 'Dorothea II' 9-max Seat #9 is the button
Seat 1: zapata 7777 ($88.35 in chips) 
Seat 2: joker180785 ($50 in chips) 
Seat 4: matiko09 ($166.16 in chips) 
Seat 5: Bailey Dew ($83.55 in chips) 
Seat 7: desmo465 ($69.52 in chips) 
Seat 8: TheMinion ($50 in chips) 
Seat 9: funXmun ($50 in chips) 
zapata 7777: posts small blind $0.25
joker180785: posts big blind $0.50
fudzi: sits out 
kotkas1000: sits out 
zapata 7777: posts the ante $0.10
joker180785: posts the ante $0.10
matiko09: posts the ante $0.10
Bailey Dew: posts the ante $0.10
desmo465: posts the ante $0.10
TheMinion: posts the ante $0.10
funXmun: posts the ante $0.10
*** HOLE CARDS ***
Dealt to matiko09 [8h 4c]
kotkas1000 leaves the table
r4mz3s joins the table at seat #6 
matiko09: folds 
Bailey Dew: folds 
desmo465: raises $1 to $1.50
TheMinion: folds 
funXmun: calls $1.50
zapata 7777: folds 
joker180785: folds 
*** FLOP *** [Qd Ah Th]
desmo465: bets $2.81
funXmun: calls $2.81
*** TURN *** [Qd Ah Th] [Qs]
desmo465: checks 
funXmun: checks 
*** RIVER *** [Qd Ah Th Qs] [Jd]
desmo465: bets $20
funXmun: folds 
Uncalled bet ($20) returned to desmo465
desmo465 collected $9.57 from pot
*** SUMMARY ***
Total pot $10.07 | Rake $0.50 
Board [Qd Ah Th Qs Jd]
Seat 1: zapata 7777 (small blind) folded before Flop
Seat 2: joker180785 (big blind) folded before Flop
Seat 4: matiko09 folded before Flop (didn't bet)
Seat 5: Bailey Dew folded before Flop (didn't bet)
Seat 7: desmo465 collected ($9.57)
Seat 8: TheMinion folded before Flop (didn't bet)
Seat 9: funXmun (button) folded on the River





PokerStars Hand #155380540212:  Hold'em No Limit ($0.25/$0.50 USD) - 2016/06/30 14:09:35 CET [2016/06/30 8:09:35 ET]
Table 'Elektra II' 9-max Seat #7 is the button
Seat 1: drlee77 ($44.53 in chips) 
Seat 2: TheMinion ($60.82 in chips) 
Seat 3: mojtabagol ($80.79 in chips) 
Seat 4: matiko09 ($59.04 in chips) 
Seat 6: pfunkolstar ($50 in chips) 
Seat 7: MuddyDance ($49.25 in chips) 
Seat 9: KABAL_ua ($55.02 in chips) 
KABAL_ua: posts small blind $0.25
drlee77: posts big blind $0.50
*** HOLE CARDS ***
Dealt to matiko09 [Qc 4s]
TheMinion: folds 
mojtabagol: folds 
matiko09: folds 
pfunkolstar: folds 
MuddyDance: raises $0.54 to $1.04
KABAL_ua: calls $0.79
drlee77: folds 
*** FLOP *** [Qd 8c 4d]
KABAL_ua: checks 
MuddyDance: bets $1.61
KABAL_ua: calls $1.61
*** TURN *** [Qd 8c 4d] [As]
KABAL_ua: checks 
MuddyDance: checks 
*** RIVER *** [Qd 8c 4d As] [Td]
KABAL_ua: checks 
MuddyDance: checks 
*** SHOW DOWN ***
KABAL_ua: shows [Qs Ts] (two pair, Queens and Tens)
MuddyDance: mucks hand 
KABAL_ua collected $5.51 from pot
*** SUMMARY ***
Total pot $5.80 | Rake $0.29 
Board [Qd 8c 4d As Td]
Seat 1: drlee77 (big blind) folded before Flop
Seat 2: TheMinion folded before Flop (didn't bet)
Seat 3: mojtabagol folded before Flop (didn't bet)
Seat 4: matiko09 folded before Flop (didn't bet)
Seat 6: pfunkolstar folded before Flop (didn't bet)
Seat 7: MuddyDance (button) mucked [7c 6h]
Seat 9: KABAL_ua (small blind) showed [Qs Ts] and won ($5.51) with two pair, Queens and Tens





PokerStars Hand #155380544050:  Hold'em No Limit ($0.50/$1.00 USD) - 2016/06/30 14:09:43 CET [2016/06/30 8:09:43 ET]
Table 'Altarf II' 9-max Seat #8 is the button
Seat 2: KovIFish89 ($102.50 in chips) 
Seat 4: Greha999 ($69.16 in chips) 
Seat 5: DIMAN_324 ($228.24 in chips) 
Seat 6: mbk88 ($101.50 in chips) 
Seat 7: matiko09 ($103.40 in chips) 
Seat 8: DomiVY ($40 in chips) 
Seat 9: omanibemihum ($136.07 in chips) 
omanibemihum: posts small blind $0.50
KovIFish89: posts big blind $1
*** HOLE CARDS ***
Dealt to matiko09 [3c Qs]
Greha999: folds 
DIMAN_324: folds 
mbk88: raises $2 to $3
matiko09: folds 
DomiVY: folds 
omanibemihum: folds 
KovIFish89: folds 
Uncalled bet ($2) returned to mbk88
mbk88 collected $2.50 from pot
mbk88: doesn't show hand 
*** SUMMARY ***
Total pot $2.50 | Rake $0 
Seat 2: KovIFish89 (big blind) folded before Flop
Seat 4: Greha999 folded before Flop (didn't bet)
Seat 5: DIMAN_324 folded before Flop (didn't bet)
Seat 6: mbk88 collected ($2.50)
Seat 7: matiko09 folded before Flop (didn't bet)
Seat 8: DomiVY (button) folded before Flop (didn't bet)
Seat 9: omanibemihum (small blind) folded before Flop





PokerStars Hand #155380544932:  Hold'em No Limit ($0.50/$1.00 USD) - 2016/06/30 14:09:45 CET [2016/06/30 8:09:45 ET]
Table 'Askania' 9-max Seat #9 is the button
Seat 1: chenconhaste ($101.50 in chips) 
Seat 2: DIMAN_324 ($103 in chips) 
Seat 3: matiko09 ($100 in chips) 
Seat 4: Hvittingfoss ($42.70 in chips) 
Seat 5: jezzaber ($106.20 in chips) 
Seat 7: ruslik_by ($100 in chips) 
Seat 8: kalcumite ($80.50 in chips) 
Seat 9: paul_007440 ($37.38 in chips) 
chenconhaste: posts small blind $0.50
DIMAN_324: posts big blind $1
*** HOLE CARDS ***
Dealt to matiko09 [4s Js]
matiko09: folds 
Hvittingfoss: folds 
jezzaber: folds 
ruslik_by: folds 
kalcumite: folds 
paul_007440: raises $2 to $3
chenconhaste: folds 
DIMAN_324: folds 
Uncalled bet ($2) returned to paul_007440
paul_007440 collected $2.50 from pot
*** SUMMARY ***
Total pot $2.50 | Rake $0 
Seat 1: chenconhaste (small blind) folded before Flop
Seat 2: DIMAN_324 (big blind) folded before Flop
Seat 3: matiko09 folded before Flop (didn't bet)
Seat 4: Hvittingfoss folded before Flop (didn't bet)
Seat 5: jezzaber folded before Flop (didn't bet)
Seat 7: ruslik_by folded before Flop (didn't bet)
Seat 8: kalcumite folded before Flop (didn't bet)
Seat 9: paul_007440 (button) collected ($2.50)





PokerStars Hand #155380549389:  Hold'em No Limit ($0.50/$1.00 USD) - 2016/06/30 14:09:55 CET [2016/06/30 8:09:55 ET]
Table 'Altarf II' 9-max Seat #9 is the button
Seat 2: KovIFish89 ($101.50 in chips) 
Seat 4: Greha999 ($69.16 in chips) 
Seat 5: DIMAN_324 ($228.24 in chips) 
Seat 6: mbk88 ($103 in chips) 
Seat 7: matiko09 ($103.40 in chips) 
Seat 8: DomiVY ($40 in chips) 
Seat 9: omanibemihum ($135.57 in chips) 
KovIFish89: posts small blind $0.50
Greha999: posts big blind $1
*** HOLE CARDS ***
Dealt to matiko09 [Qs Qh]
DIMAN_324: folds 
mbk88: raises $2 to $3
matiko09: raises $7 to $10
DomiVY: folds 
omanibemihum: folds 
KovIFish89: folds 
Greha999: folds 
mbk88: folds 
Uncalled bet ($7) returned to matiko09
matiko09 collected $7.50 from pot
matiko09: doesn't show hand 
*** SUMMARY ***
Total pot $7.50 | Rake $0 
Seat 2: KovIFish89 (small blind) folded before Flop
Seat 4: Greha999 (big blind) folded before Flop
Seat 5: DIMAN_324 folded before Flop (didn't bet)
Seat 6: mbk88 folded before Flop
Seat 7: matiko09 collected ($7.50)
Seat 8: DomiVY folded before Flop (didn't bet)
Seat 9: omanibemihum (button) folded before Flop (didn't bet)





PokerStars Hand #155380553440:  Hold'em No Limit ($0.50/$1.00 USD) - 2016/06/30 14:10:04 CET [2016/06/30 8:10:04 ET]
Table 'Eucharis' 9-max Seat #9 is the button
Seat 1: picka4u ($89.98 in chips) 
Seat 2: matiko09 ($101.12 in chips) 
Seat 3: ramzes160468 ($72.36 in chips) 
Seat 4: mbk88 ($145.50 in chips) 
Seat 5: swizzly58 ($73.06 in chips) 
Seat 6: joooh79 ($132.02 in chips) 
Seat 8: nickreason17 ($141.37 in chips) 
Seat 9: geiranger011 ($88.68 in chips) 
picka4u: posts small blind $0.50
matiko09: posts big blind $1
*** HOLE CARDS ***
Dealt to matiko09 [Qc Ks]
ramzes160468: folds 
mbk88: folds 
swizzly58: folds 
joooh79: folds 
nickreason17: folds 
geiranger011: folds 
picka4u: raises $1.25 to $2.25
matiko09: calls $1.25
*** FLOP *** [Jc Td Qs]
picka4u: bets $3
matiko09: calls $3
*** TURN *** [Jc Td Qs] [Js]
picka4u: checks 
matiko09: checks 
*** RIVER *** [Jc Td Qs Js] [6h]
picka4u: checks 
matiko09: checks 
*** SHOW DOWN ***
picka4u: shows [9c 9s] (two pair, Jacks and Nines)
matiko09: shows [Qc Ks] (two pair, Queens and Jacks)
matiko09 collected $9.98 from pot
*** SUMMARY ***
Total pot $10.50 | Rake $0.52 
Board [Jc Td Qs Js 6h]
Seat 1: picka4u (small blind) showed [9c 9s] and lost with two pair, Jacks and Nines
Seat 2: matiko09 (big blind) showed [Qc Ks] and won ($9.98) with two pair, Queens and Jacks
Seat 3: ramzes160468 folded before Flop (didn't bet)
Seat 4: mbk88 folded before Flop (didn't bet)
Seat 5: swizzly58 folded before Flop (didn't bet)
Seat 6: joooh79 folded before Flop (didn't bet)
Seat 8: nickreason17 folded before Flop (didn't bet)
Seat 9: geiranger011 (button) folded before Flop (didn't bet)





PokerStars Hand #155380553479:  Hold'em No Limit ($0.50/$1.00 USD) - 2016/06/30 14:10:04 CET [2016/06/30 8:10:04 ET]
Table 'California II' 9-max Seat #7 is the button
Seat 2: velourleder ($53 in chips) 
Seat 3: KovIFish89 ($105.02 in chips) 
Seat 4: mbk88 ($178.42 in chips) 
Seat 5: Rohitbarve ($109.02 in chips) 
Seat 6: matiko09 ($100 in chips) 
Seat 7: DomiVY ($82.70 in chips) 
Seat 9: di0d80 ($100 in chips) 
di0d80: posts small blind $0.50
velourleder: posts big blind $1
*** HOLE CARDS ***
Dealt to matiko09 [Ad 5s]
KovIFish89: folds 
mbk88: folds 
Rohitbarve: folds 
matiko09: folds 
DomiVY: folds 
di0d80: raises $2 to $3
velourleder: folds 
Uncalled bet ($2) returned to di0d80
di0d80 collected $2 from pot
di0d80: doesn't show hand 
*** SUMMARY ***
Total pot $2 | Rake $0 
Seat 2: velourleder (big blind) folded before Flop
Seat 3: KovIFish89 folded before Flop (didn't bet)
Seat 4: mbk88 folded before Flop (didn't bet)
Seat 5: Rohitbarve folded before Flop (didn't bet)
Seat 6: matiko09 folded before Flop (didn't bet)
Seat 7: DomiVY (button) folded before Flop (didn't bet)
Seat 9: di0d80 (small blind) collected ($2)





PokerStars Hand #155380555359:  Hold'em No Limit ($0.50/$1.00 USD) - 2016/06/30 14:10:08 CET [2016/06/30 8:10:08 ET]
Table 'Borrelly II' 9-max Seat #4 is the button
Seat 2: mbk88 ($105 in chips) 
Seat 3: di0d80 ($106.02 in chips) 
Seat 4: DonRon_AT ($40.19 in chips) 
Seat 5: DIMAN_324 ($100 in chips) 
Seat 6: m_michalec ($172.68 in chips) 
Seat 7: matiko09 ($176.36 in chips) 
Seat 8: Arjun A Raju ($133.74 in chips) 
Seat 9: alhill86 ($74.18 in chips) 
DIMAN_324: posts small blind $0.50
m_michalec: posts big blind $1
*** HOLE CARDS ***
Dealt to matiko09 [5h 6s]
matiko09: folds 
Arjun A Raju: folds 
alhill86: folds 
mbk88: folds 
di0d80: raises $1.50 to $2.50
DonRon_AT: folds 
DIMAN_324: folds 
m_michalec: calls $1.50
*** FLOP *** [Ks 7c 3h]
m_michalec: checks 
di0d80: checks 
*** TURN *** [Ks 7c 3h] [2h]
m_michalec: checks 
di0d80: checks 
*** RIVER *** [Ks 7c 3h 2h] [Js]
m_michalec: bets $4
di0d80: calls $4
*** SHOW DOWN ***
m_michalec: shows [9d Kh] (a pair of Kings)
di0d80: mucks hand 
m_michalec collected $12.82 from pot
*** SUMMARY ***
Total pot $13.50 | Rake $0.68 
Board [Ks 7c 3h 2h Js]
Seat 2: mbk88 folded before Flop (didn't bet)
Seat 3: di0d80 mucked [8s 8h]
Seat 4: DonRon_AT (button) folded before Flop (didn't bet)
Seat 5: DIMAN_324 (small blind) folded before Flop
Seat 6: m_michalec (big blind) showed [9d Kh] and won ($12.82) with a pair of Kings
Seat 7: matiko09 folded before Flop (didn't bet)
Seat 8: Arjun A Raju folded before Flop (didn't bet)
Seat 9: alhill86 folded before Flop (didn't bet)





PokerStars Hand #155380556341:  Hold'em No Limit ($0.50/$1.00 USD) - 2016/06/30 14:10:10 CET [2016/06/30 8:10:10 ET]
Table 'Asmodeus' 9-max Seat #9 is the button
Seat 1: scollop ($103.50 in chips) 
Seat 2: picka4u ($42.90 in chips) 
Seat 3: matiko09 ($105.41 in chips) 
Seat 4: DIMAN_324 ($110 in chips) 
Seat 6: koutani7 ($102.53 in chips) 
Seat 7: aaronzzr ($136.33 in chips) 
Seat 9: mbk88 ($159.26 in chips) 
scollop: posts small blind $0.50
picka4u: posts big blind $1
*** HOLE CARDS ***
Dealt to matiko09 [Jh 6d]
matiko09: folds 
DIMAN_324: folds 
koutani7: folds 
aaronzzr: raises $1 to $2
mbk88: raises $6 to $8
scollop: folds 
picka4u: folds 
aaronzzr: folds 
Uncalled bet ($6) returned to mbk88
mbk88 collected $5.50 from pot
mbk88: doesn't show hand 
*** SUMMARY ***
Total pot $5.50 | Rake $0 
Seat 1: scollop (small blind) folded before Flop
Seat 2: picka4u (big blind) folded before Flop
Seat 3: matiko09 folded before Flop (didn't bet)
Seat 4: DIMAN_324 folded before Flop (didn't bet)
Seat 6: koutani7 folded before Flop (didn't bet)
Seat 7: aaronzzr folded before Flop
Seat 9: mbk88 (button) collected ($5.50)





PokerStars Hand #155380556689:  Hold'em No Limit ($0.50/$1.00 USD) - 2016/06/30 14:10:11 CET [2016/06/30 8:10:11 ET]
Table 'Sigrid' 9-max Seat #9 is the button
Seat 2: matiko09 ($104.52 in chips) 
Seat 4: mbk88 ($120.87 in chips) 
Seat 5: DIMAN_324 ($100 in chips) 
Seat 6: di0d80 ($115.39 in chips) 
Seat 8: Kukuryzka ($133 in chips) 
Seat 9: KovIFish89 ($102.46 in chips) 
matiko09: posts small blind $0.50
mbk88: posts big blind $1
*** HOLE CARDS ***
Dealt to matiko09 [Qs 5d]
DIMAN_324: folds 
di0d80: folds 
Kukuryzka: folds 
KovIFish89: raises $1 to $2
matiko09: folds 
mbk88: folds 
Uncalled bet ($1) returned to KovIFish89
KovIFish89 collected $2.50 from pot
KovIFish89: doesn't show hand 
*** SUMMARY ***
Total pot $2.50 | Rake $0 
Seat 2: matiko09 (small blind) folded before Flop
Seat 4: mbk88 (big blind) folded before Flop
Seat 5: DIMAN_324 folded before Flop (didn't bet)
Seat 6: di0d80 folded before Flop (didn't bet)
Seat 8: Kukuryzka folded before Flop (didn't bet)
Seat 9: KovIFish89 (button) collected ($2.50)





PokerStars Hand #155380559779:  Hold'em No Limit ($0.50/$1.00 USD) - 2016/06/30 14:10:18 CET [2016/06/30 8:10:18 ET]
Table 'Askania' 9-max Seat #1 is the button
Seat 1: chenconhaste ($101 in chips) 
Seat 2: DIMAN_324 ($102 in chips) 
Seat 3: matiko09 ($100 in chips) 
Seat 4: Hvittingfoss ($42.70 in chips) 
Seat 5: jezzaber ($106.20 in chips) 
Seat 7: ruslik_by ($100 in chips) 
Seat 8: kalcumite ($80.50 in chips) 
Seat 9: paul_007440 ($38.88 in chips) 
DIMAN_324: posts small blind $0.50
matiko09: posts big blind $1
*** HOLE CARDS ***
Dealt to matiko09 [7h 4h]
Hvittingfoss: folds 
jezzaber: raises $2 to $3
ruslik_by: folds 
kalcumite: folds 
paul_007440: calls $3
chenconhaste: folds 
DIMAN_324: folds 
matiko09: folds 
*** FLOP *** [5s 9c Ac]
jezzaber: bets $7
paul_007440: calls $7
*** TURN *** [5s 9c Ac] [8c]
jezzaber: bets $10
paul_007440: calls $10
*** RIVER *** [5s 9c Ac 8c] [8s]
jezzaber: bets $20
paul_007440: folds 
Uncalled bet ($20) returned to jezzaber
jezzaber collected $39.42 from pot
jezzaber: doesn't show hand 
*** SUMMARY ***
Total pot $41.50 | Rake $2.08 
Board [5s 9c Ac 8c 8s]
Seat 1: chenconhaste (button) folded before Flop (didn't bet)
Seat 2: DIMAN_324 (small blind) folded before Flop
Seat 3: matiko09 (big blind) folded before Flop
Seat 4: Hvittingfoss folded before Flop (didn't bet)
Seat 5: jezzaber collected ($39.42)
Seat 7: ruslik_by folded before Flop (didn't bet)
Seat 8: kalcumite folded before Flop (didn't bet)
Seat 9: paul_007440 folded on the River





PokerStars Hand #155380561715:  Hold'em No Limit ($0.50/$1.00 USD) - 2016/06/30 14:10:22 CET [2016/06/30 8:10:22 ET]
Table 'California II' 9-max Seat #9 is the button
Seat 2: velourleder ($52 in chips) 
Seat 3: KovIFish89 ($105.02 in chips) 
Seat 4: mbk88 ($178.42 in chips) 
Seat 5: Rohitbarve ($109.02 in chips) 
Seat 6: matiko09 ($100 in chips) 
Seat 7: DomiVY ($82.70 in chips) 
Seat 9: di0d80 ($101 in chips) 
velourleder: posts small blind $0.50
KovIFish89: posts big blind $1
*** HOLE CARDS ***
Dealt to matiko09 [Qc 7d]
mbk88: folds 
Rohitbarve: folds 
matiko09: folds 
DomiVY: folds 
di0d80: raises $1 to $2
velourleder: folds 
KovIFish89: calls $1
*** FLOP *** [Th 3c Kc]
KovIFish89: checks 
di0d80: bets $3
KovIFish89: folds 
Uncalled bet ($3) returned to di0d80
di0d80 collected $4.28 from pot
di0d80: doesn't show hand 
*** SUMMARY ***
Total pot $4.50 | Rake $0.22 
Board [Th 3c Kc]
Seat 2: velourleder (small blind) folded before Flop
Seat 3: KovIFish89 (big blind) folded on the Flop
Seat 4: mbk88 folded before Flop (didn't bet)
Seat 5: Rohitbarve folded before Flop (didn't bet)
Seat 6: matiko09 folded before Flop (didn't bet)
Seat 7: DomiVY folded before Flop (didn't bet)
Seat 9: di0d80 (button) collected ($4.28)





PokerStars Hand #155380562763:  Hold'em No Limit ($0.50/$1.00 USD) - 2016/06/30 14:10:24 CET [2016/06/30 8:10:24 ET]
Table 'Altarf II' 9-max Seat #2 is the button
Seat 2: KovIFish89 ($101 in chips) 
Seat 4: Greha999 ($68.16 in chips) 
Seat 5: DIMAN_324 ($228.24 in chips) 
Seat 6: mbk88 ($100 in chips) 
Seat 7: matiko09 ($107.90 in chips) 
Seat 8: DomiVY ($40 in chips) 
Seat 9: omanibemihum ($135.57 in chips) 
Greha999: posts small blind $0.50
DIMAN_324: posts big blind $1
*** HOLE CARDS ***
Dealt to matiko09 [Th 8s]
mbk88: folds 
matiko09: folds 
DomiVY: folds 
omanibemihum: raises $1 to $2
KovIFish89: folds 
Greha999: folds 
DIMAN_324: folds 
Uncalled bet ($1) returned to omanibemihum
omanibemihum collected $2.50 from pot
omanibemihum: doesn't show hand 
*** SUMMARY ***
Total pot $2.50 | Rake $0 
Seat 2: KovIFish89 (button) folded before Flop (didn't bet)
Seat 4: Greha999 (small blind) folded before Flop
Seat 5: DIMAN_324 (big blind) folded before Flop
Seat 6: mbk88 folded before Flop (didn't bet)
Seat 7: matiko09 folded before Flop (didn't bet)
Seat 8: DomiVY folded before Flop (didn't bet)
Seat 9: omanibemihum collected ($2.50)





PokerStars Hand #155380565017:  Hold'em No Limit ($0.50/$1.00 USD) - 2016/06/30 14:10:29 CET [2016/06/30 8:10:29 ET]
Table 'Sigrid' 9-max Seat #2 is the button
Seat 2: matiko09 ($104.02 in chips) 
Seat 4: mbk88 ($119.87 in chips) 
Seat 5: DIMAN_324 ($100 in chips) 
Seat 6: di0d80 ($115.39 in chips) 
Seat 8: Kukuryzka ($133 in chips) 
Seat 9: KovIFish89 ($103.96 in chips) 
mbk88: posts small blind $0.50
DIMAN_324: posts big blind $1
*** HOLE CARDS ***
Dealt to matiko09 [As 9d]
di0d80: folds 
Kukuryzka: folds 
KovIFish89: folds 
matiko09: raises $1.27 to $2.27
mbk88: folds 
DIMAN_324: folds 
Uncalled bet ($1.27) returned to matiko09
matiko09 collected $2.50 from pot
matiko09: doesn't show hand 
*** SUMMARY ***
Total pot $2.50 | Rake $0 
Seat 2: matiko09 (button) collected ($2.50)
Seat 4: mbk88 (small blind) folded before Flop
Seat 5: DIMAN_324 (big blind) folded before Flop
Seat 6: di0d80 folded before Flop (didn't bet)
Seat 8: Kukuryzka folded before Flop (didn't bet)
Seat 9: KovIFish89 folded before Flop (didn't bet)





PokerStars Hand #155380572951:  Hold'em No Limit ($0.50/$1.00 USD) - 2016/06/30 14:10:47 CET [2016/06/30 8:10:47 ET]
Table 'Tatjana' 9-max Seat #6 is the button
Seat 1: tipner ($116.40 in chips) 
Seat 2: DIMAN_324 ($100 in chips) 
Seat 4: mopatron25 ($103.64 in chips) 
Seat 5: matiko09 ($100 in chips) 
Seat 6: mbk88 ($168.66 in chips) 
Seat 7: daigodisco ($38.84 in chips) 
Seat 8: alhill86 ($78.84 in chips) 
Seat 9: POTAPENKO700 ($235.71 in chips) 
daigodisco: posts small blind $0.50
alhill86: posts big blind $1
Rafaello18: sits out 
*** HOLE CARDS ***
Dealt to matiko09 [6s 3s]
POTAPENKO700: folds 
tipner: raises $2 to $3
DIMAN_324: folds 
mopatron25: folds 
matiko09: folds 
mbk88: folds 
daigodisco: folds 
alhill86: folds 
Uncalled bet ($2) returned to tipner
tipner collected $2.50 from pot
tipner: doesn't show hand 
*** SUMMARY ***
Total pot $2.50 | Rake $0 
Seat 1: tipner collected ($2.50)
Seat 2: DIMAN_324 folded before Flop (didn't bet)
Seat 4: mopatron25 folded before Flop (didn't bet)
Seat 5: matiko09 folded before Flop (didn't bet)
Seat 6: mbk88 (button) folded before Flop (didn't bet)
Seat 7: daigodisco (small blind) folded before Flop
Seat 8: alhill86 (big blind) folded before Flop
Seat 9: POTAPENKO700 folded before Flop (didn't bet)





PokerStars Hand #155380573910:  Hold'em No Limit ($0.50/$1.00 USD) - 2016/06/30 14:10:49 CET [2016/06/30 8:10:49 ET]
Table 'Altarf II' 9-max Seat #4 is the button
Seat 2: KovIFish89 ($101 in chips) 
Seat 4: Greha999 ($67.66 in chips) 
Seat 5: DIMAN_324 ($227.24 in chips) 
Seat 6: mbk88 ($100 in chips) 
Seat 7: matiko09 ($107.90 in chips) 
Seat 8: DomiVY ($40 in chips) 
Seat 9: omanibemihum ($137.07 in chips) 
DIMAN_324: posts small blind $0.50
mbk88: posts big blind $1
Rafaello18: sits out 
*** HOLE CARDS ***
Dealt to matiko09 [2d 7s]
matiko09: folds 
DomiVY: folds 
omanibemihum: folds 
KovIFish89: folds 
Greha999: raises $1 to $2
DIMAN_324: raises $5 to $7
mbk88: folds 
Greha999: folds 
Uncalled bet ($5) returned to DIMAN_324
DIMAN_324 collected $5 from pot
DIMAN_324: doesn't show hand 
*** SUMMARY ***
Total pot $5 | Rake $0 
Seat 2: KovIFish89 folded before Flop (didn't bet)
Seat 4: Greha999 (button) folded before Flop
Seat 5: DIMAN_324 (small blind) collected ($5)
Seat 6: mbk88 (big blind) folded before Flop
Seat 7: matiko09 folded before Flop (didn't bet)
Seat 8: DomiVY folded before Flop (didn't bet)
Seat 9: omanibemihum folded before Flop (didn't bet)





PokerStars Hand #155380574479:  Hold'em No Limit ($0.50/$1.00 USD) - 2016/06/30 14:10:50 CET [2016/06/30 8:10:50 ET]
Table 'Asmodeus' 9-max Seat #1 is the button
Seat 1: scollop ($103 in chips) 
Seat 2: picka4u ($41.90 in chips) 
Seat 3: matiko09 ($105.41 in chips) 
Seat 4: DIMAN_324 ($110 in chips) 
Seat 6: koutani7 ($102.53 in chips) 
Seat 7: aaronzzr ($134.33 in chips) 
Seat 9: mbk88 ($162.76 in chips) 
picka4u: posts small blind $0.50
matiko09: posts big blind $1
Rafaello18: sits out 
*** HOLE CARDS ***
Dealt to matiko09 [Ah 8h]
DIMAN_324: folds 
koutani7: folds 
aaronzzr: folds 
mbk88: folds 
scollop: folds 
picka4u: raises $1.25 to $2.25
matiko09: calls $1.25
*** FLOP *** [Ad 5d 7d]
picka4u: bets $3
matiko09: calls $3
*** TURN *** [Ad 5d 7d] [3s]
picka4u: bets $5
matiko09: calls $5
*** RIVER *** [Ad 5d 7d 3s] [Qs]
picka4u: bets $14
matiko09: calls $14
*** SHOW DOWN ***
picka4u: shows [8d 6h] (high card Ace)
matiko09: shows [Ah 8h] (a pair of Aces)
matiko09 collected $46.08 from pot
*** SUMMARY ***
Total pot $48.50 | Rake $2.42 
Board [Ad 5d 7d 3s Qs]
Seat 1: scollop (button) folded before Flop (didn't bet)
Seat 2: picka4u (small blind) showed [8d 6h] and lost with high card Ace
Seat 3: matiko09 (big blind) showed [Ah 8h] and won ($46.08) with a pair of Aces
Seat 4: DIMAN_324 folded before Flop (didn't bet)
Seat 6: koutani7 folded before Flop (didn't bet)
Seat 7: aaronzzr folded before Flop (didn't bet)
Seat 9: mbk88 folded before Flop (didn't bet)





PokerStars Hand #155380574883:  Hold'em No Limit ($0.50/$1.00 USD) - 2016/06/30 14:10:51 CET [2016/06/30 8:10:51 ET]
Table 'Sigrid' 9-max Seat #4 is the button
Seat 2: matiko09 ($105.52 in chips) 
Seat 4: mbk88 ($119.37 in chips) 
Seat 5: DIMAN_324 ($100 in chips) 
Seat 6: di0d80 ($115.39 in chips) 
Seat 7: arctur17 ($100 in chips) 
Seat 8: Kukuryzka ($133 in chips) 
Seat 9: KovIFish89 ($103.96 in chips) 
DIMAN_324: posts small blind $0.50
di0d80: posts big blind $1
Rafaello18: sits out 
*** HOLE CARDS ***
Dealt to matiko09 [9c 8d]
arctur17: folds 
Kukuryzka: folds 
KovIFish89: folds 
matiko09: folds 
mbk88: folds 
DIMAN_324: folds 
Uncalled bet ($0.50) returned to di0d80
di0d80 collected $1 from pot
di0d80: doesn't show hand 
*** SUMMARY ***
Total pot $1 | Rake $0 
Seat 2: matiko09 folded before Flop (didn't bet)
Seat 4: mbk88 (button) folded before Flop (didn't bet)
Seat 5: DIMAN_324 (small blind) folded before Flop
Seat 6: di0d80 (big blind) collected ($1)
Seat 7: arctur17 folded before Flop (didn't bet)
Seat 8: Kukuryzka folded before Flop (didn't bet)
Seat 9: KovIFish89 folded before Flop (didn't bet)





PokerStars Hand #155380575489:  Hold'em No Limit ($0.50/$1.00 USD) - 2016/06/30 14:10:52 CET [2016/06/30 8:10:52 ET]
Table 'Eucharis' 9-max Seat #1 is the button
Seat 1: picka4u ($84.73 in chips) 
Seat 2: matiko09 ($105.85 in chips) 
Seat 3: ramzes160468 ($72.36 in chips) 
Seat 4: mbk88 ($145.50 in chips) 
Seat 5: swizzly58 ($73.06 in chips) 
Seat 6: joooh79 ($132.02 in chips) 
Seat 7: Ty Nick 420 ($144 in chips) 
Seat 8: nickreason17 ($141.37 in chips) 
Seat 9: geiranger011 ($88.68 in chips) 
matiko09: posts small blind $0.50
ramzes160468: posts big blind $1
*** HOLE CARDS ***
Dealt to matiko09 [Qs 5s]
mbk88: raises $2 to $3
swizzly58: folds 
joooh79: folds 
Ty Nick 420: folds 
nickreason17: calls $3
geiranger011: folds 
picka4u: folds 
matiko09: folds 
ramzes160468: folds 
*** FLOP *** [Jc 9d 2h]
mbk88: bets $4
nickreason17: folds 
Uncalled bet ($4) returned to mbk88
mbk88 collected $7.12 from pot
mbk88: doesn't show hand 
*** SUMMARY ***
Total pot $7.50 | Rake $0.38 
Board [Jc 9d 2h]
Seat 1: picka4u (button) folded before Flop (didn't bet)
Seat 2: matiko09 (small blind) folded before Flop
Seat 3: ramzes160468 (big blind) folded before Flop
Seat 4: mbk88 collected ($7.12)
Seat 5: swizzly58 folded before Flop (didn't bet)
Seat 6: joooh79 folded before Flop (didn't bet)
Seat 7: Ty Nick 420 folded before Flop (didn't bet)
Seat 8: nickreason17 folded on the Flop
Seat 9: geiranger011 folded before Flop (didn't bet)





PokerStars Hand #155380576383:  Hold'em No Limit ($0.50/$1.00 USD) - 2016/06/30 14:10:54 CET [2016/06/30 8:10:54 ET]
Table 'Askania' 9-max Seat #2 is the button
Seat 1: chenconhaste ($101 in chips) 
Seat 2: DIMAN_324 ($101.50 in chips) 
Seat 3: matiko09 ($100 in chips) 
Seat 4: Hvittingfoss ($42.70 in chips) 
Seat 5: jezzaber ($125.62 in chips) 
Seat 7: ruslik_by ($100 in chips) 
Seat 8: kalcumite ($80.50 in chips) 
Seat 9: paul_007440 ($18.88 in chips) 
matiko09: posts small blind $0.50
Hvittingfoss: posts big blind $1
*** HOLE CARDS ***
Dealt to matiko09 [4s As]
jezzaber: folds 
ruslik_by: folds 
kalcumite: folds 
paul_007440: raises $2 to $3
chenconhaste: folds 
DIMAN_324: folds 
matiko09: folds 
Hvittingfoss: folds 
Uncalled bet ($2) returned to paul_007440
paul_007440 collected $2.50 from pot
*** SUMMARY ***
Total pot $2.50 | Rake $0 
Seat 1: chenconhaste folded before Flop (didn't bet)
Seat 2: DIMAN_324 (button) folded before Flop (didn't bet)
Seat 3: matiko09 (small blind) folded before Flop
Seat 4: Hvittingfoss (big blind) folded before Flop
Seat 5: jezzaber folded before Flop (didn't bet)
Seat 7: ruslik_by folded before Flop (didn't bet)
Seat 8: kalcumite folded before Flop (didn't bet)
Seat 9: paul_007440 collected ($2.50)





PokerStars Hand #155380577401:  Hold'em No Limit ($0.50/$1.00 USD) - 2016/06/30 14:10:56 CET [2016/06/30 8:10:56 ET]
Table 'California II' 9-max Seat #2 is the button
Seat 2: velourleder ($51.50 in chips) 
Seat 3: KovIFish89 ($103.02 in chips) 
Seat 4: mbk88 ($178.42 in chips) 
Seat 5: Rohitbarve ($109.02 in chips) 
Seat 6: matiko09 ($100 in chips) 
Seat 7: DomiVY ($82.70 in chips) 
Seat 9: di0d80 ($103.28 in chips) 
KovIFish89: posts small blind $0.50
mbk88: posts big blind $1
Rafaello18: sits out 
*** HOLE CARDS ***
Dealt to matiko09 [5c 4d]
Rohitbarve: raises $2 to $3
matiko09: folds 
DomiVY: folds 
di0d80: folds 
velourleder: folds 
KovIFish89: folds 
mbk88: folds 
Uncalled bet ($2) returned to Rohitbarve
Rohitbarve collected $2.50 from pot
Rohitbarve: doesn't show hand 
*** SUMMARY ***
Total pot $2.50 | Rake $0 
Seat 2: velourleder (button) folded before Flop (didn't bet)
Seat 3: KovIFish89 (small blind) folded before Flop
Seat 4: mbk88 (big blind) folded before Flop
Seat 5: Rohitbarve collected ($2.50)
Seat 6: matiko09 folded before Flop (didn't bet)
Seat 7: DomiVY folded before Flop (didn't bet)
Seat 9: di0d80 folded before Flop (didn't bet)





PokerStars Hand #155380578786:  Hold'em No Limit ($0.25/$0.50 USD) - 2016/06/30 14:10:59 CET [2016/06/30 8:10:59 ET]
Table 'Elektra II' 9-max Seat #9 is the button
Seat 1: drlee77 ($44.03 in chips) 
Seat 2: TheMinion ($60.82 in chips) 
Seat 3: mojtabagol ($80.79 in chips) 
Seat 4: matiko09 ($59.04 in chips) 
Seat 6: pfunkolstar ($50 in chips) 
Seat 7: MuddyDance ($50 in chips) 
Seat 9: KABAL_ua ($57.88 in chips) 
drlee77: posts small blind $0.25
TheMinion: posts big blind $0.50
Rafaello18: sits out 
*** HOLE CARDS ***
Dealt to matiko09 [Kh 8h]
mojtabagol: folds 
matiko09: folds 
pfunkolstar: folds 
MuddyDance: raises $0.75 to $1.25
KABAL_ua: folds 
drlee77: folds 
TheMinion: folds 
Uncalled bet ($0.75) returned to MuddyDance
MuddyDance collected $1.25 from pot
MuddyDance: doesn't show hand 
*** SUMMARY ***
Total pot $1.25 | Rake $0 
Seat 1: drlee77 (small blind) folded before Flop
Seat 2: TheMinion (big blind) folded before Flop
Seat 3: mojtabagol folded before Flop (didn't bet)
Seat 4: matiko09 folded before Flop (didn't bet)
Seat 6: pfunkolstar folded before Flop (didn't bet)
Seat 7: MuddyDance collected ($1.25)
Seat 9: KABAL_ua (button) folded before Flop (didn't bet)





PokerStars Hand #155380585305:  Hold'em No Limit ($0.50/$1.00 USD) - 2016/06/30 14:11:14 CET [2016/06/30 8:11:14 ET]
Table 'Sigrid' 9-max Seat #5 is the button
Seat 2: matiko09 ($105.52 in chips) 
Seat 4: mbk88 ($119.37 in chips) 
Seat 5: DIMAN_324 ($100 in chips) 
Seat 6: di0d80 ($115.89 in chips) 
Seat 7: arctur17 ($100 in chips) 
Seat 8: Kukuryzka ($133 in chips) 
Seat 9: KovIFish89 ($103.96 in chips) 
di0d80: posts small blind $0.50
arctur17: posts big blind $1
Rafaello18: sits out 
*** HOLE CARDS ***
Dealt to matiko09 [8h 3d]
Kukuryzka: folds 
Kukuryzka leaves the table
KovIFish89: folds 
matiko09: folds 
mbk88: folds 
DIMAN_324: raises $1.10 to $2.10
di0d80: raises $4.90 to $7
arctur17: folds 
DIMAN_324: folds 
Uncalled bet ($4.90) returned to di0d80
di0d80 collected $5.20 from pot
di0d80: doesn't show hand 
*** SUMMARY ***
Total pot $5.20 | Rake $0 
Seat 2: matiko09 folded before Flop (didn't bet)
Seat 4: mbk88 folded before Flop (didn't bet)
Seat 5: DIMAN_324 (button) folded before Flop
Seat 6: di0d80 (small blind) collected ($5.20)
Seat 7: arctur17 (big blind) folded before Flop
Seat 8: Kukuryzka folded before Flop (didn't bet)
Seat 9: KovIFish89 folded before Flop (didn't bet)





PokerStars Hand #155380586115:  Hold'em No Limit ($0.50/$1.00 USD) - 2016/06/30 14:11:15 CET [2016/06/30 8:11:15 ET]
Table 'Tatjana' 9-max Seat #7 is the button
Seat 1: tipner ($117.90 in chips) 
Seat 2: DIMAN_324 ($100 in chips) 
Seat 4: mopatron25 ($103.64 in chips) 
Seat 5: matiko09 ($100 in chips) 
Seat 6: mbk88 ($168.66 in chips) 
Seat 7: daigodisco ($38.34 in chips) 
Seat 8: alhill86 ($77.84 in chips) 
Seat 9: POTAPENKO700 ($235.71 in chips) 
alhill86: posts small blind $0.50
POTAPENKO700: posts big blind $1
Rafaello18: sits out 
*** HOLE CARDS ***
Dealt to matiko09 [Qs Tc]
tipner: folds 
DIMAN_324: folds 
mopatron25: folds 
matiko09: folds 
mbk88: folds 
daigodisco: raises $2 to $3
alhill86: folds 
POTAPENKO700: folds 
Uncalled bet ($2) returned to daigodisco
daigodisco collected $2.50 from pot
daigodisco: doesn't show hand 
*** SUMMARY ***
Total pot $2.50 | Rake $0 
Seat 1: tipner folded before Flop (didn't bet)
Seat 2: DIMAN_324 folded before Flop (didn't bet)
Seat 4: mopatron25 folded before Flop (didn't bet)
Seat 5: matiko09 folded before Flop (didn't bet)
Seat 6: mbk88 folded before Flop (didn't bet)
Seat 7: daigodisco (button) collected ($2.50)
Seat 8: alhill86 (small blind) folded before Flop
Seat 9: POTAPENKO700 (big blind) folded before Flop





PokerStars Hand #155380587494:  Hold'em No Limit ($0.50/$1.00 USD) - 2016/06/30 14:11:18 CET [2016/06/30 8:11:18 ET]
Table 'Borrelly II' 9-max Seat #5 is the button
Seat 2: mbk88 ($105 in chips) 
Seat 3: di0d80 ($100 in chips) 
Seat 4: DonRon_AT ($40.19 in chips) 
Seat 5: DIMAN_324 ($100 in chips) 
Seat 6: m_michalec ($179 in chips) 
Seat 7: matiko09 ($176.36 in chips) 
Seat 8: Arjun A Raju ($133.74 in chips) 
Seat 9: alhill86 ($74.18 in chips) 
m_michalec: posts small blind $0.50
matiko09: posts big blind $1
Rafaello18: sits out 
*** HOLE CARDS ***
Dealt to matiko09 [7d 7c]
Arjun A Raju: raises $2 to $3
alhill86: folds 
mbk88: folds 
di0d80: folds 
DonRon_AT: folds 
DIMAN_324: folds 
m_michalec: folds 
matiko09: calls $2
*** FLOP *** [6c 6h Ad]
matiko09: checks 
Arjun A Raju: checks 
*** TURN *** [6c 6h Ad] [8h]
matiko09: checks 
Arjun A Raju: bets $6.18
matiko09: folds 
Uncalled bet ($6.18) returned to Arjun A Raju
Arjun A Raju collected $6.18 from pot
Arjun A Raju: doesn't show hand 
*** SUMMARY ***
Total pot $6.50 | Rake $0.32 
Board [6c 6h Ad 8h]
Seat 2: mbk88 folded before Flop (didn't bet)
Seat 3: di0d80 folded before Flop (didn't bet)
Seat 4: DonRon_AT folded before Flop (didn't bet)
Seat 5: DIMAN_324 (button) folded before Flop (didn't bet)
Seat 6: m_michalec (small blind) folded before Flop
Seat 7: matiko09 (big blind) folded on the Turn
Seat 8: Arjun A Raju collected ($6.18)
Seat 9: alhill86 folded before Flop (didn't bet)





PokerStars Hand #155380588208:  Hold'em No Limit ($0.50/$1.00 USD) - 2016/06/30 14:11:20 CET [2016/06/30 8:11:20 ET]
Table 'Altarf II' 9-max Seat #5 is the button
Seat 2: KovIFish89 ($101 in chips) 
Seat 4: Greha999 ($65.66 in chips) 
Seat 5: DIMAN_324 ($230.24 in chips) 
Seat 6: mbk88 ($100 in chips) 
Seat 7: matiko09 ($107.90 in chips) 
Seat 8: DomiVY ($40 in chips) 
Seat 9: omanibemihum ($137.07 in chips) 
mbk88: posts small blind $0.50
matiko09: posts big blind $1
Rafaello18: sits out 
*** HOLE CARDS ***
Dealt to matiko09 [4d 8s]
DomiVY: folds 
omanibemihum: folds 
KovIFish89: raises $2 to $3
Greha999: folds 
DIMAN_324: folds 
mbk88: folds 
matiko09: folds 
Uncalled bet ($2) returned to KovIFish89
KovIFish89 collected $2.50 from pot
KovIFish89: doesn't show hand 
*** SUMMARY ***
Total pot $2.50 | Rake $0 
Seat 2: KovIFish89 collected ($2.50)
Seat 4: Greha999 folded before Flop (didn't bet)
Seat 5: DIMAN_324 (button) folded before Flop (didn't bet)
Seat 6: mbk88 (small blind) folded before Flop
Seat 7: matiko09 (big blind) folded before Flop
Seat 8: DomiVY folded before Flop (didn't bet)
Seat 9: omanibemihum folded before Flop (didn't bet)





PokerStars Hand #155380589549:  Hold'em No Limit ($0.50/$1.00 USD) - 2016/06/30 14:11:23 CET [2016/06/30 8:11:23 ET]
Table 'Askania' 9-max Seat #3 is the button
Seat 1: chenconhaste ($101 in chips) 
Seat 2: DIMAN_324 ($101.50 in chips) 
Seat 3: matiko09 ($100 in chips) 
Seat 4: Hvittingfoss ($41.70 in chips) 
Seat 5: jezzaber ($125.62 in chips) 
Seat 7: ruslik_by ($100 in chips) 
Seat 8: kalcumite ($80.50 in chips) 
Seat 9: paul_007440 ($20.38 in chips) 
Hvittingfoss: posts small blind $0.50
jezzaber: posts big blind $1
*** HOLE CARDS ***
Dealt to matiko09 [Kh 9c]
ruslik_by: folds 
kalcumite: folds 
paul_007440: folds 
chenconhaste: folds 
DIMAN_324: folds 
matiko09: raises $1.27 to $2.27
Hvittingfoss: folds 
jezzaber: folds 
Uncalled bet ($1.27) returned to matiko09
matiko09 collected $2.50 from pot
matiko09: doesn't show hand 
*** SUMMARY ***
Total pot $2.50 | Rake $0 
Seat 1: chenconhaste folded before Flop (didn't bet)
Seat 2: DIMAN_324 folded before Flop (didn't bet)
Seat 3: matiko09 (button) collected ($2.50)
Seat 4: Hvittingfoss (small blind) folded before Flop
Seat 5: jezzaber (big blind) folded before Flop
Seat 7: ruslik_by folded before Flop (didn't bet)
Seat 8: kalcumite folded before Flop (didn't bet)
Seat 9: paul_007440 folded before Flop (didn't bet)





PokerStars Hand #155380592739:  Hold'em No Limit ($0.50/$1.00 USD) - 2016/06/30 14:11:30 CET [2016/06/30 8:11:30 ET]
Table 'California II' 9-max Seat #3 is the button
Seat 2: velourleder ($51.50 in chips) 
Seat 3: KovIFish89 ($102.52 in chips) 
Seat 4: mbk88 ($177.42 in chips) 
Seat 5: Rohitbarve ($110.52 in chips) 
Seat 6: matiko09 ($100 in chips) 
Seat 7: DomiVY ($82.70 in chips) 
Seat 9: di0d80 ($103.28 in chips) 
mbk88: posts small blind $0.50
Rohitbarve: posts big blind $1
Rafaello18: sits out 
*** HOLE CARDS ***
Dealt to matiko09 [4d 9h]
matiko09: folds 
DomiVY: raises $2 to $3
di0d80: calls $3
velourleder: calls $3
KovIFish89: folds 
mbk88: folds 
Rohitbarve: folds 
*** FLOP *** [6c 3c 9d]
DomiVY: checks 
di0d80: checks 
velourleder: bets $13
DomiVY: folds 
di0d80: folds 
Uncalled bet ($13) returned to velourleder
velourleder collected $9.98 from pot
*** SUMMARY ***
Total pot $10.50 | Rake $0.52 
Board [6c 3c 9d]
Seat 2: velourleder collected ($9.98)
Seat 3: KovIFish89 (button) folded before Flop (didn't bet)
Seat 4: mbk88 (small blind) folded before Flop
Seat 5: Rohitbarve (big blind) folded before Flop
Seat 6: matiko09 folded before Flop (didn't bet)
Seat 7: DomiVY folded on the Flop
Seat 9: di0d80 folded on the Flop





PokerStars Hand #155380598076:  Hold'em No Limit ($0.50/$1.00 USD) - 2016/06/30 14:11:41 CET [2016/06/30 8:11:41 ET]
Table 'Tatjana' 9-max Seat #8 is the button
Seat 1: tipner ($117.90 in chips) 
Seat 2: DIMAN_324 ($100 in chips) 
Seat 4: mopatron25 ($103.64 in chips) 
Seat 5: matiko09 ($100 in chips) 
Seat 6: mbk88 ($168.66 in chips) 
Seat 7: daigodisco ($39.84 in chips) 
Seat 8: alhill86 ($77.34 in chips) 
Seat 9: POTAPENKO700 ($234.71 in chips) 
POTAPENKO700: posts small blind $0.50
tipner: posts big blind $1
Rafaello18: sits out 
*** HOLE CARDS ***
Dealt to matiko09 [7s 3s]
DIMAN_324: folds 
mopatron25: calls $1
matiko09: folds 
mbk88: raises $3 to $4
daigodisco: calls $4
alhill86: folds 
POTAPENKO700: folds 
tipner: folds 
mopatron25: calls $3
*** FLOP *** [Ks 3h 7h]
mopatron25: bets $3
mbk88: raises $5 to $8
daigodisco: raises $5 to $13
mopatron25: calls $10
mbk88: folds 
*** TURN *** [Ks 3h 7h] [Td]
mopatron25: checks 
daigodisco: bets $13
mopatron25: calls $13
*** RIVER *** [Ks 3h 7h Td] [4s]
mopatron25: bets $9
daigodisco: calls $9
*** SHOW DOWN ***
mopatron25: shows [Th Qh] (a pair of Tens)
daigodisco: shows [Jc Kc] (a pair of Kings)
daigodisco collected $89 from pot
*** SUMMARY ***
Total pot $91.50 | Rake $2.50 
Board [Ks 3h 7h Td 4s]
Seat 1: tipner (big blind) folded before Flop
Seat 2: DIMAN_324 folded before Flop (didn't bet)
Seat 4: mopatron25 showed [Th Qh] and lost with a pair of Tens
Seat 5: matiko09 folded before Flop (didn't bet)
Seat 6: mbk88 folded on the Flop
Seat 7: daigodisco showed [Jc Kc] and won ($89) with a pair of Kings
Seat 8: alhill86 (button) folded before Flop (didn't bet)
Seat 9: POTAPENKO700 (small blind) folded before Flop





PokerStars Hand #155380598616:  Hold'em No Limit ($0.50/$1.00 USD) - 2016/06/30 14:11:43 CET [2016/06/30 8:11:43 ET]
Table 'Eucharis' 9-max Seat #2 is the button
Seat 1: picka4u ($84.73 in chips) 
Seat 2: matiko09 ($105.35 in chips) 
Seat 3: ramzes160468 ($71.36 in chips) 
Seat 4: mbk88 ($149.62 in chips) 
Seat 5: swizzly58 ($73.06 in chips) 
Seat 6: joooh79 ($132.02 in chips) 
Seat 7: Ty Nick 420 ($144 in chips) 
Seat 8: nickreason17 ($138.37 in chips) 
Seat 9: geiranger011 ($88.68 in chips) 
ramzes160468: posts small blind $0.50
mbk88: posts big blind $1
*** HOLE CARDS ***
Dealt to matiko09 [Qh 4c]
swizzly58: folds 
joooh79: folds 
Ty Nick 420: folds 
nickreason17: folds 
geiranger011: folds 
picka4u: folds 
matiko09: folds 
ramzes160468: folds 
Uncalled bet ($0.50) returned to mbk88
mbk88 collected $1 from pot
mbk88: doesn't show hand 
*** SUMMARY ***
Total pot $1 | Rake $0 
Seat 1: picka4u folded before Flop (didn't bet)
Seat 2: matiko09 (button) folded before Flop (didn't bet)
Seat 3: ramzes160468 (small blind) folded before Flop
Seat 4: mbk88 (big blind) collected ($1)
Seat 5: swizzly58 folded before Flop (didn't bet)
Seat 6: joooh79 folded before Flop (didn't bet)
Seat 7: Ty Nick 420 folded before Flop (didn't bet)
Seat 8: nickreason17 folded before Flop (didn't bet)
Seat 9: geiranger011 folded before Flop (didn't bet)





PokerStars Hand #155380601255:  Hold'em No Limit ($0.50/$1.00 USD) - 2016/06/30 14:11:48 CET [2016/06/30 8:11:48 ET]
Table 'Askania' 9-max Seat #4 is the button
Seat 1: chenconhaste ($101 in chips) 
Seat 2: DIMAN_324 ($101.50 in chips) 
Seat 3: matiko09 ($101.50 in chips) 
Seat 4: Hvittingfoss ($41.20 in chips) 
Seat 5: jezzaber ($124.62 in chips) 
Seat 6: nickreason17 ($100 in chips) 
Seat 7: ruslik_by ($100 in chips) 
Seat 8: kalcumite ($80.50 in chips) 
Seat 9: paul_007440 ($20.38 in chips) 
jezzaber: posts small blind $0.50
nickreason17: posts big blind $1
*** HOLE CARDS ***
Dealt to matiko09 [6h Kc]
ruslik_by: folds 
kalcumite: folds 
paul_007440: folds 
chenconhaste: folds 
DIMAN_324: folds 
matiko09: folds 
Hvittingfoss: raises $1.36 to $2.36
jezzaber: folds 
nickreason17: calls $1.36
*** FLOP *** [9h Td 9s]
nickreason17: checks 
Hvittingfoss: checks 
*** TURN *** [9h Td 9s] [Js]
nickreason17: checks 
Hvittingfoss: checks 
*** RIVER *** [9h Td 9s Js] [Qd]
nickreason17: checks 
Hvittingfoss: checks 
*** SHOW DOWN ***
nickreason17: shows [5d 5h] (two pair, Nines and Fives)
Hvittingfoss: mucks hand 
nickreason17 collected $4.96 from pot
*** SUMMARY ***
Total pot $5.22 | Rake $0.26 
Board [9h Td 9s Js Qd]
Seat 1: chenconhaste folded before Flop (didn't bet)
Seat 2: DIMAN_324 folded before Flop (didn't bet)
Seat 3: matiko09 folded before Flop (didn't bet)
Seat 4: Hvittingfoss (button) mucked [6c 3c]
Seat 5: jezzaber (small blind) folded before Flop
Seat 6: nickreason17 (big blind) showed [5d 5h] and won ($4.96) with two pair, Nines and Fives
Seat 7: ruslik_by folded before Flop (didn't bet)
Seat 8: kalcumite folded before Flop (didn't bet)
Seat 9: paul_007440 folded before Flop (didn't bet)





PokerStars Hand #155380601882:  Hold'em No Limit ($0.50/$1.00 USD) - 2016/06/30 14:11:50 CET [2016/06/30 8:11:50 ET]
Table 'Asmodeus' 9-max Seat #2 is the button
Seat 1: scollop ($103 in chips) 
Seat 2: picka4u ($40 in chips) 
Seat 3: matiko09 ($127.24 in chips) 
Seat 4: DIMAN_324 ($110 in chips) 
Seat 6: koutani7 ($102.53 in chips) 
Seat 7: aaronzzr ($134.33 in chips) 
Seat 9: mbk88 ($162.76 in chips) 
matiko09: posts small blind $0.50
DIMAN_324: posts big blind $1
Rafaello18: sits out 
*** HOLE CARDS ***
Dealt to matiko09 [9c 5c]
koutani7: folds 
aaronzzr: folds 
mbk88: raises $2 to $3
scollop: calls $3
picka4u: folds 
matiko09: folds 
DIMAN_324: raises $10.50 to $13.50
mbk88: folds 
scollop: calls $10.50
*** FLOP *** [Kh 5s 6h]
DIMAN_324: bets $14.50
scollop: calls $14.50
*** TURN *** [Kh 5s 6h] [7c]
DIMAN_324: bets $82 and is all-in
scollop: calls $75 and is all-in
Uncalled bet ($7) returned to DIMAN_324
*** RIVER *** [Kh 5s 6h 7c] [7s]
*** SHOW DOWN ***
DIMAN_324: shows [As 4s] (a pair of Sevens)
scollop: shows [Kd 9s] (two pair, Kings and Sevens)
scollop collected $207 from pot
*** SUMMARY ***
Total pot $209.50 | Rake $2.50 
Board [Kh 5s 6h 7c 7s]
Seat 1: scollop showed [Kd 9s] and won ($207) with two pair, Kings and Sevens
Seat 2: picka4u (button) folded before Flop (didn't bet)
Seat 3: matiko09 (small blind) folded before Flop
Seat 4: DIMAN_324 (big blind) showed [As 4s] and lost with a pair of Sevens
Seat 6: koutani7 folded before Flop (didn't bet)
Seat 7: aaronzzr folded before Flop (didn't bet)
Seat 9: mbk88 folded before Flop





PokerStars Hand #155380604280:  Hold'em No Limit ($0.50/$1.00 USD) - 2016/06/30 14:11:55 CET [2016/06/30 8:11:55 ET]
Table 'Altarf II' 9-max Seat #6 is the button
Seat 2: KovIFish89 ($102.50 in chips) 
Seat 4: Greha999 ($65.66 in chips) 
Seat 5: DIMAN_324 ($230.24 in chips) 
Seat 6: mbk88 ($100 in chips) 
Seat 7: matiko09 ($106.90 in chips) 
Seat 8: DomiVY ($40 in chips) 
Seat 9: omanibemihum ($137.07 in chips) 
matiko09: posts small blind $0.50
DomiVY: posts big blind $1
Rafaello18: sits out 
*** HOLE CARDS ***
Dealt to matiko09 [8c As]
omanibemihum: folds 
KovIFish89: folds 
Greha999: folds 
DIMAN_324: folds 
mbk88: raises $1.02 to $2.02
matiko09: folds 
DomiVY: folds 
Uncalled bet ($1.02) returned to mbk88
mbk88 collected $2.50 from pot
mbk88: doesn't show hand 
*** SUMMARY ***
Total pot $2.50 | Rake $0 
Seat 2: KovIFish89 folded before Flop (didn't bet)
Seat 4: Greha999 folded before Flop (didn't bet)
Seat 5: DIMAN_324 folded before Flop (didn't bet)
Seat 6: mbk88 (button) collected ($2.50)
Seat 7: matiko09 (small blind) folded before Flop
Seat 8: DomiVY (big blind) folded before Flop
Seat 9: omanibemihum folded before Flop (didn't bet)





PokerStars Hand #155380604102:  Hold'em No Limit ($0.50/$1.00 USD) - 2016/06/30 14:11:55 CET [2016/06/30 8:11:55 ET]
Table 'Sigrid' 9-max Seat #6 is the button
Seat 2: matiko09 ($105.52 in chips) 
Seat 4: mbk88 ($119.37 in chips) 
Seat 5: DIMAN_324 ($100 in chips) 
Seat 6: di0d80 ($118.99 in chips) 
Seat 7: arctur17 ($99 in chips) 
Seat 9: KovIFish89 ($103.96 in chips) 
arctur17: posts small blind $0.50
KovIFish89: posts big blind $1
Rafaello18: sits out 
*** HOLE CARDS ***
Dealt to matiko09 [4d 7d]
matiko09: folds 
mbk88: folds 
DIMAN_324: folds 
di0d80: raises $1 to $2
arctur17: folds 
KovIFish89: calls $1
*** FLOP *** [2c Th 4s]
KovIFish89: checks 
ruslik_by joins the table at seat #8 
di0d80: bets $2.50
KovIFish89: calls $2.50
*** TURN *** [2c Th 4s] [3h]
KovIFish89: checks 
di0d80: checks 
*** RIVER *** [2c Th 4s 3h] [Ac]
KovIFish89: checks 
di0d80: checks 
*** SHOW DOWN ***
KovIFish89: shows [Td Kc] (a pair of Tens)
di0d80: mucks hand 
KovIFish89 collected $9.02 from pot
*** SUMMARY ***
Total pot $9.50 | Rake $0.48 
Board [2c Th 4s 3h Ac]
Seat 2: matiko09 folded before Flop (didn't bet)
Seat 4: mbk88 folded before Flop (didn't bet)
Seat 5: DIMAN_324 folded before Flop (didn't bet)
Seat 6: di0d80 (button) mucked [8s Jd]
Seat 7: arctur17 (small blind) folded before Flop
Seat 9: KovIFish89 (big blind) showed [Td Kc] and won ($9.02) with a pair of Tens





PokerStars Hand #155380606419:  Hold'em No Limit ($0.50/$1.00 USD) - 2016/06/30 14:12:00 CET [2016/06/30 8:12:00 ET]
Table 'Eucharis' 9-max Seat #3 is the button
Seat 1: picka4u ($84.73 in chips) 
Seat 2: matiko09 ($105.35 in chips) 
Seat 3: ramzes160468 ($70.86 in chips) 
Seat 4: mbk88 ($150.12 in chips) 
Seat 6: joooh79 ($132.02 in chips) 
Seat 7: Ty Nick 420 ($144 in chips) 
Seat 8: nickreason17 ($138.37 in chips) 
Seat 9: geiranger011 ($88.68 in chips) 
mbk88: posts small blind $0.50
swizzly58: is sitting out 
joooh79: posts big blind $1
*** HOLE CARDS ***
Dealt to matiko09 [9c 3d]
Ty Nick 420: folds 
nickreason17: raises $1.50 to $2.50
geiranger011: calls $2.50
picka4u: folds 
matiko09: folds 
ramzes160468: folds 
mbk88: folds 
joooh79: folds 
*** FLOP *** [5h 8h 8d]
nickreason17: bets $5.25
geiranger011: calls $5.25
*** TURN *** [5h 8h 8d] [8s]
nickreason17: checks 
geiranger011: bets $16
nickreason17: folds 
Uncalled bet ($16) returned to geiranger011
geiranger011 collected $16.15 from pot
geiranger011: doesn't show hand 
*** SUMMARY ***
Total pot $17 | Rake $0.85 
Board [5h 8h 8d 8s]
Seat 1: picka4u folded before Flop (didn't bet)
Seat 2: matiko09 folded before Flop (didn't bet)
Seat 3: ramzes160468 (button) folded before Flop (didn't bet)
Seat 4: mbk88 (small blind) folded before Flop
Seat 6: joooh79 (big blind) folded before Flop
Seat 7: Ty Nick 420 folded before Flop (didn't bet)
Seat 8: nickreason17 folded on the Turn
Seat 9: geiranger011 collected ($16.15)





PokerStars Hand #155380611080:  Hold'em No Limit ($0.50/$1.00 USD) - 2016/06/30 14:12:10 CET [2016/06/30 8:12:10 ET]
Table 'Borrelly II' 9-max Seat #6 is the button
Seat 2: mbk88 ($105 in chips) 
Seat 3: di0d80 ($100 in chips) 
Seat 4: DonRon_AT ($40.19 in chips) 
Seat 5: DIMAN_324 ($100 in chips) 
Seat 6: m_michalec ($178.50 in chips) 
Seat 7: matiko09 ($173.36 in chips) 
Seat 8: Arjun A Raju ($136.92 in chips) 
Seat 9: alhill86 ($74.18 in chips) 
matiko09: posts small blind $0.50
Arjun A Raju: posts big blind $1
Rafaello18: sits out 
*** HOLE CARDS ***
Dealt to matiko09 [Jc 8h]
alhill86: folds 
mbk88: folds 
di0d80: folds 
DonRon_AT: folds 
DIMAN_324: folds 
m_michalec: folds 
matiko09: raises $2 to $3
Arjun A Raju: folds 
Uncalled bet ($2) returned to matiko09
matiko09 collected $2 from pot
matiko09: doesn't show hand 
*** SUMMARY ***
Total pot $2 | Rake $0 
Seat 2: mbk88 folded before Flop (didn't bet)
Seat 3: di0d80 folded before Flop (didn't bet)
Seat 4: DonRon_AT folded before Flop (didn't bet)
Seat 5: DIMAN_324 folded before Flop (didn't bet)
Seat 6: m_michalec (button) folded before Flop (didn't bet)
Seat 7: matiko09 (small blind) collected ($2)
Seat 8: Arjun A Raju (big blind) folded before Flop
Seat 9: alhill86 folded before Flop (didn't bet)





PokerStars Hand #155380614177:  Hold'em No Limit ($0.50/$1.00 USD) - 2016/06/30 14:12:17 CET [2016/06/30 8:12:17 ET]
Table 'Altarf II' 9-max Seat #7 is the button
Seat 2: KovIFish89 ($102.50 in chips) 
Seat 4: Greha999 ($65.66 in chips) 
Seat 5: DIMAN_324 ($230.24 in chips) 
Seat 6: mbk88 ($101.50 in chips) 
Seat 7: matiko09 ($106.40 in chips) 
Seat 8: DomiVY ($40 in chips) 
Seat 9: omanibemihum ($137.07 in chips) 
DomiVY: posts small blind $0.50
omanibemihum: posts big blind $1
Rafaello18: sits out 
*** HOLE CARDS ***
Dealt to matiko09 [Qh 2d]
KovIFish89: folds 
Greha999: raises $2 to $3
DIMAN_324: folds 
mbk88: folds 
matiko09: folds 
DomiVY: folds 
omanibemihum: calls $2
*** FLOP *** [4s Jc Td]
omanibemihum: bets $3
Greha999: calls $3
*** TURN *** [4s Jc Td] [6s]
omanibemihum: checks 
Greha999: checks 
*** RIVER *** [4s Jc Td 6s] [3d]
omanibemihum: bets $6
Greha999: calls $6
*** SHOW DOWN ***
omanibemihum: shows [9c As] (high card Ace)
Greha999: shows [Qd Ad] (high card Ace - Queen kicker)
Greha999 collected $23.28 from pot
*** SUMMARY ***
Total pot $24.50 | Rake $1.22 
Board [4s Jc Td 6s 3d]
Seat 2: KovIFish89 folded before Flop (didn't bet)
Seat 4: Greha999 showed [Qd Ad] and won ($23.28) with high card Ace
Seat 5: DIMAN_324 folded before Flop (didn't bet)
Seat 6: mbk88 folded before Flop (didn't bet)
Seat 7: matiko09 (button) folded before Flop (didn't bet)
Seat 8: DomiVY (small blind) folded before Flop
Seat 9: omanibemihum (big blind) showed [9c As] and lost with high card Ace





PokerStars Hand #155380618291:  Hold'em No Limit ($0.50/$1.00 USD) - 2016/06/30 14:12:26 CET [2016/06/30 8:12:26 ET]
Table 'Donnera' 9-max Seat #2 is the button
Seat 2: robbiescrim9 ($97.41 in chips) 
Seat 3: matiko09 ($100 in chips) 
Seat 4: Kukuryzka ($100 in chips) 
tipner joins the table at seat #5 
matiko09: posts small blind $0.50
Kukuryzka: posts big blind $1
*** HOLE CARDS ***
Dealt to matiko09 [3d 5s]
robbiescrim9: calls $1
matiko09: folds 
chenconhaste joins the table at seat #9 
ruslik_by joins the table at seat #8 
Kukuryzka: checks 
*** FLOP *** [Jd 2h 6c]
chenconhaste leaves the table
nickreason17 joins the table at seat #6 
Rafaello18 joins the table at seat #7 
Starw!nd joins the table at seat #9 
chenconhaste joins the table at seat #1 
Kukuryzka: checks 
robbiescrim9: checks 
*** TURN *** [Jd 2h 6c] [5h]
Kukuryzka: checks 
robbiescrim9: checks 
*** RIVER *** [Jd 2h 6c 5h] [Th]
Kukuryzka: checks 
robbiescrim9: checks 
*** SHOW DOWN ***
Kukuryzka: shows [2d 9h] (a pair of Deuces)
robbiescrim9: shows [7d 7s] (a pair of Sevens)
robbiescrim9 collected $2.38 from pot
*** SUMMARY ***
Total pot $2.50 | Rake $0.12 
Board [Jd 2h 6c 5h Th]
Seat 2: robbiescrim9 (button) showed [7d 7s] and won ($2.38) with a pair of Sevens
Seat 3: matiko09 (small blind) folded before Flop
Seat 4: Kukuryzka (big blind) showed [2d 9h] and lost with a pair of Deuces





PokerStars Hand #155380620002:  Hold'em No Limit ($0.50/$1.00 USD) - 2016/06/30 14:12:30 CET [2016/06/30 8:12:30 ET]
Table 'California II' 9-max Seat #4 is the button
Seat 2: velourleder ($58.48 in chips) 
Seat 3: KovIFish89 ($102.52 in chips) 
Seat 4: mbk88 ($176.92 in chips) 
Seat 5: Rohitbarve ($109.52 in chips) 
Seat 6: matiko09 ($100 in chips) 
Seat 7: DomiVY ($79.70 in chips) 
Seat 9: di0d80 ($100.28 in chips) 
Rohitbarve: posts small blind $0.50
matiko09: posts big blind $1
Rafaello18: sits out 
*** HOLE CARDS ***
Dealt to matiko09 [Qs 3c]
DomiVY: raises $2 to $3
di0d80: folds 
velourleder: folds 
KovIFish89: folds 
mbk88: folds 
Rohitbarve: folds 
matiko09: folds 
Uncalled bet ($2) returned to DomiVY
DomiVY collected $2.50 from pot
DomiVY: doesn't show hand 
*** SUMMARY ***
Total pot $2.50 | Rake $0 
Seat 2: velourleder folded before Flop (didn't bet)
Seat 3: KovIFish89 folded before Flop (didn't bet)
Seat 4: mbk88 (button) folded before Flop (didn't bet)
Seat 5: Rohitbarve (small blind) folded before Flop
Seat 6: matiko09 (big blind) folded before Flop
Seat 7: DomiVY collected ($2.50)
Seat 9: di0d80 folded before Flop (didn't bet)





PokerStars Hand #155380621835:  Hold'em No Limit ($0.50/$1.00 USD) - 2016/06/30 14:12:34 CET [2016/06/30 8:12:34 ET]
Table 'Borrelly II' 9-max Seat #7 is the button
Seat 2: mbk88 ($105 in chips) 
Seat 3: di0d80 ($100 in chips) 
Seat 4: DonRon_AT ($40.19 in chips) 
Seat 5: DIMAN_324 ($100 in chips) 
Seat 6: m_michalec ($178.50 in chips) 
Seat 7: matiko09 ($174.36 in chips) 
Seat 8: Arjun A Raju ($135.92 in chips) 
Seat 9: alhill86 ($74.18 in chips) 
Arjun A Raju: posts small blind $0.50
alhill86: posts big blind $1
Rafaello18: sits out 
*** HOLE CARDS ***
Dealt to matiko09 [2h 8s]
mbk88: folds 
di0d80: folds 
DonRon_AT: folds 
DIMAN_324: raises $2 to $3
m_michalec: calls $3
matiko09: folds 
Arjun A Raju: folds 
alhill86: folds 
*** FLOP *** [3c Jh Ah]
DIMAN_324: checks 
m_michalec: checks 
*** TURN *** [3c Jh Ah] [6h]
DIMAN_324: checks 
m_michalec: bets $4
DIMAN_324: calls $4
*** RIVER *** [3c Jh Ah 6h] [9c]
DIMAN_324: checks 
m_michalec: bets $5
DIMAN_324: calls $5
*** SHOW DOWN ***
m_michalec: shows [Ts Ad] (a pair of Aces)
DIMAN_324: shows [Td As] (a pair of Aces)
DIMAN_324 collected $12.11 from pot
m_michalec collected $12.11 from pot
*** SUMMARY ***
Total pot $25.50 | Rake $1.28 
Board [3c Jh Ah 6h 9c]
Seat 2: mbk88 folded before Flop (didn't bet)
Seat 3: di0d80 folded before Flop (didn't bet)
Seat 4: DonRon_AT folded before Flop (didn't bet)
Seat 5: DIMAN_324 showed [Td As] and won ($12.11) with a pair of Aces
Seat 6: m_michalec showed [Ts Ad] and won ($12.11) with a pair of Aces
Seat 7: matiko09 (button) folded before Flop (didn't bet)
Seat 8: Arjun A Raju (small blind) folded before Flop
Seat 9: alhill86 (big blind) folded before Flop





PokerStars Hand #155380628459:  Hold'em No Limit ($0.50/$1.00 USD) - 2016/06/30 14:12:48 CET [2016/06/30 8:12:48 ET]
Table 'Eucharis' 9-max Seat #4 is the button
Seat 1: picka4u ($84.73 in chips) 
Seat 2: matiko09 ($105.35 in chips) 
Seat 3: ramzes160468 ($70.86 in chips) 
Seat 4: mbk88 ($149.62 in chips) 
Seat 6: joooh79 ($131.02 in chips) 
Seat 7: Ty Nick 420 ($144 in chips) 
Seat 8: nickreason17 ($130.62 in chips) 
Seat 9: geiranger011 ($97.08 in chips) 
joooh79: posts small blind $0.50
Ty Nick 420: posts big blind $1
*** HOLE CARDS ***
Dealt to matiko09 [Kd Td]
nickreason17: folds 
geiranger011: folds 
nickreason17 leaves the table
ruslik_by joins the table at seat #8 
picka4u: folds 
matiko09: raises $2 to $3
ramzes160468: folds 
mbk88: folds 
joooh79: folds 
Ty Nick 420: calls $2
*** FLOP *** [3d Ks 7s]
Ty Nick 420: checks 
matiko09: checks 
*** TURN *** [3d Ks 7s] [2d]
Ty Nick 420: checks 
matiko09: bets $3.21
Ty Nick 420: folds 
Uncalled bet ($3.21) returned to matiko09
matiko09 collected $6.18 from pot
matiko09: doesn't show hand 
*** SUMMARY ***
Total pot $6.50 | Rake $0.32 
Board [3d Ks 7s 2d]
Seat 1: picka4u folded before Flop (didn't bet)
Seat 2: matiko09 collected ($6.18)
Seat 3: ramzes160468 folded before Flop (didn't bet)
Seat 4: mbk88 (button) folded before Flop (didn't bet)
Seat 6: joooh79 (small blind) folded before Flop
Seat 7: Ty Nick 420 (big blind) folded on the Turn
Seat 8: nickreason17 folded before Flop (didn't bet)
Seat 9: geiranger011 folded before Flop (didn't bet)





PokerStars Hand #155380630409:  Hold'em No Limit ($0.50/$1.00 USD) - 2016/06/30 14:12:52 CET [2016/06/30 8:12:52 ET]
Table 'Askania' 9-max Seat #5 is the button
Seat 1: chenconhaste ($101 in chips) 
Seat 2: DIMAN_324 ($101.50 in chips) 
Seat 3: matiko09 ($101.50 in chips) 
Seat 4: Hvittingfoss ($38.84 in chips) 
Seat 5: jezzaber ($124.12 in chips) 
Seat 6: nickreason17 ($102.60 in chips) 
Seat 7: ruslik_by ($100 in chips) 
Seat 8: kalcumite ($80.50 in chips) 
Seat 9: paul_007440 ($20.38 in chips) 
nickreason17: posts small blind $0.50
ruslik_by: posts big blind $1
*** HOLE CARDS ***
Dealt to matiko09 [Jh 7c]
kalcumite: folds 
paul_007440: raises $2 to $3
chenconhaste: folds 
DIMAN_324: folds 
matiko09: folds 
Hvittingfoss: folds 
jezzaber: calls $3
nickreason17: folds 
ruslik_by: folds 
*** FLOP *** [Ah 8d 4d]
paul_007440: checks 
jezzaber: bets $4
paul_007440: folds 
Uncalled bet ($4) returned to jezzaber
jezzaber collected $7.12 from pot
jezzaber: doesn't show hand 
*** SUMMARY ***
Total pot $7.50 | Rake $0.38 
Board [Ah 8d 4d]
Seat 1: chenconhaste folded before Flop (didn't bet)
Seat 2: DIMAN_324 folded before Flop (didn't bet)
Seat 3: matiko09 folded before Flop (didn't bet)
Seat 4: Hvittingfoss folded before Flop (didn't bet)
Seat 5: jezzaber (button) collected ($7.12)
Seat 6: nickreason17 (small blind) folded before Flop
Seat 7: ruslik_by (big blind) folded before Flop
Seat 8: kalcumite folded before Flop (didn't bet)
Seat 9: paul_007440 folded on the Flop





PokerStars Hand #155380634921:  Hold'em No Limit ($0.50/$1.00 USD) - 2016/06/30 14:13:02 CET [2016/06/30 8:13:02 ET]
Table 'California II' 9-max Seat #5 is the button
Seat 2: velourleder ($58.48 in chips) 
Seat 3: KovIFish89 ($102.52 in chips) 
Seat 4: mbk88 ($176.92 in chips) 
Seat 5: Rohitbarve ($109.02 in chips) 
Seat 6: matiko09 ($100 in chips) 
Seat 7: DomiVY ($81.20 in chips) 
Seat 9: di0d80 ($100.28 in chips) 
matiko09: posts small blind $0.50
DomiVY: posts big blind $1
Rafaello18: sits out 
*** HOLE CARDS ***
Dealt to matiko09 [9h 6c]
di0d80: raises $1.50 to $2.50
velourleder: folds 
KovIFish89: folds 
mbk88: folds 
Rohitbarve: raises $7.50 to $10
matiko09: folds 
DomiVY: folds 
di0d80: folds 
Uncalled bet ($7.50) returned to Rohitbarve
Rohitbarve collected $6.50 from pot
Rohitbarve: doesn't show hand 
*** SUMMARY ***
Total pot $6.50 | Rake $0 
Seat 2: velourleder folded before Flop (didn't bet)
Seat 3: KovIFish89 folded before Flop (didn't bet)
Seat 4: mbk88 folded before Flop (didn't bet)
Seat 5: Rohitbarve (button) collected ($6.50)
Seat 6: matiko09 (small blind) folded before Flop
Seat 7: DomiVY (big blind) folded before Flop
Seat 9: di0d80 folded before Flop





PokerStars Hand #155380634576:  Hold'em No Limit ($0.50/$1.00 USD) - 2016/06/30 14:13:02 CET [2016/06/30 8:13:02 ET]
Table 'Sigrid' 9-max Seat #7 is the button
Seat 1: Greha999 ($70.90 in chips) 
Seat 2: matiko09 ($105.52 in chips) 
Seat 4: mbk88 ($119.37 in chips) 
Seat 5: DIMAN_324 ($100 in chips) 
Seat 6: di0d80 ($114.49 in chips) 
Seat 7: arctur17 ($98.50 in chips) 
Seat 9: KovIFish89 ($108.48 in chips) 
ruslik_by will be allowed to play after the button
KovIFish89: posts small blind $0.50
Greha999: posts big blind $1
Rafaello18: sits out 
*** HOLE CARDS ***
Dealt to matiko09 [5h 9c]
matiko09: folds 
mbk88: folds 
DIMAN_324: folds 
di0d80: folds 
arctur17: folds 
KovIFish89: folds 
Uncalled bet ($0.50) returned to Greha999
Greha999 collected $1 from pot
*** SUMMARY ***
Total pot $1 | Rake $0 
Seat 1: Greha999 (big blind) collected ($1)
Seat 2: matiko09 folded before Flop (didn't bet)
Seat 4: mbk88 folded before Flop (didn't bet)
Seat 5: DIMAN_324 folded before Flop (didn't bet)
Seat 6: di0d80 folded before Flop (didn't bet)
Seat 7: arctur17 (button) folded before Flop (didn't bet)
Seat 9: KovIFish89 (small blind) folded before Flop





PokerStars Hand #155380641131:  Hold'em No Limit ($0.50/$1.00 USD) - 2016/06/30 14:13:16 CET [2016/06/30 8:13:16 ET]
Table 'Tatjana' 9-max Seat #9 is the button
Seat 1: tipner ($116.90 in chips) 
Seat 2: DIMAN_324 ($100 in chips) 
Seat 4: mopatron25 ($64.64 in chips) 
Seat 5: matiko09 ($100 in chips) 
Seat 6: mbk88 ($156.66 in chips) 
Seat 7: daigodisco ($89.84 in chips) 
Seat 8: alhill86 ($77.34 in chips) 
Seat 9: POTAPENKO700 ($234.21 in chips) 
tipner: posts small blind $0.50
DIMAN_324: posts big blind $1
Rafaello18: sits out 
*** HOLE CARDS ***
Dealt to matiko09 [6c 7d]
mopatron25: folds 
matiko09: folds 
mbk88: raises $2 to $3
daigodisco: folds 
alhill86: folds 
POTAPENKO700: folds 
tipner: folds 
DIMAN_324: calls $2
*** FLOP *** [Qd 9h 2c]
DIMAN_324: checks 
mbk88: bets $4
DIMAN_324: calls $4
*** TURN *** [Qd 9h 2c] [Th]
DIMAN_324: checks 
mbk88: bets $9
DIMAN_324: calls $9
*** RIVER *** [Qd 9h 2c Th] [5c]
DIMAN_324: checks 
mbk88: checks 
*** SHOW DOWN ***
DIMAN_324: shows [Kd Ah] (high card Ace)
mbk88: shows [Ad Qh] (a pair of Queens)
mbk88 collected $30.88 from pot
*** SUMMARY ***
Total pot $32.50 | Rake $1.62 
Board [Qd 9h 2c Th 5c]
Seat 1: tipner (small blind) folded before Flop
Seat 2: DIMAN_324 (big blind) showed [Kd Ah] and lost with high card Ace
Seat 4: mopatron25 folded before Flop (didn't bet)
Seat 5: matiko09 folded before Flop (didn't bet)
Seat 6: mbk88 showed [Ad Qh] and won ($30.88) with a pair of Queens
Seat 7: daigodisco folded before Flop (didn't bet)
Seat 8: alhill86 folded before Flop (didn't bet)
Seat 9: POTAPENKO700 (button) folded before Flop (didn't bet)





PokerStars Hand #155380642529:  Hold'em No Limit ($0.50/$1.00 USD) - 2016/06/30 14:13:19 CET [2016/06/30 8:13:19 ET]
Table 'Sigrid' 9-max Seat #9 is the button
Seat 1: Greha999 ($71.40 in chips) 
Seat 2: matiko09 ($105.52 in chips) 
Seat 4: mbk88 ($119.37 in chips) 
Seat 5: DIMAN_324 ($100 in chips) 
Seat 6: di0d80 ($114.49 in chips) 
Seat 7: arctur17 ($98.50 in chips) 
Seat 9: KovIFish89 ($107.98 in chips) 
Greha999: posts small blind $0.50
matiko09: posts big blind $1
Rafaello18: sits out 
ruslik_by: sits out 
*** HOLE CARDS ***
Dealt to matiko09 [Qd Kc]
mbk88: folds 
DIMAN_324: folds 
di0d80: folds 
arctur17: folds 
KovIFish89: raises $1 to $2
Greha999: folds 
matiko09: calls $1
*** FLOP *** [Qs 6h 6s]
matiko09: checks 
KovIFish89: bets $2.85
matiko09: calls $2.85
*** TURN *** [Qs 6h 6s] [Ah]
matiko09: checks 
KovIFish89: bets $6.45
matiko09: calls $6.45
*** RIVER *** [Qs 6h 6s Ah] [8c]
matiko09: checks 
KovIFish89: checks 
*** SHOW DOWN ***
matiko09: shows [Qd Kc] (two pair, Queens and Sixes)
KovIFish89: mucks hand 
matiko09 collected $21.94 from pot
*** SUMMARY ***
Total pot $23.10 | Rake $1.16 
Board [Qs 6h 6s Ah 8c]
Seat 1: Greha999 (small blind) folded before Flop
Seat 2: matiko09 (big blind) showed [Qd Kc] and won ($21.94) with two pair, Queens and Sixes
Seat 4: mbk88 folded before Flop (didn't bet)
Seat 5: DIMAN_324 folded before Flop (didn't bet)
Seat 6: di0d80 folded before Flop (didn't bet)
Seat 7: arctur17 folded before Flop (didn't bet)
Seat 9: KovIFish89 (button) mucked [Ts Kd]





PokerStars Hand #155380646303:  Hold'em No Limit ($0.50/$1.00 USD) - 2016/06/30 14:13:27 CET [2016/06/30 8:13:27 ET]
Table 'Asmodeus' 9-max Seat #3 is the button
Seat 1: scollop ($207 in chips) 
Seat 2: picka4u ($40 in chips) 
Seat 3: matiko09 ($126.74 in chips) 
Seat 4: DIMAN_324 ($100 in chips) 
Seat 6: koutani7 ($102.53 in chips) 
Seat 7: aaronzzr ($134.33 in chips) 
Seat 9: mbk88 ($159.76 in chips) 
DIMAN_324: posts small blind $0.50
koutani7: posts big blind $1
Rafaello18: sits out 
*** HOLE CARDS ***
Dealt to matiko09 [Jc 6d]
aaronzzr is disconnected 
aaronzzr has timed out while disconnected
aaronzzr: folds 
mbk88: raises $2 to $3
scollop: folds 
picka4u: folds 
matiko09: folds 
DIMAN_324: folds 
koutani7: folds 
Uncalled bet ($2) returned to mbk88
mbk88 collected $2.50 from pot
mbk88: doesn't show hand 
*** SUMMARY ***
Total pot $2.50 | Rake $0 
Seat 1: scollop folded before Flop (didn't bet)
Seat 2: picka4u folded before Flop (didn't bet)
Seat 3: matiko09 (button) folded before Flop (didn't bet)
Seat 4: DIMAN_324 (small blind) folded before Flop
Seat 6: koutani7 (big blind) folded before Flop
Seat 7: aaronzzr folded before Flop (didn't bet)
Seat 9: mbk88 collected ($2.50)





PokerStars Hand #155380647241:  Hold'em No Limit ($0.50/$1.00 USD) - 2016/06/30 14:13:30 CET [2016/06/30 8:13:30 ET]
Table 'California II' 9-max Seat #6 is the button
Seat 2: velourleder ($58.48 in chips) 
Seat 3: KovIFish89 ($102.52 in chips) 
Seat 4: mbk88 ($176.92 in chips) 
Seat 5: Rohitbarve ($113.02 in chips) 
Seat 6: matiko09 ($100 in chips) 
Seat 7: DomiVY ($80.20 in chips) 
Seat 9: di0d80 ($100 in chips) 
DomiVY: posts small blind $0.50
di0d80: posts big blind $1
Rafaello18: sits out 
*** HOLE CARDS ***
Dealt to matiko09 [Kh 4h]
velourleder: folds 
KovIFish89: folds 
mbk88: raises $2 to $3
Rohitbarve: folds 
matiko09: folds 
DomiVY: folds 
di0d80: folds 
Uncalled bet ($2) returned to mbk88
mbk88 collected $2.50 from pot
mbk88: doesn't show hand 
*** SUMMARY ***
Total pot $2.50 | Rake $0 
Seat 2: velourleder folded before Flop (didn't bet)
Seat 3: KovIFish89 folded before Flop (didn't bet)
Seat 4: mbk88 collected ($2.50)
Seat 5: Rohitbarve folded before Flop (didn't bet)
Seat 6: matiko09 (button) folded before Flop (didn't bet)
Seat 7: DomiVY (small blind) folded before Flop
Seat 9: di0d80 (big blind) folded before Flop





PokerStars Hand #155380649646:  Hold'em No Limit ($0.50/$1.00 USD) - 2016/06/30 14:13:35 CET [2016/06/30 8:13:35 ET]
Table 'Askania' 9-max Seat #6 is the button
Seat 1: chenconhaste ($101 in chips) 
Seat 2: DIMAN_324 ($101.50 in chips) 
Seat 3: matiko09 ($101.50 in chips) 
Seat 4: Hvittingfoss ($38.84 in chips) 
Seat 5: jezzaber ($128.24 in chips) 
Seat 6: nickreason17 ($102.10 in chips) 
Seat 7: ruslik_by ($100 in chips) 
Seat 8: kalcumite ($80.50 in chips) 
Seat 9: paul_007440 ($17.38 in chips) 
ruslik_by: posts small blind $0.50
kalcumite: posts big blind $1
*** HOLE CARDS ***
Dealt to matiko09 [8c Ac]
paul_007440: folds 
chenconhaste: raises $1.25 to $2.25
DIMAN_324: folds 
matiko09: folds 
Hvittingfoss: calls $2.25
jezzaber: folds 
nickreason17: folds 
ruslik_by: folds 
kalcumite: calls $1.25
*** FLOP *** [8s Ah 3s]
kalcumite: checks 
chenconhaste: checks 
Hvittingfoss: checks 
*** TURN *** [8s Ah 3s] [Td]
kalcumite: checks 
chenconhaste: checks 
Hvittingfoss: checks 
*** RIVER *** [8s Ah 3s Td] [4c]
kalcumite: checks 
chenconhaste: bets $3
Hvittingfoss: folds 
kalcumite: folds 
Uncalled bet ($3) returned to chenconhaste
chenconhaste collected $6.89 from pot
*** SUMMARY ***
Total pot $7.25 | Rake $0.36 
Board [8s Ah 3s Td 4c]
Seat 1: chenconhaste collected ($6.89)
Seat 2: DIMAN_324 folded before Flop (didn't bet)
Seat 3: matiko09 folded before Flop (didn't bet)
Seat 4: Hvittingfoss folded on the River
Seat 5: jezzaber folded before Flop (didn't bet)
Seat 6: nickreason17 (button) folded before Flop (didn't bet)
Seat 7: ruslik_by (small blind) folded before Flop
Seat 8: kalcumite (big blind) folded on the River
Seat 9: paul_007440 folded before Flop (didn't bet)





PokerStars Hand #155380651300:  Hold'em No Limit ($0.50/$1.00 USD) - 2016/06/30 14:13:38 CET [2016/06/30 8:13:38 ET]
Table 'Altarf II' 9-max Seat #8 is the button
Seat 1: Rafaello18 ($100 in chips) 
Seat 2: KovIFish89 ($102.50 in chips) 
Seat 4: Greha999 ($76.94 in chips) 
Seat 5: DIMAN_324 ($230.24 in chips) 
Seat 6: mbk88 ($101.50 in chips) 
Seat 7: matiko09 ($106.40 in chips) 
Seat 8: DomiVY ($40 in chips) 
Seat 9: omanibemihum ($125.07 in chips) 
omanibemihum: posts small blind $0.50
Rafaello18: posts big blind $1
*** HOLE CARDS ***
Dealt to matiko09 [2d 6c]
KovIFish89: folds 
Greha999: folds 
DIMAN_324: folds 
mbk88: folds 
matiko09: folds 
DomiVY: folds 
omanibemihum: raises $1 to $2
Rafaello18: folds 
Uncalled bet ($1) returned to omanibemihum
omanibemihum collected $2 from pot
omanibemihum: doesn't show hand 
*** SUMMARY ***
Total pot $2 | Rake $0 
Seat 1: Rafaello18 (big blind) folded before Flop
Seat 2: KovIFish89 folded before Flop (didn't bet)
Seat 4: Greha999 folded before Flop (didn't bet)
Seat 5: DIMAN_324 folded before Flop (didn't bet)
Seat 6: mbk88 folded before Flop (didn't bet)
Seat 7: matiko09 folded before Flop (didn't bet)
Seat 8: DomiVY (button) folded before Flop (didn't bet)
Seat 9: omanibemihum (small blind) collected ($2)





PokerStars Hand #155380662855:  Hold'em No Limit ($0.50/$1.00 USD) - 2016/06/30 14:14:04 CET [2016/06/30 8:14:04 ET]
Table 'California II' 9-max Seat #7 is the button
Seat 1: Rafaello18 ($101.02 in chips) 
Seat 2: velourleder ($58.48 in chips) 
Seat 3: KovIFish89 ($102.52 in chips) 
Seat 4: mbk88 ($178.42 in chips) 
Seat 5: Rohitbarve ($113.02 in chips) 
Seat 6: matiko09 ($100 in chips) 
Seat 7: DomiVY ($79.70 in chips) 
Seat 9: di0d80 ($100 in chips) 
di0d80: posts small blind $0.50
Rafaello18: posts big blind $1
*** HOLE CARDS ***
Dealt to matiko09 [6c Tc]
velourleder: folds 
KovIFish89: folds 
mbk88: folds 
Rohitbarve: folds 
matiko09: folds 
DomiVY: raises $1.10 to $2.10
di0d80: raises $4.90 to $7
Rafaello18: folds 
DomiVY: folds 
Uncalled bet ($4.90) returned to di0d80
di0d80 collected $5.20 from pot
di0d80: doesn't show hand 
*** SUMMARY ***
Total pot $5.20 | Rake $0 
Seat 1: Rafaello18 (big blind) folded before Flop
Seat 2: velourleder folded before Flop (didn't bet)
Seat 3: KovIFish89 folded before Flop (didn't bet)
Seat 4: mbk88 folded before Flop (didn't bet)
Seat 5: Rohitbarve folded before Flop (didn't bet)
Seat 6: matiko09 folded before Flop (didn't bet)
Seat 7: DomiVY (button) folded before Flop
Seat 9: di0d80 (small blind) collected ($5.20)





PokerStars Hand #155380663626:  Hold'em No Limit ($0.50/$1.00 USD) - 2016/06/30 14:14:05 CET [2016/06/30 8:14:05 ET]
Table 'Donnera' 9-max Seat #3 is the button
Seat 2: robbiescrim9 ($98.79 in chips) 
Seat 3: matiko09 ($100 in chips) 
Seat 4: Kukuryzka ($99 in chips) 
Seat 5: tipner ($100 in chips) 
Kukuryzka: posts small blind $0.50
tipner: posts big blind $1
nickreason17: sits out 
Rafaello18: sits out 
ruslik_by: sits out 
Starw!nd: sits out 
chenconhaste: sits out 
*** HOLE CARDS ***
Dealt to matiko09 [8h Jh]
robbiescrim9: raises $1 to $2
matiko09: folds 
Kukuryzka: folds 
tipner: calls $1
*** FLOP *** [Kc Qd Qh]
tipner: checks 
robbiescrim9: checks 
*** TURN *** [Kc Qd Qh] [7c]
tipner: checks 
robbiescrim9: bets $3
tipner: folds 
Uncalled bet ($3) returned to robbiescrim9
robbiescrim9 collected $4.28 from pot
robbiescrim9: doesn't show hand 
*** SUMMARY ***
Total pot $4.50 | Rake $0.22 
Board [Kc Qd Qh 7c]
Seat 2: robbiescrim9 collected ($4.28)
Seat 3: matiko09 (button) folded before Flop (didn't bet)
Seat 4: Kukuryzka (small blind) folded before Flop
Seat 5: tipner (big blind) folded on the Turn





PokerStars Hand #155380664949:  Hold'em No Limit ($0.50/$1.00 USD) - 2016/06/30 14:14:08 CET [2016/06/30 8:14:08 ET]
Table 'Tatjana' 9-max Seat #1 is the button
Seat 1: tipner ($116.40 in chips) 
Seat 2: DIMAN_324 ($100 in chips) 
Seat 3: Rafaello18 ($102.79 in chips) 
Seat 4: mopatron25 ($64.64 in chips) 
Seat 5: matiko09 ($100 in chips) 
Seat 6: mbk88 ($171.54 in chips) 
Seat 7: daigodisco ($89.84 in chips) 
Seat 8: alhill86 ($77.34 in chips) 
Seat 9: POTAPENKO700 ($234.21 in chips) 
DIMAN_324: posts small blind $0.50
Rafaello18: posts big blind $1
*** HOLE CARDS ***
Dealt to matiko09 [Kh 5c]
mopatron25: folds 
matiko09: folds 
mbk88: folds 
daigodisco: calls $1
alhill86: folds 
POTAPENKO700: folds 
tipner: folds 
DIMAN_324: calls $0.50
Rafaello18: checks 
*** FLOP *** [2c Js 8s]
DIMAN_324: checks 
Rafaello18: checks 
daigodisco: bets $4
DIMAN_324: folds 
Rafaello18: folds 
Uncalled bet ($4) returned to daigodisco
daigodisco collected $2.85 from pot
daigodisco: doesn't show hand 
*** SUMMARY ***
Total pot $3 | Rake $0.15 
Board [2c Js 8s]
Seat 1: tipner (button) folded before Flop (didn't bet)
Seat 2: DIMAN_324 (small blind) folded on the Flop
Seat 3: Rafaello18 (big blind) folded on the Flop
Seat 4: mopatron25 folded before Flop (didn't bet)
Seat 5: matiko09 folded before Flop (didn't bet)
Seat 6: mbk88 folded before Flop (didn't bet)
Seat 7: daigodisco collected ($2.85)
Seat 8: alhill86 folded before Flop (didn't bet)
Seat 9: POTAPENKO700 folded before Flop (didn't bet)





PokerStars Hand #155380667858:  Hold'em No Limit ($0.50/$1.00 USD) - 2016/06/30 14:14:14 CET [2016/06/30 8:14:14 ET]
Table 'Altarf II' 9-max Seat #9 is the button
Seat 1: Rafaello18 ($100 in chips) 
Seat 2: KovIFish89 ($102.50 in chips) 
Seat 4: Greha999 ($76.94 in chips) 
Seat 5: DIMAN_324 ($230.24 in chips) 
Seat 6: mbk88 ($101.50 in chips) 
Seat 7: matiko09 ($106.40 in chips) 
Seat 8: DomiVY ($40 in chips) 
Seat 9: omanibemihum ($126.07 in chips) 
Rafaello18: posts small blind $0.50
KovIFish89: posts big blind $1
*** HOLE CARDS ***
Dealt to matiko09 [3h 3c]
Greha999: folds 
DIMAN_324: folds 
mbk88: folds 
matiko09: raises $2 to $3
DomiVY: folds 
omanibemihum: calls $3
Rafaello18: folds 
KovIFish89: folds 
*** FLOP *** [Qd Jh Qh]
matiko09: checks 
omanibemihum: bets $7
matiko09: folds 
Uncalled bet ($7) returned to omanibemihum
omanibemihum collected $7.12 from pot
omanibemihum: doesn't show hand 
*** SUMMARY ***
Total pot $7.50 | Rake $0.38 
Board [Qd Jh Qh]
Seat 1: Rafaello18 (small blind) folded before Flop
Seat 2: KovIFish89 (big blind) folded before Flop
Seat 4: Greha999 folded before Flop (didn't bet)
Seat 5: DIMAN_324 folded before Flop (didn't bet)
Seat 6: mbk88 folded before Flop (didn't bet)
Seat 7: matiko09 folded on the Flop
Seat 8: DomiVY folded before Flop (didn't bet)
Seat 9: omanibemihum (button) collected ($7.12)





PokerStars Hand #155380668033:  Hold'em No Limit ($0.50/$1.00 USD) - 2016/06/30 14:14:15 CET [2016/06/30 8:14:15 ET]
Table 'Eucharis' 9-max Seat #6 is the button
Seat 1: picka4u ($84.73 in chips) 
Seat 2: matiko09 ($108.53 in chips) 
Seat 3: ramzes160468 ($70.86 in chips) 
Seat 4: mbk88 ($149.62 in chips) 
Seat 6: joooh79 ($130.52 in chips) 
Seat 7: Ty Nick 420 ($141 in chips) 
Seat 8: ruslik_by ($100 in chips) 
Seat 9: geiranger011 ($97.08 in chips) 
Ty Nick 420: posts small blind $0.50
ruslik_by: posts big blind $1
*** HOLE CARDS ***
Dealt to matiko09 [3s 4d]
geiranger011: folds 
picka4u: folds 
matiko09: folds 
ramzes160468: raises $2 to $3
mbk88: folds 
joooh79: folds 
Ty Nick 420: folds 
ruslik_by: folds 
Uncalled bet ($2) returned to ramzes160468
ramzes160468 collected $2.50 from pot
*** SUMMARY ***
Total pot $2.50 | Rake $0 
Seat 1: picka4u folded before Flop (didn't bet)
Seat 2: matiko09 folded before Flop (didn't bet)
Seat 3: ramzes160468 collected ($2.50)
Seat 4: mbk88 folded before Flop (didn't bet)
Seat 6: joooh79 (button) folded before Flop (didn't bet)
Seat 7: Ty Nick 420 (small blind) folded before Flop
Seat 8: ruslik_by (big blind) folded before Flop
Seat 9: geiranger011 folded before Flop (didn't bet)





PokerStars Hand #155380669630:  Hold'em No Limit ($0.50/$1.00 USD) - 2016/06/30 14:14:18 CET [2016/06/30 8:14:18 ET]
Table 'Sigrid' 9-max Seat #1 is the button
Seat 1: Greha999 ($70.90 in chips) 
Seat 2: matiko09 ($116.16 in chips) 
Seat 3: Rafaello18 ($101.10 in chips) 
Seat 4: mbk88 ($119.37 in chips) 
Seat 5: DIMAN_324 ($100 in chips) 
Seat 6: di0d80 ($114.49 in chips) 
Seat 7: arctur17 ($98.50 in chips) 
Seat 9: KovIFish89 ($100 in chips) 
matiko09: posts small blind $0.50
Rafaello18: posts big blind $1
ruslik_by: sits out 
*** HOLE CARDS ***
Dealt to matiko09 [8d Ah]
mbk88: raises $2 to $3
DIMAN_324: folds 
di0d80: folds 
arctur17: folds 
KovIFish89: folds 
Greha999: folds 
matiko09: folds 
Rafaello18: folds 
Uncalled bet ($2) returned to mbk88
mbk88 collected $2.50 from pot
mbk88: doesn't show hand 
*** SUMMARY ***
Total pot $2.50 | Rake $0 
Seat 1: Greha999 (button) folded before Flop (didn't bet)
Seat 2: matiko09 (small blind) folded before Flop
Seat 3: Rafaello18 (big blind) folded before Flop
Seat 4: mbk88 collected ($2.50)
Seat 5: DIMAN_324 folded before Flop (didn't bet)
Seat 6: di0d80 folded before Flop (didn't bet)
Seat 7: arctur17 folded before Flop (didn't bet)
Seat 9: KovIFish89 folded before Flop (didn't bet)





PokerStars Hand #155380673543:  Hold'em No Limit ($0.50/$1.00 USD) - 2016/06/30 14:14:27 CET [2016/06/30 8:14:27 ET]
Table 'Asmodeus' 9-max Seat #4 is the button
Seat 1: scollop ($207 in chips) 
Seat 2: picka4u ($40 in chips) 
Seat 3: matiko09 ($126.74 in chips) 
Seat 4: DIMAN_324 ($100 in chips) 
Seat 6: koutani7 ($101.53 in chips) 
Seat 8: Rafaello18 ($168.85 in chips) 
Seat 9: mbk88 ($161.26 in chips) 
koutani7: posts small blind $0.50
Rafaello18: posts big blind $1
*** HOLE CARDS ***
Dealt to matiko09 [3s 7h]
mbk88: folds 
scollop: calls $1
picka4u: folds 
matiko09: folds 
DIMAN_324: folds 
koutani7: folds 
Rafaello18: checks 
*** FLOP *** [4s Kc 7d]
Rafaello18: checks 
scollop: checks 
*** TURN *** [4s Kc 7d] [9h]
Rafaello18: bets $1.50
scollop: calls $1.50
*** RIVER *** [4s Kc 7d 9h] [2h]
Rafaello18: bets $2
scollop: folds 
Uncalled bet ($2) returned to Rafaello18
Rafaello18 collected $5.22 from pot
Rafaello18: doesn't show hand 
*** SUMMARY ***
Total pot $5.50 | Rake $0.28 
Board [4s Kc 7d 9h 2h]
Seat 1: scollop folded on the River
Seat 2: picka4u folded before Flop (didn't bet)
Seat 3: matiko09 folded before Flop (didn't bet)
Seat 4: DIMAN_324 (button) folded before Flop (didn't bet)
Seat 6: koutani7 (small blind) folded before Flop
Seat 8: Rafaello18 (big blind) collected ($5.22)
Seat 9: mbk88 folded before Flop (didn't bet)





PokerStars Hand #155380679548:  Hold'em No Limit ($0.50/$1.00 USD) - 2016/06/30 14:14:40 CET [2016/06/30 8:14:40 ET]
Table 'Eucharis' 9-max Seat #7 is the button
Seat 1: picka4u ($84.73 in chips) 
Seat 2: matiko09 ($108.53 in chips) 
Seat 3: ramzes160468 ($72.36 in chips) 
Seat 4: mbk88 ($149.62 in chips) 
Seat 6: joooh79 ($130.52 in chips) 
Seat 7: Ty Nick 420 ($140.50 in chips) 
Seat 8: ruslik_by ($100 in chips) 
Seat 9: geiranger011 ($97.08 in chips) 
ruslik_by: posts small blind $0.50
geiranger011: posts big blind $1
*** HOLE CARDS ***
Dealt to matiko09 [5c 8c]
picka4u: folds 
matiko09: folds 
ramzes160468: folds 
mbk88: raises $2 to $3
picka4u leaves the table
joooh79: folds 
Ty Nick 420: folds 
ruslik_by: raises $6.50 to $9.50
geiranger011: folds 
mbk88: calls $6.50
*** FLOP *** [4c Ah Jc]
ruslik_by: checks 
mbk88: checks 
*** TURN *** [4c Ah Jc] [2c]
ruslik_by: bets $9.50
mbk88: calls $9.50
*** RIVER *** [4c Ah Jc 2c] [8s]
ruslik_by: bets $18.52
chenconhaste joins the table at seat #1 
mbk88: raises $112.10 to $130.62 and is all-in
ruslik_by: calls $62.48 and is all-in
Uncalled bet ($49.62) returned to mbk88
*** SHOW DOWN ***
mbk88: shows [9c Tc] (a flush, Jack high)
ruslik_by: shows [Ac As] (three of a kind, Aces)
mbk88 collected $198.50 from pot
*** SUMMARY ***
Total pot $201 | Rake $2.50 
Board [4c Ah Jc 2c 8s]
Seat 1: picka4u folded before Flop (didn't bet)
Seat 2: matiko09 folded before Flop (didn't bet)
Seat 3: ramzes160468 folded before Flop (didn't bet)
Seat 4: mbk88 showed [9c Tc] and won ($198.50) with a flush, Jack high
Seat 6: joooh79 folded before Flop (didn't bet)
Seat 7: Ty Nick 420 (button) folded before Flop (didn't bet)
Seat 8: ruslik_by (small blind) showed [Ac As] and lost with three of a kind, Aces
Seat 9: geiranger011 (big blind) folded before Flop





PokerStars Hand #155380680688:  Hold'em No Limit ($0.50/$1.00 USD) - 2016/06/30 14:14:42 CET [2016/06/30 8:14:42 ET]
Table 'Sigrid' 9-max Seat #2 is the button
Seat 1: Greha999 ($70.90 in chips) 
Seat 2: matiko09 ($115.66 in chips) 
Seat 3: Rafaello18 ($100.10 in chips) 
Seat 4: mbk88 ($120.87 in chips) 
Seat 5: DIMAN_324 ($100 in chips) 
Seat 6: di0d80 ($114.49 in chips) 
Seat 7: arctur17 ($98.50 in chips) 
Seat 9: KovIFish89 ($100 in chips) 
Rafaello18: posts small blind $0.50
mbk88: posts big blind $1
ruslik_by: sits out 
*** HOLE CARDS ***
Dealt to matiko09 [Kh 6s]
DIMAN_324: folds 
di0d80: folds 
arctur17: folds 
KovIFish89: folds 
Greha999: raises $2 to $3
matiko09: folds 
Rafaello18: folds 
mbk88: calls $2
*** FLOP *** [4h As 9s]
mbk88: checks 
Greha999: bets $3
mbk88: folds 
Uncalled bet ($3) returned to Greha999
Greha999 collected $6.18 from pot
*** SUMMARY ***
Total pot $6.50 | Rake $0.32 
Board [4h As 9s]
Seat 1: Greha999 collected ($6.18)
Seat 2: matiko09 (button) folded before Flop (didn't bet)
Seat 3: Rafaello18 (small blind) folded before Flop
Seat 4: mbk88 (big blind) folded on the Flop
Seat 5: DIMAN_324 folded before Flop (didn't bet)
Seat 6: di0d80 folded before Flop (didn't bet)
Seat 7: arctur17 folded before Flop (didn't bet)
Seat 9: KovIFish89 folded before Flop (didn't bet)





PokerStars Hand #155380681544:  Hold'em No Limit ($0.25/$0.50 USD) - 2016/06/30 14:14:44 CET [2016/06/30 8:14:44 ET]
Table 'Arcturus' 9-max Seat #1 is the button
Seat 1: kourk250 ($131.02 in chips) 
Seat 2: Rafaello18 ($50 in chips) 
Seat 3: matiko09 ($54.31 in chips) 
Seat 4: Vedpapa ($50.75 in chips) 
Seat 5: stockbridge8 ($49.25 in chips) 
Seat 6: statistik85 ($64.97 in chips) 
Seat 7: DaikenGF ($67.63 in chips) 
Seat 8: TheMinion ($50 in chips) 
Seat 9: pfunkolstar ($57.42 in chips) 
Rafaello18: posts small blind $0.25
matiko09: posts big blind $0.50
*** HOLE CARDS ***
Dealt to matiko09 [7c 2s]
Vedpapa: folds 
stockbridge8: folds 
statistik85: calls $0.50
DaikenGF: raises $1.75 to $2.25
TheMinion: folds 
pfunkolstar: calls $2.25
kourk250: folds 
Rafaello18: folds 
matiko09: folds 
statistik85: folds 
*** FLOP *** [Jd 4s Js]
DaikenGF: bets $2.75
pfunkolstar: folds 
Uncalled bet ($2.75) returned to DaikenGF
DaikenGF collected $5.46 from pot
DaikenGF: doesn't show hand 
*** SUMMARY ***
Total pot $5.75 | Rake $0.29 
Board [Jd 4s Js]
Seat 1: kourk250 (button) folded before Flop (didn't bet)
Seat 2: Rafaello18 (small blind) folded before Flop
Seat 3: matiko09 (big blind) folded before Flop
Seat 4: Vedpapa folded before Flop (didn't bet)
Seat 5: stockbridge8 folded before Flop (didn't bet)
Seat 6: statistik85 folded before Flop
Seat 7: DaikenGF collected ($5.46)
Seat 8: TheMinion folded before Flop (didn't bet)
Seat 9: pfunkolstar folded on the Flop





PokerStars Hand #155380682141:  Hold'em No Limit ($0.50/$1.00 USD) - 2016/06/30 14:14:45 CET [2016/06/30 8:14:45 ET]
Table 'Borrelly II' 9-max Seat #8 is the button
Seat 1: Rafaello18 ($118.57 in chips) 
Seat 2: mbk88 ($105 in chips) 
Seat 3: di0d80 ($100 in chips) 
Seat 4: DonRon_AT ($40.19 in chips) 
Seat 5: DIMAN_324 ($100.11 in chips) 
Seat 6: m_michalec ($178.61 in chips) 
Seat 7: matiko09 ($174.36 in chips) 
Seat 8: Arjun A Raju ($135.42 in chips) 
Seat 9: alhill86 ($73.18 in chips) 
alhill86: posts small blind $0.50
Rafaello18: posts big blind $1
*** HOLE CARDS ***
Dealt to matiko09 [Ks Tc]
mbk88: folds 
di0d80: folds 
DonRon_AT: folds 
DIMAN_324: folds 
m_michalec: folds 
matiko09: raises $1.50 to $2.50
Arjun A Raju: folds 
alhill86: folds 
Rafaello18: folds 
Uncalled bet ($1.50) returned to matiko09
matiko09 collected $2.50 from pot
matiko09: doesn't show hand 
*** SUMMARY ***
Total pot $2.50 | Rake $0 
Seat 1: Rafaello18 (big blind) folded before Flop
Seat 2: mbk88 folded before Flop (didn't bet)
Seat 3: di0d80 folded before Flop (didn't bet)
Seat 4: DonRon_AT folded before Flop (didn't bet)
Seat 5: DIMAN_324 folded before Flop (didn't bet)
Seat 6: m_michalec folded before Flop (didn't bet)
Seat 7: matiko09 collected ($2.50)
Seat 8: Arjun A Raju (button) folded before Flop (didn't bet)
Seat 9: alhill86 (small blind) folded before Flop





PokerStars Hand #155380682283:  Hold'em No Limit ($0.50/$1.00 USD) - 2016/06/30 14:14:46 CET [2016/06/30 8:14:46 ET]
Table 'Askania' 9-max Seat #7 is the button
Seat 1: chenconhaste ($105.64 in chips) 
Seat 2: DIMAN_324 ($101.50 in chips) 
Seat 3: matiko09 ($101.50 in chips) 
Seat 4: Hvittingfoss ($36.59 in chips) 
Seat 5: jezzaber ($128.24 in chips) 
Seat 6: nickreason17 ($102.10 in chips) 
Seat 7: ruslik_by ($100 in chips) 
Seat 8: kalcumite ($78.25 in chips) 
Seat 9: paul_007440 ($17.38 in chips) 
kalcumite: posts small blind $0.50
paul_007440: posts big blind $1
*** HOLE CARDS ***
Dealt to matiko09 [7h Ah]
chenconhaste: folds 
DIMAN_324: folds 
matiko09: folds 
Hvittingfoss: folds 
jezzaber: raises $2 to $3
nickreason17: folds 
ruslik_by: folds 
kalcumite: folds 
paul_007440: folds 
Uncalled bet ($2) returned to jezzaber
jezzaber collected $2.50 from pot
jezzaber: doesn't show hand 
*** SUMMARY ***
Total pot $2.50 | Rake $0 
Seat 1: chenconhaste folded before Flop (didn't bet)
Seat 2: DIMAN_324 folded before Flop (didn't bet)
Seat 3: matiko09 folded before Flop (didn't bet)
Seat 4: Hvittingfoss folded before Flop (didn't bet)
Seat 5: jezzaber collected ($2.50)
Seat 6: nickreason17 folded before Flop (didn't bet)
Seat 7: ruslik_by (button) folded before Flop (didn't bet)
Seat 8: kalcumite (small blind) folded before Flop
Seat 9: paul_007440 (big blind) folded before Flop





PokerStars Hand #155380683932:  Hold'em No Limit ($0.50/$1.00 USD) - 2016/06/30 14:14:49 CET [2016/06/30 8:14:49 ET]
Table 'Donnera' 9-max Seat #4 is the button
Seat 2: robbiescrim9 ($101.07 in chips) 
Seat 3: matiko09 ($100 in chips) 
Seat 4: Kukuryzka ($100 in chips) 
Seat 5: tipner ($100 in chips) 
Seat 6: nickreason17 ($100 in chips) 
tipner: posts small blind $0.50
nickreason17: posts big blind $1
Rafaello18: sits out 
ruslik_by: sits out 
Starw!nd: sits out 
chenconhaste: sits out 
*** HOLE CARDS ***
Dealt to matiko09 [2s 8d]
robbiescrim9: calls $1
matiko09: folds 
Kukuryzka: raises $3 to $4
tipner: calls $3.50
nickreason17: calls $3
robbiescrim9: folds 
*** FLOP *** [Kc As Tc]
tipner: checks 
nickreason17: checks 
Kukuryzka: checks 
*** TURN *** [Kc As Tc] [4d]
tipner: checks 
nickreason17: checks 
Kukuryzka: checks 
*** RIVER *** [Kc As Tc 4d] [Qc]
tipner: bets $7
nickreason17: folds 
Kukuryzka: folds 
Uncalled bet ($7) returned to tipner
tipner collected $12.35 from pot
tipner: doesn't show hand 
*** SUMMARY ***
Total pot $13 | Rake $0.65 
Board [Kc As Tc 4d Qc]
Seat 2: robbiescrim9 folded before Flop
Seat 3: matiko09 folded before Flop (didn't bet)
Seat 4: Kukuryzka (button) folded on the River
Seat 5: tipner (small blind) collected ($12.35)
Seat 6: nickreason17 (big blind) folded on the River





PokerStars Hand #155380686045:  Hold'em No Limit ($0.50/$1.00 USD) - 2016/06/30 14:14:54 CET [2016/06/30 8:14:54 ET]
Table 'California II' 9-max Seat #9 is the button
Seat 1: Rafaello18 ($100.02 in chips) 
Seat 2: velourleder ($58.48 in chips) 
Seat 3: KovIFish89 ($102.52 in chips) 
Seat 4: mbk88 ($178.42 in chips) 
Seat 5: Rohitbarve ($113.02 in chips) 
Seat 6: matiko09 ($100 in chips) 
Seat 7: DomiVY ($77.60 in chips) 
Seat 9: di0d80 ($103.10 in chips) 
Rafaello18: posts small blind $0.50
velourleder: posts big blind $1
*** HOLE CARDS ***
Dealt to matiko09 [5s Kd]
KovIFish89: folds 
mbk88: folds 
Rohitbarve: folds 
matiko09: folds 
DomiVY: folds 
di0d80: raises $1 to $2
Rafaello18: folds 
velourleder: calls $1
*** FLOP *** [Kc 8c 7c]
velourleder: bets $4
di0d80: folds 
Uncalled bet ($4) returned to velourleder
velourleder collected $4.28 from pot
*** SUMMARY ***
Total pot $4.50 | Rake $0.22 
Board [Kc 8c 7c]
Seat 1: Rafaello18 (small blind) folded before Flop
Seat 2: velourleder (big blind) collected ($4.28)
Seat 3: KovIFish89 folded before Flop (didn't bet)
Seat 4: mbk88 folded before Flop (didn't bet)
Seat 5: Rohitbarve folded before Flop (didn't bet)
Seat 6: matiko09 folded before Flop (didn't bet)
Seat 7: DomiVY folded before Flop (didn't bet)
Seat 9: di0d80 (button) folded on the Flop





PokerStars Hand #155380687693:  Hold'em No Limit ($0.50/$1.00 USD) - 2016/06/30 14:14:58 CET [2016/06/30 8:14:58 ET]
Table 'Altarf II' 9-max Seat #1 is the button
Seat 1: Rafaello18 ($100 in chips) 
Seat 2: KovIFish89 ($101.50 in chips) 
Seat 4: Greha999 ($76.94 in chips) 
Seat 5: DIMAN_324 ($230.24 in chips) 
Seat 6: mbk88 ($101.50 in chips) 
Seat 7: matiko09 ($103.40 in chips) 
Seat 8: DomiVY ($40 in chips) 
Seat 9: omanibemihum ($130.19 in chips) 
KovIFish89: posts small blind $0.50
Greha999: posts big blind $1
*** HOLE CARDS ***
Dealt to matiko09 [7c 7h]
DIMAN_324: folds 
mbk88: folds 
matiko09: raises $2 to $3
DomiVY: folds 
omanibemihum: folds 
Rafaello18: folds 
KovIFish89: folds 
Greha999: folds 
Uncalled bet ($2) returned to matiko09
matiko09 collected $2.50 from pot
matiko09: doesn't show hand 
*** SUMMARY ***
Total pot $2.50 | Rake $0 
Seat 1: Rafaello18 (button) folded before Flop (didn't bet)
Seat 2: KovIFish89 (small blind) folded before Flop
Seat 4: Greha999 (big blind) folded before Flop
Seat 5: DIMAN_324 folded before Flop (didn't bet)
Seat 6: mbk88 folded before Flop (didn't bet)
Seat 7: matiko09 collected ($2.50)
Seat 8: DomiVY folded before Flop (didn't bet)
Seat 9: omanibemihum folded before Flop (didn't bet)





PokerStars Hand #155380690069:  Hold'em No Limit ($0.50/$1.00 USD) - 2016/06/30 14:15:03 CET [2016/06/30 8:15:03 ET]
Table 'Tatjana' 9-max Seat #2 is the button
Seat 1: tipner ($116.40 in chips) 
Seat 2: DIMAN_324 ($100 in chips) 
Seat 3: Rafaello18 ($101.79 in chips) 
Seat 4: mopatron25 ($64.64 in chips) 
Seat 5: matiko09 ($100 in chips) 
Seat 6: mbk88 ($171.54 in chips) 
Seat 7: daigodisco ($91.69 in chips) 
Seat 8: alhill86 ($77.34 in chips) 
Seat 9: POTAPENKO700 ($234.21 in chips) 
Rafaello18: posts small blind $0.50
mopatron25: posts big blind $1
*** HOLE CARDS ***
Dealt to matiko09 [3h 4d]
matiko09: folds 
mbk88: folds 
daigodisco: folds 
alhill86: folds 
POTAPENKO700: folds 
tipner: folds 
DIMAN_324: raises $1.10 to $2.10
Rafaello18: folds 
mopatron25: calls $1.10
*** FLOP *** [Ts 6c 2s]
mopatron25: bets $2
DIMAN_324: folds 
Uncalled bet ($2) returned to mopatron25
mopatron25 collected $4.46 from pot
mopatron25: doesn't show hand 
*** SUMMARY ***
Total pot $4.70 | Rake $0.24 
Board [Ts 6c 2s]
Seat 1: tipner folded before Flop (didn't bet)
Seat 2: DIMAN_324 (button) folded on the Flop
Seat 3: Rafaello18 (small blind) folded before Flop
Seat 4: mopatron25 (big blind) collected ($4.46)
Seat 5: matiko09 folded before Flop (didn't bet)
Seat 6: mbk88 folded before Flop (didn't bet)
Seat 7: daigodisco folded before Flop (didn't bet)
Seat 8: alhill86 folded before Flop (didn't bet)
Seat 9: POTAPENKO700 folded before Flop (didn't bet)





PokerStars Hand #155380692913:  Hold'em No Limit ($0.50/$1.00 USD) - 2016/06/30 14:15:09 CET [2016/06/30 8:15:09 ET]
Table 'Askania' 9-max Seat #8 is the button
Seat 1: chenconhaste ($105.64 in chips) 
Seat 2: DIMAN_324 ($101.50 in chips) 
Seat 3: matiko09 ($101.50 in chips) 
Seat 4: Hvittingfoss ($36.59 in chips) 
Seat 5: jezzaber ($129.74 in chips) 
Seat 6: nickreason17 ($102.10 in chips) 
Seat 7: ruslik_by ($100 in chips) 
Seat 8: kalcumite ($77.75 in chips) 
Seat 9: paul_007440 ($16.38 in chips) 
paul_007440: posts small blind $0.50
chenconhaste: posts big blind $1
*** HOLE CARDS ***
Dealt to matiko09 [8d 7d]
DIMAN_324: folds 
matiko09: raises $2 to $3
Hvittingfoss: folds 
jezzaber: folds 
nickreason17: folds 
ruslik_by: folds 
kalcumite: folds 
paul_007440: folds 
chenconhaste: folds 
Uncalled bet ($2) returned to matiko09
matiko09 collected $2.50 from pot
matiko09: doesn't show hand 
*** SUMMARY ***
Total pot $2.50 | Rake $0 
Seat 1: chenconhaste (big blind) folded before Flop
Seat 2: DIMAN_324 folded before Flop (didn't bet)
Seat 3: matiko09 collected ($2.50)
Seat 4: Hvittingfoss folded before Flop (didn't bet)
Seat 5: jezzaber folded before Flop (didn't bet)
Seat 6: nickreason17 folded before Flop (didn't bet)
Seat 7: ruslik_by folded before Flop (didn't bet)
Seat 8: kalcumite (button) folded before Flop (didn't bet)
Seat 9: paul_007440 (small blind) folded before Flop





PokerStars Hand #155380694949:  Hold'em No Limit ($0.50/$1.00 USD) - 2016/06/30 14:15:13 CET [2016/06/30 8:15:13 ET]
Table 'Borrelly II' 9-max Seat #9 is the button
Seat 1: Rafaello18 ($117.57 in chips) 
Seat 2: mbk88 ($105 in chips) 
Seat 3: di0d80 ($100 in chips) 
Seat 4: DonRon_AT ($40.19 in chips) 
Seat 5: DIMAN_324 ($100.11 in chips) 
Seat 6: m_michalec ($178.61 in chips) 
Seat 7: matiko09 ($175.86 in chips) 
Seat 8: Arjun A Raju ($135.42 in chips) 
Seat 9: alhill86 ($72.68 in chips) 
Rafaello18: posts small blind $0.50
mbk88: posts big blind $1
*** HOLE CARDS ***
Dealt to matiko09 [3s 3c]
di0d80: folds 
DonRon_AT: folds 
DIMAN_324: folds 
m_michalec: folds 
matiko09: raises $2 to $3
Arjun A Raju: folds 
alhill86: folds 
Rafaello18: folds 
mbk88: folds 
Uncalled bet ($2) returned to matiko09
matiko09 collected $2.50 from pot
*** SUMMARY ***
Total pot $2.50 | Rake $0 
Seat 1: Rafaello18 (small blind) folded before Flop
Seat 2: mbk88 (big blind) folded before Flop
Seat 3: di0d80 folded before Flop (didn't bet)
Seat 4: DonRon_AT folded before Flop (didn't bet)
Seat 5: DIMAN_324 folded before Flop (didn't bet)
Seat 6: m_michalec folded before Flop (didn't bet)
Seat 7: matiko09 collected ($2.50)
Seat 8: Arjun A Raju folded before Flop (didn't bet)
Seat 9: alhill86 (button) folded before Flop (didn't bet)





PokerStars Hand #155380696512:  Hold'em No Limit ($0.50/$1.00 USD) - 2016/06/30 14:15:17 CET [2016/06/30 8:15:17 ET]
Table 'Sigrid' 9-max Seat #3 is the button
Seat 1: Greha999 ($74.08 in chips) 
Seat 2: matiko09 ($115.66 in chips) 
Seat 3: Rafaello18 ($100 in chips) 
Seat 4: mbk88 ($117.87 in chips) 
Seat 6: di0d80 ($114.49 in chips) 
Seat 7: arctur17 ($98.50 in chips) 
Seat 9: KovIFish89 ($100 in chips) 
mbk88: posts small blind $0.50
DIMAN_324: is sitting out 
di0d80: posts big blind $1
ruslik_by: sits out 
*** HOLE CARDS ***
Dealt to matiko09 [Kd 9d]
arctur17: folds 
KovIFish89: folds 
Greha999: raises $1 to $2
matiko09: folds 
Rafaello18: folds 
mbk88: folds 
di0d80: folds 
Uncalled bet ($1) returned to Greha999
Greha999 collected $2.50 from pot
*** SUMMARY ***
Total pot $2.50 | Rake $0 
Seat 1: Greha999 collected ($2.50)
Seat 2: matiko09 folded before Flop (didn't bet)
Seat 3: Rafaello18 (button) folded before Flop (didn't bet)
Seat 4: mbk88 (small blind) folded before Flop
Seat 6: di0d80 (big blind) folded before Flop
Seat 7: arctur17 folded before Flop (didn't bet)
Seat 9: KovIFish89 folded before Flop (didn't bet)





PokerStars Hand #155380701371:  Hold'em No Limit ($0.50/$1.00 USD) - 2016/06/30 14:15:27 CET [2016/06/30 8:15:27 ET]
Table 'Altarf II' 9-max Seat #2 is the button
Seat 1: Rafaello18 ($100 in chips) 
Seat 2: KovIFish89 ($101 in chips) 
Seat 4: Greha999 ($75.94 in chips) 
Seat 5: DIMAN_324 ($230.24 in chips) 
Seat 6: mbk88 ($101.50 in chips) 
Seat 7: matiko09 ($104.90 in chips) 
Seat 8: DomiVY ($40 in chips) 
Seat 9: omanibemihum ($130.19 in chips) 
Greha999: posts small blind $0.50
DIMAN_324: posts big blind $1
*** HOLE CARDS ***
Dealt to matiko09 [Kd 2d]
mbk88: folds 
matiko09: folds 
DomiVY: folds 
omanibemihum: raises $1 to $2
Rafaello18: folds 
KovIFish89: folds 
Greha999: folds 
DIMAN_324: folds 
Uncalled bet ($1) returned to omanibemihum
omanibemihum collected $2.50 from pot
omanibemihum: doesn't show hand 
*** SUMMARY ***
Total pot $2.50 | Rake $0 
Seat 1: Rafaello18 folded before Flop (didn't bet)
Seat 2: KovIFish89 (button) folded before Flop (didn't bet)
Seat 4: Greha999 (small blind) folded before Flop
Seat 5: DIMAN_324 (big blind) folded before Flop
Seat 6: mbk88 folded before Flop (didn't bet)
Seat 7: matiko09 folded before Flop (didn't bet)
Seat 8: DomiVY folded before Flop (didn't bet)
Seat 9: omanibemihum collected ($2.50)





PokerStars Hand #155380701971:  Hold'em No Limit ($0.50/$1.00 USD) - 2016/06/30 14:15:28 CET [2016/06/30 8:15:28 ET]
Table 'Asmodeus' 9-max Seat #6 is the button
Seat 1: scollop ($204.50 in chips) 
Seat 2: picka4u ($40 in chips) 
Seat 3: matiko09 ($126.74 in chips) 
Seat 4: DIMAN_324 ($100 in chips) 
Seat 6: koutani7 ($101.03 in chips) 
Seat 8: Rafaello18 ($171.57 in chips) 
aaronzzr will be allowed to play after the button
Rafaello18: posts small blind $0.50
mbk88: is sitting out 
scollop: posts big blind $1
*** HOLE CARDS ***
Dealt to matiko09 [Ts 5d]
picka4u: folds 
picka4u leaves the table
nickreason17 joins the table at seat #2 
matiko09: folds 
DIMAN_324: folds 
koutani7: folds 
Rafaello18: raises $1.50 to $2.50
scollop: folds 
Uncalled bet ($1.50) returned to Rafaello18
Rafaello18 collected $2 from pot
Rafaello18: doesn't show hand 
*** SUMMARY ***
Total pot $2 | Rake $0 
Seat 1: scollop (big blind) folded before Flop
Seat 2: picka4u folded before Flop (didn't bet)
Seat 3: matiko09 folded before Flop (didn't bet)
Seat 4: DIMAN_324 folded before Flop (didn't bet)
Seat 6: koutani7 (button) folded before Flop (didn't bet)
Seat 8: Rafaello18 (small blind) collected ($2)





PokerStars Hand #155380707041:  Hold'em No Limit ($0.50/$1.00 USD) - 2016/06/30 14:15:39 CET [2016/06/30 8:15:39 ET]
Table 'Askania' 9-max Seat #9 is the button
Seat 1: chenconhaste ($104.64 in chips) 
Seat 2: DIMAN_324 ($101.50 in chips) 
Seat 3: matiko09 ($103 in chips) 
Seat 4: Hvittingfoss ($36.59 in chips) 
Seat 5: jezzaber ($129.74 in chips) 
Seat 6: nickreason17 ($102.10 in chips) 
Seat 7: ruslik_by ($100 in chips) 
Seat 8: kalcumite ($77.75 in chips) 
Seat 9: paul_007440 ($15.88 in chips) 
chenconhaste: posts small blind $0.50
DIMAN_324: posts big blind $1
*** HOLE CARDS ***
Dealt to matiko09 [3s Ad]
matiko09: folds 
Hvittingfoss: folds 
jezzaber: folds 
nickreason17: folds 
ruslik_by: raises $2 to $3
kalcumite: folds 
paul_007440: folds 
chenconhaste: folds 
DIMAN_324: folds 
Uncalled bet ($2) returned to ruslik_by
ruslik_by collected $2.50 from pot
ruslik_by: doesn't show hand 
*** SUMMARY ***
Total pot $2.50 | Rake $0 
Seat 1: chenconhaste (small blind) folded before Flop
Seat 2: DIMAN_324 (big blind) folded before Flop
Seat 3: matiko09 folded before Flop (didn't bet)
Seat 4: Hvittingfoss folded before Flop (didn't bet)
Seat 5: jezzaber folded before Flop (didn't bet)
Seat 6: nickreason17 folded before Flop (didn't bet)
Seat 7: ruslik_by collected ($2.50)
Seat 8: kalcumite folded before Flop (didn't bet)
Seat 9: paul_007440 (button) folded before Flop (didn't bet)





PokerStars Hand #155380709963:  Hold'em No Limit ($0.50/$1.00 USD) - 2016/06/30 14:15:46 CET [2016/06/30 8:15:46 ET]
Table 'California II' 9-max Seat #1 is the button
Seat 1: Rafaello18 ($100 in chips) 
Seat 2: velourleder ($60.76 in chips) 
Seat 3: KovIFish89 ($102.52 in chips) 
Seat 4: mbk88 ($178.42 in chips) 
Seat 5: Rohitbarve ($113.02 in chips) 
Seat 6: matiko09 ($100 in chips) 
Seat 7: DomiVY ($77.60 in chips) 
Seat 9: di0d80 ($101.10 in chips) 
velourleder: posts small blind $0.50
KovIFish89: posts big blind $1
*** HOLE CARDS ***
Dealt to matiko09 [As Ad]
mbk88: raises $2 to $3
Rohitbarve: folds 
matiko09: calls $3
DomiVY: folds 
di0d80: folds 
Rafaello18: folds 
velourleder: folds 
KovIFish89: folds 
*** FLOP *** [4s Jh Kd]
mbk88: bets $5
matiko09: calls $5
*** TURN *** [4s Jh Kd] [6h]
mbk88: bets $11
matiko09: calls $11
*** RIVER *** [4s Jh Kd 6h] [7s]
mbk88: bets $28
matiko09: calls $28
*** SHOW DOWN ***
mbk88: shows [Tc Ac] (high card Ace)
matiko09: shows [As Ad] (a pair of Aces)
matiko09 collected $93 from pot
*** SUMMARY ***
Total pot $95.50 | Rake $2.50 
Board [4s Jh Kd 6h 7s]
Seat 1: Rafaello18 (button) folded before Flop (didn't bet)
Seat 2: velourleder (small blind) folded before Flop
Seat 3: KovIFish89 (big blind) folded before Flop
Seat 4: mbk88 showed [Tc Ac] and lost with high card Ace
Seat 5: Rohitbarve folded before Flop (didn't bet)
Seat 6: matiko09 showed [As Ad] and won ($93) with a pair of Aces
Seat 7: DomiVY folded before Flop (didn't bet)
Seat 9: di0d80 folded before Flop (didn't bet)





PokerStars Hand #155380712911:  Hold'em No Limit ($0.25/$0.50 USD) - 2016/06/30 14:15:52 CET [2016/06/30 8:15:52 ET]
Table 'Arcturus' 9-max Seat #2 is the button
Seat 1: kourk250 ($131.02 in chips) 
Seat 2: Rafaello18 ($50 in chips) 
Seat 3: matiko09 ($53.81 in chips) 
Seat 4: Vedpapa ($50.75 in chips) 
Seat 5: stockbridge8 ($49.25 in chips) 
Seat 6: statistik85 ($64.47 in chips) 
Seat 7: DaikenGF ($70.84 in chips) 
Seat 8: TheMinion ($50 in chips) 
Seat 9: pfunkolstar ($55.17 in chips) 
matiko09: posts small blind $0.25
Vedpapa: posts big blind $0.50
*** HOLE CARDS ***
Dealt to matiko09 [8c 3s]
stockbridge8: folds 
statistik85: folds 
DaikenGF: raises $0.80 to $1.30
TheMinion: folds 
pfunkolstar: raises $3.20 to $4.50
kourk250: folds 
Rafaello18: folds 
matiko09: folds 
Vedpapa: folds 
DaikenGF: folds 
Uncalled bet ($3.20) returned to pfunkolstar
pfunkolstar collected $3.35 from pot
pfunkolstar: doesn't show hand 
*** SUMMARY ***
Total pot $3.35 | Rake $0 
Seat 1: kourk250 folded before Flop (didn't bet)
Seat 2: Rafaello18 (button) folded before Flop (didn't bet)
Seat 3: matiko09 (small blind) folded before Flop
Seat 4: Vedpapa (big blind) folded before Flop
Seat 5: stockbridge8 folded before Flop (didn't bet)
Seat 6: statistik85 folded before Flop (didn't bet)
Seat 7: DaikenGF folded before Flop
Seat 8: TheMinion folded before Flop (didn't bet)
Seat 9: pfunkolstar collected ($3.35)





PokerStars Hand #155380713730:  Hold'em No Limit ($0.50/$1.00 USD) - 2016/06/30 14:15:54 CET [2016/06/30 8:15:54 ET]
Table 'Sigrid' 9-max Seat #4 is the button
Seat 1: Greha999 ($75.58 in chips) 
Seat 2: matiko09 ($115.66 in chips) 
Seat 3: Rafaello18 ($100 in chips) 
Seat 4: mbk88 ($117.37 in chips) 
Seat 6: di0d80 ($113.49 in chips) 
Seat 7: arctur17 ($98.50 in chips) 
Seat 9: KovIFish89 ($100 in chips) 
di0d80: posts small blind $0.50
arctur17: posts big blind $1
ruslik_by: sits out 
*** HOLE CARDS ***
Dealt to matiko09 [Jc 8s]
KovIFish89: folds 
Greha999: folds 
matiko09: folds 
Rafaello18: raises $1.50 to $2.50
mbk88: folds 
di0d80: calls $2
arctur17: folds 
*** FLOP *** [Kc 4d 5s]
di0d80: checks 
Rafaello18: bets $4
di0d80: folds 
Uncalled bet ($4) returned to Rafaello18
Rafaello18 collected $5.70 from pot
Rafaello18: doesn't show hand 
*** SUMMARY ***
Total pot $6 | Rake $0.30 
Board [Kc 4d 5s]
Seat 1: Greha999 folded before Flop (didn't bet)
Seat 2: matiko09 folded before Flop (didn't bet)
Seat 3: Rafaello18 collected ($5.70)
Seat 4: mbk88 (button) folded before Flop (didn't bet)
Seat 6: di0d80 (small blind) folded on the Flop
Seat 7: arctur17 (big blind) folded before Flop
Seat 9: KovIFish89 folded before Flop (didn't bet)





PokerStars Hand #155380714262:  Hold'em No Limit ($0.50/$1.00 USD) - 2016/06/30 14:15:55 CET [2016/06/30 8:15:55 ET]
Table 'Tatjana' 9-max Seat #3 is the button
Seat 1: tipner ($116.40 in chips) 
Seat 2: DIMAN_324 ($100 in chips) 
Seat 3: Rafaello18 ($101.29 in chips) 
Seat 4: mopatron25 ($67 in chips) 
Seat 5: matiko09 ($100 in chips) 
Seat 6: mbk88 ($171.54 in chips) 
Seat 7: daigodisco ($91.69 in chips) 
Seat 8: alhill86 ($77.34 in chips) 
Seat 9: POTAPENKO700 ($234.21 in chips) 
mopatron25: posts small blind $0.50
matiko09: posts big blind $1
*** HOLE CARDS ***
Dealt to matiko09 [Ac 7h]
mbk88: folds 
daigodisco: folds 
alhill86: folds 
POTAPENKO700: folds 
tipner: folds 
DIMAN_324: raises $1.40 to $2.40
Rafaello18: folds 
mopatron25: calls $1.90
matiko09: folds 
*** FLOP *** [Th 6d 2h]
mopatron25: bets $2
DIMAN_324: folds 
Uncalled bet ($2) returned to mopatron25
mopatron25 collected $5.51 from pot
mopatron25: doesn't show hand 
*** SUMMARY ***
Total pot $5.80 | Rake $0.29 
Board [Th 6d 2h]
Seat 1: tipner folded before Flop (didn't bet)
Seat 2: DIMAN_324 folded on the Flop
Seat 3: Rafaello18 (button) folded before Flop (didn't bet)
Seat 4: mopatron25 (small blind) collected ($5.51)
Seat 5: matiko09 (big blind) folded before Flop
Seat 6: mbk88 folded before Flop (didn't bet)
Seat 7: daigodisco folded before Flop (didn't bet)
Seat 8: alhill86 folded before Flop (didn't bet)
Seat 9: POTAPENKO700 folded before Flop (didn't bet)





PokerStars Hand #155380714506:  Hold'em No Limit ($0.50/$1.00 USD) - 2016/06/30 14:15:56 CET [2016/06/30 8:15:56 ET]
Table 'Altarf II' 9-max Seat #4 is the button
Seat 1: Rafaello18 ($100 in chips) 
Seat 2: KovIFish89 ($101 in chips) 
Seat 4: Greha999 ($75.44 in chips) 
Seat 5: DIMAN_324 ($229.24 in chips) 
Seat 6: mbk88 ($101.50 in chips) 
Seat 7: matiko09 ($104.90 in chips) 
Seat 8: DomiVY ($40 in chips) 
Seat 9: omanibemihum ($131.69 in chips) 
DIMAN_324: posts small blind $0.50
mbk88: posts big blind $1
*** HOLE CARDS ***
Dealt to matiko09 [7d Ac]
matiko09: folds 
DomiVY: folds 
omanibemihum: folds 
Rafaello18: folds 
KovIFish89: folds 
Greha999: folds 
DIMAN_324: folds 
Uncalled bet ($0.50) returned to mbk88
mbk88 collected $1 from pot
mbk88: doesn't show hand 
*** SUMMARY ***
Total pot $1 | Rake $0 
Seat 1: Rafaello18 folded before Flop (didn't bet)
Seat 2: KovIFish89 folded before Flop (didn't bet)
Seat 4: Greha999 (button) folded before Flop (didn't bet)
Seat 5: DIMAN_324 (small blind) folded before Flop
Seat 6: mbk88 (big blind) collected ($1)
Seat 7: matiko09 folded before Flop (didn't bet)
Seat 8: DomiVY folded before Flop (didn't bet)
Seat 9: omanibemihum folded before Flop (didn't bet)





PokerStars Hand #155380717872:  Hold'em No Limit ($0.50/$1.00 USD) - 2016/06/30 14:16:03 CET [2016/06/30 8:16:03 ET]
Table 'Borrelly II' 9-max Seat #1 is the button
Seat 1: Rafaello18 ($117.07 in chips) 
Seat 2: mbk88 ($104 in chips) 
Seat 3: di0d80 ($100 in chips) 
Seat 4: DonRon_AT ($40.19 in chips) 
Seat 5: DIMAN_324 ($100.11 in chips) 
Seat 6: m_michalec ($178.61 in chips) 
Seat 7: matiko09 ($177.36 in chips) 
Seat 8: Arjun A Raju ($135.42 in chips) 
Seat 9: alhill86 ($72.68 in chips) 
mbk88: posts small blind $0.50
di0d80: posts big blind $1
*** HOLE CARDS ***
Dealt to matiko09 [Qc Jc]
DonRon_AT: raises $2 to $3
DIMAN_324: folds 
m_michalec: folds 
matiko09: folds 
Arjun A Raju: folds 
alhill86: folds 
Rafaello18: folds 
mbk88: folds 
di0d80: folds 
Uncalled bet ($2) returned to DonRon_AT
DonRon_AT collected $2.50 from pot
*** SUMMARY ***
Total pot $2.50 | Rake $0 
Seat 1: Rafaello18 (button) folded before Flop (didn't bet)
Seat 2: mbk88 (small blind) folded before Flop
Seat 3: di0d80 (big blind) folded before Flop
Seat 4: DonRon_AT collected ($2.50)
Seat 5: DIMAN_324 folded before Flop (didn't bet)
Seat 6: m_michalec folded before Flop (didn't bet)
Seat 7: matiko09 folded before Flop (didn't bet)
Seat 8: Arjun A Raju folded before Flop (didn't bet)
Seat 9: alhill86 folded before Flop (didn't bet)





PokerStars Hand #155380717806:  Hold'em No Limit ($0.50/$1.00 USD) - 2016/06/30 14:16:03 CET [2016/06/30 8:16:03 ET]
Table 'Asmodeus' 9-max Seat #8 is the button
Seat 1: scollop ($203.50 in chips) 
Seat 2: nickreason17 ($100 in chips) 
Seat 3: matiko09 ($126.74 in chips) 
Seat 4: DIMAN_324 ($100 in chips) 
Seat 6: koutani7 ($101.03 in chips) 
Seat 8: Rafaello18 ($172.57 in chips) 
scollop: posts small blind $0.50
nickreason17: posts big blind $1
aaronzzr: sits out 
*** HOLE CARDS ***
Dealt to matiko09 [6d 6s]
matiko09: raises $2 to $3
DIMAN_324: calls $3
koutani7: folds 
Rafaello18: folds 
scollop: calls $2.50
nickreason17: folds 
*** FLOP *** [4c 8s 2c]
scollop: checks 
matiko09: bets $5
DIMAN_324: folds 
scollop: calls $5
*** TURN *** [4c 8s 2c] [Ac]
scollop: checks 
matiko09: checks 
*** RIVER *** [4c 8s 2c Ac] [9h]
scollop: bets $1
matiko09: folds 
Uncalled bet ($1) returned to scollop
scollop collected $19 from pot
scollop: doesn't show hand 
*** SUMMARY ***
Total pot $20 | Rake $1 
Board [4c 8s 2c Ac 9h]
Seat 1: scollop (small blind) collected ($19)
Seat 2: nickreason17 (big blind) folded before Flop
Seat 3: matiko09 folded on the River
Seat 4: DIMAN_324 folded on the Flop
Seat 6: koutani7 folded before Flop (didn't bet)
Seat 8: Rafaello18 (button) folded before Flop (didn't bet)





PokerStars Hand #155380718980:  Hold'em No Limit ($0.50/$1.00 USD) - 2016/06/30 14:16:05 CET [2016/06/30 8:16:05 ET]
Table 'Donnera' 9-max Seat #5 is the button
Seat 2: robbiescrim9 ($100.07 in chips) 
Seat 3: matiko09 ($100 in chips) 
Seat 4: Kukuryzka ($100 in chips) 
Seat 5: tipner ($108.35 in chips) 
Seat 6: nickreason17 ($100 in chips) 
Seat 7: Rafaello18 ($100 in chips) 
nickreason17: posts small blind $0.50
Rafaello18: posts big blind $1
ruslik_by: sits out 
Starw!nd: sits out 
chenconhaste: sits out 
*** HOLE CARDS ***
Dealt to matiko09 [Jc 9s]
robbiescrim9: folds 
matiko09: folds 
Kukuryzka: folds 
tipner: folds 
nickreason17: raises $2 to $3
Rafaello18: folds 
Uncalled bet ($2) returned to nickreason17
nickreason17 collected $2 from pot
*** SUMMARY ***
Total pot $2 | Rake $0 
Seat 2: robbiescrim9 folded before Flop (didn't bet)
Seat 3: matiko09 folded before Flop (didn't bet)
Seat 4: Kukuryzka folded before Flop (didn't bet)
Seat 5: tipner (button) folded before Flop (didn't bet)
Seat 6: nickreason17 (small blind) collected ($2)
Seat 7: Rafaello18 (big blind) folded before Flop





PokerStars Hand #155380724735:  Hold'em No Limit ($0.50/$1.00 USD) - 2016/06/30 14:16:18 CET [2016/06/30 8:16:18 ET]
Table 'Eucharis' 9-max Seat #8 is the button
Seat 1: chenconhaste ($100 in chips) 
Seat 2: matiko09 ($108.53 in chips) 
Seat 3: ramzes160468 ($72.36 in chips) 
Seat 4: mbk88 ($248.12 in chips) 
Seat 6: joooh79 ($130.52 in chips) 
Seat 7: Ty Nick 420 ($140.50 in chips) 
Seat 8: ruslik_by ($100 in chips) 
Seat 9: geiranger011 ($96.08 in chips) 
geiranger011: posts small blind $0.50
chenconhaste: posts big blind $1
swizzly58: sits out 
*** HOLE CARDS ***
Dealt to matiko09 [Ac 7d]
matiko09: folds 
ramzes160468: folds 
mbk88: folds 
joooh79: folds 
Ty Nick 420: folds 
ruslik_by: folds 
geiranger011: calls $0.50
chenconhaste: raises $2.50 to $3.50
geiranger011: calls $2.50
*** FLOP *** [Qh 2d Jh]
geiranger011: bets $3
chenconhaste: calls $3
*** TURN *** [Qh 2d Jh] [Qs]
geiranger011: checks 
chenconhaste: checks 
*** RIVER *** [Qh 2d Jh Qs] [4d]
geiranger011: bets $12
chenconhaste: calls $12
*** SHOW DOWN ***
geiranger011: shows [6d Qd] (three of a kind, Queens)
chenconhaste: mucks hand 
geiranger011 collected $35.15 from pot
*** SUMMARY ***
Total pot $37 | Rake $1.85 
Board [Qh 2d Jh Qs 4d]
Seat 1: chenconhaste (big blind) mucked [8c 8d]
Seat 2: matiko09 folded before Flop (didn't bet)
Seat 3: ramzes160468 folded before Flop (didn't bet)
Seat 4: mbk88 folded before Flop (didn't bet)
Seat 6: joooh79 folded before Flop (didn't bet)
Seat 7: Ty Nick 420 folded before Flop (didn't bet)
Seat 8: ruslik_by (button) folded before Flop (didn't bet)
Seat 9: geiranger011 (small blind) showed [6d Qd] and won ($35.15) with three of a kind, Queens





PokerStars Hand #155380725379:  Hold'em No Limit ($0.50/$1.00 USD) - 2016/06/30 14:16:19 CET [2016/06/30 8:16:19 ET]
Table 'Altarf II' 9-max Seat #5 is the button
Seat 1: Rafaello18 ($100 in chips) 
Seat 2: KovIFish89 ($101 in chips) 
Seat 4: Greha999 ($75.44 in chips) 
Seat 5: DIMAN_324 ($228.74 in chips) 
Seat 6: mbk88 ($102 in chips) 
Seat 7: matiko09 ($104.90 in chips) 
Seat 8: DomiVY ($40 in chips) 
Seat 9: omanibemihum ($131.69 in chips) 
mbk88: posts small blind $0.50
matiko09: posts big blind $1
*** HOLE CARDS ***
Dealt to matiko09 [7c Kc]
DomiVY: raises $2 to $3
omanibemihum: calls $3
Rafaello18: folds 
KovIFish89: folds 
Greha999: folds 
DIMAN_324: folds 
mbk88: folds 
matiko09: folds 
*** FLOP *** [5d 8s 5h]
DomiVY: bets $5
omanibemihum: calls $5
*** TURN *** [5d 8s 5h] [8h]
DomiVY: bets $10
omanibemihum: folds 
Uncalled bet ($10) returned to DomiVY
DomiVY collected $16.62 from pot
DomiVY: doesn't show hand 
*** SUMMARY ***
Total pot $17.50 | Rake $0.88 
Board [5d 8s 5h 8h]
Seat 1: Rafaello18 folded before Flop (didn't bet)
Seat 2: KovIFish89 folded before Flop (didn't bet)
Seat 4: Greha999 folded before Flop (didn't bet)
Seat 5: DIMAN_324 (button) folded before Flop (didn't bet)
Seat 6: mbk88 (small blind) folded before Flop
Seat 7: matiko09 (big blind) folded before Flop
Seat 8: DomiVY collected ($16.62)
Seat 9: omanibemihum folded on the Turn





PokerStars Hand #155380728001:  Hold'em No Limit ($0.50/$1.00 USD) - 2016/06/30 14:16:25 CET [2016/06/30 8:16:25 ET]
Table 'Donnera' 9-max Seat #6 is the button
Seat 2: robbiescrim9 ($100.07 in chips) 
Seat 3: matiko09 ($100 in chips) 
Seat 4: Kukuryzka ($100 in chips) 
Seat 5: tipner ($108.35 in chips) 
Seat 6: nickreason17 ($101 in chips) 
Seat 7: Rafaello18 ($100 in chips) 
Seat 8: ruslik_by ($100 in chips) 
Rafaello18: posts small blind $0.50
ruslik_by: posts big blind $1
Starw!nd: sits out 
chenconhaste: sits out 
*** HOLE CARDS ***
Dealt to matiko09 [Kh Tc]
robbiescrim9: calls $1
matiko09: raises $3.50 to $4.50
Kukuryzka: folds 
tipner: folds 
nickreason17: folds 
Rafaello18: folds 
ruslik_by: calls $3.50
robbiescrim9: calls $3.50
*** FLOP *** [6h 4s 4h]
ruslik_by: checks 
robbiescrim9: checks 
matiko09: bets $7
ruslik_by: calls $7
robbiescrim9: folds 
*** TURN *** [6h 4s 4h] [6c]
ruslik_by: checks 
matiko09: checks 
*** RIVER *** [6h 4s 4h 6c] [Qs]
ruslik_by: checks 
matiko09: checks 
*** SHOW DOWN ***
ruslik_by: shows [7h Ah] (two pair, Sixes and Fours)
matiko09: mucks hand 
ruslik_by collected $26.60 from pot
*** SUMMARY ***
Total pot $28 | Rake $1.40 
Board [6h 4s 4h 6c Qs]
Seat 2: robbiescrim9 folded on the Flop
Seat 3: matiko09 mucked [Kh Tc]
Seat 4: Kukuryzka folded before Flop (didn't bet)
Seat 5: tipner folded before Flop (didn't bet)
Seat 6: nickreason17 (button) folded before Flop (didn't bet)
Seat 7: Rafaello18 (small blind) folded before Flop
Seat 8: ruslik_by (big blind) showed [7h Ah] and won ($26.60) with two pair, Sixes and Fours





PokerStars Hand #155380730615:  Hold'em No Limit ($0.25/$0.50 USD) - 2016/06/30 14:16:31 CET [2016/06/30 8:16:31 ET]
Table 'Arcturus' 9-max Seat #3 is the button
Seat 1: kourk250 ($131.02 in chips) 
Seat 2: Rafaello18 ($50 in chips) 
Seat 3: matiko09 ($53.56 in chips) 
Seat 4: Vedpapa ($50.25 in chips) 
Seat 5: stockbridge8 ($49.25 in chips) 
Seat 6: statistik85 ($64.47 in chips) 
Seat 7: DaikenGF ($69.54 in chips) 
Seat 8: TheMinion ($50 in chips) 
Seat 9: pfunkolstar ($57.22 in chips) 
Vedpapa: posts small blind $0.25
stockbridge8: posts big blind $0.50
*** HOLE CARDS ***
Dealt to matiko09 [Ad 2c]
statistik85: folds 
DaikenGF: folds 
TheMinion: folds 
pfunkolstar: folds 
kourk250: folds 
Rafaello18: folds 
matiko09: raises $0.63 to $1.13
DaikenGF leaves the table
bratbugor joins the table at seat #7 
Vedpapa: folds 
stockbridge8: folds 
Uncalled bet ($0.63) returned to matiko09
matiko09 collected $1.25 from pot
matiko09: doesn't show hand 
*** SUMMARY ***
Total pot $1.25 | Rake $0 
Seat 1: kourk250 folded before Flop (didn't bet)
Seat 2: Rafaello18 folded before Flop (didn't bet)
Seat 3: matiko09 (button) collected ($1.25)
Seat 4: Vedpapa (small blind) folded before Flop
Seat 5: stockbridge8 (big blind) folded before Flop
Seat 6: statistik85 folded before Flop (didn't bet)
Seat 7: DaikenGF folded before Flop (didn't bet)
Seat 8: TheMinion folded before Flop (didn't bet)
Seat 9: pfunkolstar folded before Flop (didn't bet)





PokerStars Hand #155380732797:  Hold'em No Limit ($0.50/$1.00 USD) - 2016/06/30 14:16:35 CET [2016/06/30 8:16:35 ET]
Table 'Tatjana' 9-max Seat #4 is the button
Seat 1: tipner ($116.40 in chips) 
Seat 2: DIMAN_324 ($100 in chips) 
Seat 3: Rafaello18 ($101.29 in chips) 
Seat 4: mopatron25 ($70.11 in chips) 
Seat 5: matiko09 ($100 in chips) 
Seat 6: mbk88 ($171.54 in chips) 
Seat 7: daigodisco ($91.69 in chips) 
Seat 8: alhill86 ($77.34 in chips) 
Seat 9: POTAPENKO700 ($234.21 in chips) 
matiko09: posts small blind $0.50
mbk88: posts big blind $1
*** HOLE CARDS ***
Dealt to matiko09 [Jd Jh]
daigodisco: folds 
alhill86: folds 
POTAPENKO700: folds 
tipner: folds 
DIMAN_324: raises $1.40 to $2.40
Rafaello18: folds 
mopatron25: calls $2.40
matiko09: raises $8.60 to $11
mbk88: folds 
DIMAN_324: raises $11 to $22
mopatron25: folds 
matiko09: calls $11
*** FLOP *** [2h 8c 2s]
matiko09: checks 
DIMAN_324: checks 
*** TURN *** [2h 8c 2s] [7h]
matiko09: bets $16
DIMAN_324: folds 
Uncalled bet ($16) returned to matiko09
matiko09 collected $45.03 from pot
matiko09: doesn't show hand 
*** SUMMARY ***
Total pot $47.40 | Rake $2.37 
Board [2h 8c 2s 7h]
Seat 1: tipner folded before Flop (didn't bet)
Seat 2: DIMAN_324 folded on the Turn
Seat 3: Rafaello18 folded before Flop (didn't bet)
Seat 4: mopatron25 (button) folded before Flop
Seat 5: matiko09 (small blind) collected ($45.03)
Seat 6: mbk88 (big blind) folded before Flop
Seat 7: daigodisco folded before Flop (didn't bet)
Seat 8: alhill86 folded before Flop (didn't bet)
Seat 9: POTAPENKO700 folded before Flop (didn't bet)





PokerStars Hand #155380745340:  Hold'em No Limit ($0.50/$1.00 USD) - 2016/06/30 14:17:03 CET [2016/06/30 8:17:03 ET]
Table 'Eucharis' 9-max Seat #9 is the button
Seat 1: chenconhaste ($100 in chips) 
Seat 2: matiko09 ($108.53 in chips) 
Seat 3: ramzes160468 ($72.36 in chips) 
Seat 4: mbk88 ($248.12 in chips) 
Seat 6: joooh79 ($130.52 in chips) 
Seat 7: Ty Nick 420 ($140.50 in chips) 
Seat 8: ruslik_by ($100 in chips) 
Seat 9: geiranger011 ($112.73 in chips) 
chenconhaste: posts small blind $0.50
matiko09: posts big blind $1
swizzly58: sits out 
*** HOLE CARDS ***
Dealt to matiko09 [Td 6d]
ramzes160468: folds 
ramzes160468 leaves the table
mbk88: folds 
joooh79: folds 
Ty Nick 420: folds 
ruslik_by: folds 
geiranger011: raises $2 to $3
chenconhaste: folds 
matiko09: folds 
Uncalled bet ($2) returned to geiranger011
geiranger011 collected $2.50 from pot
geiranger011: doesn't show hand 
*** SUMMARY ***
Total pot $2.50 | Rake $0 
Seat 1: chenconhaste (small blind) folded before Flop
Seat 2: matiko09 (big blind) folded before Flop
Seat 3: ramzes160468 folded before Flop (didn't bet)
Seat 4: mbk88 folded before Flop (didn't bet)
Seat 6: joooh79 folded before Flop (didn't bet)
Seat 7: Ty Nick 420 folded before Flop (didn't bet)
Seat 8: ruslik_by folded before Flop (didn't bet)
Seat 9: geiranger011 (button) collected ($2.50)





PokerStars Hand #155380749840:  Hold'em No Limit ($0.50/$1.00 USD) - 2016/06/30 14:17:12 CET [2016/06/30 8:17:12 ET]
Table 'California II' 9-max Seat #2 is the button
Seat 1: Rafaello18 ($100 in chips) 
Seat 2: velourleder ($60.26 in chips) 
Seat 3: KovIFish89 ($101.52 in chips) 
Seat 4: mbk88 ($131.42 in chips) 
Seat 5: Rohitbarve ($113.02 in chips) 
Seat 6: matiko09 ($146 in chips) 
Seat 7: DomiVY ($77.60 in chips) 
Seat 9: di0d80 ($101.10 in chips) 
KovIFish89: posts small blind $0.50
mbk88: posts big blind $1
*** HOLE CARDS ***
Dealt to matiko09 [Th Jd]
Rohitbarve: folds 
matiko09: folds 
DomiVY: folds 
di0d80: folds 
Rafaello18: raises $1.50 to $2.50
velourleder: folds 
KovIFish89: folds 
mbk88: folds 
Uncalled bet ($1.50) returned to Rafaello18
Rafaello18 collected $2.50 from pot
Rafaello18: doesn't show hand 
*** SUMMARY ***
Total pot $2.50 | Rake $0 
Seat 1: Rafaello18 collected ($2.50)
Seat 2: velourleder (button) folded before Flop (didn't bet)
Seat 3: KovIFish89 (small blind) folded before Flop
Seat 4: mbk88 (big blind) folded before Flop
Seat 5: Rohitbarve folded before Flop (didn't bet)
Seat 6: matiko09 folded before Flop (didn't bet)
Seat 7: DomiVY folded before Flop (didn't bet)
Seat 9: di0d80 folded before Flop (didn't bet)





PokerStars Hand #155380753506:  Hold'em No Limit ($0.50/$1.00 USD) - 2016/06/30 14:17:20 CET [2016/06/30 8:17:20 ET]
Table 'Sigrid' 9-max Seat #6 is the button
Seat 1: Greha999 ($75.58 in chips) 
Seat 2: matiko09 ($115.66 in chips) 
Seat 3: Rafaello18 ($103.20 in chips) 
Seat 4: mbk88 ($117.37 in chips) 
Seat 6: di0d80 ($110.99 in chips) 
Seat 7: arctur17 ($97.50 in chips) 
Seat 8: ruslik_by ($100 in chips) 
Seat 9: KovIFish89 ($100 in chips) 
arctur17: posts small blind $0.50
ruslik_by: posts big blind $1
*** HOLE CARDS ***
Dealt to matiko09 [2d Kd]
KovIFish89: folds 
Greha999: folds 
matiko09: folds 
Rafaello18: folds 
mbk88: folds 
di0d80: raises $1 to $2
arctur17: folds 
ruslik_by: folds 
Uncalled bet ($1) returned to di0d80
di0d80 collected $2.50 from pot
di0d80: doesn't show hand 
*** SUMMARY ***
Total pot $2.50 | Rake $0 
Seat 1: Greha999 folded before Flop (didn't bet)
Seat 2: matiko09 folded before Flop (didn't bet)
Seat 3: Rafaello18 folded before Flop (didn't bet)
Seat 4: mbk88 folded before Flop (didn't bet)
Seat 6: di0d80 (button) collected ($2.50)
Seat 7: arctur17 (small blind) folded before Flop
Seat 8: ruslik_by (big blind) folded before Flop
Seat 9: KovIFish89 folded before Flop (didn't bet)





PokerStars Hand #155380753771:  Hold'em No Limit ($0.50/$1.00 USD) - 2016/06/30 14:17:21 CET [2016/06/30 8:17:21 ET]
Table 'Borrelly II' 9-max Seat #2 is the button
Seat 1: Rafaello18 ($117.07 in chips) 
Seat 2: mbk88 ($103.50 in chips) 
Seat 3: di0d80 ($100 in chips) 
Seat 4: DonRon_AT ($41.69 in chips) 
Seat 5: DIMAN_324 ($100.11 in chips) 
Seat 6: m_michalec ($178.61 in chips) 
Seat 7: matiko09 ($177.36 in chips) 
Seat 8: Arjun A Raju ($135.42 in chips) 
Seat 9: alhill86 ($72.68 in chips) 
di0d80: posts small blind $0.50
DonRon_AT: posts big blind $1
*** HOLE CARDS ***
Dealt to matiko09 [8d Td]
DIMAN_324: folds 
m_michalec: folds 
matiko09: folds 
Arjun A Raju: folds 
alhill86: raises $2 to $3
Rafaello18: folds 
mbk88: folds 
di0d80: folds 
DonRon_AT: folds 
Uncalled bet ($2) returned to alhill86
alhill86 collected $2.50 from pot
alhill86: doesn't show hand 
*** SUMMARY ***
Total pot $2.50 | Rake $0 
Seat 1: Rafaello18 folded before Flop (didn't bet)
Seat 2: mbk88 (button) folded before Flop (didn't bet)
Seat 3: di0d80 (small blind) folded before Flop
Seat 4: DonRon_AT (big blind) folded before Flop
Seat 5: DIMAN_324 folded before Flop (didn't bet)
Seat 6: m_michalec folded before Flop (didn't bet)
Seat 7: matiko09 folded before Flop (didn't bet)
Seat 8: Arjun A Raju folded before Flop (didn't bet)
Seat 9: alhill86 collected ($2.50)





PokerStars Hand #155380754859:  Hold'em No Limit ($0.25/$0.50 USD) - 2016/06/30 14:17:23 CET [2016/06/30 8:17:23 ET]
Table 'Arcturus' 9-max Seat #4 is the button
Seat 1: kourk250 ($131.02 in chips) 
Seat 2: Rafaello18 ($50 in chips) 
Seat 3: matiko09 ($54.31 in chips) 
Seat 4: Vedpapa ($50 in chips) 
Seat 5: stockbridge8 ($48.75 in chips) 
Seat 6: statistik85 ($64.47 in chips) 
Seat 8: TheMinion ($50 in chips) 
Seat 9: pfunkolstar ($57.22 in chips) 
stockbridge8: posts small blind $0.25
statistik85: posts big blind $0.50
bratbugor: sits out 
*** HOLE CARDS ***
Dealt to matiko09 [2h 8c]
TheMinion: folds 
pfunkolstar: folds 
kourk250: folds 
Rafaello18: folds 
matiko09: folds 
Vedpapa has timed out
Vedpapa: folds 
stockbridge8: folds 
Uncalled bet ($0.25) returned to statistik85
statistik85 collected $0.50 from pot
statistik85: doesn't show hand 
*** SUMMARY ***
Total pot $0.50 | Rake $0 
Seat 1: kourk250 folded before Flop (didn't bet)
Seat 2: Rafaello18 folded before Flop (didn't bet)
Seat 3: matiko09 folded before Flop (didn't bet)
Seat 4: Vedpapa (button) folded before Flop (didn't bet)
Seat 5: stockbridge8 (small blind) folded before Flop
Seat 6: statistik85 (big blind) collected ($0.50)
Seat 8: TheMinion folded before Flop (didn't bet)
Seat 9: pfunkolstar folded before Flop (didn't bet)





PokerStars Hand #155380759742:  Hold'em No Limit ($0.50/$1.00 USD) - 2016/06/30 14:17:34 CET [2016/06/30 8:17:34 ET]
Table 'Eucharis' 9-max Seat #1 is the button
Seat 1: chenconhaste ($100 in chips) 
Seat 2: matiko09 ($107.53 in chips) 
Seat 4: mbk88 ($248.12 in chips) 
Seat 6: joooh79 ($130.52 in chips) 
Seat 7: Ty Nick 420 ($140.50 in chips) 
Seat 8: ruslik_by ($100 in chips) 
Seat 9: geiranger011 ($114.23 in chips) 
matiko09: posts small blind $0.50
mbk88: posts big blind $1
swizzly58: sits out 
*** HOLE CARDS ***
Dealt to matiko09 [Js 8c]
joooh79: raises $2 to $3
Ty Nick 420: folds 
ruslik_by: folds 
geiranger011: folds 
chenconhaste: folds 
matiko09: folds 
mbk88: folds 
Uncalled bet ($2) returned to joooh79
joooh79 collected $2.50 from pot
*** SUMMARY ***
Total pot $2.50 | Rake $0 
Seat 1: chenconhaste (button) folded before Flop (didn't bet)
Seat 2: matiko09 (small blind) folded before Flop
Seat 4: mbk88 (big blind) folded before Flop
Seat 6: joooh79 collected ($2.50)
Seat 7: Ty Nick 420 folded before Flop (didn't bet)
Seat 8: ruslik_by folded before Flop (didn't bet)
Seat 9: geiranger011 folded before Flop (didn't bet)





PokerStars Hand #155380763717:  Hold'em No Limit ($0.50/$1.00 USD) - 2016/06/30 14:17:43 CET [2016/06/30 8:17:43 ET]
Table 'Sigrid' 9-max Seat #7 is the button
Seat 1: Greha999 ($75.58 in chips) 
Seat 2: matiko09 ($115.66 in chips) 
Seat 3: Rafaello18 ($103.20 in chips) 
Seat 4: mbk88 ($117.37 in chips) 
Seat 6: di0d80 ($112.49 in chips) 
Seat 7: arctur17 ($97 in chips) 
Seat 8: ruslik_by ($100 in chips) 
Seat 9: KovIFish89 ($100 in chips) 
ruslik_by: posts small blind $0.50
KovIFish89: posts big blind $1
*** HOLE CARDS ***
Dealt to matiko09 [Kh 8h]
Greha999: folds 
matiko09: folds 
Rafaello18: folds 
mbk88: folds 
di0d80: folds 
arctur17: folds 
ruslik_by: raises $2 to $3
KovIFish89: folds 
Uncalled bet ($2) returned to ruslik_by
ruslik_by collected $2 from pot
ruslik_by: doesn't show hand 
*** SUMMARY ***
Total pot $2 | Rake $0 
Seat 1: Greha999 folded before Flop (didn't bet)
Seat 2: matiko09 folded before Flop (didn't bet)
Seat 3: Rafaello18 folded before Flop (didn't bet)
Seat 4: mbk88 folded before Flop (didn't bet)
Seat 6: di0d80 folded before Flop (didn't bet)
Seat 7: arctur17 (button) folded before Flop (didn't bet)
Seat 8: ruslik_by (small blind) collected ($2)
Seat 9: KovIFish89 (big blind) folded before Flop





PokerStars Hand #155380764850:  Hold'em No Limit ($0.50/$1.00 USD) - 2016/06/30 14:17:45 CET [2016/06/30 8:17:45 ET]
Table 'California II' 9-max Seat #3 is the button
Seat 1: Rafaello18 ($101.50 in chips) 
Seat 2: velourleder ($60.26 in chips) 
Seat 3: KovIFish89 ($101.02 in chips) 
Seat 4: mbk88 ($130.42 in chips) 
Seat 5: Rohitbarve ($113.02 in chips) 
Seat 6: matiko09 ($146 in chips) 
Seat 7: DomiVY ($77.60 in chips) 
Seat 9: di0d80 ($101.10 in chips) 
mbk88: posts small blind $0.50
Rohitbarve: posts big blind $1
*** HOLE CARDS ***
Dealt to matiko09 [3h 9s]
matiko09: folds 
DomiVY: folds 
di0d80: folds 
Rafaello18: folds 
velourleder: folds 
KovIFish89: folds 
mbk88: raises $2 to $3
Rohitbarve: calls $2
*** FLOP *** [8s Ac 8h]
mbk88: bets $4
Rohitbarve: folds 
Uncalled bet ($4) returned to mbk88
mbk88 collected $5.70 from pot
mbk88: doesn't show hand 
*** SUMMARY ***
Total pot $6 | Rake $0.30 
Board [8s Ac 8h]
Seat 1: Rafaello18 folded before Flop (didn't bet)
Seat 2: velourleder folded before Flop (didn't bet)
Seat 3: KovIFish89 (button) folded before Flop (didn't bet)
Seat 4: mbk88 (small blind) collected ($5.70)
Seat 5: Rohitbarve (big blind) folded on the Flop
Seat 6: matiko09 folded before Flop (didn't bet)
Seat 7: DomiVY folded before Flop (didn't bet)
Seat 9: di0d80 folded before Flop (didn't bet)





PokerStars Hand #155380766621:  Hold'em No Limit ($0.50/$1.00 USD) - 2016/06/30 14:17:49 CET [2016/06/30 8:17:49 ET]
Table 'Altarf II' 9-max Seat #6 is the button
Seat 1: Rafaello18 ($100 in chips) 
Seat 2: KovIFish89 ($101 in chips) 
Seat 4: Greha999 ($75.44 in chips) 
Seat 5: DIMAN_324 ($228.74 in chips) 
Seat 6: mbk88 ($101.50 in chips) 
Seat 7: matiko09 ($103.90 in chips) 
Seat 8: DomiVY ($48.62 in chips) 
Seat 9: omanibemihum ($123.69 in chips) 
matiko09: posts small blind $0.50
DomiVY: posts big blind $1
*** HOLE CARDS ***
Dealt to matiko09 [Qc Ts]
omanibemihum: folds 
Rafaello18: folds 
KovIFish89: folds 
Greha999: raises $2 to $3
DIMAN_324: folds 
mbk88: folds 
matiko09: folds 
DomiVY: folds 
Uncalled bet ($2) returned to Greha999
Greha999 collected $2.50 from pot
*** SUMMARY ***
Total pot $2.50 | Rake $0 
Seat 1: Rafaello18 folded before Flop (didn't bet)
Seat 2: KovIFish89 folded before Flop (didn't bet)
Seat 4: Greha999 collected ($2.50)
Seat 5: DIMAN_324 folded before Flop (didn't bet)
Seat 6: mbk88 (button) folded before Flop (didn't bet)
Seat 7: matiko09 (small blind) folded before Flop
Seat 8: DomiVY (big blind) folded before Flop
Seat 9: omanibemihum folded before Flop (didn't bet)





PokerStars Hand #155380768789:  Hold'em No Limit ($0.50/$1.00 USD) - 2016/06/30 14:17:54 CET [2016/06/30 8:17:54 ET]
Table 'Donnera' 9-max Seat #7 is the button
Seat 2: robbiescrim9 ($95.57 in chips) 
Seat 3: matiko09 ($100 in chips) 
Seat 4: Kukuryzka ($100 in chips) 
Seat 5: tipner ($108.35 in chips) 
Seat 6: nickreason17 ($101 in chips) 
Seat 7: Rafaello18 ($100 in chips) 
Seat 8: ruslik_by ($115.10 in chips) 
Seat 9: Starw!nd ($100 in chips) 
ruslik_by: posts small blind $0.50
Starw!nd: posts big blind $1
chenconhaste: sits out 
*** HOLE CARDS ***
Dealt to matiko09 [Kh Kc]
robbiescrim9: folds 
matiko09: raises $2 to $3
Kukuryzka: folds 
tipner: folds 
nickreason17: folds 
Rafaello18: folds 
ruslik_by: folds 
Starw!nd: folds 
Uncalled bet ($2) returned to matiko09
matiko09 collected $2.50 from pot
matiko09: doesn't show hand 
*** SUMMARY ***
Total pot $2.50 | Rake $0 
Seat 2: robbiescrim9 folded before Flop (didn't bet)
Seat 3: matiko09 collected ($2.50)
Seat 4: Kukuryzka folded before Flop (didn't bet)
Seat 5: tipner folded before Flop (didn't bet)
Seat 6: nickreason17 folded before Flop (didn't bet)
Seat 7: Rafaello18 (button) folded before Flop (didn't bet)
Seat 8: ruslik_by (small blind) folded before Flop
Seat 9: Starw!nd (big blind) folded before Flop





PokerStars Hand #155380770371:  Hold'em No Limit ($0.50/$1.00 USD) - 2016/06/30 14:17:57 CET [2016/06/30 8:17:57 ET]
Table 'Eucharis' 9-max Seat #2 is the button
Seat 1: chenconhaste ($100 in chips) 
Seat 2: matiko09 ($107.03 in chips) 
Seat 4: mbk88 ($247.12 in chips) 
Seat 5: swizzly58 ($73.06 in chips) 
Seat 6: joooh79 ($132.02 in chips) 
Seat 7: Ty Nick 420 ($140.50 in chips) 
Seat 8: ruslik_by ($100 in chips) 
Seat 9: geiranger011 ($114.23 in chips) 
mbk88: posts small blind $0.50
swizzly58: posts big blind $1
*** HOLE CARDS ***
Dealt to matiko09 [7s 6s]
joooh79: folds 
Ty Nick 420: folds 
mooose100 joins the table at seat #3 
ruslik_by: folds 
geiranger011: folds 
chenconhaste: folds 
matiko09: raises $1.27 to $2.27
mbk88: folds 
swizzly58: folds 
Uncalled bet ($1.27) returned to matiko09
matiko09 collected $2.50 from pot
matiko09: doesn't show hand 
*** SUMMARY ***
Total pot $2.50 | Rake $0 
Seat 1: chenconhaste folded before Flop (didn't bet)
Seat 2: matiko09 (button) collected ($2.50)
Seat 4: mbk88 (small blind) folded before Flop
Seat 5: swizzly58 (big blind) folded before Flop
Seat 6: joooh79 folded before Flop (didn't bet)
Seat 7: Ty Nick 420 folded before Flop (didn't bet)
Seat 8: ruslik_by folded before Flop (didn't bet)
Seat 9: geiranger011 folded before Flop (didn't bet)





PokerStars Hand #155380777151:  Hold'em No Limit ($0.25/$0.50 USD) - 2016/06/30 14:18:12 CET [2016/06/30 8:18:12 ET]
Table 'Arcturus' 9-max Seat #5 is the button
Seat 1: kourk250 ($131.02 in chips) 
Seat 2: Rafaello18 ($50 in chips) 
Seat 3: matiko09 ($54.31 in chips) 
Seat 5: stockbridge8 ($48.50 in chips) 
Seat 6: statistik85 ($64.72 in chips) 
Seat 7: bratbugor ($50 in chips) 
Seat 8: TheMinion ($50 in chips) 
Seat 9: pfunkolstar ($57.22 in chips) 
statistik85: posts small blind $0.25
bratbugor: posts big blind $0.50
*** HOLE CARDS ***
Dealt to matiko09 [8d 4s]
TheMinion: folds 
pfunkolstar: folds 
kourk250 has timed out
kourk250: folds 
Rafaello18: folds 
matiko09: folds 
stockbridge8: folds 
statistik85: calls $0.25
bratbugor: raises $1.25 to $1.75
statistik85: folds 
Uncalled bet ($1.25) returned to bratbugor
bratbugor collected $1 from pot
bratbugor: doesn't show hand 
*** SUMMARY ***
Total pot $1 | Rake $0 
Seat 1: kourk250 folded before Flop (didn't bet)
Seat 2: Rafaello18 folded before Flop (didn't bet)
Seat 3: matiko09 folded before Flop (didn't bet)
Seat 5: stockbridge8 (button) folded before Flop (didn't bet)
Seat 6: statistik85 (small blind) folded before Flop
Seat 7: bratbugor (big blind) collected ($1)
Seat 8: TheMinion folded before Flop (didn't bet)
Seat 9: pfunkolstar folded before Flop (didn't bet)





PokerStars Hand #155380783498:  Hold'em No Limit ($0.50/$1.00 USD) - 2016/06/30 14:18:26 CET [2016/06/30 8:18:26 ET]
Table 'Eucharis' 9-max Seat #4 is the button
Seat 1: chenconhaste ($100 in chips) 
Seat 2: matiko09 ($108.53 in chips) 
Seat 4: mbk88 ($246.62 in chips) 
Seat 5: swizzly58 ($72.06 in chips) 
Seat 6: joooh79 ($132.02 in chips) 
Seat 7: Ty Nick 420 ($140.50 in chips) 
Seat 8: ruslik_by ($100 in chips) 
Seat 9: geiranger011 ($114.23 in chips) 
swizzly58: posts small blind $0.50
joooh79: posts big blind $1
mooose100: sits out 
*** HOLE CARDS ***
Dealt to matiko09 [3c 9h]
Ty Nick 420: folds 
ruslik_by: folds 
geiranger011: folds 
chenconhaste: folds 
matiko09: folds 
mbk88: folds 
swizzly58: calls $0.50
joooh79: checks 
*** FLOP *** [8d 2c Ts]
swizzly58: bets $1.90
joooh79: calls $1.90
*** TURN *** [8d 2c Ts] [4s]
swizzly58: checks 
joooh79: checks 
*** RIVER *** [8d 2c Ts 4s] [3s]
swizzly58: checks 
joooh79: bets $2.75
swizzly58: folds 
Uncalled bet ($2.75) returned to joooh79
joooh79 collected $5.51 from pot
*** SUMMARY ***
Total pot $5.80 | Rake $0.29 
Board [8d 2c Ts 4s 3s]
Seat 1: chenconhaste folded before Flop (didn't bet)
Seat 2: matiko09 folded before Flop (didn't bet)
Seat 4: mbk88 (button) folded before Flop (didn't bet)
Seat 5: swizzly58 (small blind) folded on the River
Seat 6: joooh79 (big blind) collected ($5.51)
Seat 7: Ty Nick 420 folded before Flop (didn't bet)
Seat 8: ruslik_by folded before Flop (didn't bet)
Seat 9: geiranger011 folded before Flop (didn't bet)





PokerStars Hand #155380783972:  Hold'em No Limit ($0.50/$1.00 USD) - 2016/06/30 14:18:27 CET [2016/06/30 8:18:27 ET]
Table 'Donnera' 9-max Seat #8 is the button
Seat 1: chenconhaste ($100 in chips) 
Seat 2: robbiescrim9 ($95.57 in chips) 
Seat 3: matiko09 ($101.50 in chips) 
Seat 4: Kukuryzka ($100 in chips) 
Seat 5: tipner ($108.35 in chips) 
Seat 6: nickreason17 ($101 in chips) 
Seat 7: Rafaello18 ($100 in chips) 
Seat 8: ruslik_by ($114.60 in chips) 
Seat 9: Starw!nd ($100 in chips) 
Starw!nd: posts small blind $0.50
chenconhaste: posts big blind $1
*** HOLE CARDS ***
Dealt to matiko09 [3s Td]
robbiescrim9: calls $1
matiko09: folds 
Kukuryzka: folds 
tipner: folds 
nickreason17: folds 
Rafaello18: folds 
ruslik_by: folds 
Starw!nd: calls $0.50
chenconhaste: checks 
*** FLOP *** [Jh Ks Qc]
Starw!nd: checks 
chenconhaste: checks 
robbiescrim9: checks 
*** TURN *** [Jh Ks Qc] [Ad]
Starw!nd: bets $2
chenconhaste: folds 
robbiescrim9: calls $2
*** RIVER *** [Jh Ks Qc Ad] [Kd]
Starw!nd: bets $4
robbiescrim9: calls $4
*** SHOW DOWN ***
Starw!nd: shows [9s Ts] (a straight, Ten to Ace)
robbiescrim9: mucks hand 
Starw!nd collected $14.25 from pot
*** SUMMARY ***
Total pot $15 | Rake $0.75 
Board [Jh Ks Qc Ad Kd]
Seat 1: chenconhaste (big blind) folded on the Turn
Seat 2: robbiescrim9 mucked [Jc 7h]
Seat 3: matiko09 folded before Flop (didn't bet)
Seat 4: Kukuryzka folded before Flop (didn't bet)
Seat 5: tipner folded before Flop (didn't bet)
Seat 6: nickreason17 folded before Flop (didn't bet)
Seat 7: Rafaello18 folded before Flop (didn't bet)
Seat 8: ruslik_by (button) folded before Flop (didn't bet)
Seat 9: Starw!nd (small blind) showed [9s Ts] and won ($14.25) with a straight, Ten to Ace





PokerStars Hand #155380784074:  Hold'em No Limit ($0.50/$1.00 USD) - 2016/06/30 14:18:27 CET [2016/06/30 8:18:27 ET]
Table 'Tatjana' 9-max Seat #5 is the button
Seat 1: tipner ($116.40 in chips) 
Seat 2: DIMAN_324 ($100 in chips) 
Seat 3: Rafaello18 ($101.29 in chips) 
Seat 4: mopatron25 ($67.71 in chips) 
Seat 5: matiko09 ($123.03 in chips) 
Seat 6: mbk88 ($170.54 in chips) 
Seat 7: daigodisco ($91.69 in chips) 
Seat 8: alhill86 ($77.34 in chips) 
Seat 9: POTAPENKO700 ($234.21 in chips) 
mbk88: posts small blind $0.50
daigodisco: posts big blind $1
*** HOLE CARDS ***
Dealt to matiko09 [6h 3d]
alhill86: raises $2 to $3
POTAPENKO700: folds 
tipner: folds 
DIMAN_324: folds 
Rafaello18: folds 
mopatron25: calls $3
matiko09: folds 
mbk88: folds 
daigodisco: folds 
*** FLOP *** [Kd Th 5s]
alhill86: bets $4
mopatron25: calls $4
*** TURN *** [Kd Th 5s] [9c]
alhill86: checks 
mopatron25: bets $5
alhill86: calls $5
*** RIVER *** [Kd Th 5s 9c] [3h]
alhill86: checks 
mopatron25: bets $6
alhill86: raises $6 to $12
mopatron25: calls $6
*** SHOW DOWN ***
alhill86: shows [Ac As] (a pair of Aces)
mopatron25: mucks hand 
alhill86 collected $47.02 from pot
*** SUMMARY ***
Total pot $49.50 | Rake $2.48 
Board [Kd Th 5s 9c 3h]
Seat 1: tipner folded before Flop (didn't bet)
Seat 2: DIMAN_324 folded before Flop (didn't bet)
Seat 3: Rafaello18 folded before Flop (didn't bet)
Seat 4: mopatron25 mucked [Ah Ts]
Seat 5: matiko09 (button) folded before Flop (didn't bet)
Seat 6: mbk88 (small blind) folded before Flop
Seat 7: daigodisco (big blind) folded before Flop
Seat 8: alhill86 showed [Ac As] and won ($47.02) with a pair of Aces
Seat 9: POTAPENKO700 folded before Flop (didn't bet)





PokerStars Hand #155380784076:  Hold'em No Limit ($0.50/$1.00 USD) - 2016/06/30 14:18:27 CET [2016/06/30 8:18:27 ET]
Table 'California II' 9-max Seat #4 is the button
Seat 1: Rafaello18 ($101.50 in chips) 
Seat 2: velourleder ($60.26 in chips) 
Seat 3: KovIFish89 ($101.02 in chips) 
Seat 4: mbk88 ($133.12 in chips) 
Seat 5: Rohitbarve ($110.02 in chips) 
Seat 6: matiko09 ($146 in chips) 
Seat 7: DomiVY ($77.60 in chips) 
Seat 9: di0d80 ($101.10 in chips) 
Rohitbarve: posts small blind $0.50
matiko09: posts big blind $1
*** HOLE CARDS ***
Dealt to matiko09 [2d Kd]
DomiVY: folds 
di0d80: folds 
Rafaello18: folds 
velourleder: folds 
KovIFish89: folds 
mbk88: folds 
Rohitbarve: folds 
Uncalled bet ($0.50) returned to matiko09
matiko09 collected $1 from pot
matiko09: doesn't show hand 
*** SUMMARY ***
Total pot $1 | Rake $0 
Seat 1: Rafaello18 folded before Flop (didn't bet)
Seat 2: velourleder folded before Flop (didn't bet)
Seat 3: KovIFish89 folded before Flop (didn't bet)
Seat 4: mbk88 (button) folded before Flop (didn't bet)
Seat 5: Rohitbarve (small blind) folded before Flop
Seat 6: matiko09 (big blind) collected ($1)
Seat 7: DomiVY folded before Flop (didn't bet)
Seat 9: di0d80 folded before Flop (didn't bet)





PokerStars Hand #155380784386:  Hold'em No Limit ($0.50/$1.00 USD) - 2016/06/30 14:18:28 CET [2016/06/30 8:18:28 ET]
Table 'Borrelly II' 9-max Seat #3 is the button
Seat 1: Rafaello18 ($117.07 in chips) 
Seat 2: mbk88 ($103.50 in chips) 
Seat 3: di0d80 ($100 in chips) 
Seat 4: DonRon_AT ($40.69 in chips) 
Seat 5: DIMAN_324 ($100.11 in chips) 
Seat 6: m_michalec ($178.61 in chips) 
Seat 7: matiko09 ($177.36 in chips) 
Seat 8: Arjun A Raju ($135.42 in chips) 
Seat 9: alhill86 ($74.18 in chips) 
DonRon_AT: posts small blind $0.50
DIMAN_324: posts big blind $1
*** HOLE CARDS ***
Dealt to matiko09 [8h 5c]
m_michalec: folds 
matiko09: folds 
Arjun A Raju: folds 
alhill86: folds 
Rafaello18: folds 
mbk88: folds 
di0d80: raises $1 to $2
DonRon_AT: folds 
DIMAN_324: raises $6.50 to $8.50
di0d80: calls $6.50
*** FLOP *** [7s 2d Ah]
DIMAN_324: bets $8.31
di0d80: calls $8.31
*** TURN *** [7s 2d Ah] [6d]
DIMAN_324: bets $16.20
di0d80: calls $16.20
*** RIVER *** [7s 2d Ah 6d] [4d]
DIMAN_324: bets $67.10 and is all-in
di0d80: calls $66.99 and is all-in
Uncalled bet ($0.11) returned to DIMAN_324
*** SHOW DOWN ***
DIMAN_324: shows [Kh As] (a pair of Aces)
di0d80: shows [Ac 7c] (two pair, Aces and Sevens)
di0d80 collected $198 from pot
*** SUMMARY ***
Total pot $200.50 | Rake $2.50 
Board [7s 2d Ah 6d 4d]
Seat 1: Rafaello18 folded before Flop (didn't bet)
Seat 2: mbk88 folded before Flop (didn't bet)
Seat 3: di0d80 (button) showed [Ac 7c] and won ($198) with two pair, Aces and Sevens
Seat 4: DonRon_AT (small blind) folded before Flop
Seat 5: DIMAN_324 (big blind) showed [Kh As] and lost with a pair of Aces
Seat 6: m_michalec folded before Flop (didn't bet)
Seat 7: matiko09 folded before Flop (didn't bet)
Seat 8: Arjun A Raju folded before Flop (didn't bet)
Seat 9: alhill86 folded before Flop (didn't bet)





PokerStars Hand #155380787261:  Hold'em No Limit ($0.50/$1.00 USD) - 2016/06/30 14:18:34 CET [2016/06/30 8:18:34 ET]
Table 'Sigrid' 9-max Seat #8 is the button
Seat 1: Greha999 ($75.58 in chips) 
Seat 2: matiko09 ($115.66 in chips) 
Seat 3: Rafaello18 ($103.20 in chips) 
Seat 4: mbk88 ($117.37 in chips) 
Seat 6: di0d80 ($112.49 in chips) 
Seat 7: arctur17 ($97 in chips) 
Seat 8: ruslik_by ($101 in chips) 
Seat 9: KovIFish89 ($100 in chips) 
KovIFish89: posts small blind $0.50
Greha999: posts big blind $1
*** HOLE CARDS ***
Dealt to matiko09 [2s Ad]
matiko09: folds 
Rafaello18: folds 
mbk88: folds 
di0d80: folds 
arctur17: folds 
ruslik_by: folds 
KovIFish89: folds 
Uncalled bet ($0.50) returned to Greha999
Greha999 collected $1 from pot
*** SUMMARY ***
Total pot $1 | Rake $0 
Seat 1: Greha999 (big blind) collected ($1)
Seat 2: matiko09 folded before Flop (didn't bet)
Seat 3: Rafaello18 folded before Flop (didn't bet)
Seat 4: mbk88 folded before Flop (didn't bet)
Seat 6: di0d80 folded before Flop (didn't bet)
Seat 7: arctur17 folded before Flop (didn't bet)
Seat 8: ruslik_by (button) folded before Flop (didn't bet)
Seat 9: KovIFish89 (small blind) folded before Flop





PokerStars Hand #155380789656:  Hold'em No Limit ($0.50/$1.00 USD) - 2016/06/30 14:18:39 CET [2016/06/30 8:18:39 ET]
Table 'Altarf II' 9-max Seat #7 is the button
Seat 1: Rafaello18 ($100 in chips) 
Seat 2: KovIFish89 ($101 in chips) 
Seat 4: Greha999 ($76.94 in chips) 
Seat 5: DIMAN_324 ($228.74 in chips) 
Seat 6: mbk88 ($101.50 in chips) 
Seat 7: matiko09 ($103.40 in chips) 
Seat 8: DomiVY ($47.62 in chips) 
Seat 9: omanibemihum ($123.69 in chips) 
DomiVY: posts small blind $0.50
omanibemihum: posts big blind $1
*** HOLE CARDS ***
Dealt to matiko09 [9h Qh]
Rafaello18: folds 
KovIFish89: folds 
Greha999: raises $1 to $2
DIMAN_324: folds 
mbk88: folds 
matiko09: folds 
DomiVY: folds 
omanibemihum: folds 
Uncalled bet ($1) returned to Greha999
Greha999 collected $2.50 from pot
*** SUMMARY ***
Total pot $2.50 | Rake $0 
Seat 1: Rafaello18 folded before Flop (didn't bet)
Seat 2: KovIFish89 folded before Flop (didn't bet)
Seat 4: Greha999 collected ($2.50)
Seat 5: DIMAN_324 folded before Flop (didn't bet)
Seat 6: mbk88 folded before Flop (didn't bet)
Seat 7: matiko09 (button) folded before Flop (didn't bet)
Seat 8: DomiVY (small blind) folded before Flop
Seat 9: omanibemihum (big blind) folded before Flop





PokerStars Hand #155380791588:  Hold'em No Limit ($0.50/$1.00 USD) - 2016/06/30 14:18:43 CET [2016/06/30 8:18:43 ET]
Table 'Asmodeus' 9-max Seat #1 is the button
Seat 1: scollop ($214.50 in chips) 
Seat 2: nickreason17 ($100 in chips) 
Seat 3: matiko09 ($118.74 in chips) 
Seat 4: DIMAN_324 ($100 in chips) 
Seat 6: koutani7 ($101.03 in chips) 
Seat 8: Rafaello18 ($172.57 in chips) 
nickreason17: posts small blind $0.50
matiko09: posts big blind $1
aaronzzr: sits out 
mbk88: sits out 
*** HOLE CARDS ***
Dealt to matiko09 [2c 2s]
DIMAN_324: folds 
koutani7: raises $2 to $3
Rafaello18: folds 
scollop: folds 
nickreason17: folds 
matiko09: folds 
Uncalled bet ($2) returned to koutani7
koutani7 collected $2.50 from pot
koutani7: doesn't show hand 
*** SUMMARY ***
Total pot $2.50 | Rake $0 
Seat 1: scollop (button) folded before Flop (didn't bet)
Seat 2: nickreason17 (small blind) folded before Flop
Seat 3: matiko09 (big blind) folded before Flop
Seat 4: DIMAN_324 folded before Flop (didn't bet)
Seat 6: koutani7 collected ($2.50)
Seat 8: Rafaello18 folded before Flop (didn't bet)





PokerStars Hand #155380795549:  Hold'em No Limit ($0.50/$1.00 USD) - 2016/06/30 14:18:52 CET [2016/06/30 8:18:52 ET]
Table 'California II' 9-max Seat #5 is the button
Seat 1: Rafaello18 ($101.50 in chips) 
Seat 2: velourleder ($60.26 in chips) 
Seat 3: KovIFish89 ($101.02 in chips) 
Seat 4: mbk88 ($133.12 in chips) 
Seat 5: Rohitbarve ($109.52 in chips) 
Seat 6: matiko09 ($146.50 in chips) 
Seat 7: DomiVY ($77.60 in chips) 
Seat 9: di0d80 ($101.10 in chips) 
matiko09: posts small blind $0.50
DomiVY: posts big blind $1
*** HOLE CARDS ***
Dealt to matiko09 [8c 7h]
di0d80: folds 
Rafaello18: folds 
velourleder: folds 
velourleder leaves the table
KovIFish89: folds 
mbk88: folds 
Rohitbarve: folds 
matiko09: folds 
Uncalled bet ($0.50) returned to DomiVY
DomiVY collected $1 from pot
DomiVY: doesn't show hand 
*** SUMMARY ***
Total pot $1 | Rake $0 
Seat 1: Rafaello18 folded before Flop (didn't bet)
Seat 2: velourleder folded before Flop (didn't bet)
Seat 3: KovIFish89 folded before Flop (didn't bet)
Seat 4: mbk88 folded before Flop (didn't bet)
Seat 5: Rohitbarve (button) folded before Flop (didn't bet)
Seat 6: matiko09 (small blind) folded before Flop
Seat 7: DomiVY (big blind) collected ($1)
Seat 9: di0d80 folded before Flop (didn't bet)





PokerStars Hand #155380799142:  Hold'em No Limit ($0.50/$1.00 USD) - 2016/06/30 14:19:00 CET [2016/06/30 8:19:00 ET]
Table 'Altarf II' 9-max Seat #8 is the button
Seat 1: Rafaello18 ($100 in chips) 
Seat 2: KovIFish89 ($101 in chips) 
Seat 4: Greha999 ($78.44 in chips) 
Seat 5: DIMAN_324 ($228.74 in chips) 
Seat 6: mbk88 ($101.50 in chips) 
Seat 7: matiko09 ($103.40 in chips) 
Seat 8: DomiVY ($47.12 in chips) 
Seat 9: omanibemihum ($122.69 in chips) 
omanibemihum: posts small blind $0.50
Rafaello18: posts big blind $1
*** HOLE CARDS ***
Dealt to matiko09 [Qs Td]
KovIFish89: folds 
Greha999: folds 
DIMAN_324: folds 
mbk88: raises $2 to $3
matiko09: folds 
DomiVY: folds 
omanibemihum: calls $2.50
Rafaello18: folds 
*** FLOP *** [Ac Th Ad]
omanibemihum: checks 
mbk88: bets $4
omanibemihum: folds 
Uncalled bet ($4) returned to mbk88
mbk88 collected $6.65 from pot
mbk88: doesn't show hand 
*** SUMMARY ***
Total pot $7 | Rake $0.35 
Board [Ac Th Ad]
Seat 1: Rafaello18 (big blind) folded before Flop
Seat 2: KovIFish89 folded before Flop (didn't bet)
Seat 4: Greha999 folded before Flop (didn't bet)
Seat 5: DIMAN_324 folded before Flop (didn't bet)
Seat 6: mbk88 collected ($6.65)
Seat 7: matiko09 folded before Flop (didn't bet)
Seat 8: DomiVY (button) folded before Flop (didn't bet)
Seat 9: omanibemihum (small blind) folded on the Flop





PokerStars Hand #155380803187:  Hold'em No Limit ($0.25/$0.50 USD) - 2016/06/30 14:19:09 CET [2016/06/30 8:19:09 ET]
Table 'Arcturus' 9-max Seat #6 is the button
Seat 1: kourk250 ($131.02 in chips) 
Seat 2: Rafaello18 ($50 in chips) 
Seat 3: matiko09 ($54.31 in chips) 
Seat 5: stockbridge8 ($48.50 in chips) 
Seat 6: statistik85 ($64.22 in chips) 
Seat 7: bratbugor ($50.50 in chips) 
Seat 8: TheMinion ($50 in chips) 
Seat 9: pfunkolstar ($57.22 in chips) 
bratbugor: posts small blind $0.25
TheMinion: posts big blind $0.50
*** HOLE CARDS ***
Dealt to matiko09 [Ac Tc]
pfunkolstar: folds 
kourk250: raises $1 to $1.50
Rafaello18: folds 
matiko09: raises $3 to $4.50
stockbridge8: folds 
statistik85: folds 
bratbugor: folds 
TheMinion: folds 
kourk250: calls $3
*** FLOP *** [Kh 5d Td]
kourk250: checks 
matiko09: checks 
*** TURN *** [Kh 5d Td] [Qs]
kourk250: checks 
matiko09: checks 
*** RIVER *** [Kh 5d Td Qs] [Kd]
kourk250: bets $4.63
matiko09: folds 
Uncalled bet ($4.63) returned to kourk250
kourk250 collected $9.26 from pot
kourk250: doesn't show hand 
*** SUMMARY ***
Total pot $9.75 | Rake $0.49 
Board [Kh 5d Td Qs Kd]
Seat 1: kourk250 collected ($9.26)
Seat 2: Rafaello18 folded before Flop (didn't bet)
Seat 3: matiko09 folded on the River
Seat 5: stockbridge8 folded before Flop (didn't bet)
Seat 6: statistik85 (button) folded before Flop (didn't bet)
Seat 7: bratbugor (small blind) folded before Flop
Seat 8: TheMinion (big blind) folded before Flop
Seat 9: pfunkolstar folded before Flop (didn't bet)





PokerStars Hand #155380807128:  Hold'em No Limit ($0.50/$1.00 USD) - 2016/06/30 14:19:17 CET [2016/06/30 8:19:17 ET]
Table 'California II' 9-max Seat #6 is the button
Seat 1: Rafaello18 ($101.50 in chips) 
Seat 3: KovIFish89 ($101.02 in chips) 
Seat 4: mbk88 ($133.12 in chips) 
Seat 5: Rohitbarve ($109.52 in chips) 
Seat 6: matiko09 ($146 in chips) 
Seat 7: DomiVY ($78.10 in chips) 
Seat 9: di0d80 ($101.10 in chips) 
DomiVY: posts small blind $0.50
di0d80: posts big blind $1
*** HOLE CARDS ***
Dealt to matiko09 [7d 5d]
Rafaello18: folds 
KovIFish89: folds 
mbk88: folds 
Rohitbarve: folds 
matiko09: raises $1.27 to $2.27
DomiVY: folds 
di0d80: raises $5.23 to $7.50
matiko09: folds 
Uncalled bet ($5.23) returned to di0d80
di0d80 collected $5.04 from pot
di0d80: doesn't show hand 
*** SUMMARY ***
Total pot $5.04 | Rake $0 
Seat 1: Rafaello18 folded before Flop (didn't bet)
Seat 3: KovIFish89 folded before Flop (didn't bet)
Seat 4: mbk88 folded before Flop (didn't bet)
Seat 5: Rohitbarve folded before Flop (didn't bet)
Seat 6: matiko09 (button) folded before Flop
Seat 7: DomiVY (small blind) folded before Flop
Seat 9: di0d80 (big blind) collected ($5.04)





PokerStars Hand #155380809814:  Hold'em No Limit ($0.50/$1.00 USD) - 2016/06/30 14:19:23 CET [2016/06/30 8:19:23 ET]
Table 'Sigrid' 9-max Seat #9 is the button
Seat 1: Greha999 ($76.08 in chips) 
Seat 2: matiko09 ($115.66 in chips) 
Seat 3: Rafaello18 ($103.20 in chips) 
Seat 4: mbk88 ($117.37 in chips) 
Seat 6: di0d80 ($112.49 in chips) 
Seat 7: arctur17 ($97 in chips) 
Seat 8: ruslik_by ($101 in chips) 
Seat 9: KovIFish89 ($100 in chips) 
Greha999: posts small blind $0.50
matiko09: posts big blind $1
*** HOLE CARDS ***
Dealt to matiko09 [Kd 6h]
Rafaello18: folds 
mbk88: raises $2 to $3
di0d80: folds 
arctur17: folds 
ruslik_by: folds 
KovIFish89: folds 
Greha999: folds 
matiko09: folds 
Uncalled bet ($2) returned to mbk88
mbk88 collected $2.50 from pot
mbk88: doesn't show hand 
*** SUMMARY ***
Total pot $2.50 | Rake $0 
Seat 1: Greha999 (small blind) folded before Flop
Seat 2: matiko09 (big blind) folded before Flop
Seat 3: Rafaello18 folded before Flop (didn't bet)
Seat 4: mbk88 collected ($2.50)
Seat 6: di0d80 folded before Flop (didn't bet)
Seat 7: arctur17 folded before Flop (didn't bet)
Seat 8: ruslik_by folded before Flop (didn't bet)
Seat 9: KovIFish89 (button) folded before Flop (didn't bet)





PokerStars Hand #155380812209:  Hold'em No Limit ($0.50/$1.00 USD) - 2016/06/30 14:19:28 CET [2016/06/30 8:19:28 ET]
Table 'Asmodeus' 9-max Seat #2 is the button
Seat 1: scollop ($214.50 in chips) 
Seat 2: nickreason17 ($100 in chips) 
Seat 3: matiko09 ($117.74 in chips) 
Seat 4: DIMAN_324 ($100 in chips) 
Seat 6: koutani7 ($102.53 in chips) 
Seat 8: Rafaello18 ($172.57 in chips) 
matiko09: posts small blind $0.50
DIMAN_324: posts big blind $1
aaronzzr: sits out 
mbk88: sits out 
*** HOLE CARDS ***
Dealt to matiko09 [8h 6c]
koutani7: raises $2 to $3
Rafaello18: folds 
scollop: calls $3
nickreason17: folds 
matiko09: folds 
DIMAN_324: folds 
*** FLOP *** [Ac 4c Qd]
koutani7: checks 
scollop: checks 
*** TURN *** [Ac 4c Qd] [3d]
koutani7: bets $5
scollop: calls $5
*** RIVER *** [Ac 4c Qd 3d] [6d]
koutani7: bets $11
scollop: calls $11
*** SHOW DOWN ***
koutani7: shows [Jh Jd] (a pair of Jacks)
scollop: shows [Jc Qh] (a pair of Queens)
scollop collected $37.52 from pot
*** SUMMARY ***
Total pot $39.50 | Rake $1.98 
Board [Ac 4c Qd 3d 6d]
Seat 1: scollop showed [Jc Qh] and won ($37.52) with a pair of Queens
Seat 2: nickreason17 (button) folded before Flop (didn't bet)
Seat 3: matiko09 (small blind) folded before Flop
Seat 4: DIMAN_324 (big blind) folded before Flop
Seat 6: koutani7 showed [Jh Jd] and lost with a pair of Jacks
Seat 8: Rafaello18 folded before Flop (didn't bet)





PokerStars Hand #155380811949:  Hold'em No Limit ($0.50/$1.00 USD) - 2016/06/30 14:19:28 CET [2016/06/30 8:19:28 ET]
Table 'Eucharis' 9-max Seat #5 is the button
Seat 1: chenconhaste ($100 in chips) 
Seat 2: matiko09 ($108.53 in chips) 
Seat 4: mbk88 ($246.62 in chips) 
Seat 5: swizzly58 ($69.16 in chips) 
Seat 6: joooh79 ($134.63 in chips) 
Seat 7: Ty Nick 420 ($140.50 in chips) 
Seat 8: ruslik_by ($100 in chips) 
Seat 9: geiranger011 ($114.23 in chips) 
joooh79: posts small blind $0.50
Ty Nick 420: posts big blind $1
mooose100: sits out 
*** HOLE CARDS ***
Dealt to matiko09 [Ah 7c]
ruslik_by: folds 
geiranger011: folds 
chenconhaste: folds 
matiko09: folds 
mbk88: folds 
swizzly58: folds 
joooh79: folds 
Uncalled bet ($0.50) returned to Ty Nick 420
Ty Nick 420 collected $1 from pot
*** SUMMARY ***
Total pot $1 | Rake $0 
Seat 1: chenconhaste folded before Flop (didn't bet)
Seat 2: matiko09 folded before Flop (didn't bet)
Seat 4: mbk88 folded before Flop (didn't bet)
Seat 5: swizzly58 (button) folded before Flop (didn't bet)
Seat 6: joooh79 (small blind) folded before Flop
Seat 7: Ty Nick 420 (big blind) collected ($1)
Seat 8: ruslik_by folded before Flop (didn't bet)
Seat 9: geiranger011 folded before Flop (didn't bet)





PokerStars Hand #155380814310:  Hold'em No Limit ($0.50/$1.00 USD) - 2016/06/30 14:19:33 CET [2016/06/30 8:19:33 ET]
Table 'Donnera' 9-max Seat #9 is the button
Seat 1: chenconhaste ($100 in chips) 
Seat 2: robbiescrim9 ($88.57 in chips) 
Seat 3: matiko09 ($101.50 in chips) 
Seat 4: Kukuryzka ($100 in chips) 
Seat 5: tipner ($108.35 in chips) 
Seat 6: nickreason17 ($101 in chips) 
Seat 7: Rafaello18 ($100 in chips) 
Seat 8: ruslik_by ($114.60 in chips) 
Seat 9: Starw!nd ($107.25 in chips) 
chenconhaste: posts small blind $0.50
robbiescrim9: posts big blind $1
*** HOLE CARDS ***
Dealt to matiko09 [Js 7c]
matiko09: folds 
Kukuryzka: folds 
tipner: raises $2 to $3
nickreason17: folds 
Rafaello18: folds 
ruslik_by: folds 
Starw!nd: folds 
chenconhaste: folds 
robbiescrim9: raises $2 to $5
tipner: calls $2
*** FLOP *** [Jc 5s 8c]
robbiescrim9: bets $5
tipner: calls $5
*** TURN *** [Jc 5s 8c] [Jh]
robbiescrim9: bets $6
tipner: calls $6
*** RIVER *** [Jc 5s 8c Jh] [4s]
robbiescrim9: checks 
tipner: checks 
*** SHOW DOWN ***
robbiescrim9: shows [Ad Ah] (two pair, Aces and Jacks)
tipner: mucks hand 
robbiescrim9 collected $30.88 from pot
*** SUMMARY ***
Total pot $32.50 | Rake $1.62 
Board [Jc 5s 8c Jh 4s]
Seat 1: chenconhaste (small blind) folded before Flop
Seat 2: robbiescrim9 (big blind) showed [Ad Ah] and won ($30.88) with two pair, Aces and Jacks
Seat 3: matiko09 folded before Flop (didn't bet)
Seat 4: Kukuryzka folded before Flop (didn't bet)
Seat 5: tipner mucked [7d 8d]
Seat 6: nickreason17 folded before Flop (didn't bet)
Seat 7: Rafaello18 folded before Flop (didn't bet)
Seat 8: ruslik_by folded before Flop (didn't bet)
Seat 9: Starw!nd (button) folded before Flop (didn't bet)





PokerStars Hand #155380817183:  Hold'em No Limit ($0.50/$1.00 USD) - 2016/06/30 14:19:39 CET [2016/06/30 8:19:39 ET]
Table 'California II' 9-max Seat #7 is the button
Seat 1: Rafaello18 ($101.50 in chips) 
Seat 3: KovIFish89 ($101.02 in chips) 
Seat 4: mbk88 ($133.12 in chips) 
Seat 5: Rohitbarve ($109.52 in chips) 
Seat 6: matiko09 ($143.73 in chips) 
Seat 7: DomiVY ($77.60 in chips) 
Seat 9: di0d80 ($103.87 in chips) 
di0d80: posts small blind $0.50
Rafaello18: posts big blind $1
*** HOLE CARDS ***
Dealt to matiko09 [Js 3s]
KovIFish89: folds 
mbk88: folds 
Rohitbarve: raises $2 to $3
matiko09: folds 
DomiVY: folds 
di0d80: folds 
Rafaello18: folds 
Uncalled bet ($2) returned to Rohitbarve
Rohitbarve collected $2.50 from pot
Rohitbarve: doesn't show hand 
*** SUMMARY ***
Total pot $2.50 | Rake $0 
Seat 1: Rafaello18 (big blind) folded before Flop
Seat 3: KovIFish89 folded before Flop (didn't bet)
Seat 4: mbk88 folded before Flop (didn't bet)
Seat 5: Rohitbarve collected ($2.50)
Seat 6: matiko09 folded before Flop (didn't bet)
Seat 7: DomiVY (button) folded before Flop (didn't bet)
Seat 9: di0d80 (small blind) folded before Flop





PokerStars Hand #155380817587:  Hold'em No Limit ($0.50/$1.00 USD) - 2016/06/30 14:19:40 CET [2016/06/30 8:19:40 ET]
Table 'Tatjana' 9-max Seat #6 is the button
Seat 1: tipner ($116.40 in chips) 
Seat 2: DIMAN_324 ($100 in chips) 
Seat 3: Rafaello18 ($101.29 in chips) 
Seat 4: mopatron25 ($43.71 in chips) 
Seat 5: matiko09 ($123.03 in chips) 
Seat 6: mbk88 ($170.04 in chips) 
Seat 7: daigodisco ($90.69 in chips) 
Seat 8: alhill86 ($100.36 in chips) 
Seat 9: POTAPENKO700 ($234.21 in chips) 
daigodisco: posts small blind $0.50
alhill86: posts big blind $1
*** HOLE CARDS ***
Dealt to matiko09 [Kh 3c]
POTAPENKO700: folds 
tipner: folds 
DIMAN_324: folds 
Rafaello18: raises $1.50 to $2.50
mopatron25: folds 
matiko09: folds 
mbk88: folds 
daigodisco: folds 
alhill86: folds 
Uncalled bet ($1.50) returned to Rafaello18
Rafaello18 collected $2.50 from pot
Rafaello18: doesn't show hand 
*** SUMMARY ***
Total pot $2.50 | Rake $0 
Seat 1: tipner folded before Flop (didn't bet)
Seat 2: DIMAN_324 folded before Flop (didn't bet)
Seat 3: Rafaello18 collected ($2.50)
Seat 4: mopatron25 folded before Flop (didn't bet)
Seat 5: matiko09 folded before Flop (didn't bet)
Seat 6: mbk88 (button) folded before Flop (didn't bet)
Seat 7: daigodisco (small blind) folded before Flop
Seat 8: alhill86 (big blind) folded before Flop
Seat 9: POTAPENKO700 folded before Flop (didn't bet)





PokerStars Hand #155380818890:  Hold'em No Limit ($0.50/$1.00 USD) - 2016/06/30 14:19:43 CET [2016/06/30 8:19:43 ET]
Table 'Eucharis' 9-max Seat #6 is the button
Seat 1: chenconhaste ($100 in chips) 
Seat 2: matiko09 ($108.53 in chips) 
Seat 4: mbk88 ($246.62 in chips) 
Seat 5: swizzly58 ($69.16 in chips) 
Seat 6: joooh79 ($134.13 in chips) 
Seat 7: Ty Nick 420 ($141 in chips) 
Seat 8: ruslik_by ($100 in chips) 
Seat 9: geiranger011 ($114.23 in chips) 
Ty Nick 420: posts small blind $0.50
ruslik_by: posts big blind $1
mooose100: sits out 
*** HOLE CARDS ***
Dealt to matiko09 [6c 3s]
geiranger011: calls $1
chenconhaste: calls $1
matiko09: folds 
mbk88: folds 
swizzly58: folds 
joooh79: folds 
Ty Nick 420: calls $0.50
ruslik_by: raises $4 to $5
geiranger011: calls $4
chenconhaste: calls $4
Ty Nick 420: calls $4
*** FLOP *** [7d 9h 5s]
Ty Nick 420: checks 
ruslik_by: checks 
geiranger011: bets $4
chenconhaste: folds 
Ty Nick 420: calls $4
ruslik_by: folds 
*** TURN *** [7d 9h 5s] [4s]
Ty Nick 420: checks 
geiranger011: bets $4
Ty Nick 420: calls $4
*** RIVER *** [7d 9h 5s 4s] [Ts]
Ty Nick 420: checks 
geiranger011: bets $4
Ty Nick 420: calls $4
*** SHOW DOWN ***
geiranger011: shows [Td Th] (three of a kind, Tens)
Ty Nick 420: mucks hand 
geiranger011 collected $41.80 from pot
*** SUMMARY ***
Total pot $44 | Rake $2.20 
Board [7d 9h 5s 4s Ts]
Seat 1: chenconhaste folded on the Flop
Seat 2: matiko09 folded before Flop (didn't bet)
Seat 4: mbk88 folded before Flop (didn't bet)
Seat 5: swizzly58 folded before Flop (didn't bet)
Seat 6: joooh79 (button) folded before Flop (didn't bet)
Seat 7: Ty Nick 420 (small blind) mucked [Tc 8c]
Seat 8: ruslik_by (big blind) folded on the Flop
Seat 9: geiranger011 showed [Td Th] and won ($41.80) with three of a kind, Tens





PokerStars Hand #155380825464:  Hold'em No Limit ($0.50/$1.00 USD) - 2016/06/30 14:19:57 CET [2016/06/30 8:19:57 ET]
Table 'Altarf II' 9-max Seat #9 is the button
Seat 1: Rafaello18 ($100 in chips) 
Seat 2: KovIFish89 ($101 in chips) 
Seat 4: Greha999 ($78.44 in chips) 
Seat 5: DIMAN_324 ($228.74 in chips) 
Seat 6: mbk88 ($105.15 in chips) 
Seat 7: matiko09 ($103.40 in chips) 
Seat 8: DomiVY ($47.12 in chips) 
Seat 9: omanibemihum ($119.69 in chips) 
Rafaello18: posts small blind $0.50
KovIFish89: posts big blind $1
*** HOLE CARDS ***
Dealt to matiko09 [5c 8c]
Greha999: folds 
DIMAN_324: folds 
mbk88: raises $2 to $3
matiko09: folds 
DomiVY: folds 
omanibemihum: folds 
Rafaello18: folds 
KovIFish89: folds 
Uncalled bet ($2) returned to mbk88
mbk88 collected $2.50 from pot
mbk88: doesn't show hand 
*** SUMMARY ***
Total pot $2.50 | Rake $0 
Seat 1: Rafaello18 (small blind) folded before Flop
Seat 2: KovIFish89 (big blind) folded before Flop
Seat 4: Greha999 folded before Flop (didn't bet)
Seat 5: DIMAN_324 folded before Flop (didn't bet)
Seat 6: mbk88 collected ($2.50)
Seat 7: matiko09 folded before Flop (didn't bet)
Seat 8: DomiVY folded before Flop (didn't bet)
Seat 9: omanibemihum (button) folded before Flop (didn't bet)





PokerStars Hand #155380828253:  Hold'em No Limit ($0.50/$1.00 USD) - 2016/06/30 14:20:03 CET [2016/06/30 8:20:03 ET]
Table 'Sigrid' 9-max Seat #1 is the button
Seat 1: Greha999 ($75.58 in chips) 
Seat 2: matiko09 ($114.66 in chips) 
Seat 3: Rafaello18 ($103.20 in chips) 
Seat 4: mbk88 ($118.87 in chips) 
Seat 6: di0d80 ($112.49 in chips) 
Seat 7: arctur17 ($97 in chips) 
Seat 8: ruslik_by ($101 in chips) 
Seat 9: KovIFish89 ($100 in chips) 
matiko09: posts small blind $0.50
Rafaello18: posts big blind $1
*** HOLE CARDS ***
Dealt to matiko09 [Qd 5c]
mbk88: folds 
di0d80: folds 
arctur17: raises $2 to $3
ruslik_by: folds 
KovIFish89: folds 
Greha999: folds 
matiko09: folds 
Rafaello18: folds 
Uncalled bet ($2) returned to arctur17
arctur17 collected $2.50 from pot
arctur17: doesn't show hand 
*** SUMMARY ***
Total pot $2.50 | Rake $0 
Seat 1: Greha999 (button) folded before Flop (didn't bet)
Seat 2: matiko09 (small blind) folded before Flop
Seat 3: Rafaello18 (big blind) folded before Flop
Seat 4: mbk88 folded before Flop (didn't bet)
Seat 6: di0d80 folded before Flop (didn't bet)
Seat 7: arctur17 collected ($2.50)
Seat 8: ruslik_by folded before Flop (didn't bet)
Seat 9: KovIFish89 folded before Flop (didn't bet)





PokerStars Hand #155380829381:  Hold'em No Limit ($0.50/$1.00 USD) - 2016/06/30 14:20:05 CET [2016/06/30 8:20:05 ET]
Table 'Tatjana' 9-max Seat #7 is the button
Seat 1: tipner ($116.40 in chips) 
Seat 2: DIMAN_324 ($100 in chips) 
Seat 3: Rafaello18 ($102.79 in chips) 
Seat 4: mopatron25 ($43.71 in chips) 
Seat 5: matiko09 ($123.03 in chips) 
Seat 6: mbk88 ($170.04 in chips) 
Seat 7: daigodisco ($90.19 in chips) 
Seat 8: alhill86 ($99.36 in chips) 
Seat 9: POTAPENKO700 ($234.21 in chips) 
alhill86: posts small blind $0.50
POTAPENKO700: posts big blind $1
*** HOLE CARDS ***
Dealt to matiko09 [Qh 2d]
tipner: raises $2 to $3
DIMAN_324: folds 
Rafaello18: folds 
mopatron25: folds 
matiko09: folds 
mbk88: folds 
daigodisco: folds 
alhill86: folds 
POTAPENKO700: folds 
Uncalled bet ($2) returned to tipner
tipner collected $2.50 from pot
tipner: doesn't show hand 
*** SUMMARY ***
Total pot $2.50 | Rake $0 
Seat 1: tipner collected ($2.50)
Seat 2: DIMAN_324 folded before Flop (didn't bet)
Seat 3: Rafaello18 folded before Flop (didn't bet)
Seat 4: mopatron25 folded before Flop (didn't bet)
Seat 5: matiko09 folded before Flop (didn't bet)
Seat 6: mbk88 folded before Flop (didn't bet)
Seat 7: daigodisco (button) folded before Flop (didn't bet)
Seat 8: alhill86 (small blind) folded before Flop
Seat 9: POTAPENKO700 (big blind) folded before Flop





PokerStars Hand #155380829420:  Hold'em No Limit ($0.50/$1.00 USD) - 2016/06/30 14:20:06 CET [2016/06/30 8:20:06 ET]
Table 'Borrelly II' 9-max Seat #4 is the button
Seat 1: Rafaello18 ($117.07 in chips) 
Seat 2: mbk88 ($103.50 in chips) 
Seat 3: di0d80 ($198 in chips) 
Seat 4: DonRon_AT ($40.19 in chips) 
Seat 5: DIMAN_324 ($100 in chips) 
Seat 6: m_michalec ($178.61 in chips) 
Seat 7: matiko09 ($177.36 in chips) 
Seat 8: Arjun A Raju ($135.42 in chips) 
Seat 9: alhill86 ($74.18 in chips) 
DIMAN_324: posts small blind $0.50
m_michalec: posts big blind $1
*** HOLE CARDS ***
Dealt to matiko09 [Kc 5h]
matiko09: folds 
Arjun A Raju: folds 
alhill86: raises $2 to $3
Rafaello18: folds 
mbk88: folds 
di0d80: folds 
DonRon_AT: folds 
DIMAN_324: folds 
m_michalec: calls $2
*** FLOP *** [Tc 2d Qh]
m_michalec: checks 
alhill86: bets $4
m_michalec: calls $4
*** TURN *** [Tc 2d Qh] [Qc]
m_michalec: checks 
alhill86: bets $10
m_michalec: calls $10
*** RIVER *** [Tc 2d Qh Qc] [8d]
m_michalec: checks 
alhill86: bets $20
m_michalec: folds 
Uncalled bet ($20) returned to alhill86
alhill86 collected $32.78 from pot
alhill86: doesn't show hand 
*** SUMMARY ***
Total pot $34.50 | Rake $1.72 
Board [Tc 2d Qh Qc 8d]
Seat 1: Rafaello18 folded before Flop (didn't bet)
Seat 2: mbk88 folded before Flop (didn't bet)
Seat 3: di0d80 folded before Flop (didn't bet)
Seat 4: DonRon_AT (button) folded before Flop (didn't bet)
Seat 5: DIMAN_324 (small blind) folded before Flop
Seat 6: m_michalec (big blind) folded on the River
Seat 7: matiko09 folded before Flop (didn't bet)
Seat 8: Arjun A Raju folded before Flop (didn't bet)
Seat 9: alhill86 collected ($32.78)





PokerStars Hand #155380829939:  Hold'em No Limit ($0.25/$0.50 USD) - 2016/06/30 14:20:07 CET [2016/06/30 8:20:07 ET]
Table 'Arcturus' 9-max Seat #7 is the button
Seat 1: kourk250 ($135.78 in chips) 
Seat 2: Rafaello18 ($50 in chips) 
Seat 3: matiko09 ($50 in chips) 
Seat 5: stockbridge8 ($48.50 in chips) 
Seat 6: statistik85 ($64.22 in chips) 
Seat 7: bratbugor ($50.25 in chips) 
Seat 8: TheMinion ($50 in chips) 
Seat 9: pfunkolstar ($57.22 in chips) 
TheMinion: posts small blind $0.25
pfunkolstar: posts big blind $0.50
*** HOLE CARDS ***
Dealt to matiko09 [4c Js]
kourk250: folds 
Rafaello18: folds 
matiko09: folds 
stockbridge8: folds 
statistik85: folds 
bratbugor: folds 
TheMinion: folds 
Uncalled bet ($0.25) returned to pfunkolstar
pfunkolstar collected $0.50 from pot
pfunkolstar: doesn't show hand 
*** SUMMARY ***
Total pot $0.50 | Rake $0 
Seat 1: kourk250 folded before Flop (didn't bet)
Seat 2: Rafaello18 folded before Flop (didn't bet)
Seat 3: matiko09 folded before Flop (didn't bet)
Seat 5: stockbridge8 folded before Flop (didn't bet)
Seat 6: statistik85 folded before Flop (didn't bet)
Seat 7: bratbugor (button) folded before Flop (didn't bet)
Seat 8: TheMinion (small blind) folded before Flop
Seat 9: pfunkolstar (big blind) collected ($0.50)





PokerStars Hand #155380831238:  Hold'em No Limit ($0.50/$1.00 USD) - 2016/06/30 14:20:10 CET [2016/06/30 8:20:10 ET]
Table 'California II' 9-max Seat #9 is the button
Seat 1: Rafaello18 ($100.50 in chips) 
Seat 3: KovIFish89 ($101.02 in chips) 
Seat 4: mbk88 ($133.12 in chips) 
Seat 5: Rohitbarve ($111.02 in chips) 
Seat 6: matiko09 ($143.73 in chips) 
Seat 7: DomiVY ($77.60 in chips) 
Seat 9: di0d80 ($103.37 in chips) 
Rafaello18: posts small blind $0.50
KovIFish89: posts big blind $1
*** HOLE CARDS ***
Dealt to matiko09 [Tc Ac]
mbk88: folds 
Rohitbarve: folds 
matiko09: raises $2 to $3
DomiVY: raises $5 to $8
di0d80: folds 
ruslik_by joins the table at seat #2 
Rafaello18: folds 
KovIFish89: calls $7
matiko09: calls $5
*** FLOP *** [6d 2s 9c]
KovIFish89: checks 
matiko09: checks 
DomiVY: bets $10
KovIFish89: folds 
sanr23 leaves the table
chenconhaste joins the table at seat #8 
matiko09: folds 
Uncalled bet ($10) returned to DomiVY
DomiVY collected $23.28 from pot
DomiVY: doesn't show hand 
*** SUMMARY ***
Total pot $24.50 | Rake $1.22 
Board [6d 2s 9c]
Seat 1: Rafaello18 (small blind) folded before Flop
Seat 3: KovIFish89 (big blind) folded on the Flop
Seat 4: mbk88 folded before Flop (didn't bet)
Seat 5: Rohitbarve folded before Flop (didn't bet)
Seat 6: matiko09 folded on the Flop
Seat 7: DomiVY collected ($23.28)
Seat 9: di0d80 (button) folded before Flop (didn't bet)





PokerStars Hand #155380838233:  Hold'em No Limit ($0.50/$1.00 USD) - 2016/06/30 14:20:25 CET [2016/06/30 8:20:25 ET]
Table 'Altarf II' 9-max Seat #1 is the button
Seat 1: Rafaello18 ($100 in chips) 
Seat 2: KovIFish89 ($100 in chips) 
Seat 4: Greha999 ($78.44 in chips) 
Seat 5: DIMAN_324 ($228.74 in chips) 
Seat 6: mbk88 ($106.65 in chips) 
Seat 7: matiko09 ($103.40 in chips) 
Seat 8: DomiVY ($47.12 in chips) 
Seat 9: omanibemihum ($119.69 in chips) 
KovIFish89: posts small blind $0.50
Greha999: posts big blind $1
*** HOLE CARDS ***
Dealt to matiko09 [6d 8h]
DIMAN_324: folds 
mbk88: folds 
matiko09: folds 
DomiVY: raises $2 to $3
omanibemihum: raises $2 to $5
Rafaello18: folds 
KovIFish89: folds 
Greha999: folds 
DomiVY: calls $2
*** FLOP *** [9d 4s 4c]
DomiVY: checks 
omanibemihum: bets $7
DomiVY: folds 
Uncalled bet ($7) returned to omanibemihum
omanibemihum collected $10.92 from pot
omanibemihum: doesn't show hand 
*** SUMMARY ***
Total pot $11.50 | Rake $0.58 
Board [9d 4s 4c]
Seat 1: Rafaello18 (button) folded before Flop (didn't bet)
Seat 2: KovIFish89 (small blind) folded before Flop
Seat 4: Greha999 (big blind) folded before Flop
Seat 5: DIMAN_324 folded before Flop (didn't bet)
Seat 6: mbk88 folded before Flop (didn't bet)
Seat 7: matiko09 folded before Flop (didn't bet)
Seat 8: DomiVY folded on the Flop
Seat 9: omanibemihum collected ($10.92)





PokerStars Hand #155380838835:  Hold'em No Limit ($0.25/$0.50 USD) - 2016/06/30 14:20:26 CET [2016/06/30 8:20:26 ET]
Table 'Arcturus' 9-max Seat #8 is the button
Seat 1: kourk250 ($135.78 in chips) 
Seat 2: Rafaello18 ($50 in chips) 
Seat 3: matiko09 ($50 in chips) 
Seat 5: stockbridge8 ($48.50 in chips) 
Seat 6: statistik85 ($64.22 in chips) 
Seat 7: bratbugor ($50.25 in chips) 
Seat 8: TheMinion ($50 in chips) 
Seat 9: pfunkolstar ($57.47 in chips) 
pfunkolstar: posts small blind $0.25
kourk250: posts big blind $0.50
*** HOLE CARDS ***
Dealt to matiko09 [4s Tc]
Rafaello18: folds 
matiko09: folds 
stockbridge8: folds 
statistik85: folds 
bratbugor: raises $0.57 to $1.07
TheMinion: calls $1.07
pfunkolstar: folds 
kourk250: folds 
*** FLOP *** [7h 8d Jh]
bratbugor: checks 
TheMinion: checks 
*** TURN *** [7h 8d Jh] [3c]
bratbugor: bets $1.84
TheMinion: folds 
Uncalled bet ($1.84) returned to bratbugor
bratbugor collected $2.75 from pot
bratbugor: doesn't show hand 
*** SUMMARY ***
Total pot $2.89 | Rake $0.14 
Board [7h 8d Jh 3c]
Seat 1: kourk250 (big blind) folded before Flop
Seat 2: Rafaello18 folded before Flop (didn't bet)
Seat 3: matiko09 folded before Flop (didn't bet)
Seat 5: stockbridge8 folded before Flop (didn't bet)
Seat 6: statistik85 folded before Flop (didn't bet)
Seat 7: bratbugor collected ($2.75)
Seat 8: TheMinion (button) folded on the Turn
Seat 9: pfunkolstar (small blind) folded before Flop





PokerStars Hand #155380841344:  Hold'em No Limit ($0.50/$1.00 USD) - 2016/06/30 14:20:32 CET [2016/06/30 8:20:32 ET]
Table 'Sigrid' 9-max Seat #2 is the button
Seat 1: Greha999 ($75.58 in chips) 
Seat 2: matiko09 ($114.16 in chips) 
Seat 3: Rafaello18 ($102.20 in chips) 
Seat 4: mbk88 ($118.87 in chips) 
Seat 6: di0d80 ($112.49 in chips) 
Seat 7: arctur17 ($98.50 in chips) 
Seat 8: ruslik_by ($101 in chips) 
Seat 9: KovIFish89 ($100 in chips) 
Rafaello18: posts small blind $0.50
mbk88: posts big blind $1
*** HOLE CARDS ***
Dealt to matiko09 [Qc 6s]
di0d80: folds 
arctur17: folds 
ruslik_by: folds 
KovIFish89: folds 
Greha999: folds 
matiko09: folds 
Rafaello18: raises $1.50 to $2.50
mbk88: calls $1.50
*** FLOP *** [Jh 3h As]
Rafaello18: checks 
mbk88: checks 
*** TURN *** [Jh 3h As] [Ks]
Rafaello18: bets $3
mbk88: folds 
Uncalled bet ($3) returned to Rafaello18
Rafaello18 collected $4.75 from pot
Rafaello18: doesn't show hand 
*** SUMMARY ***
Total pot $5 | Rake $0.25 
Board [Jh 3h As Ks]
Seat 1: Greha999 folded before Flop (didn't bet)
Seat 2: matiko09 (button) folded before Flop (didn't bet)
Seat 3: Rafaello18 (small blind) collected ($4.75)
Seat 4: mbk88 (big blind) folded on the Turn
Seat 6: di0d80 folded before Flop (didn't bet)
Seat 7: arctur17 folded before Flop (didn't bet)
Seat 8: ruslik_by folded before Flop (didn't bet)
Seat 9: KovIFish89 folded before Flop (didn't bet)





PokerStars Hand #155380843748:  Hold'em No Limit ($0.50/$1.00 USD) - 2016/06/30 14:20:37 CET [2016/06/30 8:20:37 ET]
Table 'Tatjana' 9-max Seat #8 is the button
Seat 1: tipner ($117.90 in chips) 
Seat 2: DIMAN_324 ($100 in chips) 
Seat 3: Rafaello18 ($102.79 in chips) 
Seat 4: mopatron25 ($43.71 in chips) 
Seat 5: matiko09 ($123.03 in chips) 
Seat 6: mbk88 ($170.04 in chips) 
Seat 7: daigodisco ($90.19 in chips) 
Seat 8: alhill86 ($98.86 in chips) 
Seat 9: POTAPENKO700 ($233.21 in chips) 
POTAPENKO700: posts small blind $0.50
tipner: posts big blind $1
*** HOLE CARDS ***
Dealt to matiko09 [Jh Js]
DIMAN_324: folds 
Rafaello18: folds 
mopatron25: calls $1
matiko09: raises $3.50 to $4.50
mbk88: folds 
daigodisco: folds 
alhill86: folds 
POTAPENKO700: folds 
tipner: folds 
mopatron25: calls $3.50
*** FLOP *** [Jc Qs 9s]
mopatron25: bets $3
matiko09: raises $8 to $11
mopatron25: calls $8
*** TURN *** [Jc Qs 9s] [4s]
mopatron25: bets $28.21 and is all-in
matiko09: calls $28.21
*** RIVER *** [Jc Qs 9s 4s] [Tc]
*** SHOW DOWN ***
mopatron25: shows [5s 3s] (a flush, Queen high)
matiko09: shows [Jh Js] (three of a kind, Jacks)
mopatron25 collected $86.42 from pot
*** SUMMARY ***
Total pot $88.92 | Rake $2.50 
Board [Jc Qs 9s 4s Tc]
Seat 1: tipner (big blind) folded before Flop
Seat 2: DIMAN_324 folded before Flop (didn't bet)
Seat 3: Rafaello18 folded before Flop (didn't bet)
Seat 4: mopatron25 showed [5s 3s] and won ($86.42) with a flush, Queen high
Seat 5: matiko09 showed [Jh Js] and lost with three of a kind, Jacks
Seat 6: mbk88 folded before Flop (didn't bet)
Seat 7: daigodisco folded before Flop (didn't bet)
Seat 8: alhill86 (button) folded before Flop (didn't bet)
Seat 9: POTAPENKO700 (small blind) folded before Flop





PokerStars Hand #155380845365:  Hold'em No Limit ($0.50/$1.00 USD) - 2016/06/30 14:20:41 CET [2016/06/30 8:20:41 ET]
Table 'Donnera' 9-max Seat #1 is the button
Seat 1: chenconhaste ($100 in chips) 
Seat 2: robbiescrim9 ($103.45 in chips) 
Seat 3: matiko09 ($101.50 in chips) 
Seat 4: Kukuryzka ($100 in chips) 
Seat 5: tipner ($100 in chips) 
Seat 6: nickreason17 ($101 in chips) 
Seat 7: Rafaello18 ($100 in chips) 
Seat 8: ruslik_by ($114.60 in chips) 
Seat 9: Starw!nd ($107.25 in chips) 
robbiescrim9: posts small blind $0.50
matiko09: posts big blind $1
*** HOLE CARDS ***
Dealt to matiko09 [Kh Js]
Kukuryzka: folds 
tipner: raises $2 to $3
nickreason17: folds 
Rafaello18: folds 
ruslik_by: folds 
Starw!nd: folds 
chenconhaste: folds 
robbiescrim9: calls $2.50
matiko09: calls $2
*** FLOP *** [As Jh Qs]
robbiescrim9: checks 
matiko09: checks 
tipner: checks 
*** TURN *** [As Jh Qs] [6d]
robbiescrim9: checks 
matiko09: checks 
tipner: checks 
*** RIVER *** [As Jh Qs 6d] [3d]
robbiescrim9: bets $3
matiko09: calls $3
tipner: folds 
*** SHOW DOWN ***
robbiescrim9: shows [7s 3s] (a pair of Threes)
matiko09: shows [Kh Js] (a pair of Jacks)
matiko09 collected $14.25 from pot
*** SUMMARY ***
Total pot $15 | Rake $0.75 
Board [As Jh Qs 6d 3d]
Seat 1: chenconhaste (button) folded before Flop (didn't bet)
Seat 2: robbiescrim9 (small blind) showed [7s 3s] and lost with a pair of Threes
Seat 3: matiko09 (big blind) showed [Kh Js] and won ($14.25) with a pair of Jacks
Seat 4: Kukuryzka folded before Flop (didn't bet)
Seat 5: tipner folded on the River
Seat 6: nickreason17 folded before Flop (didn't bet)
Seat 7: Rafaello18 folded before Flop (didn't bet)
Seat 8: ruslik_by folded before Flop (didn't bet)
Seat 9: Starw!nd folded before Flop (didn't bet)





PokerStars Hand #155380852093:  Hold'em No Limit ($0.50/$1.00 USD) - 2016/06/30 14:20:55 CET [2016/06/30 8:20:55 ET]
Table 'Simeisa II' 9-max Seat #1 is the button
Seat 1: joooh79 ($86.30 in chips) 
Seat 2: Rafaello18 ($143.15 in chips) 
Seat 3: matiko09 ($100 in chips) 
Seat 4: Ty Nick 420 ($100 in chips) 
Seat 5: arctur17 ($77.05 in chips) 
Seat 6: ruslik_by ($100 in chips) 
Seat 7: Eriksjef93 ($38.65 in chips) 
Seat 8: DIMAN_324 ($180.87 in chips) 
Seat 9: mbk88 ($186.18 in chips) 
Rafaello18: posts small blind $0.50
matiko09: posts big blind $1
*** HOLE CARDS ***
Dealt to matiko09 [Ts 3h]
Ty Nick 420: folds 
arctur17: folds 
ruslik_by: folds 
Eriksjef93: raises $2 to $3
DIMAN_324: folds 
mbk88: folds 
joooh79: calls $3
Rafaello18: folds 
matiko09: folds 
*** FLOP *** [3d 6h 2d]
Eriksjef93: checks 
joooh79: bets $3.56
Eriksjef93: calls $3.56
*** TURN *** [3d 6h 2d] [8h]
Eriksjef93: checks 
joooh79: checks 
*** RIVER *** [3d 6h 2d 8h] [Jh]
Eriksjef93: bets $4
joooh79: raises $10 to $14
Eriksjef93: folds 
Uncalled bet ($10) returned to joooh79
joooh79 collected $21.49 from pot
*** SUMMARY ***
Total pot $22.62 | Rake $1.13 
Board [3d 6h 2d 8h Jh]
Seat 1: joooh79 (button) collected ($21.49)
Seat 2: Rafaello18 (small blind) folded before Flop
Seat 3: matiko09 (big blind) folded before Flop
Seat 4: Ty Nick 420 folded before Flop (didn't bet)
Seat 5: arctur17 folded before Flop (didn't bet)
Seat 6: ruslik_by folded before Flop (didn't bet)
Seat 7: Eriksjef93 folded on the River
Seat 8: DIMAN_324 folded before Flop (didn't bet)
Seat 9: mbk88 folded before Flop (didn't bet)





PokerStars Hand #155380852473:  Hold'em No Limit ($0.50/$1.00 USD) - 2016/06/30 14:20:56 CET [2016/06/30 8:20:56 ET]
Table 'Borrelly II' 9-max Seat #5 is the button
Seat 1: Rafaello18 ($117.07 in chips) 
Seat 2: mbk88 ($103.50 in chips) 
Seat 3: di0d80 ($198 in chips) 
Seat 4: DonRon_AT ($40.19 in chips) 
Seat 5: DIMAN_324 ($100 in chips) 
Seat 6: m_michalec ($161.61 in chips) 
Seat 7: matiko09 ($177.36 in chips) 
Seat 8: Arjun A Raju ($135.42 in chips) 
Seat 9: alhill86 ($89.96 in chips) 
m_michalec: posts small blind $0.50
matiko09: posts big blind $1
*** HOLE CARDS ***
Dealt to matiko09 [Ah 5s]
Arjun A Raju: folds 
alhill86: folds 
Rafaello18: folds 
mbk88: folds 
di0d80: folds 
DonRon_AT: folds 
DIMAN_324: folds 
m_michalec: folds 
Uncalled bet ($0.50) returned to matiko09
matiko09 collected $1 from pot
matiko09: doesn't show hand 
*** SUMMARY ***
Total pot $1 | Rake $0 
Seat 1: Rafaello18 folded before Flop (didn't bet)
Seat 2: mbk88 folded before Flop (didn't bet)
Seat 3: di0d80 folded before Flop (didn't bet)
Seat 4: DonRon_AT folded before Flop (didn't bet)
Seat 5: DIMAN_324 (button) folded before Flop (didn't bet)
Seat 6: m_michalec (small blind) folded before Flop
Seat 7: matiko09 (big blind) collected ($1)
Seat 8: Arjun A Raju folded before Flop (didn't bet)
Seat 9: alhill86 folded before Flop (didn't bet)





PokerStars Hand #155380861974:  Hold'em No Limit (€0.25/€0.50 EUR) - 2016/06/30 14:21:17 CET [2016/06/30 8:21:17 ET]
Table 'Vibeke II' 9-max Seat #5 is the button
Seat 4: acelacat111 (€23.32 in chips) 
Seat 5: mazefaka007 (€50 in chips) 
Seat 6: Kukuryzka (€50 in chips) 
Seat 7: matiko09 (€50 in chips) 
Kukuryzka: posts small blind €0.25
matiko09: posts big blind €0.50
*** HOLE CARDS ***
Dealt to matiko09 [Qc Ah]
acelacat111: folds 
mazefaka007: raises €0.55 to €1.05
Kukuryzka: raises €2.95 to €4
matiko09: raises €5 to €9
mazefaka007: folds 
Kukuryzka: calls €5
*** FLOP *** [5c 9h 7s]
Kukuryzka: checks 
matiko09: bets €7
Kukuryzka: folds 
Uncalled bet (€7) returned to matiko09
matiko09 collected €18.35 from pot
matiko09: doesn't show hand 
*** SUMMARY ***
Total pot €19.05 | Rake €0.70 
Board [5c 9h 7s]
Seat 4: acelacat111 folded before Flop (didn't bet)
Seat 5: mazefaka007 (button) folded before Flop
Seat 6: Kukuryzka (small blind) folded on the Flop
Seat 7: matiko09 (big blind) collected (€18.35)





PokerStars Hand #155380864631:  Hold'em No Limit ($0.50/$1.00 USD) - 2016/06/30 14:21:23 CET [2016/06/30 8:21:23 ET]
Table 'Altarf II' 9-max Seat #2 is the button
Seat 1: Rafaello18 ($100 in chips) 
Seat 2: KovIFish89 ($100 in chips) 
Seat 4: Greha999 ($77.44 in chips) 
Seat 5: DIMAN_324 ($228.74 in chips) 
Seat 6: mbk88 ($106.65 in chips) 
Seat 7: matiko09 ($103.40 in chips) 
Seat 8: DomiVY ($42.12 in chips) 
Seat 9: omanibemihum ($125.61 in chips) 
Greha999: posts small blind $0.50
DIMAN_324: posts big blind $1
*** HOLE CARDS ***
Dealt to matiko09 [Td 2h]
mbk88: raises $2 to $3
matiko09: folds 
DomiVY: folds 
omanibemihum: calls $3
Rafaello18: folds 
KovIFish89: calls $3
Greha999: folds 
DIMAN_324: folds 
*** FLOP *** [5d 5h 2d]
mbk88: bets $10
omanibemihum: calls $10
KovIFish89: folds 
*** TURN *** [5d 5h 2d] [2s]
mbk88: checks 
omanibemihum: bets $14
mbk88: calls $14
*** RIVER *** [5d 5h 2d 2s] [3h]
mbk88: checks 
omanibemihum: bets $98.61 and is all-in
mbk88: folds 
Uncalled bet ($98.61) returned to omanibemihum
omanibemihum collected $56 from pot
omanibemihum: doesn't show hand 
*** SUMMARY ***
Total pot $58.50 | Rake $2.50 
Board [5d 5h 2d 2s 3h]
Seat 1: Rafaello18 folded before Flop (didn't bet)
Seat 2: KovIFish89 (button) folded on the Flop
Seat 4: Greha999 (small blind) folded before Flop
Seat 5: DIMAN_324 (big blind) folded before Flop
Seat 6: mbk88 folded on the River
Seat 7: matiko09 folded before Flop (didn't bet)
Seat 8: DomiVY folded before Flop (didn't bet)
Seat 9: omanibemihum collected ($56)





PokerStars Hand #155380866561:  Hold'em No Limit ($0.50/$1.00 USD) - 2016/06/30 14:21:27 CET [2016/06/30 8:21:27 ET]
Table 'Borrelly II' 9-max Seat #6 is the button
Seat 1: Rafaello18 ($117.07 in chips) 
Seat 2: mbk88 ($103.50 in chips) 
Seat 3: di0d80 ($198 in chips) 
Seat 4: DonRon_AT ($40.19 in chips) 
Seat 5: DIMAN_324 ($100 in chips) 
Seat 6: m_michalec ($161.11 in chips) 
Seat 7: matiko09 ($177.86 in chips) 
Seat 8: Arjun A Raju ($135.42 in chips) 
Seat 9: alhill86 ($89.96 in chips) 
matiko09: posts small blind $0.50
Arjun A Raju: posts big blind $1
*** HOLE CARDS ***
Dealt to matiko09 [2c 7h]
alhill86: folds 
Rafaello18: folds 
mbk88: folds 
di0d80: folds 
DonRon_AT: folds 
DIMAN_324: raises $1.40 to $2.40
m_michalec: calls $2.40
matiko09: folds 
Arjun A Raju: folds 
*** FLOP *** [5d 9h Ks]
DIMAN_324: bets $3
m_michalec: folds 
Uncalled bet ($3) returned to DIMAN_324
DIMAN_324 collected $5.98 from pot
DIMAN_324: doesn't show hand 
*** SUMMARY ***
Total pot $6.30 | Rake $0.32 
Board [5d 9h Ks]
Seat 1: Rafaello18 folded before Flop (didn't bet)
Seat 2: mbk88 folded before Flop (didn't bet)
Seat 3: di0d80 folded before Flop (didn't bet)
Seat 4: DonRon_AT folded before Flop (didn't bet)
Seat 5: DIMAN_324 collected ($5.98)
Seat 6: m_michalec (button) folded on the Flop
Seat 7: matiko09 (small blind) folded before Flop
Seat 8: Arjun A Raju (big blind) folded before Flop
Seat 9: alhill86 folded before Flop (didn't bet)





PokerStars Hand #155380867662:  Hold'em No Limit ($0.50/$1.00 USD) - 2016/06/30 14:21:29 CET [2016/06/30 8:21:29 ET]
Table 'Sigrid' 9-max Seat #3 is the button
Seat 1: Greha999 ($75.58 in chips) 
Seat 2: matiko09 ($114.16 in chips) 
Seat 3: Rafaello18 ($104.45 in chips) 
Seat 4: mbk88 ($116.37 in chips) 
Seat 7: arctur17 ($98.50 in chips) 
Seat 8: ruslik_by ($101 in chips) 
Seat 9: KovIFish89 ($100 in chips) 
mbk88: posts small blind $0.50
di0d80: is sitting out 
arctur17: posts big blind $1
*** HOLE CARDS ***
Dealt to matiko09 [3h 3c]
ruslik_by: folds 
KovIFish89: folds 
Greha999: folds 
matiko09: raises $1.50 to $2.50
Rafaello18: calls $2.50
mbk88: folds 
arctur17: folds 
*** FLOP *** [As Qc 5s]
matiko09: checks 
Rafaello18: checks 
*** TURN *** [As Qc 5s] [8c]
matiko09: checks 
Rafaello18: bets $4
matiko09: folds 
Uncalled bet ($4) returned to Rafaello18
Rafaello18 collected $6.18 from pot
Rafaello18: doesn't show hand 
*** SUMMARY ***
Total pot $6.50 | Rake $0.32 
Board [As Qc 5s 8c]
Seat 1: Greha999 folded before Flop (didn't bet)
Seat 2: matiko09 folded on the Turn
Seat 3: Rafaello18 (button) collected ($6.18)
Seat 4: mbk88 (small blind) folded before Flop
Seat 7: arctur17 (big blind) folded before Flop
Seat 8: ruslik_by folded before Flop (didn't bet)
Seat 9: KovIFish89 folded before Flop (didn't bet)





PokerStars Hand #155380871564:  Hold'em No Limit ($0.50/$1.00 USD) - 2016/06/30 14:21:37 CET [2016/06/30 8:21:37 ET]
Table 'Tatjana' 9-max Seat #9 is the button
Seat 1: tipner ($116.90 in chips) 
Seat 2: DIMAN_324 ($100 in chips) 
Seat 3: Rafaello18 ($102.79 in chips) 
Seat 4: mopatron25 ($86.42 in chips) 
Seat 5: matiko09 ($100 in chips) 
Seat 6: mbk88 ($170.04 in chips) 
Seat 7: daigodisco ($90.19 in chips) 
Seat 8: alhill86 ($98.86 in chips) 
Seat 9: POTAPENKO700 ($232.71 in chips) 
tipner: posts small blind $0.50
DIMAN_324: posts big blind $1
*** HOLE CARDS ***
Dealt to matiko09 [9h 7h]
Rafaello18: folds 
mopatron25: folds 
matiko09: folds 
mbk88: folds 
daigodisco: folds 
alhill86: folds 
POTAPENKO700: raises $1.50 to $2.50
tipner: folds 
DIMAN_324: calls $1.50
*** FLOP *** [5d 8c Qd]
DIMAN_324: checks 
POTAPENKO700: bets $3.47
DIMAN_324: folds 
Uncalled bet ($3.47) returned to POTAPENKO700
POTAPENKO700 collected $5.22 from pot
POTAPENKO700: doesn't show hand 
*** SUMMARY ***
Total pot $5.50 | Rake $0.28 
Board [5d 8c Qd]
Seat 1: tipner (small blind) folded before Flop
Seat 2: DIMAN_324 (big blind) folded on the Flop
Seat 3: Rafaello18 folded before Flop (didn't bet)
Seat 4: mopatron25 folded before Flop (didn't bet)
Seat 5: matiko09 folded before Flop (didn't bet)
Seat 6: mbk88 folded before Flop (didn't bet)
Seat 7: daigodisco folded before Flop (didn't bet)
Seat 8: alhill86 folded before Flop (didn't bet)
Seat 9: POTAPENKO700 (button) collected ($5.22)





PokerStars Hand #155380877078:  Hold'em No Limit ($0.50/$1.00 USD) - 2016/06/30 14:21:50 CET [2016/06/30 8:21:50 ET]
Table 'Asmodeus' 9-max Seat #3 is the button
Seat 1: scollop ($233.02 in chips) 
Seat 2: nickreason17 ($100 in chips) 
Seat 3: matiko09 ($117.24 in chips) 
Seat 4: DIMAN_324 ($100 in chips) 
Seat 6: koutani7 ($83.53 in chips) 
Seat 8: Rafaello18 ($172.57 in chips) 
DIMAN_324: posts small blind $0.50
koutani7: posts big blind $1
aaronzzr: sits out 
mbk88: sits out 
*** HOLE CARDS ***
Dealt to matiko09 [As 7h]
Rafaello18: folds 
scollop has timed out
scollop: folds 
nickreason17: folds 
matiko09: raises $1.27 to $2.27
DIMAN_324: raises $6.23 to $8.50
koutani7: folds 
matiko09: folds 
Uncalled bet ($6.23) returned to DIMAN_324
DIMAN_324 collected $5.54 from pot
DIMAN_324: doesn't show hand 
*** SUMMARY ***
Total pot $5.54 | Rake $0 
Seat 1: scollop folded before Flop (didn't bet)
Seat 2: nickreason17 folded before Flop (didn't bet)
Seat 3: matiko09 (button) folded before Flop
Seat 4: DIMAN_324 (small blind) collected ($5.54)
Seat 6: koutani7 (big blind) folded before Flop
Seat 8: Rafaello18 folded before Flop (didn't bet)





PokerStars Hand #155380881317:  Hold'em No Limit ($0.25/$0.50 USD) - 2016/06/30 14:21:59 CET [2016/06/30 8:21:59 ET]
Table 'Arcturus' 9-max Seat #9 is the button
Seat 1: kourk250 ($135.28 in chips) 
Seat 2: Rafaello18 ($50 in chips) 
Seat 3: matiko09 ($50 in chips) 
Seat 5: stockbridge8 ($48.50 in chips) 
Seat 6: statistik85 ($64.22 in chips) 
Seat 7: bratbugor ($51.93 in chips) 
Seat 8: TheMinion ($50 in chips) 
Seat 9: pfunkolstar ($57.22 in chips) 
kourk250: posts small blind $0.25
Rafaello18: posts big blind $0.50
*** HOLE CARDS ***
Dealt to matiko09 [Ts 9d]
matiko09: folds 
stockbridge8: folds 
statistik85: folds 
bratbugor: folds 
TheMinion: folds 
pfunkolstar: raises $0.50 to $1
kourk250: calls $0.75
Rafaello18: raises $4 to $5
pfunkolstar: calls $4
kourk250: calls $4
*** FLOP *** [4d Jd 8h]
kourk250: checks 
Rafaello18: bets $10
pfunkolstar: raises $42.22 to $52.22 and is all-in
kourk250: folds 
Rafaello18: calls $35 and is all-in
Uncalled bet ($7.22) returned to pfunkolstar
*** FIRST TURN *** [4d Jd 8h] [5d]
*** FIRST RIVER *** [4d Jd 8h 5d] [6c]
*** SECOND TURN *** [4d Jd 8h] [6s]
*** SECOND RIVER *** [4d Jd 8h 6s] [3s]
*** FIRST SHOW DOWN ***
Rafaello18: shows [Kd Ks] (a pair of Kings)
pfunkolstar: shows [8d 6d] (a flush, Jack high)
pfunkolstar collected $51.50 from pot
*** SECOND SHOW DOWN ***
Rafaello18: shows [Kd Ks] (a pair of Kings)
pfunkolstar: shows [8d 6d] (two pair, Eights and Sixes)
pfunkolstar collected $51.50 from pot
*** SUMMARY ***
Total pot $105 | Rake $2 
Hand was run twice
FIRST Board [4d Jd 8h 5d 6c]
SECOND Board [4d Jd 8h 6s 3s]
Seat 1: kourk250 (small blind) folded on the Flop
Seat 2: Rafaello18 (big blind) showed [Kd Ks] and lost with a pair of Kings, and lost with a pair of Kings
Seat 3: matiko09 folded before Flop (didn't bet)
Seat 5: stockbridge8 folded before Flop (didn't bet)
Seat 6: statistik85 folded before Flop (didn't bet)
Seat 7: bratbugor folded before Flop (didn't bet)
Seat 8: TheMinion folded before Flop (didn't bet)
Seat 9: pfunkolstar (button) showed [8d 6d] and won ($51.50) with a flush, Jack high, and won ($51.50) with two pair, Eights and Sixes





PokerStars Hand #155380885262:  Hold'em No Limit ($0.50/$1.00 USD) - 2016/06/30 14:22:07 CET [2016/06/30 8:22:07 ET]
Table 'California II' 9-max Seat #1 is the button
Seat 1: Rafaello18 ($100 in chips) 
Seat 3: KovIFish89 ($100 in chips) 
Seat 5: Rohitbarve ($111.02 in chips) 
Seat 6: matiko09 ($135.73 in chips) 
Seat 7: DomiVY ($92.88 in chips) 
Seat 9: di0d80 ($103.37 in chips) 
ruslik_by will be allowed to play after the button
KovIFish89: posts small blind $0.50
mbk88: is sitting out 
Rohitbarve: posts big blind $1
chenconhaste: sits out 
*** HOLE CARDS ***
Dealt to matiko09 [Qd 9h]
matiko09: folds 
DomiVY: folds 
di0d80: folds 
Rafaello18: folds 
KovIFish89: folds 
Uncalled bet ($0.50) returned to Rohitbarve
Rohitbarve collected $1 from pot
Rohitbarve: doesn't show hand 
*** SUMMARY ***
Total pot $1 | Rake $0 
Seat 1: Rafaello18 (button) folded before Flop (didn't bet)
Seat 3: KovIFish89 (small blind) folded before Flop
Seat 5: Rohitbarve (big blind) collected ($1)
Seat 6: matiko09 folded before Flop (didn't bet)
Seat 7: DomiVY folded before Flop (didn't bet)
Seat 9: di0d80 folded before Flop (didn't bet)





PokerStars Hand #155380889455:  Hold'em No Limit ($0.50/$1.00 USD) - 2016/06/30 14:22:16 CET [2016/06/30 8:22:16 ET]
Table 'Simeisa II' 9-max Seat #2 is the button
Seat 1: joooh79 ($97.23 in chips) 
Seat 2: Rafaello18 ($142.65 in chips) 
Seat 3: matiko09 ($100 in chips) 
Seat 4: Ty Nick 420 ($100 in chips) 
Seat 5: arctur17 ($77.05 in chips) 
Seat 6: ruslik_by ($100 in chips) 
Seat 7: Eriksjef93 ($28.09 in chips) 
Seat 8: DIMAN_324 ($180.87 in chips) 
Seat 9: mbk88 ($186.18 in chips) 
matiko09: posts small blind $0.50
Ty Nick 420: posts big blind $1
*** HOLE CARDS ***
Dealt to matiko09 [Ah 5s]
arctur17: folds 
ruslik_by: folds 
Eriksjef93: raises $2 to $3
DIMAN_324: folds 
mbk88: folds 
joooh79: folds 
Rafaello18: folds 
matiko09: folds 
Ty Nick 420: folds 
Uncalled bet ($2) returned to Eriksjef93
Eriksjef93 collected $2.50 from pot
Eriksjef93: doesn't show hand 
*** SUMMARY ***
Total pot $2.50 | Rake $0 
Seat 1: joooh79 folded before Flop (didn't bet)
Seat 2: Rafaello18 (button) folded before Flop (didn't bet)
Seat 3: matiko09 (small blind) folded before Flop
Seat 4: Ty Nick 420 (big blind) folded before Flop
Seat 5: arctur17 folded before Flop (didn't bet)
Seat 6: ruslik_by folded before Flop (didn't bet)
Seat 7: Eriksjef93 collected ($2.50)
Seat 8: DIMAN_324 folded before Flop (didn't bet)
Seat 9: mbk88 folded before Flop (didn't bet)





PokerStars Hand #155380890330:  Hold'em No Limit ($0.50/$1.00 USD) - 2016/06/30 14:22:18 CET [2016/06/30 8:22:18 ET]
Table 'Donnera' 9-max Seat #2 is the button
Seat 1: chenconhaste ($100 in chips) 
Seat 2: robbiescrim9 ($97.45 in chips) 
Seat 3: matiko09 ($109.75 in chips) 
Seat 4: Kukuryzka ($100 in chips) 
Seat 5: tipner ($100 in chips) 
Seat 6: nickreason17 ($101 in chips) 
Seat 7: Rafaello18 ($100 in chips) 
Seat 8: ruslik_by ($114.60 in chips) 
Seat 9: Starw!nd ($107.25 in chips) 
matiko09: posts small blind $0.50
Kukuryzka: posts big blind $1
*** HOLE CARDS ***
Dealt to matiko09 [6d 5s]
tipner: folds 
nickreason17: folds 
Rafaello18: folds 
ruslik_by: folds 
Starw!nd: folds 
chenconhaste: raises $1.25 to $2.25
robbiescrim9: folds 
matiko09: folds 
Kukuryzka: raises $6.25 to $8.50
chenconhaste: calls $6.25
*** FLOP *** [Kc 3d 9s]
Kukuryzka: bets $5.48
chenconhaste: calls $5.48
*** TURN *** [Kc 3d 9s] [7d]
Kukuryzka: checks 
chenconhaste: bets $11
Kukuryzka: folds 
Uncalled bet ($11) returned to chenconhaste
chenconhaste collected $27.04 from pot
*** SUMMARY ***
Total pot $28.46 | Rake $1.42 
Board [Kc 3d 9s 7d]
Seat 1: chenconhaste collected ($27.04)
Seat 2: robbiescrim9 (button) folded before Flop (didn't bet)
Seat 3: matiko09 (small blind) folded before Flop
Seat 4: Kukuryzka (big blind) folded on the Turn
Seat 5: tipner folded before Flop (didn't bet)
Seat 6: nickreason17 folded before Flop (didn't bet)
Seat 7: Rafaello18 folded before Flop (didn't bet)
Seat 8: ruslik_by folded before Flop (didn't bet)
Seat 9: Starw!nd folded before Flop (didn't bet)





PokerStars Hand #155380893482:  Hold'em No Limit ($0.50/$1.00 USD) - 2016/06/30 14:22:25 CET [2016/06/30 8:22:25 ET]
Table 'Sigrid' 9-max Seat #4 is the button
Seat 1: Greha999 ($75.58 in chips) 
Seat 2: matiko09 ($111.66 in chips) 
Seat 3: Rafaello18 ($108.13 in chips) 
Seat 4: mbk88 ($115.87 in chips) 
Seat 7: arctur17 ($97.50 in chips) 
Seat 8: ruslik_by ($101 in chips) 
Seat 9: KovIFish89 ($100 in chips) 
arctur17: posts small blind $0.50
ruslik_by: posts big blind $1
*** HOLE CARDS ***
Dealt to matiko09 [Qs Td]
KovIFish89: folds 
Greha999: folds 
matiko09: folds 
Rafaello18: folds 
mbk88: folds 
arctur17: folds 
Uncalled bet ($0.50) returned to ruslik_by
ruslik_by collected $1 from pot
ruslik_by: doesn't show hand 
*** SUMMARY ***
Total pot $1 | Rake $0 
Seat 1: Greha999 folded before Flop (didn't bet)
Seat 2: matiko09 folded before Flop (didn't bet)
Seat 3: Rafaello18 folded before Flop (didn't bet)
Seat 4: mbk88 (button) folded before Flop (didn't bet)
Seat 7: arctur17 (small blind) folded before Flop
Seat 8: ruslik_by (big blind) collected ($1)
Seat 9: KovIFish89 folded before Flop (didn't bet)





PokerStars Hand #155380894954:  Hold'em No Limit ($0.50/$1.00 USD) - 2016/06/30 14:22:28 CET [2016/06/30 8:22:28 ET]
Table 'California II' 9-max Seat #3 is the button
Seat 1: Rafaello18 ($100 in chips) 
Seat 3: KovIFish89 ($100 in chips) 
Seat 5: Rohitbarve ($111.52 in chips) 
Seat 6: matiko09 ($135.73 in chips) 
Seat 7: DomiVY ($92.88 in chips) 
Seat 9: di0d80 ($103.37 in chips) 
Rohitbarve: posts small blind $0.50
matiko09: posts big blind $1
chenconhaste: sits out 
ruslik_by: sits out 
*** HOLE CARDS ***
Dealt to matiko09 [Qh 9s]
DomiVY: folds 
di0d80: folds 
Rafaello18: folds 
KovIFish89 has timed out
KovIFish89: folds 
Rohitbarve: raises $2 to $3
matiko09: folds 
Uncalled bet ($2) returned to Rohitbarve
Rohitbarve collected $2 from pot
Rohitbarve: doesn't show hand 
*** SUMMARY ***
Total pot $2 | Rake $0 
Seat 1: Rafaello18 folded before Flop (didn't bet)
Seat 3: KovIFish89 (button) folded before Flop (didn't bet)
Seat 5: Rohitbarve (small blind) collected ($2)
Seat 6: matiko09 (big blind) folded before Flop
Seat 7: DomiVY folded before Flop (didn't bet)
Seat 9: di0d80 folded before Flop (didn't bet)





PokerStars Hand #155380896057:  Hold'em No Limit ($0.50/$1.00 USD) - 2016/06/30 14:22:30 CET [2016/06/30 8:22:30 ET]
Table 'Asmodeus' 9-max Seat #4 is the button
Seat 2: nickreason17 ($100 in chips) 
Seat 3: matiko09 ($114.97 in chips) 
Seat 4: DIMAN_324 ($103.27 in chips) 
Seat 6: koutani7 ($82.53 in chips) 
Seat 7: aaronzzr ($134.33 in chips) 
Seat 8: Rafaello18 ($172.57 in chips) 
sanr23 will be allowed to play after the button
koutani7: posts small blind $0.50
aaronzzr: posts big blind $1
mbk88: sits out 
*** HOLE CARDS ***
Dealt to matiko09 [Jd Ah]
Rafaello18: folds 
nickreason17: folds 
matiko09: raises $1.50 to $2.50
DIMAN_324: folds 
koutani7: folds 
aaronzzr: folds 
Uncalled bet ($1.50) returned to matiko09
matiko09 collected $2.50 from pot
matiko09: doesn't show hand 
*** SUMMARY ***
Total pot $2.50 | Rake $0 
Seat 2: nickreason17 folded before Flop (didn't bet)
Seat 3: matiko09 collected ($2.50)
Seat 4: DIMAN_324 (button) folded before Flop (didn't bet)
Seat 6: koutani7 (small blind) folded before Flop
Seat 7: aaronzzr (big blind) folded before Flop
Seat 8: Rafaello18 folded before Flop (didn't bet)





PokerStars Hand #155380900724:  Hold'em No Limit ($0.50/$1.00 USD) - 2016/06/30 14:22:40 CET [2016/06/30 8:22:40 ET]
Table 'Altarf II' 9-max Seat #4 is the button
Seat 1: Rafaello18 ($100 in chips) 
Seat 2: KovIFish89 ($100 in chips) 
Seat 4: Greha999 ($76.94 in chips) 
Seat 5: DIMAN_324 ($227.74 in chips) 
Seat 6: mbk88 ($100 in chips) 
Seat 7: matiko09 ($103.40 in chips) 
Seat 8: DomiVY ($42.12 in chips) 
Seat 9: omanibemihum ($154.61 in chips) 
DIMAN_324: posts small blind $0.50
mbk88: posts big blind $1
sanr23: sits out 
*** HOLE CARDS ***
Dealt to matiko09 [6h 4h]
matiko09: folds 
DomiVY: folds 
omanibemihum: folds 
Rafaello18: folds 
KovIFish89: raises $2 to $3
Greha999: calls $3
DIMAN_324: folds 
mbk88: folds 
*** FLOP *** [8c 6c 7s]
KovIFish89: bets $4.74
Greha999: raises $8.26 to $13
KovIFish89: calls $8.26
*** TURN *** [8c 6c 7s] [Jd]
KovIFish89: checks 
Greha999: bets $32
KovIFish89: raises $32 to $64
Greha999: calls $28.94 and is all-in
Uncalled bet ($3.06) returned to KovIFish89
*** RIVER *** [8c 6c 7s Jd] [5h]
*** SHOW DOWN ***
KovIFish89: shows [Jc Jh] (three of a kind, Jacks)
Greha999: shows [9d Ts] (a straight, Seven to Jack)
Greha999 collected $152.88 from pot
*** SUMMARY ***
Total pot $155.38 | Rake $2.50 
Board [8c 6c 7s Jd 5h]
Seat 1: Rafaello18 folded before Flop (didn't bet)
Seat 2: KovIFish89 showed [Jc Jh] and lost with three of a kind, Jacks
Seat 4: Greha999 (button) showed [9d Ts] and won ($152.88) with a straight, Seven to Jack
Seat 5: DIMAN_324 (small blind) folded before Flop
Seat 6: mbk88 (big blind) folded before Flop
Seat 7: matiko09 folded before Flop (didn't bet)
Seat 8: DomiVY folded before Flop (didn't bet)
Seat 9: omanibemihum folded before Flop (didn't bet)





PokerStars Hand #155380900934:  Hold'em No Limit ($0.50/$1.00 USD) - 2016/06/30 14:22:41 CET [2016/06/30 8:22:41 ET]
Table 'Borrelly II' 9-max Seat #7 is the button
Seat 1: Rafaello18 ($117.07 in chips) 
Seat 2: mbk88 ($103.50 in chips) 
Seat 3: di0d80 ($198 in chips) 
Seat 4: DonRon_AT ($40.19 in chips) 
Seat 5: DIMAN_324 ($103.58 in chips) 
Seat 6: m_michalec ($158.71 in chips) 
Seat 7: matiko09 ($177.36 in chips) 
Seat 8: Arjun A Raju ($134.42 in chips) 
Seat 9: alhill86 ($89.96 in chips) 
Arjun A Raju: posts small blind $0.50
alhill86: posts big blind $1
*** HOLE CARDS ***
Dealt to matiko09 [3h 4d]
Rafaello18: folds 
mbk88: raises $2 to $3
di0d80: calls $3
DonRon_AT: folds 
DIMAN_324: folds 
m_michalec: calls $3
matiko09: folds 
Arjun A Raju: folds 
alhill86: calls $2
*** FLOP *** [2h 3d Ad]
alhill86: checks 
mbk88: bets $6
di0d80: calls $6
m_michalec: folds 
alhill86: folds 
*** TURN *** [2h 3d Ad] [4s]
mbk88: bets $23
di0d80: folds 
Uncalled bet ($23) returned to mbk88
mbk88 collected $23.28 from pot
mbk88: doesn't show hand 
*** SUMMARY ***
Total pot $24.50 | Rake $1.22 
Board [2h 3d Ad 4s]
Seat 1: Rafaello18 folded before Flop (didn't bet)
Seat 2: mbk88 collected ($23.28)
Seat 3: di0d80 folded on the Turn
Seat 4: DonRon_AT folded before Flop (didn't bet)
Seat 5: DIMAN_324 folded before Flop (didn't bet)
Seat 6: m_michalec folded on the Flop
Seat 7: matiko09 (button) folded before Flop (didn't bet)
Seat 8: Arjun A Raju (small blind) folded before Flop
Seat 9: alhill86 (big blind) folded on the Flop





PokerStars Hand #155380901987:  Hold'em No Limit ($0.50/$1.00 USD) - 2016/06/30 14:22:43 CET [2016/06/30 8:22:43 ET]
Table 'Simeisa II' 9-max Seat #3 is the button
Seat 1: joooh79 ($97.23 in chips) 
Seat 2: Rafaello18 ($142.65 in chips) 
Seat 3: matiko09 ($100 in chips) 
Seat 4: Ty Nick 420 ($100 in chips) 
Seat 5: arctur17 ($77.05 in chips) 
Seat 6: ruslik_by ($100 in chips) 
Seat 7: Eriksjef93 ($29.59 in chips) 
Seat 8: DIMAN_324 ($180.87 in chips) 
Seat 9: mbk88 ($186.18 in chips) 
Ty Nick 420: posts small blind $0.50
arctur17: posts big blind $1
*** HOLE CARDS ***
Dealt to matiko09 [Qh 6s]
ruslik_by: folds 
Eriksjef93: calls $1
DIMAN_324: folds 
mbk88: folds 
joooh79: folds 
Rafaello18: folds 
matiko09: folds 
Ty Nick 420: folds 
arctur17: checks 
*** FLOP *** [As 6h 3d]
arctur17: checks 
Eriksjef93: checks 
*** TURN *** [As 6h 3d] [Jd]
arctur17: checks 
Eriksjef93: checks 
*** RIVER *** [As 6h 3d Jd] [2d]
arctur17: checks 
Eriksjef93: checks 
*** SHOW DOWN ***
arctur17: shows [Jh 4d] (a pair of Jacks)
Eriksjef93: mucks hand 
arctur17 collected $2.38 from pot
*** SUMMARY ***
Total pot $2.50 | Rake $0.12 
Board [As 6h 3d Jd 2d]
Seat 1: joooh79 folded before Flop (didn't bet)
Seat 2: Rafaello18 folded before Flop (didn't bet)
Seat 3: matiko09 (button) folded before Flop (didn't bet)
Seat 4: Ty Nick 420 (small blind) folded before Flop
Seat 5: arctur17 (big blind) showed [Jh 4d] and won ($2.38) with a pair of Jacks
Seat 6: ruslik_by folded before Flop (didn't bet)
Seat 7: Eriksjef93 mucked [5h Kc]
Seat 8: DIMAN_324 folded before Flop (didn't bet)
Seat 9: mbk88 folded before Flop (didn't bet)





PokerStars Hand #155380902153:  Hold'em No Limit ($0.50/$1.00 USD) - 2016/06/30 14:22:43 CET [2016/06/30 8:22:43 ET]
Table 'Tatjana' 9-max Seat #1 is the button
Seat 1: tipner ($116.40 in chips) 
Seat 2: DIMAN_324 ($100 in chips) 
Seat 3: Rafaello18 ($102.79 in chips) 
Seat 4: mopatron25 ($86.42 in chips) 
Seat 5: matiko09 ($100 in chips) 
Seat 6: mbk88 ($170.04 in chips) 
Seat 7: daigodisco ($90.19 in chips) 
Seat 8: alhill86 ($98.86 in chips) 
Seat 9: POTAPENKO700 ($235.43 in chips) 
DIMAN_324: posts small blind $0.50
Rafaello18: posts big blind $1
*** HOLE CARDS ***
Dealt to matiko09 [4s As]
mopatron25: calls $1
matiko09: folds 
mbk88: folds 
daigodisco has timed out
daigodisco: folds 
alhill86: folds 
POTAPENKO700: folds 
tipner: folds 
DIMAN_324: folds 
Rafaello18: checks 
*** FLOP *** [Qs Qd 6h]
Rafaello18: checks 
mopatron25: bets $2
Rafaello18: folds 
Uncalled bet ($2) returned to mopatron25
daigodisco leaves the table
mopatron25 collected $2.38 from pot
mopatron25: doesn't show hand 
*** SUMMARY ***
Total pot $2.50 | Rake $0.12 
Board [Qs Qd 6h]
Seat 1: tipner (button) folded before Flop (didn't bet)
Seat 2: DIMAN_324 (small blind) folded before Flop
Seat 3: Rafaello18 (big blind) folded on the Flop
Seat 4: mopatron25 collected ($2.38)
Seat 5: matiko09 folded before Flop (didn't bet)
Seat 6: mbk88 folded before Flop (didn't bet)
Seat 7: daigodisco folded before Flop (didn't bet)
Seat 8: alhill86 folded before Flop (didn't bet)
Seat 9: POTAPENKO700 folded before Flop (didn't bet)





PokerStars Hand #155380904225:  Hold'em No Limit ($0.50/$1.00 USD) - 2016/06/30 14:22:48 CET [2016/06/30 8:22:48 ET]
Table 'Sigrid' 9-max Seat #7 is the button
Seat 1: Greha999 ($75.58 in chips) 
Seat 2: matiko09 ($111.66 in chips) 
Seat 3: Rafaello18 ($108.13 in chips) 
Seat 4: mbk88 ($115.87 in chips) 
Seat 7: arctur17 ($97 in chips) 
Seat 8: ruslik_by ($101.50 in chips) 
Seat 9: KovIFish89 ($100 in chips) 
ruslik_by: posts small blind $0.50
KovIFish89: posts big blind $1
*** HOLE CARDS ***
Dealt to matiko09 [7d 6h]
Greha999: raises $1 to $2
DIMAN_324 leaves the table
matiko09: folds 
Rafaello18: folds 
mbk88: folds 
arctur17: folds 
chenconhaste joins the table at seat #5 
ruslik_by: folds 
KovIFish89: calls $1
*** FLOP *** [Jd 3c 8d]
KovIFish89: checks 
Greha999: bets $2
KovIFish89: raises $5 to $7
Greha999: folds 
Uncalled bet ($5) returned to KovIFish89
KovIFish89 collected $8.08 from pot
KovIFish89: doesn't show hand 
*** SUMMARY ***
Total pot $8.50 | Rake $0.42 
Board [Jd 3c 8d]
Seat 1: Greha999 folded on the Flop
Seat 2: matiko09 folded before Flop (didn't bet)
Seat 3: Rafaello18 folded before Flop (didn't bet)
Seat 4: mbk88 folded before Flop (didn't bet)
Seat 7: arctur17 (button) folded before Flop (didn't bet)
Seat 8: ruslik_by (small blind) folded before Flop
Seat 9: KovIFish89 (big blind) collected ($8.08)





PokerStars Hand #155380907217:  Hold'em No Limit ($0.50/$1.00 USD) - 2016/06/30 14:22:54 CET [2016/06/30 8:22:54 ET]
Table 'Asmodeus' 9-max Seat #6 is the button
Seat 2: nickreason17 ($100 in chips) 
Seat 3: matiko09 ($116.47 in chips) 
Seat 4: DIMAN_324 ($103.27 in chips) 
Seat 6: koutani7 ($82.03 in chips) 
Seat 7: aaronzzr ($133.33 in chips) 
Seat 8: Rafaello18 ($172.57 in chips) 
aaronzzr: posts small blind $0.50
Rafaello18: posts big blind $1
mbk88: sits out 
sanr23: sits out 
*** HOLE CARDS ***
Dealt to matiko09 [Kd 8s]
nickreason17: folds 
matiko09: folds 
DIMAN_324: folds 
koutani7: folds 
aaronzzr: folds 
Uncalled bet ($0.50) returned to Rafaello18
Rafaello18 collected $1 from pot
Rafaello18: doesn't show hand 
*** SUMMARY ***
Total pot $1 | Rake $0 
Seat 2: nickreason17 folded before Flop (didn't bet)
Seat 3: matiko09 folded before Flop (didn't bet)
Seat 4: DIMAN_324 folded before Flop (didn't bet)
Seat 6: koutani7 (button) folded before Flop (didn't bet)
Seat 7: aaronzzr (small blind) folded before Flop
Seat 8: Rafaello18 (big blind) collected ($1)





PokerStars Hand #155380915795:  Hold'em No Limit ($0.50/$1.00 USD) - 2016/06/30 14:23:13 CET [2016/06/30 8:23:13 ET]
Table 'California II' 9-max Seat #5 is the button
Seat 1: Rafaello18 ($100 in chips) 
Seat 3: KovIFish89 ($100 in chips) 
Seat 5: Rohitbarve ($112.52 in chips) 
Seat 6: matiko09 ($134.73 in chips) 
Seat 7: DomiVY ($92.88 in chips) 
Seat 9: di0d80 ($103.37 in chips) 
matiko09: posts small blind $0.50
DomiVY: posts big blind $1
chenconhaste: sits out 
ruslik_by: sits out 
*** HOLE CARDS ***
Dealt to matiko09 [3s Ac]
di0d80: folds 
Rafaello18: raises $1.50 to $2.50
KovIFish89: folds 
Rohitbarve: calls $2.50
matiko09: folds 
DomiVY: folds 
*** FLOP *** [Kc 4h 3c]
Rafaello18: bets $4
Rohitbarve: folds 
Uncalled bet ($4) returned to Rafaello18
Rafaello18 collected $6.18 from pot
Rafaello18: doesn't show hand 
*** SUMMARY ***
Total pot $6.50 | Rake $0.32 
Board [Kc 4h 3c]
Seat 1: Rafaello18 collected ($6.18)
Seat 3: KovIFish89 folded before Flop (didn't bet)
Seat 5: Rohitbarve (button) folded on the Flop
Seat 6: matiko09 (small blind) folded before Flop
Seat 7: DomiVY (big blind) folded before Flop
Seat 9: di0d80 folded before Flop (didn't bet)





PokerStars Hand #155380917614:  Hold'em No Limit ($0.50/$1.00 USD) - 2016/06/30 14:23:16 CET [2016/06/30 8:23:16 ET]
Table 'Asmodeus' 9-max Seat #7 is the button
Seat 2: nickreason17 ($100 in chips) 
Seat 3: matiko09 ($116.47 in chips) 
Seat 4: DIMAN_324 ($103.27 in chips) 
Seat 6: koutani7 ($82.03 in chips) 
Seat 7: aaronzzr ($132.83 in chips) 
Seat 8: Rafaello18 ($173.07 in chips) 
Seat 9: mbk88 ($161.26 in chips) 
Rafaello18: posts small blind $0.50
mbk88: posts big blind $1
sanr23: sits out 
*** HOLE CARDS ***
Dealt to matiko09 [3d Js]
nickreason17: raises $1.50 to $2.50
matiko09: folds 
DIMAN_324: folds 
koutani7: folds 
aaronzzr: calls $2.50
Rafaello18: folds 
mbk88: folds 
*** FLOP *** [9c 5s 4s]
nickreason17: checks 
aaronzzr: checks 
*** TURN *** [9c 5s 4s] [6d]
nickreason17: checks 
aaronzzr: checks 
*** RIVER *** [9c 5s 4s 6d] [Kh]
nickreason17: bets $4
aaronzzr: folds 
Uncalled bet ($4) returned to nickreason17
nickreason17 collected $6.18 from pot
*** SUMMARY ***
Total pot $6.50 | Rake $0.32 
Board [9c 5s 4s 6d Kh]
Seat 2: nickreason17 collected ($6.18)
Seat 3: matiko09 folded before Flop (didn't bet)
Seat 4: DIMAN_324 folded before Flop (didn't bet)
Seat 6: koutani7 folded before Flop (didn't bet)
Seat 7: aaronzzr (button) folded on the River
Seat 8: Rafaello18 (small blind) folded before Flop
Seat 9: mbk88 (big blind) folded before Flop





PokerStars Hand #155380922372:  Hold'em No Limit ($0.50/$1.00 USD) - 2016/06/30 14:23:27 CET [2016/06/30 8:23:27 ET]
Table 'Donnera' 9-max Seat #3 is the button
Seat 1: chenconhaste ($113.06 in chips) 
Seat 2: robbiescrim9 ($97.45 in chips) 
Seat 3: matiko09 ($109.25 in chips) 
Seat 4: Kukuryzka ($100 in chips) 
Seat 5: tipner ($100 in chips) 
Seat 6: nickreason17 ($101 in chips) 
Seat 7: Rafaello18 ($100 in chips) 
Seat 8: ruslik_by ($114.60 in chips) 
Seat 9: Starw!nd ($107.25 in chips) 
Kukuryzka: posts small blind $0.50
tipner: posts big blind $1
*** HOLE CARDS ***
Dealt to matiko09 [Ad 7s]
nickreason17: raises $1.50 to $2.50
Rafaello18: folds 
ruslik_by: folds 
Starw!nd: folds 
chenconhaste: folds 
robbiescrim9: calls $2.50
matiko09: folds 
Kukuryzka: folds 
tipner: calls $1.50
*** FLOP *** [Jh 6h 9c]
tipner: checks 
nickreason17: checks 
robbiescrim9: bets $3
tipner: folds 
nickreason17: calls $3
*** TURN *** [Jh 6h 9c] [Jd]
nickreason17: checks 
robbiescrim9: bets $4
nickreason17: calls $4
*** RIVER *** [Jh 6h 9c Jd] [Jc]
nickreason17: checks 
robbiescrim9: bets $10.45
nickreason17: calls $10.45
*** SHOW DOWN ***
robbiescrim9: shows [Js 8s] (four of a kind, Jacks)
nickreason17: mucks hand 
robbiescrim9 collected $40.76 from pot
*** SUMMARY ***
Total pot $42.90 | Rake $2.14 
Board [Jh 6h 9c Jd Jc]
Seat 1: chenconhaste folded before Flop (didn't bet)
Seat 2: robbiescrim9 showed [Js 8s] and won ($40.76) with four of a kind, Jacks
Seat 3: matiko09 (button) folded before Flop (didn't bet)
Seat 4: Kukuryzka (small blind) folded before Flop
Seat 5: tipner (big blind) folded on the Flop
Seat 6: nickreason17 mucked [Td Th]
Seat 7: Rafaello18 folded before Flop (didn't bet)
Seat 8: ruslik_by folded before Flop (didn't bet)
Seat 9: Starw!nd folded before Flop (didn't bet)





PokerStars Hand #155380925124:  Hold'em No Limit ($0.50/$1.00 USD) - 2016/06/30 14:23:33 CET [2016/06/30 8:23:33 ET]
Table 'Simeisa II' 9-max Seat #4 is the button
Seat 1: joooh79 ($97.23 in chips) 
Seat 2: Rafaello18 ($142.65 in chips) 
Seat 3: matiko09 ($100 in chips) 
Seat 4: Ty Nick 420 ($100 in chips) 
Seat 5: arctur17 ($78.43 in chips) 
Seat 6: ruslik_by ($100 in chips) 
Seat 7: Eriksjef93 ($28.59 in chips) 
Seat 8: DIMAN_324 ($180.87 in chips) 
Seat 9: mbk88 ($186.18 in chips) 
arctur17: posts small blind $0.50
ruslik_by: posts big blind $1
*** HOLE CARDS ***
Dealt to matiko09 [9h Qd]
Eriksjef93: raises $1 to $2
DIMAN_324: raises $2.50 to $4.50
mbk88: folds 
joooh79: folds 
Rafaello18: folds 
matiko09: folds 
Ty Nick 420: folds 
arctur17: folds 
ruslik_by: folds 
Eriksjef93: calls $2.50
*** FLOP *** [3s 7s Tc]
Eriksjef93: bets $3
DIMAN_324: folds 
Uncalled bet ($3) returned to Eriksjef93
Eriksjef93 collected $9.98 from pot
Eriksjef93: doesn't show hand 
*** SUMMARY ***
Total pot $10.50 | Rake $0.52 
Board [3s 7s Tc]
Seat 1: joooh79 folded before Flop (didn't bet)
Seat 2: Rafaello18 folded before Flop (didn't bet)
Seat 3: matiko09 folded before Flop (didn't bet)
Seat 4: Ty Nick 420 (button) folded before Flop (didn't bet)
Seat 5: arctur17 (small blind) folded before Flop
Seat 6: ruslik_by (big blind) folded before Flop
Seat 7: Eriksjef93 collected ($9.98)
Seat 8: DIMAN_324 folded on the Flop
Seat 9: mbk88 folded before Flop (didn't bet)





PokerStars Hand #155380925597:  Hold'em No Limit (€0.25/€0.50 EUR) - 2016/06/30 14:23:34 CET [2016/06/30 8:23:34 ET]
Table 'Vibeke II' 9-max Seat #6 is the button
Seat 4: acelacat111 (€23.32 in chips) 
Seat 5: mazefaka007 (€50 in chips) 
Seat 6: Kukuryzka (€50 in chips) 
Seat 7: matiko09 (€59.35 in chips) 
matiko09: posts small blind €0.25
acelacat111: posts big blind €0.50
*** HOLE CARDS ***
Dealt to matiko09 [3h Jh]
mazefaka007: raises €0.55 to €1.05
Kukuryzka: folds 
matiko09: folds 
acelacat111: calls €0.55
*** FLOP *** [9s 6d 5c]
acelacat111: checks 
mazefaka007: bets €1.11
acelacat111: calls €1.11
*** TURN *** [9s 6d 5c] [2h]
acelacat111: checks 
mazefaka007: checks 
*** RIVER *** [9s 6d 5c 2h] [2d]
acelacat111: checks 
mazefaka007: checks 
*** SHOW DOWN ***
acelacat111: shows [Ad 5h] (two pair, Fives and Deuces)
mazefaka007: mucks hand 
acelacat111 collected €4.34 from pot
*** SUMMARY ***
Total pot €4.57 | Rake €0.23 
Board [9s 6d 5c 2h 2d]
Seat 4: acelacat111 (big blind) showed [Ad 5h] and won (€4.34) with two pair, Fives and Deuces
Seat 5: mazefaka007 mucked [Qc Ac]
Seat 6: Kukuryzka (button) folded before Flop (didn't bet)
Seat 7: matiko09 (small blind) folded before Flop





PokerStars Hand #155380927314:  Hold'em No Limit ($0.25/$0.50 USD) - 2016/06/30 14:23:37 CET [2016/06/30 8:23:37 ET]
Table 'Arcturus' 9-max Seat #1 is the button
Seat 1: kourk250 ($130.28 in chips) 
Seat 2: Rafaello18 ($50 in chips) 
Seat 3: matiko09 ($50 in chips) 
Seat 5: stockbridge8 ($48.50 in chips) 
Seat 6: statistik85 ($64.22 in chips) 
Seat 7: bratbugor ($51.93 in chips) 
Seat 8: TheMinion ($50 in chips) 
Seat 9: pfunkolstar ($110.22 in chips) 
Rafaello18: posts small blind $0.25
matiko09: posts big blind $0.50
*** HOLE CARDS ***
Dealt to matiko09 [Qh 3h]
stockbridge8: folds 
statistik85: folds 
bratbugor: raises $1 to $1.50
TheMinion: folds 
pfunkolstar: folds 
kourk250: calls $1.50
Rafaello18: folds 
matiko09: folds 
*** FLOP *** [3d Qc 2h]
bratbugor: bets $2.20
kourk250: calls $2.20
*** TURN *** [3d Qc 2h] [Jc]
bratbugor: bets $4.79
kourk250: raises $5.21 to $10
bratbugor: calls $5.21
*** RIVER *** [3d Qc 2h Jc] [8s]
bratbugor: checks 
kourk250: bets $10
bratbugor: folds 
Uncalled bet ($10) returned to kourk250
kourk250 collected $26.74 from pot
kourk250: doesn't show hand 
*** SUMMARY ***
Total pot $28.15 | Rake $1.41 
Board [3d Qc 2h Jc 8s]
Seat 1: kourk250 (button) collected ($26.74)
Seat 2: Rafaello18 (small blind) folded before Flop
Seat 3: matiko09 (big blind) folded before Flop
Seat 5: stockbridge8 folded before Flop (didn't bet)
Seat 6: statistik85 folded before Flop (didn't bet)
Seat 7: bratbugor folded on the River
Seat 8: TheMinion folded before Flop (didn't bet)
Seat 9: pfunkolstar folded before Flop (didn't bet)





PokerStars Hand #155380929636:  Hold'em No Limit ($0.50/$1.00 USD) - 2016/06/30 14:23:42 CET [2016/06/30 8:23:42 ET]
Table 'Sigrid' 9-max Seat #8 is the button
Seat 1: Greha999 ($71.58 in chips) 
Seat 2: matiko09 ($111.66 in chips) 
Seat 3: Rafaello18 ($108.13 in chips) 
Seat 4: mbk88 ($115.87 in chips) 
Seat 7: arctur17 ($97 in chips) 
Seat 8: ruslik_by ($101 in chips) 
Seat 9: KovIFish89 ($104.08 in chips) 
KovIFish89: posts small blind $0.50
Greha999: posts big blind $1
chenconhaste: sits out 
*** HOLE CARDS ***
Dealt to matiko09 [3h 4h]
matiko09: folds 
Rafaello18: folds 
mbk88: raises $2 to $3
arctur17: folds 
ruslik_by: folds 
KovIFish89: folds 
Greha999: folds 
Uncalled bet ($2) returned to mbk88
mbk88 collected $2.50 from pot
mbk88: doesn't show hand 
*** SUMMARY ***
Total pot $2.50 | Rake $0 
Seat 1: Greha999 (big blind) folded before Flop
Seat 2: matiko09 folded before Flop (didn't bet)
Seat 3: Rafaello18 folded before Flop (didn't bet)
Seat 4: mbk88 collected ($2.50)
Seat 7: arctur17 folded before Flop (didn't bet)
Seat 8: ruslik_by (button) folded before Flop (didn't bet)
Seat 9: KovIFish89 (small blind) folded before Flop





PokerStars Hand #155380933283:  Hold'em No Limit ($0.50/$1.00 USD) - 2016/06/30 14:23:50 CET [2016/06/30 8:23:50 ET]
Table 'Tatjana' 9-max Seat #2 is the button
Seat 1: tipner ($116.40 in chips) 
Seat 2: DIMAN_324 ($100 in chips) 
Seat 3: Rafaello18 ($101.79 in chips) 
Seat 4: mopatron25 ($87.80 in chips) 
Seat 5: matiko09 ($100 in chips) 
Seat 6: mbk88 ($170.04 in chips) 
Seat 8: alhill86 ($98.86 in chips) 
Seat 9: POTAPENKO700 ($235.43 in chips) 
Rafaello18: posts small blind $0.50
mopatron25: posts big blind $1
*** HOLE CARDS ***
Dealt to matiko09 [As 6h]
nickreason17 joins the table at seat #7 
matiko09: folds 
mbk88: folds 
alhill86: folds 
POTAPENKO700: folds 
tipner: raises $1 to $2
DIMAN_324: folds 
Rafaello18: folds 
mopatron25: calls $1
*** FLOP *** [2h Ah Kd]
mopatron25: bets $2
tipner: folds 
Uncalled bet ($2) returned to mopatron25
mopatron25 collected $4.28 from pot
mopatron25: doesn't show hand 
*** SUMMARY ***
Total pot $4.50 | Rake $0.22 
Board [2h Ah Kd]
Seat 1: tipner folded on the Flop
Seat 2: DIMAN_324 (button) folded before Flop (didn't bet)
Seat 3: Rafaello18 (small blind) folded before Flop
Seat 4: mopatron25 (big blind) collected ($4.28)
Seat 5: matiko09 folded before Flop (didn't bet)
Seat 6: mbk88 folded before Flop (didn't bet)
Seat 8: alhill86 folded before Flop (didn't bet)
Seat 9: POTAPENKO700 folded before Flop (didn't bet)





PokerStars Hand #155380935321:  Hold'em No Limit ($0.50/$1.00 USD) - 2016/06/30 14:23:55 CET [2016/06/30 8:23:55 ET]
Table 'California II' 9-max Seat #6 is the button
Seat 1: Rafaello18 ($103.68 in chips) 
Seat 3: KovIFish89 ($100 in chips) 
Seat 5: Rohitbarve ($110.02 in chips) 
Seat 6: matiko09 ($134.23 in chips) 
Seat 7: DomiVY ($91.88 in chips) 
Seat 8: chenconhaste ($100 in chips) 
Seat 9: di0d80 ($103.37 in chips) 
DomiVY: posts small blind $0.50
chenconhaste: posts big blind $1
ruslik_by: sits out 
*** HOLE CARDS ***
Dealt to matiko09 [6s Ad]
di0d80: folds 
Rafaello18: folds 
KovIFish89: folds 
Rohitbarve: raises $2 to $3
mbk88 leaves the table
matiko09: folds 
DomiVY: folds 
chenconhaste: folds 
Uncalled bet ($2) returned to Rohitbarve
Rohitbarve collected $2.50 from pot
Rohitbarve: doesn't show hand 
*** SUMMARY ***
Total pot $2.50 | Rake $0 
Seat 1: Rafaello18 folded before Flop (didn't bet)
Seat 3: KovIFish89 folded before Flop (didn't bet)
Seat 5: Rohitbarve collected ($2.50)
Seat 6: matiko09 (button) folded before Flop (didn't bet)
Seat 7: DomiVY (small blind) folded before Flop
Seat 8: chenconhaste (big blind) folded before Flop
Seat 9: di0d80 folded before Flop (didn't bet)





PokerStars Hand #155380940591:  Hold'em No Limit ($0.50/$1.00 USD) - 2016/06/30 14:24:06 CET [2016/06/30 8:24:06 ET]
Table 'Borrelly II' 9-max Seat #8 is the button
Seat 1: Rafaello18 ($117.07 in chips) 
Seat 2: mbk88 ($117.78 in chips) 
Seat 3: di0d80 ($189 in chips) 
Seat 4: DonRon_AT ($40.19 in chips) 
Seat 5: DIMAN_324 ($103.58 in chips) 
Seat 6: m_michalec ($155.71 in chips) 
Seat 7: matiko09 ($177.36 in chips) 
Seat 8: Arjun A Raju ($133.92 in chips) 
Seat 9: alhill86 ($86.96 in chips) 
alhill86: posts small blind $0.50
Rafaello18: posts big blind $1
*** HOLE CARDS ***
Dealt to matiko09 [Tc Jh]
mbk88: folds 
di0d80: folds 
DonRon_AT: raises $2 to $3
DIMAN_324: folds 
m_michalec: folds 
matiko09: folds 
Arjun A Raju: folds 
alhill86: folds 
Rafaello18: folds 
Uncalled bet ($2) returned to DonRon_AT
DonRon_AT collected $2.50 from pot
*** SUMMARY ***
Total pot $2.50 | Rake $0 
Seat 1: Rafaello18 (big blind) folded before Flop
Seat 2: mbk88 folded before Flop (didn't bet)
Seat 3: di0d80 folded before Flop (didn't bet)
Seat 4: DonRon_AT collected ($2.50)
Seat 5: DIMAN_324 folded before Flop (didn't bet)
Seat 6: m_michalec folded before Flop (didn't bet)
Seat 7: matiko09 folded before Flop (didn't bet)
Seat 8: Arjun A Raju (button) folded before Flop (didn't bet)
Seat 9: alhill86 (small blind) folded before Flop





PokerStars Hand #155380941578:  Hold'em No Limit ($0.50/$1.00 USD) - 2016/06/30 14:24:08 CET [2016/06/30 8:24:08 ET]
Table 'Altarf II' 9-max Seat #5 is the button
Seat 1: Rafaello18 ($100 in chips) 
Seat 2: KovIFish89 ($100 in chips) 
Seat 4: Greha999 ($152.88 in chips) 
Seat 5: DIMAN_324 ($227.24 in chips) 
Seat 6: mbk88 ($100 in chips) 
Seat 7: matiko09 ($103.40 in chips) 
Seat 8: DomiVY ($42.12 in chips) 
Seat 9: omanibemihum ($154.61 in chips) 
mbk88: posts small blind $0.50
matiko09: posts big blind $1
sanr23: sits out 
*** HOLE CARDS ***
Dealt to matiko09 [Ks 7d]
DomiVY: folds 
omanibemihum: folds 
Rafaello18: folds 
KovIFish89: raises $2 to $3
Greha999: folds 
DIMAN_324: folds 
mbk88: folds 
matiko09: folds 
Uncalled bet ($2) returned to KovIFish89
KovIFish89 collected $2.50 from pot
KovIFish89: doesn't show hand 
*** SUMMARY ***
Total pot $2.50 | Rake $0 
Seat 1: Rafaello18 folded before Flop (didn't bet)
Seat 2: KovIFish89 collected ($2.50)
Seat 4: Greha999 folded before Flop (didn't bet)
Seat 5: DIMAN_324 (button) folded before Flop (didn't bet)
Seat 6: mbk88 (small blind) folded before Flop
Seat 7: matiko09 (big blind) folded before Flop
Seat 8: DomiVY folded before Flop (didn't bet)
Seat 9: omanibemihum folded before Flop (didn't bet)





PokerStars Hand #155380943127:  Hold'em No Limit (€0.25/€0.50 EUR) - 2016/06/30 14:24:12 CET [2016/06/30 8:24:12 ET]
Table 'Vibeke II' 9-max Seat #7 is the button
Seat 4: acelacat111 (€25.50 in chips) 
Seat 5: mazefaka007 (€50 in chips) 
Seat 6: Kukuryzka (€50 in chips) 
Seat 7: matiko09 (€59.10 in chips) 
acelacat111: posts small blind €0.25
mazefaka007: posts big blind €0.50
*** HOLE CARDS ***
Dealt to matiko09 [Ad Td]
Kukuryzka: folds 
matiko09: raises €0.63 to €1.13
acelacat111: folds 
mazefaka007: folds 
Uncalled bet (€0.63) returned to matiko09
matiko09 collected €1.25 from pot
matiko09: doesn't show hand 
*** SUMMARY ***
Total pot €1.25 | Rake €0 
Seat 4: acelacat111 (small blind) folded before Flop
Seat 5: mazefaka007 (big blind) folded before Flop
Seat 6: Kukuryzka folded before Flop (didn't bet)
Seat 7: matiko09 (button) collected (€1.25)





PokerStars Hand #155380944252:  Hold'em No Limit ($0.50/$1.00 USD) - 2016/06/30 14:24:14 CET [2016/06/30 8:24:14 ET]
Table 'Sigrid' 9-max Seat #9 is the button
Seat 1: Greha999 ($70.58 in chips) 
Seat 2: matiko09 ($111.66 in chips) 
Seat 3: Rafaello18 ($108.13 in chips) 
Seat 4: mbk88 ($117.37 in chips) 
Seat 7: arctur17 ($97 in chips) 
Seat 8: ruslik_by ($101 in chips) 
Seat 9: KovIFish89 ($103.58 in chips) 
Greha999: posts small blind $0.50
matiko09: posts big blind $1
chenconhaste: sits out 
*** HOLE CARDS ***
Dealt to matiko09 [8s 6s]
Rafaello18: folds 
mbk88: folds 
arctur17: folds 
ruslik_by: raises $1.50 to $2.50
KovIFish89: folds 
Greha999: calls $2
matiko09: calls $1.50
*** FLOP *** [2d 2s 5h]
Greha999: checks 
matiko09: checks 
ruslik_by: bets $3.56
Greha999: folds 
matiko09: folds 
Uncalled bet ($3.56) returned to ruslik_by
ruslik_by collected $7.12 from pot
ruslik_by: doesn't show hand 
*** SUMMARY ***
Total pot $7.50 | Rake $0.38 
Board [2d 2s 5h]
Seat 1: Greha999 (small blind) folded on the Flop
Seat 2: matiko09 (big blind) folded on the Flop
Seat 3: Rafaello18 folded before Flop (didn't bet)
Seat 4: mbk88 folded before Flop (didn't bet)
Seat 7: arctur17 folded before Flop (didn't bet)
Seat 8: ruslik_by collected ($7.12)
Seat 9: KovIFish89 (button) folded before Flop (didn't bet)





PokerStars Hand #155380944522:  Hold'em Pot Limit ($0.50/$1.00 USD) - 2016/06/30 14:24:15 CET [2016/06/30 8:24:15 ET]
Table 'Rafita' 9-max Seat #3 is the button
Seat 3: dragankosti ($36 in chips) 
Seat 5: stefantas ($43.60 in chips) 
Seat 6: matiko09 ($100 in chips) 
stefantas: posts small blind $0.50
matiko09: posts big blind $1
Vecherov: sits out 
Ty Nick 420: sits out 
*** HOLE CARDS ***
Dealt to matiko09 [4s 2h]
dragankosti: folds 
dragankosti leaves the table
stefantas: calls $0.50
matiko09: checks 
*** FLOP *** [6d 4h 7h]
stefantas: checks 
matiko09: checks 
*** TURN *** [6d 4h 7h] [Jc]
stefantas: checks 
matiko09: checks 
*** RIVER *** [6d 4h 7h Jc] [Ah]
nickreason17 joins the table at seat #9 
stefantas: bets $1
matiko09: folds 
Uncalled bet ($1) returned to stefantas
stefantas collected $1.90 from pot
stefantas: doesn't show hand 
*** SUMMARY ***
Total pot $2 | Rake $0.10 
Board [6d 4h 7h Jc Ah]
Seat 3: dragankosti (button) folded before Flop (didn't bet)
Seat 5: stefantas (small blind) collected ($1.90)
Seat 6: matiko09 (big blind) folded on the River





PokerStars Hand #155380947610:  Hold'em No Limit ($0.50/$1.00 USD) - 2016/06/30 14:24:21 CET [2016/06/30 8:24:21 ET]
Table 'Asmodeus' 9-max Seat #8 is the button
Seat 2: nickreason17 ($103.68 in chips) 
Seat 3: matiko09 ($116.47 in chips) 
Seat 4: DIMAN_324 ($103.27 in chips) 
Seat 6: koutani7 ($82.03 in chips) 
Seat 7: aaronzzr ($130.33 in chips) 
Seat 8: Rafaello18 ($172.57 in chips) 
Seat 9: mbk88 ($160.26 in chips) 
mbk88: posts small blind $0.50
nickreason17: posts big blind $1
sanr23: sits out 
*** HOLE CARDS ***
Dealt to matiko09 [9d 4d]
matiko09: folds 
DIMAN_324: folds 
koutani7: folds 
aaronzzr: folds 
Rafaello18: raises $1.50 to $2.50
mbk88: folds 
nickreason17: folds 
Uncalled bet ($1.50) returned to Rafaello18
Rafaello18 collected $2.50 from pot
Rafaello18: doesn't show hand 
*** SUMMARY ***
Total pot $2.50 | Rake $0 
Seat 2: nickreason17 (big blind) folded before Flop
Seat 3: matiko09 folded before Flop (didn't bet)
Seat 4: DIMAN_324 folded before Flop (didn't bet)
Seat 6: koutani7 folded before Flop (didn't bet)
Seat 7: aaronzzr folded before Flop (didn't bet)
Seat 8: Rafaello18 (button) collected ($2.50)
Seat 9: mbk88 (small blind) folded before Flop





PokerStars Hand #155380949287:  Hold'em No Limit ($0.50/$1.00 USD) - 2016/06/30 14:24:25 CET [2016/06/30 8:24:25 ET]
Table 'Tatjana' 9-max Seat #3 is the button
Seat 1: tipner ($114.40 in chips) 
Seat 2: DIMAN_324 ($100 in chips) 
Seat 3: Rafaello18 ($101.29 in chips) 
Seat 4: mopatron25 ($90.08 in chips) 
Seat 5: matiko09 ($100 in chips) 
Seat 6: mbk88 ($170.04 in chips) 
Seat 8: alhill86 ($98.86 in chips) 
Seat 9: POTAPENKO700 ($235.43 in chips) 
mopatron25: posts small blind $0.50
matiko09: posts big blind $1
*** HOLE CARDS ***
Dealt to matiko09 [4h 4c]
mbk88: folds 
alhill86: folds 
POTAPENKO700: folds 
tipner: raises $2 to $3
DIMAN_324: calls $3
Rafaello18: folds 
mopatron25: calls $2.50
matiko09: calls $2
*** FLOP *** [6h As 6s]
mopatron25: checks 
matiko09: checks 
tipner: checks 
DIMAN_324: bets $5.70
mopatron25: folds 
matiko09: folds 
tipner: calls $5.70
*** TURN *** [6h As 6s] [5d]
tipner: checks 
DIMAN_324: checks 
*** RIVER *** [6h As 6s 5d] [Ah]
tipner: checks 
DIMAN_324: bets $11.11
tipner: folds 
Uncalled bet ($11.11) returned to DIMAN_324
DIMAN_324 collected $22.23 from pot
DIMAN_324: doesn't show hand 
*** SUMMARY ***
Total pot $23.40 | Rake $1.17 
Board [6h As 6s 5d Ah]
Seat 1: tipner folded on the River
Seat 2: DIMAN_324 collected ($22.23)
Seat 3: Rafaello18 (button) folded before Flop (didn't bet)
Seat 4: mopatron25 (small blind) folded on the Flop
Seat 5: matiko09 (big blind) folded on the Flop
Seat 6: mbk88 folded before Flop (didn't bet)
Seat 8: alhill86 folded before Flop (didn't bet)
Seat 9: POTAPENKO700 folded before Flop (didn't bet)





PokerStars Hand #155380949783:  Hold'em No Limit (€0.25/€0.50 EUR) - 2016/06/30 14:24:26 CET [2016/06/30 8:24:26 ET]
Table 'Vibeke II' 9-max Seat #4 is the button
Seat 4: acelacat111 (€25.25 in chips) 
Seat 5: mazefaka007 (€50 in chips) 
Seat 6: Kukuryzka (€50 in chips) 
Seat 7: matiko09 (€59.85 in chips) 
mazefaka007: posts small blind €0.25
Kukuryzka: posts big blind €0.50
*** HOLE CARDS ***
Dealt to matiko09 [Jc 5h]
matiko09: folds 
acelacat111: raises €1 to €1.50
mr.loon21 joins the table at seat #3 
mazefaka007: folds 
Kukuryzka: folds 
Uncalled bet (€1) returned to acelacat111
acelacat111 collected €1.25 from pot
acelacat111: doesn't show hand 
*** SUMMARY ***
Total pot €1.25 | Rake €0 
Seat 4: acelacat111 (button) collected (€1.25)
Seat 5: mazefaka007 (small blind) folded before Flop
Seat 6: Kukuryzka (big blind) folded before Flop
Seat 7: matiko09 folded before Flop (didn't bet)





PokerStars Hand #155380950487:  Hold'em No Limit ($0.50/$1.00 USD) - 2016/06/30 14:24:28 CET [2016/06/30 8:24:28 ET]
Table 'Borrelly II' 9-max Seat #9 is the button
Seat 1: Rafaello18 ($116.07 in chips) 
Seat 2: mbk88 ($117.78 in chips) 
Seat 3: di0d80 ($189 in chips) 
Seat 4: DonRon_AT ($41.69 in chips) 
Seat 5: DIMAN_324 ($103.58 in chips) 
Seat 6: m_michalec ($155.71 in chips) 
Seat 7: matiko09 ($177.36 in chips) 
Seat 8: Arjun A Raju ($133.92 in chips) 
Seat 9: alhill86 ($86.46 in chips) 
Rafaello18: posts small blind $0.50
mbk88: posts big blind $1
*** HOLE CARDS ***
Dealt to matiko09 [Qh 9h]
di0d80: folds 
DonRon_AT: folds 
DIMAN_324: folds 
m_michalec: raises $2 to $3
matiko09: folds 
Arjun A Raju: folds 
alhill86: calls $3
Rafaello18: folds 
mbk88: folds 
*** FLOP *** [2s 5s Kc]
m_michalec: checks 
alhill86: bets $3.56
m_michalec: calls $3.56
*** TURN *** [2s 5s Kc] [6h]
m_michalec: checks 
alhill86: checks 
*** RIVER *** [2s 5s Kc 6h] [9d]
m_michalec: bets $6
alhill86: folds 
Uncalled bet ($6) returned to m_michalec
m_michalec collected $13.89 from pot
m_michalec: doesn't show hand 
*** SUMMARY ***
Total pot $14.62 | Rake $0.73 
Board [2s 5s Kc 6h 9d]
Seat 1: Rafaello18 (small blind) folded before Flop
Seat 2: mbk88 (big blind) folded before Flop
Seat 3: di0d80 folded before Flop (didn't bet)
Seat 4: DonRon_AT folded before Flop (didn't bet)
Seat 5: DIMAN_324 folded before Flop (didn't bet)
Seat 6: m_michalec collected ($13.89)
Seat 7: matiko09 folded before Flop (didn't bet)
Seat 8: Arjun A Raju folded before Flop (didn't bet)
Seat 9: alhill86 (button) folded on the River





PokerStars Hand #155380951131:  Hold'em No Limit ($0.50/$1.00 USD) - 2016/06/30 14:24:29 CET [2016/06/30 8:24:29 ET]
Table 'Simeisa II' 9-max Seat #5 is the button
Seat 1: joooh79 ($97.23 in chips) 
Seat 2: Rafaello18 ($142.65 in chips) 
Seat 3: matiko09 ($100 in chips) 
Seat 4: Ty Nick 420 ($100 in chips) 
Seat 5: arctur17 ($77.93 in chips) 
Seat 6: ruslik_by ($100 in chips) 
Seat 7: Eriksjef93 ($34.07 in chips) 
Seat 8: DIMAN_324 ($176.37 in chips) 
Seat 9: mbk88 ($186.18 in chips) 
ruslik_by: posts small blind $0.50
Eriksjef93: posts big blind $1
*** HOLE CARDS ***
Dealt to matiko09 [2d 5c]
DIMAN_324: folds 
mbk88: folds 
joooh79: folds 
Rafaello18: folds 
matiko09: folds 
Ty Nick 420: folds 
arctur17: folds 
ruslik_by: folds 
Uncalled bet ($0.50) returned to Eriksjef93
Eriksjef93 collected $1 from pot
Eriksjef93: doesn't show hand 
*** SUMMARY ***
Total pot $1 | Rake $0 
Seat 1: joooh79 folded before Flop (didn't bet)
Seat 2: Rafaello18 folded before Flop (didn't bet)
Seat 3: matiko09 folded before Flop (didn't bet)
Seat 4: Ty Nick 420 folded before Flop (didn't bet)
Seat 5: arctur17 (button) folded before Flop (didn't bet)
Seat 6: ruslik_by (small blind) folded before Flop
Seat 7: Eriksjef93 (big blind) collected ($1)
Seat 8: DIMAN_324 folded before Flop (didn't bet)
Seat 9: mbk88 folded before Flop (didn't bet)





PokerStars Hand #155380952568:  Hold'em No Limit ($0.50/$1.00 USD) - 2016/06/30 14:24:32 CET [2016/06/30 8:24:32 ET]
Table 'California II' 9-max Seat #7 is the button
Seat 1: Rafaello18 ($103.68 in chips) 
Seat 3: KovIFish89 ($100 in chips) 
Seat 5: Rohitbarve ($111.52 in chips) 
Seat 6: matiko09 ($134.23 in chips) 
Seat 7: DomiVY ($91.38 in chips) 
Seat 8: chenconhaste ($100 in chips) 
Seat 9: di0d80 ($103.37 in chips) 
chenconhaste: posts small blind $0.50
di0d80: posts big blind $1
ruslik_by: sits out 
*** HOLE CARDS ***
Dealt to matiko09 [Jh 4c]
Rafaello18: folds 
KovIFish89: folds 
Rohitbarve: folds 
matiko09: folds 
DomiVY: folds 
chenconhaste: folds 
Uncalled bet ($0.50) returned to di0d80
di0d80 collected $1 from pot
di0d80: doesn't show hand 
*** SUMMARY ***
Total pot $1 | Rake $0 
Seat 1: Rafaello18 folded before Flop (didn't bet)
Seat 3: KovIFish89 folded before Flop (didn't bet)
Seat 5: Rohitbarve folded before Flop (didn't bet)
Seat 6: matiko09 folded before Flop (didn't bet)
Seat 7: DomiVY (button) folded before Flop (didn't bet)
Seat 8: chenconhaste (small blind) folded before Flop
Seat 9: di0d80 (big blind) collected ($1)





PokerStars Hand #155380954978:  Hold'em No Limit ($0.50/$1.00 USD) - 2016/06/30 14:24:37 CET [2016/06/30 8:24:37 ET]
Table 'Asmodeus' 9-max Seat #9 is the button
Seat 2: nickreason17 ($102.68 in chips) 
Seat 3: matiko09 ($116.47 in chips) 
Seat 4: DIMAN_324 ($103.27 in chips) 
Seat 6: koutani7 ($82.03 in chips) 
Seat 7: aaronzzr ($130.33 in chips) 
Seat 8: Rafaello18 ($174.07 in chips) 
Seat 9: mbk88 ($159.76 in chips) 
nickreason17: posts small blind $0.50
matiko09: posts big blind $1
sanr23: sits out 
*** HOLE CARDS ***
Dealt to matiko09 [8c Qd]
DIMAN_324: folds 
koutani7: folds 
aaronzzr: folds 
Rafaello18: raises $1.50 to $2.50
mbk88: folds 
nickreason17: folds 
matiko09: folds 
Uncalled bet ($1.50) returned to Rafaello18
Rafaello18 collected $2.50 from pot
Rafaello18: doesn't show hand 
*** SUMMARY ***
Total pot $2.50 | Rake $0 
Seat 2: nickreason17 (small blind) folded before Flop
Seat 3: matiko09 (big blind) folded before Flop
Seat 4: DIMAN_324 folded before Flop (didn't bet)
Seat 6: koutani7 folded before Flop (didn't bet)
Seat 7: aaronzzr folded before Flop (didn't bet)
Seat 8: Rafaello18 collected ($2.50)
Seat 9: mbk88 (button) folded before Flop (didn't bet)





PokerStars Hand #155380955107:  Hold'em No Limit ($0.50/$1.00 USD) - 2016/06/30 14:24:38 CET [2016/06/30 8:24:38 ET]
Table 'Altarf II' 9-max Seat #6 is the button
Seat 1: Rafaello18 ($100 in chips) 
Seat 2: KovIFish89 ($101.50 in chips) 
Seat 4: Greha999 ($152.88 in chips) 
Seat 5: DIMAN_324 ($227.24 in chips) 
Seat 6: mbk88 ($100 in chips) 
Seat 7: matiko09 ($102.40 in chips) 
Seat 8: DomiVY ($42.12 in chips) 
Seat 9: omanibemihum ($154.61 in chips) 
matiko09: posts small blind $0.50
DomiVY: posts big blind $1
sanr23: sits out 
*** HOLE CARDS ***
Dealt to matiko09 [6c Ad]
omanibemihum: calls $1
Rafaello18: folds 
KovIFish89: folds 
Greha999: calls $1
DIMAN_324: folds 
mbk88: raises $5 to $6
matiko09: folds 
DomiVY: folds 
omanibemihum: calls $5
Greha999: folds 
*** FLOP *** [Ac Kd Qc]
omanibemihum: bets $7
mbk88: calls $7
*** TURN *** [Ac Kd Qc] [5h]
omanibemihum: checks 
mbk88: checks 
*** RIVER *** [Ac Kd Qc 5h] [Kh]
omanibemihum: bets $14
mbk88: folds 
Uncalled bet ($14) returned to omanibemihum
omanibemihum collected $27.08 from pot
omanibemihum: doesn't show hand 
*** SUMMARY ***
Total pot $28.50 | Rake $1.42 
Board [Ac Kd Qc 5h Kh]
Seat 1: Rafaello18 folded before Flop (didn't bet)
Seat 2: KovIFish89 folded before Flop (didn't bet)
Seat 4: Greha999 folded before Flop
Seat 5: DIMAN_324 folded before Flop (didn't bet)
Seat 6: mbk88 (button) folded on the River
Seat 7: matiko09 (small blind) folded before Flop
Seat 8: DomiVY (big blind) folded before Flop
Seat 9: omanibemihum collected ($27.08)





PokerStars Hand #155380956798:  Hold'em No Limit ($0.50/$1.00 USD) - 2016/06/30 14:24:41 CET [2016/06/30 8:24:41 ET]
Table 'Donnera' 9-max Seat #4 is the button
Seat 1: chenconhaste ($113.06 in chips) 
Seat 2: robbiescrim9 ($118.26 in chips) 
Seat 3: matiko09 ($109.25 in chips) 
Seat 4: Kukuryzka ($99.50 in chips) 
Seat 5: tipner ($100 in chips) 
Seat 6: nickreason17 ($100 in chips) 
Seat 7: Rafaello18 ($100 in chips) 
Seat 8: ruslik_by ($114.60 in chips) 
Seat 9: Starw!nd ($107.25 in chips) 
tipner: posts small blind $0.50
nickreason17: posts big blind $1
*** HOLE CARDS ***
Dealt to matiko09 [Ah 3h]
Rafaello18: folds 
ruslik_by: raises $2 to $3
Starw!nd: folds 
chenconhaste: folds 
robbiescrim9: calls $3
matiko09: folds 
Kukuryzka: raises $9 to $12
tipner: folds 
nickreason17: folds 
ruslik_by: calls $9
robbiescrim9: folds 
*** FLOP *** [2d Kd 7h]
ruslik_by: checks 
Kukuryzka: bets $13.54
ruslik_by: calls $13.54
*** TURN *** [2d Kd 7h] [Qd]
ruslik_by: checks 
Kukuryzka: checks 
*** RIVER *** [2d Kd 7h Qd] [2c]
ruslik_by: bets $26.54
Kukuryzka: raises $47.42 to $73.96 and is all-in
ruslik_by: calls $47.42
*** SHOW DOWN ***
Kukuryzka: shows [As Ks] (two pair, Kings and Deuces)
ruslik_by: shows [Kc Qh] (two pair, Kings and Queens)
ruslik_by collected $201 from pot
*** SUMMARY ***
Total pot $203.50 | Rake $2.50 
Board [2d Kd 7h Qd 2c]
Seat 1: chenconhaste folded before Flop (didn't bet)
Seat 2: robbiescrim9 folded before Flop
Seat 3: matiko09 folded before Flop (didn't bet)
Seat 4: Kukuryzka (button) showed [As Ks] and lost with two pair, Kings and Deuces
Seat 5: tipner (small blind) folded before Flop
Seat 6: nickreason17 (big blind) folded before Flop
Seat 7: Rafaello18 folded before Flop (didn't bet)
Seat 8: ruslik_by showed [Kc Qh] and won ($201) with two pair, Kings and Queens
Seat 9: Starw!nd folded before Flop (didn't bet)





PokerStars Hand #155380960966:  Hold'em No Limit ($0.25/$0.50 USD) - 2016/06/30 14:24:50 CET [2016/06/30 8:24:50 ET]
Table 'Arcturus' 9-max Seat #2 is the button
Seat 1: kourk250 ($143.32 in chips) 
Seat 2: Rafaello18 ($50 in chips) 
Seat 3: matiko09 ($50 in chips) 
Seat 5: stockbridge8 ($48.50 in chips) 
Seat 6: statistik85 ($64.22 in chips) 
Seat 7: bratbugor ($50 in chips) 
Seat 8: TheMinion ($50 in chips) 
Seat 9: pfunkolstar ($110.22 in chips) 
matiko09: posts small blind $0.25
stockbridge8: posts big blind $0.50
*** HOLE CARDS ***
Dealt to matiko09 [9c Ac]
statistik85: folds 
bratbugor: folds 
TheMinion: folds 
pfunkolstar: folds 
kourk250: raises $1 to $1.50
Rafaello18: folds 
matiko09: folds 
stockbridge8: folds 
Uncalled bet ($1) returned to kourk250
kourk250 collected $1.25 from pot
kourk250: doesn't show hand 
*** SUMMARY ***
Total pot $1.25 | Rake $0 
Seat 1: kourk250 collected ($1.25)
Seat 2: Rafaello18 (button) folded before Flop (didn't bet)
Seat 3: matiko09 (small blind) folded before Flop
Seat 5: stockbridge8 (big blind) folded before Flop
Seat 6: statistik85 folded before Flop (didn't bet)
Seat 7: bratbugor folded before Flop (didn't bet)
Seat 8: TheMinion folded before Flop (didn't bet)
Seat 9: pfunkolstar folded before Flop (didn't bet)





PokerStars Hand #155380961310:  Hold'em No Limit ($0.50/$1.00 USD) - 2016/06/30 14:24:51 CET [2016/06/30 8:24:51 ET]
Table 'Sigrid' 9-max Seat #1 is the button
Seat 1: Greha999 ($68.08 in chips) 
Seat 2: matiko09 ($109.16 in chips) 
Seat 3: Rafaello18 ($108.13 in chips) 
Seat 4: mbk88 ($117.37 in chips) 
Seat 7: arctur17 ($97 in chips) 
Seat 8: ruslik_by ($105.62 in chips) 
Seat 9: KovIFish89 ($103.58 in chips) 
matiko09: posts small blind $0.50
Rafaello18: posts big blind $1
chenconhaste: sits out 
*** HOLE CARDS ***
Dealt to matiko09 [5h Th]
mbk88: folds 
arctur17: raises $2 to $3
ruslik_by: folds 
KovIFish89: folds 
Greha999: calls $3
matiko09: folds 
Rafaello18: folds 
*** FLOP *** [Jc 7h Qd]
arctur17: bets $5
Greha999: calls $5
*** TURN *** [Jc 7h Qd] [4d]
arctur17: bets $12
Greha999: folds 
Uncalled bet ($12) returned to arctur17
arctur17 collected $16.62 from pot
arctur17: doesn't show hand 
*** SUMMARY ***
Total pot $17.50 | Rake $0.88 
Board [Jc 7h Qd 4d]
Seat 1: Greha999 (button) folded on the Turn
Seat 2: matiko09 (small blind) folded before Flop
Seat 3: Rafaello18 (big blind) folded before Flop
Seat 4: mbk88 folded before Flop (didn't bet)
Seat 7: arctur17 collected ($16.62)
Seat 8: ruslik_by folded before Flop (didn't bet)
Seat 9: KovIFish89 folded before Flop (didn't bet)





PokerStars Hand #155380962306:  Hold'em No Limit ($0.50/$1.00 USD) - 2016/06/30 14:24:53 CET [2016/06/30 8:24:53 ET]
Table 'California II' 9-max Seat #8 is the button
Seat 1: Rafaello18 ($103.68 in chips) 
Seat 3: KovIFish89 ($100 in chips) 
Seat 5: Rohitbarve ($111.52 in chips) 
Seat 6: matiko09 ($134.23 in chips) 
Seat 7: DomiVY ($91.38 in chips) 
Seat 8: chenconhaste ($100 in chips) 
Seat 9: di0d80 ($103.87 in chips) 
di0d80: posts small blind $0.50
Rafaello18: posts big blind $1
ruslik_by: sits out 
*** HOLE CARDS ***
Dealt to matiko09 [6s Jc]
KovIFish89: folds 
Rohitbarve: folds 
f1reworks joins the table at seat #4 
matiko09: folds 
DomiVY: folds 
chenconhaste: folds 
di0d80: folds 
Uncalled bet ($0.50) returned to Rafaello18
Rafaello18 collected $1 from pot
Rafaello18: doesn't show hand 
*** SUMMARY ***
Total pot $1 | Rake $0 
Seat 1: Rafaello18 (big blind) collected ($1)
Seat 3: KovIFish89 folded before Flop (didn't bet)
Seat 5: Rohitbarve folded before Flop (didn't bet)
Seat 6: matiko09 folded before Flop (didn't bet)
Seat 7: DomiVY folded before Flop (didn't bet)
Seat 8: chenconhaste (button) folded before Flop (didn't bet)
Seat 9: di0d80 (small blind) folded before Flop





PokerStars Hand #155380963148:  Hold'em No Limit ($0.50/$1.00 USD) - 2016/06/30 14:24:55 CET [2016/06/30 8:24:55 ET]
Table 'Simeisa II' 9-max Seat #6 is the button
Seat 1: joooh79 ($97.23 in chips) 
Seat 2: Rafaello18 ($142.65 in chips) 
Seat 3: matiko09 ($100 in chips) 
Seat 4: Ty Nick 420 ($100 in chips) 
Seat 5: arctur17 ($77.93 in chips) 
Seat 6: ruslik_by ($100 in chips) 
Seat 7: Eriksjef93 ($34.57 in chips) 
Seat 8: DIMAN_324 ($176.37 in chips) 
Seat 9: mbk88 ($186.18 in chips) 
Eriksjef93: posts small blind $0.50
DIMAN_324: posts big blind $1
*** HOLE CARDS ***
Dealt to matiko09 [3c 5d]
mbk88: folds 
joooh79: folds 
Rafaello18: folds 
matiko09: folds 
Ty Nick 420: folds 
arctur17: folds 
ruslik_by: folds 
Eriksjef93: raises $3 to $4
DIMAN_324: folds 
Uncalled bet ($3) returned to Eriksjef93
Eriksjef93 collected $2 from pot
Eriksjef93: doesn't show hand 
*** SUMMARY ***
Total pot $2 | Rake $0 
Seat 1: joooh79 folded before Flop (didn't bet)
Seat 2: Rafaello18 folded before Flop (didn't bet)
Seat 3: matiko09 folded before Flop (didn't bet)
Seat 4: Ty Nick 420 folded before Flop (didn't bet)
Seat 5: arctur17 folded before Flop (didn't bet)
Seat 6: ruslik_by (button) folded before Flop (didn't bet)
Seat 7: Eriksjef93 (small blind) collected ($2)
Seat 8: DIMAN_324 (big blind) folded before Flop
Seat 9: mbk88 folded before Flop (didn't bet)





PokerStars Hand #155380963521:  Hold'em Pot Limit ($0.50/$1.00 USD) - 2016/06/30 14:24:56 CET [2016/06/30 8:24:56 ET]
Table 'Rafita' 9-max Seat #5 is the button
Seat 5: stefantas ($44.50 in chips) 
Seat 6: matiko09 ($100 in chips) 
Seat 7: Vecherov ($100 in chips) 
matiko09: posts small blind $0.50
Vecherov: posts big blind $1
Ty Nick 420: sits out 
*** HOLE CARDS ***
Dealt to matiko09 [Ks Jh]
stefantas: folds 
stefantas leaves the table
matiko09: raises $2 to $3
Vecherov: folds 
Uncalled bet ($2) returned to matiko09
matiko09 collected $2 from pot
matiko09: doesn't show hand 
tipner leaves the table
*** SUMMARY ***
Total pot $2 | Rake $0 
Seat 5: stefantas (button) folded before Flop (didn't bet)
Seat 6: matiko09 (small blind) collected ($2)
Seat 7: Vecherov (big blind) folded before Flop





PokerStars Hand #155380969597:  Hold'em Pot Limit ($0.50/$1.00 USD) - 2016/06/30 14:25:09 CET [2016/06/30 8:25:09 ET]
Table 'Rafita' 9-max Seat #6 is the button
Seat 6: matiko09 ($101 in chips) 
Seat 7: Vecherov ($100 in chips) 
Seat 8: Ty Nick 420 ($100 in chips) 
Vecherov: posts small blind $0.50
Ty Nick 420: posts big blind $1
nickreason17: sits out 
*** HOLE CARDS ***
Dealt to matiko09 [Td 8h]
matiko09: folds 
Vecherov: folds 
Uncalled bet ($0.50) returned to Ty Nick 420
Ty Nick 420 collected $1 from pot
*** SUMMARY ***
Total pot $1 | Rake $0 
Seat 6: matiko09 (button) folded before Flop (didn't bet)
Seat 7: Vecherov (small blind) folded before Flop
Seat 8: Ty Nick 420 (big blind) collected ($1)





PokerStars Hand #155380970381:  Hold'em No Limit ($0.50/$1.00 USD) - 2016/06/30 14:25:11 CET [2016/06/30 8:25:11 ET]
Table 'California II' 9-max Seat #9 is the button
Seat 1: Rafaello18 ($104.18 in chips) 
Seat 2: ruslik_by ($100 in chips) 
Seat 3: KovIFish89 ($100 in chips) 
Seat 5: Rohitbarve ($111.52 in chips) 
Seat 6: matiko09 ($134.23 in chips) 
Seat 7: DomiVY ($91.38 in chips) 
Seat 8: chenconhaste ($100 in chips) 
Seat 9: di0d80 ($103.37 in chips) 
Rafaello18: posts small blind $0.50
ruslik_by: posts big blind $1
f1reworks: sits out 
*** HOLE CARDS ***
Dealt to matiko09 [5h 9s]
KovIFish89: folds 
Rohitbarve: folds 
matiko09: folds 
DomiVY: raises $2 to $3
chenconhaste: folds 
di0d80: folds 
Rafaello18: folds 
ruslik_by: folds 
Uncalled bet ($2) returned to DomiVY
DomiVY collected $2.50 from pot
DomiVY: doesn't show hand 
*** SUMMARY ***
Total pot $2.50 | Rake $0 
Seat 1: Rafaello18 (small blind) folded before Flop
Seat 2: ruslik_by (big blind) folded before Flop
Seat 3: KovIFish89 folded before Flop (didn't bet)
Seat 5: Rohitbarve folded before Flop (didn't bet)
Seat 6: matiko09 folded before Flop (didn't bet)
Seat 7: DomiVY collected ($2.50)
Seat 8: chenconhaste folded before Flop (didn't bet)
Seat 9: di0d80 (button) folded before Flop (didn't bet)





PokerStars Hand #155380971219:  Hold'em No Limit ($0.50/$1.00 USD) - 2016/06/30 14:25:12 CET [2016/06/30 8:25:12 ET]
Table 'Asmodeus' 9-max Seat #2 is the button
Seat 2: nickreason17 ($102.18 in chips) 
Seat 3: matiko09 ($115.47 in chips) 
Seat 5: sanr23 ($110.30 in chips) 
Seat 6: koutani7 ($82.03 in chips) 
Seat 7: aaronzzr ($130.33 in chips) 
Seat 8: Rafaello18 ($175.57 in chips) 
Seat 9: mbk88 ($159.76 in chips) 
matiko09: posts small blind $0.50
DIMAN_324: is sitting out 
sanr23: posts big blind $1
*** HOLE CARDS ***
Dealt to matiko09 [9d 5c]
DIMAN_324 leaves the table
koutani7: folds 
aaronzzr: raises $2 to $3
Rafaello18: folds 
mbk88: folds 
nickreason17: folds 
matiko09: folds 
Ty Nick 420 joins the table at seat #4 
sanr23: folds 
Uncalled bet ($2) returned to aaronzzr
aaronzzr collected $2.50 from pot
aaronzzr: doesn't show hand 
*** SUMMARY ***
Total pot $2.50 | Rake $0 
Seat 2: nickreason17 (button) folded before Flop (didn't bet)
Seat 3: matiko09 (small blind) folded before Flop
Seat 5: sanr23 (big blind) folded before Flop
Seat 6: koutani7 folded before Flop (didn't bet)
Seat 7: aaronzzr collected ($2.50)
Seat 8: Rafaello18 folded before Flop (didn't bet)
Seat 9: mbk88 folded before Flop (didn't bet)





PokerStars Hand #155380975681:  Hold'em No Limit (€0.25/€0.50 EUR) - 2016/06/30 14:25:22 CET [2016/06/30 8:25:22 ET]
Table 'Vibeke II' 9-max Seat #5 is the button
Seat 4: acelacat111 (€26 in chips) 
Seat 5: mazefaka007 (€50 in chips) 
Seat 6: Kukuryzka (€49.50 in chips) 
Seat 7: matiko09 (€59.85 in chips) 
Kukuryzka: posts small blind €0.25
matiko09: posts big blind €0.50
*** HOLE CARDS ***
Dealt to matiko09 [3c 7d]
mr.loon21 leaves the table
acelacat111: folds 
mazefaka007: raises €0.55 to €1.05
Kukuryzka: folds 
matiko09: folds 
Uncalled bet (€0.55) returned to mazefaka007
mazefaka007 collected €1.25 from pot
mazefaka007: doesn't show hand 
*** SUMMARY ***
Total pot €1.25 | Rake €0 
Seat 4: acelacat111 folded before Flop (didn't bet)
Seat 5: mazefaka007 (button) collected (€1.25)
Seat 6: Kukuryzka (small blind) folded before Flop
Seat 7: matiko09 (big blind) folded before Flop





PokerStars Hand #155380975882:  Hold'em No Limit ($0.50/$1.00 USD) - 2016/06/30 14:25:23 CET [2016/06/30 8:25:23 ET]
Table 'Simeisa II' 9-max Seat #7 is the button
Seat 1: joooh79 ($97.23 in chips) 
Seat 2: Rafaello18 ($142.65 in chips) 
Seat 3: matiko09 ($100 in chips) 
Seat 4: Ty Nick 420 ($100 in chips) 
Seat 5: arctur17 ($77.93 in chips) 
Seat 6: ruslik_by ($100 in chips) 
Seat 7: Eriksjef93 ($35.57 in chips) 
Seat 8: DIMAN_324 ($175.37 in chips) 
Seat 9: mbk88 ($186.18 in chips) 
DIMAN_324: posts small blind $0.50
mbk88: posts big blind $1
*** HOLE CARDS ***
Dealt to matiko09 [Ts 3c]
joooh79: folds 
Rafaello18: folds 
matiko09: folds 
Ty Nick 420: folds 
arctur17: raises $2 to $3
ruslik_by: folds 
Eriksjef93: folds 
DIMAN_324: folds 
mbk88: folds 
Uncalled bet ($2) returned to arctur17
arctur17 collected $2.50 from pot
arctur17: doesn't show hand 
*** SUMMARY ***
Total pot $2.50 | Rake $0 
Seat 1: joooh79 folded before Flop (didn't bet)
Seat 2: Rafaello18 folded before Flop (didn't bet)
Seat 3: matiko09 folded before Flop (didn't bet)
Seat 4: Ty Nick 420 folded before Flop (didn't bet)
Seat 5: arctur17 collected ($2.50)
Seat 6: ruslik_by folded before Flop (didn't bet)
Seat 7: Eriksjef93 (button) folded before Flop (didn't bet)
Seat 8: DIMAN_324 (small blind) folded before Flop
Seat 9: mbk88 (big blind) folded before Flop





PokerStars Hand #155380977254:  Hold'em No Limit ($0.25/$0.50 USD) - 2016/06/30 14:25:26 CET [2016/06/30 8:25:26 ET]
Table 'Arcturus' 9-max Seat #3 is the button
Seat 1: kourk250 ($144.07 in chips) 
Seat 2: Rafaello18 ($50 in chips) 
Seat 3: matiko09 ($50 in chips) 
Seat 5: stockbridge8 ($48 in chips) 
Seat 6: statistik85 ($64.22 in chips) 
Seat 7: bratbugor ($50 in chips) 
Seat 8: TheMinion ($50 in chips) 
Seat 9: pfunkolstar ($110.22 in chips) 
stockbridge8: posts small blind $0.25
statistik85: posts big blind $0.50
*** HOLE CARDS ***
Dealt to matiko09 [9s 5c]
bratbugor: folds 
TheMinion: folds 
pfunkolstar: folds 
kourk250: folds 
Rafaello18: folds 
matiko09: folds 
stockbridge8: folds 
Uncalled bet ($0.25) returned to statistik85
statistik85 collected $0.50 from pot
statistik85: doesn't show hand 
*** SUMMARY ***
Total pot $0.50 | Rake $0 
Seat 1: kourk250 folded before Flop (didn't bet)
Seat 2: Rafaello18 folded before Flop (didn't bet)
Seat 3: matiko09 (button) folded before Flop (didn't bet)
Seat 5: stockbridge8 (small blind) folded before Flop
Seat 6: statistik85 (big blind) collected ($0.50)
Seat 7: bratbugor folded before Flop (didn't bet)
Seat 8: TheMinion folded before Flop (didn't bet)
Seat 9: pfunkolstar folded before Flop (didn't bet)





PokerStars Hand #155380978180:  Hold'em No Limit ($0.50/$1.00 USD) - 2016/06/30 14:25:28 CET [2016/06/30 8:25:28 ET]
Table 'Sigrid' 9-max Seat #2 is the button
Seat 1: Greha999 ($60.08 in chips) 
Seat 2: matiko09 ($108.66 in chips) 
Seat 3: Rafaello18 ($107.13 in chips) 
Seat 4: mbk88 ($117.37 in chips) 
Seat 7: arctur17 ($105.62 in chips) 
Seat 8: ruslik_by ($105.62 in chips) 
Seat 9: KovIFish89 ($103.58 in chips) 
Rafaello18: posts small blind $0.50
mbk88: posts big blind $1
chenconhaste: sits out 
*** HOLE CARDS ***
Dealt to matiko09 [2d 3c]
arctur17: folds 
ruslik_by: folds 
KovIFish89: folds 
Greha999: folds 
matiko09: folds 
Rafaello18: folds 
Uncalled bet ($0.50) returned to mbk88
mbk88 collected $1 from pot
mbk88: doesn't show hand 
*** SUMMARY ***
Total pot $1 | Rake $0 
Seat 1: Greha999 folded before Flop (didn't bet)
Seat 2: matiko09 (button) folded before Flop (didn't bet)
Seat 3: Rafaello18 (small blind) folded before Flop
Seat 4: mbk88 (big blind) collected ($1)
Seat 7: arctur17 folded before Flop (didn't bet)
Seat 8: ruslik_by folded before Flop (didn't bet)
Seat 9: KovIFish89 folded before Flop (didn't bet)





PokerStars Hand #155380979866:  Hold'em No Limit ($0.50/$1.00 USD) - 2016/06/30 14:25:31 CET [2016/06/30 8:25:31 ET]
Table 'Borrelly II' 9-max Seat #1 is the button
Seat 1: Rafaello18 ($115.57 in chips) 
Seat 2: mbk88 ($116.78 in chips) 
Seat 4: DonRon_AT ($41.69 in chips) 
Seat 5: DIMAN_324 ($103.58 in chips) 
Seat 6: m_michalec ($163.04 in chips) 
Seat 7: matiko09 ($177.36 in chips) 
Seat 8: Arjun A Raju ($133.92 in chips) 
Seat 9: alhill86 ($79.90 in chips) 
mbk88: posts small blind $0.50
di0d80: is sitting out 
DonRon_AT: posts big blind $1
*** HOLE CARDS ***
Dealt to matiko09 [5h 5d]
di0d80 leaves the table
DIMAN_324: folds 
nickreason17 joins the table at seat #3 
m_michalec: folds 
matiko09: raises $2 to $3
Arjun A Raju: folds 
alhill86: folds 
Rafaello18: calls $3
mbk88: folds 
DonRon_AT: calls $2
*** FLOP *** [9c Ks Ac]
DonRon_AT: checks 
matiko09: checks 
Rafaello18: checks 
*** TURN *** [9c Ks Ac] [3s]
DonRon_AT: checks 
matiko09: checks 
Rafaello18: checks 
*** RIVER *** [9c Ks Ac 3s] [6d]
DonRon_AT: checks 
matiko09: checks 
Rafaello18: bets $2.97
DonRon_AT: folds 
matiko09: folds 
Uncalled bet ($2.97) returned to Rafaello18
Rafaello18 collected $9.02 from pot
Rafaello18: doesn't show hand 
*** SUMMARY ***
Total pot $9.50 | Rake $0.48 
Board [9c Ks Ac 3s 6d]
Seat 1: Rafaello18 (button) collected ($9.02)
Seat 2: mbk88 (small blind) folded before Flop
Seat 4: DonRon_AT (big blind) folded on the River
Seat 5: DIMAN_324 folded before Flop (didn't bet)
Seat 6: m_michalec folded before Flop (didn't bet)
Seat 7: matiko09 folded on the River
Seat 8: Arjun A Raju folded before Flop (didn't bet)
Seat 9: alhill86 folded before Flop (didn't bet)





PokerStars Hand #155380984306:  Hold'em No Limit ($0.50/$1.00 USD) - 2016/06/30 14:25:41 CET [2016/06/30 8:25:41 ET]
Table 'California II' 9-max Seat #1 is the button
Seat 1: Rafaello18 ($103.68 in chips) 
Seat 2: ruslik_by ($100 in chips) 
Seat 3: KovIFish89 ($100 in chips) 
Seat 5: Rohitbarve ($111.52 in chips) 
Seat 6: matiko09 ($134.23 in chips) 
Seat 7: DomiVY ($92.88 in chips) 
Seat 8: chenconhaste ($100 in chips) 
Seat 9: di0d80 ($103.37 in chips) 
ruslik_by: posts small blind $0.50
KovIFish89: posts big blind $1
f1reworks: sits out 
*** HOLE CARDS ***
Dealt to matiko09 [2s 5d]
Rohitbarve: folds 
matiko09: folds 
DomiVY: folds 
chenconhaste: folds 
di0d80: raises $1.50 to $2.50
Rafaello18: folds 
ruslik_by: folds 
KovIFish89: folds 
Uncalled bet ($1.50) returned to di0d80
di0d80 collected $2.50 from pot
di0d80: doesn't show hand 
*** SUMMARY ***
Total pot $2.50 | Rake $0 
Seat 1: Rafaello18 (button) folded before Flop (didn't bet)
Seat 2: ruslik_by (small blind) folded before Flop
Seat 3: KovIFish89 (big blind) folded before Flop
Seat 5: Rohitbarve folded before Flop (didn't bet)
Seat 6: matiko09 folded before Flop (didn't bet)
Seat 7: DomiVY folded before Flop (didn't bet)
Seat 8: chenconhaste folded before Flop (didn't bet)
Seat 9: di0d80 collected ($2.50)





PokerStars Hand #155380986241:  Hold'em No Limit ($0.50/$1.00 USD) - 2016/06/30 14:25:45 CET [2016/06/30 8:25:45 ET]
Table 'Altarf II' 9-max Seat #7 is the button
Seat 1: Rafaello18 ($100 in chips) 
Seat 2: KovIFish89 ($101.50 in chips) 
Seat 4: Greha999 ($151.88 in chips) 
Seat 5: DIMAN_324 ($227.24 in chips) 
Seat 6: mbk88 ($100 in chips) 
Seat 7: matiko09 ($101.90 in chips) 
Seat 8: DomiVY ($41.12 in chips) 
Seat 9: omanibemihum ($168.69 in chips) 
DomiVY: posts small blind $0.50
omanibemihum: posts big blind $1
sanr23: sits out 
*** HOLE CARDS ***
Dealt to matiko09 [Kc Ah]
Rafaello18: folds 
KovIFish89: folds 
Greha999: folds 
DIMAN_324: folds 
mbk88: folds 
matiko09: raises $1.27 to $2.27
DomiVY: folds 
omanibemihum: calls $1.27
*** FLOP *** [Kh Th 7d]
omanibemihum: bets $2
matiko09: raises $5.71 to $7.71
omanibemihum: folds 
Uncalled bet ($5.71) returned to matiko09
matiko09 collected $8.59 from pot
matiko09: doesn't show hand 
*** SUMMARY ***
Total pot $9.04 | Rake $0.45 
Board [Kh Th 7d]
Seat 1: Rafaello18 folded before Flop (didn't bet)
Seat 2: KovIFish89 folded before Flop (didn't bet)
Seat 4: Greha999 folded before Flop (didn't bet)
Seat 5: DIMAN_324 folded before Flop (didn't bet)
Seat 6: mbk88 folded before Flop (didn't bet)
Seat 7: matiko09 (button) collected ($8.59)
Seat 8: DomiVY (small blind) folded before Flop
Seat 9: omanibemihum (big blind) folded on the Flop





PokerStars Hand #155380989255:  Hold'em No Limit ($0.50/$1.00 USD) - 2016/06/30 14:25:52 CET [2016/06/30 8:25:52 ET]
Table 'Asmodeus' 9-max Seat #3 is the button
Seat 2: nickreason17 ($102.18 in chips) 
Seat 3: matiko09 ($114.97 in chips) 
Seat 5: sanr23 ($109.30 in chips) 
Seat 6: koutani7 ($82.03 in chips) 
Seat 7: aaronzzr ($131.83 in chips) 
Seat 8: Rafaello18 ($175.57 in chips) 
Seat 9: mbk88 ($159.76 in chips) 
Ty Nick 420 will be allowed to play after the button
sanr23: posts small blind $0.50
koutani7: posts big blind $1
*** HOLE CARDS ***
Dealt to matiko09 [Th 4s]
aaronzzr: folds 
Rafaello18: folds 
mbk88: folds 
nickreason17: folds 
matiko09: folds 
sanr23: raises $1.50 to $2.50
koutani7: folds 
Uncalled bet ($1.50) returned to sanr23
sanr23 collected $2 from pot
sanr23: doesn't show hand 
*** SUMMARY ***
Total pot $2 | Rake $0 
Seat 2: nickreason17 folded before Flop (didn't bet)
Seat 3: matiko09 (button) folded before Flop (didn't bet)
Seat 5: sanr23 (small blind) collected ($2)
Seat 6: koutani7 (big blind) folded before Flop
Seat 7: aaronzzr folded before Flop (didn't bet)
Seat 8: Rafaello18 folded before Flop (didn't bet)
Seat 9: mbk88 folded before Flop (didn't bet)





PokerStars Hand #155380989755:  Hold'em No Limit ($0.50/$1.00 USD) - 2016/06/30 14:25:53 CET [2016/06/30 8:25:53 ET]
Table 'Simeisa II' 9-max Seat #8 is the button
Seat 1: joooh79 ($97.23 in chips) 
Seat 2: Rafaello18 ($142.65 in chips) 
Seat 3: matiko09 ($100 in chips) 
Seat 4: Ty Nick 420 ($100 in chips) 
Seat 5: arctur17 ($79.43 in chips) 
Seat 6: ruslik_by ($100 in chips) 
Seat 7: Eriksjef93 ($35.57 in chips) 
Seat 8: DIMAN_324 ($174.87 in chips) 
Seat 9: mbk88 ($185.18 in chips) 
mbk88: posts small blind $0.50
joooh79: posts big blind $1
*** HOLE CARDS ***
Dealt to matiko09 [2d 2s]
Rafaello18: folds 
matiko09: folds 
Ty Nick 420: folds 
arctur17: folds 
ruslik_by: folds 
Eriksjef93: raises $2 to $3
DIMAN_324: folds 
mbk88: folds 
joooh79: folds 
Uncalled bet ($2) returned to Eriksjef93
Eriksjef93 collected $2.50 from pot
Eriksjef93: doesn't show hand 
*** SUMMARY ***
Total pot $2.50 | Rake $0 
Seat 1: joooh79 (big blind) folded before Flop
Seat 2: Rafaello18 folded before Flop (didn't bet)
Seat 3: matiko09 folded before Flop (didn't bet)
Seat 4: Ty Nick 420 folded before Flop (didn't bet)
Seat 5: arctur17 folded before Flop (didn't bet)
Seat 6: ruslik_by folded before Flop (didn't bet)
Seat 7: Eriksjef93 collected ($2.50)
Seat 8: DIMAN_324 (button) folded before Flop (didn't bet)
Seat 9: mbk88 (small blind) folded before Flop





PokerStars Hand #155380991117:  Hold'em No Limit ($0.25/$0.50 USD) - 2016/06/30 14:25:56 CET [2016/06/30 8:25:56 ET]
Table 'Arcturus' 9-max Seat #5 is the button
Seat 1: kourk250 ($144.07 in chips) 
Seat 2: Rafaello18 ($50 in chips) 
Seat 3: matiko09 ($50 in chips) 
Seat 5: stockbridge8 ($47.75 in chips) 
Seat 6: statistik85 ($64.47 in chips) 
Seat 7: bratbugor ($50 in chips) 
Seat 8: TheMinion ($50 in chips) 
Seat 9: pfunkolstar ($110.22 in chips) 
statistik85: posts small blind $0.25
bratbugor: posts big blind $0.50
*** HOLE CARDS ***
Dealt to matiko09 [4s Qs]
TheMinion: raises $1 to $1.50
pfunkolstar: calls $1.50
kourk250: calls $1.50
Rafaello18: folds 
matiko09: folds 
stockbridge8: folds 
statistik85: folds 
bratbugor: folds 
*** FLOP *** [Kc 8c 9h]
TheMinion: checks 
pfunkolstar: checks 
kourk250: checks 
*** TURN *** [Kc 8c 9h] [9c]
TheMinion: checks 
pfunkolstar: checks 
kourk250: checks 
*** RIVER *** [Kc 8c 9h 9c] [3d]
TheMinion: checks 
pfunkolstar: checks 
kourk250: checks 
*** SHOW DOWN ***
TheMinion: shows [Jd Jh] (two pair, Jacks and Nines)
pfunkolstar: mucks hand 
kourk250: shows [Kd 6d] (two pair, Kings and Nines)
kourk250 collected $4.99 from pot
*** SUMMARY ***
Total pot $5.25 | Rake $0.26 
Board [Kc 8c 9h 9c 3d]
Seat 1: kourk250 showed [Kd 6d] and won ($4.99) with two pair, Kings and Nines
Seat 2: Rafaello18 folded before Flop (didn't bet)
Seat 3: matiko09 folded before Flop (didn't bet)
Seat 5: stockbridge8 (button) folded before Flop (didn't bet)
Seat 6: statistik85 (small blind) folded before Flop
Seat 7: bratbugor (big blind) folded before Flop
Seat 8: TheMinion showed [Jd Jh] and lost with two pair, Jacks and Nines
Seat 9: pfunkolstar mucked [4c 4h]





PokerStars Hand #155380991741:  Hold'em No Limit (€0.25/€0.50 EUR) - 2016/06/30 14:25:57 CET [2016/06/30 8:25:57 ET]
Table 'Vibeke II' 9-max Seat #6 is the button
Seat 4: acelacat111 (€26 in chips) 
Seat 5: mazefaka007 (€50.75 in chips) 
Seat 6: Kukuryzka (€50 in chips) 
Seat 7: matiko09 (€59.35 in chips) 
matiko09: posts small blind €0.25
acelacat111: posts big blind €0.50
*** HOLE CARDS ***
Dealt to matiko09 [Qh 2d]
mazefaka007: folds 
KABAL_ua joins the table at seat #8 
Kukuryzka: folds 
matiko09: folds 
Uncalled bet (€0.25) returned to acelacat111
acelacat111 collected €0.50 from pot
*** SUMMARY ***
Total pot €0.50 | Rake €0 
Seat 4: acelacat111 (big blind) collected (€0.50)
Seat 5: mazefaka007 folded before Flop (didn't bet)
Seat 6: Kukuryzka (button) folded before Flop (didn't bet)
Seat 7: matiko09 (small blind) folded before Flop





PokerStars Hand #155380994999:  Hold'em No Limit ($0.50/$1.00 USD) - 2016/06/30 14:26:04 CET [2016/06/30 8:26:04 ET]
Table 'Tatjana' 9-max Seat #4 is the button
Seat 1: tipner ($105.70 in chips) 
Seat 2: DIMAN_324 ($113.53 in chips) 
Seat 3: Rafaello18 ($101.29 in chips) 
Seat 4: mopatron25 ($87.08 in chips) 
Seat 5: matiko09 ($100 in chips) 
Seat 6: mbk88 ($170.04 in chips) 
Seat 8: alhill86 ($98.86 in chips) 
Seat 9: POTAPENKO700 ($235.43 in chips) 
matiko09: posts small blind $0.50
mbk88: posts big blind $1
*** HOLE CARDS ***
Dealt to matiko09 [9d 8h]
alhill86: raises $2 to $3
POTAPENKO700: folds 
tipner: folds 
DIMAN_324: folds 
Rafaello18: folds 
mopatron25: folds 
matiko09: folds 
mbk88: folds 
Uncalled bet ($2) returned to alhill86
alhill86 collected $2.50 from pot
alhill86: doesn't show hand 
*** SUMMARY ***
Total pot $2.50 | Rake $0 
Seat 1: tipner folded before Flop (didn't bet)
Seat 2: DIMAN_324 folded before Flop (didn't bet)
Seat 3: Rafaello18 folded before Flop (didn't bet)
Seat 4: mopatron25 (button) folded before Flop (didn't bet)
Seat 5: matiko09 (small blind) folded before Flop
Seat 6: mbk88 (big blind) folded before Flop
Seat 8: alhill86 collected ($2.50)
Seat 9: POTAPENKO700 folded before Flop (didn't bet)





PokerStars Hand #155380999663:  Hold'em No Limit ($0.50/$1.00 USD) - 2016/06/30 14:26:14 CET [2016/06/30 8:26:14 ET]
Table 'California II' 9-max Seat #2 is the button
Seat 1: Rafaello18 ($103.68 in chips) 
Seat 2: ruslik_by ($100 in chips) 
Seat 3: KovIFish89 ($100 in chips) 
Seat 4: f1reworks ($100 in chips) 
Seat 5: Rohitbarve ($111.52 in chips) 
Seat 6: matiko09 ($134.23 in chips) 
Seat 7: DomiVY ($92.88 in chips) 
Seat 8: chenconhaste ($100 in chips) 
Seat 9: di0d80 ($104.87 in chips) 
KovIFish89: posts small blind $0.50
f1reworks: posts big blind $1
*** HOLE CARDS ***
Dealt to matiko09 [Th 3s]
Rohitbarve: folds 
matiko09: folds 
DomiVY: folds 
chenconhaste: raises $1.25 to $2.25
di0d80: folds 
Rafaello18: folds 
ruslik_by: folds 
KovIFish89: folds 
f1reworks: folds 
Uncalled bet ($1.25) returned to chenconhaste
chenconhaste collected $2.50 from pot
*** SUMMARY ***
Total pot $2.50 | Rake $0 
Seat 1: Rafaello18 folded before Flop (didn't bet)
Seat 2: ruslik_by (button) folded before Flop (didn't bet)
Seat 3: KovIFish89 (small blind) folded before Flop
Seat 4: f1reworks (big blind) folded before Flop
Seat 5: Rohitbarve folded before Flop (didn't bet)
Seat 6: matiko09 folded before Flop (didn't bet)
Seat 7: DomiVY folded before Flop (didn't bet)
Seat 8: chenconhaste collected ($2.50)
Seat 9: di0d80 folded before Flop (didn't bet)





PokerStars Hand #155381001134:  Hold'em No Limit ($0.50/$1.00 USD) - 2016/06/30 14:26:17 CET [2016/06/30 8:26:17 ET]
Table 'Donnera' 9-max Seat #5 is the button
Seat 1: chenconhaste ($113.06 in chips) 
Seat 2: robbiescrim9 ($115.26 in chips) 
Seat 3: matiko09 ($109.25 in chips) 
Seat 4: Kukuryzka ($100 in chips) 
Seat 5: tipner ($100 in chips) 
Seat 6: nickreason17 ($100 in chips) 
Seat 7: Rafaello18 ($100 in chips) 
Seat 8: ruslik_by ($216.10 in chips) 
Seat 9: Starw!nd ($107.25 in chips) 
nickreason17: posts small blind $0.50
Rafaello18: posts big blind $1
*** HOLE CARDS ***
Dealt to matiko09 [Ad 2d]
ruslik_by: folds 
Starw!nd: raises $2 to $3
chenconhaste: folds 
robbiescrim9: folds 
matiko09: folds 
Kukuryzka: folds 
tipner: folds 
nickreason17: folds 
Rafaello18: folds 
Uncalled bet ($2) returned to Starw!nd
Starw!nd collected $2.50 from pot
Starw!nd: doesn't show hand 
*** SUMMARY ***
Total pot $2.50 | Rake $0 
Seat 1: chenconhaste folded before Flop (didn't bet)
Seat 2: robbiescrim9 folded before Flop (didn't bet)
Seat 3: matiko09 folded before Flop (didn't bet)
Seat 4: Kukuryzka folded before Flop (didn't bet)
Seat 5: tipner (button) folded before Flop (didn't bet)
Seat 6: nickreason17 (small blind) folded before Flop
Seat 7: Rafaello18 (big blind) folded before Flop
Seat 8: ruslik_by folded before Flop (didn't bet)
Seat 9: Starw!nd collected ($2.50)





PokerStars Hand #155381001831:  Hold'em No Limit (€0.25/€0.50 EUR) - 2016/06/30 14:26:18 CET [2016/06/30 8:26:18 ET]
Table 'Vibeke II' 9-max Seat #7 is the button
Seat 4: acelacat111 (€26.25 in chips) 
Seat 5: mazefaka007 (€50.75 in chips) 
Seat 6: Kukuryzka (€50 in chips) 
Seat 7: matiko09 (€59.10 in chips) 
KABAL_ua will be allowed to play after the button
acelacat111: posts small blind €0.25
mazefaka007: posts big blind €0.50
*** HOLE CARDS ***
Dealt to matiko09 [7h 7d]
Kukuryzka: folds 
matiko09: raises €0.63 to €1.13
acelacat111: folds 
mazefaka007: raises €2.26 to €3.39
matiko09: calls €2.26
*** FLOP *** [Ah 7c Js]
mazefaka007: bets €3.34
matiko09: calls €3.34
*** TURN *** [Ah 7c Js] [9d]
mazefaka007: checks 
matiko09: bets €8.50
mazefaka007: folds 
Uncalled bet (€8.50) returned to matiko09
matiko09 collected €13.02 from pot
matiko09: doesn't show hand 
*** SUMMARY ***
Total pot €13.71 | Rake €0.69 
Board [Ah 7c Js 9d]
Seat 4: acelacat111 (small blind) folded before Flop
Seat 5: mazefaka007 (big blind) folded on the Turn
Seat 6: Kukuryzka folded before Flop (didn't bet)
Seat 7: matiko09 (button) collected (€13.02)





PokerStars Hand #155381001765:  Hold'em No Limit ($0.50/$1.00 USD) - 2016/06/30 14:26:18 CET [2016/06/30 8:26:18 ET]
Table 'Sigrid' 9-max Seat #3 is the button
Seat 1: Greha999 ($60.08 in chips) 
Seat 2: matiko09 ($108.66 in chips) 
Seat 3: Rafaello18 ($106.63 in chips) 
Seat 4: mbk88 ($117.87 in chips) 
Seat 5: chenconhaste ($100 in chips) 
Seat 7: arctur17 ($105.62 in chips) 
Seat 8: ruslik_by ($105.62 in chips) 
Seat 9: KovIFish89 ($103.58 in chips) 
mbk88: posts small blind $0.50
chenconhaste: posts big blind $1
*** HOLE CARDS ***
Dealt to matiko09 [Jc Td]
arctur17: folds 
ruslik_by: folds 
KovIFish89: folds 
Greha999: folds 
matiko09: folds 
Rafaello18: folds 
mbk88: raises $2 to $3
chenconhaste: folds 
Uncalled bet ($2) returned to mbk88
mbk88 collected $2 from pot
mbk88: doesn't show hand 
*** SUMMARY ***
Total pot $2 | Rake $0 
Seat 1: Greha999 folded before Flop (didn't bet)
Seat 2: matiko09 folded before Flop (didn't bet)
Seat 3: Rafaello18 (button) folded before Flop (didn't bet)
Seat 4: mbk88 (small blind) collected ($2)
Seat 5: chenconhaste (big blind) folded before Flop
Seat 7: arctur17 folded before Flop (didn't bet)
Seat 8: ruslik_by folded before Flop (didn't bet)
Seat 9: KovIFish89 folded before Flop (didn't bet)





PokerStars Hand #155381005777:  Hold'em No Limit ($0.50/$1.00 USD) - 2016/06/30 14:26:27 CET [2016/06/30 8:26:27 ET]
Table 'Tatjana' 9-max Seat #5 is the button
Seat 1: tipner ($105.70 in chips) 
Seat 2: DIMAN_324 ($113.53 in chips) 
Seat 3: Rafaello18 ($101.29 in chips) 
Seat 4: mopatron25 ($87.08 in chips) 
Seat 5: matiko09 ($100 in chips) 
Seat 6: mbk88 ($169.04 in chips) 
Seat 8: alhill86 ($100.36 in chips) 
Seat 9: POTAPENKO700 ($235.43 in chips) 
mbk88: posts small blind $0.50
alhill86: posts big blind $1
*** HOLE CARDS ***
Dealt to matiko09 [6s Td]
POTAPENKO700: folds 
tipner: folds 
DIMAN_324: folds 
Rafaello18: folds 
mopatron25: folds 
matiko09: folds 
mbk88: calls $0.50
alhill86: checks 
*** FLOP *** [7s 6d 5h]
mbk88: bets $2
alhill86: raises $5 to $7
mbk88: calls $5
*** TURN *** [7s 6d 5h] [9d]
mbk88: checks 
alhill86: bets $9
mbk88: folds 
Uncalled bet ($9) returned to alhill86
alhill86 collected $15.20 from pot
alhill86: doesn't show hand 
*** SUMMARY ***
Total pot $16 | Rake $0.80 
Board [7s 6d 5h 9d]
Seat 1: tipner folded before Flop (didn't bet)
Seat 2: DIMAN_324 folded before Flop (didn't bet)
Seat 3: Rafaello18 folded before Flop (didn't bet)
Seat 4: mopatron25 folded before Flop (didn't bet)
Seat 5: matiko09 (button) folded before Flop (didn't bet)
Seat 6: mbk88 (small blind) folded on the Turn
Seat 8: alhill86 (big blind) collected ($15.20)
Seat 9: POTAPENKO700 folded before Flop (didn't bet)





PokerStars Hand #155381006087:  Hold'em No Limit ($0.50/$1.00 USD) - 2016/06/30 14:26:28 CET [2016/06/30 8:26:28 ET]
Table 'Asmodeus' 9-max Seat #5 is the button
Seat 2: nickreason17 ($102.18 in chips) 
Seat 3: matiko09 ($114.97 in chips) 
Seat 5: sanr23 ($110.30 in chips) 
Seat 6: koutani7 ($81.03 in chips) 
Seat 7: aaronzzr ($131.83 in chips) 
Seat 8: Rafaello18 ($175.57 in chips) 
Seat 9: mbk88 ($159.76 in chips) 
koutani7: posts small blind $0.50
aaronzzr: posts big blind $1
Ty Nick 420: sits out 
*** HOLE CARDS ***
Dealt to matiko09 [Ks 6d]
Rafaello18: folds 
mbk88: folds 
nickreason17: folds 
matiko09: folds 
sanr23: raises $1 to $2
koutani7: folds 
aaronzzr: folds 
Uncalled bet ($1) returned to sanr23
sanr23 collected $2.50 from pot
sanr23: doesn't show hand 
*** SUMMARY ***
Total pot $2.50 | Rake $0 
Seat 2: nickreason17 folded before Flop (didn't bet)
Seat 3: matiko09 folded before Flop (didn't bet)
Seat 5: sanr23 (button) collected ($2.50)
Seat 6: koutani7 (small blind) folded before Flop
Seat 7: aaronzzr (big blind) folded before Flop
Seat 8: Rafaello18 folded before Flop (didn't bet)
Seat 9: mbk88 folded before Flop (didn't bet)





PokerStars Hand #155381012928:  Hold'em No Limit ($0.50/$1.00 USD) - 2016/06/30 14:26:43 CET [2016/06/30 8:26:43 ET]
Table 'Altarf II' 9-max Seat #8 is the button
Seat 1: Rafaello18 ($100 in chips) 
Seat 2: KovIFish89 ($101.50 in chips) 
Seat 4: Greha999 ($151.88 in chips) 
Seat 5: DIMAN_324 ($227.24 in chips) 
Seat 6: mbk88 ($100 in chips) 
Seat 7: matiko09 ($106.22 in chips) 
Seat 8: DomiVY ($40.62 in chips) 
Seat 9: omanibemihum ($164.42 in chips) 
omanibemihum: posts small blind $0.50
Rafaello18: posts big blind $1
sanr23: sits out 
*** HOLE CARDS ***
Dealt to matiko09 [2h Ks]
KovIFish89: folds 
Greha999: folds 
DIMAN_324: raises $2 to $3
mbk88: folds 
matiko09: folds 
DomiVY: folds 
omanibemihum: folds 
Rafaello18: folds 
Uncalled bet ($2) returned to DIMAN_324
DIMAN_324 collected $2.50 from pot
DIMAN_324: doesn't show hand 
*** SUMMARY ***
Total pot $2.50 | Rake $0 
Seat 1: Rafaello18 (big blind) folded before Flop
Seat 2: KovIFish89 folded before Flop (didn't bet)
Seat 4: Greha999 folded before Flop (didn't bet)
Seat 5: DIMAN_324 collected ($2.50)
Seat 6: mbk88 folded before Flop (didn't bet)
Seat 7: matiko09 folded before Flop (didn't bet)
Seat 8: DomiVY (button) folded before Flop (didn't bet)
Seat 9: omanibemihum (small blind) folded before Flop





PokerStars Hand #155381017553:  Hold'em No Limit ($0.50/$1.00 USD) - 2016/06/30 14:26:53 CET [2016/06/30 8:26:53 ET]
Table 'Asmodeus' 9-max Seat #6 is the button
Seat 2: nickreason17 ($102.18 in chips) 
Seat 3: matiko09 ($114.97 in chips) 
Seat 5: sanr23 ($111.80 in chips) 
Seat 6: koutani7 ($80.53 in chips) 
Seat 7: aaronzzr ($130.83 in chips) 
Seat 8: Rafaello18 ($175.57 in chips) 
Seat 9: mbk88 ($159.76 in chips) 
aaronzzr: posts small blind $0.50
Rafaello18: posts big blind $1
Ty Nick 420: sits out 
*** HOLE CARDS ***
Dealt to matiko09 [Kd 9s]
mbk88: raises $2 to $3
nickreason17: folds 
matiko09: folds 
sanr23: folds 
koutani7: folds 
aaronzzr: folds 
Rafaello18: folds 
Uncalled bet ($2) returned to mbk88
mbk88 collected $2.50 from pot
mbk88: doesn't show hand 
*** SUMMARY ***
Total pot $2.50 | Rake $0 
Seat 2: nickreason17 folded before Flop (didn't bet)
Seat 3: matiko09 folded before Flop (didn't bet)
Seat 5: sanr23 folded before Flop (didn't bet)
Seat 6: koutani7 (button) folded before Flop (didn't bet)
Seat 7: aaronzzr (small blind) folded before Flop
Seat 8: Rafaello18 (big blind) folded before Flop
Seat 9: mbk88 collected ($2.50)





PokerStars Hand #155381018260:  Hold'em No Limit ($0.50/$1.00 USD) - 2016/06/30 14:26:54 CET [2016/06/30 8:26:54 ET]
Table 'Donnera' 9-max Seat #6 is the button
Seat 1: chenconhaste ($113.06 in chips) 
Seat 2: robbiescrim9 ($115.26 in chips) 
Seat 3: matiko09 ($109.25 in chips) 
Seat 4: Kukuryzka ($100 in chips) 
Seat 5: tipner ($100 in chips) 
Seat 6: nickreason17 ($100 in chips) 
Seat 7: Rafaello18 ($100 in chips) 
Seat 8: ruslik_by ($216.10 in chips) 
Seat 9: Starw!nd ($108.75 in chips) 
Rafaello18: posts small blind $0.50
ruslik_by: posts big blind $1
*** HOLE CARDS ***
Dealt to matiko09 [6s 4s]
Starw!nd: folds 
chenconhaste: folds 
robbiescrim9: folds 
matiko09: folds 
Kukuryzka: raises $2 to $3
tipner has timed out
tipner: folds 
nickreason17: folds 
Rafaello18: calls $2.50
ruslik_by: folds 
*** FLOP *** [4c Kd Kh]
Rafaello18: checks 
Kukuryzka: checks 
*** TURN *** [4c Kd Kh] [Ah]
Rafaello18: bets $4
Kukuryzka: folds 
Uncalled bet ($4) returned to Rafaello18
Rafaello18 collected $6.65 from pot
Rafaello18: doesn't show hand 
*** SUMMARY ***
Total pot $7 | Rake $0.35 
Board [4c Kd Kh Ah]
Seat 1: chenconhaste folded before Flop (didn't bet)
Seat 2: robbiescrim9 folded before Flop (didn't bet)
Seat 3: matiko09 folded before Flop (didn't bet)
Seat 4: Kukuryzka folded on the Turn
Seat 5: tipner folded before Flop (didn't bet)
Seat 6: nickreason17 (button) folded before Flop (didn't bet)
Seat 7: Rafaello18 (small blind) collected ($6.65)
Seat 8: ruslik_by (big blind) folded before Flop
Seat 9: Starw!nd folded before Flop (didn't bet)





PokerStars Hand #155381018975:  Hold'em No Limit ($0.50/$1.00 USD) - 2016/06/30 14:26:56 CET [2016/06/30 8:26:56 ET]
Table 'California II' 9-max Seat #3 is the button
Seat 1: Rafaello18 ($103.68 in chips) 
Seat 2: ruslik_by ($100 in chips) 
Seat 3: KovIFish89 ($100 in chips) 
Seat 4: f1reworks ($100 in chips) 
Seat 5: Rohitbarve ($111.52 in chips) 
Seat 6: matiko09 ($134.23 in chips) 
Seat 7: DomiVY ($92.88 in chips) 
Seat 8: chenconhaste ($101.50 in chips) 
Seat 9: di0d80 ($104.87 in chips) 
f1reworks: posts small blind $0.50
Rohitbarve: posts big blind $1
*** HOLE CARDS ***
Dealt to matiko09 [Qd 7d]
matiko09: folds 
DomiVY: folds 
chenconhaste: raises $1.25 to $2.25
di0d80: folds 
Rafaello18: folds 
ruslik_by: calls $2.25
KovIFish89: calls $2.25
f1reworks: folds 
Rohitbarve: calls $1.25
*** FLOP *** [Ks Tc 6c]
Rohitbarve: checks 
chenconhaste: checks 
ruslik_by: checks 
KovIFish89: bets $6
Rohitbarve: folds 
chenconhaste: folds 
ruslik_by: calls $6
*** TURN *** [Ks Tc 6c] [2c]
ruslik_by: checks 
KovIFish89: checks 
*** RIVER *** [Ks Tc 6c 2c] [7h]
ruslik_by: bets $17
KovIFish89: calls $17
*** SHOW DOWN ***
ruslik_by: shows [Kc Qc] (a flush, King high)
KovIFish89: mucks hand 
ruslik_by collected $53 from pot
*** SUMMARY ***
Total pot $55.50 | Rake $2.50 
Board [Ks Tc 6c 2c 7h]
Seat 1: Rafaello18 folded before Flop (didn't bet)
Seat 2: ruslik_by showed [Kc Qc] and won ($53) with a flush, King high
Seat 3: KovIFish89 (button) mucked [Ts Td]
Seat 4: f1reworks (small blind) folded before Flop
Seat 5: Rohitbarve (big blind) folded on the Flop
Seat 6: matiko09 folded before Flop (didn't bet)
Seat 7: DomiVY folded before Flop (didn't bet)
Seat 8: chenconhaste folded on the Flop
Seat 9: di0d80 folded before Flop (didn't bet)





PokerStars Hand #155381022790:  Hold'em No Limit ($0.50/$1.00 USD) - 2016/06/30 14:27:04 CET [2016/06/30 8:27:04 ET]
Table 'Borrelly II' 9-max Seat #2 is the button
Seat 1: Rafaello18 ($121.59 in chips) 
Seat 2: mbk88 ($116.28 in chips) 
Seat 4: DonRon_AT ($38.69 in chips) 
Seat 6: m_michalec ($163.04 in chips) 
Seat 7: matiko09 ($174.36 in chips) 
Seat 8: Arjun A Raju ($133.92 in chips) 
Seat 9: alhill86 ($79.90 in chips) 
DonRon_AT: posts small blind $0.50
DIMAN_324: is sitting out 
m_michalec: posts big blind $1
*** HOLE CARDS ***
Dealt to matiko09 [Kd 5c]
DIMAN_324 leaves the table
Ty Nick 420 joins the table at seat #5 
matiko09: folds 
Arjun A Raju: folds 
alhill86: raises $2 to $3
Rafaello18: folds 
mbk88: folds 
DonRon_AT: folds 
m_michalec: folds 
Uncalled bet ($2) returned to alhill86
alhill86 collected $2.50 from pot
alhill86: doesn't show hand 
*** SUMMARY ***
Total pot $2.50 | Rake $0 
Seat 1: Rafaello18 folded before Flop (didn't bet)
Seat 2: mbk88 (button) folded before Flop (didn't bet)
Seat 4: DonRon_AT (small blind) folded before Flop
Seat 6: m_michalec (big blind) folded before Flop
Seat 7: matiko09 folded before Flop (didn't bet)
Seat 8: Arjun A Raju folded before Flop (didn't bet)
Seat 9: alhill86 collected ($2.50)





PokerStars Hand #155381024783:  Hold'em No Limit ($0.50/$1.00 USD) - 2016/06/30 14:27:08 CET [2016/06/30 8:27:08 ET]
Table 'Sigrid' 9-max Seat #4 is the button
Seat 1: Greha999 ($60.08 in chips) 
Seat 2: matiko09 ($108.66 in chips) 
Seat 3: Rafaello18 ($106.63 in chips) 
Seat 4: mbk88 ($118.87 in chips) 
Seat 5: chenconhaste ($100 in chips) 
Seat 7: arctur17 ($105.62 in chips) 
Seat 8: ruslik_by ($105.62 in chips) 
Seat 9: KovIFish89 ($103.58 in chips) 
chenconhaste: posts small blind $0.50
arctur17: posts big blind $1
*** HOLE CARDS ***
Dealt to matiko09 [5c 6d]
ruslik_by: folds 
KovIFish89: folds 
Greha999: raises $2 to $3
matiko09: folds 
Rafaello18: folds 
mbk88: folds 
chenconhaste: folds 
arctur17: folds 
Uncalled bet ($2) returned to Greha999
Greha999 collected $2.50 from pot
*** SUMMARY ***
Total pot $2.50 | Rake $0 
Seat 1: Greha999 collected ($2.50)
Seat 2: matiko09 folded before Flop (didn't bet)
Seat 3: Rafaello18 folded before Flop (didn't bet)
Seat 4: mbk88 (button) folded before Flop (didn't bet)
Seat 5: chenconhaste (small blind) folded before Flop
Seat 7: arctur17 (big blind) folded before Flop
Seat 8: ruslik_by folded before Flop (didn't bet)
Seat 9: KovIFish89 folded before Flop (didn't bet)





PokerStars Hand #155381025504:  Hold'em No Limit (€0.25/€0.50 EUR) - 2016/06/30 14:27:10 CET [2016/06/30 8:27:10 ET]
Table 'Vibeke II' 9-max Seat #4 is the button
Seat 4: acelacat111 (€26 in chips) 
Seat 5: mazefaka007 (€50 in chips) 
Seat 6: Kukuryzka (€50 in chips) 
Seat 7: matiko09 (€65.39 in chips) 
mazefaka007: posts small blind €0.25
Kukuryzka: posts big blind €0.50
KABAL_ua: sits out 
*** HOLE CARDS ***
Dealt to matiko09 [9d 2d]
matiko09: folds 
acelacat111: raises €1 to €1.50
mazefaka007: folds 
Kukuryzka: folds 
Uncalled bet (€1) returned to acelacat111
acelacat111 collected €1.25 from pot
acelacat111: doesn't show hand 
*** SUMMARY ***
Total pot €1.25 | Rake €0 
Seat 4: acelacat111 (button) collected (€1.25)
Seat 5: mazefaka007 (small blind) folded before Flop
Seat 6: Kukuryzka (big blind) folded before Flop
Seat 7: matiko09 folded before Flop (didn't bet)





PokerStars Hand #155381026056:  Hold'em No Limit ($0.50/$1.00 USD) - 2016/06/30 14:27:11 CET [2016/06/30 8:27:11 ET]
Table 'Altarf II' 9-max Seat #9 is the button
Seat 1: Rafaello18 ($100 in chips) 
Seat 2: KovIFish89 ($101.50 in chips) 
Seat 4: Greha999 ($151.88 in chips) 
Seat 5: DIMAN_324 ($228.74 in chips) 
Seat 6: mbk88 ($100 in chips) 
Seat 7: matiko09 ($106.22 in chips) 
Seat 8: DomiVY ($40.62 in chips) 
Seat 9: omanibemihum ($163.92 in chips) 
Rafaello18: posts small blind $0.50
KovIFish89: posts big blind $1
sanr23: sits out 
*** HOLE CARDS ***
Dealt to matiko09 [7h As]
Greha999: folds 
DIMAN_324: raises $2 to $3
mbk88: folds 
matiko09: folds 
DomiVY: folds 
omanibemihum: calls $3
Rafaello18: folds 
KovIFish89: folds 
*** FLOP *** [Ks 5c Ad]
DIMAN_324: bets $5.34
omanibemihum: folds 
Uncalled bet ($5.34) returned to DIMAN_324
DIMAN_324 collected $7.12 from pot
DIMAN_324: doesn't show hand 
*** SUMMARY ***
Total pot $7.50 | Rake $0.38 
Board [Ks 5c Ad]
Seat 1: Rafaello18 (small blind) folded before Flop
Seat 2: KovIFish89 (big blind) folded before Flop
Seat 4: Greha999 folded before Flop (didn't bet)
Seat 5: DIMAN_324 collected ($7.12)
Seat 6: mbk88 folded before Flop (didn't bet)
Seat 7: matiko09 folded before Flop (didn't bet)
Seat 8: DomiVY folded before Flop (didn't bet)
Seat 9: omanibemihum (button) folded on the Flop





PokerStars Hand #155381031066:  Hold'em No Limit ($0.50/$1.00 USD) - 2016/06/30 14:27:22 CET [2016/06/30 8:27:22 ET]
Table 'Tatjana' 9-max Seat #6 is the button
Seat 1: tipner ($105.70 in chips) 
Seat 2: DIMAN_324 ($113.53 in chips) 
Seat 3: Rafaello18 ($101.29 in chips) 
Seat 4: mopatron25 ($87.08 in chips) 
Seat 5: matiko09 ($100 in chips) 
Seat 6: mbk88 ($161.04 in chips) 
Seat 8: alhill86 ($107.56 in chips) 
Seat 9: POTAPENKO700 ($235.43 in chips) 
alhill86: posts small blind $0.50
POTAPENKO700: posts big blind $1
*** HOLE CARDS ***
Dealt to matiko09 [3s 8d]
tipner has timed out
tipner: folds 
DIMAN_324: folds 
Rafaello18: folds 
mopatron25: calls $1
matiko09: folds 
mbk88: folds 
alhill86: folds 
POTAPENKO700: checks 
*** FLOP *** [Ac Tc Kc]
POTAPENKO700: checks 
mopatron25: bets $2
POTAPENKO700: calls $2
*** TURN *** [Ac Tc Kc] [Td]
POTAPENKO700: checks 
mopatron25: bets $3
POTAPENKO700: folds 
Uncalled bet ($3) returned to mopatron25
mopatron25 collected $6.18 from pot
mopatron25: doesn't show hand 
*** SUMMARY ***
Total pot $6.50 | Rake $0.32 
Board [Ac Tc Kc Td]
Seat 1: tipner folded before Flop (didn't bet)
Seat 2: DIMAN_324 folded before Flop (didn't bet)
Seat 3: Rafaello18 folded before Flop (didn't bet)
Seat 4: mopatron25 collected ($6.18)
Seat 5: matiko09 folded before Flop (didn't bet)
Seat 6: mbk88 (button) folded before Flop (didn't bet)
Seat 8: alhill86 (small blind) folded before Flop
Seat 9: POTAPENKO700 (big blind) folded on the Turn





PokerStars Hand #155381031803:  Hold'em No Limit (€0.25/€0.50 EUR) - 2016/06/30 14:27:24 CET [2016/06/30 8:27:24 ET]
Table 'Vibeke II' 9-max Seat #5 is the button
Seat 4: acelacat111 (€26.75 in chips) 
Seat 5: mazefaka007 (€50 in chips) 
Seat 6: Kukuryzka (€49.50 in chips) 
Seat 7: matiko09 (€65.39 in chips) 
Kukuryzka: posts small blind €0.25
matiko09: posts big blind €0.50
KABAL_ua: sits out 
*** HOLE CARDS ***
Dealt to matiko09 [Ks 4s]
acelacat111: folds 
mazefaka007: raises €0.55 to €1.05
Kukuryzka: raises €2.95 to €4
matiko09: folds 
mazefaka007: raises €5 to €9
Kukuryzka: calls €5
*** FLOP *** [6d Kc Td]
Kukuryzka: checks 
mazefaka007: checks 
*** TURN *** [6d Kc Td] [7h]
Kukuryzka: bets €8.90
mazefaka007: calls €8.90
*** RIVER *** [6d Kc Td 7h] [3h]
Kukuryzka: checks 
mazefaka007: checks 
*** SHOW DOWN ***
Kukuryzka: shows [Qd Ah] (high card Ace)
mazefaka007: shows [Jc Jd] (a pair of Jacks)
mazefaka007 collected €35.60 from pot
*** SUMMARY ***
Total pot €36.30 | Rake €0.70 
Board [6d Kc Td 7h 3h]
Seat 4: acelacat111 folded before Flop (didn't bet)
Seat 5: mazefaka007 (button) showed [Jc Jd] and won (€35.60) with a pair of Jacks
Seat 6: Kukuryzka (small blind) showed [Qd Ah] and lost with high card Ace
Seat 7: matiko09 (big blind) folded before Flop





PokerStars Hand #155381034966:  Hold'em No Limit ($0.50/$1.00 USD) - 2016/06/30 14:27:30 CET [2016/06/30 8:27:30 ET]
Table 'Borrelly II' 9-max Seat #4 is the button
Seat 1: Rafaello18 ($121.59 in chips) 
Seat 2: mbk88 ($116.28 in chips) 
Seat 4: DonRon_AT ($38.19 in chips) 
Seat 6: m_michalec ($162.04 in chips) 
Seat 7: matiko09 ($174.36 in chips) 
Seat 8: Arjun A Raju ($133.92 in chips) 
Seat 9: alhill86 ($81.40 in chips) 
Ty Nick 420 will be allowed to play after the button
m_michalec: posts small blind $0.50
matiko09: posts big blind $1
*** HOLE CARDS ***
Dealt to matiko09 [3h 7c]
Arjun A Raju: folds 
alhill86: folds 
Rafaello18: folds 
mbk88: folds 
DonRon_AT: folds 
m_michalec: folds 
Uncalled bet ($0.50) returned to matiko09
matiko09 collected $1 from pot
matiko09: doesn't show hand 
*** SUMMARY ***
Total pot $1 | Rake $0 
Seat 1: Rafaello18 folded before Flop (didn't bet)
Seat 2: mbk88 folded before Flop (didn't bet)
Seat 4: DonRon_AT (button) folded before Flop (didn't bet)
Seat 6: m_michalec (small blind) folded before Flop
Seat 7: matiko09 (big blind) collected ($1)
Seat 8: Arjun A Raju folded before Flop (didn't bet)
Seat 9: alhill86 folded before Flop (didn't bet)





PokerStars Hand #155381035158:  Hold'em No Limit ($0.25/$0.50 USD) - 2016/06/30 14:27:31 CET [2016/06/30 8:27:31 ET]
Table 'Arcturus' 9-max Seat #6 is the button
Seat 1: kourk250 ($147.56 in chips) 
Seat 2: Rafaello18 ($50 in chips) 
Seat 3: matiko09 ($50 in chips) 
Seat 5: stockbridge8 ($47.75 in chips) 
Seat 6: statistik85 ($64.22 in chips) 
Seat 7: bratbugor ($50 in chips) 
Seat 8: TheMinion ($50 in chips) 
Seat 9: pfunkolstar ($108.72 in chips) 
bratbugor: posts small blind $0.25
TheMinion: posts big blind $0.50
*** HOLE CARDS ***
Dealt to matiko09 [Jd Qh]
pfunkolstar: folds 
kourk250: raises $0.50 to $1
Rafaello18: folds 
matiko09: folds 
stockbridge8: folds 
statistik85: folds 
bratbugor: folds 
TheMinion: folds 
Uncalled bet ($0.50) returned to kourk250
kourk250 collected $1.25 from pot
kourk250: doesn't show hand 
*** SUMMARY ***
Total pot $1.25 | Rake $0 
Seat 1: kourk250 collected ($1.25)
Seat 2: Rafaello18 folded before Flop (didn't bet)
Seat 3: matiko09 folded before Flop (didn't bet)
Seat 5: stockbridge8 folded before Flop (didn't bet)
Seat 6: statistik85 (button) folded before Flop (didn't bet)
Seat 7: bratbugor (small blind) folded before Flop
Seat 8: TheMinion (big blind) folded before Flop
Seat 9: pfunkolstar folded before Flop (didn't bet)





PokerStars Hand #155381039727:  Hold'em No Limit ($0.50/$1.00 USD) - 2016/06/30 14:27:41 CET [2016/06/30 8:27:41 ET]
Table 'Asmodeus' 9-max Seat #7 is the button
Seat 2: nickreason17 ($102.18 in chips) 
Seat 3: matiko09 ($114.97 in chips) 
Seat 5: sanr23 ($111.80 in chips) 
Seat 6: koutani7 ($80.53 in chips) 
Seat 7: aaronzzr ($130.33 in chips) 
Seat 8: Rafaello18 ($174.57 in chips) 
Seat 9: mbk88 ($161.26 in chips) 
Rafaello18: posts small blind $0.50
mbk88: posts big blind $1
Ty Nick 420: sits out 
*** HOLE CARDS ***
Dealt to matiko09 [3s 6h]
nickreason17: folds 
matiko09: folds 
sanr23: folds 
koutani7: folds 
aaronzzr: folds 
Rafaello18: raises $1.50 to $2.50
mbk88: folds 
Uncalled bet ($1.50) returned to Rafaello18
Rafaello18 collected $2 from pot
Rafaello18: doesn't show hand 
*** SUMMARY ***
Total pot $2 | Rake $0 
Seat 2: nickreason17 folded before Flop (didn't bet)
Seat 3: matiko09 folded before Flop (didn't bet)
Seat 5: sanr23 folded before Flop (didn't bet)
Seat 6: koutani7 folded before Flop (didn't bet)
Seat 7: aaronzzr (button) folded before Flop (didn't bet)
Seat 8: Rafaello18 (small blind) collected ($2)
Seat 9: mbk88 (big blind) folded before Flop





PokerStars Hand #155381040978:  Hold'em No Limit ($0.50/$1.00 USD) - 2016/06/30 14:27:43 CET [2016/06/30 8:27:43 ET]
Table 'Sigrid' 9-max Seat #5 is the button
Seat 1: Greha999 ($61.58 in chips) 
Seat 2: matiko09 ($108.66 in chips) 
Seat 3: Rafaello18 ($106.63 in chips) 
Seat 4: mbk88 ($118.87 in chips) 
Seat 5: chenconhaste ($100 in chips) 
Seat 7: arctur17 ($104.62 in chips) 
Seat 8: ruslik_by ($105.62 in chips) 
Seat 9: KovIFish89 ($103.58 in chips) 
arctur17: posts small blind $0.50
ruslik_by: posts big blind $1
*** HOLE CARDS ***
Dealt to matiko09 [5d 7s]
KovIFish89: folds 
Greha999: folds 
matiko09: folds 
Rafaello18: folds 
mbk88: folds 
chenconhaste: raises $1.25 to $2.25
arctur17: folds 
ruslik_by: folds 
Uncalled bet ($1.25) returned to chenconhaste
chenconhaste collected $2.50 from pot
*** SUMMARY ***
Total pot $2.50 | Rake $0 
Seat 1: Greha999 folded before Flop (didn't bet)
Seat 2: matiko09 folded before Flop (didn't bet)
Seat 3: Rafaello18 folded before Flop (didn't bet)
Seat 4: mbk88 folded before Flop (didn't bet)
Seat 5: chenconhaste (button) collected ($2.50)
Seat 7: arctur17 (small blind) folded before Flop
Seat 8: ruslik_by (big blind) folded before Flop
Seat 9: KovIFish89 folded before Flop (didn't bet)





PokerStars Hand #155381043505:  Hold'em No Limit ($0.50/$1.00 USD) - 2016/06/30 14:27:49 CET [2016/06/30 8:27:49 ET]
Table 'Borrelly II' 9-max Seat #6 is the button
Seat 1: Rafaello18 ($121.59 in chips) 
Seat 2: mbk88 ($116.28 in chips) 
Seat 4: DonRon_AT ($38.19 in chips) 
Seat 6: m_michalec ($161.54 in chips) 
Seat 7: matiko09 ($174.86 in chips) 
Seat 8: Arjun A Raju ($133.92 in chips) 
Seat 9: alhill86 ($81.40 in chips) 
matiko09: posts small blind $0.50
Arjun A Raju: posts big blind $1
Ty Nick 420: sits out 
*** HOLE CARDS ***
Dealt to matiko09 [8c 6d]
alhill86: folds 
Rafaello18: folds 
alhill86 leaves the table
ruslik_by joins the table at seat #9 
mbk88: raises $2 to $3
DonRon_AT: calls $3
m_michalec: raises $6 to $9
matiko09: folds 
Arjun A Raju: folds 
mbk88: folds 
DonRon_AT: calls $6
*** FLOP *** [3c 7h Qc]
DonRon_AT: checks 
m_michalec: bets $10
DonRon_AT: folds 
Uncalled bet ($10) returned to m_michalec
m_michalec collected $21.38 from pot
m_michalec: doesn't show hand 
*** SUMMARY ***
Total pot $22.50 | Rake $1.12 
Board [3c 7h Qc]
Seat 1: Rafaello18 folded before Flop (didn't bet)
Seat 2: mbk88 folded before Flop
Seat 4: DonRon_AT folded on the Flop
Seat 6: m_michalec (button) collected ($21.38)
Seat 7: matiko09 (small blind) folded before Flop
Seat 8: Arjun A Raju (big blind) folded before Flop
Seat 9: alhill86 folded before Flop (didn't bet)





PokerStars Hand #155381049829:  Hold'em No Limit ($0.50/$1.00 USD) - 2016/06/30 14:28:02 CET [2016/06/30 8:28:02 ET]
Table 'Asmodeus' 9-max Seat #8 is the button
Seat 2: nickreason17 ($102.18 in chips) 
Seat 3: matiko09 ($114.97 in chips) 
Seat 5: sanr23 ($111.80 in chips) 
Seat 6: koutani7 ($80.53 in chips) 
Seat 7: aaronzzr ($130.33 in chips) 
Seat 8: Rafaello18 ($175.57 in chips) 
Seat 9: mbk88 ($160.26 in chips) 
mbk88: posts small blind $0.50
nickreason17: posts big blind $1
Ty Nick 420: sits out 
*** HOLE CARDS ***
Dealt to matiko09 [3c 7s]
matiko09: folds 
sanr23: folds 
koutani7: folds 
aaronzzr: raises $1 to $2
Rafaello18: folds 
mbk88: folds 
nickreason17: calls $1
*** FLOP *** [6s 9d Jd]
nickreason17: checks 
aaronzzr: checks 
*** TURN *** [6s 9d Jd] [Td]
nickreason17: bets $3
aaronzzr: raises $3 to $6
nickreason17: calls $3
*** RIVER *** [6s 9d Jd Td] [5s]
nickreason17: checks 
aaronzzr: bets $16
nickreason17: folds 
Uncalled bet ($16) returned to aaronzzr
aaronzzr collected $15.68 from pot
aaronzzr: doesn't show hand 
*** SUMMARY ***
Total pot $16.50 | Rake $0.82 
Board [6s 9d Jd Td 5s]
Seat 2: nickreason17 (big blind) folded on the River
Seat 3: matiko09 folded before Flop (didn't bet)
Seat 5: sanr23 folded before Flop (didn't bet)
Seat 6: koutani7 folded before Flop (didn't bet)
Seat 7: aaronzzr collected ($15.68)
Seat 8: Rafaello18 (button) folded before Flop (didn't bet)
Seat 9: mbk88 (small blind) folded before Flop





PokerStars Hand #155381051530:  Hold'em No Limit ($0.50/$1.00 USD) - 2016/06/30 14:28:06 CET [2016/06/30 8:28:06 ET]
Table 'Altarf II' 9-max Seat #1 is the button
Seat 1: Rafaello18 ($100 in chips) 
Seat 2: KovIFish89 ($100.50 in chips) 
Seat 3: sanr23 ($185.21 in chips) 
Seat 4: Greha999 ($151.88 in chips) 
Seat 5: DIMAN_324 ($232.86 in chips) 
Seat 6: mbk88 ($100 in chips) 
Seat 7: matiko09 ($106.22 in chips) 
Seat 8: DomiVY ($40.62 in chips) 
Seat 9: omanibemihum ($160.92 in chips) 
KovIFish89: posts small blind $0.50
sanr23: posts big blind $1
*** HOLE CARDS ***
Dealt to matiko09 [9s 6h]
Greha999: raises $1 to $2
DIMAN_324: folds 
mbk88: folds 
matiko09: folds 
DomiVY: folds 
omanibemihum: raises $1 to $3
Rafaello18: folds 
KovIFish89: raises $6 to $9
sanr23: folds 
Greha999: folds 
omanibemihum: folds 
Uncalled bet ($6) returned to KovIFish89
KovIFish89 collected $9 from pot
KovIFish89: doesn't show hand 
*** SUMMARY ***
Total pot $9 | Rake $0 
Seat 1: Rafaello18 (button) folded before Flop (didn't bet)
Seat 2: KovIFish89 (small blind) collected ($9)
Seat 3: sanr23 (big blind) folded before Flop
Seat 4: Greha999 folded before Flop
Seat 5: DIMAN_324 folded before Flop (didn't bet)
Seat 6: mbk88 folded before Flop (didn't bet)
Seat 7: matiko09 folded before Flop (didn't bet)
Seat 8: DomiVY folded before Flop (didn't bet)
Seat 9: omanibemihum folded before Flop





PokerStars Hand #155381054191:  Hold'em No Limit ($0.25/$0.50 USD) - 2016/06/30 14:28:12 CET [2016/06/30 8:28:12 ET]
Table 'Arcturus' 9-max Seat #7 is the button
Seat 1: kourk250 ($148.31 in chips) 
Seat 2: Rafaello18 ($50 in chips) 
Seat 3: matiko09 ($50 in chips) 
Seat 5: stockbridge8 ($47.75 in chips) 
Seat 6: statistik85 ($64.22 in chips) 
Seat 7: bratbugor ($50 in chips) 
Seat 8: TheMinion ($50 in chips) 
Seat 9: pfunkolstar ($108.72 in chips) 
TheMinion: posts small blind $0.25
pfunkolstar: posts big blind $0.50
*** HOLE CARDS ***
Dealt to matiko09 [Jh Td]
kourk250: folds 
Rafaello18: folds 
matiko09: folds 
stockbridge8: folds 
statistik85: calls $0.50
bratbugor: folds 
TheMinion: folds 
pfunkolstar: checks 
*** FLOP *** [5s Tc Kc]
pfunkolstar: checks 
statistik85: bets $0.50
pfunkolstar: folds 
Uncalled bet ($0.50) returned to statistik85
statistik85 collected $1.19 from pot
statistik85: doesn't show hand 
*** SUMMARY ***
Total pot $1.25 | Rake $0.06 
Board [5s Tc Kc]
Seat 1: kourk250 folded before Flop (didn't bet)
Seat 2: Rafaello18 folded before Flop (didn't bet)
Seat 3: matiko09 folded before Flop (didn't bet)
Seat 5: stockbridge8 folded before Flop (didn't bet)
Seat 6: statistik85 collected ($1.19)
Seat 7: bratbugor (button) folded before Flop (didn't bet)
Seat 8: TheMinion (small blind) folded before Flop
Seat 9: pfunkolstar (big blind) folded on the Flop





PokerStars Hand #155381054154:  Hold'em No Limit ($0.50/$1.00 USD) - 2016/06/30 14:28:12 CET [2016/06/30 8:28:12 ET]
Table 'Sigrid' 9-max Seat #7 is the button
Seat 1: Greha999 ($61.58 in chips) 
Seat 2: matiko09 ($108.66 in chips) 
Seat 3: Rafaello18 ($106.63 in chips) 
Seat 4: mbk88 ($118.87 in chips) 
Seat 5: chenconhaste ($101.50 in chips) 
Seat 7: arctur17 ($104.12 in chips) 
Seat 8: ruslik_by ($104.62 in chips) 
Seat 9: KovIFish89 ($103.58 in chips) 
ruslik_by: posts small blind $0.50
KovIFish89: posts big blind $1
*** HOLE CARDS ***
Dealt to matiko09 [2h Qc]
Greha999: folds 
matiko09: folds 
Rafaello18: raises $1.50 to $2.50
mbk88: folds 
chenconhaste: folds 
arctur17: folds 
ruslik_by: folds 
KovIFish89: calls $1.50
*** FLOP *** [3d Ad Kc]
KovIFish89: checks 
Rafaello18: checks 
*** TURN *** [3d Ad Kc] [Tc]
KovIFish89: checks 
Rafaello18: checks 
*** RIVER *** [3d Ad Kc Tc] [Kd]
KovIFish89: checks 
Rafaello18: checks 
*** SHOW DOWN ***
KovIFish89: shows [6d 6h] (two pair, Kings and Sixes)
Rafaello18: shows [Js Jh] (two pair, Kings and Jacks)
Rafaello18 collected $5.22 from pot
*** SUMMARY ***
Total pot $5.50 | Rake $0.28 
Board [3d Ad Kc Tc Kd]
Seat 1: Greha999 folded before Flop (didn't bet)
Seat 2: matiko09 folded before Flop (didn't bet)
Seat 3: Rafaello18 showed [Js Jh] and won ($5.22) with two pair, Kings and Jacks
Seat 4: mbk88 folded before Flop (didn't bet)
Seat 5: chenconhaste folded before Flop (didn't bet)
Seat 7: arctur17 (button) folded before Flop (didn't bet)
Seat 8: ruslik_by (small blind) folded before Flop
Seat 9: KovIFish89 (big blind) showed [6d 6h] and lost with two pair, Kings and Sixes





PokerStars Hand #155381060746:  Hold'em No Limit ($0.50/$1.00 USD) - 2016/06/30 14:28:26 CET [2016/06/30 8:28:26 ET]
Table 'Tatjana' 9-max Seat #8 is the button
Seat 1: tipner ($105.70 in chips) 
Seat 2: DIMAN_324 ($113.53 in chips) 
Seat 3: Rafaello18 ($101.29 in chips) 
Seat 4: mopatron25 ($90.26 in chips) 
Seat 5: matiko09 ($100 in chips) 
Seat 6: mbk88 ($161.04 in chips) 
Seat 8: alhill86 ($107.06 in chips) 
Seat 9: POTAPENKO700 ($232.43 in chips) 
POTAPENKO700: posts small blind $0.50
tipner: posts big blind $1
*** HOLE CARDS ***
Dealt to matiko09 [8h 6h]
DIMAN_324: folds 
Rafaello18: folds 
mopatron25: calls $1
matiko09: raises $3 to $4
mbk88: folds 
alhill86 has timed out
alhill86: folds 
POTAPENKO700: folds 
tipner: folds 
mopatron25: calls $3
*** FLOP *** [9c 7c 2h]
mopatron25: bets $3
matiko09: raises $7 to $10
mopatron25: folds 
Uncalled bet ($7) returned to matiko09
matiko09 collected $14.72 from pot
matiko09: doesn't show hand 
*** SUMMARY ***
Total pot $15.50 | Rake $0.78 
Board [9c 7c 2h]
Seat 1: tipner (big blind) folded before Flop
Seat 2: DIMAN_324 folded before Flop (didn't bet)
Seat 3: Rafaello18 folded before Flop (didn't bet)
Seat 4: mopatron25 folded on the Flop
Seat 5: matiko09 collected ($14.72)
Seat 6: mbk88 folded before Flop (didn't bet)
Seat 8: alhill86 (button) folded before Flop (didn't bet)
Seat 9: POTAPENKO700 (small blind) folded before Flop





PokerStars Hand #155381062053:  Hold'em No Limit ($0.50/$1.00 USD) - 2016/06/30 14:28:29 CET [2016/06/30 8:28:29 ET]
Table 'Borrelly II' 9-max Seat #7 is the button
Seat 1: Rafaello18 ($121.59 in chips) 
Seat 2: mbk88 ($113.28 in chips) 
Seat 4: DonRon_AT ($29.19 in chips) 
Seat 6: m_michalec ($173.92 in chips) 
Seat 7: matiko09 ($174.36 in chips) 
Seat 8: Arjun A Raju ($132.92 in chips) 
Seat 9: ruslik_by ($100 in chips) 
Arjun A Raju: posts small blind $0.50
ruslik_by: posts big blind $1
Ty Nick 420: sits out 
*** HOLE CARDS ***
Dealt to matiko09 [7s Jc]
Rafaello18: folds 
mbk88: folds 
DonRon_AT: calls $1
m_michalec: folds 
matiko09: folds 
Arjun A Raju: folds 
ruslik_by: checks 
*** FLOP *** [4s 4h 2d]
ruslik_by: checks 
DonRon_AT: bets $1
ruslik_by: calls $1
*** TURN *** [4s 4h 2d] [5c]
ruslik_by: checks 
DonRon_AT: bets $4
ruslik_by: calls $4
*** RIVER *** [4s 4h 2d 5c] [3h]
ruslik_by: bets $10.09
DonRon_AT: raises $13.10 to $23.19 and is all-in
ruslik_by: calls $13.10
*** SHOW DOWN ***
DonRon_AT: shows [5s 5h] (a full house, Fives full of Fours)
ruslik_by: shows [8h 6h] (a straight, Deuce to Six)
DonRon_AT collected $56.38 from pot
*** SUMMARY ***
Total pot $58.88 | Rake $2.50 
Board [4s 4h 2d 5c 3h]
Seat 1: Rafaello18 folded before Flop (didn't bet)
Seat 2: mbk88 folded before Flop (didn't bet)
Seat 4: DonRon_AT showed [5s 5h] and won ($56.38) with a full house, Fives full of Fours
Seat 6: m_michalec folded before Flop (didn't bet)
Seat 7: matiko09 (button) folded before Flop (didn't bet)
Seat 8: Arjun A Raju (small blind) folded before Flop
Seat 9: ruslik_by (big blind) showed [8h 6h] and lost with a straight, Deuce to Six





PokerStars Hand #155381064234:  Hold'em No Limit ($0.50/$1.00 USD) - 2016/06/30 14:28:33 CET [2016/06/30 8:28:33 ET]
Table 'California II' 9-max Seat #4 is the button
Seat 1: Rafaello18 ($103.68 in chips) 
Seat 2: ruslik_by ($127.75 in chips) 
Seat 3: KovIFish89 ($100 in chips) 
Seat 4: f1reworks ($100 in chips) 
Seat 5: Rohitbarve ($109.27 in chips) 
Seat 6: matiko09 ($134.23 in chips) 
Seat 7: DomiVY ($92.88 in chips) 
Seat 8: chenconhaste ($100 in chips) 
Seat 9: di0d80 ($104.87 in chips) 
Rohitbarve: posts small blind $0.50
matiko09: posts big blind $1
*** HOLE CARDS ***
Dealt to matiko09 [2d 2c]
DomiVY: folds 
chenconhaste: raises $1.25 to $2.25
di0d80: folds 
Rafaello18: folds 
ruslik_by: calls $2.25
KovIFish89: folds 
f1reworks: folds 
Rohitbarve: folds 
matiko09: calls $1.25
*** FLOP *** [5c Qd Td]
matiko09: checks 
chenconhaste: checks 
ruslik_by: checks 
*** TURN *** [5c Qd Td] [7c]
matiko09: checks 
chenconhaste: checks 
ruslik_by: bets $5.85
matiko09: folds 
chenconhaste: folds 
Uncalled bet ($5.85) returned to ruslik_by
ruslik_by collected $6.89 from pot
ruslik_by: doesn't show hand 
*** SUMMARY ***
Total pot $7.25 | Rake $0.36 
Board [5c Qd Td 7c]
Seat 1: Rafaello18 folded before Flop (didn't bet)
Seat 2: ruslik_by collected ($6.89)
Seat 3: KovIFish89 folded before Flop (didn't bet)
Seat 4: f1reworks (button) folded before Flop (didn't bet)
Seat 5: Rohitbarve (small blind) folded before Flop
Seat 6: matiko09 (big blind) folded on the Turn
Seat 7: DomiVY folded before Flop (didn't bet)
Seat 8: chenconhaste folded on the Turn
Seat 9: di0d80 folded before Flop (didn't bet)





PokerStars Hand #155381065180:  Hold'em No Limit (€0.25/€0.50 EUR) - 2016/06/30 14:28:36 CET [2016/06/30 8:28:36 ET]
Table 'Vibeke II' 9-max Seat #6 is the button
Seat 4: acelacat111 (€26.75 in chips) 
Seat 5: mazefaka007 (€67.70 in chips) 
Seat 6: Kukuryzka (€50 in chips) 
Seat 7: matiko09 (€64.89 in chips) 
Seat 8: KABAL_ua (€50 in chips) 
matiko09: posts small blind €0.25
KABAL_ua: posts big blind €0.50
*** HOLE CARDS ***
Dealt to matiko09 [Ks 3s]
acelacat111: folds 
mazefaka007: raises €0.55 to €1.05
Kukuryzka: raises €2.95 to €4
matiko09: folds 
KABAL_ua: folds 
mazefaka007: folds 
Uncalled bet (€2.95) returned to Kukuryzka
Kukuryzka collected €2.85 from pot
Kukuryzka: doesn't show hand 
*** SUMMARY ***
Total pot €2.85 | Rake €0 
Seat 4: acelacat111 folded before Flop (didn't bet)
Seat 5: mazefaka007 folded before Flop
Seat 6: Kukuryzka (button) collected (€2.85)
Seat 7: matiko09 (small blind) folded before Flop
Seat 8: KABAL_ua (big blind) folded before Flop





PokerStars Hand #155381067314:  Hold'em No Limit ($0.50/$1.00 USD) - 2016/06/30 14:28:40 CET [2016/06/30 8:28:40 ET]
Table 'Donnera' 9-max Seat #7 is the button
Seat 1: chenconhaste ($113.06 in chips) 
Seat 2: robbiescrim9 ($115.26 in chips) 
Seat 3: matiko09 ($109.25 in chips) 
Seat 4: Kukuryzka ($100 in chips) 
Seat 5: tipner ($100 in chips) 
Seat 6: nickreason17 ($100 in chips) 
Seat 7: Rafaello18 ($103.65 in chips) 
Seat 8: ruslik_by ($215.10 in chips) 
Seat 9: Starw!nd ($108.75 in chips) 
ruslik_by: posts small blind $0.50
Starw!nd: posts big blind $1
*** HOLE CARDS ***
Dealt to matiko09 [8h 9d]
chenconhaste: folds 
robbiescrim9: folds 
matiko09: folds 
Kukuryzka: folds 
tipner: folds 
nickreason17: folds 
Rafaello18: folds 
ruslik_by: folds 
Uncalled bet ($0.50) returned to Starw!nd
Starw!nd collected $1 from pot
Starw!nd: doesn't show hand 
*** SUMMARY ***
Total pot $1 | Rake $0 
Seat 1: chenconhaste folded before Flop (didn't bet)
Seat 2: robbiescrim9 folded before Flop (didn't bet)
Seat 3: matiko09 folded before Flop (didn't bet)
Seat 4: Kukuryzka folded before Flop (didn't bet)
Seat 5: tipner folded before Flop (didn't bet)
Seat 6: nickreason17 folded before Flop (didn't bet)
Seat 7: Rafaello18 (button) folded before Flop (didn't bet)
Seat 8: ruslik_by (small blind) folded before Flop
Seat 9: Starw!nd (big blind) collected ($1)





PokerStars Hand #155381077590:  Hold'em No Limit ($0.25/$0.50 USD) - 2016/06/30 14:29:02 CET [2016/06/30 8:29:02 ET]
Table 'Arcturus' 9-max Seat #8 is the button
Seat 1: kourk250 ($148.31 in chips) 
Seat 2: Rafaello18 ($50 in chips) 
Seat 3: matiko09 ($50 in chips) 
Seat 5: stockbridge8 ($47.75 in chips) 
Seat 6: statistik85 ($64.91 in chips) 
Seat 7: bratbugor ($50 in chips) 
Seat 8: TheMinion ($50 in chips) 
Seat 9: pfunkolstar ($108.22 in chips) 
pfunkolstar: posts small blind $0.25
kourk250: posts big blind $0.50
*** HOLE CARDS ***
Dealt to matiko09 [Qd As]
Rafaello18: folds 
matiko09: raises $1 to $1.50
stockbridge8: folds 
statistik85: folds 
bratbugor: folds 
TheMinion: folds 
pfunkolstar: calls $1.25
kourk250: calls $1
*** FLOP *** [Jd 4h 5s]
pfunkolstar: checks 
kourk250: checks 
matiko09: checks 
*** TURN *** [Jd 4h 5s] [4c]
pfunkolstar: checks 
kourk250: checks 
matiko09: checks 
*** RIVER *** [Jd 4h 5s 4c] [Jc]
pfunkolstar: checks 
kourk250: checks 
matiko09: checks 
*** SHOW DOWN ***
pfunkolstar: shows [Tc Ad] (two pair, Jacks and Fours)
kourk250: mucks hand 
matiko09: shows [Qd As] (two pair, Jacks and Fours)
pfunkolstar collected $2.14 from pot
matiko09 collected $2.14 from pot
*** SUMMARY ***
Total pot $4.50 | Rake $0.22 
Board [Jd 4h 5s 4c Jc]
Seat 1: kourk250 (big blind) mucked [7c 3c]
Seat 2: Rafaello18 folded before Flop (didn't bet)
Seat 3: matiko09 showed [Qd As] and won ($2.14) with two pair, Jacks and Fours
Seat 5: stockbridge8 folded before Flop (didn't bet)
Seat 6: statistik85 folded before Flop (didn't bet)
Seat 7: bratbugor folded before Flop (didn't bet)
Seat 8: TheMinion (button) folded before Flop (didn't bet)
Seat 9: pfunkolstar (small blind) showed [Tc Ad] and won ($2.14) with two pair, Jacks and Fours





PokerStars Hand #155381081104:  Hold'em No Limit ($0.50/$1.00 USD) - 2016/06/30 14:29:10 CET [2016/06/30 8:29:10 ET]
Table 'Asmodeus' 9-max Seat #9 is the button
Seat 2: nickreason17 ($100 in chips) 
Seat 3: matiko09 ($114.97 in chips) 
Seat 5: sanr23 ($111.80 in chips) 
Seat 6: koutani7 ($80.53 in chips) 
Seat 7: aaronzzr ($138.01 in chips) 
Seat 8: Rafaello18 ($175.57 in chips) 
Seat 9: mbk88 ($159.76 in chips) 
nickreason17: posts small blind $0.50
matiko09: posts big blind $1
Ty Nick 420: sits out 
*** HOLE CARDS ***
Dealt to matiko09 [7c 9c]
sanr23: folds 
koutani7: raises $2 to $3
aaronzzr: folds 
Rafaello18: folds 
mbk88: folds 
nickreason17: folds 
matiko09: folds 
Uncalled bet ($2) returned to koutani7
koutani7 collected $2.50 from pot
koutani7: doesn't show hand 
*** SUMMARY ***
Total pot $2.50 | Rake $0 
Seat 2: nickreason17 (small blind) folded before Flop
Seat 3: matiko09 (big blind) folded before Flop
Seat 5: sanr23 folded before Flop (didn't bet)
Seat 6: koutani7 collected ($2.50)
Seat 7: aaronzzr folded before Flop (didn't bet)
Seat 8: Rafaello18 folded before Flop (didn't bet)
Seat 9: mbk88 (button) folded before Flop (didn't bet)





PokerStars Hand #155381082146:  Hold'em No Limit ($0.50/$1.00 USD) - 2016/06/30 14:29:12 CET [2016/06/30 8:29:12 ET]
Table 'Altarf II' 9-max Seat #2 is the button
Seat 1: Rafaello18 ($100 in chips) 
Seat 2: KovIFish89 ($106.50 in chips) 
Seat 3: sanr23 ($184.21 in chips) 
Seat 4: Greha999 ($149.88 in chips) 
Seat 5: DIMAN_324 ($232.86 in chips) 
Seat 6: mbk88 ($100 in chips) 
Seat 7: matiko09 ($106.22 in chips) 
Seat 8: DomiVY ($40.62 in chips) 
Seat 9: omanibemihum ($157.92 in chips) 
sanr23: posts small blind $0.50
Greha999: posts big blind $1
*** HOLE CARDS ***
Dealt to matiko09 [Tc Kh]
DIMAN_324: folds 
mbk88: folds 
matiko09: folds 
DomiVY: folds 
omanibemihum: raises $2 to $3
Rafaello18: folds 
KovIFish89: folds 
sanr23: folds 
Greha999: folds 
Uncalled bet ($2) returned to omanibemihum
omanibemihum collected $2.50 from pot
omanibemihum: doesn't show hand 
*** SUMMARY ***
Total pot $2.50 | Rake $0 
Seat 1: Rafaello18 folded before Flop (didn't bet)
Seat 2: KovIFish89 (button) folded before Flop (didn't bet)
Seat 3: sanr23 (small blind) folded before Flop
Seat 4: Greha999 (big blind) folded before Flop
Seat 5: DIMAN_324 folded before Flop (didn't bet)
Seat 6: mbk88 folded before Flop (didn't bet)
Seat 7: matiko09 folded before Flop (didn't bet)
Seat 8: DomiVY folded before Flop (didn't bet)
Seat 9: omanibemihum collected ($2.50)





PokerStars Hand #155381083730:  Hold'em No Limit (€0.25/€0.50 EUR) - 2016/06/30 14:29:16 CET [2016/06/30 8:29:16 ET]
Table 'Vibeke II' 9-max Seat #7 is the button
Seat 4: acelacat111 (€26.75 in chips) 
Seat 5: mazefaka007 (€66.65 in chips) 
Seat 6: Kukuryzka (€51.80 in chips) 
Seat 7: matiko09 (€64.64 in chips) 
Seat 8: KABAL_ua (€50 in chips) 
KABAL_ua: posts small blind €0.25
acelacat111: posts big blind €0.50
*** HOLE CARDS ***
Dealt to matiko09 [4c 7s]
mazefaka007: folds 
Kukuryzka: folds 
matiko09: folds 
KABAL_ua: folds 
Uncalled bet (€0.25) returned to acelacat111
acelacat111 collected €0.50 from pot
acelacat111: doesn't show hand 
*** SUMMARY ***
Total pot €0.50 | Rake €0 
Seat 4: acelacat111 (big blind) collected (€0.50)
Seat 5: mazefaka007 folded before Flop (didn't bet)
Seat 6: Kukuryzka folded before Flop (didn't bet)
Seat 7: matiko09 (button) folded before Flop (didn't bet)
Seat 8: KABAL_ua (small blind) folded before Flop





PokerStars Hand #155381085817:  Hold'em No Limit ($0.50/$1.00 USD) - 2016/06/30 14:29:20 CET [2016/06/30 8:29:20 ET]
Table 'Donnera' 9-max Seat #8 is the button
Seat 1: chenconhaste ($113.06 in chips) 
Seat 2: robbiescrim9 ($115.26 in chips) 
Seat 3: matiko09 ($109.25 in chips) 
Seat 4: Kukuryzka ($100 in chips) 
Seat 5: tipner ($100 in chips) 
Seat 6: nickreason17 ($100 in chips) 
Seat 7: Rafaello18 ($103.65 in chips) 
Seat 8: ruslik_by ($214.60 in chips) 
Seat 9: Starw!nd ($109.25 in chips) 
Starw!nd: posts small blind $0.50
chenconhaste: posts big blind $1
*** HOLE CARDS ***
Dealt to matiko09 [Td Ah]
robbiescrim9: calls $1
matiko09: raises $3.50 to $4.50
Kukuryzka: folds 
tipner: folds 
nickreason17: folds 
Rafaello18: raises $9 to $13.50
ruslik_by: calls $13.50
Starw!nd: folds 
chenconhaste: folds 
robbiescrim9: folds 
matiko09: folds 
*** FLOP *** [Kc 2c Qh]
Rafaello18: bets $10.65
ruslik_by: calls $10.65
*** TURN *** [Kc 2c Qh] [Tc]
Rafaello18: checks 
ruslik_by: checks 
*** RIVER *** [Kc 2c Qh Tc] [3s]
Rafaello18: checks 
ruslik_by: checks 
*** SHOW DOWN ***
Rafaello18: shows [Kh Ad] (a pair of Kings)
ruslik_by: mucks hand 
Rafaello18 collected $52.80 from pot
*** SUMMARY ***
Total pot $55.30 | Rake $2.50 
Board [Kc 2c Qh Tc 3s]
Seat 1: chenconhaste (big blind) folded before Flop
Seat 2: robbiescrim9 folded before Flop
Seat 3: matiko09 folded before Flop
Seat 4: Kukuryzka folded before Flop (didn't bet)
Seat 5: tipner folded before Flop (didn't bet)
Seat 6: nickreason17 folded before Flop (didn't bet)
Seat 7: Rafaello18 showed [Kh Ad] and won ($52.80) with a pair of Kings
Seat 8: ruslik_by (button) mucked [Jc Js]
Seat 9: Starw!nd (small blind) folded before Flop





PokerStars Hand #155381086163:  Hold'em No Limit ($0.50/$1.00 USD) - 2016/06/30 14:29:21 CET [2016/06/30 8:29:21 ET]
Table 'California II' 9-max Seat #5 is the button
Seat 1: Rafaello18 ($103.68 in chips) 
Seat 2: ruslik_by ($132.39 in chips) 
Seat 3: KovIFish89 ($100 in chips) 
Seat 4: f1reworks ($100 in chips) 
Seat 5: Rohitbarve ($108.77 in chips) 
Seat 6: matiko09 ($131.98 in chips) 
Seat 7: DomiVY ($92.88 in chips) 
Seat 8: chenconhaste ($100 in chips) 
Seat 9: di0d80 ($104.87 in chips) 
matiko09: posts small blind $0.50
DomiVY: posts big blind $1
*** HOLE CARDS ***
Dealt to matiko09 [Kc 7s]
chenconhaste: folds 
di0d80: folds 
Rafaello18: raises $1.50 to $2.50
ruslik_by: calls $2.50
KovIFish89: folds 
f1reworks: folds 
Rohitbarve: folds 
matiko09: folds 
DomiVY: calls $1.50
*** FLOP *** [Qd Qc 8h]
DomiVY: checks 
Rafaello18: checks 
ruslik_by: bets $3.80
DomiVY: folds 
Rafaello18: calls $3.80
*** TURN *** [Qd Qc 8h] [3h]
Rafaello18: checks 
ruslik_by: bets $7.41
Rafaello18: folds 
Uncalled bet ($7.41) returned to ruslik_by
ruslik_by collected $14.82 from pot
ruslik_by: doesn't show hand 
*** SUMMARY ***
Total pot $15.60 | Rake $0.78 
Board [Qd Qc 8h 3h]
Seat 1: Rafaello18 folded on the Turn
Seat 2: ruslik_by collected ($14.82)
Seat 3: KovIFish89 folded before Flop (didn't bet)
Seat 4: f1reworks folded before Flop (didn't bet)
Seat 5: Rohitbarve (button) folded before Flop (didn't bet)
Seat 6: matiko09 (small blind) folded before Flop
Seat 7: DomiVY (big blind) folded on the Flop
Seat 8: chenconhaste folded before Flop (didn't bet)
Seat 9: di0d80 folded before Flop (didn't bet)





PokerStars Hand #155381087977:  Hold'em No Limit ($0.50/$1.00 USD) - 2016/06/30 14:29:25 CET [2016/06/30 8:29:25 ET]
Table 'Sigrid' 9-max Seat #8 is the button
Seat 1: Greha999 ($61.58 in chips) 
Seat 2: matiko09 ($108.66 in chips) 
Seat 3: Rafaello18 ($109.35 in chips) 
Seat 4: mbk88 ($118.87 in chips) 
Seat 5: chenconhaste ($101.50 in chips) 
Seat 7: arctur17 ($104.12 in chips) 
Seat 8: ruslik_by ($104.12 in chips) 
Seat 9: KovIFish89 ($101.08 in chips) 
KovIFish89: posts small blind $0.50
Greha999: posts big blind $1
*** HOLE CARDS ***
Dealt to matiko09 [5d 9h]
matiko09: folds 
Rafaello18: folds 
mbk88: raises $2 to $3
chenconhaste: folds 
arctur17: calls $3
ruslik_by: folds 
KovIFish89: folds 
Greha999: calls $2
*** FLOP *** [8d 8c 2c]
Greha999: checks 
mbk88: bets $5
arctur17: calls $5
Greha999: folds 
*** TURN *** [8d 8c 2c] [Qc]
mbk88: bets $12
arctur17: calls $12
*** RIVER *** [8d 8c 2c Qc] [6c]
mbk88: checks 
arctur17: checks 
*** SHOW DOWN ***
mbk88: shows [Qh As] (two pair, Queens and Eights)
arctur17: shows [Jc Kc] (a flush, King high)
arctur17 collected $41.32 from pot
*** SUMMARY ***
Total pot $43.50 | Rake $2.18 
Board [8d 8c 2c Qc 6c]
Seat 1: Greha999 (big blind) folded on the Flop
Seat 2: matiko09 folded before Flop (didn't bet)
Seat 3: Rafaello18 folded before Flop (didn't bet)
Seat 4: mbk88 showed [Qh As] and lost with two pair, Queens and Eights
Seat 5: chenconhaste folded before Flop (didn't bet)
Seat 7: arctur17 showed [Jc Kc] and won ($41.32) with a flush, King high
Seat 8: ruslik_by (button) folded before Flop (didn't bet)
Seat 9: KovIFish89 (small blind) folded before Flop





PokerStars Hand #155381095077:  Hold'em No Limit (€0.25/€0.50 EUR) - 2016/06/30 14:29:40 CET [2016/06/30 8:29:40 ET]
Table 'Vibeke II' 9-max Seat #8 is the button
Seat 4: acelacat111 (€27 in chips) 
Seat 5: mazefaka007 (€66.65 in chips) 
Seat 6: Kukuryzka (€51.80 in chips) 
Seat 7: matiko09 (€64.64 in chips) 
Seat 8: KABAL_ua (€50 in chips) 
acelacat111: posts small blind €0.25
mazefaka007: posts big blind €0.50
*** HOLE CARDS ***
Dealt to matiko09 [8s 9s]
Kukuryzka: folds 
matiko09: raises €1 to €1.50
KABAL_ua: calls €1.50
acelacat111: folds 
mazefaka007: folds 
*** FLOP *** [2c 3s Qd]
matiko09: bets €2
KABAL_ua: folds 
Uncalled bet (€2) returned to matiko09
matiko09 collected €3.56 from pot
matiko09: doesn't show hand 
*** SUMMARY ***
Total pot €3.75 | Rake €0.19 
Board [2c 3s Qd]
Seat 4: acelacat111 (small blind) folded before Flop
Seat 5: mazefaka007 (big blind) folded before Flop
Seat 6: Kukuryzka folded before Flop (didn't bet)
Seat 7: matiko09 collected (€3.56)
Seat 8: KABAL_ua (button) folded on the Flop





PokerStars Hand #155381097400:  Hold'em No Limit ($0.50/$1.00 USD) - 2016/06/30 14:29:45 CET [2016/06/30 8:29:45 ET]
Table 'Asmodeus' 9-max Seat #2 is the button
Seat 2: nickreason17 ($100 in chips) 
Seat 3: matiko09 ($113.97 in chips) 
Seat 4: Ty Nick 420 ($100 in chips) 
Seat 5: sanr23 ($111.80 in chips) 
Seat 6: koutani7 ($82.03 in chips) 
Seat 7: aaronzzr ($138.01 in chips) 
Seat 8: Rafaello18 ($175.57 in chips) 
Seat 9: mbk88 ($159.76 in chips) 
matiko09: posts small blind $0.50
Ty Nick 420: posts big blind $1
*** HOLE CARDS ***
Dealt to matiko09 [3d 4d]
sanr23: folds 
koutani7: folds 
aaronzzr: folds 
Rafaello18: folds 
mbk88: folds 
nickreason17: raises $1 to $2
matiko09: folds 
Ty Nick 420: calls $1
*** FLOP *** [Jd Ks 2c]
Ty Nick 420: checks 
nickreason17: checks 
*** TURN *** [Jd Ks 2c] [8h]
Ty Nick 420: checks 
nickreason17: checks 
*** RIVER *** [Jd Ks 2c 8h] [8c]
Ty Nick 420: checks 
nickreason17: checks 
*** SHOW DOWN ***
Ty Nick 420: shows [Jc Qd] (two pair, Jacks and Eights)
nickreason17: mucks hand 
Ty Nick 420 collected $4.28 from pot
*** SUMMARY ***
Total pot $4.50 | Rake $0.22 
Board [Jd Ks 2c 8h 8c]
Seat 2: nickreason17 (button) mucked [Ts Tc]
Seat 3: matiko09 (small blind) folded before Flop
Seat 4: Ty Nick 420 (big blind) showed [Jc Qd] and won ($4.28) with two pair, Jacks and Eights
Seat 5: sanr23 folded before Flop (didn't bet)
Seat 6: koutani7 folded before Flop (didn't bet)
Seat 7: aaronzzr folded before Flop (didn't bet)
Seat 8: Rafaello18 folded before Flop (didn't bet)
Seat 9: mbk88 folded before Flop (didn't bet)





PokerStars Hand #155381099943:  Hold'em No Limit ($0.50/$1.00 USD) - 2016/06/30 14:29:50 CET [2016/06/30 8:29:50 ET]
Table 'Tatjana' 9-max Seat #9 is the button
Seat 1: tipner ($104.70 in chips) 
Seat 3: Rafaello18 ($101.29 in chips) 
Seat 4: mopatron25 ($83.26 in chips) 
Seat 5: matiko09 ($107.72 in chips) 
Seat 6: mbk88 ($161.04 in chips) 
Seat 8: alhill86 ($107.06 in chips) 
Seat 9: POTAPENKO700 ($231.93 in chips) 
tipner: posts small blind $0.50
DIMAN_324: is sitting out 
Rafaello18: posts big blind $1
*** HOLE CARDS ***
Dealt to matiko09 [2c 3c]
mopatron25: calls $1
matiko09: folds 
DIMAN_324 leaves the table
Kukuryzka joins the table at seat #2 
mbk88: folds 
alhill86: folds 
POTAPENKO700: raises $3.50 to $4.50
tipner: calls $4
Rafaello18: folds 
mopatron25: calls $3.50
*** FLOP *** [4d As 7d]
tipner: checks 
mopatron25: checks 
POTAPENKO700: bets $8.50
tipner: calls $8.50
mopatron25: calls $8.50
*** TURN *** [4d As 7d] [4h]
tipner: checks 
mopatron25: checks 
POTAPENKO700: checks 
*** RIVER *** [4d As 7d 4h] [6s]
tipner: checks 
mopatron25: checks 
POTAPENKO700: checks 
*** SHOW DOWN ***
tipner: shows [Kc Kh] (two pair, Kings and Fours)
mopatron25: shows [7c Ac] (two pair, Aces and Sevens)
POTAPENKO700: mucks hand 
mopatron25 collected $38 from pot
*** SUMMARY ***
Total pot $40 | Rake $2 
Board [4d As 7d 4h 6s]
Seat 1: tipner (small blind) showed [Kc Kh] and lost with two pair, Kings and Fours
Seat 3: Rafaello18 (big blind) folded before Flop
Seat 4: mopatron25 showed [7c Ac] and won ($38) with two pair, Aces and Sevens
Seat 5: matiko09 folded before Flop (didn't bet)
Seat 6: mbk88 folded before Flop (didn't bet)
Seat 8: alhill86 folded before Flop (didn't bet)
Seat 9: POTAPENKO700 (button) mucked [Jc Kd]





PokerStars Hand #155381102673:  Hold'em No Limit ($0.50/$1.00 USD) - 2016/06/30 14:29:56 CET [2016/06/30 8:29:56 ET]
Table 'Altarf II' 9-max Seat #3 is the button
Seat 1: Rafaello18 ($100 in chips) 
Seat 2: KovIFish89 ($106.50 in chips) 
Seat 3: sanr23 ($183.71 in chips) 
Seat 4: Greha999 ($148.88 in chips) 
Seat 6: mbk88 ($100 in chips) 
Seat 7: matiko09 ($106.22 in chips) 
Seat 8: DomiVY ($40.62 in chips) 
Seat 9: omanibemihum ($159.42 in chips) 
Greha999: posts small blind $0.50
DIMAN_324: is sitting out 
mbk88: posts big blind $1
*** HOLE CARDS ***
Dealt to matiko09 [Qc 9d]
DIMAN_324 leaves the table
nickreason17 joins the table at seat #5 
matiko09: folds 
DomiVY: folds 
omanibemihum: folds 
Rafaello18: folds 
KovIFish89: folds 
sanr23: raises $1 to $2
Greha999: folds 
mbk88: folds 
Uncalled bet ($1) returned to sanr23
sanr23 collected $2.50 from pot
sanr23: doesn't show hand 
*** SUMMARY ***
Total pot $2.50 | Rake $0 
Seat 1: Rafaello18 folded before Flop (didn't bet)
Seat 2: KovIFish89 folded before Flop (didn't bet)
Seat 3: sanr23 (button) collected ($2.50)
Seat 4: Greha999 (small blind) folded before Flop
Seat 6: mbk88 (big blind) folded before Flop
Seat 7: matiko09 folded before Flop (didn't bet)
Seat 8: DomiVY folded before Flop (didn't bet)
Seat 9: omanibemihum folded before Flop (didn't bet)





PokerStars Hand #155381107784:  Hold'em No Limit ($0.50/$1.00 USD) - 2016/06/30 14:30:06 CET [2016/06/30 8:30:06 ET]
Table 'Borrelly II' 9-max Seat #8 is the button
Seat 1: Rafaello18 ($121.59 in chips) 
Seat 2: mbk88 ($113.28 in chips) 
Seat 4: DonRon_AT ($56.38 in chips) 
Seat 6: m_michalec ($173.92 in chips) 
Seat 7: matiko09 ($174.36 in chips) 
Seat 8: Arjun A Raju ($132.42 in chips) 
Seat 9: ruslik_by ($100 in chips) 
ruslik_by: posts small blind $0.50
Rafaello18: posts big blind $1
Ty Nick 420: sits out 
*** HOLE CARDS ***
Dealt to matiko09 [Kh Kd]
mbk88: folds 
DonRon_AT: folds 
m_michalec: folds 
matiko09: raises $1.50 to $2.50
Arjun A Raju: folds 
ruslik_by: folds 
Rafaello18: folds 
Uncalled bet ($1.50) returned to matiko09
matiko09 collected $2.50 from pot
matiko09: doesn't show hand 
*** SUMMARY ***
Total pot $2.50 | Rake $0 
Seat 1: Rafaello18 (big blind) folded before Flop
Seat 2: mbk88 folded before Flop (didn't bet)
Seat 4: DonRon_AT folded before Flop (didn't bet)
Seat 6: m_michalec folded before Flop (didn't bet)
Seat 7: matiko09 collected ($2.50)
Seat 8: Arjun A Raju (button) folded before Flop (didn't bet)
Seat 9: ruslik_by (small blind) folded before Flop





PokerStars Hand #155381110115:  Hold'em No Limit ($0.25/$0.50 USD) - 2016/06/30 14:30:11 CET [2016/06/30 8:30:11 ET]
Table 'Arcturus' 9-max Seat #9 is the button
Seat 1: kourk250 ($146.81 in chips) 
Seat 2: Rafaello18 ($50 in chips) 
Seat 3: matiko09 ($50.64 in chips) 
Seat 5: stockbridge8 ($47.75 in chips) 
Seat 6: statistik85 ($64.91 in chips) 
Seat 7: bratbugor ($50 in chips) 
Seat 8: TheMinion ($50 in chips) 
Seat 9: pfunkolstar ($108.86 in chips) 
kourk250: posts small blind $0.25
Rafaello18: posts big blind $0.50
*** HOLE CARDS ***
Dealt to matiko09 [5h 5s]
matiko09: raises $1 to $1.50
stockbridge8: folds 
statistik85: folds 
bratbugor: folds 
TheMinion: folds 
pfunkolstar: folds 
kourk250: calls $1.25
Rafaello18: folds 
*** FLOP *** [4c 5d 4h]
kourk250: checks 
matiko09: bets $1.72
kourk250: calls $1.72
*** TURN *** [4c 5d 4h] [Ts]
kourk250: checks 
matiko09: bets $4
kourk250: folds 
Uncalled bet ($4) returned to matiko09
matiko09 collected $6.59 from pot
matiko09: doesn't show hand 
*** SUMMARY ***
Total pot $6.94 | Rake $0.35 
Board [4c 5d 4h Ts]
Seat 1: kourk250 (small blind) folded on the Turn
Seat 2: Rafaello18 (big blind) folded before Flop
Seat 3: matiko09 collected ($6.59)
Seat 5: stockbridge8 folded before Flop (didn't bet)
Seat 6: statistik85 folded before Flop (didn't bet)
Seat 7: bratbugor folded before Flop (didn't bet)
Seat 8: TheMinion folded before Flop (didn't bet)
Seat 9: pfunkolstar (button) folded before Flop (didn't bet)





PokerStars Hand #155381116888:  Hold'em No Limit ($0.50/$1.00 USD) - 2016/06/30 14:30:25 CET [2016/06/30 8:30:25 ET]
Table 'Altarf II' 9-max Seat #4 is the button
Seat 1: Rafaello18 ($100 in chips) 
Seat 2: KovIFish89 ($106.50 in chips) 
Seat 3: sanr23 ($185.21 in chips) 
Seat 4: Greha999 ($148.38 in chips) 
Seat 6: mbk88 ($100 in chips) 
Seat 7: matiko09 ($106.22 in chips) 
Seat 8: DomiVY ($40.62 in chips) 
Seat 9: omanibemihum ($159.42 in chips) 
mbk88: posts small blind $0.50
matiko09: posts big blind $1
*** HOLE CARDS ***
Dealt to matiko09 [9d 7h]
DomiVY: folds 
omanibemihum: folds 
Rafaello18: raises $1.50 to $2.50
KovIFish89: raises $6 to $8.50
sanr23: calls $8.50
Greha999: folds 
mbk88: folds 
matiko09: folds 
Rafaello18: folds 
*** FLOP *** [3s Td 7s]
KovIFish89: bets $10
sanr23: calls $10
*** TURN *** [3s Td 7s] [3c]
Greha999 is disconnected 
KovIFish89: bets $22.47
sanr23: folds 
Uncalled bet ($22.47) returned to KovIFish89
KovIFish89 collected $38.95 from pot
KovIFish89: doesn't show hand 
*** SUMMARY ***
Total pot $41 | Rake $2.05 
Board [3s Td 7s 3c]
Seat 1: Rafaello18 folded before Flop
Seat 2: KovIFish89 collected ($38.95)
Seat 3: sanr23 folded on the Turn
Seat 4: Greha999 (button) folded before Flop (didn't bet)
Seat 6: mbk88 (small blind) folded before Flop
Seat 7: matiko09 (big blind) folded before Flop
Seat 8: DomiVY folded before Flop (didn't bet)
Seat 9: omanibemihum folded before Flop (didn't bet)





PokerStars Hand #155381119066:  Hold'em No Limit ($0.50/$1.00 USD) - 2016/06/30 14:30:30 CET [2016/06/30 8:30:30 ET]
Table 'Sigrid' 9-max Seat #9 is the button
Seat 1: Greha999 ($58.58 in chips) 
Seat 2: matiko09 ($108.66 in chips) 
Seat 3: Rafaello18 ($109.35 in chips) 
Seat 4: mbk88 ($100 in chips) 
Seat 5: chenconhaste ($101.50 in chips) 
Seat 7: arctur17 ($125.44 in chips) 
Seat 8: ruslik_by ($104.12 in chips) 
Seat 9: KovIFish89 ($100.58 in chips) 
Greha999: posts small blind $0.50
matiko09: posts big blind $1
*** HOLE CARDS ***
Dealt to matiko09 [Qh Ac]
Rafaello18: folds 
mbk88: raises $2 to $3
chenconhaste: folds 
arctur17: folds 
ruslik_by: folds 
KovIFish89: folds 
Greha999: calls $2.50
matiko09: calls $2
*** FLOP *** [3d 6c Jh]
Greha999: checks 
matiko09: checks 
mbk88: bets $6
Greha999 is disconnected 
Greha999 is connected 
Greha999: folds 
matiko09: folds 
Uncalled bet ($6) returned to mbk88
mbk88 collected $8.55 from pot
mbk88: doesn't show hand 
*** SUMMARY ***
Total pot $9 | Rake $0.45 
Board [3d 6c Jh]
Seat 1: Greha999 (small blind) folded on the Flop
Seat 2: matiko09 (big blind) folded on the Flop
Seat 3: Rafaello18 folded before Flop (didn't bet)
Seat 4: mbk88 collected ($8.55)
Seat 5: chenconhaste folded before Flop (didn't bet)
Seat 7: arctur17 folded before Flop (didn't bet)
Seat 8: ruslik_by folded before Flop (didn't bet)
Seat 9: KovIFish89 (button) folded before Flop (didn't bet)





PokerStars Hand #155381120751:  Hold'em No Limit (€0.25/€0.50 EUR) - 2016/06/30 14:30:33 CET [2016/06/30 8:30:33 ET]
Table 'Vibeke II' 9-max Seat #4 is the button
Seat 4: acelacat111 (€26.75 in chips) 
Seat 5: mazefaka007 (€66.15 in chips) 
Seat 6: Kukuryzka (€51.80 in chips) 
Seat 7: matiko09 (€66.70 in chips) 
Seat 8: KABAL_ua (€50 in chips) 
mazefaka007: posts small blind €0.25
Kukuryzka: posts big blind €0.50
*** HOLE CARDS ***
Dealt to matiko09 [6d 7h]
matiko09: folds 
KABAL_ua: folds 
acelacat111: raises €1 to €1.50
mazefaka007: folds 
Kukuryzka: folds 
Uncalled bet (€1) returned to acelacat111
acelacat111 collected €1.25 from pot
acelacat111: doesn't show hand 
*** SUMMARY ***
Total pot €1.25 | Rake €0 
Seat 4: acelacat111 (button) collected (€1.25)
Seat 5: mazefaka007 (small blind) folded before Flop
Seat 6: Kukuryzka (big blind) folded before Flop
Seat 7: matiko09 folded before Flop (didn't bet)
Seat 8: KABAL_ua folded before Flop (didn't bet)





PokerStars Hand #155381124174:  Hold'em No Limit ($0.50/$1.00 USD) - 2016/06/30 14:30:41 CET [2016/06/30 8:30:41 ET]
Table 'Borrelly II' 9-max Seat #9 is the button
Seat 1: Rafaello18 ($120.59 in chips) 
Seat 2: mbk88 ($113.28 in chips) 
Seat 4: DonRon_AT ($56.38 in chips) 
Seat 6: m_michalec ($173.92 in chips) 
Seat 7: matiko09 ($175.86 in chips) 
Seat 8: Arjun A Raju ($132.42 in chips) 
Seat 9: ruslik_by ($100 in chips) 
Rafaello18: posts small blind $0.50
mbk88: posts big blind $1
Ty Nick 420: sits out 
*** HOLE CARDS ***
Dealt to matiko09 [3d 9d]
DonRon_AT: folds 
m_michalec: folds 
matiko09: folds 
Arjun A Raju: folds 
ruslik_by: raises $1 to $2
Rafaello18: folds 
mbk88: calls $1
*** FLOP *** [Qs 7c 9s]
mbk88: checks 
ruslik_by: bets $2.14
mbk88: calls $2.14
*** TURN *** [Qs 7c 9s] [9h]
mbk88: checks 
ruslik_by: checks 
*** RIVER *** [Qs 7c 9s 9h] [Jc]
mbk88: bets $5
ruslik_by: calls $5
*** SHOW DOWN ***
mbk88: shows [Ts Qd] (two pair, Queens and Nines)
ruslik_by: shows [Qc Kc] (two pair, Queens and Nines - King kicker)
ruslik_by collected $17.84 from pot
*** SUMMARY ***
Total pot $18.78 | Rake $0.94 
Board [Qs 7c 9s 9h Jc]
Seat 1: Rafaello18 (small blind) folded before Flop
Seat 2: mbk88 (big blind) showed [Ts Qd] and lost with two pair, Queens and Nines
Seat 4: DonRon_AT folded before Flop (didn't bet)
Seat 6: m_michalec folded before Flop (didn't bet)
Seat 7: matiko09 folded before Flop (didn't bet)
Seat 8: Arjun A Raju folded before Flop (didn't bet)
Seat 9: ruslik_by (button) showed [Qc Kc] and won ($17.84) with two pair, Queens and Nines





PokerStars Hand #155381125587:  Hold'em No Limit ($0.50/$1.00 USD) - 2016/06/30 14:30:44 CET [2016/06/30 8:30:44 ET]
Table 'Asmodeus' 9-max Seat #3 is the button
Seat 2: nickreason17 ($100 in chips) 
Seat 3: matiko09 ($113.47 in chips) 
Seat 4: Ty Nick 420 ($102.28 in chips) 
Seat 5: sanr23 ($111.80 in chips) 
Seat 6: koutani7 ($82.03 in chips) 
Seat 7: aaronzzr ($138.01 in chips) 
Seat 8: Rafaello18 ($175.57 in chips) 
Seat 9: mbk88 ($159.76 in chips) 
Ty Nick 420: posts small blind $0.50
sanr23: posts big blind $1
*** HOLE CARDS ***
Dealt to matiko09 [3d 4s]
koutani7: folds 
aaronzzr: folds 
Rafaello18: folds 
mbk88: folds 
nickreason17: raises $1.50 to $2.50
matiko09: folds 
Ty Nick 420: folds 
sanr23: folds 
Uncalled bet ($1.50) returned to nickreason17
nickreason17 collected $2.50 from pot
*** SUMMARY ***
Total pot $2.50 | Rake $0 
Seat 2: nickreason17 collected ($2.50)
Seat 3: matiko09 (button) folded before Flop (didn't bet)
Seat 4: Ty Nick 420 (small blind) folded before Flop
Seat 5: sanr23 (big blind) folded before Flop
Seat 6: koutani7 folded before Flop (didn't bet)
Seat 7: aaronzzr folded before Flop (didn't bet)
Seat 8: Rafaello18 folded before Flop (didn't bet)
Seat 9: mbk88 folded before Flop (didn't bet)





PokerStars Hand #155381129689:  Hold'em No Limit (€0.25/€0.50 EUR) - 2016/06/30 14:30:52 CET [2016/06/30 8:30:52 ET]
Table 'Vibeke II' 9-max Seat #5 is the button
Seat 4: acelacat111 (€27.50 in chips) 
Seat 5: mazefaka007 (€65.90 in chips) 
Seat 6: Kukuryzka (€51.30 in chips) 
Seat 7: matiko09 (€66.70 in chips) 
Seat 8: KABAL_ua (€50 in chips) 
Kukuryzka: posts small blind €0.25
matiko09: posts big blind €0.50
*** HOLE CARDS ***
Dealt to matiko09 [3h 4s]
KABAL_ua: folds 
acelacat111: folds 
mazefaka007: raises €0.55 to €1.05
Kukuryzka: folds 
matiko09: folds 
Uncalled bet (€0.55) returned to mazefaka007
mazefaka007 collected €1.25 from pot
mazefaka007: doesn't show hand 
*** SUMMARY ***
Total pot €1.25 | Rake €0 
Seat 4: acelacat111 folded before Flop (didn't bet)
Seat 5: mazefaka007 (button) collected (€1.25)
Seat 6: Kukuryzka (small blind) folded before Flop
Seat 7: matiko09 (big blind) folded before Flop
Seat 8: KABAL_ua folded before Flop (didn't bet)





PokerStars Hand #155381135791:  Hold'em No Limit ($0.25/$0.50 USD) - 2016/06/30 14:31:05 CET [2016/06/30 8:31:05 ET]
Table 'Arcturus' 9-max Seat #1 is the button
Seat 1: kourk250 ($143.59 in chips) 
Seat 2: Rafaello18 ($50 in chips) 
Seat 3: matiko09 ($54.01 in chips) 
Seat 5: stockbridge8 ($47.75 in chips) 
Seat 6: statistik85 ($64.91 in chips) 
Seat 7: bratbugor ($50 in chips) 
Seat 8: TheMinion ($50 in chips) 
Rafaello18: posts small blind $0.25
matiko09: posts big blind $0.50
*** HOLE CARDS ***
Dealt to matiko09 [Qd 7d]
stockbridge8: folds 
pfunkolstar leaves the table
statistik85: calls $0.50
bratbugor: raises $1.25 to $1.75
TheMinion: folds 
kourk250: calls $1.75
Rafaello18: folds 
matiko09: folds 
joker180785 joins the table at seat #9 
statistik85: folds 
*** FLOP *** [4s 4d 3s]
bratbugor: checks 
kourk250: checks 
*** TURN *** [4s 4d 3s] [6s]
bratbugor: bets $3.54
kourk250: folds 
Uncalled bet ($3.54) returned to bratbugor
bratbugor collected $4.51 from pot
bratbugor: doesn't show hand 
*** SUMMARY ***
Total pot $4.75 | Rake $0.24 
Board [4s 4d 3s 6s]
Seat 1: kourk250 (button) folded on the Turn
Seat 2: Rafaello18 (small blind) folded before Flop
Seat 3: matiko09 (big blind) folded before Flop
Seat 5: stockbridge8 folded before Flop (didn't bet)
Seat 6: statistik85 folded before Flop
Seat 7: bratbugor collected ($4.51)
Seat 8: TheMinion folded before Flop (didn't bet)





PokerStars Hand #155381138905:  Hold'em No Limit ($0.50/$1.00 USD) - 2016/06/30 14:31:12 CET [2016/06/30 8:31:12 ET]
Table 'Tatjana' 9-max Seat #1 is the button
Seat 1: tipner ($100 in chips) 
Seat 3: Rafaello18 ($100.29 in chips) 
Seat 4: mopatron25 ($108.26 in chips) 
Seat 5: matiko09 ($107.72 in chips) 
Seat 6: mbk88 ($161.04 in chips) 
Seat 8: alhill86 ($107.06 in chips) 
Seat 9: POTAPENKO700 ($218.93 in chips) 
Kukuryzka will be allowed to play after the button
Rafaello18: posts small blind $0.50
mopatron25: posts big blind $1
*** HOLE CARDS ***
Dealt to matiko09 [2s Kd]
matiko09: folds 
mbk88: folds 
alhill86: folds 
POTAPENKO700: folds 
tipner: folds 
Rafaello18: raises $1.50 to $2.50
mopatron25: calls $1.50
*** FLOP *** [8s 4d 8d]
Rafaello18: checks 
mopatron25: bets $2
Rafaello18: folds 
Uncalled bet ($2) returned to mopatron25
mopatron25 collected $4.75 from pot
mopatron25: doesn't show hand 
*** SUMMARY ***
Total pot $5 | Rake $0.25 
Board [8s 4d 8d]
Seat 1: tipner (button) folded before Flop (didn't bet)
Seat 3: Rafaello18 (small blind) folded on the Flop
Seat 4: mopatron25 (big blind) collected ($4.75)
Seat 5: matiko09 folded before Flop (didn't bet)
Seat 6: mbk88 folded before Flop (didn't bet)
Seat 8: alhill86 folded before Flop (didn't bet)
Seat 9: POTAPENKO700 folded before Flop (didn't bet)





PokerStars Hand #155381140748:  Hold'em No Limit ($0.50/$1.00 USD) - 2016/06/30 14:31:16 CET [2016/06/30 8:31:16 ET]
Table 'California II' 9-max Seat #6 is the button
Seat 1: Rafaello18 ($100 in chips) 
Seat 2: ruslik_by ($140.91 in chips) 
Seat 3: KovIFish89 ($100 in chips) 
Seat 4: f1reworks ($100 in chips) 
Seat 5: Rohitbarve ($108.77 in chips) 
Seat 6: matiko09 ($131.48 in chips) 
Seat 7: DomiVY ($90.38 in chips) 
Seat 8: chenconhaste ($100 in chips) 
Seat 9: di0d80 ($104.87 in chips) 
DomiVY: posts small blind $0.50
chenconhaste: posts big blind $1
*** HOLE CARDS ***
Dealt to matiko09 [6d 4h]
di0d80: folds 
Rafaello18: raises $1.50 to $2.50
ruslik_by: folds 
KovIFish89: calls $2.50
f1reworks: folds 
Rohitbarve: folds 
matiko09: folds 
DomiVY: folds 
chenconhaste: folds 
*** FLOP *** [2d 7h 4d]
Rafaello18: bets $4
KovIFish89: calls $4
*** TURN *** [2d 7h 4d] [Ad]
Rafaello18: checks 
KovIFish89: bets $9.18
Rafaello18: folds 
Uncalled bet ($9.18) returned to KovIFish89
KovIFish89 collected $13.78 from pot
KovIFish89: doesn't show hand 
*** SUMMARY ***
Total pot $14.50 | Rake $0.72 
Board [2d 7h 4d Ad]
Seat 1: Rafaello18 folded on the Turn
Seat 2: ruslik_by folded before Flop (didn't bet)
Seat 3: KovIFish89 collected ($13.78)
Seat 4: f1reworks folded before Flop (didn't bet)
Seat 5: Rohitbarve folded before Flop (didn't bet)
Seat 6: matiko09 (button) folded before Flop (didn't bet)
Seat 7: DomiVY (small blind) folded before Flop
Seat 8: chenconhaste (big blind) folded before Flop
Seat 9: di0d80 folded before Flop (didn't bet)





PokerStars Hand #155381142038:  Hold'em No Limit (€0.25/€0.50 EUR) - 2016/06/30 14:31:18 CET [2016/06/30 8:31:18 ET]
Table 'Vibeke II' 9-max Seat #6 is the button
Seat 4: acelacat111 (€27.50 in chips) 
Seat 5: mazefaka007 (€66.65 in chips) 
Seat 6: Kukuryzka (€51.05 in chips) 
Seat 7: matiko09 (€66.20 in chips) 
Seat 8: KABAL_ua (€50 in chips) 
matiko09: posts small blind €0.25
KABAL_ua: posts big blind €0.50
*** HOLE CARDS ***
Dealt to matiko09 [6s Jh]
acelacat111: folds 
mazefaka007: folds 
Kukuryzka: folds 
matiko09: folds 
Uncalled bet (€0.25) returned to KABAL_ua
KABAL_ua collected €0.50 from pot
KABAL_ua: doesn't show hand 
*** SUMMARY ***
Total pot €0.50 | Rake €0 
Seat 4: acelacat111 folded before Flop (didn't bet)
Seat 5: mazefaka007 folded before Flop (didn't bet)
Seat 6: Kukuryzka (button) folded before Flop (didn't bet)
Seat 7: matiko09 (small blind) folded before Flop
Seat 8: KABAL_ua (big blind) collected (€0.50)





PokerStars Hand #155381146541:  Hold'em No Limit ($0.50/$1.00 USD) - 2016/06/30 14:31:28 CET [2016/06/30 8:31:28 ET]
Table 'Donnera' 9-max Seat #9 is the button
Seat 1: chenconhaste ($112.06 in chips) 
Seat 2: robbiescrim9 ($114.26 in chips) 
Seat 3: matiko09 ($104.75 in chips) 
Seat 4: Kukuryzka ($100 in chips) 
Seat 5: tipner ($100 in chips) 
Seat 6: nickreason17 ($100 in chips) 
Seat 7: Rafaello18 ($132.30 in chips) 
Seat 8: ruslik_by ($190.45 in chips) 
Seat 9: Starw!nd ($108.75 in chips) 
chenconhaste: posts small blind $0.50
robbiescrim9: posts big blind $1
*** HOLE CARDS ***
Dealt to matiko09 [2c 5d]
matiko09: folds 
Kukuryzka: folds 
tipner: raises $2 to $3
nickreason17: calls $3
Rafaello18: folds 
ruslik_by: calls $3
Starw!nd: raises $12 to $15
chenconhaste: folds 
robbiescrim9: folds 
tipner: folds 
nickreason17: folds 
ruslik_by: folds 
Uncalled bet ($12) returned to Starw!nd
Starw!nd collected $13.50 from pot
Starw!nd: doesn't show hand 
*** SUMMARY ***
Total pot $13.50 | Rake $0 
Seat 1: chenconhaste (small blind) folded before Flop
Seat 2: robbiescrim9 (big blind) folded before Flop
Seat 3: matiko09 folded before Flop (didn't bet)
Seat 4: Kukuryzka folded before Flop (didn't bet)
Seat 5: tipner folded before Flop
Seat 6: nickreason17 folded before Flop
Seat 7: Rafaello18 folded before Flop (didn't bet)
Seat 8: ruslik_by folded before Flop
Seat 9: Starw!nd (button) collected ($13.50)





PokerStars Hand #155381149002:  Hold'em No Limit (€0.25/€0.50 EUR) - 2016/06/30 14:31:33 CET [2016/06/30 8:31:33 ET]
Table 'Vibeke II' 9-max Seat #7 is the button
Seat 4: acelacat111 (€27.50 in chips) 
Seat 5: mazefaka007 (€66.65 in chips) 
Seat 6: Kukuryzka (€51.05 in chips) 
Seat 7: matiko09 (€65.95 in chips) 
Seat 8: KABAL_ua (€50.25 in chips) 
KABAL_ua: posts small blind €0.25
acelacat111: posts big blind €0.50
*** HOLE CARDS ***
Dealt to matiko09 [As Tc]
mazefaka007: folds 
Kukuryzka: folds 
matiko09: raises €0.63 to €1.13
KABAL_ua: calls €0.88
acelacat111: folds 
*** FLOP *** [Jh 3c Td]
KABAL_ua: checks 
matiko09: checks 
*** TURN *** [Jh 3c Td] [9s]
KABAL_ua: checks 
matiko09: bets €0.81
KABAL_ua: calls €0.81
*** RIVER *** [Jh 3c Td 9s] [4c]
KABAL_ua: checks 
matiko09: checks 
*** SHOW DOWN ***
KABAL_ua: shows [7h 7c] (a pair of Sevens)
matiko09: shows [As Tc] (a pair of Tens)
matiko09 collected €4.16 from pot
*** SUMMARY ***
Total pot €4.38 | Rake €0.22 
Board [Jh 3c Td 9s 4c]
Seat 4: acelacat111 (big blind) folded before Flop
Seat 5: mazefaka007 folded before Flop (didn't bet)
Seat 6: Kukuryzka folded before Flop (didn't bet)
Seat 7: matiko09 (button) showed [As Tc] and won (€4.16) with a pair of Tens
Seat 8: KABAL_ua (small blind) showed [7h 7c] and lost with a pair of Sevens





PokerStars Hand #155381149219:  Hold'em No Limit ($0.50/$1.00 USD) - 2016/06/30 14:31:33 CET [2016/06/30 8:31:33 ET]
Table 'Asmodeus' 9-max Seat #4 is the button
Seat 2: nickreason17 ($101.50 in chips) 
Seat 3: matiko09 ($113.47 in chips) 
Seat 4: Ty Nick 420 ($101.78 in chips) 
Seat 5: sanr23 ($110.80 in chips) 
Seat 6: koutani7 ($82.03 in chips) 
Seat 7: aaronzzr ($138.01 in chips) 
Seat 8: Rafaello18 ($175.57 in chips) 
Seat 9: mbk88 ($159.76 in chips) 
sanr23: posts small blind $0.50
koutani7: posts big blind $1
*** HOLE CARDS ***
Dealt to matiko09 [Ah Qd]
aaronzzr: raises $1 to $2
Rafaello18: folds 
mbk88: folds 
nickreason17: folds 
matiko09: calls $2
Ty Nick 420: raises $8 to $10
sanr23: folds 
koutani7: folds 
aaronzzr: folds 
matiko09: folds 
Uncalled bet ($8) returned to Ty Nick 420
Ty Nick 420 collected $7.50 from pot
*** SUMMARY ***
Total pot $7.50 | Rake $0 
Seat 2: nickreason17 folded before Flop (didn't bet)
Seat 3: matiko09 folded before Flop
Seat 4: Ty Nick 420 (button) collected ($7.50)
Seat 5: sanr23 (small blind) folded before Flop
Seat 6: koutani7 (big blind) folded before Flop
Seat 7: aaronzzr folded before Flop
Seat 8: Rafaello18 folded before Flop (didn't bet)
Seat 9: mbk88 folded before Flop (didn't bet)





PokerStars Hand #155381158453:  Hold'em No Limit ($0.50/$1.00 USD) - 2016/06/30 14:31:52 CET [2016/06/30 8:31:52 ET]
Table 'Tatjana' 9-max Seat #3 is the button
Seat 1: tipner ($100 in chips) 
Seat 3: Rafaello18 ($100 in chips) 
Seat 4: mopatron25 ($110.51 in chips) 
Seat 5: matiko09 ($107.72 in chips) 
Seat 6: mbk88 ($161.04 in chips) 
Seat 8: alhill86 ($107.06 in chips) 
Seat 9: POTAPENKO700 ($218.93 in chips) 
mopatron25: posts small blind $0.50
matiko09: posts big blind $1
Kukuryzka: sits out 
*** HOLE CARDS ***
Dealt to matiko09 [7h Jh]
mbk88: folds 
alhill86: folds 
POTAPENKO700: folds 
tipner: folds 
Rafaello18: raises $1.50 to $2.50
mopatron25: calls $2
matiko09: calls $1.50
*** FLOP *** [8h Qh Ah]
mopatron25: bets $2
matiko09: calls $2
Rafaello18: folds 
*** TURN *** [8h Qh Ah] [3h]
mopatron25: checks 
matiko09: bets $6
mopatron25: folds 
Uncalled bet ($6) returned to matiko09
matiko09 collected $10.92 from pot
matiko09: doesn't show hand 
*** SUMMARY ***
Total pot $11.50 | Rake $0.58 
Board [8h Qh Ah 3h]
Seat 1: tipner folded before Flop (didn't bet)
Seat 3: Rafaello18 (button) folded on the Flop
Seat 4: mopatron25 (small blind) folded on the Turn
Seat 5: matiko09 (big blind) collected ($10.92)
Seat 6: mbk88 folded before Flop (didn't bet)
Seat 8: alhill86 folded before Flop (didn't bet)
Seat 9: POTAPENKO700 folded before Flop (didn't bet)





PokerStars Hand #155381159884:  Hold'em No Limit ($0.50/$1.00 USD) - 2016/06/30 14:31:55 CET [2016/06/30 8:31:55 ET]
Table 'Borrelly II' 9-max Seat #1 is the button
Seat 1: Rafaello18 ($120.09 in chips) 
Seat 2: mbk88 ($104.14 in chips) 
Seat 4: DonRon_AT ($56.38 in chips) 
Seat 6: m_michalec ($173.92 in chips) 
Seat 7: matiko09 ($175.86 in chips) 
Seat 8: Arjun A Raju ($132.42 in chips) 
Seat 9: ruslik_by ($108.70 in chips) 
mbk88: posts small blind $0.50
DonRon_AT: posts big blind $1
Ty Nick 420: sits out 
*** HOLE CARDS ***
Dealt to matiko09 [4s 9s]
m_michalec: folds 
matiko09: folds 
Arjun A Raju: folds 
ruslik_by: raises $1.50 to $2.50
Rafaello18: folds 
mbk88: folds 
DonRon_AT: calls $1.50
*** FLOP *** [Ad 6s 2h]
DonRon_AT: checks 
ruslik_by: bets $2.61
DonRon_AT: folds 
Uncalled bet ($2.61) returned to ruslik_by
ruslik_by collected $5.22 from pot
ruslik_by: doesn't show hand 
*** SUMMARY ***
Total pot $5.50 | Rake $0.28 
Board [Ad 6s 2h]
Seat 1: Rafaello18 (button) folded before Flop (didn't bet)
Seat 2: mbk88 (small blind) folded before Flop
Seat 4: DonRon_AT (big blind) folded on the Flop
Seat 6: m_michalec folded before Flop (didn't bet)
Seat 7: matiko09 folded before Flop (didn't bet)
Seat 8: Arjun A Raju folded before Flop (didn't bet)
Seat 9: ruslik_by collected ($5.22)





PokerStars Hand #155381169546:  Hold'em No Limit ($0.50/$1.00 USD) - 2016/06/30 14:32:15 CET [2016/06/30 8:32:15 ET]
Table 'Sigrid' 9-max Seat #1 is the button
Seat 1: Greha999 ($55.58 in chips) 
Seat 2: matiko09 ($105.66 in chips) 
Seat 3: Rafaello18 ($109.35 in chips) 
Seat 4: mbk88 ($105.55 in chips) 
Seat 5: chenconhaste ($101.50 in chips) 
Seat 7: arctur17 ($125.44 in chips) 
Seat 8: ruslik_by ($104.12 in chips) 
Seat 9: KovIFish89 ($100.58 in chips) 
matiko09: posts small blind $0.50
Rafaello18: posts big blind $1
*** HOLE CARDS ***
Dealt to matiko09 [Ac Th]
mbk88: folds 
chenconhaste: raises $1.25 to $2.25
arctur17: folds 
ruslik_by: folds 
KovIFish89: folds 
Greha999: folds 
matiko09: folds 
Rafaello18: folds 
Uncalled bet ($1.25) returned to chenconhaste
chenconhaste collected $2.50 from pot
*** SUMMARY ***
Total pot $2.50 | Rake $0 
Seat 1: Greha999 (button) folded before Flop (didn't bet)
Seat 2: matiko09 (small blind) folded before Flop
Seat 3: Rafaello18 (big blind) folded before Flop
Seat 4: mbk88 folded before Flop (didn't bet)
Seat 5: chenconhaste collected ($2.50)
Seat 7: arctur17 folded before Flop (didn't bet)
Seat 8: ruslik_by folded before Flop (didn't bet)
Seat 9: KovIFish89 folded before Flop (didn't bet)





PokerStars Hand #155381170330:  Hold'em No Limit ($0.50/$1.00 USD) - 2016/06/30 14:32:17 CET [2016/06/30 8:32:17 ET]
Table 'Donnera' 9-max Seat #1 is the button
Seat 1: chenconhaste ($111.56 in chips) 
Seat 2: robbiescrim9 ($113.26 in chips) 
Seat 3: matiko09 ($104.75 in chips) 
Seat 4: Kukuryzka ($100 in chips) 
Seat 5: tipner ($100 in chips) 
Seat 6: nickreason17 ($100 in chips) 
Seat 7: Rafaello18 ($132.30 in chips) 
Seat 8: ruslik_by ($187.45 in chips) 
Seat 9: Starw!nd ($119.25 in chips) 
robbiescrim9: posts small blind $0.50
matiko09: posts big blind $1
*** HOLE CARDS ***
Dealt to matiko09 [9h 9c]
Kukuryzka: raises $2 to $3
tipner: folds 
nickreason17: folds 
Rafaello18: folds 
ruslik_by: calls $3
Starw!nd: folds 
chenconhaste: folds 
robbiescrim9: calls $2.50
matiko09: calls $2
*** FLOP *** [Tc 2d 8h]
robbiescrim9: checks 
matiko09: checks 
Kukuryzka: checks 
ruslik_by: bets $5.70
robbiescrim9: calls $5.70
matiko09: folds 
Kukuryzka: folds 
*** TURN *** [Tc 2d 8h] [3c]
robbiescrim9: checks 
ruslik_by: bets $18.89
robbiescrim9: folds 
Uncalled bet ($18.89) returned to ruslik_by
ruslik_by collected $22.23 from pot
ruslik_by: doesn't show hand 
*** SUMMARY ***
Total pot $23.40 | Rake $1.17 
Board [Tc 2d 8h 3c]
Seat 1: chenconhaste (button) folded before Flop (didn't bet)
Seat 2: robbiescrim9 (small blind) folded on the Turn
Seat 3: matiko09 (big blind) folded on the Flop
Seat 4: Kukuryzka folded on the Flop
Seat 5: tipner folded before Flop (didn't bet)
Seat 6: nickreason17 folded before Flop (didn't bet)
Seat 7: Rafaello18 folded before Flop (didn't bet)
Seat 8: ruslik_by collected ($22.23)
Seat 9: Starw!nd folded before Flop (didn't bet)





PokerStars Hand #155381172115:  Hold'em No Limit (€0.25/€0.50 EUR) - 2016/06/30 14:32:21 CET [2016/06/30 8:32:21 ET]
Table 'Vibeke II' 9-max Seat #8 is the button
Seat 4: acelacat111 (€27 in chips) 
Seat 5: mazefaka007 (€66.65 in chips) 
Seat 6: Kukuryzka (€51.05 in chips) 
Seat 7: matiko09 (€68.17 in chips) 
Seat 8: KABAL_ua (€50 in chips) 
acelacat111: posts small blind €0.25
mazefaka007: posts big blind €0.50
*** HOLE CARDS ***
Dealt to matiko09 [Kh Td]
Kukuryzka: folds 
matiko09: raises €0.75 to €1.25
KABAL_ua: folds 
acelacat111: raises €2.25 to €3.50
mazefaka007: folds 
matiko09: folds 
Uncalled bet (€2.25) returned to acelacat111
acelacat111 collected €3 from pot
acelacat111: doesn't show hand 
*** SUMMARY ***
Total pot €3 | Rake €0 
Seat 4: acelacat111 (small blind) collected (€3)
Seat 5: mazefaka007 (big blind) folded before Flop
Seat 6: Kukuryzka folded before Flop (didn't bet)
Seat 7: matiko09 folded before Flop
Seat 8: KABAL_ua (button) folded before Flop (didn't bet)





PokerStars Hand #155381172698:  Hold'em No Limit ($0.25/$0.50 USD) - 2016/06/30 14:32:22 CET [2016/06/30 8:32:22 ET]
Table 'Arcturus' 9-max Seat #2 is the button
Seat 1: kourk250 ($141.84 in chips) 
Seat 2: Rafaello18 ($50 in chips) 
Seat 3: matiko09 ($53.51 in chips) 
Seat 5: stockbridge8 ($47.75 in chips) 
Seat 6: statistik85 ($64.41 in chips) 
Seat 7: bratbugor ($52.76 in chips) 
Seat 8: TheMinion ($50 in chips) 
matiko09: posts small blind $0.25
stockbridge8: posts big blind $0.50
joker180785: sits out 
*** HOLE CARDS ***
Dealt to matiko09 [9d 2h]
statistik85: folds 
bratbugor: folds 
TheMinion: raises $0.75 to $1.25
kourk250: folds 
Rafaello18: folds 
matiko09: folds 
stockbridge8: folds 
Uncalled bet ($0.75) returned to TheMinion
TheMinion collected $1.25 from pot
TheMinion: doesn't show hand 
*** SUMMARY ***
Total pot $1.25 | Rake $0 
Seat 1: kourk250 folded before Flop (didn't bet)
Seat 2: Rafaello18 (button) folded before Flop (didn't bet)
Seat 3: matiko09 (small blind) folded before Flop
Seat 5: stockbridge8 (big blind) folded before Flop
Seat 6: statistik85 folded before Flop (didn't bet)
Seat 7: bratbugor folded before Flop (didn't bet)
Seat 8: TheMinion collected ($1.25)





PokerStars Hand #155381173194:  Hold'em No Limit ($0.50/$1.00 USD) - 2016/06/30 14:32:23 CET [2016/06/30 8:32:23 ET]
Table 'Asmodeus' 9-max Seat #5 is the button
Seat 2: nickreason17 ($101.50 in chips) 
Seat 3: matiko09 ($111.47 in chips) 
Seat 4: Ty Nick 420 ($107.28 in chips) 
Seat 5: sanr23 ($110.30 in chips) 
Seat 6: koutani7 ($81.03 in chips) 
Seat 7: aaronzzr ($136.01 in chips) 
Seat 8: Rafaello18 ($175.57 in chips) 
Seat 9: mbk88 ($159.76 in chips) 
koutani7: posts small blind $0.50
aaronzzr: posts big blind $1
*** HOLE CARDS ***
Dealt to matiko09 [Js Qc]
Rafaello18: folds 
mbk88: folds 
nickreason17: folds 
matiko09: raises $2 to $3
Ty Nick 420: folds 
sanr23: folds 
koutani7: folds 
aaronzzr: calls $2
*** FLOP *** [Qs Jd 9d]
aaronzzr: checks 
matiko09: bets $4.02
aaronzzr: calls $4.02
*** TURN *** [Qs Jd 9d] [2d]
aaronzzr: checks 
matiko09: bets $10
aaronzzr: raises $10 to $20
matiko09: folds 
Uncalled bet ($10) returned to aaronzzr
aaronzzr collected $32.81 from pot
aaronzzr: doesn't show hand 
*** SUMMARY ***
Total pot $34.54 | Rake $1.73 
Board [Qs Jd 9d 2d]
Seat 2: nickreason17 folded before Flop (didn't bet)
Seat 3: matiko09 folded on the Turn
Seat 4: Ty Nick 420 folded before Flop (didn't bet)
Seat 5: sanr23 (button) folded before Flop (didn't bet)
Seat 6: koutani7 (small blind) folded before Flop
Seat 7: aaronzzr (big blind) collected ($32.81)
Seat 8: Rafaello18 folded before Flop (didn't bet)
Seat 9: mbk88 folded before Flop (didn't bet)





PokerStars Hand #155381176223:  Hold'em No Limit ($0.50/$1.00 USD) - 2016/06/30 14:32:29 CET [2016/06/30 8:32:29 ET]
Table 'Altarf II' 9-max Seat #6 is the button
Seat 1: Rafaello18 ($100 in chips) 
Seat 2: KovIFish89 ($126.95 in chips) 
Seat 3: sanr23 ($166.71 in chips) 
Seat 4: Greha999 ($148.38 in chips) 
Seat 6: mbk88 ($100 in chips) 
Seat 7: matiko09 ($105.22 in chips) 
Seat 8: DomiVY ($40.62 in chips) 
Seat 9: omanibemihum ($159.42 in chips) 
matiko09: posts small blind $0.50
DomiVY: posts big blind $1
*** HOLE CARDS ***
Dealt to matiko09 [9c Jd]
omanibemihum: folds 
Rafaello18: raises $1.50 to $2.50
KovIFish89: folds 
sanr23: folds 
Greha999: folds 
mbk88: folds 
matiko09: folds 
DomiVY: folds 
Uncalled bet ($1.50) returned to Rafaello18
Rafaello18 collected $2.50 from pot
Rafaello18: doesn't show hand 
*** SUMMARY ***
Total pot $2.50 | Rake $0 
Seat 1: Rafaello18 collected ($2.50)
Seat 2: KovIFish89 folded before Flop (didn't bet)
Seat 3: sanr23 folded before Flop (didn't bet)
Seat 4: Greha999 folded before Flop (didn't bet)
Seat 6: mbk88 (button) folded before Flop (didn't bet)
Seat 7: matiko09 (small blind) folded before Flop
Seat 8: DomiVY (big blind) folded before Flop
Seat 9: omanibemihum folded before Flop (didn't bet)





PokerStars Hand #155381179625:  Hold'em No Limit ($0.50/$1.00 USD) - 2016/06/30 14:32:37 CET [2016/06/30 8:32:37 ET]
Table 'California II' 9-max Seat #7 is the button
Seat 1: Rafaello18 ($100 in chips) 
Seat 2: ruslik_by ($140.91 in chips) 
Seat 3: KovIFish89 ($107.28 in chips) 
Seat 4: f1reworks ($100 in chips) 
Seat 5: Rohitbarve ($108.77 in chips) 
Seat 6: matiko09 ($131.48 in chips) 
Seat 7: DomiVY ($89.88 in chips) 
Seat 8: chenconhaste ($100 in chips) 
Seat 9: di0d80 ($104.87 in chips) 
chenconhaste: posts small blind $0.50
di0d80: posts big blind $1
*** HOLE CARDS ***
Dealt to matiko09 [2s Jd]
Rafaello18: folds 
ruslik_by: folds 
KovIFish89: folds 
f1reworks: folds 
Rohitbarve: raises $2 to $3
matiko09: folds 
DomiVY: folds 
chenconhaste: folds 
di0d80: folds 
Uncalled bet ($2) returned to Rohitbarve
Rohitbarve collected $2.50 from pot
Rohitbarve: doesn't show hand 
*** SUMMARY ***
Total pot $2.50 | Rake $0 
Seat 1: Rafaello18 folded before Flop (didn't bet)
Seat 2: ruslik_by folded before Flop (didn't bet)
Seat 3: KovIFish89 folded before Flop (didn't bet)
Seat 4: f1reworks folded before Flop (didn't bet)
Seat 5: Rohitbarve collected ($2.50)
Seat 6: matiko09 folded before Flop (didn't bet)
Seat 7: DomiVY (button) folded before Flop (didn't bet)
Seat 8: chenconhaste (small blind) folded before Flop
Seat 9: di0d80 (big blind) folded before Flop





PokerStars Hand #155381179700:  Hold'em No Limit (€0.25/€0.50 EUR) - 2016/06/30 14:32:37 CET [2016/06/30 8:32:37 ET]
Table 'Vibeke II' 9-max Seat #4 is the button
Seat 4: acelacat111 (€28.75 in chips) 
Seat 5: mazefaka007 (€66.15 in chips) 
Seat 6: Kukuryzka (€51.05 in chips) 
Seat 7: matiko09 (€66.92 in chips) 
Seat 8: KABAL_ua (€50 in chips) 
mazefaka007: posts small blind €0.25
Kukuryzka: posts big blind €0.50
*** HOLE CARDS ***
Dealt to matiko09 [5c Qc]
matiko09: folds 
KABAL_ua: folds 
acelacat111: folds 
mazefaka007: folds 
Uncalled bet (€0.25) returned to Kukuryzka
Kukuryzka collected €0.50 from pot
Kukuryzka: doesn't show hand 
*** SUMMARY ***
Total pot €0.50 | Rake €0 
Seat 4: acelacat111 (button) folded before Flop (didn't bet)
Seat 5: mazefaka007 (small blind) folded before Flop
Seat 6: Kukuryzka (big blind) collected (€0.50)
Seat 7: matiko09 folded before Flop (didn't bet)
Seat 8: KABAL_ua folded before Flop (didn't bet)





PokerStars Hand #155381180517:  Hold'em No Limit ($0.50/$1.00 USD) - 2016/06/30 14:32:38 CET [2016/06/30 8:32:38 ET]
Table 'Borrelly II' 9-max Seat #2 is the button
Seat 1: Rafaello18 ($120.09 in chips) 
Seat 2: mbk88 ($103.64 in chips) 
Seat 4: DonRon_AT ($53.88 in chips) 
Seat 5: Ty Nick 420 ($100 in chips) 
Seat 6: m_michalec ($173.92 in chips) 
Seat 7: matiko09 ($175.86 in chips) 
Seat 8: Arjun A Raju ($132.42 in chips) 
Seat 9: ruslik_by ($111.42 in chips) 
DonRon_AT: posts small blind $0.50
Ty Nick 420: posts big blind $1
*** HOLE CARDS ***
Dealt to matiko09 [Js 9s]
m_michalec: folds 
matiko09: folds 
Arjun A Raju: folds 
ruslik_by: folds 
Rafaello18: folds 
mbk88: raises $1.02 to $2.02
DonRon_AT: folds 
Ty Nick 420: calls $1.02
*** FLOP *** [Ac 9d 2s]
Ty Nick 420: checks 
mbk88: bets $3
Ty Nick 420: calls $3
*** TURN *** [Ac 9d 2s] [8c]
Ty Nick 420: checks 
mbk88: bets $10
Ty Nick 420: folds 
Uncalled bet ($10) returned to mbk88
mbk88 collected $10.01 from pot
mbk88: doesn't show hand 
*** SUMMARY ***
Total pot $10.54 | Rake $0.53 
Board [Ac 9d 2s 8c]
Seat 1: Rafaello18 folded before Flop (didn't bet)
Seat 2: mbk88 (button) collected ($10.01)
Seat 4: DonRon_AT (small blind) folded before Flop
Seat 5: Ty Nick 420 (big blind) folded on the Turn
Seat 6: m_michalec folded before Flop (didn't bet)
Seat 7: matiko09 folded before Flop (didn't bet)
Seat 8: Arjun A Raju folded before Flop (didn't bet)
Seat 9: ruslik_by folded before Flop (didn't bet)





PokerStars Hand #155381181599:  Hold'em No Limit ($0.25/$0.50 USD) - 2016/06/30 14:32:41 CET [2016/06/30 8:32:41 ET]
Table 'Chort III' 9-max Seat #1 is the button
Seat 1: BladeChen ($44.78 in chips) 
Seat 6: Franky77200 ($44.65 in chips) 
Seat 7: matiko09 ($50 in chips) 
Franky77200: posts small blind $0.25
matiko09: posts big blind $0.50
Kukuryzka: sits out 
BladeChen: posts the ante $0.10
Franky77200: posts the ante $0.10
matiko09: posts the ante $0.10
*** HOLE CARDS ***
Dealt to matiko09 [6d 8h]
BladeChen: raises $1 to $1.50
Franky77200: calls $1.25
matiko09: folds 
*** FLOP *** [8s Qh Ad]
Franky77200: checks 
BladeChen: bets $2.50
Franky77200: calls $2.50
*** TURN *** [8s Qh Ad] [7c]
Franky77200: checks 
r4mz3s joins the table at seat #9 
BladeChen: checks 
*** RIVER *** [8s Qh Ad 7c] [7h]
Franky77200: bets $6
BladeChen: calls $6
*** SHOW DOWN ***
Franky77200: shows [Jh 9h] (a pair of Sevens)
BladeChen: shows [Qs Js] (two pair, Queens and Sevens)
BladeChen collected $20.05 from pot
*** SUMMARY ***
Total pot $20.80 | Rake $0.75 
Board [8s Qh Ad 7c 7h]
Seat 1: BladeChen (button) showed [Qs Js] and won ($20.05) with two pair, Queens and Sevens
Seat 6: Franky77200 (small blind) showed [Jh 9h] and lost with a pair of Sevens
Seat 7: matiko09 (big blind) folded before Flop





PokerStars Hand #155381183108:  Hold'em No Limit ($0.50/$1.00 USD) - 2016/06/30 14:32:44 CET [2016/06/30 8:32:44 ET]
Table 'Sigrid' 9-max Seat #2 is the button
Seat 1: Greha999 ($55.58 in chips) 
Seat 2: matiko09 ($105.16 in chips) 
Seat 3: Rafaello18 ($108.35 in chips) 
Seat 4: mbk88 ($105.55 in chips) 
Seat 5: chenconhaste ($103 in chips) 
Seat 7: arctur17 ($125.44 in chips) 
Seat 8: ruslik_by ($104.12 in chips) 
Seat 9: KovIFish89 ($100.58 in chips) 
Rafaello18: posts small blind $0.50
mbk88: posts big blind $1
*** HOLE CARDS ***
Dealt to matiko09 [3s Qc]
chenconhaste: folds 
arctur17: folds 
ruslik_by: folds 
KovIFish89: folds 
Greha999: folds 
matiko09: folds 
Rafaello18: folds 
Uncalled bet ($0.50) returned to mbk88
mbk88 collected $1 from pot
mbk88: doesn't show hand 
*** SUMMARY ***
Total pot $1 | Rake $0 
Seat 1: Greha999 folded before Flop (didn't bet)
Seat 2: matiko09 (button) folded before Flop (didn't bet)
Seat 3: Rafaello18 (small blind) folded before Flop
Seat 4: mbk88 (big blind) collected ($1)
Seat 5: chenconhaste folded before Flop (didn't bet)
Seat 7: arctur17 folded before Flop (didn't bet)
Seat 8: ruslik_by folded before Flop (didn't bet)
Seat 9: KovIFish89 folded before Flop (didn't bet)





PokerStars Hand #155381188201:  Hold'em No Limit ($0.50/$1.00 USD) - 2016/06/30 14:32:55 CET [2016/06/30 8:32:55 ET]
Table 'Tatjana' 9-max Seat #4 is the button
Seat 1: tipner ($100 in chips) 
Seat 3: Rafaello18 ($100 in chips) 
Seat 4: mopatron25 ($106.01 in chips) 
Seat 5: matiko09 ($114.14 in chips) 
Seat 6: mbk88 ($161.04 in chips) 
Seat 8: alhill86 ($107.06 in chips) 
Seat 9: POTAPENKO700 ($218.93 in chips) 
matiko09: posts small blind $0.50
mbk88: posts big blind $1
Kukuryzka: sits out 
*** HOLE CARDS ***
Dealt to matiko09 [Kc 3s]
alhill86: folds 
POTAPENKO700: folds 
tipner: folds 
Rafaello18: raises $1.50 to $2.50
mopatron25: calls $2.50
matiko09: folds 
mbk88: folds 
*** FLOP *** [Qc As 9s]
Rafaello18: checks 
mopatron25: checks 
*** TURN *** [Qc As 9s] [2s]
Rafaello18: checks 
mopatron25: bets $3
Rafaello18: folds 
Uncalled bet ($3) returned to mopatron25
mopatron25 collected $6.18 from pot
mopatron25: doesn't show hand 
*** SUMMARY ***
Total pot $6.50 | Rake $0.32 
Board [Qc As 9s 2s]
Seat 1: tipner folded before Flop (didn't bet)
Seat 3: Rafaello18 folded on the Turn
Seat 4: mopatron25 (button) collected ($6.18)
Seat 5: matiko09 (small blind) folded before Flop
Seat 6: mbk88 (big blind) folded before Flop
Seat 8: alhill86 folded before Flop (didn't bet)
Seat 9: POTAPENKO700 folded before Flop (didn't bet)





PokerStars Hand #155381188288:  Hold'em No Limit (€0.25/€0.50 EUR) - 2016/06/30 14:32:55 CET [2016/06/30 8:32:55 ET]
Table 'Vibeke II' 9-max Seat #5 is the button
Seat 4: acelacat111 (€28.75 in chips) 
Seat 5: mazefaka007 (€65.90 in chips) 
Seat 6: Kukuryzka (€51.30 in chips) 
Seat 7: matiko09 (€66.92 in chips) 
Seat 8: KABAL_ua (€50 in chips) 
Kukuryzka: posts small blind €0.25
matiko09: posts big blind €0.50
*** HOLE CARDS ***
Dealt to matiko09 [Jh 8s]
KABAL_ua: raises €1 to €1.50
acelacat111: calls €1.50
mazefaka007: folds 
Kukuryzka: folds 
matiko09: folds 
*** FLOP *** [Td Jd 7s]
KABAL_ua: checks 
acelacat111: bets €2.23
KABAL_ua: folds 
Uncalled bet (€2.23) returned to acelacat111
acelacat111 collected €3.56 from pot
acelacat111: doesn't show hand 
*** SUMMARY ***
Total pot €3.75 | Rake €0.19 
Board [Td Jd 7s]
Seat 4: acelacat111 collected (€3.56)
Seat 5: mazefaka007 (button) folded before Flop (didn't bet)
Seat 6: Kukuryzka (small blind) folded before Flop
Seat 7: matiko09 (big blind) folded before Flop
Seat 8: KABAL_ua folded on the Flop





PokerStars Hand #155381190656:  Hold'em No Limit ($0.50/$1.00 USD) - 2016/06/30 14:33:00 CET [2016/06/30 8:33:00 ET]
Table 'Altarf II' 9-max Seat #7 is the button
Seat 1: Rafaello18 ($101.50 in chips) 
Seat 2: KovIFish89 ($126.95 in chips) 
Seat 3: sanr23 ($166.71 in chips) 
Seat 4: Greha999 ($148.38 in chips) 
Seat 6: mbk88 ($100 in chips) 
Seat 7: matiko09 ($104.72 in chips) 
Seat 8: DomiVY ($40 in chips) 
Seat 9: omanibemihum ($159.42 in chips) 
DomiVY: posts small blind $0.50
omanibemihum: posts big blind $1
*** HOLE CARDS ***
Dealt to matiko09 [9h Td]
Rafaello18: folds 
KovIFish89: folds 
sanr23: folds 
Greha999: folds 
mbk88: folds 
matiko09: raises $1.27 to $2.27
DomiVY: folds 
omanibemihum: folds 
Uncalled bet ($1.27) returned to matiko09
matiko09 collected $2.50 from pot
matiko09: doesn't show hand 
*** SUMMARY ***
Total pot $2.50 | Rake $0 
Seat 1: Rafaello18 folded before Flop (didn't bet)
Seat 2: KovIFish89 folded before Flop (didn't bet)
Seat 3: sanr23 folded before Flop (didn't bet)
Seat 4: Greha999 folded before Flop (didn't bet)
Seat 6: mbk88 folded before Flop (didn't bet)
Seat 7: matiko09 (button) collected ($2.50)
Seat 8: DomiVY (small blind) folded before Flop
Seat 9: omanibemihum (big blind) folded before Flop





PokerStars Hand #155381192266:  Hold'em No Limit ($0.25/$0.50 USD) - 2016/06/30 14:33:03 CET [2016/06/30 8:33:03 ET]
Table 'Arcturus' 9-max Seat #3 is the button
Seat 1: kourk250 ($141.84 in chips) 
Seat 2: Rafaello18 ($50 in chips) 
Seat 3: matiko09 ($53.26 in chips) 
Seat 5: stockbridge8 ($47.25 in chips) 
Seat 6: statistik85 ($64.41 in chips) 
Seat 7: bratbugor ($52.76 in chips) 
Seat 8: TheMinion ($50.75 in chips) 
stockbridge8: posts small blind $0.25
statistik85: posts big blind $0.50
joker180785: sits out 
*** HOLE CARDS ***
Dealt to matiko09 [Qs As]
bratbugor: folds 
TheMinion: folds 
kourk250: folds 
Rafaello18: raises $0.75 to $1.25
matiko09: raises $2.75 to $4
stockbridge8: folds 
statistik85: folds 
Rafaello18: folds 
Uncalled bet ($2.75) returned to matiko09
matiko09 collected $3.25 from pot
matiko09: doesn't show hand 
*** SUMMARY ***
Total pot $3.25 | Rake $0 
Seat 1: kourk250 folded before Flop (didn't bet)
Seat 2: Rafaello18 folded before Flop
Seat 3: matiko09 (button) collected ($3.25)
Seat 5: stockbridge8 (small blind) folded before Flop
Seat 6: statistik85 (big blind) folded before Flop
Seat 7: bratbugor folded before Flop (didn't bet)
Seat 8: TheMinion folded before Flop (didn't bet)





PokerStars Hand #155381200288:  Hold'em No Limit ($0.50/$1.00 USD) - 2016/06/30 14:33:20 CET [2016/06/30 8:33:20 ET]
Table 'Sigrid' 9-max Seat #3 is the button
Seat 1: Greha999 ($55.58 in chips) 
Seat 2: matiko09 ($105.16 in chips) 
Seat 3: Rafaello18 ($107.85 in chips) 
Seat 4: mbk88 ($106.05 in chips) 
Seat 5: chenconhaste ($103 in chips) 
Seat 7: arctur17 ($125.44 in chips) 
Seat 8: ruslik_by ($104.12 in chips) 
Seat 9: KovIFish89 ($100.58 in chips) 
mbk88: posts small blind $0.50
chenconhaste: posts big blind $1
*** HOLE CARDS ***
Dealt to matiko09 [2s 9d]
arctur17: folds 
ruslik_by: folds 
KovIFish89: folds 
Greha999: raises $2 to $3
matiko09: folds 
Rafaello18: folds 
mbk88: folds 
chenconhaste: folds 
Uncalled bet ($2) returned to Greha999
Greha999 collected $2.50 from pot
*** SUMMARY ***
Total pot $2.50 | Rake $0 
Seat 1: Greha999 collected ($2.50)
Seat 2: matiko09 folded before Flop (didn't bet)
Seat 3: Rafaello18 (button) folded before Flop (didn't bet)
Seat 4: mbk88 (small blind) folded before Flop
Seat 5: chenconhaste (big blind) folded before Flop
Seat 7: arctur17 folded before Flop (didn't bet)
Seat 8: ruslik_by folded before Flop (didn't bet)
Seat 9: KovIFish89 folded before Flop (didn't bet)





PokerStars Hand #155381203584:  Hold'em No Limit ($0.50/$1.00 USD) - 2016/06/30 14:33:27 CET [2016/06/30 8:33:27 ET]
Table 'Altarf II' 9-max Seat #8 is the button
Seat 1: Rafaello18 ($101.50 in chips) 
Seat 2: KovIFish89 ($126.95 in chips) 
Seat 3: sanr23 ($166.71 in chips) 
Seat 4: Greha999 ($148.38 in chips) 
Seat 6: mbk88 ($100 in chips) 
Seat 7: matiko09 ($106.22 in chips) 
Seat 8: DomiVY ($40 in chips) 
Seat 9: omanibemihum ($158.42 in chips) 
omanibemihum: posts small blind $0.50
Rafaello18: posts big blind $1
*** HOLE CARDS ***
Dealt to matiko09 [4h Ac]
KovIFish89: folds 
sanr23: folds 
Greha999: folds 
mbk88: folds 
matiko09: folds 
DomiVY: folds 
omanibemihum: calls $0.50
Rafaello18: raises $3 to $4
omanibemihum: folds 
Uncalled bet ($3) returned to Rafaello18
Rafaello18 collected $2 from pot
Rafaello18: doesn't show hand 
*** SUMMARY ***
Total pot $2 | Rake $0 
Seat 1: Rafaello18 (big blind) collected ($2)
Seat 2: KovIFish89 folded before Flop (didn't bet)
Seat 3: sanr23 folded before Flop (didn't bet)
Seat 4: Greha999 folded before Flop (didn't bet)
Seat 6: mbk88 folded before Flop (didn't bet)
Seat 7: matiko09 folded before Flop (didn't bet)
Seat 8: DomiVY (button) folded before Flop (didn't bet)
Seat 9: omanibemihum (small blind) folded before Flop





PokerStars Hand #155381205834:  Hold'em No Limit ($0.25/$0.50 USD) - 2016/06/30 14:33:31 CET [2016/06/30 8:33:31 ET]
Table 'Chort III' 9-max Seat #6 is the button
Seat 1: BladeChen ($54.73 in chips) 
Seat 6: Franky77200 ($34.55 in chips) 
Seat 7: matiko09 ($50 in chips) 
Seat 8: Kukuryzka ($50 in chips) 
matiko09: posts small blind $0.25
Kukuryzka: posts big blind $0.50
r4mz3s: sits out 
BladeChen: posts the ante $0.10
Franky77200: posts the ante $0.10
matiko09: posts the ante $0.10
Kukuryzka: posts the ante $0.10
*** HOLE CARDS ***
Dealt to matiko09 [Ks 3c]
BladeChen: raises $1 to $1.50
Franky77200: calls $1.50
matiko09: folds 
Hit Pit joins the table at seat #5 
Kukuryzka: folds 
*** FLOP *** [3d Qc Ts]
BladeChen: checks 
Franky77200: checks 
*** TURN *** [3d Qc Ts] [4d]
BladeChen: bets $3
Franky77200: calls $3
*** RIVER *** [3d Qc Ts 4d] [6h]
BladeChen: checks 
Franky77200: checks 
*** SHOW DOWN ***
BladeChen: shows [2c 2h] (a pair of Deuces)
Franky77200: mucks hand 
BladeChen collected $9.64 from pot
*** SUMMARY ***
Total pot $10.15 | Rake $0.51 
Board [3d Qc Ts 4d 6h]
Seat 1: BladeChen showed [2c 2h] and won ($9.64) with a pair of Deuces
Seat 6: Franky77200 (button) mucked [Js 9h]
Seat 7: matiko09 (small blind) folded before Flop
Seat 8: Kukuryzka (big blind) folded before Flop





PokerStars Hand #155381216029:  Hold'em No Limit ($0.25/$0.50 USD) - 2016/06/30 14:33:53 CET [2016/06/30 8:33:53 ET]
Table 'Arcturus' 9-max Seat #5 is the button
Seat 1: kourk250 ($141.84 in chips) 
Seat 2: Rafaello18 ($50 in chips) 
Seat 3: matiko09 ($55.26 in chips) 
Seat 5: stockbridge8 ($47 in chips) 
Seat 6: statistik85 ($63.91 in chips) 
Seat 7: bratbugor ($52.76 in chips) 
Seat 8: TheMinion ($50.75 in chips) 
statistik85: posts small blind $0.25
bratbugor: posts big blind $0.50
joker180785: sits out 
*** HOLE CARDS ***
Dealt to matiko09 [9s 8s]
TheMinion: folds 
kourk250: folds 
Rafaello18: folds 
matiko09: raises $1 to $1.50
stockbridge8: folds 
statistik85: folds 
bratbugor: folds 
Uncalled bet ($1) returned to matiko09
matiko09 collected $1.25 from pot
matiko09: doesn't show hand 
*** SUMMARY ***
Total pot $1.25 | Rake $0 
Seat 1: kourk250 folded before Flop (didn't bet)
Seat 2: Rafaello18 folded before Flop (didn't bet)
Seat 3: matiko09 collected ($1.25)
Seat 5: stockbridge8 (button) folded before Flop (didn't bet)
Seat 6: statistik85 (small blind) folded before Flop
Seat 7: bratbugor (big blind) folded before Flop
Seat 8: TheMinion folded before Flop (didn't bet)





PokerStars Hand #155381216552:  Hold'em No Limit ($0.50/$1.00 USD) - 2016/06/30 14:33:54 CET [2016/06/30 8:33:54 ET]
Table 'Tatjana' 9-max Seat #5 is the button
Seat 1: tipner ($100 in chips) 
Seat 3: Rafaello18 ($100 in chips) 
Seat 4: mopatron25 ($109.69 in chips) 
Seat 5: matiko09 ($113.64 in chips) 
Seat 6: mbk88 ($160.04 in chips) 
Seat 8: alhill86 ($107.06 in chips) 
Seat 9: POTAPENKO700 ($218.93 in chips) 
mbk88: posts small blind $0.50
alhill86: posts big blind $1
Kukuryzka: sits out 
*** HOLE CARDS ***
Dealt to matiko09 [3c 9h]
POTAPENKO700: folds 
tipner: folds 
POTAPENKO700 leaves the table
Rafaello18: raises $1.50 to $2.50
Ty Nick 420 joins the table at seat #9 
mopatron25: calls $2.50
matiko09: folds 
mbk88: folds 
alhill86: calls $1.50
*** FLOP *** [Qc 7d 4s]
alhill86: checks 
Rafaello18: checks 
mopatron25: checks 
*** TURN *** [Qc 7d 4s] [Qh]
alhill86: checks 
Rafaello18: checks 
mopatron25: bets $3
alhill86: folds 
Rafaello18: folds 
Uncalled bet ($3) returned to mopatron25
mopatron25 collected $7.60 from pot
mopatron25: doesn't show hand 
*** SUMMARY ***
Total pot $8 | Rake $0.40 
Board [Qc 7d 4s Qh]
Seat 1: tipner folded before Flop (didn't bet)
Seat 3: Rafaello18 folded on the Turn
Seat 4: mopatron25 collected ($7.60)
Seat 5: matiko09 (button) folded before Flop (didn't bet)
Seat 6: mbk88 (small blind) folded before Flop
Seat 8: alhill86 (big blind) folded on the Turn
Seat 9: POTAPENKO700 folded before Flop (didn't bet)





PokerStars Hand #155381217632:  Hold'em No Limit ($0.50/$1.00 USD) - 2016/06/30 14:33:56 CET [2016/06/30 8:33:56 ET]
Table 'California II' 9-max Seat #8 is the button
Seat 1: Rafaello18 ($100 in chips) 
Seat 2: ruslik_by ($140.91 in chips) 
Seat 3: KovIFish89 ($107.28 in chips) 
Seat 4: f1reworks ($100 in chips) 
Seat 5: Rohitbarve ($110.27 in chips) 
Seat 6: matiko09 ($131.48 in chips) 
Seat 7: DomiVY ($89.88 in chips) 
Seat 8: chenconhaste ($100 in chips) 
Seat 9: di0d80 ($103.87 in chips) 
di0d80: posts small blind $0.50
Rafaello18: posts big blind $1
*** HOLE CARDS ***
Dealt to matiko09 [Qc 7h]
ruslik_by: folds 
KovIFish89: folds 
f1reworks: folds 
Rohitbarve: folds 
matiko09: folds 
DomiVY: folds 
chenconhaste: raises $1.25 to $2.25
di0d80: folds 
Rafaello18: calls $1.25
*** FLOP *** [4c Ad 4d]
Rafaello18: checks 
chenconhaste: bets $2
Rafaello18: folds 
Uncalled bet ($2) returned to chenconhaste
chenconhaste collected $4.75 from pot
*** SUMMARY ***
Total pot $5 | Rake $0.25 
Board [4c Ad 4d]
Seat 1: Rafaello18 (big blind) folded on the Flop
Seat 2: ruslik_by folded before Flop (didn't bet)
Seat 3: KovIFish89 folded before Flop (didn't bet)
Seat 4: f1reworks folded before Flop (didn't bet)
Seat 5: Rohitbarve folded before Flop (didn't bet)
Seat 6: matiko09 folded before Flop (didn't bet)
Seat 7: DomiVY folded before Flop (didn't bet)
Seat 8: chenconhaste (button) collected ($4.75)
Seat 9: di0d80 (small blind) folded before Flop





PokerStars Hand #155381221018:  Hold'em No Limit (€0.25/€0.50 EUR) - 2016/06/30 14:34:03 CET [2016/06/30 8:34:03 ET]
Table 'Vibeke II' 9-max Seat #6 is the button
Seat 4: acelacat111 (€30.81 in chips) 
Seat 5: mazefaka007 (€65.90 in chips) 
Seat 6: Kukuryzka (€51.05 in chips) 
Seat 7: matiko09 (€66.42 in chips) 
Seat 8: KABAL_ua (€50 in chips) 
matiko09: posts small blind €0.25
KABAL_ua: posts big blind €0.50
*** HOLE CARDS ***
Dealt to matiko09 [5c Kc]
acelacat111: folds 
mazefaka007: folds 
Kukuryzka: raises €0.50 to €1
matiko09: folds 
KABAL_ua: folds 
Uncalled bet (€0.50) returned to Kukuryzka
Kukuryzka collected €1.25 from pot
Kukuryzka: doesn't show hand 
*** SUMMARY ***
Total pot €1.25 | Rake €0 
Seat 4: acelacat111 folded before Flop (didn't bet)
Seat 5: mazefaka007 folded before Flop (didn't bet)
Seat 6: Kukuryzka (button) collected (€1.25)
Seat 7: matiko09 (small blind) folded before Flop
Seat 8: KABAL_ua (big blind) folded before Flop





PokerStars Hand #155381221530:  Hold'em No Limit ($0.50/$1.00 USD) - 2016/06/30 14:34:04 CET [2016/06/30 8:34:04 ET]
Table 'Asmodeus' 9-max Seat #6 is the button
Seat 2: nickreason17 ($101.50 in chips) 
Seat 3: matiko09 ($100 in chips) 
Seat 4: Ty Nick 420 ($107.28 in chips) 
Seat 5: sanr23 ($110.30 in chips) 
Seat 6: koutani7 ($80.53 in chips) 
Seat 7: aaronzzr ($151.80 in chips) 
Seat 8: Rafaello18 ($175.57 in chips) 
Seat 9: mbk88 ($159.76 in chips) 
aaronzzr: posts small blind $0.50
Rafaello18: posts big blind $1
*** HOLE CARDS ***
Dealt to matiko09 [2h Jd]
mbk88: folds 
nickreason17: folds 
matiko09: folds 
Ty Nick 420: folds 
sanr23: folds 
koutani7: folds 
aaronzzr: raises $1 to $2
Rafaello18: calls $1
*** FLOP *** [Kd 9d 5d]
aaronzzr: checks 
Rafaello18: checks 
*** TURN *** [Kd 9d 5d] [Js]
aaronzzr: checks 
Rafaello18: checks 
*** RIVER *** [Kd 9d 5d Js] [Td]
aaronzzr: checks 
Rafaello18: checks 
*** SHOW DOWN ***
aaronzzr: shows [Qc 8c] (a straight, Nine to King)
Rafaello18: shows [3d Ah] (a flush, King high)
Rafaello18 collected $3.80 from pot
*** SUMMARY ***
Total pot $4 | Rake $0.20 
Board [Kd 9d 5d Js Td]
Seat 2: nickreason17 folded before Flop (didn't bet)
Seat 3: matiko09 folded before Flop (didn't bet)
Seat 4: Ty Nick 420 folded before Flop (didn't bet)
Seat 5: sanr23 folded before Flop (didn't bet)
Seat 6: koutani7 (button) folded before Flop (didn't bet)
Seat 7: aaronzzr (small blind) showed [Qc 8c] and lost with a straight, Nine to King
Seat 8: Rafaello18 (big blind) showed [3d Ah] and won ($3.80) with a flush, King high
Seat 9: mbk88 folded before Flop (didn't bet)





PokerStars Hand #155381222143:  Hold'em No Limit ($0.50/$1.00 USD) - 2016/06/30 14:34:06 CET [2016/06/30 8:34:06 ET]
Table 'Borrelly II' 9-max Seat #4 is the button
Seat 1: Rafaello18 ($120.09 in chips) 
Seat 2: mbk88 ($108.63 in chips) 
Seat 4: DonRon_AT ($53.38 in chips) 
Seat 5: Ty Nick 420 ($100 in chips) 
Seat 6: m_michalec ($173.92 in chips) 
Seat 7: matiko09 ($175.86 in chips) 
Seat 8: Arjun A Raju ($132.42 in chips) 
Seat 9: ruslik_by ($111.42 in chips) 
Ty Nick 420: posts small blind $0.50
m_michalec: posts big blind $1
*** HOLE CARDS ***
Dealt to matiko09 [9c Ad]
matiko09: folds 
Arjun A Raju: folds 
ruslik_by: folds 
Rafaello18: folds 
mbk88: folds 
DonRon_AT: folds 
Ty Nick 420: raises $2 to $3
m_michalec: folds 
Uncalled bet ($2) returned to Ty Nick 420
Ty Nick 420 collected $2 from pot
*** SUMMARY ***
Total pot $2 | Rake $0 
Seat 1: Rafaello18 folded before Flop (didn't bet)
Seat 2: mbk88 folded before Flop (didn't bet)
Seat 4: DonRon_AT (button) folded before Flop (didn't bet)
Seat 5: Ty Nick 420 (small blind) collected ($2)
Seat 6: m_michalec (big blind) folded before Flop
Seat 7: matiko09 folded before Flop (didn't bet)
Seat 8: Arjun A Raju folded before Flop (didn't bet)
Seat 9: ruslik_by folded before Flop (didn't bet)





PokerStars Hand #155381223869:  Hold'em No Limit ($0.50/$1.00 USD) - 2016/06/30 14:34:09 CET [2016/06/30 8:34:09 ET]
Table 'Sigrid' 9-max Seat #4 is the button
Seat 1: Greha999 ($57.08 in chips) 
Seat 2: matiko09 ($105.16 in chips) 
Seat 3: Rafaello18 ($107.85 in chips) 
Seat 4: mbk88 ($105.55 in chips) 
Seat 5: chenconhaste ($102 in chips) 
Seat 7: arctur17 ($125.44 in chips) 
Seat 8: ruslik_by ($104.12 in chips) 
Seat 9: KovIFish89 ($100.58 in chips) 
chenconhaste: posts small blind $0.50
arctur17: posts big blind $1
*** HOLE CARDS ***
Dealt to matiko09 [8h Kd]
ruslik_by: folds 
KovIFish89: folds 
Greha999: folds 
matiko09: folds 
Rafaello18: folds 
mbk88: raises $1.02 to $2.02
chenconhaste: folds 
arctur17: folds 
Uncalled bet ($1.02) returned to mbk88
mbk88 collected $2.50 from pot
mbk88: doesn't show hand 
*** SUMMARY ***
Total pot $2.50 | Rake $0 
Seat 1: Greha999 folded before Flop (didn't bet)
Seat 2: matiko09 folded before Flop (didn't bet)
Seat 3: Rafaello18 folded before Flop (didn't bet)
Seat 4: mbk88 (button) collected ($2.50)
Seat 5: chenconhaste (small blind) folded before Flop
Seat 7: arctur17 (big blind) folded before Flop
Seat 8: ruslik_by folded before Flop (didn't bet)
Seat 9: KovIFish89 folded before Flop (didn't bet)





PokerStars Hand #155381228820:  Hold'em No Limit ($0.25/$0.50 USD) - 2016/06/30 14:34:20 CET [2016/06/30 8:34:20 ET]
Table 'Chort III' 9-max Seat #7 is the button
Seat 1: BladeChen ($59.77 in chips) 
Seat 5: Hit Pit ($40 in chips) 
Seat 6: Franky77200 ($29.95 in chips) 
Seat 7: matiko09 ($50 in chips) 
Seat 8: Kukuryzka ($50 in chips) 
Seat 9: r4mz3s ($50 in chips) 
Kukuryzka: posts small blind $0.25
r4mz3s: posts big blind $0.50
Hit Pit: posts big blind $0.50
BladeChen: posts the ante $0.10
Hit Pit: posts the ante $0.10
Franky77200: posts the ante $0.10
matiko09: posts the ante $0.10
Kukuryzka: posts the ante $0.10
r4mz3s: posts the ante $0.10
*** HOLE CARDS ***
Dealt to matiko09 [Ah 7s]
BladeChen: raises $1.50 to $2
Hit Pit: calls $1.50
Franky77200: calls $2
matiko09: folds 
Kukuryzka: folds 
r4mz3s: folds 
*** FLOP *** [8c Ks 8d]
BladeChen: checks 
Hit Pit: bets $2.50
Franky77200: calls $2.50
BladeChen: raises $2.50 to $5
Alexey_Kim2 joins the table at seat #2 
Hit Pit: folds 
Franky77200: folds 
Uncalled bet ($2.50) returned to BladeChen
BladeChen collected $14.11 from pot
BladeChen: doesn't show hand 
*** SUMMARY ***
Total pot $14.85 | Rake $0.74 
Board [8c Ks 8d]
Seat 1: BladeChen collected ($14.11)
Seat 5: Hit Pit folded on the Flop
Seat 6: Franky77200 folded on the Flop
Seat 7: matiko09 (button) folded before Flop (didn't bet)
Seat 8: Kukuryzka (small blind) folded before Flop
Seat 9: r4mz3s (big blind) folded before Flop





PokerStars Hand #155381229440:  Hold'em No Limit ($0.50/$1.00 USD) - 2016/06/30 14:34:21 CET [2016/06/30 8:34:21 ET]
Table 'Altarf II' 9-max Seat #9 is the button
Seat 1: Rafaello18 ($102.50 in chips) 
Seat 2: KovIFish89 ($126.95 in chips) 
Seat 3: sanr23 ($166.71 in chips) 
Seat 4: Greha999 ($148.38 in chips) 
Seat 6: mbk88 ($100 in chips) 
Seat 7: matiko09 ($106.22 in chips) 
Seat 8: DomiVY ($40 in chips) 
Seat 9: omanibemihum ($157.42 in chips) 
Rafaello18: posts small blind $0.50
KovIFish89: posts big blind $1
*** HOLE CARDS ***
Dealt to matiko09 [Qc Ks]
sanr23: folds 
Greha999: folds 
mbk88: raises $2 to $3
matiko09: raises $7 to $10
DomiVY: folds 
omanibemihum: folds 
Rafaello18: folds 
KovIFish89: folds 
mbk88: folds 
Uncalled bet ($7) returned to matiko09
matiko09 collected $7.50 from pot
matiko09: doesn't show hand 
*** SUMMARY ***
Total pot $7.50 | Rake $0 
Seat 1: Rafaello18 (small blind) folded before Flop
Seat 2: KovIFish89 (big blind) folded before Flop
Seat 3: sanr23 folded before Flop (didn't bet)
Seat 4: Greha999 folded before Flop (didn't bet)
Seat 6: mbk88 folded before Flop
Seat 7: matiko09 collected ($7.50)
Seat 8: DomiVY folded before Flop (didn't bet)
Seat 9: omanibemihum (button) folded before Flop (didn't bet)





PokerStars Hand #155381231772:  Hold'em No Limit ($0.50/$1.00 USD) - 2016/06/30 14:34:26 CET [2016/06/30 8:34:26 ET]
Table 'Donnera' 9-max Seat #2 is the button
Seat 1: chenconhaste ($111.56 in chips) 
Seat 2: robbiescrim9 ($104.56 in chips) 
Seat 3: matiko09 ($101.75 in chips) 
Seat 4: Kukuryzka ($100 in chips) 
Seat 5: tipner ($100 in chips) 
Seat 6: nickreason17 ($100 in chips) 
Seat 7: Rafaello18 ($132.30 in chips) 
Seat 8: ruslik_by ($200.98 in chips) 
Seat 9: Starw!nd ($119.25 in chips) 
matiko09: posts small blind $0.50
Kukuryzka: posts big blind $1
*** HOLE CARDS ***
Dealt to matiko09 [8c Qs]
tipner: folds 
nickreason17: folds 
Rafaello18: folds 
ruslik_by: folds 
Starw!nd: folds 
chenconhaste: folds 
robbiescrim9: folds 
matiko09: raises $2 to $3
Kukuryzka: raises $6 to $9
matiko09: folds 
Uncalled bet ($6) returned to Kukuryzka
Kukuryzka collected $6 from pot
Kukuryzka: doesn't show hand 
*** SUMMARY ***
Total pot $6 | Rake $0 
Seat 1: chenconhaste folded before Flop (didn't bet)
Seat 2: robbiescrim9 (button) folded before Flop (didn't bet)
Seat 3: matiko09 (small blind) folded before Flop
Seat 4: Kukuryzka (big blind) collected ($6)
Seat 5: tipner folded before Flop (didn't bet)
Seat 6: nickreason17 folded before Flop (didn't bet)
Seat 7: Rafaello18 folded before Flop (didn't bet)
Seat 8: ruslik_by folded before Flop (didn't bet)
Seat 9: Starw!nd folded before Flop (didn't bet)





PokerStars Hand #155381231804:  Hold'em No Limit (€0.25/€0.50 EUR) - 2016/06/30 14:34:26 CET [2016/06/30 8:34:26 ET]
Table 'Vibeke II' 9-max Seat #7 is the button
Seat 4: acelacat111 (€30.81 in chips) 
Seat 5: mazefaka007 (€65.90 in chips) 
Seat 6: Kukuryzka (€51.80 in chips) 
Seat 7: matiko09 (€66.17 in chips) 
Seat 8: KABAL_ua (€50 in chips) 
KABAL_ua: posts small blind €0.25
acelacat111: posts big blind €0.50
*** HOLE CARDS ***
Dealt to matiko09 [4h Jc]
mazefaka007: folds 
Kukuryzka: raises €0.75 to €1.25
matiko09: folds 
KABAL_ua: calls €1
acelacat111: folds 
*** FLOP *** [Ts 5c Kd]
KABAL_ua: checks 
Kukuryzka: checks 
*** TURN *** [Ts 5c Kd] [4c]
KABAL_ua: bets €1.90
Kukuryzka: calls €1.90
*** RIVER *** [Ts 5c Kd 4c] [7h]
KABAL_ua: checks 
funXmun joins the table at seat #9 
Kukuryzka: checks 
*** SHOW DOWN ***
KABAL_ua: shows [Qd Ah] (high card Ace)
Kukuryzka: shows [Js Jh] (a pair of Jacks)
Kukuryzka collected €6.46 from pot
*** SUMMARY ***
Total pot €6.80 | Rake €0.34 
Board [Ts 5c Kd 4c 7h]
Seat 4: acelacat111 (big blind) folded before Flop
Seat 5: mazefaka007 folded before Flop (didn't bet)
Seat 6: Kukuryzka showed [Js Jh] and won (€6.46) with a pair of Jacks
Seat 7: matiko09 (button) folded before Flop (didn't bet)
Seat 8: KABAL_ua (small blind) showed [Qd Ah] and lost with high card Ace





PokerStars Hand #155381235055:  Hold'em No Limit ($0.50/$1.00 USD) - 2016/06/30 14:34:33 CET [2016/06/30 8:34:33 ET]
Table 'Sigrid' 9-max Seat #5 is the button
Seat 1: Greha999 ($57.08 in chips) 
Seat 2: matiko09 ($105.16 in chips) 
Seat 3: Rafaello18 ($107.85 in chips) 
Seat 4: mbk88 ($107.05 in chips) 
Seat 5: chenconhaste ($101.50 in chips) 
Seat 7: arctur17 ($124.44 in chips) 
Seat 8: ruslik_by ($104.12 in chips) 
Seat 9: KovIFish89 ($100.58 in chips) 
arctur17: posts small blind $0.50
ruslik_by: posts big blind $1
*** HOLE CARDS ***
Dealt to matiko09 [5d Kc]
KovIFish89: folds 
Greha999: folds 
matiko09: folds 
Rafaello18: folds 
mbk88: raises $2 to $3
chenconhaste: folds 
arctur17: folds 
ruslik_by: folds 
Uncalled bet ($2) returned to mbk88
mbk88 collected $2.50 from pot
mbk88: doesn't show hand 
*** SUMMARY ***
Total pot $2.50 | Rake $0 
Seat 1: Greha999 folded before Flop (didn't bet)
Seat 2: matiko09 folded before Flop (didn't bet)
Seat 3: Rafaello18 folded before Flop (didn't bet)
Seat 4: mbk88 collected ($2.50)
Seat 5: chenconhaste (button) folded before Flop (didn't bet)
Seat 7: arctur17 (small blind) folded before Flop
Seat 8: ruslik_by (big blind) folded before Flop
Seat 9: KovIFish89 folded before Flop (didn't bet)





PokerStars Hand #155381236030:  Hold'em No Limit ($0.25/$0.50 USD) - 2016/06/30 14:34:35 CET [2016/06/30 8:34:35 ET]
Table 'Arcturus' 9-max Seat #6 is the button
Seat 1: kourk250 ($141.84 in chips) 
Seat 2: Rafaello18 ($50 in chips) 
Seat 3: matiko09 ($56.01 in chips) 
Seat 5: stockbridge8 ($47 in chips) 
Seat 6: statistik85 ($63.66 in chips) 
Seat 7: bratbugor ($52.26 in chips) 
Seat 8: TheMinion ($50.75 in chips) 
bratbugor: posts small blind $0.25
TheMinion: posts big blind $0.50
joker180785: sits out 
*** HOLE CARDS ***
Dealt to matiko09 [Qh Kh]
kourk250: folds 
Rafaello18: folds 
matiko09: raises $1 to $1.50
stockbridge8: folds 
statistik85: folds 
bratbugor: folds 
TheMinion: folds 
Uncalled bet ($1) returned to matiko09
matiko09 collected $1.25 from pot
matiko09: doesn't show hand 
*** SUMMARY ***
Total pot $1.25 | Rake $0 
Seat 1: kourk250 folded before Flop (didn't bet)
Seat 2: Rafaello18 folded before Flop (didn't bet)
Seat 3: matiko09 collected ($1.25)
Seat 5: stockbridge8 folded before Flop (didn't bet)
Seat 6: statistik85 (button) folded before Flop (didn't bet)
Seat 7: bratbugor (small blind) folded before Flop
Seat 8: TheMinion (big blind) folded before Flop





PokerStars Hand #155381238063:  Hold'em No Limit ($0.50/$1.00 USD) - 2016/06/30 14:34:39 CET [2016/06/30 8:34:39 ET]
Table 'California II' 9-max Seat #9 is the button
Seat 1: Rafaello18 ($100 in chips) 
Seat 2: ruslik_by ($140.91 in chips) 
Seat 3: KovIFish89 ($107.28 in chips) 
Seat 4: f1reworks ($100 in chips) 
Seat 5: Rohitbarve ($110.27 in chips) 
Seat 6: matiko09 ($131.48 in chips) 
Seat 7: DomiVY ($89.88 in chips) 
Seat 8: chenconhaste ($102.50 in chips) 
Seat 9: di0d80 ($103.37 in chips) 
Rafaello18: posts small blind $0.50
ruslik_by: posts big blind $1
*** HOLE CARDS ***
Dealt to matiko09 [5c 7s]
KovIFish89: raises $2 to $3
f1reworks: folds 
Rohitbarve: folds 
matiko09: folds 
DomiVY: folds 
chenconhaste: folds 
di0d80: folds 
Rafaello18: folds 
ruslik_by: calls $2
*** FLOP *** [Td Qh 9c]
ruslik_by: checks 
KovIFish89: checks 
*** TURN *** [Td Qh 9c] [2d]
ruslik_by: bets $5.25
KovIFish89: calls $5.25
*** RIVER *** [Td Qh 9c 2d] [8s]
ruslik_by: bets $5.49
KovIFish89: folds 
Uncalled bet ($5.49) returned to ruslik_by
ruslik_by collected $16.15 from pot
ruslik_by: doesn't show hand 
*** SUMMARY ***
Total pot $17 | Rake $0.85 
Board [Td Qh 9c 2d 8s]
Seat 1: Rafaello18 (small blind) folded before Flop
Seat 2: ruslik_by (big blind) collected ($16.15)
Seat 3: KovIFish89 folded on the River
Seat 4: f1reworks folded before Flop (didn't bet)
Seat 5: Rohitbarve folded before Flop (didn't bet)
Seat 6: matiko09 folded before Flop (didn't bet)
Seat 7: DomiVY folded before Flop (didn't bet)
Seat 8: chenconhaste folded before Flop (didn't bet)
Seat 9: di0d80 (button) folded before Flop (didn't bet)





PokerStars Hand #155381239890:  Hold'em No Limit ($0.25/$0.50 USD) - 2016/06/30 14:34:43 CET [2016/06/30 8:34:43 ET]
Table 'Thalia II' 9-max Seat #7 is the button
Seat 1: matteo080613 ($31.25 in chips) 
Seat 2: DeathcorePkr ($53.05 in chips) 
Seat 3: r4mz3s ($68.61 in chips) 
Seat 4: Kukuryzka ($49.90 in chips) 
Seat 5: geowin ($68.76 in chips) 
Seat 6: chenconhaste ($51.45 in chips) 
Seat 7: fudzi ($62.83 in chips) 
Seat 8: Jo_Medici ($50 in chips) 
Seat 9: matiko09 ($50 in chips) 
Jo_Medici: posts small blind $0.25
matiko09: posts big blind $0.50
matteo080613: posts the ante $0.10
DeathcorePkr: posts the ante $0.10
r4mz3s: posts the ante $0.10
Kukuryzka: posts the ante $0.10
geowin: posts the ante $0.10
chenconhaste: posts the ante $0.10
fudzi: posts the ante $0.10
Jo_Medici: posts the ante $0.10
matiko09: posts the ante $0.10
*** HOLE CARDS ***
Dealt to matiko09 [6s Kh]
matteo080613: folds 
DeathcorePkr: folds 
r4mz3s: folds 
Kukuryzka: folds 
geowin: calls $0.50
chenconhaste: raises $1.50 to $2
fudzi: folds 
Jo_Medici: folds 
matiko09: folds 
geowin: folds 
Uncalled bet ($1.50) returned to chenconhaste
chenconhaste collected $2.65 from pot
*** SUMMARY ***
Total pot $2.65 | Rake $0 
Seat 1: matteo080613 folded before Flop (didn't bet)
Seat 2: DeathcorePkr folded before Flop (didn't bet)
Seat 3: r4mz3s folded before Flop (didn't bet)
Seat 4: Kukuryzka folded before Flop (didn't bet)
Seat 5: geowin folded before Flop
Seat 6: chenconhaste collected ($2.65)
Seat 7: fudzi (button) folded before Flop (didn't bet)
Seat 8: Jo_Medici (small blind) folded before Flop
Seat 9: matiko09 (big blind) folded before Flop





PokerStars Hand #155381240705:  Hold'em No Limit ($0.50/$1.00 USD) - 2016/06/30 14:34:45 CET [2016/06/30 8:34:45 ET]
Table 'Borrelly II' 9-max Seat #5 is the button
Seat 1: Rafaello18 ($120.09 in chips) 
Seat 2: mbk88 ($108.63 in chips) 
Seat 4: DonRon_AT ($53.38 in chips) 
Seat 5: Ty Nick 420 ($101 in chips) 
Seat 6: m_michalec ($172.92 in chips) 
Seat 7: matiko09 ($175.86 in chips) 
Seat 8: Arjun A Raju ($132.42 in chips) 
Seat 9: ruslik_by ($111.42 in chips) 
m_michalec: posts small blind $0.50
matiko09: posts big blind $1
*** HOLE CARDS ***
Dealt to matiko09 [2d 9s]
Arjun A Raju: folds 
ruslik_by: folds 
Rafaello18: folds 
mbk88: folds 
DonRon_AT: folds 
Ty Nick 420: raises $1 to $2
m_michalec: folds 
matiko09: folds 
Uncalled bet ($1) returned to Ty Nick 420
Ty Nick 420 collected $2.50 from pot
*** SUMMARY ***
Total pot $2.50 | Rake $0 
Seat 1: Rafaello18 folded before Flop (didn't bet)
Seat 2: mbk88 folded before Flop (didn't bet)
Seat 4: DonRon_AT folded before Flop (didn't bet)
Seat 5: Ty Nick 420 (button) collected ($2.50)
Seat 6: m_michalec (small blind) folded before Flop
Seat 7: matiko09 (big blind) folded before Flop
Seat 8: Arjun A Raju folded before Flop (didn't bet)
Seat 9: ruslik_by folded before Flop (didn't bet)





PokerStars Hand #155381241432:  Hold'em No Limit ($0.50/$1.00 USD) - 2016/06/30 14:34:46 CET [2016/06/30 8:34:46 ET]
Table 'Altarf II' 9-max Seat #1 is the button
Seat 1: Rafaello18 ($102 in chips) 
Seat 2: KovIFish89 ($125.95 in chips) 
Seat 3: sanr23 ($166.71 in chips) 
Seat 4: Greha999 ($148.38 in chips) 
Seat 6: mbk88 ($100 in chips) 
Seat 7: matiko09 ($110.72 in chips) 
Seat 8: DomiVY ($40 in chips) 
Seat 9: omanibemihum ($157.42 in chips) 
KovIFish89: posts small blind $0.50
sanr23: posts big blind $1
*** HOLE CARDS ***
Dealt to matiko09 [Qs 8c]
Greha999: folds 
mbk88: folds 
matiko09: folds 
DomiVY: folds 
omanibemihum: raises $3 to $4
Rafaello18: folds 
KovIFish89: folds 
sanr23: folds 
Uncalled bet ($3) returned to omanibemihum
omanibemihum collected $2.50 from pot
omanibemihum: doesn't show hand 
*** SUMMARY ***
Total pot $2.50 | Rake $0 
Seat 1: Rafaello18 (button) folded before Flop (didn't bet)
Seat 2: KovIFish89 (small blind) folded before Flop
Seat 3: sanr23 (big blind) folded before Flop
Seat 4: Greha999 folded before Flop (didn't bet)
Seat 6: mbk88 folded before Flop (didn't bet)
Seat 7: matiko09 folded before Flop (didn't bet)
Seat 8: DomiVY folded before Flop (didn't bet)
Seat 9: omanibemihum collected ($2.50)





PokerStars Hand #155381243250:  Hold'em No Limit ($0.25/$0.50 USD) - 2016/06/30 14:34:50 CET [2016/06/30 8:34:50 ET]
Table 'Arcturus' 9-max Seat #7 is the button
Seat 1: kourk250 ($141.84 in chips) 
Seat 2: Rafaello18 ($50 in chips) 
Seat 3: matiko09 ($56.76 in chips) 
Seat 5: stockbridge8 ($47 in chips) 
Seat 6: statistik85 ($63.66 in chips) 
Seat 7: bratbugor ($52.01 in chips) 
Seat 8: TheMinion ($50.25 in chips) 
Seat 9: joker180785 ($50 in chips) 
TheMinion: posts small blind $0.25
joker180785: posts big blind $0.50
*** HOLE CARDS ***
Dealt to matiko09 [5s 2s]
kourk250: raises $1 to $1.50
Rafaello18: folds 
matiko09: folds 
stockbridge8: folds 
statistik85: folds 
bratbugor: folds 
TheMinion: folds 
joker180785: folds 
Uncalled bet ($1) returned to kourk250
kourk250 collected $1.25 from pot
kourk250: doesn't show hand 
*** SUMMARY ***
Total pot $1.25 | Rake $0 
Seat 1: kourk250 collected ($1.25)
Seat 2: Rafaello18 folded before Flop (didn't bet)
Seat 3: matiko09 folded before Flop (didn't bet)
Seat 5: stockbridge8 folded before Flop (didn't bet)
Seat 6: statistik85 folded before Flop (didn't bet)
Seat 7: bratbugor (button) folded before Flop (didn't bet)
Seat 8: TheMinion (small blind) folded before Flop
Seat 9: joker180785 (big blind) folded before Flop





PokerStars Hand #155381243070:  Hold'em No Limit ($0.50/$1.00 USD) - 2016/06/30 14:34:50 CET [2016/06/30 8:34:50 ET]
Table 'Donnera' 9-max Seat #3 is the button
Seat 1: chenconhaste ($111.56 in chips) 
Seat 2: robbiescrim9 ($104.56 in chips) 
Seat 3: matiko09 ($100 in chips) 
Seat 4: Kukuryzka ($103 in chips) 
Seat 5: tipner ($100 in chips) 
Seat 6: nickreason17 ($100 in chips) 
Seat 7: Rafaello18 ($132.30 in chips) 
Seat 8: ruslik_by ($200.98 in chips) 
Seat 9: Starw!nd ($119.25 in chips) 
Kukuryzka: posts small blind $0.50
tipner: posts big blind $1
*** HOLE CARDS ***
Dealt to matiko09 [7c As]
nickreason17: folds 
Rafaello18: folds 
ruslik_by: folds 
Starw!nd: folds 
chenconhaste: raises $1.25 to $2.25
robbiescrim9: folds 
matiko09: folds 
Kukuryzka: folds 
tipner: folds 
Uncalled bet ($1.25) returned to chenconhaste
chenconhaste collected $2.50 from pot
*** SUMMARY ***
Total pot $2.50 | Rake $0 
Seat 1: chenconhaste collected ($2.50)
Seat 2: robbiescrim9 folded before Flop (didn't bet)
Seat 3: matiko09 (button) folded before Flop (didn't bet)
Seat 4: Kukuryzka (small blind) folded before Flop
Seat 5: tipner (big blind) folded before Flop
Seat 6: nickreason17 folded before Flop (didn't bet)
Seat 7: Rafaello18 folded before Flop (didn't bet)
Seat 8: ruslik_by folded before Flop (didn't bet)
Seat 9: Starw!nd folded before Flop (didn't bet)





PokerStars Hand #155381246150:  Hold'em No Limit ($0.50/$1.00 USD) - 2016/06/30 14:34:56 CET [2016/06/30 8:34:56 ET]
Table 'Sigrid' 9-max Seat #7 is the button
Seat 1: Greha999 ($57.08 in chips) 
Seat 2: matiko09 ($105.16 in chips) 
Seat 3: Rafaello18 ($107.85 in chips) 
Seat 4: mbk88 ($108.55 in chips) 
Seat 5: chenconhaste ($101.50 in chips) 
Seat 7: arctur17 ($123.94 in chips) 
Seat 8: ruslik_by ($103.12 in chips) 
Seat 9: KovIFish89 ($100.58 in chips) 
ruslik_by: posts small blind $0.50
KovIFish89: posts big blind $1
*** HOLE CARDS ***
Dealt to matiko09 [7s 6h]
Greha999: folds 
matiko09: folds 
Rafaello18: folds 
mbk88: raises $2 to $3
chenconhaste: folds 
arctur17: raises $7 to $10
ruslik_by: folds 
KovIFish89: folds 
mbk88: folds 
Uncalled bet ($7) returned to arctur17
arctur17 collected $7.50 from pot
arctur17: doesn't show hand 
*** SUMMARY ***
Total pot $7.50 | Rake $0 
Seat 1: Greha999 folded before Flop (didn't bet)
Seat 2: matiko09 folded before Flop (didn't bet)
Seat 3: Rafaello18 folded before Flop (didn't bet)
Seat 4: mbk88 folded before Flop
Seat 5: chenconhaste folded before Flop (didn't bet)
Seat 7: arctur17 (button) collected ($7.50)
Seat 8: ruslik_by (small blind) folded before Flop
Seat 9: KovIFish89 (big blind) folded before Flop





PokerStars Hand #155381249362:  Hold'em No Limit ($0.50/$1.00 USD) - 2016/06/30 14:35:03 CET [2016/06/30 8:35:03 ET]
Table 'Asmodeus' 9-max Seat #7 is the button
Seat 2: nickreason17 ($101.50 in chips) 
Seat 3: matiko09 ($100 in chips) 
Seat 4: Ty Nick 420 ($107.28 in chips) 
Seat 5: sanr23 ($110.30 in chips) 
Seat 6: koutani7 ($80.53 in chips) 
Seat 7: aaronzzr ($149.80 in chips) 
Seat 8: Rafaello18 ($177.37 in chips) 
Seat 9: mbk88 ($159.76 in chips) 
Rafaello18: posts small blind $0.50
mbk88: posts big blind $1
*** HOLE CARDS ***
Dealt to matiko09 [9s As]
nickreason17: folds 
matiko09: folds 
Ty Nick 420: folds 
sanr23: folds 
koutani7: folds 
aaronzzr: raises $1 to $2
Rafaello18: folds 
mbk88: folds 
Uncalled bet ($1) returned to aaronzzr
aaronzzr collected $2.50 from pot
aaronzzr: doesn't show hand 
*** SUMMARY ***
Total pot $2.50 | Rake $0 
Seat 2: nickreason17 folded before Flop (didn't bet)
Seat 3: matiko09 folded before Flop (didn't bet)
Seat 4: Ty Nick 420 folded before Flop (didn't bet)
Seat 5: sanr23 folded before Flop (didn't bet)
Seat 6: koutani7 folded before Flop (didn't bet)
Seat 7: aaronzzr (button) collected ($2.50)
Seat 8: Rafaello18 (small blind) folded before Flop
Seat 9: mbk88 (big blind) folded before Flop





PokerStars Hand #155381250205:  Hold'em No Limit ($0.50/$1.00 USD) - 2016/06/30 14:35:04 CET [2016/06/30 8:35:04 ET]
Table 'Borrelly II' 9-max Seat #6 is the button
Seat 1: Rafaello18 ($120.09 in chips) 
Seat 2: mbk88 ($108.63 in chips) 
Seat 4: DonRon_AT ($53.38 in chips) 
Seat 5: Ty Nick 420 ($102.50 in chips) 
Seat 6: m_michalec ($172.42 in chips) 
Seat 7: matiko09 ($174.86 in chips) 
Seat 8: Arjun A Raju ($132.42 in chips) 
Seat 9: ruslik_by ($111.42 in chips) 
matiko09: posts small blind $0.50
Arjun A Raju: posts big blind $1
*** HOLE CARDS ***
Dealt to matiko09 [4h As]
ruslik_by: folds 
Rafaello18: folds 
mbk88: folds 
DonRon_AT: folds 
Ty Nick 420: folds 
m_michalec: folds 
matiko09: raises $2 to $3
Arjun A Raju: folds 
Uncalled bet ($2) returned to matiko09
matiko09 collected $2 from pot
matiko09: doesn't show hand 
*** SUMMARY ***
Total pot $2 | Rake $0 
Seat 1: Rafaello18 folded before Flop (didn't bet)
Seat 2: mbk88 folded before Flop (didn't bet)
Seat 4: DonRon_AT folded before Flop (didn't bet)
Seat 5: Ty Nick 420 folded before Flop (didn't bet)
Seat 6: m_michalec (button) folded before Flop (didn't bet)
Seat 7: matiko09 (small blind) collected ($2)
Seat 8: Arjun A Raju (big blind) folded before Flop
Seat 9: ruslik_by folded before Flop (didn't bet)





PokerStars Hand #155381259051:  Hold'em No Limit ($0.25/$0.50 USD) - 2016/06/30 14:35:23 CET [2016/06/30 8:35:23 ET]
Table 'Chort III' 9-max Seat #8 is the button
Seat 1: BladeChen ($69.28 in chips) 
Seat 5: Hit Pit ($35.40 in chips) 
Seat 6: Franky77200 ($25.35 in chips) 
Seat 7: matiko09 ($50 in chips) 
Seat 8: Kukuryzka ($49.65 in chips) 
Seat 9: r4mz3s ($50 in chips) 
r4mz3s: posts small blind $0.25
BladeChen: posts big blind $0.50
Alexey_Kim2: sits out 
BladeChen: posts the ante $0.10
Hit Pit: posts the ante $0.10
Franky77200: posts the ante $0.10
matiko09: posts the ante $0.10
Kukuryzka: posts the ante $0.10
r4mz3s: posts the ante $0.10
*** HOLE CARDS ***
Dealt to matiko09 [4s Ks]
Hit Pit: raises $1.50 to $2
Franky77200: calls $2
matiko09: folds 
Kukuryzka: folds 
r4mz3s: folds 
BladeChen: folds 
*** FLOP *** [6d Qd 7c]
Hit Pit: checks 
kotkas1000 joins the table at seat #4 
Franky77200: checks 
*** TURN *** [6d Qd 7c] [6h]
Hit Pit: checks 
Franky77200: checks 
*** RIVER *** [6d Qd 7c 6h] [Qh]
Hit Pit: checks 
Franky77200: checks 
*** SHOW DOWN ***
Hit Pit: shows [Ad Js] (two pair, Queens and Sixes)
Franky77200: shows [Kc Ac] (two pair, Queens and Sixes)
Hit Pit collected $2.54 from pot
Franky77200 collected $2.54 from pot
*** SUMMARY ***
Total pot $5.35 | Rake $0.27 
Board [6d Qd 7c 6h Qh]
Seat 1: BladeChen (big blind) folded before Flop
Seat 5: Hit Pit showed [Ad Js] and won ($2.54) with two pair, Queens and Sixes
Seat 6: Franky77200 showed [Kc Ac] and won ($2.54) with two pair, Queens and Sixes
Seat 7: matiko09 folded before Flop (didn't bet)
Seat 8: Kukuryzka (button) folded before Flop (didn't bet)
Seat 9: r4mz3s (small blind) folded before Flop





PokerStars Hand #155381259525:  Hold'em No Limit ($0.50/$1.00 USD) - 2016/06/30 14:35:24 CET [2016/06/30 8:35:24 ET]
Table 'Donnera' 9-max Seat #4 is the button
Seat 1: chenconhaste ($113.06 in chips) 
Seat 2: robbiescrim9 ($104.56 in chips) 
Seat 3: matiko09 ($100 in chips) 
Seat 4: Kukuryzka ($102.50 in chips) 
Seat 5: tipner ($100 in chips) 
Seat 6: nickreason17 ($100 in chips) 
Seat 7: Rafaello18 ($132.30 in chips) 
Seat 8: ruslik_by ($200.98 in chips) 
Seat 9: Starw!nd ($119.25 in chips) 
tipner: posts small blind $0.50
nickreason17: posts big blind $1
*** HOLE CARDS ***
Dealt to matiko09 [Ah 9h]
Rafaello18: folds 
ruslik_by: folds 
Starw!nd: folds 
chenconhaste: folds 
robbiescrim9: calls $1
matiko09: raises $3 to $4
Kukuryzka: folds 
tipner: calls $3.50
nickreason17: folds 
robbiescrim9: folds 
*** FLOP *** [2d Js 8c]
tipner: checks 
matiko09: bets $6
tipner: calls $6
*** TURN *** [2d Js 8c] [Kd]
tipner: checks 
matiko09: checks 
*** RIVER *** [2d Js 8c Kd] [3d]
tipner: bets $16
matiko09: folds 
Uncalled bet ($16) returned to tipner
tipner collected $20.90 from pot
tipner: doesn't show hand 
*** SUMMARY ***
Total pot $22 | Rake $1.10 
Board [2d Js 8c Kd 3d]
Seat 1: chenconhaste folded before Flop (didn't bet)
Seat 2: robbiescrim9 folded before Flop
Seat 3: matiko09 folded on the River
Seat 4: Kukuryzka (button) folded before Flop (didn't bet)
Seat 5: tipner (small blind) collected ($20.90)
Seat 6: nickreason17 (big blind) folded before Flop
Seat 7: Rafaello18 folded before Flop (didn't bet)
Seat 8: ruslik_by folded before Flop (didn't bet)
Seat 9: Starw!nd folded before Flop (didn't bet)





PokerStars Hand #155381260649:  Hold'em No Limit ($0.25/$0.50 USD) - 2016/06/30 14:35:27 CET [2016/06/30 8:35:27 ET]
Table 'Arcturus' 9-max Seat #8 is the button
Seat 1: kourk250 ($142.59 in chips) 
Seat 2: Rafaello18 ($50 in chips) 
Seat 3: matiko09 ($56.76 in chips) 
Seat 5: stockbridge8 ($47 in chips) 
Seat 6: statistik85 ($63.66 in chips) 
Seat 7: bratbugor ($52.01 in chips) 
Seat 8: TheMinion ($50 in chips) 
Seat 9: joker180785 ($50 in chips) 
joker180785: posts small blind $0.25
kourk250: posts big blind $0.50
*** HOLE CARDS ***
Dealt to matiko09 [Ks Ad]
Rafaello18: folds 
matiko09: raises $1 to $1.50
stockbridge8: folds 
statistik85: folds 
bratbugor: calls $1.50
TheMinion: calls $1.50
joker180785: folds 
kourk250: calls $1
*** FLOP *** [9d Qh Kc]
kourk250: checks 
matiko09: checks 
bratbugor: checks 
TheMinion: checks 
*** TURN *** [9d Qh Kc] [Qc]
kourk250: checks 
matiko09: checks 
bratbugor: checks 
TheMinion: checks 
*** RIVER *** [9d Qh Kc Qc] [5s]
kourk250: checks 
matiko09: bets $1.84
bratbugor: folds 
TheMinion: folds 
kourk250: folds 
Uncalled bet ($1.84) returned to matiko09
matiko09 collected $5.94 from pot
matiko09: doesn't show hand 
*** SUMMARY ***
Total pot $6.25 | Rake $0.31 
Board [9d Qh Kc Qc 5s]
Seat 1: kourk250 (big blind) folded on the River
Seat 2: Rafaello18 folded before Flop (didn't bet)
Seat 3: matiko09 collected ($5.94)
Seat 5: stockbridge8 folded before Flop (didn't bet)
Seat 6: statistik85 folded before Flop (didn't bet)
Seat 7: bratbugor folded on the River
Seat 8: TheMinion (button) folded on the River
Seat 9: joker180785 (small blind) folded before Flop





PokerStars Hand #155381265718:  Hold'em No Limit ($0.25/$0.50 USD) - 2016/06/30 14:35:37 CET [2016/06/30 8:35:37 ET]
Table 'Thalia II' 9-max Seat #8 is the button
Seat 2: DeathcorePkr ($52.95 in chips) 
Seat 3: r4mz3s ($68.51 in chips) 
Seat 4: Kukuryzka ($49.80 in chips) 
Seat 5: geowin ($68.16 in chips) 
Seat 6: chenconhaste ($53.50 in chips) 
Seat 7: fudzi ($62.73 in chips) 
Seat 8: Jo_Medici ($50 in chips) 
Seat 9: matiko09 ($50 in chips) 
matiko09: posts small blind $0.25
matteo080613: is sitting out 
DeathcorePkr: posts big blind $0.50
DeathcorePkr: posts the ante $0.10
r4mz3s: posts the ante $0.10
Kukuryzka: posts the ante $0.10
geowin: posts the ante $0.10
chenconhaste: posts the ante $0.10
fudzi: posts the ante $0.10
Jo_Medici: posts the ante $0.10
matiko09: posts the ante $0.10
*** HOLE CARDS ***
Dealt to matiko09 [3s 7d]
r4mz3s: folds 
Kukuryzka: raises $1 to $1.50
geowin: folds 
chenconhaste: folds 
fudzi: calls $1.50
Jo_Medici: folds 
matiko09: folds 
DeathcorePkr: folds 
*** FLOP *** [9c Kd Ks]
Kukuryzka: checks 
fudzi: checks 
*** TURN *** [9c Kd Ks] [Jc]
Kukuryzka: checks 
fudzi: bets $3
Kukuryzka: calls $3
*** RIVER *** [9c Kd Ks Jc] [2s]
Kukuryzka: checks 
fudzi: checks 
*** SHOW DOWN ***
Kukuryzka: shows [Ac Ad] (two pair, Aces and Kings)
fudzi: mucks hand 
Kukuryzka collected $10.02 from pot
*** SUMMARY ***
Total pot $10.55 | Rake $0.53 
Board [9c Kd Ks Jc 2s]
Seat 2: DeathcorePkr (big blind) folded before Flop
Seat 3: r4mz3s folded before Flop (didn't bet)
Seat 4: Kukuryzka showed [Ac Ad] and won ($10.02) with two pair, Aces and Kings
Seat 5: geowin folded before Flop (didn't bet)
Seat 6: chenconhaste folded before Flop (didn't bet)
Seat 7: fudzi mucked [Ah Qd]
Seat 8: Jo_Medici (button) folded before Flop (didn't bet)
Seat 9: matiko09 (small blind) folded before Flop





PokerStars Hand #155381272911:  Hold'em No Limit ($0.50/$1.00 USD) - 2016/06/30 14:35:52 CET [2016/06/30 8:35:52 ET]
Table 'Asmodeus' 9-max Seat #8 is the button
Seat 3: matiko09 ($100 in chips) 
Seat 4: Ty Nick 420 ($107.28 in chips) 
Seat 5: sanr23 ($110.30 in chips) 
Seat 6: koutani7 ($80.53 in chips) 
Seat 7: aaronzzr ($151.30 in chips) 
Seat 8: Rafaello18 ($176.87 in chips) 
Seat 9: mbk88 ($158.76 in chips) 
mbk88: posts small blind $0.50
nickreason17: is sitting out 
matiko09: posts big blind $1
*** HOLE CARDS ***
Dealt to matiko09 [5c Qh]
nickreason17 leaves the table
Ty Nick 420: folds 
sanr23: folds 
koutani7: folds 
aaronzzr: folds 
DomiVY joins the table at seat #2 
Rafaello18: folds 
mbk88: calls $0.50
matiko09: checks 
*** FLOP *** [2d Ks 5d]
mbk88: checks 
matiko09: bets $1
mbk88: calls $1
*** TURN *** [2d Ks 5d] [Kh]
mbk88: checks 
matiko09: checks 
*** RIVER *** [2d Ks 5d Kh] [8s]
mbk88: checks 
matiko09: checks 
*** SHOW DOWN ***
mbk88: shows [Kd 8d] (a full house, Kings full of Eights)
matiko09: mucks hand 
mbk88 collected $3.80 from pot
*** SUMMARY ***
Total pot $4 | Rake $0.20 
Board [2d Ks 5d Kh 8s]
Seat 3: matiko09 (big blind) mucked [5c Qh]
Seat 4: Ty Nick 420 folded before Flop (didn't bet)
Seat 5: sanr23 folded before Flop (didn't bet)
Seat 6: koutani7 folded before Flop (didn't bet)
Seat 7: aaronzzr folded before Flop (didn't bet)
Seat 8: Rafaello18 (button) folded before Flop (didn't bet)
Seat 9: mbk88 (small blind) showed [Kd 8d] and won ($3.80) with a full house, Kings full of Eights





PokerStars Hand #155381273197:  Hold'em No Limit ($0.50/$1.00 USD) - 2016/06/30 14:35:53 CET [2016/06/30 8:35:53 ET]
Table 'Altarf II' 9-max Seat #2 is the button
Seat 1: Rafaello18 ($102 in chips) 
Seat 2: KovIFish89 ($125.45 in chips) 
Seat 3: sanr23 ($165.71 in chips) 
Seat 4: Greha999 ($148.38 in chips) 
Seat 6: mbk88 ($100 in chips) 
Seat 7: matiko09 ($110.72 in chips) 
Seat 8: DomiVY ($40 in chips) 
Seat 9: omanibemihum ($158.92 in chips) 
sanr23: posts small blind $0.50
Greha999: posts big blind $1
*** HOLE CARDS ***
Dealt to matiko09 [7d Js]
mbk88: folds 
matiko09: folds 
DomiVY: folds 
omanibemihum: folds 
Rafaello18: raises $1.50 to $2.50
KovIFish89: folds 
sanr23: folds 
Greha999: folds 
Uncalled bet ($1.50) returned to Rafaello18
Rafaello18 collected $2.50 from pot
Rafaello18: doesn't show hand 
*** SUMMARY ***
Total pot $2.50 | Rake $0 
Seat 1: Rafaello18 collected ($2.50)
Seat 2: KovIFish89 (button) folded before Flop (didn't bet)
Seat 3: sanr23 (small blind) folded before Flop
Seat 4: Greha999 (big blind) folded before Flop
Seat 6: mbk88 folded before Flop (didn't bet)
Seat 7: matiko09 folded before Flop (didn't bet)
Seat 8: DomiVY folded before Flop (didn't bet)
Seat 9: omanibemihum folded before Flop (didn't bet)





PokerStars Hand #155381273937:  Hold'em No Limit (€0.25/€0.50 EUR) - 2016/06/30 14:35:54 CET [2016/06/30 8:35:54 ET]
Table 'Vibeke II' 9-max Seat #8 is the button
Seat 4: acelacat111 (€30.31 in chips) 
Seat 5: mazefaka007 (€65.90 in chips) 
Seat 6: Kukuryzka (€55.11 in chips) 
Seat 7: matiko09 (€66.17 in chips) 
Seat 8: KABAL_ua (€50 in chips) 
funXmun will be allowed to play after the button
acelacat111: posts small blind €0.25
mazefaka007: posts big blind €0.50
*** HOLE CARDS ***
Dealt to matiko09 [Jc Th]
Kukuryzka: folds 
matiko09: folds 
KABAL_ua: raises €0.70 to €1.20
acelacat111: folds 
mazefaka007: folds 
Uncalled bet (€0.70) returned to KABAL_ua
KABAL_ua collected €1.25 from pot
KABAL_ua: doesn't show hand 
*** SUMMARY ***
Total pot €1.25 | Rake €0 
Seat 4: acelacat111 (small blind) folded before Flop
Seat 5: mazefaka007 (big blind) folded before Flop
Seat 6: Kukuryzka folded before Flop (didn't bet)
Seat 7: matiko09 folded before Flop (didn't bet)
Seat 8: KABAL_ua (button) collected (€1.25)





PokerStars Hand #155381277240:  Hold'em No Limit ($0.50/$1.00 USD) - 2016/06/30 14:36:01 CET [2016/06/30 8:36:01 ET]
Table 'Tatjana' 9-max Seat #6 is the button
Seat 1: tipner ($100 in chips) 
Seat 3: Rafaello18 ($100 in chips) 
Seat 4: mopatron25 ($114.79 in chips) 
Seat 5: matiko09 ($113.64 in chips) 
Seat 6: mbk88 ($159.54 in chips) 
Seat 8: alhill86 ($104.56 in chips) 
Seat 9: Ty Nick 420 ($100 in chips) 
alhill86: posts small blind $0.50
Ty Nick 420: posts big blind $1
Kukuryzka: sits out 
*** HOLE CARDS ***
Dealt to matiko09 [Jc 8d]
tipner: folds 
Rafaello18: folds 
mopatron25: calls $1
matiko09: folds 
mbk88: raises $3 to $4
alhill86: folds 
Ty Nick 420: folds 
mopatron25: calls $3
*** FLOP *** [Qh 4h 2s]
mopatron25: bets $3
mbk88: folds 
Uncalled bet ($3) returned to mopatron25
mopatron25 collected $9.02 from pot
mopatron25: doesn't show hand 
*** SUMMARY ***
Total pot $9.50 | Rake $0.48 
Board [Qh 4h 2s]
Seat 1: tipner folded before Flop (didn't bet)
Seat 3: Rafaello18 folded before Flop (didn't bet)
Seat 4: mopatron25 collected ($9.02)
Seat 5: matiko09 folded before Flop (didn't bet)
Seat 6: mbk88 (button) folded on the Flop
Seat 8: alhill86 (small blind) folded before Flop
Seat 9: Ty Nick 420 (big blind) folded before Flop





PokerStars Hand #155381277757:  Hold'em No Limit ($0.50/$1.00 USD) - 2016/06/30 14:36:02 CET [2016/06/30 8:36:02 ET]
Table 'Sigrid' 9-max Seat #8 is the button
Seat 1: Greha999 ($57.08 in chips) 
Seat 2: matiko09 ($105.16 in chips) 
Seat 3: Rafaello18 ($107.85 in chips) 
Seat 4: mbk88 ($105.55 in chips) 
Seat 5: chenconhaste ($101.50 in chips) 
Seat 7: arctur17 ($128.44 in chips) 
Seat 8: ruslik_by ($102.62 in chips) 
Seat 9: KovIFish89 ($100 in chips) 
KovIFish89: posts small blind $0.50
Greha999: posts big blind $1
*** HOLE CARDS ***
Dealt to matiko09 [6s 5c]
matiko09: folds 
Rafaello18: folds 
mbk88: folds 
chenconhaste: folds 
arctur17: folds 
ruslik_by: raises $1 to $2
KovIFish89: folds 
Greha999: calls $1
*** FLOP *** [Qd 2s 5d]
Greha999: checks 
ruslik_by: bets $2.14
Greha999: calls $2.14
*** TURN *** [Qd 2s 5d] [7s]
Greha999: checks 
ruslik_by: bets $7.08
Greha999: folds 
Uncalled bet ($7.08) returned to ruslik_by
ruslik_by collected $8.34 from pot
ruslik_by: doesn't show hand 
*** SUMMARY ***
Total pot $8.78 | Rake $0.44 
Board [Qd 2s 5d 7s]
Seat 1: Greha999 (big blind) folded on the Turn
Seat 2: matiko09 folded before Flop (didn't bet)
Seat 3: Rafaello18 folded before Flop (didn't bet)
Seat 4: mbk88 folded before Flop (didn't bet)
Seat 5: chenconhaste folded before Flop (didn't bet)
Seat 7: arctur17 folded before Flop (didn't bet)
Seat 8: ruslik_by (button) collected ($8.34)
Seat 9: KovIFish89 (small blind) folded before Flop





PokerStars Hand #155381278712:  Hold'em No Limit ($0.50/$1.00 USD) - 2016/06/30 14:36:04 CET [2016/06/30 8:36:04 ET]
Table 'Borrelly II' 9-max Seat #7 is the button
Seat 1: Rafaello18 ($120.09 in chips) 
Seat 2: mbk88 ($108.63 in chips) 
Seat 4: DonRon_AT ($53.38 in chips) 
Seat 5: Ty Nick 420 ($102.50 in chips) 
Seat 6: m_michalec ($172.42 in chips) 
Seat 7: matiko09 ($175.86 in chips) 
Seat 8: Arjun A Raju ($131.42 in chips) 
Seat 9: ruslik_by ($111.42 in chips) 
Arjun A Raju: posts small blind $0.50
ruslik_by: posts big blind $1
*** HOLE CARDS ***
Dealt to matiko09 [9c 6s]
Rafaello18: folds 
mbk88: folds 
DonRon_AT: folds 
Ty Nick 420: folds 
m_michalec: folds 
matiko09: folds 
Arjun A Raju: raises $2 to $3
ruslik_by: calls $2
*** FLOP *** [As Jh 7c]
Arjun A Raju: bets $3.79
ruslik_by: folds 
Uncalled bet ($3.79) returned to Arjun A Raju
Arjun A Raju collected $5.70 from pot
Arjun A Raju: doesn't show hand 
*** SUMMARY ***
Total pot $6 | Rake $0.30 
Board [As Jh 7c]
Seat 1: Rafaello18 folded before Flop (didn't bet)
Seat 2: mbk88 folded before Flop (didn't bet)
Seat 4: DonRon_AT folded before Flop (didn't bet)
Seat 5: Ty Nick 420 folded before Flop (didn't bet)
Seat 6: m_michalec folded before Flop (didn't bet)
Seat 7: matiko09 (button) folded before Flop (didn't bet)
Seat 8: Arjun A Raju (small blind) collected ($5.70)
Seat 9: ruslik_by (big blind) folded on the Flop





PokerStars Hand #155381281046:  Hold'em No Limit ($0.25/$0.50 USD) - 2016/06/30 14:36:09 CET [2016/06/30 8:36:09 ET]
Table 'Chort III' 9-max Seat #9 is the button
Seat 1: BladeChen ($68.68 in chips) 
Seat 4: kotkas1000 ($50 in chips) 
Seat 5: Hit Pit ($35.84 in chips) 
Seat 6: Franky77200 ($25.79 in chips) 
Seat 7: matiko09 ($50 in chips) 
Seat 8: Kukuryzka ($49.55 in chips) 
Seat 9: r4mz3s ($50 in chips) 
BladeChen: posts small blind $0.25
kotkas1000: posts big blind $0.50
BladeChen: posts the ante $0.10
kotkas1000: posts the ante $0.10
Hit Pit: posts the ante $0.10
Franky77200: posts the ante $0.10
matiko09: posts the ante $0.10
Kukuryzka: posts the ante $0.10
r4mz3s: posts the ante $0.10
*** HOLE CARDS ***
Dealt to matiko09 [Qd 9s]
Hit Pit: folds 
Franky77200: folds 
matiko09: folds 
Alexey_Kim2 leaves the table
Kukuryzka: folds 
r4mz3s: folds 
BladeChen: folds 
Uncalled bet ($0.25) returned to kotkas1000
kotkas1000 collected $1.20 from pot
kotkas1000: doesn't show hand 
*** SUMMARY ***
Total pot $1.20 | Rake $0 
Seat 1: BladeChen (small blind) folded before Flop
Seat 4: kotkas1000 (big blind) collected ($1.20)
Seat 5: Hit Pit folded before Flop (didn't bet)
Seat 6: Franky77200 folded before Flop (didn't bet)
Seat 7: matiko09 folded before Flop (didn't bet)
Seat 8: Kukuryzka folded before Flop (didn't bet)
Seat 9: r4mz3s (button) folded before Flop (didn't bet)





PokerStars Hand #155381283633:  Hold'em No Limit (€0.25/€0.50 EUR) - 2016/06/30 14:36:14 CET [2016/06/30 8:36:14 ET]
Table 'Vibeke II' 9-max Seat #4 is the button
Seat 4: acelacat111 (€30.06 in chips) 
Seat 5: mazefaka007 (€65.40 in chips) 
Seat 6: Kukuryzka (€55.11 in chips) 
Seat 7: matiko09 (€66.17 in chips) 
Seat 8: KABAL_ua (€50.75 in chips) 
mazefaka007: posts small blind €0.25
Kukuryzka: posts big blind €0.50
funXmun: sits out 
*** HOLE CARDS ***
Dealt to matiko09 [2d 7h]
matiko09: folds 
KABAL_ua: folds 
acelacat111: folds 
mazefaka007: folds 
Uncalled bet (€0.25) returned to Kukuryzka
Kukuryzka collected €0.50 from pot
Kukuryzka: doesn't show hand 
*** SUMMARY ***
Total pot €0.50 | Rake €0 
Seat 4: acelacat111 (button) folded before Flop (didn't bet)
Seat 5: mazefaka007 (small blind) folded before Flop
Seat 6: Kukuryzka (big blind) collected (€0.50)
Seat 7: matiko09 folded before Flop (didn't bet)
Seat 8: KABAL_ua folded before Flop (didn't bet)





PokerStars Hand #155381285980:  Hold'em No Limit ($0.50/$1.00 USD) - 2016/06/30 14:36:19 CET [2016/06/30 8:36:19 ET]
Table 'Altarf II' 9-max Seat #3 is the button
Seat 1: Rafaello18 ($103.50 in chips) 
Seat 2: KovIFish89 ($125.45 in chips) 
Seat 3: sanr23 ($165.21 in chips) 
Seat 4: Greha999 ($147.38 in chips) 
Seat 6: mbk88 ($100 in chips) 
Seat 7: matiko09 ($110.72 in chips) 
Seat 8: DomiVY ($40 in chips) 
Seat 9: omanibemihum ($158.92 in chips) 
Greha999: posts small blind $0.50
mbk88: posts big blind $1
*** HOLE CARDS ***
Dealt to matiko09 [3s 7s]
matiko09: folds 
DomiVY: folds 
omanibemihum: folds 
Rafaello18: folds 
KovIFish89: folds 
sanr23: raises $1 to $2
Greha999: calls $1.50
mbk88: folds 
*** FLOP *** [Kd Ad 5d]
Greha999: checks 
sanr23: bets $2.75
Greha999: folds 
Uncalled bet ($2.75) returned to sanr23
sanr23 collected $4.75 from pot
sanr23: doesn't show hand 
*** SUMMARY ***
Total pot $5 | Rake $0.25 
Board [Kd Ad 5d]
Seat 1: Rafaello18 folded before Flop (didn't bet)
Seat 2: KovIFish89 folded before Flop (didn't bet)
Seat 3: sanr23 (button) collected ($4.75)
Seat 4: Greha999 (small blind) folded on the Flop
Seat 6: mbk88 (big blind) folded before Flop
Seat 7: matiko09 folded before Flop (didn't bet)
Seat 8: DomiVY folded before Flop (didn't bet)
Seat 9: omanibemihum folded before Flop (didn't bet)





PokerStars Hand #155381290506:  Hold'em No Limit ($0.25/$0.50 USD) - 2016/06/30 14:36:29 CET [2016/06/30 8:36:29 ET]
Table 'Thalia II' 9-max Seat #9 is the button
Seat 2: DeathcorePkr ($52.35 in chips) 
Seat 3: r4mz3s ($68.41 in chips) 
Seat 4: Kukuryzka ($55.22 in chips) 
Seat 5: geowin ($68.06 in chips) 
Seat 6: chenconhaste ($53.40 in chips) 
Seat 7: fudzi ($58.13 in chips) 
Seat 8: Jo_Medici ($50 in chips) 
Seat 9: matiko09 ($50 in chips) 
DeathcorePkr: posts small blind $0.25
r4mz3s: posts big blind $0.50
DeathcorePkr: posts the ante $0.10
r4mz3s: posts the ante $0.10
Kukuryzka: posts the ante $0.10
geowin: posts the ante $0.10
chenconhaste: posts the ante $0.10
fudzi: posts the ante $0.10
Jo_Medici: posts the ante $0.10
matiko09: posts the ante $0.10
*** HOLE CARDS ***
Dealt to matiko09 [4c 8h]
Kukuryzka: folds 
geowin: calls $0.50
chenconhaste: raises $1.50 to $2
fudzi: folds 
Jo_Medici: folds 
matiko09: folds 
DeathcorePkr: calls $1.75
r4mz3s: calls $1.50
geowin: calls $1.50
*** FLOP *** [8s Th 2h]
DeathcorePkr: checks 
r4mz3s: bets $5.75
geowin: folds 
chenconhaste: folds 
DeathcorePkr: folds 
Uncalled bet ($5.75) returned to r4mz3s
r4mz3s collected $8.36 from pot
r4mz3s: doesn't show hand 
*** SUMMARY ***
Total pot $8.80 | Rake $0.44 
Board [8s Th 2h]
Seat 2: DeathcorePkr (small blind) folded on the Flop
Seat 3: r4mz3s (big blind) collected ($8.36)
Seat 4: Kukuryzka folded before Flop (didn't bet)
Seat 5: geowin folded on the Flop
Seat 6: chenconhaste folded on the Flop
Seat 7: fudzi folded before Flop (didn't bet)
Seat 8: Jo_Medici folded before Flop (didn't bet)
Seat 9: matiko09 (button) folded before Flop (didn't bet)





PokerStars Hand #155381290563:  Hold'em No Limit ($0.25/$0.50 USD) - 2016/06/30 14:36:29 CET [2016/06/30 8:36:29 ET]
Table 'Chort III' 9-max Seat #1 is the button
Seat 1: BladeChen ($68.33 in chips) 
Seat 4: kotkas1000 ($50.85 in chips) 
Seat 5: Hit Pit ($35.74 in chips) 
Seat 6: Franky77200 ($25.69 in chips) 
Seat 7: matiko09 ($50 in chips) 
Seat 8: Kukuryzka ($50 in chips) 
Seat 9: r4mz3s ($50 in chips) 
kotkas1000: posts small blind $0.25
Hit Pit: posts big blind $0.50
BladeChen: posts the ante $0.10
kotkas1000: posts the ante $0.10
Hit Pit: posts the ante $0.10
Franky77200: posts the ante $0.10
matiko09: posts the ante $0.10
Kukuryzka: posts the ante $0.10
r4mz3s: posts the ante $0.10
*** HOLE CARDS ***
Dealt to matiko09 [3h 9c]
Franky77200: calls $0.50
matiko09: folds 
Kukuryzka: folds 
r4mz3s: folds 
BladeChen: raises $2 to $2.50
kotkas1000: folds 
Hit Pit: folds 
Franky77200: calls $2
*** FLOP *** [8c 2c Th]
Franky77200: checks 
BladeChen: bets $6
Franky77200: folds 
Uncalled bet ($6) returned to BladeChen
BladeChen collected $6.13 from pot
BladeChen: doesn't show hand 
*** SUMMARY ***
Total pot $6.45 | Rake $0.32 
Board [8c 2c Th]
Seat 1: BladeChen (button) collected ($6.13)
Seat 4: kotkas1000 (small blind) folded before Flop
Seat 5: Hit Pit (big blind) folded before Flop
Seat 6: Franky77200 folded on the Flop
Seat 7: matiko09 folded before Flop (didn't bet)
Seat 8: Kukuryzka folded before Flop (didn't bet)
Seat 9: r4mz3s folded before Flop (didn't bet)





PokerStars Hand #155381294200:  Hold'em No Limit (€0.25/€0.50 EUR) - 2016/06/30 14:36:37 CET [2016/06/30 8:36:37 ET]
Table 'Vibeke II' 9-max Seat #5 is the button
Seat 4: acelacat111 (€30.06 in chips) 
Seat 5: mazefaka007 (€65.15 in chips) 
Seat 6: Kukuryzka (€55.36 in chips) 
Seat 7: matiko09 (€66.17 in chips) 
Seat 8: KABAL_ua (€50.75 in chips) 
Kukuryzka: posts small blind €0.25
matiko09: posts big blind €0.50
funXmun: sits out 
*** HOLE CARDS ***
Dealt to matiko09 [9c 7c]
KABAL_ua: folds 
acelacat111: folds 
mazefaka007: folds 
Kukuryzka: raises €0.75 to €1.25
matiko09: calls €0.75
*** FLOP *** [Qh Tc Jd]
Kukuryzka: bets €1.19
matiko09: calls €1.19
*** TURN *** [Qh Tc Jd] [5c]
Kukuryzka: bets €3.16
matiko09: calls €3.16
*** RIVER *** [Qh Tc Jd 5c] [5h]
Kukuryzka: bets €7
matiko09: folds 
Uncalled bet (€7) returned to Kukuryzka
Kukuryzka collected €10.64 from pot
Kukuryzka: doesn't show hand 
*** SUMMARY ***
Total pot €11.20 | Rake €0.56 
Board [Qh Tc Jd 5c 5h]
Seat 4: acelacat111 folded before Flop (didn't bet)
Seat 5: mazefaka007 (button) folded before Flop (didn't bet)
Seat 6: Kukuryzka (small blind) collected (€10.64)
Seat 7: matiko09 (big blind) folded on the River
Seat 8: KABAL_ua folded before Flop (didn't bet)





PokerStars Hand #155381295455:  Hold'em No Limit ($0.50/$1.00 USD) - 2016/06/30 14:36:39 CET [2016/06/30 8:36:39 ET]
Table 'California II' 9-max Seat #1 is the button
Seat 1: Rafaello18 ($100 in chips) 
Seat 2: ruslik_by ($148.81 in chips) 
Seat 3: KovIFish89 ($100 in chips) 
Seat 4: f1reworks ($100 in chips) 
Seat 5: Rohitbarve ($110.27 in chips) 
Seat 6: matiko09 ($131.48 in chips) 
Seat 7: DomiVY ($89.88 in chips) 
Seat 8: chenconhaste ($102.50 in chips) 
Seat 9: di0d80 ($103.37 in chips) 
ruslik_by: posts small blind $0.50
KovIFish89: posts big blind $1
*** HOLE CARDS ***
Dealt to matiko09 [7c Jh]
f1reworks: folds 
Rohitbarve: folds 
matiko09: folds 
DomiVY: folds 
chenconhaste: folds 
di0d80: folds 
Rafaello18: folds 
ruslik_by: folds 
Uncalled bet ($0.50) returned to KovIFish89
KovIFish89 collected $1 from pot
KovIFish89: doesn't show hand 
*** SUMMARY ***
Total pot $1 | Rake $0 
Seat 1: Rafaello18 (button) folded before Flop (didn't bet)
Seat 2: ruslik_by (small blind) folded before Flop
Seat 3: KovIFish89 (big blind) collected ($1)
Seat 4: f1reworks folded before Flop (didn't bet)
Seat 5: Rohitbarve folded before Flop (didn't bet)
Seat 6: matiko09 folded before Flop (didn't bet)
Seat 7: DomiVY folded before Flop (didn't bet)
Seat 8: chenconhaste folded before Flop (didn't bet)
Seat 9: di0d80 folded before Flop (didn't bet)





PokerStars Hand #155381305005:  Hold'em No Limit ($0.50/$1.00 USD) - 2016/06/30 14:36:59 CET [2016/06/30 8:36:59 ET]
Table 'Tatjana' 9-max Seat #8 is the button
Seat 1: tipner ($100 in chips) 
Seat 3: Rafaello18 ($100 in chips) 
Seat 4: mopatron25 ($119.81 in chips) 
Seat 5: matiko09 ($113.64 in chips) 
Seat 6: mbk88 ($155.54 in chips) 
Seat 8: alhill86 ($104.06 in chips) 
Seat 9: Ty Nick 420 ($100 in chips) 
Ty Nick 420: posts small blind $0.50
tipner: posts big blind $1
Kukuryzka: sits out 
*** HOLE CARDS ***
Dealt to matiko09 [7d Qh]
Rafaello18: folds 
mopatron25: calls $1
matiko09: folds 
mbk88: folds 
alhill86: raises $3 to $4
Ty Nick 420: folds 
tipner: raises $8 to $12
mopatron25: folds 
alhill86: calls $8
*** FLOP *** [7h Td 6d]
tipner: bets $12
alhill86: calls $12
*** TURN *** [7h Td 6d] [7s]
tipner: bets $20
alhill86: calls $20
*** RIVER *** [7h Td 6d 7s] [Jh]
tipner: checks 
alhill86: checks 
*** SHOW DOWN ***
tipner: shows [Qd Ad] (a pair of Sevens)
alhill86: shows [Ts Qs] (two pair, Tens and Sevens)
alhill86 collected $87 from pot
*** SUMMARY ***
Total pot $89.50 | Rake $2.50 
Board [7h Td 6d 7s Jh]
Seat 1: tipner (big blind) showed [Qd Ad] and lost with a pair of Sevens
Seat 3: Rafaello18 folded before Flop (didn't bet)
Seat 4: mopatron25 folded before Flop
Seat 5: matiko09 folded before Flop (didn't bet)
Seat 6: mbk88 folded before Flop (didn't bet)
Seat 8: alhill86 (button) showed [Ts Qs] and won ($87) with two pair, Tens and Sevens
Seat 9: Ty Nick 420 (small blind) folded before Flop





PokerStars Hand #155381311290:  Hold'em No Limit ($0.50/$1.00 USD) - 2016/06/30 14:37:11 CET [2016/06/30 8:37:11 ET]
Table 'Borrelly II' 9-max Seat #8 is the button
Seat 1: Rafaello18 ($120.09 in chips) 
Seat 2: mbk88 ($108.63 in chips) 
Seat 4: DonRon_AT ($53.38 in chips) 
Seat 5: Ty Nick 420 ($102.50 in chips) 
Seat 6: m_michalec ($172.42 in chips) 
Seat 7: matiko09 ($175.86 in chips) 
Seat 8: Arjun A Raju ($134.12 in chips) 
Seat 9: ruslik_by ($108.42 in chips) 
ruslik_by: posts small blind $0.50
Rafaello18: posts big blind $1
*** HOLE CARDS ***
Dealt to matiko09 [Th 2c]
mbk88: raises $2 to $3
DonRon_AT: folds 
Ty Nick 420: folds 
m_michalec: folds 
matiko09: folds 
Arjun A Raju: folds 
ruslik_by: folds 
Rafaello18: folds 
Uncalled bet ($2) returned to mbk88
mbk88 collected $2.50 from pot
mbk88: doesn't show hand 
*** SUMMARY ***
Total pot $2.50 | Rake $0 
Seat 1: Rafaello18 (big blind) folded before Flop
Seat 2: mbk88 collected ($2.50)
Seat 4: DonRon_AT folded before Flop (didn't bet)
Seat 5: Ty Nick 420 folded before Flop (didn't bet)
Seat 6: m_michalec folded before Flop (didn't bet)
Seat 7: matiko09 folded before Flop (didn't bet)
Seat 8: Arjun A Raju (button) folded before Flop (didn't bet)
Seat 9: ruslik_by (small blind) folded before Flop





PokerStars Hand #155381312787:  Hold'em No Limit ($0.50/$1.00 USD) - 2016/06/30 14:37:14 CET [2016/06/30 8:37:14 ET]
Table 'Sigrid' 9-max Seat #9 is the button
Seat 1: Greha999 ($52.94 in chips) 
Seat 2: matiko09 ($105.16 in chips) 
Seat 3: Rafaello18 ($107.85 in chips) 
Seat 4: mbk88 ($105.55 in chips) 
Seat 5: chenconhaste ($101.50 in chips) 
Seat 7: arctur17 ($128.44 in chips) 
Seat 8: ruslik_by ($106.82 in chips) 
Seat 9: KovIFish89 ($100 in chips) 
Greha999: posts small blind $0.50
matiko09: posts big blind $1
*** HOLE CARDS ***
Dealt to matiko09 [2h Qd]
Rafaello18: raises $1.50 to $2.50
mbk88: folds 
chenconhaste: folds 
arctur17: folds 
ruslik_by: calls $2.50
KovIFish89: folds 
Greha999: folds 
matiko09: folds 
*** FLOP *** [Ts Ad 6d]
Rafaello18: bets $4
ruslik_by: calls $4
*** TURN *** [Ts Ad 6d] [6h]
Rafaello18: bets $10
ruslik_by: folds 
Uncalled bet ($10) returned to Rafaello18
Rafaello18 collected $13.78 from pot
Rafaello18: doesn't show hand 
*** SUMMARY ***
Total pot $14.50 | Rake $0.72 
Board [Ts Ad 6d 6h]
Seat 1: Greha999 (small blind) folded before Flop
Seat 2: matiko09 (big blind) folded before Flop
Seat 3: Rafaello18 collected ($13.78)
Seat 4: mbk88 folded before Flop (didn't bet)
Seat 5: chenconhaste folded before Flop (didn't bet)
Seat 7: arctur17 folded before Flop (didn't bet)
Seat 8: ruslik_by folded on the Turn
Seat 9: KovIFish89 (button) folded before Flop (didn't bet)





PokerStars Hand #155381314262:  Hold'em No Limit ($0.25/$0.50 USD) - 2016/06/30 14:37:17 CET [2016/06/30 8:37:17 ET]
Table 'Chort III' 9-max Seat #4 is the button
Seat 1: BladeChen ($71.86 in chips) 
Seat 4: kotkas1000 ($50.50 in chips) 
Seat 5: Hit Pit ($35.14 in chips) 
Seat 6: Franky77200 ($23.09 in chips) 
Seat 7: matiko09 ($50 in chips) 
Seat 8: Kukuryzka ($49.90 in chips) 
Seat 9: r4mz3s ($50 in chips) 
Hit Pit: posts small blind $0.25
Franky77200: posts big blind $0.50
BladeChen: posts the ante $0.10
kotkas1000: posts the ante $0.10
Hit Pit: posts the ante $0.10
Franky77200: posts the ante $0.10
matiko09: posts the ante $0.10
Kukuryzka: posts the ante $0.10
r4mz3s: posts the ante $0.10
*** HOLE CARDS ***
Dealt to matiko09 [Ah 5c]
matiko09: folds 
Kukuryzka: folds 
r4mz3s: folds 
BladeChen: folds 
kotkas1000: folds 
Hit Pit: calls $0.25
Franky77200: checks 
*** FLOP *** [4c 3s Td]
Hit Pit: checks 
Franky77200: checks 
*** TURN *** [4c 3s Td] [4h]
Hit Pit: bets $1.50
Franky77200: folds 
Uncalled bet ($1.50) returned to Hit Pit
Hit Pit collected $1.62 from pot
*** SUMMARY ***
Total pot $1.70 | Rake $0.08 
Board [4c 3s Td 4h]
Seat 1: BladeChen folded before Flop (didn't bet)
Seat 4: kotkas1000 (button) folded before Flop (didn't bet)
Seat 5: Hit Pit (small blind) collected ($1.62)
Seat 6: Franky77200 (big blind) folded on the Turn
Seat 7: matiko09 folded before Flop (didn't bet)
Seat 8: Kukuryzka folded before Flop (didn't bet)
Seat 9: r4mz3s folded before Flop (didn't bet)





PokerStars Hand #155381317293:  Hold'em No Limit ($0.50/$1.00 USD) - 2016/06/30 14:37:24 CET [2016/06/30 8:37:24 ET]
Table 'Asmodeus' 9-max Seat #9 is the button
Seat 3: matiko09 ($100 in chips) 
Seat 4: Ty Nick 420 ($107.28 in chips) 
Seat 5: sanr23 ($110.30 in chips) 
Seat 6: koutani7 ($80.53 in chips) 
Seat 7: aaronzzr ($151.30 in chips) 
Seat 8: Rafaello18 ($176.87 in chips) 
Seat 9: mbk88 ($160.56 in chips) 
DomiVY will be allowed to play after the button
matiko09: posts small blind $0.50
Ty Nick 420: posts big blind $1
*** HOLE CARDS ***
Dealt to matiko09 [2d 6c]
sanr23: folds 
koutani7: folds 
aaronzzr: raises $1 to $2
Rafaello18: folds 
mbk88: folds 
matiko09: folds 
Ty Nick 420: calls $1
*** FLOP *** [Tc 7s Jh]
Ty Nick 420: checks 
aaronzzr: checks 
*** TURN *** [Tc 7s Jh] [Jd]
Ty Nick 420: checks 
aaronzzr: checks 
*** RIVER *** [Tc 7s Jh Jd] [Kc]
Ty Nick 420: checks 
aaronzzr: checks 
*** SHOW DOWN ***
Ty Nick 420: shows [Ad 7h] (two pair, Jacks and Sevens)
aaronzzr: mucks hand 
Ty Nick 420 collected $4.28 from pot
*** SUMMARY ***
Total pot $4.50 | Rake $0.22 
Board [Tc 7s Jh Jd Kc]
Seat 3: matiko09 (small blind) folded before Flop
Seat 4: Ty Nick 420 (big blind) showed [Ad 7h] and won ($4.28) with two pair, Jacks and Sevens
Seat 5: sanr23 folded before Flop (didn't bet)
Seat 6: koutani7 folded before Flop (didn't bet)
Seat 7: aaronzzr mucked [9d As]
Seat 8: Rafaello18 folded before Flop (didn't bet)
Seat 9: mbk88 (button) folded before Flop (didn't bet)





PokerStars Hand #155381318096:  Hold'em No Limit ($0.50/$1.00 USD) - 2016/06/30 14:37:25 CET [2016/06/30 8:37:25 ET]
Table 'California II' 9-max Seat #2 is the button
Seat 1: Rafaello18 ($100 in chips) 
Seat 2: ruslik_by ($148.31 in chips) 
Seat 3: KovIFish89 ($100.50 in chips) 
Seat 4: f1reworks ($100 in chips) 
Seat 5: Rohitbarve ($110.27 in chips) 
Seat 6: matiko09 ($131.48 in chips) 
Seat 7: DomiVY ($89.88 in chips) 
Seat 8: chenconhaste ($102.50 in chips) 
Seat 9: di0d80 ($103.37 in chips) 
KovIFish89: posts small blind $0.50
f1reworks: posts big blind $1
*** HOLE CARDS ***
Dealt to matiko09 [8d 5d]
Rohitbarve: folds 
matiko09: folds 
DomiVY: folds 
chenconhaste: folds 
di0d80: folds 
Rafaello18: folds 
ruslik_by: folds 
KovIFish89: raises $2 to $3
f1reworks: calls $2
*** FLOP *** [7d 4s 7c]
KovIFish89: checks 
f1reworks: bets $3.13
KovIFish89: calls $3.13
*** TURN *** [7d 4s 7c] [Js]
KovIFish89: checks 
f1reworks: bets $8
KovIFish89: raises $16 to $24
f1reworks: folds 
Uncalled bet ($16) returned to KovIFish89
KovIFish89 collected $26.85 from pot
KovIFish89: doesn't show hand 
*** SUMMARY ***
Total pot $28.26 | Rake $1.41 
Board [7d 4s 7c Js]
Seat 1: Rafaello18 folded before Flop (didn't bet)
Seat 2: ruslik_by (button) folded before Flop (didn't bet)
Seat 3: KovIFish89 (small blind) collected ($26.85)
Seat 4: f1reworks (big blind) folded on the Turn
Seat 5: Rohitbarve folded before Flop (didn't bet)
Seat 6: matiko09 folded before Flop (didn't bet)
Seat 7: DomiVY folded before Flop (didn't bet)
Seat 8: chenconhaste folded before Flop (didn't bet)
Seat 9: di0d80 folded before Flop (didn't bet)





PokerStars Hand #155381320923:  Hold'em No Limit ($0.25/$0.50 USD) - 2016/06/30 14:37:31 CET [2016/06/30 8:37:31 ET]
Table 'Arcturus' 9-max Seat #9 is the button
Seat 1: kourk250 ($141.09 in chips) 
Seat 2: Rafaello18 ($50 in chips) 
Seat 3: matiko09 ($61.20 in chips) 
Seat 5: stockbridge8 ($47 in chips) 
Seat 6: statistik85 ($63.66 in chips) 
Seat 7: bratbugor ($50.51 in chips) 
Seat 8: TheMinion ($50 in chips) 
Seat 9: joker180785 ($50 in chips) 
kourk250: posts small blind $0.25
Rafaello18: posts big blind $0.50
*** HOLE CARDS ***
Dealt to matiko09 [4h 2h]
matiko09: folds 
stockbridge8: raises $1 to $1.50
statistik85: folds 
bratbugor: folds 
TheMinion: calls $1.50
joker180785: folds 
kourk250: folds 
Rafaello18: folds 
*** FLOP *** [Ks Th 8c]
stockbridge8: bets $1.78
TheMinion: raises $4.27 to $6.05
stockbridge8: calls $4.27
*** TURN *** [Ks Th 8c] [2c]
stockbridge8: bets $7.53
TheMinion: raises $34.92 to $42.45 and is all-in
stockbridge8: folds 
Uncalled bet ($34.92) returned to TheMinion
TheMinion collected $29.36 from pot
TheMinion: doesn't show hand 
*** SUMMARY ***
Total pot $30.91 | Rake $1.55 
Board [Ks Th 8c 2c]
Seat 1: kourk250 (small blind) folded before Flop
Seat 2: Rafaello18 (big blind) folded before Flop
Seat 3: matiko09 folded before Flop (didn't bet)
Seat 5: stockbridge8 folded on the Turn
Seat 6: statistik85 folded before Flop (didn't bet)
Seat 7: bratbugor folded before Flop (didn't bet)
Seat 8: TheMinion collected ($29.36)
Seat 9: joker180785 (button) folded before Flop (didn't bet)





PokerStars Hand #155381323659:  Hold'em No Limit ($0.50/$1.00 USD) - 2016/06/30 14:37:37 CET [2016/06/30 8:37:37 ET]
Table 'Altarf II' 9-max Seat #4 is the button
Seat 1: Rafaello18 ($103.50 in chips) 
Seat 2: KovIFish89 ($125.45 in chips) 
Seat 3: sanr23 ($167.96 in chips) 
Seat 4: Greha999 ($145.38 in chips) 
Seat 6: mbk88 ($100 in chips) 
Seat 7: matiko09 ($110.72 in chips) 
Seat 8: DomiVY ($40 in chips) 
Seat 9: omanibemihum ($158.92 in chips) 
mbk88: posts small blind $0.50
matiko09: posts big blind $1
*** HOLE CARDS ***
Dealt to matiko09 [Ac Td]
DomiVY: folds 
omanibemihum: folds 
Rafaello18: raises $1.50 to $2.50
KovIFish89: calls $2.50
sanr23: folds 
Greha999: folds 
mbk88: folds 
matiko09: folds 
*** FLOP *** [6c 5h Ks]
Rafaello18: bets $4
KovIFish89: folds 
Uncalled bet ($4) returned to Rafaello18
Rafaello18 collected $6.18 from pot
Rafaello18: doesn't show hand 
*** SUMMARY ***
Total pot $6.50 | Rake $0.32 
Board [6c 5h Ks]
Seat 1: Rafaello18 collected ($6.18)
Seat 2: KovIFish89 folded on the Flop
Seat 3: sanr23 folded before Flop (didn't bet)
Seat 4: Greha999 (button) folded before Flop (didn't bet)
Seat 6: mbk88 (small blind) folded before Flop
Seat 7: matiko09 (big blind) folded before Flop
Seat 8: DomiVY folded before Flop (didn't bet)
Seat 9: omanibemihum folded before Flop (didn't bet)





PokerStars Hand #155381325533:  Hold'em No Limit ($0.50/$1.00 USD) - 2016/06/30 14:37:41 CET [2016/06/30 8:37:41 ET]
Table 'Donnera' 9-max Seat #5 is the button
Seat 1: chenconhaste ($113.06 in chips) 
Seat 2: robbiescrim9 ($103.56 in chips) 
Seat 3: matiko09 ($100 in chips) 
Seat 4: Kukuryzka ($102.50 in chips) 
Seat 5: tipner ($110.90 in chips) 
Seat 6: nickreason17 ($100 in chips) 
Seat 7: Rafaello18 ($132.30 in chips) 
Seat 8: ruslik_by ($200.98 in chips) 
Seat 9: Starw!nd ($119.25 in chips) 
nickreason17: posts small blind $0.50
Rafaello18: posts big blind $1
*** HOLE CARDS ***
Dealt to matiko09 [9s 9d]
ruslik_by: folds 
Starw!nd: folds 
chenconhaste: folds 
robbiescrim9: calls $1
matiko09: raises $3 to $4
Kukuryzka: folds 
tipner: folds 
nickreason17: folds 
Rafaello18: folds 
robbiescrim9: calls $3
*** FLOP *** [Qc Td 5d]
robbiescrim9: checks 
matiko09: checks 
*** TURN *** [Qc Td 5d] [Jd]
robbiescrim9: checks 
matiko09: checks 
*** RIVER *** [Qc Td 5d Jd] [Tc]
robbiescrim9: bets $2
matiko09: calls $2
*** SHOW DOWN ***
robbiescrim9: shows [5c Ah] (two pair, Tens and Fives)
matiko09: shows [9s 9d] (two pair, Tens and Nines)
matiko09 collected $12.82 from pot
*** SUMMARY ***
Total pot $13.50 | Rake $0.68 
Board [Qc Td 5d Jd Tc]
Seat 1: chenconhaste folded before Flop (didn't bet)
Seat 2: robbiescrim9 showed [5c Ah] and lost with two pair, Tens and Fives
Seat 3: matiko09 showed [9s 9d] and won ($12.82) with two pair, Tens and Nines
Seat 4: Kukuryzka folded before Flop (didn't bet)
Seat 5: tipner (button) folded before Flop (didn't bet)
Seat 6: nickreason17 (small blind) folded before Flop
Seat 7: Rafaello18 (big blind) folded before Flop
Seat 8: ruslik_by folded before Flop (didn't bet)
Seat 9: Starw!nd folded before Flop (didn't bet)





PokerStars Hand #155381327225:  Hold'em No Limit (€0.25/€0.50 EUR) - 2016/06/30 14:37:44 CET [2016/06/30 8:37:44 ET]
Table 'Vibeke II' 9-max Seat #6 is the button
Seat 4: acelacat111 (€30.06 in chips) 
Seat 5: mazefaka007 (€65.15 in chips) 
Seat 6: Kukuryzka (€60.40 in chips) 
Seat 7: matiko09 (€60.57 in chips) 
Seat 8: KABAL_ua (€50.75 in chips) 
matiko09: posts small blind €0.25
KABAL_ua: posts big blind €0.50
*** HOLE CARDS ***
Dealt to matiko09 [Js 9h]
acelacat111: folds 
mazefaka007: raises €0.55 to €1.05
Kukuryzka: folds 
matiko09: folds 
KABAL_ua: folds 
Uncalled bet (€0.55) returned to mazefaka007
mazefaka007 collected €1.25 from pot
mazefaka007: doesn't show hand 
*** SUMMARY ***
Total pot €1.25 | Rake €0 
Seat 4: acelacat111 folded before Flop (didn't bet)
Seat 5: mazefaka007 collected (€1.25)
Seat 6: Kukuryzka (button) folded before Flop (didn't bet)
Seat 7: matiko09 (small blind) folded before Flop
Seat 8: KABAL_ua (big blind) folded before Flop





PokerStars Hand #155381336064:  Hold'em No Limit (€0.25/€0.50 EUR) - 2016/06/30 14:38:02 CET [2016/06/30 8:38:02 ET]
Table 'Vibeke II' 9-max Seat #7 is the button
Seat 4: acelacat111 (€30.06 in chips) 
Seat 5: mazefaka007 (€65.90 in chips) 
Seat 6: Kukuryzka (€60.40 in chips) 
Seat 7: matiko09 (€60.32 in chips) 
Seat 8: KABAL_ua (€50.25 in chips) 
KABAL_ua: posts small blind €0.25
acelacat111: posts big blind €0.50
*** HOLE CARDS ***
Dealt to matiko09 [7d 9c]
mazefaka007: folds 
Kukuryzka: folds 
matiko09: folds 
KABAL_ua: raises €0.70 to €1.20
acelacat111: raises €2.40 to €3.60
KABAL_ua: folds 
Uncalled bet (€2.40) returned to acelacat111
acelacat111 collected €2.40 from pot
acelacat111: doesn't show hand 
*** SUMMARY ***
Total pot €2.40 | Rake €0 
Seat 4: acelacat111 (big blind) collected (€2.40)
Seat 5: mazefaka007 folded before Flop (didn't bet)
Seat 6: Kukuryzka folded before Flop (didn't bet)
Seat 7: matiko09 (button) folded before Flop (didn't bet)
Seat 8: KABAL_ua (small blind) folded before Flop





PokerStars Hand #155381336351:  Hold'em No Limit ($0.50/$1.00 USD) - 2016/06/30 14:38:03 CET [2016/06/30 8:38:03 ET]
Table 'Borrelly II' 9-max Seat #9 is the button
Seat 1: Rafaello18 ($119.09 in chips) 
Seat 2: mbk88 ($110.13 in chips) 
Seat 4: DonRon_AT ($53.38 in chips) 
Seat 5: Ty Nick 420 ($102.50 in chips) 
Seat 6: m_michalec ($172.42 in chips) 
Seat 7: matiko09 ($175.86 in chips) 
Seat 8: Arjun A Raju ($134.12 in chips) 
Seat 9: ruslik_by ($107.92 in chips) 
Rafaello18: posts small blind $0.50
mbk88: posts big blind $1
*** HOLE CARDS ***
Dealt to matiko09 [As 6s]
DonRon_AT: raises $3 to $4
Ty Nick 420: folds 
m_michalec: folds 
matiko09: folds 
Arjun A Raju: folds 
ruslik_by: folds 
Rafaello18: folds 
mbk88: calls $3
*** FLOP *** [6d Qd 7c]
mbk88: checks 
DonRon_AT: bets $4
mbk88: calls $4
*** TURN *** [6d Qd 7c] [Th]
mbk88: checks 
DonRon_AT: bets $7.84
mbk88: calls $7.84
*** RIVER *** [6d Qd 7c Th] [2s]
mbk88: checks 
DonRon_AT: bets $15.28
mbk88: calls $15.28
*** SHOW DOWN ***
DonRon_AT: shows [Ac Qs] (a pair of Queens)
mbk88: mucks hand 
DonRon_AT collected $60.24 from pot
*** SUMMARY ***
Total pot $62.74 | Rake $2.50 
Board [6d Qd 7c Th 2s]
Seat 1: Rafaello18 (small blind) folded before Flop
Seat 2: mbk88 (big blind) mucked [Td Kd]
Seat 4: DonRon_AT showed [Ac Qs] and won ($60.24) with a pair of Queens
Seat 5: Ty Nick 420 folded before Flop (didn't bet)
Seat 6: m_michalec folded before Flop (didn't bet)
Seat 7: matiko09 folded before Flop (didn't bet)
Seat 8: Arjun A Raju folded before Flop (didn't bet)
Seat 9: ruslik_by (button) folded before Flop (didn't bet)





PokerStars Hand #155381336202:  Hold'em No Limit ($0.25/$0.50 USD) - 2016/06/30 14:38:03 CET [2016/06/30 8:38:03 ET]
Table 'Thalia II' 9-max Seat #2 is the button
Seat 2: DeathcorePkr ($50.25 in chips) 
Seat 3: r4mz3s ($74.67 in chips) 
Seat 4: Kukuryzka ($55.12 in chips) 
Seat 5: geowin ($65.96 in chips) 
Seat 6: chenconhaste ($51.30 in chips) 
Seat 7: fudzi ($58.03 in chips) 
Seat 8: Jo_Medici ($50 in chips) 
Seat 9: matiko09 ($50 in chips) 
r4mz3s: posts small blind $0.25
Kukuryzka: posts big blind $0.50
DeathcorePkr: posts the ante $0.10
r4mz3s: posts the ante $0.10
Kukuryzka: posts the ante $0.10
geowin: posts the ante $0.10
chenconhaste: posts the ante $0.10
fudzi: posts the ante $0.10
Jo_Medici: posts the ante $0.10
matiko09: posts the ante $0.10
*** HOLE CARDS ***
Dealt to matiko09 [5c 6d]
geowin: raises $0.75 to $1.25
chenconhaste: folds 
fudzi: folds 
Jo_Medici: calls $1.25
matiko09: folds 
DeathcorePkr: calls $1.25
r4mz3s: folds 
Kukuryzka: folds 
*** FLOP *** [5d Ts Qs]
geowin: bets $0.50
Jo_Medici: folds 
DeathcorePkr: calls $0.50
*** TURN *** [5d Ts Qs] [4d]
geowin: bets $0.50
DeathcorePkr: calls $0.50
*** RIVER *** [5d Ts Qs 4d] [Ks]
geowin: checks 
DeathcorePkr: bets $2.22
geowin: folds 
Uncalled bet ($2.22) returned to DeathcorePkr
DeathcorePkr collected $6.94 from pot
DeathcorePkr: doesn't show hand 
*** SUMMARY ***
Total pot $7.30 | Rake $0.36 
Board [5d Ts Qs 4d Ks]
Seat 2: DeathcorePkr (button) collected ($6.94)
Seat 3: r4mz3s (small blind) folded before Flop
Seat 4: Kukuryzka (big blind) folded before Flop
Seat 5: geowin folded on the River
Seat 6: chenconhaste folded before Flop (didn't bet)
Seat 7: fudzi folded before Flop (didn't bet)
Seat 8: Jo_Medici folded on the Flop
Seat 9: matiko09 folded before Flop (didn't bet)





PokerStars Hand #155381336724:  Hold'em No Limit ($0.25/$0.50 USD) - 2016/06/30 14:38:04 CET [2016/06/30 8:38:04 ET]
Table 'Chort III' 9-max Seat #5 is the button
Seat 1: BladeChen ($71.76 in chips) 
Seat 4: kotkas1000 ($50.40 in chips) 
Seat 5: Hit Pit ($36.16 in chips) 
Seat 6: Franky77200 ($22.49 in chips) 
Seat 7: matiko09 ($50 in chips) 
Seat 8: Kukuryzka ($49.80 in chips) 
Seat 9: r4mz3s ($50 in chips) 
Franky77200: posts small blind $0.25
matiko09: posts big blind $0.50
BladeChen: posts the ante $0.10
kotkas1000: posts the ante $0.10
Hit Pit: posts the ante $0.10
Franky77200: posts the ante $0.10
matiko09: posts the ante $0.10
Kukuryzka: posts the ante $0.10
r4mz3s: posts the ante $0.10
*** HOLE CARDS ***
Dealt to matiko09 [5h 8c]
Kukuryzka: folds 
r4mz3s: folds 
BladeChen: folds 
kotkas1000: folds 
Hit Pit: folds 
Franky77200: raises $1 to $1.50
matiko09: folds 
Uncalled bet ($1) returned to Franky77200
Franky77200 collected $1.70 from pot
Franky77200: doesn't show hand 
*** SUMMARY ***
Total pot $1.70 | Rake $0 
Seat 1: BladeChen folded before Flop (didn't bet)
Seat 4: kotkas1000 folded before Flop (didn't bet)
Seat 5: Hit Pit (button) folded before Flop (didn't bet)
Seat 6: Franky77200 (small blind) collected ($1.70)
Seat 7: matiko09 (big blind) folded before Flop
Seat 8: Kukuryzka folded before Flop (didn't bet)
Seat 9: r4mz3s folded before Flop (didn't bet)





PokerStars Hand #155381337841:  Hold'em No Limit ($0.50/$1.00 USD) - 2016/06/30 14:38:06 CET [2016/06/30 8:38:06 ET]
Table 'Asmodeus' 9-max Seat #3 is the button
Seat 3: matiko09 ($100 in chips) 
Seat 4: Ty Nick 420 ($109.56 in chips) 
Seat 5: sanr23 ($110.30 in chips) 
Seat 6: koutani7 ($80.53 in chips) 
Seat 7: aaronzzr ($149.30 in chips) 
Seat 8: Rafaello18 ($176.87 in chips) 
Seat 9: mbk88 ($160.56 in chips) 
Ty Nick 420: posts small blind $0.50
sanr23: posts big blind $1
DomiVY: sits out 
*** HOLE CARDS ***
Dealt to matiko09 [9s 2h]
koutani7: folds 
aaronzzr: folds 
Rafaello18: folds 
mbk88: raises $2 to $3
matiko09: folds 
Ty Nick 420: folds 
sanr23: folds 
Uncalled bet ($2) returned to mbk88
mbk88 collected $2.50 from pot
*** SUMMARY ***
Total pot $2.50 | Rake $0 
Seat 3: matiko09 (button) folded before Flop (didn't bet)
Seat 4: Ty Nick 420 (small blind) folded before Flop
Seat 5: sanr23 (big blind) folded before Flop
Seat 6: koutani7 folded before Flop (didn't bet)
Seat 7: aaronzzr folded before Flop (didn't bet)
Seat 8: Rafaello18 folded before Flop (didn't bet)
Seat 9: mbk88 collected ($2.50)





PokerStars Hand #155381345343:  Hold'em No Limit ($0.50/$1.00 USD) - 2016/06/30 14:38:22 CET [2016/06/30 8:38:22 ET]
Table 'Altarf II' 9-max Seat #6 is the button
Seat 1: Rafaello18 ($107.18 in chips) 
Seat 2: KovIFish89 ($122.95 in chips) 
Seat 3: sanr23 ($167.96 in chips) 
Seat 4: Greha999 ($145.38 in chips) 
Seat 6: mbk88 ($100 in chips) 
Seat 7: matiko09 ($109.72 in chips) 
Seat 8: DomiVY ($40 in chips) 
Seat 9: omanibemihum ($158.92 in chips) 
matiko09: posts small blind $0.50
DomiVY: posts big blind $1
*** HOLE CARDS ***
Dealt to matiko09 [Kh 3c]
omanibemihum: folds 
Rafaello18: folds 
KovIFish89: raises $2 to $3
sanr23: folds 
Greha999: folds 
mbk88: calls $3
matiko09: folds 
DomiVY: folds 
*** FLOP *** [Kc 6s 4d]
KovIFish89: bets $4
mbk88: calls $4
*** TURN *** [Kc 6s 4d] [8s]
KovIFish89: bets $9.50
mbk88: calls $9.50
*** RIVER *** [Kc 6s 4d 8s] [3d]
KovIFish89: checks 
mbk88: bets $16
KovIFish89: raises $43.18 to $59.18
mbk88: calls $43.18
*** SHOW DOWN ***
KovIFish89: shows [Ac Jd] (high card Ace)
mbk88: shows [Kd Ad] (a pair of Kings)
mbk88 collected $150.36 from pot
*** SUMMARY ***
Total pot $152.86 | Rake $2.50 
Board [Kc 6s 4d 8s 3d]
Seat 1: Rafaello18 folded before Flop (didn't bet)
Seat 2: KovIFish89 showed [Ac Jd] and lost with high card Ace
Seat 3: sanr23 folded before Flop (didn't bet)
Seat 4: Greha999 folded before Flop (didn't bet)
Seat 6: mbk88 (button) showed [Kd Ad] and won ($150.36) with a pair of Kings
Seat 7: matiko09 (small blind) folded before Flop
Seat 8: DomiVY (big blind) folded before Flop
Seat 9: omanibemihum folded before Flop (didn't bet)





PokerStars Hand #155381345764:  Hold'em No Limit ($0.25/$0.50 USD) - 2016/06/30 14:38:23 CET [2016/06/30 8:38:23 ET]
Table 'Chort III' 9-max Seat #6 is the button
Seat 1: BladeChen ($71.66 in chips) 
Seat 4: kotkas1000 ($50.30 in chips) 
Seat 5: Hit Pit ($36.06 in chips) 
Seat 6: Franky77200 ($23.59 in chips) 
Seat 7: matiko09 ($50 in chips) 
Seat 8: Kukuryzka ($49.70 in chips) 
Seat 9: r4mz3s ($50 in chips) 
matiko09: posts small blind $0.25
Kukuryzka: posts big blind $0.50
BladeChen: posts the ante $0.10
kotkas1000: posts the ante $0.10
Hit Pit: posts the ante $0.10
Franky77200: posts the ante $0.10
matiko09: posts the ante $0.10
Kukuryzka: posts the ante $0.10
r4mz3s: posts the ante $0.10
*** HOLE CARDS ***
Dealt to matiko09 [Qs 2c]
r4mz3s: folds 
BladeChen: folds 
kotkas1000: folds 
Hit Pit: calls $0.50
Franky77200: calls $0.50
matiko09: folds 
Kukuryzka: checks 
*** FLOP *** [9d As Ts]
Kukuryzka: checks 
Hit Pit: bets $1
Franky77200: calls $1
Kukuryzka: folds 
*** TURN *** [9d As Ts] [Jd]
Hit Pit: bets $1.50
Franky77200: calls $1.50
*** RIVER *** [9d As Ts Jd] [6h]
Hit Pit: bets $2
Franky77200: raises $5.50 to $7.50
Hit Pit: folds 
Uncalled bet ($5.50) returned to Franky77200
Franky77200 collected $10.88 from pot
Franky77200: doesn't show hand 
*** SUMMARY ***
Total pot $11.45 | Rake $0.57 
Board [9d As Ts Jd 6h]
Seat 1: BladeChen folded before Flop (didn't bet)
Seat 4: kotkas1000 folded before Flop (didn't bet)
Seat 5: Hit Pit folded on the River
Seat 6: Franky77200 (button) collected ($10.88)
Seat 7: matiko09 (small blind) folded before Flop
Seat 8: Kukuryzka (big blind) folded on the Flop
Seat 9: r4mz3s folded before Flop (didn't bet)





PokerStars Hand #155381348512:  Hold'em No Limit (€0.25/€0.50 EUR) - 2016/06/30 14:38:28 CET [2016/06/30 8:38:28 ET]
Table 'Vibeke II' 9-max Seat #8 is the button
Seat 4: acelacat111 (€31.26 in chips) 
Seat 5: mazefaka007 (€65.90 in chips) 
Seat 6: Kukuryzka (€60.40 in chips) 
Seat 7: matiko09 (€60.32 in chips) 
Seat 8: KABAL_ua (€50 in chips) 
acelacat111: posts small blind €0.25
mazefaka007: posts big blind €0.50
*** HOLE CARDS ***
Dealt to matiko09 [8h Tc]
Kukuryzka: raises €1 to €1.50
matiko09: folds 
KABAL_ua: folds 
acelacat111: calls €1.25
mazefaka007: folds 
*** FLOP *** [4s 7d 7h]
acelacat111: checks 
Kukuryzka: bets €1.66
acelacat111: calls €1.66
*** TURN *** [4s 7d 7h] [As]
acelacat111: checks 
Kukuryzka: checks 
*** RIVER *** [4s 7d 7h As] [Jh]
acelacat111: bets €6.48
Kukuryzka: folds 
Uncalled bet (€6.48) returned to acelacat111
acelacat111 collected €6.48 from pot
acelacat111: doesn't show hand 
*** SUMMARY ***
Total pot €6.82 | Rake €0.34 
Board [4s 7d 7h As Jh]
Seat 4: acelacat111 (small blind) collected (€6.48)
Seat 5: mazefaka007 (big blind) folded before Flop
Seat 6: Kukuryzka folded on the River
Seat 7: matiko09 folded before Flop (didn't bet)
Seat 8: KABAL_ua (button) folded before Flop (didn't bet)





PokerStars Hand #155381352096:  Hold'em No Limit ($0.50/$1.00 USD) - 2016/06/30 14:38:36 CET [2016/06/30 8:38:36 ET]
Table 'Asmodeus' 9-max Seat #4 is the button
Seat 3: matiko09 ($100 in chips) 
Seat 4: Ty Nick 420 ($109.06 in chips) 
Seat 5: sanr23 ($109.30 in chips) 
Seat 6: koutani7 ($80.53 in chips) 
Seat 7: aaronzzr ($149.30 in chips) 
Seat 8: Rafaello18 ($176.87 in chips) 
Seat 9: mbk88 ($162.06 in chips) 
sanr23: posts small blind $0.50
koutani7: posts big blind $1
DomiVY: sits out 
*** HOLE CARDS ***
Dealt to matiko09 [6s Ks]
aaronzzr: folds 
Rafaello18: folds 
mbk88: folds 
matiko09: folds 
Ty Nick 420: raises $1 to $2
sanr23: folds 
koutani7: folds 
Uncalled bet ($1) returned to Ty Nick 420
Ty Nick 420 collected $2.50 from pot
*** SUMMARY ***
Total pot $2.50 | Rake $0 
Seat 3: matiko09 folded before Flop (didn't bet)
Seat 4: Ty Nick 420 (button) collected ($2.50)
Seat 5: sanr23 (small blind) folded before Flop
Seat 6: koutani7 (big blind) folded before Flop
Seat 7: aaronzzr folded before Flop (didn't bet)
Seat 8: Rafaello18 folded before Flop (didn't bet)
Seat 9: mbk88 folded before Flop (didn't bet)





PokerStars Hand #155381353453:  Hold'em No Limit ($0.50/$1.00 USD) - 2016/06/30 14:38:39 CET [2016/06/30 8:38:39 ET]
Table 'Tatjana' 9-max Seat #9 is the button
Seat 1: tipner ($100 in chips) 
Seat 2: Kukuryzka ($100 in chips) 
Seat 3: Rafaello18 ($100 in chips) 
Seat 4: mopatron25 ($118.81 in chips) 
Seat 5: matiko09 ($113.64 in chips) 
Seat 6: mbk88 ($155.54 in chips) 
Seat 8: alhill86 ($147.06 in chips) 
Seat 9: Ty Nick 420 ($100 in chips) 
tipner: posts small blind $0.50
Kukuryzka: posts big blind $1
*** HOLE CARDS ***
Dealt to matiko09 [Ad 9h]
Rafaello18: folds 
mopatron25: calls $1
matiko09: folds 
mbk88: folds 
alhill86: folds 
Ty Nick 420: folds 
tipner: folds 
Kukuryzka: checks 
*** FLOP *** [Qh 5d Kh]
Kukuryzka: checks 
mopatron25: bets $2
Kukuryzka: calls $2
*** TURN *** [Qh 5d Kh] [9s]
Kukuryzka: checks 
mopatron25: bets $3
Kukuryzka: calls $3
*** RIVER *** [Qh 5d Kh 9s] [2c]
Kukuryzka: checks 
mopatron25: checks 
*** SHOW DOWN ***
Kukuryzka: shows [Kc 8s] (a pair of Kings)
mopatron25: mucks hand 
Kukuryzka collected $11.88 from pot
*** SUMMARY ***
Total pot $12.50 | Rake $0.62 
Board [Qh 5d Kh 9s 2c]
Seat 1: tipner (small blind) folded before Flop
Seat 2: Kukuryzka (big blind) showed [Kc 8s] and won ($11.88) with a pair of Kings
Seat 3: Rafaello18 folded before Flop (didn't bet)
Seat 4: mopatron25 mucked [Jc 5s]
Seat 5: matiko09 folded before Flop (didn't bet)
Seat 6: mbk88 folded before Flop (didn't bet)
Seat 8: alhill86 folded before Flop (didn't bet)
Seat 9: Ty Nick 420 (button) folded before Flop (didn't bet)





PokerStars Hand #155381353788:  Hold'em No Limit ($0.50/$1.00 USD) - 2016/06/30 14:38:39 CET [2016/06/30 8:38:39 ET]
Table 'Sigrid' 9-max Seat #1 is the button
Seat 1: Greha999 ($52.44 in chips) 
Seat 2: matiko09 ($104.16 in chips) 
Seat 3: Rafaello18 ($115.13 in chips) 
Seat 4: mbk88 ($105.55 in chips) 
Seat 5: chenconhaste ($101.50 in chips) 
Seat 7: arctur17 ($128.44 in chips) 
Seat 8: ruslik_by ($100.32 in chips) 
Seat 9: KovIFish89 ($100 in chips) 
matiko09: posts small blind $0.50
Rafaello18: posts big blind $1
*** HOLE CARDS ***
Dealt to matiko09 [5s Ac]
mbk88: folds 
chenconhaste: folds 
arctur17: raises $2 to $3
ruslik_by: folds 
KovIFish89: calls $3
Greha999: folds 
matiko09: folds 
Rafaello18: folds 
*** FLOP *** [Kh 9d Qs]
arctur17: checks 
KovIFish89: checks 
*** TURN *** [Kh 9d Qs] [2c]
arctur17: checks 
KovIFish89: bets $4
arctur17: folds 
Uncalled bet ($4) returned to KovIFish89
KovIFish89 collected $7.12 from pot
KovIFish89: doesn't show hand 
*** SUMMARY ***
Total pot $7.50 | Rake $0.38 
Board [Kh 9d Qs 2c]
Seat 1: Greha999 (button) folded before Flop (didn't bet)
Seat 2: matiko09 (small blind) folded before Flop
Seat 3: Rafaello18 (big blind) folded before Flop
Seat 4: mbk88 folded before Flop (didn't bet)
Seat 5: chenconhaste folded before Flop (didn't bet)
Seat 7: arctur17 folded on the Turn
Seat 8: ruslik_by folded before Flop (didn't bet)
Seat 9: KovIFish89 collected ($7.12)





PokerStars Hand #155381359543:  Hold'em No Limit ($0.50/$1.00 USD) - 2016/06/30 14:38:51 CET [2016/06/30 8:38:51 ET]
Table 'California II' 9-max Seat #3 is the button
Seat 1: Rafaello18 ($100 in chips) 
Seat 2: ruslik_by ($148.31 in chips) 
Seat 3: KovIFish89 ($113.22 in chips) 
Seat 4: f1reworks ($100 in chips) 
Seat 5: Rohitbarve ($110.27 in chips) 
Seat 6: matiko09 ($131.48 in chips) 
Seat 7: DomiVY ($89.88 in chips) 
Seat 8: chenconhaste ($102.50 in chips) 
Seat 9: di0d80 ($103.37 in chips) 
f1reworks: posts small blind $0.50
Rohitbarve: posts big blind $1
*** HOLE CARDS ***
Dealt to matiko09 [Ad 4d]
matiko09: folds 
DomiVY: folds 
chenconhaste: folds 
di0d80: folds 
Rafaello18: folds 
ruslik_by: folds 
KovIFish89: folds 
f1reworks: raises $2 to $3
Rohitbarve: folds 
Uncalled bet ($2) returned to f1reworks
f1reworks collected $2 from pot
f1reworks: doesn't show hand 
*** SUMMARY ***
Total pot $2 | Rake $0 
Seat 1: Rafaello18 folded before Flop (didn't bet)
Seat 2: ruslik_by folded before Flop (didn't bet)
Seat 3: KovIFish89 (button) folded before Flop (didn't bet)
Seat 4: f1reworks (small blind) collected ($2)
Seat 5: Rohitbarve (big blind) folded before Flop
Seat 6: matiko09 folded before Flop (didn't bet)
Seat 7: DomiVY folded before Flop (didn't bet)
Seat 8: chenconhaste folded before Flop (didn't bet)
Seat 9: di0d80 folded before Flop (didn't bet)





PokerStars Hand #155381359714:  Hold'em No Limit ($0.25/$0.50 USD) - 2016/06/30 14:38:52 CET [2016/06/30 8:38:52 ET]
Table 'Arcturus' 9-max Seat #1 is the button
Seat 1: kourk250 ($140.84 in chips) 
Seat 2: Rafaello18 ($50 in chips) 
Seat 3: matiko09 ($61.20 in chips) 
Seat 5: stockbridge8 ($31.92 in chips) 
Seat 6: statistik85 ($63.66 in chips) 
Seat 7: bratbugor ($50.51 in chips) 
Seat 8: TheMinion ($64.28 in chips) 
Seat 9: joker180785 ($50 in chips) 
Rafaello18: posts small blind $0.25
matiko09: posts big blind $0.50
*** HOLE CARDS ***
Dealt to matiko09 [Jd 5h]
stockbridge8: folds 
statistik85: folds 
bratbugor: folds 
TheMinion: folds 
joker180785: folds 
kourk250: folds 
Rafaello18: raises $0.75 to $1.25
matiko09: folds 
Uncalled bet ($0.75) returned to Rafaello18
Rafaello18 collected $1 from pot
Rafaello18: doesn't show hand 
*** SUMMARY ***
Total pot $1 | Rake $0 
Seat 1: kourk250 (button) folded before Flop (didn't bet)
Seat 2: Rafaello18 (small blind) collected ($1)
Seat 3: matiko09 (big blind) folded before Flop
Seat 5: stockbridge8 folded before Flop (didn't bet)
Seat 6: statistik85 folded before Flop (didn't bet)
Seat 7: bratbugor folded before Flop (didn't bet)
Seat 8: TheMinion folded before Flop (didn't bet)
Seat 9: joker180785 folded before Flop (didn't bet)





PokerStars Hand #155381360669:  Hold'em No Limit ($0.50/$1.00 USD) - 2016/06/30 14:38:54 CET [2016/06/30 8:38:54 ET]
Table 'Donnera' 9-max Seat #6 is the button
Seat 1: chenconhaste ($113.06 in chips) 
Seat 2: robbiescrim9 ($97.56 in chips) 
Seat 3: matiko09 ($106.82 in chips) 
Seat 4: Kukuryzka ($102.50 in chips) 
Seat 5: tipner ($110.90 in chips) 
Seat 6: nickreason17 ($100 in chips) 
Seat 7: Rafaello18 ($131.30 in chips) 
Seat 8: ruslik_by ($200.98 in chips) 
Seat 9: Starw!nd ($119.25 in chips) 
Rafaello18: posts small blind $0.50
ruslik_by: posts big blind $1
*** HOLE CARDS ***
Dealt to matiko09 [6s Jc]
Starw!nd: folds 
chenconhaste: folds 
robbiescrim9: calls $1
matiko09: folds 
Kukuryzka: folds 
tipner: folds 
nickreason17: raises $2.50 to $3.50
Rafaello18: folds 
ruslik_by: raises $7 to $10.50
robbiescrim9: folds 
nickreason17: calls $7
*** FLOP *** [4d Js 9d]
ruslik_by: bets $10.69
nickreason17: folds 
Uncalled bet ($10.69) returned to ruslik_by
ruslik_by collected $21.38 from pot
ruslik_by: doesn't show hand 
*** SUMMARY ***
Total pot $22.50 | Rake $1.12 
Board [4d Js 9d]
Seat 1: chenconhaste folded before Flop (didn't bet)
Seat 2: robbiescrim9 folded before Flop
Seat 3: matiko09 folded before Flop (didn't bet)
Seat 4: Kukuryzka folded before Flop (didn't bet)
Seat 5: tipner folded before Flop (didn't bet)
Seat 6: nickreason17 (button) folded on the Flop
Seat 7: Rafaello18 (small blind) folded before Flop
Seat 8: ruslik_by (big blind) collected ($21.38)
Seat 9: Starw!nd folded before Flop (didn't bet)





PokerStars Hand #155381376872:  Hold'em No Limit ($0.50/$1.00 USD) - 2016/06/30 14:39:08 CET [2016/06/30 8:39:08 ET]
Table 'Asmodeus' 9-max Seat #5 is the button
Seat 3: matiko09 ($100 in chips) 
Seat 4: Ty Nick 420 ($110.56 in chips) 
Seat 5: sanr23 ($108.80 in chips) 
Seat 6: koutani7 ($79.53 in chips) 
Seat 7: aaronzzr ($149.30 in chips) 
Seat 8: Rafaello18 ($176.87 in chips) 
Seat 9: mbk88 ($162.06 in chips) 
koutani7: posts small blind $0.50
aaronzzr: posts big blind $1
DomiVY: sits out 
*** HOLE CARDS ***
Dealt to matiko09 [Jh 3c]
Rafaello18: folds 
mbk88: folds 
matiko09: folds 
Ty Nick 420: folds 
sanr23: raises $1 to $2
koutani7: folds 
aaronzzr: raises $4 to $6
sanr23: folds 
Uncalled bet ($4) returned to aaronzzr
aaronzzr collected $4.50 from pot
aaronzzr: doesn't show hand 
*** SUMMARY ***
Total pot $4.50 | Rake $0 
Seat 3: matiko09 folded before Flop (didn't bet)
Seat 4: Ty Nick 420 folded before Flop (didn't bet)
Seat 5: sanr23 (button) folded before Flop
Seat 6: koutani7 (small blind) folded before Flop
Seat 7: aaronzzr (big blind) collected ($4.50)
Seat 8: Rafaello18 folded before Flop (didn't bet)
Seat 9: mbk88 folded before Flop (didn't bet)





PokerStars Hand #155381379618:  Hold'em No Limit ($0.50/$1.00 USD) - 2016/06/30 14:39:14 CET [2016/06/30 8:39:14 ET]
Table 'Borrelly II' 9-max Seat #1 is the button
Seat 1: Rafaello18 ($118.59 in chips) 
Seat 2: mbk88 ($100 in chips) 
Seat 4: DonRon_AT ($82.50 in chips) 
Seat 5: Ty Nick 420 ($102.50 in chips) 
Seat 6: m_michalec ($172.42 in chips) 
Seat 7: matiko09 ($175.86 in chips) 
Seat 8: Arjun A Raju ($134.12 in chips) 
Seat 9: ruslik_by ($107.92 in chips) 
mbk88: posts small blind $0.50
DonRon_AT: posts big blind $1
*** HOLE CARDS ***
Dealt to matiko09 [7s 8d]
Ty Nick 420: folds 
m_michalec: folds 
matiko09: folds 
Arjun A Raju: folds 
ruslik_by: folds 
Rafaello18: raises $1.50 to $2.50
mbk88: folds 
DonRon_AT: folds 
Uncalled bet ($1.50) returned to Rafaello18
Rafaello18 collected $2.50 from pot
Rafaello18: doesn't show hand 
*** SUMMARY ***
Total pot $2.50 | Rake $0 
Seat 1: Rafaello18 (button) collected ($2.50)
Seat 2: mbk88 (small blind) folded before Flop
Seat 4: DonRon_AT (big blind) folded before Flop
Seat 5: Ty Nick 420 folded before Flop (didn't bet)
Seat 6: m_michalec folded before Flop (didn't bet)
Seat 7: matiko09 folded before Flop (didn't bet)
Seat 8: Arjun A Raju folded before Flop (didn't bet)
Seat 9: ruslik_by folded before Flop (didn't bet)





PokerStars Hand #155381382556:  Hold'em No Limit (€0.25/€0.50 EUR) - 2016/06/30 14:39:20 CET [2016/06/30 8:39:20 ET]
Table 'Vibeke II' 9-max Seat #4 is the button
Seat 4: acelacat111 (€34.58 in chips) 
Seat 5: mazefaka007 (€65.40 in chips) 
Seat 6: Kukuryzka (€57.24 in chips) 
Seat 7: matiko09 (€60.32 in chips) 
Seat 8: KABAL_ua (€50 in chips) 
mazefaka007: posts small blind €0.25
Kukuryzka: posts big blind €0.50
*** HOLE CARDS ***
Dealt to matiko09 [4s Qs]
matiko09: folds 
KABAL_ua: folds 
acelacat111: raises €1 to €1.50
mazefaka007: folds 
Kukuryzka: folds 
Uncalled bet (€1) returned to acelacat111
acelacat111 collected €1.25 from pot
acelacat111: doesn't show hand 
*** SUMMARY ***
Total pot €1.25 | Rake €0 
Seat 4: acelacat111 (button) collected (€1.25)
Seat 5: mazefaka007 (small blind) folded before Flop
Seat 6: Kukuryzka (big blind) folded before Flop
Seat 7: matiko09 folded before Flop (didn't bet)
Seat 8: KABAL_ua folded before Flop (didn't bet)





PokerStars Hand #155381383784:  Hold'em No Limit ($0.25/$0.50 USD) - 2016/06/30 14:39:22 CET [2016/06/30 8:39:22 ET]
Table 'Arcturus' 9-max Seat #2 is the button
Seat 1: kourk250 ($140.84 in chips) 
Seat 2: Rafaello18 ($50.50 in chips) 
Seat 3: matiko09 ($60.70 in chips) 
Seat 5: stockbridge8 ($50 in chips) 
Seat 6: statistik85 ($63.66 in chips) 
Seat 7: bratbugor ($50.51 in chips) 
Seat 8: TheMinion ($64.28 in chips) 
Seat 9: joker180785 ($50 in chips) 
matiko09: posts small blind $0.25
stockbridge8: posts big blind $0.50
*** HOLE CARDS ***
Dealt to matiko09 [8s 4h]
statistik85: folds 
bratbugor: folds 
TheMinion: folds 
statistik85 leaves the table
joker180785: folds 
kotkas1000 joins the table at seat #6 
kourk250: raises $0.50 to $1
kotkas1000 leaves the table
Rafaello18: folds 
sanr23 joins the table at seat #6 
matiko09: folds 
stockbridge8: folds 
Uncalled bet ($0.50) returned to kourk250
kourk250 collected $1.25 from pot
kourk250: doesn't show hand 
*** SUMMARY ***
Total pot $1.25 | Rake $0 
Seat 1: kourk250 collected ($1.25)
Seat 2: Rafaello18 (button) folded before Flop (didn't bet)
Seat 3: matiko09 (small blind) folded before Flop
Seat 5: stockbridge8 (big blind) folded before Flop
Seat 6: statistik85 folded before Flop (didn't bet)
Seat 7: bratbugor folded before Flop (didn't bet)
Seat 8: TheMinion folded before Flop (didn't bet)
Seat 9: joker180785 folded before Flop (didn't bet)





PokerStars Hand #155381391886:  Hold'em No Limit ($0.50/$1.00 USD) - 2016/06/30 14:39:39 CET [2016/06/30 8:39:39 ET]
Table 'Tatjana' 9-max Seat #1 is the button
Seat 1: tipner ($100 in chips) 
Seat 2: Kukuryzka ($105.88 in chips) 
Seat 3: Rafaello18 ($100 in chips) 
Seat 4: mopatron25 ($112.81 in chips) 
Seat 5: matiko09 ($113.64 in chips) 
Seat 6: mbk88 ($155.54 in chips) 
Seat 8: alhill86 ($147.06 in chips) 
Seat 9: Ty Nick 420 ($100 in chips) 
Kukuryzka: posts small blind $0.50
Rafaello18: posts big blind $1
*** HOLE CARDS ***
Dealt to matiko09 [7h 9d]
mopatron25: folds 
matiko09: folds 
mbk88: raises $2 to $3
alhill86: folds 
Ty Nick 420: folds 
tipner: folds 
Kukuryzka: folds 
Rafaello18: folds 
Uncalled bet ($2) returned to mbk88
mbk88 collected $2.50 from pot
mbk88: doesn't show hand 
*** SUMMARY ***
Total pot $2.50 | Rake $0 
Seat 1: tipner (button) folded before Flop (didn't bet)
Seat 2: Kukuryzka (small blind) folded before Flop
Seat 3: Rafaello18 (big blind) folded before Flop
Seat 4: mopatron25 folded before Flop (didn't bet)
Seat 5: matiko09 folded before Flop (didn't bet)
Seat 6: mbk88 collected ($2.50)
Seat 8: alhill86 folded before Flop (didn't bet)
Seat 9: Ty Nick 420 folded before Flop (didn't bet)





PokerStars Hand #155381392305:  Hold'em No Limit ($0.50/$1.00 USD) - 2016/06/30 14:39:40 CET [2016/06/30 8:39:40 ET]
Table 'Asmodeus' 9-max Seat #6 is the button
Seat 3: matiko09 ($100 in chips) 
Seat 4: Ty Nick 420 ($110.56 in chips) 
Seat 5: sanr23 ($106.80 in chips) 
Seat 6: koutani7 ($79.03 in chips) 
Seat 7: aaronzzr ($151.80 in chips) 
Seat 8: Rafaello18 ($176.87 in chips) 
Seat 9: mbk88 ($162.06 in chips) 
aaronzzr: posts small blind $0.50
Rafaello18: posts big blind $1
DomiVY: sits out 
*** HOLE CARDS ***
Dealt to matiko09 [Jh Jd]
mbk88: folds 
matiko09: raises $2 to $3
Ty Nick 420: folds 
sanr23: folds 
koutani7: folds 
aaronzzr: calls $2.50
Rafaello18: folds 
*** FLOP *** [2h 2s Kh]
aaronzzr: checks 
matiko09: checks 
*** TURN *** [2h 2s Kh] [8h]
aaronzzr: checks 
matiko09: bets $4.32
aaronzzr: folds 
Uncalled bet ($4.32) returned to matiko09
matiko09 collected $6.65 from pot
matiko09: doesn't show hand 
*** SUMMARY ***
Total pot $7 | Rake $0.35 
Board [2h 2s Kh 8h]
Seat 3: matiko09 collected ($6.65)
Seat 4: Ty Nick 420 folded before Flop (didn't bet)
Seat 5: sanr23 folded before Flop (didn't bet)
Seat 6: koutani7 (button) folded before Flop (didn't bet)
Seat 7: aaronzzr (small blind) folded on the Turn
Seat 8: Rafaello18 (big blind) folded before Flop
Seat 9: mbk88 folded before Flop (didn't bet)





PokerStars Hand #155381392620:  Hold'em No Limit ($0.25/$0.50 USD) - 2016/06/30 14:39:41 CET [2016/06/30 8:39:41 ET]
Table 'Thalia II' 9-max Seat #3 is the button
Seat 2: DeathcorePkr ($54.84 in chips) 
Seat 3: r4mz3s ($74.32 in chips) 
Seat 4: Kukuryzka ($54.52 in chips) 
Seat 5: geowin ($63.61 in chips) 
Seat 6: chenconhaste ($51.20 in chips) 
Seat 7: fudzi ($57.93 in chips) 
Seat 8: Jo_Medici ($50 in chips) 
Seat 9: matiko09 ($50 in chips) 
Kukuryzka: posts small blind $0.25
geowin: posts big blind $0.50
DeathcorePkr: posts the ante $0.10
r4mz3s: posts the ante $0.10
Kukuryzka: posts the ante $0.10
geowin: posts the ante $0.10
chenconhaste: posts the ante $0.10
fudzi: posts the ante $0.10
Jo_Medici: posts the ante $0.10
matiko09: posts the ante $0.10
*** HOLE CARDS ***
Dealt to matiko09 [3d 6c]
chenconhaste: folds 
fudzi: raises $1 to $1.50
Jo_Medici: folds 
matiko09: folds 
DeathcorePkr: folds 
r4mz3s: folds 
Kukuryzka: folds 
geowin: raises $1 to $2.50
fudzi: raises $6.05 to $8.55
geowin: calls $6.05
*** FLOP *** [Jd 4h Jc]
geowin: bets $0.50
fudzi: calls $0.50
*** TURN *** [Jd 4h Jc] [9s]
geowin: bets $0.50
fudzi: raises $9.59 to $10.09
geowin: folds 
Uncalled bet ($9.59) returned to fudzi
fudzi collected $19.14 from pot
fudzi: doesn't show hand 
*** SUMMARY ***
Total pot $20.15 | Rake $1.01 
Board [Jd 4h Jc 9s]
Seat 2: DeathcorePkr folded before Flop (didn't bet)
Seat 3: r4mz3s (button) folded before Flop (didn't bet)
Seat 4: Kukuryzka (small blind) folded before Flop
Seat 5: geowin (big blind) folded on the Turn
Seat 6: chenconhaste folded before Flop (didn't bet)
Seat 7: fudzi collected ($19.14)
Seat 8: Jo_Medici folded before Flop (didn't bet)
Seat 9: matiko09 folded before Flop (didn't bet)





PokerStars Hand #155381393405:  Hold'em No Limit ($0.50/$1.00 USD) - 2016/06/30 14:39:42 CET [2016/06/30 8:39:42 ET]
Table 'Borrelly II' 9-max Seat #2 is the button
Seat 1: Rafaello18 ($120.09 in chips) 
Seat 2: mbk88 ($100 in chips) 
Seat 4: DonRon_AT ($81.50 in chips) 
Seat 5: Ty Nick 420 ($102.50 in chips) 
Seat 6: m_michalec ($172.42 in chips) 
Seat 7: matiko09 ($175.86 in chips) 
Seat 8: Arjun A Raju ($134.12 in chips) 
Seat 9: ruslik_by ($107.92 in chips) 
DonRon_AT: posts small blind $0.50
Ty Nick 420: posts big blind $1
*** HOLE CARDS ***
Dealt to matiko09 [6d Qd]
m_michalec: folds 
matiko09: folds 
Arjun A Raju: folds 
ruslik_by: folds 
Rafaello18: folds 
mbk88: folds 
DonRon_AT: folds 
Uncalled bet ($0.50) returned to Ty Nick 420
Ty Nick 420 collected $1 from pot
*** SUMMARY ***
Total pot $1 | Rake $0 
Seat 1: Rafaello18 folded before Flop (didn't bet)
Seat 2: mbk88 (button) folded before Flop (didn't bet)
Seat 4: DonRon_AT (small blind) folded before Flop
Seat 5: Ty Nick 420 (big blind) collected ($1)
Seat 6: m_michalec folded before Flop (didn't bet)
Seat 7: matiko09 folded before Flop (didn't bet)
Seat 8: Arjun A Raju folded before Flop (didn't bet)
Seat 9: ruslik_by folded before Flop (didn't bet)





PokerStars Hand #155381393444:  Hold'em No Limit ($0.50/$1.00 USD) - 2016/06/30 14:39:42 CET [2016/06/30 8:39:42 ET]
Table 'Donnera' 9-max Seat #7 is the button
Seat 1: chenconhaste ($113.06 in chips) 
Seat 2: robbiescrim9 ($96.56 in chips) 
Seat 3: matiko09 ($106.82 in chips) 
Seat 4: Kukuryzka ($102.50 in chips) 
Seat 5: tipner ($110.90 in chips) 
Seat 6: nickreason17 ($100 in chips) 
Seat 7: Rafaello18 ($130.80 in chips) 
Seat 8: ruslik_by ($211.86 in chips) 
Seat 9: Starw!nd ($119.25 in chips) 
ruslik_by: posts small blind $0.50
Starw!nd: posts big blind $1
*** HOLE CARDS ***
Dealt to matiko09 [7h Jd]
chenconhaste: folds 
robbiescrim9: calls $1
matiko09: folds 
Kukuryzka: folds 
tipner: folds 
nickreason17: folds 
Rafaello18: folds 
ruslik_by: calls $0.50
Starw!nd: checks 
*** FLOP *** [Ah 2h Qs]
ruslik_by: checks 
Starw!nd: checks 
robbiescrim9: checks 
*** TURN *** [Ah 2h Qs] [Ts]
ruslik_by: bets $1.42
Starw!nd: folds 
robbiescrim9: calls $1.42
*** RIVER *** [Ah 2h Qs Ts] [9s]
ruslik_by: checks 
robbiescrim9: bets $5.55
ruslik_by: folds 
Uncalled bet ($5.55) returned to robbiescrim9
robbiescrim9 collected $5.55 from pot
robbiescrim9: doesn't show hand 
*** SUMMARY ***
Total pot $5.84 | Rake $0.29 
Board [Ah 2h Qs Ts 9s]
Seat 1: chenconhaste folded before Flop (didn't bet)
Seat 2: robbiescrim9 collected ($5.55)
Seat 3: matiko09 folded before Flop (didn't bet)
Seat 4: Kukuryzka folded before Flop (didn't bet)
Seat 5: tipner folded before Flop (didn't bet)
Seat 6: nickreason17 folded before Flop (didn't bet)
Seat 7: Rafaello18 (button) folded before Flop (didn't bet)
Seat 8: ruslik_by (small blind) folded on the River
Seat 9: Starw!nd (big blind) folded on the Turn





PokerStars Hand #155381394483:  Hold'em No Limit ($0.50/$1.00 USD) - 2016/06/30 14:39:44 CET [2016/06/30 8:39:44 ET]
Table 'California II' 9-max Seat #4 is the button
Seat 1: Rafaello18 ($100 in chips) 
Seat 2: ruslik_by ($148.31 in chips) 
Seat 3: KovIFish89 ($113.22 in chips) 
Seat 4: f1reworks ($101 in chips) 
Seat 5: Rohitbarve ($109.27 in chips) 
Seat 6: matiko09 ($131.48 in chips) 
Seat 7: DomiVY ($89.88 in chips) 
Seat 8: chenconhaste ($102.50 in chips) 
Seat 9: di0d80 ($103.37 in chips) 
Rohitbarve: posts small blind $0.50
matiko09: posts big blind $1
*** HOLE CARDS ***
Dealt to matiko09 [Tc 7h]
DomiVY: folds 
chenconhaste: raises $1.25 to $2.25
di0d80: folds 
Rafaello18: folds 
ruslik_by: folds 
KovIFish89: folds 
f1reworks: folds 
Rohitbarve: folds 
matiko09: folds 
Uncalled bet ($1.25) returned to chenconhaste
chenconhaste collected $2.50 from pot
*** SUMMARY ***
Total pot $2.50 | Rake $0 
Seat 1: Rafaello18 folded before Flop (didn't bet)
Seat 2: ruslik_by folded before Flop (didn't bet)
Seat 3: KovIFish89 folded before Flop (didn't bet)
Seat 4: f1reworks (button) folded before Flop (didn't bet)
Seat 5: Rohitbarve (small blind) folded before Flop
Seat 6: matiko09 (big blind) folded before Flop
Seat 7: DomiVY folded before Flop (didn't bet)
Seat 8: chenconhaste collected ($2.50)
Seat 9: di0d80 folded before Flop (didn't bet)





PokerStars Hand #155381395069:  Hold'em No Limit (€0.25/€0.50 EUR) - 2016/06/30 14:39:46 CET [2016/06/30 8:39:46 ET]
Table 'Vibeke II' 9-max Seat #5 is the button
Seat 4: acelacat111 (€35.33 in chips) 
Seat 5: mazefaka007 (€65.15 in chips) 
Seat 6: Kukuryzka (€56.74 in chips) 
Seat 7: matiko09 (€60.32 in chips) 
Seat 8: KABAL_ua (€50 in chips) 
Kukuryzka: posts small blind €0.25
matiko09: posts big blind €0.50
funXmun: sits out 
*** HOLE CARDS ***
Dealt to matiko09 [Qd Jd]
KABAL_ua: folds 
acelacat111: folds 
KABAL_ua leaves the table
mazefaka007: raises €0.55 to €1.05
Kukuryzka: folds 
matiko09: calls €0.55
*** FLOP *** [Th 5h 7h]
matiko09: checks 
mazefaka007: checks 
*** TURN *** [Th 5h 7h] [2d]
matiko09: checks 
mazefaka007: bets €1.56
matiko09: folds 
Uncalled bet (€1.56) returned to mazefaka007
mazefaka007 collected €2.23 from pot
mazefaka007: doesn't show hand 
*** SUMMARY ***
Total pot €2.35 | Rake €0.12 
Board [Th 5h 7h 2d]
Seat 4: acelacat111 folded before Flop (didn't bet)
Seat 5: mazefaka007 (button) collected (€2.23)
Seat 6: Kukuryzka (small blind) folded before Flop
Seat 7: matiko09 (big blind) folded on the Turn
Seat 8: KABAL_ua folded before Flop (didn't bet)





PokerStars Hand #155381398571:  Hold'em No Limit ($0.50/$1.00 USD) - 2016/06/30 14:39:53 CET [2016/06/30 8:39:53 ET]
Table 'Sigrid' 9-max Seat #2 is the button
Seat 1: Greha999 ($52.44 in chips) 
Seat 2: matiko09 ($103.66 in chips) 
Seat 3: Rafaello18 ($114.13 in chips) 
Seat 4: mbk88 ($105.55 in chips) 
Seat 5: chenconhaste ($101.50 in chips) 
Seat 7: arctur17 ($125.44 in chips) 
Seat 8: ruslik_by ($100.32 in chips) 
Seat 9: KovIFish89 ($104.12 in chips) 
Rafaello18: posts small blind $0.50
mbk88: posts big blind $1
*** HOLE CARDS ***
Dealt to matiko09 [Qh 2c]
chenconhaste: folds 
arctur17: folds 
ruslik_by: raises $2 to $3
KovIFish89: folds 
Greha999: folds 
matiko09: folds 
Rafaello18: folds 
mbk88: folds 
Uncalled bet ($2) returned to ruslik_by
ruslik_by collected $2.50 from pot
ruslik_by: doesn't show hand 
*** SUMMARY ***
Total pot $2.50 | Rake $0 
Seat 1: Greha999 folded before Flop (didn't bet)
Seat 2: matiko09 (button) folded before Flop (didn't bet)
Seat 3: Rafaello18 (small blind) folded before Flop
Seat 4: mbk88 (big blind) folded before Flop
Seat 5: chenconhaste folded before Flop (didn't bet)
Seat 7: arctur17 folded before Flop (didn't bet)
Seat 8: ruslik_by collected ($2.50)
Seat 9: KovIFish89 folded before Flop (didn't bet)





PokerStars Hand #155381402882:  Hold'em No Limit ($0.25/$0.50 USD) - 2016/06/30 14:40:02 CET [2016/06/30 8:40:02 ET]
Table 'Chort III' 9-max Seat #7 is the button
Seat 1: BladeChen ($71.56 in chips) 
Seat 4: kotkas1000 ($50.20 in chips) 
Seat 5: Hit Pit ($30.96 in chips) 
Seat 6: Franky77200 ($29.37 in chips) 
Seat 7: matiko09 ($50 in chips) 
Seat 8: Kukuryzka ($50 in chips) 
Seat 9: r4mz3s ($50 in chips) 
Kukuryzka: posts small blind $0.25
r4mz3s: posts big blind $0.50
BladeChen: posts the ante $0.10
kotkas1000: posts the ante $0.10
Hit Pit: posts the ante $0.10
Franky77200: posts the ante $0.10
matiko09: posts the ante $0.10
Kukuryzka: posts the ante $0.10
r4mz3s: posts the ante $0.10
*** HOLE CARDS ***
Dealt to matiko09 [5d 9h]
BladeChen: raises $0.50 to $1
kotkas1000: folds 
Hit Pit: folds 
Franky77200: folds 
matiko09: folds 
Kukuryzka: folds 
r4mz3s: calls $0.50
*** FLOP *** [Kc 6s Kd]
r4mz3s: checks 
BladeChen: bets $1.50
r4mz3s: folds 
Uncalled bet ($1.50) returned to BladeChen
BladeChen collected $2.80 from pot
BladeChen: doesn't show hand 
*** SUMMARY ***
Total pot $2.95 | Rake $0.15 
Board [Kc 6s Kd]
Seat 1: BladeChen collected ($2.80)
Seat 4: kotkas1000 folded before Flop (didn't bet)
Seat 5: Hit Pit folded before Flop (didn't bet)
Seat 6: Franky77200 folded before Flop (didn't bet)
Seat 7: matiko09 (button) folded before Flop (didn't bet)
Seat 8: Kukuryzka (small blind) folded before Flop
Seat 9: r4mz3s (big blind) folded on the Flop





PokerStars Hand #155381403602:  Hold'em No Limit ($0.25/$0.50 USD) - 2016/06/30 14:40:03 CET [2016/06/30 8:40:03 ET]
Table 'Arcturus' 9-max Seat #3 is the button
Seat 1: kourk250 ($141.59 in chips) 
Seat 2: Rafaello18 ($50.50 in chips) 
Seat 3: matiko09 ($60.45 in chips) 
Seat 5: stockbridge8 ($49.50 in chips) 
Seat 6: sanr23 ($52.06 in chips) 
Seat 7: bratbugor ($50.51 in chips) 
Seat 8: TheMinion ($64.28 in chips) 
Seat 9: joker180785 ($50 in chips) 
stockbridge8: posts small blind $0.25
sanr23: posts big blind $0.50
*** HOLE CARDS ***
Dealt to matiko09 [6h 6d]
bratbugor: folds 
TheMinion: folds 
joker180785: folds 
kourk250: folds 
Rafaello18: raises $0.75 to $1.25
matiko09: calls $1.25
stockbridge8: folds 
sanr23: folds 
*** FLOP *** [4h Ah 9c]
Rafaello18: checks 
matiko09: checks 
*** TURN *** [4h Ah 9c] [Qd]
Rafaello18: bets $2
matiko09: folds 
Uncalled bet ($2) returned to Rafaello18
Rafaello18 collected $3.09 from pot
Rafaello18: doesn't show hand 
*** SUMMARY ***
Total pot $3.25 | Rake $0.16 
Board [4h Ah 9c Qd]
Seat 1: kourk250 folded before Flop (didn't bet)
Seat 2: Rafaello18 collected ($3.09)
Seat 3: matiko09 (button) folded on the Turn
Seat 5: stockbridge8 (small blind) folded before Flop
Seat 6: sanr23 (big blind) folded before Flop
Seat 7: bratbugor folded before Flop (didn't bet)
Seat 8: TheMinion folded before Flop (didn't bet)
Seat 9: joker180785 folded before Flop (didn't bet)





PokerStars Hand #155381411368:  Hold'em No Limit ($0.50/$1.00 USD) - 2016/06/30 14:40:20 CET [2016/06/30 8:40:20 ET]
Table 'Altarf II' 9-max Seat #7 is the button
Seat 1: Rafaello18 ($107.18 in chips) 
Seat 2: KovIFish89 ($100 in chips) 
Seat 3: sanr23 ($167.96 in chips) 
Seat 4: Greha999 ($145.38 in chips) 
Seat 6: mbk88 ($174.68 in chips) 
Seat 7: matiko09 ($109.22 in chips) 
Seat 8: DomiVY ($40 in chips) 
Seat 9: omanibemihum ($158.92 in chips) 
DomiVY: posts small blind $0.50
omanibemihum: posts big blind $1
*** HOLE CARDS ***
Dealt to matiko09 [6s Qs]
Rafaello18: folds 
KovIFish89: folds 
sanr23: folds 
Greha999: folds 
mbk88: folds 
matiko09: folds 
DomiVY: raises $1.10 to $2.10
omanibemihum: calls $1.10
*** FLOP *** [3d Td 2d]
DomiVY: bets $3
omanibemihum: folds 
Uncalled bet ($3) returned to DomiVY
DomiVY collected $3.99 from pot
DomiVY: doesn't show hand 
*** SUMMARY ***
Total pot $4.20 | Rake $0.21 
Board [3d Td 2d]
Seat 1: Rafaello18 folded before Flop (didn't bet)
Seat 2: KovIFish89 folded before Flop (didn't bet)
Seat 3: sanr23 folded before Flop (didn't bet)
Seat 4: Greha999 folded before Flop (didn't bet)
Seat 6: mbk88 folded before Flop (didn't bet)
Seat 7: matiko09 (button) folded before Flop (didn't bet)
Seat 8: DomiVY (small blind) collected ($3.99)
Seat 9: omanibemihum (big blind) folded on the Flop





PokerStars Hand #155381414697:  Hold'em No Limit ($0.50/$1.00 USD) - 2016/06/30 14:40:26 CET [2016/06/30 8:40:26 ET]
Table 'California II' 9-max Seat #5 is the button
Seat 1: Rafaello18 ($100 in chips) 
Seat 2: ruslik_by ($148.31 in chips) 
Seat 3: KovIFish89 ($113.22 in chips) 
Seat 4: f1reworks ($101 in chips) 
Seat 5: Rohitbarve ($108.77 in chips) 
Seat 6: matiko09 ($130.48 in chips) 
Seat 7: DomiVY ($89.88 in chips) 
Seat 8: chenconhaste ($104 in chips) 
Seat 9: di0d80 ($103.37 in chips) 
matiko09: posts small blind $0.50
DomiVY: posts big blind $1
*** HOLE CARDS ***
Dealt to matiko09 [2h Td]
chenconhaste: folds 
di0d80: folds 
Rafaello18: folds 
ruslik_by: raises $2 to $3
KovIFish89: folds 
f1reworks: folds 
Rohitbarve: folds 
matiko09: folds 
DomiVY: folds 
Uncalled bet ($2) returned to ruslik_by
ruslik_by collected $2.50 from pot
ruslik_by: doesn't show hand 
*** SUMMARY ***
Total pot $2.50 | Rake $0 
Seat 1: Rafaello18 folded before Flop (didn't bet)
Seat 2: ruslik_by collected ($2.50)
Seat 3: KovIFish89 folded before Flop (didn't bet)
Seat 4: f1reworks folded before Flop (didn't bet)
Seat 5: Rohitbarve (button) folded before Flop (didn't bet)
Seat 6: matiko09 (small blind) folded before Flop
Seat 7: DomiVY (big blind) folded before Flop
Seat 8: chenconhaste folded before Flop (didn't bet)
Seat 9: di0d80 folded before Flop (didn't bet)





PokerStars Hand #155381415207:  Hold'em No Limit ($0.50/$1.00 USD) - 2016/06/30 14:40:28 CET [2016/06/30 8:40:28 ET]
Table 'Tatjana' 9-max Seat #2 is the button
Seat 1: tipner ($100 in chips) 
Seat 2: Kukuryzka ($105.38 in chips) 
Seat 3: Rafaello18 ($100 in chips) 
Seat 4: mopatron25 ($112.81 in chips) 
Seat 5: matiko09 ($113.64 in chips) 
Seat 6: mbk88 ($157.04 in chips) 
Seat 8: alhill86 ($147.06 in chips) 
Seat 9: Ty Nick 420 ($100 in chips) 
Rafaello18: posts small blind $0.50
mopatron25: posts big blind $1
*** HOLE CARDS ***
Dealt to matiko09 [4s Th]
matiko09: folds 
mbk88: folds 
alhill86: raises $2 to $3
Ty Nick 420: folds 
tipner: folds 
Kukuryzka: folds 
Rafaello18: folds 
mopatron25: calls $2
*** FLOP *** [2h Ah 4h]
mopatron25: bets $1
alhill86: raises $5 to $6
mopatron25: calls $5
*** TURN *** [2h Ah 4h] [4c]
mopatron25: bets $3
alhill86: raises $10 to $13
mopatron25: calls $10
*** RIVER *** [2h Ah 4h 4c] [Ac]
mopatron25: bets $6
alhill86: raises $14 to $20
mopatron25: calls $14
*** SHOW DOWN ***
alhill86: shows [Jh As] (a full house, Aces full of Fours)
mopatron25: shows [Ad 5s] (a full house, Aces full of Fours)
mopatron25 collected $41 from pot
alhill86 collected $41 from pot
*** SUMMARY ***
Total pot $84.50 | Rake $2.50 
Board [2h Ah 4h 4c Ac]
Seat 1: tipner folded before Flop (didn't bet)
Seat 2: Kukuryzka (button) folded before Flop (didn't bet)
Seat 3: Rafaello18 (small blind) folded before Flop
Seat 4: mopatron25 (big blind) showed [Ad 5s] and won ($41) with a full house, Aces full of Fours
Seat 5: matiko09 folded before Flop (didn't bet)
Seat 6: mbk88 folded before Flop (didn't bet)
Seat 8: alhill86 showed [Jh As] and won ($41) with a full house, Aces full of Fours
Seat 9: Ty Nick 420 folded before Flop (didn't bet)





PokerStars Hand #155381418674:  Hold'em No Limit ($0.50/$1.00 USD) - 2016/06/30 14:40:34 CET [2016/06/30 8:40:34 ET]
Table 'Sigrid' 9-max Seat #3 is the button
Seat 1: Greha999 ($52.44 in chips) 
Seat 2: matiko09 ($103.66 in chips) 
Seat 3: Rafaello18 ($113.63 in chips) 
Seat 4: mbk88 ($104.55 in chips) 
Seat 5: chenconhaste ($101.50 in chips) 
Seat 7: arctur17 ($125.44 in chips) 
Seat 8: ruslik_by ($101.82 in chips) 
Seat 9: KovIFish89 ($104.12 in chips) 
mbk88: posts small blind $0.50
chenconhaste: posts big blind $1
*** HOLE CARDS ***
Dealt to matiko09 [6s Th]
arctur17: folds 
ruslik_by: folds 
KovIFish89: folds 
Greha999: folds 
matiko09: folds 
Rafaello18: raises $1.50 to $2.50
mbk88: folds 
chenconhaste: calls $1.50
*** FLOP *** [Ad Kc 9c]
chenconhaste: checks 
Rafaello18: bets $3
chenconhaste: folds 
Uncalled bet ($3) returned to Rafaello18
Rafaello18 collected $5.22 from pot
Rafaello18: doesn't show hand 
*** SUMMARY ***
Total pot $5.50 | Rake $0.28 
Board [Ad Kc 9c]
Seat 1: Greha999 folded before Flop (didn't bet)
Seat 2: matiko09 folded before Flop (didn't bet)
Seat 3: Rafaello18 (button) collected ($5.22)
Seat 4: mbk88 (small blind) folded before Flop
Seat 5: chenconhaste (big blind) folded on the Flop
Seat 7: arctur17 folded before Flop (didn't bet)
Seat 8: ruslik_by folded before Flop (didn't bet)
Seat 9: KovIFish89 folded before Flop (didn't bet)





PokerStars Hand #155381420003:  Hold'em No Limit ($0.50/$1.00 USD) - 2016/06/30 14:40:37 CET [2016/06/30 8:40:37 ET]
Table 'Borrelly II' 9-max Seat #4 is the button
Seat 1: Rafaello18 ($120.09 in chips) 
Seat 2: mbk88 ($100 in chips) 
Seat 4: DonRon_AT ($81 in chips) 
Seat 5: Ty Nick 420 ($103 in chips) 
Seat 6: m_michalec ($172.42 in chips) 
Seat 7: matiko09 ($175.86 in chips) 
Seat 8: Arjun A Raju ($134.12 in chips) 
Seat 9: ruslik_by ($107.92 in chips) 
Ty Nick 420: posts small blind $0.50
m_michalec: posts big blind $1
*** HOLE CARDS ***
Dealt to matiko09 [8s Jc]
matiko09: folds 
Arjun A Raju: folds 
ruslik_by: raises $2 to $3
Rafaello18: folds 
mbk88: folds 
DonRon_AT: calls $3
Ty Nick 420: folds 
m_michalec: calls $2
*** FLOP *** [6h 6s 2h]
m_michalec: checks 
ruslik_by: bets $4.51
DonRon_AT: calls $4.51
m_michalec: folds 
*** TURN *** [6h 6s 2h] [Ks]
ruslik_by: checks 
DonRon_AT: bets $8.79
ruslik_by: calls $8.79
*** RIVER *** [6h 6s 2h Ks] [8h]
ruslik_by: checks 
DonRon_AT: checks 
*** SHOW DOWN ***
ruslik_by: shows [5c 5s] (two pair, Sixes and Fives)
DonRon_AT: shows [6c Ac] (three of a kind, Sixes)
DonRon_AT collected $34.30 from pot
*** SUMMARY ***
Total pot $36.10 | Rake $1.80 
Board [6h 6s 2h Ks 8h]
Seat 1: Rafaello18 folded before Flop (didn't bet)
Seat 2: mbk88 folded before Flop (didn't bet)
Seat 4: DonRon_AT (button) showed [6c Ac] and won ($34.30) with three of a kind, Sixes
Seat 5: Ty Nick 420 (small blind) folded before Flop
Seat 6: m_michalec (big blind) folded on the Flop
Seat 7: matiko09 folded before Flop (didn't bet)
Seat 8: Arjun A Raju folded before Flop (didn't bet)
Seat 9: ruslik_by showed [5c 5s] and lost with two pair, Sixes and Fives





PokerStars Hand #155381420998:  Hold'em No Limit ($0.25/$0.50 USD) - 2016/06/30 14:40:39 CET [2016/06/30 8:40:39 ET]
Table 'Chort III' 9-max Seat #8 is the button
Seat 1: BladeChen ($73.26 in chips) 
Seat 4: kotkas1000 ($50.10 in chips) 
Seat 5: Hit Pit ($30.86 in chips) 
Seat 6: Franky77200 ($29.27 in chips) 
Seat 7: matiko09 ($50 in chips) 
Seat 8: Kukuryzka ($49.65 in chips) 
Seat 9: r4mz3s ($50 in chips) 
r4mz3s: posts small blind $0.25
BladeChen: posts big blind $0.50
BladeChen: posts the ante $0.10
kotkas1000: posts the ante $0.10
Hit Pit: posts the ante $0.10
Franky77200: posts the ante $0.10
matiko09: posts the ante $0.10
Kukuryzka: posts the ante $0.10
r4mz3s: posts the ante $0.10
*** HOLE CARDS ***
Dealt to matiko09 [Ad 3d]
kotkas1000: folds 
Hit Pit: folds 
Franky77200: folds 
matiko09: raises $1 to $1.50
Kukuryzka: folds 
r4mz3s: folds 
BladeChen: folds 
Uncalled bet ($1) returned to matiko09
matiko09 collected $1.95 from pot
matiko09: doesn't show hand 
*** SUMMARY ***
Total pot $1.95 | Rake $0 
Seat 1: BladeChen (big blind) folded before Flop
Seat 4: kotkas1000 folded before Flop (didn't bet)
Seat 5: Hit Pit folded before Flop (didn't bet)
Seat 6: Franky77200 folded before Flop (didn't bet)
Seat 7: matiko09 collected ($1.95)
Seat 8: Kukuryzka (button) folded before Flop (didn't bet)
Seat 9: r4mz3s (small blind) folded before Flop





PokerStars Hand #155381424210:  Hold'em No Limit ($0.50/$1.00 USD) - 2016/06/30 14:40:46 CET [2016/06/30 8:40:46 ET]
Table 'Asmodeus' 9-max Seat #7 is the button
Seat 3: matiko09 ($103.65 in chips) 
Seat 4: Ty Nick 420 ($110.56 in chips) 
Seat 5: sanr23 ($106.80 in chips) 
Seat 6: koutani7 ($79.03 in chips) 
Seat 7: aaronzzr ($148.80 in chips) 
Seat 8: Rafaello18 ($175.87 in chips) 
Seat 9: mbk88 ($162.06 in chips) 
Rafaello18: posts small blind $0.50
mbk88: posts big blind $1
DomiVY: sits out 
*** HOLE CARDS ***
Dealt to matiko09 [9h Js]
matiko09: folds 
Ty Nick 420: folds 
sanr23: folds 
koutani7: folds 
aaronzzr: folds 
Rafaello18: folds 
Uncalled bet ($0.50) returned to mbk88
mbk88 collected $1 from pot
mbk88: doesn't show hand 
*** SUMMARY ***
Total pot $1 | Rake $0 
Seat 3: matiko09 folded before Flop (didn't bet)
Seat 4: Ty Nick 420 folded before Flop (didn't bet)
Seat 5: sanr23 folded before Flop (didn't bet)
Seat 6: koutani7 folded before Flop (didn't bet)
Seat 7: aaronzzr (button) folded before Flop (didn't bet)
Seat 8: Rafaello18 (small blind) folded before Flop
Seat 9: mbk88 (big blind) collected ($1)





PokerStars Hand #155381428241:  Hold'em No Limit ($0.25/$0.50 USD) - 2016/06/30 14:40:54 CET [2016/06/30 8:40:54 ET]
Table 'Thalia II' 9-max Seat #4 is the button
Seat 2: DeathcorePkr ($54.74 in chips) 
Seat 3: r4mz3s ($74.22 in chips) 
Seat 4: Kukuryzka ($54.17 in chips) 
Seat 5: geowin ($53.96 in chips) 
Seat 6: chenconhaste ($51.10 in chips) 
Seat 7: fudzi ($67.42 in chips) 
Seat 8: Jo_Medici ($50 in chips) 
Seat 9: matiko09 ($50 in chips) 
geowin: posts small blind $0.25
chenconhaste: posts big blind $0.50
DeathcorePkr: posts the ante $0.10
r4mz3s: posts the ante $0.10
Kukuryzka: posts the ante $0.10
geowin: posts the ante $0.10
chenconhaste: posts the ante $0.10
fudzi: posts the ante $0.10
Jo_Medici: posts the ante $0.10
matiko09: posts the ante $0.10
*** HOLE CARDS ***
Dealt to matiko09 [8c As]
fudzi: folds 
Jo_Medici: folds 
matiko09: folds 
DeathcorePkr: folds 
r4mz3s: folds 
Kukuryzka: raises $0.50 to $1
geowin: calls $0.75
chenconhaste: calls $0.50
*** FLOP *** [8h Kh 6c]
matteo080613 is disconnected 
geowin: bets $0.50
chenconhaste: calls $0.50
Kukuryzka: calls $0.50
*** TURN *** [8h Kh 6c] [Ah]
geowin: checks 
chenconhaste: checks 
Kukuryzka: checks 
*** RIVER *** [8h Kh 6c Ah] [4c]
geowin: checks 
chenconhaste: checks 
Kukuryzka: checks 
*** SHOW DOWN ***
geowin: shows [5d 4h] (a pair of Fours)
chenconhaste: shows [8s Qc] (a pair of Eights)
Kukuryzka: mucks hand 
chenconhaste collected $5.04 from pot
*** SUMMARY ***
Total pot $5.30 | Rake $0.26 
Board [8h Kh 6c Ah 4c]
Seat 2: DeathcorePkr folded before Flop (didn't bet)
Seat 3: r4mz3s folded before Flop (didn't bet)
Seat 4: Kukuryzka (button) mucked [7s 6s]
Seat 5: geowin (small blind) showed [5d 4h] and lost with a pair of Fours
Seat 6: chenconhaste (big blind) showed [8s Qc] and won ($5.04) with a pair of Eights
Seat 7: fudzi folded before Flop (didn't bet)
Seat 8: Jo_Medici folded before Flop (didn't bet)
Seat 9: matiko09 folded before Flop (didn't bet)





PokerStars Hand #155381433961:  Hold'em No Limit ($0.25/$0.50 USD) - 2016/06/30 14:41:06 CET [2016/06/30 8:41:06 ET]
Table 'Chort III' 9-max Seat #9 is the button
Seat 1: BladeChen ($72.66 in chips) 
Seat 4: kotkas1000 ($50 in chips) 
Seat 5: Hit Pit ($30.76 in chips) 
Seat 6: Franky77200 ($29.17 in chips) 
Seat 7: matiko09 ($51.35 in chips) 
Seat 8: Kukuryzka ($49.55 in chips) 
Seat 9: r4mz3s ($50 in chips) 
BladeChen: posts small blind $0.25
kotkas1000: posts big blind $0.50
BladeChen: posts the ante $0.10
kotkas1000: posts the ante $0.10
Hit Pit: posts the ante $0.10
Franky77200: posts the ante $0.10
matiko09: posts the ante $0.10
Kukuryzka: posts the ante $0.10
r4mz3s: posts the ante $0.10
*** HOLE CARDS ***
Dealt to matiko09 [Kd Jd]
Hit Pit: folds 
Franky77200: calls $0.50
matiko09: raises $2 to $2.50
Kukuryzka: folds 
r4mz3s: folds 
BladeChen: folds 
Yourstepmom joins the table at seat #2 
kotkas1000: folds 
Franky77200: calls $2
*** FLOP *** [7s Qs 2s]
Franky77200: checks 
matiko09: checks 
*** TURN *** [7s Qs 2s] [5h]
Franky77200: checks 
matiko09: checks 
*** RIVER *** [7s Qs 2s 5h] [Jc]
Franky77200: checks 
matiko09: bets $1
Franky77200: calls $1
*** SHOW DOWN ***
matiko09: shows [Kd Jd] (a pair of Jacks)
Franky77200: mucks hand 
matiko09 collected $8.03 from pot
*** SUMMARY ***
Total pot $8.45 | Rake $0.42 
Board [7s Qs 2s 5h Jc]
Seat 1: BladeChen (small blind) folded before Flop
Seat 4: kotkas1000 (big blind) folded before Flop
Seat 5: Hit Pit folded before Flop (didn't bet)
Seat 6: Franky77200 mucked [9h 9d]
Seat 7: matiko09 showed [Kd Jd] and won ($8.03) with a pair of Jacks
Seat 8: Kukuryzka folded before Flop (didn't bet)
Seat 9: r4mz3s (button) folded before Flop (didn't bet)





PokerStars Hand #155381435312:  Hold'em No Limit ($0.50/$1.00 USD) - 2016/06/30 14:41:09 CET [2016/06/30 8:41:09 ET]
Table 'California II' 9-max Seat #6 is the button
Seat 1: Rafaello18 ($100 in chips) 
Seat 2: ruslik_by ($149.81 in chips) 
Seat 3: KovIFish89 ($113.22 in chips) 
Seat 4: f1reworks ($101 in chips) 
Seat 5: Rohitbarve ($108.77 in chips) 
Seat 6: matiko09 ($129.98 in chips) 
Seat 7: DomiVY ($88.88 in chips) 
Seat 8: chenconhaste ($104 in chips) 
Seat 9: di0d80 ($103.37 in chips) 
DomiVY: posts small blind $0.50
chenconhaste: posts big blind $1
*** HOLE CARDS ***
Dealt to matiko09 [4s Qh]
di0d80: folds 
Rafaello18: folds 
ruslik_by: folds 
KovIFish89: folds 
f1reworks: folds 
Rohitbarve: folds 
matiko09: folds 
DomiVY: folds 
Uncalled bet ($0.50) returned to chenconhaste
chenconhaste collected $1 from pot
*** SUMMARY ***
Total pot $1 | Rake $0 
Seat 1: Rafaello18 folded before Flop (didn't bet)
Seat 2: ruslik_by folded before Flop (didn't bet)
Seat 3: KovIFish89 folded before Flop (didn't bet)
Seat 4: f1reworks folded before Flop (didn't bet)
Seat 5: Rohitbarve folded before Flop (didn't bet)
Seat 6: matiko09 (button) folded before Flop (didn't bet)
Seat 7: DomiVY (small blind) folded before Flop
Seat 8: chenconhaste (big blind) collected ($1)
Seat 9: di0d80 folded before Flop (didn't bet)





PokerStars Hand #155381436160:  Hold'em No Limit ($0.50/$1.00 USD) - 2016/06/30 14:41:11 CET [2016/06/30 8:41:11 ET]
Table 'Altarf II' 9-max Seat #8 is the button
Seat 1: Rafaello18 ($107.18 in chips) 
Seat 2: KovIFish89 ($100 in chips) 
Seat 3: sanr23 ($167.96 in chips) 
Seat 4: Greha999 ($145.38 in chips) 
Seat 6: mbk88 ($174.68 in chips) 
Seat 7: matiko09 ($109.22 in chips) 
Seat 8: DomiVY ($41.89 in chips) 
Seat 9: omanibemihum ($156.82 in chips) 
omanibemihum: posts small blind $0.50
Rafaello18: posts big blind $1
*** HOLE CARDS ***
Dealt to matiko09 [Jc 2s]
KovIFish89: folds 
sanr23: folds 
Greha999: raises $2 to $3
mbk88: folds 
matiko09: folds 
DomiVY: folds 
omanibemihum: folds 
Rafaello18: folds 
Uncalled bet ($2) returned to Greha999
Greha999 collected $2.50 from pot
*** SUMMARY ***
Total pot $2.50 | Rake $0 
Seat 1: Rafaello18 (big blind) folded before Flop
Seat 2: KovIFish89 folded before Flop (didn't bet)
Seat 3: sanr23 folded before Flop (didn't bet)
Seat 4: Greha999 collected ($2.50)
Seat 6: mbk88 folded before Flop (didn't bet)
Seat 7: matiko09 folded before Flop (didn't bet)
Seat 8: DomiVY (button) folded before Flop (didn't bet)
Seat 9: omanibemihum (small blind) folded before Flop





PokerStars Hand #155381436450:  Hold'em No Limit ($0.50/$1.00 USD) - 2016/06/30 14:41:11 CET [2016/06/30 8:41:11 ET]
Table 'Asmodeus' 9-max Seat #8 is the button
Seat 2: DomiVY ($40 in chips) 
Seat 3: matiko09 ($103.65 in chips) 
Seat 4: Ty Nick 420 ($110.56 in chips) 
Seat 5: sanr23 ($106.80 in chips) 
Seat 6: koutani7 ($79.03 in chips) 
Seat 7: aaronzzr ($148.80 in chips) 
Seat 8: Rafaello18 ($175.37 in chips) 
Seat 9: mbk88 ($162.56 in chips) 
mbk88: posts small blind $0.50
DomiVY: posts big blind $1
*** HOLE CARDS ***
Dealt to matiko09 [9c 3c]
matiko09: folds 
Ty Nick 420: folds 
sanr23: raises $2 to $3
koutani7: folds 
aaronzzr: calls $3
Rafaello18: folds 
mbk88: folds 
DomiVY: calls $2
*** FLOP *** [6h Jh Ad]
DomiVY: checks 
sanr23: checks 
aaronzzr: bets $5
DomiVY: folds 
sanr23: calls $5
*** TURN *** [6h Jh Ad] [8d]
sanr23: checks 
aaronzzr: checks 
*** RIVER *** [6h Jh Ad 8d] [Td]
sanr23: checks 
aaronzzr: bets $19
sanr23: folds 
Uncalled bet ($19) returned to aaronzzr
aaronzzr collected $18.52 from pot
aaronzzr: doesn't show hand 
*** SUMMARY ***
Total pot $19.50 | Rake $0.98 
Board [6h Jh Ad 8d Td]
Seat 2: DomiVY (big blind) folded on the Flop
Seat 3: matiko09 folded before Flop (didn't bet)
Seat 4: Ty Nick 420 folded before Flop (didn't bet)
Seat 5: sanr23 folded on the River
Seat 6: koutani7 folded before Flop (didn't bet)
Seat 7: aaronzzr collected ($18.52)
Seat 8: Rafaello18 (button) folded before Flop (didn't bet)
Seat 9: mbk88 (small blind) folded before Flop





PokerStars Hand #155381438119:  Hold'em No Limit ($0.25/$0.50 USD) - 2016/06/30 14:41:15 CET [2016/06/30 8:41:15 ET]
Table 'Arcturus' 9-max Seat #5 is the button
Seat 1: kourk250 ($141.59 in chips) 
Seat 2: Rafaello18 ($52.34 in chips) 
Seat 3: matiko09 ($59.20 in chips) 
Seat 5: stockbridge8 ($49.25 in chips) 
Seat 6: sanr23 ($51.56 in chips) 
Seat 7: bratbugor ($50.51 in chips) 
Seat 8: TheMinion ($64.28 in chips) 
Seat 9: joker180785 ($50 in chips) 
sanr23: posts small blind $0.25
bratbugor: posts big blind $0.50
*** HOLE CARDS ***
Dealt to matiko09 [Ks Qc]
TheMinion: folds 
joker180785: folds 
kourk250: folds 
Rafaello18: folds 
matiko09: raises $0.75 to $1.25
stockbridge8: folds 
sanr23: folds 
bratbugor: calls $0.75
*** FLOP *** [2s 9c Td]
bratbugor: checks 
matiko09: bets $1.70
bratbugor: calls $1.70
*** TURN *** [2s 9c Td] [Js]
bratbugor: checks 
matiko09: bets $4
bratbugor: calls $4
*** RIVER *** [2s 9c Td Js] [6d]
bratbugor: checks 
matiko09: bets $10
bratbugor: folds 
Uncalled bet ($10) returned to matiko09
matiko09 collected $13.44 from pot
matiko09: doesn't show hand 
*** SUMMARY ***
Total pot $14.15 | Rake $0.71 
Board [2s 9c Td Js 6d]
Seat 1: kourk250 folded before Flop (didn't bet)
Seat 2: Rafaello18 folded before Flop (didn't bet)
Seat 3: matiko09 collected ($13.44)
Seat 5: stockbridge8 (button) folded before Flop (didn't bet)
Seat 6: sanr23 (small blind) folded before Flop
Seat 7: bratbugor (big blind) folded on the River
Seat 8: TheMinion folded before Flop (didn't bet)
Seat 9: joker180785 folded before Flop (didn't bet)





PokerStars Hand #155381438724:  Hold'em No Limit (€0.25/€0.50 EUR) - 2016/06/30 14:41:16 CET [2016/06/30 8:41:16 ET]
Table 'Vibeke II' 9-max Seat #6 is the button
Seat 4: acelacat111 (€35.33 in chips) 
Seat 5: mazefaka007 (€66.33 in chips) 
Seat 6: Kukuryzka (€56.49 in chips) 
Seat 7: matiko09 (€59.27 in chips) 
Seat 9: funXmun (€50 in chips) 
matiko09: posts small blind €0.25
funXmun: posts big blind €0.50
*** HOLE CARDS ***
Dealt to matiko09 [8s 7s]
acelacat111: folds 
mazefaka007: folds 
Kukuryzka: folds 
matiko09: raises €1 to €1.50
funXmun: folds 
Uncalled bet (€1) returned to matiko09
matiko09 collected €1 from pot
matiko09: doesn't show hand 
*** SUMMARY ***
Total pot €1 | Rake €0 
Seat 4: acelacat111 folded before Flop (didn't bet)
Seat 5: mazefaka007 folded before Flop (didn't bet)
Seat 6: Kukuryzka (button) folded before Flop (didn't bet)
Seat 7: matiko09 (small blind) collected (€1)
Seat 9: funXmun (big blind) folded before Flop





PokerStars Hand #155381444245:  Hold'em No Limit ($0.50/$1.00 USD) - 2016/06/30 14:41:27 CET [2016/06/30 8:41:27 ET]
Table 'Tatjana' 9-max Seat #3 is the button
Seat 1: tipner ($100 in chips) 
Seat 2: Kukuryzka ($105.38 in chips) 
Seat 3: Rafaello18 ($100 in chips) 
Seat 4: mopatron25 ($111.81 in chips) 
Seat 5: matiko09 ($113.64 in chips) 
Seat 6: mbk88 ($157.04 in chips) 
Seat 8: alhill86 ($146.06 in chips) 
Seat 9: Ty Nick 420 ($100 in chips) 
mopatron25: posts small blind $0.50
matiko09: posts big blind $1
*** HOLE CARDS ***
Dealt to matiko09 [Js As]
mbk88: raises $2 to $3
alhill86: folds 
Ty Nick 420: folds 
tipner: folds 
Kukuryzka: folds 
Rafaello18: folds 
mopatron25: calls $2.50
matiko09: calls $2
*** FLOP *** [8h 7d Ah]
mopatron25: bets $3
matiko09: raises $8 to $11
mbk88: calls $11
mopatron25: calls $8
*** TURN *** [8h 7d Ah] [7c]
mopatron25: checks 
matiko09: checks 
mbk88: bets $19
mopatron25: calls $19
matiko09: folds 
*** RIVER *** [8h 7d Ah 7c] [7s]
mopatron25: bets $8
mbk88: raises $8 to $16
mopatron25: folds 
Uncalled bet ($8) returned to mbk88
mbk88 collected $93.50 from pot
mbk88: doesn't show hand 
*** SUMMARY ***
Total pot $96 | Rake $2.50 
Board [8h 7d Ah 7c 7s]
Seat 1: tipner folded before Flop (didn't bet)
Seat 2: Kukuryzka folded before Flop (didn't bet)
Seat 3: Rafaello18 (button) folded before Flop (didn't bet)
Seat 4: mopatron25 (small blind) folded on the River
Seat 5: matiko09 (big blind) folded on the Turn
Seat 6: mbk88 collected ($93.50)
Seat 8: alhill86 folded before Flop (didn't bet)
Seat 9: Ty Nick 420 folded before Flop (didn't bet)





PokerStars Hand #155381449344:  Hold'em No Limit ($0.50/$1.00 USD) - 2016/06/30 14:41:38 CET [2016/06/30 8:41:38 ET]
Table 'Sigrid' 9-max Seat #4 is the button
Seat 1: Greha999 ($52.44 in chips) 
Seat 2: matiko09 ($103.66 in chips) 
Seat 3: Rafaello18 ($116.35 in chips) 
Seat 4: mbk88 ($104.05 in chips) 
Seat 5: chenconhaste ($100 in chips) 
Seat 8: ruslik_by ($101.82 in chips) 
Seat 9: KovIFish89 ($104.12 in chips) 
chenconhaste: posts small blind $0.50
ruslik_by: posts big blind $1
*** HOLE CARDS ***
Dealt to matiko09 [3c 8d]
KovIFish89: folds 
Greha999: folds 
matiko09: folds 
Rafaello18: raises $1.50 to $2.50
mbk88: raises $6.50 to $9
chenconhaste: folds 
ruslik_by: folds 
Rafaello18: raises $12 to $21
mbk88: folds 
Uncalled bet ($12) returned to Rafaello18
Rafaello18 collected $19.50 from pot
Rafaello18: doesn't show hand 
*** SUMMARY ***
Total pot $19.50 | Rake $0 
Seat 1: Greha999 folded before Flop (didn't bet)
Seat 2: matiko09 folded before Flop (didn't bet)
Seat 3: Rafaello18 collected ($19.50)
Seat 4: mbk88 (button) folded before Flop
Seat 5: chenconhaste (small blind) folded before Flop
Seat 8: ruslik_by (big blind) folded before Flop
Seat 9: KovIFish89 folded before Flop (didn't bet)





PokerStars Hand #155381452904:  Hold'em No Limit ($0.50/$1.00 USD) - 2016/06/30 14:41:45 CET [2016/06/30 8:41:45 ET]
Table 'California II' 9-max Seat #7 is the button
Seat 1: Rafaello18 ($100 in chips) 
Seat 2: ruslik_by ($149.81 in chips) 
Seat 3: KovIFish89 ($113.22 in chips) 
Seat 4: f1reworks ($101 in chips) 
Seat 5: Rohitbarve ($108.77 in chips) 
Seat 6: matiko09 ($129.98 in chips) 
Seat 7: DomiVY ($88.38 in chips) 
Seat 8: chenconhaste ($104.50 in chips) 
Seat 9: di0d80 ($103.37 in chips) 
chenconhaste: posts small blind $0.50
di0d80: posts big blind $1
*** HOLE CARDS ***
Dealt to matiko09 [6c 2d]
Rafaello18: folds 
ruslik_by: folds 
KovIFish89: raises $2 to $3
f1reworks: folds 
Rohitbarve: calls $3
matiko09: folds 
DomiVY: folds 
chenconhaste: folds 
di0d80: raises $9 to $12
KovIFish89: calls $9
Rohitbarve: folds 
*** FLOP *** [2h Qh Js]
di0d80: bets $12
KovIFish89: calls $12
*** TURN *** [2h Qh Js] [4s]
di0d80: bets $25
KovIFish89: raises $64.22 to $89.22 and is all-in
di0d80: calls $54.37 and is all-in
Uncalled bet ($9.85) returned to KovIFish89
*** RIVER *** [2h Qh Js 4s] [4h]
*** SHOW DOWN ***
di0d80: shows [Qd Qc] (a full house, Queens full of Fours)
KovIFish89: shows [Kd Kh] (two pair, Kings and Fours)
di0d80 collected $207.74 from pot
*** SUMMARY ***
Total pot $210.24 | Rake $2.50 
Board [2h Qh Js 4s 4h]
Seat 1: Rafaello18 folded before Flop (didn't bet)
Seat 2: ruslik_by folded before Flop (didn't bet)
Seat 3: KovIFish89 showed [Kd Kh] and lost with two pair, Kings and Fours
Seat 4: f1reworks folded before Flop (didn't bet)
Seat 5: Rohitbarve folded before Flop
Seat 6: matiko09 folded before Flop (didn't bet)
Seat 7: DomiVY (button) folded before Flop (didn't bet)
Seat 8: chenconhaste (small blind) folded before Flop
Seat 9: di0d80 (big blind) showed [Qd Qc] and won ($207.74) with a full house, Queens full of Fours





PokerStars Hand #155381453957:  Hold'em No Limit (€0.25/€0.50 EUR) - 2016/06/30 14:41:47 CET [2016/06/30 8:41:47 ET]
Table 'Vibeke II' 9-max Seat #7 is the button
Seat 4: acelacat111 (€35.33 in chips) 
Seat 5: mazefaka007 (€66.33 in chips) 
Seat 6: Kukuryzka (€56.49 in chips) 
Seat 7: matiko09 (€59.77 in chips) 
Seat 9: funXmun (€50 in chips) 
funXmun: posts small blind €0.25
acelacat111: posts big blind €0.50
*** HOLE CARDS ***
Dealt to matiko09 [Ac Qc]
mazefaka007: folds 
Kukuryzka: folds 
matiko09: raises €0.63 to €1.13
funXmun: folds 
acelacat111: folds 
Uncalled bet (€0.63) returned to matiko09
matiko09 collected €1.25 from pot
matiko09: doesn't show hand 
*** SUMMARY ***
Total pot €1.25 | Rake €0 
Seat 4: acelacat111 (big blind) folded before Flop
Seat 5: mazefaka007 folded before Flop (didn't bet)
Seat 6: Kukuryzka folded before Flop (didn't bet)
Seat 7: matiko09 (button) collected (€1.25)
Seat 9: funXmun (small blind) folded before Flop





PokerStars Hand #155381456191:  Hold'em No Limit ($0.50/$1.00 USD) - 2016/06/30 14:41:52 CET [2016/06/30 8:41:52 ET]
Table 'Donnera' 9-max Seat #8 is the button
Seat 1: chenconhaste ($113.06 in chips) 
Seat 2: robbiescrim9 ($99.69 in chips) 
Seat 3: matiko09 ($106.82 in chips) 
Seat 4: Kukuryzka ($102.50 in chips) 
Seat 5: tipner ($110.90 in chips) 
Seat 6: nickreason17 ($100 in chips) 
Seat 7: Rafaello18 ($130.80 in chips) 
Seat 8: ruslik_by ($209.44 in chips) 
Seat 9: Starw!nd ($118.25 in chips) 
Starw!nd: posts small blind $0.50
chenconhaste: posts big blind $1
*** HOLE CARDS ***
Dealt to matiko09 [Ad As]
robbiescrim9: raises $1 to $2
matiko09: raises $6 to $8
Kukuryzka: folds 
tipner: folds 
nickreason17: folds 
Rafaello18: calls $8
ruslik_by: folds 
Starw!nd: folds 
chenconhaste: folds 
robbiescrim9: calls $6
*** FLOP *** [Qc 9d 7s]
robbiescrim9: checks 
matiko09: bets $16
Rafaello18: folds 
robbiescrim9: calls $16
*** TURN *** [Qc 9d 7s] [Ts]
robbiescrim9: checks 
matiko09: bets $82.82 and is all-in
robbiescrim9: folds 
Uncalled bet ($82.82) returned to matiko09
matiko09 collected $55 from pot
matiko09: doesn't show hand 
*** SUMMARY ***
Total pot $57.50 | Rake $2.50 
Board [Qc 9d 7s Ts]
Seat 1: chenconhaste (big blind) folded before Flop
Seat 2: robbiescrim9 folded on the Turn
Seat 3: matiko09 collected ($55)
Seat 4: Kukuryzka folded before Flop (didn't bet)
Seat 5: tipner folded before Flop (didn't bet)
Seat 6: nickreason17 folded before Flop (didn't bet)
Seat 7: Rafaello18 folded on the Flop
Seat 8: ruslik_by (button) folded before Flop (didn't bet)
Seat 9: Starw!nd (small blind) folded before Flop





PokerStars Hand #155381456252:  Hold'em No Limit ($0.25/$0.50 USD) - 2016/06/30 14:41:52 CET [2016/06/30 8:41:52 ET]
Table 'Chort III' 9-max Seat #1 is the button
Seat 1: BladeChen ($72.31 in chips) 
Seat 4: kotkas1000 ($50 in chips) 
Seat 5: Hit Pit ($30.66 in chips) 
Seat 6: Franky77200 ($25.57 in chips) 
Seat 7: matiko09 ($55.78 in chips) 
Seat 8: Kukuryzka ($50 in chips) 
Seat 9: r4mz3s ($50 in chips) 
Yourstepmom will be allowed to play after the button
kotkas1000: posts small blind $0.25
Hit Pit: posts big blind $0.50
BladeChen: posts the ante $0.10
kotkas1000: posts the ante $0.10
Hit Pit: posts the ante $0.10
Franky77200: posts the ante $0.10
matiko09: posts the ante $0.10
Kukuryzka: posts the ante $0.10
r4mz3s: posts the ante $0.10
*** HOLE CARDS ***
Dealt to matiko09 [Jc 6s]
Franky77200: raises $1 to $1.50
matiko09: folds 
Kukuryzka: folds 
r4mz3s: folds 
BladeChen: folds 
kotkas1000: folds 
Hit Pit: folds 
Uncalled bet ($1) returned to Franky77200
Franky77200 collected $1.95 from pot
Franky77200: doesn't show hand 
*** SUMMARY ***
Total pot $1.95 | Rake $0 
Seat 1: BladeChen (button) folded before Flop (didn't bet)
Seat 4: kotkas1000 (small blind) folded before Flop
Seat 5: Hit Pit (big blind) folded before Flop
Seat 6: Franky77200 collected ($1.95)
Seat 7: matiko09 folded before Flop (didn't bet)
Seat 8: Kukuryzka folded before Flop (didn't bet)
Seat 9: r4mz3s folded before Flop (didn't bet)





PokerStars Hand #155381459811:  Hold'em No Limit ($0.50/$1.00 USD) - 2016/06/30 14:41:59 CET [2016/06/30 8:41:59 ET]
Table 'Altarf II' 9-max Seat #9 is the button
Seat 1: Rafaello18 ($106.18 in chips) 
Seat 2: KovIFish89 ($100 in chips) 
Seat 3: sanr23 ($167.96 in chips) 
Seat 4: Greha999 ($146.88 in chips) 
Seat 6: mbk88 ($174.68 in chips) 
Seat 7: matiko09 ($109.22 in chips) 
Seat 8: DomiVY ($41.89 in chips) 
Seat 9: omanibemihum ($156.32 in chips) 
Rafaello18: posts small blind $0.50
KovIFish89: posts big blind $1
*** HOLE CARDS ***
Dealt to matiko09 [6c 2s]
sanr23: folds 
Greha999: calls $1
mbk88: folds 
matiko09: folds 
DomiVY: folds 
omanibemihum: folds 
Rafaello18: folds 
KovIFish89: checks 
*** FLOP *** [9s Qd 8h]
KovIFish89: checks 
Greha999: bets $2
KovIFish89: calls $2
*** TURN *** [9s Qd 8h] [7d]
KovIFish89: checks 
Greha999: bets $6
KovIFish89: folds 
Uncalled bet ($6) returned to Greha999
Greha999 collected $6.18 from pot
*** SUMMARY ***
Total pot $6.50 | Rake $0.32 
Board [9s Qd 8h 7d]
Seat 1: Rafaello18 (small blind) folded before Flop
Seat 2: KovIFish89 (big blind) folded on the Turn
Seat 3: sanr23 folded before Flop (didn't bet)
Seat 4: Greha999 collected ($6.18)
Seat 6: mbk88 folded before Flop (didn't bet)
Seat 7: matiko09 folded before Flop (didn't bet)
Seat 8: DomiVY folded before Flop (didn't bet)
Seat 9: omanibemihum (button) folded before Flop (didn't bet)





PokerStars Hand #155381465164:  Hold'em No Limit ($0.25/$0.50 USD) - 2016/06/30 14:42:10 CET [2016/06/30 8:42:10 ET]
Table 'Chort III' 9-max Seat #4 is the button
Seat 1: BladeChen ($72.21 in chips) 
Seat 4: kotkas1000 ($50 in chips) 
Seat 5: Hit Pit ($30.06 in chips) 
Seat 6: Franky77200 ($26.92 in chips) 
Seat 7: matiko09 ($55.68 in chips) 
Seat 8: Kukuryzka ($49.90 in chips) 
Seat 9: r4mz3s ($50 in chips) 
Hit Pit: posts small blind $0.25
Franky77200: posts big blind $0.50
Yourstepmom: sits out 
BladeChen: posts the ante $0.10
kotkas1000: posts the ante $0.10
Hit Pit: posts the ante $0.10
Franky77200: posts the ante $0.10
matiko09: posts the ante $0.10
Kukuryzka: posts the ante $0.10
r4mz3s: posts the ante $0.10
*** HOLE CARDS ***
Dealt to matiko09 [7s Qh]
matiko09: folds 
Dantist1122 joins the table at seat #3 
Kukuryzka: raises $1 to $1.50
r4mz3s: folds 
BladeChen: folds 
kotkas1000: folds 
Hit Pit: folds 
Franky77200: calls $1
*** FLOP *** [9s 5c 3h]
Franky77200: checks 
Kukuryzka: checks 
*** TURN *** [9s 5c 3h] [Qs]
Franky77200: bets $2.50
Kukuryzka: folds 
Uncalled bet ($2.50) returned to Franky77200
Franky77200 collected $3.75 from pot
Franky77200: doesn't show hand 
*** SUMMARY ***
Total pot $3.95 | Rake $0.20 
Board [9s 5c 3h Qs]
Seat 1: BladeChen folded before Flop (didn't bet)
Seat 4: kotkas1000 (button) folded before Flop (didn't bet)
Seat 5: Hit Pit (small blind) folded before Flop
Seat 6: Franky77200 (big blind) collected ($3.75)
Seat 7: matiko09 folded before Flop (didn't bet)
Seat 8: Kukuryzka folded on the Turn
Seat 9: r4mz3s folded before Flop (didn't bet)





PokerStars Hand #155381467322:  Hold'em No Limit (€0.25/€0.50 EUR) - 2016/06/30 14:42:15 CET [2016/06/30 8:42:15 ET]
Table 'Vibeke II' 9-max Seat #9 is the button
Seat 4: acelacat111 (€34.83 in chips) 
Seat 5: mazefaka007 (€66.33 in chips) 
Seat 6: Kukuryzka (€56.49 in chips) 
Seat 7: matiko09 (€60.52 in chips) 
Seat 9: funXmun (€50 in chips) 
acelacat111: posts small blind €0.25
mazefaka007: posts big blind €0.50
*** HOLE CARDS ***
Dealt to matiko09 [Qs Td]
Kukuryzka: raises €1 to €1.50
matiko09: folds 
funXmun: folds 
acelacat111: raises €3.50 to €5
mazefaka007: folds 
Kukuryzka: folds 
Uncalled bet (€3.50) returned to acelacat111
acelacat111 collected €3.50 from pot
acelacat111: doesn't show hand 
*** SUMMARY ***
Total pot €3.50 | Rake €0 
Seat 4: acelacat111 (small blind) collected (€3.50)
Seat 5: mazefaka007 (big blind) folded before Flop
Seat 6: Kukuryzka folded before Flop
Seat 7: matiko09 folded before Flop (didn't bet)
Seat 9: funXmun (button) folded before Flop (didn't bet)





PokerStars Hand #155381468353:  Hold'em No Limit ($0.25/$0.50 USD) - 2016/06/30 14:42:17 CET [2016/06/30 8:42:17 ET]
Table 'Thalia II' 9-max Seat #5 is the button
Seat 2: DeathcorePkr ($54.64 in chips) 
Seat 3: r4mz3s ($74.12 in chips) 
Seat 4: Kukuryzka ($52.57 in chips) 
Seat 5: geowin ($52.36 in chips) 
Seat 6: chenconhaste ($54.54 in chips) 
Seat 7: fudzi ($67.32 in chips) 
Seat 8: Jo_Medici ($50 in chips) 
Seat 9: matiko09 ($50 in chips) 
chenconhaste: posts small blind $0.25
fudzi: posts big blind $0.50
DeathcorePkr: posts the ante $0.10
r4mz3s: posts the ante $0.10
Kukuryzka: posts the ante $0.10
geowin: posts the ante $0.10
chenconhaste: posts the ante $0.10
fudzi: posts the ante $0.10
Jo_Medici: posts the ante $0.10
matiko09: posts the ante $0.10
*** HOLE CARDS ***
Dealt to matiko09 [4d Ts]
Jo_Medici: raises $0.75 to $1.25
matiko09: folds 
DeathcorePkr: folds 
r4mz3s: folds 
Kukuryzka: folds 
geowin: calls $1.25
chenconhaste: folds 
fudzi: folds 
*** FLOP *** [4s Ac Jh]
Jo_Medici: bets $2.50
geowin: folds 
Uncalled bet ($2.50) returned to Jo_Medici
Jo_Medici collected $3.85 from pot
Jo_Medici: doesn't show hand 
*** SUMMARY ***
Total pot $4.05 | Rake $0.20 
Board [4s Ac Jh]
Seat 2: DeathcorePkr folded before Flop (didn't bet)
Seat 3: r4mz3s folded before Flop (didn't bet)
Seat 4: Kukuryzka folded before Flop (didn't bet)
Seat 5: geowin (button) folded on the Flop
Seat 6: chenconhaste (small blind) folded before Flop
Seat 7: fudzi (big blind) folded before Flop
Seat 8: Jo_Medici collected ($3.85)
Seat 9: matiko09 folded before Flop (didn't bet)





PokerStars Hand #155381473749:  Hold'em No Limit ($0.50/$1.00 USD) - 2016/06/30 14:42:28 CET [2016/06/30 8:42:28 ET]
Table 'Sigrid' 9-max Seat #5 is the button
Seat 1: Greha999 ($52.44 in chips) 
Seat 2: matiko09 ($103.66 in chips) 
Seat 3: Rafaello18 ($126.85 in chips) 
Seat 4: mbk88 ($100 in chips) 
Seat 5: chenconhaste ($100 in chips) 
Seat 8: ruslik_by ($100.82 in chips) 
Seat 9: KovIFish89 ($104.12 in chips) 
ruslik_by: posts small blind $0.50
KovIFish89: posts big blind $1
*** HOLE CARDS ***
Dealt to matiko09 [Ad 9d]
Greha999: folds 
matiko09: folds 
Rafaello18: folds 
mbk88: folds 
chenconhaste: folds 
ruslik_by: folds 
Uncalled bet ($0.50) returned to KovIFish89
KovIFish89 collected $1 from pot
KovIFish89: doesn't show hand 
*** SUMMARY ***
Total pot $1 | Rake $0 
Seat 1: Greha999 folded before Flop (didn't bet)
Seat 2: matiko09 folded before Flop (didn't bet)
Seat 3: Rafaello18 folded before Flop (didn't bet)
Seat 4: mbk88 folded before Flop (didn't bet)
Seat 5: chenconhaste (button) folded before Flop (didn't bet)
Seat 8: ruslik_by (small blind) folded before Flop
Seat 9: KovIFish89 (big blind) collected ($1)





PokerStars Hand #155381477332:  Hold'em No Limit ($0.50/$1.00 USD) - 2016/06/30 14:42:35 CET [2016/06/30 8:42:35 ET]
Table 'Borrelly II' 9-max Seat #5 is the button
Seat 1: Rafaello18 ($120.09 in chips) 
Seat 2: mbk88 ($100 in chips) 
Seat 4: DonRon_AT ($99 in chips) 
Seat 5: Ty Nick 420 ($102.50 in chips) 
Seat 6: m_michalec ($169.42 in chips) 
Seat 7: matiko09 ($175.86 in chips) 
Seat 8: Arjun A Raju ($134.12 in chips) 
Seat 9: ruslik_by ($100 in chips) 
m_michalec: posts small blind $0.50
matiko09: posts big blind $1
*** HOLE CARDS ***
Dealt to matiko09 [Ah 9c]
Arjun A Raju: folds 
ruslik_by: folds 
Rafaello18: raises $1.50 to $2.50
mbk88: folds 
DonRon_AT: folds 
Ty Nick 420: folds 
m_michalec: folds 
matiko09: folds 
Uncalled bet ($1.50) returned to Rafaello18
Rafaello18 collected $2.50 from pot
Rafaello18: doesn't show hand 
*** SUMMARY ***
Total pot $2.50 | Rake $0 
Seat 1: Rafaello18 collected ($2.50)
Seat 2: mbk88 folded before Flop (didn't bet)
Seat 4: DonRon_AT folded before Flop (didn't bet)
Seat 5: Ty Nick 420 (button) folded before Flop (didn't bet)
Seat 6: m_michalec (small blind) folded before Flop
Seat 7: matiko09 (big blind) folded before Flop
Seat 8: Arjun A Raju folded before Flop (didn't bet)
Seat 9: ruslik_by folded before Flop (didn't bet)





PokerStars Hand #155381487456:  Hold'em No Limit ($0.50/$1.00 USD) - 2016/06/30 14:42:56 CET [2016/06/30 8:42:56 ET]
Table 'Altarf II' 9-max Seat #1 is the button
Seat 1: Rafaello18 ($105.68 in chips) 
Seat 2: KovIFish89 ($100 in chips) 
Seat 3: sanr23 ($167.96 in chips) 
Seat 4: Greha999 ($150.06 in chips) 
Seat 6: mbk88 ($174.68 in chips) 
Seat 7: matiko09 ($109.22 in chips) 
Seat 8: DomiVY ($41.89 in chips) 
Seat 9: omanibemihum ($156.32 in chips) 
KovIFish89: posts small blind $0.50
sanr23: posts big blind $1
*** HOLE CARDS ***
Dealt to matiko09 [Qd 4h]
Greha999: folds 
mbk88: folds 
matiko09: folds 
DomiVY: folds 
omanibemihum: folds 
Rafaello18: folds 
KovIFish89: raises $2 to $3
sanr23: calls $2
*** FLOP *** [As 3s 3h]
KovIFish89: checks 
sanr23: bets $3.30
KovIFish89: folds 
Uncalled bet ($3.30) returned to sanr23
sanr23 collected $5.70 from pot
sanr23: doesn't show hand 
*** SUMMARY ***
Total pot $6 | Rake $0.30 
Board [As 3s 3h]
Seat 1: Rafaello18 (button) folded before Flop (didn't bet)
Seat 2: KovIFish89 (small blind) folded on the Flop
Seat 3: sanr23 (big blind) collected ($5.70)
Seat 4: Greha999 folded before Flop (didn't bet)
Seat 6: mbk88 folded before Flop (didn't bet)
Seat 7: matiko09 folded before Flop (didn't bet)
Seat 8: DomiVY folded before Flop (didn't bet)
Seat 9: omanibemihum folded before Flop (didn't bet)





PokerStars Hand #155381487297:  Hold'em No Limit ($0.50/$1.00 USD) - 2016/06/30 14:42:56 CET [2016/06/30 8:42:56 ET]
Table 'Tatjana' 9-max Seat #4 is the button
Seat 1: tipner ($100 in chips) 
Seat 2: Kukuryzka ($105.38 in chips) 
Seat 3: Rafaello18 ($100 in chips) 
Seat 4: mopatron25 ($70.81 in chips) 
Seat 5: matiko09 ($100 in chips) 
Seat 6: mbk88 ($209.54 in chips) 
Seat 8: alhill86 ($146.06 in chips) 
Seat 9: Ty Nick 420 ($100 in chips) 
matiko09: posts small blind $0.50
mbk88: posts big blind $1
*** HOLE CARDS ***
Dealt to matiko09 [5c Qs]
alhill86: folds 
Ty Nick 420: folds 
tipner: folds 
Kukuryzka: folds 
Rafaello18: raises $1.50 to $2.50
mopatron25: folds 
matiko09: folds 
mbk88: calls $1.50
*** FLOP *** [Qh 6h 9c]
mbk88: checks 
Rafaello18: bets $3.50
mbk88: calls $3.50
*** TURN *** [Qh 6h 9c] [7s]
mbk88: checks 
Rafaello18: bets $8
mbk88: folds 
Uncalled bet ($8) returned to Rafaello18
Rafaello18 collected $11.88 from pot
Rafaello18: doesn't show hand 
*** SUMMARY ***
Total pot $12.50 | Rake $0.62 
Board [Qh 6h 9c 7s]
Seat 1: tipner folded before Flop (didn't bet)
Seat 2: Kukuryzka folded before Flop (didn't bet)
Seat 3: Rafaello18 collected ($11.88)
Seat 4: mopatron25 (button) folded before Flop (didn't bet)
Seat 5: matiko09 (small blind) folded before Flop
Seat 6: mbk88 (big blind) folded on the Turn
Seat 8: alhill86 folded before Flop (didn't bet)
Seat 9: Ty Nick 420 folded before Flop (didn't bet)





PokerStars Hand #155381488444:  Hold'em No Limit (€0.25/€0.50 EUR) - 2016/06/30 14:42:58 CET [2016/06/30 8:42:58 ET]
Table 'Vibeke II' 9-max Seat #4 is the button
Seat 4: acelacat111 (€36.83 in chips) 
Seat 5: mazefaka007 (€65.83 in chips) 
Seat 6: Kukuryzka (€54.99 in chips) 
Seat 7: matiko09 (€60.52 in chips) 
Seat 9: funXmun (€50 in chips) 
mazefaka007: posts small blind €0.25
Kukuryzka: posts big blind €0.50
*** HOLE CARDS ***
Dealt to matiko09 [4h 9s]
Math9881 joins the table at seat #8 
matiko09: folds 
funXmun: raises €0.75 to €1.25
acelacat111: calls €1.25
kotkas1000 joins the table at seat #1 
mazefaka007: folds 
Kukuryzka: folds 
*** FLOP *** [4c 2d 6c]
funXmun: checks 
acelacat111: bets €2.12
funXmun: raises €7.33 to €9.45
acelacat111: folds 
Uncalled bet (€7.33) returned to funXmun
funXmun collected €7.12 from pot
funXmun: doesn't show hand 
*** SUMMARY ***
Total pot €7.49 | Rake €0.37 
Board [4c 2d 6c]
Seat 4: acelacat111 (button) folded on the Flop
Seat 5: mazefaka007 (small blind) folded before Flop
Seat 6: Kukuryzka (big blind) folded before Flop
Seat 7: matiko09 folded before Flop (didn't bet)
Seat 9: funXmun collected (€7.12)





PokerStars Hand #155381488741:  Hold'em No Limit ($0.50/$1.00 USD) - 2016/06/30 14:42:59 CET [2016/06/30 8:42:59 ET]
Table 'Borrelly II' 9-max Seat #6 is the button
Seat 1: Rafaello18 ($121.59 in chips) 
Seat 2: mbk88 ($100 in chips) 
Seat 4: DonRon_AT ($99 in chips) 
Seat 5: Ty Nick 420 ($102.50 in chips) 
Seat 6: m_michalec ($168.92 in chips) 
Seat 7: matiko09 ($174.86 in chips) 
Seat 8: Arjun A Raju ($134.12 in chips) 
Seat 9: ruslik_by ($100 in chips) 
matiko09: posts small blind $0.50
Arjun A Raju: posts big blind $1
*** HOLE CARDS ***
Dealt to matiko09 [4s 3h]
ruslik_by: folds 
Rafaello18: folds 
mbk88: folds 
DonRon_AT: calls $1
Ty Nick 420: folds 
m_michalec: folds 
matiko09: folds 
Arjun A Raju: checks 
*** FLOP *** [Jh Ac 5c]
Arjun A Raju: checks 
DonRon_AT: checks 
*** TURN *** [Jh Ac 5c] [Ts]
Arjun A Raju: checks 
DonRon_AT: checks 
*** RIVER *** [Jh Ac 5c Ts] [7h]
Arjun A Raju: checks 
DonRon_AT: checks 
*** SHOW DOWN ***
Arjun A Raju: shows [7c 5d] (two pair, Sevens and Fives)
DonRon_AT: mucks hand 
Arjun A Raju collected $2.38 from pot
*** SUMMARY ***
Total pot $2.50 | Rake $0.12 
Board [Jh Ac 5c Ts 7h]
Seat 1: Rafaello18 folded before Flop (didn't bet)
Seat 2: mbk88 folded before Flop (didn't bet)
Seat 4: DonRon_AT mucked [4d 4c]
Seat 5: Ty Nick 420 folded before Flop (didn't bet)
Seat 6: m_michalec (button) folded before Flop (didn't bet)
Seat 7: matiko09 (small blind) folded before Flop
Seat 8: Arjun A Raju (big blind) showed [7c 5d] and won ($2.38) with two pair, Sevens and Fives
Seat 9: ruslik_by folded before Flop (didn't bet)





PokerStars Hand #155381489036:  Hold'em No Limit ($0.50/$1.00 USD) - 2016/06/30 14:42:59 CET [2016/06/30 8:42:59 ET]
Table 'Asmodeus' 9-max Seat #9 is the button
Seat 2: DomiVY ($40 in chips) 
Seat 3: matiko09 ($103.65 in chips) 
Seat 4: Ty Nick 420 ($110.56 in chips) 
Seat 5: sanr23 ($100 in chips) 
Seat 6: koutani7 ($79.03 in chips) 
Seat 7: aaronzzr ($159.32 in chips) 
Seat 8: Rafaello18 ($175.37 in chips) 
Seat 9: mbk88 ($162.06 in chips) 
DomiVY: posts small blind $0.50
matiko09: posts big blind $1
*** HOLE CARDS ***
Dealt to matiko09 [2c 7h]
Ty Nick 420: folds 
sanr23: folds 
koutani7: raises $2 to $3
aaronzzr: folds 
Rafaello18: folds 
mbk88: folds 
DomiVY: folds 
matiko09: folds 
Uncalled bet ($2) returned to koutani7
koutani7 collected $2.50 from pot
koutani7: doesn't show hand 
*** SUMMARY ***
Total pot $2.50 | Rake $0 
Seat 2: DomiVY (small blind) folded before Flop
Seat 3: matiko09 (big blind) folded before Flop
Seat 4: Ty Nick 420 folded before Flop (didn't bet)
Seat 5: sanr23 folded before Flop (didn't bet)
Seat 6: koutani7 collected ($2.50)
Seat 7: aaronzzr folded before Flop (didn't bet)
Seat 8: Rafaello18 folded before Flop (didn't bet)
Seat 9: mbk88 (button) folded before Flop (didn't bet)





PokerStars Hand #155381492884:  Hold'em No Limit ($0.25/$0.50 USD) - 2016/06/30 14:43:07 CET [2016/06/30 8:43:07 ET]
Table 'Thalia II' 9-max Seat #6 is the button
Seat 2: DeathcorePkr ($54.54 in chips) 
Seat 3: r4mz3s ($74.02 in chips) 
Seat 4: Kukuryzka ($52.47 in chips) 
Seat 5: geowin ($51.01 in chips) 
Seat 6: chenconhaste ($54.19 in chips) 
Seat 7: fudzi ($66.72 in chips) 
Seat 8: Jo_Medici ($52.50 in chips) 
Seat 9: matiko09 ($50 in chips) 
fudzi: posts small blind $0.25
Jo_Medici: posts big blind $0.50
DeathcorePkr: posts the ante $0.10
r4mz3s: posts the ante $0.10
Kukuryzka: posts the ante $0.10
geowin: posts the ante $0.10
chenconhaste: posts the ante $0.10
fudzi: posts the ante $0.10
Jo_Medici: posts the ante $0.10
matiko09: posts the ante $0.10
*** HOLE CARDS ***
Dealt to matiko09 [5s Kh]
matiko09: folds 
DeathcorePkr: folds 
r4mz3s: folds 
Kukuryzka: folds 
geowin: folds 
chenconhaste: folds 
fudzi: raises $1 to $1.50
Jo_Medici: folds 
Uncalled bet ($1) returned to fudzi
fudzi collected $1.80 from pot
fudzi: doesn't show hand 
*** SUMMARY ***
Total pot $1.80 | Rake $0 
Seat 2: DeathcorePkr folded before Flop (didn't bet)
Seat 3: r4mz3s folded before Flop (didn't bet)
Seat 4: Kukuryzka folded before Flop (didn't bet)
Seat 5: geowin folded before Flop (didn't bet)
Seat 6: chenconhaste (button) folded before Flop (didn't bet)
Seat 7: fudzi (small blind) collected ($1.80)
Seat 8: Jo_Medici (big blind) folded before Flop
Seat 9: matiko09 folded before Flop (didn't bet)





PokerStars Hand #155381493357:  Hold'em No Limit ($0.25/$0.50 USD) - 2016/06/30 14:43:08 CET [2016/06/30 8:43:08 ET]
Table 'Chort III' 9-max Seat #5 is the button
Seat 1: BladeChen ($72.11 in chips) 
Seat 4: kotkas1000 ($50 in chips) 
Seat 5: Hit Pit ($29.71 in chips) 
Seat 6: Franky77200 ($29.07 in chips) 
Seat 7: matiko09 ($55.58 in chips) 
Seat 8: Kukuryzka ($50 in chips) 
Seat 9: r4mz3s ($50 in chips) 
Franky77200: posts small blind $0.25
matiko09: posts big blind $0.50
Yourstepmom: sits out 
Dantist1122: sits out 
BladeChen: posts the ante $0.10
kotkas1000: posts the ante $0.10
Hit Pit: posts the ante $0.10
Franky77200: posts the ante $0.10
matiko09: posts the ante $0.10
Kukuryzka: posts the ante $0.10
r4mz3s: posts the ante $0.10
*** HOLE CARDS ***
Dealt to matiko09 [Ts 2d]
Kukuryzka: folds 
r4mz3s: folds 
BladeChen: folds 
kotkas1000: folds 
Hit Pit: calls $0.50
Franky77200: folds 
matiko09: checks 
*** FLOP *** [Ac 5c 9d]
matiko09: checks 
Hit Pit: bets $1
matiko09: folds 
Uncalled bet ($1) returned to Hit Pit
Hit Pit collected $1.85 from pot
*** SUMMARY ***
Total pot $1.95 | Rake $0.10 
Board [Ac 5c 9d]
Seat 1: BladeChen folded before Flop (didn't bet)
Seat 4: kotkas1000 folded before Flop (didn't bet)
Seat 5: Hit Pit (button) collected ($1.85)
Seat 6: Franky77200 (small blind) folded before Flop
Seat 7: matiko09 (big blind) folded on the Flop
Seat 8: Kukuryzka folded before Flop (didn't bet)
Seat 9: r4mz3s folded before Flop (didn't bet)





PokerStars Hand #155381493735:  Hold'em No Limit ($0.50/$1.00 USD) - 2016/06/30 14:43:09 CET [2016/06/30 8:43:09 ET]
Table 'Sigrid' 9-max Seat #8 is the button
Seat 1: Greha999 ($52.44 in chips) 
Seat 2: matiko09 ($103.66 in chips) 
Seat 3: Rafaello18 ($126.85 in chips) 
Seat 4: mbk88 ($100 in chips) 
Seat 5: chenconhaste ($100 in chips) 
Seat 8: ruslik_by ($100.32 in chips) 
Seat 9: KovIFish89 ($104.62 in chips) 
KovIFish89: posts small blind $0.50
Greha999: posts big blind $1
*** HOLE CARDS ***
Dealt to matiko09 [7c 8s]
matiko09: folds 
Rafaello18: folds 
mbk88: folds 
chenconhaste: folds 
ruslik_by: raises $1 to $2
KovIFish89: calls $1.50
Greha999: calls $1
*** FLOP *** [9s 2c 6c]
KovIFish89: bets $3.79
Greha999: folds 
ruslik_by: folds 
Uncalled bet ($3.79) returned to KovIFish89
KovIFish89 collected $5.70 from pot
KovIFish89: doesn't show hand 
*** SUMMARY ***
Total pot $6 | Rake $0.30 
Board [9s 2c 6c]
Seat 1: Greha999 (big blind) folded on the Flop
Seat 2: matiko09 folded before Flop (didn't bet)
Seat 3: Rafaello18 folded before Flop (didn't bet)
Seat 4: mbk88 folded before Flop (didn't bet)
Seat 5: chenconhaste folded before Flop (didn't bet)
Seat 8: ruslik_by (button) folded on the Flop
Seat 9: KovIFish89 (small blind) collected ($5.70)





PokerStars Hand #155381495108:  Hold'em No Limit ($0.25/$0.50 USD) - 2016/06/30 14:43:12 CET [2016/06/30 8:43:12 ET]
Table 'Arcturus' 9-max Seat #6 is the button
Seat 1: kourk250 ($141.59 in chips) 
Seat 2: Rafaello18 ($52.34 in chips) 
Seat 3: matiko09 ($65.69 in chips) 
Seat 5: stockbridge8 ($49.25 in chips) 
Seat 6: sanr23 ($51.31 in chips) 
Seat 7: bratbugor ($50 in chips) 
Seat 8: TheMinion ($64.28 in chips) 
Seat 9: joker180785 ($50 in chips) 
bratbugor: posts small blind $0.25
TheMinion: posts big blind $0.50
*** HOLE CARDS ***
Dealt to matiko09 [Tc 9h]
joker180785: folds 
kourk250: folds 
Rafaello18: folds 
matiko09: folds 
stockbridge8: folds 
sanr23: raises $0.50 to $1
bratbugor: folds 
TheMinion: folds 
Uncalled bet ($0.50) returned to sanr23
sanr23 collected $1.25 from pot
sanr23: doesn't show hand 
*** SUMMARY ***
Total pot $1.25 | Rake $0 
Seat 1: kourk250 folded before Flop (didn't bet)
Seat 2: Rafaello18 folded before Flop (didn't bet)
Seat 3: matiko09 folded before Flop (didn't bet)
Seat 5: stockbridge8 folded before Flop (didn't bet)
Seat 6: sanr23 (button) collected ($1.25)
Seat 7: bratbugor (small blind) folded before Flop
Seat 8: TheMinion (big blind) folded before Flop
Seat 9: joker180785 folded before Flop (didn't bet)





PokerStars Hand #155381499136:  Hold'em No Limit ($0.50/$1.00 USD) - 2016/06/30 14:43:20 CET [2016/06/30 8:43:20 ET]
Table 'California II' 9-max Seat #8 is the button
Seat 1: Rafaello18 ($100 in chips) 
Seat 2: ruslik_by ($149.81 in chips) 
Seat 3: KovIFish89 ($100 in chips) 
Seat 4: f1reworks ($101 in chips) 
Seat 5: Rohitbarve ($105.77 in chips) 
Seat 6: matiko09 ($129.98 in chips) 
Seat 7: DomiVY ($88.38 in chips) 
Seat 8: chenconhaste ($104 in chips) 
Seat 9: di0d80 ($207.74 in chips) 
di0d80: posts small blind $0.50
Rafaello18: posts big blind $1
*** HOLE CARDS ***
Dealt to matiko09 [Kh Ah]
ruslik_by: folds 
KovIFish89: raises $2 to $3
f1reworks: folds 
Rohitbarve: folds 
matiko09: raises $7 to $10
DomiVY: folds 
chenconhaste: folds 
di0d80: folds 
Rafaello18: folds 
KovIFish89: calls $7
*** FLOP *** [Ts 8c 3h]
KovIFish89: checks 
matiko09: checks 
*** TURN *** [Ts 8c 3h] [5s]
KovIFish89: bets $13.61
matiko09: folds 
Uncalled bet ($13.61) returned to KovIFish89
KovIFish89 collected $20.42 from pot
KovIFish89: doesn't show hand 
*** SUMMARY ***
Total pot $21.50 | Rake $1.08 
Board [Ts 8c 3h 5s]
Seat 1: Rafaello18 (big blind) folded before Flop
Seat 2: ruslik_by folded before Flop (didn't bet)
Seat 3: KovIFish89 collected ($20.42)
Seat 4: f1reworks folded before Flop (didn't bet)
Seat 5: Rohitbarve folded before Flop (didn't bet)
Seat 6: matiko09 folded on the Turn
Seat 7: DomiVY folded before Flop (didn't bet)
Seat 8: chenconhaste (button) folded before Flop (didn't bet)
Seat 9: di0d80 (small blind) folded before Flop





PokerStars Hand #155381501318:  Hold'em No Limit ($0.50/$1.00 USD) - 2016/06/30 14:43:25 CET [2016/06/30 8:43:25 ET]
Table 'Donnera' 9-max Seat #9 is the button
Seat 1: chenconhaste ($112.06 in chips) 
Seat 2: robbiescrim9 ($75.69 in chips) 
Seat 3: matiko09 ($137.82 in chips) 
Seat 4: Kukuryzka ($102.50 in chips) 
Seat 5: tipner ($110.90 in chips) 
Seat 6: nickreason17 ($100 in chips) 
Seat 7: Rafaello18 ($122.80 in chips) 
Seat 8: ruslik_by ($209.44 in chips) 
Seat 9: Starw!nd ($117.75 in chips) 
chenconhaste: posts small blind $0.50
robbiescrim9: posts big blind $1
*** HOLE CARDS ***
Dealt to matiko09 [3s Ah]
matiko09: folds 
Kukuryzka: folds 
tipner: folds 
nickreason17: folds 
Rafaello18: folds 
ruslik_by: raises $1.50 to $2.50
Starw!nd: folds 
chenconhaste: folds 
robbiescrim9: raises $5.50 to $8
ruslik_by: calls $5.50
*** FLOP *** [2h Qd 4h]
robbiescrim9: bets $15.68
ruslik_by: folds 
Uncalled bet ($15.68) returned to robbiescrim9
robbiescrim9 collected $15.68 from pot
robbiescrim9: doesn't show hand 
*** SUMMARY ***
Total pot $16.50 | Rake $0.82 
Board [2h Qd 4h]
Seat 1: chenconhaste (small blind) folded before Flop
Seat 2: robbiescrim9 (big blind) collected ($15.68)
Seat 3: matiko09 folded before Flop (didn't bet)
Seat 4: Kukuryzka folded before Flop (didn't bet)
Seat 5: tipner folded before Flop (didn't bet)
Seat 6: nickreason17 folded before Flop (didn't bet)
Seat 7: Rafaello18 folded before Flop (didn't bet)
Seat 8: ruslik_by folded on the Flop
Seat 9: Starw!nd (button) folded before Flop (didn't bet)





PokerStars Hand #155381506726:  Hold'em No Limit ($0.50/$1.00 USD) - 2016/06/30 14:43:36 CET [2016/06/30 8:43:36 ET]
Table 'Altarf II' 9-max Seat #2 is the button
Seat 1: Rafaello18 ($105.68 in chips) 
Seat 2: KovIFish89 ($100 in chips) 
Seat 3: sanr23 ($170.66 in chips) 
Seat 4: Greha999 ($150.06 in chips) 
Seat 6: mbk88 ($174.68 in chips) 
Seat 7: matiko09 ($109.22 in chips) 
Seat 8: DomiVY ($41.89 in chips) 
Seat 9: omanibemihum ($156.32 in chips) 
sanr23: posts small blind $0.50
Greha999: posts big blind $1
*** HOLE CARDS ***
Dealt to matiko09 [3s 6c]
mbk88: folds 
matiko09: folds 
DomiVY: folds 
omanibemihum: raises $1 to $2
Rafaello18: folds 
KovIFish89: folds 
sanr23: folds 
Greha999: calls $1
*** FLOP *** [5s Ah 7s]
Greha999: checks 
omanibemihum: bets $4
Greha999: calls $4
*** TURN *** [5s Ah 7s] [Qh]
Greha999: checks 
omanibemihum: checks 
*** RIVER *** [5s Ah 7s Qh] [3c]
Greha999: checks 
omanibemihum: checks 
*** SHOW DOWN ***
Greha999: shows [Kh 7d] (a pair of Sevens)
omanibemihum: mucks hand 
Greha999 collected $11.88 from pot
*** SUMMARY ***
Total pot $12.50 | Rake $0.62 
Board [5s Ah 7s Qh 3c]
Seat 1: Rafaello18 folded before Flop (didn't bet)
Seat 2: KovIFish89 (button) folded before Flop (didn't bet)
Seat 3: sanr23 (small blind) folded before Flop
Seat 4: Greha999 (big blind) showed [Kh 7d] and won ($11.88) with a pair of Sevens
Seat 6: mbk88 folded before Flop (didn't bet)
Seat 7: matiko09 folded before Flop (didn't bet)
Seat 8: DomiVY folded before Flop (didn't bet)
Seat 9: omanibemihum mucked [8d 9h]





PokerStars Hand #155381512932:  Hold'em No Limit ($0.25/$0.50 USD) - 2016/06/30 14:43:49 CET [2016/06/30 8:43:49 ET]
Table 'Chort III' 9-max Seat #6 is the button
Seat 1: BladeChen ($72.01 in chips) 
Seat 4: kotkas1000 ($50 in chips) 
Seat 5: Hit Pit ($30.96 in chips) 
Seat 6: Franky77200 ($28.72 in chips) 
Seat 7: matiko09 ($54.98 in chips) 
Seat 8: Kukuryzka ($49.90 in chips) 
Seat 9: r4mz3s ($50 in chips) 
matiko09: posts small blind $0.25
Kukuryzka: posts big blind $0.50
Yourstepmom: sits out 
Dantist1122: sits out 
BladeChen: posts the ante $0.10
kotkas1000: posts the ante $0.10
Hit Pit: posts the ante $0.10
Franky77200: posts the ante $0.10
matiko09: posts the ante $0.10
Kukuryzka: posts the ante $0.10
r4mz3s: posts the ante $0.10
*** HOLE CARDS ***
Dealt to matiko09 [8s 7h]
r4mz3s: folds 
BladeChen: folds 
kotkas1000: folds 
Hit Pit: calls $0.50
Franky77200: calls $0.50
matiko09: calls $0.25
Kukuryzka: checks 
*** FLOP *** [9c 9h Qh]
matiko09: checks 
Kukuryzka: checks 
Hit Pit: bets $1
Franky77200: folds 
matiko09: folds 
Kukuryzka: folds 
Uncalled bet ($1) returned to Hit Pit
Hit Pit collected $2.56 from pot
*** SUMMARY ***
Total pot $2.70 | Rake $0.14 
Board [9c 9h Qh]
Seat 1: BladeChen folded before Flop (didn't bet)
Seat 4: kotkas1000 folded before Flop (didn't bet)
Seat 5: Hit Pit collected ($2.56)
Seat 6: Franky77200 (button) folded on the Flop
Seat 7: matiko09 (small blind) folded on the Flop
Seat 8: Kukuryzka (big blind) folded on the Flop
Seat 9: r4mz3s folded before Flop (didn't bet)





PokerStars Hand #155381513355:  Hold'em No Limit ($0.25/$0.50 USD) - 2016/06/30 14:43:50 CET [2016/06/30 8:43:50 ET]
Table 'Thalia II' 9-max Seat #7 is the button
Seat 2: DeathcorePkr ($54.44 in chips) 
Seat 3: r4mz3s ($73.92 in chips) 
Seat 4: Kukuryzka ($52.37 in chips) 
Seat 5: geowin ($50.91 in chips) 
Seat 6: chenconhaste ($54.09 in chips) 
Seat 7: fudzi ($67.92 in chips) 
Seat 8: Jo_Medici ($51.90 in chips) 
Seat 9: matiko09 ($50 in chips) 
Jo_Medici: posts small blind $0.25
matiko09: posts big blind $0.50
DeathcorePkr: posts the ante $0.10
r4mz3s: posts the ante $0.10
Kukuryzka: posts the ante $0.10
geowin: posts the ante $0.10
chenconhaste: posts the ante $0.10
fudzi: posts the ante $0.10
Jo_Medici: posts the ante $0.10
matiko09: posts the ante $0.10
*** HOLE CARDS ***
Dealt to matiko09 [5d Ts]
DeathcorePkr is disconnected 
DeathcorePkr has timed out while disconnected
DeathcorePkr: folds 
r4mz3s: folds 
Kukuryzka: folds 
geowin: folds 
chenconhaste: folds 
fudzi: raises $1 to $1.50
Jo_Medici: raises $3.75 to $5.25
matiko09: folds 
fudzi: calls $3.75
*** FLOP *** [7h 6c 9c]
Jo_Medici: checks 
fudzi: checks 
*** TURN *** [7h 6c 9c] [3c]
Jo_Medici: bets $7
fudzi: folds 
Uncalled bet ($7) returned to Jo_Medici
Jo_Medici collected $11.21 from pot
Jo_Medici: doesn't show hand 
*** SUMMARY ***
Total pot $11.80 | Rake $0.59 
Board [7h 6c 9c 3c]
Seat 2: DeathcorePkr folded before Flop (didn't bet)
Seat 3: r4mz3s folded before Flop (didn't bet)
Seat 4: Kukuryzka folded before Flop (didn't bet)
Seat 5: geowin folded before Flop (didn't bet)
Seat 6: chenconhaste folded before Flop (didn't bet)
Seat 7: fudzi (button) folded on the Turn
Seat 8: Jo_Medici (small blind) collected ($11.21)
Seat 9: matiko09 (big blind) folded before Flop





PokerStars Hand #155381513324:  Hold'em No Limit ($0.50/$1.00 USD) - 2016/06/30 14:43:50 CET [2016/06/30 8:43:50 ET]
Table 'Asmodeus' 9-max Seat #2 is the button
Seat 2: DomiVY ($40 in chips) 
Seat 3: matiko09 ($102.65 in chips) 
Seat 4: Ty Nick 420 ($110.56 in chips) 
Seat 5: sanr23 ($100 in chips) 
Seat 6: koutani7 ($80.53 in chips) 
Seat 7: aaronzzr ($159.32 in chips) 
Seat 8: Rafaello18 ($175.37 in chips) 
Seat 9: mbk88 ($162.06 in chips) 
matiko09: posts small blind $0.50
Ty Nick 420: posts big blind $1
*** HOLE CARDS ***
Dealt to matiko09 [3s Kh]
sanr23: folds 
koutani7: raises $2 to $3
aaronzzr: calls $3
Rafaello18: folds 
mbk88: raises $9 to $12
DomiVY: folds 
matiko09: folds 
Ty Nick 420: folds 
koutani7: folds 
aaronzzr: calls $9
*** FLOP *** [2c 6h 9h]
aaronzzr: checks 
mbk88: bets $12
aaronzzr: raises $12 to $24
mbk88: folds 
Uncalled bet ($12) returned to aaronzzr
aaronzzr collected $50 from pot
aaronzzr: doesn't show hand 
*** SUMMARY ***
Total pot $52.50 | Rake $2.50 
Board [2c 6h 9h]
Seat 2: DomiVY (button) folded before Flop (didn't bet)
Seat 3: matiko09 (small blind) folded before Flop
Seat 4: Ty Nick 420 (big blind) folded before Flop
Seat 5: sanr23 folded before Flop (didn't bet)
Seat 6: koutani7 folded before Flop
Seat 7: aaronzzr collected ($50)
Seat 8: Rafaello18 folded before Flop (didn't bet)
Seat 9: mbk88 folded on the Flop





PokerStars Hand #155381514167:  Hold'em No Limit ($0.50/$1.00 USD) - 2016/06/30 14:43:52 CET [2016/06/30 8:43:52 ET]
Table 'Tatjana' 9-max Seat #5 is the button
Seat 1: tipner ($100 in chips) 
Seat 2: Kukuryzka ($105.38 in chips) 
Seat 3: Rafaello18 ($105.88 in chips) 
Seat 4: mopatron25 ($70.81 in chips) 
Seat 5: matiko09 ($100 in chips) 
Seat 6: mbk88 ($203.54 in chips) 
Seat 8: alhill86 ($146.06 in chips) 
Seat 9: Ty Nick 420 ($100 in chips) 
mbk88: posts small blind $0.50
alhill86: posts big blind $1
*** HOLE CARDS ***
Dealt to matiko09 [9s 5h]
Ty Nick 420: folds 
tipner: folds 
Kukuryzka: folds 
Rafaello18: folds 
mopatron25: calls $1
matiko09: folds 
mbk88: folds 
alhill86: checks 
*** FLOP *** [8d Qc 7c]
alhill86: checks 
mopatron25: checks 
*** TURN *** [8d Qc 7c] [Ks]
alhill86: checks 
mopatron25: checks 
*** RIVER *** [8d Qc 7c Ks] [9d]
alhill86: checks 
mopatron25: checks 
*** SHOW DOWN ***
alhill86: shows [As 4h] (high card Ace)
mopatron25: shows [3d Ah] (high card Ace)
alhill86 collected $1.19 from pot
mopatron25 collected $1.19 from pot
*** SUMMARY ***
Total pot $2.50 | Rake $0.12 
Board [8d Qc 7c Ks 9d]
Seat 1: tipner folded before Flop (didn't bet)
Seat 2: Kukuryzka folded before Flop (didn't bet)
Seat 3: Rafaello18 folded before Flop (didn't bet)
Seat 4: mopatron25 showed [3d Ah] and won ($1.19) with high card Ace
Seat 5: matiko09 (button) folded before Flop (didn't bet)
Seat 6: mbk88 (small blind) folded before Flop
Seat 8: alhill86 (big blind) showed [As 4h] and won ($1.19) with high card Ace
Seat 9: Ty Nick 420 folded before Flop (didn't bet)





PokerStars Hand #155381516796:  Hold'em No Limit ($0.50/$1.00 USD) - 2016/06/30 14:43:57 CET [2016/06/30 8:43:57 ET]
Table 'Borrelly II' 9-max Seat #7 is the button
Seat 1: Rafaello18 ($121.59 in chips) 
Seat 2: mbk88 ($100 in chips) 
Seat 4: DonRon_AT ($98 in chips) 
Seat 5: Ty Nick 420 ($102.50 in chips) 
Seat 6: m_michalec ($168.92 in chips) 
Seat 7: matiko09 ($174.36 in chips) 
Seat 8: Arjun A Raju ($135.50 in chips) 
Seat 9: ruslik_by ($100 in chips) 
Arjun A Raju: posts small blind $0.50
ruslik_by: posts big blind $1
*** HOLE CARDS ***
Dealt to matiko09 [Js 9h]
Rafaello18: folds 
mbk88: folds 
DonRon_AT: folds 
Ty Nick 420: raises $1.50 to $2.50
m_michalec: calls $2.50
matiko09: folds 
Arjun A Raju: folds 
ruslik_by: raises $9.50 to $12
Ty Nick 420: calls $9.50
m_michalec: folds 
*** FLOP *** [7h 7s Jc]
ruslik_by: bets $8.72
Ty Nick 420: folds 
Uncalled bet ($8.72) returned to ruslik_by
ruslik_by collected $25.65 from pot
ruslik_by: doesn't show hand 
*** SUMMARY ***
Total pot $27 | Rake $1.35 
Board [7h 7s Jc]
Seat 1: Rafaello18 folded before Flop (didn't bet)
Seat 2: mbk88 folded before Flop (didn't bet)
Seat 4: DonRon_AT folded before Flop (didn't bet)
Seat 5: Ty Nick 420 folded on the Flop
Seat 6: m_michalec folded before Flop
Seat 7: matiko09 (button) folded before Flop (didn't bet)
Seat 8: Arjun A Raju (small blind) folded before Flop
Seat 9: ruslik_by (big blind) collected ($25.65)





PokerStars Hand #155381518978:  Hold'em No Limit (€0.25/€0.50 EUR) - 2016/06/30 14:44:01 CET [2016/06/30 8:44:01 ET]
Table 'Vibeke II' 9-max Seat #5 is the button
Seat 4: acelacat111 (€33.46 in chips) 
Seat 5: mazefaka007 (€65.58 in chips) 
Seat 6: Kukuryzka (€54.49 in chips) 
Seat 7: matiko09 (€60.52 in chips) 
Seat 8: Math9881 (€40 in chips) 
Seat 9: funXmun (€53.75 in chips) 
Kukuryzka: posts small blind €0.25
matiko09: posts big blind €0.50
Math9881: posts big blind €0.50
kotkas1000: sits out 
*** HOLE CARDS ***
Dealt to matiko09 [Ts Ks]
Math9881: raises €1 to €1.50
funXmun: folds 
acelacat111: folds 
mazefaka007: folds 
Kukuryzka: folds 
matiko09: calls €1
*** FLOP *** [Jd 5c Ah]
RvPersie joins the table at seat #3 
matiko09: checks 
Math9881: checks 
*** TURN *** [Jd 5c Ah] [2d]
matiko09: checks 
drosser321 joins the table at seat #2 
Math9881: checks 
*** RIVER *** [Jd 5c Ah 2d] [Ad]
matiko09: checks 
Math9881: checks 
*** SHOW DOWN ***
matiko09: shows [Ts Ks] (a pair of Aces)
Math9881: shows [Kh Th] (a pair of Aces)
matiko09 collected €1.55 from pot
Math9881 collected €1.54 from pot
*** SUMMARY ***
Total pot €3.25 | Rake €0.16 
Board [Jd 5c Ah 2d Ad]
Seat 4: acelacat111 folded before Flop (didn't bet)
Seat 5: mazefaka007 (button) folded before Flop (didn't bet)
Seat 6: Kukuryzka (small blind) folded before Flop
Seat 7: matiko09 (big blind) showed [Ts Ks] and won (€1.55) with a pair of Aces
Seat 8: Math9881 showed [Kh Th] and won (€1.54) with a pair of Aces
Seat 9: funXmun folded before Flop (didn't bet)





PokerStars Hand #155381520326:  Hold'em No Limit ($0.50/$1.00 USD) - 2016/06/30 14:44:04 CET [2016/06/30 8:44:04 ET]
Table 'Sigrid' 9-max Seat #9 is the button
Seat 1: Greha999 ($50.44 in chips) 
Seat 2: matiko09 ($103.66 in chips) 
Seat 3: Rafaello18 ($126.85 in chips) 
Seat 4: mbk88 ($100 in chips) 
Seat 5: chenconhaste ($100 in chips) 
Seat 8: ruslik_by ($100 in chips) 
Seat 9: KovIFish89 ($108.32 in chips) 
Greha999: posts small blind $0.50
matiko09: posts big blind $1
*** HOLE CARDS ***
Dealt to matiko09 [Ts Qd]
Rafaello18: folds 
mbk88: folds 
chenconhaste: folds 
ruslik_by: folds 
KovIFish89: raises $1 to $2
Greha999: calls $1.50
matiko09: calls $1
*** FLOP *** [As Jh 9h]
Greha999: checks 
matiko09: checks 
KovIFish89: checks 
*** TURN *** [As Jh 9h] [Qc]
Greha999: checks 
matiko09: checks 
KovIFish89: checks 
*** RIVER *** [As Jh 9h Qc] [6d]
Greha999: checks 
matiko09: checks 
KovIFish89: checks 
*** SHOW DOWN ***
Greha999: shows [Jd 8s] (a pair of Jacks)
matiko09: shows [Ts Qd] (a pair of Queens)
KovIFish89: mucks hand 
matiko09 collected $5.70 from pot
*** SUMMARY ***
Total pot $6 | Rake $0.30 
Board [As Jh 9h Qc 6d]
Seat 1: Greha999 (small blind) showed [Jd 8s] and lost with a pair of Jacks
Seat 2: matiko09 (big blind) showed [Ts Qd] and won ($5.70) with a pair of Queens
Seat 3: Rafaello18 folded before Flop (didn't bet)
Seat 4: mbk88 folded before Flop (didn't bet)
Seat 5: chenconhaste folded before Flop (didn't bet)
Seat 8: ruslik_by folded before Flop (didn't bet)
Seat 9: KovIFish89 (button) mucked [8c Kd]





PokerStars Hand #155381523041:  Hold'em No Limit ($0.50/$1.00 USD) - 2016/06/30 14:44:10 CET [2016/06/30 8:44:10 ET]
Table 'California II' 9-max Seat #9 is the button
Seat 1: Rafaello18 ($100 in chips) 
Seat 2: ruslik_by ($149.81 in chips) 
Seat 3: KovIFish89 ($110.42 in chips) 
Seat 4: f1reworks ($101 in chips) 
Seat 5: Rohitbarve ($105.77 in chips) 
Seat 6: matiko09 ($119.98 in chips) 
Seat 7: DomiVY ($88.38 in chips) 
Seat 8: chenconhaste ($104 in chips) 
Seat 9: di0d80 ($207.24 in chips) 
Rafaello18: posts small blind $0.50
ruslik_by: posts big blind $1
*** HOLE CARDS ***
Dealt to matiko09 [2s 8d]
KovIFish89: folds 
f1reworks: folds 
Rohitbarve: folds 
matiko09: folds 
DomiVY: folds 
chenconhaste: folds 
di0d80: folds 
Rafaello18: raises $1.50 to $2.50
ruslik_by: raises $6 to $8.50
Rafaello18: raises $11.50 to $20
ruslik_by: folds 
Uncalled bet ($11.50) returned to Rafaello18
Rafaello18 collected $17 from pot
Rafaello18: doesn't show hand 
*** SUMMARY ***
Total pot $17 | Rake $0 
Seat 1: Rafaello18 (small blind) collected ($17)
Seat 2: ruslik_by (big blind) folded before Flop
Seat 3: KovIFish89 folded before Flop (didn't bet)
Seat 4: f1reworks folded before Flop (didn't bet)
Seat 5: Rohitbarve folded before Flop (didn't bet)
Seat 6: matiko09 folded before Flop (didn't bet)
Seat 7: DomiVY folded before Flop (didn't bet)
Seat 8: chenconhaste folded before Flop (didn't bet)
Seat 9: di0d80 (button) folded before Flop (didn't bet)





PokerStars Hand #155381523745:  Hold'em No Limit ($0.50/$1.00 USD) - 2016/06/30 14:44:11 CET [2016/06/30 8:44:11 ET]
Table 'Donnera' 9-max Seat #1 is the button
Seat 1: chenconhaste ($111.56 in chips) 
Seat 2: robbiescrim9 ($83.37 in chips) 
Seat 3: matiko09 ($137.82 in chips) 
Seat 4: Kukuryzka ($102.50 in chips) 
Seat 5: tipner ($110.90 in chips) 
Seat 6: nickreason17 ($100 in chips) 
Seat 7: Rafaello18 ($122.80 in chips) 
Seat 8: ruslik_by ($201.44 in chips) 
Seat 9: Starw!nd ($117.75 in chips) 
robbiescrim9: posts small blind $0.50
matiko09: posts big blind $1
*** HOLE CARDS ***
Dealt to matiko09 [4s 9h]
Kukuryzka: folds 
tipner: folds 
nickreason17: folds 
Rafaello18: raises $1.50 to $2.50
ruslik_by: folds 
Starw!nd: folds 
chenconhaste: calls $2.50
robbiescrim9: folds 
matiko09: folds 
*** FLOP *** [4h Tc 2c]
Rafaello18: bets $4
chenconhaste: calls $4
*** TURN *** [4h Tc 2c] [Th]
Rafaello18: checks 
chenconhaste: checks 
*** RIVER *** [4h Tc 2c Th] [6s]
Rafaello18: checks 
chenconhaste: checks 
*** SHOW DOWN ***
Rafaello18: shows [Ac Ks] (a pair of Tens)
chenconhaste: shows [5d 5s] (two pair, Tens and Fives)
chenconhaste collected $13.78 from pot
*** SUMMARY ***
Total pot $14.50 | Rake $0.72 
Board [4h Tc 2c Th 6s]
Seat 1: chenconhaste (button) showed [5d 5s] and won ($13.78) with two pair, Tens and Fives
Seat 2: robbiescrim9 (small blind) folded before Flop
Seat 3: matiko09 (big blind) folded before Flop
Seat 4: Kukuryzka folded before Flop (didn't bet)
Seat 5: tipner folded before Flop (didn't bet)
Seat 6: nickreason17 folded before Flop (didn't bet)
Seat 7: Rafaello18 showed [Ac Ks] and lost with a pair of Tens
Seat 8: ruslik_by folded before Flop (didn't bet)
Seat 9: Starw!nd folded before Flop (didn't bet)





PokerStars Hand #155381525507:  Hold'em No Limit ($0.25/$0.50 USD) - 2016/06/30 14:44:15 CET [2016/06/30 8:44:15 ET]
Table 'Arcturus' 9-max Seat #7 is the button
Seat 1: kourk250 ($141.59 in chips) 
Seat 2: Rafaello18 ($52.34 in chips) 
Seat 3: matiko09 ($65.69 in chips) 
Seat 5: stockbridge8 ($49.25 in chips) 
Seat 6: sanr23 ($52.06 in chips) 
Seat 7: bratbugor ($50 in chips) 
Seat 8: TheMinion ($63.78 in chips) 
Seat 9: joker180785 ($50 in chips) 
TheMinion: posts small blind $0.25
joker180785: posts big blind $0.50
*** HOLE CARDS ***
Dealt to matiko09 [2c 4s]
kourk250: raises $1.25 to $1.75
Rafaello18: folds 
matiko09: folds 
stockbridge8: folds 
sanr23: calls $1.75
bratbugor: folds 
TheMinion: folds 
joker180785: folds 
*** FLOP *** [3s 6d 3h]
kourk250: bets $2.02
sanr23: calls $2.02
*** TURN *** [3s 6d 3h] [Jd]
kourk250: bets $3.94
sanr23: calls $3.94
*** RIVER *** [3s 6d 3h Jd] [Ah]
kourk250: checks 
sanr23: checks 
*** SHOW DOWN ***
kourk250: shows [8d 8c] (two pair, Eights and Threes)
sanr23: shows [8s 8h] (two pair, Eights and Threes)
kourk250 collected $7.68 from pot
sanr23 collected $7.68 from pot
*** SUMMARY ***
Total pot $16.17 | Rake $0.81 
Board [3s 6d 3h Jd Ah]
Seat 1: kourk250 showed [8d 8c] and won ($7.68) with two pair, Eights and Threes
Seat 2: Rafaello18 folded before Flop (didn't bet)
Seat 3: matiko09 folded before Flop (didn't bet)
Seat 5: stockbridge8 folded before Flop (didn't bet)
Seat 6: sanr23 showed [8s 8h] and won ($7.68) with two pair, Eights and Threes
Seat 7: bratbugor (button) folded before Flop (didn't bet)
Seat 8: TheMinion (small blind) folded before Flop
Seat 9: joker180785 (big blind) folded before Flop





PokerStars Hand #155381538217:  Hold'em No Limit ($0.50/$1.00 USD) - 2016/06/30 14:44:41 CET [2016/06/30 8:44:41 ET]
Table 'Tatjana' 9-max Seat #6 is the button
Seat 1: tipner ($100 in chips) 
Seat 2: Kukuryzka ($105.38 in chips) 
Seat 3: Rafaello18 ($105.88 in chips) 
Seat 4: mopatron25 ($71 in chips) 
Seat 5: matiko09 ($100 in chips) 
Seat 6: mbk88 ($203.04 in chips) 
Seat 8: alhill86 ($146.25 in chips) 
Seat 9: Ty Nick 420 ($100 in chips) 
alhill86: posts small blind $0.50
Ty Nick 420: posts big blind $1
*** HOLE CARDS ***
Dealt to matiko09 [9h 8c]
tipner: folds 
Kukuryzka: folds 
Rafaello18: folds 
mopatron25: calls $1
matiko09: folds 
mbk88: folds 
alhill86: calls $0.50
Ty Nick 420: checks 
*** FLOP *** [3h Ts 8d]
alhill86: bets $2
Ty Nick 420: folds 
mopatron25: calls $2
*** TURN *** [3h Ts 8d] [Ah]
alhill86: checks 
mopatron25: bets $3
alhill86: calls $3
*** RIVER *** [3h Ts 8d Ah] [6s]
alhill86: checks 
mopatron25: checks 
*** SHOW DOWN ***
alhill86: shows [8h 6h] (two pair, Eights and Sixes)
mopatron25: mucks hand 
alhill86 collected $12.35 from pot
*** SUMMARY ***
Total pot $13 | Rake $0.65 
Board [3h Ts 8d Ah 6s]
Seat 1: tipner folded before Flop (didn't bet)
Seat 2: Kukuryzka folded before Flop (didn't bet)
Seat 3: Rafaello18 folded before Flop (didn't bet)
Seat 4: mopatron25 mucked [3d Qd]
Seat 5: matiko09 folded before Flop (didn't bet)
Seat 6: mbk88 (button) folded before Flop (didn't bet)
Seat 8: alhill86 (small blind) showed [8h 6h] and won ($12.35) with two pair, Eights and Sixes
Seat 9: Ty Nick 420 (big blind) folded on the Flop





PokerStars Hand #155381542037:  Hold'em No Limit (€0.25/€0.50 EUR) - 2016/06/30 14:44:49 CET [2016/06/30 8:44:49 ET]
Table 'Vibeke II' 9-max Seat #6 is the button
Seat 4: acelacat111 (€33.46 in chips) 
Seat 5: mazefaka007 (€65.58 in chips) 
Seat 6: Kukuryzka (€54.24 in chips) 
Seat 7: matiko09 (€60.57 in chips) 
Seat 8: Math9881 (€40.04 in chips) 
Seat 9: funXmun (€53.75 in chips) 
matiko09: posts small blind €0.25
Math9881: posts big blind €0.50
kotkas1000: sits out 
drosser321: sits out 
RvPersie: sits out 
*** HOLE CARDS ***
Dealt to matiko09 [5d 7s]
funXmun: raises €0.63 to €1.13
acelacat111: folds 
mazefaka007: folds 
Kukuryzka: folds 
matiko09: folds 
Math9881: calls €0.63
*** FLOP *** [Qc 6s Ac]
Math9881: checks 
funXmun: checks 
*** TURN *** [Qc 6s Ac] [3d]
Math9881: bets €1
funXmun: folds 
Uncalled bet (€1) returned to Math9881
Math9881 collected €2.38 from pot
Math9881: doesn't show hand 
*** SUMMARY ***
Total pot €2.51 | Rake €0.13 
Board [Qc 6s Ac 3d]
Seat 4: acelacat111 folded before Flop (didn't bet)
Seat 5: mazefaka007 folded before Flop (didn't bet)
Seat 6: Kukuryzka (button) folded before Flop (didn't bet)
Seat 7: matiko09 (small blind) folded before Flop
Seat 8: Math9881 (big blind) collected (€2.38)
Seat 9: funXmun folded on the Turn





PokerStars Hand #155381542880:  Hold'em No Limit ($0.25/$0.50 USD) - 2016/06/30 14:44:51 CET [2016/06/30 8:44:51 ET]
Table 'Chort III' 9-max Seat #7 is the button
Seat 1: BladeChen ($71.91 in chips) 
Seat 4: kotkas1000 ($50 in chips) 
Seat 5: Hit Pit ($32.92 in chips) 
Seat 6: Franky77200 ($28.12 in chips) 
Seat 7: matiko09 ($54.38 in chips) 
Seat 8: Kukuryzka ($50 in chips) 
Seat 9: r4mz3s ($50 in chips) 
Kukuryzka: posts small blind $0.25
r4mz3s: posts big blind $0.50
Yourstepmom: sits out 
Dantist1122: sits out 
BladeChen: posts the ante $0.10
kotkas1000: posts the ante $0.10
Hit Pit: posts the ante $0.10
Franky77200: posts the ante $0.10
matiko09: posts the ante $0.10
Kukuryzka: posts the ante $0.10
r4mz3s: posts the ante $0.10
*** HOLE CARDS ***
Dealt to matiko09 [9h 7s]
BladeChen: folds 
kotkas1000: folds 
Hit Pit: folds 
Franky77200: raises $1 to $1.50
matiko09: folds 
Kukuryzka: folds 
r4mz3s: folds 
Uncalled bet ($1) returned to Franky77200
Franky77200 collected $1.95 from pot
Franky77200: doesn't show hand 
*** SUMMARY ***
Total pot $1.95 | Rake $0 
Seat 1: BladeChen folded before Flop (didn't bet)
Seat 4: kotkas1000 folded before Flop (didn't bet)
Seat 5: Hit Pit folded before Flop (didn't bet)
Seat 6: Franky77200 collected ($1.95)
Seat 7: matiko09 (button) folded before Flop (didn't bet)
Seat 8: Kukuryzka (small blind) folded before Flop
Seat 9: r4mz3s (big blind) folded before Flop





PokerStars Hand #155381546389:  Hold'em No Limit ($0.50/$1.00 USD) - 2016/06/30 14:44:58 CET [2016/06/30 8:44:58 ET]
Table 'California II' 9-max Seat #1 is the button
Seat 1: Rafaello18 ($108.50 in chips) 
Seat 2: ruslik_by ($141.31 in chips) 
Seat 3: KovIFish89 ($110.42 in chips) 
Seat 4: f1reworks ($101 in chips) 
Seat 5: Rohitbarve ($105.77 in chips) 
Seat 6: matiko09 ($119.98 in chips) 
Seat 7: DomiVY ($88.38 in chips) 
Seat 8: chenconhaste ($104 in chips) 
Seat 9: di0d80 ($207.24 in chips) 
ruslik_by: posts small blind $0.50
KovIFish89: posts big blind $1
*** HOLE CARDS ***
Dealt to matiko09 [6s 2c]
f1reworks: folds 
Rohitbarve: folds 
matiko09: folds 
DomiVY: folds 
chenconhaste: folds 
di0d80: raises $1.50 to $2.50
Rafaello18: folds 
ruslik_by: folds 
KovIFish89: folds 
Uncalled bet ($1.50) returned to di0d80
di0d80 collected $2.50 from pot
di0d80: doesn't show hand 
*** SUMMARY ***
Total pot $2.50 | Rake $0 
Seat 1: Rafaello18 (button) folded before Flop (didn't bet)
Seat 2: ruslik_by (small blind) folded before Flop
Seat 3: KovIFish89 (big blind) folded before Flop
Seat 4: f1reworks folded before Flop (didn't bet)
Seat 5: Rohitbarve folded before Flop (didn't bet)
Seat 6: matiko09 folded before Flop (didn't bet)
Seat 7: DomiVY folded before Flop (didn't bet)
Seat 8: chenconhaste folded before Flop (didn't bet)
Seat 9: di0d80 collected ($2.50)





PokerStars Hand #155381546146:  Hold'em No Limit ($0.50/$1.00 USD) - 2016/06/30 14:44:58 CET [2016/06/30 8:44:58 ET]
Table 'Sigrid' 9-max Seat #1 is the button
Seat 1: Greha999 ($48.44 in chips) 
Seat 2: matiko09 ($107.36 in chips) 
Seat 3: Rafaello18 ($126.85 in chips) 
Seat 4: mbk88 ($100 in chips) 
Seat 5: chenconhaste ($100 in chips) 
Seat 8: ruslik_by ($100 in chips) 
Seat 9: KovIFish89 ($106.32 in chips) 
matiko09: posts small blind $0.50
Rafaello18: posts big blind $1
*** HOLE CARDS ***
Dealt to matiko09 [7c Qc]
mbk88: folds 
chenconhaste: folds 
ruslik_by: folds 
KovIFish89: folds 
Greha999: raises $2 to $3
matiko09: folds 
Rafaello18: folds 
Uncalled bet ($2) returned to Greha999
Greha999 collected $2.50 from pot
*** SUMMARY ***
Total pot $2.50 | Rake $0 
Seat 1: Greha999 (button) collected ($2.50)
Seat 2: matiko09 (small blind) folded before Flop
Seat 3: Rafaello18 (big blind) folded before Flop
Seat 4: mbk88 folded before Flop (didn't bet)
Seat 5: chenconhaste folded before Flop (didn't bet)
Seat 8: ruslik_by folded before Flop (didn't bet)
Seat 9: KovIFish89 folded before Flop (didn't bet)





PokerStars Hand #155381554733:  Hold'em No Limit ($0.25/$0.50 USD) - 2016/06/30 14:45:15 CET [2016/06/30 8:45:15 ET]
Table 'Chort III' 9-max Seat #8 is the button
Seat 2: Yourstepmom ($50 in chips) 
Seat 4: kotkas1000 ($50 in chips) 
Seat 5: Hit Pit ($32.82 in chips) 
Seat 6: Franky77200 ($29.47 in chips) 
Seat 7: matiko09 ($54.28 in chips) 
Seat 8: Kukuryzka ($49.65 in chips) 
Seat 9: r4mz3s ($50 in chips) 
r4mz3s: posts small blind $0.25
Yourstepmom: posts big blind $0.50
Dantist1122: sits out 
Yourstepmom: posts the ante $0.10
kotkas1000: posts the ante $0.10
Hit Pit: posts the ante $0.10
Franky77200: posts the ante $0.10
matiko09: posts the ante $0.10
Kukuryzka: posts the ante $0.10
r4mz3s: posts the ante $0.10
*** HOLE CARDS ***
Dealt to matiko09 [5c 9d]
kotkas1000: folds 
Hit Pit: calls $0.50
Franky77200: calls $0.50
matiko09: folds 
Kukuryzka: calls $0.50
r4mz3s: raises $3 to $3.50
Yourstepmom: raises $9.20 to $12.70
Hit Pit: folds 
Franky77200: folds 
Kukuryzka: folds 
r4mz3s: folds 
Uncalled bet ($9.20) returned to Yourstepmom
Yourstepmom collected $9.20 from pot
Yourstepmom: doesn't show hand 
*** SUMMARY ***
Total pot $9.20 | Rake $0 
Seat 2: Yourstepmom (big blind) collected ($9.20)
Seat 4: kotkas1000 folded before Flop (didn't bet)
Seat 5: Hit Pit folded before Flop
Seat 6: Franky77200 folded before Flop
Seat 7: matiko09 folded before Flop (didn't bet)
Seat 8: Kukuryzka (button) folded before Flop
Seat 9: r4mz3s (small blind) folded before Flop





PokerStars Hand #155381555754:  Hold'em No Limit ($0.50/$1.00 USD) - 2016/06/30 14:45:18 CET [2016/06/30 8:45:18 ET]
Table 'Tatjana' 9-max Seat #8 is the button
Seat 1: tipner ($100 in chips) 
Seat 2: Kukuryzka ($105.38 in chips) 
Seat 3: Rafaello18 ($105.88 in chips) 
Seat 4: mopatron25 ($65 in chips) 
Seat 5: matiko09 ($100 in chips) 
Seat 6: mbk88 ($203.04 in chips) 
Seat 8: alhill86 ($152.60 in chips) 
Seat 9: Ty Nick 420 ($100 in chips) 
Ty Nick 420: posts small blind $0.50
tipner: posts big blind $1
*** HOLE CARDS ***
Dealt to matiko09 [Ad 7c]
Kukuryzka: folds 
Rafaello18: folds 
mopatron25: folds 
matiko09: folds 
mbk88: folds 
alhill86: raises $2 to $3
Ty Nick 420: folds 
tipner: raises $7 to $10
alhill86: calls $7
*** FLOP *** [4h Qd 5h]
tipner: checks 
alhill86: bets $9.74
tipner: calls $9.74
*** TURN *** [4h Qd 5h] [2h]
tipner: checks 
alhill86: bets $20
tipner: calls $20
*** RIVER *** [4h Qd 5h 2h] [Qs]
tipner: checks 
alhill86: bets $40
tipner: calls $40
*** SHOW DOWN ***
alhill86: shows [9h Ah] (a flush, Ace high)
tipner: mucks hand 
alhill86 collected $157.48 from pot
*** SUMMARY ***
Total pot $159.98 | Rake $2.50 
Board [4h Qd 5h 2h Qs]
Seat 1: tipner (big blind) mucked [9s 9d]
Seat 2: Kukuryzka folded before Flop (didn't bet)
Seat 3: Rafaello18 folded before Flop (didn't bet)
Seat 4: mopatron25 folded before Flop (didn't bet)
Seat 5: matiko09 folded before Flop (didn't bet)
Seat 6: mbk88 folded before Flop (didn't bet)
Seat 8: alhill86 (button) showed [9h Ah] and won ($157.48) with a flush, Ace high
Seat 9: Ty Nick 420 (small blind) folded before Flop





PokerStars Hand #155381560629:  Hold'em No Limit ($0.50/$1.00 USD) - 2016/06/30 14:45:28 CET [2016/06/30 8:45:28 ET]
Table 'Borrelly II' 9-max Seat #8 is the button
Seat 1: Rafaello18 ($121.59 in chips) 
Seat 2: mbk88 ($100 in chips) 
Seat 4: DonRon_AT ($98 in chips) 
Seat 5: Ty Nick 420 ($100 in chips) 
Seat 6: m_michalec ($166.42 in chips) 
Seat 7: matiko09 ($174.36 in chips) 
Seat 8: Arjun A Raju ($135 in chips) 
Seat 9: ruslik_by ($113.65 in chips) 
ruslik_by: posts small blind $0.50
Rafaello18: posts big blind $1
*** HOLE CARDS ***
Dealt to matiko09 [Jd 3h]
mbk88: folds 
DonRon_AT: calls $1
Ty Nick 420: folds 
m_michalec: folds 
matiko09: folds 
Arjun A Raju: folds 
ruslik_by: calls $0.50
Rafaello18: checks 
*** FLOP *** [Jc 5d Kd]
ruslik_by: bets $1
Rafaello18: folds 
DonRon_AT: calls $1
*** TURN *** [Jc 5d Kd] [6h]
ruslik_by: checks 
DonRon_AT: checks 
*** RIVER *** [Jc 5d Kd 6h] [8s]
ruslik_by: checks 
DonRon_AT: bets $2.37
ruslik_by: folds 
Uncalled bet ($2.37) returned to DonRon_AT
DonRon_AT collected $4.75 from pot
*** SUMMARY ***
Total pot $5 | Rake $0.25 
Board [Jc 5d Kd 6h 8s]
Seat 1: Rafaello18 (big blind) folded on the Flop
Seat 2: mbk88 folded before Flop (didn't bet)
Seat 4: DonRon_AT collected ($4.75)
Seat 5: Ty Nick 420 folded before Flop (didn't bet)
Seat 6: m_michalec folded before Flop (didn't bet)
Seat 7: matiko09 folded before Flop (didn't bet)
Seat 8: Arjun A Raju (button) folded before Flop (didn't bet)
Seat 9: ruslik_by (small blind) folded on the River





PokerStars Hand #155381562905:  Hold'em No Limit ($0.50/$1.00 USD) - 2016/06/30 14:45:32 CET [2016/06/30 8:45:32 ET]
Table 'Asmodeus' 9-max Seat #3 is the button
Seat 2: DomiVY ($40 in chips) 
Seat 3: matiko09 ($102.15 in chips) 
Seat 4: Ty Nick 420 ($109.56 in chips) 
Seat 5: sanr23 ($100 in chips) 
Seat 6: koutani7 ($77.53 in chips) 
Seat 7: aaronzzr ($185.32 in chips) 
Seat 8: Rafaello18 ($175.37 in chips) 
Seat 9: mbk88 ($138.06 in chips) 
Ty Nick 420: posts small blind $0.50
sanr23: posts big blind $1
*** HOLE CARDS ***
Dealt to matiko09 [Kc 4s]
koutani7: folds 
aaronzzr: folds 
Rafaello18: folds 
mbk88: folds 
DomiVY: raises $1.10 to $2.10
matiko09: folds 
Ty Nick 420: folds 
sanr23: folds 
Uncalled bet ($1.10) returned to DomiVY
DomiVY collected $2.50 from pot
DomiVY: doesn't show hand 
*** SUMMARY ***
Total pot $2.50 | Rake $0 
Seat 2: DomiVY collected ($2.50)
Seat 3: matiko09 (button) folded before Flop (didn't bet)
Seat 4: Ty Nick 420 (small blind) folded before Flop
Seat 5: sanr23 (big blind) folded before Flop
Seat 6: koutani7 folded before Flop (didn't bet)
Seat 7: aaronzzr folded before Flop (didn't bet)
Seat 8: Rafaello18 folded before Flop (didn't bet)
Seat 9: mbk88 folded before Flop (didn't bet)





PokerStars Hand #155381563337:  Hold'em No Limit ($0.50/$1.00 USD) - 2016/06/30 14:45:33 CET [2016/06/30 8:45:33 ET]
Table 'Donnera' 9-max Seat #2 is the button
Seat 1: chenconhaste ($118.84 in chips) 
Seat 2: robbiescrim9 ($82.87 in chips) 
Seat 3: matiko09 ($136.82 in chips) 
Seat 4: Kukuryzka ($102.50 in chips) 
Seat 5: tipner ($110.90 in chips) 
Seat 6: nickreason17 ($100 in chips) 
Seat 7: Rafaello18 ($116.30 in chips) 
Seat 8: ruslik_by ($201.44 in chips) 
Seat 9: Starw!nd ($117.75 in chips) 
matiko09: posts small blind $0.50
Kukuryzka: posts big blind $1
*** HOLE CARDS ***
Dealt to matiko09 [3s Jh]
tipner: folds 
nickreason17: folds 
Rafaello18: folds 
ruslik_by: folds 
Starw!nd: folds 
chenconhaste: folds 
robbiescrim9: calls $1
matiko09: folds 
Kukuryzka: checks 
*** FLOP *** [7d Qs 8c]
Kukuryzka: checks 
robbiescrim9: checks 
*** TURN *** [7d Qs 8c] [Jd]
Kukuryzka: checks 
robbiescrim9: checks 
*** RIVER *** [7d Qs 8c Jd] [4c]
Kukuryzka: bets $1
robbiescrim9: calls $1
*** SHOW DOWN ***
Kukuryzka: shows [Jc 5c] (a pair of Jacks)
robbiescrim9: mucks hand 
Kukuryzka collected $4.28 from pot
*** SUMMARY ***
Total pot $4.50 | Rake $0.22 
Board [7d Qs 8c Jd 4c]
Seat 1: chenconhaste folded before Flop (didn't bet)
Seat 2: robbiescrim9 (button) mucked [3c Ah]
Seat 3: matiko09 (small blind) folded before Flop
Seat 4: Kukuryzka (big blind) showed [Jc 5c] and won ($4.28) with a pair of Jacks
Seat 5: tipner folded before Flop (didn't bet)
Seat 6: nickreason17 folded before Flop (didn't bet)
Seat 7: Rafaello18 folded before Flop (didn't bet)
Seat 8: ruslik_by folded before Flop (didn't bet)
Seat 9: Starw!nd folded before Flop (didn't bet)





PokerStars Hand #155381563047:  Hold'em No Limit ($0.25/$0.50 USD) - 2016/06/30 14:45:33 CET [2016/06/30 8:45:33 ET]
Table 'Thalia II' 9-max Seat #8 is the button
Seat 2: DeathcorePkr ($54.34 in chips) 
Seat 3: r4mz3s ($73.82 in chips) 
Seat 4: Kukuryzka ($52.27 in chips) 
Seat 5: geowin ($50.81 in chips) 
Seat 6: chenconhaste ($53.99 in chips) 
Seat 7: fudzi ($62.57 in chips) 
Seat 8: Jo_Medici ($57.76 in chips) 
Seat 9: matiko09 ($50 in chips) 
matiko09: posts small blind $0.25
DeathcorePkr: posts big blind $0.50
DeathcorePkr: posts the ante $0.10
r4mz3s: posts the ante $0.10
Kukuryzka: posts the ante $0.10
geowin: posts the ante $0.10
chenconhaste: posts the ante $0.10
fudzi: posts the ante $0.10
Jo_Medici: posts the ante $0.10
matiko09: posts the ante $0.10
*** HOLE CARDS ***
Dealt to matiko09 [2h 5h]
r4mz3s: folds 
Kukuryzka: raises $1 to $1.50
geowin: folds 
chenconhaste: folds 
fudzi: folds 
Jo_Medici: folds 
matiko09: folds 
DeathcorePkr: folds 
Uncalled bet ($1) returned to Kukuryzka
Kukuryzka collected $2.05 from pot
Kukuryzka: doesn't show hand 
*** SUMMARY ***
Total pot $2.05 | Rake $0 
Seat 2: DeathcorePkr (big blind) folded before Flop
Seat 3: r4mz3s folded before Flop (didn't bet)
Seat 4: Kukuryzka collected ($2.05)
Seat 5: geowin folded before Flop (didn't bet)
Seat 6: chenconhaste folded before Flop (didn't bet)
Seat 7: fudzi folded before Flop (didn't bet)
Seat 8: Jo_Medici (button) folded before Flop (didn't bet)
Seat 9: matiko09 (small blind) folded before Flop





PokerStars Hand #155381563680:  Hold'em No Limit (€0.25/€0.50 EUR) - 2016/06/30 14:45:34 CET [2016/06/30 8:45:34 ET]
Table 'Vibeke II' 9-max Seat #7 is the button
Seat 4: acelacat111 (€33.46 in chips) 
Seat 5: mazefaka007 (€65.58 in chips) 
Seat 6: Kukuryzka (€54.24 in chips) 
Seat 7: matiko09 (€60.32 in chips) 
Seat 8: Math9881 (€41.29 in chips) 
Seat 9: funXmun (€52.62 in chips) 
Math9881: posts small blind €0.25
funXmun: posts big blind €0.50
kotkas1000: sits out 
drosser321: sits out 
RvPersie: sits out 
*** HOLE CARDS ***
Dealt to matiko09 [Qd 9h]
acelacat111: folds 
mazefaka007: folds 
Kukuryzka: folds 
matiko09: raises €0.63 to €1.13
Math9881: calls €0.88
funXmun: folds 
*** FLOP *** [Td 5c 8s]
Math9881: checks 
matiko09: bets €1.70
Math9881: folds 
Uncalled bet (€1.70) returned to matiko09
matiko09 collected €2.62 from pot
matiko09: doesn't show hand 
*** SUMMARY ***
Total pot €2.76 | Rake €0.14 
Board [Td 5c 8s]
Seat 4: acelacat111 folded before Flop (didn't bet)
Seat 5: mazefaka007 folded before Flop (didn't bet)
Seat 6: Kukuryzka folded before Flop (didn't bet)
Seat 7: matiko09 (button) collected (€2.62)
Seat 8: Math9881 (small blind) folded on the Flop
Seat 9: funXmun (big blind) folded before Flop





PokerStars Hand #155381564481:  Hold'em No Limit ($0.50/$1.00 USD) - 2016/06/30 14:45:35 CET [2016/06/30 8:45:35 ET]
Table 'Sigrid' 9-max Seat #2 is the button
Seat 1: Greha999 ($49.94 in chips) 
Seat 2: matiko09 ($106.86 in chips) 
Seat 3: Rafaello18 ($125.85 in chips) 
Seat 4: mbk88 ($100 in chips) 
Seat 5: chenconhaste ($100 in chips) 
Seat 8: ruslik_by ($100 in chips) 
Seat 9: KovIFish89 ($106.32 in chips) 
Rafaello18: posts small blind $0.50
mbk88: posts big blind $1
*** HOLE CARDS ***
Dealt to matiko09 [6d 9d]
chenconhaste: folds 
ruslik_by: folds 
KovIFish89: folds 
Greha999: folds 
matiko09: raises $1.27 to $2.27
Rafaello18: folds 
mbk88: folds 
Uncalled bet ($1.27) returned to matiko09
matiko09 collected $2.50 from pot
matiko09: doesn't show hand 
*** SUMMARY ***
Total pot $2.50 | Rake $0 
Seat 1: Greha999 folded before Flop (didn't bet)
Seat 2: matiko09 (button) collected ($2.50)
Seat 3: Rafaello18 (small blind) folded before Flop
Seat 4: mbk88 (big blind) folded before Flop
Seat 5: chenconhaste folded before Flop (didn't bet)
Seat 8: ruslik_by folded before Flop (didn't bet)
Seat 9: KovIFish89 folded before Flop (didn't bet)





PokerStars Hand #155381565091:  Hold'em No Limit ($0.50/$1.00 USD) - 2016/06/30 14:45:37 CET [2016/06/30 8:45:37 ET]
Table 'California II' 9-max Seat #2 is the button
Seat 1: Rafaello18 ($108.50 in chips) 
Seat 2: ruslik_by ($140.81 in chips) 
Seat 3: KovIFish89 ($109.42 in chips) 
Seat 4: f1reworks ($101 in chips) 
Seat 5: Rohitbarve ($105.77 in chips) 
Seat 6: matiko09 ($119.98 in chips) 
Seat 7: DomiVY ($88.38 in chips) 
Seat 8: chenconhaste ($104 in chips) 
Seat 9: di0d80 ($208.74 in chips) 
KovIFish89: posts small blind $0.50
f1reworks: posts big blind $1
*** HOLE CARDS ***
Dealt to matiko09 [Js 8h]
Rohitbarve: folds 
matiko09: folds 
DomiVY: folds 
chenconhaste: raises $1.25 to $2.25
di0d80: folds 
Rafaello18: folds 
ruslik_by: folds 
KovIFish89: folds 
f1reworks: folds 
Uncalled bet ($1.25) returned to chenconhaste
chenconhaste collected $2.50 from pot
*** SUMMARY ***
Total pot $2.50 | Rake $0 
Seat 1: Rafaello18 folded before Flop (didn't bet)
Seat 2: ruslik_by (button) folded before Flop (didn't bet)
Seat 3: KovIFish89 (small blind) folded before Flop
Seat 4: f1reworks (big blind) folded before Flop
Seat 5: Rohitbarve folded before Flop (didn't bet)
Seat 6: matiko09 folded before Flop (didn't bet)
Seat 7: DomiVY folded before Flop (didn't bet)
Seat 8: chenconhaste collected ($2.50)
Seat 9: di0d80 folded before Flop (didn't bet)





PokerStars Hand #155381573989:  Hold'em No Limit ($0.25/$0.50 USD) - 2016/06/30 14:45:55 CET [2016/06/30 8:45:55 ET]
Table 'Arcturus' 9-max Seat #8 is the button
Seat 1: kourk250 ($141.56 in chips) 
Seat 2: Rafaello18 ($52.34 in chips) 
Seat 3: matiko09 ($65.69 in chips) 
Seat 5: stockbridge8 ($49.25 in chips) 
Seat 6: sanr23 ($52.03 in chips) 
Seat 7: bratbugor ($50 in chips) 
Seat 8: TheMinion ($63.53 in chips) 
Seat 9: joker180785 ($50 in chips) 
joker180785: posts small blind $0.25
kourk250: posts big blind $0.50
*** HOLE CARDS ***
Dealt to matiko09 [Tc Jh]
kourk250 said, "(y)"
Rafaello18: folds 
matiko09: folds 
stockbridge8: folds 
sanr23: raises $1 to $1.50
bratbugor: folds 
TheMinion: folds 
joker180785: folds 
kourk250: folds 
Uncalled bet ($1) returned to sanr23
sanr23 collected $1.25 from pot
sanr23: doesn't show hand 
*** SUMMARY ***
Total pot $1.25 | Rake $0 
Seat 1: kourk250 (big blind) folded before Flop
Seat 2: Rafaello18 folded before Flop (didn't bet)
Seat 3: matiko09 folded before Flop (didn't bet)
Seat 5: stockbridge8 folded before Flop (didn't bet)
Seat 6: sanr23 collected ($1.25)
Seat 7: bratbugor folded before Flop (didn't bet)
Seat 8: TheMinion (button) folded before Flop (didn't bet)
Seat 9: joker180785 (small blind) folded before Flop





PokerStars Hand #155381576209:  Hold'em No Limit ($0.25/$0.50 USD) - 2016/06/30 14:46:00 CET [2016/06/30 8:46:00 ET]
Table 'Thalia II' 9-max Seat #9 is the button
Seat 2: DeathcorePkr ($53.74 in chips) 
Seat 3: r4mz3s ($73.72 in chips) 
Seat 4: Kukuryzka ($53.72 in chips) 
Seat 5: geowin ($50.71 in chips) 
Seat 6: chenconhaste ($53.89 in chips) 
Seat 7: fudzi ($62.47 in chips) 
Seat 8: Jo_Medici ($57.66 in chips) 
Seat 9: matiko09 ($50 in chips) 
DeathcorePkr: posts small blind $0.25
r4mz3s: posts big blind $0.50
DeathcorePkr: posts the ante $0.10
r4mz3s: posts the ante $0.10
Kukuryzka: posts the ante $0.10
geowin: posts the ante $0.10
chenconhaste: posts the ante $0.10
fudzi: posts the ante $0.10
Jo_Medici: posts the ante $0.10
matiko09: posts the ante $0.10
*** HOLE CARDS ***
Dealt to matiko09 [3s 7c]
Kukuryzka: folds 
geowin: raises $0.75 to $1.25
chenconhaste: folds 
fudzi: folds 
Jo_Medici: folds 
matiko09: folds 
DeathcorePkr: raises $4.75 to $6
r4mz3s: folds 
geowin: calls $4.75
*** FLOP *** [7d Qs 4c]
DeathcorePkr: bets $8.50
geowin: folds 
Uncalled bet ($8.50) returned to DeathcorePkr
DeathcorePkr collected $12.64 from pot
DeathcorePkr: doesn't show hand 
*** SUMMARY ***
Total pot $13.30 | Rake $0.66 
Board [7d Qs 4c]
Seat 2: DeathcorePkr (small blind) collected ($12.64)
Seat 3: r4mz3s (big blind) folded before Flop
Seat 4: Kukuryzka folded before Flop (didn't bet)
Seat 5: geowin folded on the Flop
Seat 6: chenconhaste folded before Flop (didn't bet)
Seat 7: fudzi folded before Flop (didn't bet)
Seat 8: Jo_Medici folded before Flop (didn't bet)
Seat 9: matiko09 (button) folded before Flop (didn't bet)





PokerStars Hand #155381580266:  Hold'em No Limit ($0.50/$1.00 USD) - 2016/06/30 14:46:08 CET [2016/06/30 8:46:08 ET]
Table 'California II' 9-max Seat #3 is the button
Seat 1: Rafaello18 ($108.50 in chips) 
Seat 2: ruslik_by ($140.81 in chips) 
Seat 3: KovIFish89 ($108.92 in chips) 
Seat 4: f1reworks ($100 in chips) 
Seat 5: Rohitbarve ($105.77 in chips) 
Seat 6: matiko09 ($119.98 in chips) 
Seat 7: DomiVY ($88.38 in chips) 
Seat 8: chenconhaste ($105.50 in chips) 
Seat 9: di0d80 ($208.74 in chips) 
f1reworks: posts small blind $0.50
Rohitbarve: posts big blind $1
*** HOLE CARDS ***
Dealt to matiko09 [5s Kd]
matiko09: folds 
DomiVY has timed out
DomiVY: folds 
chenconhaste: folds 
di0d80: folds 
Rafaello18: raises $1.50 to $2.50
ruslik_by: folds 
KovIFish89: folds 
f1reworks: folds 
Rohitbarve: folds 
Uncalled bet ($1.50) returned to Rafaello18
Rafaello18 collected $2.50 from pot
Rafaello18: doesn't show hand 
*** SUMMARY ***
Total pot $2.50 | Rake $0 
Seat 1: Rafaello18 collected ($2.50)
Seat 2: ruslik_by folded before Flop (didn't bet)
Seat 3: KovIFish89 (button) folded before Flop (didn't bet)
Seat 4: f1reworks (small blind) folded before Flop
Seat 5: Rohitbarve (big blind) folded before Flop
Seat 6: matiko09 folded before Flop (didn't bet)
Seat 7: DomiVY folded before Flop (didn't bet)
Seat 8: chenconhaste folded before Flop (didn't bet)
Seat 9: di0d80 folded before Flop (didn't bet)





PokerStars Hand #155381580323:  Hold'em No Limit ($0.50/$1.00 USD) - 2016/06/30 14:46:08 CET [2016/06/30 8:46:08 ET]
Table 'Tietjen' 9-max Seat #6 is the button
Seat 1: swizzly58 ($80 in chips) 
Seat 2: chenconhaste ($100 in chips) 
Seat 3: bearlar ($100 in chips) 
Seat 4: matiko09 ($100 in chips) 
Seat 5: Ty Nick 420 ($100 in chips) 
Seat 6: CR0ZAMATOZ ($100 in chips) 
Seat 7: Rafaello18 ($100 in chips) 
Seat 8: rukus0000 ($40 in chips) 
Seat 9: ETHANS ($80 in chips) 
Rafaello18: posts small blind $0.50
rukus0000: posts big blind $1
*** HOLE CARDS ***
Dealt to matiko09 [5c Td]
ETHANS: folds 
swizzly58: folds 
chenconhaste: folds 
bearlar: folds 
matiko09: folds 
Ty Nick 420: raises $1.50 to $2.50
CR0ZAMATOZ: folds 
Rafaello18: folds 
rukus0000: calls $1.50
*** FLOP *** [Ah Js Jd]
rukus0000: checks 
Ty Nick 420: checks 
*** TURN *** [Ah Js Jd] [Ad]
rukus0000: checks 
Ty Nick 420: checks 
*** RIVER *** [Ah Js Jd Ad] [Tc]
rukus0000: checks 
Ty Nick 420: bets $1.50
rukus0000: folds 
Uncalled bet ($1.50) returned to Ty Nick 420
Ty Nick 420 collected $5.22 from pot
*** SUMMARY ***
Total pot $5.50 | Rake $0.28 
Board [Ah Js Jd Ad Tc]
Seat 1: swizzly58 folded before Flop (didn't bet)
Seat 2: chenconhaste folded before Flop (didn't bet)
Seat 3: bearlar folded before Flop (didn't bet)
Seat 4: matiko09 folded before Flop (didn't bet)
Seat 5: Ty Nick 420 collected ($5.22)
Seat 6: CR0ZAMATOZ (button) folded before Flop (didn't bet)
Seat 7: Rafaello18 (small blind) folded before Flop
Seat 8: rukus0000 (big blind) folded on the River
Seat 9: ETHANS folded before Flop (didn't bet)





PokerStars Hand #155381582276:  Hold'em No Limit ($0.50/$1.00 USD) - 2016/06/30 14:46:12 CET [2016/06/30 8:46:12 ET]
Table 'Asmodeus' 9-max Seat #4 is the button
Seat 2: DomiVY ($41.50 in chips) 
Seat 3: matiko09 ($102.15 in chips) 
Seat 4: Ty Nick 420 ($109.06 in chips) 
Seat 5: sanr23 ($100 in chips) 
Seat 6: koutani7 ($77.53 in chips) 
Seat 7: aaronzzr ($185.32 in chips) 
Seat 8: Rafaello18 ($175.37 in chips) 
Seat 9: mbk88 ($138.06 in chips) 
sanr23: posts small blind $0.50
koutani7: posts big blind $1
*** HOLE CARDS ***
Dealt to matiko09 [3s 5s]
aaronzzr: folds 
Rafaello18: folds 
mbk88: folds 
DomiVY: folds 
matiko09: folds 
Ty Nick 420: folds 
sanr23: raises $1.50 to $2.50
koutani7: calls $1.50
*** FLOP *** [Th Tc 5c]
sanr23: checks 
koutani7: checks 
*** TURN *** [Th Tc 5c] [4s]
sanr23: checks 
koutani7: checks 
*** RIVER *** [Th Tc 5c 4s] [9c]
sanr23: checks 
koutani7: checks 
*** SHOW DOWN ***
sanr23: shows [4d As] (two pair, Tens and Fours)
koutani7: mucks hand 
sanr23 collected $4.75 from pot
*** SUMMARY ***
Total pot $5 | Rake $0.25 
Board [Th Tc 5c 4s 9c]
Seat 2: DomiVY folded before Flop (didn't bet)
Seat 3: matiko09 folded before Flop (didn't bet)
Seat 4: Ty Nick 420 (button) folded before Flop (didn't bet)
Seat 5: sanr23 (small blind) showed [4d As] and won ($4.75) with two pair, Tens and Fours
Seat 6: koutani7 (big blind) mucked [Kh Jd]
Seat 7: aaronzzr folded before Flop (didn't bet)
Seat 8: Rafaello18 folded before Flop (didn't bet)
Seat 9: mbk88 folded before Flop (didn't bet)





PokerStars Hand #155381584684:  Hold'em No Limit ($0.50/$1.00 USD) - 2016/06/30 14:46:17 CET [2016/06/30 8:46:17 ET]
Table 'Sigrid' 9-max Seat #3 is the button
Seat 1: Greha999 ($49.94 in chips) 
Seat 2: matiko09 ($108.36 in chips) 
Seat 3: Rafaello18 ($125.35 in chips) 
Seat 4: mbk88 ($100 in chips) 
Seat 5: chenconhaste ($100 in chips) 
Seat 8: ruslik_by ($100 in chips) 
Seat 9: KovIFish89 ($106.32 in chips) 
mbk88: posts small blind $0.50
chenconhaste: posts big blind $1
*** HOLE CARDS ***
Dealt to matiko09 [6s As]
ruslik_by: raises $2 to $3
KovIFish89: folds 
Greha999: folds 
matiko09: folds 
Rafaello18: folds 
mbk88: folds 
chenconhaste: folds 
Uncalled bet ($2) returned to ruslik_by
ruslik_by collected $2.50 from pot
ruslik_by: doesn't show hand 
*** SUMMARY ***
Total pot $2.50 | Rake $0 
Seat 1: Greha999 folded before Flop (didn't bet)
Seat 2: matiko09 folded before Flop (didn't bet)
Seat 3: Rafaello18 (button) folded before Flop (didn't bet)
Seat 4: mbk88 (small blind) folded before Flop
Seat 5: chenconhaste (big blind) folded before Flop
Seat 8: ruslik_by collected ($2.50)
Seat 9: KovIFish89 folded before Flop (didn't bet)





PokerStars Hand #155381584974:  Hold'em No Limit ($0.50/$1.00 USD) - 2016/06/30 14:46:18 CET [2016/06/30 8:46:18 ET]
Table 'Donnera' 9-max Seat #3 is the button
Seat 1: chenconhaste ($118.84 in chips) 
Seat 2: robbiescrim9 ($80.87 in chips) 
Seat 3: matiko09 ($136.32 in chips) 
Seat 4: Kukuryzka ($104.78 in chips) 
Seat 5: tipner ($110.90 in chips) 
Seat 6: nickreason17 ($100 in chips) 
Seat 7: Rafaello18 ($116.30 in chips) 
Seat 8: ruslik_by ($201.44 in chips) 
Seat 9: Starw!nd ($117.75 in chips) 
Kukuryzka: posts small blind $0.50
tipner: posts big blind $1
*** HOLE CARDS ***
Dealt to matiko09 [4s 5d]
nickreason17: folds 
Rafaello18: folds 
ruslik_by: folds 
Starw!nd: folds 
chenconhaste: folds 
robbiescrim9: folds 
matiko09: folds 
Kukuryzka: folds 
Uncalled bet ($0.50) returned to tipner
tipner collected $1 from pot
tipner: doesn't show hand 
*** SUMMARY ***
Total pot $1 | Rake $0 
Seat 1: chenconhaste folded before Flop (didn't bet)
Seat 2: robbiescrim9 folded before Flop (didn't bet)
Seat 3: matiko09 (button) folded before Flop (didn't bet)
Seat 4: Kukuryzka (small blind) folded before Flop
Seat 5: tipner (big blind) collected ($1)
Seat 6: nickreason17 folded before Flop (didn't bet)
Seat 7: Rafaello18 folded before Flop (didn't bet)
Seat 8: ruslik_by folded before Flop (didn't bet)
Seat 9: Starw!nd folded before Flop (didn't bet)





PokerStars Hand #155381587115:  Hold'em No Limit (€0.25/€0.50 EUR) - 2016/06/30 14:46:22 CET [2016/06/30 8:46:22 ET]
Table 'Vibeke II' 9-max Seat #8 is the button
Seat 1: kotkas1000 (€50 in chips) 
Seat 4: acelacat111 (€33.46 in chips) 
Seat 5: mazefaka007 (€65.58 in chips) 
Seat 6: Kukuryzka (€54.24 in chips) 
Seat 7: matiko09 (€61.81 in chips) 
Seat 8: Math9881 (€40.16 in chips) 
Seat 9: funXmun (€52.12 in chips) 
funXmun: posts small blind €0.25
kotkas1000: posts big blind €0.50
drosser321: sits out 
RvPersie: sits out 
*** HOLE CARDS ***
Dealt to matiko09 [8s 4h]
acelacat111: raises €1 to €1.50
mazefaka007: folds 
Kukuryzka: folds 
matiko09: folds 
Math9881: folds 
funXmun: calls €1.25
kotkas1000: calls €1
*** FLOP *** [Qs 3d 8h]
funXmun: checks 
kotkas1000: checks 
acelacat111: bets €2.66
funXmun: folds 
kotkas1000: folds 
Uncalled bet (€2.66) returned to acelacat111
acelacat111 collected €4.28 from pot
acelacat111: doesn't show hand 
*** SUMMARY ***
Total pot €4.50 | Rake €0.22 
Board [Qs 3d 8h]
Seat 1: kotkas1000 (big blind) folded on the Flop
Seat 4: acelacat111 collected (€4.28)
Seat 5: mazefaka007 folded before Flop (didn't bet)
Seat 6: Kukuryzka folded before Flop (didn't bet)
Seat 7: matiko09 folded before Flop (didn't bet)
Seat 8: Math9881 (button) folded before Flop (didn't bet)
Seat 9: funXmun (small blind) folded on the Flop





PokerStars Hand #155381587549:  Hold'em No Limit ($0.25/$0.50 USD) - 2016/06/30 14:46:23 CET [2016/06/30 8:46:23 ET]
Table 'Chort III' 9-max Seat #9 is the button
Seat 2: Yourstepmom ($55.60 in chips) 
Seat 3: Dantist1122 ($50 in chips) 
Seat 4: kotkas1000 ($50 in chips) 
Seat 5: Hit Pit ($32.22 in chips) 
Seat 6: Franky77200 ($28.87 in chips) 
Seat 7: matiko09 ($54.18 in chips) 
Seat 8: Kukuryzka ($50 in chips) 
Seat 9: r4mz3s ($50 in chips) 
Yourstepmom: posts small blind $0.25
Dantist1122: posts big blind $0.50
Yourstepmom: posts the ante $0.10
Dantist1122: posts the ante $0.10
kotkas1000: posts the ante $0.10
Hit Pit: posts the ante $0.10
Franky77200: posts the ante $0.10
matiko09: posts the ante $0.10
Kukuryzka: posts the ante $0.10
r4mz3s: posts the ante $0.10
*** HOLE CARDS ***
Dealt to matiko09 [8c Jh]
kotkas1000: folds 
Hit Pit: folds 
Franky77200: folds 
matiko09: folds 
Kukuryzka: raises $0.75 to $1.25
r4mz3s: folds 
Yourstepmom: folds 
Dantist1122: folds 
Uncalled bet ($0.75) returned to Kukuryzka
Kukuryzka collected $2.05 from pot
Kukuryzka: doesn't show hand 
*** SUMMARY ***
Total pot $2.05 | Rake $0 
Seat 2: Yourstepmom (small blind) folded before Flop
Seat 3: Dantist1122 (big blind) folded before Flop
Seat 4: kotkas1000 folded before Flop (didn't bet)
Seat 5: Hit Pit folded before Flop (didn't bet)
Seat 6: Franky77200 folded before Flop (didn't bet)
Seat 7: matiko09 folded before Flop (didn't bet)
Seat 8: Kukuryzka collected ($2.05)
Seat 9: r4mz3s (button) folded before Flop (didn't bet)





PokerStars Hand #155381592656:  Hold'em No Limit ($0.50/$1.00 USD) - 2016/06/30 14:46:34 CET [2016/06/30 8:46:34 ET]
Table 'Borrelly II' 9-max Seat #9 is the button
Seat 1: Rafaello18 ($120.59 in chips) 
Seat 2: mbk88 ($100 in chips) 
Seat 4: DonRon_AT ($100.75 in chips) 
Seat 5: Ty Nick 420 ($100 in chips) 
Seat 6: m_michalec ($166.42 in chips) 
Seat 7: matiko09 ($174.36 in chips) 
Seat 8: Arjun A Raju ($135 in chips) 
Seat 9: ruslik_by ($111.65 in chips) 
Rafaello18: posts small blind $0.50
mbk88: posts big blind $1
*** HOLE CARDS ***
Dealt to matiko09 [6s 8c]
DonRon_AT: folds 
Ty Nick 420: raises $1.50 to $2.50
m_michalec: folds 
matiko09: folds 
Arjun A Raju: raises $5 to $7.50
ruslik_by: folds 
DonRon_AT leaves the table
Rafaello18: folds 
mbk88: folds 
chenconhaste joins the table at seat #4 
Ty Nick 420: folds 
Uncalled bet ($5) returned to Arjun A Raju
Arjun A Raju collected $6.50 from pot
Arjun A Raju: doesn't show hand 
*** SUMMARY ***
Total pot $6.50 | Rake $0 
Seat 1: Rafaello18 (small blind) folded before Flop
Seat 2: mbk88 (big blind) folded before Flop
Seat 4: DonRon_AT folded before Flop (didn't bet)
Seat 5: Ty Nick 420 folded before Flop
Seat 6: m_michalec folded before Flop (didn't bet)
Seat 7: matiko09 folded before Flop (didn't bet)
Seat 8: Arjun A Raju collected ($6.50)
Seat 9: ruslik_by (button) folded before Flop (didn't bet)





PokerStars Hand #155381596227:  Hold'em No Limit ($0.25/$0.50 USD) - 2016/06/30 14:46:41 CET [2016/06/30 8:46:41 ET]
Table 'Chort III' 9-max Seat #2 is the button
Seat 2: Yourstepmom ($55.25 in chips) 
Seat 3: Dantist1122 ($50 in chips) 
Seat 4: kotkas1000 ($50 in chips) 
Seat 5: Hit Pit ($32.12 in chips) 
Seat 6: Franky77200 ($28.77 in chips) 
Seat 7: matiko09 ($54.08 in chips) 
Seat 8: Kukuryzka ($51.45 in chips) 
Seat 9: r4mz3s ($50 in chips) 
Dantist1122: posts small blind $0.25
kotkas1000: posts big blind $0.50
Yourstepmom: posts the ante $0.10
Dantist1122: posts the ante $0.10
kotkas1000: posts the ante $0.10
Hit Pit: posts the ante $0.10
Franky77200: posts the ante $0.10
matiko09: posts the ante $0.10
Kukuryzka: posts the ante $0.10
r4mz3s: posts the ante $0.10
*** HOLE CARDS ***
Dealt to matiko09 [8s 4s]
Hit Pit: folds 
Franky77200: calls $0.50
matiko09: folds 
Kukuryzka: folds 
r4mz3s: folds 
Yourstepmom: raises $1 to $1.50
Dantist1122: raises $3.50 to $5
kotkas1000: folds 
Franky77200: folds 
Yourstepmom: calls $3.50
*** FLOP *** [2c 6c 5c]
Dantist1122: checks 
Yourstepmom: bets $5.50
Dantist1122: folds 
Uncalled bet ($5.50) returned to Yourstepmom
Yourstepmom collected $11.21 from pot
Yourstepmom: doesn't show hand 
*** SUMMARY ***
Total pot $11.80 | Rake $0.59 
Board [2c 6c 5c]
Seat 2: Yourstepmom (button) collected ($11.21)
Seat 3: Dantist1122 (small blind) folded on the Flop
Seat 4: kotkas1000 (big blind) folded before Flop
Seat 5: Hit Pit folded before Flop (didn't bet)
Seat 6: Franky77200 folded before Flop
Seat 7: matiko09 folded before Flop (didn't bet)
Seat 8: Kukuryzka folded before Flop (didn't bet)
Seat 9: r4mz3s folded before Flop (didn't bet)





PokerStars Hand #155381598182:  Hold'em No Limit ($0.50/$1.00 USD) - 2016/06/30 14:46:45 CET [2016/06/30 8:46:45 ET]
Table 'Sigrid' 9-max Seat #4 is the button
Seat 1: Greha999 ($49.94 in chips) 
Seat 2: matiko09 ($108.36 in chips) 
Seat 3: Rafaello18 ($125.35 in chips) 
Seat 4: mbk88 ($100 in chips) 
Seat 5: chenconhaste ($100 in chips) 
Seat 8: ruslik_by ($101.50 in chips) 
Seat 9: KovIFish89 ($106.32 in chips) 
chenconhaste: posts small blind $0.50
di0d80 was removed from the table for failing to post
ruslik_by: posts big blind $1
*** HOLE CARDS ***
Dealt to matiko09 [Th 5d]
KovIFish89: folds 
Greha999: folds 
matiko09: folds 
Rafaello18: folds 
mbk88: raises $1.02 to $2.02
chenconhaste: folds 
KovIFish89 leaves the table
Ty Nick 420 joins the table at seat #9 
f1reworks joins the table at seat #6 
ruslik_by: calls $1.02
*** FLOP *** [4s 2s Qh]
ruslik_by: checks 
mbk88: bets $2
ruslik_by: calls $2
*** TURN *** [4s 2s Qh] [5s]
ruslik_by: checks 
mbk88: bets $5
ruslik_by: raises $9.05 to $14.05
mbk88: folds 
Uncalled bet ($9.05) returned to ruslik_by
ruslik_by collected $17.61 from pot
ruslik_by: doesn't show hand 
*** SUMMARY ***
Total pot $18.54 | Rake $0.93 
Board [4s 2s Qh 5s]
Seat 1: Greha999 folded before Flop (didn't bet)
Seat 2: matiko09 folded before Flop (didn't bet)
Seat 3: Rafaello18 folded before Flop (didn't bet)
Seat 4: mbk88 (button) folded on the Turn
Seat 5: chenconhaste (small blind) folded before Flop
Seat 8: ruslik_by (big blind) collected ($17.61)
Seat 9: KovIFish89 folded before Flop (didn't bet)





PokerStars Hand #155381598746:  Hold'em No Limit ($0.25/$0.50 USD) - 2016/06/30 14:46:46 CET [2016/06/30 8:46:46 ET]
Table 'Arcturus' 9-max Seat #9 is the button
Seat 1: kourk250 ($141.06 in chips) 
Seat 2: Rafaello18 ($52.34 in chips) 
Seat 3: matiko09 ($65.69 in chips) 
Seat 5: stockbridge8 ($49.25 in chips) 
Seat 6: sanr23 ($52.78 in chips) 
Seat 7: bratbugor ($50 in chips) 
Seat 8: TheMinion ($63.53 in chips) 
Seat 9: joker180785 ($50 in chips) 
kourk250: posts small blind $0.25
Rafaello18: posts big blind $0.50
*** HOLE CARDS ***
Dealt to matiko09 [9s 7h]
matiko09: folds 
stockbridge8: raises $1 to $1.50
sanr23: folds 
bratbugor: folds 
TheMinion: raises $3 to $4.50
joker180785: folds 
kourk250: calls $4.25
Rafaello18: folds 
stockbridge8: calls $3
*** FLOP *** [Ad Tc 5h]
kourk250: checks 
stockbridge8: checks 
TheMinion: bets $8.27
kourk250: calls $8.27
stockbridge8: folds 
*** TURN *** [Ad Tc 5h] [Qc]
kourk250: checks 
TheMinion: checks 
*** RIVER *** [Ad Tc 5h Qc] [2h]
kourk250: checks 
TheMinion: checks 
*** SHOW DOWN ***
kourk250: shows [As Ks] (a pair of Aces)
TheMinion: shows [Ah Kh] (a pair of Aces)
kourk250 collected $14.51 from pot
TheMinion collected $14.50 from pot
*** SUMMARY ***
Total pot $30.54 | Rake $1.53 
Board [Ad Tc 5h Qc 2h]
Seat 1: kourk250 (small blind) showed [As Ks] and won ($14.51) with a pair of Aces
Seat 2: Rafaello18 (big blind) folded before Flop
Seat 3: matiko09 folded before Flop (didn't bet)
Seat 5: stockbridge8 folded on the Flop
Seat 6: sanr23 folded before Flop (didn't bet)
Seat 7: bratbugor folded before Flop (didn't bet)
Seat 8: TheMinion showed [Ah Kh] and won ($14.50) with a pair of Aces
Seat 9: joker180785 (button) folded before Flop (didn't bet)





PokerStars Hand #155381602815:  Hold'em No Limit ($0.50/$1.00 USD) - 2016/06/30 14:46:55 CET [2016/06/30 8:46:55 ET]
Table 'Donnera' 9-max Seat #4 is the button
Seat 1: chenconhaste ($118.84 in chips) 
Seat 2: robbiescrim9 ($80.87 in chips) 
Seat 3: matiko09 ($136.32 in chips) 
Seat 4: Kukuryzka ($104.28 in chips) 
Seat 5: tipner ($111.40 in chips) 
Seat 6: nickreason17 ($100 in chips) 
Seat 7: Rafaello18 ($116.30 in chips) 
Seat 8: ruslik_by ($201.44 in chips) 
Seat 9: Starw!nd ($117.75 in chips) 
tipner: posts small blind $0.50
nickreason17: posts big blind $1
*** HOLE CARDS ***
Dealt to matiko09 [2h 8d]
Rafaello18: folds 
ruslik_by: folds 
Starw!nd: folds 
chenconhaste: folds 
robbiescrim9: folds 
matiko09: folds 
Kukuryzka: folds 
tipner: raises $2 to $3
nickreason17: calls $2
*** FLOP *** [6d 8h Js]
tipner: bets $3
nickreason17: raises $6.50 to $9.50
tipner: calls $6.50
*** TURN *** [6d 8h Js] [3s]
tipner: checks 
nickreason17: bets $16.62
tipner: folds 
Uncalled bet ($16.62) returned to nickreason17
nickreason17 collected $23.75 from pot
*** SUMMARY ***
Total pot $25 | Rake $1.25 
Board [6d 8h Js 3s]
Seat 1: chenconhaste folded before Flop (didn't bet)
Seat 2: robbiescrim9 folded before Flop (didn't bet)
Seat 3: matiko09 folded before Flop (didn't bet)
Seat 4: Kukuryzka (button) folded before Flop (didn't bet)
Seat 5: tipner (small blind) folded on the Turn
Seat 6: nickreason17 (big blind) collected ($23.75)
Seat 7: Rafaello18 folded before Flop (didn't bet)
Seat 8: ruslik_by folded before Flop (didn't bet)
Seat 9: Starw!nd folded before Flop (didn't bet)





PokerStars Hand #155381603829:  Hold'em No Limit ($0.50/$1.00 USD) - 2016/06/30 14:46:57 CET [2016/06/30 8:46:57 ET]
Table 'California II' 9-max Seat #4 is the button
Seat 1: Rafaello18 ($110 in chips) 
Seat 2: ruslik_by ($140.81 in chips) 
Seat 3: KovIFish89 ($108.92 in chips) 
Seat 4: f1reworks ($100 in chips) 
Seat 5: Rohitbarve ($104.77 in chips) 
Seat 6: matiko09 ($119.98 in chips) 
Seat 7: DomiVY ($88.38 in chips) 
Seat 8: chenconhaste ($105.50 in chips) 
Seat 9: di0d80 ($208.74 in chips) 
Rohitbarve: posts small blind $0.50
matiko09: posts big blind $1
*** HOLE CARDS ***
Dealt to matiko09 [Qc 4s]
DomiVY: folds 
chenconhaste: raises $1.25 to $2.25
di0d80: folds 
Rafaello18: folds 
ruslik_by: folds 
KovIFish89: folds 
f1reworks: calls $2.25
Rohitbarve: folds 
matiko09: folds 
*** FLOP *** [2c 5h Qd]
chenconhaste: bets $3.50
f1reworks: calls $3.50
*** TURN *** [2c 5h Qd] [Kc]
chenconhaste: bets $7.50
f1reworks: calls $7.50
*** RIVER *** [2c 5h Qd Kc] [Qh]
chenconhaste: checks 
f1reworks: bets $14.63
chenconhaste: folds 
Uncalled bet ($14.63) returned to f1reworks
f1reworks collected $26.60 from pot
f1reworks: doesn't show hand 
*** SUMMARY ***
Total pot $28 | Rake $1.40 
Board [2c 5h Qd Kc Qh]
Seat 1: Rafaello18 folded before Flop (didn't bet)
Seat 2: ruslik_by folded before Flop (didn't bet)
Seat 3: KovIFish89 folded before Flop (didn't bet)
Seat 4: f1reworks (button) collected ($26.60)
Seat 5: Rohitbarve (small blind) folded before Flop
Seat 6: matiko09 (big blind) folded before Flop
Seat 7: DomiVY folded before Flop (didn't bet)
Seat 8: chenconhaste folded on the River
Seat 9: di0d80 folded before Flop (didn't bet)





PokerStars Hand #155381615016:  Hold'em No Limit ($0.25/$0.50 USD) - 2016/06/30 14:47:20 CET [2016/06/30 8:47:20 ET]
Table 'Thalia II' 9-max Seat #2 is the button
Seat 2: DeathcorePkr ($60.28 in chips) 
Seat 3: r4mz3s ($73.12 in chips) 
Seat 4: Kukuryzka ($53.62 in chips) 
Seat 5: geowin ($44.61 in chips) 
Seat 6: chenconhaste ($53.79 in chips) 
Seat 7: fudzi ($62.37 in chips) 
Seat 8: Jo_Medici ($57.56 in chips) 
Seat 9: matiko09 ($50 in chips) 
r4mz3s: posts small blind $0.25
Kukuryzka: posts big blind $0.50
DeathcorePkr: posts the ante $0.10
r4mz3s: posts the ante $0.10
Kukuryzka: posts the ante $0.10
geowin: posts the ante $0.10
chenconhaste: posts the ante $0.10
fudzi: posts the ante $0.10
Jo_Medici: posts the ante $0.10
matiko09: posts the ante $0.10
*** HOLE CARDS ***
Dealt to matiko09 [7c 3s]
geowin: folds 
chenconhaste: folds 
fudzi: folds 
Jo_Medici: folds 
matiko09: folds 
DeathcorePkr: raises $0.75 to $1.25
r4mz3s: folds 
Kukuryzka: raises $3.25 to $4.50
DeathcorePkr: calls $3.25
*** FLOP *** [9c 4d Js]
Kukuryzka: bets $3.15
DeathcorePkr: calls $3.15
*** TURN *** [9c 4d Js] [Qc]
Kukuryzka: checks 
DeathcorePkr: bets $8.07
Kukuryzka: folds 
Uncalled bet ($8.07) returned to DeathcorePkr
DeathcorePkr collected $15.53 from pot
*** SUMMARY ***
Total pot $16.35 | Rake $0.82 
Board [9c 4d Js Qc]
Seat 2: DeathcorePkr (button) collected ($15.53)
Seat 3: r4mz3s (small blind) folded before Flop
Seat 4: Kukuryzka (big blind) folded on the Turn
Seat 5: geowin folded before Flop (didn't bet)
Seat 6: chenconhaste folded before Flop (didn't bet)
Seat 7: fudzi folded before Flop (didn't bet)
Seat 8: Jo_Medici folded before Flop (didn't bet)
Seat 9: matiko09 folded before Flop (didn't bet)





PokerStars Hand #155381615714:  Hold'em No Limit ($0.50/$1.00 USD) - 2016/06/30 14:47:22 CET [2016/06/30 8:47:22 ET]
Table 'Borrelly II' 9-max Seat #1 is the button
Seat 1: Rafaello18 ($120.09 in chips) 
Seat 2: mbk88 ($100 in chips) 
Seat 4: chenconhaste ($100 in chips) 
Seat 5: Ty Nick 420 ($100 in chips) 
Seat 6: m_michalec ($166.42 in chips) 
Seat 7: matiko09 ($174.36 in chips) 
Seat 8: Arjun A Raju ($139 in chips) 
Seat 9: ruslik_by ($111.65 in chips) 
mbk88: posts small blind $0.50
chenconhaste: posts big blind $1
*** HOLE CARDS ***
Dealt to matiko09 [9s Qs]
Ty Nick 420: folds 
m_michalec: raises $2 to $3
Ty Nick 420 leaves the table
matiko09: folds 
Arjun A Raju: folds 
ruslik_by: folds 
Rafaello18: folds 
mbk88: folds 
chenconhaste: folds 
Uncalled bet ($2) returned to m_michalec
m_michalec collected $2.50 from pot
m_michalec: doesn't show hand 
*** SUMMARY ***
Total pot $2.50 | Rake $0 
Seat 1: Rafaello18 (button) folded before Flop (didn't bet)
Seat 2: mbk88 (small blind) folded before Flop
Seat 4: chenconhaste (big blind) folded before Flop
Seat 5: Ty Nick 420 folded before Flop (didn't bet)
Seat 6: m_michalec collected ($2.50)
Seat 7: matiko09 folded before Flop (didn't bet)
Seat 8: Arjun A Raju folded before Flop (didn't bet)
Seat 9: ruslik_by folded before Flop (didn't bet)





PokerStars Hand #155381617461:  Hold'em No Limit ($0.50/$1.00 USD) - 2016/06/30 14:47:25 CET [2016/06/30 8:47:25 ET]
Table 'Asmodeus' 9-max Seat #5 is the button
Seat 2: DomiVY ($41.50 in chips) 
Seat 3: matiko09 ($102.15 in chips) 
Seat 4: Ty Nick 420 ($109.06 in chips) 
Seat 5: sanr23 ($102.25 in chips) 
Seat 6: koutani7 ($75.03 in chips) 
Seat 7: aaronzzr ($185.32 in chips) 
Seat 8: Rafaello18 ($175.37 in chips) 
Seat 9: mbk88 ($138.06 in chips) 
koutani7: posts small blind $0.50
aaronzzr: posts big blind $1
*** HOLE CARDS ***
Dealt to matiko09 [As 5c]
Rafaello18: folds 
mbk88: folds 
DomiVY: raises $2 to $3
matiko09: folds 
Ty Nick 420: folds 
sanr23: folds 
koutani7: calls $2.50
aaronzzr: raises $8 to $11
DomiVY: folds 
koutani7: calls $8
*** FLOP *** [7d 2d 6c]
koutani7: checks 
aaronzzr: bets $12
koutani7: raises $19 to $31
aaronzzr: folds 
Uncalled bet ($19) returned to koutani7
koutani7 collected $46.55 from pot
koutani7: doesn't show hand 
*** SUMMARY ***
Total pot $49 | Rake $2.45 
Board [7d 2d 6c]
Seat 2: DomiVY folded before Flop
Seat 3: matiko09 folded before Flop (didn't bet)
Seat 4: Ty Nick 420 folded before Flop (didn't bet)
Seat 5: sanr23 (button) folded before Flop (didn't bet)
Seat 6: koutani7 (small blind) collected ($46.55)
Seat 7: aaronzzr (big blind) folded on the Flop
Seat 8: Rafaello18 folded before Flop (didn't bet)
Seat 9: mbk88 folded before Flop (didn't bet)





PokerStars Hand #155381620895:  Hold'em No Limit ($0.50/$1.00 USD) - 2016/06/30 14:47:33 CET [2016/06/30 8:47:33 ET]
Table 'Tatjana' 9-max Seat #9 is the button
Seat 1: tipner ($100 in chips) 
Seat 2: Kukuryzka ($105.38 in chips) 
Seat 3: Rafaello18 ($105.88 in chips) 
Seat 4: mopatron25 ($65 in chips) 
Seat 5: matiko09 ($100 in chips) 
Seat 6: mbk88 ($203.04 in chips) 
Seat 8: alhill86 ($230.34 in chips) 
Seat 9: Ty Nick 420 ($100 in chips) 
tipner: posts small blind $0.50
Kukuryzka: posts big blind $1
*** HOLE CARDS ***
Dealt to matiko09 [Ac 4c]
Rafaello18: folds 
mopatron25: calls $1
matiko09: raises $3 to $4
mbk88: folds 
alhill86: folds 
Ty Nick 420: folds 
tipner: folds 
Kukuryzka: folds 
mopatron25: raises $6 to $10
matiko09: folds 
Uncalled bet ($6) returned to mopatron25
mopatron25 collected $9.50 from pot
mopatron25: doesn't show hand 
*** SUMMARY ***
Total pot $9.50 | Rake $0 
Seat 1: tipner (small blind) folded before Flop
Seat 2: Kukuryzka (big blind) folded before Flop
Seat 3: Rafaello18 folded before Flop (didn't bet)
Seat 4: mopatron25 collected ($9.50)
Seat 5: matiko09 folded before Flop
Seat 6: mbk88 folded before Flop (didn't bet)
Seat 8: alhill86 folded before Flop (didn't bet)
Seat 9: Ty Nick 420 (button) folded before Flop (didn't bet)





PokerStars Hand #155381621557:  Hold'em No Limit (€0.25/€0.50 EUR) - 2016/06/30 14:47:34 CET [2016/06/30 8:47:34 ET]
Table 'Vibeke II' 9-max Seat #9 is the button
Seat 1: kotkas1000 (€50 in chips) 
Seat 2: drosser321 (€50 in chips) 
Seat 4: acelacat111 (€36.24 in chips) 
Seat 5: mazefaka007 (€65.58 in chips) 
Seat 6: Kukuryzka (€54.24 in chips) 
Seat 7: matiko09 (€61.81 in chips) 
Seat 8: Math9881 (€40.16 in chips) 
Seat 9: funXmun (€50.62 in chips) 
kotkas1000: posts small blind €0.25
drosser321: posts big blind €0.50
RvPersie: sits out 
*** HOLE CARDS ***
Dealt to matiko09 [9h 7h]
acelacat111: folds 
mazefaka007 has timed out
mazefaka007: folds 
Kukuryzka: folds 
matiko09: folds 
Math9881: raises €1 to €1.50
funXmun: folds 
kotkas1000: folds 
drosser321: folds 
Uncalled bet (€1) returned to Math9881
Math9881 collected €1.25 from pot
Math9881: doesn't show hand 
*** SUMMARY ***
Total pot €1.25 | Rake €0 
Seat 1: kotkas1000 (small blind) folded before Flop
Seat 2: drosser321 (big blind) folded before Flop
Seat 4: acelacat111 folded before Flop (didn't bet)
Seat 5: mazefaka007 folded before Flop (didn't bet)
Seat 6: Kukuryzka folded before Flop (didn't bet)
Seat 7: matiko09 folded before Flop (didn't bet)
Seat 8: Math9881 collected (€1.25)
Seat 9: funXmun (button) folded before Flop (didn't bet)





PokerStars Hand #155381625839:  Hold'em No Limit ($0.25/$0.50 USD) - 2016/06/30 14:47:43 CET [2016/06/30 8:47:43 ET]
Table 'Chort III' 9-max Seat #3 is the button
Seat 2: Yourstepmom ($61.36 in chips) 
Seat 3: Dantist1122 ($50 in chips) 
Seat 4: kotkas1000 ($50 in chips) 
Seat 5: Hit Pit ($32.02 in chips) 
Seat 6: Franky77200 ($28.17 in chips) 
Seat 7: matiko09 ($53.98 in chips) 
Seat 8: Kukuryzka ($51.35 in chips) 
Seat 9: r4mz3s ($50 in chips) 
kotkas1000: posts small blind $0.25
Hit Pit: posts big blind $0.50
Yourstepmom: posts the ante $0.10
Dantist1122: posts the ante $0.10
kotkas1000: posts the ante $0.10
Hit Pit: posts the ante $0.10
Franky77200: posts the ante $0.10
matiko09: posts the ante $0.10
Kukuryzka: posts the ante $0.10
r4mz3s: posts the ante $0.10
*** HOLE CARDS ***
Dealt to matiko09 [Ks 4h]
Franky77200: raises $1 to $1.50
matiko09: folds 
Kukuryzka: folds 
r4mz3s: folds 
Yourstepmom: folds 
Dantist1122: folds 
kotkas1000: folds 
Hit Pit: folds 
Uncalled bet ($1) returned to Franky77200
Franky77200 collected $2.05 from pot
Franky77200: doesn't show hand 
*** SUMMARY ***
Total pot $2.05 | Rake $0 
Seat 2: Yourstepmom folded before Flop (didn't bet)
Seat 3: Dantist1122 (button) folded before Flop (didn't bet)
Seat 4: kotkas1000 (small blind) folded before Flop
Seat 5: Hit Pit (big blind) folded before Flop
Seat 6: Franky77200 collected ($2.05)
Seat 7: matiko09 folded before Flop (didn't bet)
Seat 8: Kukuryzka folded before Flop (didn't bet)
Seat 9: r4mz3s folded before Flop (didn't bet)





PokerStars Hand #155381628088:  Hold'em No Limit ($0.50/$1.00 USD) - 2016/06/30 14:47:48 CET [2016/06/30 8:47:48 ET]
Table 'Sigrid' 9-max Seat #5 is the button
Seat 1: Greha999 ($49.94 in chips) 
Seat 2: matiko09 ($108.36 in chips) 
Seat 3: Rafaello18 ($125.35 in chips) 
Seat 4: mbk88 ($100 in chips) 
Seat 5: chenconhaste ($100 in chips) 
Seat 8: ruslik_by ($110.09 in chips) 
Seat 9: Ty Nick 420 ($100 in chips) 
f1reworks will be allowed to play after the button
ruslik_by: posts small blind $0.50
Ty Nick 420: posts big blind $1
*** HOLE CARDS ***
Dealt to matiko09 [6h Jd]
Greha999: folds 
matiko09: folds 
Rafaello18: raises $1.50 to $2.50
mbk88: folds 
chenconhaste: folds 
ruslik_by: folds 
Ty Nick 420: folds 
Uncalled bet ($1.50) returned to Rafaello18
Rafaello18 collected $2.50 from pot
Rafaello18: doesn't show hand 
*** SUMMARY ***
Total pot $2.50 | Rake $0 
Seat 1: Greha999 folded before Flop (didn't bet)
Seat 2: matiko09 folded before Flop (didn't bet)
Seat 3: Rafaello18 collected ($2.50)
Seat 4: mbk88 folded before Flop (didn't bet)
Seat 5: chenconhaste (button) folded before Flop (didn't bet)
Seat 8: ruslik_by (small blind) folded before Flop
Seat 9: Ty Nick 420 (big blind) folded before Flop





PokerStars Hand #155381629527:  Hold'em No Limit ($0.25/$0.50 USD) - 2016/06/30 14:47:51 CET [2016/06/30 8:47:51 ET]
Table 'Joella II' 9-max Seat #1 is the button
Seat 1: r4mz3s ($111.26 in chips) 
Seat 3: santa88188 ($22.26 in chips) 
Seat 4: matiko09 ($50 in chips) 
Seat 5: TheMinion ($50 in chips) 
Seat 6: kotkas1000 ($50 in chips) 
Seat 7: seblafstian ($55.56 in chips) 
Seat 8: Askim32 ($100.25 in chips) 
Seat 9: Dantist1122 ($50.75 in chips) 
santa88188: posts small blind $0.25
matiko09: posts big blind $0.50
*** HOLE CARDS ***
Dealt to matiko09 [8s 2s]
TheMinion: folds 
kotkas1000: raises $1 to $1.50
seblafstian: folds 
Askim32: folds 
seblafstian leaves the table
Dantist1122: folds 
RvPersie joins the table at seat #7 
r4mz3s: folds 
santa88188: folds 
matiko09: folds 
Uncalled bet ($1) returned to kotkas1000
kotkas1000 collected $1.25 from pot
kotkas1000: doesn't show hand 
*** SUMMARY ***
Total pot $1.25 | Rake $0 
Seat 1: r4mz3s (button) folded before Flop (didn't bet)
Seat 3: santa88188 (small blind) folded before Flop
Seat 4: matiko09 (big blind) folded before Flop
Seat 5: TheMinion folded before Flop (didn't bet)
Seat 6: kotkas1000 collected ($1.25)
Seat 7: seblafstian folded before Flop (didn't bet)
Seat 8: Askim32 folded before Flop (didn't bet)
Seat 9: Dantist1122 folded before Flop (didn't bet)





PokerStars Hand #155381632994:  Hold'em No Limit ($0.25/$0.50 USD) - 2016/06/30 14:47:58 CET [2016/06/30 8:47:58 ET]
Table 'Chort III' 9-max Seat #4 is the button
Seat 2: Yourstepmom ($61.26 in chips) 
Seat 3: Dantist1122 ($50 in chips) 
Seat 4: kotkas1000 ($50 in chips) 
Seat 5: Hit Pit ($31.42 in chips) 
Seat 6: Franky77200 ($29.62 in chips) 
Seat 7: matiko09 ($53.88 in chips) 
Seat 8: Kukuryzka ($51.25 in chips) 
Seat 9: r4mz3s ($50 in chips) 
Hit Pit: posts small blind $0.25
Franky77200: posts big blind $0.50
Yourstepmom: posts the ante $0.10
Dantist1122: posts the ante $0.10
kotkas1000: posts the ante $0.10
Hit Pit: posts the ante $0.10
Franky77200: posts the ante $0.10
matiko09: posts the ante $0.10
Kukuryzka: posts the ante $0.10
r4mz3s: posts the ante $0.10
*** HOLE CARDS ***
Dealt to matiko09 [Kd 9d]
matiko09: folds 
Kukuryzka: folds 
r4mz3s: folds 
Yourstepmom: raises $1 to $1.50
Dantist1122: folds 
kotkas1000: folds 
Hit Pit: folds 
Franky77200: calls $1
*** FLOP *** [3s 9h 4h]
Franky77200: checks 
Yourstepmom: bets $2
Franky77200: folds 
Uncalled bet ($2) returned to Yourstepmom
Yourstepmom collected $3.85 from pot
Yourstepmom: doesn't show hand 
*** SUMMARY ***
Total pot $4.05 | Rake $0.20 
Board [3s 9h 4h]
Seat 2: Yourstepmom collected ($3.85)
Seat 3: Dantist1122 folded before Flop (didn't bet)
Seat 4: kotkas1000 (button) folded before Flop (didn't bet)
Seat 5: Hit Pit (small blind) folded before Flop
Seat 6: Franky77200 (big blind) folded on the Flop
Seat 7: matiko09 folded before Flop (didn't bet)
Seat 8: Kukuryzka folded before Flop (didn't bet)
Seat 9: r4mz3s folded before Flop (didn't bet)





PokerStars Hand #155381633829:  Hold'em No Limit ($0.50/$1.00 USD) - 2016/06/30 14:48:00 CET [2016/06/30 8:48:00 ET]
Table 'Borrelly II' 9-max Seat #2 is the button
Seat 1: Rafaello18 ($120.09 in chips) 
Seat 2: mbk88 ($100 in chips) 
Seat 4: chenconhaste ($100 in chips) 
Seat 6: m_michalec ($167.92 in chips) 
Seat 7: matiko09 ($174.36 in chips) 
Seat 8: Arjun A Raju ($139 in chips) 
Seat 9: ruslik_by ($111.65 in chips) 
chenconhaste: posts small blind $0.50
m_michalec: posts big blind $1
*** HOLE CARDS ***
Dealt to matiko09 [9s 8s]
f1reworks joins the table at seat #5 
matiko09: raises $2 to $3
Arjun A Raju: folds 
ruslik_by: folds 
Rafaello18: folds 
mbk88: folds 
chenconhaste: folds 
m_michalec: calls $2
*** FLOP *** [3c Ks Td]
m_michalec: checks 
matiko09: bets $4.02
m_michalec: calls $4.02
*** TURN *** [3c Ks Td] [4d]
m_michalec: checks 
matiko09: checks 
*** RIVER *** [3c Ks Td 4d] [2s]
m_michalec: bets $5
matiko09: folds 
Uncalled bet ($5) returned to m_michalec
m_michalec collected $13.81 from pot
m_michalec: doesn't show hand 
*** SUMMARY ***
Total pot $14.54 | Rake $0.73 
Board [3c Ks Td 4d 2s]
Seat 1: Rafaello18 folded before Flop (didn't bet)
Seat 2: mbk88 (button) folded before Flop (didn't bet)
Seat 4: chenconhaste (small blind) folded before Flop
Seat 6: m_michalec (big blind) collected ($13.81)
Seat 7: matiko09 folded on the River
Seat 8: Arjun A Raju folded before Flop (didn't bet)
Seat 9: ruslik_by folded before Flop (didn't bet)





PokerStars Hand #155381640568:  Hold'em No Limit (€0.25/€0.50 EUR) - 2016/06/30 14:48:14 CET [2016/06/30 8:48:14 ET]
Table 'Vibeke II' 9-max Seat #1 is the button
Seat 1: kotkas1000 (€50 in chips) 
Seat 2: drosser321 (€50 in chips) 
Seat 3: RvPersie (€50 in chips) 
Seat 4: acelacat111 (€36.24 in chips) 
Seat 5: mazefaka007 (€65.58 in chips) 
Seat 6: Kukuryzka (€54.24 in chips) 
Seat 7: matiko09 (€61.81 in chips) 
Seat 8: Math9881 (€40.91 in chips) 
Seat 9: funXmun (€50.62 in chips) 
drosser321: posts small blind €0.25
RvPersie: posts big blind €0.50
*** HOLE CARDS ***
Dealt to matiko09 [5h Th]
acelacat111: folds 
mazefaka007: folds 
Kukuryzka: folds 
matiko09: folds 
Math9881: folds 
funXmun: folds 
kotkas1000: folds 
drosser321: folds 
Uncalled bet (€0.25) returned to RvPersie
RvPersie collected €0.50 from pot
RvPersie: doesn't show hand 
*** SUMMARY ***
Total pot €0.50 | Rake €0 
Seat 1: kotkas1000 (button) folded before Flop (didn't bet)
Seat 2: drosser321 (small blind) folded before Flop
Seat 3: RvPersie (big blind) collected (€0.50)
Seat 4: acelacat111 folded before Flop (didn't bet)
Seat 5: mazefaka007 folded before Flop (didn't bet)
Seat 6: Kukuryzka folded before Flop (didn't bet)
Seat 7: matiko09 folded before Flop (didn't bet)
Seat 8: Math9881 folded before Flop (didn't bet)
Seat 9: funXmun folded before Flop (didn't bet)





PokerStars Hand #155381642255:  Hold'em No Limit ($0.50/$1.00 USD) - 2016/06/30 14:48:17 CET [2016/06/30 8:48:17 ET]
Table 'Tatjana' 9-max Seat #1 is the button
Seat 1: tipner ($100 in chips) 
Seat 2: Kukuryzka ($104.38 in chips) 
Seat 3: Rafaello18 ($105.88 in chips) 
Seat 4: mopatron25 ($70.50 in chips) 
Seat 5: matiko09 ($100 in chips) 
Seat 6: mbk88 ($203.04 in chips) 
Seat 8: alhill86 ($230.34 in chips) 
Seat 9: Ty Nick 420 ($100 in chips) 
Kukuryzka: posts small blind $0.50
Rafaello18: posts big blind $1
*** HOLE CARDS ***
Dealt to matiko09 [Kh Td]
mopatron25: calls $1
matiko09: folds 
mbk88: folds 
alhill86: folds 
Ty Nick 420: raises $2.50 to $3.50
tipner: folds 
Kukuryzka: folds 
Rafaello18: folds 
mopatron25: calls $2.50
*** FLOP *** [7c Jd 3d]
mopatron25: bets $3
Ty Nick 420: raises $6 to $9
mopatron25: calls $6
*** TURN *** [7c Jd 3d] [3h]
mopatron25: bets $13
Ty Nick 420: calls $13
*** RIVER *** [7c Jd 3d 3h] [Jh]
mopatron25: bets $10
Ty Nick 420: raises $64.50 to $74.50 and is all-in
mopatron25: folds 
Uncalled bet ($64.50) returned to Ty Nick 420
Ty Nick 420 collected $70 from pot
*** SUMMARY ***
Total pot $72.50 | Rake $2.50 
Board [7c Jd 3d 3h Jh]
Seat 1: tipner (button) folded before Flop (didn't bet)
Seat 2: Kukuryzka (small blind) folded before Flop
Seat 3: Rafaello18 (big blind) folded before Flop
Seat 4: mopatron25 folded on the River
Seat 5: matiko09 folded before Flop (didn't bet)
Seat 6: mbk88 folded before Flop (didn't bet)
Seat 8: alhill86 folded before Flop (didn't bet)
Seat 9: Ty Nick 420 collected ($70)





PokerStars Hand #155381641928:  Hold'em No Limit ($0.50/$1.00 USD) - 2016/06/30 14:48:17 CET [2016/06/30 8:48:17 ET]
Table 'California II' 9-max Seat #5 is the button
Seat 1: Rafaello18 ($110 in chips) 
Seat 2: ruslik_by ($140.81 in chips) 
Seat 3: KovIFish89 ($108.92 in chips) 
Seat 4: f1reworks ($113.35 in chips) 
Seat 5: Rohitbarve ($104.27 in chips) 
Seat 6: matiko09 ($118.98 in chips) 
Seat 7: DomiVY ($88.38 in chips) 
Seat 8: chenconhaste ($100 in chips) 
Seat 9: di0d80 ($208.74 in chips) 
matiko09: posts small blind $0.50
DomiVY: posts big blind $1
*** HOLE CARDS ***
Dealt to matiko09 [7d 5h]
chenconhaste: folds 
di0d80: folds 
Rafaello18: folds 
ruslik_by: raises $2 to $3
KovIFish89: folds 
f1reworks: folds 
Rohitbarve: folds 
matiko09: folds 
DomiVY: folds 
Uncalled bet ($2) returned to ruslik_by
ruslik_by collected $2.50 from pot
ruslik_by: doesn't show hand 
*** SUMMARY ***
Total pot $2.50 | Rake $0 
Seat 1: Rafaello18 folded before Flop (didn't bet)
Seat 2: ruslik_by collected ($2.50)
Seat 3: KovIFish89 folded before Flop (didn't bet)
Seat 4: f1reworks folded before Flop (didn't bet)
Seat 5: Rohitbarve (button) folded before Flop (didn't bet)
Seat 6: matiko09 (small blind) folded before Flop
Seat 7: DomiVY (big blind) folded before Flop
Seat 8: chenconhaste folded before Flop (didn't bet)
Seat 9: di0d80 folded before Flop (didn't bet)





PokerStars Hand #155381642774:  Hold'em No Limit ($0.50/$1.00 USD) - 2016/06/30 14:48:18 CET [2016/06/30 8:48:18 ET]
Table 'Tietjen' 9-max Seat #7 is the button
Seat 1: swizzly58 ($80 in chips) 
Seat 2: chenconhaste ($100 in chips) 
Seat 3: bearlar ($100 in chips) 
Seat 4: matiko09 ($100 in chips) 
Seat 5: Ty Nick 420 ($102.72 in chips) 
Seat 6: CR0ZAMATOZ ($100 in chips) 
Seat 7: Rafaello18 ($100 in chips) 
Seat 8: rukus0000 ($37.50 in chips) 
Seat 9: ETHANS ($80 in chips) 
rukus0000: posts small blind $0.50
ETHANS: posts big blind $1
*** HOLE CARDS ***
Dealt to matiko09 [Ts Ad]
swizzly58: folds 
chenconhaste: folds 
bearlar: raises $2 to $3
matiko09: folds 
Ty Nick 420: calls $3
CR0ZAMATOZ: folds 
Rafaello18: folds 
rukus0000: calls $2.50
ETHANS: raises $12 to $15
bearlar: folds 
Ty Nick 420: folds 
rukus0000: calls $12
*** FLOP *** [6s 4s 9d]
rukus0000: checks 
ETHANS: bets $34.20
rukus0000: calls $22.50 and is all-in
Uncalled bet ($11.70) returned to ETHANS
*** TURN *** [6s 4s 9d] [8c]
*** RIVER *** [6s 4s 9d 8c] [9c]
*** SHOW DOWN ***
rukus0000: shows [7s Ks] (a pair of Nines)
ETHANS: shows [Jc Jd] (two pair, Jacks and Nines)
ETHANS collected $78.50 from pot
*** SUMMARY ***
Total pot $81 | Rake $2.50 
Board [6s 4s 9d 8c 9c]
Seat 1: swizzly58 folded before Flop (didn't bet)
Seat 2: chenconhaste folded before Flop (didn't bet)
Seat 3: bearlar folded before Flop
Seat 4: matiko09 folded before Flop (didn't bet)
Seat 5: Ty Nick 420 folded before Flop
Seat 6: CR0ZAMATOZ folded before Flop (didn't bet)
Seat 7: Rafaello18 (button) folded before Flop (didn't bet)
Seat 8: rukus0000 (small blind) showed [7s Ks] and lost with a pair of Nines
Seat 9: ETHANS (big blind) showed [Jc Jd] and won ($78.50) with two pair, Jacks and Nines





PokerStars Hand #155381646742:  Hold'em No Limit ($0.25/$0.50 USD) - 2016/06/30 14:48:27 CET [2016/06/30 8:48:27 ET]
Table 'Joella II' 9-max Seat #3 is the button
Seat 1: r4mz3s ($111.26 in chips) 
Seat 3: santa88188 ($22.01 in chips) 
Seat 4: matiko09 ($50 in chips) 
Seat 5: TheMinion ($50 in chips) 
Seat 6: kotkas1000 ($50.75 in chips) 
Seat 8: Askim32 ($100.25 in chips) 
Seat 9: Dantist1122 ($50.75 in chips) 
matiko09: posts small blind $0.25
TheMinion: posts big blind $0.50
RvPersie: sits out 
*** HOLE CARDS ***
Dealt to matiko09 [7h Kd]
kotkas1000: folds 
Askim32: raises $1 to $1.50
kotkas1000 leaves the table
Dantist1122: folds 
r4mz3s: folds 
OMGHankAzari joins the table at seat #6 
santa88188: folds 
matiko09: folds 
TheMinion: folds 
Uncalled bet ($1) returned to Askim32
Askim32 collected $1.25 from pot
Askim32: doesn't show hand 
*** SUMMARY ***
Total pot $1.25 | Rake $0 
Seat 1: r4mz3s folded before Flop (didn't bet)
Seat 3: santa88188 (button) folded before Flop (didn't bet)
Seat 4: matiko09 (small blind) folded before Flop
Seat 5: TheMinion (big blind) folded before Flop
Seat 6: kotkas1000 folded before Flop (didn't bet)
Seat 8: Askim32 collected ($1.25)
Seat 9: Dantist1122 folded before Flop (didn't bet)





PokerStars Hand #155381652392:  Hold'em No Limit ($0.25/$0.50 USD) - 2016/06/30 14:48:39 CET [2016/06/30 8:48:39 ET]
Table 'Arcturus' 9-max Seat #1 is the button
Seat 1: kourk250 ($142.80 in chips) 
Seat 2: Rafaello18 ($51.84 in chips) 
Seat 3: matiko09 ($65.69 in chips) 
Seat 5: stockbridge8 ($44.75 in chips) 
Seat 6: sanr23 ($52.78 in chips) 
Seat 7: bratbugor ($50 in chips) 
Seat 8: TheMinion ($65.26 in chips) 
Seat 9: joker180785 ($50 in chips) 
Rafaello18: posts small blind $0.25
matiko09: posts big blind $0.50
*** HOLE CARDS ***
Dealt to matiko09 [5h 9c]
stockbridge8: folds 
sanr23: folds 
bratbugor: folds 
TheMinion: folds 
joker180785: raises $1 to $1.50
kourk250: folds 
Rafaello18: folds 
matiko09: folds 
Uncalled bet ($1) returned to joker180785
joker180785 collected $1.25 from pot
*** SUMMARY ***
Total pot $1.25 | Rake $0 
Seat 1: kourk250 (button) folded before Flop (didn't bet)
Seat 2: Rafaello18 (small blind) folded before Flop
Seat 3: matiko09 (big blind) folded before Flop
Seat 5: stockbridge8 folded before Flop (didn't bet)
Seat 6: sanr23 folded before Flop (didn't bet)
Seat 7: bratbugor folded before Flop (didn't bet)
Seat 8: TheMinion folded before Flop (didn't bet)
Seat 9: joker180785 collected ($1.25)





PokerStars Hand #155381652539:  Hold'em No Limit ($0.25/$0.50 USD) - 2016/06/30 14:48:39 CET [2016/06/30 8:48:39 ET]
Table 'Chort III' 9-max Seat #5 is the button
Seat 2: Yourstepmom ($63.51 in chips) 
Seat 3: Dantist1122 ($50 in chips) 
Seat 4: kotkas1000 ($50 in chips) 
Seat 5: Hit Pit ($31.07 in chips) 
Seat 6: Franky77200 ($28.02 in chips) 
Seat 7: matiko09 ($53.78 in chips) 
Seat 8: Kukuryzka ($51.15 in chips) 
Seat 9: r4mz3s ($50 in chips) 
Franky77200: posts small blind $0.25
matiko09: posts big blind $0.50
Yourstepmom: posts the ante $0.10
Dantist1122: posts the ante $0.10
kotkas1000: posts the ante $0.10
Hit Pit: posts the ante $0.10
Franky77200: posts the ante $0.10
matiko09: posts the ante $0.10
Kukuryzka: posts the ante $0.10
r4mz3s: posts the ante $0.10
*** HOLE CARDS ***
Dealt to matiko09 [Qd Td]
Kukuryzka: folds 
r4mz3s: folds 
Yourstepmom: raises $1 to $1.50
Dantist1122: folds 
kotkas1000: folds 
Hit Pit: folds 
Franky77200: folds 
matiko09: folds 
Uncalled bet ($1) returned to Yourstepmom
Yourstepmom collected $2.05 from pot
Yourstepmom: doesn't show hand 
*** SUMMARY ***
Total pot $2.05 | Rake $0 
Seat 2: Yourstepmom collected ($2.05)
Seat 3: Dantist1122 folded before Flop (didn't bet)
Seat 4: kotkas1000 folded before Flop (didn't bet)
Seat 5: Hit Pit (button) folded before Flop (didn't bet)
Seat 6: Franky77200 (small blind) folded before Flop
Seat 7: matiko09 (big blind) folded before Flop
Seat 8: Kukuryzka folded before Flop (didn't bet)
Seat 9: r4mz3s folded before Flop (didn't bet)





PokerStars Hand #155381654973:  Hold'em No Limit (€0.25/€0.50 EUR) - 2016/06/30 14:48:44 CET [2016/06/30 8:48:44 ET]
Table 'Vibeke II' 9-max Seat #2 is the button
Seat 1: kotkas1000 (€50 in chips) 
Seat 2: drosser321 (€50 in chips) 
Seat 3: RvPersie (€50.25 in chips) 
Seat 4: acelacat111 (€36.24 in chips) 
Seat 5: mazefaka007 (€65.58 in chips) 
Seat 6: Kukuryzka (€54.24 in chips) 
Seat 7: matiko09 (€61.81 in chips) 
Seat 8: Math9881 (€40.91 in chips) 
Seat 9: funXmun (€50.62 in chips) 
RvPersie: posts small blind €0.25
acelacat111: posts big blind €0.50
*** HOLE CARDS ***
Dealt to matiko09 [As 8c]
mazefaka007 has timed out
mazefaka007: folds 
Kukuryzka: folds 
mazefaka007 leaves the table
matiko09: folds 
Math9881: raises €1 to €1.50
funXmun: folds 
kotkas1000: folds 
drosser321: folds 
RvPersie: folds 
acelacat111: folds 
Uncalled bet (€1) returned to Math9881
Math9881 collected €1.25 from pot
Math9881: doesn't show hand 
*** SUMMARY ***
Total pot €1.25 | Rake €0 
Seat 1: kotkas1000 folded before Flop (didn't bet)
Seat 2: drosser321 (button) folded before Flop (didn't bet)
Seat 3: RvPersie (small blind) folded before Flop
Seat 4: acelacat111 (big blind) folded before Flop
Seat 5: mazefaka007 folded before Flop (didn't bet)
Seat 6: Kukuryzka folded before Flop (didn't bet)
Seat 7: matiko09 folded before Flop (didn't bet)
Seat 8: Math9881 collected (€1.25)
Seat 9: funXmun folded before Flop (didn't bet)





PokerStars Hand #155381655734:  Hold'em No Limit ($0.25/$0.50 USD) - 2016/06/30 14:48:46 CET [2016/06/30 8:48:46 ET]
Table 'Thalia II' 9-max Seat #3 is the button
Seat 2: DeathcorePkr ($68.06 in chips) 
Seat 3: r4mz3s ($72.77 in chips) 
Seat 4: Kukuryzka ($50 in chips) 
Seat 5: geowin ($44.51 in chips) 
Seat 6: chenconhaste ($53.69 in chips) 
Seat 7: fudzi ($62.27 in chips) 
Seat 8: Jo_Medici ($57.46 in chips) 
Seat 9: matiko09 ($50 in chips) 
Kukuryzka: posts small blind $0.25
geowin: posts big blind $0.50
DeathcorePkr: posts the ante $0.10
r4mz3s: posts the ante $0.10
Kukuryzka: posts the ante $0.10
geowin: posts the ante $0.10
chenconhaste: posts the ante $0.10
fudzi: posts the ante $0.10
Jo_Medici: posts the ante $0.10
matiko09: posts the ante $0.10
*** HOLE CARDS ***
Dealt to matiko09 [Qs 3d]
chenconhaste: folds 
fudzi: folds 
Jo_Medici: folds 
matiko09: folds 
DeathcorePkr: raises $0.75 to $1.25
r4mz3s: calls $1.25
Kukuryzka: folds 
geowin: folds 
*** FLOP *** [9d 9h Tc]
DeathcorePkr: checks 
r4mz3s: bets $2
DeathcorePkr: folds 
Uncalled bet ($2) returned to r4mz3s
r4mz3s collected $3.85 from pot
r4mz3s: doesn't show hand 
*** SUMMARY ***
Total pot $4.05 | Rake $0.20 
Board [9d 9h Tc]
Seat 2: DeathcorePkr folded on the Flop
Seat 3: r4mz3s (button) collected ($3.85)
Seat 4: Kukuryzka (small blind) folded before Flop
Seat 5: geowin (big blind) folded before Flop
Seat 6: chenconhaste folded before Flop (didn't bet)
Seat 7: fudzi folded before Flop (didn't bet)
Seat 8: Jo_Medici folded before Flop (didn't bet)
Seat 9: matiko09 folded before Flop (didn't bet)





PokerStars Hand #155381657261:  Hold'em No Limit ($0.50/$1.00 USD) - 2016/06/30 14:48:49 CET [2016/06/30 8:48:49 ET]
Table 'California II' 9-max Seat #6 is the button
Seat 1: Rafaello18 ($110 in chips) 
Seat 2: ruslik_by ($142.31 in chips) 
Seat 3: KovIFish89 ($108.92 in chips) 
Seat 4: f1reworks ($113.35 in chips) 
Seat 5: Rohitbarve ($104.27 in chips) 
Seat 6: matiko09 ($118.48 in chips) 
Seat 7: DomiVY ($87.38 in chips) 
Seat 8: chenconhaste ($100 in chips) 
Seat 9: di0d80 ($208.74 in chips) 
DomiVY: posts small blind $0.50
chenconhaste: posts big blind $1
*** HOLE CARDS ***
Dealt to matiko09 [Th 4s]
di0d80: folds 
di0d80 leaves the table
Ty Nick 420 joins the table at seat #9 
Rafaello18: folds 
ruslik_by: folds 
KovIFish89: folds 
f1reworks: folds 
Rohitbarve: folds 
matiko09: folds 
DomiVY: folds 
Uncalled bet ($0.50) returned to chenconhaste
chenconhaste collected $1 from pot
*** SUMMARY ***
Total pot $1 | Rake $0 
Seat 1: Rafaello18 folded before Flop (didn't bet)
Seat 2: ruslik_by folded before Flop (didn't bet)
Seat 3: KovIFish89 folded before Flop (didn't bet)
Seat 4: f1reworks folded before Flop (didn't bet)
Seat 5: Rohitbarve folded before Flop (didn't bet)
Seat 6: matiko09 (button) folded before Flop (didn't bet)
Seat 7: DomiVY (small blind) folded before Flop
Seat 8: chenconhaste (big blind) collected ($1)
Seat 9: di0d80 folded before Flop (didn't bet)





PokerStars Hand #155381659803:  Hold'em No Limit ($0.25/$0.50 USD) - 2016/06/30 14:48:54 CET [2016/06/30 8:48:54 ET]
Table 'Joella II' 9-max Seat #4 is the button
Seat 3: santa88188 ($22.01 in chips) 
Seat 4: matiko09 ($50 in chips) 
Seat 5: TheMinion ($50 in chips) 
Seat 6: OMGHankAzari ($21.14 in chips) 
Seat 8: Askim32 ($101 in chips) 
Seat 9: Dantist1122 ($50.75 in chips) 
TheMinion: posts small blind $0.25
OMGHankAzari: posts big blind $0.50
RvPersie: sits out 
*** HOLE CARDS ***
Dealt to matiko09 [9c 3h]
Askim32: folds 
Dantist1122: folds 
santa88188: folds 
matiko09: folds 
TheMinion: folds 
Uncalled bet ($0.25) returned to OMGHankAzari
OMGHankAzari collected $0.50 from pot
OMGHankAzari: doesn't show hand 
*** SUMMARY ***
Total pot $0.50 | Rake $0 
Seat 3: santa88188 folded before Flop (didn't bet)
Seat 4: matiko09 (button) folded before Flop (didn't bet)
Seat 5: TheMinion (small blind) folded before Flop
Seat 6: OMGHankAzari (big blind) collected ($0.50)
Seat 8: Askim32 folded before Flop (didn't bet)
Seat 9: Dantist1122 folded before Flop (didn't bet)





PokerStars Hand #155381660755:  Hold'em No Limit ($0.25/$0.50 USD) - 2016/06/30 14:48:56 CET [2016/06/30 8:48:56 ET]
Table 'Chort III' 9-max Seat #6 is the button
Seat 2: Yourstepmom ($64.96 in chips) 
Seat 3: Dantist1122 ($50 in chips) 
Seat 4: kotkas1000 ($50 in chips) 
Seat 5: Hit Pit ($30.97 in chips) 
Seat 6: Franky77200 ($27.67 in chips) 
Seat 7: matiko09 ($53.18 in chips) 
Seat 8: Kukuryzka ($51.05 in chips) 
matiko09: posts small blind $0.25
Kukuryzka: posts big blind $0.50
Yourstepmom: posts the ante $0.10
Dantist1122: posts the ante $0.10
kotkas1000: posts the ante $0.10
Hit Pit: posts the ante $0.10
Franky77200: posts the ante $0.10
matiko09: posts the ante $0.10
Kukuryzka: posts the ante $0.10
*** HOLE CARDS ***
Dealt to matiko09 [5c Qs]
Yourstepmom: folds 
Dantist1122: folds 
kotkas1000: raises $1.25 to $1.75
Hit Pit: folds 
Franky77200: folds 
matiko09: folds 
Kukuryzka: folds 
Uncalled bet ($1.25) returned to kotkas1000
kotkas1000 collected $1.95 from pot
kotkas1000: doesn't show hand 
*** SUMMARY ***
Total pot $1.95 | Rake $0 
Seat 2: Yourstepmom folded before Flop (didn't bet)
Seat 3: Dantist1122 folded before Flop (didn't bet)
Seat 4: kotkas1000 collected ($1.95)
Seat 5: Hit Pit folded before Flop (didn't bet)
Seat 6: Franky77200 (button) folded before Flop (didn't bet)
Seat 7: matiko09 (small blind) folded before Flop
Seat 8: Kukuryzka (big blind) folded before Flop





PokerStars Hand #155381665896:  Hold'em No Limit ($0.50/$1.00 USD) - 2016/06/30 14:49:06 CET [2016/06/30 8:49:06 ET]
Table 'Donnera' 9-max Seat #5 is the button
Seat 1: chenconhaste ($118.84 in chips) 
Seat 2: robbiescrim9 ($80.87 in chips) 
Seat 3: matiko09 ($136.32 in chips) 
Seat 4: Kukuryzka ($104.28 in chips) 
Seat 5: tipner ($100 in chips) 
Seat 6: nickreason17 ($111.25 in chips) 
Seat 7: Rafaello18 ($116.30 in chips) 
Seat 8: ruslik_by ($201.44 in chips) 
Seat 9: Starw!nd ($117.75 in chips) 
nickreason17: posts small blind $0.50
Rafaello18: posts big blind $1
*** HOLE CARDS ***
Dealt to matiko09 [5h Kh]
ruslik_by: folds 
Starw!nd: folds 
chenconhaste: folds 
robbiescrim9: calls $1
matiko09: folds 
Kukuryzka: folds 
tipner: raises $3 to $4
nickreason17: folds 
Rafaello18: raises $10 to $14
robbiescrim9: calls $13
tipner: calls $10
*** FLOP *** [Ts 2c As]
Rafaello18: checks 
robbiescrim9: bets $8.46
tipner: raises $8.54 to $17
Rafaello18: folds 
robbiescrim9: calls $8.54
*** TURN *** [Ts 2c As] [7s]
robbiescrim9: bets $49.87 and is all-in
tipner: calls $49.87
*** RIVER *** [Ts 2c As 7s] [Ah]
*** SHOW DOWN ***
robbiescrim9: shows [Th Kd] (two pair, Aces and Tens)
tipner: shows [Ad 2d] (a full house, Aces full of Deuces)
tipner collected $173.74 from pot
*** SUMMARY ***
Total pot $176.24 | Rake $2.50 
Board [Ts 2c As 7s Ah]
Seat 1: chenconhaste folded before Flop (didn't bet)
Seat 2: robbiescrim9 showed [Th Kd] and lost with two pair, Aces and Tens
Seat 3: matiko09 folded before Flop (didn't bet)
Seat 4: Kukuryzka folded before Flop (didn't bet)
Seat 5: tipner (button) showed [Ad 2d] and won ($173.74) with a full house, Aces full of Deuces
Seat 6: nickreason17 (small blind) folded before Flop
Seat 7: Rafaello18 (big blind) folded on the Flop
Seat 8: ruslik_by folded before Flop (didn't bet)
Seat 9: Starw!nd folded before Flop (didn't bet)





PokerStars Hand #155381670625:  Hold'em No Limit ($0.25/$0.50 USD) - 2016/06/30 14:49:16 CET [2016/06/30 8:49:16 ET]
Table 'Joella II' 9-max Seat #5 is the button
Seat 3: santa88188 ($22.01 in chips) 
Seat 4: matiko09 ($50 in chips) 
Seat 5: TheMinion ($50 in chips) 
Seat 6: OMGHankAzari ($21.39 in chips) 
Seat 7: RvPersie ($50 in chips) 
Seat 8: Askim32 ($101 in chips) 
Seat 9: Dantist1122 ($50.75 in chips) 
OMGHankAzari: posts small blind $0.25
RvPersie: posts big blind $0.50
*** HOLE CARDS ***
Dealt to matiko09 [8c 5c]
Askim32: folds 
Dantist1122: folds 
santa88188: folds 
matiko09: folds 
TheMinion: folds 
OMGHankAzari: raises $1 to $1.50
RvPersie: calls $1
*** FLOP *** [Jh 2d 3h]
OMGHankAzari: checks 
RvPersie: checks 
*** TURN *** [Jh 2d 3h] [Jc]
OMGHankAzari: bets $1
RvPersie: calls $1
*** RIVER *** [Jh 2d 3h Jc] [3d]
OMGHankAzari: checks 
RvPersie: checks 
*** SHOW DOWN ***
OMGHankAzari: shows [Ah 2c] (two pair, Jacks and Threes)
RvPersie: shows [7s Ad] (two pair, Jacks and Threes)
OMGHankAzari collected $2.38 from pot
RvPersie collected $2.37 from pot
*** SUMMARY ***
Total pot $5 | Rake $0.25 
Board [Jh 2d 3h Jc 3d]
Seat 3: santa88188 folded before Flop (didn't bet)
Seat 4: matiko09 folded before Flop (didn't bet)
Seat 5: TheMinion (button) folded before Flop (didn't bet)
Seat 6: OMGHankAzari (small blind) showed [Ah 2c] and won ($2.38) with two pair, Jacks and Threes
Seat 7: RvPersie (big blind) showed [7s Ad] and won ($2.37) with two pair, Jacks and Threes
Seat 8: Askim32 folded before Flop (didn't bet)
Seat 9: Dantist1122 folded before Flop (didn't bet)





