PokerStars Hand #150705831775:  Hold'em No Limit ($0.50/$1.00 USD) - 2016/03/21 16:22:20 CET [2016/03/21 11:22:20 ET]
Table 'Goberta' 9-max Seat #4 is the button
Seat 1: CapnDobro ($167.58 in chips) 
Seat 2: mycka86 ($119 in chips) 
Seat 3: Pacifistas ($100 in chips) 
Seat 4: aseban11 ($106.55 in chips) 
Seat 5: matiko09 ($100 in chips) 
Seat 6: sanpidk ($114.53 in chips) 
Seat 7: flk.Dasas ($100 in chips) 
Seat 8: Zeeshka ($103.21 in chips) 
Seat 9: Ez1kelL ($44.70 in chips) 
matiko09: posts small blind $0.50
sanpidk: posts big blind $1
*** HOLE CARDS ***
Dealt to matiko09 [Qd 3h]
flk.Dasas: folds 
Zeeshka: raises $2 to $3
Ez1kelL: folds 
CapnDobro: folds 
mycka86: folds 
Pacifistas: folds 
aseban11: calls $3
matiko09: folds 
sanpidk: folds 
*** FLOP *** [Tc 8h 3s]
Zeeshka: checks 
aseban11: checks 
*** TURN *** [Tc 8h 3s] [4s]
Zeeshka: bets $4.79
aseban11: folds 
Uncalled bet ($4.79) returned to Zeeshka
Zeeshka collected $7.16 from pot
Zeeshka: doesn't show hand 
*** SUMMARY ***
Total pot $7.50 | Rake $0.34 
Board [Tc 8h 3s 4s]
Seat 1: CapnDobro folded before Flop (didn't bet)
Seat 2: mycka86 folded before Flop (didn't bet)
Seat 3: Pacifistas folded before Flop (didn't bet)
Seat 4: aseban11 (button) folded on the Turn
Seat 5: matiko09 (small blind) folded before Flop
Seat 6: sanpidk (big blind) folded before Flop
Seat 7: flk.Dasas folded before Flop (didn't bet)
Seat 8: Zeeshka collected ($7.16)
Seat 9: Ez1kelL folded before Flop (didn't bet)





PokerStars Hand #150705835211:  Hold'em No Limit ($0.50/$1.00 USD) - 2016/03/21 16:22:25 CET [2016/03/21 11:22:25 ET]
Table 'Massalia II' 9-max Seat #5 is the button
Seat 5: roninio1 ($87.84 in chips) 
Seat 6: Pacifistas ($100 in chips) 
Seat 8: matiko09 ($100 in chips) 
Pacifistas: posts small blind $0.50
matiko09: posts big blind $1
roninio1: posts the ante $0.20
Pacifistas: posts the ante $0.20
matiko09: posts the ante $0.20
*** HOLE CARDS ***
Dealt to matiko09 [Th 3h]
roninio1: folds 
Pacifistas: raises $1.50 to $2.50
matiko09: folds 
Uncalled bet ($1.50) returned to Pacifistas
Pacifistas collected $2.60 from pot
Pacifistas: doesn't show hand 
*** SUMMARY ***
Total pot $2.60 | Rake $0 
Seat 5: roninio1 (button) folded before Flop (didn't bet)
Seat 6: Pacifistas (small blind) collected ($2.60)
Seat 8: matiko09 (big blind) folded before Flop





PokerStars Hand #150705843005:  Hold'em No Limit ($0.50/$1.00 USD) - 2016/03/21 16:22:36 CET [2016/03/21 11:22:36 ET]
Table 'Vega III' 9-max Seat #5 is the button
Seat 1: solbi86 ($164.32 in chips) 
Seat 2: hammerwife ($108.08 in chips) 
Seat 3: forsmthgood ($103 in chips) 
Seat 4: gabi_igna ($101.62 in chips) 
Seat 5: matiko09 ($101.14 in chips) 
Seat 6: samirj88 ($143.48 in chips) 
Seat 7: mycka86 ($110.41 in chips) 
Seat 8: sanpidk ($100 in chips) 
Seat 9: chute85 ($42.64 in chips) 
samirj88: posts small blind $0.50
mycka86: posts big blind $1
*** HOLE CARDS ***
Dealt to matiko09 [3h Th]
sanpidk: folds 
chute85: folds 
solbi86: folds 
hammerwife: folds 
forsmthgood: raises $2 to $3
gabi_igna: folds 
matiko09: folds 
samirj88: folds 
mycka86: folds 
Uncalled bet ($2) returned to forsmthgood
forsmthgood collected $2.50 from pot
forsmthgood: doesn't show hand 
*** SUMMARY ***
Total pot $2.50 | Rake $0 
Seat 1: solbi86 folded before Flop (didn't bet)
Seat 2: hammerwife folded before Flop (didn't bet)
Seat 3: forsmthgood collected ($2.50)
Seat 4: gabi_igna folded before Flop (didn't bet)
Seat 5: matiko09 (button) folded before Flop (didn't bet)
Seat 6: samirj88 (small blind) folded before Flop
Seat 7: mycka86 (big blind) folded before Flop
Seat 8: sanpidk folded before Flop (didn't bet)
Seat 9: chute85 folded before Flop (didn't bet)





PokerStars Hand #150705845960:  Hold'em No Limit ($0.50/$1.00 USD) - 2016/03/21 16:22:40 CET [2016/03/21 11:22:40 ET]
Table 'Juhani' 9-max Seat #4 is the button
Seat 1: Dachish ($69 in chips) 
Seat 2: matiko09 ($102.50 in chips) 
Seat 3: cobrik23 ($37 in chips) 
Seat 4: Pacifistas ($113.63 in chips) 
Seat 5: RICKA16 ($103.50 in chips) 
Seat 6: Pay-My-Thc-B ($106.25 in chips) 
Seat 7: liyiwei233 ($38.36 in chips) 
Seat 8: sanpidk ($100 in chips) 
Seat 9: gabi_igna ($149.45 in chips) 
RICKA16: posts small blind $0.50
Pay-My-Thc-B: posts big blind $1
*** HOLE CARDS ***
Dealt to matiko09 [8s 4c]
liyiwei233: raises $1.70 to $2.70
sanpidk: folds 
gabi_igna: folds 
Dachish: folds 
matiko09: folds 
cobrik23: folds 
Pacifistas: folds 
RICKA16: folds 
Pay-My-Thc-B: folds 
Uncalled bet ($1.70) returned to liyiwei233
liyiwei233 collected $2.50 from pot
liyiwei233: doesn't show hand 
*** SUMMARY ***
Total pot $2.50 | Rake $0 
Seat 1: Dachish folded before Flop (didn't bet)
Seat 2: matiko09 folded before Flop (didn't bet)
Seat 3: cobrik23 folded before Flop (didn't bet)
Seat 4: Pacifistas (button) folded before Flop (didn't bet)
Seat 5: RICKA16 (small blind) folded before Flop
Seat 6: Pay-My-Thc-B (big blind) folded before Flop
Seat 7: liyiwei233 collected ($2.50)
Seat 8: sanpidk folded before Flop (didn't bet)
Seat 9: gabi_igna folded before Flop (didn't bet)





PokerStars Hand #150705848059:  Hold'em No Limit ($0.50/$1.00 USD) - 2016/03/21 16:22:43 CET [2016/03/21 11:22:43 ET]
Table 'Gondola II' 9-max Seat #7 is the button
Seat 1: matiko09 ($100 in chips) 
Seat 2: R1aki ($112.62 in chips) 
Seat 3: flk.Dasas ($103.50 in chips) 
Seat 4: aseban11 ($100 in chips) 
Seat 5: teukka8 ($87.01 in chips) 
Seat 7: Pacifistas ($100 in chips) 
Seat 8: cn_chayanne ($100.50 in chips) 
Seat 9: djammusic ($40.20 in chips) 
cn_chayanne: posts small blind $0.50
djammusic: posts big blind $1
SanychStar: sits out 
*** HOLE CARDS ***
Dealt to matiko09 [Kd Qc]
matiko09: folds 
R1aki: folds 
flk.Dasas: folds 
aseban11: folds 
teukka8: folds 
Pacifistas: raises $1.50 to $2.50
cn_chayanne: folds 
djammusic: raises $37.50 to $40
Pacifistas: folds 
Uncalled bet ($37.50) returned to djammusic
djammusic collected $5.50 from pot
djammusic: doesn't show hand 
*** SUMMARY ***
Total pot $5.50 | Rake $0 
Seat 1: matiko09 folded before Flop (didn't bet)
Seat 2: R1aki folded before Flop (didn't bet)
Seat 3: flk.Dasas folded before Flop (didn't bet)
Seat 4: aseban11 folded before Flop (didn't bet)
Seat 5: teukka8 folded before Flop (didn't bet)
Seat 7: Pacifistas (button) folded before Flop
Seat 8: cn_chayanne (small blind) folded before Flop
Seat 9: djammusic (big blind) collected ($5.50)





PokerStars Hand #150705850010:  Hold'em No Limit ($0.50/$1.00 USD) - 2016/03/21 16:22:46 CET [2016/03/21 11:22:46 ET]
Table 'Massalia II' 9-max Seat #6 is the button
Seat 5: roninio1 ($87.64 in chips) 
Seat 6: Pacifistas ($101.40 in chips) 
Seat 8: matiko09 ($100 in chips) 
matiko09: posts small blind $0.50
roninio1: posts big blind $1
roninio1: posts the ante $0.20
Pacifistas: posts the ante $0.20
matiko09: posts the ante $0.20
*** HOLE CARDS ***
Dealt to matiko09 [8c Ks]
Pacifistas: folds 
matiko09: raises $1.50 to $2.50
roninio1: calls $1.50
*** FLOP *** [Ac 9d 6s]
matiko09: checks 
roninio1 said, "do we play the 72 game?"
roninio1: bets $5.35
matiko09: folds 
Uncalled bet ($5.35) returned to roninio1
roninio1 collected $5.35 from pot
roninio1: doesn't show hand 
*** SUMMARY ***
Total pot $5.60 | Rake $0.25 
Board [Ac 9d 6s]
Seat 5: roninio1 (big blind) collected ($5.35)
Seat 6: Pacifistas (button) folded before Flop (didn't bet)
Seat 8: matiko09 (small blind) folded on the Flop





PokerStars Hand #150705853054:  Hold'em No Limit ($0.50/$1.00 USD) - 2016/03/21 16:22:50 CET [2016/03/21 11:22:50 ET]
Table 'Onnie II' 9-max Seat #1 is the button
Seat 1: aseban11 ($110.32 in chips) 
Seat 2: RICKA16 ($86.73 in chips) 
Seat 3: cn_chayanne ($101.18 in chips) 
Seat 4: Bothfeld11 ($99 in chips) 
Seat 5: roninio1 ($79.50 in chips) 
Seat 6: Pacifistas ($106.16 in chips) 
Seat 7: djammusic ($75.08 in chips) 
Seat 8: solbi86 ($100 in chips) 
Seat 9: matiko09 ($112.55 in chips) 
RICKA16: posts small blind $0.50
cn_chayanne: posts big blind $1
*** HOLE CARDS ***
Dealt to matiko09 [Ad 3h]
Bothfeld11: calls $1
roninio1: folds 
Pacifistas: folds 
djammusic: folds 
solbi86: raises $3 to $4
matiko09: folds 
aseban11: calls $4
RICKA16: folds 
cn_chayanne: folds 
Bothfeld11: calls $3
*** FLOP *** [9h 7h Jh]
Bothfeld11: checks 
solbi86: checks 
aseban11: bets $9.66
Bothfeld11: folds 
solbi86: folds 
Uncalled bet ($9.66) returned to aseban11
aseban11 collected $12.89 from pot
aseban11: doesn't show hand 
*** SUMMARY ***
Total pot $13.50 | Rake $0.61 
Board [9h 7h Jh]
Seat 1: aseban11 (button) collected ($12.89)
Seat 2: RICKA16 (small blind) folded before Flop
Seat 3: cn_chayanne (big blind) folded before Flop
Seat 4: Bothfeld11 folded on the Flop
Seat 5: roninio1 folded before Flop (didn't bet)
Seat 6: Pacifistas folded before Flop (didn't bet)
Seat 7: djammusic folded before Flop (didn't bet)
Seat 8: solbi86 folded on the Flop
Seat 9: matiko09 folded before Flop (didn't bet)





PokerStars Hand #150705855434:  Hold'em No Limit ($0.50/$1.00 USD) - 2016/03/21 16:22:54 CET [2016/03/21 11:22:54 ET]
Table 'Ostanina' 9-max Seat #2 is the button
Seat 1: cn_chayanne ($106.33 in chips) 
Seat 2: Vaclos_o_o ($121.93 in chips) 
Seat 4: rolle490 ($38.42 in chips) 
Seat 5: aseban11 ($103.50 in chips) 
Seat 6: solbi86 ($129.03 in chips) 
Seat 7: sanpidk ($109.83 in chips) 
Seat 8: matiko09 ($101.50 in chips) 
Seat 9: AKplus ($72.03 in chips) 
rolle490: posts small blind $0.50
aseban11: posts big blind $1
*** HOLE CARDS ***
Dealt to matiko09 [Td Ah]
solbi86: raises $2 to $3
sanpidk: folds 
matiko09: folds 
AKplus: folds 
cn_chayanne: folds 
Vaclos_o_o: folds 
rolle490: folds 
aseban11: folds 
Uncalled bet ($2) returned to solbi86
solbi86 collected $2.50 from pot
solbi86: doesn't show hand 
*** SUMMARY ***
Total pot $2.50 | Rake $0 
Seat 1: cn_chayanne folded before Flop (didn't bet)
Seat 2: Vaclos_o_o (button) folded before Flop (didn't bet)
Seat 4: rolle490 (small blind) folded before Flop
Seat 5: aseban11 (big blind) folded before Flop
Seat 6: solbi86 collected ($2.50)
Seat 7: sanpidk folded before Flop (didn't bet)
Seat 8: matiko09 folded before Flop (didn't bet)
Seat 9: AKplus folded before Flop (didn't bet)





PokerStars Hand #150705863218:  Hold'em No Limit ($0.50/$1.00 USD) - 2016/03/21 16:23:04 CET [2016/03/21 11:23:04 ET]
Table 'Goberta' 9-max Seat #5 is the button
Seat 1: CapnDobro ($167.58 in chips) 
Seat 2: mycka86 ($119 in chips) 
Seat 3: Pacifistas ($100 in chips) 
Seat 4: aseban11 ($103.55 in chips) 
Seat 5: matiko09 ($100 in chips) 
Seat 6: sanpidk ($113.53 in chips) 
Seat 7: flk.Dasas ($100 in chips) 
Seat 8: Zeeshka ($107.37 in chips) 
Seat 9: Ez1kelL ($44.70 in chips) 
sanpidk: posts small blind $0.50
flk.Dasas: posts big blind $1
*** HOLE CARDS ***
Dealt to matiko09 [Jh 2s]
Zeeshka: folds 
Ez1kelL: folds 
CapnDobro: folds 
mycka86: folds 
Pacifistas: folds 
aseban11: raises $1.50 to $2.50
matiko09: folds 
sanpidk: folds 
flk.Dasas: folds 
Uncalled bet ($1.50) returned to aseban11
aseban11 collected $2.50 from pot
aseban11: doesn't show hand 
*** SUMMARY ***
Total pot $2.50 | Rake $0 
Seat 1: CapnDobro folded before Flop (didn't bet)
Seat 2: mycka86 folded before Flop (didn't bet)
Seat 3: Pacifistas folded before Flop (didn't bet)
Seat 4: aseban11 collected ($2.50)
Seat 5: matiko09 (button) folded before Flop (didn't bet)
Seat 6: sanpidk (small blind) folded before Flop
Seat 7: flk.Dasas (big blind) folded before Flop
Seat 8: Zeeshka folded before Flop (didn't bet)
Seat 9: Ez1kelL folded before Flop (didn't bet)





PokerStars Hand #150705863854:  Hold'em No Limit ($0.50/$1.00 USD) - 2016/03/21 16:23:05 CET [2016/03/21 11:23:05 ET]
Table 'Juhani' 9-max Seat #5 is the button
Seat 1: Dachish ($69 in chips) 
Seat 2: matiko09 ($102.50 in chips) 
Seat 3: cobrik23 ($37 in chips) 
Seat 4: Pacifistas ($113.63 in chips) 
Seat 5: RICKA16 ($103 in chips) 
Seat 6: Pay-My-Thc-B ($105.25 in chips) 
Seat 7: liyiwei233 ($39.86 in chips) 
Seat 8: sanpidk ($100 in chips) 
Seat 9: gabi_igna ($149.45 in chips) 
Pay-My-Thc-B: posts small blind $0.50
liyiwei233: posts big blind $1
*** HOLE CARDS ***
Dealt to matiko09 [7d 4d]
sanpidk: raises $2 to $3
gabi_igna: folds 
Dachish: folds 
matiko09: folds 
cobrik23: folds 
Pacifistas: folds 
RICKA16: folds 
Pay-My-Thc-B: folds 
liyiwei233: calls $2
*** FLOP *** [9c Kh 9d]
liyiwei233: checks 
sanpidk: bets $3.50
liyiwei233: calls $3.50
*** TURN *** [9c Kh 9d] [9h]
liyiwei233: checks 
sanpidk: bets $5.50
liyiwei233: folds 
Uncalled bet ($5.50) returned to sanpidk
sanpidk collected $12.89 from pot
sanpidk: doesn't show hand 
*** SUMMARY ***
Total pot $13.50 | Rake $0.61 
Board [9c Kh 9d 9h]
Seat 1: Dachish folded before Flop (didn't bet)
Seat 2: matiko09 folded before Flop (didn't bet)
Seat 3: cobrik23 folded before Flop (didn't bet)
Seat 4: Pacifistas folded before Flop (didn't bet)
Seat 5: RICKA16 (button) folded before Flop (didn't bet)
Seat 6: Pay-My-Thc-B (small blind) folded before Flop
Seat 7: liyiwei233 (big blind) folded on the Turn
Seat 8: sanpidk collected ($12.89)
Seat 9: gabi_igna folded before Flop (didn't bet)





PokerStars Hand #150705870193:  Hold'em No Limit ($0.50/$1.00 USD) - 2016/03/21 16:23:14 CET [2016/03/21 11:23:14 ET]
Table 'Vega III' 9-max Seat #6 is the button
Seat 1: solbi86 ($164.32 in chips) 
Seat 2: hammerwife ($108.08 in chips) 
Seat 3: forsmthgood ($104.50 in chips) 
Seat 4: gabi_igna ($101.62 in chips) 
Seat 5: matiko09 ($101.14 in chips) 
Seat 6: samirj88 ($142.98 in chips) 
Seat 7: mycka86 ($109.41 in chips) 
Seat 8: sanpidk ($100 in chips) 
Seat 9: chute85 ($42.64 in chips) 
mycka86: posts small blind $0.50
sanpidk: posts big blind $1
*** HOLE CARDS ***
Dealt to matiko09 [4d 8c]
chute85: folds 
solbi86: folds 
hammerwife: folds 
forsmthgood: folds 
gabi_igna: folds 
matiko09: folds 
samirj88: calls $1
mycka86: calls $0.50
sanpidk: checks 
*** FLOP *** [Qs 8d Ac]
mycka86: checks 
sanpidk: checks 
samirj88: bets $2
mycka86: folds 
sanpidk: folds 
Uncalled bet ($2) returned to samirj88
samirj88 collected $2.86 from pot
samirj88: doesn't show hand 
*** SUMMARY ***
Total pot $3 | Rake $0.14 
Board [Qs 8d Ac]
Seat 1: solbi86 folded before Flop (didn't bet)
Seat 2: hammerwife folded before Flop (didn't bet)
Seat 3: forsmthgood folded before Flop (didn't bet)
Seat 4: gabi_igna folded before Flop (didn't bet)
Seat 5: matiko09 folded before Flop (didn't bet)
Seat 6: samirj88 (button) collected ($2.86)
Seat 7: mycka86 (small blind) folded on the Flop
Seat 8: sanpidk (big blind) folded on the Flop
Seat 9: chute85 folded before Flop (didn't bet)





PokerStars Hand #150705870792:  Hold'em No Limit ($0.50/$1.00 USD) - 2016/03/21 16:23:15 CET [2016/03/21 11:23:15 ET]
Table 'Ostanina' 9-max Seat #4 is the button
Seat 1: cn_chayanne ($106.33 in chips) 
Seat 2: Vaclos_o_o ($121.93 in chips) 
Seat 4: rolle490 ($37.92 in chips) 
Seat 5: aseban11 ($102.50 in chips) 
Seat 6: solbi86 ($130.53 in chips) 
Seat 7: sanpidk ($109.83 in chips) 
Seat 8: matiko09 ($101.50 in chips) 
Seat 9: AKplus ($72.03 in chips) 
aseban11: posts small blind $0.50
solbi86: posts big blind $1
*** HOLE CARDS ***
Dealt to matiko09 [Ac Jd]
sanpidk: raises $2 to $3
flk.Dasas joins the table at seat #3 
matiko09: raises $6.50 to $9.50
AKplus: folds 
cn_chayanne: folds 
Vaclos_o_o: folds 
rolle490: folds 
aseban11: folds 
solbi86: folds 
sanpidk: folds 
Uncalled bet ($6.50) returned to matiko09
matiko09 collected $7.50 from pot
matiko09: doesn't show hand 
*** SUMMARY ***
Total pot $7.50 | Rake $0 
Seat 1: cn_chayanne folded before Flop (didn't bet)
Seat 2: Vaclos_o_o folded before Flop (didn't bet)
Seat 4: rolle490 (button) folded before Flop (didn't bet)
Seat 5: aseban11 (small blind) folded before Flop
Seat 6: solbi86 (big blind) folded before Flop
Seat 7: sanpidk folded before Flop
Seat 8: matiko09 collected ($7.50)
Seat 9: AKplus folded before Flop (didn't bet)





PokerStars Hand #150705874242:  Hold'em No Limit ($0.50/$1.00 USD) - 2016/03/21 16:23:20 CET [2016/03/21 11:23:20 ET]
Table 'Massalia II' 9-max Seat #8 is the button
Seat 5: roninio1 ($90.29 in chips) 
Seat 6: Pacifistas ($101.20 in chips) 
Seat 8: matiko09 ($100 in chips) 
roninio1: posts small blind $0.50
Pacifistas: posts big blind $1
roninio1: posts the ante $0.20
Pacifistas: posts the ante $0.20
matiko09: posts the ante $0.20
*** HOLE CARDS ***
Dealt to matiko09 [8d Jc]
matiko09: raises $1.50 to $2.50
roninio1: folds 
runner10 joins the table at seat #4 
R1aki joins the table at seat #9 
Pacifistas: calls $1.50
*** FLOP *** [9h Ts Jd]
Pacifistas: checks 
matiko09: checks 
*** TURN *** [9h Ts Jd] [7s]
crepke joins the table at seat #1 
Pacifistas: checks 
matiko09: bets $3.79
solbi86 joins the table at seat #2 
Pacifistas: calls $3.79
*** RIVER *** [9h Ts Jd 7s] [2c]
Pacifistas: checks 
matiko09: bets $8
Pacifistas: calls $8
*** SHOW DOWN ***
matiko09: shows [8d Jc] (a straight, Seven to Jack)
Pacifistas: shows [9c 8c] (a straight, Seven to Jack)
Pacifistas collected $14.17 from pot
matiko09 collected $14.17 from pot
*** SUMMARY ***
Total pot $29.68 | Rake $1.34 
Board [9h Ts Jd 7s 2c]
Seat 5: roninio1 (small blind) folded before Flop
Seat 6: Pacifistas (big blind) showed [9c 8c] and won ($14.17) with a straight, Seven to Jack
Seat 8: matiko09 (button) showed [8d Jc] and won ($14.17) with a straight, Seven to Jack





PokerStars Hand #150705884159:  Hold'em No Limit ($0.50/$1.00 USD) - 2016/03/21 16:23:34 CET [2016/03/21 11:23:34 ET]
Table 'Etheridgea II' 9-max Seat #1 is the button
Seat 1: cobrik23 ($98.50 in chips) 
Seat 2: gabi_igna ($207.71 in chips) 
Seat 3: flk.Dasas ($100 in chips) 
Seat 4: Dachish ($64.50 in chips) 
Seat 6: di0d80 ($183.80 in chips) 
Seat 7: matiko09 ($101.50 in chips) 
Seat 8: sanpidk ($110.01 in chips) 
Seat 9: Maloy yu ($50.78 in chips) 
gabi_igna: posts small blind $0.50
flk.Dasas: posts big blind $1
*** HOLE CARDS ***
Dealt to matiko09 [Qc Ks]
Dachish: raises $1.50 to $2.50
di0d80: folds 
matiko09: folds 
sanpidk: folds 
Maloy yu: folds 
cobrik23: folds 
gabi_igna: folds 
flk.Dasas: folds 
Uncalled bet ($1.50) returned to Dachish
Dachish collected $2.50 from pot
Dachish: doesn't show hand 
*** SUMMARY ***
Total pot $2.50 | Rake $0 
Seat 1: cobrik23 (button) folded before Flop (didn't bet)
Seat 2: gabi_igna (small blind) folded before Flop
Seat 3: flk.Dasas (big blind) folded before Flop
Seat 4: Dachish collected ($2.50)
Seat 6: di0d80 folded before Flop (didn't bet)
Seat 7: matiko09 folded before Flop (didn't bet)
Seat 8: sanpidk folded before Flop (didn't bet)
Seat 9: Maloy yu folded before Flop (didn't bet)





PokerStars Hand #150705885890:  Hold'em No Limit ($0.50/$1.00 USD) - 2016/03/21 16:23:36 CET [2016/03/21 11:23:36 ET]
Table 'Onnie II' 9-max Seat #2 is the button
Seat 1: aseban11 ($119.21 in chips) 
Seat 2: RICKA16 ($100 in chips) 
Seat 3: cn_chayanne ($100.18 in chips) 
Seat 4: Bothfeld11 ($95 in chips) 
Seat 5: roninio1 ($79.50 in chips) 
Seat 6: Pacifistas ($106.16 in chips) 
Seat 7: djammusic ($75.08 in chips) 
Seat 8: solbi86 ($100 in chips) 
Seat 9: matiko09 ($112.55 in chips) 
cn_chayanne: posts small blind $0.50
Bothfeld11: posts big blind $1
*** HOLE CARDS ***
Dealt to matiko09 [3c 8d]
roninio1: folds 
Pacifistas: folds 
djammusic: folds 
solbi86: folds 
matiko09: folds 
aseban11: raises $1.50 to $2.50
RICKA16: folds 
cn_chayanne: folds 
Bothfeld11: calls $1.50
*** FLOP *** [Kh 7c Ah]
Bothfeld11: checks 
aseban11: bets $3.93
Bothfeld11: calls $3.93
*** TURN *** [Kh 7c Ah] [5d]
Bothfeld11: checks 
aseban11: bets $9.57
Bothfeld11: calls $9.57
*** RIVER *** [Kh 7c Ah 5d] [8h]
Bothfeld11: checks 
aseban11: bets $26.50
Bothfeld11: calls $26.50
*** SHOW DOWN ***
aseban11: shows [6h Qh] (a flush, Ace high)
Bothfeld11: mucks hand 
aseban11 collected $82.70 from pot
*** SUMMARY ***
Total pot $85.50 | Rake $2.80 
Board [Kh 7c Ah 5d 8h]
Seat 1: aseban11 showed [6h Qh] and won ($82.70) with a flush, Ace high
Seat 2: RICKA16 (button) folded before Flop (didn't bet)
Seat 3: cn_chayanne (small blind) folded before Flop
Seat 4: Bothfeld11 (big blind) mucked [Ad Tc]
Seat 5: roninio1 folded before Flop (didn't bet)
Seat 6: Pacifistas folded before Flop (didn't bet)
Seat 7: djammusic folded before Flop (didn't bet)
Seat 8: solbi86 folded before Flop (didn't bet)
Seat 9: matiko09 folded before Flop (didn't bet)





PokerStars Hand #150705890218:  Hold'em No Limit ($0.50/$1.00 USD) - 2016/03/21 16:23:43 CET [2016/03/21 11:23:43 ET]
Table 'Goberta' 9-max Seat #6 is the button
Seat 1: CapnDobro ($167.58 in chips) 
Seat 2: mycka86 ($119 in chips) 
Seat 3: Pacifistas ($100 in chips) 
Seat 4: aseban11 ($105.05 in chips) 
Seat 5: matiko09 ($100 in chips) 
Seat 6: sanpidk ($113.03 in chips) 
Seat 7: flk.Dasas ($100 in chips) 
Seat 8: Zeeshka ($107.37 in chips) 
Seat 9: Ez1kelL ($44.70 in chips) 
flk.Dasas: posts small blind $0.50
Zeeshka: posts big blind $1
*** HOLE CARDS ***
Dealt to matiko09 [5s As]
Ez1kelL: folds 
CapnDobro: folds 
mycka86: folds 
Pacifistas: folds 
aseban11: folds 
matiko09: raises $1.50 to $2.50
sanpidk: folds 
flk.Dasas: folds 
Zeeshka: calls $1.50
*** FLOP *** [Qh Kc 5h]
Zeeshka: checks 
matiko09: checks 
*** TURN *** [Qh Kc 5h] [6h]
Zeeshka: checks 
matiko09: checks 
*** RIVER *** [Qh Kc 5h 6h] [Qs]
Zeeshka: checks 
matiko09: checks 
*** SHOW DOWN ***
Zeeshka: shows [9s Ac] (a pair of Queens)
matiko09: shows [5s As] (two pair, Queens and Fives)
matiko09 collected $5.25 from pot
*** SUMMARY ***
Total pot $5.50 | Rake $0.25 
Board [Qh Kc 5h 6h Qs]
Seat 1: CapnDobro folded before Flop (didn't bet)
Seat 2: mycka86 folded before Flop (didn't bet)
Seat 3: Pacifistas folded before Flop (didn't bet)
Seat 4: aseban11 folded before Flop (didn't bet)
Seat 5: matiko09 showed [5s As] and won ($5.25) with two pair, Queens and Fives
Seat 6: sanpidk (button) folded before Flop (didn't bet)
Seat 7: flk.Dasas (small blind) folded before Flop
Seat 8: Zeeshka (big blind) showed [9s Ac] and lost with a pair of Queens
Seat 9: Ez1kelL folded before Flop (didn't bet)





PokerStars Hand #150705890740:  Hold'em No Limit ($0.50/$1.00 USD) - 2016/03/21 16:23:43 CET [2016/03/21 11:23:43 ET]
Table 'Leonteus III' 9-max Seat #3 is the button
Seat 1: flk.Dasas ($150.24 in chips) 
Seat 2: Dachish ($70 in chips) 
Seat 3: gabi_igna ($100 in chips) 
Seat 4: juelzz99 ($51.86 in chips) 
Seat 5: mycka86 ($110.71 in chips) 
Seat 7: matiko09 ($105.21 in chips) 
Seat 8: RICKA16 ($103.68 in chips) 
Seat 9: solbi86 ($100.54 in chips) 
juelzz99: posts small blind $0.50
mycka86: posts big blind $1
Pacifistas: sits out 
Dachish: posts big blind $1
*** HOLE CARDS ***
Dealt to matiko09 [Ad 6s]
matiko09: folds 
RICKA16: folds 
solbi86: raises $3 to $4
flk.Dasas: folds 
Dachish: folds 
gabi_igna: raises $7 to $11
juelzz99: folds 
mycka86: folds 
solbi86: calls $7
*** FLOP *** [2s 8s Tc]
solbi86: checks 
gabi_igna: bets $11
solbi86: calls $11
*** TURN *** [2s 8s Tc] [8h]
solbi86: checks 
gabi_igna: bets $22
solbi86: raises $56.54 to $78.54 and is all-in
gabi_igna: calls $56 and is all-in
Uncalled bet ($0.54) returned to solbi86
*** FIRST RIVER *** [2s 8s Tc 8h] [3h]
*** SECOND RIVER *** [2s 8s Tc 8h] [Kd]
*** FIRST SHOW DOWN ***
solbi86: shows [Td Th] (a full house, Tens full of Eights)
gabi_igna: mucks hand 
solbi86 collected $99.85 from pot
*** SECOND SHOW DOWN ***
solbi86: shows [Td Th] (a full house, Tens full of Eights)
gabi_igna: mucks hand 
solbi86 collected $99.85 from pot
*** SUMMARY ***
Total pot $202.50 | Rake $2.80 
Hand was run twice
FIRST Board [2s 8s Tc 8h 3h]
SECOND Board [2s 8s Tc 8h Kd]
Seat 1: flk.Dasas folded before Flop (didn't bet)
Seat 2: Dachish folded before Flop
Seat 3: gabi_igna (button) mucked [Kh Ac]
Seat 4: juelzz99 (small blind) folded before Flop
Seat 5: mycka86 (big blind) folded before Flop
Seat 7: matiko09 folded before Flop (didn't bet)
Seat 8: RICKA16 folded before Flop (didn't bet)
Seat 9: solbi86 showed [Td Th] and won ($99.85) with a full house, Tens full of Eights, and won ($99.85) with a full house, Tens full of Eights





PokerStars Hand #150705903775:  Hold'em No Limit ($0.50/$1.00 USD) - 2016/03/21 16:24:02 CET [2016/03/21 11:24:02 ET]
Table 'Gondola II' 9-max Seat #8 is the button
Seat 1: matiko09 ($100 in chips) 
Seat 2: R1aki ($112.62 in chips) 
Seat 3: flk.Dasas ($103.50 in chips) 
Seat 4: aseban11 ($100 in chips) 
Seat 5: teukka8 ($87.01 in chips) 
Seat 7: Pacifistas ($100 in chips) 
Seat 8: cn_chayanne ($100 in chips) 
Seat 9: djammusic ($43.20 in chips) 
djammusic: posts small blind $0.50
matiko09: posts big blind $1
SanychStar: sits out 
*** HOLE CARDS ***
Dealt to matiko09 [7s 2c]
R1aki: folds 
flk.Dasas: raises $2 to $3
aseban11: folds 
teukka8: folds 
Pacifistas: folds 
cn_chayanne: folds 
djammusic: folds 
matiko09: folds 
Uncalled bet ($2) returned to flk.Dasas
flk.Dasas collected $2.50 from pot
flk.Dasas: doesn't show hand 
*** SUMMARY ***
Total pot $2.50 | Rake $0 
Seat 1: matiko09 (big blind) folded before Flop
Seat 2: R1aki folded before Flop (didn't bet)
Seat 3: flk.Dasas collected ($2.50)
Seat 4: aseban11 folded before Flop (didn't bet)
Seat 5: teukka8 folded before Flop (didn't bet)
Seat 7: Pacifistas folded before Flop (didn't bet)
Seat 8: cn_chayanne (button) folded before Flop (didn't bet)
Seat 9: djammusic (small blind) folded before Flop





PokerStars Hand #150705905566:  Hold'em No Limit ($0.50/$1.00 USD) - 2016/03/21 16:24:04 CET [2016/03/21 11:24:04 ET]
Table 'Etheridgea II' 9-max Seat #2 is the button
Seat 1: cobrik23 ($98.50 in chips) 
Seat 2: gabi_igna ($207.21 in chips) 
Seat 3: flk.Dasas ($100 in chips) 
Seat 4: Dachish ($66 in chips) 
Seat 6: di0d80 ($183.80 in chips) 
Seat 7: matiko09 ($101.50 in chips) 
Seat 8: sanpidk ($110.01 in chips) 
Seat 9: Maloy yu ($50.78 in chips) 
flk.Dasas: posts small blind $0.50
Dachish: posts big blind $1
*** HOLE CARDS ***
Dealt to matiko09 [9h 4s]
di0d80: folds 
matiko09: folds 
sanpidk: folds 
Maloy yu: folds 
cobrik23: folds 
gabi_igna: raises $1.50 to $2.50
flk.Dasas: folds 
Dachish: folds 
Uncalled bet ($1.50) returned to gabi_igna
gabi_igna collected $2.50 from pot
gabi_igna: doesn't show hand 
*** SUMMARY ***
Total pot $2.50 | Rake $0 
Seat 1: cobrik23 folded before Flop (didn't bet)
Seat 2: gabi_igna (button) collected ($2.50)
Seat 3: flk.Dasas (small blind) folded before Flop
Seat 4: Dachish (big blind) folded before Flop
Seat 6: di0d80 folded before Flop (didn't bet)
Seat 7: matiko09 folded before Flop (didn't bet)
Seat 8: sanpidk folded before Flop (didn't bet)
Seat 9: Maloy yu folded before Flop (didn't bet)





PokerStars Hand #150705923074:  Hold'em No Limit ($0.50/$1.00 USD) - 2016/03/21 16:24:29 CET [2016/03/21 11:24:29 ET]
Table 'Vega III' 9-max Seat #7 is the button
Seat 1: solbi86 ($164.32 in chips) 
Seat 2: hammerwife ($108.08 in chips) 
Seat 3: forsmthgood ($104.50 in chips) 
Seat 4: gabi_igna ($101.62 in chips) 
Seat 5: matiko09 ($101.14 in chips) 
Seat 6: samirj88 ($144.84 in chips) 
Seat 7: mycka86 ($108.41 in chips) 
Seat 8: sanpidk ($100 in chips) 
Seat 9: chute85 ($42.64 in chips) 
sanpidk: posts small blind $0.50
chute85: posts big blind $1
*** HOLE CARDS ***
Dealt to matiko09 [Th 3s]
solbi86: raises $2 to $3
hammerwife: folds 
forsmthgood: folds 
gabi_igna: calls $3
matiko09: folds 
samirj88: folds 
mycka86: folds 
sanpidk: folds 
chute85: folds 
*** FLOP *** [7h Ks 3c]
solbi86: checks 
gabi_igna: checks 
*** TURN *** [7h Ks 3c] [Jh]
solbi86: checks 
gabi_igna: checks 
*** RIVER *** [7h Ks 3c Jh] [2d]
solbi86: checks 
gabi_igna: checks 
*** SHOW DOWN ***
solbi86: shows [Tc Td] (a pair of Tens)
gabi_igna: mucks hand 
solbi86 collected $7.16 from pot
*** SUMMARY ***
Total pot $7.50 | Rake $0.34 
Board [7h Ks 3c Jh 2d]
Seat 1: solbi86 showed [Tc Td] and won ($7.16) with a pair of Tens
Seat 2: hammerwife folded before Flop (didn't bet)
Seat 3: forsmthgood folded before Flop (didn't bet)
Seat 4: gabi_igna mucked [9s 9h]
Seat 5: matiko09 folded before Flop (didn't bet)
Seat 6: samirj88 folded before Flop (didn't bet)
Seat 7: mycka86 (button) folded before Flop (didn't bet)
Seat 8: sanpidk (small blind) folded before Flop
Seat 9: chute85 (big blind) folded before Flop





PokerStars Hand #150705935414:  Hold'em No Limit ($0.50/$1.00 USD) - 2016/03/21 16:24:46 CET [2016/03/21 11:24:46 ET]
Table 'Onnie II' 9-max Seat #3 is the button
Seat 1: aseban11 ($159.41 in chips) 
Seat 2: RICKA16 ($100 in chips) 
Seat 3: cn_chayanne ($100 in chips) 
Seat 4: Bothfeld11 ($52.50 in chips) 
Seat 5: roninio1 ($79.50 in chips) 
Seat 6: Pacifistas ($106.16 in chips) 
Seat 7: djammusic ($75.08 in chips) 
Seat 8: solbi86 ($100 in chips) 
Seat 9: matiko09 ($112.55 in chips) 
Bothfeld11: posts small blind $0.50
roninio1: posts big blind $1
*** HOLE CARDS ***
Dealt to matiko09 [Th 3h]
Pacifistas: folds 
djammusic: folds 
solbi86: folds 
matiko09: folds 
aseban11: raises $1.50 to $2.50
RICKA16: folds 
cn_chayanne: folds 
Bothfeld11: folds 
roninio1: calls $1.50
*** FLOP *** [2d 6s 3c]
roninio1: bets $5.25
aseban11: folds 
Uncalled bet ($5.25) returned to roninio1
roninio1 collected $5.25 from pot
roninio1: doesn't show hand 
*** SUMMARY ***
Total pot $5.50 | Rake $0.25 
Board [2d 6s 3c]
Seat 1: aseban11 folded on the Flop
Seat 2: RICKA16 folded before Flop (didn't bet)
Seat 3: cn_chayanne (button) folded before Flop (didn't bet)
Seat 4: Bothfeld11 (small blind) folded before Flop
Seat 5: roninio1 (big blind) collected ($5.25)
Seat 6: Pacifistas folded before Flop (didn't bet)
Seat 7: djammusic folded before Flop (didn't bet)
Seat 8: solbi86 folded before Flop (didn't bet)
Seat 9: matiko09 folded before Flop (didn't bet)





PokerStars Hand #150705937325:  Hold'em No Limit ($0.50/$1.00 USD) - 2016/03/21 16:24:49 CET [2016/03/21 11:24:49 ET]
Table 'Gondola II' 9-max Seat #9 is the button
Seat 1: matiko09 ($100 in chips) 
Seat 2: R1aki ($112.62 in chips) 
Seat 3: flk.Dasas ($105 in chips) 
Seat 4: aseban11 ($100 in chips) 
Seat 5: teukka8 ($87.01 in chips) 
Seat 7: Pacifistas ($100 in chips) 
Seat 8: cn_chayanne ($100 in chips) 
Seat 9: djammusic ($42.70 in chips) 
matiko09: posts small blind $0.50
R1aki: posts big blind $1
SanychStar: sits out 
*** HOLE CARDS ***
Dealt to matiko09 [2d 5h]
flk.Dasas: folds 
aseban11: folds 
teukka8: folds 
Pacifistas: folds 
cn_chayanne: folds 
djammusic: raises $1.02 to $2.02
matiko09: folds 
R1aki: calls $1.02
*** FLOP *** [6d 4s 8h]
R1aki: checks 
djammusic: bets $2.50
R1aki: folds 
Uncalled bet ($2.50) returned to djammusic
djammusic collected $4.34 from pot
djammusic: doesn't show hand 
*** SUMMARY ***
Total pot $4.54 | Rake $0.20 
Board [6d 4s 8h]
Seat 1: matiko09 (small blind) folded before Flop
Seat 2: R1aki (big blind) folded on the Flop
Seat 3: flk.Dasas folded before Flop (didn't bet)
Seat 4: aseban11 folded before Flop (didn't bet)
Seat 5: teukka8 folded before Flop (didn't bet)
Seat 7: Pacifistas folded before Flop (didn't bet)
Seat 8: cn_chayanne folded before Flop (didn't bet)
Seat 9: djammusic (button) collected ($4.34)





PokerStars Hand #150705939721:  Hold'em No Limit ($0.50/$1.00 USD) - 2016/03/21 16:24:52 CET [2016/03/21 11:24:52 ET]
Table 'Juhani' 9-max Seat #6 is the button
Seat 1: Dachish ($69 in chips) 
Seat 2: matiko09 ($102.50 in chips) 
Seat 3: cobrik23 ($37 in chips) 
Seat 4: Pacifistas ($113.63 in chips) 
Seat 5: RICKA16 ($103 in chips) 
Seat 6: Pay-My-Thc-B ($104.75 in chips) 
Seat 7: liyiwei233 ($33.36 in chips) 
Seat 8: sanpidk ($106.39 in chips) 
Seat 9: gabi_igna ($149.45 in chips) 
liyiwei233: posts small blind $0.50
sanpidk: posts big blind $1
*** HOLE CARDS ***
Dealt to matiko09 [5d 7c]
gabi_igna has timed out
gabi_igna: folds 
Dachish: folds 
matiko09: folds 
cobrik23: folds 
Pacifistas: folds 
RICKA16: raises $2 to $3
Pay-My-Thc-B: folds 
liyiwei233: calls $2.50
sanpidk: folds 
*** FLOP *** [3d Th 8h]
liyiwei233: checks 
RICKA16: checks 
*** TURN *** [3d Th 8h] [Ac]
liyiwei233: checks 
RICKA16: bets $4
liyiwei233: calls $4
*** RIVER *** [3d Th 8h Ac] [5c]
liyiwei233: checks 
RICKA16: checks 
*** SHOW DOWN ***
liyiwei233: shows [9s As] (a pair of Aces)
RICKA16: mucks hand 
liyiwei233 collected $14.32 from pot
*** SUMMARY ***
Total pot $15 | Rake $0.68 
Board [3d Th 8h Ac 5c]
Seat 1: Dachish folded before Flop (didn't bet)
Seat 2: matiko09 folded before Flop (didn't bet)
Seat 3: cobrik23 folded before Flop (didn't bet)
Seat 4: Pacifistas folded before Flop (didn't bet)
Seat 5: RICKA16 mucked [Kh Jd]
Seat 6: Pay-My-Thc-B (button) folded before Flop (didn't bet)
Seat 7: liyiwei233 (small blind) showed [9s As] and won ($14.32) with a pair of Aces
Seat 8: sanpidk (big blind) folded before Flop
Seat 9: gabi_igna folded before Flop (didn't bet)





PokerStars Hand #150705945852:  Hold'em No Limit ($0.50/$1.00 USD) - 2016/03/21 16:25:01 CET [2016/03/21 11:25:01 ET]
Table 'Massalia II' 9-max Seat #5 is the button
Seat 4: runner10 ($61.71 in chips) 
Seat 5: roninio1 ($89.59 in chips) 
Seat 6: Pacifistas ($100.88 in chips) 
Seat 8: matiko09 ($100 in chips) 
Pacifistas: posts small blind $0.50
matiko09: posts big blind $1
R1aki: sits out 
crepke: sits out 
solbi86: sits out 
runner10: posts big blind $1
runner10: posts the ante $0.20
roninio1: posts the ante $0.20
Pacifistas: posts the ante $0.20
matiko09: posts the ante $0.20
*** HOLE CARDS ***
Dealt to matiko09 [3h Kh]
runner10: raises $2 to $3
roninio1: folds 
Pacifistas: raises $6 to $9
matiko09: folds 
runner10: calls $6
*** FLOP *** [Ad 2d 3c]
Pacifistas: bets $9
runner10: raises $43.51 to $52.51 and is all-in
Pacifistas: folds 
Uncalled bet ($43.51) returned to runner10
runner10 collected $36.30 from pot
runner10: doesn't show hand 
*** SUMMARY ***
Total pot $37.80 | Rake $1.50 
Board [Ad 2d 3c]
Seat 4: runner10 collected ($36.30)
Seat 5: roninio1 (button) folded before Flop (didn't bet)
Seat 6: Pacifistas (small blind) folded on the Flop
Seat 8: matiko09 (big blind) folded before Flop





PokerStars Hand #150705950474:  Hold'em No Limit ($0.50/$1.00 USD) - 2016/03/21 16:25:08 CET [2016/03/21 11:25:08 ET]
Table 'Goberta' 9-max Seat #7 is the button
Seat 1: CapnDobro ($167.58 in chips) 
Seat 2: mycka86 ($119 in chips) 
Seat 3: Pacifistas ($100 in chips) 
Seat 4: aseban11 ($105.05 in chips) 
Seat 5: matiko09 ($102.75 in chips) 
Seat 6: sanpidk ($113.03 in chips) 
Seat 7: flk.Dasas ($100 in chips) 
Seat 8: Zeeshka ($104.87 in chips) 
Seat 9: Ez1kelL ($44.70 in chips) 
Zeeshka: posts small blind $0.50
Ez1kelL: posts big blind $1
*** HOLE CARDS ***
Dealt to matiko09 [3h 9s]
CapnDobro: folds 
CapnDobro leaves the table
mycka86: folds 
RICKA16 joins the table at seat #1 
RICKA16 leaves the table
Pacifistas: folds 
Dachish joins the table at seat #1 
aseban11: folds 
matiko09: folds 
Dachish leaves the table
sanpidk: folds 
flk.Dasas: folds 
Rikti joins the table at seat #1 
Zeeshka: raises $1.50 to $2.50
Ez1kelL: raises $4.50 to $7
Zeeshka: folds 
Uncalled bet ($4.50) returned to Ez1kelL
Ez1kelL collected $5 from pot
Ez1kelL: doesn't show hand 
*** SUMMARY ***
Total pot $5 | Rake $0 
Seat 1: CapnDobro folded before Flop (didn't bet)
Seat 2: mycka86 folded before Flop (didn't bet)
Seat 3: Pacifistas folded before Flop (didn't bet)
Seat 4: aseban11 folded before Flop (didn't bet)
Seat 5: matiko09 folded before Flop (didn't bet)
Seat 6: sanpidk folded before Flop (didn't bet)
Seat 7: flk.Dasas (button) folded before Flop (didn't bet)
Seat 8: Zeeshka (small blind) folded before Flop
Seat 9: Ez1kelL (big blind) collected ($5)





PokerStars Hand #150705960025:  Hold'em No Limit ($0.50/$1.00 USD) - 2016/03/21 16:25:21 CET [2016/03/21 11:25:21 ET]
Table 'Leonteus III' 9-max Seat #4 is the button
Seat 1: flk.Dasas ($150.24 in chips) 
Seat 2: Dachish ($69 in chips) 
Seat 3: gabi_igna ($100 in chips) 
Seat 4: juelzz99 ($51.36 in chips) 
Seat 5: mycka86 ($109.71 in chips) 
Seat 6: Pacifistas ($101.50 in chips) 
Seat 7: matiko09 ($105.21 in chips) 
Seat 8: RICKA16 ($103.68 in chips) 
Seat 9: solbi86 ($200.24 in chips) 
mycka86: posts small blind $0.50
Pacifistas: posts big blind $1
*** HOLE CARDS ***
Dealt to matiko09 [3c Tc]
matiko09: folds 
RICKA16: folds 
solbi86: folds 
flk.Dasas: folds 
Dachish: folds 
gabi_igna: folds 
juelzz99: folds 
mycka86: raises $1.75 to $2.75
Pacifistas: calls $1.75
*** FLOP *** [5h 8c As]
mycka86: checks 
Pacifistas: checks 
*** TURN *** [5h 8c As] [2d]
mycka86: bets $3.50
Pacifistas: calls $3.50
*** RIVER *** [5h 8c As 2d] [Qc]
mycka86: bets $7.56
Pacifistas: calls $7.56
*** SHOW DOWN ***
mycka86: shows [Ah 6h] (a pair of Aces)
Pacifistas: shows [8d Qd] (two pair, Queens and Eights)
Pacifistas collected $26.38 from pot
*** SUMMARY ***
Total pot $27.62 | Rake $1.24 
Board [5h 8c As 2d Qc]
Seat 1: flk.Dasas folded before Flop (didn't bet)
Seat 2: Dachish folded before Flop (didn't bet)
Seat 3: gabi_igna folded before Flop (didn't bet)
Seat 4: juelzz99 (button) folded before Flop (didn't bet)
Seat 5: mycka86 (small blind) showed [Ah 6h] and lost with a pair of Aces
Seat 6: Pacifistas (big blind) showed [8d Qd] and won ($26.38) with two pair, Queens and Eights
Seat 7: matiko09 folded before Flop (didn't bet)
Seat 8: RICKA16 folded before Flop (didn't bet)
Seat 9: solbi86 folded before Flop (didn't bet)





PokerStars Hand #150705968884:  Hold'em No Limit ($0.50/$1.00 USD) - 2016/03/21 16:25:33 CET [2016/03/21 11:25:33 ET]
Table 'Gondola II' 9-max Seat #1 is the button
Seat 1: matiko09 ($100 in chips) 
Seat 2: R1aki ($110.60 in chips) 
Seat 3: flk.Dasas ($105 in chips) 
Seat 4: aseban11 ($100 in chips) 
Seat 5: teukka8 ($87.01 in chips) 
Seat 7: Pacifistas ($100 in chips) 
Seat 8: cn_chayanne ($100 in chips) 
Seat 9: djammusic ($45.02 in chips) 
R1aki: posts small blind $0.50
flk.Dasas: posts big blind $1
SanychStar: sits out 
*** HOLE CARDS ***
Dealt to matiko09 [As Kc]
aseban11: folds 
teukka8: folds 
Pacifistas: folds 
cn_chayanne: raises $1.50 to $2.50
djammusic: folds 
matiko09: calls $2.50
R1aki: folds 
flk.Dasas: calls $1.50
*** FLOP *** [3s 7s Ac]
flk.Dasas: checks 
cn_chayanne: checks 
matiko09: bets $4.97
flk.Dasas: folds 
cn_chayanne: folds 
Uncalled bet ($4.97) returned to matiko09
matiko09 collected $7.64 from pot
matiko09: doesn't show hand 
*** SUMMARY ***
Total pot $8 | Rake $0.36 
Board [3s 7s Ac]
Seat 1: matiko09 (button) collected ($7.64)
Seat 2: R1aki (small blind) folded before Flop
Seat 3: flk.Dasas (big blind) folded on the Flop
Seat 4: aseban11 folded before Flop (didn't bet)
Seat 5: teukka8 folded before Flop (didn't bet)
Seat 7: Pacifistas folded before Flop (didn't bet)
Seat 8: cn_chayanne folded on the Flop
Seat 9: djammusic folded before Flop (didn't bet)





PokerStars Hand #150705970360:  Hold'em No Limit ($0.50/$1.00 USD) - 2016/03/21 16:25:36 CET [2016/03/21 11:25:36 ET]
Table 'Onnie II' 9-max Seat #4 is the button
Seat 1: aseban11 ($156.91 in chips) 
Seat 2: RICKA16 ($100 in chips) 
Seat 3: cn_chayanne ($100 in chips) 
Seat 4: Bothfeld11 ($77.83 in chips) 
Seat 5: roninio1 ($82.25 in chips) 
Seat 6: Pacifistas ($106.16 in chips) 
Seat 7: djammusic ($75.08 in chips) 
Seat 8: solbi86 ($100 in chips) 
Seat 9: matiko09 ($112.55 in chips) 
roninio1: posts small blind $0.50
Pacifistas: posts big blind $1
*** HOLE CARDS ***
Dealt to matiko09 [Th Qs]
djammusic: folds 
solbi86: folds 
matiko09: folds 
aseban11: folds 
RICKA16: raises $2 to $3
cn_chayanne: calls $3
Bothfeld11: folds 
roninio1: folds 
Pacifistas: calls $2
*** FLOP *** [Ac As 7s]
Pacifistas: checks 
RICKA16: bets $6
cn_chayanne: folds 
Pacifistas: folds 
Uncalled bet ($6) returned to RICKA16
RICKA16 collected $9.07 from pot
RICKA16: doesn't show hand 
*** SUMMARY ***
Total pot $9.50 | Rake $0.43 
Board [Ac As 7s]
Seat 1: aseban11 folded before Flop (didn't bet)
Seat 2: RICKA16 collected ($9.07)
Seat 3: cn_chayanne folded on the Flop
Seat 4: Bothfeld11 (button) folded before Flop (didn't bet)
Seat 5: roninio1 (small blind) folded before Flop
Seat 6: Pacifistas (big blind) folded on the Flop
Seat 7: djammusic folded before Flop (didn't bet)
Seat 8: solbi86 folded before Flop (didn't bet)
Seat 9: matiko09 folded before Flop (didn't bet)





PokerStars Hand #150705974101:  Hold'em No Limit ($0.50/$1.00 USD) - 2016/03/21 16:25:41 CET [2016/03/21 11:25:41 ET]
Table 'Massalia II' 9-max Seat #6 is the button
Seat 4: runner10 ($79.81 in chips) 
Seat 5: roninio1 ($89.39 in chips) 
Seat 6: Pacifistas ($100 in chips) 
Seat 8: matiko09 ($100 in chips) 
Seat 9: R1aki ($100 in chips) 
matiko09: posts small blind $0.50
R1aki: posts big blind $1
crepke: sits out 
solbi86: sits out 
runner10: posts the ante $0.20
roninio1: posts the ante $0.20
Pacifistas: posts the ante $0.20
matiko09: posts the ante $0.20
R1aki: posts the ante $0.20
*** HOLE CARDS ***
Dealt to matiko09 [2s 9d]
runner10: folds 
roninio1: raises $2 to $3
Pacifistas: folds 
matiko09: folds 
R1aki: folds 
Uncalled bet ($2) returned to roninio1
roninio1 collected $3.50 from pot
roninio1: doesn't show hand 
*** SUMMARY ***
Total pot $3.50 | Rake $0 
Seat 4: runner10 folded before Flop (didn't bet)
Seat 5: roninio1 collected ($3.50)
Seat 6: Pacifistas (button) folded before Flop (didn't bet)
Seat 8: matiko09 (small blind) folded before Flop
Seat 9: R1aki (big blind) folded before Flop





PokerStars Hand #150705979830:  Hold'em No Limit ($0.50/$1.00 USD) - 2016/03/21 16:25:49 CET [2016/03/21 11:25:49 ET]
Table 'Vega III' 9-max Seat #8 is the button
Seat 1: solbi86 ($168.48 in chips) 
Seat 2: hammerwife ($108.08 in chips) 
Seat 3: forsmthgood ($104.50 in chips) 
Seat 4: gabi_igna ($100 in chips) 
Seat 5: matiko09 ($101.14 in chips) 
Seat 6: samirj88 ($144.84 in chips) 
Seat 7: mycka86 ($108.41 in chips) 
Seat 8: sanpidk ($100 in chips) 
Seat 9: chute85 ($41.64 in chips) 
chute85: posts small blind $0.50
solbi86: posts big blind $1
*** HOLE CARDS ***
Dealt to matiko09 [Ks As]
hammerwife: folds 
forsmthgood: folds 
gabi_igna: folds 
matiko09: raises $2 to $3
samirj88: folds 
mycka86: folds 
sanpidk: folds 
chute85: calls $2.50
solbi86: folds 
*** FLOP *** [Ac 9s 5h]
chute85: checks 
matiko09: bets $4.34
chute85: folds 
Uncalled bet ($4.34) returned to matiko09
matiko09 collected $6.68 from pot
matiko09: doesn't show hand 
*** SUMMARY ***
Total pot $7 | Rake $0.32 
Board [Ac 9s 5h]
Seat 1: solbi86 (big blind) folded before Flop
Seat 2: hammerwife folded before Flop (didn't bet)
Seat 3: forsmthgood folded before Flop (didn't bet)
Seat 4: gabi_igna folded before Flop (didn't bet)
Seat 5: matiko09 collected ($6.68)
Seat 6: samirj88 folded before Flop (didn't bet)
Seat 7: mycka86 folded before Flop (didn't bet)
Seat 8: sanpidk (button) folded before Flop (didn't bet)
Seat 9: chute85 (small blind) folded on the Flop





PokerStars Hand #150705987463:  Hold'em No Limit ($0.50/$1.00 USD) - 2016/03/21 16:26:00 CET [2016/03/21 11:26:00 ET]
Table 'Massalia II' 9-max Seat #8 is the button
Seat 1: crepke ($80 in chips) 
Seat 4: runner10 ($79.61 in chips) 
Seat 5: roninio1 ($91.69 in chips) 
Seat 6: Pacifistas ($100 in chips) 
Seat 8: matiko09 ($100 in chips) 
Seat 9: R1aki ($100 in chips) 
R1aki: posts small blind $0.50
crepke: posts big blind $1
solbi86: sits out 
crepke: posts the ante $0.20
runner10: posts the ante $0.20
roninio1: posts the ante $0.20
Pacifistas: posts the ante $0.20
matiko09: posts the ante $0.20
R1aki: posts the ante $0.20
*** HOLE CARDS ***
Dealt to matiko09 [Qd Qh]
runner10: folds 
roninio1: folds 
Pacifistas: folds 
matiko09: raises $1.27 to $2.27
R1aki: raises $7.23 to $9.50
crepke: folds 
runner10 leaves the table
matiko09: raises $10.50 to $20
123chambo joins the table at seat #3 
R1aki: raises $79.80 to $99.80 and is all-in
matiko09: calls $79.80 and is all-in
*** FLOP *** [2c 5h Qs]
*** TURN *** [2c 5h Qs] [3d]
*** RIVER *** [2c 5h Qs 3d] [6d]
*** SHOW DOWN ***
R1aki: shows [Jc Jh] (a pair of Jacks)
matiko09: shows [Qd Qh] (three of a kind, Queens)
matiko09 collected $199 from pot
*** SUMMARY ***
Total pot $201.80 | Rake $2.80 
Board [2c 5h Qs 3d 6d]
Seat 1: crepke (big blind) folded before Flop
Seat 4: runner10 folded before Flop (didn't bet)
Seat 5: roninio1 folded before Flop (didn't bet)
Seat 6: Pacifistas folded before Flop (didn't bet)
Seat 8: matiko09 (button) showed [Qd Qh] and won ($199) with three of a kind, Queens
Seat 9: R1aki (small blind) showed [Jc Jh] and lost with a pair of Jacks





PokerStars Hand #150706003364:  Hold'em No Limit ($0.50/$1.00 USD) - 2016/03/21 16:26:22 CET [2016/03/21 11:26:22 ET]
Table 'Vega III' 9-max Seat #9 is the button
Seat 1: solbi86 ($167.48 in chips) 
Seat 2: hammerwife ($108.08 in chips) 
Seat 3: forsmthgood ($104.50 in chips) 
Seat 4: gabi_igna ($100 in chips) 
Seat 5: matiko09 ($104.82 in chips) 
Seat 6: samirj88 ($144.84 in chips) 
Seat 7: mycka86 ($108.41 in chips) 
Seat 8: sanpidk ($100 in chips) 
Seat 9: chute85 ($38.64 in chips) 
solbi86: posts small blind $0.50
hammerwife: posts big blind $1
*** HOLE CARDS ***
Dealt to matiko09 [Ad Qd]
forsmthgood: folds 
gabi_igna: folds 
matiko09: raises $2 to $3
samirj88: folds 
mycka86: folds 
sanpidk: calls $3
chute85: folds 
solbi86: folds 
hammerwife: calls $2
*** FLOP *** [Ac 2h 5d]
hammerwife: checks 
matiko09: bets $5.90
sanpidk: folds 
hammerwife: folds 
Uncalled bet ($5.90) returned to matiko09
matiko09 collected $9.07 from pot
matiko09: doesn't show hand 
*** SUMMARY ***
Total pot $9.50 | Rake $0.43 
Board [Ac 2h 5d]
Seat 1: solbi86 (small blind) folded before Flop
Seat 2: hammerwife (big blind) folded on the Flop
Seat 3: forsmthgood folded before Flop (didn't bet)
Seat 4: gabi_igna folded before Flop (didn't bet)
Seat 5: matiko09 collected ($9.07)
Seat 6: samirj88 folded before Flop (didn't bet)
Seat 7: mycka86 folded before Flop (didn't bet)
Seat 8: sanpidk folded on the Flop
Seat 9: chute85 (button) folded before Flop (didn't bet)





PokerStars Hand #150706004507:  Hold'em No Limit ($0.50/$1.00 USD) - 2016/03/21 16:26:24 CET [2016/03/21 11:26:24 ET]
Table 'Onnie II' 9-max Seat #5 is the button
Seat 1: aseban11 ($156.91 in chips) 
Seat 2: RICKA16 ($106.07 in chips) 
Seat 3: cn_chayanne ($100 in chips) 
Seat 4: Bothfeld11 ($77.83 in chips) 
Seat 5: roninio1 ($81.75 in chips) 
Seat 6: Pacifistas ($103.16 in chips) 
Seat 7: djammusic ($75.08 in chips) 
Seat 8: solbi86 ($100 in chips) 
Seat 9: matiko09 ($112.55 in chips) 
Pacifistas: posts small blind $0.50
djammusic: posts big blind $1
*** HOLE CARDS ***
Dealt to matiko09 [3h Th]
solbi86: folds 
matiko09: folds 
aseban11: raises $1.50 to $2.50
RICKA16: folds 
cn_chayanne: folds 
Bothfeld11: folds 
roninio1: calls $2.50
Pacifistas: folds 
djammusic: folds 
*** FLOP *** [6h 3d 5c]
aseban11: bets $4
roninio1: folds 
Uncalled bet ($4) returned to aseban11
aseban11 collected $6.21 from pot
aseban11: doesn't show hand 
*** SUMMARY ***
Total pot $6.50 | Rake $0.29 
Board [6h 3d 5c]
Seat 1: aseban11 collected ($6.21)
Seat 2: RICKA16 folded before Flop (didn't bet)
Seat 3: cn_chayanne folded before Flop (didn't bet)
Seat 4: Bothfeld11 folded before Flop (didn't bet)
Seat 5: roninio1 (button) folded on the Flop
Seat 6: Pacifistas (small blind) folded before Flop
Seat 7: djammusic (big blind) folded before Flop
Seat 8: solbi86 folded before Flop (didn't bet)
Seat 9: matiko09 folded before Flop (didn't bet)





PokerStars Hand #150706004649:  Hold'em No Limit ($0.50/$1.00 USD) - 2016/03/21 16:26:24 CET [2016/03/21 11:26:24 ET]
Table 'Goberta' 9-max Seat #8 is the button
Seat 1: Rikti ($41.50 in chips) 
Seat 2: mycka86 ($119 in chips) 
Seat 3: Pacifistas ($100 in chips) 
Seat 4: aseban11 ($105.05 in chips) 
Seat 5: matiko09 ($102.75 in chips) 
Seat 6: sanpidk ($113.03 in chips) 
Seat 7: flk.Dasas ($100 in chips) 
Seat 8: Zeeshka ($102.37 in chips) 
Seat 9: Ez1kelL ($47.20 in chips) 
Ez1kelL: posts small blind $0.50
Rikti: posts big blind $1
*** HOLE CARDS ***
Dealt to matiko09 [Ac 3h]
mycka86: folds 
Pacifistas: folds 
aseban11: folds 
matiko09: folds 
sanpidk: folds 
flk.Dasas: folds 
Zeeshka: folds 
Ez1kelL: raises $1.50 to $2.50
Rikti: folds 
Uncalled bet ($1.50) returned to Ez1kelL
Ez1kelL collected $2 from pot
Ez1kelL: doesn't show hand 
*** SUMMARY ***
Total pot $2 | Rake $0 
Seat 1: Rikti (big blind) folded before Flop
Seat 2: mycka86 folded before Flop (didn't bet)
Seat 3: Pacifistas folded before Flop (didn't bet)
Seat 4: aseban11 folded before Flop (didn't bet)
Seat 5: matiko09 folded before Flop (didn't bet)
Seat 6: sanpidk folded before Flop (didn't bet)
Seat 7: flk.Dasas folded before Flop (didn't bet)
Seat 8: Zeeshka (button) folded before Flop (didn't bet)
Seat 9: Ez1kelL (small blind) collected ($2)





PokerStars Hand #150706016280:  Hold'em No Limit ($0.50/$1.00 USD) - 2016/03/21 16:26:40 CET [2016/03/21 11:26:40 ET]
Table 'Juhani' 9-max Seat #7 is the button
Seat 1: Dachish ($69 in chips) 
Seat 2: matiko09 ($102.50 in chips) 
Seat 3: cobrik23 ($37 in chips) 
Seat 4: Pacifistas ($113.63 in chips) 
Seat 5: RICKA16 ($96 in chips) 
Seat 6: Pay-My-Thc-B ($104.75 in chips) 
Seat 7: liyiwei233 ($40.68 in chips) 
Seat 8: sanpidk ($105.39 in chips) 
Seat 9: gabi_igna ($149.45 in chips) 
sanpidk: posts small blind $0.50
gabi_igna: posts big blind $1
*** HOLE CARDS ***
Dealt to matiko09 [3d 9d]
Dachish: folds 
matiko09: folds 
cobrik23: folds 
Pacifistas: folds 
RICKA16: raises $2 to $3
Pay-My-Thc-B: folds 
liyiwei233: calls $3
sanpidk: folds 
gabi_igna: calls $2
*** FLOP *** [6h Th As]
gabi_igna: checks 
RICKA16: bets $6
liyiwei233: folds 
gabi_igna: folds 
Uncalled bet ($6) returned to RICKA16
RICKA16 collected $9.07 from pot
RICKA16: doesn't show hand 
*** SUMMARY ***
Total pot $9.50 | Rake $0.43 
Board [6h Th As]
Seat 1: Dachish folded before Flop (didn't bet)
Seat 2: matiko09 folded before Flop (didn't bet)
Seat 3: cobrik23 folded before Flop (didn't bet)
Seat 4: Pacifistas folded before Flop (didn't bet)
Seat 5: RICKA16 collected ($9.07)
Seat 6: Pay-My-Thc-B folded before Flop (didn't bet)
Seat 7: liyiwei233 (button) folded on the Flop
Seat 8: sanpidk (small blind) folded before Flop
Seat 9: gabi_igna (big blind) folded on the Flop





PokerStars Hand #150706022521:  Hold'em No Limit ($0.50/$1.00 USD) - 2016/03/21 16:26:49 CET [2016/03/21 11:26:49 ET]
Table 'Gondola II' 9-max Seat #2 is the button
Seat 1: matiko09 ($105.14 in chips) 
Seat 2: R1aki ($110.10 in chips) 
Seat 3: flk.Dasas ($102.50 in chips) 
Seat 4: aseban11 ($100 in chips) 
Seat 5: teukka8 ($87.01 in chips) 
Seat 7: Pacifistas ($100 in chips) 
Seat 8: cn_chayanne ($100 in chips) 
Seat 9: djammusic ($45.02 in chips) 
flk.Dasas: posts small blind $0.50
aseban11: posts big blind $1
SanychStar: sits out 
*** HOLE CARDS ***
Dealt to matiko09 [7h Qh]
teukka8: raises $1 to $2
Pacifistas: folds 
cn_chayanne: folds 
djammusic: folds 
matiko09: folds 
R1aki: raises $6 to $8
flk.Dasas: folds 
aseban11: folds 
teukka8: folds 
Uncalled bet ($6) returned to R1aki
R1aki collected $5.50 from pot
R1aki: doesn't show hand 
*** SUMMARY ***
Total pot $5.50 | Rake $0 
Seat 1: matiko09 folded before Flop (didn't bet)
Seat 2: R1aki (button) collected ($5.50)
Seat 3: flk.Dasas (small blind) folded before Flop
Seat 4: aseban11 (big blind) folded before Flop
Seat 5: teukka8 folded before Flop
Seat 7: Pacifistas folded before Flop (didn't bet)
Seat 8: cn_chayanne folded before Flop (didn't bet)
Seat 9: djammusic folded before Flop (didn't bet)





PokerStars Hand #150706028733:  Hold'em No Limit ($0.50/$1.00 USD) - 2016/03/21 16:26:58 CET [2016/03/21 11:26:58 ET]
Table 'Massalia II' 9-max Seat #9 is the button
Seat 1: crepke ($78.80 in chips) 
Seat 2: solbi86 ($100 in chips) 
Seat 5: roninio1 ($91.49 in chips) 
Seat 6: Pacifistas ($100 in chips) 
Seat 8: matiko09 ($199 in chips) 
Seat 9: R1aki ($100 in chips) 
crepke: posts small blind $0.50
solbi86: posts big blind $1
123chambo: sits out 
crepke: posts the ante $0.20
solbi86: posts the ante $0.20
roninio1: posts the ante $0.20
Pacifistas: posts the ante $0.20
matiko09: posts the ante $0.20
R1aki: posts the ante $0.20
*** HOLE CARDS ***
Dealt to matiko09 [Jh 2d]
roninio1: calls $1
Pacifistas: folds 
matiko09: folds 
R1aki: raises $3.50 to $4.50
crepke: folds 
solbi86: folds 
roninio1: calls $3.50
*** FLOP *** [Ks Kd 9d]
roninio1: checks 
R1aki: checks 
*** TURN *** [Ks Kd 9d] [8h]
roninio1: bets $5.58
R1aki: calls $5.58
*** RIVER *** [Ks Kd 9d 8h] [8c]
roninio1: bets $10.91
R1aki: folds 
Uncalled bet ($10.91) returned to roninio1
roninio1 collected $21.83 from pot
roninio1: doesn't show hand 
*** SUMMARY ***
Total pot $22.86 | Rake $1.03 
Board [Ks Kd 9d 8h 8c]
Seat 1: crepke (small blind) folded before Flop
Seat 2: solbi86 (big blind) folded before Flop
Seat 5: roninio1 collected ($21.83)
Seat 6: Pacifistas folded before Flop (didn't bet)
Seat 8: matiko09 folded before Flop (didn't bet)
Seat 9: R1aki (button) folded on the River





PokerStars Hand #150706038458:  Hold'em No Limit ($0.50/$1.00 USD) - 2016/03/21 16:27:11 CET [2016/03/21 11:27:11 ET]
Table 'Onnie II' 9-max Seat #6 is the button
Seat 1: aseban11 ($160.62 in chips) 
Seat 2: RICKA16 ($106.07 in chips) 
Seat 3: cn_chayanne ($100 in chips) 
Seat 4: Bothfeld11 ($77.83 in chips) 
Seat 5: roninio1 ($79.25 in chips) 
Seat 6: Pacifistas ($102.66 in chips) 
Seat 7: djammusic ($74.08 in chips) 
Seat 8: solbi86 ($100 in chips) 
Seat 9: matiko09 ($112.55 in chips) 
djammusic: posts small blind $0.50
solbi86: posts big blind $1
*** HOLE CARDS ***
Dealt to matiko09 [Td 5c]
matiko09: folds 
aseban11: folds 
RICKA16: folds 
cn_chayanne: folds 
Bothfeld11: calls $1
roninio1: folds 
Pacifistas: folds 
djammusic: folds 
solbi86: raises $3 to $4
Bothfeld11: calls $3
*** FLOP *** [Jc 7c Qc]
solbi86: bets $5
Bothfeld11: folds 
Uncalled bet ($5) returned to solbi86
solbi86 collected $8.12 from pot
solbi86: doesn't show hand 
*** SUMMARY ***
Total pot $8.50 | Rake $0.38 
Board [Jc 7c Qc]
Seat 1: aseban11 folded before Flop (didn't bet)
Seat 2: RICKA16 folded before Flop (didn't bet)
Seat 3: cn_chayanne folded before Flop (didn't bet)
Seat 4: Bothfeld11 folded on the Flop
Seat 5: roninio1 folded before Flop (didn't bet)
Seat 6: Pacifistas (button) folded before Flop (didn't bet)
Seat 7: djammusic (small blind) folded before Flop
Seat 8: solbi86 (big blind) collected ($8.12)
Seat 9: matiko09 folded before Flop (didn't bet)





PokerStars Hand #150706042982:  Hold'em No Limit ($0.50/$1.00 USD) - 2016/03/21 16:27:18 CET [2016/03/21 11:27:18 ET]
Table 'Goberta' 9-max Seat #9 is the button
Seat 1: Rikti ($40.50 in chips) 
Seat 2: mycka86 ($119 in chips) 
Seat 3: Pacifistas ($100 in chips) 
Seat 4: aseban11 ($105.05 in chips) 
Seat 5: matiko09 ($102.75 in chips) 
Seat 6: sanpidk ($113.03 in chips) 
Seat 7: flk.Dasas ($100 in chips) 
Seat 8: Zeeshka ($102.37 in chips) 
Seat 9: Ez1kelL ($48.20 in chips) 
Rikti: posts small blind $0.50
mycka86: posts big blind $1
*** HOLE CARDS ***
Dealt to matiko09 [4c Td]
Pacifistas: folds 
Pacifistas leaves the table
aseban11: raises $1.50 to $2.50
matiko09: folds 
sanpidk: folds 
flk.Dasas: folds 
Zeeshka: folds 
Ez1kelL: folds 
Rikti: folds 
mycka86: folds 
Uncalled bet ($1.50) returned to aseban11
aseban11 collected $2.50 from pot
aseban11: doesn't show hand 
*** SUMMARY ***
Total pot $2.50 | Rake $0 
Seat 1: Rikti (small blind) folded before Flop
Seat 2: mycka86 (big blind) folded before Flop
Seat 3: Pacifistas folded before Flop (didn't bet)
Seat 4: aseban11 collected ($2.50)
Seat 5: matiko09 folded before Flop (didn't bet)
Seat 6: sanpidk folded before Flop (didn't bet)
Seat 7: flk.Dasas folded before Flop (didn't bet)
Seat 8: Zeeshka folded before Flop (didn't bet)
Seat 9: Ez1kelL (button) folded before Flop (didn't bet)





PokerStars Hand #150706049363:  Hold'em No Limit ($0.50/$1.00 USD) - 2016/03/21 16:27:27 CET [2016/03/21 11:27:27 ET]
Table 'Gondola II' 9-max Seat #3 is the button
Seat 1: matiko09 ($105.14 in chips) 
Seat 2: R1aki ($113.60 in chips) 
Seat 3: flk.Dasas ($102 in chips) 
Seat 4: aseban11 ($100 in chips) 
Seat 5: teukka8 ($85.01 in chips) 
Seat 7: Pacifistas ($100 in chips) 
Seat 8: cn_chayanne ($100 in chips) 
Seat 9: djammusic ($45.02 in chips) 
aseban11: posts small blind $0.50
teukka8: posts big blind $1
SanychStar: sits out 
*** HOLE CARDS ***
Dealt to matiko09 [5c 2d]
Pacifistas: folds 
cn_chayanne: folds 
djammusic: raises $1.15 to $2.15
matiko09: folds 
R1aki: folds 
flk.Dasas: folds 
aseban11: folds 
teukka8: calls $1.15
*** FLOP *** [2c 6s 6d]
teukka8: checks 
djammusic: bets $2.38
teukka8: folds 
Uncalled bet ($2.38) returned to djammusic
djammusic collected $4.58 from pot
djammusic: doesn't show hand 
*** SUMMARY ***
Total pot $4.80 | Rake $0.22 
Board [2c 6s 6d]
Seat 1: matiko09 folded before Flop (didn't bet)
Seat 2: R1aki folded before Flop (didn't bet)
Seat 3: flk.Dasas (button) folded before Flop (didn't bet)
Seat 4: aseban11 (small blind) folded before Flop
Seat 5: teukka8 (big blind) folded on the Flop
Seat 7: Pacifistas folded before Flop (didn't bet)
Seat 8: cn_chayanne folded before Flop (didn't bet)
Seat 9: djammusic collected ($4.58)





PokerStars Hand #150706058163:  Hold'em No Limit ($0.50/$1.00 USD) - 2016/03/21 16:27:39 CET [2016/03/21 11:27:39 ET]
Table 'Massalia II' 9-max Seat #1 is the button
Seat 1: crepke ($78.10 in chips) 
Seat 2: solbi86 ($100 in chips) 
Seat 3: 123chambo ($100 in chips) 
Seat 5: roninio1 ($103.04 in chips) 
Seat 6: Pacifistas ($100 in chips) 
Seat 8: matiko09 ($198.80 in chips) 
Seat 9: R1aki ($100 in chips) 
solbi86: posts small blind $0.50
123chambo: posts big blind $1
crepke: posts the ante $0.20
solbi86: posts the ante $0.20
123chambo: posts the ante $0.20
roninio1: posts the ante $0.20
Pacifistas: posts the ante $0.20
matiko09: posts the ante $0.20
R1aki: posts the ante $0.20
*** HOLE CARDS ***
Dealt to matiko09 [Jc As]
roninio1: folds 
Pacifistas: folds 
matiko09: raises $2 to $3
OriginalTony joins the table at seat #4 
R1aki: folds 
crepke: folds 
solbi86: folds 
123chambo: folds 
Uncalled bet ($2) returned to matiko09
matiko09 collected $3.90 from pot
matiko09: doesn't show hand 
*** SUMMARY ***
Total pot $3.90 | Rake $0 
Seat 1: crepke (button) folded before Flop (didn't bet)
Seat 2: solbi86 (small blind) folded before Flop
Seat 3: 123chambo (big blind) folded before Flop
Seat 5: roninio1 folded before Flop (didn't bet)
Seat 6: Pacifistas folded before Flop (didn't bet)
Seat 8: matiko09 collected ($3.90)
Seat 9: R1aki folded before Flop (didn't bet)





PokerStars Hand #150706063075:  Hold'em No Limit ($0.50/$1.00 USD) - 2016/03/21 16:27:46 CET [2016/03/21 11:27:46 ET]
Table 'Juhani' 9-max Seat #8 is the button
Seat 1: Dachish ($69 in chips) 
Seat 2: matiko09 ($102.50 in chips) 
Seat 3: cobrik23 ($37 in chips) 
Seat 4: Pacifistas ($113.63 in chips) 
Seat 5: RICKA16 ($102.07 in chips) 
Seat 6: Pay-My-Thc-B ($104.75 in chips) 
Seat 7: liyiwei233 ($37.68 in chips) 
Seat 8: sanpidk ($104.89 in chips) 
Seat 9: gabi_igna ($146.45 in chips) 
gabi_igna: posts small blind $0.50
Dachish: posts big blind $1
*** HOLE CARDS ***
Dealt to matiko09 [4d 2d]
matiko09: folds 
cobrik23: folds 
Pacifistas: folds 
RICKA16: folds 
Pay-My-Thc-B: folds 
liyiwei233: raises $1.60 to $2.60
sanpidk: folds 
gabi_igna: folds 
Dachish: folds 
Uncalled bet ($1.60) returned to liyiwei233
liyiwei233 collected $2.50 from pot
liyiwei233: doesn't show hand 
*** SUMMARY ***
Total pot $2.50 | Rake $0 
Seat 1: Dachish (big blind) folded before Flop
Seat 2: matiko09 folded before Flop (didn't bet)
Seat 3: cobrik23 folded before Flop (didn't bet)
Seat 4: Pacifistas folded before Flop (didn't bet)
Seat 5: RICKA16 folded before Flop (didn't bet)
Seat 6: Pay-My-Thc-B folded before Flop (didn't bet)
Seat 7: liyiwei233 collected ($2.50)
Seat 8: sanpidk (button) folded before Flop (didn't bet)
Seat 9: gabi_igna (small blind) folded before Flop





PokerStars Hand #150706064215:  Hold'em No Limit ($0.50/$1.00 USD) - 2016/03/21 16:27:48 CET [2016/03/21 11:27:48 ET]
Table 'Goberta' 9-max Seat #1 is the button
Seat 1: Rikti ($40 in chips) 
Seat 2: mycka86 ($118 in chips) 
Seat 4: aseban11 ($106.55 in chips) 
Seat 5: matiko09 ($102.75 in chips) 
Seat 6: sanpidk ($113.03 in chips) 
Seat 7: flk.Dasas ($100 in chips) 
Seat 8: Zeeshka ($102.37 in chips) 
Seat 9: Ez1kelL ($48.20 in chips) 
mycka86: posts small blind $0.50
aseban11: posts big blind $1
*** HOLE CARDS ***
Dealt to matiko09 [2h Ks]
matiko09: folds 
sanpidk: folds 
flk.Dasas: folds 
Zeeshka: raises $2 to $3
Ez1kelL: folds 
Rikti: folds 
Khaine_CM joins the table at seat #3 
mycka86: folds 
aseban11: folds 
Uncalled bet ($2) returned to Zeeshka
Zeeshka collected $2.50 from pot
Zeeshka: doesn't show hand 
*** SUMMARY ***
Total pot $2.50 | Rake $0 
Seat 1: Rikti (button) folded before Flop (didn't bet)
Seat 2: mycka86 (small blind) folded before Flop
Seat 4: aseban11 (big blind) folded before Flop
Seat 5: matiko09 folded before Flop (didn't bet)
Seat 6: sanpidk folded before Flop (didn't bet)
Seat 7: flk.Dasas folded before Flop (didn't bet)
Seat 8: Zeeshka collected ($2.50)
Seat 9: Ez1kelL folded before Flop (didn't bet)





PokerStars Hand #150706068144:  Hold'em No Limit ($0.50/$1.00 USD) - 2016/03/21 16:27:53 CET [2016/03/21 11:27:53 ET]
Table 'Onnie II' 9-max Seat #7 is the button
Seat 1: aseban11 ($160.62 in chips) 
Seat 2: RICKA16 ($106.07 in chips) 
Seat 3: cn_chayanne ($100 in chips) 
Seat 4: Bothfeld11 ($73.83 in chips) 
Seat 5: roninio1 ($79.25 in chips) 
Seat 6: Pacifistas ($102.66 in chips) 
Seat 7: djammusic ($73.58 in chips) 
Seat 8: solbi86 ($104.12 in chips) 
Seat 9: matiko09 ($112.55 in chips) 
solbi86: posts small blind $0.50
matiko09: posts big blind $1
*** HOLE CARDS ***
Dealt to matiko09 [4d Qc]
aseban11: folds 
RICKA16: folds 
cn_chayanne: raises $1.50 to $2.50
Bothfeld11: folds 
roninio1: folds 
Pacifistas: folds 
djammusic: folds 
solbi86: folds 
matiko09: folds 
Uncalled bet ($1.50) returned to cn_chayanne
cn_chayanne collected $2.50 from pot
cn_chayanne: doesn't show hand 
*** SUMMARY ***
Total pot $2.50 | Rake $0 
Seat 1: aseban11 folded before Flop (didn't bet)
Seat 2: RICKA16 folded before Flop (didn't bet)
Seat 3: cn_chayanne collected ($2.50)
Seat 4: Bothfeld11 folded before Flop (didn't bet)
Seat 5: roninio1 folded before Flop (didn't bet)
Seat 6: Pacifistas folded before Flop (didn't bet)
Seat 7: djammusic (button) folded before Flop (didn't bet)
Seat 8: solbi86 (small blind) folded before Flop
Seat 9: matiko09 (big blind) folded before Flop





PokerStars Hand #150706077424:  Hold'em No Limit (€0.50/€1.00 EUR) - 2016/03/21 16:28:07 CET [2016/03/21 11:28:07 ET]
Table 'Anhui' 9-max Seat #9 is the button
Seat 1: Pacifistas (€100 in chips) 
Seat 2: R1aki (€100 in chips) 
Seat 3: matiko09 (€100 in chips) 
Seat 5: cobrik23 (€40 in chips) 
Seat 9: Snoopy797 (€100 in chips) 
Pacifistas: posts small blind €0.50
R1aki: posts big blind €1
*** HOLE CARDS ***
Dealt to matiko09 [7c 5c]
matiko09: folds 
cobrik23: raises €2 to €3
Snoopy797: calls €3
Pacifistas: folds 
R1aki: calls €2
*** FLOP *** [4d 5s 7s]
R1aki: checks 
stds st joins the table at seat #4 
Muinmyheart joins the table at seat #6 
cobrik23: checks 
Snoopy797: bets €3
R1aki: folds 
cobrik23: raises €10 to €13
aseban11 joins the table at seat #7 
Snoopy797: folds 
Uncalled bet (€10) returned to cobrik23
cobrik23 collected €14.80 from pot
cobrik23: doesn't show hand 
*** SUMMARY ***
Total pot €15.50 | Rake €0.70 
Board [4d 5s 7s]
Seat 1: Pacifistas (small blind) folded before Flop
Seat 2: R1aki (big blind) folded on the Flop
Seat 3: matiko09 folded before Flop (didn't bet)
Seat 5: cobrik23 collected (€14.80)
Seat 9: Snoopy797 (button) folded on the Flop





PokerStars Hand #150706087594:  Hold'em No Limit ($0.50/$1.00 USD) - 2016/03/21 16:28:21 CET [2016/03/21 11:28:21 ET]
Table 'Onnie II' 9-max Seat #8 is the button
Seat 1: aseban11 ($160.62 in chips) 
Seat 2: RICKA16 ($106.07 in chips) 
Seat 3: cn_chayanne ($101.50 in chips) 
Seat 4: Bothfeld11 ($73.83 in chips) 
Seat 5: roninio1 ($79.25 in chips) 
Seat 6: Pacifistas ($102.66 in chips) 
Seat 7: djammusic ($73.58 in chips) 
Seat 8: solbi86 ($103.62 in chips) 
Seat 9: matiko09 ($111.55 in chips) 
matiko09: posts small blind $0.50
aseban11: posts big blind $1
*** HOLE CARDS ***
Dealt to matiko09 [Tc 4s]
RICKA16: raises $2 to $3
cn_chayanne: folds 
Bothfeld11: calls $3
roninio1: folds 
Pacifistas: folds 
djammusic: folds 
solbi86: calls $3
matiko09: folds 
aseban11: folds 
*** FLOP *** [7d 2s 2c]
RICKA16: checks 
Bothfeld11: checks 
solbi86: checks 
*** TURN *** [7d 2s 2c] [Ts]
RICKA16: checks 
Bothfeld11: checks 
solbi86: checks 
*** RIVER *** [7d 2s 2c Ts] [7c]
RICKA16: checks 
Bothfeld11: checks 
solbi86: checks 
*** SHOW DOWN ***
RICKA16: shows [Ah Qd] (two pair, Sevens and Deuces)
Bothfeld11: shows [3c 3s] (two pair, Sevens and Threes)
solbi86: mucks hand 
Bothfeld11 collected $10.03 from pot
*** SUMMARY ***
Total pot $10.50 | Rake $0.47 
Board [7d 2s 2c Ts 7c]
Seat 1: aseban11 (big blind) folded before Flop
Seat 2: RICKA16 showed [Ah Qd] and lost with two pair, Sevens and Deuces
Seat 3: cn_chayanne folded before Flop (didn't bet)
Seat 4: Bothfeld11 showed [3c 3s] and won ($10.03) with two pair, Sevens and Threes
Seat 5: roninio1 folded before Flop (didn't bet)
Seat 6: Pacifistas folded before Flop (didn't bet)
Seat 7: djammusic folded before Flop (didn't bet)
Seat 8: solbi86 (button) mucked [Qs Kc]
Seat 9: matiko09 (small blind) folded before Flop





PokerStars Hand #150706087442:  Hold'em No Limit ($0.50/$1.00 USD) - 2016/03/21 16:28:21 CET [2016/03/21 11:28:21 ET]
Table 'Massalia II' 9-max Seat #2 is the button
Seat 1: crepke ($77.90 in chips) 
Seat 2: solbi86 ($100 in chips) 
Seat 3: 123chambo ($98.80 in chips) 
Seat 4: OriginalTony ($100 in chips) 
Seat 5: roninio1 ($102.84 in chips) 
Seat 6: Pacifistas ($100 in chips) 
Seat 8: matiko09 ($201.50 in chips) 
Seat 9: R1aki ($100 in chips) 
123chambo: posts small blind $0.50
OriginalTony: posts big blind $1
crepke: posts the ante $0.20
solbi86: posts the ante $0.20
123chambo: posts the ante $0.20
OriginalTony: posts the ante $0.20
roninio1: posts the ante $0.20
Pacifistas: posts the ante $0.20
matiko09: posts the ante $0.20
R1aki: posts the ante $0.20
*** HOLE CARDS ***
Dealt to matiko09 [9s 2h]
roninio1: folds 
Pacifistas: folds 
matiko09: folds 
R1aki: folds 
crepke: folds 
solbi86: raises $1.50 to $2.50
123chambo: raises $3.50 to $6
OriginalTony: calls $5
solbi86: calls $3.50
*** FLOP *** [Ks 7s 9h]
123chambo: bets $8
OriginalTony: calls $8
solbi86: folds 
*** TURN *** [Ks 7s 9h] [6h]
123chambo: bets $14
OriginalTony: raises $14 to $28
123chambo: folds 
Uncalled bet ($14) returned to OriginalTony
OriginalTony collected $60.80 from pot
*** SUMMARY ***
Total pot $63.60 | Rake $2.80 
Board [Ks 7s 9h 6h]
Seat 1: crepke folded before Flop (didn't bet)
Seat 2: solbi86 (button) folded on the Flop
Seat 3: 123chambo (small blind) folded on the Turn
Seat 4: OriginalTony (big blind) collected ($60.80)
Seat 5: roninio1 folded before Flop (didn't bet)
Seat 6: Pacifistas folded before Flop (didn't bet)
Seat 8: matiko09 folded before Flop (didn't bet)
Seat 9: R1aki folded before Flop (didn't bet)





PokerStars Hand #150706102476:  Hold'em No Limit ($0.50/$1.00 USD) - 2016/03/21 16:28:42 CET [2016/03/21 11:28:42 ET]
Table 'Gondola II' 9-max Seat #4 is the button
Seat 1: matiko09 ($105.14 in chips) 
Seat 2: R1aki ($113.60 in chips) 
Seat 3: flk.Dasas ($102 in chips) 
Seat 4: aseban11 ($100 in chips) 
Seat 5: teukka8 ($82.86 in chips) 
Seat 6: SanychStar ($100 in chips) 
Seat 7: Pacifistas ($100 in chips) 
Seat 8: cn_chayanne ($100 in chips) 
Seat 9: djammusic ($47.45 in chips) 
teukka8: posts small blind $0.50
SanychStar: posts big blind $1
*** HOLE CARDS ***
Dealt to matiko09 [Qc 2c]
Pacifistas: folds 
cn_chayanne: raises $1.50 to $2.50
djammusic: folds 
matiko09: folds 
R1aki: folds 
flk.Dasas: folds 
aseban11: folds 
teukka8: calls $2
SanychStar: folds 
*** FLOP *** [9d 9h 4s]
teukka8: checks 
cn_chayanne: checks 
*** TURN *** [9d 9h 4s] [8h]
teukka8: bets $4
cn_chayanne: folds 
Uncalled bet ($4) returned to teukka8
teukka8 collected $5.73 from pot
teukka8: doesn't show hand 
*** SUMMARY ***
Total pot $6 | Rake $0.27 
Board [9d 9h 4s 8h]
Seat 1: matiko09 folded before Flop (didn't bet)
Seat 2: R1aki folded before Flop (didn't bet)
Seat 3: flk.Dasas folded before Flop (didn't bet)
Seat 4: aseban11 (button) folded before Flop (didn't bet)
Seat 5: teukka8 (small blind) collected ($5.73)
Seat 6: SanychStar (big blind) folded before Flop
Seat 7: Pacifistas folded before Flop (didn't bet)
Seat 8: cn_chayanne folded on the Turn
Seat 9: djammusic folded before Flop (didn't bet)





PokerStars Hand #150706119842:  Hold'em No Limit ($0.50/$1.00 USD) - 2016/03/21 16:29:06 CET [2016/03/21 11:29:06 ET]
Table 'Genoveva II' 9-max Seat #7 is the button
Seat 1: RICKA16 ($153.25 in chips) 
Seat 2: Ez1kelL ($39.39 in chips) 
Seat 3: sanpidk ($100 in chips) 
Seat 4: aseban11 ($100 in chips) 
Seat 5: volwebni4ek ($45.44 in chips) 
Seat 6: Pacifistas ($106.54 in chips) 
Seat 7: Robert201202 ($125.90 in chips) 
Seat 8: R1aki ($116.56 in chips) 
Seat 9: matiko09 ($100 in chips) 
R1aki: posts small blind $0.50
matiko09: posts big blind $1
*** HOLE CARDS ***
Dealt to matiko09 [Kc Ac]
RICKA16: folds 
Ez1kelL: folds 
sanpidk: folds 
aseban11: folds 
volwebni4ek: folds 
Pacifistas: raises $1.50 to $2.50
Robert201202: folds 
R1aki: folds 
matiko09: raises $6.50 to $9
Pacifistas: folds 
Uncalled bet ($6.50) returned to matiko09
matiko09 collected $5.50 from pot
matiko09: doesn't show hand 
*** SUMMARY ***
Total pot $5.50 | Rake $0 
Seat 1: RICKA16 folded before Flop (didn't bet)
Seat 2: Ez1kelL folded before Flop (didn't bet)
Seat 3: sanpidk folded before Flop (didn't bet)
Seat 4: aseban11 folded before Flop (didn't bet)
Seat 5: volwebni4ek folded before Flop (didn't bet)
Seat 6: Pacifistas folded before Flop
Seat 7: Robert201202 (button) folded before Flop (didn't bet)
Seat 8: R1aki (small blind) folded before Flop
Seat 9: matiko09 (big blind) collected ($5.50)





PokerStars Hand #150706143560:  Hold'em No Limit (€0.50/€1.00 EUR) - 2016/03/21 16:29:39 CET [2016/03/21 11:29:39 ET]
Table 'Anhui' 9-max Seat #1 is the button
Seat 1: Pacifistas (€100 in chips) 
Seat 2: R1aki (€100 in chips) 
Seat 3: matiko09 (€100 in chips) 
Seat 5: cobrik23 (€100 in chips) 
Seat 9: Snoopy797 (€94 in chips) 
R1aki: posts small blind €0.50
matiko09: posts big blind €1
stds st: sits out 
Muinmyheart: sits out 
aseban11: sits out 
*** HOLE CARDS ***
Dealt to matiko09 [2c As]
cobrik23: folds 
Snoopy797: folds 
Pacifistas: folds 
R1aki: folds 
Uncalled bet (€0.50) returned to matiko09
matiko09 collected €1 from pot
matiko09: doesn't show hand 
*** SUMMARY ***
Total pot €1 | Rake €0 
Seat 1: Pacifistas (button) folded before Flop (didn't bet)
Seat 2: R1aki (small blind) folded before Flop
Seat 3: matiko09 (big blind) collected (€1)
Seat 5: cobrik23 folded before Flop (didn't bet)
Seat 9: Snoopy797 folded before Flop (didn't bet)





PokerStars Hand #150706144468:  Hold'em No Limit ($0.50/$1.00 USD) - 2016/03/21 16:29:40 CET [2016/03/21 11:29:40 ET]
Table 'Noel' 9-max Seat #6 is the button
Seat 3: gabi_igna ($217.60 in chips) 
Seat 5: matiko09 ($100 in chips) 
Seat 6: hammerwife ($103.50 in chips) 
djammusic will be allowed to play after the button
Dachish will be allowed to play after the button
grifkaaa will be allowed to play after the button
ep538 will be allowed to play after the button
gabi_igna: posts small blind $0.50
aseban11: is sitting out 
matiko09: posts big blind $1
*** HOLE CARDS ***
Dealt to matiko09 [3s 7s]
aseban11 leaves the table
hammerwife: raises $1.01 to $2.01
gabi_igna: raises $5.99 to $8
Kobiroga150 joins the table at seat #4 
matiko09: folds 
hammerwife: calls $5.99
*** FLOP *** [3d 7h Jc]
gabi_igna: bets $10
hammerwife: folds 
Uncalled bet ($10) returned to gabi_igna
gabi_igna collected $16.24 from pot
gabi_igna: doesn't show hand 
*** SUMMARY ***
Total pot $17 | Rake $0.76 
Board [3d 7h Jc]
Seat 3: gabi_igna (small blind) collected ($16.24)
Seat 5: matiko09 (big blind) folded before Flop
Seat 6: hammerwife (button) folded on the Flop





PokerStars Hand #150706149586:  Hold'em No Limit ($0.50/$1.00 USD) - 2016/03/21 16:29:48 CET [2016/03/21 11:29:48 ET]
Table 'Genoveva II' 9-max Seat #8 is the button
Seat 1: RICKA16 ($153.25 in chips) 
Seat 2: Ez1kelL ($39.39 in chips) 
Seat 3: sanpidk ($100 in chips) 
Seat 4: aseban11 ($100 in chips) 
Seat 5: volwebni4ek ($45.44 in chips) 
Seat 6: Pacifistas ($104.04 in chips) 
Seat 7: Robert201202 ($125.90 in chips) 
Seat 8: R1aki ($116.06 in chips) 
Seat 9: matiko09 ($103 in chips) 
matiko09: posts small blind $0.50
RICKA16: posts big blind $1
*** HOLE CARDS ***
Dealt to matiko09 [Ad 9d]
Ez1kelL: folds 
sanpidk: folds 
aseban11: folds 
volwebni4ek: folds 
Pacifistas: folds 
Robert201202: raises $2 to $3
R1aki: folds 
matiko09: folds 
RICKA16: folds 
Uncalled bet ($2) returned to Robert201202
Robert201202 collected $2.50 from pot
Robert201202: doesn't show hand 
*** SUMMARY ***
Total pot $2.50 | Rake $0 
Seat 1: RICKA16 (big blind) folded before Flop
Seat 2: Ez1kelL folded before Flop (didn't bet)
Seat 3: sanpidk folded before Flop (didn't bet)
Seat 4: aseban11 folded before Flop (didn't bet)
Seat 5: volwebni4ek folded before Flop (didn't bet)
Seat 6: Pacifistas folded before Flop (didn't bet)
Seat 7: Robert201202 collected ($2.50)
Seat 8: R1aki (button) folded before Flop (didn't bet)
Seat 9: matiko09 (small blind) folded before Flop





PokerStars Hand #150706152579:  Hold'em No Limit ($0.50/$1.00 USD) - 2016/03/21 16:29:52 CET [2016/03/21 11:29:52 ET]
Table 'Gondola II' 9-max Seat #5 is the button
Seat 1: matiko09 ($105.14 in chips) 
Seat 2: R1aki ($113.60 in chips) 
Seat 3: flk.Dasas ($102 in chips) 
Seat 4: aseban11 ($100 in chips) 
Seat 5: teukka8 ($86.09 in chips) 
Seat 6: SanychStar ($100 in chips) 
Seat 7: Pacifistas ($100 in chips) 
Seat 8: cn_chayanne ($100 in chips) 
Seat 9: djammusic ($47.45 in chips) 
SanychStar: posts small blind $0.50
Pacifistas: posts big blind $1
*** HOLE CARDS ***
Dealt to matiko09 [7c 4d]
cn_chayanne: raises $1.50 to $2.50
djammusic: folds 
matiko09: folds 
R1aki: folds 
flk.Dasas: folds 
aseban11: folds 
teukka8: calls $2.50
SanychStar: raises $10 to $12.50
Pacifistas: folds 
cn_chayanne: folds 
teukka8: folds 
Uncalled bet ($10) returned to SanychStar
SanychStar collected $8.50 from pot
*** SUMMARY ***
Total pot $8.50 | Rake $0 
Seat 1: matiko09 folded before Flop (didn't bet)
Seat 2: R1aki folded before Flop (didn't bet)
Seat 3: flk.Dasas folded before Flop (didn't bet)
Seat 4: aseban11 folded before Flop (didn't bet)
Seat 5: teukka8 (button) folded before Flop
Seat 6: SanychStar (small blind) collected ($8.50)
Seat 7: Pacifistas (big blind) folded before Flop
Seat 8: cn_chayanne folded before Flop
Seat 9: djammusic folded before Flop (didn't bet)





PokerStars Hand #150706154401:  Hold'em No Limit (€0.50/€1.00 EUR) - 2016/03/21 16:29:54 CET [2016/03/21 11:29:54 ET]
Table 'Anhui' 9-max Seat #2 is the button
Seat 1: Pacifistas (€100 in chips) 
Seat 2: R1aki (€100 in chips) 
Seat 3: matiko09 (€100.50 in chips) 
Seat 4: stds st (€40 in chips) 
Seat 5: cobrik23 (€100 in chips) 
Seat 9: Snoopy797 (€94 in chips) 
matiko09: posts small blind €0.50
stds st: posts big blind €1
Muinmyheart: sits out 
aseban11: sits out 
*** HOLE CARDS ***
Dealt to matiko09 [4d 7c]
cobrik23: folds 
Snoopy797: calls €1
Pacifistas: folds 
R1aki: folds 
matiko09: folds 
stds st: checks 
*** FLOP *** [Kh 6s 6d]
stds st: checks 
Snoopy797: checks 
*** TURN *** [Kh 6s 6d] [5s]
volwebni4ek joins the table at seat #8 
stds st: checks 
Snoopy797: bets €2
stds st: folds 
Uncalled bet (€2) returned to Snoopy797
Snoopy797 collected €2.39 from pot
Snoopy797: doesn't show hand 
*** SUMMARY ***
Total pot €2.50 | Rake €0.11 
Board [Kh 6s 6d 5s]
Seat 1: Pacifistas folded before Flop (didn't bet)
Seat 2: R1aki (button) folded before Flop (didn't bet)
Seat 3: matiko09 (small blind) folded before Flop
Seat 4: stds st (big blind) folded on the Turn
Seat 5: cobrik23 folded before Flop (didn't bet)
Seat 9: Snoopy797 collected (€2.39)





PokerStars Hand #150706175258:  Hold'em No Limit ($0.50/$1.00 USD) - 2016/03/21 16:30:23 CET [2016/03/21 11:30:23 ET]
Table 'Noel' 9-max Seat #3 is the button
Seat 3: gabi_igna ($225.84 in chips) 
Seat 5: matiko09 ($100 in chips) 
Seat 6: hammerwife ($100 in chips) 
Kobiroga150 will be allowed to play after the button
matiko09: posts small blind $0.50
hammerwife: posts big blind $1
djammusic: sits out 
Dachish: sits out 
grifkaaa: sits out 
ep538: sits out 
cobrik23: sits out 
*** HOLE CARDS ***
Dealt to matiko09 [7h Js]
gabi_igna: folds 
matiko09: folds 
Uncalled bet ($0.50) returned to hammerwife
hammerwife collected $1 from pot
hammerwife: doesn't show hand 
*** SUMMARY ***
Total pot $1 | Rake $0 
Seat 3: gabi_igna (button) folded before Flop (didn't bet)
Seat 5: matiko09 (small blind) folded before Flop
Seat 6: hammerwife (big blind) collected ($1)





PokerStars Hand #150706176158:  Hold'em No Limit ($0.50/$1.00 USD) - 2016/03/21 16:30:24 CET [2016/03/21 11:30:24 ET]
Table 'Gondola II' 9-max Seat #6 is the button
Seat 1: matiko09 ($105.14 in chips) 
Seat 2: R1aki ($113.60 in chips) 
Seat 3: flk.Dasas ($102 in chips) 
Seat 4: aseban11 ($100 in chips) 
Seat 5: teukka8 ($83.59 in chips) 
Seat 6: SanychStar ($106 in chips) 
Seat 7: Pacifistas ($100 in chips) 
Seat 8: cn_chayanne ($100 in chips) 
Seat 9: djammusic ($47.45 in chips) 
Pacifistas: posts small blind $0.50
cn_chayanne: posts big blind $1
*** HOLE CARDS ***
Dealt to matiko09 [5h 2h]
djammusic: folds 
matiko09: folds 
R1aki: folds 
flk.Dasas: raises $2 to $3
aseban11: folds 
teukka8: calls $3
SanychStar: folds 
Pacifistas: folds 
cn_chayanne: folds 
*** FLOP *** [Qd 3s Js]
flk.Dasas: checks 
teukka8: bets $3
flk.Dasas: calls $3
*** TURN *** [Qd 3s Js] [Tc]
flk.Dasas: checks 
teukka8: bets $3
flk.Dasas: raises $7 to $10
teukka8: calls $7
*** RIVER *** [Qd 3s Js Tc] [6c]
flk.Dasas: bets $23
teukka8: folds 
Uncalled bet ($23) returned to flk.Dasas
flk.Dasas collected $31.99 from pot
flk.Dasas: doesn't show hand 
*** SUMMARY ***
Total pot $33.50 | Rake $1.51 
Board [Qd 3s Js Tc 6c]
Seat 1: matiko09 folded before Flop (didn't bet)
Seat 2: R1aki folded before Flop (didn't bet)
Seat 3: flk.Dasas collected ($31.99)
Seat 4: aseban11 folded before Flop (didn't bet)
Seat 5: teukka8 folded on the River
Seat 6: SanychStar (button) folded before Flop (didn't bet)
Seat 7: Pacifistas (small blind) folded before Flop
Seat 8: cn_chayanne (big blind) folded before Flop
Seat 9: djammusic folded before Flop (didn't bet)





PokerStars Hand #150706179254:  Hold'em No Limit ($0.50/$1.00 USD) - 2016/03/21 16:30:28 CET [2016/03/21 11:30:28 ET]
Table 'Genoveva II' 9-max Seat #9 is the button
Seat 1: RICKA16 ($152.25 in chips) 
Seat 2: Ez1kelL ($39.39 in chips) 
Seat 3: sanpidk ($100 in chips) 
Seat 4: aseban11 ($100 in chips) 
Seat 5: volwebni4ek ($45.44 in chips) 
Seat 6: Pacifistas ($104.04 in chips) 
Seat 7: Robert201202 ($127.40 in chips) 
Seat 8: R1aki ($116.06 in chips) 
Seat 9: matiko09 ($102.50 in chips) 
RICKA16: posts small blind $0.50
Ez1kelL: posts big blind $1
*** HOLE CARDS ***
Dealt to matiko09 [7c 6s]
sanpidk: folds 
aseban11: folds 
volwebni4ek: folds 
Pacifistas: folds 
Robert201202: folds 
R1aki: folds 
matiko09: raises $1.27 to $2.27
RICKA16: folds 
Ez1kelL: raises $4.73 to $7
matiko09: folds 
Uncalled bet ($4.73) returned to Ez1kelL
Ez1kelL collected $5.04 from pot
Ez1kelL: doesn't show hand 
*** SUMMARY ***
Total pot $5.04 | Rake $0 
Seat 1: RICKA16 (small blind) folded before Flop
Seat 2: Ez1kelL (big blind) collected ($5.04)
Seat 3: sanpidk folded before Flop (didn't bet)
Seat 4: aseban11 folded before Flop (didn't bet)
Seat 5: volwebni4ek folded before Flop (didn't bet)
Seat 6: Pacifistas folded before Flop (didn't bet)
Seat 7: Robert201202 folded before Flop (didn't bet)
Seat 8: R1aki folded before Flop (didn't bet)
Seat 9: matiko09 (button) folded before Flop





PokerStars Hand #150706181771:  Hold'em No Limit ($0.50/$1.00 USD) - 2016/03/21 16:30:32 CET [2016/03/21 11:30:32 ET]
Table 'Massalia II' 9-max Seat #3 is the button
Seat 1: crepke ($77.70 in chips) 
Seat 2: solbi86 ($100 in chips) 
Seat 3: 123chambo ($70.60 in chips) 
Seat 4: OriginalTony ($132.60 in chips) 
Seat 5: roninio1 ($102.64 in chips) 
Seat 6: Pacifistas ($100 in chips) 
Seat 8: matiko09 ($201.30 in chips) 
Seat 9: R1aki ($100 in chips) 
OriginalTony: posts small blind $0.50
roninio1: posts big blind $1
flk.Dasas: sits out 
crepke: posts the ante $0.20
solbi86: posts the ante $0.20
123chambo: posts the ante $0.20
OriginalTony: posts the ante $0.20
roninio1: posts the ante $0.20
Pacifistas: posts the ante $0.20
matiko09: posts the ante $0.20
R1aki: posts the ante $0.20
*** HOLE CARDS ***
Dealt to matiko09 [5h 9c]
Pacifistas: raises $2 to $3
matiko09: folds 
R1aki: folds 
crepke: folds 
solbi86: folds 
123chambo: folds 
OriginalTony: folds 
roninio1: calls $2
*** FLOP *** [3d Ah Jd]
roninio1: checks 
Pacifistas: bets $4.17
roninio1: calls $4.17
*** TURN *** [3d Ah Jd] [4h]
roninio1: checks 
Pacifistas: bets $8.47
roninio1: calls $8.47
*** RIVER *** [3d Ah Jd 4h] [3c]
roninio1: checks 
Pacifistas: checks 
*** SHOW DOWN ***
roninio1: shows [9d 7d] (a pair of Threes)
Pacifistas: shows [2s As] (two pair, Aces and Threes)
Pacifistas collected $31.88 from pot
*** SUMMARY ***
Total pot $33.38 | Rake $1.50 
Board [3d Ah Jd 4h 3c]
Seat 1: crepke folded before Flop (didn't bet)
Seat 2: solbi86 folded before Flop (didn't bet)
Seat 3: 123chambo (button) folded before Flop (didn't bet)
Seat 4: OriginalTony (small blind) folded before Flop
Seat 5: roninio1 (big blind) showed [9d 7d] and lost with a pair of Threes
Seat 6: Pacifistas showed [2s As] and won ($31.88) with two pair, Aces and Threes
Seat 8: matiko09 folded before Flop (didn't bet)
Seat 9: R1aki folded before Flop (didn't bet)





PokerStars Hand #150706184026:  Hold'em No Limit ($0.50/$1.00 USD) - 2016/03/21 16:30:35 CET [2016/03/21 11:30:35 ET]
Table 'Onnie II' 9-max Seat #9 is the button
Seat 1: aseban11 ($159.62 in chips) 
Seat 2: RICKA16 ($103.07 in chips) 
Seat 3: cn_chayanne ($101.50 in chips) 
Seat 4: Bothfeld11 ($80.86 in chips) 
Seat 5: roninio1 ($79.25 in chips) 
Seat 6: Pacifistas ($102.66 in chips) 
Seat 7: djammusic ($73.58 in chips) 
Seat 8: solbi86 ($100.62 in chips) 
Seat 9: matiko09 ($111.05 in chips) 
aseban11: posts small blind $0.50
RICKA16: posts big blind $1
*** HOLE CARDS ***
Dealt to matiko09 [8s 5s]
cn_chayanne: folds 
Bothfeld11: folds 
roninio1: calls $1
Pacifistas: folds 
djammusic: folds 
solbi86: folds 
matiko09: raises $3 to $4
aseban11: folds 
RICKA16: folds 
roninio1: calls $3
*** FLOP *** [6d 5d Qs]
roninio1: checks 
matiko09: checks 
*** TURN *** [6d 5d Qs] [9s]
roninio1: checks 
matiko09: checks 
*** RIVER *** [6d 5d Qs 9s] [2d]
roninio1: checks 
matiko09: checks 
*** SHOW DOWN ***
roninio1: shows [Kc Tc] (high card King)
matiko09: shows [8s 5s] (a pair of Fives)
matiko09 collected $9.07 from pot
*** SUMMARY ***
Total pot $9.50 | Rake $0.43 
Board [6d 5d Qs 9s 2d]
Seat 1: aseban11 (small blind) folded before Flop
Seat 2: RICKA16 (big blind) folded before Flop
Seat 3: cn_chayanne folded before Flop (didn't bet)
Seat 4: Bothfeld11 folded before Flop (didn't bet)
Seat 5: roninio1 showed [Kc Tc] and lost with high card King
Seat 6: Pacifistas folded before Flop (didn't bet)
Seat 7: djammusic folded before Flop (didn't bet)
Seat 8: solbi86 folded before Flop (didn't bet)
Seat 9: matiko09 (button) showed [8s 5s] and won ($9.07) with a pair of Fives





PokerStars Hand #150706196348:  Hold'em No Limit ($0.50/$1.00 USD) - 2016/03/21 16:30:52 CET [2016/03/21 11:30:52 ET]
Table 'Noel' 9-max Seat #5 is the button
Seat 3: gabi_igna ($225.84 in chips) 
Seat 5: matiko09 ($100 in chips) 
Seat 6: hammerwife ($100.50 in chips) 
Seat 7: djammusic ($40.20 in chips) 
hammerwife: posts small blind $0.50
djammusic: posts big blind $1
Dachish: sits out 
grifkaaa: sits out 
ep538: sits out 
cobrik23: sits out 
Kobiroga150: sits out 
*** HOLE CARDS ***
Dealt to matiko09 [Ah 5d]
gabi_igna: folds 
matiko09: raises $1.27 to $2.27
hammerwife: folds 
djammusic: folds 
Uncalled bet ($1.27) returned to matiko09
matiko09 collected $2.50 from pot
matiko09: doesn't show hand 
*** SUMMARY ***
Total pot $2.50 | Rake $0 
Seat 3: gabi_igna folded before Flop (didn't bet)
Seat 5: matiko09 (button) collected ($2.50)
Seat 6: hammerwife (small blind) folded before Flop
Seat 7: djammusic (big blind) folded before Flop





PokerStars Hand #150706202028:  Hold'em No Limit (€0.50/€1.00 EUR) - 2016/03/21 16:31:00 CET [2016/03/21 11:31:00 ET]
Table 'Anhui' 9-max Seat #3 is the button
Seat 1: Pacifistas (€100 in chips) 
Seat 2: R1aki (€100 in chips) 
Seat 3: matiko09 (€100 in chips) 
Seat 4: stds st (€39 in chips) 
Seat 5: cobrik23 (€100 in chips) 
Seat 9: Snoopy797 (€95.39 in chips) 
stds st: posts small blind €0.50
cobrik23: posts big blind €1
Muinmyheart: sits out 
aseban11: sits out 
volwebni4ek: sits out 
*** HOLE CARDS ***
Dealt to matiko09 [8d 6s]
Snoopy797: calls €1
Pacifistas: folds 
R1aki: folds 
matiko09: folds 
stds st: folds 
cobrik23: checks 
*** FLOP *** [Tc Th 5h]
cobrik23: checks 
Snoopy797: checks 
*** TURN *** [Tc Th 5h] [4c]
cobrik23: checks 
Snoopy797: checks 
*** RIVER *** [Tc Th 5h 4c] [8c]
cobrik23: checks 
Snoopy797: bets €5
cobrik23: folds 
Uncalled bet (€5) returned to Snoopy797
Snoopy797 collected €2.39 from pot
Snoopy797: doesn't show hand 
*** SUMMARY ***
Total pot €2.50 | Rake €0.11 
Board [Tc Th 5h 4c 8c]
Seat 1: Pacifistas folded before Flop (didn't bet)
Seat 2: R1aki folded before Flop (didn't bet)
Seat 3: matiko09 (button) folded before Flop (didn't bet)
Seat 4: stds st (small blind) folded before Flop
Seat 5: cobrik23 (big blind) folded on the River
Seat 9: Snoopy797 collected (€2.39)





PokerStars Hand #150706211526:  Hold'em No Limit ($0.50/$1.00 USD) - 2016/03/21 16:31:13 CET [2016/03/21 11:31:13 ET]
Table 'Massalia II' 9-max Seat #4 is the button
Seat 1: crepke ($77.50 in chips) 
Seat 2: solbi86 ($100 in chips) 
Seat 3: 123chambo ($100 in chips) 
Seat 4: OriginalTony ($131.90 in chips) 
Seat 5: roninio1 ($86.80 in chips) 
Seat 6: Pacifistas ($116.04 in chips) 
Seat 8: matiko09 ($201.10 in chips) 
Seat 9: R1aki ($100 in chips) 
roninio1: posts small blind $0.50
Pacifistas: posts big blind $1
flk.Dasas: sits out 
crepke: posts the ante $0.20
solbi86: posts the ante $0.20
123chambo: posts the ante $0.20
OriginalTony: posts the ante $0.20
roninio1: posts the ante $0.20
Pacifistas: posts the ante $0.20
matiko09: posts the ante $0.20
R1aki: posts the ante $0.20
*** HOLE CARDS ***
Dealt to matiko09 [Ac 6c]
matiko09: folds 
R1aki: folds 
crepke: folds 
solbi86: folds 
123chambo: folds 
OriginalTony: raises $2 to $3
roninio1: calls $2.50
Pacifistas: folds 
*** FLOP *** [2c Ad 9h]
roninio1: checks 
OriginalTony: bets $4
roninio1: calls $4
*** TURN *** [2c Ad 9h] [Ks]
roninio1: checks 
OriginalTony: checks 
*** RIVER *** [2c Ad 9h Ks] [3d]
roninio1: checks 
OriginalTony: bets $5
roninio1: raises $12.92 to $17.92
OriginalTony: folds [Ah]
Uncalled bet ($12.92) returned to roninio1
roninio1 collected $25.40 from pot
roninio1: doesn't show hand 
*** SUMMARY ***
Total pot $26.60 | Rake $1.20 
Board [2c Ad 9h Ks 3d]
Seat 1: crepke folded before Flop (didn't bet)
Seat 2: solbi86 folded before Flop (didn't bet)
Seat 3: 123chambo folded before Flop (didn't bet)
Seat 4: OriginalTony (button) folded on the River
Seat 5: roninio1 (small blind) collected ($25.40)
Seat 6: Pacifistas (big blind) folded before Flop
Seat 8: matiko09 folded before Flop (didn't bet)
Seat 9: R1aki folded before Flop (didn't bet)





PokerStars Hand #150706215763:  Hold'em No Limit ($0.50/$1.00 USD) - 2016/03/21 16:31:19 CET [2016/03/21 11:31:19 ET]
Table 'Noel' 9-max Seat #6 is the button
Seat 3: gabi_igna ($225.84 in chips) 
Seat 5: matiko09 ($101.50 in chips) 
Seat 6: hammerwife ($100 in chips) 
Seat 7: djammusic ($39.20 in chips) 
Seat 8: Dachish ($70 in chips) 
djammusic: posts small blind $0.50
Dachish: posts big blind $1
grifkaaa: sits out 
ep538: sits out 
cobrik23: sits out 
Kobiroga150: sits out 
*** HOLE CARDS ***
Dealt to matiko09 [Ad Qh]
gabi_igna: folds 
matiko09: raises $1.50 to $2.50
hammerwife: folds 
djammusic: folds 
Dachish: calls $1.50
*** FLOP *** [2s 3h 9s]
Dachish: checks 
matiko09: bets $3.41
Dachish: folds 
Uncalled bet ($3.41) returned to matiko09
matiko09 collected $5.25 from pot
matiko09: doesn't show hand 
*** SUMMARY ***
Total pot $5.50 | Rake $0.25 
Board [2s 3h 9s]
Seat 3: gabi_igna folded before Flop (didn't bet)
Seat 5: matiko09 collected ($5.25)
Seat 6: hammerwife (button) folded before Flop (didn't bet)
Seat 7: djammusic (small blind) folded before Flop
Seat 8: Dachish (big blind) folded on the Flop





PokerStars Hand #150706218939:  Hold'em No Limit ($0.50/$1.00 USD) - 2016/03/21 16:31:23 CET [2016/03/21 11:31:23 ET]
Table 'Genoveva II' 9-max Seat #1 is the button
Seat 1: RICKA16 ($151.75 in chips) 
Seat 2: Ez1kelL ($42.16 in chips) 
Seat 3: sanpidk ($100 in chips) 
Seat 4: aseban11 ($100 in chips) 
Seat 5: volwebni4ek ($45.44 in chips) 
Seat 6: Pacifistas ($104.04 in chips) 
Seat 7: Robert201202 ($127.40 in chips) 
Seat 8: R1aki ($116.06 in chips) 
Seat 9: matiko09 ($100.23 in chips) 
Ez1kelL: posts small blind $0.50
sanpidk: posts big blind $1
*** HOLE CARDS ***
Dealt to matiko09 [9h Tc]
aseban11: folds 
volwebni4ek: folds 
Pacifistas: folds 
Robert201202: folds 
R1aki: folds 
matiko09: folds 
RICKA16: folds 
Ez1kelL: folds 
Uncalled bet ($0.50) returned to sanpidk
sanpidk collected $1 from pot
sanpidk: doesn't show hand 
*** SUMMARY ***
Total pot $1 | Rake $0 
Seat 1: RICKA16 (button) folded before Flop (didn't bet)
Seat 2: Ez1kelL (small blind) folded before Flop
Seat 3: sanpidk (big blind) collected ($1)
Seat 4: aseban11 folded before Flop (didn't bet)
Seat 5: volwebni4ek folded before Flop (didn't bet)
Seat 6: Pacifistas folded before Flop (didn't bet)
Seat 7: Robert201202 folded before Flop (didn't bet)
Seat 8: R1aki folded before Flop (didn't bet)
Seat 9: matiko09 folded before Flop (didn't bet)





PokerStars Hand #150706231469:  Hold'em No Limit ($0.50/$1.00 USD) - 2016/03/21 16:31:41 CET [2016/03/21 11:31:41 ET]
Table 'Onnie II' 9-max Seat #1 is the button
Seat 1: aseban11 ($159.12 in chips) 
Seat 2: RICKA16 ($102.07 in chips) 
Seat 3: cn_chayanne ($101.50 in chips) 
Seat 4: Bothfeld11 ($80.86 in chips) 
Seat 5: roninio1 ($75.25 in chips) 
Seat 6: Pacifistas ($102.66 in chips) 
Seat 7: djammusic ($73.58 in chips) 
Seat 8: solbi86 ($100.62 in chips) 
Seat 9: matiko09 ($116.12 in chips) 
RICKA16: posts small blind $0.50
cn_chayanne: posts big blind $1
*** HOLE CARDS ***
Dealt to matiko09 [2d 5c]
Bothfeld11: folds 
roninio1: folds 
Pacifistas: folds 
djammusic: folds 
solbi86: folds 
matiko09: folds 
aseban11: folds 
RICKA16: raises $2 to $3
cn_chayanne: folds 
Uncalled bet ($2) returned to RICKA16
RICKA16 collected $2 from pot
RICKA16: doesn't show hand 
*** SUMMARY ***
Total pot $2 | Rake $0 
Seat 1: aseban11 (button) folded before Flop (didn't bet)
Seat 2: RICKA16 (small blind) collected ($2)
Seat 3: cn_chayanne (big blind) folded before Flop
Seat 4: Bothfeld11 folded before Flop (didn't bet)
Seat 5: roninio1 folded before Flop (didn't bet)
Seat 6: Pacifistas folded before Flop (didn't bet)
Seat 7: djammusic folded before Flop (didn't bet)
Seat 8: solbi86 folded before Flop (didn't bet)
Seat 9: matiko09 folded before Flop (didn't bet)





PokerStars Hand #150706237189:  Hold'em No Limit ($0.50/$1.00 USD) - 2016/03/21 16:31:48 CET [2016/03/21 11:31:48 ET]
Table 'Genoveva II' 9-max Seat #2 is the button
Seat 1: RICKA16 ($151.75 in chips) 
Seat 2: Ez1kelL ($41.66 in chips) 
Seat 3: sanpidk ($100.50 in chips) 
Seat 4: aseban11 ($100 in chips) 
Seat 5: volwebni4ek ($45.44 in chips) 
Seat 6: Pacifistas ($104.04 in chips) 
Seat 7: Robert201202 ($127.40 in chips) 
Seat 8: R1aki ($116.06 in chips) 
Seat 9: matiko09 ($100.23 in chips) 
sanpidk: posts small blind $0.50
aseban11: posts big blind $1
*** HOLE CARDS ***
Dealt to matiko09 [Jc 6c]
volwebni4ek: folds 
Pacifistas: folds 
Robert201202: folds 
R1aki: folds 
matiko09: folds 
RICKA16: folds 
Ez1kelL: folds 
sanpidk: folds 
Uncalled bet ($0.50) returned to aseban11
aseban11 collected $1 from pot
aseban11: doesn't show hand 
*** SUMMARY ***
Total pot $1 | Rake $0 
Seat 1: RICKA16 folded before Flop (didn't bet)
Seat 2: Ez1kelL (button) folded before Flop (didn't bet)
Seat 3: sanpidk (small blind) folded before Flop
Seat 4: aseban11 (big blind) collected ($1)
Seat 5: volwebni4ek folded before Flop (didn't bet)
Seat 6: Pacifistas folded before Flop (didn't bet)
Seat 7: Robert201202 folded before Flop (didn't bet)
Seat 8: R1aki folded before Flop (didn't bet)
Seat 9: matiko09 folded before Flop (didn't bet)





PokerStars Hand #150706250073:  Hold'em No Limit ($0.50/$1.00 USD) - 2016/03/21 16:32:06 CET [2016/03/21 11:32:06 ET]
Table 'Noel' 9-max Seat #7 is the button
Seat 3: gabi_igna ($225.84 in chips) 
Seat 4: Kobiroga150 ($50 in chips) 
Seat 5: matiko09 ($104.25 in chips) 
Seat 6: hammerwife ($100 in chips) 
Seat 7: djammusic ($38.70 in chips) 
Seat 8: Dachish ($67.50 in chips) 
Seat 9: grifkaaa ($100 in chips) 
Dachish: posts small blind $0.50
grifkaaa: posts big blind $1
cobrik23: sits out 
Kobiroga150: posts big blind $1
*** HOLE CARDS ***
Dealt to matiko09 [9s Ad]
gabi_igna: folds 
Kobiroga150: checks 
matiko09: raises $3 to $4
hammerwife: folds 
djammusic: folds 
Dachish: folds 
grifkaaa: folds 
Kobiroga150: folds 
Uncalled bet ($3) returned to matiko09
matiko09 collected $3.50 from pot
matiko09: doesn't show hand 
*** SUMMARY ***
Total pot $3.50 | Rake $0 
Seat 3: gabi_igna folded before Flop (didn't bet)
Seat 4: Kobiroga150 folded before Flop
Seat 5: matiko09 collected ($3.50)
Seat 6: hammerwife folded before Flop (didn't bet)
Seat 7: djammusic (button) folded before Flop (didn't bet)
Seat 8: Dachish (small blind) folded before Flop
Seat 9: grifkaaa (big blind) folded before Flop





PokerStars Hand #150706256162:  Hold'em No Limit (€0.50/€1.00 EUR) - 2016/03/21 16:32:14 CET [2016/03/21 11:32:14 ET]
Table 'Anhui' 9-max Seat #4 is the button
Seat 1: Pacifistas (€100 in chips) 
Seat 2: R1aki (€100 in chips) 
Seat 3: matiko09 (€100 in chips) 
Seat 4: stds st (€38.50 in chips) 
Seat 5: cobrik23 (€99 in chips) 
Seat 6: Muinmyheart (€100 in chips) 
Seat 9: Snoopy797 (€96.78 in chips) 
cobrik23: posts small blind €0.50
Muinmyheart: posts big blind €1
aseban11: sits out 
volwebni4ek: sits out 
*** HOLE CARDS ***
Dealt to matiko09 [3c Tc]
Snoopy797: folds 
Pacifistas: folds 
R1aki: folds 
matiko09: folds 
stds st: folds 
cobrik23: folds 
Uncalled bet (€0.50) returned to Muinmyheart
Muinmyheart collected €1 from pot
Muinmyheart: doesn't show hand 
*** SUMMARY ***
Total pot €1 | Rake €0 
Seat 1: Pacifistas folded before Flop (didn't bet)
Seat 2: R1aki folded before Flop (didn't bet)
Seat 3: matiko09 folded before Flop (didn't bet)
Seat 4: stds st (button) folded before Flop (didn't bet)
Seat 5: cobrik23 (small blind) folded before Flop
Seat 6: Muinmyheart (big blind) collected (€1)
Seat 9: Snoopy797 folded before Flop (didn't bet)





PokerStars Hand #150706256750:  Hold'em No Limit ($0.50/$1.00 USD) - 2016/03/21 16:32:15 CET [2016/03/21 11:32:15 ET]
Table 'Onnie II' 9-max Seat #2 is the button
Seat 1: aseban11 ($159.12 in chips) 
Seat 2: RICKA16 ($103.07 in chips) 
Seat 3: cn_chayanne ($100.50 in chips) 
Seat 4: Bothfeld11 ($80.86 in chips) 
Seat 5: roninio1 ($75.25 in chips) 
Seat 6: Pacifistas ($102.66 in chips) 
Seat 7: djammusic ($73.58 in chips) 
Seat 8: solbi86 ($100.62 in chips) 
Seat 9: matiko09 ($116.12 in chips) 
cn_chayanne: posts small blind $0.50
Bothfeld11: posts big blind $1
*** HOLE CARDS ***
Dealt to matiko09 [4h 8s]
roninio1: calls $1
Pacifistas: folds 
djammusic: folds 
solbi86: folds 
matiko09: folds 
aseban11: raises $3.50 to $4.50
RICKA16: folds 
cn_chayanne: folds 
Bothfeld11: folds 
roninio1: calls $3.50
*** FLOP *** [5d Qd 8d]
roninio1: checks 
aseban11: bets $7.52
roninio1: calls $7.52
*** TURN *** [5d Qd 8d] [Qh]
roninio1: checks 
aseban11: bets $24.39
roninio1: calls $24.39
*** RIVER *** [5d Qd 8d Qh] [7c]
roninio1: checks 
aseban11: bets $53.64
roninio1: folds 
Uncalled bet ($53.64) returned to aseban11
aseban11 collected $71.52 from pot
aseban11: doesn't show hand 
*** SUMMARY ***
Total pot $74.32 | Rake $2.80 
Board [5d Qd 8d Qh 7c]
Seat 1: aseban11 collected ($71.52)
Seat 2: RICKA16 (button) folded before Flop (didn't bet)
Seat 3: cn_chayanne (small blind) folded before Flop
Seat 4: Bothfeld11 (big blind) folded before Flop
Seat 5: roninio1 folded on the River
Seat 6: Pacifistas folded before Flop (didn't bet)
Seat 7: djammusic folded before Flop (didn't bet)
Seat 8: solbi86 folded before Flop (didn't bet)
Seat 9: matiko09 folded before Flop (didn't bet)





PokerStars Hand #150706258650:  Hold'em No Limit ($0.50/$1.00 USD) - 2016/03/21 16:32:18 CET [2016/03/21 11:32:18 ET]
Table 'Gondola II' 9-max Seat #7 is the button
Seat 1: matiko09 ($105.14 in chips) 
Seat 2: R1aki ($113.60 in chips) 
Seat 3: flk.Dasas ($117.99 in chips) 
Seat 4: aseban11 ($100 in chips) 
Seat 5: teukka8 ($67.59 in chips) 
Seat 6: SanychStar ($106 in chips) 
Seat 7: Pacifistas ($100 in chips) 
Seat 8: cn_chayanne ($100 in chips) 
cn_chayanne: posts small blind $0.50
djammusic: is sitting out 
matiko09: posts big blind $1
*** HOLE CARDS ***
Dealt to matiko09 [2s 4d]
R1aki: folds 
flk.Dasas: folds 
aseban11: folds 
teukka8: raises $1 to $2
SanychStar: folds 
Pacifistas: folds 
cn_chayanne: calls $1.50
matiko09: folds 
*** FLOP *** [Td Qc 2c]
cn_chayanne: checks 
teukka8: bets $2
cn_chayanne: folds 
Uncalled bet ($2) returned to teukka8
teukka8 collected $4.78 from pot
teukka8: doesn't show hand 
*** SUMMARY ***
Total pot $5 | Rake $0.22 
Board [Td Qc 2c]
Seat 1: matiko09 (big blind) folded before Flop
Seat 2: R1aki folded before Flop (didn't bet)
Seat 3: flk.Dasas folded before Flop (didn't bet)
Seat 4: aseban11 folded before Flop (didn't bet)
Seat 5: teukka8 collected ($4.78)
Seat 6: SanychStar folded before Flop (didn't bet)
Seat 7: Pacifistas (button) folded before Flop (didn't bet)
Seat 8: cn_chayanne (small blind) folded on the Flop





PokerStars Hand #150706272559:  Hold'em No Limit ($0.50/$1.00 USD) - 2016/03/21 16:32:37 CET [2016/03/21 11:32:37 ET]
Table 'Genoveva II' 9-max Seat #3 is the button
Seat 1: RICKA16 ($151.75 in chips) 
Seat 2: Ez1kelL ($41.66 in chips) 
Seat 3: sanpidk ($100 in chips) 
Seat 4: aseban11 ($100.50 in chips) 
Seat 5: volwebni4ek ($45.44 in chips) 
Seat 6: Pacifistas ($104.04 in chips) 
Seat 7: Robert201202 ($127.40 in chips) 
Seat 8: R1aki ($116.06 in chips) 
Seat 9: matiko09 ($100.23 in chips) 
aseban11: posts small blind $0.50
volwebni4ek: posts big blind $1
*** HOLE CARDS ***
Dealt to matiko09 [5c 2s]
Pacifistas: folds 
Robert201202: folds 
R1aki: folds 
matiko09: folds 
RICKA16: folds 
Ez1kelL: raises $1.50 to $2.50
sanpidk: calls $2.50
aseban11: folds 
volwebni4ek: folds 
*** FLOP *** [Th Qs 4h]
Ez1kelL: checks 
sanpidk: bets $4
Ez1kelL: calls $4
*** TURN *** [Th Qs 4h] [3d]
Ez1kelL: checks 
sanpidk: bets $9.50
Ez1kelL: calls $9.50
*** RIVER *** [Th Qs 4h 3d] [6c]
Ez1kelL: checks 
sanpidk: bets $19
Ez1kelL: folds 
Uncalled bet ($19) returned to sanpidk
sanpidk collected $31.99 from pot
sanpidk: doesn't show hand 
*** SUMMARY ***
Total pot $33.50 | Rake $1.51 
Board [Th Qs 4h 3d 6c]
Seat 1: RICKA16 folded before Flop (didn't bet)
Seat 2: Ez1kelL folded on the River
Seat 3: sanpidk (button) collected ($31.99)
Seat 4: aseban11 (small blind) folded before Flop
Seat 5: volwebni4ek (big blind) folded before Flop
Seat 6: Pacifistas folded before Flop (didn't bet)
Seat 7: Robert201202 folded before Flop (didn't bet)
Seat 8: R1aki folded before Flop (didn't bet)
Seat 9: matiko09 folded before Flop (didn't bet)





PokerStars Hand #150706282670:  Hold'em No Limit ($0.50/$1.00 USD) - 2016/03/21 16:32:51 CET [2016/03/21 11:32:51 ET]
Table 'Noel' 9-max Seat #8 is the button
Seat 2: cobrik23 ($180.90 in chips) 
Seat 3: gabi_igna ($225.84 in chips) 
Seat 4: Kobiroga150 ($49 in chips) 
Seat 5: matiko09 ($106.75 in chips) 
Seat 6: hammerwife ($100 in chips) 
Seat 7: djammusic ($38.70 in chips) 
Seat 8: Dachish ($67 in chips) 
Seat 9: grifkaaa ($100 in chips) 
grifkaaa: posts small blind $0.50
cobrik23: posts big blind $1
*** HOLE CARDS ***
Dealt to matiko09 [2s 6s]
gabi_igna: raises $2 to $3
Kobiroga150: calls $3
matiko09: folds 
hammerwife: folds 
djammusic: folds 
Dachish: folds 
grifkaaa: folds 
cobrik23: folds 
*** FLOP *** [3h Jh 4d]
gabi_igna: bets $5
Kobiroga150: calls $5
*** TURN *** [3h Jh 4d] [Tc]
gabi_igna: bets $12
Kobiroga150: raises $29 to $41 and is all-in
gabi_igna: calls $29
*** RIVER *** [3h Jh 4d Tc] [Jd]
*** SHOW DOWN ***
gabi_igna: shows [9h 8h] (a pair of Jacks)
Kobiroga150: shows [Ts Td] (a full house, Tens full of Jacks)
Kobiroga150 collected $96.70 from pot
*** SUMMARY ***
Total pot $99.50 | Rake $2.80 
Board [3h Jh 4d Tc Jd]
Seat 2: cobrik23 (big blind) folded before Flop
Seat 3: gabi_igna showed [9h 8h] and lost with a pair of Jacks
Seat 4: Kobiroga150 showed [Ts Td] and won ($96.70) with a full house, Tens full of Jacks
Seat 5: matiko09 folded before Flop (didn't bet)
Seat 6: hammerwife folded before Flop (didn't bet)
Seat 7: djammusic folded before Flop (didn't bet)
Seat 8: Dachish (button) folded before Flop (didn't bet)
Seat 9: grifkaaa (small blind) folded before Flop





PokerStars Hand #150706285330:  Hold'em No Limit (€0.50/€1.00 EUR) - 2016/03/21 16:32:55 CET [2016/03/21 11:32:55 ET]
Table 'Anhui' 9-max Seat #5 is the button
Seat 1: Pacifistas (€100 in chips) 
Seat 2: R1aki (€100 in chips) 
Seat 3: matiko09 (€100 in chips) 
Seat 4: stds st (€38.50 in chips) 
Seat 5: cobrik23 (€98.50 in chips) 
Seat 6: Muinmyheart (€100.50 in chips) 
Seat 7: aseban11 (€100 in chips) 
Seat 9: Snoopy797 (€96.78 in chips) 
Muinmyheart: posts small blind €0.50
aseban11: posts big blind €1
volwebni4ek: sits out 
*** HOLE CARDS ***
Dealt to matiko09 [4d Qc]
Snoopy797: calls €1
Pacifistas: folds 
R1aki: folds 
matiko09: folds 
stds st: folds 
cobrik23: raises €3 to €4
Muinmyheart: folds 
aseban11: folds 
Snoopy797: calls €3
*** FLOP *** [Tc Td 6d]
Snoopy797: checks 
cobrik23: checks 
*** TURN *** [Tc Td 6d] [Ts]
Snoopy797: checks 
cobrik23: checks 
*** RIVER *** [Tc Td 6d Ts] [6s]
Snoopy797: checks 
cobrik23: bets €10
Snoopy797: calls €10
*** SHOW DOWN ***
cobrik23: shows [Kd Qh] (a full house, Tens full of Sixes)
Snoopy797: shows [5c 9c] (a full house, Tens full of Sixes)
Snoopy797 collected €14.09 from pot
cobrik23 collected €14.08 from pot
*** SUMMARY ***
Total pot €29.50 | Rake €1.33 
Board [Tc Td 6d Ts 6s]
Seat 1: Pacifistas folded before Flop (didn't bet)
Seat 2: R1aki folded before Flop (didn't bet)
Seat 3: matiko09 folded before Flop (didn't bet)
Seat 4: stds st folded before Flop (didn't bet)
Seat 5: cobrik23 (button) showed [Kd Qh] and won (€14.08) with a full house, Tens full of Sixes
Seat 6: Muinmyheart (small blind) folded before Flop
Seat 7: aseban11 (big blind) folded before Flop
Seat 9: Snoopy797 showed [5c 9c] and won (€14.09) with a full house, Tens full of Sixes





PokerStars Hand #150706286854:  Hold'em No Limit ($0.50/$1.00 USD) - 2016/03/21 16:32:57 CET [2016/03/21 11:32:57 ET]
Table 'Toutatis II' 9-max Seat #1 is the button
Seat 1: Linghem ($100 in chips) 
Seat 2: matiko09 ($100 in chips) 
Linghem: posts small blind $0.50
runner10 joins the table at seat #6 
matiko09: posts big blind $1
*** HOLE CARDS ***
Dealt to matiko09 [Ts Qs]
Pacifistas joins the table at seat #7 
R1aki joins the table at seat #3 
cn_chayanne joins the table at seat #4 
Linghem: raises $1 to $2
matiko09: calls $1
*** FLOP *** [7d 2s 5h]
matiko09: bets $2.48
Linghem: calls $2.48
*** TURN *** [7d 2s 5h] [5c]
Dachish joins the table at seat #8 
matiko09: checks 
Linghem: checks 
*** RIVER *** [7d 2s 5h 5c] [Kh]
B@ngel joins the table at seat #9 
matiko09: checks 
Linghem: bets $4.28
matiko09: folds 
Uncalled bet ($4.28) returned to Linghem
Linghem collected $8.56 from pot
Linghem: doesn't show hand 
*** SUMMARY ***
Total pot $8.96 | Rake $0.40 
Board [7d 2s 5h 5c Kh]
Seat 1: Linghem (button) (small blind) collected ($8.56)
Seat 2: matiko09 (big blind) folded on the River





PokerStars Hand #150706289743:  Hold'em No Limit ($0.50/$1.00 USD) - 2016/03/21 16:33:01 CET [2016/03/21 11:33:01 ET]
Table 'Gondola II' 9-max Seat #8 is the button
Seat 1: matiko09 ($104.14 in chips) 
Seat 2: R1aki ($113.60 in chips) 
Seat 3: flk.Dasas ($117.99 in chips) 
Seat 4: aseban11 ($100 in chips) 
Seat 5: teukka8 ($70.37 in chips) 
Seat 6: SanychStar ($106 in chips) 
Seat 7: Pacifistas ($100 in chips) 
Seat 8: cn_chayanne ($100 in chips) 
djammusic will be allowed to play after the button
matiko09: posts small blind $0.50
R1aki: posts big blind $1
*** HOLE CARDS ***
Dealt to matiko09 [Qs 7d]
flk.Dasas: folds 
aseban11: folds 
teukka8: folds 
SanychStar: folds 
Pacifistas: folds 
cn_chayanne: raises $1.50 to $2.50
matiko09: folds 
R1aki: folds 
Uncalled bet ($1.50) returned to cn_chayanne
cn_chayanne collected $2.50 from pot
cn_chayanne: doesn't show hand 
*** SUMMARY ***
Total pot $2.50 | Rake $0 
Seat 1: matiko09 (small blind) folded before Flop
Seat 2: R1aki (big blind) folded before Flop
Seat 3: flk.Dasas folded before Flop (didn't bet)
Seat 4: aseban11 folded before Flop (didn't bet)
Seat 5: teukka8 folded before Flop (didn't bet)
Seat 6: SanychStar folded before Flop (didn't bet)
Seat 7: Pacifistas folded before Flop (didn't bet)
Seat 8: cn_chayanne (button) collected ($2.50)





PokerStars Hand #150706291031:  Hold'em No Limit ($0.50/$1.00 USD) - 2016/03/21 16:33:02 CET [2016/03/21 11:33:02 ET]
Table 'Onnie II' 9-max Seat #3 is the button
Seat 1: aseban11 ($194.23 in chips) 
Seat 2: RICKA16 ($103.07 in chips) 
Seat 3: cn_chayanne ($100 in chips) 
Seat 4: Bothfeld11 ($79.86 in chips) 
Seat 5: roninio1 ($38.84 in chips) 
Seat 6: Pacifistas ($102.66 in chips) 
Seat 7: djammusic ($73.58 in chips) 
Seat 8: solbi86 ($100.62 in chips) 
Seat 9: matiko09 ($116.12 in chips) 
Bothfeld11: posts small blind $0.50
roninio1: posts big blind $1
*** HOLE CARDS ***
Dealt to matiko09 [6h Qc]
Pacifistas: raises $2 to $3
djammusic: folds 
solbi86: folds 
matiko09: folds 
aseban11: folds 
RICKA16: folds 
cn_chayanne: folds 
Bothfeld11: folds 
roninio1: raises $35.84 to $38.84 and is all-in
Pacifistas: calls $35.84
*** FIRST FLOP *** [6c 4s Kd]
*** FIRST TURN *** [6c 4s Kd] [4h]
*** FIRST RIVER *** [6c 4s Kd 4h] [Jc]
*** SECOND FLOP *** [8c Ad 5d]
*** SECOND TURN *** [8c Ad 5d] [5s]
*** SECOND RIVER *** [8c Ad 5d 5s] [Ah]
*** FIRST SHOW DOWN ***
roninio1: shows [2c 5h] (a pair of Fours)
Pacifistas: shows [Th Ts] (two pair, Tens and Fours)
Pacifistas collected $37.69 from pot
*** SECOND SHOW DOWN ***
roninio1: shows [2c 5h] (a full house, Fives full of Aces)
Pacifistas: shows [Th Ts] (two pair, Aces and Tens)
roninio1 collected $37.69 from pot
*** SUMMARY ***
Total pot $78.18 | Rake $2.80 
Hand was run twice
FIRST Board [6c 4s Kd 4h Jc]
SECOND Board [8c Ad 5d 5s Ah]
Seat 1: aseban11 folded before Flop (didn't bet)
Seat 2: RICKA16 folded before Flop (didn't bet)
Seat 3: cn_chayanne (button) folded before Flop (didn't bet)
Seat 4: Bothfeld11 (small blind) folded before Flop
Seat 5: roninio1 (big blind) showed [2c 5h] and lost with a pair of Fours, and won ($37.69) with a full house, Fives full of Aces
Seat 6: Pacifistas showed [Th Ts] and won ($37.69) with two pair, Tens and Fours, and lost with two pair, Aces and Tens
Seat 7: djammusic folded before Flop (didn't bet)
Seat 8: solbi86 folded before Flop (didn't bet)
Seat 9: matiko09 folded before Flop (didn't bet)





PokerStars Hand #150706292309:  Hold'em No Limit ($0.50/$1.00 USD) - 2016/03/21 16:33:04 CET [2016/03/21 11:33:04 ET]
Table 'Massalia II' 9-max Seat #5 is the button
Seat 1: crepke ($77.30 in chips) 
Seat 2: solbi86 ($100 in chips) 
Seat 3: 123chambo ($99.80 in chips) 
Seat 4: OriginalTony ($119.70 in chips) 
Seat 5: roninio1 ($100 in chips) 
Seat 6: Pacifistas ($114.84 in chips) 
Seat 7: flk.Dasas ($100 in chips) 
Seat 8: matiko09 ($200.90 in chips) 
Seat 9: R1aki ($100 in chips) 
Pacifistas: posts small blind $0.50
flk.Dasas: posts big blind $1
crepke: posts the ante $0.20
solbi86: posts the ante $0.20
123chambo: posts the ante $0.20
OriginalTony: posts the ante $0.20
roninio1: posts the ante $0.20
Pacifistas: posts the ante $0.20
flk.Dasas: posts the ante $0.20
matiko09: posts the ante $0.20
R1aki: posts the ante $0.20
*** HOLE CARDS ***
Dealt to matiko09 [3d Qd]
matiko09: folds 
R1aki: folds 
crepke: folds 
solbi86: raises $2 to $3
123chambo: folds 
OriginalTony: folds 
roninio1: folds 
Pacifistas: folds 
flk.Dasas: folds 
Uncalled bet ($2) returned to solbi86
solbi86 collected $4.30 from pot
solbi86: doesn't show hand 
*** SUMMARY ***
Total pot $4.30 | Rake $0 
Seat 1: crepke folded before Flop (didn't bet)
Seat 2: solbi86 collected ($4.30)
Seat 3: 123chambo folded before Flop (didn't bet)
Seat 4: OriginalTony folded before Flop (didn't bet)
Seat 5: roninio1 (button) folded before Flop (didn't bet)
Seat 6: Pacifistas (small blind) folded before Flop
Seat 7: flk.Dasas (big blind) folded before Flop
Seat 8: matiko09 folded before Flop (didn't bet)
Seat 9: R1aki folded before Flop (didn't bet)





PokerStars Hand #150706307343:  Hold'em No Limit ($0.50/$1.00 USD) - 2016/03/21 16:33:25 CET [2016/03/21 11:33:25 ET]
Table 'Massalia II' 9-max Seat #6 is the button
Seat 1: crepke ($77.10 in chips) 
Seat 2: solbi86 ($103.10 in chips) 
Seat 3: 123chambo ($99.60 in chips) 
Seat 4: OriginalTony ($119.50 in chips) 
Seat 5: roninio1 ($99.80 in chips) 
Seat 6: Pacifistas ($114.14 in chips) 
Seat 7: flk.Dasas ($100 in chips) 
Seat 8: matiko09 ($200.70 in chips) 
Seat 9: R1aki ($100 in chips) 
flk.Dasas: posts small blind $0.50
matiko09: posts big blind $1
crepke: posts the ante $0.20
solbi86: posts the ante $0.20
123chambo: posts the ante $0.20
OriginalTony: posts the ante $0.20
roninio1: posts the ante $0.20
Pacifistas: posts the ante $0.20
flk.Dasas: posts the ante $0.20
matiko09: posts the ante $0.20
R1aki: posts the ante $0.20
*** HOLE CARDS ***
Dealt to matiko09 [Ah Td]
R1aki: folds 
crepke: folds 
solbi86: folds 
123chambo: folds 
OriginalTony: folds 
roninio1: raises $2 to $3
Pacifistas: folds 
flk.Dasas: folds 
matiko09: folds 
Uncalled bet ($2) returned to roninio1
roninio1 collected $4.30 from pot
roninio1: doesn't show hand 
*** SUMMARY ***
Total pot $4.30 | Rake $0 
Seat 1: crepke folded before Flop (didn't bet)
Seat 2: solbi86 folded before Flop (didn't bet)
Seat 3: 123chambo folded before Flop (didn't bet)
Seat 4: OriginalTony folded before Flop (didn't bet)
Seat 5: roninio1 collected ($4.30)
Seat 6: Pacifistas (button) folded before Flop (didn't bet)
Seat 7: flk.Dasas (small blind) folded before Flop
Seat 8: matiko09 (big blind) folded before Flop
Seat 9: R1aki folded before Flop (didn't bet)





PokerStars Hand #150706310354:  Hold'em No Limit ($0.50/$1.00 USD) - 2016/03/21 16:33:29 CET [2016/03/21 11:33:29 ET]
Table 'Toutatis II' 9-max Seat #1 is the button
Seat 1: Linghem ($104.08 in chips) 
Seat 2: matiko09 ($100 in chips) 
Seat 3: R1aki ($100 in chips) 
Seat 6: runner10 ($40 in chips) 
matiko09: posts small blind $0.50
R1aki: posts big blind $1
cn_chayanne: sits out 
aseban11: sits out 
runner10: posts big blind $1
Pacifistas: sits out 
Dachish: sits out 
B@ngel: sits out 
*** HOLE CARDS ***
Dealt to matiko09 [7c 8d]
runner10: checks 
Linghem: folds 
matiko09: folds 
R1aki: checks 
*** FLOP *** [3c Qd 5c]
R1aki: checks 
runner10: bets $1.19
R1aki: folds 
Uncalled bet ($1.19) returned to runner10
runner10 collected $2.39 from pot
runner10: doesn't show hand 
*** SUMMARY ***
Total pot $2.50 | Rake $0.11 
Board [3c Qd 5c]
Seat 1: Linghem (button) folded before Flop (didn't bet)
Seat 2: matiko09 (small blind) folded before Flop
Seat 3: R1aki (big blind) folded on the Flop
Seat 6: runner10 collected ($2.39)





PokerStars Hand #150706325630:  Hold'em No Limit ($0.50/$1.00 USD) - 2016/03/21 16:33:50 CET [2016/03/21 11:33:50 ET]
Table 'Gondola II' 9-max Seat #1 is the button
Seat 1: matiko09 ($103.64 in chips) 
Seat 2: R1aki ($112.60 in chips) 
Seat 3: flk.Dasas ($117.99 in chips) 
Seat 4: aseban11 ($100 in chips) 
Seat 5: teukka8 ($70.37 in chips) 
Seat 6: SanychStar ($106 in chips) 
Seat 7: Pacifistas ($100 in chips) 
Seat 8: cn_chayanne ($101.50 in chips) 
R1aki: posts small blind $0.50
flk.Dasas: posts big blind $1
djammusic: sits out 
*** HOLE CARDS ***
Dealt to matiko09 [8d 4h]
aseban11: folds 
teukka8: calls $1
SanychStar: raises $2.50 to $3.50
Pacifistas: folds 
cn_chayanne: folds 
matiko09: folds 
R1aki: calls $3
flk.Dasas: calls $2.50
teukka8: calls $2.50
*** FLOP *** [5s 5c As]
R1aki: checks 
flk.Dasas: checks 
teukka8: checks 
SanychStar: bets $8
R1aki: folds 
flk.Dasas: folds 
teukka8: folds 
Uncalled bet ($8) returned to SanychStar
SanychStar collected $13.37 from pot
*** SUMMARY ***
Total pot $14 | Rake $0.63 
Board [5s 5c As]
Seat 1: matiko09 (button) folded before Flop (didn't bet)
Seat 2: R1aki (small blind) folded on the Flop
Seat 3: flk.Dasas (big blind) folded on the Flop
Seat 4: aseban11 folded before Flop (didn't bet)
Seat 5: teukka8 folded on the Flop
Seat 6: SanychStar collected ($13.37)
Seat 7: Pacifistas folded before Flop (didn't bet)
Seat 8: cn_chayanne folded before Flop (didn't bet)





PokerStars Hand #150706326374:  Hold'em No Limit ($0.50/$1.00 USD) - 2016/03/21 16:33:51 CET [2016/03/21 11:33:51 ET]
Table 'Massalia II' 9-max Seat #7 is the button
Seat 1: crepke ($76.90 in chips) 
Seat 2: solbi86 ($102.90 in chips) 
Seat 3: 123chambo ($99.40 in chips) 
Seat 4: OriginalTony ($119.30 in chips) 
Seat 5: roninio1 ($102.90 in chips) 
Seat 6: Pacifistas ($113.94 in chips) 
Seat 7: flk.Dasas ($100 in chips) 
Seat 8: matiko09 ($199.50 in chips) 
Seat 9: R1aki ($100 in chips) 
matiko09: posts small blind $0.50
R1aki: posts big blind $1
crepke: posts the ante $0.20
solbi86: posts the ante $0.20
123chambo: posts the ante $0.20
OriginalTony: posts the ante $0.20
roninio1: posts the ante $0.20
Pacifistas: posts the ante $0.20
flk.Dasas: posts the ante $0.20
matiko09: posts the ante $0.20
R1aki: posts the ante $0.20
*** HOLE CARDS ***
Dealt to matiko09 [3c 4s]
crepke: raises $2 to $3
solbi86: folds 
123chambo: folds 
OriginalTony: folds 
roninio1 is disconnected 
roninio1 has timed out while disconnected
roninio1: folds 
Pacifistas: folds 
flk.Dasas: calls $3
matiko09: folds 
R1aki: folds 
*** FLOP *** [8d Ad 6d]
crepke: bets $4
flk.Dasas: calls $4
*** TURN *** [8d Ad 6d] [5c]
crepke: bets $8
flk.Dasas: folds 
Uncalled bet ($8) returned to crepke
crepke collected $16.52 from pot
crepke: doesn't show hand 
*** SUMMARY ***
Total pot $17.30 | Rake $0.78 
Board [8d Ad 6d 5c]
Seat 1: crepke collected ($16.52)
Seat 2: solbi86 folded before Flop (didn't bet)
Seat 3: 123chambo folded before Flop (didn't bet)
Seat 4: OriginalTony folded before Flop (didn't bet)
Seat 5: roninio1 folded before Flop (didn't bet)
Seat 6: Pacifistas folded before Flop (didn't bet)
Seat 7: flk.Dasas (button) folded on the Turn
Seat 8: matiko09 (small blind) folded before Flop
Seat 9: R1aki (big blind) folded before Flop





PokerStars Hand #150706328033:  Hold'em No Limit ($0.50/$1.00 USD) - 2016/03/21 16:33:53 CET [2016/03/21 11:33:53 ET]
Table 'Toutatis II' 9-max Seat #2 is the button
Seat 1: Linghem ($104.08 in chips) 
Seat 2: matiko09 ($100 in chips) 
Seat 3: R1aki ($100 in chips) 
Seat 4: cn_chayanne ($100 in chips) 
Seat 6: runner10 ($41.39 in chips) 
R1aki: posts small blind $0.50
cn_chayanne: posts big blind $1
aseban11: sits out 
Pacifistas: sits out 
Dachish: sits out 
B@ngel: sits out 
*** HOLE CARDS ***
Dealt to matiko09 [7h Ks]
runner10: raises $2 to $3
Linghem: folds 
matiko09: folds 
R1aki: folds 
cn_chayanne: calls $2
*** FLOP *** [2c 7c 9h]
cn_chayanne: checks 
runner10: bets $5
cn_chayanne: folds 
Uncalled bet ($5) returned to runner10
runner10 collected $6.21 from pot
runner10: doesn't show hand 
*** SUMMARY ***
Total pot $6.50 | Rake $0.29 
Board [2c 7c 9h]
Seat 1: Linghem folded before Flop (didn't bet)
Seat 2: matiko09 (button) folded before Flop (didn't bet)
Seat 3: R1aki (small blind) folded before Flop
Seat 4: cn_chayanne (big blind) folded on the Flop
Seat 6: runner10 collected ($6.21)





PokerStars Hand #150706334427:  Hold'em No Limit ($0.50/$1.00 USD) - 2016/03/21 16:34:02 CET [2016/03/21 11:34:02 ET]
Table 'Noel' 9-max Seat #9 is the button
Seat 2: cobrik23 ($179.90 in chips) 
Seat 4: Kobiroga150 ($96.70 in chips) 
Seat 5: matiko09 ($106.75 in chips) 
Seat 6: hammerwife ($100 in chips) 
Seat 7: djammusic ($38.70 in chips) 
Seat 8: Dachish ($67 in chips) 
Seat 9: grifkaaa ($100 in chips) 
ep538 will be allowed to play after the button
cobrik23: posts small blind $0.50
gabi_igna: is sitting out 
Kobiroga150: posts big blind $1
*** HOLE CARDS ***
Dealt to matiko09 [Ad 9s]
matiko09: folds 
hammerwife: folds 
djammusic: raises $1.15 to $2.15
Dachish: folds 
grifkaaa: folds 
cobrik23: folds 
Kobiroga150: calls $1.15
*** FLOP *** [8h 5d 9h]
Kobiroga150: checks 
djammusic: bets $1.83
Kobiroga150: calls $1.83
*** TURN *** [8h 5d 9h] [Jc]
Kobiroga150: checks 
djammusic: checks 
*** RIVER *** [8h 5d 9h Jc] [Qs]
Kobiroga150: checks 
djammusic: checks 
*** SHOW DOWN ***
Kobiroga150: shows [8d Kd] (a pair of Eights)
djammusic: mucks hand 
Kobiroga150 collected $8.08 from pot
*** SUMMARY ***
Total pot $8.46 | Rake $0.38 
Board [8h 5d 9h Jc Qs]
Seat 2: cobrik23 (small blind) folded before Flop
Seat 4: Kobiroga150 (big blind) showed [8d Kd] and won ($8.08) with a pair of Eights
Seat 5: matiko09 folded before Flop (didn't bet)
Seat 6: hammerwife folded before Flop (didn't bet)
Seat 7: djammusic mucked [Ac 7c]
Seat 8: Dachish folded before Flop (didn't bet)
Seat 9: grifkaaa (button) folded before Flop (didn't bet)





PokerStars Hand #150706335330:  Hold'em No Limit ($0.50/$1.00 USD) - 2016/03/21 16:34:03 CET [2016/03/21 11:34:03 ET]
Table 'Onnie II' 9-max Seat #4 is the button
Seat 1: aseban11 ($194.23 in chips) 
Seat 2: RICKA16 ($103.07 in chips) 
Seat 3: cn_chayanne ($100 in chips) 
Seat 4: Bothfeld11 ($79.36 in chips) 
Seat 6: Pacifistas ($101.51 in chips) 
Seat 7: djammusic ($73.58 in chips) 
Seat 8: solbi86 ($100.62 in chips) 
Seat 9: matiko09 ($116.12 in chips) 
roninio1 is disconnected 
roninio1 has timed out while disconnected
roninio1: is sitting out 
Pacifistas: posts small blind $0.50
djammusic: posts big blind $1
*** HOLE CARDS ***
Dealt to matiko09 [2h 5s]
solbi86: raises $2 to $3
matiko09: folds 
aseban11: folds 
RICKA16: folds 
cn_chayanne: folds 
Bothfeld11: calls $3
Pacifistas: folds 
djammusic: folds 
*** FLOP *** [3d Kc Ad]
solbi86: checks 
Bothfeld11: checks 
*** TURN *** [3d Kc Ad] [8c]
solbi86: checks 
Bothfeld11: checks 
*** RIVER *** [3d Kc Ad 8c] [3h]
solbi86: bets $2
Bothfeld11: calls $2
*** SHOW DOWN ***
solbi86: shows [Jh Jc] (two pair, Jacks and Threes)
Bothfeld11: mucks hand 
solbi86 collected $10.98 from pot
*** SUMMARY ***
Total pot $11.50 | Rake $0.52 
Board [3d Kc Ad 8c 3h]
Seat 1: aseban11 folded before Flop (didn't bet)
Seat 2: RICKA16 folded before Flop (didn't bet)
Seat 3: cn_chayanne folded before Flop (didn't bet)
Seat 4: Bothfeld11 (button) mucked [2d 2s]
Seat 6: Pacifistas (small blind) folded before Flop
Seat 7: djammusic (big blind) folded before Flop
Seat 8: solbi86 showed [Jh Jc] and won ($10.98) with two pair, Jacks and Threes
Seat 9: matiko09 folded before Flop (didn't bet)





PokerStars Hand #150706341747:  Hold'em No Limit ($0.50/$1.00 USD) - 2016/03/21 16:34:12 CET [2016/03/21 11:34:12 ET]
Table 'Genoveva II' 9-max Seat #4 is the button
Seat 1: RICKA16 ($151.75 in chips) 
Seat 2: Ez1kelL ($25.66 in chips) 
Seat 3: sanpidk ($115.99 in chips) 
Seat 4: aseban11 ($100 in chips) 
Seat 5: volwebni4ek ($44.44 in chips) 
Seat 6: Pacifistas ($104.04 in chips) 
Seat 7: Robert201202 ($127.40 in chips) 
Seat 8: R1aki ($116.06 in chips) 
Seat 9: matiko09 ($100.23 in chips) 
volwebni4ek: posts small blind $0.50
Pacifistas: posts big blind $1
*** HOLE CARDS ***
Dealt to matiko09 [7s 9s]
Robert201202: raises $2 to $3
R1aki: raises $6.50 to $9.50
matiko09: folds 
RICKA16: folds 
Ez1kelL: folds 
sanpidk: folds 
aseban11: folds 
volwebni4ek: folds 
Pacifistas: folds 
Robert201202: folds 
Uncalled bet ($6.50) returned to R1aki
R1aki collected $7.50 from pot
R1aki: doesn't show hand 
*** SUMMARY ***
Total pot $7.50 | Rake $0 
Seat 1: RICKA16 folded before Flop (didn't bet)
Seat 2: Ez1kelL folded before Flop (didn't bet)
Seat 3: sanpidk folded before Flop (didn't bet)
Seat 4: aseban11 (button) folded before Flop (didn't bet)
Seat 5: volwebni4ek (small blind) folded before Flop
Seat 6: Pacifistas (big blind) folded before Flop
Seat 7: Robert201202 folded before Flop
Seat 8: R1aki collected ($7.50)
Seat 9: matiko09 folded before Flop (didn't bet)





PokerStars Hand #150706348595:  Hold'em No Limit ($0.50/$1.00 USD) - 2016/03/21 16:34:21 CET [2016/03/21 11:34:21 ET]
Table 'Toutatis II' 9-max Seat #3 is the button
Seat 1: Linghem ($104.08 in chips) 
Seat 2: matiko09 ($100 in chips) 
Seat 3: R1aki ($100 in chips) 
Seat 4: cn_chayanne ($100 in chips) 
Seat 5: aseban11 ($100 in chips) 
Seat 6: runner10 ($44.60 in chips) 
cn_chayanne: posts small blind $0.50
aseban11: posts big blind $1
Pacifistas: sits out 
Dachish: sits out 
B@ngel: sits out 
*** HOLE CARDS ***
Dealt to matiko09 [Jc 2d]
runner10: raises $2 to $3
Linghem: raises $7.50 to $10.50
matiko09: folds 
R1aki: folds 
cn_chayanne: folds 
aseban11: folds 
runner10: folds 
Uncalled bet ($7.50) returned to Linghem
Linghem collected $7.50 from pot
Linghem: doesn't show hand 
*** SUMMARY ***
Total pot $7.50 | Rake $0 
Seat 1: Linghem collected ($7.50)
Seat 2: matiko09 folded before Flop (didn't bet)
Seat 3: R1aki (button) folded before Flop (didn't bet)
Seat 4: cn_chayanne (small blind) folded before Flop
Seat 5: aseban11 (big blind) folded before Flop
Seat 6: runner10 folded before Flop





PokerStars Hand #150706361395:  Hold'em No Limit (€0.50/€1.00 EUR) - 2016/03/21 16:34:39 CET [2016/03/21 11:34:39 ET]
Table 'Anhui' 9-max Seat #6 is the button
Seat 1: Pacifistas (€100 in chips) 
Seat 2: R1aki (€100 in chips) 
Seat 3: matiko09 (€100 in chips) 
Seat 4: stds st (€38.50 in chips) 
Seat 5: cobrik23 (€98.58 in chips) 
Seat 6: Muinmyheart (€100 in chips) 
Seat 7: aseban11 (€100 in chips) 
Seat 8: volwebni4ek (€51.38 in chips) 
Seat 9: Snoopy797 (€96.87 in chips) 
aseban11: posts small blind €0.50
volwebni4ek: posts big blind €1
*** HOLE CARDS ***
Dealt to matiko09 [3d 5d]
Snoopy797: folds 
Pacifistas: raises €2 to €3
R1aki: folds 
matiko09: folds 
stds st: folds 
Snoopy797 leaves the table
ffac joins the table at seat #9 
cobrik23: folds 
ffac leaves the table
Muinmyheart: folds 
aseban11: folds 
volwebni4ek: folds 
Uncalled bet (€2) returned to Pacifistas
Pacifistas collected €2.50 from pot
Pacifistas: doesn't show hand 
*** SUMMARY ***
Total pot €2.50 | Rake €0 
Seat 1: Pacifistas collected (€2.50)
Seat 2: R1aki folded before Flop (didn't bet)
Seat 3: matiko09 folded before Flop (didn't bet)
Seat 4: stds st folded before Flop (didn't bet)
Seat 5: cobrik23 folded before Flop (didn't bet)
Seat 6: Muinmyheart (button) folded before Flop (didn't bet)
Seat 7: aseban11 (small blind) folded before Flop
Seat 8: volwebni4ek (big blind) folded before Flop
Seat 9: Snoopy797 folded before Flop (didn't bet)





PokerStars Hand #150706369918:  Hold'em No Limit ($0.50/$1.00 USD) - 2016/03/21 16:34:51 CET [2016/03/21 11:34:51 ET]
Table 'Toutatis II' 9-max Seat #4 is the button
Seat 1: Linghem ($108.58 in chips) 
Seat 2: matiko09 ($100 in chips) 
Seat 3: R1aki ($100 in chips) 
Seat 4: cn_chayanne ($100 in chips) 
Seat 5: aseban11 ($100 in chips) 
Seat 6: runner10 ($41.60 in chips) 
aseban11: posts small blind $0.50
runner10: posts big blind $1
Pacifistas: sits out 
Dachish: sits out 
B@ngel: sits out 
*** HOLE CARDS ***
Dealt to matiko09 [7d 9d]
Linghem: folds 
matiko09: folds 
R1aki: folds 
cn_chayanne: raises $1.50 to $2.50
aseban11: folds 
runner10: folds 
Uncalled bet ($1.50) returned to cn_chayanne
cn_chayanne collected $2.50 from pot
cn_chayanne: doesn't show hand 
*** SUMMARY ***
Total pot $2.50 | Rake $0 
Seat 1: Linghem folded before Flop (didn't bet)
Seat 2: matiko09 folded before Flop (didn't bet)
Seat 3: R1aki folded before Flop (didn't bet)
Seat 4: cn_chayanne (button) collected ($2.50)
Seat 5: aseban11 (small blind) folded before Flop
Seat 6: runner10 (big blind) folded before Flop





PokerStars Hand #150706373637:  Hold'em No Limit ($0.50/$1.00 USD) - 2016/03/21 16:34:56 CET [2016/03/21 11:34:56 ET]
Table 'Genoveva II' 9-max Seat #5 is the button
Seat 1: RICKA16 ($151.75 in chips) 
Seat 2: Ez1kelL ($25.66 in chips) 
Seat 3: sanpidk ($115.99 in chips) 
Seat 4: aseban11 ($100 in chips) 
Seat 5: volwebni4ek ($43.94 in chips) 
Seat 6: Pacifistas ($103.04 in chips) 
Seat 7: Robert201202 ($124.40 in chips) 
Seat 8: R1aki ($120.56 in chips) 
Seat 9: matiko09 ($100.23 in chips) 
Pacifistas: posts small blind $0.50
Robert201202: posts big blind $1
*** HOLE CARDS ***
Dealt to matiko09 [Qs 7s]
R1aki: folds 
matiko09: folds 
RICKA16: folds 
Ez1kelL: folds 
sanpidk: raises $1.50 to $2.50
aseban11: calls $2.50
volwebni4ek: raises $6.50 to $9
Pacifistas: folds 
Robert201202: folds 
sanpidk: folds 
aseban11: folds 
Uncalled bet ($6.50) returned to volwebni4ek
volwebni4ek collected $9 from pot
volwebni4ek: doesn't show hand 
*** SUMMARY ***
Total pot $9 | Rake $0 
Seat 1: RICKA16 folded before Flop (didn't bet)
Seat 2: Ez1kelL folded before Flop (didn't bet)
Seat 3: sanpidk folded before Flop
Seat 4: aseban11 folded before Flop
Seat 5: volwebni4ek (button) collected ($9)
Seat 6: Pacifistas (small blind) folded before Flop
Seat 7: Robert201202 (big blind) folded before Flop
Seat 8: R1aki folded before Flop (didn't bet)
Seat 9: matiko09 folded before Flop (didn't bet)





PokerStars Hand #150706375057:  Hold'em No Limit ($0.50/$1.00 USD) - 2016/03/21 16:34:58 CET [2016/03/21 11:34:58 ET]
Table 'Gondola II' 9-max Seat #2 is the button
Seat 1: matiko09 ($103.64 in chips) 
Seat 2: R1aki ($109.10 in chips) 
Seat 3: flk.Dasas ($114.49 in chips) 
Seat 4: aseban11 ($100 in chips) 
Seat 5: teukka8 ($66.87 in chips) 
Seat 6: SanychStar ($115.87 in chips) 
Seat 7: Pacifistas ($100 in chips) 
Seat 8: cn_chayanne ($101.50 in chips) 
flk.Dasas: posts small blind $0.50
aseban11: posts big blind $1
djammusic: sits out 
*** HOLE CARDS ***
Dealt to matiko09 [Qc 4c]
teukka8: raises $2 to $3
SanychStar: folds 
Pacifistas: folds 
cn_chayanne: folds 
matiko09: folds 
R1aki: calls $3
flk.Dasas: folds 
aseban11: folds 
*** FLOP *** [Ad Kc Jc]
teukka8: checks 
R1aki: bets $6
teukka8: folds 
Uncalled bet ($6) returned to R1aki
R1aki collected $7.16 from pot
R1aki: doesn't show hand 
*** SUMMARY ***
Total pot $7.50 | Rake $0.34 
Board [Ad Kc Jc]
Seat 1: matiko09 folded before Flop (didn't bet)
Seat 2: R1aki (button) collected ($7.16)
Seat 3: flk.Dasas (small blind) folded before Flop
Seat 4: aseban11 (big blind) folded before Flop
Seat 5: teukka8 folded on the Flop
Seat 6: SanychStar folded before Flop (didn't bet)
Seat 7: Pacifistas folded before Flop (didn't bet)
Seat 8: cn_chayanne folded before Flop (didn't bet)





PokerStars Hand #150706381154:  Hold'em No Limit ($0.50/$1.00 USD) - 2016/03/21 16:35:06 CET [2016/03/21 11:35:06 ET]
Table 'Noel' 9-max Seat #2 is the button
Seat 2: cobrik23 ($179.40 in chips) 
Seat 4: Kobiroga150 ($100.80 in chips) 
Seat 5: matiko09 ($106.75 in chips) 
Seat 6: hammerwife ($100 in chips) 
Seat 7: djammusic ($40 in chips) 
Seat 8: Dachish ($67 in chips) 
Seat 9: grifkaaa ($100 in chips) 
Kobiroga150: posts small blind $0.50
matiko09: posts big blind $1
ep538: sits out 
*** HOLE CARDS ***
Dealt to matiko09 [3d Qh]
hammerwife: folds 
djammusic: calls $1
Dachish: folds 
grifkaaa: calls $1
cobrik23: folds 
Kobiroga150: folds 
matiko09: checks 
*** FLOP *** [Kh 7h 9d]
matiko09: checks 
djammusic: checks 
grifkaaa: bets $2.50
matiko09: folds 
djammusic: folds 
Uncalled bet ($2.50) returned to grifkaaa
grifkaaa collected $3.34 from pot
*** SUMMARY ***
Total pot $3.50 | Rake $0.16 
Board [Kh 7h 9d]
Seat 2: cobrik23 (button) folded before Flop (didn't bet)
Seat 4: Kobiroga150 (small blind) folded before Flop
Seat 5: matiko09 (big blind) folded on the Flop
Seat 6: hammerwife folded before Flop (didn't bet)
Seat 7: djammusic folded on the Flop
Seat 8: Dachish folded before Flop (didn't bet)
Seat 9: grifkaaa collected ($3.34)





PokerStars Hand #150706382435:  Hold'em No Limit ($0.50/$1.00 USD) - 2016/03/21 16:35:08 CET [2016/03/21 11:35:08 ET]
Table 'Onnie II' 9-max Seat #6 is the button
Seat 1: aseban11 ($194.23 in chips) 
Seat 2: RICKA16 ($103.07 in chips) 
Seat 3: cn_chayanne ($100 in chips) 
Seat 4: Bothfeld11 ($74.36 in chips) 
Seat 6: Pacifistas ($101.01 in chips) 
Seat 7: djammusic ($72.58 in chips) 
Seat 8: solbi86 ($106.60 in chips) 
Seat 9: matiko09 ($116.12 in chips) 
djammusic: posts small blind $0.50
solbi86: posts big blind $1
*** HOLE CARDS ***
Dealt to matiko09 [Jc 5d]
matiko09: folds 
aseban11: folds 
RICKA16: raises $2 to $3
cn_chayanne: calls $3
Bothfeld11: folds 
Pacifistas: folds 
djammusic: folds 
solbi86: folds 
*** FLOP *** [5s Th As]
RICKA16: bets $5
cn_chayanne: folds 
Uncalled bet ($5) returned to RICKA16
RICKA16 collected $7.16 from pot
RICKA16: doesn't show hand 
*** SUMMARY ***
Total pot $7.50 | Rake $0.34 
Board [5s Th As]
Seat 1: aseban11 folded before Flop (didn't bet)
Seat 2: RICKA16 collected ($7.16)
Seat 3: cn_chayanne folded on the Flop
Seat 4: Bothfeld11 folded before Flop (didn't bet)
Seat 6: Pacifistas (button) folded before Flop (didn't bet)
Seat 7: djammusic (small blind) folded before Flop
Seat 8: solbi86 (big blind) folded before Flop
Seat 9: matiko09 folded before Flop (didn't bet)





PokerStars Hand #150706391626:  Hold'em No Limit ($0.50/$1.00 USD) - 2016/03/21 16:35:20 CET [2016/03/21 11:35:20 ET]
Table 'Toutatis II' 9-max Seat #5 is the button
Seat 1: Linghem ($108.58 in chips) 
Seat 2: matiko09 ($100 in chips) 
Seat 3: R1aki ($100 in chips) 
Seat 4: cn_chayanne ($101.50 in chips) 
Seat 5: aseban11 ($100 in chips) 
Seat 6: runner10 ($40.60 in chips) 
Seat 7: Pacifistas ($100 in chips) 
runner10: posts small blind $0.50
Pacifistas: posts big blind $1
Dachish: sits out 
B@ngel: sits out 
*** HOLE CARDS ***
Dealt to matiko09 [4d 2d]
Linghem: folds 
matiko09: folds 
R1aki: folds 
cn_chayanne: raises $1.50 to $2.50
aseban11: folds 
runner10: folds 
Pacifistas: folds 
Uncalled bet ($1.50) returned to cn_chayanne
cn_chayanne collected $2.50 from pot
cn_chayanne: doesn't show hand 
*** SUMMARY ***
Total pot $2.50 | Rake $0 
Seat 1: Linghem folded before Flop (didn't bet)
Seat 2: matiko09 folded before Flop (didn't bet)
Seat 3: R1aki folded before Flop (didn't bet)
Seat 4: cn_chayanne collected ($2.50)
Seat 5: aseban11 (button) folded before Flop (didn't bet)
Seat 6: runner10 (small blind) folded before Flop
Seat 7: Pacifistas (big blind) folded before Flop





PokerStars Hand #150706402930:  Hold'em No Limit (€0.50/€1.00 EUR) - 2016/03/21 16:35:36 CET [2016/03/21 11:35:36 ET]
Table 'Anhui' 9-max Seat #7 is the button
Seat 2: R1aki (€100 in chips) 
Seat 3: matiko09 (€100 in chips) 
Seat 4: stds st (€38.50 in chips) 
Seat 5: cobrik23 (€98.58 in chips) 
Seat 6: Muinmyheart (€100 in chips) 
Seat 7: aseban11 (€100 in chips) 
Seat 8: volwebni4ek (€50.38 in chips) 
volwebni4ek: posts small blind €0.50
Pacifistas: is sitting out 
R1aki: posts big blind €1
*** HOLE CARDS ***
Dealt to matiko09 [Jc 9s]
Pacifistas leaves the table
matiko09: folds 
matiko09 leaves the table
sanpidk joins the table at seat #9 
stds st: folds 
sanpidk leaves the table
cobrik23: raises €2 to €3
Muinmyheart: folds 
aseban11: folds 
volwebni4ek: folds 
R1aki: folds 
Uncalled bet (€2) returned to cobrik23
cobrik23 collected €2.50 from pot
cobrik23: doesn't show hand 
*** SUMMARY ***
Total pot €2.50 | Rake €0 
Seat 2: R1aki (big blind) folded before Flop
Seat 3: matiko09 folded before Flop (didn't bet)
Seat 4: stds st folded before Flop (didn't bet)
Seat 5: cobrik23 collected (€2.50)
Seat 6: Muinmyheart folded before Flop (didn't bet)
Seat 7: aseban11 (button) folded before Flop (didn't bet)
Seat 8: volwebni4ek (small blind) folded before Flop





PokerStars Hand #150706409872:  Hold'em No Limit ($0.50/$1.00 USD) - 2016/03/21 16:35:45 CET [2016/03/21 11:35:45 ET]
Table 'Noel' 9-max Seat #4 is the button
Seat 2: cobrik23 ($179.40 in chips) 
Seat 4: Kobiroga150 ($100.30 in chips) 
Seat 5: matiko09 ($105.75 in chips) 
Seat 6: hammerwife ($100 in chips) 
Seat 7: djammusic ($39 in chips) 
Seat 8: Dachish ($67 in chips) 
Seat 9: grifkaaa ($102.34 in chips) 
matiko09: posts small blind $0.50
hammerwife: posts big blind $1
ep538: sits out 
*** HOLE CARDS ***
Dealt to matiko09 [8s Ks]
djammusic: folds 
Dachish: folds 
grifkaaa: folds 
cobrik23: folds 
Kobiroga150: calls $1
matiko09: raises $4 to $5
hammerwife: folds 
Kobiroga150: calls $4
*** FLOP *** [Th 2s 8c]
matiko09: checks 
Kobiroga150: checks 
*** TURN *** [Th 2s 8c] [Ts]
matiko09: bets $5.46
Kobiroga150: calls $5.46
*** RIVER *** [Th 2s 8c Ts] [4d]
matiko09: checks 
Kobiroga150: checks 
*** SHOW DOWN ***
matiko09: shows [8s Ks] (two pair, Tens and Eights)
Kobiroga150: mucks hand 
matiko09 collected $20.93 from pot
*** SUMMARY ***
Total pot $21.92 | Rake $0.99 
Board [Th 2s 8c Ts 4d]
Seat 2: cobrik23 folded before Flop (didn't bet)
Seat 4: Kobiroga150 (button) mucked [4c Ac]
Seat 5: matiko09 (small blind) showed [8s Ks] and won ($20.93) with two pair, Tens and Eights
Seat 6: hammerwife (big blind) folded before Flop
Seat 7: djammusic folded before Flop (didn't bet)
Seat 8: Dachish folded before Flop (didn't bet)
Seat 9: grifkaaa folded before Flop (didn't bet)





PokerStars Hand #150706410379:  Hold'em No Limit ($0.50/$1.00 USD) - 2016/03/21 16:35:46 CET [2016/03/21 11:35:46 ET]
Table 'Gondola II' 9-max Seat #3 is the button
Seat 1: matiko09 ($103.64 in chips) 
Seat 2: R1aki ($113.26 in chips) 
Seat 3: flk.Dasas ($113.99 in chips) 
Seat 4: aseban11 ($100 in chips) 
Seat 5: teukka8 ($63.87 in chips) 
Seat 6: SanychStar ($115.87 in chips) 
Seat 7: Pacifistas ($100 in chips) 
Seat 8: cn_chayanne ($101.50 in chips) 
aseban11: posts small blind $0.50
teukka8: posts big blind $1
djammusic: sits out 
*** HOLE CARDS ***
Dealt to matiko09 [6s Jc]
SanychStar: folds 
Pacifistas: raises $2 to $3
cn_chayanne: folds 
matiko09: folds 
R1aki: folds 
flk.Dasas: folds 
aseban11: folds 
teukka8: calls $2
*** FLOP *** [2c Tc 4d]
teukka8: bets $3
Pacifistas: raises $6 to $9
teukka8: folds 
Uncalled bet ($6) returned to Pacifistas
Pacifistas collected $11.94 from pot
Pacifistas: doesn't show hand 
*** SUMMARY ***
Total pot $12.50 | Rake $0.56 
Board [2c Tc 4d]
Seat 1: matiko09 folded before Flop (didn't bet)
Seat 2: R1aki folded before Flop (didn't bet)
Seat 3: flk.Dasas (button) folded before Flop (didn't bet)
Seat 4: aseban11 (small blind) folded before Flop
Seat 5: teukka8 (big blind) folded on the Flop
Seat 6: SanychStar folded before Flop (didn't bet)
Seat 7: Pacifistas collected ($11.94)
Seat 8: cn_chayanne folded before Flop (didn't bet)





PokerStars Hand #150706410618:  Hold'em No Limit ($0.50/$1.00 USD) - 2016/03/21 16:35:46 CET [2016/03/21 11:35:46 ET]
Table 'Havnia' 9-max Seat #3 is the button
Seat 2: cn_chayanne ($124.90 in chips) 
Seat 3: drakariss ($45.75 in chips) 
Seat 4: Rikti ($44.37 in chips) 
Seat 5: matiko09 ($100 in chips) 
Seat 6: Vaclos_o_o ($77.51 in chips) 
Seat 7: flk.Dasas ($100 in chips) 
Seat 8: gabi_igna ($105.23 in chips) 
Seat 9: sanpidk ($202.30 in chips) 
Rikti: posts small blind $0.50
matiko09: posts big blind $1
Khaine_CM: sits out 
*** HOLE CARDS ***
Dealt to matiko09 [Qs Tc]
Vaclos_o_o: folds 
flk.Dasas: folds 
gabi_igna: raises $2 to $3
sanpidk: folds 
cn_chayanne: folds 
drakariss: folds 
Rikti: folds 
matiko09: folds 
Uncalled bet ($2) returned to gabi_igna
gabi_igna collected $2.50 from pot
gabi_igna: doesn't show hand 
*** SUMMARY ***
Total pot $2.50 | Rake $0 
Seat 2: cn_chayanne folded before Flop (didn't bet)
Seat 3: drakariss (button) folded before Flop (didn't bet)
Seat 4: Rikti (small blind) folded before Flop
Seat 5: matiko09 (big blind) folded before Flop
Seat 6: Vaclos_o_o folded before Flop (didn't bet)
Seat 7: flk.Dasas folded before Flop (didn't bet)
Seat 8: gabi_igna collected ($2.50)
Seat 9: sanpidk folded before Flop (didn't bet)





PokerStars Hand #150706410459:  Hold'em No Limit ($0.50/$1.00 USD) - 2016/03/21 16:35:46 CET [2016/03/21 11:35:46 ET]
Table 'Massalia II' 9-max Seat #8 is the button
Seat 1: crepke ($86.22 in chips) 
Seat 2: solbi86 ($102.70 in chips) 
Seat 3: 123chambo ($99.20 in chips) 
Seat 4: OriginalTony ($119.10 in chips) 
Seat 5: roninio1 ($102.70 in chips) 
Seat 6: Pacifistas ($113.74 in chips) 
Seat 7: flk.Dasas ($100 in chips) 
Seat 8: matiko09 ($198.80 in chips) 
Seat 9: R1aki ($100 in chips) 
R1aki: posts small blind $0.50
crepke: posts big blind $1
crepke: posts the ante $0.20
solbi86: posts the ante $0.20
123chambo: posts the ante $0.20
OriginalTony: posts the ante $0.20
roninio1: posts the ante $0.20
Pacifistas: posts the ante $0.20
flk.Dasas: posts the ante $0.20
matiko09: posts the ante $0.20
R1aki: posts the ante $0.20
*** HOLE CARDS ***
Dealt to matiko09 [9h 4c]
solbi86: folds 
123chambo: folds 
OriginalTony: raises $2 to $3
roninio1: folds 
Pacifistas: folds 
flk.Dasas: folds 
matiko09: folds 
R1aki: folds 
crepke: folds 
Uncalled bet ($2) returned to OriginalTony
OriginalTony collected $4.30 from pot
*** SUMMARY ***
Total pot $4.30 | Rake $0 
Seat 1: crepke (big blind) folded before Flop
Seat 2: solbi86 folded before Flop (didn't bet)
Seat 3: 123chambo folded before Flop (didn't bet)
Seat 4: OriginalTony collected ($4.30)
Seat 5: roninio1 folded before Flop (didn't bet)
Seat 6: Pacifistas folded before Flop (didn't bet)
Seat 7: flk.Dasas folded before Flop (didn't bet)
Seat 8: matiko09 (button) folded before Flop (didn't bet)
Seat 9: R1aki (small blind) folded before Flop





PokerStars Hand #150706418488:  Hold'em No Limit ($0.50/$1.00 USD) - 2016/03/21 16:35:57 CET [2016/03/21 11:35:57 ET]
Table 'Genoveva II' 9-max Seat #6 is the button
Seat 1: RICKA16 ($151.75 in chips) 
Seat 2: Ez1kelL ($25.66 in chips) 
Seat 3: sanpidk ($113.49 in chips) 
Seat 4: aseban11 ($100 in chips) 
Seat 5: volwebni4ek ($50.44 in chips) 
Seat 6: Pacifistas ($102.54 in chips) 
Seat 7: Robert201202 ($123.40 in chips) 
Seat 8: R1aki ($120.56 in chips) 
Seat 9: matiko09 ($100.23 in chips) 
Robert201202: posts small blind $0.50
R1aki: posts big blind $1
*** HOLE CARDS ***
Dealt to matiko09 [Qd Ks]
matiko09: raises $2 to $3
RICKA16: folds 
Ez1kelL: folds 
sanpidk: folds 
aseban11: folds 
volwebni4ek: folds 
Pacifistas: calls $3
Robert201202: folds 
R1aki: folds 
*** FLOP *** [Qs Js 6s]
Robert201202 leaves the table
matiko09: checks 
Pacifistas: bets $4.65
matiko09: calls $4.65
*** TURN *** [Qs Js 6s] [2c]
matiko09: checks 
Pacifistas: bets $11.07
matiko09: calls $11.07
*** RIVER *** [Qs Js 6s 2c] [9s]
matiko09: checks 
Pacifistas: checks 
*** SHOW DOWN ***
matiko09: shows [Qd Ks] (a flush, King high)
Pacifistas: mucks hand 
matiko09 collected $37.19 from pot
*** SUMMARY ***
Total pot $38.94 | Rake $1.75 
Board [Qs Js 6s 2c 9s]
Seat 1: RICKA16 folded before Flop (didn't bet)
Seat 2: Ez1kelL folded before Flop (didn't bet)
Seat 3: sanpidk folded before Flop (didn't bet)
Seat 4: aseban11 folded before Flop (didn't bet)
Seat 5: volwebni4ek folded before Flop (didn't bet)
Seat 6: Pacifistas (button) mucked [4c 4s]
Seat 7: Robert201202 (small blind) folded before Flop
Seat 8: R1aki (big blind) folded before Flop
Seat 9: matiko09 showed [Qd Ks] and won ($37.19) with a flush, King high





PokerStars Hand #150706422841:  Hold'em No Limit ($0.50/$1.00 USD) - 2016/03/21 16:36:03 CET [2016/03/21 11:36:03 ET]
Table 'Toutatis II' 9-max Seat #6 is the button
Seat 1: Linghem ($108.58 in chips) 
Seat 2: matiko09 ($100 in chips) 
Seat 3: R1aki ($100 in chips) 
Seat 4: cn_chayanne ($103 in chips) 
Seat 5: aseban11 ($100 in chips) 
Seat 6: runner10 ($40.10 in chips) 
Seat 7: Pacifistas ($100 in chips) 
Seat 8: Dachish ($70 in chips) 
Pacifistas: posts small blind $0.50
Dachish: posts big blind $1
B@ngel: sits out 
*** HOLE CARDS ***
Dealt to matiko09 [9d Td]
Linghem: folds 
matiko09: raises $2 to $3
R1aki: folds 
cn_chayanne: folds 
aseban11: folds 
runner10: folds 
Pacifistas: folds 
Dachish: folds 
Uncalled bet ($2) returned to matiko09
matiko09 collected $2.50 from pot
matiko09: doesn't show hand 
*** SUMMARY ***
Total pot $2.50 | Rake $0 
Seat 1: Linghem folded before Flop (didn't bet)
Seat 2: matiko09 collected ($2.50)
Seat 3: R1aki folded before Flop (didn't bet)
Seat 4: cn_chayanne folded before Flop (didn't bet)
Seat 5: aseban11 folded before Flop (didn't bet)
Seat 6: runner10 (button) folded before Flop (didn't bet)
Seat 7: Pacifistas (small blind) folded before Flop
Seat 8: Dachish (big blind) folded before Flop





PokerStars Hand #150706440856:  Hold'em No Limit ($0.50/$1.00 USD) - 2016/03/21 16:36:28 CET [2016/03/21 11:36:28 ET]
Table 'Onnie II' 9-max Seat #7 is the button
Seat 1: aseban11 ($194.23 in chips) 
Seat 2: RICKA16 ($107.23 in chips) 
Seat 3: cn_chayanne ($100 in chips) 
Seat 4: Bothfeld11 ($74.36 in chips) 
Seat 6: Pacifistas ($101.01 in chips) 
Seat 7: djammusic ($72.08 in chips) 
Seat 8: solbi86 ($105.60 in chips) 
Seat 9: matiko09 ($116.12 in chips) 
solbi86: posts small blind $0.50
matiko09: posts big blind $1
roninio1: sits out 
*** HOLE CARDS ***
Dealt to matiko09 [Td 4c]
aseban11: raises $1.50 to $2.50
RICKA16: calls $2.50
cn_chayanne: folds 
Bothfeld11: folds 
Pacifistas: folds 
djammusic: folds 
solbi86: folds 
matiko09: folds 
*** FLOP *** [3d 2s 5s]
aseban11: checks 
RICKA16: bets $4
aseban11: folds 
Uncalled bet ($4) returned to RICKA16
RICKA16 collected $6.21 from pot
RICKA16: doesn't show hand 
*** SUMMARY ***
Total pot $6.50 | Rake $0.29 
Board [3d 2s 5s]
Seat 1: aseban11 folded on the Flop
Seat 2: RICKA16 collected ($6.21)
Seat 3: cn_chayanne folded before Flop (didn't bet)
Seat 4: Bothfeld11 folded before Flop (didn't bet)
Seat 6: Pacifistas folded before Flop (didn't bet)
Seat 7: djammusic (button) folded before Flop (didn't bet)
Seat 8: solbi86 (small blind) folded before Flop
Seat 9: matiko09 (big blind) folded before Flop





PokerStars Hand #150706443234:  Hold'em No Limit ($0.50/$1.00 USD) - 2016/03/21 16:36:31 CET [2016/03/21 11:36:31 ET]
Table 'Massalia II' 9-max Seat #9 is the button
Seat 1: crepke ($85.02 in chips) 
Seat 2: solbi86 ($102.50 in chips) 
Seat 3: 123chambo ($99 in chips) 
Seat 4: OriginalTony ($122.20 in chips) 
Seat 5: roninio1 ($102.50 in chips) 
Seat 6: Pacifistas ($113.54 in chips) 
Seat 7: flk.Dasas ($100 in chips) 
Seat 8: matiko09 ($198.60 in chips) 
Seat 9: R1aki ($100 in chips) 
crepke: posts small blind $0.50
solbi86: posts big blind $1
crepke: posts the ante $0.20
solbi86: posts the ante $0.20
123chambo: posts the ante $0.20
OriginalTony: posts the ante $0.20
roninio1: posts the ante $0.20
Pacifistas: posts the ante $0.20
flk.Dasas: posts the ante $0.20
matiko09: posts the ante $0.20
R1aki: posts the ante $0.20
*** HOLE CARDS ***
Dealt to matiko09 [3d 3s]
123chambo: folds 
OriginalTony: folds 
roninio1: folds 
Pacifistas: folds 
flk.Dasas: folds 
matiko09: raises $1.50 to $2.50
R1aki: folds 
crepke: folds 
solbi86: folds 
Uncalled bet ($1.50) returned to matiko09
matiko09 collected $4.30 from pot
matiko09: doesn't show hand 
*** SUMMARY ***
Total pot $4.30 | Rake $0 
Seat 1: crepke (small blind) folded before Flop
Seat 2: solbi86 (big blind) folded before Flop
Seat 3: 123chambo folded before Flop (didn't bet)
Seat 4: OriginalTony folded before Flop (didn't bet)
Seat 5: roninio1 folded before Flop (didn't bet)
Seat 6: Pacifistas folded before Flop (didn't bet)
Seat 7: flk.Dasas folded before Flop (didn't bet)
Seat 8: matiko09 collected ($4.30)
Seat 9: R1aki (button) folded before Flop (didn't bet)





PokerStars Hand #150706446286:  Hold'em No Limit ($0.50/$1.00 USD) - 2016/03/21 16:36:35 CET [2016/03/21 11:36:35 ET]
Table 'Gondola II' 9-max Seat #4 is the button
Seat 1: matiko09 ($103.64 in chips) 
Seat 2: R1aki ($113.26 in chips) 
Seat 3: flk.Dasas ($113.99 in chips) 
Seat 4: aseban11 ($100 in chips) 
Seat 5: teukka8 ($57.87 in chips) 
Seat 6: SanychStar ($115.87 in chips) 
Seat 7: Pacifistas ($105.94 in chips) 
Seat 8: cn_chayanne ($101.50 in chips) 
teukka8: posts small blind $0.50
SanychStar: posts big blind $1
djammusic: sits out 
*** HOLE CARDS ***
Dealt to matiko09 [6h 2h]
Pacifistas: raises $2 to $3
cn_chayanne: folds 
matiko09: folds 
R1aki: folds 
flk.Dasas: folds 
aseban11: calls $3
teukka8: calls $2.50
SanychStar: folds 
*** FLOP *** [7d 8s Ac]
teukka8: checks 
Pacifistas: checks 
aseban11: bets $5.50
teukka8: calls $5.50
Pacifistas: folds 
*** TURN *** [7d 8s Ac] [Kd]
teukka8: checks 
aseban11: checks 
*** RIVER *** [7d 8s Ac Kd] [3h]
teukka8: bets $5
aseban11: raises $33.50 to $38.50
teukka8: folds 
Uncalled bet ($33.50) returned to aseban11
aseban11 collected $29.60 from pot
aseban11: doesn't show hand 
*** SUMMARY ***
Total pot $31 | Rake $1.40 
Board [7d 8s Ac Kd 3h]
Seat 1: matiko09 folded before Flop (didn't bet)
Seat 2: R1aki folded before Flop (didn't bet)
Seat 3: flk.Dasas folded before Flop (didn't bet)
Seat 4: aseban11 (button) collected ($29.60)
Seat 5: teukka8 (small blind) folded on the River
Seat 6: SanychStar (big blind) folded before Flop
Seat 7: Pacifistas folded on the Flop
Seat 8: cn_chayanne folded before Flop (didn't bet)





PokerStars Hand #150706452384:  Hold'em No Limit ($0.50/$1.00 USD) - 2016/03/21 16:36:43 CET [2016/03/21 11:36:43 ET]
Table 'Toutatis II' 9-max Seat #7 is the button
Seat 1: Linghem ($108.58 in chips) 
Seat 2: matiko09 ($101.50 in chips) 
Seat 3: R1aki ($100 in chips) 
Seat 4: cn_chayanne ($103 in chips) 
Seat 5: aseban11 ($100 in chips) 
Seat 6: runner10 ($40.10 in chips) 
Seat 7: Pacifistas ($100 in chips) 
Seat 8: Dachish ($69 in chips) 
Seat 9: B@ngel ($100 in chips) 
Dachish: posts small blind $0.50
B@ngel: posts big blind $1
*** HOLE CARDS ***
Dealt to matiko09 [Qs Th]
Linghem: folds 
matiko09: folds 
R1aki: folds 
cn_chayanne: folds 
aseban11: folds 
runner10: folds 
B@ngel is disconnected 
Pacifistas: folds 
Dachish: raises $1 to $2
B@ngel is connected 
B@ngel: calls $1
*** FLOP *** [3d 2h Kc]
Dachish: bets $2
B@ngel: calls $2
*** TURN *** [3d 2h Kc] [As]
Dachish: bets $4.50
B@ngel: calls $4.50
*** RIVER *** [3d 2h Kc As] [3s]
Dachish: checks 
B@ngel: checks 
*** SHOW DOWN ***
Dachish: shows [Ts 9d] (a pair of Threes)
B@ngel: shows [Qc Kd] (two pair, Kings and Threes)
B@ngel collected $16.24 from pot
*** SUMMARY ***
Total pot $17 | Rake $0.76 
Board [3d 2h Kc As 3s]
Seat 1: Linghem folded before Flop (didn't bet)
Seat 2: matiko09 folded before Flop (didn't bet)
Seat 3: R1aki folded before Flop (didn't bet)
Seat 4: cn_chayanne folded before Flop (didn't bet)
Seat 5: aseban11 folded before Flop (didn't bet)
Seat 6: runner10 folded before Flop (didn't bet)
Seat 7: Pacifistas (button) folded before Flop (didn't bet)
Seat 8: Dachish (small blind) showed [Ts 9d] and lost with a pair of Threes
Seat 9: B@ngel (big blind) showed [Qc Kd] and won ($16.24) with two pair, Kings and Threes





PokerStars Hand #150706453499:  Hold'em No Limit ($0.50/$1.00 USD) - 2016/03/21 16:36:45 CET [2016/03/21 11:36:45 ET]
Table 'Havnia' 9-max Seat #4 is the button
Seat 2: cn_chayanne ($124.90 in chips) 
Seat 3: drakariss ($45.75 in chips) 
Seat 4: Rikti ($43.87 in chips) 
Seat 5: matiko09 ($100 in chips) 
Seat 7: flk.Dasas ($100 in chips) 
Seat 8: gabi_igna ($106.73 in chips) 
Seat 9: sanpidk ($202.30 in chips) 
matiko09: posts small blind $0.50
Vaclos_o_o: is sitting out 
flk.Dasas: posts big blind $1
Khaine_CM: sits out 
*** HOLE CARDS ***
Dealt to matiko09 [Qs 7s]
gabi_igna: raises $2 to $3
sanpidk: folds 
cn_chayanne: folds 
drakariss: folds 
Rikti: folds 
matiko09: folds 
flk.Dasas: folds 
Uncalled bet ($2) returned to gabi_igna
gabi_igna collected $2.50 from pot
gabi_igna: doesn't show hand 
*** SUMMARY ***
Total pot $2.50 | Rake $0 
Seat 2: cn_chayanne folded before Flop (didn't bet)
Seat 3: drakariss folded before Flop (didn't bet)
Seat 4: Rikti (button) folded before Flop (didn't bet)
Seat 5: matiko09 (small blind) folded before Flop
Seat 7: flk.Dasas (big blind) folded before Flop
Seat 8: gabi_igna collected ($2.50)
Seat 9: sanpidk folded before Flop (didn't bet)





PokerStars Hand #150706467366:  Hold'em No Limit ($0.50/$1.00 USD) - 2016/03/21 16:37:04 CET [2016/03/21 11:37:04 ET]
Table 'Noel' 9-max Seat #5 is the button
Seat 2: cobrik23 ($179.40 in chips) 
Seat 4: Kobiroga150 ($89.84 in chips) 
Seat 5: matiko09 ($116.22 in chips) 
Seat 6: hammerwife ($100 in chips) 
Seat 7: djammusic ($39 in chips) 
Seat 8: Dachish ($67 in chips) 
Seat 9: grifkaaa ($102.34 in chips) 
hammerwife: posts small blind $0.50
djammusic: posts big blind $1
ep538: sits out 
*** HOLE CARDS ***
Dealt to matiko09 [2d 9h]
Dachish: folds 
grifkaaa: folds 
cobrik23: folds 
Kobiroga150: folds 
matiko09: folds 
hammerwife: folds 
Uncalled bet ($0.50) returned to djammusic
djammusic collected $1 from pot
djammusic: doesn't show hand 
*** SUMMARY ***
Total pot $1 | Rake $0 
Seat 2: cobrik23 folded before Flop (didn't bet)
Seat 4: Kobiroga150 folded before Flop (didn't bet)
Seat 5: matiko09 (button) folded before Flop (didn't bet)
Seat 6: hammerwife (small blind) folded before Flop
Seat 7: djammusic (big blind) collected ($1)
Seat 8: Dachish folded before Flop (didn't bet)
Seat 9: grifkaaa folded before Flop (didn't bet)





PokerStars Hand #150706470244:  Hold'em No Limit ($0.50/$1.00 USD) - 2016/03/21 16:37:08 CET [2016/03/21 11:37:08 ET]
Table 'Massalia II' 9-max Seat #1 is the button
Seat 1: crepke ($84.32 in chips) 
Seat 2: solbi86 ($101.30 in chips) 
Seat 3: 123chambo ($98.80 in chips) 
Seat 4: OriginalTony ($122 in chips) 
Seat 5: roninio1 ($102.30 in chips) 
Seat 6: Pacifistas ($113.34 in chips) 
Seat 7: flk.Dasas ($100 in chips) 
Seat 8: matiko09 ($201.70 in chips) 
Seat 9: R1aki ($100 in chips) 
solbi86: posts small blind $0.50
123chambo: posts big blind $1
crepke: posts the ante $0.20
solbi86: posts the ante $0.20
123chambo: posts the ante $0.20
OriginalTony: posts the ante $0.20
roninio1: posts the ante $0.20
Pacifistas: posts the ante $0.20
flk.Dasas: posts the ante $0.20
matiko09: posts the ante $0.20
R1aki: posts the ante $0.20
*** HOLE CARDS ***
Dealt to matiko09 [2s Kc]
OriginalTony: folds 
roninio1: folds 
Pacifistas: folds 
flk.Dasas: raises $3 to $4
matiko09: folds 
R1aki: folds 
crepke: folds 
solbi86: folds 
123chambo: folds 
Uncalled bet ($3) returned to flk.Dasas
flk.Dasas collected $4.30 from pot
flk.Dasas: doesn't show hand 
*** SUMMARY ***
Total pot $4.30 | Rake $0 
Seat 1: crepke (button) folded before Flop (didn't bet)
Seat 2: solbi86 (small blind) folded before Flop
Seat 3: 123chambo (big blind) folded before Flop
Seat 4: OriginalTony folded before Flop (didn't bet)
Seat 5: roninio1 folded before Flop (didn't bet)
Seat 6: Pacifistas folded before Flop (didn't bet)
Seat 7: flk.Dasas collected ($4.30)
Seat 8: matiko09 folded before Flop (didn't bet)
Seat 9: R1aki folded before Flop (didn't bet)





PokerStars Hand #150706475483:  Hold'em No Limit ($0.50/$1.00 USD) - 2016/03/21 16:37:15 CET [2016/03/21 11:37:15 ET]
Table 'Havnia' 9-max Seat #5 is the button
Seat 2: cn_chayanne ($124.90 in chips) 
Seat 3: drakariss ($45.75 in chips) 
Seat 4: Rikti ($43.87 in chips) 
Seat 5: matiko09 ($100 in chips) 
Seat 7: flk.Dasas ($100 in chips) 
Seat 8: gabi_igna ($108.23 in chips) 
Seat 9: sanpidk ($202.30 in chips) 
flk.Dasas: posts small blind $0.50
gabi_igna: posts big blind $1
Khaine_CM: sits out 
*** HOLE CARDS ***
Dealt to matiko09 [Tc Kd]
sanpidk: folds 
cn_chayanne: folds 
drakariss: calls $1
Rikti: folds 
matiko09: raises $3 to $4
flk.Dasas: raises $8 to $12
sanpidk leaves the table
gabi_igna: raises $13 to $25
drakariss: folds 
matiko09: folds 
flk.Dasas: raises $75 to $100 and is all-in
Vikulja1993 joins the table at seat #9 
gabi_igna: calls $75
*** FIRST FLOP *** [2s 3s 6c]
*** FIRST TURN *** [2s 3s 6c] [4s]
*** FIRST RIVER *** [2s 3s 6c 4s] [7d]
*** SECOND FLOP *** [Qd 2d 7c]
*** SECOND TURN *** [Qd 2d 7c] [Ts]
*** SECOND RIVER *** [Qd 2d 7c Ts] [3d]
*** FIRST SHOW DOWN ***
flk.Dasas: shows [Qc Qs] (a pair of Queens)
gabi_igna: mucks hand 
flk.Dasas collected $101.10 from pot
*** SECOND SHOW DOWN ***
flk.Dasas: shows [Qc Qs] (three of a kind, Queens)
gabi_igna: mucks hand 
flk.Dasas collected $101.10 from pot
*** SUMMARY ***
Total pot $205 | Rake $2.80 
Hand was run twice
FIRST Board [2s 3s 6c 4s 7d]
SECOND Board [Qd 2d 7c Ts 3d]
Seat 2: cn_chayanne folded before Flop (didn't bet)
Seat 3: drakariss folded before Flop
Seat 4: Rikti folded before Flop (didn't bet)
Seat 5: matiko09 (button) folded before Flop
Seat 7: flk.Dasas (small blind) showed [Qc Qs] and won ($101.10) with a pair of Queens, and won ($101.10) with three of a kind, Queens
Seat 8: gabi_igna (big blind) mucked [Ah Kh]
Seat 9: sanpidk folded before Flop (didn't bet)





PokerStars Hand #150706479385:  Hold'em No Limit ($0.50/$1.00 USD) - 2016/03/21 16:37:20 CET [2016/03/21 11:37:20 ET]
Table 'Onnie II' 9-max Seat #8 is the button
Seat 1: aseban11 ($191.73 in chips) 
Seat 2: RICKA16 ($110.94 in chips) 
Seat 3: cn_chayanne ($100 in chips) 
Seat 4: Bothfeld11 ($74.36 in chips) 
Seat 6: Pacifistas ($101.01 in chips) 
Seat 7: djammusic ($72.08 in chips) 
Seat 8: solbi86 ($105.10 in chips) 
Seat 9: matiko09 ($115.12 in chips) 
matiko09: posts small blind $0.50
aseban11: posts big blind $1
roninio1: sits out 
*** HOLE CARDS ***
Dealt to matiko09 [Ah 2c]
RICKA16: raises $2 to $3
cn_chayanne: folds 
Bothfeld11: folds 
Pacifistas: folds 
djammusic: folds 
solbi86: folds 
matiko09: folds 
aseban11: calls $2
*** FLOP *** [9s 5s Td]
aseban11: checks 
RICKA16: bets $4
aseban11: raises $10.65 to $14.65
RICKA16: folds 
Uncalled bet ($10.65) returned to aseban11
aseban11 collected $13.85 from pot
aseban11: doesn't show hand 
*** SUMMARY ***
Total pot $14.50 | Rake $0.65 
Board [9s 5s Td]
Seat 1: aseban11 (big blind) collected ($13.85)
Seat 2: RICKA16 folded on the Flop
Seat 3: cn_chayanne folded before Flop (didn't bet)
Seat 4: Bothfeld11 folded before Flop (didn't bet)
Seat 6: Pacifistas folded before Flop (didn't bet)
Seat 7: djammusic folded before Flop (didn't bet)
Seat 8: solbi86 (button) folded before Flop (didn't bet)
Seat 9: matiko09 (small blind) folded before Flop





PokerStars Hand #150706480128:  Hold'em No Limit ($0.50/$1.00 USD) - 2016/03/21 16:37:22 CET [2016/03/21 11:37:22 ET]
Table 'Noel' 9-max Seat #6 is the button
Seat 2: cobrik23 ($179.40 in chips) 
Seat 4: Kobiroga150 ($89.84 in chips) 
Seat 5: matiko09 ($116.22 in chips) 
Seat 6: hammerwife ($100 in chips) 
Seat 7: djammusic ($39.50 in chips) 
Seat 8: Dachish ($67 in chips) 
Seat 9: grifkaaa ($102.34 in chips) 
djammusic: posts small blind $0.50
Dachish: posts big blind $1
ep538: sits out 
*** HOLE CARDS ***
Dealt to matiko09 [6h 7h]
grifkaaa: raises $2 to $3
cobrik23: folds 
Kobiroga150: folds 
matiko09: folds 
hammerwife: folds 
djammusic: folds 
Dachish: folds 
Uncalled bet ($2) returned to grifkaaa
grifkaaa collected $2.50 from pot
*** SUMMARY ***
Total pot $2.50 | Rake $0 
Seat 2: cobrik23 folded before Flop (didn't bet)
Seat 4: Kobiroga150 folded before Flop (didn't bet)
Seat 5: matiko09 folded before Flop (didn't bet)
Seat 6: hammerwife (button) folded before Flop (didn't bet)
Seat 7: djammusic (small blind) folded before Flop
Seat 8: Dachish (big blind) folded before Flop
Seat 9: grifkaaa collected ($2.50)





PokerStars Hand #150706492972:  Hold'em No Limit ($0.50/$1.00 USD) - 2016/03/21 16:37:39 CET [2016/03/21 11:37:39 ET]
Table 'Harding II' 9-max Seat #7 is the button
Seat 5: matiko09 ($100 in chips) 
Seat 6: runner10 ($39.41 in chips) 
Seat 7: R1aki ($100 in chips) 
Seat 8: Pacifistas ($108.28 in chips) 
Pacifistas: posts small blind $0.50
matiko09: posts big blind $1
*** HOLE CARDS ***
Dealt to matiko09 [Qc Qs]
runner10: folds 
R1aki: raises $1.50 to $2.50
Pacifistas: folds 
matiko09: raises $6.50 to $9
R1aki: folds 
Uncalled bet ($6.50) returned to matiko09
sanpidk joins the table at seat #9 
matiko09 collected $5.50 from pot
matiko09: doesn't show hand 
*** SUMMARY ***
Total pot $5.50 | Rake $0 
Seat 5: matiko09 (big blind) collected ($5.50)
Seat 6: runner10 folded before Flop (didn't bet)
Seat 7: R1aki (button) folded before Flop
Seat 8: Pacifistas (small blind) folded before Flop





PokerStars Hand #150706497845:  Hold'em No Limit ($0.50/$1.00 USD) - 2016/03/21 16:37:46 CET [2016/03/21 11:37:46 ET]
Table 'Genoveva II' 9-max Seat #8 is the button
Seat 1: RICKA16 ($151.75 in chips) 
Seat 2: Ez1kelL ($25.66 in chips) 
Seat 3: sanpidk ($113.49 in chips) 
Seat 4: aseban11 ($100 in chips) 
Seat 5: volwebni4ek ($50.44 in chips) 
Seat 6: Pacifistas ($100 in chips) 
Seat 8: R1aki ($119.56 in chips) 
Seat 9: matiko09 ($118.70 in chips) 
matiko09: posts small blind $0.50
RICKA16: posts big blind $1
*** HOLE CARDS ***
Dealt to matiko09 [Kc Kh]
Ez1kelL: folds 
grifkaaa joins the table at seat #7 
sanpidk: folds 
aseban11: folds 
volwebni4ek: folds 
Pacifistas: folds 
R1aki: raises $1.50 to $2.50
matiko09: raises $6.50 to $9
RICKA16: folds 
R1aki: folds 
Uncalled bet ($6.50) returned to matiko09
matiko09 collected $6 from pot
matiko09: doesn't show hand 
*** SUMMARY ***
Total pot $6 | Rake $0 
Seat 1: RICKA16 (big blind) folded before Flop
Seat 2: Ez1kelL folded before Flop (didn't bet)
Seat 3: sanpidk folded before Flop (didn't bet)
Seat 4: aseban11 folded before Flop (didn't bet)
Seat 5: volwebni4ek folded before Flop (didn't bet)
Seat 6: Pacifistas folded before Flop (didn't bet)
Seat 8: R1aki (button) folded before Flop
Seat 9: matiko09 (small blind) collected ($6)





PokerStars Hand #150706498386:  Hold'em No Limit ($0.50/$1.00 USD) - 2016/03/21 16:37:47 CET [2016/03/21 11:37:47 ET]
Table 'Massalia II' 9-max Seat #2 is the button
Seat 1: crepke ($84.12 in chips) 
Seat 2: solbi86 ($100.60 in chips) 
Seat 3: 123chambo ($97.60 in chips) 
Seat 4: OriginalTony ($121.80 in chips) 
Seat 5: roninio1 ($102.10 in chips) 
Seat 6: Pacifistas ($113.14 in chips) 
Seat 7: flk.Dasas ($103.10 in chips) 
Seat 8: matiko09 ($201.50 in chips) 
Seat 9: R1aki ($100 in chips) 
123chambo: posts small blind $0.50
OriginalTony: posts big blind $1
crepke: posts the ante $0.20
solbi86: posts the ante $0.20
123chambo: posts the ante $0.20
OriginalTony: posts the ante $0.20
roninio1: posts the ante $0.20
Pacifistas: posts the ante $0.20
flk.Dasas: posts the ante $0.20
matiko09: posts the ante $0.20
R1aki: posts the ante $0.20
*** HOLE CARDS ***
Dealt to matiko09 [Ad Tc]
roninio1: folds 
Pacifistas: folds 
flk.Dasas: raises $3 to $4
matiko09: folds 
R1aki: calls $4
crepke: folds 
solbi86: folds 
123chambo: folds 
OriginalTony: calls $3
*** FLOP *** [6d 2d 5c]
OriginalTony: checks 
flk.Dasas: bets $8.06
R1aki: calls $8.06
OriginalTony: folds 
*** TURN *** [6d 2d 5c] [Td]
flk.Dasas: checks 
R1aki: checks 
*** RIVER *** [6d 2d 5c Td] [4c]
flk.Dasas: checks 
R1aki: checks 
*** SHOW DOWN ***
flk.Dasas: shows [8h 6h] (a pair of Sixes)
R1aki: shows [Qd Qs] (a pair of Queens)
R1aki collected $29.05 from pot
*** SUMMARY ***
Total pot $30.42 | Rake $1.37 
Board [6d 2d 5c Td 4c]
Seat 1: crepke folded before Flop (didn't bet)
Seat 2: solbi86 (button) folded before Flop (didn't bet)
Seat 3: 123chambo (small blind) folded before Flop
Seat 4: OriginalTony (big blind) folded on the Flop
Seat 5: roninio1 folded before Flop (didn't bet)
Seat 6: Pacifistas folded before Flop (didn't bet)
Seat 7: flk.Dasas showed [8h 6h] and lost with a pair of Sixes
Seat 8: matiko09 folded before Flop (didn't bet)
Seat 9: R1aki showed [Qd Qs] and won ($29.05) with a pair of Queens





PokerStars Hand #150706506160:  Hold'em No Limit ($0.50/$1.00 USD) - 2016/03/21 16:37:57 CET [2016/03/21 11:37:57 ET]
Table 'Noel' 9-max Seat #7 is the button
Seat 2: cobrik23 ($179.40 in chips) 
Seat 4: Kobiroga150 ($89.84 in chips) 
Seat 5: matiko09 ($116.22 in chips) 
Seat 6: hammerwife ($100 in chips) 
Seat 7: djammusic ($39 in chips) 
Seat 8: Dachish ($66 in chips) 
Seat 9: grifkaaa ($103.84 in chips) 
Dachish: posts small blind $0.50
grifkaaa: posts big blind $1
ep538: sits out 
*** HOLE CARDS ***
Dealt to matiko09 [4d 9s]
cobrik23: folds 
Kobiroga150: folds 
matiko09: folds 
hammerwife: raises $1.50 to $2.50
djammusic: folds 
Dachish: calls $2
grifkaaa: folds 
*** FLOP *** [Tc 6h Jh]
Dachish: checks 
hammerwife: bets $4
Dachish: folds 
Uncalled bet ($4) returned to hammerwife
hammerwife collected $5.73 from pot
hammerwife: doesn't show hand 
*** SUMMARY ***
Total pot $6 | Rake $0.27 
Board [Tc 6h Jh]
Seat 2: cobrik23 folded before Flop (didn't bet)
Seat 4: Kobiroga150 folded before Flop (didn't bet)
Seat 5: matiko09 folded before Flop (didn't bet)
Seat 6: hammerwife collected ($5.73)
Seat 7: djammusic (button) folded before Flop (didn't bet)
Seat 8: Dachish (small blind) folded on the Flop
Seat 9: grifkaaa (big blind) folded before Flop





PokerStars Hand #150706506323:  Hold'em No Limit ($0.50/$1.00 USD) - 2016/03/21 16:37:57 CET [2016/03/21 11:37:57 ET]
Table 'Gondola II' 9-max Seat #5 is the button
Seat 1: matiko09 ($103.64 in chips) 
Seat 2: R1aki ($113.26 in chips) 
Seat 3: flk.Dasas ($113.99 in chips) 
Seat 4: aseban11 ($116.10 in chips) 
Seat 5: teukka8 ($44.37 in chips) 
Seat 6: SanychStar ($114.87 in chips) 
Seat 7: Pacifistas ($102.94 in chips) 
Seat 8: cn_chayanne ($101.50 in chips) 
SanychStar: posts small blind $0.50
Pacifistas: posts big blind $1
djammusic: sits out 
*** HOLE CARDS ***
Dealt to matiko09 [4d Th]
cn_chayanne: raises $1.50 to $2.50
matiko09: folds 
R1aki: folds 
flk.Dasas: calls $2.50
aseban11: folds 
teukka8: folds 
SanychStar: folds 
Pacifistas: calls $1.50
*** FLOP *** [Kd 9s 6s]
Pacifistas: checks 
cn_chayanne: checks 
flk.Dasas: bets $5.20
Pacifistas: folds 
cn_chayanne: calls $5.20
*** TURN *** [Kd 9s 6s] [Qh]
cn_chayanne: checks 
flk.Dasas: bets $13.53
cn_chayanne: folds 
Uncalled bet ($13.53) returned to flk.Dasas
flk.Dasas collected $17.57 from pot
flk.Dasas: doesn't show hand 
*** SUMMARY ***
Total pot $18.40 | Rake $0.83 
Board [Kd 9s 6s Qh]
Seat 1: matiko09 folded before Flop (didn't bet)
Seat 2: R1aki folded before Flop (didn't bet)
Seat 3: flk.Dasas collected ($17.57)
Seat 4: aseban11 folded before Flop (didn't bet)
Seat 5: teukka8 (button) folded before Flop (didn't bet)
Seat 6: SanychStar (small blind) folded before Flop
Seat 7: Pacifistas (big blind) folded on the Flop
Seat 8: cn_chayanne folded on the Turn





PokerStars Hand #150706507335:  Hold'em No Limit ($0.50/$1.00 USD) - 2016/03/21 16:37:59 CET [2016/03/21 11:37:59 ET]
Table 'Harding II' 9-max Seat #8 is the button
Seat 5: matiko09 ($103 in chips) 
Seat 6: runner10 ($39.41 in chips) 
Seat 7: R1aki ($100 in chips) 
Seat 8: Pacifistas ($107.78 in chips) 
sanpidk will be allowed to play after the button
matiko09: posts small blind $0.50
runner10: posts big blind $1
*** HOLE CARDS ***
Dealt to matiko09 [7h 2s]
R1aki: folds 
R1aki leaves the table
Pacifistas: raises $1.50 to $2.50
matiko09: folds 
runner10: folds 
Uncalled bet ($1.50) returned to Pacifistas
Pacifistas collected $2.50 from pot
Pacifistas: doesn't show hand 
*** SUMMARY ***
Total pot $2.50 | Rake $0 
Seat 5: matiko09 (small blind) folded before Flop
Seat 6: runner10 (big blind) folded before Flop
Seat 7: R1aki folded before Flop (didn't bet)
Seat 8: Pacifistas (button) collected ($2.50)





PokerStars Hand #150706508685:  Hold'em No Limit ($0.50/$1.00 USD) - 2016/03/21 16:38:01 CET [2016/03/21 11:38:01 ET]
Table 'Toutatis II' 9-max Seat #8 is the button
Seat 1: Linghem ($108.58 in chips) 
Seat 2: matiko09 ($101.50 in chips) 
Seat 3: R1aki ($100 in chips) 
Seat 4: cn_chayanne ($103 in chips) 
Seat 5: aseban11 ($100 in chips) 
Seat 6: runner10 ($40.10 in chips) 
Seat 7: Pacifistas ($100 in chips) 
Seat 8: Dachish ($70 in chips) 
Seat 9: B@ngel ($107.74 in chips) 
B@ngel: posts small blind $0.50
Linghem: posts big blind $1
*** HOLE CARDS ***
Dealt to matiko09 [Ks As]
matiko09: raises $2 to $3
R1aki: folds 
cn_chayanne: folds 
aseban11: folds 
runner10: raises $3 to $6
Pacifistas: folds 
Dachish: folds 
B@ngel: folds 
Linghem: folds 
matiko09: raises $10 to $16
runner10: calls $10
*** FLOP *** [7c 3c 6d]
matiko09: bets $14
runner10: folds 
Uncalled bet ($14) returned to matiko09
matiko09 collected $31.99 from pot
matiko09: doesn't show hand 
*** SUMMARY ***
Total pot $33.50 | Rake $1.51 
Board [7c 3c 6d]
Seat 1: Linghem (big blind) folded before Flop
Seat 2: matiko09 collected ($31.99)
Seat 3: R1aki folded before Flop (didn't bet)
Seat 4: cn_chayanne folded before Flop (didn't bet)
Seat 5: aseban11 folded before Flop (didn't bet)
Seat 6: runner10 folded on the Flop
Seat 7: Pacifistas folded before Flop (didn't bet)
Seat 8: Dachish (button) folded before Flop (didn't bet)
Seat 9: B@ngel (small blind) folded before Flop





PokerStars Hand #150706521630:  Hold'em No Limit ($0.50/$1.00 USD) - 2016/03/21 16:38:18 CET [2016/03/21 11:38:18 ET]
Table 'Harding II' 9-max Seat #5 is the button
Seat 5: matiko09 ($102.50 in chips) 
Seat 6: runner10 ($38.41 in chips) 
Seat 8: Pacifistas ($109.28 in chips) 
runner10: posts small blind $0.50
Pacifistas: posts big blind $1
sanpidk: sits out 
*** HOLE CARDS ***
Dealt to matiko09 [Jd Kd]
matiko09: raises $1.27 to $2.27
runner10: raises $7.73 to $10
sanpidk leaves the table
Pacifistas: folds 
matiko09: folds 
Uncalled bet ($7.73) returned to runner10
runner10 collected $5.54 from pot
runner10: doesn't show hand 
*** SUMMARY ***
Total pot $5.54 | Rake $0 
Seat 5: matiko09 (button) folded before Flop
Seat 6: runner10 (small blind) collected ($5.54)
Seat 8: Pacifistas (big blind) folded before Flop





PokerStars Hand #150706526428:  Hold'em No Limit ($0.50/$1.00 USD) - 2016/03/21 16:38:25 CET [2016/03/21 11:38:25 ET]
Table 'Genoveva II' 9-max Seat #9 is the button
Seat 1: RICKA16 ($150.75 in chips) 
Seat 2: Ez1kelL ($25.66 in chips) 
Seat 3: sanpidk ($113.49 in chips) 
Seat 4: aseban11 ($100 in chips) 
Seat 5: volwebni4ek ($50.44 in chips) 
Seat 6: Pacifistas ($100 in chips) 
Seat 8: R1aki ($117.06 in chips) 
Seat 9: matiko09 ($122.20 in chips) 
RICKA16: posts small blind $0.50
Ez1kelL: posts big blind $1
grifkaaa: sits out 
*** HOLE CARDS ***
Dealt to matiko09 [6c 7d]
sanpidk: folds 
aseban11: folds 
volwebni4ek: raises $2 to $3
Pacifistas: folds 
R1aki: folds 
matiko09: folds 
RICKA16: folds 
Ez1kelL: folds 
Uncalled bet ($2) returned to volwebni4ek
volwebni4ek collected $2.50 from pot
volwebni4ek: doesn't show hand 
*** SUMMARY ***
Total pot $2.50 | Rake $0 
Seat 1: RICKA16 (small blind) folded before Flop
Seat 2: Ez1kelL (big blind) folded before Flop
Seat 3: sanpidk folded before Flop (didn't bet)
Seat 4: aseban11 folded before Flop (didn't bet)
Seat 5: volwebni4ek collected ($2.50)
Seat 6: Pacifistas folded before Flop (didn't bet)
Seat 8: R1aki folded before Flop (didn't bet)
Seat 9: matiko09 (button) folded before Flop (didn't bet)





PokerStars Hand #150706539915:  Hold'em No Limit ($0.50/$1.00 USD) - 2016/03/21 16:38:43 CET [2016/03/21 11:38:43 ET]
Table 'Onnie II' 9-max Seat #9 is the button
Seat 1: aseban11 ($198.58 in chips) 
Seat 2: RICKA16 ($103.94 in chips) 
Seat 3: cn_chayanne ($100 in chips) 
Seat 4: Bothfeld11 ($74.36 in chips) 
Seat 6: Pacifistas ($101.01 in chips) 
Seat 7: djammusic ($72.08 in chips) 
Seat 8: solbi86 ($105.10 in chips) 
Seat 9: matiko09 ($114.62 in chips) 
aseban11: posts small blind $0.50
RICKA16: posts big blind $1
roninio1: sits out 
*** HOLE CARDS ***
Dealt to matiko09 [8s 9c]
cn_chayanne: folds 
Bothfeld11: folds 
Pacifistas: folds 
djammusic: folds 
solbi86: folds 
matiko09: raises $1.27 to $2.27
aseban11: folds 
RICKA16: folds 
Uncalled bet ($1.27) returned to matiko09
matiko09 collected $2.50 from pot
matiko09: doesn't show hand 
*** SUMMARY ***
Total pot $2.50 | Rake $0 
Seat 1: aseban11 (small blind) folded before Flop
Seat 2: RICKA16 (big blind) folded before Flop
Seat 3: cn_chayanne folded before Flop (didn't bet)
Seat 4: Bothfeld11 folded before Flop (didn't bet)
Seat 6: Pacifistas folded before Flop (didn't bet)
Seat 7: djammusic folded before Flop (didn't bet)
Seat 8: solbi86 folded before Flop (didn't bet)
Seat 9: matiko09 (button) collected ($2.50)





PokerStars Hand #150706546225:  Hold'em No Limit ($0.50/$1.00 USD) - 2016/03/21 16:38:52 CET [2016/03/21 11:38:52 ET]
Table 'Havnia' 9-max Seat #7 is the button
Seat 2: cn_chayanne ($124.90 in chips) 
Seat 3: drakariss ($44.75 in chips) 
Seat 4: Rikti ($43.87 in chips) 
Seat 5: matiko09 ($100 in chips) 
Seat 7: flk.Dasas ($202.20 in chips) 
Seat 8: gabi_igna ($100 in chips) 
Seat 9: Vikulja1993 ($100 in chips) 
gabi_igna: posts small blind $0.50
Vikulja1993: posts big blind $1
Khaine_CM: sits out 
*** HOLE CARDS ***
Dealt to matiko09 [8d 3s]
cn_chayanne: folds 
drakariss: folds 
Rikti: folds 
matiko09: folds 
flk.Dasas: raises $1.50 to $2.50
gabi_igna: raises $6.50 to $9
Vikulja1993: folds 
flk.Dasas: folds 
Uncalled bet ($6.50) returned to gabi_igna
gabi_igna collected $6 from pot
gabi_igna: doesn't show hand 
*** SUMMARY ***
Total pot $6 | Rake $0 
Seat 2: cn_chayanne folded before Flop (didn't bet)
Seat 3: drakariss folded before Flop (didn't bet)
Seat 4: Rikti folded before Flop (didn't bet)
Seat 5: matiko09 folded before Flop (didn't bet)
Seat 7: flk.Dasas (button) folded before Flop
Seat 8: gabi_igna (small blind) collected ($6)
Seat 9: Vikulja1993 (big blind) folded before Flop





PokerStars Hand #150706549960:  Hold'em No Limit ($0.50/$1.00 USD) - 2016/03/21 16:38:57 CET [2016/03/21 11:38:57 ET]
Table 'Noel' 9-max Seat #8 is the button
Seat 1: ep538 ($40 in chips) 
Seat 2: cobrik23 ($179.40 in chips) 
Seat 4: Kobiroga150 ($89.84 in chips) 
Seat 5: matiko09 ($116.22 in chips) 
Seat 6: hammerwife ($103.23 in chips) 
Seat 7: djammusic ($39 in chips) 
Seat 8: Dachish ($63.50 in chips) 
Seat 9: grifkaaa ($102.84 in chips) 
grifkaaa: posts small blind $0.50
ep538: posts big blind $1
*** HOLE CARDS ***
Dealt to matiko09 [5d Jc]
cobrik23: raises $2 to $3
Kobiroga150: folds 
matiko09: folds 
hammerwife: folds 
djammusic: folds 
Dachish: folds 
grifkaaa: folds 
ep538: folds 
Uncalled bet ($2) returned to cobrik23
cobrik23 collected $2.50 from pot
cobrik23: doesn't show hand 
*** SUMMARY ***
Total pot $2.50 | Rake $0 
Seat 1: ep538 (big blind) folded before Flop
Seat 2: cobrik23 collected ($2.50)
Seat 4: Kobiroga150 folded before Flop (didn't bet)
Seat 5: matiko09 folded before Flop (didn't bet)
Seat 6: hammerwife folded before Flop (didn't bet)
Seat 7: djammusic folded before Flop (didn't bet)
Seat 8: Dachish (button) folded before Flop (didn't bet)
Seat 9: grifkaaa (small blind) folded before Flop





PokerStars Hand #150706553906:  Hold'em No Limit ($0.50/$1.00 USD) - 2016/03/21 16:39:02 CET [2016/03/21 11:39:02 ET]
Table 'Genoveva II' 9-max Seat #1 is the button
Seat 1: RICKA16 ($150.25 in chips) 
Seat 2: Ez1kelL ($24.66 in chips) 
Seat 3: sanpidk ($113.49 in chips) 
Seat 4: aseban11 ($100 in chips) 
Seat 5: volwebni4ek ($51.94 in chips) 
Seat 6: Pacifistas ($100 in chips) 
Seat 8: R1aki ($117.06 in chips) 
Seat 9: matiko09 ($122.20 in chips) 
Ez1kelL: posts small blind $0.50
sanpidk: posts big blind $1
grifkaaa: sits out 
*** HOLE CARDS ***
Dealt to matiko09 [7d Qh]
aseban11: folds 
volwebni4ek: folds 
Pacifistas: folds 
R1aki: folds 
matiko09: folds 
RICKA16: folds 
Ez1kelL: folds 
Uncalled bet ($0.50) returned to sanpidk
sanpidk collected $1 from pot
sanpidk: doesn't show hand 
*** SUMMARY ***
Total pot $1 | Rake $0 
Seat 1: RICKA16 (button) folded before Flop (didn't bet)
Seat 2: Ez1kelL (small blind) folded before Flop
Seat 3: sanpidk (big blind) collected ($1)
Seat 4: aseban11 folded before Flop (didn't bet)
Seat 5: volwebni4ek folded before Flop (didn't bet)
Seat 6: Pacifistas folded before Flop (didn't bet)
Seat 8: R1aki folded before Flop (didn't bet)
Seat 9: matiko09 folded before Flop (didn't bet)





PokerStars Hand #150706561862:  Hold'em No Limit ($0.50/$1.00 USD) - 2016/03/21 16:39:13 CET [2016/03/21 11:39:13 ET]
Table 'Massalia II' 9-max Seat #3 is the button
Seat 1: crepke ($83.92 in chips) 
Seat 2: solbi86 ($100.40 in chips) 
Seat 3: 123chambo ($96.90 in chips) 
Seat 4: OriginalTony ($117.60 in chips) 
Seat 5: roninio1 ($101.90 in chips) 
Seat 6: Pacifistas ($112.94 in chips) 
Seat 7: flk.Dasas ($100 in chips) 
Seat 8: matiko09 ($201.30 in chips) 
Seat 9: R1aki ($116.79 in chips) 
OriginalTony: posts small blind $0.50
roninio1: posts big blind $1
crepke: posts the ante $0.20
solbi86: posts the ante $0.20
123chambo: posts the ante $0.20
OriginalTony: posts the ante $0.20
roninio1: posts the ante $0.20
Pacifistas: posts the ante $0.20
flk.Dasas: posts the ante $0.20
matiko09: posts the ante $0.20
R1aki: posts the ante $0.20
*** HOLE CARDS ***
Dealt to matiko09 [3d 4c]
Pacifistas: folds 
flk.Dasas: folds 
matiko09: folds 
R1aki: folds 
crepke: folds 
solbi86: raises $1.50 to $2.50
123chambo: folds 
OriginalTony: folds 
roninio1: calls $1.50
*** FLOP *** [7s Ad 4s]
roninio1: checks 
solbi86: bets $3.83
roninio1: calls $3.83
*** TURN *** [7s Ad 4s] [Tc]
roninio1: checks 
solbi86: checks 
*** RIVER *** [7s Ad 4s Tc] [Ac]
roninio1: checks 
solbi86: checks 
*** SHOW DOWN ***
roninio1: shows [7d Jc] (two pair, Aces and Sevens)
solbi86: shows [Qh 7h] (two pair, Aces and Sevens - Queen kicker)
solbi86 collected $14.29 from pot
*** SUMMARY ***
Total pot $14.96 | Rake $0.67 
Board [7s Ad 4s Tc Ac]
Seat 1: crepke folded before Flop (didn't bet)
Seat 2: solbi86 showed [Qh 7h] and won ($14.29) with two pair, Aces and Sevens
Seat 3: 123chambo (button) folded before Flop (didn't bet)
Seat 4: OriginalTony (small blind) folded before Flop
Seat 5: roninio1 (big blind) showed [7d Jc] and lost with two pair, Aces and Sevens
Seat 6: Pacifistas folded before Flop (didn't bet)
Seat 7: flk.Dasas folded before Flop (didn't bet)
Seat 8: matiko09 folded before Flop (didn't bet)
Seat 9: R1aki folded before Flop (didn't bet)





PokerStars Hand #150706565381:  Hold'em No Limit ($0.50/$1.00 USD) - 2016/03/21 16:39:18 CET [2016/03/21 11:39:18 ET]
Table 'Onnie II' 9-max Seat #1 is the button
Seat 1: aseban11 ($198.08 in chips) 
Seat 2: RICKA16 ($102.94 in chips) 
Seat 3: cn_chayanne ($100 in chips) 
Seat 4: Bothfeld11 ($74.36 in chips) 
Seat 6: Pacifistas ($101.01 in chips) 
Seat 7: djammusic ($72.08 in chips) 
Seat 8: solbi86 ($105.10 in chips) 
Seat 9: matiko09 ($116.12 in chips) 
RICKA16: posts small blind $0.50
cn_chayanne: posts big blind $1
roninio1: sits out 
*** HOLE CARDS ***
Dealt to matiko09 [9s Qd]
Bothfeld11: calls $1
Pacifistas: raises $3 to $4
djammusic: folds 
solbi86: folds 
matiko09: folds 
aseban11: folds 
RICKA16: folds 
cn_chayanne: folds 
Bothfeld11: calls $3
*** FLOP *** [2d 3c 5s]
Bothfeld11: checks 
Pacifistas: bets $6.50
Bothfeld11: calls $6.50
*** TURN *** [2d 3c 5s] [7h]
Bothfeld11: checks 
Pacifistas: bets $13.50
Bothfeld11: raises $50.36 to $63.86 and is all-in
Pacifistas: folds 
Uncalled bet ($50.36) returned to Bothfeld11
Bothfeld11 collected $47.27 from pot
*** SUMMARY ***
Total pot $49.50 | Rake $2.23 
Board [2d 3c 5s 7h]
Seat 1: aseban11 (button) folded before Flop (didn't bet)
Seat 2: RICKA16 (small blind) folded before Flop
Seat 3: cn_chayanne (big blind) folded before Flop
Seat 4: Bothfeld11 collected ($47.27)
Seat 6: Pacifistas folded on the Turn
Seat 7: djammusic folded before Flop (didn't bet)
Seat 8: solbi86 folded before Flop (didn't bet)
Seat 9: matiko09 folded before Flop (didn't bet)





PokerStars Hand #150706566435:  Hold'em No Limit ($0.50/$1.00 USD) - 2016/03/21 16:39:20 CET [2016/03/21 11:39:20 ET]
Table 'Toutatis II' 9-max Seat #9 is the button
Seat 1: Linghem ($107.58 in chips) 
Seat 2: matiko09 ($117.49 in chips) 
Seat 3: R1aki ($100 in chips) 
Seat 4: cn_chayanne ($103 in chips) 
Seat 5: aseban11 ($100 in chips) 
Seat 6: runner10 ($44.01 in chips) 
Seat 7: Pacifistas ($100 in chips) 
Seat 8: Dachish ($70 in chips) 
Seat 9: B@ngel ($107.24 in chips) 
Linghem: posts small blind $0.50
matiko09: posts big blind $1
*** HOLE CARDS ***
Dealt to matiko09 [2h Jd]
B@ngel is disconnected 
R1aki: folds 
cn_chayanne: folds 
aseban11: raises $2 to $3
runner10: folds 
Pacifistas: folds 
Dachish: folds 
B@ngel has timed out while disconnected
B@ngel: folds 
Linghem: folds 
matiko09: folds 
Uncalled bet ($2) returned to aseban11
aseban11 collected $2.50 from pot
aseban11: doesn't show hand 
*** SUMMARY ***
Total pot $2.50 | Rake $0 
Seat 1: Linghem (small blind) folded before Flop
Seat 2: matiko09 (big blind) folded before Flop
Seat 3: R1aki folded before Flop (didn't bet)
Seat 4: cn_chayanne folded before Flop (didn't bet)
Seat 5: aseban11 collected ($2.50)
Seat 6: runner10 folded before Flop (didn't bet)
Seat 7: Pacifistas folded before Flop (didn't bet)
Seat 8: Dachish folded before Flop (didn't bet)
Seat 9: B@ngel (button) folded before Flop (didn't bet)





PokerStars Hand #150706567252:  Hold'em No Limit ($0.50/$1.00 USD) - 2016/03/21 16:39:21 CET [2016/03/21 11:39:21 ET]
Table 'Gondola II' 9-max Seat #6 is the button
Seat 1: matiko09 ($103.64 in chips) 
Seat 2: R1aki ($113.26 in chips) 
Seat 3: flk.Dasas ($123.86 in chips) 
Seat 4: aseban11 ($116.10 in chips) 
Seat 5: teukka8 ($44.37 in chips) 
Seat 6: SanychStar ($114.37 in chips) 
Seat 7: Pacifistas ($100.44 in chips) 
Seat 8: cn_chayanne ($100 in chips) 
Pacifistas: posts small blind $0.50
cn_chayanne: posts big blind $1
djammusic: sits out 
*** HOLE CARDS ***
Dealt to matiko09 [Ac Ts]
matiko09: folds 
R1aki: folds 
flk.Dasas: folds 
aseban11: raises $2 to $3
teukka8: folds 
SanychStar: raises $6 to $9
Pacifistas: folds 
cn_chayanne: folds 
aseban11: folds 
Uncalled bet ($6) returned to SanychStar
SanychStar collected $7.50 from pot
*** SUMMARY ***
Total pot $7.50 | Rake $0 
Seat 1: matiko09 folded before Flop (didn't bet)
Seat 2: R1aki folded before Flop (didn't bet)
Seat 3: flk.Dasas folded before Flop (didn't bet)
Seat 4: aseban11 folded before Flop
Seat 5: teukka8 folded before Flop (didn't bet)
Seat 6: SanychStar (button) collected ($7.50)
Seat 7: Pacifistas (small blind) folded before Flop
Seat 8: cn_chayanne (big blind) folded before Flop





PokerStars Hand #150706573096:  Hold'em No Limit ($0.50/$1.00 USD) - 2016/03/21 16:39:29 CET [2016/03/21 11:39:29 ET]
Table 'Genoveva II' 9-max Seat #2 is the button
Seat 1: RICKA16 ($150.25 in chips) 
Seat 2: Ez1kelL ($24.16 in chips) 
Seat 3: sanpidk ($113.99 in chips) 
Seat 4: aseban11 ($100 in chips) 
Seat 5: volwebni4ek ($51.94 in chips) 
Seat 6: Pacifistas ($100 in chips) 
Seat 8: R1aki ($117.06 in chips) 
Seat 9: matiko09 ($122.20 in chips) 
sanpidk: posts small blind $0.50
aseban11: posts big blind $1
grifkaaa: sits out 
*** HOLE CARDS ***
Dealt to matiko09 [6c Ad]
volwebni4ek: folds 
Pacifistas: folds 
R1aki: folds 
matiko09: folds 
RICKA16: raises $2 to $3
Ez1kelL: calls $3
sanpidk: folds 
aseban11: calls $2
*** FLOP *** [Ah 8h 8c]
aseban11: checks 
RICKA16: checks 
Ez1kelL: bets $4.53
aseban11: folds 
RICKA16: calls $4.53
*** TURN *** [Ah 8h 8c] [8d]
RICKA16: checks 
Ez1kelL: bets $8.86
RICKA16: raises $8.86 to $17.72
Ez1kelL: folds 
Uncalled bet ($8.86) returned to RICKA16
RICKA16 collected $34.65 from pot
RICKA16: doesn't show hand 
*** SUMMARY ***
Total pot $36.28 | Rake $1.63 
Board [Ah 8h 8c 8d]
Seat 1: RICKA16 collected ($34.65)
Seat 2: Ez1kelL (button) folded on the Turn
Seat 3: sanpidk (small blind) folded before Flop
Seat 4: aseban11 (big blind) folded on the Flop
Seat 5: volwebni4ek folded before Flop (didn't bet)
Seat 6: Pacifistas folded before Flop (didn't bet)
Seat 8: R1aki folded before Flop (didn't bet)
Seat 9: matiko09 folded before Flop (didn't bet)





PokerStars Hand #150706578843:  Hold'em No Limit ($0.50/$1.00 USD) - 2016/03/21 16:39:36 CET [2016/03/21 11:39:36 ET]
Table 'Noel' 9-max Seat #9 is the button
Seat 1: ep538 ($39 in chips) 
Seat 2: cobrik23 ($180.90 in chips) 
Seat 4: Kobiroga150 ($89.84 in chips) 
Seat 5: matiko09 ($116.22 in chips) 
Seat 6: hammerwife ($103.23 in chips) 
Seat 7: djammusic ($39 in chips) 
Seat 8: Dachish ($63.50 in chips) 
Seat 9: grifkaaa ($102.34 in chips) 
ep538: posts small blind $0.50
cobrik23: posts big blind $1
*** HOLE CARDS ***
Dealt to matiko09 [Js 4d]
Kobiroga150: calls $1
matiko09: folds 
hammerwife: folds 
djammusic: folds 
Dachish: raises $3.50 to $4.50
grifkaaa: folds 
ep538: folds 
cobrik23: folds 
Kobiroga150: folds 
Uncalled bet ($3.50) returned to Dachish
Dachish collected $3.50 from pot
Dachish: doesn't show hand 
*** SUMMARY ***
Total pot $3.50 | Rake $0 
Seat 1: ep538 (small blind) folded before Flop
Seat 2: cobrik23 (big blind) folded before Flop
Seat 4: Kobiroga150 folded before Flop
Seat 5: matiko09 folded before Flop (didn't bet)
Seat 6: hammerwife folded before Flop (didn't bet)
Seat 7: djammusic folded before Flop (didn't bet)
Seat 8: Dachish collected ($3.50)
Seat 9: grifkaaa (button) folded before Flop (didn't bet)





PokerStars Hand #150706582066:  Hold'em No Limit ($0.50/$1.00 USD) - 2016/03/21 16:39:41 CET [2016/03/21 11:39:41 ET]
Table 'Havnia' 9-max Seat #8 is the button
Seat 1: Khaine_CM ($100 in chips) 
Seat 2: cn_chayanne ($124.90 in chips) 
Seat 3: drakariss ($44.75 in chips) 
Seat 4: Rikti ($43.87 in chips) 
Seat 5: matiko09 ($100 in chips) 
Seat 7: flk.Dasas ($199.70 in chips) 
Seat 8: gabi_igna ($103.50 in chips) 
Seat 9: Vikulja1993 ($100 in chips) 
Vikulja1993: posts small blind $0.50
Khaine_CM: posts big blind $1
*** HOLE CARDS ***
Dealt to matiko09 [7h 4s]
cn_chayanne: raises $1.50 to $2.50
drakariss: calls $2.50
Rikti: folds 
matiko09: folds 
flk.Dasas: folds 
gabi_igna: folds 
Vikulja1993: folds 
Khaine_CM: folds 
*** FLOP *** [Ac 6c Jh]
cn_chayanne: checks 
drakariss: checks 
*** TURN *** [Ac 6c Jh] [Ad]
cn_chayanne: checks 
drakariss: bets $3
cn_chayanne: calls $3
*** RIVER *** [Ac 6c Jh Ad] [Qc]
cn_chayanne: checks 
drakariss: checks 
*** SHOW DOWN ***
cn_chayanne: shows [Qd Qs] (a full house, Queens full of Aces)
drakariss: mucks hand 
cn_chayanne collected $11.94 from pot
*** SUMMARY ***
Total pot $12.50 | Rake $0.56 
Board [Ac 6c Jh Ad Qc]
Seat 1: Khaine_CM (big blind) folded before Flop
Seat 2: cn_chayanne showed [Qd Qs] and won ($11.94) with a full house, Queens full of Aces
Seat 3: drakariss mucked [Jd 9d]
Seat 4: Rikti folded before Flop (didn't bet)
Seat 5: matiko09 folded before Flop (didn't bet)
Seat 7: flk.Dasas folded before Flop (didn't bet)
Seat 8: gabi_igna (button) folded before Flop (didn't bet)
Seat 9: Vikulja1993 (small blind) folded before Flop





PokerStars Hand #150706605144:  Hold'em No Limit ($0.50/$1.00 USD) - 2016/03/21 16:40:12 CET [2016/03/21 11:40:12 ET]
Table 'Gondola II' 9-max Seat #7 is the button
Seat 1: matiko09 ($103.64 in chips) 
Seat 2: R1aki ($113.26 in chips) 
Seat 3: flk.Dasas ($123.86 in chips) 
Seat 4: aseban11 ($113.10 in chips) 
Seat 5: teukka8 ($44.37 in chips) 
Seat 6: SanychStar ($118.87 in chips) 
Seat 7: Pacifistas ($100 in chips) 
Seat 8: cn_chayanne ($100 in chips) 
Seat 9: djammusic ($47.45 in chips) 
cn_chayanne: posts small blind $0.50
djammusic: posts big blind $1
*** HOLE CARDS ***
Dealt to matiko09 [8c Ah]
matiko09: folds 
R1aki: folds 
flk.Dasas: folds 
aseban11: folds 
teukka8: folds 
SanychStar: folds 
Pacifistas: raises $1.50 to $2.50
cn_chayanne: calls $2
djammusic: folds 
*** FLOP *** [7h 6d 5s]
cn_chayanne: checks 
Pacifistas: checks 
*** TURN *** [7h 6d 5s] [5d]
cn_chayanne: bets $4.29
Pacifistas: calls $4.29
*** RIVER *** [7h 6d 5s 5d] [5h]
cn_chayanne: checks 
Pacifistas: checks 
*** SHOW DOWN ***
cn_chayanne: shows [Jd Kc] (three of a kind, Fives)
Pacifistas: shows [Ad 9c] (three of a kind, Fives - Ace kicker)
Pacifistas collected $13.92 from pot
*** SUMMARY ***
Total pot $14.58 | Rake $0.66 
Board [7h 6d 5s 5d 5h]
Seat 1: matiko09 folded before Flop (didn't bet)
Seat 2: R1aki folded before Flop (didn't bet)
Seat 3: flk.Dasas folded before Flop (didn't bet)
Seat 4: aseban11 folded before Flop (didn't bet)
Seat 5: teukka8 folded before Flop (didn't bet)
Seat 6: SanychStar folded before Flop (didn't bet)
Seat 7: Pacifistas (button) showed [Ad 9c] and won ($13.92) with three of a kind, Fives
Seat 8: cn_chayanne (small blind) showed [Jd Kc] and lost with three of a kind, Fives
Seat 9: djammusic (big blind) folded before Flop





PokerStars Hand #150706607456:  Hold'em No Limit ($0.50/$1.00 USD) - 2016/03/21 16:40:16 CET [2016/03/21 11:40:16 ET]
Table 'Toutatis II' 9-max Seat #1 is the button
Seat 1: Linghem ($107.08 in chips) 
Seat 2: matiko09 ($116.49 in chips) 
Seat 4: cn_chayanne ($103 in chips) 
Seat 5: aseban11 ($101.50 in chips) 
Seat 6: runner10 ($44.01 in chips) 
Seat 7: Pacifistas ($100 in chips) 
Seat 8: Dachish ($70 in chips) 
matiko09: posts small blind $0.50
R1aki: is sitting out 
cn_chayanne: posts big blind $1
*** HOLE CARDS ***
Dealt to matiko09 [3h 4h]
R1aki leaves the table
Vikulja1993 joins the table at seat #3 
aseban11: folds 
runner10: folds 
Pacifistas: folds 
Dachish: folds 
Linghem: raises $1 to $2
matiko09: folds 
Vikulja1993 leaves the table
cn_chayanne: folds 
Uncalled bet ($1) returned to Linghem
Linghem collected $2.50 from pot
Linghem: doesn't show hand 
*** SUMMARY ***
Total pot $2.50 | Rake $0 
Seat 1: Linghem (button) collected ($2.50)
Seat 2: matiko09 (small blind) folded before Flop
Seat 4: cn_chayanne (big blind) folded before Flop
Seat 5: aseban11 folded before Flop (didn't bet)
Seat 6: runner10 folded before Flop (didn't bet)
Seat 7: Pacifistas folded before Flop (didn't bet)
Seat 8: Dachish folded before Flop (didn't bet)





PokerStars Hand #150706609276:  Hold'em No Limit ($0.50/$1.00 USD) - 2016/03/21 16:40:18 CET [2016/03/21 11:40:18 ET]
Table 'Massalia II' 9-max Seat #4 is the button
Seat 1: crepke ($83.72 in chips) 
Seat 2: solbi86 ($108.16 in chips) 
Seat 3: 123chambo ($96.70 in chips) 
Seat 4: OriginalTony ($116.90 in chips) 
Seat 5: roninio1 ($95.37 in chips) 
Seat 6: Pacifistas ($112.74 in chips) 
Seat 7: flk.Dasas ($100 in chips) 
Seat 8: matiko09 ($201.10 in chips) 
Seat 9: R1aki ($116.59 in chips) 
roninio1: posts small blind $0.50
Pacifistas: posts big blind $1
crepke: posts the ante $0.20
solbi86: posts the ante $0.20
123chambo: posts the ante $0.20
OriginalTony: posts the ante $0.20
roninio1: posts the ante $0.20
Pacifistas: posts the ante $0.20
flk.Dasas: posts the ante $0.20
matiko09: posts the ante $0.20
R1aki: posts the ante $0.20
*** HOLE CARDS ***
Dealt to matiko09 [8c 6d]
flk.Dasas: folds 
matiko09: folds 
R1aki: folds 
crepke: folds 
solbi86: raises $2 to $3
123chambo: calls $3
OriginalTony: folds 
roninio1: calls $2.50
Pacifistas: calls $2
*** FLOP *** [Js 9h Ac]
roninio1: checks 
Pacifistas: checks 
solbi86: checks 
123chambo: checks 
*** TURN *** [Js 9h Ac] [Jh]
roninio1: checks 
Pacifistas: checks 
solbi86: checks 
123chambo: checks 
*** RIVER *** [Js 9h Ac Jh] [5s]
roninio1: checks 
Pacifistas: checks 
solbi86: checks 
123chambo: checks 
*** SHOW DOWN ***
roninio1: shows [4d Qd] (a pair of Jacks)
Pacifistas: shows [As 2h] (two pair, Aces and Jacks)
solbi86: mucks hand 
123chambo: mucks hand 
Pacifistas collected $13.18 from pot
*** SUMMARY ***
Total pot $13.80 | Rake $0.62 
Board [Js 9h Ac Jh 5s]
Seat 1: crepke folded before Flop (didn't bet)
Seat 2: solbi86 mucked [6h 6c]
Seat 3: 123chambo mucked [Qh Kd]
Seat 4: OriginalTony (button) folded before Flop (didn't bet)
Seat 5: roninio1 (small blind) showed [4d Qd] and lost with a pair of Jacks
Seat 6: Pacifistas (big blind) showed [As 2h] and won ($13.18) with two pair, Aces and Jacks
Seat 7: flk.Dasas folded before Flop (didn't bet)
Seat 8: matiko09 folded before Flop (didn't bet)
Seat 9: R1aki folded before Flop (didn't bet)





PokerStars Hand #150706623482:  Hold'em No Limit ($0.50/$1.00 USD) - 2016/03/21 16:40:37 CET [2016/03/21 11:40:37 ET]
Table 'Onnie II' 9-max Seat #2 is the button
Seat 1: aseban11 ($198.08 in chips) 
Seat 2: RICKA16 ($102.44 in chips) 
Seat 3: cn_chayanne ($100 in chips) 
Seat 4: Bothfeld11 ($97.63 in chips) 
Seat 6: Pacifistas ($100 in chips) 
Seat 7: djammusic ($72.08 in chips) 
Seat 8: solbi86 ($105.10 in chips) 
Seat 9: matiko09 ($116.12 in chips) 
cn_chayanne: posts small blind $0.50
Bothfeld11: posts big blind $1
roninio1: sits out 
*** HOLE CARDS ***
Dealt to matiko09 [3d 4h]
Pacifistas: folds 
djammusic: folds 
solbi86: folds 
matiko09: folds 
aseban11: folds 
RICKA16: folds 
cn_chayanne: raises $2 to $3
Bothfeld11: folds 
Uncalled bet ($2) returned to cn_chayanne
cn_chayanne collected $2 from pot
cn_chayanne: doesn't show hand 
*** SUMMARY ***
Total pot $2 | Rake $0 
Seat 1: aseban11 folded before Flop (didn't bet)
Seat 2: RICKA16 (button) folded before Flop (didn't bet)
Seat 3: cn_chayanne (small blind) collected ($2)
Seat 4: Bothfeld11 (big blind) folded before Flop
Seat 6: Pacifistas folded before Flop (didn't bet)
Seat 7: djammusic folded before Flop (didn't bet)
Seat 8: solbi86 folded before Flop (didn't bet)
Seat 9: matiko09 folded before Flop (didn't bet)





PokerStars Hand #150706622925:  Hold'em No Limit ($0.50/$1.00 USD) - 2016/03/21 16:40:37 CET [2016/03/21 11:40:37 ET]
Table 'Noel' 9-max Seat #1 is the button
Seat 1: ep538 ($38.50 in chips) 
Seat 2: cobrik23 ($179.90 in chips) 
Seat 4: Kobiroga150 ($88.84 in chips) 
Seat 5: matiko09 ($116.22 in chips) 
Seat 6: hammerwife ($103.23 in chips) 
Seat 7: djammusic ($39 in chips) 
Seat 8: Dachish ($66 in chips) 
Seat 9: grifkaaa ($102.34 in chips) 
cobrik23: posts small blind $0.50
Kobiroga150: posts big blind $1
*** HOLE CARDS ***
Dealt to matiko09 [6s 3s]
matiko09: folds 
hammerwife: folds 
djammusic: folds 
Dachish: folds 
grifkaaa: raises $2 to $3
ep538: folds 
cobrik23: folds 
Kobiroga150: folds 
Uncalled bet ($2) returned to grifkaaa
grifkaaa collected $2.50 from pot
*** SUMMARY ***
Total pot $2.50 | Rake $0 
Seat 1: ep538 (button) folded before Flop (didn't bet)
Seat 2: cobrik23 (small blind) folded before Flop
Seat 4: Kobiroga150 (big blind) folded before Flop
Seat 5: matiko09 folded before Flop (didn't bet)
Seat 6: hammerwife folded before Flop (didn't bet)
Seat 7: djammusic folded before Flop (didn't bet)
Seat 8: Dachish folded before Flop (didn't bet)
Seat 9: grifkaaa collected ($2.50)





PokerStars Hand #150706624140:  Hold'em No Limit ($0.50/$1.00 USD) - 2016/03/21 16:40:38 CET [2016/03/21 11:40:38 ET]
Table 'Toutatis II' 9-max Seat #2 is the button
Seat 1: Linghem ($108.58 in chips) 
Seat 2: matiko09 ($115.99 in chips) 
Seat 4: cn_chayanne ($102 in chips) 
Seat 5: aseban11 ($101.50 in chips) 
Seat 6: runner10 ($44.01 in chips) 
Seat 7: Pacifistas ($100 in chips) 
Seat 8: Dachish ($70 in chips) 
Seat 9: B@ngel ($107.24 in chips) 
cn_chayanne: posts small blind $0.50
aseban11: posts big blind $1
*** HOLE CARDS ***
Dealt to matiko09 [Ah 2s]
runner10: folds 
Pacifistas: folds 
Dachish: folds 
B@ngel: folds 
Linghem: folds 
matiko09: raises $1.27 to $2.27
cn_chayanne: folds 
sanpidk joins the table at seat #3 
aseban11: folds 
Uncalled bet ($1.27) returned to matiko09
matiko09 collected $2.50 from pot
matiko09: doesn't show hand 
*** SUMMARY ***
Total pot $2.50 | Rake $0 
Seat 1: Linghem folded before Flop (didn't bet)
Seat 2: matiko09 (button) collected ($2.50)
Seat 4: cn_chayanne (small blind) folded before Flop
Seat 5: aseban11 (big blind) folded before Flop
Seat 6: runner10 folded before Flop (didn't bet)
Seat 7: Pacifistas folded before Flop (didn't bet)
Seat 8: Dachish folded before Flop (didn't bet)
Seat 9: B@ngel folded before Flop (didn't bet)





PokerStars Hand #150706623863:  Hold'em No Limit (€0.25/€0.50 EUR) - 2016/03/21 16:40:38 CET [2016/03/21 11:40:38 ET]
Table 'Auravictrix II' 9-max Seat #1 is the button
Seat 1: aponinho82 (€54.03 in chips) 
Seat 2: ffac (€51.25 in chips) 
Seat 3: matiko09 (€50 in chips) 
Seat 5: nombraalne1 (€50 in chips) 
ffac: posts small blind €0.25
matiko09: posts big blind €0.50
*** HOLE CARDS ***
Dealt to matiko09 [Jh Kc]
nombraalne1: folds 
aponinho82: calls €0.50
ffac: folds 
matiko09: checks 
*** FLOP *** [Kh Ac 6c]
matiko09: checks 
aponinho82: checks 
*** TURN *** [Kh Ac 6c] [2c]
matiko09: checks 
aponinho82: bets €1
matiko09: calls €1
*** RIVER *** [Kh Ac 6c 2c] [Ad]
matiko09: checks 
aponinho82: bets €1
matiko09: calls €1
*** SHOW DOWN ***
aponinho82: shows [Ks 6s] (two pair, Aces and Kings)
matiko09: shows [Jh Kc] (two pair, Aces and Kings - Jack kicker)
matiko09 collected €5.01 from pot
*** SUMMARY ***
Total pot €5.25 | Rake €0.24 
Board [Kh Ac 6c 2c Ad]
Seat 1: aponinho82 (button) showed [Ks 6s] and lost with two pair, Aces and Kings
Seat 2: ffac (small blind) folded before Flop
Seat 3: matiko09 (big blind) showed [Jh Kc] and won (€5.01) with two pair, Aces and Kings
Seat 5: nombraalne1 folded before Flop (didn't bet)





PokerStars Hand #150706634931:  Hold'em No Limit ($0.50/$1.00 USD) - 2016/03/21 16:40:53 CET [2016/03/21 11:40:53 ET]
Table 'Havnia' 9-max Seat #9 is the button
Seat 1: Khaine_CM ($100 in chips) 
Seat 3: drakariss ($39.25 in chips) 
Seat 4: Rikti ($43.87 in chips) 
Seat 5: matiko09 ($100 in chips) 
Seat 7: flk.Dasas ($199.70 in chips) 
Seat 8: gabi_igna ($103.50 in chips) 
Seat 9: Vikulja1993 ($100 in chips) 
Khaine_CM: posts small blind $0.50
cn_chayanne: is sitting out 
drakariss: posts big blind $1
*** HOLE CARDS ***
Dealt to matiko09 [4h 9h]
cn_chayanne leaves the table
Rikti: folds 
i am owsome joins the table at seat #2 
matiko09: folds 
flk.Dasas: folds 
gabi_igna: folds 
Vikulja1993: folds 
Khaine_CM: raises $2 to $3
drakariss: folds 
Uncalled bet ($2) returned to Khaine_CM
Khaine_CM collected $2 from pot
Khaine_CM: doesn't show hand 
*** SUMMARY ***
Total pot $2 | Rake $0 
Seat 1: Khaine_CM (small blind) collected ($2)
Seat 3: drakariss (big blind) folded before Flop
Seat 4: Rikti folded before Flop (didn't bet)
Seat 5: matiko09 folded before Flop (didn't bet)
Seat 7: flk.Dasas folded before Flop (didn't bet)
Seat 8: gabi_igna folded before Flop (didn't bet)
Seat 9: Vikulja1993 (button) folded before Flop (didn't bet)





PokerStars Hand #150706640970:  Hold'em No Limit ($0.50/$1.00 USD) - 2016/03/21 16:41:01 CET [2016/03/21 11:41:01 ET]
Table 'Genoveva II' 9-max Seat #3 is the button
Seat 1: RICKA16 ($168.51 in chips) 
Seat 2: Ez1kelL ($7.77 in chips) 
Seat 3: sanpidk ($113.49 in chips) 
Seat 4: aseban11 ($100 in chips) 
Seat 7: grifkaaa ($100 in chips) 
Seat 8: R1aki ($117.06 in chips) 
Seat 9: matiko09 ($122.20 in chips) 
aseban11: posts small blind $0.50
volwebni4ek: is sitting out 
Pacifistas: is sitting out 
grifkaaa: posts big blind $1
*** HOLE CARDS ***
Dealt to matiko09 [9s 2h]
Pacifistas leaves the table
R1aki: folds 
R1aki leaves the table
Vikulja1993 joins the table at seat #8 
Dachish joins the table at seat #6 
matiko09: folds 
RICKA16: folds 
Ez1kelL: folds 
sanpidk: folds 
Vikulja1993 leaves the table
aseban11: raises $2 to $3
grifkaaa: calls $2
*** FLOP *** [9d Kd Jc]
aseban11: checks 
grifkaaa: checks 
*** TURN *** [9d Kd Jc] [6h]
aseban11: checks 
grifkaaa: checks 
*** RIVER *** [9d Kd Jc 6h] [Jd]
aseban11: checks 
grifkaaa: checks 
*** SHOW DOWN ***
aseban11: shows [9h 5h] (two pair, Jacks and Nines)
grifkaaa: mucks hand 
aseban11 collected $5.73 from pot
*** SUMMARY ***
Total pot $6 | Rake $0.27 
Board [9d Kd Jc 6h Jd]
Seat 1: RICKA16 folded before Flop (didn't bet)
Seat 2: Ez1kelL folded before Flop (didn't bet)
Seat 3: sanpidk (button) folded before Flop (didn't bet)
Seat 4: aseban11 (small blind) showed [9h 5h] and won ($5.73) with two pair, Jacks and Nines
Seat 7: grifkaaa (big blind) mucked [Ah 7s]
Seat 8: R1aki folded before Flop (didn't bet)
Seat 9: matiko09 folded before Flop (didn't bet)





PokerStars Hand #150706642055:  Hold'em No Limit ($0.50/$1.00 USD) - 2016/03/21 16:41:03 CET [2016/03/21 11:41:03 ET]
Table 'Onnie II' 9-max Seat #3 is the button
Seat 1: aseban11 ($198.08 in chips) 
Seat 2: RICKA16 ($102.44 in chips) 
Seat 3: cn_chayanne ($101 in chips) 
Seat 4: Bothfeld11 ($96.63 in chips) 
Seat 5: roninio1 ($37.69 in chips) 
Seat 6: Pacifistas ($100 in chips) 
Seat 7: djammusic ($72.08 in chips) 
Seat 8: solbi86 ($105.10 in chips) 
Seat 9: matiko09 ($116.12 in chips) 
Bothfeld11: posts small blind $0.50
roninio1: posts big blind $1
*** HOLE CARDS ***
Dealt to matiko09 [3c Kh]
Pacifistas: folds 
djammusic: folds 
solbi86: folds 
matiko09: folds 
aseban11: raises $1.50 to $2.50
RICKA16: calls $2.50
cn_chayanne: folds 
Bothfeld11: calls $2
roninio1: calls $1.50
*** FLOP *** [Kd Jh 3d]
Bothfeld11: checks 
roninio1: checks 
aseban11: checks 
RICKA16: checks 
*** TURN *** [Kd Jh 3d] [Jc]
Bothfeld11: checks 
roninio1: checks 
aseban11: checks 
RICKA16: checks 
*** RIVER *** [Kd Jh 3d Jc] [8c]
Bothfeld11: bets $5
roninio1: folds 
aseban11: folds 
RICKA16: folds 
Uncalled bet ($5) returned to Bothfeld11
Bothfeld11 collected $9.55 from pot
Bothfeld11: shows [As]
*** SUMMARY ***
Total pot $10 | Rake $0.45 
Board [Kd Jh 3d Jc 8c]
Seat 1: aseban11 folded on the River
Seat 2: RICKA16 folded on the River
Seat 3: cn_chayanne (button) folded before Flop (didn't bet)
Seat 4: Bothfeld11 (small blind) collected ($9.55)
Seat 5: roninio1 (big blind) folded on the River
Seat 6: Pacifistas folded before Flop (didn't bet)
Seat 7: djammusic folded before Flop (didn't bet)
Seat 8: solbi86 folded before Flop (didn't bet)
Seat 9: matiko09 folded before Flop (didn't bet)





PokerStars Hand #150706644916:  Hold'em No Limit ($0.50/$1.00 USD) - 2016/03/21 16:41:07 CET [2016/03/21 11:41:07 ET]
Table 'Gondola II' 9-max Seat #8 is the button
Seat 1: matiko09 ($103.64 in chips) 
Seat 2: R1aki ($113.26 in chips) 
Seat 3: flk.Dasas ($123.86 in chips) 
Seat 4: aseban11 ($113.10 in chips) 
Seat 5: teukka8 ($44.37 in chips) 
Seat 6: SanychStar ($118.87 in chips) 
Seat 7: Pacifistas ($107.13 in chips) 
Seat 8: cn_chayanne ($100 in chips) 
Seat 9: djammusic ($46.45 in chips) 
djammusic: posts small blind $0.50
matiko09: posts big blind $1
*** HOLE CARDS ***
Dealt to matiko09 [As Kh]
R1aki: folds 
flk.Dasas: folds 
aseban11: folds 
teukka8: raises $1 to $2
SanychStar: folds 
Pacifistas: folds 
cn_chayanne: folds 
djammusic: folds 
matiko09: raises $8 to $10
teukka8: calls $8
*** FLOP *** [2d 8s 7h]
matiko09: checks 
teukka8: checks 
*** TURN *** [2d 8s 7h] [Ah]
matiko09: bets $12
teukka8: calls $12
*** RIVER *** [2d 8s 7h Ah] [4h]
matiko09: bets $27
teukka8: calls $22.37 and is all-in
Uncalled bet ($4.63) returned to matiko09
*** SHOW DOWN ***
matiko09: shows [As Kh] (a pair of Aces)
teukka8: mucks hand 
matiko09 collected $86.44 from pot
*** SUMMARY ***
Total pot $89.24 | Rake $2.80 
Board [2d 8s 7h Ah 4h]
Seat 1: matiko09 (big blind) showed [As Kh] and won ($86.44) with a pair of Aces
Seat 2: R1aki folded before Flop (didn't bet)
Seat 3: flk.Dasas folded before Flop (didn't bet)
Seat 4: aseban11 folded before Flop (didn't bet)
Seat 5: teukka8 mucked [9h 9c]
Seat 6: SanychStar folded before Flop (didn't bet)
Seat 7: Pacifistas folded before Flop (didn't bet)
Seat 8: cn_chayanne (button) folded before Flop (didn't bet)
Seat 9: djammusic (small blind) folded before Flop





PokerStars Hand #150706645702:  Hold'em No Limit ($0.50/$1.00 USD) - 2016/03/21 16:41:08 CET [2016/03/21 11:41:08 ET]
Table 'Toutatis II' 9-max Seat #4 is the button
Seat 1: Linghem ($108.58 in chips) 
Seat 2: matiko09 ($117.49 in chips) 
Seat 4: cn_chayanne ($101.50 in chips) 
Seat 5: aseban11 ($100.50 in chips) 
Seat 6: runner10 ($44.01 in chips) 
Seat 7: Pacifistas ($100 in chips) 
Seat 8: Dachish ($70 in chips) 
Seat 9: B@ngel ($107.24 in chips) 
aseban11: posts small blind $0.50
runner10: posts big blind $1
sanpidk: sits out 
*** HOLE CARDS ***
Dealt to matiko09 [Ts Th]
Pacifistas: raises $2 to $3
Dachish: folds 
B@ngel is disconnected 
B@ngel is connected 
B@ngel: folds 
Linghem: folds 
matiko09: calls $3
cn_chayanne: folds 
aseban11: folds 
runner10: folds 
*** FLOP *** [4h 2d Jd]
Pacifistas: bets $4.65
matiko09: calls $4.65
*** TURN *** [4h 2d Jd] [Kd]
Pacifistas: checks 
matiko09: checks 
*** RIVER *** [4h 2d Jd Kd] [6s]
Pacifistas: bets $11.07
matiko09: folds 
Uncalled bet ($11.07) returned to Pacifistas
Pacifistas collected $16.04 from pot
Pacifistas: doesn't show hand 
*** SUMMARY ***
Total pot $16.80 | Rake $0.76 
Board [4h 2d Jd Kd 6s]
Seat 1: Linghem folded before Flop (didn't bet)
Seat 2: matiko09 folded on the River
Seat 4: cn_chayanne (button) folded before Flop (didn't bet)
Seat 5: aseban11 (small blind) folded before Flop
Seat 6: runner10 (big blind) folded before Flop
Seat 7: Pacifistas collected ($16.04)
Seat 8: Dachish folded before Flop (didn't bet)
Seat 9: B@ngel folded before Flop (didn't bet)





PokerStars Hand #150706649201:  Hold'em No Limit (€0.25/€0.50 EUR) - 2016/03/21 16:41:12 CET [2016/03/21 11:41:12 ET]
Table 'Auravictrix II' 9-max Seat #2 is the button
Seat 1: aponinho82 (€51.53 in chips) 
Seat 2: ffac (€51 in chips) 
Seat 3: matiko09 (€52.51 in chips) 
Seat 5: nombraalne1 (€50 in chips) 
matiko09: posts small blind €0.25
nombraalne1: posts big blind €0.50
*** HOLE CARDS ***
Dealt to matiko09 [3s 3c]
aponinho82: calls €0.50
ffac: raises €1.50 to €2
matiko09: calls €1.75
nombraalne1: calls €1.50
aponinho82: calls €1.50
*** FLOP *** [6s Ad 2c]
matiko09: checks 
nombraalne1: checks 
aponinho82: checks 
ffac: checks 
*** TURN *** [6s Ad 2c] [Kd]
matiko09: checks 
nombraalne1: checks 
aponinho82: checks 
i am owsome joins the table at seat #4 
ffac: checks 
*** RIVER *** [6s Ad 2c Kd] [5s]
matiko09: checks 
carlouchi joins the table at seat #9 
nombraalne1: checks 
aponinho82: checks 
ffac: checks 
*** SHOW DOWN ***
matiko09: shows [3s 3c] (a pair of Threes)
nombraalne1: mucks hand 
aponinho82: shows [4s 4d] (a pair of Fours)
ffac: shows [Kc Th] (a pair of Kings)
ffac collected €7.64 from pot
*** SUMMARY ***
Total pot €8 | Rake €0.36 
Board [6s Ad 2c Kd 5s]
Seat 1: aponinho82 showed [4s 4d] and lost with a pair of Fours
Seat 2: ffac (button) showed [Kc Th] and won (€7.64) with a pair of Kings
Seat 3: matiko09 (small blind) showed [3s 3c] and lost with a pair of Threes
Seat 5: nombraalne1 (big blind) mucked [8s Js]





PokerStars Hand #150706655066:  Hold'em No Limit ($0.50/$1.00 USD) - 2016/03/21 16:41:20 CET [2016/03/21 11:41:20 ET]
Table 'Noel' 9-max Seat #2 is the button
Seat 1: ep538 ($38.50 in chips) 
Seat 2: cobrik23 ($179.40 in chips) 
Seat 4: Kobiroga150 ($87.84 in chips) 
Seat 5: matiko09 ($116.22 in chips) 
Seat 6: hammerwife ($103.23 in chips) 
Seat 7: djammusic ($39 in chips) 
Seat 8: Dachish ($66 in chips) 
Seat 9: grifkaaa ($103.84 in chips) 
Kobiroga150: posts small blind $0.50
matiko09: posts big blind $1
*** HOLE CARDS ***
Dealt to matiko09 [Ah 9h]
hammerwife: folds 
djammusic: raises $1.15 to $2.15
Dachish: folds 
grifkaaa: folds 
ep538: calls $2.15
cobrik23: folds 
Kobiroga150: calls $1.65
matiko09: calls $1.15
*** FLOP *** [8c Qs Jh]
Kobiroga150: checks 
matiko09: checks 
djammusic: bets $5.50
ep538: folds 
Kobiroga150: calls $5.50
matiko09: folds 
*** TURN *** [8c Qs Jh] [3s]
Kobiroga150: checks 
djammusic: bets $13
Kobiroga150: calls $13
*** RIVER *** [8c Qs Jh 3s] [Jd]
Kobiroga150: checks 
djammusic: checks 
*** SHOW DOWN ***
Kobiroga150: shows [Ks Td] (a pair of Jacks)
djammusic: shows [Ac Qh] (two pair, Queens and Jacks)
djammusic collected $43.55 from pot
*** SUMMARY ***
Total pot $45.60 | Rake $2.05 
Board [8c Qs Jh 3s Jd]
Seat 1: ep538 folded on the Flop
Seat 2: cobrik23 (button) folded before Flop (didn't bet)
Seat 4: Kobiroga150 (small blind) showed [Ks Td] and lost with a pair of Jacks
Seat 5: matiko09 (big blind) folded on the Flop
Seat 6: hammerwife folded before Flop (didn't bet)
Seat 7: djammusic showed [Ac Qh] and won ($43.55) with two pair, Queens and Jacks
Seat 8: Dachish folded before Flop (didn't bet)
Seat 9: grifkaaa folded before Flop (didn't bet)





PokerStars Hand #150706659707:  Hold'em No Limit ($0.50/$1.00 USD) - 2016/03/21 16:41:27 CET [2016/03/21 11:41:27 ET]
Table 'Havnia' 9-max Seat #1 is the button
Seat 1: Khaine_CM ($101 in chips) 
Seat 3: drakariss ($38.25 in chips) 
Seat 4: Rikti ($43.87 in chips) 
Seat 5: matiko09 ($100 in chips) 
Seat 7: flk.Dasas ($199.70 in chips) 
Seat 8: gabi_igna ($103.50 in chips) 
Seat 9: Vikulja1993 ($100 in chips) 
i am owsome will be allowed to play after the button
drakariss: posts small blind $0.50
Rikti: posts big blind $1
*** HOLE CARDS ***
Dealt to matiko09 [4h 8c]
matiko09: folds 
flk.Dasas: folds 
gabi_igna: folds 
Vikulja1993: raises $1.50 to $2.50
Khaine_CM: folds 
drakariss: folds 
Rikti: raises $4.50 to $7
Vikulja1993: folds 
Uncalled bet ($4.50) returned to Rikti
Rikti collected $5.50 from pot
Rikti: doesn't show hand 
*** SUMMARY ***
Total pot $5.50 | Rake $0 
Seat 1: Khaine_CM (button) folded before Flop (didn't bet)
Seat 3: drakariss (small blind) folded before Flop
Seat 4: Rikti (big blind) collected ($5.50)
Seat 5: matiko09 folded before Flop (didn't bet)
Seat 7: flk.Dasas folded before Flop (didn't bet)
Seat 8: gabi_igna folded before Flop (didn't bet)
Seat 9: Vikulja1993 folded before Flop





PokerStars Hand #150706666870:  Hold'em No Limit ($0.50/$1.00 USD) - 2016/03/21 16:41:36 CET [2016/03/21 11:41:36 ET]
Table 'Massalia II' 9-max Seat #5 is the button
Seat 1: crepke ($83.52 in chips) 
Seat 2: solbi86 ($104.96 in chips) 
Seat 3: 123chambo ($93.50 in chips) 
Seat 4: OriginalTony ($116.70 in chips) 
Seat 5: roninio1 ($92.17 in chips) 
Seat 6: Pacifistas ($122.72 in chips) 
Seat 7: flk.Dasas ($100 in chips) 
Seat 8: matiko09 ($200.90 in chips) 
Seat 9: R1aki ($116.39 in chips) 
Pacifistas: posts small blind $0.50
flk.Dasas: posts big blind $1
crepke: posts the ante $0.20
solbi86: posts the ante $0.20
123chambo: posts the ante $0.20
OriginalTony: posts the ante $0.20
roninio1: posts the ante $0.20
Pacifistas: posts the ante $0.20
flk.Dasas: posts the ante $0.20
matiko09: posts the ante $0.20
R1aki: posts the ante $0.20
*** HOLE CARDS ***
Dealt to matiko09 [7c 9s]
matiko09: folds 
R1aki: folds 
crepke: raises $1 to $2
solbi86: folds 
123chambo: folds 
OriginalTony: raises $4 to $6
roninio1: calls $6
Pacifistas: folds 
flk.Dasas: folds 
crepke: folds 
*** FLOP *** [Jh Jc Tc]
OriginalTony: bets $8
roninio1: calls $8
*** TURN *** [Jh Jc Tc] [3h]
OriginalTony: checks 
roninio1: checks 
*** RIVER *** [Jh Jc Tc 3h] [6d]
OriginalTony: checks 
roninio1: checks 
*** SHOW DOWN ***
OriginalTony: shows [Qc Kd] (a pair of Jacks)
roninio1: shows [5d 5s] (two pair, Jacks and Fives)
roninio1 collected $31.80 from pot
*** SUMMARY ***
Total pot $33.30 | Rake $1.50 
Board [Jh Jc Tc 3h 6d]
Seat 1: crepke folded before Flop
Seat 2: solbi86 folded before Flop (didn't bet)
Seat 3: 123chambo folded before Flop (didn't bet)
Seat 4: OriginalTony showed [Qc Kd] and lost with a pair of Jacks
Seat 5: roninio1 (button) showed [5d 5s] and won ($31.80) with two pair, Jacks and Fives
Seat 6: Pacifistas (small blind) folded before Flop
Seat 7: flk.Dasas (big blind) folded before Flop
Seat 8: matiko09 folded before Flop (didn't bet)
Seat 9: R1aki folded before Flop (didn't bet)





PokerStars Hand #150706681907:  Hold'em No Limit ($0.50/$1.00 USD) - 2016/03/21 16:41:57 CET [2016/03/21 11:41:57 ET]
Table 'Onnie II' 9-max Seat #4 is the button
Seat 1: aseban11 ($195.58 in chips) 
Seat 2: RICKA16 ($100 in chips) 
Seat 3: cn_chayanne ($101 in chips) 
Seat 4: Bothfeld11 ($103.68 in chips) 
Seat 5: roninio1 ($35.19 in chips) 
Seat 7: djammusic ($72.08 in chips) 
Seat 8: solbi86 ($105.10 in chips) 
Seat 9: matiko09 ($116.12 in chips) 
roninio1: posts small blind $0.50
Pacifistas: is sitting out 
djammusic: posts big blind $1
*** HOLE CARDS ***
Dealt to matiko09 [9s Qs]
solbi86: raises $2 to $3
matiko09: folds 
aseban11: folds 
RICKA16: folds 
cn_chayanne: folds 
Bothfeld11: calls $3
roninio1: folds 
djammusic: folds 
*** FLOP *** [Js Kd 9d]
solbi86: bets $4
Bothfeld11: folds 
Uncalled bet ($4) returned to solbi86
solbi86 collected $7.16 from pot
solbi86: doesn't show hand 
*** SUMMARY ***
Total pot $7.50 | Rake $0.34 
Board [Js Kd 9d]
Seat 1: aseban11 folded before Flop (didn't bet)
Seat 2: RICKA16 folded before Flop (didn't bet)
Seat 3: cn_chayanne folded before Flop (didn't bet)
Seat 4: Bothfeld11 (button) folded on the Flop
Seat 5: roninio1 (small blind) folded before Flop
Seat 7: djammusic (big blind) folded before Flop
Seat 8: solbi86 collected ($7.16)
Seat 9: matiko09 folded before Flop (didn't bet)





PokerStars Hand #150706699019:  Hold'em No Limit ($0.50/$1.00 USD) - 2016/03/21 16:42:20 CET [2016/03/21 11:42:20 ET]
Table 'Havnia' 9-max Seat #3 is the button
Seat 1: Khaine_CM ($101 in chips) 
Seat 3: drakariss ($37.75 in chips) 
Seat 4: Rikti ($46.87 in chips) 
Seat 5: matiko09 ($100 in chips) 
Seat 7: flk.Dasas ($199.70 in chips) 
Seat 8: gabi_igna ($103.50 in chips) 
Seat 9: Vikulja1993 ($100 in chips) 
Rikti: posts small blind $0.50
matiko09: posts big blind $1
i am owsome: sits out 
*** HOLE CARDS ***
Dealt to matiko09 [Ts Kh]
flk.Dasas: folds 
gabi_igna: folds 
Vikulja1993: raises $2 to $3
Khaine_CM: folds 
drakariss: folds 
Rikti: folds 
matiko09: folds 
Uncalled bet ($2) returned to Vikulja1993
Vikulja1993 collected $2.50 from pot
Vikulja1993: doesn't show hand 
*** SUMMARY ***
Total pot $2.50 | Rake $0 
Seat 1: Khaine_CM folded before Flop (didn't bet)
Seat 3: drakariss (button) folded before Flop (didn't bet)
Seat 4: Rikti (small blind) folded before Flop
Seat 5: matiko09 (big blind) folded before Flop
Seat 7: flk.Dasas folded before Flop (didn't bet)
Seat 8: gabi_igna folded before Flop (didn't bet)
Seat 9: Vikulja1993 collected ($2.50)





PokerStars Hand #150706712709:  Hold'em No Limit ($0.50/$1.00 USD) - 2016/03/21 16:42:39 CET [2016/03/21 11:42:39 ET]
Table 'Onnie II' 9-max Seat #5 is the button
Seat 1: aseban11 ($195.58 in chips) 
Seat 2: RICKA16 ($100 in chips) 
Seat 3: cn_chayanne ($101 in chips) 
Seat 4: Bothfeld11 ($100.68 in chips) 
Seat 5: roninio1 ($34.69 in chips) 
Seat 7: djammusic ($71.08 in chips) 
Seat 8: solbi86 ($109.26 in chips) 
Seat 9: matiko09 ($116.12 in chips) 
djammusic: posts small blind $0.50
solbi86: posts big blind $1
*** HOLE CARDS ***
Dealt to matiko09 [Jc Qd]
matiko09: folds 
aseban11: folds 
RICKA16: raises $2 to $3
cn_chayanne: folds 
Bothfeld11: folds 
roninio1: raises $31.69 to $34.69 and is all-in
djammusic: folds 
solbi86: folds 
RICKA16: folds 
Uncalled bet ($31.69) returned to roninio1
roninio1 collected $7.50 from pot
roninio1: doesn't show hand 
*** SUMMARY ***
Total pot $7.50 | Rake $0 
Seat 1: aseban11 folded before Flop (didn't bet)
Seat 2: RICKA16 folded before Flop
Seat 3: cn_chayanne folded before Flop (didn't bet)
Seat 4: Bothfeld11 folded before Flop (didn't bet)
Seat 5: roninio1 (button) collected ($7.50)
Seat 7: djammusic (small blind) folded before Flop
Seat 8: solbi86 (big blind) folded before Flop
Seat 9: matiko09 folded before Flop (didn't bet)





PokerStars Hand #150706718121:  Hold'em No Limit ($0.50/$1.00 USD) - 2016/03/21 16:42:46 CET [2016/03/21 11:42:46 ET]
Table 'Havnia' 9-max Seat #4 is the button
Seat 1: Khaine_CM ($101 in chips) 
Seat 3: drakariss ($37.75 in chips) 
Seat 4: Rikti ($46.37 in chips) 
Seat 5: matiko09 ($100 in chips) 
Seat 7: flk.Dasas ($199.70 in chips) 
Seat 8: gabi_igna ($103.50 in chips) 
Seat 9: Vikulja1993 ($101.50 in chips) 
matiko09: posts small blind $0.50
flk.Dasas: posts big blind $1
i am owsome: sits out 
*** HOLE CARDS ***
Dealt to matiko09 [Ad 3h]
gabi_igna: folds 
Vikulja1993: folds 
Khaine_CM: folds 
drakariss: raises $2 to $3
Rikti: folds 
matiko09: folds 
flk.Dasas: folds 
Uncalled bet ($2) returned to drakariss
drakariss collected $2.50 from pot
drakariss: doesn't show hand 
*** SUMMARY ***
Total pot $2.50 | Rake $0 
Seat 1: Khaine_CM folded before Flop (didn't bet)
Seat 3: drakariss collected ($2.50)
Seat 4: Rikti (button) folded before Flop (didn't bet)
Seat 5: matiko09 (small blind) folded before Flop
Seat 7: flk.Dasas (big blind) folded before Flop
Seat 8: gabi_igna folded before Flop (didn't bet)
Seat 9: Vikulja1993 folded before Flop (didn't bet)





PokerStars Hand #150706717889:  Hold'em No Limit ($0.50/$1.00 USD) - 2016/03/21 16:42:46 CET [2016/03/21 11:42:46 ET]
Table 'Massalia II' 9-max Seat #6 is the button
Seat 1: crepke ($81.32 in chips) 
Seat 2: solbi86 ($104.76 in chips) 
Seat 3: 123chambo ($93.30 in chips) 
Seat 4: OriginalTony ($102.50 in chips) 
Seat 5: roninio1 ($109.77 in chips) 
Seat 6: Pacifistas ($122.02 in chips) 
Seat 7: flk.Dasas ($100 in chips) 
Seat 8: matiko09 ($200.70 in chips) 
Seat 9: R1aki ($116.19 in chips) 
flk.Dasas: posts small blind $0.50
matiko09: posts big blind $1
crepke: posts the ante $0.20
solbi86: posts the ante $0.20
123chambo: posts the ante $0.20
OriginalTony: posts the ante $0.20
roninio1: posts the ante $0.20
Pacifistas: posts the ante $0.20
flk.Dasas: posts the ante $0.20
matiko09: posts the ante $0.20
R1aki: posts the ante $0.20
*** HOLE CARDS ***
Dealt to matiko09 [Qs 8d]
R1aki: folds 
R1aki leaves the table
crepke: folds 
solbi86: folds 
123chambo: folds 
hammerwife joins the table at seat #9 
OriginalTony: folds 
roninio1: folds 
Pacifistas: folds 
flk.Dasas: raises $3 to $4
matiko09: folds 
Uncalled bet ($3) returned to flk.Dasas
flk.Dasas collected $3.80 from pot
flk.Dasas: doesn't show hand 
*** SUMMARY ***
Total pot $3.80 | Rake $0 
Seat 1: crepke folded before Flop (didn't bet)
Seat 2: solbi86 folded before Flop (didn't bet)
Seat 3: 123chambo folded before Flop (didn't bet)
Seat 4: OriginalTony folded before Flop (didn't bet)
Seat 5: roninio1 folded before Flop (didn't bet)
Seat 6: Pacifistas (button) folded before Flop (didn't bet)
Seat 7: flk.Dasas (small blind) collected ($3.80)
Seat 8: matiko09 (big blind) folded before Flop
Seat 9: R1aki folded before Flop (didn't bet)





PokerStars Hand #150706719487:  Hold'em No Limit (€0.25/€0.50 EUR) - 2016/03/21 16:42:48 CET [2016/03/21 11:42:48 ET]
Table 'Auravictrix II' 9-max Seat #3 is the button
Seat 1: aponinho82 (€49.53 in chips) 
Seat 2: ffac (€56.64 in chips) 
Seat 3: matiko09 (€50.51 in chips) 
Seat 5: nombraalne1 (€50 in chips) 
Seat 9: carlouchi (€33.70 in chips) 
i am owsome will be allowed to play after the button
nombraalne1: posts small blind €0.25
carlouchi: posts big blind €0.50
*** HOLE CARDS ***
Dealt to matiko09 [5c 6c]
aponinho82: calls €0.50
ffac: folds 
matiko09: raises €1.50 to €2
nombraalne1: folds 
carlouchi: folds 
aponinho82: calls €1.50
*** FLOP *** [Th 3s Qd]
aponinho82: checks 
matiko09: checks 
*** TURN *** [Th 3s Qd] [Kh]
aponinho82: checks 
matiko09: checks 
*** RIVER *** [Th 3s Qd Kh] [9s]
aponinho82: checks 
matiko09: checks 
*** SHOW DOWN ***
aponinho82: shows [Jd 2d] (a straight, Nine to King)
matiko09: mucks hand 
aponinho82 collected €4.54 from pot
*** SUMMARY ***
Total pot €4.75 | Rake €0.21 
Board [Th 3s Qd Kh 9s]
Seat 1: aponinho82 showed [Jd 2d] and won (€4.54) with a straight, Nine to King
Seat 2: ffac folded before Flop (didn't bet)
Seat 3: matiko09 (button) mucked [5c 6c]
Seat 5: nombraalne1 (small blind) folded before Flop
Seat 9: carlouchi (big blind) folded before Flop





PokerStars Hand #150706727016:  Hold'em No Limit ($0.50/$1.00 USD) - 2016/03/21 16:42:58 CET [2016/03/21 11:42:58 ET]
Table 'Noel' 9-max Seat #4 is the button
Seat 1: ep538 ($36.35 in chips) 
Seat 2: cobrik23 ($179.40 in chips) 
Seat 4: Kobiroga150 ($67.19 in chips) 
Seat 5: matiko09 ($114.07 in chips) 
Seat 6: hammerwife ($103.23 in chips) 
Seat 7: djammusic ($61.90 in chips) 
Seat 8: Dachish ($66 in chips) 
Seat 9: grifkaaa ($103.84 in chips) 
matiko09: posts small blind $0.50
hammerwife: posts big blind $1
*** HOLE CARDS ***
Dealt to matiko09 [7d 4s]
djammusic: folds 
Dachish: folds 
grifkaaa: folds 
ep538: folds 
cobrik23: folds 
Kobiroga150: folds 
matiko09: folds 
Uncalled bet ($0.50) returned to hammerwife
hammerwife collected $1 from pot
hammerwife: doesn't show hand 
*** SUMMARY ***
Total pot $1 | Rake $0 
Seat 1: ep538 folded before Flop (didn't bet)
Seat 2: cobrik23 folded before Flop (didn't bet)
Seat 4: Kobiroga150 (button) folded before Flop (didn't bet)
Seat 5: matiko09 (small blind) folded before Flop
Seat 6: hammerwife (big blind) collected ($1)
Seat 7: djammusic folded before Flop (didn't bet)
Seat 8: Dachish folded before Flop (didn't bet)
Seat 9: grifkaaa folded before Flop (didn't bet)





PokerStars Hand #150706727450:  Hold'em No Limit ($0.50/$1.00 USD) - 2016/03/21 16:42:59 CET [2016/03/21 11:42:59 ET]
Table 'Gondola II' 9-max Seat #9 is the button
Seat 1: matiko09 ($145.71 in chips) 
Seat 2: R1aki ($113.26 in chips) 
Seat 3: flk.Dasas ($123.86 in chips) 
Seat 4: aseban11 ($113.10 in chips) 
Seat 6: SanychStar ($118.87 in chips) 
Seat 7: Pacifistas ($107.13 in chips) 
Seat 8: cn_chayanne ($100 in chips) 
Seat 9: djammusic ($45.95 in chips) 
matiko09: posts small blind $0.50
R1aki: posts big blind $1
*** HOLE CARDS ***
Dealt to matiko09 [Qh 5h]
flk.Dasas: folds 
aseban11: folds 
SanychStar: folds 
Pacifistas: folds 
cn_chayanne: folds 
teukka8 leaves the table
Vikulja1993 joins the table at seat #5 
Vikulja1993 leaves the table
djammusic: folds 
volwebni4ek joins the table at seat #5 
matiko09: raises $1.50 to $2.50
R1aki: calls $1.50
*** FLOP *** [Kc 2h 2d]
matiko09: bets $3
R1aki: folds 
Uncalled bet ($3) returned to matiko09
matiko09 collected $4.78 from pot
matiko09: doesn't show hand 
*** SUMMARY ***
Total pot $5 | Rake $0.22 
Board [Kc 2h 2d]
Seat 1: matiko09 (small blind) collected ($4.78)
Seat 2: R1aki (big blind) folded on the Flop
Seat 3: flk.Dasas folded before Flop (didn't bet)
Seat 4: aseban11 folded before Flop (didn't bet)
Seat 6: SanychStar folded before Flop (didn't bet)
Seat 7: Pacifistas folded before Flop (didn't bet)
Seat 8: cn_chayanne folded before Flop (didn't bet)
Seat 9: djammusic (button) folded before Flop (didn't bet)





PokerStars Hand #150706729888:  Hold'em No Limit ($0.50/$1.00 USD) - 2016/03/21 16:43:02 CET [2016/03/21 11:43:02 ET]
Table 'Toutatis II' 9-max Seat #5 is the button
Seat 1: Linghem ($108.58 in chips) 
Seat 2: matiko09 ($109.84 in chips) 
Seat 4: cn_chayanne ($101.50 in chips) 
Seat 5: aseban11 ($100 in chips) 
Seat 6: runner10 ($43.01 in chips) 
Seat 8: Dachish ($70 in chips) 
Seat 9: B@ngel ($107.24 in chips) 
runner10: posts small blind $0.50
Pacifistas: is sitting out 
Dachish: posts big blind $1
sanpidk: sits out 
*** HOLE CARDS ***
Dealt to matiko09 [7h Jh]
B@ngel: folds 
Linghem: folds 
matiko09: folds 
cn_chayanne: folds 
aseban11: folds 
runner10: folds 
Uncalled bet ($0.50) returned to Dachish
Dachish collected $1 from pot
Dachish: doesn't show hand 
*** SUMMARY ***
Total pot $1 | Rake $0 
Seat 1: Linghem folded before Flop (didn't bet)
Seat 2: matiko09 folded before Flop (didn't bet)
Seat 4: cn_chayanne folded before Flop (didn't bet)
Seat 5: aseban11 (button) folded before Flop (didn't bet)
Seat 6: runner10 (small blind) folded before Flop
Seat 8: Dachish (big blind) collected ($1)
Seat 9: B@ngel folded before Flop (didn't bet)





PokerStars Hand #150706731506:  Hold'em No Limit ($0.50/$1.00 USD) - 2016/03/21 16:43:04 CET [2016/03/21 11:43:04 ET]
Table 'Onnie II' 9-max Seat #7 is the button
Seat 1: aseban11 ($195.58 in chips) 
Seat 2: RICKA16 ($100 in chips) 
Seat 3: cn_chayanne ($101 in chips) 
Seat 4: Bothfeld11 ($100.68 in chips) 
Seat 5: roninio1 ($39.19 in chips) 
Seat 7: djammusic ($70.58 in chips) 
Seat 8: solbi86 ($108.26 in chips) 
Seat 9: matiko09 ($116.12 in chips) 
solbi86: posts small blind $0.50
matiko09: posts big blind $1
*** HOLE CARDS ***
Dealt to matiko09 [6h Jc]
aseban11: folds 
RICKA16: folds 
cn_chayanne: folds 
Bothfeld11: folds 
roninio1: raises $38.19 to $39.19 and is all-in
djammusic: folds 
solbi86: folds 
matiko09: folds 
Uncalled bet ($38.19) returned to roninio1
roninio1 collected $2.50 from pot
roninio1: doesn't show hand 
*** SUMMARY ***
Total pot $2.50 | Rake $0 
Seat 1: aseban11 folded before Flop (didn't bet)
Seat 2: RICKA16 folded before Flop (didn't bet)
Seat 3: cn_chayanne folded before Flop (didn't bet)
Seat 4: Bothfeld11 folded before Flop (didn't bet)
Seat 5: roninio1 collected ($2.50)
Seat 7: djammusic (button) folded before Flop (didn't bet)
Seat 8: solbi86 (small blind) folded before Flop
Seat 9: matiko09 (big blind) folded before Flop





PokerStars Hand #150706745487:  Hold'em No Limit ($0.50/$1.00 USD) - 2016/03/21 16:43:23 CET [2016/03/21 11:43:23 ET]
Table 'Toutatis II' 9-max Seat #6 is the button
Seat 1: Linghem ($108.58 in chips) 
Seat 2: matiko09 ($109.84 in chips) 
Seat 4: cn_chayanne ($101.50 in chips) 
Seat 5: aseban11 ($100 in chips) 
Seat 6: runner10 ($42.51 in chips) 
Seat 8: Dachish ($70.50 in chips) 
Seat 9: B@ngel ($107.24 in chips) 
Dachish: posts small blind $0.50
B@ngel: posts big blind $1
sanpidk: sits out 
*** HOLE CARDS ***
Dealt to matiko09 [Qs Ad]
Linghem: folds 
matiko09: raises $2 to $3
cn_chayanne: folds 
aseban11: raises $6 to $9
runner10: folds 
Dachish: folds 
B@ngel: folds 
matiko09: folds 
Uncalled bet ($6) returned to aseban11
aseban11 collected $7.50 from pot
aseban11: doesn't show hand 
*** SUMMARY ***
Total pot $7.50 | Rake $0 
Seat 1: Linghem folded before Flop (didn't bet)
Seat 2: matiko09 folded before Flop
Seat 4: cn_chayanne folded before Flop (didn't bet)
Seat 5: aseban11 collected ($7.50)
Seat 6: runner10 (button) folded before Flop (didn't bet)
Seat 8: Dachish (small blind) folded before Flop
Seat 9: B@ngel (big blind) folded before Flop





PokerStars Hand #150706750195:  Hold'em No Limit ($0.50/$1.00 USD) - 2016/03/21 16:43:30 CET [2016/03/21 11:43:30 ET]
Table 'Massalia II' 9-max Seat #7 is the button
Seat 1: crepke ($81.12 in chips) 
Seat 2: solbi86 ($104.56 in chips) 
Seat 3: 123chambo ($93.10 in chips) 
Seat 4: OriginalTony ($102.30 in chips) 
Seat 5: roninio1 ($109.57 in chips) 
Seat 6: Pacifistas ($121.82 in chips) 
Seat 7: flk.Dasas ($102.60 in chips) 
Seat 8: matiko09 ($199.50 in chips) 
Seat 9: hammerwife ($100 in chips) 
matiko09: posts small blind $0.50
hammerwife: posts big blind $1
crepke: posts the ante $0.20
solbi86: posts the ante $0.20
123chambo: posts the ante $0.20
OriginalTony: posts the ante $0.20
roninio1: posts the ante $0.20
Pacifistas: posts the ante $0.20
flk.Dasas: posts the ante $0.20
matiko09: posts the ante $0.20
hammerwife: posts the ante $0.20
*** HOLE CARDS ***
Dealt to matiko09 [Kc Ac]
crepke: folds 
solbi86: folds 
123chambo: folds 
OriginalTony: raises $2 to $3
roninio1: folds 
Pacifistas: raises $6 to $9
flk.Dasas: folds 
matiko09: calls $8.50
hammerwife: folds 
OriginalTony: calls $6
*** FLOP *** [Td 9c Qh]
matiko09: checks 
OriginalTony: checks 
Pacifistas: checks 
*** TURN *** [Td 9c Qh] [7h]
matiko09: checks 
OriginalTony: bets $9
Pacifistas: calls $9
matiko09: folds 
*** RIVER *** [Td 9c Qh 7h] [Jc]
OriginalTony: checks 
Pacifistas: checks 
*** SHOW DOWN ***
OriginalTony: shows [6h 6d] (a pair of Sixes)
Pacifistas: shows [Ah Jd] (a pair of Jacks)
Pacifistas collected $45.65 from pot
*** SUMMARY ***
Total pot $47.80 | Rake $2.15 
Board [Td 9c Qh 7h Jc]
Seat 1: crepke folded before Flop (didn't bet)
Seat 2: solbi86 folded before Flop (didn't bet)
Seat 3: 123chambo folded before Flop (didn't bet)
Seat 4: OriginalTony showed [6h 6d] and lost with a pair of Sixes
Seat 5: roninio1 folded before Flop (didn't bet)
Seat 6: Pacifistas showed [Ah Jd] and won ($45.65) with a pair of Jacks
Seat 7: flk.Dasas (button) folded before Flop (didn't bet)
Seat 8: matiko09 (small blind) folded on the Turn
Seat 9: hammerwife (big blind) folded before Flop





PokerStars Hand #150706750830:  Hold'em No Limit ($0.50/$1.00 USD) - 2016/03/21 16:43:31 CET [2016/03/21 11:43:31 ET]
Table 'Noel' 9-max Seat #5 is the button
Seat 1: ep538 ($36.35 in chips) 
Seat 2: cobrik23 ($179.40 in chips) 
Seat 4: Kobiroga150 ($67.19 in chips) 
Seat 5: matiko09 ($113.57 in chips) 
Seat 6: hammerwife ($103.73 in chips) 
Seat 7: djammusic ($61.90 in chips) 
Seat 8: Dachish ($66 in chips) 
Seat 9: grifkaaa ($103.84 in chips) 
hammerwife: posts small blind $0.50
djammusic: posts big blind $1
*** HOLE CARDS ***
Dealt to matiko09 [Qd 4c]
Dachish: folds 
grifkaaa: folds 
ep538: folds 
cobrik23: folds 
Kobiroga150: raises $2 to $3
matiko09: folds 
hammerwife: calls $2.50
djammusic: folds 
*** FLOP *** [5d 6h Jh]
hammerwife: checks 
Kobiroga150: bets $3
hammerwife: folds 
Uncalled bet ($3) returned to Kobiroga150
Kobiroga150 collected $6.68 from pot
Kobiroga150: doesn't show hand 
*** SUMMARY ***
Total pot $7 | Rake $0.32 
Board [5d 6h Jh]
Seat 1: ep538 folded before Flop (didn't bet)
Seat 2: cobrik23 folded before Flop (didn't bet)
Seat 4: Kobiroga150 collected ($6.68)
Seat 5: matiko09 (button) folded before Flop (didn't bet)
Seat 6: hammerwife (small blind) folded on the Flop
Seat 7: djammusic (big blind) folded before Flop
Seat 8: Dachish folded before Flop (didn't bet)
Seat 9: grifkaaa folded before Flop (didn't bet)





PokerStars Hand #150706752077:  Hold'em No Limit ($0.50/$1.00 USD) - 2016/03/21 16:43:32 CET [2016/03/21 11:43:32 ET]
Table 'Havnia' 9-max Seat #5 is the button
Seat 1: Khaine_CM ($101 in chips) 
Seat 3: drakariss ($39.25 in chips) 
Seat 4: Rikti ($46.37 in chips) 
Seat 5: matiko09 ($100 in chips) 
Seat 7: flk.Dasas ($198.70 in chips) 
Seat 8: gabi_igna ($103.50 in chips) 
Seat 9: Vikulja1993 ($101.50 in chips) 
flk.Dasas: posts small blind $0.50
gabi_igna: posts big blind $1
i am owsome: sits out 
*** HOLE CARDS ***
Dealt to matiko09 [Jh 8c]
Vikulja1993: folds 
Khaine_CM: folds 
drakariss: folds 
Rikti: folds 
matiko09: raises $1.27 to $2.27
flk.Dasas: folds 
gabi_igna: calls $1.27
*** FLOP *** [3d 2s 9d]
gabi_igna: checks 
matiko09: checks 
*** TURN *** [3d 2s 9d] [Qd]
gabi_igna: bets $4.81
matiko09: folds 
Uncalled bet ($4.81) returned to gabi_igna
gabi_igna collected $4.81 from pot
gabi_igna: doesn't show hand 
*** SUMMARY ***
Total pot $5.04 | Rake $0.23 
Board [3d 2s 9d Qd]
Seat 1: Khaine_CM folded before Flop (didn't bet)
Seat 3: drakariss folded before Flop (didn't bet)
Seat 4: Rikti folded before Flop (didn't bet)
Seat 5: matiko09 (button) folded on the Turn
Seat 7: flk.Dasas (small blind) folded before Flop
Seat 8: gabi_igna (big blind) collected ($4.81)
Seat 9: Vikulja1993 folded before Flop (didn't bet)





PokerStars Hand #150706753277:  Hold'em No Limit (€0.25/€0.50 EUR) - 2016/03/21 16:43:34 CET [2016/03/21 11:43:34 ET]
Table 'Auravictrix II' 9-max Seat #5 is the button
Seat 1: aponinho82 (€52.07 in chips) 
Seat 2: ffac (€56.64 in chips) 
Seat 3: matiko09 (€50 in chips) 
Seat 5: nombraalne1 (€50 in chips) 
Seat 9: carlouchi (€33.20 in chips) 
carlouchi: posts small blind €0.25
aponinho82: posts big blind €0.50
i am owsome: sits out 
*** HOLE CARDS ***
Dealt to matiko09 [Jh As]
ffac: folds 
matiko09: raises €1 to €1.50
nombraalne1: folds 
carlouchi: calls €1.25
aponinho82: calls €1
*** FLOP *** [Ts 5s Jd]
carlouchi: checks 
aponinho82: bets €1
matiko09: raises €4 to €5
carlouchi: folds 
aponinho82: folds 
Uncalled bet (€4) returned to matiko09
matiko09 collected €6.21 from pot
matiko09: doesn't show hand 
*** SUMMARY ***
Total pot €6.50 | Rake €0.29 
Board [Ts 5s Jd]
Seat 1: aponinho82 (big blind) folded on the Flop
Seat 2: ffac folded before Flop (didn't bet)
Seat 3: matiko09 collected (€6.21)
Seat 5: nombraalne1 (button) folded before Flop (didn't bet)
Seat 9: carlouchi (small blind) folded on the Flop





PokerStars Hand #150706757497:  Hold'em No Limit ($0.50/$1.00 USD) - 2016/03/21 16:43:40 CET [2016/03/21 11:43:40 ET]
Table 'Onnie II' 9-max Seat #8 is the button
Seat 1: aseban11 ($195.58 in chips) 
Seat 2: RICKA16 ($100 in chips) 
Seat 3: cn_chayanne ($101 in chips) 
Seat 4: Bothfeld11 ($100.68 in chips) 
Seat 5: roninio1 ($40.69 in chips) 
Seat 7: djammusic ($70.58 in chips) 
Seat 8: solbi86 ($107.76 in chips) 
Seat 9: matiko09 ($115.12 in chips) 
matiko09: posts small blind $0.50
aseban11: posts big blind $1
*** HOLE CARDS ***
Dealt to matiko09 [8s 8h]
RICKA16: folds 
cn_chayanne: folds 
Bothfeld11: raises $1 to $2
roninio1: folds 
djammusic: folds 
solbi86: folds 
matiko09: calls $1.50
aseban11: calls $1
*** FLOP *** [9c 5c Qs]
matiko09: checks 
aseban11: bets $4.29
Bothfeld11: raises $4.29 to $8.58
matiko09: folds 
aseban11: folds 
Uncalled bet ($4.29) returned to Bothfeld11
Bothfeld11 collected $13.92 from pot
*** SUMMARY ***
Total pot $14.58 | Rake $0.66 
Board [9c 5c Qs]
Seat 1: aseban11 (big blind) folded on the Flop
Seat 2: RICKA16 folded before Flop (didn't bet)
Seat 3: cn_chayanne folded before Flop (didn't bet)
Seat 4: Bothfeld11 collected ($13.92)
Seat 5: roninio1 folded before Flop (didn't bet)
Seat 7: djammusic folded before Flop (didn't bet)
Seat 8: solbi86 (button) folded before Flop (didn't bet)
Seat 9: matiko09 (small blind) folded on the Flop





PokerStars Hand #150706764983:  Hold'em No Limit ($0.50/$1.00 USD) - 2016/03/21 16:43:50 CET [2016/03/21 11:43:50 ET]
Table 'Gondola II' 9-max Seat #1 is the button
Seat 1: matiko09 ($147.99 in chips) 
Seat 2: R1aki ($110.76 in chips) 
Seat 3: flk.Dasas ($123.86 in chips) 
Seat 4: aseban11 ($113.10 in chips) 
Seat 6: SanychStar ($118.87 in chips) 
Seat 7: Pacifistas ($107.13 in chips) 
Seat 8: cn_chayanne ($100 in chips) 
Seat 9: djammusic ($45.95 in chips) 
R1aki: posts small blind $0.50
flk.Dasas: posts big blind $1
*** HOLE CARDS ***
Dealt to matiko09 [9h 4h]
aseban11: folds 
SanychStar: raises $1.50 to $2.50
Pacifistas: folds 
cn_chayanne: folds 
djammusic: folds 
matiko09: folds 
R1aki: folds 
flk.Dasas: calls $1.50
*** FLOP *** [3d Js 5h]
flk.Dasas: checks 
SanychStar: bets $3.46
flk.Dasas: calls $3.46
*** TURN *** [3d Js 5h] [8s]
flk.Dasas: checks 
SanychStar: checks 
*** RIVER *** [3d Js 5h 8s] [Ks]
flk.Dasas: checks 
SanychStar: bets $7.83
volwebni4ek leaves the table
flk.Dasas: folds 
Uncalled bet ($7.83) returned to SanychStar
SanychStar collected $11.86 from pot
*** SUMMARY ***
Total pot $12.42 | Rake $0.56 
Board [3d Js 5h 8s Ks]
Seat 1: matiko09 (button) folded before Flop (didn't bet)
Seat 2: R1aki (small blind) folded before Flop
Seat 3: flk.Dasas (big blind) folded on the River
Seat 4: aseban11 folded before Flop (didn't bet)
Seat 6: SanychStar collected ($11.86)
Seat 7: Pacifistas folded before Flop (didn't bet)
Seat 8: cn_chayanne folded before Flop (didn't bet)
Seat 9: djammusic folded before Flop (didn't bet)





PokerStars Hand #150706777114:  Hold'em No Limit ($0.50/$1.00 USD) - 2016/03/21 16:44:06 CET [2016/03/21 11:44:06 ET]
Table 'Noel' 9-max Seat #6 is the button
Seat 1: ep538 ($36.35 in chips) 
Seat 2: cobrik23 ($179.40 in chips) 
Seat 4: Kobiroga150 ($70.87 in chips) 
Seat 5: matiko09 ($113.57 in chips) 
Seat 6: hammerwife ($100.73 in chips) 
Seat 7: djammusic ($60.90 in chips) 
Seat 8: Dachish ($66 in chips) 
Seat 9: grifkaaa ($103.84 in chips) 
djammusic: posts small blind $0.50
Dachish: posts big blind $1
*** HOLE CARDS ***
Dealt to matiko09 [Jc 9d]
grifkaaa: folds 
ep538: folds 
cobrik23: folds 
Kobiroga150: folds 
matiko09: folds 
hammerwife: raises $1.01 to $2.01
djammusic: folds 
Dachish: folds 
Uncalled bet ($1.01) returned to hammerwife
hammerwife collected $2.50 from pot
hammerwife: doesn't show hand 
*** SUMMARY ***
Total pot $2.50 | Rake $0 
Seat 1: ep538 folded before Flop (didn't bet)
Seat 2: cobrik23 folded before Flop (didn't bet)
Seat 4: Kobiroga150 folded before Flop (didn't bet)
Seat 5: matiko09 folded before Flop (didn't bet)
Seat 6: hammerwife (button) collected ($2.50)
Seat 7: djammusic (small blind) folded before Flop
Seat 8: Dachish (big blind) folded before Flop
Seat 9: grifkaaa folded before Flop (didn't bet)





PokerStars Hand #150706779246:  Hold'em No Limit (€0.25/€0.50 EUR) - 2016/03/21 16:44:09 CET [2016/03/21 11:44:09 ET]
Table 'Auravictrix II' 9-max Seat #9 is the button
Seat 1: aponinho82 (€49.57 in chips) 
Seat 2: ffac (€56.64 in chips) 
Seat 3: matiko09 (€53.71 in chips) 
Seat 5: nombraalne1 (€50 in chips) 
Seat 9: carlouchi (€31.70 in chips) 
aponinho82: posts small blind €0.25
ffac: posts big blind €0.50
i am owsome: sits out 
*** HOLE CARDS ***
Dealt to matiko09 [2c 8c]
matiko09: folds 
nombraalne1: raises €0.50 to €1
carlouchi: folds 
aponinho82: calls €0.75
ffac: folds 
*** FLOP *** [Ts 7s 4d]
aponinho82: checks 
nombraalne1: checks 
*** TURN *** [Ts 7s 4d] [5c]
aponinho82: checks 
nombraalne1: checks 
*** RIVER *** [Ts 7s 4d 5c] [8d]
aponinho82: checks 
nombraalne1: checks 
*** SHOW DOWN ***
aponinho82: shows [8s Jc] (a pair of Eights)
nombraalne1: mucks hand 
aponinho82 collected €2.39 from pot
*** SUMMARY ***
Total pot €2.50 | Rake €0.11 
Board [Ts 7s 4d 5c 8d]
Seat 1: aponinho82 (small blind) showed [8s Jc] and won (€2.39) with a pair of Eights
Seat 2: ffac (big blind) folded before Flop
Seat 3: matiko09 folded before Flop (didn't bet)
Seat 5: nombraalne1 mucked [Ad Kc]
Seat 9: carlouchi (button) folded before Flop (didn't bet)





PokerStars Hand #150706787719:  Hold'em No Limit ($0.50/$1.00 USD) - 2016/03/21 16:44:21 CET [2016/03/21 11:44:21 ET]
Table 'Havnia' 9-max Seat #7 is the button
Seat 1: Khaine_CM ($101 in chips) 
Seat 3: drakariss ($39.25 in chips) 
Seat 4: Rikti ($46.37 in chips) 
Seat 5: matiko09 ($100 in chips) 
Seat 7: flk.Dasas ($198.20 in chips) 
Seat 8: gabi_igna ($106.04 in chips) 
Seat 9: Vikulja1993 ($101.50 in chips) 
gabi_igna: posts small blind $0.50
Vikulja1993: posts big blind $1
i am owsome: sits out 
*** HOLE CARDS ***
Dealt to matiko09 [2d 9d]
Khaine_CM: folds 
drakariss: folds 
Rikti: raises $1.50 to $2.50
matiko09: folds 
flk.Dasas: folds 
gabi_igna: folds 
Vikulja1993: folds 
Uncalled bet ($1.50) returned to Rikti
Rikti collected $2.50 from pot
Rikti: doesn't show hand 
*** SUMMARY ***
Total pot $2.50 | Rake $0 
Seat 1: Khaine_CM folded before Flop (didn't bet)
Seat 3: drakariss folded before Flop (didn't bet)
Seat 4: Rikti collected ($2.50)
Seat 5: matiko09 folded before Flop (didn't bet)
Seat 7: flk.Dasas (button) folded before Flop (didn't bet)
Seat 8: gabi_igna (small blind) folded before Flop
Seat 9: Vikulja1993 (big blind) folded before Flop





PokerStars Hand #150706790035:  Hold'em No Limit ($0.50/$1.00 USD) - 2016/03/21 16:44:24 CET [2016/03/21 11:44:24 ET]
Table 'Noel' 9-max Seat #7 is the button
Seat 1: ep538 ($36.35 in chips) 
Seat 2: cobrik23 ($179.40 in chips) 
Seat 4: Kobiroga150 ($70.87 in chips) 
Seat 5: matiko09 ($113.57 in chips) 
Seat 6: hammerwife ($102.23 in chips) 
Seat 7: djammusic ($60.40 in chips) 
Seat 8: Dachish ($65 in chips) 
Seat 9: grifkaaa ($103.84 in chips) 
Dachish: posts small blind $0.50
grifkaaa: posts big blind $1
*** HOLE CARDS ***
Dealt to matiko09 [7d 5d]
ep538: folds 
cobrik23 has timed out
cobrik23: folds 
Kobiroga150: folds 
matiko09: folds 
hammerwife: folds 
djammusic: raises $1.02 to $2.02
Dachish: folds 
grifkaaa: folds 
Uncalled bet ($1.02) returned to djammusic
djammusic collected $2.50 from pot
djammusic: doesn't show hand 
*** SUMMARY ***
Total pot $2.50 | Rake $0 
Seat 1: ep538 folded before Flop (didn't bet)
Seat 2: cobrik23 folded before Flop (didn't bet)
Seat 4: Kobiroga150 folded before Flop (didn't bet)
Seat 5: matiko09 folded before Flop (didn't bet)
Seat 6: hammerwife folded before Flop (didn't bet)
Seat 7: djammusic (button) collected ($2.50)
Seat 8: Dachish (small blind) folded before Flop
Seat 9: grifkaaa (big blind) folded before Flop





PokerStars Hand #150706801174:  Hold'em No Limit ($0.50/$1.00 USD) - 2016/03/21 16:44:39 CET [2016/03/21 11:44:39 ET]
Table 'Onnie II' 9-max Seat #9 is the button
Seat 1: aseban11 ($189.29 in chips) 
Seat 2: RICKA16 ($100 in chips) 
Seat 3: cn_chayanne ($101 in chips) 
Seat 4: Bothfeld11 ($108.31 in chips) 
Seat 5: roninio1 ($40.69 in chips) 
Seat 7: djammusic ($70.58 in chips) 
Seat 8: solbi86 ($107.76 in chips) 
Seat 9: matiko09 ($113.12 in chips) 
aseban11: posts small blind $0.50
RICKA16: posts big blind $1
*** HOLE CARDS ***
Dealt to matiko09 [3c 5c]
cn_chayanne: folds 
Bothfeld11: calls $1
roninio1: folds 
djammusic: folds 
solbi86: folds 
matiko09: folds 
aseban11: folds 
RICKA16: raises $3 to $4
Bothfeld11: calls $3
*** FLOP *** [Ac Kh Ks]
RICKA16: bets $5
Bothfeld11: folds 
Uncalled bet ($5) returned to RICKA16
RICKA16 collected $8.12 from pot
RICKA16: doesn't show hand 
*** SUMMARY ***
Total pot $8.50 | Rake $0.38 
Board [Ac Kh Ks]
Seat 1: aseban11 (small blind) folded before Flop
Seat 2: RICKA16 (big blind) collected ($8.12)
Seat 3: cn_chayanne folded before Flop (didn't bet)
Seat 4: Bothfeld11 folded on the Flop
Seat 5: roninio1 folded before Flop (didn't bet)
Seat 7: djammusic folded before Flop (didn't bet)
Seat 8: solbi86 folded before Flop (didn't bet)
Seat 9: matiko09 (button) folded before Flop (didn't bet)





PokerStars Hand #150706802746:  Hold'em No Limit ($0.50/$1.00 USD) - 2016/03/21 16:44:41 CET [2016/03/21 11:44:41 ET]
Table 'Icarion II' 9-max Seat #5 is the button
Seat 5: Gillianus ($97.45 in chips) 
Seat 6: solbi86 ($102.33 in chips) 
Seat 8: matiko09 ($100 in chips) 
solbi86: posts small blind $0.50
matiko09: posts big blind $1
*** HOLE CARDS ***
Dealt to matiko09 [Ah 2s]
teukka8 joins the table at seat #4 
R1aki joins the table at seat #9 
volwebni4ek joins the table at seat #3 
Gillianus: folds 
solbi86: folds 
Uncalled bet ($0.50) returned to matiko09
matiko09 collected $1 from pot
matiko09: doesn't show hand 
*** SUMMARY ***
Total pot $1 | Rake $0 
Seat 5: Gillianus (button) folded before Flop (didn't bet)
Seat 6: solbi86 (small blind) folded before Flop
Seat 8: matiko09 (big blind) collected ($1)





PokerStars Hand #150706817266:  Hold'em No Limit ($0.50/$1.00 USD) - 2016/03/21 16:45:01 CET [2016/03/21 11:45:01 ET]
Table 'Icarion II' 9-max Seat #6 is the button
Seat 4: teukka8 ($50 in chips) 
Seat 5: Gillianus ($97.45 in chips) 
Seat 6: solbi86 ($101.83 in chips) 
Seat 8: matiko09 ($100.50 in chips) 
Seat 9: R1aki ($100 in chips) 
matiko09: posts small blind $0.50
R1aki: posts big blind $1
volwebni4ek: sits out 
teukka8: posts big blind $1
*** HOLE CARDS ***
Dealt to matiko09 [Jd 7h]
forsmthgood joins the table at seat #1 
aseban11 joins the table at seat #2 
teukka8: checks 
Gillianus: folds 
solbi86: folds 
matiko09: folds 
R1aki: checks 
*** FLOP *** [Ah 9h 3s]
R1aki: checks 
teukka8: checks 
*** TURN *** [Ah 9h 3s] [3h]
R1aki: checks 
teukka8: checks 
*** RIVER *** [Ah 9h 3s 3h] [Qs]
R1aki: checks 
teukka8: checks 
*** SHOW DOWN ***
R1aki: shows [7c 8s] (a pair of Threes)
teukka8: shows [6c Tc] (a pair of Threes - Ace+Queen+Ten kicker)
teukka8 collected $2.39 from pot
*** SUMMARY ***
Total pot $2.50 | Rake $0.11 
Board [Ah 9h 3s 3h Qs]
Seat 4: teukka8 showed [6c Tc] and won ($2.39) with a pair of Threes
Seat 5: Gillianus folded before Flop (didn't bet)
Seat 6: solbi86 (button) folded before Flop (didn't bet)
Seat 8: matiko09 (small blind) folded before Flop
Seat 9: R1aki (big blind) showed [7c 8s] and lost with a pair of Threes





PokerStars Hand #150706817021:  Hold'em No Limit ($0.50/$1.00 USD) - 2016/03/21 16:45:01 CET [2016/03/21 11:45:01 ET]
Table 'Havnia' 9-max Seat #8 is the button
Seat 1: Khaine_CM ($101 in chips) 
Seat 3: drakariss ($39.25 in chips) 
Seat 4: Rikti ($47.87 in chips) 
Seat 5: matiko09 ($100 in chips) 
Seat 7: flk.Dasas ($198.20 in chips) 
Seat 8: gabi_igna ($105.54 in chips) 
Seat 9: Vikulja1993 ($100.50 in chips) 
Vikulja1993: posts small blind $0.50
Khaine_CM: posts big blind $1
i am owsome: sits out 
*** HOLE CARDS ***
Dealt to matiko09 [8c Ks]
drakariss: folds 
Rikti: folds 
matiko09: folds 
flk.Dasas: folds 
gabi_igna: folds 
Vikulja1993: raises $1.50 to $2.50
Khaine_CM: folds 
Uncalled bet ($1.50) returned to Vikulja1993
Vikulja1993 collected $2 from pot
Vikulja1993: doesn't show hand 
*** SUMMARY ***
Total pot $2 | Rake $0 
Seat 1: Khaine_CM (big blind) folded before Flop
Seat 3: drakariss folded before Flop (didn't bet)
Seat 4: Rikti folded before Flop (didn't bet)
Seat 5: matiko09 folded before Flop (didn't bet)
Seat 7: flk.Dasas folded before Flop (didn't bet)
Seat 8: gabi_igna (button) folded before Flop (didn't bet)
Seat 9: Vikulja1993 (small blind) collected ($2)





PokerStars Hand #150706821099:  Hold'em No Limit (€0.25/€0.50 EUR) - 2016/03/21 16:45:06 CET [2016/03/21 11:45:06 ET]
Table 'Auravictrix II' 9-max Seat #1 is the button
Seat 1: aponinho82 (€50.96 in chips) 
Seat 2: ffac (€56.14 in chips) 
Seat 3: matiko09 (€53.71 in chips) 
Seat 5: nombraalne1 (€50 in chips) 
Seat 9: carlouchi (€31.70 in chips) 
ffac: posts small blind €0.25
matiko09: posts big blind €0.50
i am owsome: sits out 
*** HOLE CARDS ***
Dealt to matiko09 [Qh 7c]
nombraalne1: folds 
carlouchi: folds 
aponinho82: calls €0.50
ffac: folds 
matiko09: checks 
*** FLOP *** [4d 4c 6h]
matiko09: checks 
aponinho82: checks 
*** TURN *** [4d 4c 6h] [5c]
matiko09: bets €0.77
aponinho82: calls €0.77
*** RIVER *** [4d 4c 6h 5c] [3s]
matiko09: bets €1.73
aponinho82: folds 
Uncalled bet (€1.73) returned to matiko09
matiko09 collected €2.66 from pot
matiko09: doesn't show hand 
*** SUMMARY ***
Total pot €2.79 | Rake €0.13 
Board [4d 4c 6h 5c 3s]
Seat 1: aponinho82 (button) folded on the River
Seat 2: ffac (small blind) folded before Flop
Seat 3: matiko09 (big blind) collected (€2.66)
Seat 5: nombraalne1 folded before Flop (didn't bet)
Seat 9: carlouchi folded before Flop (didn't bet)





PokerStars Hand #150706823299:  Hold'em No Limit ($0.50/$1.00 USD) - 2016/03/21 16:45:09 CET [2016/03/21 11:45:09 ET]
Table 'Onnie II' 9-max Seat #1 is the button
Seat 1: aseban11 ($188.79 in chips) 
Seat 2: RICKA16 ($104.12 in chips) 
Seat 3: cn_chayanne ($101 in chips) 
Seat 4: Bothfeld11 ($104.31 in chips) 
Seat 5: roninio1 ($40.69 in chips) 
Seat 7: djammusic ($70.58 in chips) 
Seat 8: solbi86 ($107.76 in chips) 
Seat 9: matiko09 ($113.12 in chips) 
RICKA16: posts small blind $0.50
cn_chayanne: posts big blind $1
*** HOLE CARDS ***
Dealt to matiko09 [5c 2s]
Bothfeld11: folds 
roninio1: calls $1
djammusic: folds 
solbi86: folds 
matiko09: folds 
aseban11: folds 
RICKA16: folds 
cn_chayanne: checks 
*** FLOP *** [Ad 5h Jc]
cn_chayanne: checks 
roninio1: bets $1
cn_chayanne: folds 
Uncalled bet ($1) returned to roninio1
roninio1 collected $2.39 from pot
roninio1: doesn't show hand 
*** SUMMARY ***
Total pot $2.50 | Rake $0.11 
Board [Ad 5h Jc]
Seat 1: aseban11 (button) folded before Flop (didn't bet)
Seat 2: RICKA16 (small blind) folded before Flop
Seat 3: cn_chayanne (big blind) folded on the Flop
Seat 4: Bothfeld11 folded before Flop (didn't bet)
Seat 5: roninio1 collected ($2.39)
Seat 7: djammusic folded before Flop (didn't bet)
Seat 8: solbi86 folded before Flop (didn't bet)
Seat 9: matiko09 folded before Flop (didn't bet)





PokerStars Hand #150706827220:  Hold'em No Limit ($0.50/$1.00 USD) - 2016/03/21 16:45:15 CET [2016/03/21 11:45:15 ET]
Table 'Noel' 9-max Seat #8 is the button
Seat 1: ep538 ($36.35 in chips) 
Seat 2: cobrik23 ($179.40 in chips) 
Seat 4: Kobiroga150 ($70.87 in chips) 
Seat 5: matiko09 ($113.57 in chips) 
Seat 6: hammerwife ($102.23 in chips) 
Seat 7: djammusic ($61.90 in chips) 
Seat 8: Dachish ($64.50 in chips) 
Seat 9: grifkaaa ($102.84 in chips) 
grifkaaa: posts small blind $0.50
ep538: posts big blind $1
*** HOLE CARDS ***
Dealt to matiko09 [3c 2h]
cobrik23: folds 
Kobiroga150: folds 
matiko09: folds 
hammerwife: raises $1.50 to $2.50
djammusic: folds 
Dachish: folds 
grifkaaa: folds 
ep538: folds 
Uncalled bet ($1.50) returned to hammerwife
hammerwife collected $2.50 from pot
hammerwife: doesn't show hand 
*** SUMMARY ***
Total pot $2.50 | Rake $0 
Seat 1: ep538 (big blind) folded before Flop
Seat 2: cobrik23 folded before Flop (didn't bet)
Seat 4: Kobiroga150 folded before Flop (didn't bet)
Seat 5: matiko09 folded before Flop (didn't bet)
Seat 6: hammerwife collected ($2.50)
Seat 7: djammusic folded before Flop (didn't bet)
Seat 8: Dachish (button) folded before Flop (didn't bet)
Seat 9: grifkaaa (small blind) folded before Flop





PokerStars Hand #150706828275:  Hold'em No Limit ($0.50/$1.00 USD) - 2016/03/21 16:45:16 CET [2016/03/21 11:45:16 ET]
Table 'Gondola II' 9-max Seat #2 is the button
Seat 1: matiko09 ($147.99 in chips) 
Seat 2: R1aki ($110.26 in chips) 
Seat 3: flk.Dasas ($117.90 in chips) 
Seat 4: aseban11 ($113.10 in chips) 
Seat 6: SanychStar ($124.77 in chips) 
Seat 7: Pacifistas ($107.13 in chips) 
Seat 8: cn_chayanne ($100 in chips) 
Seat 9: djammusic ($45.95 in chips) 
flk.Dasas: posts small blind $0.50
aseban11: posts big blind $1
*** HOLE CARDS ***
Dealt to matiko09 [Kd 4s]
SanychStar: folds 
Pacifistas: folds 
cn_chayanne: folds 
djammusic: folds 
matiko09: folds 
R1aki: raises $1.50 to $2.50
flk.Dasas: folds 
aseban11: calls $1.50
*** FLOP *** [8h Td Kc]
aseban11: checks 
R1aki: bets $3
aseban11: folds 
Uncalled bet ($3) returned to R1aki
R1aki collected $5.25 from pot
R1aki: doesn't show hand 
*** SUMMARY ***
Total pot $5.50 | Rake $0.25 
Board [8h Td Kc]
Seat 1: matiko09 folded before Flop (didn't bet)
Seat 2: R1aki (button) collected ($5.25)
Seat 3: flk.Dasas (small blind) folded before Flop
Seat 4: aseban11 (big blind) folded on the Flop
Seat 6: SanychStar folded before Flop (didn't bet)
Seat 7: Pacifistas folded before Flop (didn't bet)
Seat 8: cn_chayanne folded before Flop (didn't bet)
Seat 9: djammusic folded before Flop (didn't bet)





PokerStars Hand #150706839705:  Hold'em No Limit ($0.50/$1.00 USD) - 2016/03/21 16:45:32 CET [2016/03/21 11:45:32 ET]
Table 'Havnia' 9-max Seat #9 is the button
Seat 1: Khaine_CM ($100 in chips) 
Seat 2: i am owsome ($100 in chips) 
Seat 3: drakariss ($39.25 in chips) 
Seat 4: Rikti ($47.87 in chips) 
Seat 5: matiko09 ($100 in chips) 
Seat 7: flk.Dasas ($198.20 in chips) 
Seat 8: gabi_igna ($105.54 in chips) 
Seat 9: Vikulja1993 ($101.50 in chips) 
Khaine_CM: posts small blind $0.50
i am owsome: posts big blind $1
*** HOLE CARDS ***
Dealt to matiko09 [As 2s]
drakariss: folds 
Rikti: raises $1.50 to $2.50
matiko09: folds 
flk.Dasas: folds 
gabi_igna: folds 
Vikulja1993: folds 
Khaine_CM: folds 
i am owsome: folds 
Uncalled bet ($1.50) returned to Rikti
Rikti collected $2.50 from pot
Rikti: doesn't show hand 
*** SUMMARY ***
Total pot $2.50 | Rake $0 
Seat 1: Khaine_CM (small blind) folded before Flop
Seat 2: i am owsome (big blind) folded before Flop
Seat 3: drakariss folded before Flop (didn't bet)
Seat 4: Rikti collected ($2.50)
Seat 5: matiko09 folded before Flop (didn't bet)
Seat 7: flk.Dasas folded before Flop (didn't bet)
Seat 8: gabi_igna folded before Flop (didn't bet)
Seat 9: Vikulja1993 (button) folded before Flop (didn't bet)





PokerStars Hand #150706846262:  Hold'em No Limit (€0.25/€0.50 EUR) - 2016/03/21 16:45:40 CET [2016/03/21 11:45:40 ET]
Table 'Auravictrix II' 9-max Seat #2 is the button
Seat 1: aponinho82 (€49.69 in chips) 
Seat 2: ffac (€55.89 in chips) 
Seat 3: matiko09 (€55.10 in chips) 
Seat 4: i am owsome (€50 in chips) 
Seat 5: nombraalne1 (€50 in chips) 
Seat 9: carlouchi (€31.70 in chips) 
matiko09: posts small blind €0.25
i am owsome: posts big blind €0.50
*** HOLE CARDS ***
Dealt to matiko09 [8c 4s]
nombraalne1: raises €0.75 to €1.25
carlouchi: folds 
aponinho82: calls €1.25
ffac: folds 
matiko09: folds 
Devsteel joins the table at seat #6 
i am owsome: calls €0.75
*** FLOP *** [Ac 5h 7s]
i am owsome: checks 
nombraalne1: checks 
aponinho82: checks 
*** TURN *** [Ac 5h 7s] [9c]
i am owsome: checks 
nombraalne1: bets €2.50
aponinho82: calls €2.50
i am owsome: folds 
*** RIVER *** [Ac 5h 7s 9c] [Jc]
Volbeat7 joins the table at seat #7 
nombraalne1: checks 
aponinho82: checks 
ardo888 joins the table at seat #8 
*** SHOW DOWN ***
nombraalne1: shows [3c 3s] (a pair of Threes)
aponinho82: shows [Ks 9d] (a pair of Nines)
aponinho82 collected €8.60 from pot
*** SUMMARY ***
Total pot €9 | Rake €0.40 
Board [Ac 5h 7s 9c Jc]
Seat 1: aponinho82 showed [Ks 9d] and won (€8.60) with a pair of Nines
Seat 2: ffac (button) folded before Flop (didn't bet)
Seat 3: matiko09 (small blind) folded before Flop
Seat 4: i am owsome (big blind) folded on the Turn
Seat 5: nombraalne1 showed [3c 3s] and lost with a pair of Threes
Seat 9: carlouchi folded before Flop (didn't bet)





PokerStars Hand #150706851191:  Hold'em No Limit ($0.50/$1.00 USD) - 2016/03/21 16:45:47 CET [2016/03/21 11:45:47 ET]
Table 'Icarion II' 9-max Seat #8 is the button
Seat 1: forsmthgood ($100 in chips) 
Seat 4: teukka8 ($51.39 in chips) 
Seat 5: Gillianus ($97.45 in chips) 
Seat 6: solbi86 ($101.83 in chips) 
Seat 8: matiko09 ($100 in chips) 
Seat 9: R1aki ($100 in chips) 
R1aki: posts small blind $0.50
forsmthgood: posts big blind $1
aseban11: sits out 
volwebni4ek: sits out 
*** HOLE CARDS ***
Dealt to matiko09 [6s 9c]
teukka8: folds 
Gillianus: folds 
solbi86: folds 
matiko09: folds 
R1aki: folds 
Uncalled bet ($0.50) returned to forsmthgood
forsmthgood collected $1 from pot
*** SUMMARY ***
Total pot $1 | Rake $0 
Seat 1: forsmthgood (big blind) collected ($1)
Seat 4: teukka8 folded before Flop (didn't bet)
Seat 5: Gillianus folded before Flop (didn't bet)
Seat 6: solbi86 folded before Flop (didn't bet)
Seat 8: matiko09 (button) folded before Flop (didn't bet)
Seat 9: R1aki (small blind) folded before Flop





PokerStars Hand #150706851269:  Hold'em No Limit (€0.25/€0.50 EUR) - 2016/03/21 16:45:47 CET [2016/03/21 11:45:47 ET]
Table 'Ndola' 9-max Seat #3 is the button
Seat 1: Muinmyheart (€54.79 in chips) 
Seat 2: janarr5 (€51.85 in chips) 
Seat 3: nubpoker (€50 in chips) 
Seat 4: Gigi201133 (€66.40 in chips) 
Seat 5: matiko09 (€50 in chips) 
Seat 6: OraculBy (€53.88 in chips) 
Seat 7: djammusic (€19.35 in chips) 
Seat 8: Devsteel (€102.35 in chips) 
Seat 9: vasiy379 (€66.74 in chips) 
Gigi201133: posts small blind €0.25
matiko09: posts big blind €0.50
*** HOLE CARDS ***
Dealt to matiko09 [3s 4c]
OraculBy: folds 
djammusic: folds 
Devsteel: folds 
vasiy379: raises €1 to €1.50
Muinmyheart: folds 
janarr5: folds 
nubpoker: folds 
Gigi201133: calls €1.25
matiko09: folds 
*** FLOP *** [Jd 5c 2h]
Gigi201133: checks 
vasiy379: bets €1.16
Gigi201133: calls €1.16
*** TURN *** [Jd 5c 2h] [Jh]
Gigi201133: checks 
vasiy379: bets €3.89
Gigi201133: calls €3.89
*** RIVER *** [Jd 5c 2h Jh] [6s]
Gigi201133: checks 
vasiy379: bets €9.25
Gigi201133: calls €9.25
*** SHOW DOWN ***
vasiy379: shows [5s 5d] (a full house, Fives full of Jacks)
Gigi201133: mucks hand 
vasiy379 collected €30.66 from pot
*** SUMMARY ***
Total pot €32.10 | Rake €1.44 
Board [Jd 5c 2h Jh 6s]
Seat 1: Muinmyheart folded before Flop (didn't bet)
Seat 2: janarr5 folded before Flop (didn't bet)
Seat 3: nubpoker (button) folded before Flop (didn't bet)
Seat 4: Gigi201133 (small blind) mucked [3h 3d]
Seat 5: matiko09 (big blind) folded before Flop
Seat 6: OraculBy folded before Flop (didn't bet)
Seat 7: djammusic folded before Flop (didn't bet)
Seat 8: Devsteel folded before Flop (didn't bet)
Seat 9: vasiy379 showed [5s 5d] and won (€30.66) with a full house, Fives full of Jacks





PokerStars Hand #150706853065:  Hold'em No Limit ($0.50/$1.00 USD) - 2016/03/21 16:45:50 CET [2016/03/21 11:45:50 ET]
Table 'Massalia II' 9-max Seat #8 is the button
Seat 1: crepke ($80.92 in chips) 
Seat 2: solbi86 ($104.36 in chips) 
Seat 3: 123chambo ($92.90 in chips) 
Seat 4: OriginalTony ($94.74 in chips) 
Seat 5: roninio1 ($109.37 in chips) 
Seat 6: Pacifistas ($149.27 in chips) 
Seat 7: flk.Dasas ($102.40 in chips) 
Seat 8: matiko09 ($190.30 in chips) 
Seat 9: hammerwife ($100 in chips) 
hammerwife: posts small blind $0.50
crepke: posts big blind $1
crepke: posts the ante $0.20
solbi86: posts the ante $0.20
123chambo: posts the ante $0.20
OriginalTony: posts the ante $0.20
roninio1: posts the ante $0.20
Pacifistas: posts the ante $0.20
flk.Dasas: posts the ante $0.20
matiko09: posts the ante $0.20
hammerwife: posts the ante $0.20
*** HOLE CARDS ***
Dealt to matiko09 [Qs 4c]
solbi86: folds 
123chambo: folds 
OriginalTony: folds 
roninio1: calls $1
Pacifistas: raises $3 to $4
flk.Dasas: folds 
matiko09: folds 
hammerwife: folds 
crepke: folds 
roninio1: calls $3
*** FLOP *** [2d Kd 3d]
roninio1: checks 
Pacifistas: checks 
*** TURN *** [2d Kd 3d] [Qc]
roninio1: bets $2
Pacifistas: calls $2
*** RIVER *** [2d Kd 3d Qc] [Jc]
roninio1: bets $103.17 and is all-in
Pacifistas: folds 
Uncalled bet ($103.17) returned to roninio1
roninio1 collected $14.61 from pot
roninio1: doesn't show hand 
*** SUMMARY ***
Total pot $15.30 | Rake $0.69 
Board [2d Kd 3d Qc Jc]
Seat 1: crepke (big blind) folded before Flop
Seat 2: solbi86 folded before Flop (didn't bet)
Seat 3: 123chambo folded before Flop (didn't bet)
Seat 4: OriginalTony folded before Flop (didn't bet)
Seat 5: roninio1 collected ($14.61)
Seat 6: Pacifistas folded on the River
Seat 7: flk.Dasas folded before Flop (didn't bet)
Seat 8: matiko09 (button) folded before Flop (didn't bet)
Seat 9: hammerwife (small blind) folded before Flop





PokerStars Hand #150706859276:  Hold'em No Limit ($0.50/$1.00 USD) - 2016/03/21 16:45:58 CET [2016/03/21 11:45:58 ET]
Table 'Onnie II' 9-max Seat #2 is the button
Seat 1: aseban11 ($188.79 in chips) 
Seat 2: RICKA16 ($103.62 in chips) 
Seat 3: cn_chayanne ($100 in chips) 
Seat 4: Bothfeld11 ($104.31 in chips) 
Seat 5: roninio1 ($42.08 in chips) 
Seat 7: djammusic ($70.58 in chips) 
Seat 8: solbi86 ($107.76 in chips) 
Seat 9: matiko09 ($113.12 in chips) 
cn_chayanne: posts small blind $0.50
Bothfeld11: posts big blind $1
*** HOLE CARDS ***
Dealt to matiko09 [Tc 5s]
roninio1: folds 
djammusic: folds 
solbi86: folds 
matiko09: folds 
aseban11: folds 
RICKA16: folds 
cn_chayanne: folds 
Uncalled bet ($0.50) returned to Bothfeld11
Bothfeld11 collected $1 from pot
*** SUMMARY ***
Total pot $1 | Rake $0 
Seat 1: aseban11 folded before Flop (didn't bet)
Seat 2: RICKA16 (button) folded before Flop (didn't bet)
Seat 3: cn_chayanne (small blind) folded before Flop
Seat 4: Bothfeld11 (big blind) collected ($1)
Seat 5: roninio1 folded before Flop (didn't bet)
Seat 7: djammusic folded before Flop (didn't bet)
Seat 8: solbi86 folded before Flop (didn't bet)
Seat 9: matiko09 folded before Flop (didn't bet)





PokerStars Hand #150706860222:  Hold'em No Limit ($0.50/$1.00 USD) - 2016/03/21 16:45:59 CET [2016/03/21 11:45:59 ET]
Table 'Icarion II' 9-max Seat #9 is the button
Seat 1: forsmthgood ($100.50 in chips) 
Seat 2: aseban11 ($100 in chips) 
Seat 4: teukka8 ($51.39 in chips) 
Seat 5: Gillianus ($97.45 in chips) 
Seat 6: solbi86 ($101.83 in chips) 
Seat 8: matiko09 ($100 in chips) 
Seat 9: R1aki ($100 in chips) 
forsmthgood: posts small blind $0.50
aseban11: posts big blind $1
volwebni4ek: sits out 
*** HOLE CARDS ***
Dealt to matiko09 [3c 8s]
teukka8: folds 
Gillianus: raises $1 to $2
solbi86: folds 
matiko09: folds 
R1aki: folds 
forsmthgood: folds 
aseban11: folds 
Uncalled bet ($1) returned to Gillianus
Gillianus collected $2.50 from pot
*** SUMMARY ***
Total pot $2.50 | Rake $0 
Seat 1: forsmthgood (small blind) folded before Flop
Seat 2: aseban11 (big blind) folded before Flop
Seat 4: teukka8 folded before Flop (didn't bet)
Seat 5: Gillianus collected ($2.50)
Seat 6: solbi86 folded before Flop (didn't bet)
Seat 8: matiko09 folded before Flop (didn't bet)
Seat 9: R1aki (button) folded before Flop (didn't bet)





PokerStars Hand #150706860246:  Hold'em No Limit ($0.50/$1.00 USD) - 2016/03/21 16:45:59 CET [2016/03/21 11:45:59 ET]
Table 'Noel' 9-max Seat #9 is the button
Seat 1: ep538 ($35.35 in chips) 
Seat 2: cobrik23 ($179.40 in chips) 
Seat 4: Kobiroga150 ($70.87 in chips) 
Seat 5: matiko09 ($113.57 in chips) 
Seat 6: hammerwife ($103.73 in chips) 
Seat 7: djammusic ($61.90 in chips) 
Seat 8: Dachish ($64.50 in chips) 
Seat 9: grifkaaa ($102.34 in chips) 
ep538: posts small blind $0.50
cobrik23: posts big blind $1
*** HOLE CARDS ***
Dealt to matiko09 [5h 2s]
Kobiroga150: folds 
matiko09: folds 
hammerwife: folds 
djammusic: raises $1.50 to $2.50
Dachish: calls $2.50
grifkaaa: folds 
ep538: folds 
cobrik23: folds 
*** FLOP *** [Jh 6c 5c]
djammusic: checks 
Dachish: bets $3.50
djammusic: calls $3.50
*** TURN *** [Jh 6c 5c] [Ts]
djammusic: checks 
Dachish: checks 
*** RIVER *** [Jh 6c 5c Ts] [2c]
djammusic: bets $7.50
Dachish: folds 
Uncalled bet ($7.50) returned to djammusic
djammusic collected $12.89 from pot
djammusic: doesn't show hand 
*** SUMMARY ***
Total pot $13.50 | Rake $0.61 
Board [Jh 6c 5c Ts 2c]
Seat 1: ep538 (small blind) folded before Flop
Seat 2: cobrik23 (big blind) folded before Flop
Seat 4: Kobiroga150 folded before Flop (didn't bet)
Seat 5: matiko09 folded before Flop (didn't bet)
Seat 6: hammerwife folded before Flop (didn't bet)
Seat 7: djammusic collected ($12.89)
Seat 8: Dachish folded on the River
Seat 9: grifkaaa (button) folded before Flop (didn't bet)





PokerStars Hand #150706868737:  Hold'em No Limit ($0.50/$1.00 USD) - 2016/03/21 16:46:11 CET [2016/03/21 11:46:11 ET]
Table 'Gondola II' 9-max Seat #3 is the button
Seat 1: matiko09 ($147.99 in chips) 
Seat 2: R1aki ($113.01 in chips) 
Seat 3: flk.Dasas ($117.40 in chips) 
Seat 4: aseban11 ($110.60 in chips) 
Seat 7: Pacifistas ($107.13 in chips) 
Seat 8: cn_chayanne ($100 in chips) 
Seat 9: djammusic ($45.95 in chips) 
aseban11: posts small blind $0.50
SanychStar: is sitting out 
Pacifistas: posts big blind $1
*** HOLE CARDS ***
Dealt to matiko09 [3s 9d]
SanychStar leaves the table
Dachish joins the table at seat #5 
Dachish leaves the table
cn_chayanne: folds 
Vikulja1993 joins the table at seat #5 
djammusic: folds 
cn_chayanne leaves the table
matiko09: folds 
Vikulja1993 leaves the table
R1aki: folds 
flk.Dasas: raises $1.50 to $2.50
aseban11: folds 
Pacifistas: calls $1.50
*** FLOP *** [Js Td 5s]
Pacifistas: checks 
flk.Dasas: bets $3.57
Pacifistas: folds 
Uncalled bet ($3.57) returned to flk.Dasas
flk.Dasas collected $5.25 from pot
flk.Dasas: doesn't show hand 
*** SUMMARY ***
Total pot $5.50 | Rake $0.25 
Board [Js Td 5s]
Seat 1: matiko09 folded before Flop (didn't bet)
Seat 2: R1aki folded before Flop (didn't bet)
Seat 3: flk.Dasas (button) collected ($5.25)
Seat 4: aseban11 (small blind) folded before Flop
Seat 7: Pacifistas (big blind) folded on the Flop
Seat 8: cn_chayanne folded before Flop (didn't bet)
Seat 9: djammusic folded before Flop (didn't bet)





PokerStars Hand #150706869945:  Hold'em No Limit ($0.50/$1.00 USD) - 2016/03/21 16:46:13 CET [2016/03/21 11:46:13 ET]
Table 'Havnia' 9-max Seat #1 is the button
Seat 1: Khaine_CM ($100 in chips) 
Seat 2: i am owsome ($100 in chips) 
Seat 3: drakariss ($39.25 in chips) 
Seat 4: Rikti ($49.37 in chips) 
Seat 5: matiko09 ($100 in chips) 
Seat 7: flk.Dasas ($198.20 in chips) 
Seat 8: gabi_igna ($105.54 in chips) 
Seat 9: Vikulja1993 ($101.50 in chips) 
i am owsome: posts small blind $0.50
drakariss: posts big blind $1
*** HOLE CARDS ***
Dealt to matiko09 [Ah 9c]
Rikti: raises $1.50 to $2.50
matiko09: folds 
flk.Dasas: calls $2.50
gabi_igna: folds 
Vikulja1993: folds 
Khaine_CM: folds 
i am owsome: calls $2
drakariss: folds 
*** FLOP *** [6s Qh Ks]
i am owsome: checks 
Rikti: bets $3
flk.Dasas: folds 
i am owsome: folds 
Uncalled bet ($3) returned to Rikti
Rikti collected $8.12 from pot
Rikti: doesn't show hand 
*** SUMMARY ***
Total pot $8.50 | Rake $0.38 
Board [6s Qh Ks]
Seat 1: Khaine_CM (button) folded before Flop (didn't bet)
Seat 2: i am owsome (small blind) folded on the Flop
Seat 3: drakariss (big blind) folded before Flop
Seat 4: Rikti collected ($8.12)
Seat 5: matiko09 folded before Flop (didn't bet)
Seat 7: flk.Dasas folded on the Flop
Seat 8: gabi_igna folded before Flop (didn't bet)
Seat 9: Vikulja1993 folded before Flop (didn't bet)





PokerStars Hand #150706875271:  Hold'em No Limit ($0.50/$1.00 USD) - 2016/03/21 16:46:20 CET [2016/03/21 11:46:20 ET]
Table 'Skadi III' 9-max Seat #1 is the button
Seat 1: R1aki ($100 in chips) 
Seat 2: aseban11 ($100 in chips) 
Seat 3: matiko09 ($100 in chips) 
Seat 5: WaldiQ ($100 in chips) 
Seat 8: ilaviiitech ($100 in chips) 
Seat 9: bradsheps ($100 in chips) 
aseban11: posts small blind $0.50
matiko09: posts big blind $1
*** HOLE CARDS ***
Dealt to matiko09 [Jc 3h]
WaldiQ: raises $2 to $3
ilaviiitech: folds 
ilaviiitech leaves the table
bradsheps: folds 
ilaviiitech joins the table at seat #4 
solbi86 joins the table at seat #7 
R1aki: folds 
aseban11: folds 
matiko09: folds 
Uncalled bet ($2) returned to WaldiQ
WaldiQ collected $2.50 from pot
*** SUMMARY ***
Total pot $2.50 | Rake $0 
Seat 1: R1aki (button) folded before Flop (didn't bet)
Seat 2: aseban11 (small blind) folded before Flop
Seat 3: matiko09 (big blind) folded before Flop
Seat 5: WaldiQ collected ($2.50)
Seat 8: ilaviiitech folded before Flop (didn't bet)
Seat 9: bradsheps folded before Flop (didn't bet)





PokerStars Hand #150706879832:  Hold'em No Limit ($0.50/$1.00 USD) - 2016/03/21 16:46:26 CET [2016/03/21 11:46:26 ET]
Table 'Icarion II' 9-max Seat #1 is the button
Seat 1: forsmthgood ($100 in chips) 
Seat 2: aseban11 ($100 in chips) 
Seat 3: volwebni4ek ($51.94 in chips) 
Seat 4: teukka8 ($51.39 in chips) 
Seat 5: Gillianus ($98.95 in chips) 
Seat 6: solbi86 ($101.83 in chips) 
Seat 8: matiko09 ($100 in chips) 
Seat 9: R1aki ($100 in chips) 
aseban11: posts small blind $0.50
volwebni4ek: posts big blind $1
*** HOLE CARDS ***
Dealt to matiko09 [Ad 9h]
teukka8: folds 
Gillianus: folds 
solbi86: folds 
matiko09: folds 
R1aki: raises $1.50 to $2.50
forsmthgood: folds 
aseban11: folds 
volwebni4ek: folds 
Uncalled bet ($1.50) returned to R1aki
R1aki collected $2.50 from pot
R1aki: doesn't show hand 
*** SUMMARY ***
Total pot $2.50 | Rake $0 
Seat 1: forsmthgood (button) folded before Flop (didn't bet)
Seat 2: aseban11 (small blind) folded before Flop
Seat 3: volwebni4ek (big blind) folded before Flop
Seat 4: teukka8 folded before Flop (didn't bet)
Seat 5: Gillianus folded before Flop (didn't bet)
Seat 6: solbi86 folded before Flop (didn't bet)
Seat 8: matiko09 folded before Flop (didn't bet)
Seat 9: R1aki collected ($2.50)





PokerStars Hand #150706890106:  Hold'em No Limit ($0.50/$1.00 USD) - 2016/03/21 16:46:40 CET [2016/03/21 11:46:40 ET]
Table 'Onnie II' 9-max Seat #3 is the button
Seat 1: aseban11 ($188.79 in chips) 
Seat 2: RICKA16 ($103.62 in chips) 
Seat 3: cn_chayanne ($100 in chips) 
Seat 4: Bothfeld11 ($104.81 in chips) 
Seat 5: roninio1 ($42.08 in chips) 
Seat 7: djammusic ($70.58 in chips) 
Seat 8: solbi86 ($107.76 in chips) 
Seat 9: matiko09 ($113.12 in chips) 
Bothfeld11: posts small blind $0.50
roninio1: posts big blind $1
*** HOLE CARDS ***
Dealt to matiko09 [Qd Ts]
djammusic: raises $1.50 to $2.50
solbi86: folds 
matiko09: folds 
aseban11: folds 
RICKA16: folds 
cn_chayanne: folds 
Bothfeld11: folds 
roninio1: folds 
Uncalled bet ($1.50) returned to djammusic
djammusic collected $2.50 from pot
djammusic: doesn't show hand 
*** SUMMARY ***
Total pot $2.50 | Rake $0 
Seat 1: aseban11 folded before Flop (didn't bet)
Seat 2: RICKA16 folded before Flop (didn't bet)
Seat 3: cn_chayanne (button) folded before Flop (didn't bet)
Seat 4: Bothfeld11 (small blind) folded before Flop
Seat 5: roninio1 (big blind) folded before Flop
Seat 7: djammusic collected ($2.50)
Seat 8: solbi86 folded before Flop (didn't bet)
Seat 9: matiko09 folded before Flop (didn't bet)





PokerStars Hand #150706893991:  Hold'em No Limit ($0.50/$1.00 USD) - 2016/03/21 16:46:45 CET [2016/03/21 11:46:45 ET]
Table 'Skadi III' 9-max Seat #2 is the button
Seat 1: R1aki ($100 in chips) 
Seat 2: aseban11 ($100 in chips) 
Seat 3: matiko09 ($100 in chips) 
Seat 4: ilaviiitech ($100 in chips) 
Seat 5: WaldiQ ($101.50 in chips) 
Seat 9: bradsheps ($100 in chips) 
matiko09: posts small blind $0.50
ilaviiitech: posts big blind $1
solbi86: sits out 
*** HOLE CARDS ***
Dealt to matiko09 [Ah 2s]
WaldiQ: folds 
volwebni4ek joins the table at seat #8 
bradsheps: folds 
R1aki: folds 
aseban11: folds 
matiko09: raises $1.50 to $2.50
ilaviiitech: folds 
Uncalled bet ($1.50) returned to matiko09
matiko09 collected $2 from pot
matiko09: doesn't show hand 
*** SUMMARY ***
Total pot $2 | Rake $0 
Seat 1: R1aki folded before Flop (didn't bet)
Seat 2: aseban11 (button) folded before Flop (didn't bet)
Seat 3: matiko09 (small blind) collected ($2)
Seat 4: ilaviiitech (big blind) folded before Flop
Seat 5: WaldiQ folded before Flop (didn't bet)
Seat 9: bradsheps folded before Flop (didn't bet)





PokerStars Hand #150706899352:  Hold'em No Limit ($0.50/$1.00 USD) - 2016/03/21 16:46:53 CET [2016/03/21 11:46:53 ET]
Table 'Massalia II' 9-max Seat #9 is the button
Seat 1: crepke ($79.72 in chips) 
Seat 2: solbi86 ($104.16 in chips) 
Seat 4: OriginalTony ($94.54 in chips) 
Seat 5: roninio1 ($117.78 in chips) 
Seat 6: Pacifistas ($143.07 in chips) 
Seat 7: flk.Dasas ($102.20 in chips) 
Seat 8: matiko09 ($190.10 in chips) 
Seat 9: hammerwife ($100 in chips) 
crepke: posts small blind $0.50
solbi86: posts big blind $1
crepke: posts the ante $0.20
solbi86: posts the ante $0.20
OriginalTony: posts the ante $0.20
roninio1: posts the ante $0.20
Pacifistas: posts the ante $0.20
flk.Dasas: posts the ante $0.20
matiko09: posts the ante $0.20
hammerwife: posts the ante $0.20
*** HOLE CARDS ***
Dealt to matiko09 [4d 4h]
OriginalTony: folds 
roninio1: calls $1
Pacifistas: raises $3 to $4
flk.Dasas: folds 
matiko09: calls $4
hammerwife: folds 
crepke: folds 
solbi86: folds 
roninio1: calls $3
*** FLOP *** [2d 2c Kh]
roninio1: checks 
Pacifistas: checks 
matiko09: checks 
*** TURN *** [2d 2c Kh] [2h]
roninio1: checks 
Pacifistas: checks 
matiko09: bets $7.49
roninio1: calls $7.49
Pacifistas: folds 
*** RIVER *** [2d 2c Kh 2h] [7d]
roninio1: checks 
matiko09: checks 
*** SHOW DOWN ***
roninio1: shows [Kc 8c] (a full house, Deuces full of Kings)
matiko09: mucks hand 
roninio1 collected $28.73 from pot
*** SUMMARY ***
Total pot $30.08 | Rake $1.35 
Board [2d 2c Kh 2h 7d]
Seat 1: crepke (small blind) folded before Flop
Seat 2: solbi86 (big blind) folded before Flop
Seat 4: OriginalTony folded before Flop (didn't bet)
Seat 5: roninio1 showed [Kc 8c] and won ($28.73) with a full house, Deuces full of Kings
Seat 6: Pacifistas folded on the Turn
Seat 7: flk.Dasas folded before Flop (didn't bet)
Seat 8: matiko09 mucked [4d 4h]
Seat 9: hammerwife (button) folded before Flop (didn't bet)





PokerStars Hand #150706900624:  Hold'em No Limit (€0.25/€0.50 EUR) - 2016/03/21 16:46:54 CET [2016/03/21 11:46:54 ET]
Table 'Ndola' 9-max Seat #4 is the button
Seat 1: Muinmyheart (€54.79 in chips) 
Seat 2: janarr5 (€51.85 in chips) 
Seat 3: nubpoker (€50 in chips) 
Seat 4: Gigi201133 (€50.60 in chips) 
Seat 5: matiko09 (€50 in chips) 
Seat 6: OraculBy (€53.88 in chips) 
Seat 7: djammusic (€19.35 in chips) 
Seat 8: Devsteel (€102.35 in chips) 
Seat 9: vasiy379 (€81.60 in chips) 
matiko09: posts small blind €0.25
OraculBy: posts big blind €0.50
*** HOLE CARDS ***
Dealt to matiko09 [Ts 6d]
djammusic: folds 
djammusic leaves the table
Bailey Dew joins the table at seat #7 
Devsteel: raises €1 to €1.50
vasiy379: folds 
Bailey Dew leaves the table
nombraalne1 joins the table at seat #7 
Muinmyheart: folds 
janarr5: folds 
nubpoker: folds 
Gigi201133: calls €1.50
matiko09: folds 
OraculBy: folds 
*** FLOP *** [Jd 8s 4c]
Devsteel: bets €1.86
Gigi201133: folds 
Uncalled bet (€1.86) returned to Devsteel
Devsteel collected €3.58 from pot
Devsteel: doesn't show hand 
*** SUMMARY ***
Total pot €3.75 | Rake €0.17 
Board [Jd 8s 4c]
Seat 1: Muinmyheart folded before Flop (didn't bet)
Seat 2: janarr5 folded before Flop (didn't bet)
Seat 3: nubpoker folded before Flop (didn't bet)
Seat 4: Gigi201133 (button) folded on the Flop
Seat 5: matiko09 (small blind) folded before Flop
Seat 6: OraculBy (big blind) folded before Flop
Seat 7: djammusic folded before Flop (didn't bet)
Seat 8: Devsteel collected (€3.58)
Seat 9: vasiy379 folded before Flop (didn't bet)





PokerStars Hand #150706902524:  Hold'em No Limit ($0.50/$1.00 USD) - 2016/03/21 16:46:57 CET [2016/03/21 11:46:57 ET]
Table 'Noel' 9-max Seat #1 is the button
Seat 1: ep538 ($34.85 in chips) 
Seat 2: cobrik23 ($178.40 in chips) 
Seat 4: Kobiroga150 ($70.87 in chips) 
Seat 5: matiko09 ($113.57 in chips) 
Seat 6: hammerwife ($103.73 in chips) 
Seat 7: djammusic ($68.79 in chips) 
Seat 8: Dachish ($70 in chips) 
Seat 9: grifkaaa ($102.34 in chips) 
cobrik23: posts small blind $0.50
Kobiroga150: posts big blind $1
*** HOLE CARDS ***
Dealt to matiko09 [6d 3c]
matiko09: folds 
hammerwife: folds 
djammusic: folds 
Dachish: raises $1 to $2
grifkaaa: folds 
ep538: folds 
cobrik23: folds 
Kobiroga150: calls $1
*** FLOP *** [8h 7c Js]
Kobiroga150: checks 
Dachish: checks 
*** TURN *** [8h 7c Js] [5h]
Kobiroga150: bets $4
Dachish: calls $4
*** RIVER *** [8h 7c Js 5h] [7h]
Kobiroga150: bets $6
Dachish: folds 
Uncalled bet ($6) returned to Kobiroga150
Kobiroga150 collected $11.94 from pot
Kobiroga150: doesn't show hand 
*** SUMMARY ***
Total pot $12.50 | Rake $0.56 
Board [8h 7c Js 5h 7h]
Seat 1: ep538 (button) folded before Flop (didn't bet)
Seat 2: cobrik23 (small blind) folded before Flop
Seat 4: Kobiroga150 (big blind) collected ($11.94)
Seat 5: matiko09 folded before Flop (didn't bet)
Seat 6: hammerwife folded before Flop (didn't bet)
Seat 7: djammusic folded before Flop (didn't bet)
Seat 8: Dachish folded on the River
Seat 9: grifkaaa folded before Flop (didn't bet)





PokerStars Hand #150706903625:  Hold'em No Limit ($0.50/$1.00 USD) - 2016/03/21 16:46:58 CET [2016/03/21 11:46:58 ET]
Table 'Onnie II' 9-max Seat #4 is the button
Seat 1: aseban11 ($188.79 in chips) 
Seat 2: RICKA16 ($103.62 in chips) 
Seat 3: cn_chayanne ($100 in chips) 
Seat 4: Bothfeld11 ($104.31 in chips) 
Seat 5: roninio1 ($41.08 in chips) 
Seat 7: djammusic ($72.08 in chips) 
Seat 8: solbi86 ($107.76 in chips) 
Seat 9: matiko09 ($113.12 in chips) 
roninio1: posts small blind $0.50
djammusic: posts big blind $1
*** HOLE CARDS ***
Dealt to matiko09 [Qs 9h]
solbi86: folds 
matiko09: folds 
aseban11: folds 
RICKA16: folds 
cn_chayanne: folds 
Bothfeld11: calls $1
roninio1: raises $3 to $4
djammusic: folds 
Bothfeld11: calls $3
*** FLOP *** [Th 9s Ks]
roninio1: bets $37.08 and is all-in
Bothfeld11: folds 
Uncalled bet ($37.08) returned to roninio1
roninio1 collected $8.60 from pot
roninio1: doesn't show hand 
*** SUMMARY ***
Total pot $9 | Rake $0.40 
Board [Th 9s Ks]
Seat 1: aseban11 folded before Flop (didn't bet)
Seat 2: RICKA16 folded before Flop (didn't bet)
Seat 3: cn_chayanne folded before Flop (didn't bet)
Seat 4: Bothfeld11 (button) folded on the Flop
Seat 5: roninio1 (small blind) collected ($8.60)
Seat 7: djammusic (big blind) folded before Flop
Seat 8: solbi86 folded before Flop (didn't bet)
Seat 9: matiko09 folded before Flop (didn't bet)





PokerStars Hand #150706904999:  Hold'em No Limit ($0.50/$1.00 USD) - 2016/03/21 16:47:00 CET [2016/03/21 11:47:00 ET]
Table 'Icarion II' 9-max Seat #2 is the button
Seat 1: forsmthgood ($100 in chips) 
Seat 2: aseban11 ($100 in chips) 
Seat 3: volwebni4ek ($50.94 in chips) 
Seat 4: teukka8 ($51.39 in chips) 
Seat 5: Gillianus ($98.95 in chips) 
Seat 6: solbi86 ($101.83 in chips) 
Seat 8: matiko09 ($100 in chips) 
Seat 9: R1aki ($101.50 in chips) 
volwebni4ek: posts small blind $0.50
teukka8: posts big blind $1
*** HOLE CARDS ***
Dealt to matiko09 [5c Ad]
Gillianus: folds 
solbi86: folds 
matiko09: folds 
R1aki has timed out
R1aki: folds 
forsmthgood: folds 
aseban11: raises $1 to $2
volwebni4ek: folds 
teukka8: calls $1
*** FLOP *** [Jc 4h 8h]
teukka8: checks 
aseban11: checks 
*** TURN *** [Jc 4h 8h] [Th]
teukka8: bets $2
aseban11: calls $2
*** RIVER *** [Jc 4h 8h Th] [Tc]
teukka8: bets $2
aseban11: folds 
Uncalled bet ($2) returned to teukka8
teukka8 collected $8.12 from pot
teukka8: doesn't show hand 
*** SUMMARY ***
Total pot $8.50 | Rake $0.38 
Board [Jc 4h 8h Th Tc]
Seat 1: forsmthgood folded before Flop (didn't bet)
Seat 2: aseban11 (button) folded on the River
Seat 3: volwebni4ek (small blind) folded before Flop
Seat 4: teukka8 (big blind) collected ($8.12)
Seat 5: Gillianus folded before Flop (didn't bet)
Seat 6: solbi86 folded before Flop (didn't bet)
Seat 8: matiko09 folded before Flop (didn't bet)
Seat 9: R1aki folded before Flop (didn't bet)





PokerStars Hand #150706907990:  Hold'em No Limit ($0.50/$1.00 USD) - 2016/03/21 16:47:05 CET [2016/03/21 11:47:05 ET]
Table 'Skadi III' 9-max Seat #3 is the button
Seat 1: R1aki ($100 in chips) 
Seat 2: aseban11 ($100 in chips) 
Seat 3: matiko09 ($101 in chips) 
Seat 4: ilaviiitech ($100 in chips) 
Seat 5: WaldiQ ($101.50 in chips) 
Seat 9: bradsheps ($100 in chips) 
ilaviiitech: posts small blind $0.50
WaldiQ: posts big blind $1
solbi86: sits out 
volwebni4ek: sits out 
*** HOLE CARDS ***
Dealt to matiko09 [Qh 5s]
bradsheps: folds 
R1aki has timed out
R1aki: folds 
aseban11: raises $1.50 to $2.50
matiko09: folds 
ilaviiitech: folds 
WaldiQ: folds 
Uncalled bet ($1.50) returned to aseban11
aseban11 collected $2.50 from pot
aseban11: doesn't show hand 
*** SUMMARY ***
Total pot $2.50 | Rake $0 
Seat 1: R1aki folded before Flop (didn't bet)
Seat 2: aseban11 collected ($2.50)
Seat 3: matiko09 (button) folded before Flop (didn't bet)
Seat 4: ilaviiitech (small blind) folded before Flop
Seat 5: WaldiQ (big blind) folded before Flop
Seat 9: bradsheps folded before Flop (didn't bet)





PokerStars Hand #150706911774:  Hold'em No Limit (€0.25/€0.50 EUR) - 2016/03/21 16:47:10 CET [2016/03/21 11:47:10 ET]
Table 'Auravictrix II' 9-max Seat #3 is the button
Seat 1: aponinho82 (€54.54 in chips) 
Seat 2: ffac (€55.89 in chips) 
Seat 3: matiko09 (€54.85 in chips) 
Seat 4: i am owsome (€50 in chips) 
Seat 5: nombraalne1 (€50 in chips) 
Seat 7: Volbeat7 (€24.71 in chips) 
Seat 9: carlouchi (€31.70 in chips) 
i am owsome: posts small blind €0.25
nombraalne1: posts big blind €0.50
Devsteel: sits out 
Volbeat7: posts big blind €0.50
ardo888: sits out 
*** HOLE CARDS ***
Dealt to matiko09 [2s 2c]
Volbeat7: checks 
carlouchi: folds 
aponinho82: calls €0.50
ffac: folds 
matiko09: calls €0.50
i am owsome: calls €0.25
nombraalne1: raises €3.50 to €4
Volbeat7: folds 
aponinho82: folds 
matiko09: folds 
i am owsome: folds 
Uncalled bet (€3.50) returned to nombraalne1
Volbeat7 leaves the table
nombraalne1 collected €2.50 from pot
nombraalne1: doesn't show hand 
*** SUMMARY ***
Total pot €2.50 | Rake €0 
Seat 1: aponinho82 folded before Flop
Seat 2: ffac folded before Flop (didn't bet)
Seat 3: matiko09 (button) folded before Flop
Seat 4: i am owsome (small blind) folded before Flop
Seat 5: nombraalne1 (big blind) collected (€2.50)
Seat 7: Volbeat7 folded before Flop
Seat 9: carlouchi folded before Flop (didn't bet)





PokerStars Hand #150706922556:  Hold'em No Limit ($0.50/$1.00 USD) - 2016/03/21 16:47:24 CET [2016/03/21 11:47:24 ET]
Table 'Onnie II' 9-max Seat #5 is the button
Seat 1: aseban11 ($188.79 in chips) 
Seat 2: RICKA16 ($103.62 in chips) 
Seat 3: cn_chayanne ($100 in chips) 
Seat 4: Bothfeld11 ($100.31 in chips) 
Seat 5: roninio1 ($45.68 in chips) 
Seat 7: djammusic ($71.08 in chips) 
Seat 8: solbi86 ($107.76 in chips) 
Seat 9: matiko09 ($113.12 in chips) 
djammusic: posts small blind $0.50
solbi86: posts big blind $1
*** HOLE CARDS ***
Dealt to matiko09 [5d 2s]
matiko09: folds 
aseban11: folds 
RICKA16: folds 
cn_chayanne: folds 
Bothfeld11: folds 
roninio1: folds 
djammusic: raises $1.50 to $2.50
solbi86: folds 
Uncalled bet ($1.50) returned to djammusic
djammusic collected $2 from pot
djammusic: doesn't show hand 
*** SUMMARY ***
Total pot $2 | Rake $0 
Seat 1: aseban11 folded before Flop (didn't bet)
Seat 2: RICKA16 folded before Flop (didn't bet)
Seat 3: cn_chayanne folded before Flop (didn't bet)
Seat 4: Bothfeld11 folded before Flop (didn't bet)
Seat 5: roninio1 (button) folded before Flop (didn't bet)
Seat 7: djammusic (small blind) collected ($2)
Seat 8: solbi86 (big blind) folded before Flop
Seat 9: matiko09 folded before Flop (didn't bet)





PokerStars Hand #150706931177:  Hold'em No Limit ($0.50/$1.00 USD) - 2016/03/21 16:47:36 CET [2016/03/21 11:47:36 ET]
Table 'Skadi III' 9-max Seat #4 is the button
Seat 2: aseban11 ($101.50 in chips) 
Seat 3: matiko09 ($101 in chips) 
Seat 4: ilaviiitech ($100 in chips) 
Seat 5: WaldiQ ($100.50 in chips) 
Seat 7: solbi86 ($100 in chips) 
Seat 9: bradsheps ($100 in chips) 
WaldiQ: posts small blind $0.50
solbi86: posts big blind $1
volwebni4ek: sits out 
*** HOLE CARDS ***
Dealt to matiko09 [Ac 6c]
bradsheps: raises $1 to $2
aseban11: folds 
matiko09: folds 
ilaviiitech: folds 
WaldiQ: folds 
solbi86: folds 
Uncalled bet ($1) returned to bradsheps
bradsheps collected $2.50 from pot
*** SUMMARY ***
Total pot $2.50 | Rake $0 
Seat 2: aseban11 folded before Flop (didn't bet)
Seat 3: matiko09 folded before Flop (didn't bet)
Seat 4: ilaviiitech (button) folded before Flop (didn't bet)
Seat 5: WaldiQ (small blind) folded before Flop
Seat 7: solbi86 (big blind) folded before Flop
Seat 9: bradsheps collected ($2.50)





PokerStars Hand #150706940070:  Hold'em No Limit ($0.50/$1.00 USD) - 2016/03/21 16:47:48 CET [2016/03/21 11:47:48 ET]
Table 'Onnie II' 9-max Seat #7 is the button
Seat 1: aseban11 ($188.79 in chips) 
Seat 2: RICKA16 ($103.62 in chips) 
Seat 3: cn_chayanne ($100 in chips) 
Seat 4: Bothfeld11 ($100.31 in chips) 
Seat 5: roninio1 ($45.68 in chips) 
Seat 7: djammusic ($72.08 in chips) 
Seat 8: solbi86 ($106.76 in chips) 
Seat 9: matiko09 ($113.12 in chips) 
solbi86: posts small blind $0.50
matiko09: posts big blind $1
*** HOLE CARDS ***
Dealt to matiko09 [Qs 7d]
aseban11: folds 
RICKA16: folds 
cn_chayanne: folds 
Bothfeld11: folds 
roninio1: calls $1
djammusic: raises $2.50 to $3.50
solbi86: folds 
matiko09: folds 
roninio1: raises $42.18 to $45.68 and is all-in
djammusic: calls $42.18
*** FIRST FLOP *** [2d 3c Ks]
*** FIRST TURN *** [2d 3c Ks] [Jh]
*** FIRST RIVER *** [2d 3c Ks Jh] [9s]
*** SECOND FLOP *** [4c Td 5h]
*** SECOND TURN *** [4c Td 5h] [2s]
*** SECOND RIVER *** [4c Td 5h 2s] [5c]
*** FIRST SHOW DOWN ***
roninio1: shows [Qc Ah] (high card Ace)
djammusic: shows [Ad Qd] (high card Ace)
roninio1 collected $22.52 from pot
djammusic collected $22.51 from pot
*** SECOND SHOW DOWN ***
roninio1: shows [Qc Ah] (a pair of Fives)
djammusic: shows [Ad Qd] (a pair of Fives)
roninio1 collected $22.52 from pot
djammusic collected $22.51 from pot
*** SUMMARY ***
Total pot $92.86 | Rake $2.80 
Hand was run twice
FIRST Board [2d 3c Ks Jh 9s]
SECOND Board [4c Td 5h 2s 5c]
Seat 1: aseban11 folded before Flop (didn't bet)
Seat 2: RICKA16 folded before Flop (didn't bet)
Seat 3: cn_chayanne folded before Flop (didn't bet)
Seat 4: Bothfeld11 folded before Flop (didn't bet)
Seat 5: roninio1 showed [Qc Ah] and won ($22.52) with high card Ace, and won ($22.52) with a pair of Fives
Seat 7: djammusic (button) showed [Ad Qd] and won ($22.51) with high card Ace, and won ($22.51) with a pair of Fives
Seat 8: solbi86 (small blind) folded before Flop
Seat 9: matiko09 (big blind) folded before Flop





PokerStars Hand #150706944754:  Hold'em No Limit (€0.25/€0.50 EUR) - 2016/03/21 16:47:55 CET [2016/03/21 11:47:55 ET]
Table 'Ndola' 9-max Seat #5 is the button
Seat 1: Muinmyheart (€54.79 in chips) 
Seat 2: janarr5 (€51.85 in chips) 
Seat 3: nubpoker (€50 in chips) 
Seat 4: Gigi201133 (€49.10 in chips) 
Seat 5: matiko09 (€50 in chips) 
Seat 6: OraculBy (€53.38 in chips) 
Seat 7: nombraalne1 (€50 in chips) 
Seat 8: Devsteel (€104.43 in chips) 
Seat 9: vasiy379 (€81.60 in chips) 
OraculBy: posts small blind €0.25
nombraalne1: posts big blind €0.50
*** HOLE CARDS ***
Dealt to matiko09 [6s 8s]
Devsteel: folds 
vasiy379: folds 
Muinmyheart: folds 
janarr5: folds 
nubpoker: folds 
Gigi201133: folds 
matiko09: raises €0.75 to €1.25
OraculBy: folds 
nombraalne1: folds 
Uncalled bet (€0.75) returned to matiko09
matiko09 collected €1.25 from pot
matiko09: doesn't show hand 
*** SUMMARY ***
Total pot €1.25 | Rake €0 
Seat 1: Muinmyheart folded before Flop (didn't bet)
Seat 2: janarr5 folded before Flop (didn't bet)
Seat 3: nubpoker folded before Flop (didn't bet)
Seat 4: Gigi201133 folded before Flop (didn't bet)
Seat 5: matiko09 (button) collected (€1.25)
Seat 6: OraculBy (small blind) folded before Flop
Seat 7: nombraalne1 (big blind) folded before Flop
Seat 8: Devsteel folded before Flop (didn't bet)
Seat 9: vasiy379 folded before Flop (didn't bet)





PokerStars Hand #150706952684:  Hold'em No Limit ($0.50/$1.00 USD) - 2016/03/21 16:48:05 CET [2016/03/21 11:48:05 ET]
Table 'Skadi III' 9-max Seat #5 is the button
Seat 2: aseban11 ($101.50 in chips) 
Seat 3: matiko09 ($101 in chips) 
Seat 4: ilaviiitech ($100 in chips) 
Seat 5: WaldiQ ($100 in chips) 
Seat 7: solbi86 ($100 in chips) 
Seat 8: volwebni4ek ($78.70 in chips) 
Seat 9: bradsheps ($101.50 in chips) 
solbi86: posts small blind $0.50
volwebni4ek: posts big blind $1
*** HOLE CARDS ***
Dealt to matiko09 [Ts 8s]
bradsheps: raises $1 to $2
aseban11: folds 
matiko09: folds 
ilaviiitech: raises $7 to $9
WaldiQ: folds 
solbi86: folds 
volwebni4ek: folds 
bradsheps: calls $7
*** FLOP *** [Ac 2s 9d]
bradsheps: checks 
ilaviiitech: bets $10.50
bradsheps: calls $10.50
*** TURN *** [Ac 2s 9d] [Kd]
bradsheps: checks 
ilaviiitech: checks 
*** RIVER *** [Ac 2s 9d Kd] [9h]
bradsheps: checks 
ilaviiitech: checks 
*** SHOW DOWN ***
bradsheps: shows [Th Ah] (two pair, Aces and Nines)
ilaviiitech: mucks hand 
bradsheps collected $38.68 from pot
*** SUMMARY ***
Total pot $40.50 | Rake $1.82 
Board [Ac 2s 9d Kd 9h]
Seat 2: aseban11 folded before Flop (didn't bet)
Seat 3: matiko09 folded before Flop (didn't bet)
Seat 4: ilaviiitech mucked [Jc Js]
Seat 5: WaldiQ (button) folded before Flop (didn't bet)
Seat 7: solbi86 (small blind) folded before Flop
Seat 8: volwebni4ek (big blind) folded before Flop
Seat 9: bradsheps showed [Th Ah] and won ($38.68) with two pair, Aces and Nines





PokerStars Hand #150706953119:  Hold'em No Limit ($0.50/$1.00 USD) - 2016/03/21 16:48:06 CET [2016/03/21 11:48:06 ET]
Table 'Noel' 9-max Seat #2 is the button
Seat 1: ep538 ($34.85 in chips) 
Seat 2: cobrik23 ($177.90 in chips) 
Seat 4: Kobiroga150 ($76.81 in chips) 
Seat 5: matiko09 ($113.57 in chips) 
Seat 6: hammerwife ($103.73 in chips) 
Seat 7: djammusic ($68.79 in chips) 
Seat 8: Dachish ($64 in chips) 
Seat 9: grifkaaa ($102.34 in chips) 
Kobiroga150: posts small blind $0.50
matiko09: posts big blind $1
*** HOLE CARDS ***
Dealt to matiko09 [7s 5s]
hammerwife: folds 
djammusic: folds 
Dachish: folds 
grifkaaa: folds 
ep538: folds 
cobrik23 has timed out
cobrik23: folds 
Kobiroga150: folds 
Uncalled bet ($0.50) returned to matiko09
matiko09 collected $1 from pot
matiko09: doesn't show hand 
*** SUMMARY ***
Total pot $1 | Rake $0 
Seat 1: ep538 folded before Flop (didn't bet)
Seat 2: cobrik23 (button) folded before Flop (didn't bet)
Seat 4: Kobiroga150 (small blind) folded before Flop
Seat 5: matiko09 (big blind) collected ($1)
Seat 6: hammerwife folded before Flop (didn't bet)
Seat 7: djammusic folded before Flop (didn't bet)
Seat 8: Dachish folded before Flop (didn't bet)
Seat 9: grifkaaa folded before Flop (didn't bet)





PokerStars Hand #150706955948:  Hold'em No Limit (€0.25/€0.50 EUR) - 2016/03/21 16:48:10 CET [2016/03/21 11:48:10 ET]
Table 'Auravictrix II' 9-max Seat #4 is the button
Seat 1: aponinho82 (€54.04 in chips) 
Seat 2: ffac (€55.89 in chips) 
Seat 3: matiko09 (€54.35 in chips) 
Seat 4: i am owsome (€50 in chips) 
Seat 5: nombraalne1 (€52 in chips) 
Seat 6: Devsteel (€50 in chips) 
Seat 9: carlouchi (€31.70 in chips) 
nombraalne1: posts small blind €0.25
Devsteel: posts big blind €0.50
ardo888: sits out 
*** HOLE CARDS ***
Dealt to matiko09 [9h 4c]
vasiy379 joins the table at seat #7 
carlouchi: raises €1.25 to €1.75
aponinho82: calls €1.75
ffac: folds 
matiko09: folds 
i am owsome: calls €1.75
nombraalne1: folds 
Devsteel: folds 
*** FLOP *** [8h 2c 4h]
carlouchi: checks 
aponinho82: checks 
i am owsome: checks 
*** TURN *** [8h 2c 4h] [Jd]
carlouchi: bets €2.86
aponinho82: calls €2.86
i am owsome: folds 
*** RIVER *** [8h 2c 4h Jd] [4s]
carlouchi: bets €3
aponinho82: calls €3
*** SHOW DOWN ***
carlouchi: shows [Ad Jh] (two pair, Jacks and Fours)
aponinho82: mucks hand 
carlouchi collected €16.92 from pot
*** SUMMARY ***
Total pot €17.72 | Rake €0.80 
Board [8h 2c 4h Jd 4s]
Seat 1: aponinho82 mucked [9c Jc]
Seat 2: ffac folded before Flop (didn't bet)
Seat 3: matiko09 folded before Flop (didn't bet)
Seat 4: i am owsome (button) folded on the Turn
Seat 5: nombraalne1 (small blind) folded before Flop
Seat 6: Devsteel (big blind) folded before Flop
Seat 9: carlouchi showed [Ad Jh] and won (€16.92) with two pair, Jacks and Fours





PokerStars Hand #150706964141:  Hold'em No Limit (€0.25/€0.50 EUR) - 2016/03/21 16:48:21 CET [2016/03/21 11:48:21 ET]
Table 'Ndola' 9-max Seat #6 is the button
Seat 1: Muinmyheart (€54.79 in chips) 
Seat 2: janarr5 (€51.85 in chips) 
Seat 3: nubpoker (€50 in chips) 
Seat 4: Gigi201133 (€49.10 in chips) 
Seat 5: matiko09 (€50.75 in chips) 
Seat 6: OraculBy (€53.13 in chips) 
Seat 7: nombraalne1 (€50 in chips) 
Seat 8: Devsteel (€104.43 in chips) 
Seat 9: vasiy379 (€81.60 in chips) 
nombraalne1: posts small blind €0.25
Devsteel: posts big blind €0.50
*** HOLE CARDS ***
Dealt to matiko09 [Qc Jc]
vasiy379: folds 
Muinmyheart: raises €1 to €1.50
janarr5: folds 
nubpoker: folds 
Gigi201133: folds 
matiko09: calls €1.50
OraculBy: folds 
nombraalne1: calls €1.25
Devsteel: folds 
*** FLOP *** [5c 8h 2d]
nombraalne1: checks 
Muinmyheart: bets €3.25
matiko09: folds 
nombraalne1: calls €3.25
*** TURN *** [5c 8h 2d] [4d]
nombraalne1: checks 
Muinmyheart: checks 
*** RIVER *** [5c 8h 2d 4d] [8d]
nombraalne1: bets €7.24
Muinmyheart: calls €7.24
*** SHOW DOWN ***
nombraalne1: shows [5h 5s] (a full house, Fives full of Eights)
Muinmyheart: mucks hand 
nombraalne1 collected €24.81 from pot
*** SUMMARY ***
Total pot €25.98 | Rake €1.17 
Board [5c 8h 2d 4d 8d]
Seat 1: Muinmyheart mucked [Ks Kc]
Seat 2: janarr5 folded before Flop (didn't bet)
Seat 3: nubpoker folded before Flop (didn't bet)
Seat 4: Gigi201133 folded before Flop (didn't bet)
Seat 5: matiko09 folded on the Flop
Seat 6: OraculBy (button) folded before Flop (didn't bet)
Seat 7: nombraalne1 (small blind) showed [5h 5s] and won (€24.81) with a full house, Fives full of Eights
Seat 8: Devsteel (big blind) folded before Flop
Seat 9: vasiy379 folded before Flop (didn't bet)





PokerStars Hand #150706966774:  Hold'em No Limit ($0.50/$1.00 USD) - 2016/03/21 16:48:24 CET [2016/03/21 11:48:24 ET]
Table 'Icarion II' 9-max Seat #3 is the button
Seat 1: forsmthgood ($100 in chips) 
Seat 2: aseban11 ($100 in chips) 
Seat 3: volwebni4ek ($50.44 in chips) 
Seat 4: teukka8 ($55.51 in chips) 
Seat 5: Gillianus ($98.95 in chips) 
Seat 6: solbi86 ($101.83 in chips) 
Seat 8: matiko09 ($100 in chips) 
Seat 9: R1aki ($101.50 in chips) 
teukka8: posts small blind $0.50
Gillianus: posts big blind $1
*** HOLE CARDS ***
Dealt to matiko09 [3h 8c]
solbi86: folds 
matiko09: folds 
R1aki: raises $1.50 to $2.50
forsmthgood: folds 
aseban11: folds 
volwebni4ek: folds 
teukka8: calls $2
Gillianus: calls $1.50
*** FLOP *** [4d 5h Kc]
teukka8: checks 
Gillianus: bets $3.55
R1aki: calls $3.55
teukka8: folds 
*** TURN *** [4d 5h Kc] [4h]
Gillianus: bets $7
R1aki: calls $7
*** RIVER *** [4d 5h Kc 4h] [Td]
Gillianus: checks 
R1aki: bets $8.50
Gillianus: calls $8.50
*** SHOW DOWN ***
R1aki: shows [Ks Kd] (a full house, Kings full of Fours)
Gillianus: mucks hand 
R1aki collected $43.55 from pot
*** SUMMARY ***
Total pot $45.60 | Rake $2.05 
Board [4d 5h Kc 4h Td]
Seat 1: forsmthgood folded before Flop (didn't bet)
Seat 2: aseban11 folded before Flop (didn't bet)
Seat 3: volwebni4ek (button) folded before Flop (didn't bet)
Seat 4: teukka8 (small blind) folded on the Flop
Seat 5: Gillianus (big blind) mucked [Ts Ac]
Seat 6: solbi86 folded before Flop (didn't bet)
Seat 8: matiko09 folded before Flop (didn't bet)
Seat 9: R1aki showed [Ks Kd] and won ($43.55) with a full house, Kings full of Fours





PokerStars Hand #150706968273:  Hold'em No Limit ($0.50/$1.00 USD) - 2016/03/21 16:48:26 CET [2016/03/21 11:48:26 ET]
Table 'Massalia II' 9-max Seat #1 is the button
Seat 1: crepke ($79.02 in chips) 
Seat 2: solbi86 ($102.96 in chips) 
Seat 4: OriginalTony ($94.34 in chips) 
Seat 5: roninio1 ($134.82 in chips) 
Seat 6: Pacifistas ($138.87 in chips) 
Seat 7: flk.Dasas ($102 in chips) 
Seat 8: matiko09 ($178.41 in chips) 
Seat 9: hammerwife ($100 in chips) 
solbi86: posts small blind $0.50
OriginalTony: posts big blind $1
crepke: posts the ante $0.20
solbi86: posts the ante $0.20
OriginalTony: posts the ante $0.20
roninio1: posts the ante $0.20
Pacifistas: posts the ante $0.20
flk.Dasas: posts the ante $0.20
matiko09: posts the ante $0.20
hammerwife: posts the ante $0.20
*** HOLE CARDS ***
Dealt to matiko09 [5s Qh]
roninio1: folds 
Pacifistas: folds 
flk.Dasas: folds 
matiko09: folds 
hammerwife: folds 
crepke: folds 
solbi86: raises $1.50 to $2.50
OriginalTony: calls $1.50
*** FLOP *** [9c 8h 4c]
solbi86: bets $4.09
OriginalTony: calls $4.09
*** TURN *** [9c 8h 4c] [Qd]
solbi86: bets $10
OriginalTony: calls $10
*** RIVER *** [9c 8h 4c Qd] [3s]
solbi86: checks 
OriginalTony: checks 
*** SHOW DOWN ***
solbi86: shows [Td Qc] (a pair of Queens)
OriginalTony: mucks hand 
solbi86 collected $33.21 from pot
*** SUMMARY ***
Total pot $34.78 | Rake $1.57 
Board [9c 8h 4c Qd 3s]
Seat 1: crepke (button) folded before Flop (didn't bet)
Seat 2: solbi86 (small blind) showed [Td Qc] and won ($33.21) with a pair of Queens
Seat 4: OriginalTony (big blind) mucked [8c 2c]
Seat 5: roninio1 folded before Flop (didn't bet)
Seat 6: Pacifistas folded before Flop (didn't bet)
Seat 7: flk.Dasas folded before Flop (didn't bet)
Seat 8: matiko09 folded before Flop (didn't bet)
Seat 9: hammerwife folded before Flop (didn't bet)





PokerStars Hand #150706977413:  Hold'em No Limit ($0.50/$1.00 USD) - 2016/03/21 16:48:39 CET [2016/03/21 11:48:39 ET]
Table 'Onnie II' 9-max Seat #8 is the button
Seat 1: aseban11 ($188.79 in chips) 
Seat 2: RICKA16 ($103.62 in chips) 
Seat 3: cn_chayanne ($100 in chips) 
Seat 4: Bothfeld11 ($100.31 in chips) 
Seat 5: roninio1 ($45.04 in chips) 
Seat 7: djammusic ($71.42 in chips) 
Seat 8: solbi86 ($106.26 in chips) 
Seat 9: matiko09 ($112.12 in chips) 
matiko09: posts small blind $0.50
aseban11: posts big blind $1
*** HOLE CARDS ***
Dealt to matiko09 [Qc 8h]
RICKA16: folds 
cn_chayanne: folds 
Bothfeld11: folds 
roninio1: folds 
djammusic: folds 
solbi86: raises $1.50 to $2.50
matiko09: folds 
aseban11: folds 
Uncalled bet ($1.50) returned to solbi86
solbi86 collected $2.50 from pot
solbi86: doesn't show hand 
*** SUMMARY ***
Total pot $2.50 | Rake $0 
Seat 1: aseban11 (big blind) folded before Flop
Seat 2: RICKA16 folded before Flop (didn't bet)
Seat 3: cn_chayanne folded before Flop (didn't bet)
Seat 4: Bothfeld11 folded before Flop (didn't bet)
Seat 5: roninio1 folded before Flop (didn't bet)
Seat 7: djammusic folded before Flop (didn't bet)
Seat 8: solbi86 (button) collected ($2.50)
Seat 9: matiko09 (small blind) folded before Flop





PokerStars Hand #150706992766:  Hold'em No Limit ($0.50/$1.00 USD) - 2016/03/21 16:48:59 CET [2016/03/21 11:48:59 ET]
Table 'Noel' 9-max Seat #4 is the button
Seat 1: ep538 ($34.85 in chips) 
Seat 4: Kobiroga150 ($76.31 in chips) 
Seat 5: matiko09 ($114.07 in chips) 
Seat 6: hammerwife ($103.73 in chips) 
Seat 7: djammusic ($68.79 in chips) 
Seat 8: Dachish ($64 in chips) 
Seat 9: grifkaaa ($102.34 in chips) 
matiko09: posts small blind $0.50
hammerwife: posts big blind $1
*** HOLE CARDS ***
Dealt to matiko09 [2h 6d]
djammusic: folds 
Dachish: folds 
grifkaaa: folds 
ep538: folds 
Kobiroga150: folds 
matiko09: folds 
Uncalled bet ($0.50) returned to hammerwife
hammerwife collected $1 from pot
hammerwife: doesn't show hand 
*** SUMMARY ***
Total pot $1 | Rake $0 
Seat 1: ep538 folded before Flop (didn't bet)
Seat 4: Kobiroga150 (button) folded before Flop (didn't bet)
Seat 5: matiko09 (small blind) folded before Flop
Seat 6: hammerwife (big blind) collected ($1)
Seat 7: djammusic folded before Flop (didn't bet)
Seat 8: Dachish folded before Flop (didn't bet)
Seat 9: grifkaaa folded before Flop (didn't bet)





PokerStars Hand #150706993468:  Hold'em No Limit ($0.50/$1.00 USD) - 2016/03/21 16:49:00 CET [2016/03/21 11:49:00 ET]
Table 'Onnie II' 9-max Seat #9 is the button
Seat 1: aseban11 ($187.79 in chips) 
Seat 2: RICKA16 ($103.62 in chips) 
Seat 3: cn_chayanne ($100 in chips) 
Seat 4: Bothfeld11 ($100.31 in chips) 
Seat 5: roninio1 ($45.04 in chips) 
Seat 7: djammusic ($71.42 in chips) 
Seat 8: solbi86 ($107.76 in chips) 
Seat 9: matiko09 ($111.62 in chips) 
aseban11: posts small blind $0.50
RICKA16: posts big blind $1
*** HOLE CARDS ***
Dealt to matiko09 [As Qs]
cn_chayanne: folds 
Bothfeld11: folds 
roninio1: folds 
djammusic: folds 
solbi86: folds 
matiko09: raises $1.27 to $2.27
aseban11: folds 
RICKA16: folds 
Uncalled bet ($1.27) returned to matiko09
matiko09 collected $2.50 from pot
matiko09: doesn't show hand 
*** SUMMARY ***
Total pot $2.50 | Rake $0 
Seat 1: aseban11 (small blind) folded before Flop
Seat 2: RICKA16 (big blind) folded before Flop
Seat 3: cn_chayanne folded before Flop (didn't bet)
Seat 4: Bothfeld11 folded before Flop (didn't bet)
Seat 5: roninio1 folded before Flop (didn't bet)
Seat 7: djammusic folded before Flop (didn't bet)
Seat 8: solbi86 folded before Flop (didn't bet)
Seat 9: matiko09 (button) collected ($2.50)





PokerStars Hand #150707003190:  Hold'em No Limit ($0.50/$1.00 USD) - 2016/03/21 16:49:13 CET [2016/03/21 11:49:13 ET]
Table 'Skadi III' 9-max Seat #7 is the button
Seat 1: R1aki ($100 in chips) 
Seat 2: aseban11 ($101.50 in chips) 
Seat 3: matiko09 ($101 in chips) 
Seat 4: ilaviiitech ($100 in chips) 
Seat 5: WaldiQ ($100 in chips) 
Seat 7: solbi86 ($100 in chips) 
Seat 8: volwebni4ek ($77.70 in chips) 
Seat 9: bradsheps ($120.68 in chips) 
volwebni4ek: posts small blind $0.50
bradsheps: posts big blind $1
*** HOLE CARDS ***
Dealt to matiko09 [Ah 5s]
R1aki: folds 
aseban11: folds 
matiko09: folds 
ilaviiitech: folds 
WaldiQ: folds 
solbi86: raises $1.50 to $2.50
volwebni4ek: raises $6.50 to $9
bradsheps: folds 
solbi86: calls $6.50
*** FLOP *** [Kd 3h 4h]
volwebni4ek: bets $11
solbi86: calls $11
*** TURN *** [Kd 3h 4h] [Jc]
volwebni4ek: checks 
solbi86: checks 
*** RIVER *** [Kd 3h 4h Jc] [9h]
volwebni4ek: checks 
solbi86: bets $21
volwebni4ek: folds 
Uncalled bet ($21) returned to solbi86
solbi86 collected $39.16 from pot
solbi86: doesn't show hand 
*** SUMMARY ***
Total pot $41 | Rake $1.84 
Board [Kd 3h 4h Jc 9h]
Seat 1: R1aki folded before Flop (didn't bet)
Seat 2: aseban11 folded before Flop (didn't bet)
Seat 3: matiko09 folded before Flop (didn't bet)
Seat 4: ilaviiitech folded before Flop (didn't bet)
Seat 5: WaldiQ folded before Flop (didn't bet)
Seat 7: solbi86 (button) collected ($39.16)
Seat 8: volwebni4ek (small blind) folded on the River
Seat 9: bradsheps (big blind) folded before Flop





PokerStars Hand #150707008012:  Hold'em No Limit ($0.50/$1.00 USD) - 2016/03/21 16:49:20 CET [2016/03/21 11:49:20 ET]
Table 'Massalia II' 9-max Seat #2 is the button
Seat 1: crepke ($78.82 in chips) 
Seat 2: solbi86 ($119.38 in chips) 
Seat 4: OriginalTony ($77.55 in chips) 
Seat 5: roninio1 ($134.62 in chips) 
Seat 7: flk.Dasas ($101.80 in chips) 
Seat 8: matiko09 ($178.21 in chips) 
Seat 9: hammerwife ($100 in chips) 
OriginalTony: posts small blind $0.50
roninio1: posts big blind $1
crepke: posts the ante $0.20
solbi86: posts the ante $0.20
OriginalTony: posts the ante $0.20
roninio1: posts the ante $0.20
flk.Dasas: posts the ante $0.20
matiko09: posts the ante $0.20
hammerwife: posts the ante $0.20
*** HOLE CARDS ***
Dealt to matiko09 [Jh 4h]
flk.Dasas: raises $3 to $4
matiko09: folds 
hammerwife: folds 
crepke: folds 
solbi86: calls $4
OriginalTony: folds 
roninio1: folds 
*** FLOP *** [4d 2d 6c]
flk.Dasas: bets $7.08
solbi86: raises $14.92 to $22
flk.Dasas: folds 
Uncalled bet ($14.92) returned to solbi86
solbi86 collected $23.93 from pot
solbi86: doesn't show hand 
*** SUMMARY ***
Total pot $25.06 | Rake $1.13 
Board [4d 2d 6c]
Seat 1: crepke folded before Flop (didn't bet)
Seat 2: solbi86 (button) collected ($23.93)
Seat 4: OriginalTony (small blind) folded before Flop
Seat 5: roninio1 (big blind) folded before Flop
Seat 7: flk.Dasas folded on the Flop
Seat 8: matiko09 folded before Flop (didn't bet)
Seat 9: hammerwife folded before Flop (didn't bet)





PokerStars Hand #150707008308:  Hold'em No Limit ($0.50/$1.00 USD) - 2016/03/21 16:49:20 CET [2016/03/21 11:49:20 ET]
Table 'Noel' 9-max Seat #5 is the button
Seat 1: ep538 ($34.85 in chips) 
Seat 4: Kobiroga150 ($76.31 in chips) 
Seat 5: matiko09 ($113.57 in chips) 
Seat 6: hammerwife ($104.23 in chips) 
Seat 7: djammusic ($68.79 in chips) 
Seat 8: Dachish ($64 in chips) 
Seat 9: grifkaaa ($102.34 in chips) 
hammerwife: posts small blind $0.50
djammusic: posts big blind $1
*** HOLE CARDS ***
Dealt to matiko09 [9d 6d]
Dachish: folds 
grifkaaa: folds 
ep538: folds 
Kobiroga150: raises $2 to $3
matiko09: folds 
hammerwife: folds 
djammusic: folds 
Uncalled bet ($2) returned to Kobiroga150
Kobiroga150 collected $2.50 from pot
Kobiroga150: doesn't show hand 
*** SUMMARY ***
Total pot $2.50 | Rake $0 
Seat 1: ep538 folded before Flop (didn't bet)
Seat 4: Kobiroga150 collected ($2.50)
Seat 5: matiko09 (button) folded before Flop (didn't bet)
Seat 6: hammerwife (small blind) folded before Flop
Seat 7: djammusic (big blind) folded before Flop
Seat 8: Dachish folded before Flop (didn't bet)
Seat 9: grifkaaa folded before Flop (didn't bet)





PokerStars Hand #150707012358:  Hold'em No Limit ($0.50/$1.00 USD) - 2016/03/21 16:49:26 CET [2016/03/21 11:49:26 ET]
Table 'Onnie II' 9-max Seat #1 is the button
Seat 1: aseban11 ($187.29 in chips) 
Seat 2: RICKA16 ($102.62 in chips) 
Seat 3: cn_chayanne ($100 in chips) 
Seat 4: Bothfeld11 ($100.31 in chips) 
Seat 5: roninio1 ($45.04 in chips) 
Seat 7: djammusic ($71.42 in chips) 
Seat 8: solbi86 ($107.76 in chips) 
Seat 9: matiko09 ($113.12 in chips) 
RICKA16: posts small blind $0.50
cn_chayanne: posts big blind $1
*** HOLE CARDS ***
Dealt to matiko09 [6s 9c]
Bothfeld11: calls $1
roninio1: raises $2 to $3
djammusic: folds 
solbi86: folds 
matiko09: folds 
aseban11: folds 
RICKA16: raises $7 to $10
cn_chayanne: folds 
Bothfeld11: folds 
roninio1: raises $35.04 to $45.04 and is all-in
RICKA16: calls $35.04
*** FLOP *** [3s 5d Th]
*** TURN *** [3s 5d Th] [Qd]
*** RIVER *** [3s 5d Th Qd] [5h]
*** SHOW DOWN ***
RICKA16: shows [Kc Ac] (a pair of Fives)
roninio1: shows [Td Ad] (two pair, Tens and Fives)
roninio1 collected $89.28 from pot
*** SUMMARY ***
Total pot $92.08 | Rake $2.80 
Board [3s 5d Th Qd 5h]
Seat 1: aseban11 (button) folded before Flop (didn't bet)
Seat 2: RICKA16 (small blind) showed [Kc Ac] and lost with a pair of Fives
Seat 3: cn_chayanne (big blind) folded before Flop
Seat 4: Bothfeld11 folded before Flop
Seat 5: roninio1 showed [Td Ad] and won ($89.28) with two pair, Tens and Fives
Seat 7: djammusic folded before Flop (didn't bet)
Seat 8: solbi86 folded before Flop (didn't bet)
Seat 9: matiko09 folded before Flop (didn't bet)





PokerStars Hand #150707017470:  Hold'em No Limit (€0.25/€0.50 EUR) - 2016/03/21 16:49:32 CET [2016/03/21 11:49:32 ET]
Table 'Auravictrix II' 9-max Seat #5 is the button
Seat 1: aponinho82 (€46.43 in chips) 
Seat 2: ffac (€55.89 in chips) 
Seat 3: matiko09 (€54.35 in chips) 
Seat 4: i am owsome (€50 in chips) 
Seat 5: nombraalne1 (€51.75 in chips) 
Seat 6: Devsteel (€50 in chips) 
Seat 7: vasiy379 (€50 in chips) 
Seat 9: carlouchi (€41.01 in chips) 
Devsteel: posts small blind €0.25
vasiy379: posts big blind €0.50
ardo888: sits out 
*** HOLE CARDS ***
Dealt to matiko09 [9d 2h]
carlouchi: calls €0.50
aponinho82: folds 
ffac: folds 
matiko09: folds 
i am owsome: folds 
nombraalne1: raises €1.50 to €2
Devsteel: folds 
vasiy379: folds 
carlouchi: folds 
Uncalled bet (€1.50) returned to nombraalne1
nombraalne1 collected €1.75 from pot
nombraalne1: doesn't show hand 
*** SUMMARY ***
Total pot €1.75 | Rake €0 
Seat 1: aponinho82 folded before Flop (didn't bet)
Seat 2: ffac folded before Flop (didn't bet)
Seat 3: matiko09 folded before Flop (didn't bet)
Seat 4: i am owsome folded before Flop (didn't bet)
Seat 5: nombraalne1 (button) collected (€1.75)
Seat 6: Devsteel (small blind) folded before Flop
Seat 7: vasiy379 (big blind) folded before Flop
Seat 9: carlouchi folded before Flop





PokerStars Hand #150707033477:  Hold'em No Limit ($0.50/$1.00 USD) - 2016/03/21 16:49:54 CET [2016/03/21 11:49:54 ET]
Table 'Noel' 9-max Seat #6 is the button
Seat 1: ep538 ($34.85 in chips) 
Seat 2: cobrik23 ($177.90 in chips) 
Seat 4: Kobiroga150 ($77.81 in chips) 
Seat 5: matiko09 ($113.57 in chips) 
Seat 6: hammerwife ($103.73 in chips) 
Seat 7: djammusic ($67.79 in chips) 
Seat 8: Dachish ($64 in chips) 
Seat 9: grifkaaa ($102.34 in chips) 
djammusic: posts small blind $0.50
Dachish: posts big blind $1
*** HOLE CARDS ***
Dealt to matiko09 [Qh 2s]
grifkaaa: folds 
ep538: calls $1
cobrik23: folds 
Kobiroga150: folds 
matiko09: folds 
hammerwife: folds 
djammusic: folds 
Dachish: checks 
*** FLOP *** [Ac Ah Ad]
Dachish: checks 
ep538: bets $1
Dachish: calls $1
*** TURN *** [Ac Ah Ad] [4d]
Dachish: checks 
ep538: bets $1
Dachish: calls $1
*** RIVER *** [Ac Ah Ad 4d] [9s]
Dachish: checks 
ep538: bets $31.85 and is all-in
Dachish: folds 
Uncalled bet ($31.85) returned to ep538
ep538 collected $6.21 from pot
*** SUMMARY ***
Total pot $6.50 | Rake $0.29 
Board [Ac Ah Ad 4d 9s]
Seat 1: ep538 collected ($6.21)
Seat 2: cobrik23 folded before Flop (didn't bet)
Seat 4: Kobiroga150 folded before Flop (didn't bet)
Seat 5: matiko09 folded before Flop (didn't bet)
Seat 6: hammerwife (button) folded before Flop (didn't bet)
Seat 7: djammusic (small blind) folded before Flop
Seat 8: Dachish (big blind) folded on the River
Seat 9: grifkaaa folded before Flop (didn't bet)





PokerStars Hand #150707038198:  Hold'em No Limit ($0.50/$1.00 USD) - 2016/03/21 16:50:00 CET [2016/03/21 11:50:00 ET]
Table 'Onnie II' 9-max Seat #2 is the button
Seat 1: aseban11 ($187.29 in chips) 
Seat 2: RICKA16 ($97.58 in chips) 
Seat 3: cn_chayanne ($100 in chips) 
Seat 4: Bothfeld11 ($99.31 in chips) 
Seat 5: roninio1 ($89.28 in chips) 
Seat 7: djammusic ($71.42 in chips) 
Seat 8: solbi86 ($107.76 in chips) 
Seat 9: matiko09 ($113.12 in chips) 
cn_chayanne: posts small blind $0.50
Bothfeld11: posts big blind $1
*** HOLE CARDS ***
Dealt to matiko09 [Qc Tc]
roninio1: calls $1
djammusic: folds 
solbi86: folds 
matiko09: raises $3 to $4
aseban11: folds 
RICKA16: folds 
cn_chayanne: folds 
Bothfeld11: folds 
roninio1: calls $3
*** FLOP *** [6c 8h 5d]
roninio1: checks 
matiko09: bets $5
roninio1: folds 
Uncalled bet ($5) returned to matiko09
matiko09 collected $9.07 from pot
matiko09: doesn't show hand 
*** SUMMARY ***
Total pot $9.50 | Rake $0.43 
Board [6c 8h 5d]
Seat 1: aseban11 folded before Flop (didn't bet)
Seat 2: RICKA16 (button) folded before Flop (didn't bet)
Seat 3: cn_chayanne (small blind) folded before Flop
Seat 4: Bothfeld11 (big blind) folded before Flop
Seat 5: roninio1 folded on the Flop
Seat 7: djammusic folded before Flop (didn't bet)
Seat 8: solbi86 folded before Flop (didn't bet)
Seat 9: matiko09 collected ($9.07)





PokerStars Hand #150707040755:  Hold'em No Limit ($0.50/$1.00 USD) - 2016/03/21 16:50:04 CET [2016/03/21 11:50:04 ET]
Table 'Icarion II' 9-max Seat #4 is the button
Seat 1: forsmthgood ($100 in chips) 
Seat 2: aseban11 ($100 in chips) 
Seat 3: volwebni4ek ($50.44 in chips) 
Seat 4: teukka8 ($53.01 in chips) 
Seat 5: Gillianus ($77.40 in chips) 
Seat 6: solbi86 ($101.83 in chips) 
Seat 8: matiko09 ($100 in chips) 
Seat 9: R1aki ($123.50 in chips) 
Gillianus: posts small blind $0.50
solbi86: posts big blind $1
*** HOLE CARDS ***
Dealt to matiko09 [Td 8d]
matiko09: folds 
R1aki: folds 
forsmthgood: raises $2 to $3
aseban11: folds 
volwebni4ek: folds 
teukka8: calls $3
Gillianus: folds 
solbi86: calls $2
*** FLOP *** [5c Qd 8h]
solbi86: checks 
forsmthgood: checks 
teukka8: bets $5
solbi86: folds 
forsmthgood: folds 
Uncalled bet ($5) returned to teukka8
teukka8 collected $9.07 from pot
teukka8: doesn't show hand 
*** SUMMARY ***
Total pot $9.50 | Rake $0.43 
Board [5c Qd 8h]
Seat 1: forsmthgood folded on the Flop
Seat 2: aseban11 folded before Flop (didn't bet)
Seat 3: volwebni4ek folded before Flop (didn't bet)
Seat 4: teukka8 (button) collected ($9.07)
Seat 5: Gillianus (small blind) folded before Flop
Seat 6: solbi86 (big blind) folded on the Flop
Seat 8: matiko09 folded before Flop (didn't bet)
Seat 9: R1aki folded before Flop (didn't bet)





PokerStars Hand #150707048342:  Hold'em No Limit (€0.25/€0.50 EUR) - 2016/03/21 16:50:14 CET [2016/03/21 11:50:14 ET]
Table 'Auravictrix II' 9-max Seat #6 is the button
Seat 1: aponinho82 (€46.43 in chips) 
Seat 2: ffac (€55.89 in chips) 
Seat 3: matiko09 (€54.35 in chips) 
Seat 4: i am owsome (€50 in chips) 
Seat 5: nombraalne1 (€53 in chips) 
Seat 6: Devsteel (€50 in chips) 
Seat 7: vasiy379 (€50 in chips) 
Seat 8: ardo888 (€50 in chips) 
Seat 9: carlouchi (€40.51 in chips) 
vasiy379: posts small blind €0.25
ardo888: posts big blind €0.50
*** HOLE CARDS ***
Dealt to matiko09 [Qh 7d]
carlouchi: folds 
aponinho82: raises €1 to €1.50
ffac: folds 
matiko09: folds 
i am owsome: folds 
nombraalne1: folds 
Devsteel: folds 
vasiy379: folds 
ardo888: folds 
Uncalled bet (€1) returned to aponinho82
aponinho82 collected €1.25 from pot
aponinho82: doesn't show hand 
*** SUMMARY ***
Total pot €1.25 | Rake €0 
Seat 1: aponinho82 collected (€1.25)
Seat 2: ffac folded before Flop (didn't bet)
Seat 3: matiko09 folded before Flop (didn't bet)
Seat 4: i am owsome folded before Flop (didn't bet)
Seat 5: nombraalne1 folded before Flop (didn't bet)
Seat 6: Devsteel (button) folded before Flop (didn't bet)
Seat 7: vasiy379 (small blind) folded before Flop
Seat 8: ardo888 (big blind) folded before Flop
Seat 9: carlouchi folded before Flop (didn't bet)





PokerStars Hand #150707057318:  Hold'em No Limit ($0.50/$1.00 USD) - 2016/03/21 16:50:27 CET [2016/03/21 11:50:27 ET]
Table 'Lucifer III' 9-max Seat #8 is the button
Seat 2: matiko09 ($100 in chips) 
Seat 3: Vizonto ($96.57 in chips) 
Seat 4: R1aki ($100 in chips) 
Seat 5: cobrik23 ($71.40 in chips) 
Seat 6: solbi86 ($100 in chips) 
Seat 7: roninio1 ($105.31 in chips) 
Seat 8: aseban11 ($136.55 in chips) 
Seat 9: mycka86 ($117 in chips) 
mycka86: posts small blind $0.50
matiko09: posts big blind $1
*** HOLE CARDS ***
Dealt to matiko09 [4d 7c]
Vizonto: calls $1
R1aki: folds 
cobrik23 has timed out
cobrik23: folds 
solbi86: folds 
roninio1: raises $2 to $3
aseban11: folds 
mycka86: folds 
matiko09: folds 
Vizonto: calls $2
*** FLOP *** [9s 3s 8c]
Vizonto: bets $7.16
roninio1: folds 
Uncalled bet ($7.16) returned to Vizonto
Vizonto collected $7.16 from pot
Vizonto: doesn't show hand 
*** SUMMARY ***
Total pot $7.50 | Rake $0.34 
Board [9s 3s 8c]
Seat 2: matiko09 (big blind) folded before Flop
Seat 3: Vizonto collected ($7.16)
Seat 4: R1aki folded before Flop (didn't bet)
Seat 5: cobrik23 folded before Flop (didn't bet)
Seat 6: solbi86 folded before Flop (didn't bet)
Seat 7: roninio1 folded on the Flop
Seat 8: aseban11 (button) folded before Flop (didn't bet)
Seat 9: mycka86 (small blind) folded before Flop





PokerStars Hand #150707062486:  Hold'em No Limit ($0.50/$1.00 USD) - 2016/03/21 16:50:34 CET [2016/03/21 11:50:34 ET]
Table 'Onnie II' 9-max Seat #3 is the button
Seat 1: aseban11 ($187.29 in chips) 
Seat 2: RICKA16 ($100 in chips) 
Seat 3: cn_chayanne ($100 in chips) 
Seat 4: Bothfeld11 ($98.31 in chips) 
Seat 5: roninio1 ($85.28 in chips) 
Seat 7: djammusic ($71.42 in chips) 
Seat 8: solbi86 ($107.76 in chips) 
Seat 9: matiko09 ($118.19 in chips) 
Bothfeld11: posts small blind $0.50
roninio1: posts big blind $1
*** HOLE CARDS ***
Dealt to matiko09 [Kh 7s]
djammusic: folds 
solbi86: folds 
matiko09: folds 
aseban11: folds 
RICKA16: folds 
cn_chayanne: folds 
Bothfeld11: calls $0.50
roninio1: checks 
*** FLOP *** [5h Kd 2h]
Bothfeld11: bets $2
roninio1: calls $2
*** TURN *** [5h Kd 2h] [Ac]
Bothfeld11: bets $3
roninio1: calls $3
*** RIVER *** [5h Kd 2h Ac] [8h]
Bothfeld11: checks 
roninio1: bets $79.28 and is all-in
Bothfeld11: calls $79.28
*** SHOW DOWN ***
roninio1: shows [Jd Qc] (high card Ace)
Bothfeld11: shows [4h 3h] (a flush, Eight high)
Bothfeld11 collected $167.76 from pot
*** SUMMARY ***
Total pot $170.56 | Rake $2.80 
Board [5h Kd 2h Ac 8h]
Seat 1: aseban11 folded before Flop (didn't bet)
Seat 2: RICKA16 folded before Flop (didn't bet)
Seat 3: cn_chayanne (button) folded before Flop (didn't bet)
Seat 4: Bothfeld11 (small blind) showed [4h 3h] and won ($167.76) with a flush, Eight high
Seat 5: roninio1 (big blind) showed [Jd Qc] and lost with high card Ace
Seat 7: djammusic folded before Flop (didn't bet)
Seat 8: solbi86 folded before Flop (didn't bet)
Seat 9: matiko09 folded before Flop (didn't bet)





PokerStars Hand #150707064651:  Hold'em No Limit (€0.25/€0.50 EUR) - 2016/03/21 16:50:37 CET [2016/03/21 11:50:37 ET]
Table 'Ndola' 9-max Seat #7 is the button
Seat 1: Muinmyheart (€50 in chips) 
Seat 2: janarr5 (€51.85 in chips) 
Seat 3: nubpoker (€50 in chips) 
Seat 4: Gigi201133 (€49.10 in chips) 
Seat 5: matiko09 (€50 in chips) 
Seat 6: OraculBy (€53.13 in chips) 
Seat 7: nombraalne1 (€62.82 in chips) 
Seat 8: Devsteel (€103.93 in chips) 
Seat 9: vasiy379 (€81.60 in chips) 
Devsteel: posts small blind €0.25
vasiy379: posts big blind €0.50
*** HOLE CARDS ***
Dealt to matiko09 [7s 8d]
Muinmyheart: folds 
janarr5: folds 
nubpoker: raises €1 to €1.50
Gigi201133: calls €1.50
matiko09: folds 
OraculBy: folds 
nombraalne1: folds 
Devsteel: folds 
vasiy379: folds 
*** FLOP *** [Jh Jc 9c]
nubpoker: bets €2
Gigi201133: folds 
Uncalled bet (€2) returned to nubpoker
nubpoker collected €3.58 from pot
nubpoker: doesn't show hand 
*** SUMMARY ***
Total pot €3.75 | Rake €0.17 
Board [Jh Jc 9c]
Seat 1: Muinmyheart folded before Flop (didn't bet)
Seat 2: janarr5 folded before Flop (didn't bet)
Seat 3: nubpoker collected (€3.58)
Seat 4: Gigi201133 folded on the Flop
Seat 5: matiko09 folded before Flop (didn't bet)
Seat 6: OraculBy folded before Flop (didn't bet)
Seat 7: nombraalne1 (button) folded before Flop (didn't bet)
Seat 8: Devsteel (small blind) folded before Flop
Seat 9: vasiy379 (big blind) folded before Flop





PokerStars Hand #150707066948:  Hold'em No Limit (€0.25/€0.50 EUR) - 2016/03/21 16:50:40 CET [2016/03/21 11:50:40 ET]
Table 'Auravictrix II' 9-max Seat #7 is the button
Seat 1: aponinho82 (€47.18 in chips) 
Seat 2: ffac (€55.89 in chips) 
Seat 3: matiko09 (€54.35 in chips) 
Seat 4: i am owsome (€50 in chips) 
Seat 5: nombraalne1 (€53 in chips) 
Seat 6: Devsteel (€50 in chips) 
Seat 7: vasiy379 (€50 in chips) 
Seat 8: ardo888 (€50 in chips) 
Seat 9: carlouchi (€40.51 in chips) 
ardo888: posts small blind €0.25
carlouchi: posts big blind €0.50
*** HOLE CARDS ***
Dealt to matiko09 [Ad Jc]
aponinho82: folds 
ffac: folds 
matiko09: raises €1 to €1.50
i am owsome: folds 
nombraalne1: calls €1.50
Devsteel: folds 
vasiy379: folds 
ardo888: folds 
carlouchi: calls €1
*** FLOP *** [4d Ks Ah]
carlouchi: checks 
matiko09: bets €2.95
nombraalne1: calls €2.95
carlouchi: calls €2.95
*** TURN *** [4d Ks Ah] [9c]
carlouchi: checks 
matiko09: bets €7
nombraalne1: calls €7
carlouchi: folds 
*** RIVER *** [4d Ks Ah 9c] [3c]
matiko09: checks 
nombraalne1: bets €41.55 and is all-in
matiko09: folds 
Uncalled bet (€41.55) returned to nombraalne1
nombraalne1 collected €26.36 from pot
nombraalne1: doesn't show hand 
*** SUMMARY ***
Total pot €27.60 | Rake €1.24 
Board [4d Ks Ah 9c 3c]
Seat 1: aponinho82 folded before Flop (didn't bet)
Seat 2: ffac folded before Flop (didn't bet)
Seat 3: matiko09 folded on the River
Seat 4: i am owsome folded before Flop (didn't bet)
Seat 5: nombraalne1 collected (€26.36)
Seat 6: Devsteel folded before Flop (didn't bet)
Seat 7: vasiy379 (button) folded before Flop (didn't bet)
Seat 8: ardo888 (small blind) folded before Flop
Seat 9: carlouchi (big blind) folded on the Turn





PokerStars Hand #150707071158:  Hold'em No Limit ($0.50/$1.00 USD) - 2016/03/21 16:50:45 CET [2016/03/21 11:50:45 ET]
Table 'Noel' 9-max Seat #7 is the button
Seat 1: ep538 ($38.06 in chips) 
Seat 2: cobrik23 ($177.90 in chips) 
Seat 4: Kobiroga150 ($77.81 in chips) 
Seat 5: matiko09 ($113.57 in chips) 
Seat 6: hammerwife ($103.73 in chips) 
Seat 7: djammusic ($67.29 in chips) 
Seat 8: Dachish ($70 in chips) 
Seat 9: grifkaaa ($102.34 in chips) 
Dachish: posts small blind $0.50
grifkaaa: posts big blind $1
gabi_igna: sits out 
*** HOLE CARDS ***
Dealt to matiko09 [6d Js]
ep538: calls $1
cobrik23 has timed out
cobrik23: folds 
Kobiroga150: folds 
matiko09: folds 
hammerwife: folds 
djammusic: folds 
Dachish: folds 
grifkaaa: checks 
*** FLOP *** [8h Qs Td]
grifkaaa: checks 
ep538: checks 
*** TURN *** [8h Qs Td] [8c]
grifkaaa: checks 
ep538: bets $1
grifkaaa: folds 
Uncalled bet ($1) returned to ep538
ep538 collected $2.39 from pot
*** SUMMARY ***
Total pot $2.50 | Rake $0.11 
Board [8h Qs Td 8c]
Seat 1: ep538 collected ($2.39)
Seat 2: cobrik23 folded before Flop (didn't bet)
Seat 4: Kobiroga150 folded before Flop (didn't bet)
Seat 5: matiko09 folded before Flop (didn't bet)
Seat 6: hammerwife folded before Flop (didn't bet)
Seat 7: djammusic (button) folded before Flop (didn't bet)
Seat 8: Dachish (small blind) folded before Flop
Seat 9: grifkaaa (big blind) folded on the Turn





PokerStars Hand #150707085720:  Hold'em No Limit (€0.25/€0.50 EUR) - 2016/03/21 16:51:05 CET [2016/03/21 11:51:05 ET]
Table 'Ndola' 9-max Seat #8 is the button
Seat 1: Muinmyheart (€50 in chips) 
Seat 2: janarr5 (€51.85 in chips) 
Seat 3: nubpoker (€52.08 in chips) 
Seat 4: Gigi201133 (€47.60 in chips) 
Seat 5: matiko09 (€50 in chips) 
Seat 6: OraculBy (€53.13 in chips) 
Seat 7: nombraalne1 (€62.82 in chips) 
Seat 8: Devsteel (€103.68 in chips) 
Seat 9: vasiy379 (€81.10 in chips) 
vasiy379: posts small blind €0.25
Muinmyheart: posts big blind €0.50
*** HOLE CARDS ***
Dealt to matiko09 [2d 7h]
janarr5: folds 
nubpoker: folds 
Gigi201133: folds 
matiko09: folds 
OraculBy: raises €1 to €1.50
nombraalne1: folds 
Devsteel: folds 
vasiy379: folds 
Muinmyheart: folds 
Uncalled bet (€1) returned to OraculBy
OraculBy collected €1.25 from pot
OraculBy: doesn't show hand 
*** SUMMARY ***
Total pot €1.25 | Rake €0 
Seat 1: Muinmyheart (big blind) folded before Flop
Seat 2: janarr5 folded before Flop (didn't bet)
Seat 3: nubpoker folded before Flop (didn't bet)
Seat 4: Gigi201133 folded before Flop (didn't bet)
Seat 5: matiko09 folded before Flop (didn't bet)
Seat 6: OraculBy collected (€1.25)
Seat 7: nombraalne1 folded before Flop (didn't bet)
Seat 8: Devsteel (button) folded before Flop (didn't bet)
Seat 9: vasiy379 (small blind) folded before Flop





PokerStars Hand #150707089982:  Hold'em No Limit ($0.50/$1.00 USD) - 2016/03/21 16:51:11 CET [2016/03/21 11:51:11 ET]
Table 'Icarion II' 9-max Seat #5 is the button
Seat 1: forsmthgood ($100 in chips) 
Seat 2: aseban11 ($100 in chips) 
Seat 3: volwebni4ek ($50.44 in chips) 
Seat 4: teukka8 ($59.08 in chips) 
Seat 5: Gillianus ($100 in chips) 
Seat 6: solbi86 ($100 in chips) 
Seat 8: matiko09 ($100 in chips) 
Seat 9: R1aki ($123.50 in chips) 
solbi86: posts small blind $0.50
matiko09: posts big blind $1
*** HOLE CARDS ***
Dealt to matiko09 [7d 5d]
R1aki: folds 
forsmthgood: folds 
aseban11: folds 
volwebni4ek: folds 
teukka8: raises $1 to $2
Gillianus: folds 
solbi86: folds 
matiko09: folds 
Uncalled bet ($1) returned to teukka8
teukka8 collected $2.50 from pot
teukka8: doesn't show hand 
*** SUMMARY ***
Total pot $2.50 | Rake $0 
Seat 1: forsmthgood folded before Flop (didn't bet)
Seat 2: aseban11 folded before Flop (didn't bet)
Seat 3: volwebni4ek folded before Flop (didn't bet)
Seat 4: teukka8 collected ($2.50)
Seat 5: Gillianus (button) folded before Flop (didn't bet)
Seat 6: solbi86 (small blind) folded before Flop
Seat 8: matiko09 (big blind) folded before Flop
Seat 9: R1aki folded before Flop (didn't bet)





PokerStars Hand #150707095586:  Hold'em No Limit ($0.50/$1.00 USD) - 2016/03/21 16:51:18 CET [2016/03/21 11:51:18 ET]
Table 'Massalia II' 9-max Seat #4 is the button
Seat 1: crepke ($78.62 in chips) 
Seat 2: solbi86 ($132.03 in chips) 
Seat 3: 123chambo ($92.70 in chips) 
Seat 4: OriginalTony ($76.85 in chips) 
Seat 5: roninio1 ($133.42 in chips) 
Seat 7: flk.Dasas ($100 in chips) 
Seat 8: matiko09 ($178.01 in chips) 
Seat 9: hammerwife ($100 in chips) 
roninio1: posts small blind $0.50
flk.Dasas: posts big blind $1
123chambo: posts small & big blinds $1.50
crepke: posts the ante $0.20
solbi86: posts the ante $0.20
123chambo: posts the ante $0.20
OriginalTony: posts the ante $0.20
roninio1: posts the ante $0.20
flk.Dasas: posts the ante $0.20
matiko09: posts the ante $0.20
hammerwife: posts the ante $0.20
*** HOLE CARDS ***
Dealt to matiko09 [Qh 2d]
matiko09: folds 
hammerwife: folds 
crepke: folds 
solbi86: folds 
123chambo: checks 
OriginalTony: raises $4 to $5
roninio1: folds 
flk.Dasas: folds 
123chambo: folds 
Uncalled bet ($4) returned to OriginalTony
OriginalTony collected $5.60 from pot
*** SUMMARY ***
Total pot $5.60 | Rake $0 
Seat 1: crepke folded before Flop (didn't bet)
Seat 2: solbi86 folded before Flop (didn't bet)
Seat 3: 123chambo folded before Flop
Seat 4: OriginalTony (button) collected ($5.60)
Seat 5: roninio1 (small blind) folded before Flop
Seat 7: flk.Dasas (big blind) folded before Flop
Seat 8: matiko09 folded before Flop (didn't bet)
Seat 9: hammerwife folded before Flop (didn't bet)





PokerStars Hand #150707096537:  Hold'em No Limit ($0.50/$1.00 USD) - 2016/03/21 16:51:20 CET [2016/03/21 11:51:20 ET]
Table 'Skadi III' 9-max Seat #8 is the button
Seat 1: R1aki ($100 in chips) 
Seat 2: aseban11 ($101.50 in chips) 
Seat 3: matiko09 ($101 in chips) 
Seat 4: ilaviiitech ($100 in chips) 
Seat 5: WaldiQ ($100 in chips) 
Seat 7: solbi86 ($119.16 in chips) 
Seat 8: volwebni4ek ($57.70 in chips) 
Seat 9: bradsheps ($119.68 in chips) 
bradsheps: posts small blind $0.50
R1aki: posts big blind $1
*** HOLE CARDS ***
Dealt to matiko09 [Th Kd]
aseban11: folds 
matiko09: folds 
ilaviiitech: folds 
WaldiQ: folds 
solbi86: folds 
volwebni4ek: folds 
bradsheps: raises $2 to $3
R1aki: folds 
Uncalled bet ($2) returned to bradsheps
bradsheps collected $2 from pot
*** SUMMARY ***
Total pot $2 | Rake $0 
Seat 1: R1aki (big blind) folded before Flop
Seat 2: aseban11 folded before Flop (didn't bet)
Seat 3: matiko09 folded before Flop (didn't bet)
Seat 4: ilaviiitech folded before Flop (didn't bet)
Seat 5: WaldiQ folded before Flop (didn't bet)
Seat 7: solbi86 folded before Flop (didn't bet)
Seat 8: volwebni4ek (button) folded before Flop (didn't bet)
Seat 9: bradsheps (small blind) collected ($2)





PokerStars Hand #150707098184:  Hold'em No Limit ($0.50/$1.00 USD) - 2016/03/21 16:51:22 CET [2016/03/21 11:51:22 ET]
Table 'Lucifer III' 9-max Seat #9 is the button
Seat 2: matiko09 ($100 in chips) 
Seat 3: Vizonto ($100.73 in chips) 
Seat 4: R1aki ($100 in chips) 
Seat 6: solbi86 ($100 in chips) 
Seat 7: roninio1 ($102.31 in chips) 
Seat 8: aseban11 ($136.55 in chips) 
Seat 9: mycka86 ($116.50 in chips) 
matiko09: posts small blind $0.50
Vizonto: posts big blind $1
*** HOLE CARDS ***
Dealt to matiko09 [6h As]
R1aki: folds 
R1aki leaves the table
solbi86: raises $2 to $3
roninio1: folds 
aseban11: folds 
RICKA16 joins the table at seat #4 
mycka86: calls $3
matiko09: folds 
Vizonto: folds 
*** FLOP *** [2s 9d 3s]
solbi86: checks 
mycka86: bets $4.50
solbi86: folds 
Uncalled bet ($4.50) returned to mycka86
mycka86 collected $7.16 from pot
*** SUMMARY ***
Total pot $7.50 | Rake $0.34 
Board [2s 9d 3s]
Seat 2: matiko09 (small blind) folded before Flop
Seat 3: Vizonto (big blind) folded before Flop
Seat 4: R1aki folded before Flop (didn't bet)
Seat 6: solbi86 folded on the Flop
Seat 7: roninio1 folded before Flop (didn't bet)
Seat 8: aseban11 folded before Flop (didn't bet)
Seat 9: mycka86 (button) collected ($7.16)





PokerStars Hand #150707100925:  Hold'em No Limit ($0.50/$1.00 USD) - 2016/03/21 16:51:26 CET [2016/03/21 11:51:26 ET]
Table 'Onnie II' 9-max Seat #4 is the button
Seat 1: aseban11 ($187.29 in chips) 
Seat 2: RICKA16 ($100 in chips) 
Seat 3: cn_chayanne ($100 in chips) 
Seat 4: Bothfeld11 ($180.79 in chips) 
Seat 7: djammusic ($71.42 in chips) 
Seat 8: solbi86 ($107.76 in chips) 
Seat 9: matiko09 ($118.19 in chips) 
djammusic: posts small blind $0.50
solbi86: posts big blind $1
*** HOLE CARDS ***
Dealt to matiko09 [Qh 9c]
roninio1 leaves the table
matiko09: folds 
hammerwife joins the table at seat #5 
aseban11: folds 
RICKA16: folds 
cn_chayanne: raises $1.50 to $2.50
Bothfeld11: folds 
djammusic: folds 
solbi86: folds 
Uncalled bet ($1.50) returned to cn_chayanne
cn_chayanne collected $2.50 from pot
cn_chayanne: doesn't show hand 
*** SUMMARY ***
Total pot $2.50 | Rake $0 
Seat 1: aseban11 folded before Flop (didn't bet)
Seat 2: RICKA16 folded before Flop (didn't bet)
Seat 3: cn_chayanne collected ($2.50)
Seat 4: Bothfeld11 (button) folded before Flop (didn't bet)
Seat 7: djammusic (small blind) folded before Flop
Seat 8: solbi86 (big blind) folded before Flop
Seat 9: matiko09 folded before Flop (didn't bet)





PokerStars Hand #150707110777:  Hold'em No Limit ($0.50/$1.00 USD) - 2016/03/21 16:51:39 CET [2016/03/21 11:51:39 ET]
Table 'Noel' 9-max Seat #8 is the button
Seat 1: ep538 ($39.45 in chips) 
Seat 4: Kobiroga150 ($77.81 in chips) 
Seat 5: matiko09 ($113.57 in chips) 
Seat 6: hammerwife ($103.73 in chips) 
Seat 7: djammusic ($67.29 in chips) 
Seat 8: Dachish ($69.50 in chips) 
Seat 9: grifkaaa ($101.34 in chips) 
grifkaaa: posts small blind $0.50
ep538: posts big blind $1
gabi_igna: sits out 
*** HOLE CARDS ***
Dealt to matiko09 [7h 2d]
Kobiroga150: folds 
matiko09: folds 
hammerwife: folds 
djammusic: folds 
Dachish: raises $1.50 to $2.50
grifkaaa: folds 
ep538: calls $1.50
*** FLOP *** [3c 5c 8d]
ep538: bets $1
Dachish: calls $1
*** TURN *** [3c 5c 8d] [7s]
ep538: bets $1
Dachish: calls $1
*** RIVER *** [3c 5c 8d 7s] [2s]
ep538: bets $34.95 and is all-in
Dachish: folds 
Uncalled bet ($34.95) returned to ep538
ep538 collected $9.07 from pot
*** SUMMARY ***
Total pot $9.50 | Rake $0.43 
Board [3c 5c 8d 7s 2s]
Seat 1: ep538 (big blind) collected ($9.07)
Seat 4: Kobiroga150 folded before Flop (didn't bet)
Seat 5: matiko09 folded before Flop (didn't bet)
Seat 6: hammerwife folded before Flop (didn't bet)
Seat 7: djammusic folded before Flop (didn't bet)
Seat 8: Dachish (button) folded on the River
Seat 9: grifkaaa (small blind) folded before Flop





PokerStars Hand #150707113830:  Hold'em No Limit ($0.50/$1.00 USD) - 2016/03/21 16:51:43 CET [2016/03/21 11:51:43 ET]
Table 'Icarion II' 9-max Seat #6 is the button
Seat 1: forsmthgood ($100 in chips) 
Seat 2: aseban11 ($100 in chips) 
Seat 3: volwebni4ek ($50.44 in chips) 
Seat 4: teukka8 ($60.58 in chips) 
Seat 5: Gillianus ($100 in chips) 
Seat 6: solbi86 ($100 in chips) 
Seat 8: matiko09 ($100 in chips) 
Seat 9: R1aki ($123.50 in chips) 
matiko09: posts small blind $0.50
R1aki: posts big blind $1
*** HOLE CARDS ***
Dealt to matiko09 [9h 5h]
forsmthgood: folds 
aseban11: folds 
volwebni4ek: folds 
teukka8: folds 
Gillianus: raises $1 to $2
solbi86: folds 
matiko09: folds 
R1aki: folds 
Uncalled bet ($1) returned to Gillianus
Gillianus collected $2.50 from pot
*** SUMMARY ***
Total pot $2.50 | Rake $0 
Seat 1: forsmthgood folded before Flop (didn't bet)
Seat 2: aseban11 folded before Flop (didn't bet)
Seat 3: volwebni4ek folded before Flop (didn't bet)
Seat 4: teukka8 folded before Flop (didn't bet)
Seat 5: Gillianus collected ($2.50)
Seat 6: solbi86 (button) folded before Flop (didn't bet)
Seat 8: matiko09 (small blind) folded before Flop
Seat 9: R1aki (big blind) folded before Flop





PokerStars Hand #150707115739:  Hold'em No Limit ($0.50/$1.00 USD) - 2016/03/21 16:51:46 CET [2016/03/21 11:51:46 ET]
Table 'Onnie II' 9-max Seat #7 is the button
Seat 1: aseban11 ($187.29 in chips) 
Seat 2: RICKA16 ($100 in chips) 
Seat 3: cn_chayanne ($101.50 in chips) 
Seat 4: Bothfeld11 ($180.79 in chips) 
Seat 7: djammusic ($70.92 in chips) 
Seat 8: solbi86 ($106.76 in chips) 
Seat 9: matiko09 ($118.19 in chips) 
solbi86: posts small blind $0.50
matiko09: posts big blind $1
*** HOLE CARDS ***
Dealt to matiko09 [5c 2d]
aseban11: folds 
RICKA16: raises $2 to $3
cn_chayanne: calls $3
Bothfeld11: folds 
djammusic: folds 
solbi86: folds 
matiko09: folds 
*** FLOP *** [2s Td 7s]
RICKA16: bets $5
cn_chayanne: calls $5
*** TURN *** [2s Td 7s] [Ac]
RICKA16: bets $14
cn_chayanne: calls $14
*** RIVER *** [2s Td 7s Ac] [Ks]
hammerwife leaves the table
Vikulja1993 joins the table at seat #5 
RICKA16: bets $27
cn_chayanne: calls $27
*** SHOW DOWN ***
RICKA16: shows [3s 3h] (a pair of Threes)
cn_chayanne: shows [Kd As] (two pair, Aces and Kings)
cn_chayanne collected $96.70 from pot
*** SUMMARY ***
Total pot $99.50 | Rake $2.80 
Board [2s Td 7s Ac Ks]
Seat 1: aseban11 folded before Flop (didn't bet)
Seat 2: RICKA16 showed [3s 3h] and lost with a pair of Threes
Seat 3: cn_chayanne showed [Kd As] and won ($96.70) with two pair, Aces and Kings
Seat 4: Bothfeld11 folded before Flop (didn't bet)
Seat 7: djammusic (button) folded before Flop (didn't bet)
Seat 8: solbi86 (small blind) folded before Flop
Seat 9: matiko09 (big blind) folded before Flop





PokerStars Hand #150707119446:  Hold'em No Limit (€0.25/€0.50 EUR) - 2016/03/21 16:51:51 CET [2016/03/21 11:51:51 ET]
Table 'Ndola' 9-max Seat #9 is the button
Seat 1: Muinmyheart (€50 in chips) 
Seat 2: janarr5 (€51.85 in chips) 
Seat 3: nubpoker (€52.08 in chips) 
Seat 4: Gigi201133 (€47.60 in chips) 
Seat 5: matiko09 (€50 in chips) 
Seat 6: OraculBy (€53.88 in chips) 
Seat 7: nombraalne1 (€62.82 in chips) 
Seat 8: Devsteel (€103.68 in chips) 
Seat 9: vasiy379 (€80.85 in chips) 
Muinmyheart: posts small blind €0.25
janarr5: posts big blind €0.50
*** HOLE CARDS ***
Dealt to matiko09 [Ac Kc]
nubpoker: folds 
Gigi201133: raises €1 to €1.50
matiko09: raises €3.50 to €5
OraculBy: folds 
nombraalne1: folds 
Devsteel: folds 
vasiy379: folds 
Muinmyheart: folds 
janarr5: folds 
Gigi201133: calls €3.50
*** FLOP *** [Ad 6d Jc]
Gigi201133: checks 
matiko09: bets €7
Gigi201133: calls €7
*** TURN *** [Ad 6d Jc] [6s]
Gigi201133: checks 
matiko09: bets €16
Gigi201133: calls €16
*** RIVER *** [Ad 6d Jc 6s] [8s]
Gigi201133: checks 
matiko09: bets €22 and is all-in
Gigi201133 is disconnected 
Gigi201133 is connected 
Gigi201133: folds 
Uncalled bet (€22) returned to matiko09
matiko09 collected €54.75 from pot
matiko09: doesn't show hand 
*** SUMMARY ***
Total pot €56.75 | Rake €2 
Board [Ad 6d Jc 6s 8s]
Seat 1: Muinmyheart (small blind) folded before Flop
Seat 2: janarr5 (big blind) folded before Flop
Seat 3: nubpoker folded before Flop (didn't bet)
Seat 4: Gigi201133 folded on the River
Seat 5: matiko09 collected (€54.75)
Seat 6: OraculBy folded before Flop (didn't bet)
Seat 7: nombraalne1 folded before Flop (didn't bet)
Seat 8: Devsteel folded before Flop (didn't bet)
Seat 9: vasiy379 (button) folded before Flop (didn't bet)





PokerStars Hand #150707124430:  Hold'em No Limit ($0.50/$1.00 USD) - 2016/03/21 16:51:57 CET [2016/03/21 11:51:57 ET]
Table 'Massalia II' 9-max Seat #5 is the button
Seat 1: crepke ($78.42 in chips) 
Seat 2: solbi86 ($131.83 in chips) 
Seat 3: 123chambo ($91 in chips) 
Seat 4: OriginalTony ($81.25 in chips) 
Seat 5: roninio1 ($132.72 in chips) 
Seat 7: flk.Dasas ($100 in chips) 
Seat 8: matiko09 ($177.81 in chips) 
Seat 9: hammerwife ($100 in chips) 
flk.Dasas: posts small blind $0.50
matiko09: posts big blind $1
crepke: posts the ante $0.20
solbi86: posts the ante $0.20
123chambo: posts the ante $0.20
OriginalTony: posts the ante $0.20
roninio1: posts the ante $0.20
flk.Dasas: posts the ante $0.20
matiko09: posts the ante $0.20
hammerwife: posts the ante $0.20
*** HOLE CARDS ***
Dealt to matiko09 [Kh 3c]
hammerwife: folds 
crepke: folds 
solbi86: raises $2 to $3
123chambo: raises $5 to $8
OriginalTony: folds 
roninio1: folds 
flk.Dasas: folds 
matiko09: folds 
solbi86: folds 
Uncalled bet ($5) returned to 123chambo
123chambo collected $9.10 from pot
123chambo: doesn't show hand 
*** SUMMARY ***
Total pot $9.10 | Rake $0 
Seat 1: crepke folded before Flop (didn't bet)
Seat 2: solbi86 folded before Flop
Seat 3: 123chambo collected ($9.10)
Seat 4: OriginalTony folded before Flop (didn't bet)
Seat 5: roninio1 (button) folded before Flop (didn't bet)
Seat 7: flk.Dasas (small blind) folded before Flop
Seat 8: matiko09 (big blind) folded before Flop
Seat 9: hammerwife folded before Flop (didn't bet)





PokerStars Hand #150707125825:  Hold'em No Limit ($0.50/$1.00 USD) - 2016/03/21 16:51:59 CET [2016/03/21 11:51:59 ET]
Table 'Lucifer III' 9-max Seat #2 is the button
Seat 2: matiko09 ($100 in chips) 
Seat 3: Vizonto ($99.73 in chips) 
Seat 4: RICKA16 ($100 in chips) 
Seat 6: solbi86 ($100 in chips) 
Seat 7: roninio1 ($102.31 in chips) 
Seat 8: aseban11 ($136.55 in chips) 
Seat 9: mycka86 ($120.66 in chips) 
Vizonto: posts small blind $0.50
RICKA16: posts big blind $1
*** HOLE CARDS ***
Dealt to matiko09 [Qs 9d]
solbi86: folds 
roninio1: folds 
aseban11: raises $2 to $3
mycka86: folds 
matiko09: folds 
Vizonto: folds 
RICKA16: folds 
Uncalled bet ($2) returned to aseban11
aseban11 collected $2.50 from pot
aseban11: doesn't show hand 
*** SUMMARY ***
Total pot $2.50 | Rake $0 
Seat 2: matiko09 (button) folded before Flop (didn't bet)
Seat 3: Vizonto (small blind) folded before Flop
Seat 4: RICKA16 (big blind) folded before Flop
Seat 6: solbi86 folded before Flop (didn't bet)
Seat 7: roninio1 folded before Flop (didn't bet)
Seat 8: aseban11 collected ($2.50)
Seat 9: mycka86 folded before Flop (didn't bet)





PokerStars Hand #150707136402:  Hold'em No Limit ($0.50/$1.00 USD) - 2016/03/21 16:52:14 CET [2016/03/21 11:52:14 ET]
Table 'Skadi III' 9-max Seat #9 is the button
Seat 1: R1aki ($100 in chips) 
Seat 2: aseban11 ($101.50 in chips) 
Seat 3: matiko09 ($101 in chips) 
Seat 4: ilaviiitech ($100 in chips) 
Seat 5: WaldiQ ($100 in chips) 
Seat 7: solbi86 ($119.16 in chips) 
Seat 8: volwebni4ek ($57.70 in chips) 
Seat 9: bradsheps ($120.68 in chips) 
R1aki: posts small blind $0.50
aseban11: posts big blind $1
*** HOLE CARDS ***
Dealt to matiko09 [Jc 6d]
matiko09: folds 
ilaviiitech: folds 
WaldiQ: folds 
solbi86: folds 
volwebni4ek: raises $1.20 to $2.20
bradsheps: calls $2.20
R1aki: folds 
aseban11: calls $1.20
*** FLOP *** [2c 3c 7c]
aseban11: checks 
volwebni4ek: bets $4.44
bradsheps: calls $4.44
aseban11: folds 
*** TURN *** [2c 3c 7c] [9s]
volwebni4ek: bets $11
bradsheps: calls $11
*** RIVER *** [2c 3c 7c 9s] [As]
volwebni4ek: checks 
bradsheps: checks 
*** SHOW DOWN ***
volwebni4ek: shows [Qh Kc] (high card Ace)
bradsheps: shows [Ac 5h] (a pair of Aces)
bradsheps collected $36.27 from pot
*** SUMMARY ***
Total pot $37.98 | Rake $1.71 
Board [2c 3c 7c 9s As]
Seat 1: R1aki (small blind) folded before Flop
Seat 2: aseban11 (big blind) folded on the Flop
Seat 3: matiko09 folded before Flop (didn't bet)
Seat 4: ilaviiitech folded before Flop (didn't bet)
Seat 5: WaldiQ folded before Flop (didn't bet)
Seat 7: solbi86 folded before Flop (didn't bet)
Seat 8: volwebni4ek showed [Qh Kc] and lost with high card Ace
Seat 9: bradsheps (button) showed [Ac 5h] and won ($36.27) with a pair of Aces





PokerStars Hand #150707137483:  Hold'em No Limit ($0.50/$1.00 USD) - 2016/03/21 16:52:15 CET [2016/03/21 11:52:15 ET]
Table 'Icarion II' 9-max Seat #8 is the button
Seat 1: forsmthgood ($100 in chips) 
Seat 2: aseban11 ($100 in chips) 
Seat 3: volwebni4ek ($50.44 in chips) 
Seat 4: teukka8 ($60.58 in chips) 
Seat 5: Gillianus ($101.50 in chips) 
Seat 6: solbi86 ($100 in chips) 
Seat 8: matiko09 ($100 in chips) 
Seat 9: R1aki ($122.50 in chips) 
R1aki: posts small blind $0.50
forsmthgood: posts big blind $1
*** HOLE CARDS ***
Dealt to matiko09 [3d 9d]
aseban11: folds 
volwebni4ek: folds 
teukka8: raises $1 to $2
Gillianus: folds 
solbi86: folds 
matiko09: folds 
R1aki: folds 
forsmthgood: folds 
Uncalled bet ($1) returned to teukka8
teukka8 collected $2.50 from pot
teukka8: doesn't show hand 
*** SUMMARY ***
Total pot $2.50 | Rake $0 
Seat 1: forsmthgood (big blind) folded before Flop
Seat 2: aseban11 folded before Flop (didn't bet)
Seat 3: volwebni4ek folded before Flop (didn't bet)
Seat 4: teukka8 collected ($2.50)
Seat 5: Gillianus folded before Flop (didn't bet)
Seat 6: solbi86 folded before Flop (didn't bet)
Seat 8: matiko09 (button) folded before Flop (didn't bet)
Seat 9: R1aki (small blind) folded before Flop





PokerStars Hand #150707142533:  Hold'em No Limit ($0.50/$1.00 USD) - 2016/03/21 16:52:22 CET [2016/03/21 11:52:22 ET]
Table 'Noel' 9-max Seat #9 is the button
Seat 1: ep538 ($44.02 in chips) 
Seat 2: cobrik23 ($177.90 in chips) 
Seat 4: Kobiroga150 ($77.81 in chips) 
Seat 5: matiko09 ($113.57 in chips) 
Seat 6: hammerwife ($103.73 in chips) 
Seat 7: djammusic ($67.29 in chips) 
Seat 8: Dachish ($65 in chips) 
Seat 9: grifkaaa ($100.84 in chips) 
ep538: posts small blind $0.50
cobrik23: posts big blind $1
gabi_igna: sits out 
*** HOLE CARDS ***
Dealt to matiko09 [Ad Kd]
Kobiroga150: calls $1
matiko09: raises $3 to $4
hammerwife: folds 
djammusic: folds 
Dachish: calls $4
grifkaaa: folds 
ep538: folds 
cobrik23: raises $12 to $16
Kobiroga150: folds 
matiko09: raises $18 to $34
Dachish: folds 
cobrik23 has timed out
cobrik23: folds 
Uncalled bet ($18) returned to matiko09
matiko09 collected $37.50 from pot
matiko09: doesn't show hand 
*** SUMMARY ***
Total pot $37.50 | Rake $0 
Seat 1: ep538 (small blind) folded before Flop
Seat 2: cobrik23 (big blind) folded before Flop
Seat 4: Kobiroga150 folded before Flop
Seat 5: matiko09 collected ($37.50)
Seat 6: hammerwife folded before Flop (didn't bet)
Seat 7: djammusic folded before Flop (didn't bet)
Seat 8: Dachish folded before Flop
Seat 9: grifkaaa (button) folded before Flop (didn't bet)





PokerStars Hand #150707151488:  Hold'em No Limit ($0.50/$1.00 USD) - 2016/03/21 16:52:34 CET [2016/03/21 11:52:34 ET]
Table 'Lucifer III' 9-max Seat #3 is the button
Seat 2: matiko09 ($100 in chips) 
Seat 3: Vizonto ($99.23 in chips) 
Seat 4: RICKA16 ($99 in chips) 
Seat 6: solbi86 ($100 in chips) 
Seat 7: roninio1 ($102.31 in chips) 
Seat 8: aseban11 ($138.05 in chips) 
Seat 9: mycka86 ($120.66 in chips) 
RICKA16: posts small blind $0.50
solbi86: posts big blind $1
*** HOLE CARDS ***
Dealt to matiko09 [4d 7h]
roninio1: raises $2 to $3
aseban11: folds 
mycka86: folds 
matiko09: folds 
Vizonto: calls $3
RICKA16: folds 
solbi86: folds 
*** FLOP *** [2h 7d Js]
roninio1: bets $7.16
Vizonto: folds 
Uncalled bet ($7.16) returned to roninio1
roninio1 collected $7.16 from pot
roninio1: doesn't show hand 
*** SUMMARY ***
Total pot $7.50 | Rake $0.34 
Board [2h 7d Js]
Seat 2: matiko09 folded before Flop (didn't bet)
Seat 3: Vizonto (button) folded on the Flop
Seat 4: RICKA16 (small blind) folded before Flop
Seat 6: solbi86 (big blind) folded before Flop
Seat 7: roninio1 collected ($7.16)
Seat 8: aseban11 folded before Flop (didn't bet)
Seat 9: mycka86 folded before Flop (didn't bet)





PokerStars Hand #150707155861:  Hold'em No Limit ($0.50/$1.00 USD) - 2016/03/21 16:52:40 CET [2016/03/21 11:52:40 ET]
Table 'Massalia II' 9-max Seat #7 is the button
Seat 1: crepke ($78.22 in chips) 
Seat 2: solbi86 ($128.63 in chips) 
Seat 3: 123chambo ($96.90 in chips) 
Seat 4: OriginalTony ($81.05 in chips) 
Seat 5: roninio1 ($132.52 in chips) 
Seat 7: flk.Dasas ($100 in chips) 
Seat 8: matiko09 ($176.61 in chips) 
Seat 9: hammerwife ($100 in chips) 
matiko09: posts small blind $0.50
hammerwife: posts big blind $1
crepke: posts the ante $0.20
solbi86: posts the ante $0.20
123chambo: posts the ante $0.20
OriginalTony: posts the ante $0.20
roninio1: posts the ante $0.20
flk.Dasas: posts the ante $0.20
matiko09: posts the ante $0.20
hammerwife: posts the ante $0.20
*** HOLE CARDS ***
Dealt to matiko09 [4h Js]
crepke: folds 
solbi86: folds 
123chambo: folds 
OriginalTony: raises $2 to $3
roninio1: calls $3
flk.Dasas: folds 
matiko09: folds 
hammerwife: folds 
*** FLOP *** [Th 5h 7d]
OriginalTony: bets $5
roninio1: folds 
Uncalled bet ($5) returned to OriginalTony
OriginalTony collected $8.69 from pot
*** SUMMARY ***
Total pot $9.10 | Rake $0.41 
Board [Th 5h 7d]
Seat 1: crepke folded before Flop (didn't bet)
Seat 2: solbi86 folded before Flop (didn't bet)
Seat 3: 123chambo folded before Flop (didn't bet)
Seat 4: OriginalTony collected ($8.69)
Seat 5: roninio1 folded on the Flop
Seat 7: flk.Dasas (button) folded before Flop (didn't bet)
Seat 8: matiko09 (small blind) folded before Flop
Seat 9: hammerwife (big blind) folded before Flop





PokerStars Hand #150707158883:  Hold'em No Limit ($0.50/$1.00 USD) - 2016/03/21 16:52:43 CET [2016/03/21 11:52:43 ET]
Table 'Marmulla II' 9-max Seat #6 is the button
Seat 1: hammerwife ($101.50 in chips) 
Seat 2: lumen21 ($100 in chips) 
Seat 3: Vikulja1993 ($100 in chips) 
Seat 6: R1aki ($111.93 in chips) 
Seat 8: ilaviiitech ($113.06 in chips) 
Seat 9: matiko09 ($100 in chips) 
ilaviiitech: posts small blind $0.50
matiko09: posts big blind $1
gabi_igna: sits out 
maaaGik88: sits out 
*** HOLE CARDS ***
Dealt to matiko09 [9s 7s]
hammerwife: folds 
lumen21: folds 
Vikulja1993: folds 
R1aki: folds 
ilaviiitech: folds 
Uncalled bet ($0.50) returned to matiko09
matiko09 collected $1 from pot
matiko09: doesn't show hand 
*** SUMMARY ***
Total pot $1 | Rake $0 
Seat 1: hammerwife folded before Flop (didn't bet)
Seat 2: lumen21 folded before Flop (didn't bet)
Seat 3: Vikulja1993 folded before Flop (didn't bet)
Seat 6: R1aki (button) folded before Flop (didn't bet)
Seat 8: ilaviiitech (small blind) folded before Flop
Seat 9: matiko09 (big blind) collected ($1)





PokerStars Hand #150707161072:  Hold'em No Limit ($0.50/$1.00 USD) - 2016/03/21 16:52:46 CET [2016/03/21 11:52:46 ET]
Table 'Icarion II' 9-max Seat #9 is the button
Seat 1: forsmthgood ($100 in chips) 
Seat 2: aseban11 ($100 in chips) 
Seat 3: volwebni4ek ($50.44 in chips) 
Seat 4: teukka8 ($62.08 in chips) 
Seat 5: Gillianus ($101.50 in chips) 
Seat 6: solbi86 ($100 in chips) 
Seat 8: matiko09 ($100 in chips) 
Seat 9: R1aki ($122 in chips) 
forsmthgood: posts small blind $0.50
aseban11: posts big blind $1
*** HOLE CARDS ***
Dealt to matiko09 [8c As]
volwebni4ek: folds 
teukka8: raises $1 to $2
Gillianus: folds 
solbi86: folds 
matiko09: folds 
R1aki: calls $2
forsmthgood: folds 
aseban11: folds 
*** FLOP *** [9h Ts Ah]
teukka8: bets $3
R1aki: calls $3
*** TURN *** [9h Ts Ah] [3s]
teukka8: bets $3
R1aki: calls $3
*** RIVER *** [9h Ts Ah 3s] [6h]
teukka8: bets $5
R1aki: raises $10.50 to $15.50
teukka8: folds 
Uncalled bet ($10.50) returned to R1aki
R1aki collected $26.26 from pot
R1aki: doesn't show hand 
*** SUMMARY ***
Total pot $27.50 | Rake $1.24 
Board [9h Ts Ah 3s 6h]
Seat 1: forsmthgood (small blind) folded before Flop
Seat 2: aseban11 (big blind) folded before Flop
Seat 3: volwebni4ek folded before Flop (didn't bet)
Seat 4: teukka8 folded on the River
Seat 5: Gillianus folded before Flop (didn't bet)
Seat 6: solbi86 folded before Flop (didn't bet)
Seat 8: matiko09 folded before Flop (didn't bet)
Seat 9: R1aki (button) collected ($26.26)





PokerStars Hand #150707164478:  Hold'em No Limit (€0.25/€0.50 EUR) - 2016/03/21 16:52:51 CET [2016/03/21 11:52:51 ET]
Table 'Auravictrix II' 9-max Seat #8 is the button
Seat 1: aponinho82 (€47.18 in chips) 
Seat 2: ffac (€55.89 in chips) 
Seat 3: matiko09 (€50 in chips) 
Seat 4: i am owsome (€50 in chips) 
Seat 5: nombraalne1 (€67.91 in chips) 
Seat 6: Devsteel (€50 in chips) 
Seat 7: vasiy379 (€50 in chips) 
Seat 8: ardo888 (€50 in chips) 
Seat 9: carlouchi (€36.06 in chips) 
carlouchi: posts small blind €0.25
aponinho82: posts big blind €0.50
*** HOLE CARDS ***
Dealt to matiko09 [2h Js]
ffac: folds 
matiko09: folds 
i am owsome: folds 
nombraalne1: folds 
Devsteel: folds 
vasiy379: raises €0.80 to €1.30
ardo888: folds 
carlouchi: calls €1.05
aponinho82: calls €0.80
*** FLOP *** [Jh 8s Kc]
carlouchi: checks 
aponinho82: checks 
vasiy379: bets €2.25
carlouchi: calls €2.25
aponinho82: folds 
*** TURN *** [Jh 8s Kc] [Qc]
carlouchi: checks 
vasiy379: checks 
*** RIVER *** [Jh 8s Kc Qc] [9h]
carlouchi: bets €1.50
vasiy379: calls €1.50
*** SHOW DOWN ***
carlouchi: shows [9d Qd] (two pair, Queens and Nines)
vasiy379: mucks hand 
carlouchi collected €10.89 from pot
*** SUMMARY ***
Total pot €11.40 | Rake €0.51 
Board [Jh 8s Kc Qc 9h]
Seat 1: aponinho82 (big blind) folded on the Flop
Seat 2: ffac folded before Flop (didn't bet)
Seat 3: matiko09 folded before Flop (didn't bet)
Seat 4: i am owsome folded before Flop (didn't bet)
Seat 5: nombraalne1 folded before Flop (didn't bet)
Seat 6: Devsteel folded before Flop (didn't bet)
Seat 7: vasiy379 mucked [Jc 8c]
Seat 8: ardo888 (button) folded before Flop (didn't bet)
Seat 9: carlouchi (small blind) showed [9d Qd] and won (€10.89) with two pair, Queens and Nines





PokerStars Hand #150707175126:  Hold'em No Limit ($0.50/$1.00 USD) - 2016/03/21 16:53:05 CET [2016/03/21 11:53:05 ET]
Table 'Marmulla II' 9-max Seat #8 is the button
Seat 1: hammerwife ($101.50 in chips) 
Seat 2: lumen21 ($100 in chips) 
Seat 3: Vikulja1993 ($100 in chips) 
Seat 6: R1aki ($111.93 in chips) 
Seat 8: ilaviiitech ($112.56 in chips) 
Seat 9: matiko09 ($100.50 in chips) 
matiko09: posts small blind $0.50
hammerwife: posts big blind $1
gabi_igna: sits out 
maaaGik88: sits out 
*** HOLE CARDS ***
Dealt to matiko09 [6d 2d]
lumen21: folds 
Vikulja1993: folds 
R1aki: folds 
ilaviiitech: folds 
matiko09: folds 
Uncalled bet ($0.50) returned to hammerwife
hammerwife collected $1 from pot
hammerwife: doesn't show hand 
*** SUMMARY ***
Total pot $1 | Rake $0 
Seat 1: hammerwife (big blind) collected ($1)
Seat 2: lumen21 folded before Flop (didn't bet)
Seat 3: Vikulja1993 folded before Flop (didn't bet)
Seat 6: R1aki folded before Flop (didn't bet)
Seat 8: ilaviiitech (button) folded before Flop (didn't bet)
Seat 9: matiko09 (small blind) folded before Flop





PokerStars Hand #150707180283:  Hold'em No Limit ($0.50/$1.00 USD) - 2016/03/21 16:53:12 CET [2016/03/21 11:53:12 ET]
Table 'Lucifer III' 9-max Seat #4 is the button
Seat 2: matiko09 ($100 in chips) 
Seat 3: Vizonto ($96.23 in chips) 
Seat 4: RICKA16 ($98.50 in chips) 
Seat 6: solbi86 ($100 in chips) 
Seat 7: roninio1 ($106.47 in chips) 
Seat 8: aseban11 ($138.05 in chips) 
Seat 9: mycka86 ($120.66 in chips) 
cobrik23 will be allowed to play after the button
solbi86: posts small blind $0.50
roninio1: posts big blind $1
*** HOLE CARDS ***
Dealt to matiko09 [9d Kc]
aseban11: folds 
mycka86: folds 
matiko09: folds 
Vizonto: folds 
RICKA16: folds 
solbi86: raises $1.50 to $2.50
roninio1: calls $1.50
*** FLOP *** [Ks 5d Qh]
solbi86: bets $3.10
roninio1: raises $3.10 to $6.20
solbi86: calls $3.10
*** TURN *** [Ks 5d Qh] [6c]
solbi86: checks 
roninio1: bets $20
solbi86: folds 
Uncalled bet ($20) returned to roninio1
roninio1 collected $16.62 from pot
roninio1: doesn't show hand 
*** SUMMARY ***
Total pot $17.40 | Rake $0.78 
Board [Ks 5d Qh 6c]
Seat 2: matiko09 folded before Flop (didn't bet)
Seat 3: Vizonto folded before Flop (didn't bet)
Seat 4: RICKA16 (button) folded before Flop (didn't bet)
Seat 6: solbi86 (small blind) folded on the Turn
Seat 7: roninio1 (big blind) collected ($16.62)
Seat 8: aseban11 folded before Flop (didn't bet)
Seat 9: mycka86 folded before Flop (didn't bet)





PokerStars Hand #150707189551:  Hold'em No Limit ($0.50/$1.00 USD) - 2016/03/21 16:53:25 CET [2016/03/21 11:53:25 ET]
Table 'Massalia II' 9-max Seat #8 is the button
Seat 1: crepke ($78.02 in chips) 
Seat 2: solbi86 ($128.43 in chips) 
Seat 3: 123chambo ($96.70 in chips) 
Seat 4: OriginalTony ($86.54 in chips) 
Seat 5: roninio1 ($129.32 in chips) 
Seat 7: flk.Dasas ($100 in chips) 
Seat 8: matiko09 ($175.91 in chips) 
Seat 9: hammerwife ($100 in chips) 
hammerwife: posts small blind $0.50
crepke: posts big blind $1
crepke: posts the ante $0.20
solbi86: posts the ante $0.20
123chambo: posts the ante $0.20
OriginalTony: posts the ante $0.20
roninio1: posts the ante $0.20
flk.Dasas: posts the ante $0.20
matiko09: posts the ante $0.20
hammerwife: posts the ante $0.20
*** HOLE CARDS ***
Dealt to matiko09 [Ks 9d]
solbi86: folds 
123chambo: folds 
OriginalTony: folds 
roninio1: folds 
flk.Dasas: raises $2 to $3
matiko09: folds 
hammerwife: folds 
crepke: folds 
Uncalled bet ($2) returned to flk.Dasas
flk.Dasas collected $4.10 from pot
flk.Dasas: doesn't show hand 
*** SUMMARY ***
Total pot $4.10 | Rake $0 
Seat 1: crepke (big blind) folded before Flop
Seat 2: solbi86 folded before Flop (didn't bet)
Seat 3: 123chambo folded before Flop (didn't bet)
Seat 4: OriginalTony folded before Flop (didn't bet)
Seat 5: roninio1 folded before Flop (didn't bet)
Seat 7: flk.Dasas collected ($4.10)
Seat 8: matiko09 (button) folded before Flop (didn't bet)
Seat 9: hammerwife (small blind) folded before Flop





PokerStars Hand #150707195904:  Hold'em No Limit ($0.50/$1.00 USD) - 2016/03/21 16:53:33 CET [2016/03/21 11:53:33 ET]
Table 'Marmulla II' 9-max Seat #9 is the button
Seat 1: hammerwife ($102 in chips) 
Seat 2: lumen21 ($100 in chips) 
Seat 3: Vikulja1993 ($100 in chips) 
Seat 6: R1aki ($111.93 in chips) 
Seat 8: ilaviiitech ($112.56 in chips) 
Seat 9: matiko09 ($100 in chips) 
hammerwife: posts small blind $0.50
lumen21: posts big blind $1
gabi_igna: sits out 
maaaGik88: sits out 
*** HOLE CARDS ***
Dealt to matiko09 [9d 6d]
Vikulja1993: raises $2 to $3
R1aki: folds 
ilaviiitech: folds 
matiko09: folds 
hammerwife: folds 
lumen21: folds 
Uncalled bet ($2) returned to Vikulja1993
Vikulja1993 collected $2.50 from pot
Vikulja1993: doesn't show hand 
*** SUMMARY ***
Total pot $2.50 | Rake $0 
Seat 1: hammerwife (small blind) folded before Flop
Seat 2: lumen21 (big blind) folded before Flop
Seat 3: Vikulja1993 collected ($2.50)
Seat 6: R1aki folded before Flop (didn't bet)
Seat 8: ilaviiitech folded before Flop (didn't bet)
Seat 9: matiko09 (button) folded before Flop (didn't bet)





PokerStars Hand #150707198818:  Hold'em No Limit ($0.50/$1.00 USD) - 2016/03/21 16:53:37 CET [2016/03/21 11:53:37 ET]
Table 'Onnie II' 9-max Seat #8 is the button
Seat 1: aseban11 ($187.29 in chips) 
Seat 2: RICKA16 ($51 in chips) 
Seat 3: cn_chayanne ($149.20 in chips) 
Seat 4: Bothfeld11 ($180.79 in chips) 
Seat 7: djammusic ($70.92 in chips) 
Seat 8: solbi86 ($106.26 in chips) 
Seat 9: matiko09 ($117.19 in chips) 
matiko09: posts small blind $0.50
aseban11: posts big blind $1
Vikulja1993: sits out 
*** HOLE CARDS ***
Dealt to matiko09 [Js 5d]
RICKA16: folds 
cn_chayanne: raises $1.50 to $2.50
Bothfeld11: calls $2.50
djammusic: folds 
solbi86: folds 
matiko09: folds 
aseban11: folds 
*** FLOP *** [4h 6c Ts]
cn_chayanne: checks 
Bothfeld11: checks 
*** TURN *** [4h 6c Ts] [2d]
cn_chayanne: checks 
Bothfeld11: checks 
*** RIVER *** [4h 6c Ts 2d] [As]
cn_chayanne: bets $6
Bothfeld11: folds 
Uncalled bet ($6) returned to cn_chayanne
cn_chayanne collected $6.21 from pot
cn_chayanne: doesn't show hand 
*** SUMMARY ***
Total pot $6.50 | Rake $0.29 
Board [4h 6c Ts 2d As]
Seat 1: aseban11 (big blind) folded before Flop
Seat 2: RICKA16 folded before Flop (didn't bet)
Seat 3: cn_chayanne collected ($6.21)
Seat 4: Bothfeld11 folded on the River
Seat 7: djammusic folded before Flop (didn't bet)
Seat 8: solbi86 (button) folded before Flop (didn't bet)
Seat 9: matiko09 (small blind) folded before Flop





PokerStars Hand #150707212881:  Hold'em No Limit ($0.50/$1.00 USD) - 2016/03/21 16:53:56 CET [2016/03/21 11:53:56 ET]
Table 'Skadi III' 9-max Seat #1 is the button
Seat 1: R1aki ($100 in chips) 
Seat 2: aseban11 ($100 in chips) 
Seat 3: matiko09 ($101 in chips) 
Seat 4: ilaviiitech ($100 in chips) 
Seat 5: WaldiQ ($100 in chips) 
Seat 7: solbi86 ($119.16 in chips) 
Seat 8: volwebni4ek ($40.06 in chips) 
Seat 9: bradsheps ($139.31 in chips) 
aseban11: posts small blind $0.50
matiko09: posts big blind $1
*** HOLE CARDS ***
Dealt to matiko09 [4c 8d]
ilaviiitech: folds 
WaldiQ: folds 
solbi86: folds 
volwebni4ek: folds 
bradsheps: folds 
R1aki: folds 
aseban11: folds 
Uncalled bet ($0.50) returned to matiko09
matiko09 collected $1 from pot
matiko09: doesn't show hand 
*** SUMMARY ***
Total pot $1 | Rake $0 
Seat 1: R1aki (button) folded before Flop (didn't bet)
Seat 2: aseban11 (small blind) folded before Flop
Seat 3: matiko09 (big blind) collected ($1)
Seat 4: ilaviiitech folded before Flop (didn't bet)
Seat 5: WaldiQ folded before Flop (didn't bet)
Seat 7: solbi86 folded before Flop (didn't bet)
Seat 8: volwebni4ek folded before Flop (didn't bet)
Seat 9: bradsheps folded before Flop (didn't bet)





PokerStars Hand #150707213506:  Hold'em No Limit ($0.50/$1.00 USD) - 2016/03/21 16:53:57 CET [2016/03/21 11:53:57 ET]
Table 'Lucifer III' 9-max Seat #6 is the button
Seat 2: matiko09 ($100 in chips) 
Seat 3: Vizonto ($96.23 in chips) 
Seat 4: RICKA16 ($98.50 in chips) 
Seat 6: solbi86 ($100 in chips) 
Seat 7: roninio1 ($114.39 in chips) 
Seat 8: aseban11 ($138.05 in chips) 
Seat 9: mycka86 ($120.66 in chips) 
roninio1: posts small blind $0.50
aseban11: posts big blind $1
cobrik23: sits out 
*** HOLE CARDS ***
Dealt to matiko09 [7d 5d]
mycka86: folds 
matiko09: folds 
Vizonto: calls $1
RICKA16: raises $3 to $4
solbi86: calls $4
roninio1: calls $3.50
aseban11: raises $14.50 to $18.50
Vizonto: folds 
RICKA16: folds 
solbi86: raises $18.50 to $37
roninio1: folds 
aseban11: folds 
Uncalled bet ($18.50) returned to solbi86
solbi86 collected $46 from pot
solbi86: doesn't show hand 
*** SUMMARY ***
Total pot $46 | Rake $0 
Seat 2: matiko09 folded before Flop (didn't bet)
Seat 3: Vizonto folded before Flop
Seat 4: RICKA16 folded before Flop
Seat 6: solbi86 (button) collected ($46)
Seat 7: roninio1 (small blind) folded before Flop
Seat 8: aseban11 (big blind) folded before Flop
Seat 9: mycka86 folded before Flop (didn't bet)





PokerStars Hand #150707214356:  Hold'em No Limit ($0.50/$1.00 USD) - 2016/03/21 16:53:58 CET [2016/03/21 11:53:58 ET]
Table 'Noel' 9-max Seat #1 is the button
Seat 1: ep538 ($43.52 in chips) 
Seat 4: Kobiroga150 ($76.81 in chips) 
Seat 5: matiko09 ($135.07 in chips) 
Seat 6: hammerwife ($103.73 in chips) 
Seat 7: djammusic ($67.29 in chips) 
Seat 8: Dachish ($70 in chips) 
Seat 9: grifkaaa ($100.84 in chips) 
gabi_igna will be allowed to play after the button
Kobiroga150: posts small blind $0.50
matiko09: posts big blind $1
*** HOLE CARDS ***
Dealt to matiko09 [Kc 3h]
hammerwife: folds 
djammusic: raises $1.50 to $2.50
Dachish: folds 
grifkaaa: folds 
ep538: folds 
Kobiroga150: folds 
matiko09: folds 
Uncalled bet ($1.50) returned to djammusic
djammusic collected $2.50 from pot
djammusic: doesn't show hand 
*** SUMMARY ***
Total pot $2.50 | Rake $0 
Seat 1: ep538 (button) folded before Flop (didn't bet)
Seat 4: Kobiroga150 (small blind) folded before Flop
Seat 5: matiko09 (big blind) folded before Flop
Seat 6: hammerwife folded before Flop (didn't bet)
Seat 7: djammusic collected ($2.50)
Seat 8: Dachish folded before Flop (didn't bet)
Seat 9: grifkaaa folded before Flop (didn't bet)





PokerStars Hand #150707215177:  Hold'em No Limit ($0.50/$1.00 USD) - 2016/03/21 16:53:59 CET [2016/03/21 11:53:59 ET]
Table 'Massalia II' 9-max Seat #9 is the button
Seat 1: crepke ($76.82 in chips) 
Seat 2: solbi86 ($128.23 in chips) 
Seat 3: 123chambo ($96.50 in chips) 
Seat 4: OriginalTony ($86.34 in chips) 
Seat 5: roninio1 ($129.12 in chips) 
Seat 7: flk.Dasas ($102.90 in chips) 
Seat 8: matiko09 ($175.71 in chips) 
Seat 9: hammerwife ($100 in chips) 
crepke: posts small blind $0.50
solbi86: posts big blind $1
crepke: posts the ante $0.20
solbi86: posts the ante $0.20
123chambo: posts the ante $0.20
OriginalTony: posts the ante $0.20
roninio1: posts the ante $0.20
flk.Dasas: posts the ante $0.20
matiko09: posts the ante $0.20
hammerwife: posts the ante $0.20
*** HOLE CARDS ***
Dealt to matiko09 [Js 3s]
123chambo: calls $1
OriginalTony: folds 
roninio1: raises $5.10 to $6.10
flk.Dasas: folds 
matiko09: folds 
hammerwife: folds 
crepke: folds 
solbi86: folds 
123chambo: folds 
Uncalled bet ($5.10) returned to roninio1
roninio1 collected $5.10 from pot
roninio1: doesn't show hand 
*** SUMMARY ***
Total pot $5.10 | Rake $0 
Seat 1: crepke (small blind) folded before Flop
Seat 2: solbi86 (big blind) folded before Flop
Seat 3: 123chambo folded before Flop
Seat 4: OriginalTony folded before Flop (didn't bet)
Seat 5: roninio1 collected ($5.10)
Seat 7: flk.Dasas folded before Flop (didn't bet)
Seat 8: matiko09 folded before Flop (didn't bet)
Seat 9: hammerwife (button) folded before Flop (didn't bet)





PokerStars Hand #150707215446:  Hold'em No Limit ($0.50/$1.00 USD) - 2016/03/21 16:53:59 CET [2016/03/21 11:53:59 ET]
Table 'Marmulla II' 9-max Seat #1 is the button
Seat 1: hammerwife ($101.50 in chips) 
Seat 2: lumen21 ($100 in chips) 
Seat 3: Vikulja1993 ($101.50 in chips) 
Seat 5: maaaGik88 ($42 in chips) 
Seat 6: R1aki ($111.93 in chips) 
Seat 8: ilaviiitech ($112.56 in chips) 
Seat 9: matiko09 ($100 in chips) 
lumen21: posts small blind $0.50
Vikulja1993: posts big blind $1
gabi_igna: sits out 
maaaGik88: posts small & big blinds $1.50
*** HOLE CARDS ***
Dealt to matiko09 [Td 5h]
maaaGik88: raises $1 to $2
R1aki: raises $4.50 to $6.50
ilaviiitech: folds 
matiko09: folds 
hammerwife: folds 
lumen21: folds 
Vikulja1993: folds 
maaaGik88: calls $4.50
*** FLOP *** [Tc 9d Qd]
maaaGik88: checks 
R1aki: bets $35
maaaGik88: calls $35 and is all-in
*** TURN *** [Tc 9d Qd] [Qc]
*** RIVER *** [Tc 9d Qd Qc] [2c]
*** SHOW DOWN ***
maaaGik88: shows [Kd Jh] (a straight, Nine to King)
R1aki: shows [Ac Qh] (three of a kind, Queens)
maaaGik88 collected $82.20 from pot
*** SUMMARY ***
Total pot $85 | Rake $2.80 
Board [Tc 9d Qd Qc 2c]
Seat 1: hammerwife (button) folded before Flop (didn't bet)
Seat 2: lumen21 (small blind) folded before Flop
Seat 3: Vikulja1993 (big blind) folded before Flop
Seat 5: maaaGik88 showed [Kd Jh] and won ($82.20) with a straight, Nine to King
Seat 6: R1aki showed [Ac Qh] and lost with three of a kind, Queens
Seat 8: ilaviiitech folded before Flop (didn't bet)
Seat 9: matiko09 folded before Flop (didn't bet)





PokerStars Hand #150707217577:  Hold'em No Limit (€0.25/€0.50 EUR) - 2016/03/21 16:54:02 CET [2016/03/21 11:54:02 ET]
Table 'Ndola' 9-max Seat #1 is the button
Seat 1: Muinmyheart (€50 in chips) 
Seat 2: janarr5 (€51.35 in chips) 
Seat 3: nubpoker (€52.08 in chips) 
Seat 4: Gigi201133 (€19.60 in chips) 
Seat 5: matiko09 (€76.75 in chips) 
Seat 6: OraculBy (€53.88 in chips) 
Seat 7: nombraalne1 (€62.82 in chips) 
Seat 8: Devsteel (€103.68 in chips) 
Seat 9: vasiy379 (€80.85 in chips) 
janarr5: posts small blind €0.25
nubpoker: posts big blind €0.50
*** HOLE CARDS ***
Dealt to matiko09 [Ac As]
Gigi201133: raises €1 to €1.50
matiko09: raises €2.50 to €4
OraculBy: folds 
nombraalne1: folds 
Devsteel: folds 
vasiy379: folds 
Muinmyheart: folds 
janarr5: folds 
nubpoker: folds 
Gigi201133: calls €2.50
*** FLOP *** [Tc 7d Kd]
janarr5 leaves the table
Gigi201133: checks 
ffac joins the table at seat #2 
matiko09: bets €5.50
Gigi201133: folds 
Uncalled bet (€5.50) returned to matiko09
matiko09 collected €8.36 from pot
matiko09: doesn't show hand 
*** SUMMARY ***
Total pot €8.75 | Rake €0.39 
Board [Tc 7d Kd]
Seat 1: Muinmyheart (button) folded before Flop (didn't bet)
Seat 2: janarr5 (small blind) folded before Flop
Seat 3: nubpoker (big blind) folded before Flop
Seat 4: Gigi201133 folded on the Flop
Seat 5: matiko09 collected (€8.36)
Seat 6: OraculBy folded before Flop (didn't bet)
Seat 7: nombraalne1 folded before Flop (didn't bet)
Seat 8: Devsteel folded before Flop (didn't bet)
Seat 9: vasiy379 folded before Flop (didn't bet)





PokerStars Hand #150707226362:  Hold'em No Limit ($0.50/$1.00 USD) - 2016/03/21 16:54:14 CET [2016/03/21 11:54:14 ET]
Table 'Icarion II' 9-max Seat #1 is the button
Seat 1: forsmthgood ($100 in chips) 
Seat 2: aseban11 ($100 in chips) 
Seat 3: volwebni4ek ($50.44 in chips) 
Seat 4: teukka8 ($49.08 in chips) 
Seat 5: Gillianus ($101.50 in chips) 
Seat 6: solbi86 ($100 in chips) 
Seat 8: matiko09 ($100 in chips) 
Seat 9: R1aki ($135.26 in chips) 
aseban11: posts small blind $0.50
volwebni4ek: posts big blind $1
Pacifistas: sits out 
*** HOLE CARDS ***
Dealt to matiko09 [Jh 7s]
teukka8: calls $1
Gillianus: folds 
solbi86: folds 
matiko09: folds 
Gillianus leaves the table
R1aki: folds 
forsmthgood: raises $3.50 to $4.50
aseban11: folds 
volwebni4ek: folds 
teukka8: calls $3.50
*** FLOP *** [3c 9d 6s]
SanychStar joins the table at seat #5 
teukka8: checks 
forsmthgood: bets $6.50
teukka8: folds 
Uncalled bet ($6.50) returned to forsmthgood
forsmthgood collected $10.03 from pot
*** SUMMARY ***
Total pot $10.50 | Rake $0.47 
Board [3c 9d 6s]
Seat 1: forsmthgood (button) collected ($10.03)
Seat 2: aseban11 (small blind) folded before Flop
Seat 3: volwebni4ek (big blind) folded before Flop
Seat 4: teukka8 folded on the Flop
Seat 5: Gillianus folded before Flop (didn't bet)
Seat 6: solbi86 folded before Flop (didn't bet)
Seat 8: matiko09 folded before Flop (didn't bet)
Seat 9: R1aki folded before Flop (didn't bet)





PokerStars Hand #150707234024:  Hold'em No Limit ($0.50/$1.00 USD) - 2016/03/21 16:54:24 CET [2016/03/21 11:54:24 ET]
Table 'Skadi III' 9-max Seat #2 is the button
Seat 1: R1aki ($100 in chips) 
Seat 2: aseban11 ($100 in chips) 
Seat 3: matiko09 ($101.50 in chips) 
Seat 4: ilaviiitech ($100 in chips) 
Seat 5: WaldiQ ($100 in chips) 
Seat 7: solbi86 ($119.16 in chips) 
Seat 8: volwebni4ek ($40.06 in chips) 
Seat 9: bradsheps ($139.31 in chips) 
matiko09: posts small blind $0.50
ilaviiitech: posts big blind $1
Pacifistas: sits out 
*** HOLE CARDS ***
Dealt to matiko09 [Qs Kd]
WaldiQ: folds 
solbi86: folds 
volwebni4ek: raises $2 to $3
bradsheps: folds 
R1aki: folds 
aseban11: folds 
matiko09: folds 
ilaviiitech: folds 
Uncalled bet ($2) returned to volwebni4ek
volwebni4ek collected $2.50 from pot
volwebni4ek: doesn't show hand 
*** SUMMARY ***
Total pot $2.50 | Rake $0 
Seat 1: R1aki folded before Flop (didn't bet)
Seat 2: aseban11 (button) folded before Flop (didn't bet)
Seat 3: matiko09 (small blind) folded before Flop
Seat 4: ilaviiitech (big blind) folded before Flop
Seat 5: WaldiQ folded before Flop (didn't bet)
Seat 7: solbi86 folded before Flop (didn't bet)
Seat 8: volwebni4ek collected ($2.50)
Seat 9: bradsheps folded before Flop (didn't bet)





PokerStars Hand #150707234701:  Hold'em No Limit (€0.25/€0.50 EUR) - 2016/03/21 16:54:25 CET [2016/03/21 11:54:25 ET]
Table 'Auravictrix II' 9-max Seat #9 is the button
Seat 1: aponinho82 (€45.88 in chips) 
Seat 2: ffac (€55.89 in chips) 
Seat 3: matiko09 (€50 in chips) 
Seat 4: i am owsome (€50 in chips) 
Seat 5: nombraalne1 (€67.91 in chips) 
Seat 6: Devsteel (€50 in chips) 
Seat 7: vasiy379 (€50 in chips) 
Seat 8: ardo888 (€50 in chips) 
Seat 9: carlouchi (€41.90 in chips) 
aponinho82: posts small blind €0.25
ffac: posts big blind €0.50
*** HOLE CARDS ***
Dealt to matiko09 [4h Js]
matiko09: folds 
i am owsome: folds 
nombraalne1: folds 
Devsteel: folds 
vasiy379: folds 
ardo888: folds 
carlouchi: folds 
aponinho82: calls €0.25
ffac: checks 
*** FLOP *** [6c Qc 4d]
aponinho82: checks 
ffac: bets €1
aponinho82: folds 
Uncalled bet (€1) returned to ffac
ffac collected €0.96 from pot
ffac: doesn't show hand 
*** SUMMARY ***
Total pot €1 | Rake €0.04 
Board [6c Qc 4d]
Seat 1: aponinho82 (small blind) folded on the Flop
Seat 2: ffac (big blind) collected (€0.96)
Seat 3: matiko09 folded before Flop (didn't bet)
Seat 4: i am owsome folded before Flop (didn't bet)
Seat 5: nombraalne1 folded before Flop (didn't bet)
Seat 6: Devsteel folded before Flop (didn't bet)
Seat 7: vasiy379 folded before Flop (didn't bet)
Seat 8: ardo888 folded before Flop (didn't bet)
Seat 9: carlouchi (button) folded before Flop (didn't bet)





PokerStars Hand #150707238442:  Hold'em No Limit ($0.50/$1.00 USD) - 2016/03/21 16:54:30 CET [2016/03/21 11:54:30 ET]
Table 'Noel' 9-max Seat #4 is the button
Seat 1: ep538 ($43.52 in chips) 
Seat 4: Kobiroga150 ($76.31 in chips) 
Seat 5: matiko09 ($134.07 in chips) 
Seat 6: hammerwife ($103.73 in chips) 
Seat 7: djammusic ($68.79 in chips) 
Seat 8: Dachish ($70 in chips) 
Seat 9: grifkaaa ($100.84 in chips) 
matiko09: posts small blind $0.50
hammerwife: posts big blind $1
cobrik23: sits out 
gabi_igna: sits out 
*** HOLE CARDS ***
Dealt to matiko09 [7d Ks]
djammusic: raises $1.25 to $2.25
Dachish: folds 
grifkaaa: folds 
ep538: folds 
Kobiroga150: folds 
matiko09: folds 
hammerwife: calls $1.25
*** FLOP *** [Qc Th 2c]
hammerwife: checks 
djammusic: checks 
*** TURN *** [Qc Th 2c] [Ah]
hammerwife: bets $4
djammusic: calls $4
*** RIVER *** [Qc Th 2c Ah] [5h]
hammerwife: bets $8.50
djammusic: folds 
Uncalled bet ($8.50) returned to hammerwife
hammerwife collected $12.42 from pot
hammerwife: doesn't show hand 
*** SUMMARY ***
Total pot $13 | Rake $0.58 
Board [Qc Th 2c Ah 5h]
Seat 1: ep538 folded before Flop (didn't bet)
Seat 4: Kobiroga150 (button) folded before Flop (didn't bet)
Seat 5: matiko09 (small blind) folded before Flop
Seat 6: hammerwife (big blind) collected ($12.42)
Seat 7: djammusic folded on the River
Seat 8: Dachish folded before Flop (didn't bet)
Seat 9: grifkaaa folded before Flop (didn't bet)





PokerStars Hand #150707245225:  Hold'em No Limit ($0.50/$1.00 USD) - 2016/03/21 16:54:39 CET [2016/03/21 11:54:39 ET]
Table 'Massalia II' 9-max Seat #1 is the button
Seat 1: crepke ($76.12 in chips) 
Seat 2: solbi86 ($127.03 in chips) 
Seat 3: 123chambo ($95.30 in chips) 
Seat 4: OriginalTony ($86.14 in chips) 
Seat 5: roninio1 ($133.02 in chips) 
Seat 7: flk.Dasas ($102.70 in chips) 
Seat 8: matiko09 ($175.51 in chips) 
Seat 9: hammerwife ($100 in chips) 
solbi86: posts small blind $0.50
123chambo: posts big blind $1
Pacifistas: sits out 
crepke: posts the ante $0.20
solbi86: posts the ante $0.20
123chambo: posts the ante $0.20
OriginalTony: posts the ante $0.20
roninio1: posts the ante $0.20
flk.Dasas: posts the ante $0.20
matiko09: posts the ante $0.20
hammerwife: posts the ante $0.20
*** HOLE CARDS ***
Dealt to matiko09 [2d 9c]
OriginalTony: folds 
roninio1: folds 
flk.Dasas: raises $3 to $4
matiko09: folds 
hammerwife: folds 
crepke: folds 
solbi86: folds 
123chambo: folds 
Uncalled bet ($3) returned to flk.Dasas
flk.Dasas collected $4.10 from pot
flk.Dasas: doesn't show hand 
*** SUMMARY ***
Total pot $4.10 | Rake $0 
Seat 1: crepke (button) folded before Flop (didn't bet)
Seat 2: solbi86 (small blind) folded before Flop
Seat 3: 123chambo (big blind) folded before Flop
Seat 4: OriginalTony folded before Flop (didn't bet)
Seat 5: roninio1 folded before Flop (didn't bet)
Seat 7: flk.Dasas collected ($4.10)
Seat 8: matiko09 folded before Flop (didn't bet)
Seat 9: hammerwife folded before Flop (didn't bet)





PokerStars Hand #150707247175:  Hold'em No Limit ($0.50/$1.00 USD) - 2016/03/21 16:54:42 CET [2016/03/21 11:54:42 ET]
Table 'Onnie II' 9-max Seat #9 is the button
Seat 1: aseban11 ($186.29 in chips) 
Seat 2: RICKA16 ($100 in chips) 
Seat 3: cn_chayanne ($152.91 in chips) 
Seat 4: Bothfeld11 ($178.29 in chips) 
Seat 7: djammusic ($70.92 in chips) 
Seat 8: solbi86 ($106.26 in chips) 
Seat 9: matiko09 ($116.69 in chips) 
aseban11: posts small blind $0.50
RICKA16: posts big blind $1
Vikulja1993: sits out 
Pacifistas: sits out 
*** HOLE CARDS ***
Dealt to matiko09 [Js 6h]
cn_chayanne: folds 
Bothfeld11: calls $1
djammusic: raises $2.50 to $3.50
solbi86: folds 
matiko09: folds 
Vikulja1993 leaves the table
aseban11: calls $3
RICKA16: folds 
Bothfeld11: calls $2.50
*** FLOP *** [7c Qc 8d]
sanpidk joins the table at seat #5 
aseban11: checks 
Bothfeld11: checks 
djammusic: checks 
*** TURN *** [7c Qc 8d] [8c]
aseban11: checks 
Bothfeld11: checks 
djammusic: bets $5.70
aseban11: folds 
Bothfeld11: folds 
Uncalled bet ($5.70) returned to djammusic
djammusic collected $10.98 from pot
djammusic: doesn't show hand 
*** SUMMARY ***
Total pot $11.50 | Rake $0.52 
Board [7c Qc 8d 8c]
Seat 1: aseban11 (small blind) folded on the Turn
Seat 2: RICKA16 (big blind) folded before Flop
Seat 3: cn_chayanne folded before Flop (didn't bet)
Seat 4: Bothfeld11 folded on the Turn
Seat 7: djammusic collected ($10.98)
Seat 8: solbi86 folded before Flop (didn't bet)
Seat 9: matiko09 (button) folded before Flop (didn't bet)





PokerStars Hand #150707253097:  Hold'em No Limit (€0.25/€0.50 EUR) - 2016/03/21 16:54:50 CET [2016/03/21 11:54:50 ET]
Table 'Ndola' 9-max Seat #3 is the button
Seat 1: Muinmyheart (€50 in chips) 
Seat 3: nubpoker (€51.58 in chips) 
Seat 4: Gigi201133 (€15.60 in chips) 
Seat 5: matiko09 (€81.11 in chips) 
Seat 6: OraculBy (€53.88 in chips) 
Seat 7: nombraalne1 (€62.82 in chips) 
Seat 8: Devsteel (€103.68 in chips) 
Seat 9: vasiy379 (€80.85 in chips) 
Gigi201133: posts small blind €0.25
matiko09: posts big blind €0.50
ffac: sits out 
*** HOLE CARDS ***
Dealt to matiko09 [7h 8c]
OraculBy: raises €1 to €1.50
nombraalne1: folds 
Devsteel: folds 
vasiy379: folds 
Muinmyheart: folds 
nubpoker: folds 
Gigi201133: raises €14.10 to €15.60 and is all-in
matiko09: folds 
OraculBy: calls €14.10
*** FLOP *** [Ac 5h 8s]
*** TURN *** [Ac 5h 8s] [Ts]
*** RIVER *** [Ac 5h 8s Ts] [6s]
*** SHOW DOWN ***
Gigi201133: shows [Qc Ad] (a pair of Aces)
OraculBy: shows [Td Tc] (three of a kind, Tens)
OraculBy collected €30.27 from pot
*** SUMMARY ***
Total pot €31.70 | Rake €1.43 
Board [Ac 5h 8s Ts 6s]
Seat 1: Muinmyheart folded before Flop (didn't bet)
Seat 3: nubpoker (button) folded before Flop (didn't bet)
Seat 4: Gigi201133 (small blind) showed [Qc Ad] and lost with a pair of Aces
Seat 5: matiko09 (big blind) folded before Flop
Seat 6: OraculBy showed [Td Tc] and won (€30.27) with three of a kind, Tens
Seat 7: nombraalne1 folded before Flop (didn't bet)
Seat 8: Devsteel folded before Flop (didn't bet)
Seat 9: vasiy379 folded before Flop (didn't bet)





PokerStars Hand #150707262584:  Hold'em No Limit ($0.50/$1.00 USD) - 2016/03/21 16:55:03 CET [2016/03/21 11:55:03 ET]
Table 'Massalia II' 9-max Seat #2 is the button
Seat 1: crepke ($75.92 in chips) 
Seat 2: solbi86 ($126.33 in chips) 
Seat 3: 123chambo ($94.10 in chips) 
Seat 4: OriginalTony ($85.94 in chips) 
Seat 5: roninio1 ($132.82 in chips) 
Seat 7: flk.Dasas ($105.60 in chips) 
Seat 8: matiko09 ($175.31 in chips) 
Seat 9: hammerwife ($100 in chips) 
123chambo: posts small blind $0.50
OriginalTony: posts big blind $1
Pacifistas: sits out 
crepke: posts the ante $0.20
solbi86: posts the ante $0.20
123chambo: posts the ante $0.20
OriginalTony: posts the ante $0.20
roninio1: posts the ante $0.20
flk.Dasas: posts the ante $0.20
matiko09: posts the ante $0.20
hammerwife: posts the ante $0.20
*** HOLE CARDS ***
Dealt to matiko09 [2h 7c]
roninio1: calls $1
flk.Dasas: folds 
matiko09: folds 
hammerwife: folds 
crepke: folds 
solbi86: folds 
123chambo: folds 
OriginalTony: checks 
*** FLOP *** [6d 2d Jh]
OriginalTony: checks 
roninio1: bets $3.92
OriginalTony: folds 
Uncalled bet ($3.92) returned to roninio1
roninio1 collected $3.92 from pot
roninio1: doesn't show hand 
*** SUMMARY ***
Total pot $4.10 | Rake $0.18 
Board [6d 2d Jh]
Seat 1: crepke folded before Flop (didn't bet)
Seat 2: solbi86 (button) folded before Flop (didn't bet)
Seat 3: 123chambo (small blind) folded before Flop
Seat 4: OriginalTony (big blind) folded on the Flop
Seat 5: roninio1 collected ($3.92)
Seat 7: flk.Dasas folded before Flop (didn't bet)
Seat 8: matiko09 folded before Flop (didn't bet)
Seat 9: hammerwife folded before Flop (didn't bet)





PokerStars Hand #150707263203:  Hold'em No Limit (€0.25/€0.50 EUR) - 2016/03/21 16:55:04 CET [2016/03/21 11:55:04 ET]
Table 'Auravictrix II' 9-max Seat #1 is the button
Seat 1: aponinho82 (€45.38 in chips) 
Seat 2: ffac (€56.35 in chips) 
Seat 3: matiko09 (€50 in chips) 
Seat 4: i am owsome (€50 in chips) 
Seat 5: nombraalne1 (€67.91 in chips) 
Seat 6: Devsteel (€50 in chips) 
Seat 7: vasiy379 (€50 in chips) 
Seat 8: ardo888 (€50 in chips) 
Seat 9: carlouchi (€41.90 in chips) 
ffac: posts small blind €0.25
matiko09: posts big blind €0.50
*** HOLE CARDS ***
Dealt to matiko09 [5s 4c]
i am owsome: folds 
nombraalne1: folds 
Devsteel: folds 
vasiy379: folds 
ardo888: folds 
carlouchi: folds 
aponinho82: folds 
ffac: folds 
Uncalled bet (€0.25) returned to matiko09
matiko09 collected €0.50 from pot
matiko09: doesn't show hand 
*** SUMMARY ***
Total pot €0.50 | Rake €0 
Seat 1: aponinho82 (button) folded before Flop (didn't bet)
Seat 2: ffac (small blind) folded before Flop
Seat 3: matiko09 (big blind) collected (€0.50)
Seat 4: i am owsome folded before Flop (didn't bet)
Seat 5: nombraalne1 folded before Flop (didn't bet)
Seat 6: Devsteel folded before Flop (didn't bet)
Seat 7: vasiy379 folded before Flop (didn't bet)
Seat 8: ardo888 folded before Flop (didn't bet)
Seat 9: carlouchi folded before Flop (didn't bet)





PokerStars Hand #150707266303:  Hold'em No Limit ($0.50/$1.00 USD) - 2016/03/21 16:55:08 CET [2016/03/21 11:55:08 ET]
Table 'Skadi III' 9-max Seat #3 is the button
Seat 1: R1aki ($100 in chips) 
Seat 2: aseban11 ($100 in chips) 
Seat 3: matiko09 ($101 in chips) 
Seat 4: ilaviiitech ($100 in chips) 
Seat 5: WaldiQ ($100 in chips) 
Seat 7: solbi86 ($119.16 in chips) 
Seat 8: volwebni4ek ($41.56 in chips) 
Seat 9: bradsheps ($139.31 in chips) 
ilaviiitech: posts small blind $0.50
WaldiQ: posts big blind $1
Pacifistas: sits out 
*** HOLE CARDS ***
Dealt to matiko09 [Ac 9c]
solbi86: raises $2 to $3
volwebni4ek: folds 
bradsheps: folds 
R1aki: folds 
aseban11: folds 
matiko09: folds 
ilaviiitech: folds 
WaldiQ: folds 
Uncalled bet ($2) returned to solbi86
solbi86 collected $2.50 from pot
solbi86: doesn't show hand 
*** SUMMARY ***
Total pot $2.50 | Rake $0 
Seat 1: R1aki folded before Flop (didn't bet)
Seat 2: aseban11 folded before Flop (didn't bet)
Seat 3: matiko09 (button) folded before Flop (didn't bet)
Seat 4: ilaviiitech (small blind) folded before Flop
Seat 5: WaldiQ (big blind) folded before Flop
Seat 7: solbi86 collected ($2.50)
Seat 8: volwebni4ek folded before Flop (didn't bet)
Seat 9: bradsheps folded before Flop (didn't bet)





PokerStars Hand #150707270090:  Hold'em No Limit ($0.50/$1.00 USD) - 2016/03/21 16:55:15 CET [2016/03/21 11:55:15 ET]
Table 'Marmulla II' 9-max Seat #2 is the button
Seat 1: hammerwife ($101.50 in chips) 
Seat 2: lumen21 ($100 in chips) 
Seat 3: Vikulja1993 ($100.50 in chips) 
Seat 4: gabi_igna ($100 in chips) 
Seat 5: maaaGik88 ($82.20 in chips) 
Seat 6: R1aki ($100 in chips) 
Seat 8: ilaviiitech ($112.56 in chips) 
Seat 9: matiko09 ($100 in chips) 
Vikulja1993: posts small blind $0.50
gabi_igna: posts big blind $1
Pacifistas: sits out 
*** HOLE CARDS ***
Dealt to matiko09 [8h 2d]
maaaGik88: folds 
R1aki: folds 
ilaviiitech: folds 
matiko09: folds 
hammerwife: folds 
lumen21: folds 
Vikulja1993: folds 
Uncalled bet ($0.50) returned to gabi_igna
gabi_igna collected $1 from pot
gabi_igna: doesn't show hand 
*** SUMMARY ***
Total pot $1 | Rake $0 
Seat 1: hammerwife folded before Flop (didn't bet)
Seat 2: lumen21 (button) folded before Flop (didn't bet)
Seat 3: Vikulja1993 (small blind) folded before Flop
Seat 4: gabi_igna (big blind) collected ($1)
Seat 5: maaaGik88 folded before Flop (didn't bet)
Seat 6: R1aki folded before Flop (didn't bet)
Seat 8: ilaviiitech folded before Flop (didn't bet)
Seat 9: matiko09 folded before Flop (didn't bet)





PokerStars Hand #150707270900:  Hold'em No Limit ($0.50/$1.00 USD) - 2016/03/21 16:55:16 CET [2016/03/21 11:55:16 ET]
Table 'Juhani' 9-max Seat #5 is the button
Seat 5: Smartiecat ($83.23 in chips) 
Seat 6: Pacifistas ($100.50 in chips) 
Seat 7: matiko09 ($102.50 in chips) 
Pacifistas: posts small blind $0.50
matiko09: posts big blind $1
*** HOLE CARDS ***
Dealt to matiko09 [Qs Jh]
Smartiecat: calls $1
grifkaaa joins the table at seat #8 
Pacifistas: raises $3.50 to $4.50
matiko09: folds 
Smartiecat: folds 
Uncalled bet ($3.50) returned to Pacifistas
Pacifistas collected $3 from pot
Pacifistas: doesn't show hand 
*** SUMMARY ***
Total pot $3 | Rake $0 
Seat 5: Smartiecat (button) folded before Flop
Seat 6: Pacifistas (small blind) collected ($3)
Seat 7: matiko09 (big blind) folded before Flop





PokerStars Hand #150707276638:  Hold'em No Limit ($0.50/$1.00 USD) - 2016/03/21 16:55:25 CET [2016/03/21 11:55:25 ET]
Table 'Icarion II' 9-max Seat #2 is the button
Seat 1: forsmthgood ($105.53 in chips) 
Seat 2: aseban11 ($100 in chips) 
Seat 3: volwebni4ek ($49.44 in chips) 
Seat 4: teukka8 ($44.58 in chips) 
Seat 6: solbi86 ($100 in chips) 
Seat 8: matiko09 ($100 in chips) 
Seat 9: R1aki ($135.26 in chips) 
volwebni4ek: posts small blind $0.50
teukka8: posts big blind $1
SanychStar: sits out 
Pacifistas: sits out 
*** HOLE CARDS ***
Dealt to matiko09 [2d 7h]
solbi86: folds 
matiko09: folds 
R1aki: folds 
forsmthgood: folds 
aseban11: raises $1 to $2
volwebni4ek: folds 
teukka8: calls $1
*** FLOP *** [5c 9d 4h]
teukka8: bets $1
aseban11: calls $1
*** TURN *** [5c 9d 4h] [2c]
teukka8: bets $4
aseban11: folds 
Uncalled bet ($4) returned to teukka8
teukka8 collected $6.21 from pot
teukka8: doesn't show hand 
*** SUMMARY ***
Total pot $6.50 | Rake $0.29 
Board [5c 9d 4h 2c]
Seat 1: forsmthgood folded before Flop (didn't bet)
Seat 2: aseban11 (button) folded on the Turn
Seat 3: volwebni4ek (small blind) folded before Flop
Seat 4: teukka8 (big blind) collected ($6.21)
Seat 6: solbi86 folded before Flop (didn't bet)
Seat 8: matiko09 folded before Flop (didn't bet)
Seat 9: R1aki folded before Flop (didn't bet)





PokerStars Hand #150707276932:  Hold'em No Limit (€0.25/€0.50 EUR) - 2016/03/21 16:55:26 CET [2016/03/21 11:55:26 ET]
Table 'Auravictrix II' 9-max Seat #2 is the button
Seat 1: aponinho82 (€45.38 in chips) 
Seat 2: ffac (€56.10 in chips) 
Seat 3: matiko09 (€50.25 in chips) 
Seat 4: i am owsome (€50 in chips) 
Seat 5: nombraalne1 (€67.91 in chips) 
Seat 6: Devsteel (€50 in chips) 
Seat 7: vasiy379 (€50 in chips) 
Seat 8: ardo888 (€50 in chips) 
Seat 9: carlouchi (€41.90 in chips) 
matiko09: posts small blind €0.25
i am owsome: posts big blind €0.50
*** HOLE CARDS ***
Dealt to matiko09 [7c 6c]
nombraalne1: folds 
Devsteel: folds 
vasiy379: folds 
ardo888: folds 
carlouchi: folds 
aponinho82: raises €1 to €1.50
ffac: folds 
matiko09: folds 
i am owsome: folds 
Uncalled bet (€1) returned to aponinho82
aponinho82 collected €1.25 from pot
aponinho82: doesn't show hand 
*** SUMMARY ***
Total pot €1.25 | Rake €0 
Seat 1: aponinho82 collected (€1.25)
Seat 2: ffac (button) folded before Flop (didn't bet)
Seat 3: matiko09 (small blind) folded before Flop
Seat 4: i am owsome (big blind) folded before Flop
Seat 5: nombraalne1 folded before Flop (didn't bet)
Seat 6: Devsteel folded before Flop (didn't bet)
Seat 7: vasiy379 folded before Flop (didn't bet)
Seat 8: ardo888 folded before Flop (didn't bet)
Seat 9: carlouchi folded before Flop (didn't bet)





PokerStars Hand #150707277268:  Hold'em No Limit (€0.25/€0.50 EUR) - 2016/03/21 16:55:26 CET [2016/03/21 11:55:26 ET]
Table 'Ndola' 9-max Seat #5 is the button
Seat 1: Muinmyheart (€50 in chips) 
Seat 3: nubpoker (€51.58 in chips) 
Seat 5: matiko09 (€80.61 in chips) 
Seat 6: OraculBy (€68.55 in chips) 
Seat 7: nombraalne1 (€62.82 in chips) 
Seat 8: Devsteel (€103.68 in chips) 
Seat 9: vasiy379 (€80.85 in chips) 
OraculBy: posts small blind €0.25
nombraalne1: posts big blind €0.50
ffac: sits out 
*** HOLE CARDS ***
Dealt to matiko09 [Ts 6d]
Devsteel: folds 
vasiy379: folds 
Muinmyheart: folds 
Gigi201133 leaves the table
nubpoker: raises €1 to €1.50
matiko09: folds 
OraculBy: folds 
Racushniak joins the table at seat #4 
nombraalne1: folds 
Uncalled bet (€1) returned to nubpoker
nubpoker collected €1.25 from pot
nubpoker: doesn't show hand 
*** SUMMARY ***
Total pot €1.25 | Rake €0 
Seat 1: Muinmyheart folded before Flop (didn't bet)
Seat 3: nubpoker collected (€1.25)
Seat 5: matiko09 (button) folded before Flop (didn't bet)
Seat 6: OraculBy (small blind) folded before Flop
Seat 7: nombraalne1 (big blind) folded before Flop
Seat 8: Devsteel folded before Flop (didn't bet)
Seat 9: vasiy379 folded before Flop (didn't bet)





PokerStars Hand #150707285352:  Hold'em No Limit ($0.50/$1.00 USD) - 2016/03/21 16:55:39 CET [2016/03/21 11:55:39 ET]
Table 'Massalia II' 9-max Seat #3 is the button
Seat 1: crepke ($75.72 in chips) 
Seat 2: solbi86 ($126.13 in chips) 
Seat 3: 123chambo ($93.40 in chips) 
Seat 4: OriginalTony ($84.74 in chips) 
Seat 5: roninio1 ($135.54 in chips) 
Seat 7: flk.Dasas ($105.40 in chips) 
Seat 8: matiko09 ($175.11 in chips) 
Seat 9: hammerwife ($100 in chips) 
OriginalTony: posts small blind $0.50
roninio1: posts big blind $1
Pacifistas: sits out 
crepke: posts the ante $0.20
solbi86: posts the ante $0.20
123chambo: posts the ante $0.20
OriginalTony: posts the ante $0.20
roninio1: posts the ante $0.20
flk.Dasas: posts the ante $0.20
matiko09: posts the ante $0.20
hammerwife: posts the ante $0.20
*** HOLE CARDS ***
Dealt to matiko09 [7h Qh]
flk.Dasas: folds 
matiko09: folds 
hammerwife: folds 
crepke: folds 
solbi86: folds 
123chambo: raises $2 to $3
OriginalTony: folds 
roninio1: raises $8.10 to $11.10
123chambo: calls $8.10
*** FLOP *** [6h 3c Ts]
roninio1: bets $23.21
123chambo: folds 
Uncalled bet ($23.21) returned to roninio1
roninio1 collected $23.21 from pot
roninio1: doesn't show hand 
*** SUMMARY ***
Total pot $24.30 | Rake $1.09 
Board [6h 3c Ts]
Seat 1: crepke folded before Flop (didn't bet)
Seat 2: solbi86 folded before Flop (didn't bet)
Seat 3: 123chambo (button) folded on the Flop
Seat 4: OriginalTony (small blind) folded before Flop
Seat 5: roninio1 (big blind) collected ($23.21)
Seat 7: flk.Dasas folded before Flop (didn't bet)
Seat 8: matiko09 folded before Flop (didn't bet)
Seat 9: hammerwife folded before Flop (didn't bet)





PokerStars Hand #150707285933:  Hold'em No Limit ($0.50/$1.00 USD) - 2016/03/21 16:55:40 CET [2016/03/21 11:55:40 ET]
Table 'Marmulla II' 9-max Seat #3 is the button
Seat 1: hammerwife ($101.50 in chips) 
Seat 2: lumen21 ($100 in chips) 
Seat 3: Vikulja1993 ($100 in chips) 
Seat 4: gabi_igna ($100.50 in chips) 
Seat 5: maaaGik88 ($82.20 in chips) 
Seat 6: R1aki ($100 in chips) 
Seat 8: ilaviiitech ($112.56 in chips) 
Seat 9: matiko09 ($100 in chips) 
gabi_igna: posts small blind $0.50
maaaGik88: posts big blind $1
Pacifistas: sits out 
*** HOLE CARDS ***
Dealt to matiko09 [3c Jd]
R1aki: raises $1.50 to $2.50
ilaviiitech: folds 
matiko09: folds 
hammerwife: folds 
lumen21: folds 
Vikulja1993: folds 
gabi_igna: folds 
maaaGik88: folds 
Uncalled bet ($1.50) returned to R1aki
R1aki collected $2.50 from pot
R1aki: doesn't show hand 
*** SUMMARY ***
Total pot $2.50 | Rake $0 
Seat 1: hammerwife folded before Flop (didn't bet)
Seat 2: lumen21 folded before Flop (didn't bet)
Seat 3: Vikulja1993 (button) folded before Flop (didn't bet)
Seat 4: gabi_igna (small blind) folded before Flop
Seat 5: maaaGik88 (big blind) folded before Flop
Seat 6: R1aki collected ($2.50)
Seat 8: ilaviiitech folded before Flop (didn't bet)
Seat 9: matiko09 folded before Flop (didn't bet)





PokerStars Hand #150707291111:  Hold'em No Limit ($0.50/$1.00 USD) - 2016/03/21 16:55:48 CET [2016/03/21 11:55:48 ET]
Table 'Noel' 9-max Seat #5 is the button
Seat 1: ep538 ($43.52 in chips) 
Seat 4: Kobiroga150 ($76.31 in chips) 
Seat 5: matiko09 ($133.57 in chips) 
Seat 6: hammerwife ($109.90 in chips) 
Seat 7: djammusic ($62.54 in chips) 
Seat 8: Dachish ($70 in chips) 
Seat 9: grifkaaa ($100.84 in chips) 
hammerwife: posts small blind $0.50
djammusic: posts big blind $1
cobrik23: sits out 
gabi_igna: sits out 
*** HOLE CARDS ***
Dealt to matiko09 [Ts 5d]
Dachish: folds 
grifkaaa: folds 
ep538: calls $1
Kobiroga150: calls $1
matiko09: folds 
hammerwife: folds 
djammusic: checks 
*** FLOP *** [3s 7h 6d]
djammusic: checks 
ep538: checks 
Kobiroga150: checks 
*** TURN *** [3s 7h 6d] [3c]
djammusic: checks 
ep538: bets $1
Kobiroga150: folds 
djammusic: folds 
Uncalled bet ($1) returned to ep538
ep538 collected $3.34 from pot
*** SUMMARY ***
Total pot $3.50 | Rake $0.16 
Board [3s 7h 6d 3c]
Seat 1: ep538 collected ($3.34)
Seat 4: Kobiroga150 folded on the Turn
Seat 5: matiko09 (button) folded before Flop (didn't bet)
Seat 6: hammerwife (small blind) folded before Flop
Seat 7: djammusic (big blind) folded on the Turn
Seat 8: Dachish folded before Flop (didn't bet)
Seat 9: grifkaaa folded before Flop (didn't bet)





PokerStars Hand #150707292609:  Hold'em No Limit ($0.50/$1.00 USD) - 2016/03/21 16:55:51 CET [2016/03/21 11:55:51 ET]
Table 'Lucifer III' 9-max Seat #7 is the button
Seat 1: Pacifistas ($168.64 in chips) 
Seat 2: matiko09 ($100 in chips) 
Seat 3: Vizonto ($95.23 in chips) 
Seat 4: RICKA16 ($100 in chips) 
Seat 6: solbi86 ($127.50 in chips) 
Seat 7: roninio1 ($110.39 in chips) 
Seat 8: aseban11 ($119.55 in chips) 
aseban11: posts small blind $0.50
Pacifistas: posts big blind $1
cobrik23: sits out 
*** HOLE CARDS ***
Dealt to matiko09 [9s 2c]
matiko09: folds 
Vizonto: folds 
RICKA16: folds 
solbi86: folds 
roninio1: raises $2 to $3
aseban11: folds 
Pacifistas: calls $2
*** FLOP *** [Kc Kh Qh]
Pacifistas: checks 
roninio1: checks 
*** TURN *** [Kc Kh Qh] [Ks]
Pacifistas: checks 
roninio1: checks 
*** RIVER *** [Kc Kh Qh Ks] [Js]
Pacifistas: checks 
roninio1: checks 
*** SHOW DOWN ***
Pacifistas: shows [7s 9h] (three of a kind, Kings)
roninio1: shows [9c Ac] (three of a kind, Kings - Ace kicker)
roninio1 collected $6.21 from pot
*** SUMMARY ***
Total pot $6.50 | Rake $0.29 
Board [Kc Kh Qh Ks Js]
Seat 1: Pacifistas (big blind) showed [7s 9h] and lost with three of a kind, Kings
Seat 2: matiko09 folded before Flop (didn't bet)
Seat 3: Vizonto folded before Flop (didn't bet)
Seat 4: RICKA16 folded before Flop (didn't bet)
Seat 6: solbi86 folded before Flop (didn't bet)
Seat 7: roninio1 (button) showed [9c Ac] and won ($6.21) with three of a kind, Kings
Seat 8: aseban11 (small blind) folded before Flop





PokerStars Hand #150707295886:  Hold'em No Limit (€0.25/€0.50 EUR) - 2016/03/21 16:55:56 CET [2016/03/21 11:55:56 ET]
Table 'Auravictrix II' 9-max Seat #3 is the button
Seat 1: aponinho82 (€46.13 in chips) 
Seat 2: ffac (€56.10 in chips) 
Seat 3: matiko09 (€50 in chips) 
Seat 4: i am owsome (€50 in chips) 
Seat 5: nombraalne1 (€67.91 in chips) 
Seat 6: Devsteel (€50 in chips) 
Seat 7: vasiy379 (€50 in chips) 
Seat 8: ardo888 (€50 in chips) 
Seat 9: carlouchi (€41.90 in chips) 
i am owsome: posts small blind €0.25
nombraalne1: posts big blind €0.50
*** HOLE CARDS ***
Dealt to matiko09 [Jh 3h]
Devsteel: folds 
vasiy379: folds 
ardo888: folds 
carlouchi: folds 
aponinho82: calls €0.50
ffac: folds 
matiko09: folds 
i am owsome: raises €1.50 to €2
nombraalne1: folds 
aponinho82: calls €1.50
*** FLOP *** [2d 8s 4c]
i am owsome: bets €2.25
aponinho82: calls €2.25
*** TURN *** [2d 8s 4c] [6h]
i am owsome: checks 
aponinho82: bets €2
i am owsome: folds 
Uncalled bet (€2) returned to aponinho82
aponinho82 collected €8.60 from pot
aponinho82: doesn't show hand 
*** SUMMARY ***
Total pot €9 | Rake €0.40 
Board [2d 8s 4c 6h]
Seat 1: aponinho82 collected (€8.60)
Seat 2: ffac folded before Flop (didn't bet)
Seat 3: matiko09 (button) folded before Flop (didn't bet)
Seat 4: i am owsome (small blind) folded on the Turn
Seat 5: nombraalne1 (big blind) folded before Flop
Seat 6: Devsteel folded before Flop (didn't bet)
Seat 7: vasiy379 folded before Flop (didn't bet)
Seat 8: ardo888 folded before Flop (didn't bet)
Seat 9: carlouchi folded before Flop (didn't bet)





PokerStars Hand #150707296819:  Hold'em No Limit ($0.50/$1.00 USD) - 2016/03/21 16:55:57 CET [2016/03/21 11:55:57 ET]
Table 'Skadi III' 9-max Seat #4 is the button
Seat 1: R1aki ($100 in chips) 
Seat 2: aseban11 ($100 in chips) 
Seat 3: matiko09 ($101 in chips) 
Seat 4: ilaviiitech ($100 in chips) 
Seat 5: WaldiQ ($99 in chips) 
Seat 6: Pacifistas ($100 in chips) 
Seat 7: solbi86 ($120.66 in chips) 
Seat 8: volwebni4ek ($41.56 in chips) 
Seat 9: bradsheps ($139.31 in chips) 
WaldiQ: posts small blind $0.50
Pacifistas: posts big blind $1
*** HOLE CARDS ***
Dealt to matiko09 [Qd Kh]
solbi86: folds 
volwebni4ek: raises $2 to $3
bradsheps: folds 
R1aki: folds 
aseban11: folds 
matiko09: folds 
ilaviiitech: folds 
WaldiQ: folds 
Pacifistas: calls $2
*** FLOP *** [2s Ts 4s]
Pacifistas: checks 
volwebni4ek: bets $4
Pacifistas: calls $4
*** TURN *** [2s Ts 4s] [6d]
Pacifistas: checks 
volwebni4ek: checks 
*** RIVER *** [2s Ts 4s 6d] [2c]
Pacifistas: bets $9.56
volwebni4ek: folds 
Uncalled bet ($9.56) returned to Pacifistas
Pacifistas collected $13.85 from pot
Pacifistas: doesn't show hand 
*** SUMMARY ***
Total pot $14.50 | Rake $0.65 
Board [2s Ts 4s 6d 2c]
Seat 1: R1aki folded before Flop (didn't bet)
Seat 2: aseban11 folded before Flop (didn't bet)
Seat 3: matiko09 folded before Flop (didn't bet)
Seat 4: ilaviiitech (button) folded before Flop (didn't bet)
Seat 5: WaldiQ (small blind) folded before Flop
Seat 6: Pacifistas (big blind) collected ($13.85)
Seat 7: solbi86 folded before Flop (didn't bet)
Seat 8: volwebni4ek folded on the River
Seat 9: bradsheps folded before Flop (didn't bet)





PokerStars Hand #150707299507:  Hold'em No Limit ($0.50/$1.00 USD) - 2016/03/21 16:56:02 CET [2016/03/21 11:56:02 ET]
Table 'Juhani' 9-max Seat #6 is the button
Seat 5: Smartiecat ($82.23 in chips) 
Seat 6: Pacifistas ($102.50 in chips) 
Seat 7: matiko09 ($101.50 in chips) 
Seat 8: grifkaaa ($100 in chips) 
matiko09: posts small blind $0.50
grifkaaa: posts big blind $1
*** HOLE CARDS ***
Dealt to matiko09 [3d Kh]
IntsAA joins the table at seat #9 
Smartiecat: raises $2 to $3
Pacifistas: raises $6 to $9
solbi86 joins the table at seat #1 
matiko09: folds 
grifkaaa: folds 
Smartiecat: calls $6
*** FLOP *** [8s Tc Ks]
Smartiecat: checks 
Pacifistas: bets $10.05
Smartiecat: calls $10.05
*** TURN *** [8s Tc Ks] [2d]
Smartiecat: checks 
Pacifistas: checks 
*** RIVER *** [8s Tc Ks 2d] [2h]
Smartiecat: checks 
Pacifistas: checks 
*** SHOW DOWN ***
Smartiecat: shows [8d 8c] (a full house, Eights full of Deuces)
Pacifistas: mucks hand 
Smartiecat collected $38.10 from pot
*** SUMMARY ***
Total pot $39.60 | Rake $1.50 
Board [8s Tc Ks 2d 2h]
Seat 5: Smartiecat showed [8d 8c] and won ($38.10) with a full house, Eights full of Deuces
Seat 6: Pacifistas (button) mucked [Ah Js]
Seat 7: matiko09 (small blind) folded before Flop
Seat 8: grifkaaa (big blind) folded before Flop





PokerStars Hand #150707301650:  Hold'em No Limit ($0.50/$1.00 USD) - 2016/03/21 16:56:05 CET [2016/03/21 11:56:05 ET]
Table 'Marmulla II' 9-max Seat #4 is the button
Seat 1: hammerwife ($101.50 in chips) 
Seat 2: lumen21 ($100 in chips) 
Seat 3: Vikulja1993 ($100 in chips) 
Seat 4: gabi_igna ($100 in chips) 
Seat 5: maaaGik88 ($81.20 in chips) 
Seat 6: R1aki ($101.50 in chips) 
Seat 8: ilaviiitech ($112.56 in chips) 
Seat 9: matiko09 ($100 in chips) 
maaaGik88: posts small blind $0.50
R1aki: posts big blind $1
Pacifistas: sits out 
*** HOLE CARDS ***
Dealt to matiko09 [7c Kd]
ilaviiitech: raises $1 to $2
matiko09: folds 
hammerwife: folds 
lumen21: folds 
Vikulja1993: folds 
gabi_igna: folds 
maaaGik88: folds 
R1aki: folds 
Uncalled bet ($1) returned to ilaviiitech
ilaviiitech collected $2.50 from pot
ilaviiitech: doesn't show hand 
*** SUMMARY ***
Total pot $2.50 | Rake $0 
Seat 1: hammerwife folded before Flop (didn't bet)
Seat 2: lumen21 folded before Flop (didn't bet)
Seat 3: Vikulja1993 folded before Flop (didn't bet)
Seat 4: gabi_igna (button) folded before Flop (didn't bet)
Seat 5: maaaGik88 (small blind) folded before Flop
Seat 6: R1aki (big blind) folded before Flop
Seat 8: ilaviiitech collected ($2.50)
Seat 9: matiko09 folded before Flop (didn't bet)





PokerStars Hand #150707302594:  Hold'em No Limit (€0.25/€0.50 EUR) - 2016/03/21 16:56:07 CET [2016/03/21 11:56:07 ET]
Table 'Ndola' 9-max Seat #6 is the button
Seat 1: Muinmyheart (€50 in chips) 
Seat 3: nubpoker (€52.33 in chips) 
Seat 5: matiko09 (€80.61 in chips) 
Seat 6: OraculBy (€68.30 in chips) 
Seat 7: nombraalne1 (€62.32 in chips) 
Seat 9: vasiy379 (€80.85 in chips) 
nombraalne1: posts small blind €0.25
Devsteel: is sitting out 
vasiy379: posts big blind €0.50
Devsteel leaves the table
ffac: sits out 
Racushniak: sits out 
*** HOLE CARDS ***
Dealt to matiko09 [Kd Qh]
Indr3k joins the table at seat #8 
Indr3k leaves the table
mi$$I$Elena joins the table at seat #8 
mi$$I$Elena leaves the table
Muinmyheart: folds 
nubpoker: folds 
matiko09: raises €0.75 to €1.25
OraculBy: folds 
ffac leaves the table
nombraalne1: folds 
vasiy379: raises €3 to €4.25
matiko09: calls €3
*** FLOP *** [Ts 7c 2d]
vasiy379: bets €3.25
matiko09: folds 
Uncalled bet (€3.25) returned to vasiy379
vasiy379 collected €8.36 from pot
vasiy379: doesn't show hand 
*** SUMMARY ***
Total pot €8.75 | Rake €0.39 
Board [Ts 7c 2d]
Seat 1: Muinmyheart folded before Flop (didn't bet)
Seat 3: nubpoker folded before Flop (didn't bet)
Seat 5: matiko09 folded on the Flop
Seat 6: OraculBy (button) folded before Flop (didn't bet)
Seat 7: nombraalne1 (small blind) folded before Flop
Seat 9: vasiy379 (big blind) collected (€8.36)





PokerStars Hand #150707310397:  Hold'em No Limit ($0.50/$1.00 USD) - 2016/03/21 16:56:19 CET [2016/03/21 11:56:19 ET]
Table 'Onnie II' 9-max Seat #1 is the button
Seat 1: aseban11 ($182.79 in chips) 
Seat 2: RICKA16 ($100 in chips) 
Seat 4: Bothfeld11 ($174.79 in chips) 
Seat 7: djammusic ($78.40 in chips) 
Seat 8: solbi86 ($106.26 in chips) 
Seat 9: matiko09 ($116.69 in chips) 
RICKA16: posts small blind $0.50
cn_chayanne: is sitting out 
Bothfeld11: posts big blind $1
sanpidk: sits out 
Pacifistas: sits out 
*** HOLE CARDS ***
Dealt to matiko09 [8c 4d]
djammusic: folds 
solbi86: folds 
matiko09: folds 
aseban11: folds 
RICKA16: folds 
Uncalled bet ($0.50) returned to Bothfeld11
Bothfeld11 collected $1 from pot
*** SUMMARY ***
Total pot $1 | Rake $0 
Seat 1: aseban11 (button) folded before Flop (didn't bet)
Seat 2: RICKA16 (small blind) folded before Flop
Seat 4: Bothfeld11 (big blind) collected ($1)
Seat 7: djammusic folded before Flop (didn't bet)
Seat 8: solbi86 folded before Flop (didn't bet)
Seat 9: matiko09 folded before Flop (didn't bet)





PokerStars Hand #150707311961:  Hold'em No Limit ($0.50/$1.00 USD) - 2016/03/21 16:56:21 CET [2016/03/21 11:56:21 ET]
Table 'Massalia II' 9-max Seat #4 is the button
Seat 1: crepke ($75.52 in chips) 
Seat 2: solbi86 ($125.93 in chips) 
Seat 3: 123chambo ($82.10 in chips) 
Seat 4: OriginalTony ($84.04 in chips) 
Seat 5: roninio1 ($147.45 in chips) 
Seat 6: Pacifistas ($138.67 in chips) 
Seat 7: flk.Dasas ($105.20 in chips) 
Seat 8: matiko09 ($174.91 in chips) 
Seat 9: hammerwife ($100 in chips) 
roninio1: posts small blind $0.50
Pacifistas: posts big blind $1
crepke: posts the ante $0.20
solbi86: posts the ante $0.20
123chambo: posts the ante $0.20
OriginalTony: posts the ante $0.20
roninio1: posts the ante $0.20
Pacifistas: posts the ante $0.20
flk.Dasas: posts the ante $0.20
matiko09: posts the ante $0.20
hammerwife: posts the ante $0.20
*** HOLE CARDS ***
Dealt to matiko09 [Jh 7h]
flk.Dasas: folds 
matiko09: folds 
hammerwife: raises $2 to $3
crepke: folds 
solbi86: calls $3
123chambo: folds 
OriginalTony: folds 
roninio1: calls $2.50
Pacifistas: folds 
*** FLOP *** [2d 9c 2c]
roninio1: checks 
hammerwife: checks 
solbi86: bets $7
roninio1: raises $7 to $14
hammerwife: folds 
solbi86: raises $18 to $32
roninio1: calls $18
*** TURN *** [2d 9c 2c] [Th]
roninio1: checks 
solbi86: bets $28
roninio1: calls $28
*** RIVER *** [2d 9c 2c Th] [8c]
roninio1: checks 
solbi86: bets $62.73 and is all-in
roninio1: calls $62.73
*** SHOW DOWN ***
solbi86: shows [Tc Td] (a full house, Tens full of Deuces)
roninio1: shows [9s 5s] (two pair, Nines and Deuces)
solbi86 collected $254.46 from pot
*** SUMMARY ***
Total pot $257.26 | Rake $2.80 
Board [2d 9c 2c Th 8c]
Seat 1: crepke folded before Flop (didn't bet)
Seat 2: solbi86 showed [Tc Td] and won ($254.46) with a full house, Tens full of Deuces
Seat 3: 123chambo folded before Flop (didn't bet)
Seat 4: OriginalTony (button) folded before Flop (didn't bet)
Seat 5: roninio1 (small blind) showed [9s 5s] and lost with two pair, Nines and Deuces
Seat 6: Pacifistas (big blind) folded before Flop
Seat 7: flk.Dasas folded before Flop (didn't bet)
Seat 8: matiko09 folded before Flop (didn't bet)
Seat 9: hammerwife folded on the Flop





PokerStars Hand #150707315970:  Hold'em No Limit ($0.50/$1.00 USD) - 2016/03/21 16:56:28 CET [2016/03/21 11:56:28 ET]
Table 'Lucifer III' 9-max Seat #8 is the button
Seat 1: Pacifistas ($165.64 in chips) 
Seat 2: matiko09 ($100 in chips) 
Seat 3: Vizonto ($95.23 in chips) 
Seat 4: RICKA16 ($100 in chips) 
Seat 6: solbi86 ($127.50 in chips) 
Seat 7: roninio1 ($113.60 in chips) 
Seat 8: aseban11 ($119.05 in chips) 
Pacifistas: posts small blind $0.50
matiko09: posts big blind $1
cobrik23: sits out 
*** HOLE CARDS ***
Dealt to matiko09 [Ad Js]
Vizonto: folds 
RICKA16: folds 
solbi86: folds 
roninio1: folds 
aseban11: folds 
Pacifistas: raises $1.50 to $2.50
matiko09: calls $1.50
*** FLOP *** [5s 4d 4c]
Pacifistas: bets $2.58
matiko09: calls $2.58
*** TURN *** [5s 4d 4c] [8s]
Pacifistas: checks 
matiko09: checks 
*** RIVER *** [5s 4d 4c 8s] [Jh]
Pacifistas: bets $6
matiko09: calls $6
*** SHOW DOWN ***
Pacifistas: shows [Jd Ts] (two pair, Jacks and Fours)
matiko09: shows [Ad Js] (two pair, Jacks and Fours - Ace kicker)
matiko09 collected $21.16 from pot
*** SUMMARY ***
Total pot $22.16 | Rake $1 
Board [5s 4d 4c 8s Jh]
Seat 1: Pacifistas (small blind) showed [Jd Ts] and lost with two pair, Jacks and Fours
Seat 2: matiko09 (big blind) showed [Ad Js] and won ($21.16) with two pair, Jacks and Fours
Seat 3: Vizonto folded before Flop (didn't bet)
Seat 4: RICKA16 folded before Flop (didn't bet)
Seat 6: solbi86 folded before Flop (didn't bet)
Seat 7: roninio1 folded before Flop (didn't bet)
Seat 8: aseban11 (button) folded before Flop (didn't bet)





PokerStars Hand #150707321367:  Hold'em No Limit ($0.50/$1.00 USD) - 2016/03/21 16:56:36 CET [2016/03/21 11:56:36 ET]
Table 'Marmulla II' 9-max Seat #5 is the button
Seat 1: hammerwife ($101.50 in chips) 
Seat 2: lumen21 ($100 in chips) 
Seat 3: Vikulja1993 ($100 in chips) 
Seat 4: gabi_igna ($100 in chips) 
Seat 5: maaaGik88 ($80.70 in chips) 
Seat 6: R1aki ($100.50 in chips) 
Seat 7: Pacifistas ($109.92 in chips) 
Seat 8: ilaviiitech ($114.06 in chips) 
Seat 9: matiko09 ($100 in chips) 
R1aki: posts small blind $0.50
Pacifistas: posts big blind $1
*** HOLE CARDS ***
Dealt to matiko09 [9c Kc]
ilaviiitech: folds 
matiko09: folds 
hammerwife: folds 
lumen21: folds 
Vikulja1993: folds 
gabi_igna: folds 
maaaGik88: folds 
R1aki: folds 
Uncalled bet ($0.50) returned to Pacifistas
Pacifistas collected $1 from pot
Pacifistas: doesn't show hand 
*** SUMMARY ***
Total pot $1 | Rake $0 
Seat 1: hammerwife folded before Flop (didn't bet)
Seat 2: lumen21 folded before Flop (didn't bet)
Seat 3: Vikulja1993 folded before Flop (didn't bet)
Seat 4: gabi_igna folded before Flop (didn't bet)
Seat 5: maaaGik88 (button) folded before Flop (didn't bet)
Seat 6: R1aki (small blind) folded before Flop
Seat 7: Pacifistas (big blind) collected ($1)
Seat 8: ilaviiitech folded before Flop (didn't bet)
Seat 9: matiko09 folded before Flop (didn't bet)





PokerStars Hand #150707322895:  Hold'em No Limit ($0.50/$1.00 USD) - 2016/03/21 16:56:39 CET [2016/03/21 11:56:39 ET]
Table 'Icarion II' 9-max Seat #3 is the button
Seat 1: forsmthgood ($105.53 in chips) 
Seat 2: aseban11 ($100 in chips) 
Seat 3: volwebni4ek ($48.94 in chips) 
Seat 4: teukka8 ($47.79 in chips) 
Seat 5: SanychStar ($100 in chips) 
Seat 6: solbi86 ($100 in chips) 
Seat 8: matiko09 ($100 in chips) 
Seat 9: R1aki ($135.26 in chips) 
teukka8: posts small blind $0.50
SanychStar: posts big blind $1
Pacifistas: sits out 
*** HOLE CARDS ***
Dealt to matiko09 [3c As]
solbi86: folds 
matiko09: folds 
R1aki: folds 
forsmthgood: folds 
aseban11: raises $1.50 to $2.50
volwebni4ek: folds 
teukka8: folds 
SanychStar: calls $1.50
*** FLOP *** [4h Ts Tc]
SanychStar: checks 
aseban11: bets $3.50
SanychStar: folds 
Uncalled bet ($3.50) returned to aseban11
aseban11 collected $5.25 from pot
aseban11: doesn't show hand 
*** SUMMARY ***
Total pot $5.50 | Rake $0.25 
Board [4h Ts Tc]
Seat 1: forsmthgood folded before Flop (didn't bet)
Seat 2: aseban11 collected ($5.25)
Seat 3: volwebni4ek (button) folded before Flop (didn't bet)
Seat 4: teukka8 (small blind) folded before Flop
Seat 5: SanychStar (big blind) folded on the Flop
Seat 6: solbi86 folded before Flop (didn't bet)
Seat 8: matiko09 folded before Flop (didn't bet)
Seat 9: R1aki folded before Flop (didn't bet)





PokerStars Hand #150707327956:  Hold'em No Limit ($0.50/$1.00 USD) - 2016/03/21 16:56:47 CET [2016/03/21 11:56:47 ET]
Table 'Noel' 9-max Seat #6 is the button
Seat 1: ep538 ($45.86 in chips) 
Seat 4: Kobiroga150 ($75.31 in chips) 
Seat 5: matiko09 ($133.57 in chips) 
Seat 6: hammerwife ($109.40 in chips) 
Seat 7: djammusic ($61.54 in chips) 
Seat 8: Dachish ($70 in chips) 
Seat 9: grifkaaa ($100.84 in chips) 
djammusic: posts small blind $0.50
Dachish: posts big blind $1
cobrik23: sits out 
gabi_igna: sits out 
*** HOLE CARDS ***
Dealt to matiko09 [Ks 9h]
grifkaaa: folds 
ep538: folds 
Kobiroga150: folds 
matiko09: folds 
hammerwife: raises $1.01 to $2.01
djammusic: folds 
Dachish: folds 
Uncalled bet ($1.01) returned to hammerwife
hammerwife collected $2.50 from pot
hammerwife: doesn't show hand 
*** SUMMARY ***
Total pot $2.50 | Rake $0 
Seat 1: ep538 folded before Flop (didn't bet)
Seat 4: Kobiroga150 folded before Flop (didn't bet)
Seat 5: matiko09 folded before Flop (didn't bet)
Seat 6: hammerwife (button) collected ($2.50)
Seat 7: djammusic (small blind) folded before Flop
Seat 8: Dachish (big blind) folded before Flop
Seat 9: grifkaaa folded before Flop (didn't bet)





PokerStars Hand #150707328591:  Hold'em No Limit ($0.50/$1.00 USD) - 2016/03/21 16:56:48 CET [2016/03/21 11:56:48 ET]
Table 'Onnie II' 9-max Seat #2 is the button
Seat 1: aseban11 ($182.79 in chips) 
Seat 2: RICKA16 ($99.50 in chips) 
Seat 4: Bothfeld11 ($175.29 in chips) 
Seat 5: sanpidk ($101.50 in chips) 
Seat 7: djammusic ($78.40 in chips) 
Seat 8: solbi86 ($106.26 in chips) 
Seat 9: matiko09 ($116.69 in chips) 
Bothfeld11: posts small blind $0.50
sanpidk: posts big blind $1
Pacifistas: sits out 
*** HOLE CARDS ***
Dealt to matiko09 [3s 9d]
djammusic: folds 
solbi86: folds 
matiko09: folds 
aseban11: folds 
RICKA16: folds 
Bothfeld11: calls $0.50
sanpidk: checks 
*** FLOP *** [6s Th 5s]
Bothfeld11: checks 
sanpidk: checks 
*** TURN *** [6s Th 5s] [Kh]
Bothfeld11: checks 
sanpidk: checks 
*** RIVER *** [6s Th 5s Kh] [Qc]
Bothfeld11: checks 
sanpidk: checks 
*** SHOW DOWN ***
Bothfeld11: shows [9h 8c] (high card King)
sanpidk: mucks hand 
Bothfeld11 collected $1.91 from pot
*** SUMMARY ***
Total pot $2 | Rake $0.09 
Board [6s Th 5s Kh Qc]
Seat 1: aseban11 folded before Flop (didn't bet)
Seat 2: RICKA16 (button) folded before Flop (didn't bet)
Seat 4: Bothfeld11 (small blind) showed [9h 8c] and won ($1.91) with high card King
Seat 5: sanpidk (big blind) mucked [3c 9s]
Seat 7: djammusic folded before Flop (didn't bet)
Seat 8: solbi86 folded before Flop (didn't bet)
Seat 9: matiko09 folded before Flop (didn't bet)





PokerStars Hand #150707343774:  Hold'em No Limit (€0.25/€0.50 EUR) - 2016/03/21 16:57:12 CET [2016/03/21 11:57:12 ET]
Table 'Auravictrix II' 9-max Seat #4 is the button
Seat 1: aponinho82 (€50.48 in chips) 
Seat 2: ffac (€56.10 in chips) 
Seat 3: matiko09 (€50 in chips) 
Seat 4: i am owsome (€50 in chips) 
Seat 5: nombraalne1 (€67.41 in chips) 
Seat 6: Devsteel (€50 in chips) 
Seat 7: vasiy379 (€50 in chips) 
Seat 8: ardo888 (€50 in chips) 
Seat 9: carlouchi (€41.90 in chips) 
nombraalne1: posts small blind €0.25
Devsteel: posts big blind €0.50
*** HOLE CARDS ***
Dealt to matiko09 [Js 7c]
vasiy379: folds 
ardo888: folds 
carlouchi: folds 
aponinho82: folds 
ffac: folds 
matiko09: folds 
i am owsome: raises €0.75 to €1.25
nombraalne1: folds 
Devsteel: raises €3 to €4.25
i am owsome: raises €6.75 to €11
Devsteel: raises €39 to €50 and is all-in
i am owsome: calls €39 and is all-in
*** FLOP *** [Td 4s Qs]
*** TURN *** [Td 4s Qs] [6h]
*** RIVER *** [Td 4s Qs 6h] [Jc]
*** SHOW DOWN ***
Devsteel: shows [8c 8d] (a pair of Eights)
i am owsome: shows [Kh Ks] (a pair of Kings)
i am owsome collected €98.25 from pot
*** SUMMARY ***
Total pot €100.25 | Rake €2 
Board [Td 4s Qs 6h Jc]
Seat 1: aponinho82 folded before Flop (didn't bet)
Seat 2: ffac folded before Flop (didn't bet)
Seat 3: matiko09 folded before Flop (didn't bet)
Seat 4: i am owsome (button) showed [Kh Ks] and won (€98.25) with a pair of Kings
Seat 5: nombraalne1 (small blind) folded before Flop
Seat 6: Devsteel (big blind) showed [8c 8d] and lost with a pair of Eights
Seat 7: vasiy379 folded before Flop (didn't bet)
Seat 8: ardo888 folded before Flop (didn't bet)
Seat 9: carlouchi folded before Flop (didn't bet)





PokerStars Hand #150707344555:  Hold'em No Limit ($0.50/$1.00 USD) - 2016/03/21 16:57:13 CET [2016/03/21 11:57:13 ET]
Table 'Juhani' 9-max Seat #7 is the button
Seat 5: Smartiecat ($101.28 in chips) 
Seat 6: Pacifistas ($100 in chips) 
Seat 7: matiko09 ($101 in chips) 
Seat 8: grifkaaa ($100 in chips) 
Seat 9: IntsAA ($96 in chips) 
grifkaaa: posts small blind $0.50
IntsAA: posts big blind $1
solbi86: sits out 
*** HOLE CARDS ***
Dealt to matiko09 [9h 3c]
Smartiecat: folds 
Pacifistas: folds 
matiko09: folds 
grifkaaa: raises $1.35 to $2.35
IntsAA: folds 
Uncalled bet ($1.35) returned to grifkaaa
grifkaaa collected $2 from pot
*** SUMMARY ***
Total pot $2 | Rake $0 
Seat 5: Smartiecat folded before Flop (didn't bet)
Seat 6: Pacifistas folded before Flop (didn't bet)
Seat 7: matiko09 (button) folded before Flop (didn't bet)
Seat 8: grifkaaa (small blind) collected ($2)
Seat 9: IntsAA (big blind) folded before Flop





PokerStars Hand #150707344864:  Hold'em No Limit ($0.50/$1.00 USD) - 2016/03/21 16:57:14 CET [2016/03/21 11:57:14 ET]
Table 'Marmulla II' 9-max Seat #6 is the button
Seat 1: hammerwife ($101.50 in chips) 
Seat 2: lumen21 ($100 in chips) 
Seat 3: Vikulja1993 ($100 in chips) 
Seat 4: gabi_igna ($100 in chips) 
Seat 5: maaaGik88 ($80.70 in chips) 
Seat 6: R1aki ($100 in chips) 
Seat 7: Pacifistas ($110.42 in chips) 
Seat 8: ilaviiitech ($114.06 in chips) 
Seat 9: matiko09 ($100 in chips) 
Pacifistas: posts small blind $0.50
ilaviiitech: posts big blind $1
*** HOLE CARDS ***
Dealt to matiko09 [Js 2c]
matiko09: folds 
hammerwife: raises $2 to $3
lumen21: folds 
Vikulja1993: folds 
gabi_igna: folds 
maaaGik88: folds 
R1aki: folds 
Pacifistas: folds 
ilaviiitech: folds 
Uncalled bet ($2) returned to hammerwife
hammerwife collected $2.50 from pot
hammerwife: doesn't show hand 
*** SUMMARY ***
Total pot $2.50 | Rake $0 
Seat 1: hammerwife collected ($2.50)
Seat 2: lumen21 folded before Flop (didn't bet)
Seat 3: Vikulja1993 folded before Flop (didn't bet)
Seat 4: gabi_igna folded before Flop (didn't bet)
Seat 5: maaaGik88 folded before Flop (didn't bet)
Seat 6: R1aki (button) folded before Flop (didn't bet)
Seat 7: Pacifistas (small blind) folded before Flop
Seat 8: ilaviiitech (big blind) folded before Flop
Seat 9: matiko09 folded before Flop (didn't bet)





PokerStars Hand #150707344797:  Hold'em No Limit (€0.25/€0.50 EUR) - 2016/03/21 16:57:14 CET [2016/03/21 11:57:14 ET]
Table 'Ndola' 9-max Seat #7 is the button
Seat 1: Muinmyheart (€50 in chips) 
Seat 3: nubpoker (€52.33 in chips) 
Seat 5: matiko09 (€76.36 in chips) 
Seat 6: OraculBy (€68.30 in chips) 
Seat 7: nombraalne1 (€62.07 in chips) 
Seat 9: vasiy379 (€84.96 in chips) 
vasiy379: posts small blind €0.25
Muinmyheart: posts big blind €0.50
Racushniak: sits out 
*** HOLE CARDS ***
Dealt to matiko09 [8h Ks]
nubpoker: raises €1 to €1.50
matiko09: folds 
OraculBy: raises €3 to €4.50
nombraalne1: folds 
vasiy379: folds 
Muinmyheart: folds 
nubpoker: calls €3
*** FLOP *** [Ac 8d 5c]
nubpoker: checks 
OraculBy: bets €6.50
nubpoker: folds 
Uncalled bet (€6.50) returned to OraculBy
OraculBy collected €9.31 from pot
OraculBy: doesn't show hand 
*** SUMMARY ***
Total pot €9.75 | Rake €0.44 
Board [Ac 8d 5c]
Seat 1: Muinmyheart (big blind) folded before Flop
Seat 3: nubpoker folded on the Flop
Seat 5: matiko09 folded before Flop (didn't bet)
Seat 6: OraculBy collected (€9.31)
Seat 7: nombraalne1 (button) folded before Flop (didn't bet)
Seat 9: vasiy379 (small blind) folded before Flop





PokerStars Hand #150707345308:  Hold'em No Limit ($0.50/$1.00 USD) - 2016/03/21 16:57:15 CET [2016/03/21 11:57:15 ET]
Table 'Noel' 9-max Seat #7 is the button
Seat 1: ep538 ($45.86 in chips) 
Seat 4: Kobiroga150 ($75.31 in chips) 
Seat 5: matiko09 ($133.57 in chips) 
Seat 6: hammerwife ($110.90 in chips) 
Seat 7: djammusic ($61.04 in chips) 
Seat 8: Dachish ($69 in chips) 
Seat 9: grifkaaa ($100.84 in chips) 
Dachish: posts small blind $0.50
grifkaaa: posts big blind $1
cobrik23: sits out 
gabi_igna: sits out 
*** HOLE CARDS ***
Dealt to matiko09 [Jh 5s]
ep538: folds 
Kobiroga150: folds 
matiko09: folds 
hammerwife: raises $1.50 to $2.50
djammusic: folds 
Dachish: raises $6 to $8.50
grifkaaa: folds 
hammerwife: folds 
Uncalled bet ($6) returned to Dachish
Dachish collected $6 from pot
Dachish: doesn't show hand 
*** SUMMARY ***
Total pot $6 | Rake $0 
Seat 1: ep538 folded before Flop (didn't bet)
Seat 4: Kobiroga150 folded before Flop (didn't bet)
Seat 5: matiko09 folded before Flop (didn't bet)
Seat 6: hammerwife folded before Flop
Seat 7: djammusic (button) folded before Flop (didn't bet)
Seat 8: Dachish (small blind) collected ($6)
Seat 9: grifkaaa (big blind) folded before Flop





PokerStars Hand #150707348002:  Hold'em No Limit ($0.50/$1.00 USD) - 2016/03/21 16:57:19 CET [2016/03/21 11:57:19 ET]
Table 'Lucifer III' 9-max Seat #1 is the button
Seat 1: Pacifistas ($154.56 in chips) 
Seat 2: matiko09 ($110.08 in chips) 
Seat 3: Vizonto ($95.23 in chips) 
Seat 4: RICKA16 ($100 in chips) 
Seat 6: solbi86 ($127.50 in chips) 
Seat 7: roninio1 ($113.60 in chips) 
Seat 8: aseban11 ($119.05 in chips) 
matiko09: posts small blind $0.50
Vizonto: posts big blind $1
cobrik23: sits out 
*** HOLE CARDS ***
Dealt to matiko09 [Kh 3d]
RICKA16: folds 
solbi86: folds 
roninio1: folds 
aseban11: folds 
Pacifistas: raises $1.50 to $2.50
matiko09: folds 
Vizonto: folds 
Uncalled bet ($1.50) returned to Pacifistas
Pacifistas collected $2.50 from pot
Pacifistas: doesn't show hand 
*** SUMMARY ***
Total pot $2.50 | Rake $0 
Seat 1: Pacifistas (button) collected ($2.50)
Seat 2: matiko09 (small blind) folded before Flop
Seat 3: Vizonto (big blind) folded before Flop
Seat 4: RICKA16 folded before Flop (didn't bet)
Seat 6: solbi86 folded before Flop (didn't bet)
Seat 7: roninio1 folded before Flop (didn't bet)
Seat 8: aseban11 folded before Flop (didn't bet)





PokerStars Hand #150707352961:  Hold'em No Limit ($0.50/$1.00 USD) - 2016/03/21 16:57:27 CET [2016/03/21 11:57:27 ET]
Table 'Icarion II' 9-max Seat #4 is the button
Seat 1: forsmthgood ($105.53 in chips) 
Seat 2: aseban11 ($102.75 in chips) 
Seat 3: volwebni4ek ($48.94 in chips) 
Seat 4: teukka8 ($47.29 in chips) 
Seat 5: SanychStar ($100 in chips) 
Seat 6: solbi86 ($100 in chips) 
Seat 8: matiko09 ($100 in chips) 
Seat 9: R1aki ($135.26 in chips) 
SanychStar: posts small blind $0.50
solbi86: posts big blind $1
Pacifistas: sits out 
*** HOLE CARDS ***
Dealt to matiko09 [7d 4s]
matiko09: folds 
R1aki: folds 
forsmthgood: folds 
aseban11: folds 
volwebni4ek: raises $1.20 to $2.20
teukka8: folds 
SanychStar: folds 
solbi86: raises $4.80 to $7
volwebni4ek: calls $4.80
*** FLOP *** [Jc 8c Kc]
solbi86: checks 
volwebni4ek: bets $7
solbi86: calls $7
*** TURN *** [Jc 8c Kc] [6d]
solbi86: checks 
volwebni4ek: checks 
*** RIVER *** [Jc 8c Kc 6d] [8d]
solbi86: bets $14
volwebni4ek: folds 
Uncalled bet ($14) returned to solbi86
solbi86 collected $27.22 from pot
solbi86: doesn't show hand 
*** SUMMARY ***
Total pot $28.50 | Rake $1.28 
Board [Jc 8c Kc 6d 8d]
Seat 1: forsmthgood folded before Flop (didn't bet)
Seat 2: aseban11 folded before Flop (didn't bet)
Seat 3: volwebni4ek folded on the River
Seat 4: teukka8 (button) folded before Flop (didn't bet)
Seat 5: SanychStar (small blind) folded before Flop
Seat 6: solbi86 (big blind) collected ($27.22)
Seat 8: matiko09 folded before Flop (didn't bet)
Seat 9: R1aki folded before Flop (didn't bet)





PokerStars Hand #150707357538:  Hold'em No Limit ($0.50/$1.00 USD) - 2016/03/21 16:57:34 CET [2016/03/21 11:57:34 ET]
Table 'Onnie II' 9-max Seat #4 is the button
Seat 1: aseban11 ($182.79 in chips) 
Seat 2: RICKA16 ($99.50 in chips) 
Seat 4: Bothfeld11 ($176.20 in chips) 
Seat 5: sanpidk ($100.50 in chips) 
Seat 6: Pacifistas ($100 in chips) 
Seat 7: djammusic ($78.40 in chips) 
Seat 8: solbi86 ($106.26 in chips) 
Seat 9: matiko09 ($116.69 in chips) 
sanpidk: posts small blind $0.50
Pacifistas: posts big blind $1
*** HOLE CARDS ***
Dealt to matiko09 [5s 3d]
djammusic: folds 
solbi86: folds 
matiko09: folds 
aseban11: folds 
RICKA16: folds 
Bothfeld11: folds 
sanpidk: raises $1.24 to $2.24
Pacifistas: calls $1.24
*** FLOP *** [3h Ks Qs]
sanpidk: bets $3
Pacifistas: calls $3
*** TURN *** [3h Ks Qs] [7c]
sanpidk: checks 
Pacifistas: bets $6.91
sanpidk: folds 
Uncalled bet ($6.91) returned to Pacifistas
Pacifistas collected $10.01 from pot
Pacifistas: doesn't show hand 
*** SUMMARY ***
Total pot $10.48 | Rake $0.47 
Board [3h Ks Qs 7c]
Seat 1: aseban11 folded before Flop (didn't bet)
Seat 2: RICKA16 folded before Flop (didn't bet)
Seat 4: Bothfeld11 (button) folded before Flop (didn't bet)
Seat 5: sanpidk (small blind) folded on the Turn
Seat 6: Pacifistas (big blind) collected ($10.01)
Seat 7: djammusic folded before Flop (didn't bet)
Seat 8: solbi86 folded before Flop (didn't bet)
Seat 9: matiko09 folded before Flop (didn't bet)





PokerStars Hand #150707361852:  Hold'em No Limit ($0.50/$1.00 USD) - 2016/03/21 16:57:41 CET [2016/03/21 11:57:41 ET]
Table 'Skadi III' 9-max Seat #5 is the button
Seat 1: R1aki ($100 in chips) 
Seat 2: aseban11 ($100 in chips) 
Seat 3: matiko09 ($101 in chips) 
Seat 4: ilaviiitech ($100 in chips) 
Seat 5: WaldiQ ($98.50 in chips) 
Seat 6: Pacifistas ($106.85 in chips) 
Seat 7: solbi86 ($120.66 in chips) 
Seat 8: volwebni4ek ($40 in chips) 
Seat 9: bradsheps ($139.31 in chips) 
Pacifistas: posts small blind $0.50
solbi86: posts big blind $1
*** HOLE CARDS ***
Dealt to matiko09 [7d 9h]
volwebni4ek: folds 
bradsheps: raises $2 to $3
R1aki: folds 
aseban11: folds 
matiko09: folds 
ilaviiitech: folds 
WaldiQ: calls $3
Pacifistas: folds 
solbi86: folds 
*** FLOP *** [Ts Jh 7c]
bradsheps: bets $4
WaldiQ: raises $8 to $12
bradsheps: raises $16 to $28
WaldiQ: folds 
Uncalled bet ($16) returned to bradsheps
bradsheps collected $30.08 from pot
*** SUMMARY ***
Total pot $31.50 | Rake $1.42 
Board [Ts Jh 7c]
Seat 1: R1aki folded before Flop (didn't bet)
Seat 2: aseban11 folded before Flop (didn't bet)
Seat 3: matiko09 folded before Flop (didn't bet)
Seat 4: ilaviiitech folded before Flop (didn't bet)
Seat 5: WaldiQ (button) folded on the Flop
Seat 6: Pacifistas (small blind) folded before Flop
Seat 7: solbi86 (big blind) folded before Flop
Seat 8: volwebni4ek folded before Flop (didn't bet)
Seat 9: bradsheps collected ($30.08)





PokerStars Hand #150707363163:  Hold'em No Limit ($0.50/$1.00 USD) - 2016/03/21 16:57:43 CET [2016/03/21 11:57:43 ET]
Table 'Marmulla II' 9-max Seat #7 is the button
Seat 1: hammerwife ($103 in chips) 
Seat 2: lumen21 ($100 in chips) 
Seat 3: Vikulja1993 ($100 in chips) 
Seat 4: gabi_igna ($100 in chips) 
Seat 5: maaaGik88 ($80.70 in chips) 
Seat 6: R1aki ($100 in chips) 
Seat 7: Pacifistas ($109.92 in chips) 
Seat 8: ilaviiitech ($113.06 in chips) 
Seat 9: matiko09 ($100 in chips) 
ilaviiitech: posts small blind $0.50
matiko09: posts big blind $1
*** HOLE CARDS ***
Dealt to matiko09 [9s Jh]
hammerwife: folds 
lumen21: folds 
Vikulja1993: folds 
gabi_igna: folds 
maaaGik88: folds 
R1aki: folds 
Pacifistas: raises $1.50 to $2.50
ilaviiitech: folds 
matiko09: calls $1.50
*** FLOP *** [6d 3c Ts]
matiko09: checks 
Pacifistas: bets $2.83
matiko09: folds 
Uncalled bet ($2.83) returned to Pacifistas
Pacifistas collected $5.25 from pot
Pacifistas: doesn't show hand 
*** SUMMARY ***
Total pot $5.50 | Rake $0.25 
Board [6d 3c Ts]
Seat 1: hammerwife folded before Flop (didn't bet)
Seat 2: lumen21 folded before Flop (didn't bet)
Seat 3: Vikulja1993 folded before Flop (didn't bet)
Seat 4: gabi_igna folded before Flop (didn't bet)
Seat 5: maaaGik88 folded before Flop (didn't bet)
Seat 6: R1aki folded before Flop (didn't bet)
Seat 7: Pacifistas (button) collected ($5.25)
Seat 8: ilaviiitech (small blind) folded before Flop
Seat 9: matiko09 (big blind) folded on the Flop





PokerStars Hand #150707369205:  Hold'em No Limit ($0.50/$1.00 USD) - 2016/03/21 16:57:52 CET [2016/03/21 11:57:52 ET]
Table 'Juhani' 9-max Seat #8 is the button
Seat 1: solbi86 ($100 in chips) 
Seat 5: Smartiecat ($101.28 in chips) 
Seat 6: Pacifistas ($100 in chips) 
Seat 7: matiko09 ($101 in chips) 
Seat 8: grifkaaa ($101 in chips) 
Seat 9: IntsAA ($96 in chips) 
IntsAA: posts small blind $0.50
solbi86: posts big blind $1
*** HOLE CARDS ***
Dealt to matiko09 [Qh 8h]
Smartiecat: folds 
Pacifistas: folds 
matiko09: raises $1.50 to $2.50
grifkaaa: folds 
IntsAA: folds 
solbi86: folds 
Uncalled bet ($1.50) returned to matiko09
matiko09 collected $2.50 from pot
matiko09: doesn't show hand 
*** SUMMARY ***
Total pot $2.50 | Rake $0 
Seat 1: solbi86 (big blind) folded before Flop
Seat 5: Smartiecat folded before Flop (didn't bet)
Seat 6: Pacifistas folded before Flop (didn't bet)
Seat 7: matiko09 collected ($2.50)
Seat 8: grifkaaa (button) folded before Flop (didn't bet)
Seat 9: IntsAA (small blind) folded before Flop





PokerStars Hand #150707370849:  Hold'em No Limit ($0.50/$1.00 USD) - 2016/03/21 16:57:55 CET [2016/03/21 11:57:55 ET]
Table 'Lucifer III' 9-max Seat #2 is the button
Seat 1: Pacifistas ($156.06 in chips) 
Seat 2: matiko09 ($109.58 in chips) 
Seat 3: Vizonto ($94.23 in chips) 
Seat 4: RICKA16 ($100 in chips) 
Seat 6: solbi86 ($127.50 in chips) 
Seat 7: roninio1 ($113.60 in chips) 
Seat 8: aseban11 ($119.05 in chips) 
Vizonto: posts small blind $0.50
RICKA16: posts big blind $1
cobrik23: sits out 
*** HOLE CARDS ***
Dealt to matiko09 [2d 5c]
solbi86: folds 
roninio1: raises $2 to $3
aseban11: folds 
Pacifistas: folds 
matiko09: folds 
Vizonto: calls $2.50
RICKA16: folds 
*** FLOP *** [Th Tc 9d]
Vizonto: checks 
roninio1: bets $2
Vizonto: folds 
Uncalled bet ($2) returned to roninio1
roninio1 collected $6.68 from pot
roninio1: doesn't show hand 
*** SUMMARY ***
Total pot $7 | Rake $0.32 
Board [Th Tc 9d]
Seat 1: Pacifistas folded before Flop (didn't bet)
Seat 2: matiko09 (button) folded before Flop (didn't bet)
Seat 3: Vizonto (small blind) folded on the Flop
Seat 4: RICKA16 (big blind) folded before Flop
Seat 6: solbi86 folded before Flop (didn't bet)
Seat 7: roninio1 collected ($6.68)
Seat 8: aseban11 folded before Flop (didn't bet)





PokerStars Hand #150707377035:  Hold'em No Limit ($0.50/$1.00 USD) - 2016/03/21 16:58:05 CET [2016/03/21 11:58:05 ET]
Table 'Noel' 9-max Seat #8 is the button
Seat 1: ep538 ($45.86 in chips) 
Seat 4: Kobiroga150 ($75.31 in chips) 
Seat 5: matiko09 ($133.57 in chips) 
Seat 6: hammerwife ($108.40 in chips) 
Seat 7: djammusic ($61.04 in chips) 
Seat 8: Dachish ($72.50 in chips) 
Seat 9: grifkaaa ($100 in chips) 
grifkaaa: posts small blind $0.50
ep538: posts big blind $1
cobrik23: sits out 
gabi_igna: sits out 
*** HOLE CARDS ***
Dealt to matiko09 [6d Qs]
Kobiroga150: folds 
matiko09: folds 
hammerwife: folds 
djammusic: raises $1.25 to $2.25
Dachish: folds 
grifkaaa: raises $5.75 to $8
ep538: folds 
djammusic: folds 
Uncalled bet ($5.75) returned to grifkaaa
grifkaaa collected $5.50 from pot
*** SUMMARY ***
Total pot $5.50 | Rake $0 
Seat 1: ep538 (big blind) folded before Flop
Seat 4: Kobiroga150 folded before Flop (didn't bet)
Seat 5: matiko09 folded before Flop (didn't bet)
Seat 6: hammerwife folded before Flop (didn't bet)
Seat 7: djammusic folded before Flop
Seat 8: Dachish (button) folded before Flop (didn't bet)
Seat 9: grifkaaa (small blind) collected ($5.50)





PokerStars Hand #150707378326:  Hold'em No Limit ($0.50/$1.00 USD) - 2016/03/21 16:58:07 CET [2016/03/21 11:58:07 ET]
Table 'Juhani' 9-max Seat #9 is the button
Seat 1: solbi86 ($100 in chips) 
Seat 5: Smartiecat ($101.28 in chips) 
Seat 6: Pacifistas ($100 in chips) 
Seat 7: matiko09 ($102.50 in chips) 
Seat 8: grifkaaa ($101 in chips) 
Seat 9: IntsAA ($96 in chips) 
solbi86: posts small blind $0.50
Smartiecat: posts big blind $1
*** HOLE CARDS ***
Dealt to matiko09 [5s 4h]
Pacifistas: folds 
matiko09: folds 
grifkaaa: folds 
IntsAA: folds 
solbi86: folds 
Uncalled bet ($0.50) returned to Smartiecat
SleepyGuns joins the table at seat #2 
Smartiecat collected $1 from pot
Smartiecat: doesn't show hand 
*** SUMMARY ***
Total pot $1 | Rake $0 
Seat 1: solbi86 (small blind) folded before Flop
Seat 5: Smartiecat (big blind) collected ($1)
Seat 6: Pacifistas folded before Flop (didn't bet)
Seat 7: matiko09 folded before Flop (didn't bet)
Seat 8: grifkaaa folded before Flop (didn't bet)
Seat 9: IntsAA (button) folded before Flop (didn't bet)





PokerStars Hand #150707387215:  Hold'em No Limit (€0.25/€0.50 EUR) - 2016/03/21 16:58:21 CET [2016/03/21 11:58:21 ET]
Table 'Auravictrix II' 9-max Seat #5 is the button
Seat 1: aponinho82 (€50.48 in chips) 
Seat 2: ffac (€56.10 in chips) 
Seat 3: matiko09 (€50 in chips) 
Seat 4: i am owsome (€98.25 in chips) 
Seat 5: nombraalne1 (€67.16 in chips) 
Seat 6: Devsteel (€50 in chips) 
Seat 7: vasiy379 (€50 in chips) 
Seat 8: ardo888 (€50 in chips) 
Seat 9: carlouchi (€41.90 in chips) 
Devsteel: posts small blind €0.25
vasiy379: posts big blind €0.50
*** HOLE CARDS ***
Dealt to matiko09 [7d 3s]
ardo888: raises €1 to €1.50
carlouchi: folds 
aponinho82: calls €1.50
ffac: folds 
matiko09: folds 
i am owsome: calls €1.50
nombraalne1: folds 
Devsteel: folds 
vasiy379: folds 
*** FLOP *** [9d 4s 8c]
ardo888: bets €2.65
aponinho82: folds 
i am owsome: folds 
Uncalled bet (€2.65) returned to ardo888
ardo888 collected €5.01 from pot
ardo888: doesn't show hand 
*** SUMMARY ***
Total pot €5.25 | Rake €0.24 
Board [9d 4s 8c]
Seat 1: aponinho82 folded on the Flop
Seat 2: ffac folded before Flop (didn't bet)
Seat 3: matiko09 folded before Flop (didn't bet)
Seat 4: i am owsome folded on the Flop
Seat 5: nombraalne1 (button) folded before Flop (didn't bet)
Seat 6: Devsteel (small blind) folded before Flop
Seat 7: vasiy379 (big blind) folded before Flop
Seat 8: ardo888 collected (€5.01)
Seat 9: carlouchi folded before Flop (didn't bet)





PokerStars Hand #150707394730:  Hold'em No Limit ($0.50/$1.00 USD) - 2016/03/21 16:58:32 CET [2016/03/21 11:58:32 ET]
Table 'Lucifer III' 9-max Seat #3 is the button
Seat 1: Pacifistas ($156.06 in chips) 
Seat 2: matiko09 ($109.58 in chips) 
Seat 3: Vizonto ($91.23 in chips) 
Seat 4: RICKA16 ($99 in chips) 
Seat 5: cobrik23 ($71.40 in chips) 
Seat 6: solbi86 ($127.50 in chips) 
Seat 7: roninio1 ($117.28 in chips) 
Seat 8: aseban11 ($119.05 in chips) 
RICKA16: posts small blind $0.50
cobrik23: posts big blind $1
*** HOLE CARDS ***
Dealt to matiko09 [4h 6d]
solbi86: folds 
roninio1: raises $2 to $3
aseban11: folds 
Pacifistas: folds 
matiko09: folds 
Vizonto: folds 
RICKA16: folds 
cobrik23: folds 
Uncalled bet ($2) returned to roninio1
roninio1 collected $2.50 from pot
roninio1: doesn't show hand 
*** SUMMARY ***
Total pot $2.50 | Rake $0 
Seat 1: Pacifistas folded before Flop (didn't bet)
Seat 2: matiko09 folded before Flop (didn't bet)
Seat 3: Vizonto (button) folded before Flop (didn't bet)
Seat 4: RICKA16 (small blind) folded before Flop
Seat 5: cobrik23 (big blind) folded before Flop
Seat 6: solbi86 folded before Flop (didn't bet)
Seat 7: roninio1 collected ($2.50)
Seat 8: aseban11 folded before Flop (didn't bet)





PokerStars Hand #150707394204:  Hold'em No Limit ($0.50/$1.00 USD) - 2016/03/21 16:58:32 CET [2016/03/21 11:58:32 ET]
Table 'Marmulla II' 9-max Seat #8 is the button
Seat 1: hammerwife ($103 in chips) 
Seat 2: lumen21 ($100 in chips) 
Seat 3: Vikulja1993 ($100 in chips) 
Seat 4: gabi_igna ($100 in chips) 
Seat 5: maaaGik88 ($80.70 in chips) 
Seat 6: R1aki ($100 in chips) 
Seat 7: Pacifistas ($112.67 in chips) 
Seat 8: ilaviiitech ($112.56 in chips) 
Seat 9: matiko09 ($100 in chips) 
matiko09: posts small blind $0.50
hammerwife: posts big blind $1
*** HOLE CARDS ***
Dealt to matiko09 [9s 5d]
lumen21: folds 
Vikulja1993: folds 
gabi_igna: raises $2 to $3
maaaGik88: folds 
R1aki: folds 
Pacifistas: calls $3
ilaviiitech: folds 
matiko09: folds 
hammerwife: folds 
*** FLOP *** [Js 9h Qd]
gabi_igna: checks 
Pacifistas: checks 
*** TURN *** [Js 9h Qd] [6c]
gabi_igna: bets $5
Pacifistas: folds 
Uncalled bet ($5) returned to gabi_igna
gabi_igna collected $7.16 from pot
gabi_igna: doesn't show hand 
*** SUMMARY ***
Total pot $7.50 | Rake $0.34 
Board [Js 9h Qd 6c]
Seat 1: hammerwife (big blind) folded before Flop
Seat 2: lumen21 folded before Flop (didn't bet)
Seat 3: Vikulja1993 folded before Flop (didn't bet)
Seat 4: gabi_igna collected ($7.16)
Seat 5: maaaGik88 folded before Flop (didn't bet)
Seat 6: R1aki folded before Flop (didn't bet)
Seat 7: Pacifistas folded on the Turn
Seat 8: ilaviiitech (button) folded before Flop (didn't bet)
Seat 9: matiko09 (small blind) folded before Flop





PokerStars Hand #150707404147:  Hold'em No Limit ($0.50/$1.00 USD) - 2016/03/21 16:58:47 CET [2016/03/21 11:58:47 ET]
Table 'Onnie II' 9-max Seat #5 is the button
Seat 1: aseban11 ($182.79 in chips) 
Seat 2: RICKA16 ($99.50 in chips) 
Seat 4: Bothfeld11 ($176.20 in chips) 
Seat 5: sanpidk ($100 in chips) 
Seat 6: Pacifistas ($104.77 in chips) 
Seat 7: djammusic ($78.40 in chips) 
Seat 8: solbi86 ($106.26 in chips) 
Seat 9: matiko09 ($116.69 in chips) 
Pacifistas: posts small blind $0.50
djammusic: posts big blind $1
*** HOLE CARDS ***
Dealt to matiko09 [3h Jh]
solbi86: folds 
matiko09: folds 
aseban11: folds 
RICKA16: folds 
Bothfeld11: raises $1 to $2
sanpidk: calls $2
Pacifistas: folds 
djammusic: folds 
*** FLOP *** [8d Jc 3s]
Bothfeld11: checks 
sanpidk: bets $3.50
Bothfeld11: folds 
Uncalled bet ($3.50) returned to sanpidk
sanpidk collected $5.25 from pot
sanpidk: doesn't show hand 
*** SUMMARY ***
Total pot $5.50 | Rake $0.25 
Board [8d Jc 3s]
Seat 1: aseban11 folded before Flop (didn't bet)
Seat 2: RICKA16 folded before Flop (didn't bet)
Seat 4: Bothfeld11 folded on the Flop
Seat 5: sanpidk (button) collected ($5.25)
Seat 6: Pacifistas (small blind) folded before Flop
Seat 7: djammusic (big blind) folded before Flop
Seat 8: solbi86 folded before Flop (didn't bet)
Seat 9: matiko09 folded before Flop (didn't bet)





PokerStars Hand #150707407086:  Hold'em No Limit ($0.50/$1.00 USD) - 2016/03/21 16:58:52 CET [2016/03/21 11:58:52 ET]
Table 'Juhani' 9-max Seat #1 is the button
Seat 1: solbi86 ($100 in chips) 
Seat 5: Smartiecat ($101.78 in chips) 
Seat 6: Pacifistas ($100 in chips) 
Seat 7: matiko09 ($102.50 in chips) 
Seat 8: grifkaaa ($101 in chips) 
Seat 9: IntsAA ($96 in chips) 
SleepyGuns will be allowed to play after the button
Smartiecat: posts small blind $0.50
Pacifistas: posts big blind $1
*** HOLE CARDS ***
Dealt to matiko09 [9h 4s]
matiko09: folds 
grifkaaa: raises $2 to $3
IntsAA: folds 
solbi86: folds 
Smartiecat: folds 
Pacifistas: folds 
Uncalled bet ($2) returned to grifkaaa
grifkaaa collected $2.50 from pot
*** SUMMARY ***
Total pot $2.50 | Rake $0 
Seat 1: solbi86 (button) folded before Flop (didn't bet)
Seat 5: Smartiecat (small blind) folded before Flop
Seat 6: Pacifistas (big blind) folded before Flop
Seat 7: matiko09 folded before Flop (didn't bet)
Seat 8: grifkaaa collected ($2.50)
Seat 9: IntsAA folded before Flop (didn't bet)





PokerStars Hand #150707412613:  Hold'em No Limit ($0.50/$1.00 USD) - 2016/03/21 16:59:00 CET [2016/03/21 11:59:00 ET]
Table 'Massalia II' 9-max Seat #5 is the button
Seat 1: crepke ($75.32 in chips) 
Seat 2: solbi86 ($254.46 in chips) 
Seat 3: 123chambo ($81.90 in chips) 
Seat 4: OriginalTony ($83.84 in chips) 
Seat 5: roninio1 ($21.52 in chips) 
Seat 6: Pacifistas ($137.47 in chips) 
Seat 7: flk.Dasas ($105 in chips) 
Seat 8: matiko09 ($174.71 in chips) 
Seat 9: hammerwife ($100 in chips) 
Pacifistas: posts small blind $0.50
flk.Dasas: posts big blind $1
crepke: posts the ante $0.20
solbi86: posts the ante $0.20
123chambo: posts the ante $0.20
OriginalTony: posts the ante $0.20
roninio1: posts the ante $0.20
Pacifistas: posts the ante $0.20
flk.Dasas: posts the ante $0.20
matiko09: posts the ante $0.20
hammerwife: posts the ante $0.20
*** HOLE CARDS ***
Dealt to matiko09 [4h Ad]
matiko09: folds 
hammerwife: raises $2 to $3
crepke: folds 
solbi86: folds 
123chambo: calls $3
OriginalTony: folds 
roninio1: folds 
roninio1 leaves the table
Pacifistas: folds 
Vikulja1993 joins the table at seat #5 
flk.Dasas: folds 
*** FLOP *** [Kh Qs Tc]
hammerwife: checks 
123chambo: checks 
*** TURN *** [Kh Qs Tc] [3h]
hammerwife: bets $6.50
123chambo: folds 
Uncalled bet ($6.50) returned to hammerwife
hammerwife collected $8.88 from pot
hammerwife: doesn't show hand 
*** SUMMARY ***
Total pot $9.30 | Rake $0.42 
Board [Kh Qs Tc 3h]
Seat 1: crepke folded before Flop (didn't bet)
Seat 2: solbi86 folded before Flop (didn't bet)
Seat 3: 123chambo folded on the Turn
Seat 4: OriginalTony folded before Flop (didn't bet)
Seat 5: roninio1 (button) folded before Flop (didn't bet)
Seat 6: Pacifistas (small blind) folded before Flop
Seat 7: flk.Dasas (big blind) folded before Flop
Seat 8: matiko09 folded before Flop (didn't bet)
Seat 9: hammerwife collected ($8.88)





PokerStars Hand #150707416836:  Hold'em No Limit ($0.50/$1.00 USD) - 2016/03/21 16:59:07 CET [2016/03/21 11:59:07 ET]
Table 'Lucifer III' 9-max Seat #4 is the button
Seat 1: Pacifistas ($156.06 in chips) 
Seat 2: matiko09 ($109.58 in chips) 
Seat 3: Vizonto ($91.23 in chips) 
Seat 4: RICKA16 ($98.50 in chips) 
Seat 5: cobrik23 ($70.40 in chips) 
Seat 6: solbi86 ($127.50 in chips) 
Seat 7: roninio1 ($118.78 in chips) 
Seat 8: aseban11 ($119.05 in chips) 
cobrik23: posts small blind $0.50
solbi86: posts big blind $1
*** HOLE CARDS ***
Dealt to matiko09 [3d 5c]
roninio1: folds 
aseban11: raises $2 to $3
Pacifistas: folds 
matiko09: folds 
Vizonto: raises $7.50 to $10.50
RICKA16: folds 
cobrik23: folds 
solbi86: folds 
aseban11: raises $16.50 to $27
Vizonto: calls $16.50
*** FLOP *** [2h Jc 7h]
aseban11: checks 
Vizonto: checks 
*** TURN *** [2h Jc 7h] [7s]
aseban11: bets $18
Vizonto: calls $18
*** RIVER *** [2h Jc 7h 7s] [6c]
aseban11: checks 
Vizonto: checks 
*** SHOW DOWN ***
aseban11: shows [Qh Qs] (two pair, Queens and Sevens)
Vizonto: mucks hand 
aseban11 collected $88.70 from pot
*** SUMMARY ***
Total pot $91.50 | Rake $2.80 
Board [2h Jc 7h 7s 6c]
Seat 1: Pacifistas folded before Flop (didn't bet)
Seat 2: matiko09 folded before Flop (didn't bet)
Seat 3: Vizonto mucked [Kc Ad]
Seat 4: RICKA16 (button) folded before Flop (didn't bet)
Seat 5: cobrik23 (small blind) folded before Flop
Seat 6: solbi86 (big blind) folded before Flop
Seat 7: roninio1 folded before Flop (didn't bet)
Seat 8: aseban11 showed [Qh Qs] and won ($88.70) with two pair, Queens and Sevens





PokerStars Hand #150707419902:  Hold'em No Limit ($0.50/$1.00 USD) - 2016/03/21 16:59:12 CET [2016/03/21 11:59:12 ET]
Table 'Juhani' 9-max Seat #5 is the button
Seat 1: solbi86 ($100 in chips) 
Seat 5: Smartiecat ($101.28 in chips) 
Seat 6: Pacifistas ($100 in chips) 
Seat 7: matiko09 ($102.50 in chips) 
Seat 8: grifkaaa ($102.50 in chips) 
Seat 9: IntsAA ($96 in chips) 
Pacifistas: posts small blind $0.50
matiko09: posts big blind $1
SleepyGuns: sits out 
*** HOLE CARDS ***
Dealt to matiko09 [As Ac]
grifkaaa: folds 
IntsAA: folds 
solbi86: folds 
Smartiecat: folds 
Pacifistas: raises $1.50 to $2.50
matiko09: raises $6 to $8.50
Pacifistas: calls $6
*** FLOP *** [Kh 2d Js]
Pacifistas: checks 
matiko09: bets $8.44
Pacifistas: calls $8.44
*** TURN *** [Kh 2d Js] [9h]
Pacifistas: checks 
matiko09: bets $21
lysandrafly joins the table at seat #3 
Pacifistas: folds 
Uncalled bet ($21) returned to matiko09
ka100pka527 joins the table at seat #4 
matiko09 collected $32.36 from pot
matiko09: doesn't show hand 
*** SUMMARY ***
Total pot $33.88 | Rake $1.52 
Board [Kh 2d Js 9h]
Seat 1: solbi86 folded before Flop (didn't bet)
Seat 5: Smartiecat (button) folded before Flop (didn't bet)
Seat 6: Pacifistas (small blind) folded on the Turn
Seat 7: matiko09 (big blind) collected ($32.36)
Seat 8: grifkaaa folded before Flop (didn't bet)
Seat 9: IntsAA folded before Flop (didn't bet)





PokerStars Hand #150707423029:  Hold'em No Limit ($0.50/$1.00 USD) - 2016/03/21 16:59:17 CET [2016/03/21 11:59:17 ET]
Table 'Noel' 9-max Seat #9 is the button
Seat 1: ep538 ($44.86 in chips) 
Seat 2: cobrik23 ($161.90 in chips) 
Seat 4: Kobiroga150 ($75.31 in chips) 
Seat 5: matiko09 ($133.57 in chips) 
Seat 6: hammerwife ($108.40 in chips) 
Seat 7: djammusic ($58.79 in chips) 
Seat 8: Dachish ($72.50 in chips) 
Seat 9: grifkaaa ($103.25 in chips) 
ep538: posts small blind $0.50
cobrik23: posts big blind $1
gabi_igna: sits out 
*** HOLE CARDS ***
Dealt to matiko09 [3c Ah]
Kobiroga150: folds 
matiko09: folds 
hammerwife: folds 
djammusic: folds 
Dachish: raises $1.50 to $2.50
grifkaaa: folds 
ep538: folds 
cobrik23: folds 
Uncalled bet ($1.50) returned to Dachish
Dachish collected $2.50 from pot
Dachish: doesn't show hand 
*** SUMMARY ***
Total pot $2.50 | Rake $0 
Seat 1: ep538 (small blind) folded before Flop
Seat 2: cobrik23 (big blind) folded before Flop
Seat 4: Kobiroga150 folded before Flop (didn't bet)
Seat 5: matiko09 folded before Flop (didn't bet)
Seat 6: hammerwife folded before Flop (didn't bet)
Seat 7: djammusic folded before Flop (didn't bet)
Seat 8: Dachish collected ($2.50)
Seat 9: grifkaaa (button) folded before Flop (didn't bet)





PokerStars Hand #150707424873:  Hold'em No Limit ($0.50/$1.00 USD) - 2016/03/21 16:59:20 CET [2016/03/21 11:59:20 ET]
Table 'Skadi III' 9-max Seat #6 is the button
Seat 1: R1aki ($100 in chips) 
Seat 2: aseban11 ($100 in chips) 
Seat 3: matiko09 ($101 in chips) 
Seat 4: ilaviiitech ($100 in chips) 
Seat 5: WaldiQ ($83.50 in chips) 
Seat 6: Pacifistas ($106.35 in chips) 
Seat 7: solbi86 ($119.66 in chips) 
Seat 8: volwebni4ek ($40 in chips) 
Seat 9: bradsheps ($154.39 in chips) 
solbi86: posts small blind $0.50
volwebni4ek: posts big blind $1
*** HOLE CARDS ***
Dealt to matiko09 [7s 8h]
bradsheps: folds 
R1aki: folds 
aseban11: folds 
matiko09: folds 
ilaviiitech: folds 
WaldiQ: folds 
Pacifistas: folds 
solbi86: folds 
Uncalled bet ($0.50) returned to volwebni4ek
volwebni4ek collected $1 from pot
volwebni4ek: doesn't show hand 
*** SUMMARY ***
Total pot $1 | Rake $0 
Seat 1: R1aki folded before Flop (didn't bet)
Seat 2: aseban11 folded before Flop (didn't bet)
Seat 3: matiko09 folded before Flop (didn't bet)
Seat 4: ilaviiitech folded before Flop (didn't bet)
Seat 5: WaldiQ folded before Flop (didn't bet)
Seat 6: Pacifistas (button) folded before Flop (didn't bet)
Seat 7: solbi86 (small blind) folded before Flop
Seat 8: volwebni4ek (big blind) collected ($1)
Seat 9: bradsheps folded before Flop (didn't bet)





PokerStars Hand #150707425841:  Hold'em No Limit ($0.50/$1.00 USD) - 2016/03/21 16:59:21 CET [2016/03/21 11:59:21 ET]
Table 'Marmulla II' 9-max Seat #9 is the button
Seat 1: hammerwife ($102 in chips) 
Seat 2: lumen21 ($100 in chips) 
Seat 3: Vikulja1993 ($100 in chips) 
Seat 4: gabi_igna ($104.16 in chips) 
Seat 5: maaaGik88 ($80.70 in chips) 
Seat 6: R1aki ($100 in chips) 
Seat 7: Pacifistas ($109.67 in chips) 
Seat 8: ilaviiitech ($112.56 in chips) 
Seat 9: matiko09 ($100 in chips) 
hammerwife: posts small blind $0.50
lumen21: posts big blind $1
*** HOLE CARDS ***
Dealt to matiko09 [5c 9c]
Vikulja1993: folds 
gabi_igna: folds 
maaaGik88: folds 
R1aki: folds 
Pacifistas: folds 
ilaviiitech: folds 
matiko09: folds 
hammerwife: folds 
Uncalled bet ($0.50) returned to lumen21
lumen21 collected $1 from pot
lumen21: doesn't show hand 
*** SUMMARY ***
Total pot $1 | Rake $0 
Seat 1: hammerwife (small blind) folded before Flop
Seat 2: lumen21 (big blind) collected ($1)
Seat 3: Vikulja1993 folded before Flop (didn't bet)
Seat 4: gabi_igna folded before Flop (didn't bet)
Seat 5: maaaGik88 folded before Flop (didn't bet)
Seat 6: R1aki folded before Flop (didn't bet)
Seat 7: Pacifistas folded before Flop (didn't bet)
Seat 8: ilaviiitech folded before Flop (didn't bet)
Seat 9: matiko09 (button) folded before Flop (didn't bet)





PokerStars Hand #150707433511:  Hold'em No Limit ($0.50/$1.00 USD) - 2016/03/21 16:59:33 CET [2016/03/21 11:59:33 ET]
Table 'Icarion II' 9-max Seat #5 is the button
Seat 1: forsmthgood ($105.53 in chips) 
Seat 2: aseban11 ($102.75 in chips) 
Seat 3: volwebni4ek ($40 in chips) 
Seat 4: teukka8 ($47.29 in chips) 
Seat 5: SanychStar ($100 in chips) 
Seat 6: solbi86 ($113.22 in chips) 
Seat 7: Pacifistas ($100 in chips) 
Seat 8: matiko09 ($100 in chips) 
Seat 9: R1aki ($135.26 in chips) 
solbi86: posts small blind $0.50
Pacifistas: posts big blind $1
*** HOLE CARDS ***
Dealt to matiko09 [9h 2d]
matiko09: folds 
R1aki: folds 
forsmthgood: folds 
aseban11: folds 
volwebni4ek: folds 
teukka8: folds 
SanychStar: raises $1.50 to $2.50
solbi86: folds 
Pacifistas: folds 
Uncalled bet ($1.50) returned to SanychStar
SanychStar collected $2.50 from pot
*** SUMMARY ***
Total pot $2.50 | Rake $0 
Seat 1: forsmthgood folded before Flop (didn't bet)
Seat 2: aseban11 folded before Flop (didn't bet)
Seat 3: volwebni4ek folded before Flop (didn't bet)
Seat 4: teukka8 folded before Flop (didn't bet)
Seat 5: SanychStar (button) collected ($2.50)
Seat 6: solbi86 (small blind) folded before Flop
Seat 7: Pacifistas (big blind) folded before Flop
Seat 8: matiko09 folded before Flop (didn't bet)
Seat 9: R1aki folded before Flop (didn't bet)





PokerStars Hand #150707434336:  Hold'em No Limit ($0.50/$1.00 USD) - 2016/03/21 16:59:34 CET [2016/03/21 11:59:34 ET]
Table 'Onnie II' 9-max Seat #6 is the button
Seat 1: aseban11 ($182.79 in chips) 
Seat 2: RICKA16 ($99.50 in chips) 
Seat 4: Bothfeld11 ($174.20 in chips) 
Seat 5: sanpidk ($103.25 in chips) 
Seat 6: Pacifistas ($104.27 in chips) 
Seat 7: djammusic ($77.40 in chips) 
Seat 8: solbi86 ($106.26 in chips) 
Seat 9: matiko09 ($116.69 in chips) 
djammusic: posts small blind $0.50
solbi86: posts big blind $1
*** HOLE CARDS ***
Dealt to matiko09 [4s 8s]
matiko09: folds 
aseban11: folds 
RICKA16: folds 
Bothfeld11: calls $1
sanpidk: folds 
Pacifistas: folds 
djammusic: folds 
solbi86: raises $3 to $4
Bothfeld11: calls $3
*** FLOP *** [4h 9d 8d]
solbi86: bets $5
Bothfeld11: raises $9.06 to $14.06
solbi86: folds 
Uncalled bet ($9.06) returned to Bothfeld11
Bothfeld11 collected $17.67 from pot
Bothfeld11: shows [4d]
*** SUMMARY ***
Total pot $18.50 | Rake $0.83 
Board [4h 9d 8d]
Seat 1: aseban11 folded before Flop (didn't bet)
Seat 2: RICKA16 folded before Flop (didn't bet)
Seat 4: Bothfeld11 collected ($17.67)
Seat 5: sanpidk folded before Flop (didn't bet)
Seat 6: Pacifistas (button) folded before Flop (didn't bet)
Seat 7: djammusic (small blind) folded before Flop
Seat 8: solbi86 (big blind) folded on the Flop
Seat 9: matiko09 folded before Flop (didn't bet)





PokerStars Hand #150707435718:  Hold'em No Limit (€0.25/€0.50 EUR) - 2016/03/21 16:59:37 CET [2016/03/21 11:59:37 ET]
Table 'Auravictrix II' 9-max Seat #6 is the button
Seat 1: aponinho82 (€48.98 in chips) 
Seat 2: ffac (€56.10 in chips) 
Seat 3: matiko09 (€50 in chips) 
Seat 4: i am owsome (€96.75 in chips) 
Seat 5: nombraalne1 (€67.16 in chips) 
Seat 6: Devsteel (€50 in chips) 
Seat 7: vasiy379 (€50 in chips) 
Seat 8: ardo888 (€53.51 in chips) 
Seat 9: carlouchi (€41.90 in chips) 
vasiy379: posts small blind €0.25
ardo888: posts big blind €0.50
*** HOLE CARDS ***
Dealt to matiko09 [Ac Ts]
carlouchi: calls €0.50
aponinho82: folds 
ffac: raises €1.50 to €2
matiko09: folds 
i am owsome: folds 
nombraalne1: folds 
Devsteel: folds 
vasiy379: folds 
ardo888: folds 
carlouchi: folds 
Uncalled bet (€1.50) returned to ffac
ffac collected €1.75 from pot
ffac: doesn't show hand 
*** SUMMARY ***
Total pot €1.75 | Rake €0 
Seat 1: aponinho82 folded before Flop (didn't bet)
Seat 2: ffac collected (€1.75)
Seat 3: matiko09 folded before Flop (didn't bet)
Seat 4: i am owsome folded before Flop (didn't bet)
Seat 5: nombraalne1 folded before Flop (didn't bet)
Seat 6: Devsteel (button) folded before Flop (didn't bet)
Seat 7: vasiy379 (small blind) folded before Flop
Seat 8: ardo888 (big blind) folded before Flop
Seat 9: carlouchi folded before Flop





PokerStars Hand #150707438672:  Hold'em No Limit ($0.50/$1.00 USD) - 2016/03/21 16:59:41 CET [2016/03/21 11:59:41 ET]
Table 'Noel' 9-max Seat #1 is the button
Seat 1: ep538 ($44.36 in chips) 
Seat 2: cobrik23 ($160.90 in chips) 
Seat 3: gabi_igna ($176.84 in chips) 
Seat 4: Kobiroga150 ($75.31 in chips) 
Seat 5: matiko09 ($133.57 in chips) 
Seat 6: hammerwife ($108.40 in chips) 
Seat 7: djammusic ($58.79 in chips) 
Seat 8: Dachish ($74 in chips) 
Seat 9: grifkaaa ($103.25 in chips) 
cobrik23: posts small blind $0.50
gabi_igna: posts big blind $1
*** HOLE CARDS ***
Dealt to matiko09 [Jh 5c]
Kobiroga150: calls $1
matiko09: folds 
hammerwife: folds 
djammusic: folds 
Dachish: folds 
grifkaaa: folds 
ep538: calls $1
cobrik23: folds 
gabi_igna: checks 
*** FLOP *** [9h 3s Jc]
gabi_igna: checks 
Kobiroga150: bets $2
ep538: calls $2
gabi_igna: folds 
*** TURN *** [9h 3s Jc] [5d]
Kobiroga150: checks 
ep538: checks 
*** RIVER *** [9h 3s Jc 5d] [8d]
Kobiroga150: checks 
ep538: checks 
*** SHOW DOWN ***
Kobiroga150: shows [Ks Qh] (high card King)
ep538: shows [8c Qc] (a pair of Eights)
ep538 collected $7.16 from pot
*** SUMMARY ***
Total pot $7.50 | Rake $0.34 
Board [9h 3s Jc 5d 8d]
Seat 1: ep538 (button) showed [8c Qc] and won ($7.16) with a pair of Eights
Seat 2: cobrik23 (small blind) folded before Flop
Seat 3: gabi_igna (big blind) folded on the Flop
Seat 4: Kobiroga150 showed [Ks Qh] and lost with high card King
Seat 5: matiko09 folded before Flop (didn't bet)
Seat 6: hammerwife folded before Flop (didn't bet)
Seat 7: djammusic folded before Flop (didn't bet)
Seat 8: Dachish folded before Flop (didn't bet)
Seat 9: grifkaaa folded before Flop (didn't bet)





PokerStars Hand #150707447848:  Hold'em No Limit ($0.50/$1.00 USD) - 2016/03/21 16:59:56 CET [2016/03/21 11:59:56 ET]
Table 'Massalia II' 9-max Seat #6 is the button
Seat 1: crepke ($75.12 in chips) 
Seat 2: solbi86 ($254.26 in chips) 
Seat 3: 123chambo ($78.70 in chips) 
Seat 4: OriginalTony ($83.64 in chips) 
Seat 6: Pacifistas ($136.77 in chips) 
Seat 7: flk.Dasas ($103.80 in chips) 
Seat 8: matiko09 ($174.51 in chips) 
Seat 9: hammerwife ($105.68 in chips) 
flk.Dasas: posts small blind $0.50
matiko09: posts big blind $1
Vikulja1993: sits out 
crepke: posts the ante $0.20
solbi86: posts the ante $0.20
123chambo: posts the ante $0.20
OriginalTony: posts the ante $0.20
Pacifistas: posts the ante $0.20
flk.Dasas: posts the ante $0.20
matiko09: posts the ante $0.20
hammerwife: posts the ante $0.20
*** HOLE CARDS ***
Dealt to matiko09 [Qc 6h]
hammerwife: folds 
crepke: folds 
solbi86: folds 
123chambo: folds 
OriginalTony: folds 
Pacifistas: raises $1.50 to $2.50
flk.Dasas: folds 
matiko09: folds 
Uncalled bet ($1.50) returned to Pacifistas
Pacifistas collected $4.10 from pot
Pacifistas: doesn't show hand 
*** SUMMARY ***
Total pot $4.10 | Rake $0 
Seat 1: crepke folded before Flop (didn't bet)
Seat 2: solbi86 folded before Flop (didn't bet)
Seat 3: 123chambo folded before Flop (didn't bet)
Seat 4: OriginalTony folded before Flop (didn't bet)
Seat 6: Pacifistas (button) collected ($4.10)
Seat 7: flk.Dasas (small blind) folded before Flop
Seat 8: matiko09 (big blind) folded before Flop
Seat 9: hammerwife folded before Flop (didn't bet)





PokerStars Hand #150707451102:  Hold'em No Limit ($0.50/$1.00 USD) - 2016/03/21 17:00:01 CET [2016/03/21 12:00:01 ET]
Table 'Skadi III' 9-max Seat #7 is the button
Seat 1: R1aki ($100 in chips) 
Seat 2: aseban11 ($100 in chips) 
Seat 3: matiko09 ($101 in chips) 
Seat 4: ilaviiitech ($100 in chips) 
Seat 5: WaldiQ ($100 in chips) 
Seat 6: Pacifistas ($106.35 in chips) 
Seat 7: solbi86 ($119.16 in chips) 
Seat 8: volwebni4ek ($40.50 in chips) 
Seat 9: bradsheps ($154.39 in chips) 
volwebni4ek: posts small blind $0.50
bradsheps: posts big blind $1
*** HOLE CARDS ***
Dealt to matiko09 [Ts 6d]
R1aki: folds 
R1aki leaves the table
aseban11: folds 
CI58 joins the table at seat #1 
matiko09: folds 
ilaviiitech: folds 
WaldiQ: folds 
Pacifistas: raises $1.50 to $2.50
solbi86: folds 
volwebni4ek: folds 
bradsheps: calls $1.50
*** FLOP *** [Ad 3s 9d]
bradsheps: checks 
Pacifistas: checks 
*** TURN *** [Ad 3s 9d] [Jd]
bradsheps: bets $3
Pacifistas: calls $3
*** RIVER *** [Ad 3s 9d Jd] [2s]
bradsheps: bets $6
Pacifistas: folds 
Uncalled bet ($6) returned to bradsheps
bradsheps collected $10.98 from pot
*** SUMMARY ***
Total pot $11.50 | Rake $0.52 
Board [Ad 3s 9d Jd 2s]
Seat 1: R1aki folded before Flop (didn't bet)
Seat 2: aseban11 folded before Flop (didn't bet)
Seat 3: matiko09 folded before Flop (didn't bet)
Seat 4: ilaviiitech folded before Flop (didn't bet)
Seat 5: WaldiQ folded before Flop (didn't bet)
Seat 6: Pacifistas folded on the River
Seat 7: solbi86 (button) folded before Flop (didn't bet)
Seat 8: volwebni4ek (small blind) folded before Flop
Seat 9: bradsheps (big blind) collected ($10.98)





PokerStars Hand #150707452758:  Hold'em No Limit ($0.50/$1.00 USD) - 2016/03/21 17:00:03 CET [2016/03/21 12:00:03 ET]
Table 'Marmulla II' 9-max Seat #1 is the button
Seat 1: hammerwife ($101.50 in chips) 
Seat 2: lumen21 ($100.50 in chips) 
Seat 3: Vikulja1993 ($100 in chips) 
Seat 4: gabi_igna ($104.16 in chips) 
Seat 5: maaaGik88 ($80.70 in chips) 
Seat 6: R1aki ($100 in chips) 
Seat 7: Pacifistas ($109.67 in chips) 
Seat 8: ilaviiitech ($112.56 in chips) 
Seat 9: matiko09 ($100 in chips) 
lumen21: posts small blind $0.50
Vikulja1993: posts big blind $1
*** HOLE CARDS ***
Dealt to matiko09 [6h 3c]
gabi_igna: folds 
maaaGik88: raises $1 to $2
R1aki: folds 
Pacifistas: folds 
ilaviiitech: calls $2
matiko09: folds 
hammerwife: folds 
lumen21: folds 
Vikulja1993: folds 
*** FLOP *** [Td 9h Kd]
maaaGik88: bets $2.62
ilaviiitech: calls $2.62
*** TURN *** [Td 9h Kd] [4c]
maaaGik88: bets $5
ilaviiitech: folds 
Uncalled bet ($5) returned to maaaGik88
maaaGik88 collected $10.26 from pot
maaaGik88: doesn't show hand 
*** SUMMARY ***
Total pot $10.74 | Rake $0.48 
Board [Td 9h Kd 4c]
Seat 1: hammerwife (button) folded before Flop (didn't bet)
Seat 2: lumen21 (small blind) folded before Flop
Seat 3: Vikulja1993 (big blind) folded before Flop
Seat 4: gabi_igna folded before Flop (didn't bet)
Seat 5: maaaGik88 collected ($10.26)
Seat 6: R1aki folded before Flop (didn't bet)
Seat 7: Pacifistas folded before Flop (didn't bet)
Seat 8: ilaviiitech folded on the Turn
Seat 9: matiko09 folded before Flop (didn't bet)





PokerStars Hand #150707457775:  Hold'em No Limit (€0.25/€0.50 EUR) - 2016/03/21 17:00:11 CET [2016/03/21 12:00:11 ET]
Table 'Auravictrix II' 9-max Seat #7 is the button
Seat 1: aponinho82 (€48.98 in chips) 
Seat 2: ffac (€57.35 in chips) 
Seat 3: matiko09 (€50 in chips) 
Seat 4: i am owsome (€96.75 in chips) 
Seat 5: nombraalne1 (€67.16 in chips) 
Seat 6: Devsteel (€50 in chips) 
Seat 7: vasiy379 (€50 in chips) 
Seat 8: ardo888 (€53.01 in chips) 
Seat 9: carlouchi (€41.40 in chips) 
ardo888: posts small blind €0.25
carlouchi: posts big blind €0.50
*** HOLE CARDS ***
Dealt to matiko09 [Qs 4d]
aponinho82: calls €0.50
ffac: folds 
matiko09: folds 
i am owsome: raises €1.50 to €2
nombraalne1: folds 
Devsteel: folds 
vasiy379: calls €2
ardo888: raises €7 to €9
carlouchi: folds 
aponinho82: folds 
i am owsome: folds 
vasiy379: folds 
Uncalled bet (€7) returned to ardo888
ardo888 collected €7 from pot
ardo888: doesn't show hand 
*** SUMMARY ***
Total pot €7 | Rake €0 
Seat 1: aponinho82 folded before Flop
Seat 2: ffac folded before Flop (didn't bet)
Seat 3: matiko09 folded before Flop (didn't bet)
Seat 4: i am owsome folded before Flop
Seat 5: nombraalne1 folded before Flop (didn't bet)
Seat 6: Devsteel folded before Flop (didn't bet)
Seat 7: vasiy379 (button) folded before Flop
Seat 8: ardo888 (small blind) collected (€7)
Seat 9: carlouchi (big blind) folded before Flop





PokerStars Hand #150707459533:  Hold'em No Limit ($0.50/$1.00 USD) - 2016/03/21 17:00:14 CET [2016/03/21 12:00:14 ET]
Table 'Lucifer III' 9-max Seat #5 is the button
Seat 1: Pacifistas ($156.06 in chips) 
Seat 2: matiko09 ($109.58 in chips) 
Seat 3: Vizonto ($46.23 in chips) 
Seat 4: RICKA16 ($98.50 in chips) 
Seat 5: cobrik23 ($69.90 in chips) 
Seat 6: solbi86 ($126.50 in chips) 
Seat 7: roninio1 ($118.78 in chips) 
Seat 8: aseban11 ($162.75 in chips) 
solbi86: posts small blind $0.50
roninio1: posts big blind $1
mycka86: sits out 
*** HOLE CARDS ***
Dealt to matiko09 [Qh 4c]
aseban11: folds 
Pacifistas: folds 
matiko09: folds 
Vizonto: calls $1
RICKA16: folds 
cobrik23: folds 
solbi86: folds 
roninio1: checks 
*** FLOP *** [7h 6d Ah]
roninio1: checks 
Vizonto: checks 
*** TURN *** [7h 6d Ah] [9s]
roninio1: checks 
Vizonto: checks 
*** RIVER *** [7h 6d Ah 9s] [As]
roninio1: checks 
Vizonto: checks 
*** SHOW DOWN ***
roninio1: shows [4d 4s] (two pair, Aces and Fours)
Vizonto: mucks hand 
roninio1 collected $2.39 from pot
*** SUMMARY ***
Total pot $2.50 | Rake $0.11 
Board [7h 6d Ah 9s As]
Seat 1: Pacifistas folded before Flop (didn't bet)
Seat 2: matiko09 folded before Flop (didn't bet)
Seat 3: Vizonto mucked [Qc 2c]
Seat 4: RICKA16 folded before Flop (didn't bet)
Seat 5: cobrik23 (button) folded before Flop (didn't bet)
Seat 6: solbi86 (small blind) folded before Flop
Seat 7: roninio1 (big blind) showed [4d 4s] and won ($2.39) with two pair, Aces and Fours
Seat 8: aseban11 folded before Flop (didn't bet)





PokerStars Hand #150707461300:  Hold'em No Limit ($0.50/$1.00 USD) - 2016/03/21 17:00:16 CET [2016/03/21 12:00:16 ET]
Table 'Icarion II' 9-max Seat #6 is the button
Seat 1: forsmthgood ($105.53 in chips) 
Seat 2: aseban11 ($102.75 in chips) 
Seat 3: volwebni4ek ($40 in chips) 
Seat 4: teukka8 ($47.29 in chips) 
Seat 5: SanychStar ($101.50 in chips) 
Seat 6: solbi86 ($112.72 in chips) 
Seat 7: Pacifistas ($100 in chips) 
Seat 8: matiko09 ($100 in chips) 
Seat 9: R1aki ($135.26 in chips) 
Pacifistas: posts small blind $0.50
matiko09: posts big blind $1
*** HOLE CARDS ***
Dealt to matiko09 [As Kc]
R1aki: folds 
forsmthgood: raises $2 to $3
aseban11: folds 
volwebni4ek: folds 
teukka8: calls $3
SanychStar: folds 
solbi86: calls $3
Pacifistas: calls $2.50
matiko09: raises $13 to $16
forsmthgood: folds 
teukka8: folds 
solbi86: folds 
Pacifistas: folds 
Uncalled bet ($13) returned to matiko09
matiko09 collected $15 from pot
matiko09: doesn't show hand 
*** SUMMARY ***
Total pot $15 | Rake $0 
Seat 1: forsmthgood folded before Flop
Seat 2: aseban11 folded before Flop (didn't bet)
Seat 3: volwebni4ek folded before Flop (didn't bet)
Seat 4: teukka8 folded before Flop
Seat 5: SanychStar folded before Flop (didn't bet)
Seat 6: solbi86 (button) folded before Flop
Seat 7: Pacifistas (small blind) folded before Flop
Seat 8: matiko09 (big blind) collected ($15)
Seat 9: R1aki folded before Flop (didn't bet)





PokerStars Hand #150707469552:  Hold'em No Limit ($0.50/$1.00 USD) - 2016/03/21 17:00:29 CET [2016/03/21 12:00:29 ET]
Table 'Massalia II' 9-max Seat #7 is the button
Seat 1: crepke ($74.92 in chips) 
Seat 2: solbi86 ($254.06 in chips) 
Seat 3: 123chambo ($78.50 in chips) 
Seat 4: OriginalTony ($83.44 in chips) 
Seat 6: Pacifistas ($139.67 in chips) 
Seat 7: flk.Dasas ($103.10 in chips) 
Seat 8: matiko09 ($173.31 in chips) 
Seat 9: hammerwife ($105.48 in chips) 
matiko09: posts small blind $0.50
hammerwife: posts big blind $1
Vikulja1993: sits out 
crepke: posts the ante $0.20
solbi86: posts the ante $0.20
123chambo: posts the ante $0.20
OriginalTony: posts the ante $0.20
Pacifistas: posts the ante $0.20
flk.Dasas: posts the ante $0.20
matiko09: posts the ante $0.20
hammerwife: posts the ante $0.20
*** HOLE CARDS ***
Dealt to matiko09 [9s 7h]
crepke: folds 
solbi86: raises $2 to $3
123chambo: folds 
OriginalTony: folds 
Pacifistas: folds 
flk.Dasas: folds 
matiko09: folds 
hammerwife: folds 
Uncalled bet ($2) returned to solbi86
solbi86 collected $4.10 from pot
solbi86: doesn't show hand 
*** SUMMARY ***
Total pot $4.10 | Rake $0 
Seat 1: crepke folded before Flop (didn't bet)
Seat 2: solbi86 collected ($4.10)
Seat 3: 123chambo folded before Flop (didn't bet)
Seat 4: OriginalTony folded before Flop (didn't bet)
Seat 6: Pacifistas folded before Flop (didn't bet)
Seat 7: flk.Dasas (button) folded before Flop (didn't bet)
Seat 8: matiko09 (small blind) folded before Flop
Seat 9: hammerwife (big blind) folded before Flop





PokerStars Hand #150707480704:  Hold'em No Limit ($0.50/$1.00 USD) - 2016/03/21 17:00:45 CET [2016/03/21 12:00:45 ET]
Table 'Noel' 9-max Seat #2 is the button
Seat 1: ep538 ($48.52 in chips) 
Seat 2: cobrik23 ($160.40 in chips) 
Seat 3: gabi_igna ($175.84 in chips) 
Seat 4: Kobiroga150 ($72.31 in chips) 
Seat 5: matiko09 ($133.57 in chips) 
Seat 6: hammerwife ($108.40 in chips) 
Seat 7: djammusic ($58.79 in chips) 
Seat 8: Dachish ($74 in chips) 
Seat 9: grifkaaa ($103.25 in chips) 
gabi_igna: posts small blind $0.50
Kobiroga150: posts big blind $1
*** HOLE CARDS ***
Dealt to matiko09 [2s 8s]
matiko09: folds 
hammerwife: folds 
djammusic: folds 
Dachish: folds 
grifkaaa: folds 
ep538: folds 
cobrik23: raises $2 to $3
gabi_igna: folds 
Kobiroga150: folds 
Uncalled bet ($2) returned to cobrik23
cobrik23 collected $2.50 from pot
cobrik23: doesn't show hand 
*** SUMMARY ***
Total pot $2.50 | Rake $0 
Seat 1: ep538 folded before Flop (didn't bet)
Seat 2: cobrik23 (button) collected ($2.50)
Seat 3: gabi_igna (small blind) folded before Flop
Seat 4: Kobiroga150 (big blind) folded before Flop
Seat 5: matiko09 folded before Flop (didn't bet)
Seat 6: hammerwife folded before Flop (didn't bet)
Seat 7: djammusic folded before Flop (didn't bet)
Seat 8: Dachish folded before Flop (didn't bet)
Seat 9: grifkaaa folded before Flop (didn't bet)





PokerStars Hand #150707482852:  Hold'em No Limit ($0.50/$1.00 USD) - 2016/03/21 17:00:48 CET [2016/03/21 12:00:48 ET]
Table 'Onnie II' 9-max Seat #7 is the button
Seat 1: aseban11 ($182.79 in chips) 
Seat 2: RICKA16 ($99.50 in chips) 
Seat 4: Bothfeld11 ($182.87 in chips) 
Seat 5: sanpidk ($103.25 in chips) 
Seat 6: Pacifistas ($104.27 in chips) 
Seat 7: djammusic ($76.90 in chips) 
Seat 8: solbi86 ($100 in chips) 
Seat 9: matiko09 ($116.69 in chips) 
solbi86: posts small blind $0.50
matiko09: posts big blind $1
cn_chayanne: sits out 
*** HOLE CARDS ***
Dealt to matiko09 [3c 7h]
aseban11: folds 
RICKA16: folds 
Bothfeld11: folds 
sanpidk: raises $1.50 to $2.50
Pacifistas: folds 
djammusic: folds 
solbi86: folds 
matiko09: folds 
Uncalled bet ($1.50) returned to sanpidk
sanpidk collected $2.50 from pot
sanpidk: doesn't show hand 
*** SUMMARY ***
Total pot $2.50 | Rake $0 
Seat 1: aseban11 folded before Flop (didn't bet)
Seat 2: RICKA16 folded before Flop (didn't bet)
Seat 4: Bothfeld11 folded before Flop (didn't bet)
Seat 5: sanpidk collected ($2.50)
Seat 6: Pacifistas folded before Flop (didn't bet)
Seat 7: djammusic (button) folded before Flop (didn't bet)
Seat 8: solbi86 (small blind) folded before Flop
Seat 9: matiko09 (big blind) folded before Flop





PokerStars Hand #150707485776:  Hold'em No Limit ($0.50/$1.00 USD) - 2016/03/21 17:00:53 CET [2016/03/21 12:00:53 ET]
Table 'Lucifer III' 9-max Seat #6 is the button
Seat 1: Pacifistas ($156.06 in chips) 
Seat 2: matiko09 ($109.58 in chips) 
Seat 3: Vizonto ($45.23 in chips) 
Seat 4: RICKA16 ($98.50 in chips) 
Seat 5: cobrik23 ($69.90 in chips) 
Seat 6: solbi86 ($126 in chips) 
Seat 7: roninio1 ($120.17 in chips) 
Seat 8: aseban11 ($162.75 in chips) 
roninio1: posts small blind $0.50
aseban11: posts big blind $1
mycka86: sits out 
*** HOLE CARDS ***
Dealt to matiko09 [3h 8c]
Pacifistas: raises $2 to $3
matiko09: folds 
Vizonto: folds 
RICKA16: folds 
cobrik23: folds 
solbi86: folds 
roninio1: calls $2.50
aseban11: folds 
*** FLOP *** [5s 9h Jh]
roninio1: checks 
Pacifistas: checks 
*** TURN *** [5s 9h Jh] [7s]
roninio1: checks 
Pacifistas: bets $3.60
roninio1: raises $113.57 to $117.17 and is all-in
Pacifistas: folds 
Uncalled bet ($113.57) returned to roninio1
roninio1 collected $13.56 from pot
roninio1: doesn't show hand 
*** SUMMARY ***
Total pot $14.20 | Rake $0.64 
Board [5s 9h Jh 7s]
Seat 1: Pacifistas folded on the Turn
Seat 2: matiko09 folded before Flop (didn't bet)
Seat 3: Vizonto folded before Flop (didn't bet)
Seat 4: RICKA16 folded before Flop (didn't bet)
Seat 5: cobrik23 folded before Flop (didn't bet)
Seat 6: solbi86 (button) folded before Flop (didn't bet)
Seat 7: roninio1 (small blind) collected ($13.56)
Seat 8: aseban11 (big blind) folded before Flop





PokerStars Hand #150707497022:  Hold'em No Limit (€0.25/€0.50 EUR) - 2016/03/21 17:01:09 CET [2016/03/21 12:01:09 ET]
Table 'Auravictrix II' 9-max Seat #8 is the button
Seat 1: aponinho82 (€48.48 in chips) 
Seat 2: ffac (€57.35 in chips) 
Seat 3: matiko09 (€50 in chips) 
Seat 4: i am owsome (€94.75 in chips) 
Seat 5: nombraalne1 (€67.16 in chips) 
Seat 6: Devsteel (€50 in chips) 
Seat 7: vasiy379 (€50 in chips) 
Seat 8: ardo888 (€58.01 in chips) 
Seat 9: carlouchi (€40.90 in chips) 
carlouchi: posts small blind €0.25
aponinho82: posts big blind €0.50
*** HOLE CARDS ***
Dealt to matiko09 [9d Qh]
ffac: folds 
matiko09: folds 
i am owsome: folds 
nombraalne1: folds 
Devsteel: folds 
vasiy379: folds 
ardo888: folds 
carlouchi: folds 
Uncalled bet (€0.25) returned to aponinho82
aponinho82 collected €0.50 from pot
aponinho82: doesn't show hand 
*** SUMMARY ***
Total pot €0.50 | Rake €0 
Seat 1: aponinho82 (big blind) collected (€0.50)
Seat 2: ffac folded before Flop (didn't bet)
Seat 3: matiko09 folded before Flop (didn't bet)
Seat 4: i am owsome folded before Flop (didn't bet)
Seat 5: nombraalne1 folded before Flop (didn't bet)
Seat 6: Devsteel folded before Flop (didn't bet)
Seat 7: vasiy379 folded before Flop (didn't bet)
Seat 8: ardo888 (button) folded before Flop (didn't bet)
Seat 9: carlouchi (small blind) folded before Flop





PokerStars Hand #150707504713:  Hold'em No Limit ($0.50/$1.00 USD) - 2016/03/21 17:01:19 CET [2016/03/21 12:01:19 ET]
Table 'Massalia II' 9-max Seat #8 is the button
Seat 1: crepke ($74.72 in chips) 
Seat 2: solbi86 ($256.96 in chips) 
Seat 3: 123chambo ($78.30 in chips) 
Seat 4: OriginalTony ($83.24 in chips) 
Seat 6: Pacifistas ($139.47 in chips) 
Seat 7: flk.Dasas ($102.90 in chips) 
Seat 8: matiko09 ($172.61 in chips) 
Seat 9: hammerwife ($104.28 in chips) 
hammerwife: posts small blind $0.50
crepke: posts big blind $1
Vikulja1993: sits out 
crepke: posts the ante $0.20
solbi86: posts the ante $0.20
123chambo: posts the ante $0.20
OriginalTony: posts the ante $0.20
Pacifistas: posts the ante $0.20
flk.Dasas: posts the ante $0.20
matiko09: posts the ante $0.20
hammerwife: posts the ante $0.20
*** HOLE CARDS ***
Dealt to matiko09 [As 7s]
solbi86: raises $2 to $3
123chambo: folds 
OriginalTony: calls $3
Pacifistas: folds 
flk.Dasas: folds 
matiko09: folds 
hammerwife: calls $2.50
crepke: folds 
*** FLOP *** [Td 6h Kh]
hammerwife: checks 
solbi86: checks 
OriginalTony: bets $6
hammerwife: folds 
solbi86: folds 
Uncalled bet ($6) returned to OriginalTony
OriginalTony collected $11.08 from pot
*** SUMMARY ***
Total pot $11.60 | Rake $0.52 
Board [Td 6h Kh]
Seat 1: crepke (big blind) folded before Flop
Seat 2: solbi86 folded on the Flop
Seat 3: 123chambo folded before Flop (didn't bet)
Seat 4: OriginalTony collected ($11.08)
Seat 6: Pacifistas folded before Flop (didn't bet)
Seat 7: flk.Dasas folded before Flop (didn't bet)
Seat 8: matiko09 (button) folded before Flop (didn't bet)
Seat 9: hammerwife (small blind) folded on the Flop





PokerStars Hand #150707508063:  Hold'em No Limit ($0.50/$1.00 USD) - 2016/03/21 17:01:23 CET [2016/03/21 12:01:23 ET]
Table 'Marmulla II' 9-max Seat #2 is the button
Seat 1: hammerwife ($101.50 in chips) 
Seat 2: lumen21 ($100 in chips) 
Seat 3: Vikulja1993 ($100 in chips) 
Seat 6: R1aki ($100 in chips) 
Seat 7: Pacifistas ($109.67 in chips) 
Seat 8: ilaviiitech ($107.94 in chips) 
Seat 9: matiko09 ($100 in chips) 
Vikulja1993: posts small blind $0.50
gabi_igna: is sitting out 
maaaGik88: is sitting out 
R1aki: posts big blind $1
*** HOLE CARDS ***
Dealt to matiko09 [5s 3h]
gabi_igna leaves the table
Dachish joins the table at seat #4 
Pacifistas: folds 
ilaviiitech: folds 
matiko09: folds 
hammerwife: folds 
lumen21: folds 
Vikulja1993: folds 
Uncalled bet ($0.50) returned to R1aki
R1aki collected $1 from pot
R1aki: doesn't show hand 
*** SUMMARY ***
Total pot $1 | Rake $0 
Seat 1: hammerwife folded before Flop (didn't bet)
Seat 2: lumen21 (button) folded before Flop (didn't bet)
Seat 3: Vikulja1993 (small blind) folded before Flop
Seat 6: R1aki (big blind) collected ($1)
Seat 7: Pacifistas folded before Flop (didn't bet)
Seat 8: ilaviiitech folded before Flop (didn't bet)
Seat 9: matiko09 folded before Flop (didn't bet)





PokerStars Hand #150707510463:  Hold'em No Limit ($0.50/$1.00 USD) - 2016/03/21 17:01:27 CET [2016/03/21 12:01:27 ET]
Table 'Icarion II' 9-max Seat #7 is the button
Seat 1: forsmthgood ($102.53 in chips) 
Seat 2: aseban11 ($102.75 in chips) 
Seat 3: volwebni4ek ($40 in chips) 
Seat 4: teukka8 ($44.29 in chips) 
Seat 5: SanychStar ($101.50 in chips) 
Seat 6: solbi86 ($109.72 in chips) 
Seat 7: Pacifistas ($100 in chips) 
Seat 8: matiko09 ($112 in chips) 
Seat 9: R1aki ($135.26 in chips) 
matiko09: posts small blind $0.50
R1aki: posts big blind $1
*** HOLE CARDS ***
Dealt to matiko09 [Kd 9h]
forsmthgood: folds 
aseban11: folds 
volwebni4ek: folds 
teukka8: raises $2 to $3
SanychStar: folds 
solbi86: folds 
Pacifistas: raises $4.50 to $7.50
matiko09: folds 
R1aki: folds 
teukka8: calls $4.50
*** FLOP *** [5c Ts 2s]
teukka8: bets $5
Pacifistas: calls $5
*** TURN *** [5c Ts 2s] [6d]
teukka8: bets $9
Pacifistas: folds 
Uncalled bet ($9) returned to teukka8
teukka8 collected $25.31 from pot
teukka8: doesn't show hand 
*** SUMMARY ***
Total pot $26.50 | Rake $1.19 
Board [5c Ts 2s 6d]
Seat 1: forsmthgood folded before Flop (didn't bet)
Seat 2: aseban11 folded before Flop (didn't bet)
Seat 3: volwebni4ek folded before Flop (didn't bet)
Seat 4: teukka8 collected ($25.31)
Seat 5: SanychStar folded before Flop (didn't bet)
Seat 6: solbi86 folded before Flop (didn't bet)
Seat 7: Pacifistas (button) folded on the Turn
Seat 8: matiko09 (small blind) folded before Flop
Seat 9: R1aki (big blind) folded before Flop





PokerStars Hand #150707511598:  Hold'em No Limit ($0.50/$1.00 USD) - 2016/03/21 17:01:28 CET [2016/03/21 12:01:28 ET]
Table 'Noel' 9-max Seat #3 is the button
Seat 1: ep538 ($48.52 in chips) 
Seat 2: cobrik23 ($161.90 in chips) 
Seat 3: gabi_igna ($175.34 in chips) 
Seat 5: matiko09 ($133.57 in chips) 
Seat 6: hammerwife ($108.40 in chips) 
Seat 7: djammusic ($58.79 in chips) 
Seat 8: Dachish ($74 in chips) 
Seat 9: grifkaaa ($103.25 in chips) 
matiko09: posts small blind $0.50
hammerwife: posts big blind $1
*** HOLE CARDS ***
Dealt to matiko09 [4s 4d]
djammusic: folds 
Dachish: folds 
grifkaaa: folds 
ep538: folds 
cobrik23: folds 
gabi_igna: folds 
matiko09: raises $1.50 to $2.50
hammerwife: folds 
Uncalled bet ($1.50) returned to matiko09
matiko09 collected $2 from pot
matiko09: doesn't show hand 
*** SUMMARY ***
Total pot $2 | Rake $0 
Seat 1: ep538 folded before Flop (didn't bet)
Seat 2: cobrik23 folded before Flop (didn't bet)
Seat 3: gabi_igna (button) folded before Flop (didn't bet)
Seat 5: matiko09 (small blind) collected ($2)
Seat 6: hammerwife (big blind) folded before Flop
Seat 7: djammusic folded before Flop (didn't bet)
Seat 8: Dachish folded before Flop (didn't bet)
Seat 9: grifkaaa folded before Flop (didn't bet)





PokerStars Hand #150707514548:  Hold'em No Limit (€0.25/€0.50 EUR) - 2016/03/21 17:01:33 CET [2016/03/21 12:01:33 ET]
Table 'Auravictrix II' 9-max Seat #9 is the button
Seat 1: aponinho82 (€48.73 in chips) 
Seat 2: ffac (€57.35 in chips) 
Seat 3: matiko09 (€50 in chips) 
Seat 4: i am owsome (€94.75 in chips) 
Seat 5: nombraalne1 (€67.16 in chips) 
Seat 6: Devsteel (€50 in chips) 
Seat 7: vasiy379 (€50 in chips) 
Seat 8: ardo888 (€58.01 in chips) 
Seat 9: carlouchi (€40.65 in chips) 
aponinho82: posts small blind €0.25
ffac: posts big blind €0.50
*** HOLE CARDS ***
Dealt to matiko09 [9d 7d]
matiko09: folds 
i am owsome: folds 
nombraalne1: folds 
Devsteel: folds 
vasiy379: folds 
ardo888: folds 
carlouchi: folds 
aponinho82: calls €0.25
ffac: checks 
*** FLOP *** [9s 7h Kc]
aponinho82: checks 
ffac: bets €0.50
aponinho82: folds 
Uncalled bet (€0.50) returned to ffac
ffac collected €0.96 from pot
ffac: doesn't show hand 
*** SUMMARY ***
Total pot €1 | Rake €0.04 
Board [9s 7h Kc]
Seat 1: aponinho82 (small blind) folded on the Flop
Seat 2: ffac (big blind) collected (€0.96)
Seat 3: matiko09 folded before Flop (didn't bet)
Seat 4: i am owsome folded before Flop (didn't bet)
Seat 5: nombraalne1 folded before Flop (didn't bet)
Seat 6: Devsteel folded before Flop (didn't bet)
Seat 7: vasiy379 folded before Flop (didn't bet)
Seat 8: ardo888 folded before Flop (didn't bet)
Seat 9: carlouchi (button) folded before Flop (didn't bet)





PokerStars Hand #150707520100:  Hold'em No Limit ($0.50/$1.00 USD) - 2016/03/21 17:01:41 CET [2016/03/21 12:01:41 ET]
Table 'Juhani' 9-max Seat #6 is the button
Seat 1: solbi86 ($100 in chips) 
Seat 5: Smartiecat ($101.28 in chips) 
Seat 6: Pacifistas ($100 in chips) 
Seat 7: matiko09 ($117.92 in chips) 
Seat 8: grifkaaa ($102.50 in chips) 
Seat 9: IntsAA ($96 in chips) 
matiko09: posts small blind $0.50
grifkaaa: posts big blind $1
ka100pka527: sits out 
*** HOLE CARDS ***
Dealt to matiko09 [9s Th]
IntsAA: folds 
solbi86: folds 
Smartiecat: folds 
lysandrafly leaves the table
Vikulja1993 joins the table at seat #3 
Pacifistas: folds 
matiko09: raises $1.50 to $2.50
grifkaaa: calls $1.50
*** FLOP *** [5h Ah 6c]
matiko09: bets $3
grifkaaa: calls $3
*** TURN *** [5h Ah 6c] [Tc]
matiko09: checks 
grifkaaa: bets $7.88
matiko09: folds 
Uncalled bet ($7.88) returned to grifkaaa
grifkaaa collected $10.50 from pot
*** SUMMARY ***
Total pot $11 | Rake $0.50 
Board [5h Ah 6c Tc]
Seat 1: solbi86 folded before Flop (didn't bet)
Seat 5: Smartiecat folded before Flop (didn't bet)
Seat 6: Pacifistas (button) folded before Flop (didn't bet)
Seat 7: matiko09 (small blind) folded on the Turn
Seat 8: grifkaaa (big blind) collected ($10.50)
Seat 9: IntsAA folded before Flop (didn't bet)





PokerStars Hand #150707524885:  Hold'em No Limit ($0.50/$1.00 USD) - 2016/03/21 17:01:47 CET [2016/03/21 12:01:47 ET]
Table 'Lucifer III' 9-max Seat #7 is the button
Seat 1: Pacifistas ($149.46 in chips) 
Seat 2: matiko09 ($109.58 in chips) 
Seat 3: Vizonto ($45.23 in chips) 
Seat 4: RICKA16 ($98.50 in chips) 
Seat 5: cobrik23 ($69.90 in chips) 
Seat 6: solbi86 ($126 in chips) 
Seat 7: roninio1 ($127.13 in chips) 
Seat 8: aseban11 ($161.75 in chips) 
Seat 9: mycka86 ($120.66 in chips) 
aseban11: posts small blind $0.50
mycka86: posts big blind $1
*** HOLE CARDS ***
Dealt to matiko09 [6d 3d]
Pacifistas: folds 
matiko09: folds 
Vizonto: folds 
RICKA16: raises $2 to $3
cobrik23: folds 
solbi86: folds 
roninio1: folds 
aseban11: folds 
mycka86: folds 
Uncalled bet ($2) returned to RICKA16
RICKA16 collected $2.50 from pot
RICKA16: doesn't show hand 
*** SUMMARY ***
Total pot $2.50 | Rake $0 
Seat 1: Pacifistas folded before Flop (didn't bet)
Seat 2: matiko09 folded before Flop (didn't bet)
Seat 3: Vizonto folded before Flop (didn't bet)
Seat 4: RICKA16 collected ($2.50)
Seat 5: cobrik23 folded before Flop (didn't bet)
Seat 6: solbi86 folded before Flop (didn't bet)
Seat 7: roninio1 (button) folded before Flop (didn't bet)
Seat 8: aseban11 (small blind) folded before Flop
Seat 9: mycka86 (big blind) folded before Flop





PokerStars Hand #150707530600:  Hold'em No Limit ($0.50/$1.00 USD) - 2016/03/21 17:01:55 CET [2016/03/21 12:01:55 ET]
Table 'Onnie II' 9-max Seat #8 is the button
Seat 1: aseban11 ($182.79 in chips) 
Seat 2: RICKA16 ($99.50 in chips) 
Seat 4: Bothfeld11 ($182.87 in chips) 
Seat 5: sanpidk ($104.75 in chips) 
Seat 6: Pacifistas ($104.27 in chips) 
Seat 7: djammusic ($76.90 in chips) 
Seat 8: solbi86 ($100 in chips) 
Seat 9: matiko09 ($115.69 in chips) 
matiko09: posts small blind $0.50
aseban11: posts big blind $1
cn_chayanne: sits out 
*** HOLE CARDS ***
Dealt to matiko09 [9s 3s]
RICKA16: folds 
Bothfeld11: raises $1 to $2
sanpidk: folds 
Pacifistas: folds 
djammusic: calls $2
solbi86: folds 
matiko09: folds 
aseban11: raises $8.50 to $10.50
Bothfeld11: calls $8.50
djammusic: folds 
*** FLOP *** [4s Ks 8s]
aseban11: bets $11.50
Bothfeld11: folds [Jh Jc]
Uncalled bet ($11.50) returned to aseban11
aseban11 collected $22.44 from pot
aseban11: doesn't show hand 
*** SUMMARY ***
Total pot $23.50 | Rake $1.06 
Board [4s Ks 8s]
Seat 1: aseban11 (big blind) collected ($22.44)
Seat 2: RICKA16 folded before Flop (didn't bet)
Seat 4: Bothfeld11 folded on the Flop
Seat 5: sanpidk folded before Flop (didn't bet)
Seat 6: Pacifistas folded before Flop (didn't bet)
Seat 7: djammusic folded before Flop
Seat 8: solbi86 (button) folded before Flop (didn't bet)
Seat 9: matiko09 (small blind) folded before Flop





PokerStars Hand #150707531580:  Hold'em No Limit ($0.50/$1.00 USD) - 2016/03/21 17:01:56 CET [2016/03/21 12:01:56 ET]
Table 'Marmulla II' 9-max Seat #3 is the button
Seat 1: hammerwife ($101.50 in chips) 
Seat 2: lumen21 ($100 in chips) 
Seat 3: Vikulja1993 ($100 in chips) 
Seat 6: R1aki ($100.50 in chips) 
Seat 7: Pacifistas ($109.67 in chips) 
Seat 8: ilaviiitech ($107.94 in chips) 
Seat 9: matiko09 ($100 in chips) 
Dachish will be allowed to play after the button
maaaGik88 will be allowed to play after the button
R1aki: posts small blind $0.50
Pacifistas: posts big blind $1
*** HOLE CARDS ***
Dealt to matiko09 [Kd 7c]
ilaviiitech: folds 
matiko09: folds 
hammerwife: raises $1.50 to $2.50
lumen21: folds 
Vikulja1993: calls $2.50
R1aki: folds 
Pacifistas: calls $1.50
*** FLOP *** [Ah Kh 6s]
Pacifistas: checks 
hammerwife: checks 
Vikulja1993: bets $2.50
Pacifistas: folds 
hammerwife: folds 
Uncalled bet ($2.50) returned to Vikulja1993
Vikulja1993 collected $7.64 from pot
Vikulja1993: doesn't show hand 
*** SUMMARY ***
Total pot $8 | Rake $0.36 
Board [Ah Kh 6s]
Seat 1: hammerwife folded on the Flop
Seat 2: lumen21 folded before Flop (didn't bet)
Seat 3: Vikulja1993 (button) collected ($7.64)
Seat 6: R1aki (small blind) folded before Flop
Seat 7: Pacifistas (big blind) folded on the Flop
Seat 8: ilaviiitech folded before Flop (didn't bet)
Seat 9: matiko09 folded before Flop (didn't bet)





PokerStars Hand #150707545044:  Hold'em No Limit ($0.50/$1.00 USD) - 2016/03/21 17:02:14 CET [2016/03/21 12:02:14 ET]
Table 'Lucifer III' 9-max Seat #8 is the button
Seat 1: Pacifistas ($149.46 in chips) 
Seat 2: matiko09 ($109.58 in chips) 
Seat 3: Vizonto ($45.23 in chips) 
Seat 4: RICKA16 ($100 in chips) 
Seat 5: cobrik23 ($69.90 in chips) 
Seat 6: solbi86 ($126 in chips) 
Seat 7: roninio1 ($127.13 in chips) 
Seat 8: aseban11 ($161.25 in chips) 
Seat 9: mycka86 ($119.66 in chips) 
mycka86: posts small blind $0.50
Pacifistas: posts big blind $1
*** HOLE CARDS ***
Dealt to matiko09 [As 6d]
matiko09: folds 
Vizonto: calls $1
RICKA16: folds 
cobrik23: folds 
solbi86: raises $3 to $4
roninio1: folds 
aseban11: folds 
mycka86: folds 
Pacifistas: folds 
Vizonto: calls $3
*** FLOP *** [4c 7s 9s]
Vizonto: checks 
solbi86: bets $5
Vizonto: calls $5
*** TURN *** [4c 7s 9s] [Th]
Vizonto: checks 
solbi86: checks 
*** RIVER *** [4c 7s 9s Th] [Jc]
Vizonto: checks 
solbi86: bets $6
Vizonto: calls $6
*** SHOW DOWN ***
solbi86: shows [Js Kd] (a pair of Jacks)
Vizonto: mucks hand 
solbi86 collected $30.08 from pot
*** SUMMARY ***
Total pot $31.50 | Rake $1.42 
Board [4c 7s 9s Th Jc]
Seat 1: Pacifistas (big blind) folded before Flop
Seat 2: matiko09 folded before Flop (didn't bet)
Seat 3: Vizonto mucked [Ac 7h]
Seat 4: RICKA16 folded before Flop (didn't bet)
Seat 5: cobrik23 folded before Flop (didn't bet)
Seat 6: solbi86 showed [Js Kd] and won ($30.08) with a pair of Jacks
Seat 7: roninio1 folded before Flop (didn't bet)
Seat 8: aseban11 (button) folded before Flop (didn't bet)
Seat 9: mycka86 (small blind) folded before Flop





PokerStars Hand #150707547582:  Hold'em No Limit ($0.50/$1.00 USD) - 2016/03/21 17:02:18 CET [2016/03/21 12:02:18 ET]
Table 'Skadi III' 9-max Seat #8 is the button
Seat 1: CI58 ($100 in chips) 
Seat 2: aseban11 ($100 in chips) 
Seat 3: matiko09 ($101 in chips) 
Seat 4: ilaviiitech ($100 in chips) 
Seat 5: WaldiQ ($100 in chips) 
Seat 6: Pacifistas ($100.85 in chips) 
Seat 7: solbi86 ($119.16 in chips) 
Seat 8: volwebni4ek ($40 in chips) 
Seat 9: bradsheps ($159.87 in chips) 
bradsheps: posts small blind $0.50
CI58: posts big blind $1
*** HOLE CARDS ***
Dealt to matiko09 [9h 7c]
aseban11: folds 
matiko09: folds 
ilaviiitech: folds 
WaldiQ: folds 
Pacifistas: folds 
solbi86: raises $1.50 to $2.50
volwebni4ek: folds 
bradsheps: folds 
CI58: folds 
Uncalled bet ($1.50) returned to solbi86
solbi86 collected $2.50 from pot
solbi86: doesn't show hand 
*** SUMMARY ***
Total pot $2.50 | Rake $0 
Seat 1: CI58 (big blind) folded before Flop
Seat 2: aseban11 folded before Flop (didn't bet)
Seat 3: matiko09 folded before Flop (didn't bet)
Seat 4: ilaviiitech folded before Flop (didn't bet)
Seat 5: WaldiQ folded before Flop (didn't bet)
Seat 6: Pacifistas folded before Flop (didn't bet)
Seat 7: solbi86 collected ($2.50)
Seat 8: volwebni4ek (button) folded before Flop (didn't bet)
Seat 9: bradsheps (small blind) folded before Flop





PokerStars Hand #150707549307:  Hold'em No Limit ($0.50/$1.00 USD) - 2016/03/21 17:02:20 CET [2016/03/21 12:02:20 ET]
Table 'Noel' 9-max Seat #5 is the button
Seat 1: ep538 ($48.52 in chips) 
Seat 2: cobrik23 ($161.90 in chips) 
Seat 3: gabi_igna ($175.34 in chips) 
Seat 5: matiko09 ($134.57 in chips) 
Seat 6: hammerwife ($107.40 in chips) 
Seat 7: djammusic ($58.79 in chips) 
Seat 8: Dachish ($74 in chips) 
Seat 9: grifkaaa ($103.25 in chips) 
hammerwife: posts small blind $0.50
djammusic: posts big blind $1
*** HOLE CARDS ***
Dealt to matiko09 [Ks 5s]
Dachish: folds 
grifkaaa: folds 
ep538: folds 
cobrik23: folds 
gabi_igna: folds 
matiko09: raises $1.27 to $2.27
hammerwife: folds 
djammusic: calls $1.27
*** FLOP *** [Qd Kc Kh]
djammusic: checks 
matiko09: checks 
*** TURN *** [Qd Kc Kh] [4h]
djammusic: bets $3
matiko09: calls $3
*** RIVER *** [Qd Kc Kh 4h] [3d]
djammusic: checks 
matiko09: bets $5
djammusic: folds 
Uncalled bet ($5) returned to matiko09
matiko09 collected $10.54 from pot
matiko09: doesn't show hand 
*** SUMMARY ***
Total pot $11.04 | Rake $0.50 
Board [Qd Kc Kh 4h 3d]
Seat 1: ep538 folded before Flop (didn't bet)
Seat 2: cobrik23 folded before Flop (didn't bet)
Seat 3: gabi_igna folded before Flop (didn't bet)
Seat 5: matiko09 (button) collected ($10.54)
Seat 6: hammerwife (small blind) folded before Flop
Seat 7: djammusic (big blind) folded on the River
Seat 8: Dachish folded before Flop (didn't bet)
Seat 9: grifkaaa folded before Flop (didn't bet)





PokerStars Hand #150707550902:  Hold'em No Limit (€0.25/€0.50 EUR) - 2016/03/21 17:02:22 CET [2016/03/21 12:02:22 ET]
Table 'Auravictrix II' 9-max Seat #1 is the button
Seat 1: aponinho82 (€48.23 in chips) 
Seat 2: ffac (€57.81 in chips) 
Seat 3: matiko09 (€50 in chips) 
Seat 4: i am owsome (€94.75 in chips) 
Seat 5: nombraalne1 (€67.16 in chips) 
Seat 6: Devsteel (€50 in chips) 
Seat 7: vasiy379 (€50 in chips) 
Seat 8: ardo888 (€58.01 in chips) 
Seat 9: carlouchi (€40.65 in chips) 
ffac: posts small blind €0.25
matiko09: posts big blind €0.50
*** HOLE CARDS ***
Dealt to matiko09 [Qc 3c]
i am owsome: folds 
nombraalne1: folds 
Devsteel: folds 
vasiy379: folds 
ardo888: folds 
carlouchi: folds 
aponinho82: calls €0.50
ffac: folds 
matiko09: checks 
*** FLOP *** [9h Tc Ac]
matiko09: bets €0.77
aponinho82: calls €0.77
*** TURN *** [9h Tc Ac] [7d]
matiko09: checks 
aponinho82: checks 
*** RIVER *** [9h Tc Ac 7d] [6c]
matiko09: bets €2
aponinho82: calls €2
*** SHOW DOWN ***
matiko09: shows [Qc 3c] (a flush, Ace high)
aponinho82: mucks hand 
matiko09 collected €6.48 from pot
*** SUMMARY ***
Total pot €6.79 | Rake €0.31 
Board [9h Tc Ac 7d 6c]
Seat 1: aponinho82 (button) mucked [5s Ad]
Seat 2: ffac (small blind) folded before Flop
Seat 3: matiko09 (big blind) showed [Qc 3c] and won (€6.48) with a flush, Ace high
Seat 4: i am owsome folded before Flop (didn't bet)
Seat 5: nombraalne1 folded before Flop (didn't bet)
Seat 6: Devsteel folded before Flop (didn't bet)
Seat 7: vasiy379 folded before Flop (didn't bet)
Seat 8: ardo888 folded before Flop (didn't bet)
Seat 9: carlouchi folded before Flop (didn't bet)





PokerStars Hand #150707553964:  Hold'em No Limit ($0.50/$1.00 USD) - 2016/03/21 17:02:26 CET [2016/03/21 12:02:26 ET]
Table 'Massalia II' 9-max Seat #9 is the button
Seat 1: crepke ($73.52 in chips) 
Seat 3: 123chambo ($78.10 in chips) 
Seat 4: OriginalTony ($91.12 in chips) 
Seat 6: Pacifistas ($139.27 in chips) 
Seat 7: flk.Dasas ($102.70 in chips) 
Seat 8: matiko09 ($172.41 in chips) 
Seat 9: hammerwife ($101.08 in chips) 
crepke: posts small blind $0.50
solbi86: is sitting out 
123chambo: posts big blind $1
Vikulja1993: sits out 
crepke: posts the ante $0.20
123chambo: posts the ante $0.20
OriginalTony: posts the ante $0.20
Pacifistas: posts the ante $0.20
flk.Dasas: posts the ante $0.20
matiko09: posts the ante $0.20
hammerwife: posts the ante $0.20
*** HOLE CARDS ***
Dealt to matiko09 [5c Jc]
OriginalTony: folds 
Pacifistas: folds 
flk.Dasas: folds 
matiko09: folds 
hammerwife: folds 
solbi86 leaves the table
crepke: raises $2 to $3
123chambo: folds 
Uncalled bet ($2) returned to crepke
crepke collected $3.40 from pot
crepke: doesn't show hand 
*** SUMMARY ***
Total pot $3.40 | Rake $0 
Seat 1: crepke (small blind) collected ($3.40)
Seat 3: 123chambo (big blind) folded before Flop
Seat 4: OriginalTony folded before Flop (didn't bet)
Seat 6: Pacifistas folded before Flop (didn't bet)
Seat 7: flk.Dasas folded before Flop (didn't bet)
Seat 8: matiko09 folded before Flop (didn't bet)
Seat 9: hammerwife (button) folded before Flop (didn't bet)





PokerStars Hand #150707556335:  Hold'em No Limit ($0.50/$1.00 USD) - 2016/03/21 17:02:29 CET [2016/03/21 12:02:29 ET]
Table 'Icarion II' 9-max Seat #8 is the button
Seat 1: forsmthgood ($102.53 in chips) 
Seat 2: aseban11 ($102.75 in chips) 
Seat 3: volwebni4ek ($40 in chips) 
Seat 4: teukka8 ($57.10 in chips) 
Seat 5: SanychStar ($101.50 in chips) 
Seat 6: solbi86 ($109.72 in chips) 
Seat 7: Pacifistas ($100 in chips) 
Seat 8: matiko09 ($111.50 in chips) 
Seat 9: R1aki ($134.26 in chips) 
R1aki: posts small blind $0.50
forsmthgood: posts big blind $1
*** HOLE CARDS ***
Dealt to matiko09 [Ac 9d]
aseban11: folds 
volwebni4ek: folds 
teukka8: raises $1 to $2
SanychStar: folds 
solbi86: folds 
Pacifistas: calls $2
matiko09: folds 
R1aki: raises $8 to $10
forsmthgood: folds 
teukka8: folds 
Pacifistas: folds 
Uncalled bet ($8) returned to R1aki
R1aki collected $7 from pot
R1aki: doesn't show hand 
*** SUMMARY ***
Total pot $7 | Rake $0 
Seat 1: forsmthgood (big blind) folded before Flop
Seat 2: aseban11 folded before Flop (didn't bet)
Seat 3: volwebni4ek folded before Flop (didn't bet)
Seat 4: teukka8 folded before Flop
Seat 5: SanychStar folded before Flop (didn't bet)
Seat 6: solbi86 folded before Flop (didn't bet)
Seat 7: Pacifistas folded before Flop
Seat 8: matiko09 (button) folded before Flop (didn't bet)
Seat 9: R1aki (small blind) collected ($7)





PokerStars Hand #150707572226:  Hold'em No Limit ($0.50/$1.00 USD) - 2016/03/21 17:02:50 CET [2016/03/21 12:02:50 ET]
Table 'Juhani' 9-max Seat #7 is the button
Seat 1: solbi86 ($100 in chips) 
Seat 5: Smartiecat ($101.28 in chips) 
Seat 6: Pacifistas ($100 in chips) 
Seat 7: matiko09 ($112.42 in chips) 
Seat 8: grifkaaa ($107.50 in chips) 
Seat 9: IntsAA ($96 in chips) 
grifkaaa: posts small blind $0.50
IntsAA: posts big blind $1
Vikulja1993: sits out 
ka100pka527: sits out 
*** HOLE CARDS ***
Dealt to matiko09 [4c Qs]
solbi86: raises $2 to $3
Smartiecat: folds 
Pacifistas: folds 
matiko09: folds 
grifkaaa: raises $6 to $9
IntsAA: folds 
solbi86: folds 
Uncalled bet ($6) returned to grifkaaa
grifkaaa collected $7 from pot
*** SUMMARY ***
Total pot $7 | Rake $0 
Seat 1: solbi86 folded before Flop
Seat 5: Smartiecat folded before Flop (didn't bet)
Seat 6: Pacifistas folded before Flop (didn't bet)
Seat 7: matiko09 (button) folded before Flop (didn't bet)
Seat 8: grifkaaa (small blind) collected ($7)
Seat 9: IntsAA (big blind) folded before Flop





PokerStars Hand #150707573340:  Hold'em No Limit ($0.50/$1.00 USD) - 2016/03/21 17:02:52 CET [2016/03/21 12:02:52 ET]
Table 'Massalia II' 9-max Seat #1 is the button
Seat 1: crepke ($75.72 in chips) 
Seat 3: 123chambo ($76.90 in chips) 
Seat 4: OriginalTony ($90.92 in chips) 
Seat 6: Pacifistas ($139.07 in chips) 
Seat 7: flk.Dasas ($102.50 in chips) 
Seat 8: matiko09 ($172.21 in chips) 
Seat 9: hammerwife ($100.88 in chips) 
123chambo: posts small blind $0.50
OriginalTony: posts big blind $1
Vikulja1993: sits out 
crepke: posts the ante $0.20
123chambo: posts the ante $0.20
OriginalTony: posts the ante $0.20
Pacifistas: posts the ante $0.20
flk.Dasas: posts the ante $0.20
matiko09: posts the ante $0.20
hammerwife: posts the ante $0.20
*** HOLE CARDS ***
Dealt to matiko09 [8h 9c]
Pacifistas: folds 
maxxmeister joins the table at seat #2 
flk.Dasas: folds 
matiko09: folds 
hammerwife: folds 
crepke: folds 
123chambo: folds 
Uncalled bet ($0.50) returned to OriginalTony
OriginalTony collected $2.40 from pot
*** SUMMARY ***
Total pot $2.40 | Rake $0 
Seat 1: crepke (button) folded before Flop (didn't bet)
Seat 3: 123chambo (small blind) folded before Flop
Seat 4: OriginalTony (big blind) collected ($2.40)
Seat 6: Pacifistas folded before Flop (didn't bet)
Seat 7: flk.Dasas folded before Flop (didn't bet)
Seat 8: matiko09 folded before Flop (didn't bet)
Seat 9: hammerwife folded before Flop (didn't bet)





PokerStars Hand #150707577502:  Hold'em No Limit ($0.50/$1.00 USD) - 2016/03/21 17:02:58 CET [2016/03/21 12:02:58 ET]
Table 'Onnie II' 9-max Seat #9 is the button
Seat 1: aseban11 ($194.73 in chips) 
Seat 2: RICKA16 ($99.50 in chips) 
Seat 4: Bothfeld11 ($172.37 in chips) 
Seat 5: sanpidk ($104.75 in chips) 
Seat 6: Pacifistas ($104.27 in chips) 
Seat 7: djammusic ($74.90 in chips) 
Seat 8: solbi86 ($100 in chips) 
Seat 9: matiko09 ($115.19 in chips) 
aseban11: posts small blind $0.50
RICKA16: posts big blind $1
cn_chayanne: sits out 
*** HOLE CARDS ***
Dealt to matiko09 [5c 7s]
Bothfeld11: calls $1
sanpidk: folds 
Pacifistas: calls $1
djammusic: raises $4.50 to $5.50
solbi86: folds 
matiko09: folds 
aseban11: folds 
RICKA16: folds 
Bothfeld11: folds 
Pacifistas: folds 
Uncalled bet ($4.50) returned to djammusic
djammusic collected $4.50 from pot
djammusic: doesn't show hand 
*** SUMMARY ***
Total pot $4.50 | Rake $0 
Seat 1: aseban11 (small blind) folded before Flop
Seat 2: RICKA16 (big blind) folded before Flop
Seat 4: Bothfeld11 folded before Flop
Seat 5: sanpidk folded before Flop (didn't bet)
Seat 6: Pacifistas folded before Flop
Seat 7: djammusic collected ($4.50)
Seat 8: solbi86 folded before Flop (didn't bet)
Seat 9: matiko09 (button) folded before Flop (didn't bet)





PokerStars Hand #150707583695:  Hold'em No Limit ($0.50/$1.00 USD) - 2016/03/21 17:03:06 CET [2016/03/21 12:03:06 ET]
Table 'Skadi III' 9-max Seat #9 is the button
Seat 1: CI58 ($100 in chips) 
Seat 2: aseban11 ($100 in chips) 
Seat 3: matiko09 ($101 in chips) 
Seat 4: ilaviiitech ($100 in chips) 
Seat 5: WaldiQ ($100 in chips) 
Seat 6: Pacifistas ($100.85 in chips) 
Seat 7: solbi86 ($120.66 in chips) 
Seat 8: volwebni4ek ($40 in chips) 
Seat 9: bradsheps ($159.37 in chips) 
CI58: posts small blind $0.50
aseban11: posts big blind $1
*** HOLE CARDS ***
Dealt to matiko09 [Kh 8d]
matiko09: folds 
ilaviiitech: folds 
WaldiQ: folds 
Pacifistas: folds 
solbi86: folds 
volwebni4ek: raises $1.20 to $2.20
bradsheps: calls $2.20
CI58: folds 
aseban11: folds 
*** FLOP *** [7s 4s Qc]
volwebni4ek: checks 
bradsheps: checks 
*** TURN *** [7s 4s Qc] [4h]
volwebni4ek: checks 
bradsheps: bets $3
volwebni4ek: folds 
Uncalled bet ($3) returned to bradsheps
bradsheps collected $5.63 from pot
*** SUMMARY ***
Total pot $5.90 | Rake $0.27 
Board [7s 4s Qc 4h]
Seat 1: CI58 (small blind) folded before Flop
Seat 2: aseban11 (big blind) folded before Flop
Seat 3: matiko09 folded before Flop (didn't bet)
Seat 4: ilaviiitech folded before Flop (didn't bet)
Seat 5: WaldiQ folded before Flop (didn't bet)
Seat 6: Pacifistas folded before Flop (didn't bet)
Seat 7: solbi86 folded before Flop (didn't bet)
Seat 8: volwebni4ek folded on the Turn
Seat 9: bradsheps (button) collected ($5.63)





PokerStars Hand #150707586233:  Hold'em No Limit ($0.50/$1.00 USD) - 2016/03/21 17:03:09 CET [2016/03/21 12:03:09 ET]
Table 'Icarion II' 9-max Seat #9 is the button
Seat 1: forsmthgood ($101.53 in chips) 
Seat 2: aseban11 ($102.75 in chips) 
Seat 3: volwebni4ek ($40 in chips) 
Seat 4: teukka8 ($55.10 in chips) 
Seat 5: SanychStar ($101.50 in chips) 
Seat 6: solbi86 ($109.72 in chips) 
Seat 7: Pacifistas ($100 in chips) 
Seat 8: matiko09 ($111.50 in chips) 
Seat 9: R1aki ($139.26 in chips) 
forsmthgood: posts small blind $0.50
aseban11: posts big blind $1
*** HOLE CARDS ***
Dealt to matiko09 [Qh 9c]
volwebni4ek: folds 
teukka8: folds 
SanychStar: folds 
solbi86: folds 
Pacifistas: folds 
matiko09: folds 
R1aki: folds 
forsmthgood: raises $1.50 to $2.50
aseban11: calls $1.50
*** FLOP *** [Qd As 4d]
forsmthgood: checks 
aseban11: checks 
*** TURN *** [Qd As 4d] [2d]
forsmthgood: checks 
aseban11: checks 
*** RIVER *** [Qd As 4d 2d] [3c]
forsmthgood: checks 
aseban11: checks 
*** SHOW DOWN ***
forsmthgood: shows [Kc 4c] (a pair of Fours)
aseban11: mucks hand 
forsmthgood collected $4.78 from pot
*** SUMMARY ***
Total pot $5 | Rake $0.22 
Board [Qd As 4d 2d 3c]
Seat 1: forsmthgood (small blind) showed [Kc 4c] and won ($4.78) with a pair of Fours
Seat 2: aseban11 (big blind) mucked [6s 4h]
Seat 3: volwebni4ek folded before Flop (didn't bet)
Seat 4: teukka8 folded before Flop (didn't bet)
Seat 5: SanychStar folded before Flop (didn't bet)
Seat 6: solbi86 folded before Flop (didn't bet)
Seat 7: Pacifistas folded before Flop (didn't bet)
Seat 8: matiko09 folded before Flop (didn't bet)
Seat 9: R1aki (button) folded before Flop (didn't bet)





PokerStars Hand #150707587933:  Hold'em No Limit ($0.50/$1.00 USD) - 2016/03/21 17:03:11 CET [2016/03/21 12:03:11 ET]
Table 'Massalia II' 9-max Seat #3 is the button
Seat 1: crepke ($75.52 in chips) 
Seat 3: 123chambo ($76.20 in chips) 
Seat 4: OriginalTony ($92.62 in chips) 
Seat 5: Vikulja1993 ($100 in chips) 
Seat 6: Pacifistas ($138.87 in chips) 
Seat 7: flk.Dasas ($102.30 in chips) 
Seat 8: matiko09 ($172.01 in chips) 
Seat 9: hammerwife ($100.68 in chips) 
OriginalTony: posts small blind $0.50
Vikulja1993: posts big blind $1
maxxmeister: sits out 
crepke: posts the ante $0.20
123chambo: posts the ante $0.20
OriginalTony: posts the ante $0.20
Vikulja1993: posts the ante $0.20
Pacifistas: posts the ante $0.20
flk.Dasas: posts the ante $0.20
matiko09: posts the ante $0.20
hammerwife: posts the ante $0.20
*** HOLE CARDS ***
Dealt to matiko09 [Jd Qd]
Pacifistas: folds 
flk.Dasas: folds 
matiko09: raises $2 to $3
hammerwife: folds 
crepke: folds 
123chambo: folds 
OriginalTony: folds 
Vikulja1993: folds 
Uncalled bet ($2) returned to matiko09
matiko09 collected $4.10 from pot
matiko09: doesn't show hand 
*** SUMMARY ***
Total pot $4.10 | Rake $0 
Seat 1: crepke folded before Flop (didn't bet)
Seat 3: 123chambo (button) folded before Flop (didn't bet)
Seat 4: OriginalTony (small blind) folded before Flop
Seat 5: Vikulja1993 (big blind) folded before Flop
Seat 6: Pacifistas folded before Flop (didn't bet)
Seat 7: flk.Dasas folded before Flop (didn't bet)
Seat 8: matiko09 collected ($4.10)
Seat 9: hammerwife folded before Flop (didn't bet)





PokerStars Hand #150707589376:  Hold'em No Limit (€0.25/€0.50 EUR) - 2016/03/21 17:03:13 CET [2016/03/21 12:03:13 ET]
Table 'Auravictrix II' 9-max Seat #2 is the button
Seat 1: aponinho82 (€44.96 in chips) 
Seat 2: ffac (€57.56 in chips) 
Seat 3: matiko09 (€53.21 in chips) 
Seat 4: i am owsome (€94.75 in chips) 
Seat 5: nombraalne1 (€67.16 in chips) 
Seat 6: Devsteel (€50 in chips) 
Seat 7: vasiy379 (€50 in chips) 
Seat 8: ardo888 (€58.01 in chips) 
Seat 9: carlouchi (€40.65 in chips) 
matiko09: posts small blind €0.25
i am owsome: posts big blind €0.50
*** HOLE CARDS ***
Dealt to matiko09 [Ts 2h]
nombraalne1: folds 
Devsteel: raises €1 to €1.50
vasiy379: calls €1.50
ardo888: calls €1.50
carlouchi: folds 
aponinho82: folds 
ffac: folds 
matiko09: folds 
i am owsome: folds 
*** FLOP *** [8d 3c 2s]
Devsteel: checks 
vasiy379: checks 
ardo888: bets €2.75
Devsteel: calls €2.75
vasiy379: folds 
*** TURN *** [8d 3c 2s] [Th]
Devsteel: checks 
ardo888: bets €7.49
Devsteel: calls €7.49
*** RIVER *** [8d 3c 2s Th] [8c]
Devsteel: checks 
ardo888: checks 
*** SHOW DOWN ***
Devsteel: shows [8h 8s] (four of a kind, Eights)
ardo888: mucks hand 
Devsteel collected €24.57 from pot
*** SUMMARY ***
Total pot €25.73 | Rake €1.16 
Board [8d 3c 2s Th 8c]
Seat 1: aponinho82 folded before Flop (didn't bet)
Seat 2: ffac (button) folded before Flop (didn't bet)
Seat 3: matiko09 (small blind) folded before Flop
Seat 4: i am owsome (big blind) folded before Flop
Seat 5: nombraalne1 folded before Flop (didn't bet)
Seat 6: Devsteel showed [8h 8s] and won (€24.57) with four of a kind, Eights
Seat 7: vasiy379 folded on the Flop
Seat 8: ardo888 mucked [Js Qs]
Seat 9: carlouchi folded before Flop (didn't bet)





PokerStars Hand #150707595377:  Hold'em No Limit ($0.50/$1.00 USD) - 2016/03/21 17:03:21 CET [2016/03/21 12:03:21 ET]
Table 'Lucifer III' 9-max Seat #9 is the button
Seat 1: Pacifistas ($148.46 in chips) 
Seat 2: matiko09 ($109.58 in chips) 
Seat 3: Vizonto ($30.23 in chips) 
Seat 4: RICKA16 ($100 in chips) 
Seat 5: cobrik23 ($69.90 in chips) 
Seat 6: solbi86 ($141.08 in chips) 
Seat 7: roninio1 ($127.13 in chips) 
Seat 8: aseban11 ($161.25 in chips) 
Seat 9: mycka86 ($119.16 in chips) 
Pacifistas: posts small blind $0.50
matiko09: posts big blind $1
*** HOLE CARDS ***
Dealt to matiko09 [2h 8s]
Vizonto: folds 
RICKA16: folds 
cobrik23: folds 
solbi86: folds 
roninio1: raises $2 to $3
aseban11: folds 
mycka86: calls $3
Pacifistas: folds 
matiko09: folds 
*** FLOP *** [Jc 5d Ah]
roninio1: bets $3.58
mycka86: raises $4.38 to $7.96
roninio1: calls $4.38
*** TURN *** [Jc 5d Ah] [7c]
roninio1: checks 
mycka86: checks 
*** RIVER *** [Jc 5d Ah 7c] [8h]
roninio1: bets $11.18
mycka86: folds 
Uncalled bet ($11.18) returned to roninio1
roninio1 collected $22.37 from pot
roninio1: doesn't show hand 
*** SUMMARY ***
Total pot $23.42 | Rake $1.05 
Board [Jc 5d Ah 7c 8h]
Seat 1: Pacifistas (small blind) folded before Flop
Seat 2: matiko09 (big blind) folded before Flop
Seat 3: Vizonto folded before Flop (didn't bet)
Seat 4: RICKA16 folded before Flop (didn't bet)
Seat 5: cobrik23 folded before Flop (didn't bet)
Seat 6: solbi86 folded before Flop (didn't bet)
Seat 7: roninio1 collected ($22.37)
Seat 8: aseban11 folded before Flop (didn't bet)
Seat 9: mycka86 (button) folded on the River





PokerStars Hand #150707599574:  Hold'em No Limit ($0.50/$1.00 USD) - 2016/03/21 17:03:27 CET [2016/03/21 12:03:27 ET]
Table 'Marmulla II' 9-max Seat #6 is the button
Seat 1: hammerwife ($100 in chips) 
Seat 3: Vikulja1993 ($105.14 in chips) 
Seat 4: Dachish ($70 in chips) 
Seat 6: R1aki ($100 in chips) 
Seat 7: Pacifistas ($107.17 in chips) 
Seat 8: ilaviiitech ($107.94 in chips) 
Seat 9: matiko09 ($100 in chips) 
Pacifistas: posts small blind $0.50
ilaviiitech: posts big blind $1
Dachish: posts big blind $1
maaaGik88: sits out 
*** HOLE CARDS ***
Dealt to matiko09 [Ks Td]
lumen21 leaves the table
matiko09: folds 
hammerwife: raises $1.50 to $2.50
Vikulja1993: folds 
Dachish: folds 
R1aki: folds 
Pacifistas: folds 
ilaviiitech: folds 
Uncalled bet ($1.50) returned to hammerwife
hammerwife collected $3.50 from pot
hammerwife: doesn't show hand 
*** SUMMARY ***
Total pot $3.50 | Rake $0 
Seat 1: hammerwife collected ($3.50)
Seat 3: Vikulja1993 folded before Flop (didn't bet)
Seat 4: Dachish folded before Flop
Seat 6: R1aki (button) folded before Flop (didn't bet)
Seat 7: Pacifistas (small blind) folded before Flop
Seat 8: ilaviiitech (big blind) folded before Flop
Seat 9: matiko09 folded before Flop (didn't bet)





PokerStars Hand #150707603566:  Hold'em No Limit ($0.50/$1.00 USD) - 2016/03/21 17:03:32 CET [2016/03/21 12:03:32 ET]
Table 'Onnie II' 9-max Seat #1 is the button
Seat 1: aseban11 ($194.23 in chips) 
Seat 2: RICKA16 ($98.50 in chips) 
Seat 3: cn_chayanne ($152.91 in chips) 
Seat 4: Bothfeld11 ($171.37 in chips) 
Seat 5: sanpidk ($104.75 in chips) 
Seat 6: Pacifistas ($103.27 in chips) 
Seat 7: djammusic ($78.40 in chips) 
Seat 8: solbi86 ($100 in chips) 
Seat 9: matiko09 ($115.19 in chips) 
RICKA16: posts small blind $0.50
cn_chayanne: posts big blind $1
*** HOLE CARDS ***
Dealt to matiko09 [As 5s]
Bothfeld11: folds 
sanpidk: raises $2 to $3
Pacifistas: folds 
djammusic: folds 
solbi86: folds 
matiko09: raises $6.50 to $9.50
aseban11: folds 
RICKA16: folds 
cn_chayanne: folds 
sanpidk: folds 
Uncalled bet ($6.50) returned to matiko09
matiko09 collected $7.50 from pot
matiko09: doesn't show hand 
*** SUMMARY ***
Total pot $7.50 | Rake $0 
Seat 1: aseban11 (button) folded before Flop (didn't bet)
Seat 2: RICKA16 (small blind) folded before Flop
Seat 3: cn_chayanne (big blind) folded before Flop
Seat 4: Bothfeld11 folded before Flop (didn't bet)
Seat 5: sanpidk folded before Flop
Seat 6: Pacifistas folded before Flop (didn't bet)
Seat 7: djammusic folded before Flop (didn't bet)
Seat 8: solbi86 folded before Flop (didn't bet)
Seat 9: matiko09 collected ($7.50)





PokerStars Hand #150707605250:  Hold'em No Limit ($0.50/$1.00 USD) - 2016/03/21 17:03:34 CET [2016/03/21 12:03:34 ET]
Table 'Juhani' 9-max Seat #8 is the button
Seat 1: solbi86 ($100 in chips) 
Seat 5: Smartiecat ($101.28 in chips) 
Seat 6: Pacifistas ($100 in chips) 
Seat 7: matiko09 ($112.42 in chips) 
Seat 8: grifkaaa ($111.50 in chips) 
Seat 9: IntsAA ($96 in chips) 
IntsAA: posts small blind $0.50
solbi86: posts big blind $1
Vikulja1993: sits out 
ka100pka527: sits out 
*** HOLE CARDS ***
Dealt to matiko09 [Jd 7h]
Smartiecat: folds 
Pacifistas: folds 
matiko09: folds 
grifkaaa: folds 
IntsAA: folds 
Uncalled bet ($0.50) returned to solbi86
solbi86 collected $1 from pot
solbi86: doesn't show hand 
*** SUMMARY ***
Total pot $1 | Rake $0 
Seat 1: solbi86 (big blind) collected ($1)
Seat 5: Smartiecat folded before Flop (didn't bet)
Seat 6: Pacifistas folded before Flop (didn't bet)
Seat 7: matiko09 folded before Flop (didn't bet)
Seat 8: grifkaaa (button) folded before Flop (didn't bet)
Seat 9: IntsAA (small blind) folded before Flop





PokerStars Hand #150707609256:  Hold'em No Limit ($0.50/$1.00 USD) - 2016/03/21 17:03:39 CET [2016/03/21 12:03:39 ET]
Table 'Massalia II' 9-max Seat #4 is the button
Seat 1: crepke ($75.32 in chips) 
Seat 3: 123chambo ($76 in chips) 
Seat 4: OriginalTony ($91.92 in chips) 
Seat 5: Vikulja1993 ($100 in chips) 
Seat 6: Pacifistas ($138.67 in chips) 
Seat 7: flk.Dasas ($102.10 in chips) 
Seat 8: matiko09 ($174.91 in chips) 
Seat 9: hammerwife ($100.48 in chips) 
Vikulja1993: posts small blind $0.50
Pacifistas: posts big blind $1
maxxmeister: sits out 
crepke: posts the ante $0.20
123chambo: posts the ante $0.20
OriginalTony: posts the ante $0.20
Vikulja1993: posts the ante $0.20
Pacifistas: posts the ante $0.20
flk.Dasas: posts the ante $0.20
matiko09: posts the ante $0.20
hammerwife: posts the ante $0.20
*** HOLE CARDS ***
Dealt to matiko09 [4s 6h]
flk.Dasas: folds 
matiko09: folds 
hammerwife: folds 
crepke: folds 
123chambo: folds 
OriginalTony: raises $2 to $3
Vikulja1993: raises $7 to $10
Pacifistas: folds 
OriginalTony: raises $20 to $30
Vikulja1993: raises $30 to $60
OriginalTony: raises $31.72 to $91.72 and is all-in
Vikulja1993: calls $31.72
*** FIRST FLOP *** [3c Tc 9c]
*** FIRST TURN *** [3c Tc 9c] [2s]
*** FIRST RIVER *** [3c Tc 9c 2s] [7d]
*** SECOND FLOP *** [2d 4c Ah]
*** SECOND TURN *** [2d 4c Ah] [3d]
*** SECOND RIVER *** [2d 4c Ah 3d] [Qs]
*** FIRST SHOW DOWN ***
Vikulja1993: shows [Jd Jh] (a pair of Jacks)
OriginalTony: shows [As Ks] (high card Ace)
Vikulja1993 collected $91.62 from pot
*** SECOND SHOW DOWN ***
Vikulja1993: shows [Jd Jh] (a pair of Jacks)
OriginalTony: shows [As Ks] (a pair of Aces)
OriginalTony collected $91.62 from pot
*** SUMMARY ***
Total pot $186.04 | Rake $2.80 
Hand was run twice
FIRST Board [3c Tc 9c 2s 7d]
SECOND Board [2d 4c Ah 3d Qs]
Seat 1: crepke folded before Flop (didn't bet)
Seat 3: 123chambo folded before Flop (didn't bet)
Seat 4: OriginalTony (button) showed [As Ks] and lost with high card Ace, and won ($91.62) with a pair of Aces
Seat 5: Vikulja1993 (small blind) showed [Jd Jh] and won ($91.62) with a pair of Jacks, and lost with a pair of Jacks
Seat 6: Pacifistas (big blind) folded before Flop
Seat 7: flk.Dasas folded before Flop (didn't bet)
Seat 8: matiko09 folded before Flop (didn't bet)
Seat 9: hammerwife folded before Flop (didn't bet)





PokerStars Hand #150707613947:  Hold'em No Limit ($0.50/$1.00 USD) - 2016/03/21 17:03:46 CET [2016/03/21 12:03:46 ET]
Table 'Marmulla II' 9-max Seat #7 is the button
Seat 1: hammerwife ($102.50 in chips) 
Seat 3: Vikulja1993 ($105.14 in chips) 
Seat 4: Dachish ($69 in chips) 
Seat 6: R1aki ($100 in chips) 
Seat 7: Pacifistas ($106.67 in chips) 
Seat 8: ilaviiitech ($106.94 in chips) 
Seat 9: matiko09 ($100 in chips) 
ilaviiitech: posts small blind $0.50
matiko09: posts big blind $1
maaaGik88: sits out 
*** HOLE CARDS ***
Dealt to matiko09 [Ts Qh]
hammerwife: folds 
Vikulja1993: folds 
Dachish: folds 
R1aki: folds 
Pacifistas: raises $1.50 to $2.50
ilaviiitech: folds 
matiko09: calls $1.50
*** FLOP *** [4h 7d 3s]
matiko09: checks 
Pacifistas: bets $2.83
matiko09: folds 
Uncalled bet ($2.83) returned to Pacifistas
Pacifistas collected $5.25 from pot
Pacifistas: doesn't show hand 
*** SUMMARY ***
Total pot $5.50 | Rake $0.25 
Board [4h 7d 3s]
Seat 1: hammerwife folded before Flop (didn't bet)
Seat 3: Vikulja1993 folded before Flop (didn't bet)
Seat 4: Dachish folded before Flop (didn't bet)
Seat 6: R1aki folded before Flop (didn't bet)
Seat 7: Pacifistas (button) collected ($5.25)
Seat 8: ilaviiitech (small blind) folded before Flop
Seat 9: matiko09 (big blind) folded on the Flop





PokerStars Hand #150707620149:  Hold'em No Limit ($0.50/$1.00 USD) - 2016/03/21 17:03:54 CET [2016/03/21 12:03:54 ET]
Table 'Juhani' 9-max Seat #9 is the button
Seat 1: solbi86 ($100.50 in chips) 
Seat 3: Vikulja1993 ($141.27 in chips) 
Seat 5: Smartiecat ($101.28 in chips) 
Seat 6: Pacifistas ($100 in chips) 
Seat 7: matiko09 ($112.42 in chips) 
Seat 8: grifkaaa ($111.50 in chips) 
Seat 9: IntsAA ($96 in chips) 
solbi86: posts small blind $0.50
Vikulja1993: posts big blind $1
ka100pka527: sits out 
*** HOLE CARDS ***
Dealt to matiko09 [7c 6h]
Smartiecat: folds 
Pacifistas: folds 
matiko09: folds 
grifkaaa: raises $2 to $3
IntsAA: folds 
solbi86: folds 
Vikulja1993: calls $2
*** FLOP *** [Kh 9s 8s]
Vikulja1993: checks 
grifkaaa: bets $4.66
Vikulja1993: folds 
Uncalled bet ($4.66) returned to grifkaaa
grifkaaa collected $6.21 from pot
*** SUMMARY ***
Total pot $6.50 | Rake $0.29 
Board [Kh 9s 8s]
Seat 1: solbi86 (small blind) folded before Flop
Seat 3: Vikulja1993 (big blind) folded on the Flop
Seat 5: Smartiecat folded before Flop (didn't bet)
Seat 6: Pacifistas folded before Flop (didn't bet)
Seat 7: matiko09 folded before Flop (didn't bet)
Seat 8: grifkaaa collected ($6.21)
Seat 9: IntsAA (button) folded before Flop (didn't bet)





PokerStars Hand #150707622379:  Hold'em No Limit ($0.50/$1.00 USD) - 2016/03/21 17:03:57 CET [2016/03/21 12:03:57 ET]
Table 'Skadi III' 9-max Seat #1 is the button
Seat 1: CI58 ($100 in chips) 
Seat 2: aseban11 ($100 in chips) 
Seat 3: matiko09 ($101 in chips) 
Seat 4: ilaviiitech ($100 in chips) 
Seat 5: WaldiQ ($100 in chips) 
Seat 6: Pacifistas ($100.85 in chips) 
Seat 7: solbi86 ($120.66 in chips) 
Seat 8: volwebni4ek ($40 in chips) 
Seat 9: bradsheps ($162.80 in chips) 
aseban11: posts small blind $0.50
matiko09: posts big blind $1
*** HOLE CARDS ***
Dealt to matiko09 [3h 8c]
ilaviiitech: folds 
WaldiQ: folds 
Pacifistas: folds 
solbi86: raises $2 to $3
volwebni4ek: folds 
bradsheps: calls $3
CI58: folds 
aseban11: folds 
matiko09: folds 
*** FLOP *** [6s Ks 2s]
solbi86: bets $4.65
bradsheps: folds 
Uncalled bet ($4.65) returned to solbi86
solbi86 collected $7.16 from pot
solbi86: doesn't show hand 
*** SUMMARY ***
Total pot $7.50 | Rake $0.34 
Board [6s Ks 2s]
Seat 1: CI58 (button) folded before Flop (didn't bet)
Seat 2: aseban11 (small blind) folded before Flop
Seat 3: matiko09 (big blind) folded before Flop
Seat 4: ilaviiitech folded before Flop (didn't bet)
Seat 5: WaldiQ folded before Flop (didn't bet)
Seat 6: Pacifistas folded before Flop (didn't bet)
Seat 7: solbi86 collected ($7.16)
Seat 8: volwebni4ek folded before Flop (didn't bet)
Seat 9: bradsheps folded on the Flop





PokerStars Hand #150707630112:  Hold'em No Limit ($0.50/$1.00 USD) - 2016/03/21 17:04:07 CET [2016/03/21 12:04:07 ET]
Table 'Noel' 9-max Seat #6 is the button
Seat 1: ep538 ($48.52 in chips) 
Seat 2: cobrik23 ($161.90 in chips) 
Seat 3: gabi_igna ($175.34 in chips) 
Seat 5: matiko09 ($139.84 in chips) 
Seat 6: hammerwife ($106.90 in chips) 
Seat 7: djammusic ($53.52 in chips) 
Seat 8: Dachish ($74 in chips) 
Seat 9: grifkaaa ($103.25 in chips) 
djammusic: posts small blind $0.50
Dachish: posts big blind $1
*** HOLE CARDS ***
Dealt to matiko09 [5c 8h]
grifkaaa: raises $2 to $3
ep538: folds 
cobrik23: folds 
gabi_igna: folds 
matiko09: folds 
hammerwife: folds 
djammusic: folds 
Dachish: folds 
Uncalled bet ($2) returned to grifkaaa
grifkaaa collected $2.50 from pot
*** SUMMARY ***
Total pot $2.50 | Rake $0 
Seat 1: ep538 folded before Flop (didn't bet)
Seat 2: cobrik23 folded before Flop (didn't bet)
Seat 3: gabi_igna folded before Flop (didn't bet)
Seat 5: matiko09 folded before Flop (didn't bet)
Seat 6: hammerwife (button) folded before Flop (didn't bet)
Seat 7: djammusic (small blind) folded before Flop
Seat 8: Dachish (big blind) folded before Flop
Seat 9: grifkaaa collected ($2.50)





PokerStars Hand #150707639254:  Hold'em No Limit ($0.50/$1.00 USD) - 2016/03/21 17:04:19 CET [2016/03/21 12:04:19 ET]
Table 'Marmulla II' 9-max Seat #8 is the button
Seat 1: hammerwife ($102.50 in chips) 
Seat 3: Vikulja1993 ($105.14 in chips) 
Seat 4: Dachish ($69 in chips) 
Seat 5: maaaGik88 ($86.34 in chips) 
Seat 6: R1aki ($100 in chips) 
Seat 7: Pacifistas ($109.42 in chips) 
Seat 8: ilaviiitech ($106.44 in chips) 
Seat 9: matiko09 ($100 in chips) 
matiko09: posts small blind $0.50
hammerwife: posts big blind $1
maaaGik88: posts small & big blinds $1.50
*** HOLE CARDS ***
Dealt to matiko09 [7c 6d]
flk.Dasas joins the table at seat #2 
Vikulja1993: folds 
Dachish: raises $4 to $5
maaaGik88: folds 
R1aki: folds 
Pacifistas: folds 
ilaviiitech: folds 
matiko09: folds 
hammerwife: folds 
Uncalled bet ($4) returned to Dachish
Dachish collected $4 from pot
Dachish: doesn't show hand 
*** SUMMARY ***
Total pot $4 | Rake $0 
Seat 1: hammerwife (big blind) folded before Flop
Seat 3: Vikulja1993 folded before Flop (didn't bet)
Seat 4: Dachish collected ($4)
Seat 5: maaaGik88 folded before Flop
Seat 6: R1aki folded before Flop (didn't bet)
Seat 7: Pacifistas folded before Flop (didn't bet)
Seat 8: ilaviiitech (button) folded before Flop (didn't bet)
Seat 9: matiko09 (small blind) folded before Flop





PokerStars Hand #150707642138:  Hold'em No Limit ($0.50/$1.00 USD) - 2016/03/21 17:04:23 CET [2016/03/21 12:04:23 ET]
Table 'Lucifer III' 9-max Seat #1 is the button
Seat 1: Pacifistas ($147.96 in chips) 
Seat 2: matiko09 ($108.58 in chips) 
Seat 3: Vizonto ($30.23 in chips) 
Seat 4: RICKA16 ($100 in chips) 
Seat 5: cobrik23 ($69.90 in chips) 
Seat 6: solbi86 ($141.08 in chips) 
Seat 7: roninio1 ($138.54 in chips) 
Seat 8: aseban11 ($161.25 in chips) 
Seat 9: mycka86 ($108.20 in chips) 
matiko09: posts small blind $0.50
Vizonto: posts big blind $1
*** HOLE CARDS ***
Dealt to matiko09 [Ts As]
RICKA16: folds 
cobrik23: folds 
solbi86: folds 
roninio1: folds 
aseban11: folds 
mycka86: raises $1.10 to $2.10
Pacifistas: folds 
matiko09: calls $1.60
Vizonto: calls $1.10
*** FLOP *** [Qd 2s Ks]
matiko09: bets $4
Vizonto: folds 
mycka86: folds 
Uncalled bet ($4) returned to matiko09
matiko09 collected $6.02 from pot
matiko09: doesn't show hand 
*** SUMMARY ***
Total pot $6.30 | Rake $0.28 
Board [Qd 2s Ks]
Seat 1: Pacifistas (button) folded before Flop (didn't bet)
Seat 2: matiko09 (small blind) collected ($6.02)
Seat 3: Vizonto (big blind) folded on the Flop
Seat 4: RICKA16 folded before Flop (didn't bet)
Seat 5: cobrik23 folded before Flop (didn't bet)
Seat 6: solbi86 folded before Flop (didn't bet)
Seat 7: roninio1 folded before Flop (didn't bet)
Seat 8: aseban11 folded before Flop (didn't bet)
Seat 9: mycka86 folded on the Flop





PokerStars Hand #150707651556:  Hold'em No Limit ($0.50/$1.00 USD) - 2016/03/21 17:04:35 CET [2016/03/21 12:04:35 ET]
Table 'Onnie II' 9-max Seat #2 is the button
Seat 1: aseban11 ($194.23 in chips) 
Seat 2: RICKA16 ($100 in chips) 
Seat 3: cn_chayanne ($151.91 in chips) 
Seat 4: Bothfeld11 ($171.37 in chips) 
Seat 5: sanpidk ($101.75 in chips) 
Seat 6: Pacifistas ($103.27 in chips) 
Seat 7: djammusic ($78.40 in chips) 
Seat 8: solbi86 ($100 in chips) 
Seat 9: matiko09 ($119.69 in chips) 
cn_chayanne: posts small blind $0.50
Bothfeld11: posts big blind $1
*** HOLE CARDS ***
Dealt to matiko09 [Qc 7d]
sanpidk: raises $2 to $3
Pacifistas: folds 
djammusic: folds 
solbi86: folds 
matiko09: folds 
aseban11: folds 
RICKA16: folds 
cn_chayanne: folds 
Bothfeld11: folds 
Uncalled bet ($2) returned to sanpidk
sanpidk collected $2.50 from pot
sanpidk: doesn't show hand 
*** SUMMARY ***
Total pot $2.50 | Rake $0 
Seat 1: aseban11 folded before Flop (didn't bet)
Seat 2: RICKA16 (button) folded before Flop (didn't bet)
Seat 3: cn_chayanne (small blind) folded before Flop
Seat 4: Bothfeld11 (big blind) folded before Flop
Seat 5: sanpidk collected ($2.50)
Seat 6: Pacifistas folded before Flop (didn't bet)
Seat 7: djammusic folded before Flop (didn't bet)
Seat 8: solbi86 folded before Flop (didn't bet)
Seat 9: matiko09 folded before Flop (didn't bet)





PokerStars Hand #150707656300:  Hold'em No Limit ($0.50/$1.00 USD) - 2016/03/21 17:04:42 CET [2016/03/21 12:04:42 ET]
Table 'Noel' 9-max Seat #7 is the button
Seat 1: ep538 ($48.52 in chips) 
Seat 2: cobrik23 ($161.90 in chips) 
Seat 3: gabi_igna ($175.34 in chips) 
Seat 5: matiko09 ($139.84 in chips) 
Seat 6: hammerwife ($106.90 in chips) 
Seat 7: djammusic ($53.02 in chips) 
Seat 8: Dachish ($73 in chips) 
Seat 9: grifkaaa ($104.75 in chips) 
Dachish: posts small blind $0.50
grifkaaa: posts big blind $1
*** HOLE CARDS ***
Dealt to matiko09 [8s 7s]
ep538: calls $1
cobrik23: folds 
gabi_igna: folds 
matiko09: raises $3 to $4
hammerwife: raises $8 to $12
djammusic: folds 
Dachish: folds 
grifkaaa: folds 
ep538: folds 
matiko09: folds 
Uncalled bet ($8) returned to hammerwife
hammerwife collected $10.50 from pot
hammerwife: doesn't show hand 
*** SUMMARY ***
Total pot $10.50 | Rake $0 
Seat 1: ep538 folded before Flop
Seat 2: cobrik23 folded before Flop (didn't bet)
Seat 3: gabi_igna folded before Flop (didn't bet)
Seat 5: matiko09 folded before Flop
Seat 6: hammerwife collected ($10.50)
Seat 7: djammusic (button) folded before Flop (didn't bet)
Seat 8: Dachish (small blind) folded before Flop
Seat 9: grifkaaa (big blind) folded before Flop





PokerStars Hand #150707658353:  Hold'em No Limit ($0.50/$1.00 USD) - 2016/03/21 17:04:44 CET [2016/03/21 12:04:44 ET]
Table 'Icarion II' 9-max Seat #1 is the button
Seat 1: forsmthgood ($103.81 in chips) 
Seat 2: aseban11 ($100.25 in chips) 
Seat 3: volwebni4ek ($40 in chips) 
Seat 4: teukka8 ($55.10 in chips) 
Seat 5: SanychStar ($101.50 in chips) 
Seat 6: solbi86 ($109.72 in chips) 
Seat 7: Pacifistas ($100 in chips) 
Seat 8: matiko09 ($111.50 in chips) 
Seat 9: R1aki ($139.26 in chips) 
aseban11: posts small blind $0.50
volwebni4ek: posts big blind $1
*** HOLE CARDS ***
Dealt to matiko09 [Th 7c]
teukka8: folds 
SanychStar: folds 
solbi86: folds 
Pacifistas: folds 
matiko09: folds 
R1aki: raises $1.50 to $2.50
forsmthgood: calls $2.50
aseban11: folds 
volwebni4ek: raises $7 to $9.50
R1aki: folds 
forsmthgood: folds 
Uncalled bet ($7) returned to volwebni4ek
volwebni4ek collected $8 from pot
volwebni4ek: doesn't show hand 
*** SUMMARY ***
Total pot $8 | Rake $0 
Seat 1: forsmthgood (button) folded before Flop
Seat 2: aseban11 (small blind) folded before Flop
Seat 3: volwebni4ek (big blind) collected ($8)
Seat 4: teukka8 folded before Flop (didn't bet)
Seat 5: SanychStar folded before Flop (didn't bet)
Seat 6: solbi86 folded before Flop (didn't bet)
Seat 7: Pacifistas folded before Flop (didn't bet)
Seat 8: matiko09 folded before Flop (didn't bet)
Seat 9: R1aki folded before Flop





PokerStars Hand #150707660564:  Hold'em No Limit ($0.50/$1.00 USD) - 2016/03/21 17:04:47 CET [2016/03/21 12:04:47 ET]
Table 'Massalia II' 9-max Seat #5 is the button
Seat 1: crepke ($75.12 in chips) 
Seat 3: 123chambo ($75.80 in chips) 
Seat 4: OriginalTony ($91.62 in chips) 
Seat 5: Vikulja1993 ($100 in chips) 
Seat 6: Pacifistas ($137.47 in chips) 
Seat 7: flk.Dasas ($101.90 in chips) 
Seat 8: matiko09 ($174.71 in chips) 
Seat 9: hammerwife ($100.28 in chips) 
Pacifistas: posts small blind $0.50
flk.Dasas: posts big blind $1
maxxmeister: sits out 
crepke: posts the ante $0.20
123chambo: posts the ante $0.20
OriginalTony: posts the ante $0.20
Vikulja1993: posts the ante $0.20
Pacifistas: posts the ante $0.20
flk.Dasas: posts the ante $0.20
matiko09: posts the ante $0.20
hammerwife: posts the ante $0.20
*** HOLE CARDS ***
Dealt to matiko09 [2s 7c]
matiko09: folds 
hammerwife: raises $2 to $3
crepke: folds 
123chambo: folds 
OriginalTony: folds 
Vikulja1993: folds 
Pacifistas: folds 
flk.Dasas: folds 
Uncalled bet ($2) returned to hammerwife
hammerwife collected $4.10 from pot
hammerwife: doesn't show hand 
*** SUMMARY ***
Total pot $4.10 | Rake $0 
Seat 1: crepke folded before Flop (didn't bet)
Seat 3: 123chambo folded before Flop (didn't bet)
Seat 4: OriginalTony folded before Flop (didn't bet)
Seat 5: Vikulja1993 (button) folded before Flop (didn't bet)
Seat 6: Pacifistas (small blind) folded before Flop
Seat 7: flk.Dasas (big blind) folded before Flop
Seat 8: matiko09 folded before Flop (didn't bet)
Seat 9: hammerwife collected ($4.10)





PokerStars Hand #150707664993:  Hold'em No Limit ($0.50/$1.00 USD) - 2016/03/21 17:04:53 CET [2016/03/21 12:04:53 ET]
Table 'Marmulla II' 9-max Seat #9 is the button
Seat 1: hammerwife ($101.50 in chips) 
Seat 3: Vikulja1993 ($105.14 in chips) 
Seat 4: Dachish ($72 in chips) 
Seat 5: maaaGik88 ($84.84 in chips) 
Seat 6: R1aki ($100 in chips) 
Seat 7: Pacifistas ($109.42 in chips) 
Seat 8: ilaviiitech ($106.44 in chips) 
Seat 9: matiko09 ($100 in chips) 
hammerwife: posts small blind $0.50
Vikulja1993: posts big blind $1
*** HOLE CARDS ***
Dealt to matiko09 [7s 4h]
Dachish: folds 
maaaGik88: folds 
R1aki: raises $1.50 to $2.50
Pacifistas: folds 
ilaviiitech: folds 
matiko09: folds 
hammerwife: folds 
Vikulja1993: folds 
Uncalled bet ($1.50) returned to R1aki
R1aki collected $2.50 from pot
R1aki: doesn't show hand 
*** SUMMARY ***
Total pot $2.50 | Rake $0 
Seat 1: hammerwife (small blind) folded before Flop
Seat 3: Vikulja1993 (big blind) folded before Flop
Seat 4: Dachish folded before Flop (didn't bet)
Seat 5: maaaGik88 folded before Flop (didn't bet)
Seat 6: R1aki collected ($2.50)
Seat 7: Pacifistas folded before Flop (didn't bet)
Seat 8: ilaviiitech folded before Flop (didn't bet)
Seat 9: matiko09 (button) folded before Flop (didn't bet)





PokerStars Hand #150707666299:  Hold'em No Limit ($0.50/$1.00 USD) - 2016/03/21 17:04:55 CET [2016/03/21 12:04:55 ET]
Table 'Onnie II' 9-max Seat #3 is the button
Seat 1: aseban11 ($194.23 in chips) 
Seat 2: RICKA16 ($100 in chips) 
Seat 3: cn_chayanne ($151.41 in chips) 
Seat 4: Bothfeld11 ($170.37 in chips) 
Seat 5: sanpidk ($103.25 in chips) 
Seat 6: Pacifistas ($103.27 in chips) 
Seat 7: djammusic ($78.40 in chips) 
Seat 8: solbi86 ($100 in chips) 
Seat 9: matiko09 ($119.69 in chips) 
Bothfeld11: posts small blind $0.50
sanpidk: posts big blind $1
*** HOLE CARDS ***
Dealt to matiko09 [7c 9c]
Pacifistas: raises $2 to $3
djammusic: folds 
solbi86: folds 
matiko09: folds 
aseban11: folds 
RICKA16: folds 
cn_chayanne: folds 
Bothfeld11: folds 
sanpidk: folds 
Uncalled bet ($2) returned to Pacifistas
Pacifistas collected $2.50 from pot
Pacifistas: doesn't show hand 
*** SUMMARY ***
Total pot $2.50 | Rake $0 
Seat 1: aseban11 folded before Flop (didn't bet)
Seat 2: RICKA16 folded before Flop (didn't bet)
Seat 3: cn_chayanne (button) folded before Flop (didn't bet)
Seat 4: Bothfeld11 (small blind) folded before Flop
Seat 5: sanpidk (big blind) folded before Flop
Seat 6: Pacifistas collected ($2.50)
Seat 7: djammusic folded before Flop (didn't bet)
Seat 8: solbi86 folded before Flop (didn't bet)
Seat 9: matiko09 folded before Flop (didn't bet)





PokerStars Hand #150707668632:  Hold'em No Limit ($0.50/$1.00 USD) - 2016/03/21 17:04:58 CET [2016/03/21 12:04:58 ET]
Table 'Skadi III' 9-max Seat #2 is the button
Seat 1: CI58 ($100 in chips) 
Seat 2: aseban11 ($100 in chips) 
Seat 3: matiko09 ($100 in chips) 
Seat 4: ilaviiitech ($100 in chips) 
Seat 5: WaldiQ ($100 in chips) 
Seat 6: Pacifistas ($100.85 in chips) 
Seat 7: solbi86 ($124.82 in chips) 
Seat 8: volwebni4ek ($40 in chips) 
Seat 9: bradsheps ($159.80 in chips) 
matiko09: posts small blind $0.50
ilaviiitech: posts big blind $1
*** HOLE CARDS ***
Dealt to matiko09 [Th 5h]
WaldiQ: folds 
Pacifistas: folds 
solbi86: folds 
volwebni4ek: folds 
bradsheps: raises $1 to $2
CI58: folds 
aseban11: folds 
matiko09: folds 
ilaviiitech: raises $8.50 to $10.50
bradsheps: folds 
Uncalled bet ($8.50) returned to ilaviiitech
ilaviiitech collected $4.50 from pot
ilaviiitech: doesn't show hand 
*** SUMMARY ***
Total pot $4.50 | Rake $0 
Seat 1: CI58 folded before Flop (didn't bet)
Seat 2: aseban11 (button) folded before Flop (didn't bet)
Seat 3: matiko09 (small blind) folded before Flop
Seat 4: ilaviiitech (big blind) collected ($4.50)
Seat 5: WaldiQ folded before Flop (didn't bet)
Seat 6: Pacifistas folded before Flop (didn't bet)
Seat 7: solbi86 folded before Flop (didn't bet)
Seat 8: volwebni4ek folded before Flop (didn't bet)
Seat 9: bradsheps folded before Flop





PokerStars Hand #150707672238:  Hold'em No Limit ($0.50/$1.00 USD) - 2016/03/21 17:05:02 CET [2016/03/21 12:05:02 ET]
Table 'Lucifer III' 9-max Seat #2 is the button
Seat 1: Pacifistas ($147.96 in chips) 
Seat 2: matiko09 ($112.50 in chips) 
Seat 3: Vizonto ($28.13 in chips) 
Seat 4: RICKA16 ($100 in chips) 
Seat 5: cobrik23 ($69.90 in chips) 
Seat 6: solbi86 ($141.08 in chips) 
Seat 7: roninio1 ($138.54 in chips) 
Seat 8: aseban11 ($161.25 in chips) 
Seat 9: mycka86 ($106.10 in chips) 
Vizonto: posts small blind $0.50
RICKA16: posts big blind $1
*** HOLE CARDS ***
Dealt to matiko09 [Kd 9s]
cobrik23: folds 
solbi86: folds 
roninio1: raises $2 to $3
aseban11: calls $3
mycka86: folds 
Pacifistas: folds 
matiko09: folds 
Vizonto: calls $2.50
RICKA16: folds 
*** FLOP *** [3c 5c 5s]
Vizonto: checks 
roninio1: bets $135.54 and is all-in
aseban11: folds 
Vizonto: folds 
Uncalled bet ($135.54) returned to roninio1
roninio1 collected $9.55 from pot
roninio1: doesn't show hand 
*** SUMMARY ***
Total pot $10 | Rake $0.45 
Board [3c 5c 5s]
Seat 1: Pacifistas folded before Flop (didn't bet)
Seat 2: matiko09 (button) folded before Flop (didn't bet)
Seat 3: Vizonto (small blind) folded on the Flop
Seat 4: RICKA16 (big blind) folded before Flop
Seat 5: cobrik23 folded before Flop (didn't bet)
Seat 6: solbi86 folded before Flop (didn't bet)
Seat 7: roninio1 collected ($9.55)
Seat 8: aseban11 folded on the Flop
Seat 9: mycka86 folded before Flop (didn't bet)





PokerStars Hand #150707678631:  Hold'em No Limit (€0.25/€0.50 EUR) - 2016/03/21 17:05:11 CET [2016/03/21 12:05:11 ET]
Table 'Auravictrix II' 9-max Seat #3 is the button
Seat 1: aponinho82 (€44.96 in chips) 
Seat 2: ffac (€57.56 in chips) 
Seat 3: matiko09 (€52.96 in chips) 
Seat 4: i am owsome (€94.25 in chips) 
Seat 5: nombraalne1 (€67.16 in chips) 
Seat 6: Devsteel (€62.83 in chips) 
Seat 7: vasiy379 (€50 in chips) 
Seat 8: ardo888 (€50 in chips) 
Seat 9: carlouchi (€40.65 in chips) 
i am owsome: posts small blind €0.25
nombraalne1: posts big blind €0.50
*** HOLE CARDS ***
Dealt to matiko09 [Th Jh]
Devsteel: raises €1 to €1.50
vasiy379: folds 
ardo888: folds 
carlouchi: folds 
aponinho82: calls €1.50
ffac: raises €4.50 to €6
matiko09: folds 
i am owsome: folds 
nombraalne1: folds 
Devsteel: calls €4.50
aponinho82: calls €4.50
*** FLOP *** [5c Jc 8c]
Devsteel: checks 
aponinho82: checks 
ffac: bets €6.50
Devsteel: calls €6.50
aponinho82: raises €15.50 to €22
ffac: calls €15.50
Devsteel: folds 
*** TURN *** [5c Jc 8c] [Kh]
aponinho82: bets €16.96 and is all-in
ffac: calls €16.96
*** RIVER *** [5c Jc 8c Kh] [9s]
*** SHOW DOWN ***
aponinho82: shows [Tc Qc] (a flush, Queen high)
ffac: mucks hand 
aponinho82 collected €101.17 from pot
*** SUMMARY ***
Total pot €103.17 | Rake €2 
Board [5c Jc 8c Kh 9s]
Seat 1: aponinho82 showed [Tc Qc] and won (€101.17) with a flush, Queen high
Seat 2: ffac mucked [Ad Ac]
Seat 3: matiko09 (button) folded before Flop (didn't bet)
Seat 4: i am owsome (small blind) folded before Flop
Seat 5: nombraalne1 (big blind) folded before Flop
Seat 6: Devsteel folded on the Flop
Seat 7: vasiy379 folded before Flop (didn't bet)
Seat 8: ardo888 folded before Flop (didn't bet)
Seat 9: carlouchi folded before Flop (didn't bet)





PokerStars Hand #150707681747:  Hold'em No Limit ($0.50/$1.00 USD) - 2016/03/21 17:05:15 CET [2016/03/21 12:05:15 ET]
Table 'Noel' 9-max Seat #8 is the button
Seat 2: cobrik23 ($161.90 in chips) 
Seat 3: gabi_igna ($175.34 in chips) 
Seat 5: matiko09 ($135.84 in chips) 
Seat 6: hammerwife ($113.40 in chips) 
Seat 7: djammusic ($53.02 in chips) 
Seat 8: Dachish ($72.50 in chips) 
Seat 9: grifkaaa ($103.75 in chips) 
grifkaaa: posts small blind $0.50
ep538: is sitting out 
cobrik23: posts big blind $1
*** HOLE CARDS ***
Dealt to matiko09 [As 8h]
gabi_igna: folds 
matiko09: folds 
hammerwife: folds 
djammusic: folds 
Dachish: folds 
grifkaaa: folds 
Uncalled bet ($0.50) returned to cobrik23
cobrik23 collected $1 from pot
cobrik23: doesn't show hand 
*** SUMMARY ***
Total pot $1 | Rake $0 
Seat 2: cobrik23 (big blind) collected ($1)
Seat 3: gabi_igna folded before Flop (didn't bet)
Seat 5: matiko09 folded before Flop (didn't bet)
Seat 6: hammerwife folded before Flop (didn't bet)
Seat 7: djammusic folded before Flop (didn't bet)
Seat 8: Dachish (button) folded before Flop (didn't bet)
Seat 9: grifkaaa (small blind) folded before Flop





PokerStars Hand #150707687251:  Hold'em No Limit ($0.50/$1.00 USD) - 2016/03/21 17:05:22 CET [2016/03/21 12:05:22 ET]
Table 'Juhani' 9-max Seat #1 is the button
Seat 1: solbi86 ($100 in chips) 
Seat 3: Vikulja1993 ($138.27 in chips) 
Seat 4: ka100pka527 ($153.89 in chips) 
Seat 5: Smartiecat ($101.28 in chips) 
Seat 6: Pacifistas ($100 in chips) 
Seat 7: matiko09 ($112.42 in chips) 
Seat 8: grifkaaa ($114.71 in chips) 
Seat 9: IntsAA ($96 in chips) 
Vikulja1993: posts small blind $0.50
ka100pka527: posts big blind $1
*** HOLE CARDS ***
Dealt to matiko09 [Js 7h]
Smartiecat: folds 
Pacifistas: folds 
matiko09: folds 
grifkaaa: raises $2 to $3
IntsAA: folds 
solbi86: folds 
Vikulja1993: folds 
ka100pka527: folds 
Uncalled bet ($2) returned to grifkaaa
grifkaaa collected $2.50 from pot
*** SUMMARY ***
Total pot $2.50 | Rake $0 
Seat 1: solbi86 (button) folded before Flop (didn't bet)
Seat 3: Vikulja1993 (small blind) folded before Flop
Seat 4: ka100pka527 (big blind) folded before Flop
Seat 5: Smartiecat folded before Flop (didn't bet)
Seat 6: Pacifistas folded before Flop (didn't bet)
Seat 7: matiko09 folded before Flop (didn't bet)
Seat 8: grifkaaa collected ($2.50)
Seat 9: IntsAA folded before Flop (didn't bet)





PokerStars Hand #150707687752:  Hold'em No Limit ($0.50/$1.00 USD) - 2016/03/21 17:05:23 CET [2016/03/21 12:05:23 ET]
Table 'Onnie II' 9-max Seat #4 is the button
Seat 1: aseban11 ($194.23 in chips) 
Seat 2: RICKA16 ($100 in chips) 
Seat 3: cn_chayanne ($151.41 in chips) 
Seat 4: Bothfeld11 ($169.87 in chips) 
Seat 5: sanpidk ($102.25 in chips) 
Seat 6: Pacifistas ($104.77 in chips) 
Seat 7: djammusic ($78.40 in chips) 
Seat 8: solbi86 ($100 in chips) 
Seat 9: matiko09 ($119.69 in chips) 
sanpidk: posts small blind $0.50
Pacifistas: posts big blind $1
*** HOLE CARDS ***
Dealt to matiko09 [Kh Qd]
djammusic: folds 
solbi86: folds 
matiko09: raises $2 to $3
aseban11: folds 
RICKA16: folds 
cn_chayanne: folds 
Bothfeld11: folds 
sanpidk: folds 
Pacifistas: folds 
Uncalled bet ($2) returned to matiko09
matiko09 collected $2.50 from pot
matiko09: doesn't show hand 
*** SUMMARY ***
Total pot $2.50 | Rake $0 
Seat 1: aseban11 folded before Flop (didn't bet)
Seat 2: RICKA16 folded before Flop (didn't bet)
Seat 3: cn_chayanne folded before Flop (didn't bet)
Seat 4: Bothfeld11 (button) folded before Flop (didn't bet)
Seat 5: sanpidk (small blind) folded before Flop
Seat 6: Pacifistas (big blind) folded before Flop
Seat 7: djammusic folded before Flop (didn't bet)
Seat 8: solbi86 folded before Flop (didn't bet)
Seat 9: matiko09 collected ($2.50)





PokerStars Hand #150707691588:  Hold'em No Limit ($0.50/$1.00 USD) - 2016/03/21 17:05:28 CET [2016/03/21 12:05:28 ET]
Table 'Massalia II' 9-max Seat #6 is the button
Seat 1: crepke ($74.92 in chips) 
Seat 3: 123chambo ($75.60 in chips) 
Seat 4: OriginalTony ($91.42 in chips) 
Seat 5: Vikulja1993 ($100 in chips) 
Seat 6: Pacifistas ($136.77 in chips) 
Seat 7: flk.Dasas ($100.70 in chips) 
Seat 8: matiko09 ($174.51 in chips) 
Seat 9: hammerwife ($103.18 in chips) 
flk.Dasas: posts small blind $0.50
matiko09: posts big blind $1
maxxmeister: sits out 
crepke: posts the ante $0.20
123chambo: posts the ante $0.20
OriginalTony: posts the ante $0.20
Vikulja1993: posts the ante $0.20
Pacifistas: posts the ante $0.20
flk.Dasas: posts the ante $0.20
matiko09: posts the ante $0.20
hammerwife: posts the ante $0.20
*** HOLE CARDS ***
Dealt to matiko09 [7s 4s]
hammerwife: folds 
crepke: folds 
123chambo: raises $2 to $3
OriginalTony: folds 
Vikulja1993: folds 
Pacifistas: folds 
flk.Dasas: folds 
matiko09: folds 
Uncalled bet ($2) returned to 123chambo
123chambo collected $4.10 from pot
123chambo: doesn't show hand 
*** SUMMARY ***
Total pot $4.10 | Rake $0 
Seat 1: crepke folded before Flop (didn't bet)
Seat 3: 123chambo collected ($4.10)
Seat 4: OriginalTony folded before Flop (didn't bet)
Seat 5: Vikulja1993 folded before Flop (didn't bet)
Seat 6: Pacifistas (button) folded before Flop (didn't bet)
Seat 7: flk.Dasas (small blind) folded before Flop
Seat 8: matiko09 (big blind) folded before Flop
Seat 9: hammerwife folded before Flop (didn't bet)





PokerStars Hand #150707700887:  Hold'em No Limit ($0.50/$1.00 USD) - 2016/03/21 17:05:40 CET [2016/03/21 12:05:40 ET]
Table 'Noel' 9-max Seat #9 is the button
Seat 2: cobrik23 ($162.40 in chips) 
Seat 5: matiko09 ($135.84 in chips) 
Seat 6: hammerwife ($113.40 in chips) 
Seat 7: djammusic ($53.02 in chips) 
Seat 8: Dachish ($72.50 in chips) 
Seat 9: grifkaaa ($103.25 in chips) 
cobrik23: posts small blind $0.50
gabi_igna: is sitting out 
matiko09: posts big blind $1
*** HOLE CARDS ***
Dealt to matiko09 [3c Ad]
gabi_igna leaves the table
solbi86 joins the table at seat #3 
hammerwife: folds 
Kobiroga150 is disconnected 
djammusic: folds 
Dachish: folds 
grifkaaa: raises $1.40 to $2.40
cobrik23: folds 
matiko09: calls $1.40
*** FLOP *** [5c 6c Ah]
matiko09: checks 
grifkaaa: checks 
*** TURN *** [5c 6c Ah] [3s]
matiko09: bets $4
grifkaaa: folds 
Uncalled bet ($4) returned to matiko09
matiko09 collected $5.06 from pot
matiko09: doesn't show hand 
*** SUMMARY ***
Total pot $5.30 | Rake $0.24 
Board [5c 6c Ah 3s]
Seat 2: cobrik23 (small blind) folded before Flop
Seat 5: matiko09 (big blind) collected ($5.06)
Seat 6: hammerwife folded before Flop (didn't bet)
Seat 7: djammusic folded before Flop (didn't bet)
Seat 8: Dachish folded before Flop (didn't bet)
Seat 9: grifkaaa (button) folded on the Turn





PokerStars Hand #150707701330:  Hold'em No Limit ($0.50/$1.00 USD) - 2016/03/21 17:05:41 CET [2016/03/21 12:05:41 ET]
Table 'Skadi III' 9-max Seat #3 is the button
Seat 1: CI58 ($100 in chips) 
Seat 2: aseban11 ($100 in chips) 
Seat 3: matiko09 ($100 in chips) 
Seat 4: ilaviiitech ($102.50 in chips) 
Seat 5: WaldiQ ($100 in chips) 
Seat 6: Pacifistas ($100.85 in chips) 
Seat 7: solbi86 ($124.82 in chips) 
Seat 8: volwebni4ek ($40 in chips) 
Seat 9: bradsheps ($157.80 in chips) 
ilaviiitech: posts small blind $0.50
WaldiQ: posts big blind $1
*** HOLE CARDS ***
Dealt to matiko09 [Qs 4c]
Pacifistas: folds 
solbi86: folds 
volwebni4ek: folds 
bradsheps: folds 
CI58: folds 
aseban11: raises $1.50 to $2.50
matiko09: folds 
ilaviiitech: calls $2
WaldiQ: calls $1.50
*** FLOP *** [2d Jd 2s]
ilaviiitech: checks 
WaldiQ: checks 
aseban11: checks 
*** TURN *** [2d Jd 2s] [6h]
ilaviiitech: bets $4
WaldiQ is disconnected 
WaldiQ has timed out while disconnected
WaldiQ: folds 
aseban11: folds 
Uncalled bet ($4) returned to ilaviiitech
ilaviiitech collected $7.16 from pot
ilaviiitech: doesn't show hand 
*** SUMMARY ***
Total pot $7.50 | Rake $0.34 
Board [2d Jd 2s 6h]
Seat 1: CI58 folded before Flop (didn't bet)
Seat 2: aseban11 folded on the Turn
Seat 3: matiko09 (button) folded before Flop (didn't bet)
Seat 4: ilaviiitech (small blind) collected ($7.16)
Seat 5: WaldiQ (big blind) folded on the Turn
Seat 6: Pacifistas folded before Flop (didn't bet)
Seat 7: solbi86 folded before Flop (didn't bet)
Seat 8: volwebni4ek folded before Flop (didn't bet)
Seat 9: bradsheps folded before Flop (didn't bet)





PokerStars Hand #150707704079:  Hold'em No Limit ($0.50/$1.00 USD) - 2016/03/21 17:05:44 CET [2016/03/21 12:05:44 ET]
Table 'Onnie II' 9-max Seat #5 is the button
Seat 1: aseban11 ($194.23 in chips) 
Seat 2: RICKA16 ($100 in chips) 
Seat 3: cn_chayanne ($151.41 in chips) 
Seat 4: Bothfeld11 ($169.87 in chips) 
Seat 5: sanpidk ($101.75 in chips) 
Seat 6: Pacifistas ($103.77 in chips) 
Seat 7: djammusic ($78.40 in chips) 
Seat 8: solbi86 ($100 in chips) 
Seat 9: matiko09 ($121.19 in chips) 
Pacifistas: posts small blind $0.50
djammusic: posts big blind $1
*** HOLE CARDS ***
Dealt to matiko09 [Qs 2s]
solbi86: folds 
matiko09: folds 
aseban11: folds 
RICKA16: folds 
cn_chayanne: folds 
Bothfeld11: folds 
sanpidk: folds 
Pacifistas: raises $1.18 to $2.18
djammusic: folds 
Uncalled bet ($1.18) returned to Pacifistas
Pacifistas collected $2 from pot
Pacifistas: doesn't show hand 
*** SUMMARY ***
Total pot $2 | Rake $0 
Seat 1: aseban11 folded before Flop (didn't bet)
Seat 2: RICKA16 folded before Flop (didn't bet)
Seat 3: cn_chayanne folded before Flop (didn't bet)
Seat 4: Bothfeld11 folded before Flop (didn't bet)
Seat 5: sanpidk (button) folded before Flop (didn't bet)
Seat 6: Pacifistas (small blind) collected ($2)
Seat 7: djammusic (big blind) folded before Flop
Seat 8: solbi86 folded before Flop (didn't bet)
Seat 9: matiko09 folded before Flop (didn't bet)





PokerStars Hand #150707704239:  Hold'em No Limit ($0.50/$1.00 USD) - 2016/03/21 17:05:44 CET [2016/03/21 12:05:44 ET]
Table 'Marmulla II' 9-max Seat #1 is the button
Seat 1: hammerwife ($101 in chips) 
Seat 3: Vikulja1993 ($104.14 in chips) 
Seat 4: Dachish ($72 in chips) 
Seat 5: maaaGik88 ($84.84 in chips) 
Seat 6: R1aki ($101.50 in chips) 
Seat 7: Pacifistas ($109.42 in chips) 
Seat 8: ilaviiitech ($106.44 in chips) 
Seat 9: matiko09 ($100 in chips) 
Vikulja1993: posts small blind $0.50
Dachish: posts big blind $1
*** HOLE CARDS ***
Dealt to matiko09 [8d Qd]
maaaGik88: folds 
R1aki: folds 
Pacifistas: folds 
ilaviiitech: folds 
matiko09: raises $1.50 to $2.50
hammerwife: raises $5.50 to $8
Vikulja1993: folds 
Dachish: raises $11.50 to $19.50
matiko09: folds 
hammerwife: folds 
Uncalled bet ($11.50) returned to Dachish
Dachish collected $19 from pot
Dachish: doesn't show hand 
*** SUMMARY ***
Total pot $19 | Rake $0 
Seat 1: hammerwife (button) folded before Flop
Seat 3: Vikulja1993 (small blind) folded before Flop
Seat 4: Dachish (big blind) collected ($19)
Seat 5: maaaGik88 folded before Flop (didn't bet)
Seat 6: R1aki folded before Flop (didn't bet)
Seat 7: Pacifistas folded before Flop (didn't bet)
Seat 8: ilaviiitech folded before Flop (didn't bet)
Seat 9: matiko09 folded before Flop





PokerStars Hand #150707703717:  Hold'em No Limit ($0.50/$1.00 USD) - 2016/03/21 17:05:44 CET [2016/03/21 12:05:44 ET]
Table 'Lucifer III' 9-max Seat #3 is the button
Seat 1: Pacifistas ($147.96 in chips) 
Seat 2: matiko09 ($112.50 in chips) 
Seat 3: Vizonto ($25.13 in chips) 
Seat 4: RICKA16 ($99 in chips) 
Seat 5: cobrik23 ($69.90 in chips) 
Seat 6: solbi86 ($141.08 in chips) 
Seat 7: roninio1 ($145.09 in chips) 
Seat 8: aseban11 ($158.25 in chips) 
Seat 9: mycka86 ($106.10 in chips) 
RICKA16: posts small blind $0.50
cobrik23: posts big blind $1
*** HOLE CARDS ***
Dealt to matiko09 [7h 5d]
solbi86: folds 
roninio1: folds 
aseban11: folds 
mycka86: folds 
Pacifistas: folds 
matiko09: folds 
Vizonto: folds 
RICKA16: folds 
Uncalled bet ($0.50) returned to cobrik23
cobrik23 collected $1 from pot
cobrik23: doesn't show hand 
*** SUMMARY ***
Total pot $1 | Rake $0 
Seat 1: Pacifistas folded before Flop (didn't bet)
Seat 2: matiko09 folded before Flop (didn't bet)
Seat 3: Vizonto (button) folded before Flop (didn't bet)
Seat 4: RICKA16 (small blind) folded before Flop
Seat 5: cobrik23 (big blind) collected ($1)
Seat 6: solbi86 folded before Flop (didn't bet)
Seat 7: roninio1 folded before Flop (didn't bet)
Seat 8: aseban11 folded before Flop (didn't bet)
Seat 9: mycka86 folded before Flop (didn't bet)





PokerStars Hand #150707707554:  Hold'em No Limit ($0.50/$1.00 USD) - 2016/03/21 17:05:49 CET [2016/03/21 12:05:49 ET]
Table 'Massalia II' 9-max Seat #7 is the button
Seat 1: crepke ($74.72 in chips) 
Seat 3: 123chambo ($78.50 in chips) 
Seat 4: OriginalTony ($91.22 in chips) 
Seat 5: Vikulja1993 ($100 in chips) 
Seat 6: Pacifistas ($136.57 in chips) 
Seat 7: flk.Dasas ($100 in chips) 
Seat 8: matiko09 ($173.31 in chips) 
Seat 9: hammerwife ($102.98 in chips) 
matiko09: posts small blind $0.50
hammerwife: posts big blind $1
maxxmeister: sits out 
crepke: posts the ante $0.20
123chambo: posts the ante $0.20
OriginalTony: posts the ante $0.20
Vikulja1993: posts the ante $0.20
Pacifistas: posts the ante $0.20
flk.Dasas: posts the ante $0.20
matiko09: posts the ante $0.20
hammerwife: posts the ante $0.20
*** HOLE CARDS ***
Dealt to matiko09 [7d 2s]
crepke: folds 
123chambo: calls $1
OriginalTony: folds 
Vikulja1993: folds 
Pacifistas: raises $3 to $4
flk.Dasas: folds 
matiko09: folds 
hammerwife: raises $9 to $13
123chambo: folds 
Pacifistas: calls $9
*** FLOP *** [6s 5s 3s]
hammerwife: bets $13.89
Pacifistas: folds 
Uncalled bet ($13.89) returned to hammerwife
hammerwife collected $27.79 from pot
hammerwife: doesn't show hand 
*** SUMMARY ***
Total pot $29.10 | Rake $1.31 
Board [6s 5s 3s]
Seat 1: crepke folded before Flop (didn't bet)
Seat 3: 123chambo folded before Flop
Seat 4: OriginalTony folded before Flop (didn't bet)
Seat 5: Vikulja1993 folded before Flop (didn't bet)
Seat 6: Pacifistas folded on the Flop
Seat 7: flk.Dasas (button) folded before Flop (didn't bet)
Seat 8: matiko09 (small blind) folded before Flop
Seat 9: hammerwife (big blind) collected ($27.79)





PokerStars Hand #150707717842:  Hold'em No Limit ($0.50/$1.00 USD) - 2016/03/21 17:06:02 CET [2016/03/21 12:06:02 ET]
Table 'Icarion II' 9-max Seat #2 is the button
Seat 1: forsmthgood ($101.31 in chips) 
Seat 2: aseban11 ($100 in chips) 
Seat 3: volwebni4ek ($45.50 in chips) 
Seat 4: teukka8 ($55.10 in chips) 
Seat 5: SanychStar ($101.50 in chips) 
Seat 6: solbi86 ($109.72 in chips) 
Seat 7: Pacifistas ($100 in chips) 
Seat 8: matiko09 ($111.50 in chips) 
Seat 9: R1aki ($136.76 in chips) 
volwebni4ek: posts small blind $0.50
teukka8: posts big blind $1
*** HOLE CARDS ***
Dealt to matiko09 [2c 4s]
SanychStar: raises $1.50 to $2.50
solbi86: folds 
Pacifistas: folds 
matiko09: folds 
R1aki: folds 
forsmthgood: folds 
aseban11: folds 
volwebni4ek: folds 
teukka8: calls $1.50
*** FLOP *** [2h Ts Kd]
teukka8: bets $3
SanychStar: calls $3
*** TURN *** [2h Ts Kd] [Ad]
teukka8: bets $4
SanychStar: raises $6 to $10
teukka8: calls $6
*** RIVER *** [2h Ts Kd Ad] [4d]
teukka8: checks 
SanychStar: bets $10
teukka8: calls $10
*** SHOW DOWN ***
SanychStar: shows [Jd Ah] (a pair of Aces)
teukka8: mucks hand 
SanychStar collected $49.18 from pot
*** SUMMARY ***
Total pot $51.50 | Rake $2.32 
Board [2h Ts Kd Ad 4d]
Seat 1: forsmthgood folded before Flop (didn't bet)
Seat 2: aseban11 (button) folded before Flop (didn't bet)
Seat 3: volwebni4ek (small blind) folded before Flop
Seat 4: teukka8 (big blind) mucked [Ac 6s]
Seat 5: SanychStar showed [Jd Ah] and won ($49.18) with a pair of Aces
Seat 6: solbi86 folded before Flop (didn't bet)
Seat 7: Pacifistas folded before Flop (didn't bet)
Seat 8: matiko09 folded before Flop (didn't bet)
Seat 9: R1aki folded before Flop (didn't bet)





PokerStars Hand #150707717962:  Hold'em No Limit ($0.50/$1.00 USD) - 2016/03/21 17:06:02 CET [2016/03/21 12:06:02 ET]
Table 'Juhani' 9-max Seat #3 is the button
Seat 1: solbi86 ($100 in chips) 
Seat 3: Vikulja1993 ($137.77 in chips) 
Seat 4: ka100pka527 ($152.89 in chips) 
Seat 5: Smartiecat ($101.28 in chips) 
Seat 6: Pacifistas ($100 in chips) 
Seat 7: matiko09 ($112.42 in chips) 
Seat 8: grifkaaa ($116.21 in chips) 
Seat 9: IntsAA ($96 in chips) 
ka100pka527: posts small blind $0.50
Smartiecat: posts big blind $1
*** HOLE CARDS ***
Dealt to matiko09 [4s 5d]
Pacifistas: folds 
matiko09: folds 
grifkaaa: raises $2 to $3
IntsAA: folds 
solbi86: folds 
Vikulja1993: folds 
ka100pka527: folds 
Smartiecat: folds 
Uncalled bet ($2) returned to grifkaaa
grifkaaa collected $2.50 from pot
*** SUMMARY ***
Total pot $2.50 | Rake $0 
Seat 1: solbi86 folded before Flop (didn't bet)
Seat 3: Vikulja1993 (button) folded before Flop (didn't bet)
Seat 4: ka100pka527 (small blind) folded before Flop
Seat 5: Smartiecat (big blind) folded before Flop
Seat 6: Pacifistas folded before Flop (didn't bet)
Seat 7: matiko09 folded before Flop (didn't bet)
Seat 8: grifkaaa collected ($2.50)
Seat 9: IntsAA folded before Flop (didn't bet)





PokerStars Hand #150707728299:  Hold'em No Limit ($0.50/$1.00 USD) - 2016/03/21 17:06:16 CET [2016/03/21 12:06:16 ET]
Table 'Lucifer III' 9-max Seat #4 is the button
Seat 1: Pacifistas ($147.96 in chips) 
Seat 2: matiko09 ($112.50 in chips) 
Seat 3: Vizonto ($25.13 in chips) 
Seat 4: RICKA16 ($98.50 in chips) 
Seat 5: cobrik23 ($70.40 in chips) 
Seat 7: roninio1 ($145.09 in chips) 
Seat 8: aseban11 ($158.25 in chips) 
Seat 9: mycka86 ($106.10 in chips) 
cobrik23: posts small blind $0.50
solbi86: is sitting out 
roninio1: posts big blind $1
*** HOLE CARDS ***
Dealt to matiko09 [Ac 2h]
aseban11: folds 
mycka86: folds 
Pacifistas: folds 
matiko09: folds 
Vizonto: raises $2.50 to $3.50
RICKA16: raises $5.50 to $9
cobrik23: folds 
roninio1: calls $8
Vizonto: raises $16.13 to $25.13 and is all-in
RICKA16: raises $73.37 to $98.50 and is all-in
roninio1: calls $89.50
*** FLOP *** [Kc Qh 3c]
*** TURN *** [Kc Qh 3c] [4d]
*** RIVER *** [Kc Qh 3c 4d] [3s]
*** SHOW DOWN ***
roninio1: shows [Td Qd] (two pair, Queens and Threes)
RICKA16: shows [Qc Qs] (a full house, Queens full of Threes)
RICKA16 collected $146.74 from side pot
Vizonto: shows [Kh As] (two pair, Kings and Threes)
RICKA16 collected $73.09 from main pot
*** SUMMARY ***
Total pot $222.63 Main pot $73.09. Side pot $146.74. | Rake $2.80 
Board [Kc Qh 3c 4d 3s]
Seat 1: Pacifistas folded before Flop (didn't bet)
Seat 2: matiko09 folded before Flop (didn't bet)
Seat 3: Vizonto showed [Kh As] and lost with two pair, Kings and Threes
Seat 4: RICKA16 (button) showed [Qc Qs] and won ($219.83) with a full house, Queens full of Threes
Seat 5: cobrik23 (small blind) folded before Flop
Seat 7: roninio1 (big blind) showed [Td Qd] and lost with two pair, Queens and Threes
Seat 8: aseban11 folded before Flop (didn't bet)
Seat 9: mycka86 folded before Flop (didn't bet)





PokerStars Hand #150707737958:  Hold'em No Limit ($0.50/$1.00 USD) - 2016/03/21 17:06:29 CET [2016/03/21 12:06:29 ET]
Table 'Onnie II' 9-max Seat #6 is the button
Seat 1: aseban11 ($194.23 in chips) 
Seat 2: RICKA16 ($100 in chips) 
Seat 3: cn_chayanne ($151.41 in chips) 
Seat 4: Bothfeld11 ($169.87 in chips) 
Seat 5: sanpidk ($101.75 in chips) 
Seat 6: Pacifistas ($104.77 in chips) 
Seat 7: djammusic ($77.40 in chips) 
Seat 9: matiko09 ($121.19 in chips) 
djammusic: posts small blind $0.50
matiko09: posts big blind $1
*** HOLE CARDS ***
Dealt to matiko09 [8h 5s]
aseban11: folds 
RICKA16: folds 
cn_chayanne: folds 
Bothfeld11: calls $1
sanpidk: folds 
Pacifistas: folds 
djammusic: folds 
matiko09: checks 
*** FLOP *** [6s Td 7h]
matiko09: bets $1.55
Bothfeld11: calls $1.55
*** TURN *** [6s Td 7h] [5c]
matiko09: checks 
Bothfeld11: bets $3
matiko09: calls $3
*** RIVER *** [6s Td 7h 5c] [4c]
matiko09: bets $5.76
Bothfeld11: calls $5.76
*** SHOW DOWN ***
matiko09: shows [8h 5s] (a straight, Four to Eight)
Bothfeld11: shows [3d 4h] (a straight, Three to Seven)
matiko09 collected $22.08 from pot
*** SUMMARY ***
Total pot $23.12 | Rake $1.04 
Board [6s Td 7h 5c 4c]
Seat 1: aseban11 folded before Flop (didn't bet)
Seat 2: RICKA16 folded before Flop (didn't bet)
Seat 3: cn_chayanne folded before Flop (didn't bet)
Seat 4: Bothfeld11 showed [3d 4h] and lost with a straight, Three to Seven
Seat 5: sanpidk folded before Flop (didn't bet)
Seat 6: Pacifistas (button) folded before Flop (didn't bet)
Seat 7: djammusic (small blind) folded before Flop
Seat 9: matiko09 (big blind) showed [8h 5s] and won ($22.08) with a straight, Four to Eight





PokerStars Hand #150707750751:  Hold'em No Limit ($0.50/$1.00 USD) - 2016/03/21 17:06:46 CET [2016/03/21 12:06:46 ET]
Table 'Marmulla II' 9-max Seat #3 is the button
Seat 1: hammerwife ($100 in chips) 
Seat 3: Vikulja1993 ($103.64 in chips) 
Seat 4: Dachish ($83 in chips) 
Seat 5: maaaGik88 ($84.84 in chips) 
Seat 6: R1aki ($101.50 in chips) 
Seat 7: Pacifistas ($109.42 in chips) 
Seat 8: ilaviiitech ($106.44 in chips) 
Seat 9: matiko09 ($100 in chips) 
Dachish: posts small blind $0.50
maaaGik88: posts big blind $1
*** HOLE CARDS ***
Dealt to matiko09 [7h Ks]
R1aki: folds 
Pacifistas: folds 
ilaviiitech: folds 
matiko09: folds 
hammerwife: folds 
Vikulja1993: folds 
Dachish: raises $3 to $4
maaaGik88: calls $3
*** FLOP *** [8s 2s 4s]
Dachish: checks 
maaaGik88: bets $3
Dachish: calls $3
*** TURN *** [8s 2s 4s] [5h]
Dachish: checks 
maaaGik88: checks 
*** RIVER *** [8s 2s 4s 5h] [3d]
Dachish: checks 
maaaGik88: bets $7
Dachish: folds 
Uncalled bet ($7) returned to maaaGik88
maaaGik88 collected $13.37 from pot
maaaGik88: doesn't show hand 
*** SUMMARY ***
Total pot $14 | Rake $0.63 
Board [8s 2s 4s 5h 3d]
Seat 1: hammerwife folded before Flop (didn't bet)
Seat 3: Vikulja1993 (button) folded before Flop (didn't bet)
Seat 4: Dachish (small blind) folded on the River
Seat 5: maaaGik88 (big blind) collected ($13.37)
Seat 6: R1aki folded before Flop (didn't bet)
Seat 7: Pacifistas folded before Flop (didn't bet)
Seat 8: ilaviiitech folded before Flop (didn't bet)
Seat 9: matiko09 folded before Flop (didn't bet)





PokerStars Hand #150707766974:  Hold'em No Limit ($0.50/$1.00 USD) - 2016/03/21 17:07:07 CET [2016/03/21 12:07:07 ET]
Table 'Lucifer III' 9-max Seat #5 is the button
Seat 1: Pacifistas ($147.96 in chips) 
Seat 2: matiko09 ($112.50 in chips) 
Seat 4: RICKA16 ($219.83 in chips) 
Seat 5: cobrik23 ($69.90 in chips) 
Seat 7: roninio1 ($46.59 in chips) 
Seat 8: aseban11 ($158.25 in chips) 
Seat 9: mycka86 ($106.10 in chips) 
roninio1: posts small blind $0.50
aseban11: posts big blind $1
*** HOLE CARDS ***
Dealt to matiko09 [6h Qd]
Vizonto leaves the table
hammerwife joins the table at seat #3 
mycka86: folds 
Pacifistas: folds 
matiko09: folds 
RICKA16: raises $2 to $3
cobrik23: folds 
roninio1: raises $43.59 to $46.59 and is all-in
aseban11: folds 
RICKA16: folds 
Uncalled bet ($43.59) returned to roninio1
roninio1 collected $7 from pot
roninio1: doesn't show hand 
*** SUMMARY ***
Total pot $7 | Rake $0 
Seat 1: Pacifistas folded before Flop (didn't bet)
Seat 2: matiko09 folded before Flop (didn't bet)
Seat 4: RICKA16 folded before Flop
Seat 5: cobrik23 (button) folded before Flop (didn't bet)
Seat 7: roninio1 (small blind) collected ($7)
Seat 8: aseban11 (big blind) folded before Flop
Seat 9: mycka86 folded before Flop (didn't bet)





PokerStars Hand #150707776470:  Hold'em No Limit ($0.50/$1.00 USD) - 2016/03/21 17:07:19 CET [2016/03/21 12:07:19 ET]
Table 'Massalia II' 9-max Seat #8 is the button
Seat 1: crepke ($74.52 in chips) 
Seat 3: 123chambo ($77.30 in chips) 
Seat 4: OriginalTony ($91.02 in chips) 
Seat 5: Vikulja1993 ($100 in chips) 
Seat 6: Pacifistas ($123.37 in chips) 
Seat 7: flk.Dasas ($100 in chips) 
Seat 8: matiko09 ($172.61 in chips) 
Seat 9: hammerwife ($117.57 in chips) 
hammerwife: posts small blind $0.50
crepke: posts big blind $1
maxxmeister: sits out 
crepke: posts the ante $0.20
123chambo: posts the ante $0.20
OriginalTony: posts the ante $0.20
Vikulja1993: posts the ante $0.20
Pacifistas: posts the ante $0.20
flk.Dasas: posts the ante $0.20
matiko09: posts the ante $0.20
hammerwife: posts the ante $0.20
*** HOLE CARDS ***
Dealt to matiko09 [As 5h]
123chambo: folds 
OriginalTony: folds 
Vikulja1993: folds 
Pacifistas: raises $2 to $3
flk.Dasas: folds 
matiko09: folds 
hammerwife: folds 
crepke: calls $2
*** FLOP *** [Kd 7d 4s]
crepke: checks 
Pacifistas: bets $5.03
crepke: folds 
Uncalled bet ($5.03) returned to Pacifistas
Pacifistas collected $7.74 from pot
Pacifistas: doesn't show hand 
*** SUMMARY ***
Total pot $8.10 | Rake $0.36 
Board [Kd 7d 4s]
Seat 1: crepke (big blind) folded on the Flop
Seat 3: 123chambo folded before Flop (didn't bet)
Seat 4: OriginalTony folded before Flop (didn't bet)
Seat 5: Vikulja1993 folded before Flop (didn't bet)
Seat 6: Pacifistas collected ($7.74)
Seat 7: flk.Dasas folded before Flop (didn't bet)
Seat 8: matiko09 (button) folded before Flop (didn't bet)
Seat 9: hammerwife (small blind) folded before Flop





PokerStars Hand #150707782162:  Hold'em No Limit ($0.50/$1.00 USD) - 2016/03/21 17:07:27 CET [2016/03/21 12:07:27 ET]
Table 'Noel' 9-max Seat #2 is the button
Seat 2: cobrik23 ($161.90 in chips) 
Seat 5: matiko09 ($138.50 in chips) 
Seat 7: djammusic ($53.02 in chips) 
Seat 8: Dachish ($72.50 in chips) 
Seat 9: grifkaaa ($100.85 in chips) 
matiko09: posts small blind $0.50
hammerwife: is sitting out 
hammerwife leaves the table
djammusic: posts big blind $1
*** HOLE CARDS ***
Dealt to matiko09 [2s 4h]
fanmtZ joins the table at seat #6 
Dachish: raises $2 to $3
grifkaaa: folds 
cobrik23: folds 
fanmtZ leaves the table
matiko09: folds 
volwebni4ek joins the table at seat #6 
ep538 leaves the table
djammusic: folds 
Uncalled bet ($2) returned to Dachish
Dachish collected $2.50 from pot
Dachish: doesn't show hand 
*** SUMMARY ***
Total pot $2.50 | Rake $0 
Seat 2: cobrik23 (button) folded before Flop (didn't bet)
Seat 5: matiko09 (small blind) folded before Flop
Seat 7: djammusic (big blind) folded before Flop
Seat 8: Dachish collected ($2.50)
Seat 9: grifkaaa folded before Flop (didn't bet)





PokerStars Hand #150707788780:  Hold'em No Limit ($0.50/$1.00 USD) - 2016/03/21 17:07:35 CET [2016/03/21 12:07:35 ET]
Table 'Icarion II' 9-max Seat #3 is the button
Seat 1: forsmthgood ($101.31 in chips) 
Seat 2: aseban11 ($100 in chips) 
Seat 3: volwebni4ek ($45 in chips) 
Seat 4: teukka8 ($29.60 in chips) 
Seat 5: SanychStar ($125.18 in chips) 
Seat 6: solbi86 ($109.72 in chips) 
Seat 7: Pacifistas ($100 in chips) 
Seat 8: matiko09 ($111.50 in chips) 
Seat 9: R1aki ($136.76 in chips) 
teukka8: posts small blind $0.50
SanychStar: posts big blind $1
*** HOLE CARDS ***
Dealt to matiko09 [8c 4h]
solbi86: folds 
Pacifistas: folds 
matiko09: folds 
R1aki: folds 
forsmthgood: folds 
aseban11: folds 
volwebni4ek: folds 
teukka8: folds 
Uncalled bet ($0.50) returned to SanychStar
SanychStar collected $1 from pot
*** SUMMARY ***
Total pot $1 | Rake $0 
Seat 1: forsmthgood folded before Flop (didn't bet)
Seat 2: aseban11 folded before Flop (didn't bet)
Seat 3: volwebni4ek (button) folded before Flop (didn't bet)
Seat 4: teukka8 (small blind) folded before Flop
Seat 5: SanychStar (big blind) collected ($1)
Seat 6: solbi86 folded before Flop (didn't bet)
Seat 7: Pacifistas folded before Flop (didn't bet)
Seat 8: matiko09 folded before Flop (didn't bet)
Seat 9: R1aki folded before Flop (didn't bet)





PokerStars Hand #150707788632:  Hold'em No Limit (€0.25/€0.50 EUR) - 2016/03/21 17:07:35 CET [2016/03/21 12:07:35 ET]
Table 'Auravictrix II' 9-max Seat #4 is the button
Seat 1: aponinho82 (€101.17 in chips) 
Seat 2: ffac (€50 in chips) 
Seat 3: matiko09 (€52.96 in chips) 
Seat 4: i am owsome (€94 in chips) 
Seat 5: nombraalne1 (€66.66 in chips) 
Seat 6: Devsteel (€50.33 in chips) 
Seat 7: vasiy379 (€50 in chips) 
Seat 8: ardo888 (€50 in chips) 
Seat 9: carlouchi (€40.65 in chips) 
nombraalne1: posts small blind €0.25
Devsteel: posts big blind €0.50
*** HOLE CARDS ***
Dealt to matiko09 [4h Kc]
vasiy379: raises €1 to €1.50
ardo888: folds 
carlouchi: folds 
aponinho82: folds 
ffac: folds 
matiko09: folds 
i am owsome: folds 
nombraalne1: folds 
Devsteel: folds 
Uncalled bet (€1) returned to vasiy379
vasiy379 collected €1.25 from pot
vasiy379: doesn't show hand 
*** SUMMARY ***
Total pot €1.25 | Rake €0 
Seat 1: aponinho82 folded before Flop (didn't bet)
Seat 2: ffac folded before Flop (didn't bet)
Seat 3: matiko09 folded before Flop (didn't bet)
Seat 4: i am owsome (button) folded before Flop (didn't bet)
Seat 5: nombraalne1 (small blind) folded before Flop
Seat 6: Devsteel (big blind) folded before Flop
Seat 7: vasiy379 collected (€1.25)
Seat 8: ardo888 folded before Flop (didn't bet)
Seat 9: carlouchi folded before Flop (didn't bet)





PokerStars Hand #150707793582:  Hold'em No Limit ($0.50/$1.00 USD) - 2016/03/21 17:07:42 CET [2016/03/21 12:07:42 ET]
Table 'Lucifer III' 9-max Seat #7 is the button
Seat 1: Pacifistas ($147.96 in chips) 
Seat 2: matiko09 ($112.50 in chips) 
Seat 4: RICKA16 ($216.83 in chips) 
Seat 5: cobrik23 ($69.90 in chips) 
Seat 7: roninio1 ($50.59 in chips) 
Seat 8: aseban11 ($157.25 in chips) 
Seat 9: mycka86 ($106.10 in chips) 
aseban11: posts small blind $0.50
mycka86: posts big blind $1
*** HOLE CARDS ***
Dealt to matiko09 [As 5h]
Pacifistas: folds 
matiko09: folds 
RICKA16: folds 
hammerwife leaves the table
cobrik23: raises $1.50 to $2.50
roninio1: folds 
fanmtZ joins the table at seat #3 
aseban11: folds 
mycka86: calls $1.50
*** FLOP *** [5c Tc 6s]
mycka86: checks 
cobrik23: checks 
*** TURN *** [5c Tc 6s] [Ah]
mycka86: checks 
cobrik23: bets $4
mycka86: calls $4
*** RIVER *** [5c Tc 6s Ah] [7d]
mycka86: checks 
cobrik23: checks 
*** SHOW DOWN ***
mycka86: shows [6d Qd] (a pair of Sixes)
cobrik23: shows [Ac 9d] (a pair of Aces)
cobrik23 collected $12.89 from pot
*** SUMMARY ***
Total pot $13.50 | Rake $0.61 
Board [5c Tc 6s Ah 7d]
Seat 1: Pacifistas folded before Flop (didn't bet)
Seat 2: matiko09 folded before Flop (didn't bet)
Seat 4: RICKA16 folded before Flop (didn't bet)
Seat 5: cobrik23 showed [Ac 9d] and won ($12.89) with a pair of Aces
Seat 7: roninio1 (button) folded before Flop (didn't bet)
Seat 8: aseban11 (small blind) folded before Flop
Seat 9: mycka86 (big blind) showed [6d Qd] and lost with a pair of Sixes





PokerStars Hand #150707794677:  Hold'em No Limit ($0.50/$1.00 USD) - 2016/03/21 17:07:43 CET [2016/03/21 12:07:43 ET]
Table 'Onnie II' 9-max Seat #7 is the button
Seat 2: RICKA16 ($100 in chips) 
Seat 3: cn_chayanne ($151.41 in chips) 
Seat 4: Bothfeld11 ($158.56 in chips) 
Seat 5: sanpidk ($101.75 in chips) 
Seat 6: Pacifistas ($104.77 in chips) 
Seat 7: djammusic ($76.90 in chips) 
Seat 9: matiko09 ($131.96 in chips) 
matiko09: posts small blind $0.50
aseban11: is sitting out 
RICKA16: posts big blind $1
*** HOLE CARDS ***
Dealt to matiko09 [Qc Tc]
cn_chayanne: folds 
Bothfeld11: raises $1 to $2
sanpidk: folds 
Pacifistas: folds 
djammusic: folds 
matiko09: folds 
RICKA16: folds 
Uncalled bet ($1) returned to Bothfeld11
Bothfeld11 collected $2.50 from pot
*** SUMMARY ***
Total pot $2.50 | Rake $0 
Seat 2: RICKA16 (big blind) folded before Flop
Seat 3: cn_chayanne folded before Flop (didn't bet)
Seat 4: Bothfeld11 collected ($2.50)
Seat 5: sanpidk folded before Flop (didn't bet)
Seat 6: Pacifistas folded before Flop (didn't bet)
Seat 7: djammusic (button) folded before Flop (didn't bet)
Seat 9: matiko09 (small blind) folded before Flop





PokerStars Hand #150707801880:  Hold'em No Limit ($0.50/$1.00 USD) - 2016/03/21 17:07:53 CET [2016/03/21 12:07:53 ET]
Table 'Noel' 9-max Seat #5 is the button
Seat 2: cobrik23 ($161.90 in chips) 
Seat 5: matiko09 ($138 in chips) 
Seat 7: djammusic ($52.02 in chips) 
djammusic: posts small blind $0.50
Dachish: is sitting out 
grifkaaa: is sitting out 
cobrik23: posts big blind $1
*** HOLE CARDS ***
Dealt to matiko09 [2c Qc]
matiko09: folds 
Vikulja1993 joins the table at seat #1 
djammusic has timed out
djammusic: folds 
Uncalled bet ($0.50) returned to cobrik23
cobrik23 collected $1 from pot
cobrik23: doesn't show hand 
*** SUMMARY ***
Total pot $1 | Rake $0 
Seat 2: cobrik23 (big blind) collected ($1)
Seat 5: matiko09 (button) folded before Flop (didn't bet)
Seat 7: djammusic (small blind) folded before Flop





PokerStars Hand #150707803841:  Hold'em No Limit (€0.25/€0.50 EUR) - 2016/03/21 17:07:55 CET [2016/03/21 12:07:55 ET]
Table 'Auravictrix II' 9-max Seat #5 is the button
Seat 1: aponinho82 (€101.17 in chips) 
Seat 2: ffac (€50 in chips) 
Seat 3: matiko09 (€52.96 in chips) 
Seat 4: i am owsome (€94 in chips) 
Seat 5: nombraalne1 (€66.41 in chips) 
Seat 6: Devsteel (€50 in chips) 
Seat 7: vasiy379 (€50.75 in chips) 
Seat 8: ardo888 (€50 in chips) 
Seat 9: carlouchi (€40.65 in chips) 
Devsteel: posts small blind €0.25
vasiy379: posts big blind €0.50
*** HOLE CARDS ***
Dealt to matiko09 [3h 2d]
ardo888: folds 
carlouchi: folds 
aponinho82: calls €0.50
ffac: raises €1 to €1.50
matiko09: folds 
i am owsome: folds 
nombraalne1: folds 
Devsteel: folds 
vasiy379: folds 
aponinho82: calls €1
*** FLOP *** [9c Ts 7d]
aponinho82: checks 
ffac: checks 
*** TURN *** [9c Ts 7d] [7c]
aponinho82: checks 
ffac: checks 
*** RIVER *** [9c Ts 7d 7c] [5s]
aponinho82: checks 
ffac: checks 
*** SHOW DOWN ***
aponinho82: shows [Jc Qs] (a pair of Sevens)
ffac: shows [As Qh] (a pair of Sevens - Ace kicker)
ffac collected €3.58 from pot
*** SUMMARY ***
Total pot €3.75 | Rake €0.17 
Board [9c Ts 7d 7c 5s]
Seat 1: aponinho82 showed [Jc Qs] and lost with a pair of Sevens
Seat 2: ffac showed [As Qh] and won (€3.58) with a pair of Sevens
Seat 3: matiko09 folded before Flop (didn't bet)
Seat 4: i am owsome folded before Flop (didn't bet)
Seat 5: nombraalne1 (button) folded before Flop (didn't bet)
Seat 6: Devsteel (small blind) folded before Flop
Seat 7: vasiy379 (big blind) folded before Flop
Seat 8: ardo888 folded before Flop (didn't bet)
Seat 9: carlouchi folded before Flop (didn't bet)





PokerStars Hand #150707808036:  Hold'em No Limit ($0.50/$1.00 USD) - 2016/03/21 17:08:01 CET [2016/03/21 12:08:01 ET]
Table 'Massalia II' 9-max Seat #9 is the button
Seat 1: crepke ($71.32 in chips) 
Seat 2: maxxmeister ($100 in chips) 
Seat 3: 123chambo ($77.10 in chips) 
Seat 4: OriginalTony ($90.82 in chips) 
Seat 5: Vikulja1993 ($100 in chips) 
Seat 6: Pacifistas ($127.91 in chips) 
Seat 7: flk.Dasas ($100 in chips) 
Seat 8: matiko09 ($172.41 in chips) 
Seat 9: hammerwife ($116.87 in chips) 
crepke: posts small blind $0.50
maxxmeister: posts big blind $1
crepke: posts the ante $0.20
maxxmeister: posts the ante $0.20
123chambo: posts the ante $0.20
OriginalTony: posts the ante $0.20
Vikulja1993: posts the ante $0.20
Pacifistas: posts the ante $0.20
flk.Dasas: posts the ante $0.20
matiko09: posts the ante $0.20
hammerwife: posts the ante $0.20
*** HOLE CARDS ***
Dealt to matiko09 [Qd Ac]
123chambo: calls $1
OriginalTony: folds 
Vikulja1993: folds 
Pacifistas: folds 
flk.Dasas: raises $3 to $4
matiko09: calls $4
hammerwife: folds 
crepke: folds 
maxxmeister: folds 
123chambo: calls $3
*** FLOP *** [7c Qs 3c]
crepke leaves the table
123chambo: checks 
Filojoes joins the table at seat #1 
flk.Dasas: bets $9.93
matiko09: calls $9.93
123chambo: calls $9.93
*** TURN *** [7c Qs 3c] [4d]
123chambo: checks 
flk.Dasas: bets $20
matiko09: calls $20
123chambo: calls $20
*** RIVER *** [7c Qs 3c 4d] [5h]
123chambo: checks 
flk.Dasas: checks 
matiko09: checks 
*** SHOW DOWN ***
123chambo: shows [5c 4c] (two pair, Fives and Fours)
flk.Dasas: mucks hand 
matiko09: mucks hand 
123chambo collected $102.29 from pot
*** SUMMARY ***
Total pot $105.09 | Rake $2.80 
Board [7c Qs 3c 4d 5h]
Seat 1: crepke (small blind) folded before Flop
Seat 2: maxxmeister (big blind) folded before Flop
Seat 3: 123chambo showed [5c 4c] and won ($102.29) with two pair, Fives and Fours
Seat 4: OriginalTony folded before Flop (didn't bet)
Seat 5: Vikulja1993 folded before Flop (didn't bet)
Seat 6: Pacifistas folded before Flop (didn't bet)
Seat 7: flk.Dasas mucked [As Qc]
Seat 8: matiko09 mucked [Qd Ac]
Seat 9: hammerwife (button) folded before Flop (didn't bet)





PokerStars Hand #150707811664:  Hold'em No Limit ($0.50/$1.00 USD) - 2016/03/21 17:08:05 CET [2016/03/21 12:08:05 ET]
Table 'Icarion II' 9-max Seat #4 is the button
Seat 1: forsmthgood ($101.31 in chips) 
Seat 2: aseban11 ($100 in chips) 
Seat 3: volwebni4ek ($45 in chips) 
Seat 4: teukka8 ($29.10 in chips) 
Seat 5: SanychStar ($125.68 in chips) 
Seat 7: Pacifistas ($100 in chips) 
Seat 8: matiko09 ($111.50 in chips) 
Seat 9: R1aki ($136.76 in chips) 
SanychStar: posts small blind $0.50
Pacifistas: posts big blind $1
*** HOLE CARDS ***
Dealt to matiko09 [3c 8d]
matiko09: folds 
R1aki: folds 
forsmthgood: folds 
aseban11: folds 
volwebni4ek: raises $1.20 to $2.20
teukka8: folds 
SanychStar: raises $5.80 to $8
Pacifistas: folds 
volwebni4ek: folds 
Uncalled bet ($5.80) returned to SanychStar
SanychStar collected $5.40 from pot
*** SUMMARY ***
Total pot $5.40 | Rake $0 
Seat 1: forsmthgood folded before Flop (didn't bet)
Seat 2: aseban11 folded before Flop (didn't bet)
Seat 3: volwebni4ek folded before Flop
Seat 4: teukka8 (button) folded before Flop (didn't bet)
Seat 5: SanychStar (small blind) collected ($5.40)
Seat 7: Pacifistas (big blind) folded before Flop
Seat 8: matiko09 folded before Flop (didn't bet)
Seat 9: R1aki folded before Flop (didn't bet)





PokerStars Hand #150707815692:  Hold'em No Limit ($0.50/$1.00 USD) - 2016/03/21 17:08:11 CET [2016/03/21 12:08:11 ET]
Table 'Skadi III' 9-max Seat #4 is the button
Seat 1: CI58 ($100 in chips) 
Seat 2: aseban11 ($100 in chips) 
Seat 3: matiko09 ($100 in chips) 
Seat 4: ilaviiitech ($107.16 in chips) 
Seat 6: Pacifistas ($100.85 in chips) 
Seat 8: volwebni4ek ($40 in chips) 
Seat 9: bradsheps ($157.80 in chips) 
Pacifistas: posts small blind $0.50
solbi86: is sitting out 
volwebni4ek: posts big blind $1
*** HOLE CARDS ***
Dealt to matiko09 [Jd 7s]
bradsheps: folds 
bradsheps leaves the table
CI58: raises $2 to $3
aseban11: folds 
fanmtZ joins the table at seat #9 
matiko09: folds 
ilaviiitech: folds 
Pacifistas: folds 
volwebni4ek: folds 
Uncalled bet ($2) returned to CI58
CI58 collected $2.50 from pot
CI58: doesn't show hand 
*** SUMMARY ***
Total pot $2.50 | Rake $0 
Seat 1: CI58 collected ($2.50)
Seat 2: aseban11 folded before Flop (didn't bet)
Seat 3: matiko09 folded before Flop (didn't bet)
Seat 4: ilaviiitech (button) folded before Flop (didn't bet)
Seat 6: Pacifistas (small blind) folded before Flop
Seat 8: volwebni4ek (big blind) folded before Flop
Seat 9: bradsheps folded before Flop (didn't bet)





PokerStars Hand #150707816400:  Hold'em No Limit ($0.50/$1.00 USD) - 2016/03/21 17:08:12 CET [2016/03/21 12:08:12 ET]
Table 'Onnie II' 9-max Seat #9 is the button
Seat 2: RICKA16 ($99 in chips) 
Seat 3: cn_chayanne ($151.41 in chips) 
Seat 4: Bothfeld11 ($160.06 in chips) 
Seat 5: sanpidk ($101.75 in chips) 
Seat 6: Pacifistas ($104.77 in chips) 
Seat 7: djammusic ($76.90 in chips) 
Seat 9: matiko09 ($131.46 in chips) 
RICKA16: posts small blind $0.50
cn_chayanne: posts big blind $1
*** HOLE CARDS ***
Dealt to matiko09 [Ah 4d]
Bothfeld11: folds 
sanpidk: folds 
Pacifistas: folds 
djammusic: folds 
matiko09: raises $1.27 to $2.27
aseban11 leaves the table
RICKA16: calls $1.77
cn_chayanne: calls $1.27
*** FLOP *** [4c Kd 2d]
RICKA16: checks 
cn_chayanne: checks 
Vikulja1993 joins the table at seat #1 
matiko09: checks 
*** TURN *** [4c Kd 2d] [Js]
Vikulja1993 leaves the table
ka100pka527 joins the table at seat #1 
RICKA16: checks 
cn_chayanne: bets $4.87
matiko09: folds 
RICKA16: folds 
Uncalled bet ($4.87) returned to cn_chayanne
cn_chayanne collected $6.50 from pot
cn_chayanne: doesn't show hand 
*** SUMMARY ***
Total pot $6.81 | Rake $0.31 
Board [4c Kd 2d Js]
Seat 2: RICKA16 (small blind) folded on the Turn
Seat 3: cn_chayanne (big blind) collected ($6.50)
Seat 4: Bothfeld11 folded before Flop (didn't bet)
Seat 5: sanpidk folded before Flop (didn't bet)
Seat 6: Pacifistas folded before Flop (didn't bet)
Seat 7: djammusic folded before Flop (didn't bet)
Seat 9: matiko09 (button) folded on the Turn





PokerStars Hand #150707819798:  Hold'em No Limit ($0.50/$1.00 USD) - 2016/03/21 17:08:16 CET [2016/03/21 12:08:16 ET]
Table 'Marmulla II' 9-max Seat #4 is the button
Seat 1: hammerwife ($100 in chips) 
Seat 3: Vikulja1993 ($103.64 in chips) 
Seat 4: Dachish ($76 in chips) 
Seat 5: maaaGik88 ($91.21 in chips) 
Seat 6: R1aki ($101.50 in chips) 
Seat 7: Pacifistas ($109.42 in chips) 
Seat 8: ilaviiitech ($106.44 in chips) 
Seat 9: matiko09 ($100 in chips) 
maaaGik88: posts small blind $0.50
R1aki: posts big blind $1
*** HOLE CARDS ***
Dealt to matiko09 [2h Th]
Pacifistas: raises $2 to $3
ilaviiitech: folds 
matiko09: folds 
hammerwife: folds 
Vikulja1993: folds 
Dachish: calls $3
maaaGik88: folds 
R1aki: folds 
*** FLOP *** [4h Kd 2s]
Pacifistas: bets $3.86
Dachish: calls $3.86
*** TURN *** [4h Kd 2s] [9d]
Pacifistas: bets $10.03
Dachish: folds 
Uncalled bet ($10.03) returned to Pacifistas
Pacifistas collected $14.54 from pot
Pacifistas: doesn't show hand 
*** SUMMARY ***
Total pot $15.22 | Rake $0.68 
Board [4h Kd 2s 9d]
Seat 1: hammerwife folded before Flop (didn't bet)
Seat 3: Vikulja1993 folded before Flop (didn't bet)
Seat 4: Dachish (button) folded on the Turn
Seat 5: maaaGik88 (small blind) folded before Flop
Seat 6: R1aki (big blind) folded before Flop
Seat 7: Pacifistas collected ($14.54)
Seat 8: ilaviiitech folded before Flop (didn't bet)
Seat 9: matiko09 folded before Flop (didn't bet)





PokerStars Hand #150707824335:  Hold'em No Limit ($0.50/$1.00 USD) - 2016/03/21 17:08:22 CET [2016/03/21 12:08:22 ET]
Table 'Noel' 9-max Seat #7 is the button
Seat 2: cobrik23 ($162.40 in chips) 
Seat 5: matiko09 ($138 in chips) 
Seat 7: djammusic ($51.52 in chips) 
Vikulja1993 will be allowed to play after the button
cobrik23: posts small blind $0.50
matiko09: posts big blind $1
*** HOLE CARDS ***
Dealt to matiko09 [Td Jh]
djammusic: raises $1.02 to $2.02
cobrik23: raises $5.98 to $8
matiko09: folds 
djammusic: folds 
Uncalled bet ($5.98) returned to cobrik23
cobrik23 collected $5.04 from pot
cobrik23: doesn't show hand 
*** SUMMARY ***
Total pot $5.04 | Rake $0 
Seat 2: cobrik23 (small blind) collected ($5.04)
Seat 5: matiko09 (big blind) folded before Flop
Seat 7: djammusic (button) folded before Flop





PokerStars Hand #150707834879:  Hold'em No Limit ($0.50/$1.00 USD) - 2016/03/21 17:08:36 CET [2016/03/21 12:08:36 ET]
Table 'Skadi III' 9-max Seat #6 is the button
Seat 1: CI58 ($101.50 in chips) 
Seat 2: aseban11 ($100 in chips) 
Seat 3: matiko09 ($100 in chips) 
Seat 4: ilaviiitech ($107.16 in chips) 
Seat 6: Pacifistas ($100.35 in chips) 
Seat 8: volwebni4ek ($40 in chips) 
Seat 9: fanmtZ ($40 in chips) 
volwebni4ek: posts small blind $0.50
fanmtZ: posts big blind $1
*** HOLE CARDS ***
Dealt to matiko09 [7h Ah]
CI58: folds 
aseban11: folds 
matiko09: raises $2 to $3
ilaviiitech: folds 
Pacifistas: folds 
volwebni4ek: folds 
fanmtZ: folds 
Uncalled bet ($2) returned to matiko09
matiko09 collected $2.50 from pot
matiko09: doesn't show hand 
*** SUMMARY ***
Total pot $2.50 | Rake $0 
Seat 1: CI58 folded before Flop (didn't bet)
Seat 2: aseban11 folded before Flop (didn't bet)
Seat 3: matiko09 collected ($2.50)
Seat 4: ilaviiitech folded before Flop (didn't bet)
Seat 6: Pacifistas (button) folded before Flop (didn't bet)
Seat 8: volwebni4ek (small blind) folded before Flop
Seat 9: fanmtZ (big blind) folded before Flop





PokerStars Hand #150707841535:  Hold'em No Limit ($0.50/$1.00 USD) - 2016/03/21 17:08:44 CET [2016/03/21 12:08:44 ET]
Table 'Lucifer III' 9-max Seat #8 is the button
Seat 1: Pacifistas ($147.96 in chips) 
Seat 2: matiko09 ($112.50 in chips) 
Seat 4: RICKA16 ($216.83 in chips) 
Seat 5: cobrik23 ($76.29 in chips) 
Seat 7: roninio1 ($50.59 in chips) 
Seat 8: aseban11 ($156.75 in chips) 
Seat 9: mycka86 ($100 in chips) 
mycka86: posts small blind $0.50
Pacifistas: posts big blind $1
fanmtZ: sits out 
*** HOLE CARDS ***
Dealt to matiko09 [Ah 2s]
matiko09: folds 
RICKA16: folds 
cobrik23: folds 
roninio1: raises $2 to $3
aseban11: folds 
mycka86: folds 
Pacifistas: folds 
Uncalled bet ($2) returned to roninio1
roninio1 collected $2.50 from pot
roninio1: doesn't show hand 
*** SUMMARY ***
Total pot $2.50 | Rake $0 
Seat 1: Pacifistas (big blind) folded before Flop
Seat 2: matiko09 folded before Flop (didn't bet)
Seat 4: RICKA16 folded before Flop (didn't bet)
Seat 5: cobrik23 folded before Flop (didn't bet)
Seat 7: roninio1 collected ($2.50)
Seat 8: aseban11 (button) folded before Flop (didn't bet)
Seat 9: mycka86 (small blind) folded before Flop





PokerStars Hand #150707847696:  Hold'em No Limit ($0.50/$1.00 USD) - 2016/03/21 17:08:53 CET [2016/03/21 12:08:53 ET]
Table 'Noel' 9-max Seat #2 is the button
Seat 1: Vikulja1993 ($100 in chips) 
Seat 2: cobrik23 ($165.42 in chips) 
Seat 5: matiko09 ($137 in chips) 
matiko09: posts small blind $0.50
djammusic: is sitting out 
Vikulja1993: posts big blind $1
*** HOLE CARDS ***
Dealt to matiko09 [8s Jc]
djammusic leaves the table
cobrik23: raises $2 to $3
matiko09: folds 
Vikulja1993: folds 
Uncalled bet ($2) returned to cobrik23
cobrik23 collected $2.50 from pot
cobrik23: doesn't show hand 
*** SUMMARY ***
Total pot $2.50 | Rake $0 
Seat 1: Vikulja1993 (big blind) folded before Flop
Seat 2: cobrik23 (button) collected ($2.50)
Seat 5: matiko09 (small blind) folded before Flop





PokerStars Hand #150707862226:  Hold'em No Limit ($0.50/$1.00 USD) - 2016/03/21 17:09:12 CET [2016/03/21 12:09:12 ET]
Table 'Lucifer III' 9-max Seat #9 is the button
Seat 1: Pacifistas ($146.96 in chips) 
Seat 2: matiko09 ($112.50 in chips) 
Seat 4: RICKA16 ($216.83 in chips) 
Seat 5: cobrik23 ($76.29 in chips) 
Seat 7: roninio1 ($52.09 in chips) 
Seat 8: aseban11 ($156.75 in chips) 
Seat 9: mycka86 ($100 in chips) 
Pacifistas: posts small blind $0.50
matiko09: posts big blind $1
fanmtZ: sits out 
*** HOLE CARDS ***
Dealt to matiko09 [Qs 9d]
RICKA16: folds 
cobrik23: folds 
roninio1: folds 
aseban11: raises $2 to $3
mycka86: folds 
Pacifistas: folds 
matiko09: folds 
Uncalled bet ($2) returned to aseban11
aseban11 collected $2.50 from pot
aseban11: doesn't show hand 
*** SUMMARY ***
Total pot $2.50 | Rake $0 
Seat 1: Pacifistas (small blind) folded before Flop
Seat 2: matiko09 (big blind) folded before Flop
Seat 4: RICKA16 folded before Flop (didn't bet)
Seat 5: cobrik23 folded before Flop (didn't bet)
Seat 7: roninio1 folded before Flop (didn't bet)
Seat 8: aseban11 collected ($2.50)
Seat 9: mycka86 (button) folded before Flop (didn't bet)





PokerStars Hand #150707863022:  Hold'em No Limit ($0.50/$1.00 USD) - 2016/03/21 17:09:13 CET [2016/03/21 12:09:13 ET]
Table 'Marmulla II' 9-max Seat #5 is the button
Seat 1: hammerwife ($100 in chips) 
Seat 3: Vikulja1993 ($103.64 in chips) 
Seat 4: Dachish ($69.14 in chips) 
Seat 5: maaaGik88 ($90.71 in chips) 
Seat 6: R1aki ($100.50 in chips) 
Seat 7: Pacifistas ($117.10 in chips) 
Seat 8: ilaviiitech ($106.44 in chips) 
Seat 9: matiko09 ($100 in chips) 
R1aki: posts small blind $0.50
Pacifistas: posts big blind $1
*** HOLE CARDS ***
Dealt to matiko09 [2s 6d]
ilaviiitech: folds 
matiko09: folds 
hammerwife: folds 
Vikulja1993: folds 
Dachish: raises $1.50 to $2.50
maaaGik88: calls $2.50
R1aki: folds 
Pacifistas: calls $1.50
*** FLOP *** [4d As Qh]
Pacifistas: checks 
Dachish: bets $3.74
maaaGik88: calls $3.74
Pacifistas: folds 
*** TURN *** [4d As Qh] [5s]
Dachish: bets $10.49
maaaGik88: folds 
Uncalled bet ($10.49) returned to Dachish
Dachish collected $14.78 from pot
Dachish: doesn't show hand 
*** SUMMARY ***
Total pot $15.48 | Rake $0.70 
Board [4d As Qh 5s]
Seat 1: hammerwife folded before Flop (didn't bet)
Seat 3: Vikulja1993 folded before Flop (didn't bet)
Seat 4: Dachish collected ($14.78)
Seat 5: maaaGik88 (button) folded on the Turn
Seat 6: R1aki (small blind) folded before Flop
Seat 7: Pacifistas (big blind) folded on the Flop
Seat 8: ilaviiitech folded before Flop (didn't bet)
Seat 9: matiko09 folded before Flop (didn't bet)





PokerStars Hand #150707864388:  Hold'em No Limit ($0.50/$1.00 USD) - 2016/03/21 17:09:14 CET [2016/03/21 12:09:14 ET]
Table 'Skadi III' 9-max Seat #8 is the button
Seat 2: aseban11 ($100 in chips) 
Seat 3: matiko09 ($101.50 in chips) 
Seat 4: ilaviiitech ($107.16 in chips) 
Seat 6: Pacifistas ($100.35 in chips) 
Seat 8: volwebni4ek ($40 in chips) 
Seat 9: fanmtZ ($40 in chips) 
fanmtZ: posts small blind $0.50
CI58: is sitting out 
aseban11: posts big blind $1
*** HOLE CARDS ***
Dealt to matiko09 [9s As]
CI58 leaves the table
matiko09: raises $2 to $3
ilaviiitech: folds 
Pacifistas: folds 
volwebni4ek: calls $3
fanmtZ: folds 
aseban11: folds 
*** FLOP *** [2h Qc 7d]
matiko09: checks 
volwebni4ek: bets $4.44
matiko09: folds 
Uncalled bet ($4.44) returned to volwebni4ek
volwebni4ek collected $7.16 from pot
volwebni4ek: doesn't show hand 
*** SUMMARY ***
Total pot $7.50 | Rake $0.34 
Board [2h Qc 7d]
Seat 2: aseban11 (big blind) folded before Flop
Seat 3: matiko09 folded on the Flop
Seat 4: ilaviiitech folded before Flop (didn't bet)
Seat 6: Pacifistas folded before Flop (didn't bet)
Seat 8: volwebni4ek (button) collected ($7.16)
Seat 9: fanmtZ (small blind) folded before Flop





PokerStars Hand #150707866847:  Hold'em No Limit (€0.25/€0.50 EUR) - 2016/03/21 17:09:18 CET [2016/03/21 12:09:18 ET]
Table 'Auravictrix II' 9-max Seat #6 is the button
Seat 1: aponinho82 (€99.67 in chips) 
Seat 2: ffac (€52.08 in chips) 
Seat 3: matiko09 (€52.96 in chips) 
Seat 4: i am owsome (€94 in chips) 
Seat 5: nombraalne1 (€66.41 in chips) 
Seat 6: Devsteel (€50 in chips) 
Seat 7: vasiy379 (€50.25 in chips) 
Seat 8: ardo888 (€50 in chips) 
Seat 9: carlouchi (€40.65 in chips) 
vasiy379: posts small blind €0.25
ardo888: posts big blind €0.50
*** HOLE CARDS ***
Dealt to matiko09 [Th Ad]
carlouchi: folds 
aponinho82: calls €0.50
ffac: raises €1.50 to €2
matiko09: folds 
i am owsome: folds 
nombraalne1: calls €2
Devsteel: raises €5.50 to €7.50
vasiy379: folds 
ardo888: folds 
aponinho82: folds 
ffac: folds 
nombraalne1: folds 
Uncalled bet (€5.50) returned to Devsteel
Devsteel collected €7.25 from pot
Devsteel: doesn't show hand 
*** SUMMARY ***
Total pot €7.25 | Rake €0 
Seat 1: aponinho82 folded before Flop
Seat 2: ffac folded before Flop
Seat 3: matiko09 folded before Flop (didn't bet)
Seat 4: i am owsome folded before Flop (didn't bet)
Seat 5: nombraalne1 folded before Flop
Seat 6: Devsteel (button) collected (€7.25)
Seat 7: vasiy379 (small blind) folded before Flop
Seat 8: ardo888 (big blind) folded before Flop
Seat 9: carlouchi folded before Flop (didn't bet)





PokerStars Hand #150707869087:  Hold'em No Limit ($0.50/$1.00 USD) - 2016/03/21 17:09:21 CET [2016/03/21 12:09:21 ET]
Table 'Icarion II' 9-max Seat #5 is the button
Seat 1: forsmthgood ($101.31 in chips) 
Seat 2: aseban11 ($100 in chips) 
Seat 3: volwebni4ek ($42.80 in chips) 
Seat 4: teukka8 ($29.10 in chips) 
Seat 5: SanychStar ($128.88 in chips) 
Seat 7: Pacifistas ($100 in chips) 
Seat 8: matiko09 ($111.50 in chips) 
Seat 9: R1aki ($136.76 in chips) 
Pacifistas: posts small blind $0.50
matiko09: posts big blind $1
*** HOLE CARDS ***
Dealt to matiko09 [9c 9s]
R1aki: folds 
forsmthgood: folds 
aseban11: folds 
volwebni4ek: raises $1.50 to $2.50
teukka8: calls $2.50
SanychStar: folds 
Pacifistas: folds 
matiko09: raises $8.50 to $11
volwebni4ek: folds 
teukka8: calls $8.50
*** FLOP *** [Jc 7h 4s]
matiko09: bets $12
teukka8: folds 
Uncalled bet ($12) returned to matiko09
matiko09 collected $23.88 from pot
matiko09: doesn't show hand 
*** SUMMARY ***
Total pot $25 | Rake $1.12 
Board [Jc 7h 4s]
Seat 1: forsmthgood folded before Flop (didn't bet)
Seat 2: aseban11 folded before Flop (didn't bet)
Seat 3: volwebni4ek folded before Flop
Seat 4: teukka8 folded on the Flop
Seat 5: SanychStar (button) folded before Flop (didn't bet)
Seat 7: Pacifistas (small blind) folded before Flop
Seat 8: matiko09 (big blind) collected ($23.88)
Seat 9: R1aki folded before Flop (didn't bet)





PokerStars Hand #150707884984:  Hold'em No Limit ($0.50/$1.00 USD) - 2016/03/21 17:09:42 CET [2016/03/21 12:09:42 ET]
Table 'Onnie II' 9-max Seat #2 is the button
Seat 2: RICKA16 ($100 in chips) 
Seat 3: cn_chayanne ($155.64 in chips) 
Seat 4: Bothfeld11 ($160.06 in chips) 
Seat 5: sanpidk ($101.75 in chips) 
Seat 6: Pacifistas ($104.77 in chips) 
Seat 7: djammusic ($76.90 in chips) 
Seat 9: matiko09 ($129.19 in chips) 
cn_chayanne: posts small blind $0.50
Bothfeld11: posts big blind $1
ka100pka527: sits out 
*** HOLE CARDS ***
Dealt to matiko09 [2d 7d]
sanpidk: folds 
Pacifistas: raises $2 to $3
djammusic: folds 
matiko09: folds 
RICKA16: raises $7 to $10
cn_chayanne: folds 
Bothfeld11: folds 
Pacifistas: folds 
Uncalled bet ($7) returned to RICKA16
RICKA16 collected $7.50 from pot
RICKA16: doesn't show hand 
*** SUMMARY ***
Total pot $7.50 | Rake $0 
Seat 2: RICKA16 (button) collected ($7.50)
Seat 3: cn_chayanne (small blind) folded before Flop
Seat 4: Bothfeld11 (big blind) folded before Flop
Seat 5: sanpidk folded before Flop (didn't bet)
Seat 6: Pacifistas folded before Flop
Seat 7: djammusic folded before Flop (didn't bet)
Seat 9: matiko09 folded before Flop (didn't bet)





PokerStars Hand #150707892332:  Hold'em No Limit ($0.50/$1.00 USD) - 2016/03/21 17:09:51 CET [2016/03/21 12:09:51 ET]
Table 'Lucifer III' 9-max Seat #1 is the button
Seat 1: Pacifistas ($146.46 in chips) 
Seat 2: matiko09 ($111.50 in chips) 
Seat 3: fanmtZ ($40 in chips) 
Seat 4: RICKA16 ($216.83 in chips) 
Seat 5: cobrik23 ($76.29 in chips) 
Seat 7: roninio1 ($52.09 in chips) 
Seat 8: aseban11 ($158.25 in chips) 
Seat 9: mycka86 ($100 in chips) 
matiko09: posts small blind $0.50
fanmtZ: posts big blind $1
*** HOLE CARDS ***
Dealt to matiko09 [Tc 7c]
RICKA16: folds 
cobrik23: folds 
roninio1: raises $2 to $3
aseban11: folds 
mycka86: folds 
Pacifistas: folds 
matiko09: folds 
fanmtZ: folds 
Uncalled bet ($2) returned to roninio1
roninio1 collected $2.50 from pot
roninio1: doesn't show hand 
*** SUMMARY ***
Total pot $2.50 | Rake $0 
Seat 1: Pacifistas (button) folded before Flop (didn't bet)
Seat 2: matiko09 (small blind) folded before Flop
Seat 3: fanmtZ (big blind) folded before Flop
Seat 4: RICKA16 folded before Flop (didn't bet)
Seat 5: cobrik23 folded before Flop (didn't bet)
Seat 7: roninio1 collected ($2.50)
Seat 8: aseban11 folded before Flop (didn't bet)
Seat 9: mycka86 folded before Flop (didn't bet)





PokerStars Hand #150707901042:  Hold'em No Limit (€0.25/€0.50 EUR) - 2016/03/21 17:10:03 CET [2016/03/21 12:10:03 ET]
Table 'Auravictrix II' 9-max Seat #7 is the button
Seat 1: aponinho82 (€99.17 in chips) 
Seat 2: ffac (€50.08 in chips) 
Seat 3: matiko09 (€52.96 in chips) 
Seat 4: i am owsome (€94 in chips) 
Seat 5: nombraalne1 (€64.41 in chips) 
Seat 6: Devsteel (€55.25 in chips) 
Seat 7: vasiy379 (€50 in chips) 
Seat 8: ardo888 (€50 in chips) 
Seat 9: carlouchi (€40.65 in chips) 
ardo888: posts small blind €0.25
carlouchi: posts big blind €0.50
*** HOLE CARDS ***
Dealt to matiko09 [9h 5s]
aponinho82: folds 
ffac: folds 
matiko09: folds 
aponinho82 leaves the table
Indr3k joins the table at seat #1 
Indr3k leaves the table
i am owsome: folds 
nombraalne1: folds 
Devsteel: folds 
vasiy379: folds 
Al3xAnd3r22 joins the table at seat #1 
ardo888: folds 
Uncalled bet (€0.25) returned to carlouchi
carlouchi collected €0.50 from pot
carlouchi: doesn't show hand 
*** SUMMARY ***
Total pot €0.50 | Rake €0 
Seat 1: aponinho82 folded before Flop (didn't bet)
Seat 2: ffac folded before Flop (didn't bet)
Seat 3: matiko09 folded before Flop (didn't bet)
Seat 4: i am owsome folded before Flop (didn't bet)
Seat 5: nombraalne1 folded before Flop (didn't bet)
Seat 6: Devsteel folded before Flop (didn't bet)
Seat 7: vasiy379 (button) folded before Flop (didn't bet)
Seat 8: ardo888 (small blind) folded before Flop
Seat 9: carlouchi (big blind) collected (€0.50)





PokerStars Hand #150707913804:  Hold'em No Limit ($0.50/$1.00 USD) - 2016/03/21 17:10:20 CET [2016/03/21 12:10:20 ET]
Table 'Lucifer III' 9-max Seat #2 is the button
Seat 1: Pacifistas ($146.46 in chips) 
Seat 2: matiko09 ($111 in chips) 
Seat 3: fanmtZ ($40 in chips) 
Seat 4: RICKA16 ($216.83 in chips) 
Seat 5: cobrik23 ($76.29 in chips) 
Seat 7: roninio1 ($53.59 in chips) 
Seat 8: aseban11 ($158.25 in chips) 
Seat 9: mycka86 ($100 in chips) 
fanmtZ: posts small blind $0.50
RICKA16: posts big blind $1
*** HOLE CARDS ***
Dealt to matiko09 [8h 9d]
cobrik23: folds 
roninio1: calls $1
aseban11: folds 
mycka86: folds 
Pacifistas: folds 
matiko09: folds 
fanmtZ: folds 
RICKA16: raises $3 to $4
roninio1: raises $49.59 to $53.59 and is all-in
RICKA16: calls $49.59
*** FLOP *** [2d 5s Kc]
*** TURN *** [2d 5s Kc] [5c]
*** RIVER *** [2d 5s Kc 5c] [9h]
*** SHOW DOWN ***
RICKA16: shows [Kd Qc] (two pair, Kings and Fives)
roninio1: shows [Jh Kh] (two pair, Kings and Fives - lower kicker)
RICKA16 collected $104.88 from pot
*** SUMMARY ***
Total pot $107.68 | Rake $2.80 
Board [2d 5s Kc 5c 9h]
Seat 1: Pacifistas folded before Flop (didn't bet)
Seat 2: matiko09 (button) folded before Flop (didn't bet)
Seat 3: fanmtZ (small blind) folded before Flop
Seat 4: RICKA16 (big blind) showed [Kd Qc] and won ($104.88) with two pair, Kings and Fives
Seat 5: cobrik23 folded before Flop (didn't bet)
Seat 7: roninio1 showed [Jh Kh] and lost with two pair, Kings and Fives
Seat 8: aseban11 folded before Flop (didn't bet)
Seat 9: mycka86 folded before Flop (didn't bet)





PokerStars Hand #150707914572:  Hold'em No Limit ($0.50/$1.00 USD) - 2016/03/21 17:10:21 CET [2016/03/21 12:10:21 ET]
Table 'Onnie II' 9-max Seat #3 is the button
Seat 2: RICKA16 ($104.50 in chips) 
Seat 3: cn_chayanne ($155.14 in chips) 
Seat 4: Bothfeld11 ($159.06 in chips) 
Seat 5: sanpidk ($101.75 in chips) 
Seat 6: Pacifistas ($101.77 in chips) 
Seat 7: djammusic ($76.90 in chips) 
Seat 9: matiko09 ($129.19 in chips) 
Bothfeld11: posts small blind $0.50
sanpidk: posts big blind $1
ka100pka527: sits out 
*** HOLE CARDS ***
Dealt to matiko09 [7d 3c]
Pacifistas: folds 
djammusic: folds 
matiko09: folds 
RICKA16: folds 
cn_chayanne: raises $1.50 to $2.50
Bothfeld11: folds 
sanpidk: calls $1.50
*** FLOP *** [9c Js Kc]
sanpidk: checks 
cn_chayanne: checks 
*** TURN *** [9c Js Kc] [8h]
sanpidk: bets $3.50
cn_chayanne: folds 
Uncalled bet ($3.50) returned to sanpidk
sanpidk collected $5.25 from pot
sanpidk: doesn't show hand 
*** SUMMARY ***
Total pot $5.50 | Rake $0.25 
Board [9c Js Kc 8h]
Seat 2: RICKA16 folded before Flop (didn't bet)
Seat 3: cn_chayanne (button) folded on the Turn
Seat 4: Bothfeld11 (small blind) folded before Flop
Seat 5: sanpidk (big blind) collected ($5.25)
Seat 6: Pacifistas folded before Flop (didn't bet)
Seat 7: djammusic folded before Flop (didn't bet)
Seat 9: matiko09 folded before Flop (didn't bet)





PokerStars Hand #150707915155:  Hold'em No Limit (€0.25/€0.50 EUR) - 2016/03/21 17:10:22 CET [2016/03/21 12:10:22 ET]
Table 'Auravictrix II' 9-max Seat #8 is the button
Seat 1: Al3xAnd3r22 (€50 in chips) 
Seat 2: ffac (€50.08 in chips) 
Seat 3: matiko09 (€52.96 in chips) 
Seat 4: i am owsome (€94 in chips) 
Seat 5: nombraalne1 (€64.41 in chips) 
Seat 6: Devsteel (€55.25 in chips) 
Seat 7: vasiy379 (€50 in chips) 
Seat 8: ardo888 (€50 in chips) 
Seat 9: carlouchi (€40.90 in chips) 
carlouchi: posts small blind €0.25
Al3xAnd3r22: posts big blind €0.50
*** HOLE CARDS ***
Dealt to matiko09 [4h 3c]
ffac: folds 
matiko09: folds 
i am owsome: folds 
nombraalne1: raises €0.75 to €1.25
Devsteel: raises €2.75 to €4
vasiy379: folds 
ardo888: folds 
carlouchi: folds 
Al3xAnd3r22: folds 
nombraalne1: raises €7 to €11
Devsteel: folds 
Uncalled bet (€7) returned to nombraalne1
nombraalne1 collected €8.75 from pot
nombraalne1: doesn't show hand 
*** SUMMARY ***
Total pot €8.75 | Rake €0 
Seat 1: Al3xAnd3r22 (big blind) folded before Flop
Seat 2: ffac folded before Flop (didn't bet)
Seat 3: matiko09 folded before Flop (didn't bet)
Seat 4: i am owsome folded before Flop (didn't bet)
Seat 5: nombraalne1 collected (€8.75)
Seat 6: Devsteel folded before Flop
Seat 7: vasiy379 folded before Flop (didn't bet)
Seat 8: ardo888 (button) folded before Flop (didn't bet)
Seat 9: carlouchi (small blind) folded before Flop





PokerStars Hand #150707918149:  Hold'em No Limit ($0.50/$1.00 USD) - 2016/03/21 17:10:26 CET [2016/03/21 12:10:26 ET]
Table 'Massalia II' 9-max Seat #2 is the button
Seat 2: maxxmeister ($100 in chips) 
Seat 3: 123chambo ($145.26 in chips) 
Seat 4: OriginalTony ($90.62 in chips) 
Seat 5: Vikulja1993 ($100 in chips) 
Seat 6: Pacifistas ($127.71 in chips) 
Seat 7: flk.Dasas ($100 in chips) 
Seat 8: matiko09 ($138.28 in chips) 
Seat 9: hammerwife ($116.67 in chips) 
123chambo: posts small blind $0.50
OriginalTony: posts big blind $1
Filojoes: sits out 
maxxmeister: posts the ante $0.20
123chambo: posts the ante $0.20
OriginalTony: posts the ante $0.20
Vikulja1993: posts the ante $0.20
Pacifistas: posts the ante $0.20
flk.Dasas: posts the ante $0.20
matiko09: posts the ante $0.20
hammerwife: posts the ante $0.20
*** HOLE CARDS ***
Dealt to matiko09 [3d Ts]
Vikulja1993: folds 
Pacifistas: folds 
flk.Dasas: folds 
matiko09: folds 
hammerwife: folds 
maxxmeister: raises $2.50 to $3.50
123chambo: folds 
OriginalTony: calls $2.50
*** FLOP *** [2c 6c 4s]
OriginalTony: checks 
maxxmeister: checks 
*** TURN *** [2c 6c 4s] [2s]
OriginalTony: checks 
maxxmeister: checks 
*** RIVER *** [2c 6c 4s 2s] [Qc]
OriginalTony: bets $5
maxxmeister: calls $5
*** SHOW DOWN ***
OriginalTony: shows [Tc Qh] (two pair, Queens and Deuces)
maxxmeister: mucks hand 
OriginalTony collected $18.24 from pot
*** SUMMARY ***
Total pot $19.10 | Rake $0.86 
Board [2c 6c 4s 2s Qc]
Seat 2: maxxmeister (button) mucked [Kd Ac]
Seat 3: 123chambo (small blind) folded before Flop
Seat 4: OriginalTony (big blind) showed [Tc Qh] and won ($18.24) with two pair, Queens and Deuces
Seat 5: Vikulja1993 folded before Flop (didn't bet)
Seat 6: Pacifistas folded before Flop (didn't bet)
Seat 7: flk.Dasas folded before Flop (didn't bet)
Seat 8: matiko09 folded before Flop (didn't bet)
Seat 9: hammerwife folded before Flop (didn't bet)





PokerStars Hand #150707931250:  Hold'em No Limit ($0.50/$1.00 USD) - 2016/03/21 17:10:43 CET [2016/03/21 12:10:43 ET]
Table 'Marmulla II' 9-max Seat #6 is the button
Seat 1: hammerwife ($100 in chips) 
Seat 3: Vikulja1993 ($103.64 in chips) 
Seat 4: Dachish ($77.68 in chips) 
Seat 5: maaaGik88 ($84.47 in chips) 
Seat 6: R1aki ($100 in chips) 
Seat 7: Pacifistas ($114.60 in chips) 
Seat 9: matiko09 ($100 in chips) 
Pacifistas: posts small blind $0.50
ilaviiitech: is sitting out 
ilaviiitech leaves the table
matiko09: posts big blind $1
*** HOLE CARDS ***
Dealt to matiko09 [7s Tc]
hammerwife: folds 
Vikulja1993: folds 
Dachish: folds 
sanpidk joins the table at seat #8 
maaaGik88: calls $1
hammerwife leaves the table
R1aki: raises $3.50 to $4.50
fanmtZ joins the table at seat #1 
Pacifistas: folds 
matiko09: folds 
maaaGik88: folds 
Uncalled bet ($3.50) returned to R1aki
R1aki collected $3.50 from pot
R1aki: doesn't show hand 
*** SUMMARY ***
Total pot $3.50 | Rake $0 
Seat 1: hammerwife folded before Flop (didn't bet)
Seat 3: Vikulja1993 folded before Flop (didn't bet)
Seat 4: Dachish folded before Flop (didn't bet)
Seat 5: maaaGik88 folded before Flop
Seat 6: R1aki (button) collected ($3.50)
Seat 7: Pacifistas (small blind) folded before Flop
Seat 9: matiko09 (big blind) folded before Flop





PokerStars Hand #150707933978:  Hold'em No Limit ($0.50/$1.00 USD) - 2016/03/21 17:10:46 CET [2016/03/21 12:10:46 ET]
Table 'Icarion II' 9-max Seat #7 is the button
Seat 1: forsmthgood ($101.31 in chips) 
Seat 2: aseban11 ($100 in chips) 
Seat 3: volwebni4ek ($40.30 in chips) 
Seat 4: teukka8 ($18.10 in chips) 
Seat 5: SanychStar ($128.88 in chips) 
Seat 7: Pacifistas ($100 in chips) 
Seat 8: matiko09 ($124.38 in chips) 
Seat 9: R1aki ($136.76 in chips) 
matiko09: posts small blind $0.50
R1aki: posts big blind $1
*** HOLE CARDS ***
Dealt to matiko09 [3d Th]
forsmthgood: folds 
aseban11: folds 
forsmthgood leaves the table
fanmtZ joins the table at seat #1 
volwebni4ek: folds 
teukka8: folds 
SanychStar: folds 
teukka8 leaves the table
sanpidk joins the table at seat #4 
sanpidk leaves the table
Pacifistas: folds 
matiko09: folds 
Uncalled bet ($0.50) returned to R1aki
R1aki collected $1 from pot
R1aki: doesn't show hand 
*** SUMMARY ***
Total pot $1 | Rake $0 
Seat 1: forsmthgood folded before Flop (didn't bet)
Seat 2: aseban11 folded before Flop (didn't bet)
Seat 3: volwebni4ek folded before Flop (didn't bet)
Seat 4: teukka8 folded before Flop (didn't bet)
Seat 5: SanychStar folded before Flop (didn't bet)
Seat 7: Pacifistas (button) folded before Flop (didn't bet)
Seat 8: matiko09 (small blind) folded before Flop
Seat 9: R1aki (big blind) collected ($1)





PokerStars Hand #150707956520:  Hold'em No Limit ($0.50/$1.00 USD) - 2016/03/21 17:11:16 CET [2016/03/21 12:11:16 ET]
Table 'Icarion II' 9-max Seat #8 is the button
Seat 1: fanmtZ ($40 in chips) 
Seat 2: aseban11 ($100 in chips) 
Seat 3: volwebni4ek ($40.30 in chips) 
Seat 5: SanychStar ($128.88 in chips) 
Seat 7: Pacifistas ($100 in chips) 
Seat 8: matiko09 ($123.88 in chips) 
Seat 9: R1aki ($137.26 in chips) 
R1aki: posts small blind $0.50
fanmtZ: posts big blind $1
*** HOLE CARDS ***
Dealt to matiko09 [7s Js]
aseban11: folds 
volwebni4ek: folds 
SanychStar: folds 
aseban11 leaves the table
ka100pka527 joins the table at seat #2 
Pacifistas: folds 
matiko09: raises $1.27 to $2.27
R1aki: raises $7.23 to $9.50
fanmtZ: folds 
matiko09: folds 
Uncalled bet ($7.23) returned to R1aki
R1aki collected $5.54 from pot
R1aki: doesn't show hand 
*** SUMMARY ***
Total pot $5.54 | Rake $0 
Seat 1: fanmtZ (big blind) folded before Flop
Seat 2: aseban11 folded before Flop (didn't bet)
Seat 3: volwebni4ek folded before Flop (didn't bet)
Seat 5: SanychStar folded before Flop (didn't bet)
Seat 7: Pacifistas folded before Flop (didn't bet)
Seat 8: matiko09 (button) folded before Flop
Seat 9: R1aki (small blind) collected ($5.54)





PokerStars Hand #150707959280:  Hold'em No Limit ($0.50/$1.00 USD) - 2016/03/21 17:11:20 CET [2016/03/21 12:11:20 ET]
Table 'Lucifer III' 9-max Seat #3 is the button
Seat 1: Pacifistas ($146.46 in chips) 
Seat 2: matiko09 ($111 in chips) 
Seat 3: fanmtZ ($40 in chips) 
Seat 4: RICKA16 ($268.12 in chips) 
Seat 8: aseban11 ($158.25 in chips) 
Seat 9: mycka86 ($100 in chips) 
RICKA16: posts small blind $0.50
cobrik23: is sitting out 
aseban11: posts big blind $1
*** HOLE CARDS ***
Dealt to matiko09 [5d Jh]
mycka86: folds 
Pacifistas: folds 
roninio1 leaves the table
sanpidk joins the table at seat #7 
matiko09: folds 
sanpidk leaves the table
Dachish joins the table at seat #7 
Dachish leaves the table
fanmtZ: folds 
RICKA16: folds 
Uncalled bet ($0.50) returned to aseban11
aseban11 collected $1 from pot
aseban11: doesn't show hand 
*** SUMMARY ***
Total pot $1 | Rake $0 
Seat 1: Pacifistas folded before Flop (didn't bet)
Seat 2: matiko09 folded before Flop (didn't bet)
Seat 3: fanmtZ (button) folded before Flop (didn't bet)
Seat 4: RICKA16 (small blind) folded before Flop
Seat 8: aseban11 (big blind) collected ($1)
Seat 9: mycka86 folded before Flop (didn't bet)





PokerStars Hand #150707960510:  Hold'em No Limit ($0.50/$1.00 USD) - 2016/03/21 17:11:21 CET [2016/03/21 12:11:21 ET]
Table 'Onnie II' 9-max Seat #4 is the button
Seat 2: RICKA16 ($104.50 in chips) 
Seat 3: cn_chayanne ($152.64 in chips) 
Seat 4: Bothfeld11 ($158.56 in chips) 
Seat 5: sanpidk ($104.50 in chips) 
Seat 6: Pacifistas ($101.77 in chips) 
Seat 7: djammusic ($76.90 in chips) 
Seat 9: matiko09 ($129.19 in chips) 
sanpidk: posts small blind $0.50
Pacifistas: posts big blind $1
ka100pka527: sits out 
*** HOLE CARDS ***
Dealt to matiko09 [3d Th]
djammusic: raises $1.50 to $2.50
matiko09: folds 
RICKA16: folds 
cn_chayanne: folds 
Bothfeld11: folds 
sanpidk: calls $2
Pacifistas: calls $1.50
*** FLOP *** [3c 5s Kd]
sanpidk: checks 
Pacifistas: checks 
djammusic: checks 
*** TURN *** [3c 5s Kd] [As]
sanpidk: checks 
Pacifistas: checks 
djammusic: checks 
*** RIVER *** [3c 5s Kd As] [4h]
sanpidk: checks 
Pacifistas: checks 
djammusic: checks 
*** SHOW DOWN ***
sanpidk: shows [8s 8c] (a pair of Eights)
Pacifistas: shows [Ks Jc] (a pair of Kings)
djammusic: mucks hand 
Pacifistas collected $7.16 from pot
*** SUMMARY ***
Total pot $7.50 | Rake $0.34 
Board [3c 5s Kd As 4h]
Seat 2: RICKA16 folded before Flop (didn't bet)
Seat 3: cn_chayanne folded before Flop (didn't bet)
Seat 4: Bothfeld11 (button) folded before Flop (didn't bet)
Seat 5: sanpidk (small blind) showed [8s 8c] and lost with a pair of Eights
Seat 6: Pacifistas (big blind) showed [Ks Jc] and won ($7.16) with a pair of Kings
Seat 7: djammusic mucked [Qc Qs]
Seat 9: matiko09 folded before Flop (didn't bet)





PokerStars Hand #150707965695:  Hold'em No Limit ($0.50/$1.00 USD) - 2016/03/21 17:11:28 CET [2016/03/21 12:11:28 ET]
Table 'Marmulla II' 9-max Seat #7 is the button
Seat 3: Vikulja1993 ($103.64 in chips) 
Seat 4: Dachish ($77.68 in chips) 
Seat 5: maaaGik88 ($83.47 in chips) 
Seat 6: R1aki ($102.50 in chips) 
Seat 7: Pacifistas ($114.10 in chips) 
Seat 9: matiko09 ($100 in chips) 
sanpidk will be allowed to play after the button
matiko09: posts small blind $0.50
Vikulja1993: posts big blind $1
*** HOLE CARDS ***
Dealt to matiko09 [Js 4c]
Dachish: folds 
maaaGik88: folds 
R1aki: folds 
Pacifistas: folds 
matiko09: folds 
Uncalled bet ($0.50) returned to Vikulja1993
Vikulja1993 collected $1 from pot
Vikulja1993: doesn't show hand 
*** SUMMARY ***
Total pot $1 | Rake $0 
Seat 3: Vikulja1993 (big blind) collected ($1)
Seat 4: Dachish folded before Flop (didn't bet)
Seat 5: maaaGik88 folded before Flop (didn't bet)
Seat 6: R1aki folded before Flop (didn't bet)
Seat 7: Pacifistas (button) folded before Flop (didn't bet)
Seat 9: matiko09 (small blind) folded before Flop





PokerStars Hand #150707973410:  Hold'em No Limit (€0.25/€0.50 EUR) - 2016/03/21 17:11:38 CET [2016/03/21 12:11:38 ET]
Table 'Auravictrix II' 9-max Seat #9 is the button
Seat 1: Al3xAnd3r22 (€50 in chips) 
Seat 2: ffac (€50.08 in chips) 
Seat 3: matiko09 (€52.96 in chips) 
Seat 4: i am owsome (€94 in chips) 
Seat 5: nombraalne1 (€69.16 in chips) 
Seat 6: Devsteel (€51.25 in chips) 
Seat 7: vasiy379 (€50 in chips) 
Seat 8: ardo888 (€50 in chips) 
Seat 9: carlouchi (€40.65 in chips) 
Al3xAnd3r22: posts small blind €0.25
ffac: posts big blind €0.50
*** HOLE CARDS ***
Dealt to matiko09 [Ah Js]
matiko09: raises €1 to €1.50
i am owsome: folds 
nombraalne1: folds 
Devsteel: folds 
vasiy379: folds 
ardo888: folds 
carlouchi: folds 
Al3xAnd3r22: folds 
ffac: folds 
Uncalled bet (€1) returned to matiko09
matiko09 collected €1.25 from pot
matiko09: doesn't show hand 
*** SUMMARY ***
Total pot €1.25 | Rake €0 
Seat 1: Al3xAnd3r22 (small blind) folded before Flop
Seat 2: ffac (big blind) folded before Flop
Seat 3: matiko09 collected (€1.25)
Seat 4: i am owsome folded before Flop (didn't bet)
Seat 5: nombraalne1 folded before Flop (didn't bet)
Seat 6: Devsteel folded before Flop (didn't bet)
Seat 7: vasiy379 folded before Flop (didn't bet)
Seat 8: ardo888 folded before Flop (didn't bet)
Seat 9: carlouchi (button) folded before Flop (didn't bet)





PokerStars Hand #150707981491:  Hold'em No Limit ($0.50/$1.00 USD) - 2016/03/21 17:11:49 CET [2016/03/21 12:11:49 ET]
Table 'Lucifer III' 9-max Seat #4 is the button
Seat 1: Pacifistas ($146.46 in chips) 
Seat 2: matiko09 ($111 in chips) 
Seat 3: fanmtZ ($40 in chips) 
Seat 4: RICKA16 ($267.62 in chips) 
Seat 8: aseban11 ($158.75 in chips) 
Seat 9: mycka86 ($100 in chips) 
aseban11: posts small blind $0.50
mycka86: posts big blind $1
*** HOLE CARDS ***
Dealt to matiko09 [9s Jc]
Pacifistas: folds 
matiko09: folds 
fanmtZ: raises $1.50 to $2.50
RICKA16: folds 
aseban11: folds 
mycka86: folds 
Uncalled bet ($1.50) returned to fanmtZ
fanmtZ collected $2.50 from pot
fanmtZ: doesn't show hand 
*** SUMMARY ***
Total pot $2.50 | Rake $0 
Seat 1: Pacifistas folded before Flop (didn't bet)
Seat 2: matiko09 folded before Flop (didn't bet)
Seat 3: fanmtZ collected ($2.50)
Seat 4: RICKA16 (button) folded before Flop (didn't bet)
Seat 8: aseban11 (small blind) folded before Flop
Seat 9: mycka86 (big blind) folded before Flop





PokerStars Hand #150707984164:  Hold'em No Limit ($0.50/$1.00 USD) - 2016/03/21 17:11:52 CET [2016/03/21 12:11:52 ET]
Table 'Massalia II' 9-max Seat #3 is the button
Seat 2: maxxmeister ($100 in chips) 
Seat 3: 123chambo ($144.56 in chips) 
Seat 4: OriginalTony ($100.16 in chips) 
Seat 5: Vikulja1993 ($100 in chips) 
Seat 6: Pacifistas ($127.51 in chips) 
Seat 7: flk.Dasas ($100 in chips) 
Seat 8: matiko09 ($138.08 in chips) 
Seat 9: hammerwife ($116.47 in chips) 
OriginalTony: posts small blind $0.50
Vikulja1993: posts big blind $1
Filojoes: sits out 
maxxmeister: posts the ante $0.20
123chambo: posts the ante $0.20
OriginalTony: posts the ante $0.20
Vikulja1993: posts the ante $0.20
Pacifistas: posts the ante $0.20
flk.Dasas: posts the ante $0.20
matiko09: posts the ante $0.20
hammerwife: posts the ante $0.20
*** HOLE CARDS ***
Dealt to matiko09 [Ts 4d]
Pacifistas: folds 
flk.Dasas: raises $3 to $4
matiko09: folds 
hammerwife: folds 
maxxmeister: folds 
123chambo: folds 
OriginalTony: folds 
Vikulja1993: folds 
Uncalled bet ($3) returned to flk.Dasas
flk.Dasas collected $4.10 from pot
flk.Dasas: doesn't show hand 
*** SUMMARY ***
Total pot $4.10 | Rake $0 
Seat 2: maxxmeister folded before Flop (didn't bet)
Seat 3: 123chambo (button) folded before Flop (didn't bet)
Seat 4: OriginalTony (small blind) folded before Flop
Seat 5: Vikulja1993 (big blind) folded before Flop
Seat 6: Pacifistas folded before Flop (didn't bet)
Seat 7: flk.Dasas collected ($4.10)
Seat 8: matiko09 folded before Flop (didn't bet)
Seat 9: hammerwife folded before Flop (didn't bet)





PokerStars Hand #150707984609:  Hold'em No Limit ($0.50/$1.00 USD) - 2016/03/21 17:11:53 CET [2016/03/21 12:11:53 ET]
Table 'Marmulla II' 9-max Seat #9 is the button
Seat 3: Vikulja1993 ($104.14 in chips) 
Seat 4: Dachish ($77.68 in chips) 
Seat 5: maaaGik88 ($83.47 in chips) 
Seat 6: R1aki ($102.50 in chips) 
Seat 7: Pacifistas ($114.10 in chips) 
Seat 9: matiko09 ($100 in chips) 
Vikulja1993: posts small blind $0.50
Dachish: posts big blind $1
sanpidk: sits out 
*** HOLE CARDS ***
Dealt to matiko09 [6d 2s]
maaaGik88: folds 
R1aki: folds 
Pacifistas: folds 
matiko09: folds 
Vikulja1993: raises $1.50 to $2.50
Dachish: calls $1.50
*** FLOP *** [Ts Kc Qc]
Vikulja1993: bets $2.50
Dachish: raises $8.89 to $11.39
Vikulja1993: folds 
Uncalled bet ($8.89) returned to Dachish
Dachish collected $9.55 from pot
Dachish: doesn't show hand 
*** SUMMARY ***
Total pot $10 | Rake $0.45 
Board [Ts Kc Qc]
Seat 3: Vikulja1993 (small blind) folded on the Flop
Seat 4: Dachish (big blind) collected ($9.55)
Seat 5: maaaGik88 folded before Flop (didn't bet)
Seat 6: R1aki folded before Flop (didn't bet)
Seat 7: Pacifistas folded before Flop (didn't bet)
Seat 9: matiko09 (button) folded before Flop (didn't bet)





PokerStars Hand #150707990507:  Hold'em No Limit ($0.50/$1.00 USD) - 2016/03/21 17:12:01 CET [2016/03/21 12:12:01 ET]
Table 'Icarion II' 9-max Seat #9 is the button
Seat 1: fanmtZ ($40 in chips) 
Seat 2: ka100pka527 ($100 in chips) 
Seat 3: volwebni4ek ($40.30 in chips) 
Seat 5: SanychStar ($128.88 in chips) 
Seat 7: Pacifistas ($100 in chips) 
Seat 8: matiko09 ($121.61 in chips) 
Seat 9: R1aki ($140.53 in chips) 
fanmtZ: posts small blind $0.50
ka100pka527: posts big blind $1
*** HOLE CARDS ***
Dealt to matiko09 [9h 9s]
volwebni4ek: raises $2 to $3
SanychStar: folds 
Pacifistas: folds 
matiko09: calls $3
R1aki: folds 
fanmtZ: folds 
ka100pka527: folds 
*** FLOP *** [2s Ac 3c]
volwebni4ek: checks 
matiko09: checks 
*** TURN *** [2s Ac 3c] [Qh]
moffo13 joins the table at seat #4 
volwebni4ek: bets $5.55
matiko09: folds 
Uncalled bet ($5.55) returned to volwebni4ek
volwebni4ek collected $7.16 from pot
volwebni4ek: doesn't show hand 
*** SUMMARY ***
Total pot $7.50 | Rake $0.34 
Board [2s Ac 3c Qh]
Seat 1: fanmtZ (small blind) folded before Flop
Seat 2: ka100pka527 (big blind) folded before Flop
Seat 3: volwebni4ek collected ($7.16)
Seat 5: SanychStar folded before Flop (didn't bet)
Seat 7: Pacifistas folded before Flop (didn't bet)
Seat 8: matiko09 folded on the Turn
Seat 9: R1aki (button) folded before Flop (didn't bet)





PokerStars Hand #150707996291:  Hold'em No Limit (€0.25/€0.50 EUR) - 2016/03/21 17:12:08 CET [2016/03/21 12:12:08 ET]
Table 'Auravictrix II' 9-max Seat #1 is the button
Seat 1: Al3xAnd3r22 (€50 in chips) 
Seat 2: ffac (€50 in chips) 
Seat 3: matiko09 (€53.71 in chips) 
Seat 4: i am owsome (€94 in chips) 
Seat 5: nombraalne1 (€69.16 in chips) 
Seat 6: Devsteel (€51.25 in chips) 
Seat 7: vasiy379 (€50 in chips) 
Seat 8: ardo888 (€50 in chips) 
Seat 9: carlouchi (€40.65 in chips) 
ffac: posts small blind €0.25
matiko09: posts big blind €0.50
*** HOLE CARDS ***
Dealt to matiko09 [2d 5h]
i am owsome: folds 
i am owsome leaves the table
nombraalne1: folds 
Devsteel: raises €1 to €1.50
vasiy379: folds 
beluccix joins the table at seat #4 
ardo888: folds 
carlouchi: folds 
Al3xAnd3r22: folds 
ffac: folds 
matiko09: folds 
Uncalled bet (€1) returned to Devsteel
Devsteel collected €1.25 from pot
Devsteel: doesn't show hand 
*** SUMMARY ***
Total pot €1.25 | Rake €0 
Seat 1: Al3xAnd3r22 (button) folded before Flop (didn't bet)
Seat 2: ffac (small blind) folded before Flop
Seat 3: matiko09 (big blind) folded before Flop
Seat 4: i am owsome folded before Flop (didn't bet)
Seat 5: nombraalne1 folded before Flop (didn't bet)
Seat 6: Devsteel collected (€1.25)
Seat 7: vasiy379 folded before Flop (didn't bet)
Seat 8: ardo888 folded before Flop (didn't bet)
Seat 9: carlouchi folded before Flop (didn't bet)





PokerStars Hand #150708001177:  Hold'em No Limit ($0.50/$1.00 USD) - 2016/03/21 17:12:15 CET [2016/03/21 12:12:15 ET]
Table 'Massalia II' 9-max Seat #4 is the button
Seat 2: maxxmeister ($100 in chips) 
Seat 3: 123chambo ($144.36 in chips) 
Seat 4: OriginalTony ($99.46 in chips) 
Seat 5: Vikulja1993 ($100 in chips) 
Seat 6: Pacifistas ($127.31 in chips) 
Seat 7: flk.Dasas ($102.90 in chips) 
Seat 8: matiko09 ($137.88 in chips) 
Seat 9: hammerwife ($116.27 in chips) 
Vikulja1993: posts small blind $0.50
Pacifistas: posts big blind $1
Filojoes: sits out 
maxxmeister: posts the ante $0.20
123chambo: posts the ante $0.20
OriginalTony: posts the ante $0.20
Vikulja1993: posts the ante $0.20
Pacifistas: posts the ante $0.20
flk.Dasas: posts the ante $0.20
matiko09: posts the ante $0.20
hammerwife: posts the ante $0.20
*** HOLE CARDS ***
Dealt to matiko09 [2s 5c]
flk.Dasas: folds 
matiko09: folds 
hammerwife: folds 
maxxmeister: folds 
123chambo: folds 
OriginalTony: raises $2 to $3
Vikulja1993: folds 
Pacifistas: calls $2
*** FLOP *** [9s Qh 8c]
Pacifistas: checks 
OriginalTony: bets $4
Pacifistas: folds 
Uncalled bet ($4) returned to OriginalTony
OriginalTony collected $7.74 from pot
*** SUMMARY ***
Total pot $8.10 | Rake $0.36 
Board [9s Qh 8c]
Seat 2: maxxmeister folded before Flop (didn't bet)
Seat 3: 123chambo folded before Flop (didn't bet)
Seat 4: OriginalTony (button) collected ($7.74)
Seat 5: Vikulja1993 (small blind) folded before Flop
Seat 6: Pacifistas (big blind) folded on the Flop
Seat 7: flk.Dasas folded before Flop (didn't bet)
Seat 8: matiko09 folded before Flop (didn't bet)
Seat 9: hammerwife folded before Flop (didn't bet)





PokerStars Hand #150708020767:  Hold'em No Limit (€0.25/€0.50 EUR) - 2016/03/21 17:12:40 CET [2016/03/21 12:12:40 ET]
Table 'Auravictrix II' 9-max Seat #2 is the button
Seat 1: Al3xAnd3r22 (€50 in chips) 
Seat 2: ffac (€50 in chips) 
Seat 3: matiko09 (€53.21 in chips) 
Seat 4: beluccix (€20 in chips) 
Seat 5: nombraalne1 (€69.16 in chips) 
Seat 6: Devsteel (€52 in chips) 
Seat 7: vasiy379 (€50 in chips) 
Seat 8: ardo888 (€50 in chips) 
Seat 9: carlouchi (€40.65 in chips) 
matiko09: posts small blind €0.25
beluccix: posts big blind €0.50
*** HOLE CARDS ***
Dealt to matiko09 [4s Js]
nombraalne1: folds 
Devsteel: folds 
vasiy379: folds 
ardo888: folds 
carlouchi: calls €0.50
Al3xAnd3r22: folds 
ffac: folds 
matiko09: folds 
beluccix: checks 
*** FLOP *** [7d 2d Qc]
beluccix: checks 
nombraalne1 leaves the table
nubpoker joins the table at seat #5 
carlouchi: checks 
*** TURN *** [7d 2d Qc] [Jh]
nubpoker leaves the table
beluccix: checks 
carlouchi: bets €1.19
beluccix: folds 
Uncalled bet (€1.19) returned to carlouchi
carlouchi collected €1.19 from pot
carlouchi: doesn't show hand 
*** SUMMARY ***
Total pot €1.25 | Rake €0.06 
Board [7d 2d Qc Jh]
Seat 1: Al3xAnd3r22 folded before Flop (didn't bet)
Seat 2: ffac (button) folded before Flop (didn't bet)
Seat 3: matiko09 (small blind) folded before Flop
Seat 4: beluccix (big blind) folded on the Turn
Seat 5: nombraalne1 folded before Flop (didn't bet)
Seat 6: Devsteel folded before Flop (didn't bet)
Seat 7: vasiy379 folded before Flop (didn't bet)
Seat 8: ardo888 folded before Flop (didn't bet)
Seat 9: carlouchi collected (€1.19)





PokerStars Hand #150708040349:  Hold'em No Limit ($0.50/$1.00 USD) - 2016/03/21 17:13:06 CET [2016/03/21 12:13:06 ET]
Table 'Onnie II' 9-max Seat #5 is the button
Seat 2: RICKA16 ($104.50 in chips) 
Seat 3: cn_chayanne ($152.64 in chips) 
Seat 4: Bothfeld11 ($158.56 in chips) 
Seat 5: sanpidk ($102 in chips) 
Seat 6: Pacifistas ($106.43 in chips) 
Seat 7: djammusic ($74.40 in chips) 
Seat 9: matiko09 ($129.19 in chips) 
Pacifistas: posts small blind $0.50
djammusic: posts big blind $1
ka100pka527: sits out 
*** HOLE CARDS ***
Dealt to matiko09 [8s 5s]
matiko09: folds 
RICKA16: folds 
cn_chayanne: folds 
Bothfeld11: folds 
sanpidk: raises $1.24 to $2.24
Pacifistas: folds 
djammusic: folds 
Uncalled bet ($1.24) returned to sanpidk
sanpidk collected $2.50 from pot
sanpidk: doesn't show hand 
*** SUMMARY ***
Total pot $2.50 | Rake $0 
Seat 2: RICKA16 folded before Flop (didn't bet)
Seat 3: cn_chayanne folded before Flop (didn't bet)
Seat 4: Bothfeld11 folded before Flop (didn't bet)
Seat 5: sanpidk (button) collected ($2.50)
Seat 6: Pacifistas (small blind) folded before Flop
Seat 7: djammusic (big blind) folded before Flop
Seat 9: matiko09 folded before Flop (didn't bet)





PokerStars Hand #150708042340:  Hold'em No Limit ($0.50/$1.00 USD) - 2016/03/21 17:13:08 CET [2016/03/21 12:13:08 ET]
Table 'Marmulla II' 9-max Seat #3 is the button
Seat 3: Vikulja1993 ($100 in chips) 
Seat 4: Dachish ($82.23 in chips) 
Seat 5: maaaGik88 ($83.47 in chips) 
Seat 6: R1aki ($102.50 in chips) 
Seat 7: Pacifistas ($114.10 in chips) 
Seat 9: matiko09 ($100 in chips) 
Dachish: posts small blind $0.50
maaaGik88: posts big blind $1
sanpidk: sits out 
*** HOLE CARDS ***
Dealt to matiko09 [5d 6s]
R1aki: folds 
Pacifistas: folds 
matiko09: folds 
Vikulja1993: raises $1 to $2
Dachish: folds 
maaaGik88: calls $1
*** FLOP *** [4s 2c Ks]
maaaGik88: checks 
Vikulja1993: checks 
*** TURN *** [4s 2c Ks] [8s]
maaaGik88: checks 
Vikulja1993: checks 
*** RIVER *** [4s 2c Ks 8s] [Kc]
maaaGik88: checks 
Vikulja1993: checks 
*** SHOW DOWN ***
maaaGik88: shows [7h 6d] (a pair of Kings)
Vikulja1993: shows [Qh Ah] (a pair of Kings - Ace kicker)
Vikulja1993 collected $4.30 from pot
*** SUMMARY ***
Total pot $4.50 | Rake $0.20 
Board [4s 2c Ks 8s Kc]
Seat 3: Vikulja1993 (button) showed [Qh Ah] and won ($4.30) with a pair of Kings
Seat 4: Dachish (small blind) folded before Flop
Seat 5: maaaGik88 (big blind) showed [7h 6d] and lost with a pair of Kings
Seat 6: R1aki folded before Flop (didn't bet)
Seat 7: Pacifistas folded before Flop (didn't bet)
Seat 9: matiko09 folded before Flop (didn't bet)





PokerStars Hand #150708044651:  Hold'em No Limit ($0.50/$1.00 USD) - 2016/03/21 17:13:11 CET [2016/03/21 12:13:11 ET]
Table 'Icarion II' 9-max Seat #1 is the button
Seat 1: fanmtZ ($40 in chips) 
Seat 2: ka100pka527 ($99 in chips) 
Seat 4: moffo13 ($40.88 in chips) 
Seat 5: SanychStar ($128.88 in chips) 
Seat 7: Pacifistas ($100 in chips) 
Seat 8: matiko09 ($118.61 in chips) 
Seat 9: R1aki ($140.53 in chips) 
ka100pka527: posts small blind $0.50
volwebni4ek: is sitting out 
moffo13: posts big blind $1
*** HOLE CARDS ***
Dealt to matiko09 [6s 2s]
SanychStar: folds 
volwebni4ek leaves the table
el_pato_cosc joins the table at seat #3 
Pacifistas: raises $2 to $3
SanychStar leaves the table
matiko09: folds 
R1aki: folds 
fanmtZ: folds 
ka100pka527: folds 
moffo13: folds 
Uncalled bet ($2) returned to Pacifistas
Pacifistas collected $2.50 from pot
Pacifistas: doesn't show hand 
*** SUMMARY ***
Total pot $2.50 | Rake $0 
Seat 1: fanmtZ (button) folded before Flop (didn't bet)
Seat 2: ka100pka527 (small blind) folded before Flop
Seat 4: moffo13 (big blind) folded before Flop
Seat 5: SanychStar folded before Flop (didn't bet)
Seat 7: Pacifistas collected ($2.50)
Seat 8: matiko09 folded before Flop (didn't bet)
Seat 9: R1aki folded before Flop (didn't bet)





PokerStars Hand #150708046682:  Hold'em No Limit ($0.50/$1.00 USD) - 2016/03/21 17:13:14 CET [2016/03/21 12:13:14 ET]
Table 'Massalia II' 9-max Seat #5 is the button
Seat 2: maxxmeister ($100 in chips) 
Seat 3: 123chambo ($144.16 in chips) 
Seat 4: OriginalTony ($104 in chips) 
Seat 5: Vikulja1993 ($100 in chips) 
Seat 6: Pacifistas ($124.11 in chips) 
Seat 7: flk.Dasas ($102.70 in chips) 
Seat 8: matiko09 ($137.68 in chips) 
Seat 9: hammerwife ($116.07 in chips) 
Pacifistas: posts small blind $0.50
flk.Dasas: posts big blind $1
Filojoes: sits out 
maxxmeister: posts the ante $0.20
123chambo: posts the ante $0.20
OriginalTony: posts the ante $0.20
Vikulja1993: posts the ante $0.20
Pacifistas: posts the ante $0.20
flk.Dasas: posts the ante $0.20
matiko09: posts the ante $0.20
hammerwife: posts the ante $0.20
*** HOLE CARDS ***
Dealt to matiko09 [2h Kh]
matiko09: folds 
hammerwife: folds 
maxxmeister: folds 
123chambo: raises $3 to $4
OriginalTony: calls $4
Vikulja1993: calls $4
Pacifistas: calls $3.50
flk.Dasas: folds 
*** FLOP *** [9h Ad 3h]
Pacifistas: checks 
123chambo: bets $11
OriginalTony: folds 
Vikulja1993: folds 
Pacifistas: calls $11
*** TURN *** [9h Ad 3h] [4c]
Pacifistas: checks 
123chambo: bets $20
Pacifistas: folds 
Uncalled bet ($20) returned to 123chambo
123chambo collected $38.77 from pot
123chambo: doesn't show hand 
*** SUMMARY ***
Total pot $40.60 | Rake $1.83 
Board [9h Ad 3h 4c]
Seat 2: maxxmeister folded before Flop (didn't bet)
Seat 3: 123chambo collected ($38.77)
Seat 4: OriginalTony folded on the Flop
Seat 5: Vikulja1993 (button) folded on the Flop
Seat 6: Pacifistas (small blind) folded on the Turn
Seat 7: flk.Dasas (big blind) folded before Flop
Seat 8: matiko09 folded before Flop (didn't bet)
Seat 9: hammerwife folded before Flop (didn't bet)





PokerStars Hand #150708062669:  Hold'em No Limit ($0.50/$1.00 USD) - 2016/03/21 17:13:35 CET [2016/03/21 12:13:35 ET]
Table 'Onnie II' 9-max Seat #6 is the button
Seat 2: RICKA16 ($104.50 in chips) 
Seat 3: cn_chayanne ($152.64 in chips) 
Seat 4: Bothfeld11 ($158.56 in chips) 
Seat 5: sanpidk ($103.50 in chips) 
Seat 6: Pacifistas ($105.93 in chips) 
Seat 7: djammusic ($73.40 in chips) 
Seat 9: matiko09 ($129.19 in chips) 
djammusic: posts small blind $0.50
matiko09: posts big blind $1
ka100pka527: sits out 
*** HOLE CARDS ***
Dealt to matiko09 [9d 2s]
RICKA16: raises $2 to $3
cn_chayanne: folds 
Bothfeld11: folds 
sanpidk: folds 
Pacifistas: folds 
djammusic: folds 
matiko09: folds 
Uncalled bet ($2) returned to RICKA16
RICKA16 collected $2.50 from pot
RICKA16: doesn't show hand 
*** SUMMARY ***
Total pot $2.50 | Rake $0 
Seat 2: RICKA16 collected ($2.50)
Seat 3: cn_chayanne folded before Flop (didn't bet)
Seat 4: Bothfeld11 folded before Flop (didn't bet)
Seat 5: sanpidk folded before Flop (didn't bet)
Seat 6: Pacifistas (button) folded before Flop (didn't bet)
Seat 7: djammusic (small blind) folded before Flop
Seat 9: matiko09 (big blind) folded before Flop





PokerStars Hand #150708073476:  Hold'em No Limit ($0.50/$1.00 USD) - 2016/03/21 17:13:49 CET [2016/03/21 12:13:49 ET]
Table 'Hilda' 9-max Seat #7 is the button
Seat 1: djammusic ($51.93 in chips) 
Seat 2: blackmont111 ($107.32 in chips) 
Seat 3: Rikti ($44.36 in chips) 
Seat 4: Pacifistas ($104.50 in chips) 
Seat 6: hemetcano ($226.58 in chips) 
Seat 7: R1aki ($114.88 in chips) 
Seat 8: sanpidk ($100 in chips) 
Seat 9: matiko09 ($100 in chips) 
sanpidk: posts small blind $0.50
matiko09: posts big blind $1
*** HOLE CARDS ***
Dealt to matiko09 [4h 3h]
djammusic: folds 
blackmont111: folds 
Rikti: folds 
Pacifistas: folds 
hemetcano: calls $1
R1aki: folds 
sanpidk: calls $0.50
matiko09: checks 
*** FLOP *** [5s 6h 2h]
sanpidk: checks 
matiko09: bets $2.31
hemetcano: calls $2.31
sanpidk: folds 
*** TURN *** [5s 6h 2h] [3s]
matiko09: bets $5
hemetcano: raises $5 to $10
matiko09: calls $5
*** RIVER *** [5s 6h 2h 3s] [Td]
matiko09: checks 
hemetcano: bets $26.38
matiko09: calls $26.38
*** SHOW DOWN ***
hemetcano: shows [Kc 4c] (a straight, Deuce to Six)
matiko09: shows [4h 3h] (a straight, Deuce to Six)
matiko09 collected $38.79 from pot
hemetcano collected $38.79 from pot
*** SUMMARY ***
Total pot $80.38 | Rake $2.80 
Board [5s 6h 2h 3s Td]
Seat 1: djammusic folded before Flop (didn't bet)
Seat 2: blackmont111 folded before Flop (didn't bet)
Seat 3: Rikti folded before Flop (didn't bet)
Seat 4: Pacifistas folded before Flop (didn't bet)
Seat 6: hemetcano showed [Kc 4c] and won ($38.79) with a straight, Deuce to Six
Seat 7: R1aki (button) folded before Flop (didn't bet)
Seat 8: sanpidk (small blind) folded on the Flop
Seat 9: matiko09 (big blind) showed [4h 3h] and won ($38.79) with a straight, Deuce to Six





PokerStars Hand #150708074423:  Hold'em No Limit (€0.25/€0.50 EUR) - 2016/03/21 17:13:50 CET [2016/03/21 12:13:50 ET]
Table 'Auravictrix II' 9-max Seat #3 is the button
Seat 1: Al3xAnd3r22 (€50 in chips) 
Seat 2: ffac (€50 in chips) 
Seat 3: matiko09 (€52.96 in chips) 
Seat 4: beluccix (€20 in chips) 
Seat 7: vasiy379 (€50 in chips) 
Seat 8: ardo888 (€50 in chips) 
Seat 9: carlouchi (€41.34 in chips) 
beluccix: posts small blind €0.25
Devsteel: is sitting out 
vasiy379: posts big blind €0.50
*** HOLE CARDS ***
Dealt to matiko09 [2c Th]
Devsteel leaves the table
ardo888: folds 
ardo888 leaves the table
carlouchi: calls €0.50
Al3xAnd3r22: folds 
ffac: folds 
matiko09: folds 
beluccix: folds 
vasiy379: checks 
*** FLOP *** [9s 7s 9d]
vasiy379: checks 
carlouchi: checks 
*** TURN *** [9s 7s 9d] [Kh]
vasiy379: checks 
carlouchi: bets €0.50
vasiy379: folds 
Uncalled bet (€0.50) returned to carlouchi
carlouchi collected €1.19 from pot
*** SUMMARY ***
Total pot €1.25 | Rake €0.06 
Board [9s 7s 9d Kh]
Seat 1: Al3xAnd3r22 folded before Flop (didn't bet)
Seat 2: ffac folded before Flop (didn't bet)
Seat 3: matiko09 (button) folded before Flop (didn't bet)
Seat 4: beluccix (small blind) folded before Flop
Seat 7: vasiy379 (big blind) folded on the Turn
Seat 8: ardo888 folded before Flop (didn't bet)
Seat 9: carlouchi collected (€1.19)





PokerStars Hand #150708083262:  Hold'em No Limit ($0.50/$1.00 USD) - 2016/03/21 17:14:02 CET [2016/03/21 12:14:02 ET]
Table 'Onnie II' 9-max Seat #7 is the button
Seat 1: ka100pka527 ($67.37 in chips) 
Seat 2: RICKA16 ($106 in chips) 
Seat 3: cn_chayanne ($152.64 in chips) 
Seat 4: Bothfeld11 ($158.56 in chips) 
Seat 5: sanpidk ($103.50 in chips) 
Seat 6: Pacifistas ($105.93 in chips) 
Seat 7: djammusic ($72.90 in chips) 
Seat 9: matiko09 ($128.19 in chips) 
matiko09: posts small blind $0.50
ka100pka527: posts big blind $1
*** HOLE CARDS ***
Dealt to matiko09 [Ts 4s]
RICKA16: folds 
cn_chayanne: folds 
Bothfeld11: folds 
sanpidk: folds 
Pacifistas: folds 
djammusic: folds 
matiko09: folds 
Uncalled bet ($0.50) returned to ka100pka527
ka100pka527 collected $1 from pot
ka100pka527: doesn't show hand 
*** SUMMARY ***
Total pot $1 | Rake $0 
Seat 1: ka100pka527 (big blind) collected ($1)
Seat 2: RICKA16 folded before Flop (didn't bet)
Seat 3: cn_chayanne folded before Flop (didn't bet)
Seat 4: Bothfeld11 folded before Flop (didn't bet)
Seat 5: sanpidk folded before Flop (didn't bet)
Seat 6: Pacifistas folded before Flop (didn't bet)
Seat 7: djammusic (button) folded before Flop (didn't bet)
Seat 9: matiko09 (small blind) folded before Flop





PokerStars Hand #150708091029:  Hold'em No Limit ($0.50/$1.00 USD) - 2016/03/21 17:14:12 CET [2016/03/21 12:14:12 ET]
Table 'Marmulla II' 9-max Seat #4 is the button
Seat 3: Vikulja1993 ($102.30 in chips) 
Seat 4: Dachish ($81.73 in chips) 
Seat 5: maaaGik88 ($81.47 in chips) 
Seat 6: R1aki ($102.50 in chips) 
Seat 7: Pacifistas ($114.10 in chips) 
Seat 9: matiko09 ($100 in chips) 
maaaGik88: posts small blind $0.50
R1aki: posts big blind $1
sanpidk: sits out 
*** HOLE CARDS ***
Dealt to matiko09 [Ts Js]
Pacifistas: folds 
matiko09: raises $2 to $3
Vikulja1993: folds 
Dachish: folds 
maaaGik88: folds 
R1aki: folds 
Uncalled bet ($2) returned to matiko09
matiko09 collected $2.50 from pot
matiko09: doesn't show hand 
*** SUMMARY ***
Total pot $2.50 | Rake $0 
Seat 3: Vikulja1993 folded before Flop (didn't bet)
Seat 4: Dachish (button) folded before Flop (didn't bet)
Seat 5: maaaGik88 (small blind) folded before Flop
Seat 6: R1aki (big blind) folded before Flop
Seat 7: Pacifistas folded before Flop (didn't bet)
Seat 9: matiko09 collected ($2.50)





PokerStars Hand #150708109301:  Hold'em No Limit ($0.50/$1.00 USD) - 2016/03/21 17:14:36 CET [2016/03/21 12:14:36 ET]
Table 'Marmulla II' 9-max Seat #5 is the button
Seat 3: Vikulja1993 ($102.30 in chips) 
Seat 4: Dachish ($81.73 in chips) 
Seat 5: maaaGik88 ($80.97 in chips) 
Seat 6: R1aki ($101.50 in chips) 
Seat 7: Pacifistas ($114.10 in chips) 
Seat 9: matiko09 ($101.50 in chips) 
R1aki: posts small blind $0.50
Pacifistas: posts big blind $1
sanpidk: sits out 
*** HOLE CARDS ***
Dealt to matiko09 [2h Ah]
matiko09: folds 
Vikulja1993: folds 
Dachish: folds 
maaaGik88: folds 
R1aki: folds 
Uncalled bet ($0.50) returned to Pacifistas
Pacifistas collected $1 from pot
Pacifistas: doesn't show hand 
*** SUMMARY ***
Total pot $1 | Rake $0 
Seat 3: Vikulja1993 folded before Flop (didn't bet)
Seat 4: Dachish folded before Flop (didn't bet)
Seat 5: maaaGik88 (button) folded before Flop (didn't bet)
Seat 6: R1aki (small blind) folded before Flop
Seat 7: Pacifistas (big blind) collected ($1)
Seat 9: matiko09 folded before Flop (didn't bet)





PokerStars Hand #150708110387:  Hold'em No Limit (€0.25/€0.50 EUR) - 2016/03/21 17:14:38 CET [2016/03/21 12:14:38 ET]
Table 'Auravictrix II' 9-max Seat #4 is the button
Seat 1: Al3xAnd3r22 (€50 in chips) 
Seat 2: ffac (€50 in chips) 
Seat 3: matiko09 (€52.96 in chips) 
Seat 4: beluccix (€20 in chips) 
Seat 7: vasiy379 (€50 in chips) 
Seat 9: carlouchi (€42.03 in chips) 
vasiy379: posts small blind €0.25
carlouchi: posts big blind €0.50
*** HOLE CARDS ***
Dealt to matiko09 [5d Jh]
Al3xAnd3r22: folds 
ffac: folds 
matiko09: folds 
beluccix: folds 
vasiy379: folds 
Uncalled bet (€0.25) returned to carlouchi
carlouchi collected €0.50 from pot
carlouchi: doesn't show hand 
*** SUMMARY ***
Total pot €0.50 | Rake €0 
Seat 1: Al3xAnd3r22 folded before Flop (didn't bet)
Seat 2: ffac folded before Flop (didn't bet)
Seat 3: matiko09 folded before Flop (didn't bet)
Seat 4: beluccix (button) folded before Flop (didn't bet)
Seat 7: vasiy379 (small blind) folded before Flop
Seat 9: carlouchi (big blind) collected (€0.50)





PokerStars Hand #150708113472:  Hold'em No Limit ($0.50/$1.00 USD) - 2016/03/21 17:14:42 CET [2016/03/21 12:14:42 ET]
Table 'Onnie II' 9-max Seat #9 is the button
Seat 1: ka100pka527 ($67.87 in chips) 
Seat 2: RICKA16 ($106 in chips) 
Seat 3: cn_chayanne ($152.64 in chips) 
Seat 4: Bothfeld11 ($158.56 in chips) 
Seat 5: sanpidk ($103.50 in chips) 
Seat 6: Pacifistas ($105.93 in chips) 
Seat 7: djammusic ($72.90 in chips) 
Seat 9: matiko09 ($127.69 in chips) 
ka100pka527: posts small blind $0.50
RICKA16: posts big blind $1
*** HOLE CARDS ***
Dealt to matiko09 [Jd 6c]
cn_chayanne: folds 
Bothfeld11: folds 
sanpidk: folds 
Pacifistas: folds 
djammusic: raises $1.50 to $2.50
matiko09: folds 
ka100pka527: folds 
RICKA16: folds 
Uncalled bet ($1.50) returned to djammusic
djammusic collected $2.50 from pot
djammusic: doesn't show hand 
*** SUMMARY ***
Total pot $2.50 | Rake $0 
Seat 1: ka100pka527 (small blind) folded before Flop
Seat 2: RICKA16 (big blind) folded before Flop
Seat 3: cn_chayanne folded before Flop (didn't bet)
Seat 4: Bothfeld11 folded before Flop (didn't bet)
Seat 5: sanpidk folded before Flop (didn't bet)
Seat 6: Pacifistas folded before Flop (didn't bet)
Seat 7: djammusic collected ($2.50)
Seat 9: matiko09 (button) folded before Flop (didn't bet)





PokerStars Hand #150708123750:  Hold'em No Limit ($0.50/$1.00 USD) - 2016/03/21 17:14:55 CET [2016/03/21 12:14:55 ET]
Table 'Marmulla II' 9-max Seat #6 is the button
Seat 3: Vikulja1993 ($102.30 in chips) 
Seat 4: Dachish ($81.73 in chips) 
Seat 5: maaaGik88 ($80.97 in chips) 
Seat 6: R1aki ($101 in chips) 
Seat 7: Pacifistas ($114.60 in chips) 
Seat 8: sanpidk ($101.50 in chips) 
Seat 9: matiko09 ($101.50 in chips) 
Pacifistas: posts small blind $0.50
sanpidk: posts big blind $1
*** HOLE CARDS ***
Dealt to matiko09 [Qd Kc]
matiko09: raises $2 to $3
Vikulja1993: folds 
Dachish: folds 
maaaGik88: calls $3
R1aki: calls $3
Pacifistas: folds 
sanpidk: folds 
*** FLOP *** [4c 3s 3h]
matiko09: bets $6
maaaGik88: calls $6
R1aki: calls $6
*** TURN *** [4c 3s 3h] [8s]
matiko09: checks 
maaaGik88: checks 
R1aki: checks 
*** RIVER *** [4c 3s 3h 8s] [Kh]
matiko09: bets $12
maaaGik88: folds 
R1aki: calls $12
*** SHOW DOWN ***
matiko09: shows [Qd Kc] (two pair, Kings and Threes)
R1aki: shows [4h 4d] (a full house, Fours full of Threes)
R1aki collected $50.14 from pot
*** SUMMARY ***
Total pot $52.50 | Rake $2.36 
Board [4c 3s 3h 8s Kh]
Seat 3: Vikulja1993 folded before Flop (didn't bet)
Seat 4: Dachish folded before Flop (didn't bet)
Seat 5: maaaGik88 folded on the River
Seat 6: R1aki (button) showed [4h 4d] and won ($50.14) with a full house, Fours full of Threes
Seat 7: Pacifistas (small blind) folded before Flop
Seat 8: sanpidk (big blind) folded before Flop
Seat 9: matiko09 showed [Qd Kc] and lost with two pair, Kings and Threes





PokerStars Hand #150708136229:  Hold'em No Limit ($0.50/$1.00 USD) - 2016/03/21 17:15:11 CET [2016/03/21 12:15:11 ET]
Table 'Onnie II' 9-max Seat #1 is the button
Seat 1: ka100pka527 ($67.37 in chips) 
Seat 2: RICKA16 ($105 in chips) 
Seat 3: cn_chayanne ($152.64 in chips) 
Seat 4: Bothfeld11 ($158.56 in chips) 
Seat 5: sanpidk ($103.50 in chips) 
Seat 6: Pacifistas ($105.93 in chips) 
Seat 7: djammusic ($74.40 in chips) 
Seat 9: matiko09 ($127.69 in chips) 
RICKA16: posts small blind $0.50
cn_chayanne: posts big blind $1
*** HOLE CARDS ***
Dealt to matiko09 [8s Ah]
Bothfeld11: folds 
sanpidk: folds 
Pacifistas: folds 
djammusic: folds 
matiko09: folds 
ka100pka527: raises $2 to $3
RICKA16: calls $2.50
cn_chayanne: calls $2
*** FLOP *** [9d 8d 7d]
RICKA16: bets $5
cn_chayanne: calls $5
ka100pka527: calls $5
*** TURN *** [9d 8d 7d] [3c]
RICKA16: bets $10
cn_chayanne: calls $10
ka100pka527: calls $10
*** RIVER *** [9d 8d 7d 3c] [5s]
RICKA16: bets $10
cn_chayanne: calls $10
ka100pka527: raises $39.37 to $49.37 and is all-in
RICKA16: folds 
cn_chayanne: folds 
Uncalled bet ($39.37) returned to ka100pka527
ka100pka527 collected $81.20 from pot
ka100pka527: doesn't show hand 
*** SUMMARY ***
Total pot $84 | Rake $2.80 
Board [9d 8d 7d 3c 5s]
Seat 1: ka100pka527 (button) collected ($81.20)
Seat 2: RICKA16 (small blind) folded on the River
Seat 3: cn_chayanne (big blind) folded on the River
Seat 4: Bothfeld11 folded before Flop (didn't bet)
Seat 5: sanpidk folded before Flop (didn't bet)
Seat 6: Pacifistas folded before Flop (didn't bet)
Seat 7: djammusic folded before Flop (didn't bet)
Seat 9: matiko09 folded before Flop (didn't bet)





PokerStars Hand #150708136473:  Hold'em No Limit ($0.50/$1.00 USD) - 2016/03/21 17:15:11 CET [2016/03/21 12:15:11 ET]
Table 'Massalia II' 9-max Seat #6 is the button
Seat 2: maxxmeister ($100 in chips) 
Seat 3: 123chambo ($167.73 in chips) 
Seat 4: OriginalTony ($99.80 in chips) 
Seat 5: Vikulja1993 ($100 in chips) 
Seat 6: Pacifistas ($108.91 in chips) 
Seat 7: flk.Dasas ($101.50 in chips) 
Seat 8: matiko09 ($137.48 in chips) 
Seat 9: hammerwife ($115.87 in chips) 
flk.Dasas: posts small blind $0.50
matiko09: posts big blind $1
Filojoes: sits out 
maxxmeister: posts the ante $0.20
123chambo: posts the ante $0.20
OriginalTony: posts the ante $0.20
Vikulja1993: posts the ante $0.20
Pacifistas: posts the ante $0.20
flk.Dasas: posts the ante $0.20
matiko09: posts the ante $0.20
hammerwife: posts the ante $0.20
*** HOLE CARDS ***
Dealt to matiko09 [4c Ad]
hammerwife: folds 
maxxmeister: folds 
123chambo: folds 
hammerwife leaves the table
OriginalTony: folds 
Vikulja1993: folds 
DanishWiking joins the table at seat #9 
Pacifistas: folds 
flk.Dasas: raises $3 to $4
matiko09: raises $7 to $11
flk.Dasas: folds 
Uncalled bet ($7) returned to matiko09
matiko09 collected $9.60 from pot
matiko09: doesn't show hand 
*** SUMMARY ***
Total pot $9.60 | Rake $0 
Seat 2: maxxmeister folded before Flop (didn't bet)
Seat 3: 123chambo folded before Flop (didn't bet)
Seat 4: OriginalTony folded before Flop (didn't bet)
Seat 5: Vikulja1993 folded before Flop (didn't bet)
Seat 6: Pacifistas (button) folded before Flop (didn't bet)
Seat 7: flk.Dasas (small blind) folded before Flop
Seat 8: matiko09 (big blind) collected ($9.60)
Seat 9: hammerwife folded before Flop (didn't bet)





PokerStars Hand #150708138048:  Hold'em No Limit (€0.25/€0.50 EUR) - 2016/03/21 17:15:13 CET [2016/03/21 12:15:13 ET]
Table 'Auravictrix II' 9-max Seat #7 is the button
Seat 3: matiko09 (€52.96 in chips) 
Seat 4: beluccix (€20 in chips) 
Seat 7: vasiy379 (€50 in chips) 
Seat 9: carlouchi (€42.28 in chips) 
carlouchi: posts small blind €0.25
Al3xAnd3r22: is sitting out 
ffac: is sitting out 
Al3xAnd3r22 leaves the table
matiko09: posts big blind €0.50
*** HOLE CARDS ***
Dealt to matiko09 [Jd 8d]
ffac leaves the table
beluccix: folds 
vasiy379: folds 
carlouchi: calls €0.25
Al3xAnd3r22 joins the table at seat #1 
matiko09: raises €1.50 to €2
carlouchi: calls €1.50
*** FLOP *** [3h 3s 2c]
carlouchi: checks 
matiko09: checks 
*** TURN *** [3h 3s 2c] [Ad]
carlouchi: checks 
matiko09: checks 
*** RIVER *** [3h 3s 2c Ad] [8c]
pocketpaira2 joins the table at seat #5 
carlouchi: checks 
lysandrafly joins the table at seat #6 
nombraalne1 joins the table at seat #8 
matiko09: checks 
*** SHOW DOWN ***
carlouchi: shows [Tc Qh] (a pair of Threes)
matiko09: shows [Jd 8d] (two pair, Eights and Threes)
matiko09 collected €3.82 from pot
HeroWok joins the table at seat #2 
*** SUMMARY ***
Total pot €4 | Rake €0.18 
Board [3h 3s 2c Ad 8c]
Seat 3: matiko09 (big blind) showed [Jd 8d] and won (€3.82) with two pair, Eights and Threes
Seat 4: beluccix folded before Flop (didn't bet)
Seat 7: vasiy379 (button) folded before Flop (didn't bet)
Seat 9: carlouchi (small blind) showed [Tc Qh] and lost with a pair of Threes





PokerStars Hand #150708144350:  Hold'em No Limit ($0.50/$1.00 USD) - 2016/03/21 17:15:22 CET [2016/03/21 12:15:22 ET]
Table 'Hilda' 9-max Seat #8 is the button
Seat 1: djammusic ($51.93 in chips) 
Seat 2: blackmont111 ($107.32 in chips) 
Seat 3: Rikti ($44.36 in chips) 
Seat 4: Pacifistas ($104.50 in chips) 
Seat 6: hemetcano ($225.68 in chips) 
Seat 7: R1aki ($114.88 in chips) 
Seat 8: sanpidk ($100 in chips) 
Seat 9: matiko09 ($100 in chips) 
matiko09: posts small blind $0.50
djammusic: posts big blind $1
*** HOLE CARDS ***
Dealt to matiko09 [Ah 5h]
blackmont111: folds 
Rikti: folds 
Pacifistas: folds 
hemetcano: calls $1
R1aki: folds 
sanpidk: raises $3.50 to $4.50
matiko09: folds 
djammusic: folds 
hemetcano: calls $3.50
*** FLOP *** [Th 7d Ts]
hemetcano: checks 
sanpidk: checks 
*** TURN *** [Th 7d Ts] [3h]
hemetcano: bets $1
sanpidk: calls $1
*** RIVER *** [Th 7d Ts 3h] [Kc]
hemetcano: checks 
sanpidk: checks 
*** SHOW DOWN ***
hemetcano: shows [Jd 2s] (a pair of Tens)
sanpidk: shows [Ac Jc] (a pair of Tens - Ace kicker)
sanpidk collected $11.94 from pot
*** SUMMARY ***
Total pot $12.50 | Rake $0.56 
Board [Th 7d Ts 3h Kc]
Seat 1: djammusic (big blind) folded before Flop
Seat 2: blackmont111 folded before Flop (didn't bet)
Seat 3: Rikti folded before Flop (didn't bet)
Seat 4: Pacifistas folded before Flop (didn't bet)
Seat 6: hemetcano showed [Jd 2s] and lost with a pair of Tens
Seat 7: R1aki folded before Flop (didn't bet)
Seat 8: sanpidk (button) showed [Ac Jc] and won ($11.94) with a pair of Tens
Seat 9: matiko09 (small blind) folded before Flop





PokerStars Hand #150708145830:  Hold'em No Limit (€0.50/€1.00 EUR) - 2016/03/21 17:15:24 CET [2016/03/21 12:15:24 ET]
Table 'Anhui' 9-max Seat #2 is the button
Seat 1: ardo888 (€100 in chips) 
Seat 2: Dachish (€67 in chips) 
Seat 5: aponinho82 (€35.73 in chips) 
Seat 6: matiko09 (€100 in chips) 
Seat 7: R1aki (€100 in chips) 
Seat 8: lysandrafly (€101.50 in chips) 
Seat 9: ffac (€112.33 in chips) 
aponinho82: posts small blind €0.50
matiko09: posts big blind €1
*** HOLE CARDS ***
Dealt to matiko09 [2c Kh]
R1aki: folds 
lysandrafly: raises €1.50 to €2.50
ffac: folds 
ardo888: calls €2.50
Dachish: calls €2.50
aponinho82: raises €9.50 to €12
matiko09: folds 
lysandrafly: folds 
ardo888: folds 
Dachish: folds 
Uncalled bet (€9.50) returned to aponinho82
aponinho82 collected €11 from pot
aponinho82: doesn't show hand 
*** SUMMARY ***
Total pot €11 | Rake €0 
Seat 1: ardo888 folded before Flop
Seat 2: Dachish (button) folded before Flop
Seat 5: aponinho82 (small blind) collected (€11)
Seat 6: matiko09 (big blind) folded before Flop
Seat 7: R1aki folded before Flop (didn't bet)
Seat 8: lysandrafly folded before Flop
Seat 9: ffac folded before Flop (didn't bet)





PokerStars Hand #150708169176:  Hold'em No Limit (€0.25/€0.50 EUR) - 2016/03/21 17:15:54 CET [2016/03/21 12:15:54 ET]
Table 'Auravictrix II' 9-max Seat #9 is the button
Seat 3: matiko09 (€54.78 in chips) 
Seat 4: beluccix (€20 in chips) 
Seat 7: vasiy379 (€50 in chips) 
Seat 9: carlouchi (€40.28 in chips) 
Al3xAnd3r22 will be allowed to play after the button
HeroWok will be allowed to play after the button
matiko09: posts small blind €0.25
beluccix: posts big blind €0.50
pocketpaira2: sits out 
nombraalne1: sits out 
*** HOLE CARDS ***
Dealt to matiko09 [Qd 5c]
vasiy379: folds 
carlouchi: raises €1.25 to €1.75
matiko09: folds 
beluccix: folds 
Uncalled bet (€1.25) returned to carlouchi
carlouchi collected €1.25 from pot
carlouchi: doesn't show hand 
*** SUMMARY ***
Total pot €1.25 | Rake €0 
Seat 3: matiko09 (small blind) folded before Flop
Seat 4: beluccix (big blind) folded before Flop
Seat 7: vasiy379 folded before Flop (didn't bet)
Seat 9: carlouchi (button) collected (€1.25)





PokerStars Hand #150708174353:  Hold'em No Limit (€0.50/€1.00 EUR) - 2016/03/21 17:16:01 CET [2016/03/21 12:16:01 ET]
Table 'Anhui' 9-max Seat #5 is the button
Seat 1: ardo888 (€100 in chips) 
Seat 2: Dachish (€64.50 in chips) 
Seat 5: aponinho82 (€44.23 in chips) 
Seat 6: matiko09 (€100 in chips) 
Seat 7: R1aki (€100 in chips) 
Seat 8: lysandrafly (€100 in chips) 
Seat 9: ffac (€112.33 in chips) 
matiko09: posts small blind €0.50
R1aki: posts big blind €1
*** HOLE CARDS ***
Dealt to matiko09 [3s Jd]
lysandrafly: folds 
ffac: folds 
ardo888: folds 
Dachish: folds 
aponinho82: calls €1
matiko09: folds 
R1aki: checks 
*** FLOP *** [2c Ah Qs]
R1aki: checks 
aponinho82: bets €1
cobrik23 joins the table at seat #4 
R1aki: folds 
Uncalled bet (€1) returned to aponinho82
aponinho82 collected €2.39 from pot
aponinho82: doesn't show hand 
*** SUMMARY ***
Total pot €2.50 | Rake €0.11 
Board [2c Ah Qs]
Seat 1: ardo888 folded before Flop (didn't bet)
Seat 2: Dachish folded before Flop (didn't bet)
Seat 5: aponinho82 (button) collected (€2.39)
Seat 6: matiko09 (small blind) folded before Flop
Seat 7: R1aki (big blind) folded on the Flop
Seat 8: lysandrafly folded before Flop (didn't bet)
Seat 9: ffac folded before Flop (didn't bet)





PokerStars Hand #150708180400:  Hold'em No Limit ($0.50/$1.00 USD) - 2016/03/21 17:16:09 CET [2016/03/21 12:16:09 ET]
Table 'Massalia II' 9-max Seat #7 is the button
Seat 2: maxxmeister ($100 in chips) 
Seat 3: 123chambo ($167.53 in chips) 
Seat 4: OriginalTony ($99.60 in chips) 
Seat 5: Vikulja1993 ($100 in chips) 
Seat 6: Pacifistas ($108.71 in chips) 
Seat 7: flk.Dasas ($100 in chips) 
Seat 8: matiko09 ($142.88 in chips) 
Seat 9: DanishWiking ($100 in chips) 
matiko09: posts small blind $0.50
DanishWiking: posts big blind $1
Filojoes: sits out 
maxxmeister: posts the ante $0.20
123chambo: posts the ante $0.20
OriginalTony: posts the ante $0.20
Vikulja1993: posts the ante $0.20
Pacifistas: posts the ante $0.20
flk.Dasas: posts the ante $0.20
matiko09: posts the ante $0.20
DanishWiking: posts the ante $0.20
*** HOLE CARDS ***
Dealt to matiko09 [8c Qh]
maxxmeister: raises $2.50 to $3.50
123chambo: folds 
OriginalTony: folds 
Vikulja1993: folds 
Pacifistas: folds 
flk.Dasas: folds 
matiko09: folds 
DanishWiking: calls $2.50
*** FLOP *** [3s Kc Qs]
DanishWiking: checks 
maxxmeister: bets $4.47
DanishWiking: raises $12.34 to $16.81
maxxmeister: folds 
Uncalled bet ($12.34) returned to DanishWiking
DanishWiking collected $17.23 from pot
DanishWiking: doesn't show hand 
*** SUMMARY ***
Total pot $18.04 | Rake $0.81 
Board [3s Kc Qs]
Seat 2: maxxmeister folded on the Flop
Seat 3: 123chambo folded before Flop (didn't bet)
Seat 4: OriginalTony folded before Flop (didn't bet)
Seat 5: Vikulja1993 folded before Flop (didn't bet)
Seat 6: Pacifistas folded before Flop (didn't bet)
Seat 7: flk.Dasas (button) folded before Flop (didn't bet)
Seat 8: matiko09 (small blind) folded before Flop
Seat 9: DanishWiking (big blind) collected ($17.23)





PokerStars Hand #150708186668:  Hold'em No Limit (€0.25/€0.50 EUR) - 2016/03/21 17:16:17 CET [2016/03/21 12:16:17 ET]
Table 'Auravictrix II' 9-max Seat #3 is the button
Seat 2: HeroWok (€40 in chips) 
Seat 3: matiko09 (€54.53 in chips) 
Seat 4: beluccix (€20 in chips) 
Seat 5: pocketpaira2 (€22.40 in chips) 
Seat 7: vasiy379 (€50 in chips) 
Seat 9: carlouchi (€41.03 in chips) 
beluccix: posts small blind €0.25
pocketpaira2: posts big blind €0.50
lysandrafly: sits out 
nombraalne1: sits out 
Al3xAnd3r22: sits out 
HeroWok: posts big blind €0.50
*** HOLE CARDS ***
Dealt to matiko09 [2c 5s]
vasiy379: folds 
carlouchi: folds 
HeroWok: checks 
matiko09: folds 
beluccix: folds 
pocketpaira2: raises €0.50 to €1
HeroWok: raises €2.50 to €3.50
pocketpaira2: calls €2.50
*** FLOP *** [9d 7s Ad]
pocketpaira2: bets €4.50
HeroWok: calls €4.50
*** TURN *** [9d 7s Ad] [Kd]
pocketpaira2: bets €14.40 and is all-in
HeroWok: calls €14.40
*** RIVER *** [9d 7s Ad Kd] [7c]
*** SHOW DOWN ***
pocketpaira2: shows [8h 4s] (a pair of Sevens)
HeroWok: shows [As 6d] (two pair, Aces and Sevens)
HeroWok collected €43.05 from pot
*** SUMMARY ***
Total pot €45.05 | Rake €2 
Board [9d 7s Ad Kd 7c]
Seat 2: HeroWok showed [As 6d] and won (€43.05) with two pair, Aces and Sevens
Seat 3: matiko09 (button) folded before Flop (didn't bet)
Seat 4: beluccix (small blind) folded before Flop
Seat 5: pocketpaira2 (big blind) showed [8h 4s] and lost with a pair of Sevens
Seat 7: vasiy379 folded before Flop (didn't bet)
Seat 9: carlouchi folded before Flop (didn't bet)





PokerStars Hand #150708197821:  Hold'em No Limit ($0.50/$1.00 USD) - 2016/03/21 17:16:32 CET [2016/03/21 12:16:32 ET]
Table 'Marmulla II' 9-max Seat #7 is the button
Seat 3: Vikulja1993 ($102.30 in chips) 
Seat 4: Dachish ($81.73 in chips) 
Seat 5: maaaGik88 ($71.97 in chips) 
Seat 6: R1aki ($130.14 in chips) 
Seat 7: Pacifistas ($114.10 in chips) 
Seat 8: sanpidk ($100.50 in chips) 
Seat 9: matiko09 ($100 in chips) 
sanpidk: posts small blind $0.50
matiko09: posts big blind $1
*** HOLE CARDS ***
Dealt to matiko09 [3d 6d]
Vikulja1993: folds 
Dachish: folds 
maaaGik88: folds 
R1aki: raises $1.50 to $2.50
Pacifistas: folds 
sanpidk: folds 
matiko09: folds 
Uncalled bet ($1.50) returned to R1aki
R1aki collected $2.50 from pot
R1aki: doesn't show hand 
*** SUMMARY ***
Total pot $2.50 | Rake $0 
Seat 3: Vikulja1993 folded before Flop (didn't bet)
Seat 4: Dachish folded before Flop (didn't bet)
Seat 5: maaaGik88 folded before Flop (didn't bet)
Seat 6: R1aki collected ($2.50)
Seat 7: Pacifistas (button) folded before Flop (didn't bet)
Seat 8: sanpidk (small blind) folded before Flop
Seat 9: matiko09 (big blind) folded before Flop





PokerStars Hand #150708199777:  Hold'em No Limit (€0.50/€1.00 EUR) - 2016/03/21 17:16:34 CET [2016/03/21 12:16:34 ET]
Table 'Anhui' 9-max Seat #6 is the button
Seat 1: ardo888 (€100 in chips) 
Seat 2: Dachish (€64.50 in chips) 
Seat 5: aponinho82 (€45.62 in chips) 
Seat 6: matiko09 (€100 in chips) 
Seat 7: R1aki (€100 in chips) 
Seat 8: lysandrafly (€100 in chips) 
Seat 9: ffac (€112.33 in chips) 
R1aki: posts small blind €0.50
lysandrafly: posts big blind €1
cobrik23: sits out 
*** HOLE CARDS ***
Dealt to matiko09 [2c 8s]
ffac: folds 
ardo888: folds 
Dachish: raises €1.50 to €2.50
aponinho82: calls €2.50
matiko09: folds 
R1aki: folds 
lysandrafly: folds 
*** FLOP *** [4d 6h 5s]
Dachish: bets €4.40
aponinho82: folds 
Uncalled bet (€4.40) returned to Dachish
Dachish collected €6.21 from pot
Dachish: doesn't show hand 
*** SUMMARY ***
Total pot €6.50 | Rake €0.29 
Board [4d 6h 5s]
Seat 1: ardo888 folded before Flop (didn't bet)
Seat 2: Dachish collected (€6.21)
Seat 5: aponinho82 folded on the Flop
Seat 6: matiko09 (button) folded before Flop (didn't bet)
Seat 7: R1aki (small blind) folded before Flop
Seat 8: lysandrafly (big blind) folded before Flop
Seat 9: ffac folded before Flop (didn't bet)





PokerStars Hand #150708203759:  Hold'em No Limit ($0.50/$1.00 USD) - 2016/03/21 17:16:39 CET [2016/03/21 12:16:39 ET]
Table 'Hilda' 9-max Seat #9 is the button
Seat 1: djammusic ($50.93 in chips) 
Seat 2: blackmont111 ($107.32 in chips) 
Seat 3: Rikti ($44.36 in chips) 
Seat 4: Pacifistas ($104.50 in chips) 
Seat 6: hemetcano ($220.18 in chips) 
Seat 7: R1aki ($114.88 in chips) 
Seat 8: sanpidk ($106.44 in chips) 
Seat 9: matiko09 ($100 in chips) 
djammusic: posts small blind $0.50
blackmont111: posts big blind $1
solbi86: sits out 
*** HOLE CARDS ***
Dealt to matiko09 [Ts 6s]
Rikti: folds 
Pacifistas: raises $2 to $3
hemetcano: calls $3
R1aki: folds 
sanpidk: folds 
matiko09: folds 
djammusic: folds 
blackmont111: calls $2
*** FLOP *** [9h 3c 2c]
blackmont111: checks 
Pacifistas: bets $5.90
hemetcano: folds 
blackmont111: folds 
Uncalled bet ($5.90) returned to Pacifistas
Pacifistas collected $9.07 from pot
Pacifistas: doesn't show hand 
*** SUMMARY ***
Total pot $9.50 | Rake $0.43 
Board [9h 3c 2c]
Seat 1: djammusic (small blind) folded before Flop
Seat 2: blackmont111 (big blind) folded on the Flop
Seat 3: Rikti folded before Flop (didn't bet)
Seat 4: Pacifistas collected ($9.07)
Seat 6: hemetcano folded on the Flop
Seat 7: R1aki folded before Flop (didn't bet)
Seat 8: sanpidk folded before Flop (didn't bet)
Seat 9: matiko09 (button) folded before Flop (didn't bet)





PokerStars Hand #150708210438:  Hold'em No Limit ($0.50/$1.00 USD) - 2016/03/21 17:16:48 CET [2016/03/21 12:16:48 ET]
Table 'Massalia II' 9-max Seat #8 is the button
Seat 1: Filojoes ($100 in chips) 
Seat 2: maxxmeister ($100 in chips) 
Seat 3: 123chambo ($167.33 in chips) 
Seat 4: OriginalTony ($99.40 in chips) 
Seat 5: Vikulja1993 ($100 in chips) 
Seat 6: Pacifistas ($108.51 in chips) 
Seat 7: flk.Dasas ($100 in chips) 
Seat 8: matiko09 ($142.18 in chips) 
Seat 9: DanishWiking ($109.06 in chips) 
DanishWiking: posts small blind $0.50
Filojoes: posts big blind $1
Filojoes: posts the ante $0.20
maxxmeister: posts the ante $0.20
123chambo: posts the ante $0.20
OriginalTony: posts the ante $0.20
Vikulja1993: posts the ante $0.20
Pacifistas: posts the ante $0.20
flk.Dasas: posts the ante $0.20
matiko09: posts the ante $0.20
DanishWiking: posts the ante $0.20
*** HOLE CARDS ***
Dealt to matiko09 [5d 6s]
maxxmeister: raises $2.50 to $3.50
123chambo: folds 
OriginalTony: folds 
Vikulja1993: folds 
Pacifistas: folds 
flk.Dasas: folds 
matiko09: folds 
DanishWiking: folds 
Filojoes: folds 
Uncalled bet ($2.50) returned to maxxmeister
maxxmeister collected $4.30 from pot
maxxmeister: doesn't show hand 
*** SUMMARY ***
Total pot $4.30 | Rake $0 
Seat 1: Filojoes (big blind) folded before Flop
Seat 2: maxxmeister collected ($4.30)
Seat 3: 123chambo folded before Flop (didn't bet)
Seat 4: OriginalTony folded before Flop (didn't bet)
Seat 5: Vikulja1993 folded before Flop (didn't bet)
Seat 6: Pacifistas folded before Flop (didn't bet)
Seat 7: flk.Dasas folded before Flop (didn't bet)
Seat 8: matiko09 (button) folded before Flop (didn't bet)
Seat 9: DanishWiking (small blind) folded before Flop





PokerStars Hand #150708220512:  Hold'em No Limit ($0.50/$1.00 USD) - 2016/03/21 17:17:01 CET [2016/03/21 12:17:01 ET]
Table 'Marmulla II' 9-max Seat #8 is the button
Seat 3: Vikulja1993 ($102.30 in chips) 
Seat 4: Dachish ($81.73 in chips) 
Seat 5: maaaGik88 ($71.97 in chips) 
Seat 6: R1aki ($131.64 in chips) 
Seat 7: Pacifistas ($114.10 in chips) 
Seat 8: sanpidk ($100 in chips) 
Seat 9: matiko09 ($100 in chips) 
matiko09: posts small blind $0.50
Vikulja1993: posts big blind $1
*** HOLE CARDS ***
Dealt to matiko09 [5d 8d]
Dachish: raises $2 to $3
maaaGik88: folds 
R1aki: folds 
Pacifistas: folds 
sanpidk: folds 
matiko09: folds 
Vikulja1993: folds 
Uncalled bet ($2) returned to Dachish
Dachish collected $2.50 from pot
Dachish: doesn't show hand 
*** SUMMARY ***
Total pot $2.50 | Rake $0 
Seat 3: Vikulja1993 (big blind) folded before Flop
Seat 4: Dachish collected ($2.50)
Seat 5: maaaGik88 folded before Flop (didn't bet)
Seat 6: R1aki folded before Flop (didn't bet)
Seat 7: Pacifistas folded before Flop (didn't bet)
Seat 8: sanpidk (button) folded before Flop (didn't bet)
Seat 9: matiko09 (small blind) folded before Flop





PokerStars Hand #150708226251:  Hold'em No Limit (€0.50/€1.00 EUR) - 2016/03/21 17:17:09 CET [2016/03/21 12:17:09 ET]
Table 'Anhui' 9-max Seat #7 is the button
Seat 1: ardo888 (€100 in chips) 
Seat 2: Dachish (€68.21 in chips) 
Seat 5: aponinho82 (€43.12 in chips) 
Seat 6: matiko09 (€100 in chips) 
Seat 7: R1aki (€100 in chips) 
Seat 8: lysandrafly (€100 in chips) 
Seat 9: ffac (€112.33 in chips) 
lysandrafly: posts small blind €0.50
ffac: posts big blind €1
cobrik23: sits out 
*** HOLE CARDS ***
Dealt to matiko09 [2s 7c]
ardo888: raises €2 to €3
Dachish: folds 
aponinho82: folds 
matiko09: folds 
R1aki: folds 
lysandrafly: folds 
ffac: folds 
Uncalled bet (€2) returned to ardo888
ardo888 collected €2.50 from pot
ardo888: doesn't show hand 
*** SUMMARY ***
Total pot €2.50 | Rake €0 
Seat 1: ardo888 collected (€2.50)
Seat 2: Dachish folded before Flop (didn't bet)
Seat 5: aponinho82 folded before Flop (didn't bet)
Seat 6: matiko09 folded before Flop (didn't bet)
Seat 7: R1aki (button) folded before Flop (didn't bet)
Seat 8: lysandrafly (small blind) folded before Flop
Seat 9: ffac (big blind) folded before Flop





PokerStars Hand #150708237662:  Hold'em No Limit (€0.25/€0.50 EUR) - 2016/03/21 17:17:24 CET [2016/03/21 12:17:24 ET]
Table 'Auravictrix II' 9-max Seat #4 is the button
Seat 2: HeroWok (€60.65 in chips) 
Seat 3: matiko09 (€54.53 in chips) 
Seat 4: beluccix (€20 in chips) 
Seat 7: vasiy379 (€50 in chips) 
Seat 8: nombraalne1 (€69.16 in chips) 
Seat 9: carlouchi (€41.03 in chips) 
lysandrafly will be allowed to play after the button
vasiy379: posts small blind €0.25
nombraalne1: posts big blind €0.50
Al3xAnd3r22: sits out 
*** HOLE CARDS ***
Dealt to matiko09 [8h 9c]
carlouchi: folds 
HeroWok: raises €0.75 to €1.25
matiko09: folds 
beluccix: folds 
pocketpaira2 leaves the table
ffac joins the table at seat #5 
vasiy379: calls €1
nombraalne1: folds 
*** FLOP *** [7c 4d 6h]
vasiy379: checks 
HeroWok: bets €1.43
vasiy379: folds 
Uncalled bet (€1.43) returned to HeroWok
HeroWok collected €2.86 from pot
HeroWok: doesn't show hand 
*** SUMMARY ***
Total pot €3 | Rake €0.14 
Board [7c 4d 6h]
Seat 2: HeroWok collected (€2.86)
Seat 3: matiko09 folded before Flop (didn't bet)
Seat 4: beluccix (button) folded before Flop (didn't bet)
Seat 7: vasiy379 (small blind) folded on the Flop
Seat 8: nombraalne1 (big blind) folded before Flop
Seat 9: carlouchi folded before Flop (didn't bet)





PokerStars Hand #150708240716:  Hold'em No Limit ($0.50/$1.00 USD) - 2016/03/21 17:17:27 CET [2016/03/21 12:17:27 ET]
Table 'Massalia II' 9-max Seat #9 is the button
Seat 1: Filojoes ($100 in chips) 
Seat 3: 123chambo ($167.13 in chips) 
Seat 4: OriginalTony ($99.20 in chips) 
Seat 5: Vikulja1993 ($100 in chips) 
Seat 6: Pacifistas ($108.31 in chips) 
Seat 7: flk.Dasas ($100 in chips) 
Seat 8: matiko09 ($141.98 in chips) 
Seat 9: DanishWiking ($108.36 in chips) 
Filojoes: posts small blind $0.50
maxxmeister: is sitting out 
123chambo: posts big blind $1
Filojoes: posts the ante $0.20
123chambo: posts the ante $0.20
OriginalTony: posts the ante $0.20
Vikulja1993: posts the ante $0.20
Pacifistas: posts the ante $0.20
flk.Dasas: posts the ante $0.20
matiko09: posts the ante $0.20
DanishWiking: posts the ante $0.20
*** HOLE CARDS ***
Dealt to matiko09 [7c 5d]
OriginalTony: folds 
maxxmeister leaves the table
Vikulja1993: folds 
SiD11211 joins the table at seat #2 
Pacifistas: folds 
flk.Dasas: folds 
matiko09: folds 
DanishWiking: folds 
Filojoes: raises $1.50 to $2.50
123chambo: calls $1.50
*** FLOP *** [4d 6c 6s]
Filojoes: checks 
123chambo: checks 
*** TURN *** [4d 6c 6s] [Jh]
Filojoes: checks 
123chambo: bets $4
Filojoes: folds 
Uncalled bet ($4) returned to 123chambo
123chambo collected $6.30 from pot
123chambo: doesn't show hand 
*** SUMMARY ***
Total pot $6.60 | Rake $0.30 
Board [4d 6c 6s Jh]
Seat 1: Filojoes (small blind) folded on the Turn
Seat 3: 123chambo (big blind) collected ($6.30)
Seat 4: OriginalTony folded before Flop (didn't bet)
Seat 5: Vikulja1993 folded before Flop (didn't bet)
Seat 6: Pacifistas folded before Flop (didn't bet)
Seat 7: flk.Dasas folded before Flop (didn't bet)
Seat 8: matiko09 folded before Flop (didn't bet)
Seat 9: DanishWiking (button) folded before Flop (didn't bet)





PokerStars Hand #150708242711:  Hold'em No Limit ($0.50/$1.00 USD) - 2016/03/21 17:17:30 CET [2016/03/21 12:17:30 ET]
Table 'Hilda' 9-max Seat #1 is the button
Seat 1: djammusic ($50.43 in chips) 
Seat 2: blackmont111 ($104.32 in chips) 
Seat 3: Rikti ($44.36 in chips) 
Seat 4: Pacifistas ($110.57 in chips) 
Seat 6: hemetcano ($217.18 in chips) 
Seat 7: R1aki ($114.88 in chips) 
Seat 8: sanpidk ($106.44 in chips) 
Seat 9: matiko09 ($100 in chips) 
blackmont111: posts small blind $0.50
Rikti: posts big blind $1
solbi86: sits out 
*** HOLE CARDS ***
Dealt to matiko09 [Th As]
Pacifistas: folds 
hemetcano: calls $1
R1aki: raises $3.50 to $4.50
sanpidk: folds 
matiko09: raises $7.50 to $12
djammusic: folds 
blackmont111: folds 
Rikti: folds 
hemetcano: folds 
R1aki: folds 
Uncalled bet ($7.50) returned to matiko09
matiko09 collected $11.50 from pot
matiko09: doesn't show hand 
*** SUMMARY ***
Total pot $11.50 | Rake $0 
Seat 1: djammusic (button) folded before Flop (didn't bet)
Seat 2: blackmont111 (small blind) folded before Flop
Seat 3: Rikti (big blind) folded before Flop
Seat 4: Pacifistas folded before Flop (didn't bet)
Seat 6: hemetcano folded before Flop
Seat 7: R1aki folded before Flop
Seat 8: sanpidk folded before Flop (didn't bet)
Seat 9: matiko09 collected ($11.50)





PokerStars Hand #150708247655:  Hold'em No Limit ($0.50/$1.00 USD) - 2016/03/21 17:17:37 CET [2016/03/21 12:17:37 ET]
Table 'Onnie II' 9-max Seat #2 is the button
Seat 1: ka100pka527 ($120.57 in chips) 
Seat 2: RICKA16 ($100 in chips) 
Seat 3: cn_chayanne ($124.64 in chips) 
Seat 4: Bothfeld11 ($158.56 in chips) 
Seat 5: sanpidk ($103.50 in chips) 
Seat 6: Pacifistas ($105.93 in chips) 
Seat 7: djammusic ($74.40 in chips) 
Seat 9: matiko09 ($127.69 in chips) 
cn_chayanne: posts small blind $0.50
Bothfeld11: posts big blind $1
solbi86: sits out 
*** HOLE CARDS ***
Dealt to matiko09 [Jd 6h]
sanpidk: folds 
Pacifistas: folds 
djammusic: folds 
matiko09: folds 
ka100pka527: folds 
RICKA16: folds 
cn_chayanne: raises $2 to $3
Bothfeld11: calls $2
*** FLOP *** [7s 8s 8h]
cn_chayanne: checks 
Bothfeld11: checks 
*** TURN *** [7s 8s 8h] [7c]
cn_chayanne: checks 
Bothfeld11: checks 
*** RIVER *** [7s 8s 8h 7c] [Jc]
cn_chayanne: checks 
Bothfeld11: checks 
*** SHOW DOWN ***
cn_chayanne: shows [Kh 9c] (two pair, Eights and Sevens)
Bothfeld11: shows [9d Qs] (two pair, Eights and Sevens - lower kicker)
cn_chayanne collected $5.73 from pot
*** SUMMARY ***
Total pot $6 | Rake $0.27 
Board [7s 8s 8h 7c Jc]
Seat 1: ka100pka527 folded before Flop (didn't bet)
Seat 2: RICKA16 (button) folded before Flop (didn't bet)
Seat 3: cn_chayanne (small blind) showed [Kh 9c] and won ($5.73) with two pair, Eights and Sevens
Seat 4: Bothfeld11 (big blind) showed [9d Qs] and lost with two pair, Eights and Sevens
Seat 5: sanpidk folded before Flop (didn't bet)
Seat 6: Pacifistas folded before Flop (didn't bet)
Seat 7: djammusic folded before Flop (didn't bet)
Seat 9: matiko09 folded before Flop (didn't bet)





PokerStars Hand #150708249477:  Hold'em No Limit ($0.50/$1.00 USD) - 2016/03/21 17:17:39 CET [2016/03/21 12:17:39 ET]
Table 'Marmulla II' 9-max Seat #9 is the button
Seat 3: Vikulja1993 ($101.30 in chips) 
Seat 4: Dachish ($83.23 in chips) 
Seat 5: maaaGik88 ($71.97 in chips) 
Seat 6: R1aki ($131.64 in chips) 
Seat 7: Pacifistas ($114.10 in chips) 
Seat 8: sanpidk ($100 in chips) 
Seat 9: matiko09 ($100 in chips) 
Vikulja1993: posts small blind $0.50
Dachish: posts big blind $1
*** HOLE CARDS ***
Dealt to matiko09 [9s 2c]
maaaGik88: folds 
R1aki: folds 
Pacifistas: folds 
sanpidk: folds 
matiko09: folds 
Vikulja1993: folds 
Uncalled bet ($0.50) returned to Dachish
Dachish collected $1 from pot
Dachish: doesn't show hand 
*** SUMMARY ***
Total pot $1 | Rake $0 
Seat 3: Vikulja1993 (small blind) folded before Flop
Seat 4: Dachish (big blind) collected ($1)
Seat 5: maaaGik88 folded before Flop (didn't bet)
Seat 6: R1aki folded before Flop (didn't bet)
Seat 7: Pacifistas folded before Flop (didn't bet)
Seat 8: sanpidk folded before Flop (didn't bet)
Seat 9: matiko09 (button) folded before Flop (didn't bet)





PokerStars Hand #150708253256:  Hold'em No Limit (€0.50/€1.00 EUR) - 2016/03/21 17:17:44 CET [2016/03/21 12:17:44 ET]
Table 'Anhui' 9-max Seat #8 is the button
Seat 1: ardo888 (€101.50 in chips) 
Seat 2: Dachish (€68.21 in chips) 
Seat 5: aponinho82 (€43.12 in chips) 
Seat 6: matiko09 (€100 in chips) 
Seat 7: R1aki (€100 in chips) 
Seat 8: lysandrafly (€100 in chips) 
Seat 9: ffac (€111.33 in chips) 
ffac: posts small blind €0.50
ardo888: posts big blind €1
cobrik23: sits out 
*** HOLE CARDS ***
Dealt to matiko09 [4s 8s]
Dachish: folds 
aponinho82: folds 
aponinho82 leaves the table
matiko09: folds 
R1aki: raises €1.50 to €2.50
lysandrafly: folds 
ffac: folds 
ardo888: folds 
Uncalled bet (€1.50) returned to R1aki
R1aki collected €2.50 from pot
R1aki: doesn't show hand 
*** SUMMARY ***
Total pot €2.50 | Rake €0 
Seat 1: ardo888 (big blind) folded before Flop
Seat 2: Dachish folded before Flop (didn't bet)
Seat 5: aponinho82 folded before Flop (didn't bet)
Seat 6: matiko09 folded before Flop (didn't bet)
Seat 7: R1aki collected (€2.50)
Seat 8: lysandrafly (button) folded before Flop (didn't bet)
Seat 9: ffac (small blind) folded before Flop





PokerStars Hand #150708265535:  Hold'em No Limit (€0.25/€0.50 EUR) - 2016/03/21 17:18:00 CET [2016/03/21 12:18:00 ET]
Table 'Auravictrix II' 9-max Seat #7 is the button
Seat 2: HeroWok (€62.26 in chips) 
Seat 3: matiko09 (€54.53 in chips) 
Seat 4: beluccix (€20 in chips) 
Seat 7: vasiy379 (€50 in chips) 
Seat 8: nombraalne1 (€68.66 in chips) 
Seat 9: carlouchi (€41.03 in chips) 
nombraalne1: posts small blind €0.25
carlouchi: posts big blind €0.50
Al3xAnd3r22: sits out 
ffac: sits out 
lysandrafly: sits out 
*** HOLE CARDS ***
Dealt to matiko09 [3s 2d]
HeroWok: folds 
matiko09: folds 
beluccix: folds 
vasiy379: raises €0.60 to €1.10
nombraalne1: folds 
carlouchi: calls €0.60
*** FLOP *** [2c 9s 2s]
carlouchi: checks 
vasiy379: bets €0.81
carlouchi: raises €3.96 to €4.77
vasiy379: calls €3.96
*** TURN *** [2c 9s 2s] [Qc]
carlouchi: checks 
vasiy379: checks 
*** RIVER *** [2c 9s 2s Qc] [8d]
carlouchi: checks 
vasiy379: checks 
*** SHOW DOWN ***
carlouchi: shows [As Th] (a pair of Deuces)
vasiy379: mucks hand 
carlouchi collected €11.45 from pot
*** SUMMARY ***
Total pot €11.99 | Rake €0.54 
Board [2c 9s 2s Qc 8d]
Seat 2: HeroWok folded before Flop (didn't bet)
Seat 3: matiko09 folded before Flop (didn't bet)
Seat 4: beluccix folded before Flop (didn't bet)
Seat 7: vasiy379 (button) mucked [Js 5s]
Seat 8: nombraalne1 (small blind) folded before Flop
Seat 9: carlouchi (big blind) showed [As Th] and won (€11.45) with a pair of Deuces





PokerStars Hand #150708272100:  Hold'em No Limit ($0.50/$1.00 USD) - 2016/03/21 17:18:09 CET [2016/03/21 12:18:09 ET]
Table 'Marmulla II' 9-max Seat #3 is the button
Seat 3: Vikulja1993 ($100.80 in chips) 
Seat 4: Dachish ($83.73 in chips) 
Seat 5: maaaGik88 ($71.97 in chips) 
Seat 6: R1aki ($131.64 in chips) 
Seat 7: Pacifistas ($114.10 in chips) 
Seat 8: sanpidk ($100 in chips) 
Seat 9: matiko09 ($100 in chips) 
Dachish: posts small blind $0.50
maaaGik88: posts big blind $1
*** HOLE CARDS ***
Dealt to matiko09 [Jd 8d]
R1aki: folds 
Pacifistas: folds 
sanpidk: folds 
matiko09: raises $1.50 to $2.50
Vikulja1993: calls $2.50
Dachish: folds 
maaaGik88: folds 
*** FLOP *** [6h 9s 7s]
matiko09: checks 
Vikulja1993: bets $3
matiko09: calls $3
*** TURN *** [6h 9s 7s] [Tc]
matiko09: checks 
Vikulja1993: bets $8
matiko09: calls $8
*** RIVER *** [6h 9s 7s Tc] [9h]
matiko09: checks 
Vikulja1993: bets $21
matiko09: calls $21
*** SHOW DOWN ***
Vikulja1993: shows [6d 6s] (a full house, Sixes full of Nines)
matiko09: mucks hand 
Vikulja1993 collected $67.70 from pot
*** SUMMARY ***
Total pot $70.50 | Rake $2.80 
Board [6h 9s 7s Tc 9h]
Seat 3: Vikulja1993 (button) showed [6d 6s] and won ($67.70) with a full house, Sixes full of Nines
Seat 4: Dachish (small blind) folded before Flop
Seat 5: maaaGik88 (big blind) folded before Flop
Seat 6: R1aki folded before Flop (didn't bet)
Seat 7: Pacifistas folded before Flop (didn't bet)
Seat 8: sanpidk folded before Flop (didn't bet)
Seat 9: matiko09 mucked [Jd 8d]





PokerStars Hand #150708279580:  Hold'em No Limit (€0.50/€1.00 EUR) - 2016/03/21 17:18:18 CET [2016/03/21 12:18:18 ET]
Table 'Anhui' 9-max Seat #9 is the button
Seat 1: ardo888 (€100.50 in chips) 
Seat 2: Dachish (€68.21 in chips) 
Seat 6: matiko09 (€100 in chips) 
Seat 7: R1aki (€101.50 in chips) 
Seat 8: lysandrafly (€100 in chips) 
Seat 9: ffac (€110.83 in chips) 
ardo888: posts small blind €0.50
Dachish: posts big blind €1
cobrik23: sits out 
*** HOLE CARDS ***
Dealt to matiko09 [8h Ts]
matiko09: folds 
R1aki: folds 
lysandrafly: raises €1.80 to €2.80
ffac: folds 
ardo888: folds 
Dachish: folds 
Uncalled bet (€1.80) returned to lysandrafly
lysandrafly collected €2.50 from pot
*** SUMMARY ***
Total pot €2.50 | Rake €0 
Seat 1: ardo888 (small blind) folded before Flop
Seat 2: Dachish (big blind) folded before Flop
Seat 6: matiko09 folded before Flop (didn't bet)
Seat 7: R1aki folded before Flop (didn't bet)
Seat 8: lysandrafly collected (€2.50)
Seat 9: ffac (button) folded before Flop (didn't bet)





PokerStars Hand #150708295892:  Hold'em No Limit ($0.50/$1.00 USD) - 2016/03/21 17:18:39 CET [2016/03/21 12:18:39 ET]
Table 'Massalia II' 9-max Seat #1 is the button
Seat 1: Filojoes ($100 in chips) 
Seat 3: 123chambo ($170.73 in chips) 
Seat 4: OriginalTony ($99 in chips) 
Seat 5: Vikulja1993 ($100 in chips) 
Seat 6: Pacifistas ($108.11 in chips) 
Seat 7: flk.Dasas ($100 in chips) 
Seat 8: matiko09 ($141.78 in chips) 
Seat 9: DanishWiking ($108.16 in chips) 
SiD11211 will be allowed to play after the button
123chambo: posts small blind $0.50
OriginalTony: posts big blind $1
Filojoes: posts the ante $0.20
123chambo: posts the ante $0.20
OriginalTony: posts the ante $0.20
Vikulja1993: posts the ante $0.20
Pacifistas: posts the ante $0.20
flk.Dasas: posts the ante $0.20
matiko09: posts the ante $0.20
DanishWiking: posts the ante $0.20
*** HOLE CARDS ***
Dealt to matiko09 [Qc Kc]
Vikulja1993: folds 
Pacifistas: folds 
flk.Dasas: folds 
matiko09: raises $2 to $3
DanishWiking: folds 
Filojoes: raises $6 to $9
123chambo: folds 
OriginalTony: folds 
matiko09: calls $6
*** FLOP *** [4h Kd 6c]
matiko09: checks 
Filojoes: bets $10
matiko09: calls $10
*** TURN *** [4h Kd 6c] [7h]
matiko09: checks 
Filojoes: bets $20
matiko09: calls $20
*** RIVER *** [4h Kd 6c 7h] [Jc]
matiko09: checks 
Filojoes: checks 
*** SHOW DOWN ***
matiko09: shows [Qc Kc] (a pair of Kings)
Filojoes: mucks hand 
matiko09 collected $78.30 from pot
*** SUMMARY ***
Total pot $81.10 | Rake $2.80 
Board [4h Kd 6c 7h Jc]
Seat 1: Filojoes (button) mucked [Qs Ah]
Seat 3: 123chambo (small blind) folded before Flop
Seat 4: OriginalTony (big blind) folded before Flop
Seat 5: Vikulja1993 folded before Flop (didn't bet)
Seat 6: Pacifistas folded before Flop (didn't bet)
Seat 7: flk.Dasas folded before Flop (didn't bet)
Seat 8: matiko09 showed [Qc Kc] and won ($78.30) with a pair of Kings
Seat 9: DanishWiking folded before Flop (didn't bet)





PokerStars Hand #150708295526:  Hold'em No Limit ($0.50/$1.00 USD) - 2016/03/21 17:18:39 CET [2016/03/21 12:18:39 ET]
Table 'Hilda' 9-max Seat #2 is the button
Seat 1: djammusic ($50.43 in chips) 
Seat 2: blackmont111 ($103.82 in chips) 
Seat 3: Rikti ($43.36 in chips) 
Seat 4: Pacifistas ($110.57 in chips) 
Seat 6: hemetcano ($216.18 in chips) 
Seat 7: R1aki ($110.38 in chips) 
Seat 8: sanpidk ($106.44 in chips) 
Seat 9: matiko09 ($107 in chips) 
Rikti: posts small blind $0.50
Pacifistas: posts big blind $1
solbi86: sits out 
*** HOLE CARDS ***
Dealt to matiko09 [Ad 5s]
hemetcano: calls $1
R1aki: folds 
sanpidk: folds 
matiko09: folds 
djammusic: folds 
blackmont111: calls $1
Rikti: calls $0.50
Pacifistas: checks 
*** FLOP *** [Ah 8s Kc]
Rikti: checks 
Pacifistas: checks 
hemetcano: checks 
blackmont111: checks 
*** TURN *** [Ah 8s Kc] [9d]
Rikti: checks 
Pacifistas: checks 
hemetcano: checks 
blackmont111: bets $3
Rikti: folds 
Pacifistas: folds 
hemetcano: calls $3
*** RIVER *** [Ah 8s Kc 9d] [Qd]
hemetcano: checks 
blackmont111: checks 
*** SHOW DOWN ***
hemetcano: shows [7h 6s] (high card Ace)
blackmont111: shows [6c 7d] (high card Ace)
hemetcano collected $4.78 from pot
blackmont111 collected $4.77 from pot
*** SUMMARY ***
Total pot $10 | Rake $0.45 
Board [Ah 8s Kc 9d Qd]
Seat 1: djammusic folded before Flop (didn't bet)
Seat 2: blackmont111 (button) showed [6c 7d] and won ($4.77) with high card Ace
Seat 3: Rikti (small blind) folded on the Turn
Seat 4: Pacifistas (big blind) folded on the Turn
Seat 6: hemetcano showed [7h 6s] and won ($4.78) with high card Ace
Seat 7: R1aki folded before Flop (didn't bet)
Seat 8: sanpidk folded before Flop (didn't bet)
Seat 9: matiko09 folded before Flop (didn't bet)





PokerStars Hand #150708298412:  Hold'em No Limit (€0.50/€1.00 EUR) - 2016/03/21 17:18:43 CET [2016/03/21 12:18:43 ET]
Table 'Anhui' 9-max Seat #1 is the button
Seat 1: ardo888 (€100 in chips) 
Seat 2: Dachish (€67.21 in chips) 
Seat 4: cobrik23 (€99.08 in chips) 
Seat 6: matiko09 (€100 in chips) 
Seat 7: R1aki (€101.50 in chips) 
Seat 8: lysandrafly (€101.50 in chips) 
Seat 9: ffac (€110.83 in chips) 
Dachish: posts small blind €0.50
cobrik23: posts big blind €1
*** HOLE CARDS ***
Dealt to matiko09 [Jc 6h]
matiko09: folds 
matiko09 leaves the table
R1aki: folds 
R1aki leaves the table
lysandrafly: folds 
lysandrafly leaves the table
ffac: folds 
ardo888: raises €1.50 to €2.50
Dachish: calls €2
cobrik23: folds 
*** FLOP *** [Kh Qd 5s]
Dachish: checks 
ardo888: bets €3.03
Dachish: calls €3.03
*** TURN *** [Kh Qd 5s] [4d]
Dachish: checks 
ardo888: checks 
*** RIVER *** [Kh Qd 5s 4d] [9h]
Dachish: bets €5.64
ardo888: folds 
Uncalled bet (€5.64) returned to Dachish
Dachish collected €11.52 from pot
Dachish: doesn't show hand 
*** SUMMARY ***
Total pot €12.06 | Rake €0.54 
Board [Kh Qd 5s 4d 9h]
Seat 1: ardo888 (button) folded on the River
Seat 2: Dachish (small blind) collected (€11.52)
Seat 4: cobrik23 (big blind) folded before Flop
Seat 6: matiko09 folded before Flop (didn't bet)
Seat 7: R1aki folded before Flop (didn't bet)
Seat 8: lysandrafly folded before Flop (didn't bet)
Seat 9: ffac folded before Flop (didn't bet)





PokerStars Hand #150708299499:  Hold'em No Limit ($0.50/$1.00 USD) - 2016/03/21 17:18:44 CET [2016/03/21 12:18:44 ET]
Table 'Onnie II' 9-max Seat #3 is the button
Seat 1: ka100pka527 ($120.57 in chips) 
Seat 2: RICKA16 ($100 in chips) 
Seat 3: cn_chayanne ($127.37 in chips) 
Seat 4: Bothfeld11 ($155.56 in chips) 
Seat 5: sanpidk ($103.50 in chips) 
Seat 6: Pacifistas ($105.93 in chips) 
Seat 7: djammusic ($74.40 in chips) 
Seat 9: matiko09 ($127.69 in chips) 
Bothfeld11: posts small blind $0.50
sanpidk: posts big blind $1
solbi86: sits out 
*** HOLE CARDS ***
Dealt to matiko09 [5c Ad]
Pacifistas: folds 
djammusic: folds 
matiko09: folds 
ka100pka527: folds 
RICKA16: raises $2 to $3
cn_chayanne: calls $3
Bothfeld11: folds 
sanpidk: folds 
*** FLOP *** [3c 4s 6s]
RICKA16: checks 
cn_chayanne: bets $4.51
RICKA16: folds 
Uncalled bet ($4.51) returned to cn_chayanne
cn_chayanne collected $7.16 from pot
cn_chayanne: doesn't show hand 
*** SUMMARY ***
Total pot $7.50 | Rake $0.34 
Board [3c 4s 6s]
Seat 1: ka100pka527 folded before Flop (didn't bet)
Seat 2: RICKA16 folded on the Flop
Seat 3: cn_chayanne (button) collected ($7.16)
Seat 4: Bothfeld11 (small blind) folded before Flop
Seat 5: sanpidk (big blind) folded before Flop
Seat 6: Pacifistas folded before Flop (didn't bet)
Seat 7: djammusic folded before Flop (didn't bet)
Seat 9: matiko09 folded before Flop (didn't bet)





PokerStars Hand #150708317185:  Hold'em No Limit ($0.50/$1.00 USD) - 2016/03/21 17:19:07 CET [2016/03/21 12:19:07 ET]
Table 'Goberta' 9-max Seat #2 is the button
Seat 2: mycka86 ($153.12 in chips) 
Seat 3: Khaine_CM ($123.17 in chips) 
Seat 4: matiko09 ($102.75 in chips) 
Seat 5: DevilisHEyz ($51.12 in chips) 
Seat 6: flk.Dasas ($104.92 in chips) 
Seat 7: Filojoes ($100 in chips) 
Seat 8: sanpidk ($101.50 in chips) 
Khaine_CM: posts small blind $0.50
matiko09: posts big blind $1
*** HOLE CARDS ***
Dealt to matiko09 [5s Js]
DevilisHEyz: raises $2.50 to $3.50
flk.Dasas: folds 
Filojoes: folds 
sanpidk: folds 
mycka86: folds 
Khaine_CM: folds 
matiko09: folds 
Uncalled bet ($2.50) returned to DevilisHEyz
DevilisHEyz collected $2.50 from pot
*** SUMMARY ***
Total pot $2.50 | Rake $0 
Seat 2: mycka86 (button) folded before Flop (didn't bet)
Seat 3: Khaine_CM (small blind) folded before Flop
Seat 4: matiko09 (big blind) folded before Flop
Seat 5: DevilisHEyz collected ($2.50)
Seat 6: flk.Dasas folded before Flop (didn't bet)
Seat 7: Filojoes folded before Flop (didn't bet)
Seat 8: sanpidk folded before Flop (didn't bet)





PokerStars Hand #150708323782:  Hold'em No Limit (€0.25/€0.50 EUR) - 2016/03/21 17:19:15 CET [2016/03/21 12:19:15 ET]
Table 'Auravictrix II' 9-max Seat #8 is the button
Seat 1: Al3xAnd3r22 (€50 in chips) 
Seat 2: HeroWok (€62.26 in chips) 
Seat 3: matiko09 (€54.53 in chips) 
Seat 4: beluccix (€20 in chips) 
Seat 7: vasiy379 (€50 in chips) 
Seat 8: nombraalne1 (€68.41 in chips) 
Seat 9: carlouchi (€46.61 in chips) 
carlouchi: posts small blind €0.25
Al3xAnd3r22: posts big blind €0.50
ffac: sits out 
lysandrafly: sits out 
*** HOLE CARDS ***
Dealt to matiko09 [6s 3d]
HeroWok: folds 
matiko09: folds 
beluccix: folds 
vasiy379: folds 
nombraalne1: raises €0.50 to €1
carlouchi: folds 
Al3xAnd3r22: folds 
Uncalled bet (€0.50) returned to nombraalne1
nombraalne1 collected €1.25 from pot
nombraalne1: doesn't show hand 
*** SUMMARY ***
Total pot €1.25 | Rake €0 
Seat 1: Al3xAnd3r22 (big blind) folded before Flop
Seat 2: HeroWok folded before Flop (didn't bet)
Seat 3: matiko09 folded before Flop (didn't bet)
Seat 4: beluccix folded before Flop (didn't bet)
Seat 7: vasiy379 folded before Flop (didn't bet)
Seat 8: nombraalne1 (button) collected (€1.25)
Seat 9: carlouchi (small blind) folded before Flop





PokerStars Hand #150708340595:  Hold'em No Limit ($0.50/$1.00 USD) - 2016/03/21 17:19:37 CET [2016/03/21 12:19:37 ET]
Table 'Onnie II' 9-max Seat #4 is the button
Seat 1: ka100pka527 ($120.57 in chips) 
Seat 2: RICKA16 ($100 in chips) 
Seat 3: cn_chayanne ($131.53 in chips) 
Seat 4: Bothfeld11 ($155.06 in chips) 
Seat 5: sanpidk ($102.50 in chips) 
Seat 6: Pacifistas ($105.93 in chips) 
Seat 7: djammusic ($74.40 in chips) 
Seat 9: matiko09 ($127.69 in chips) 
sanpidk: posts small blind $0.50
Pacifistas: posts big blind $1
solbi86: sits out 
*** HOLE CARDS ***
Dealt to matiko09 [2s 6s]
djammusic: folds 
matiko09: folds 
ka100pka527: folds 
RICKA16: folds 
cn_chayanne: raises $1.50 to $2.50
Bothfeld11: folds 
sanpidk: folds 
Pacifistas: folds 
Uncalled bet ($1.50) returned to cn_chayanne
cn_chayanne collected $2.50 from pot
cn_chayanne: doesn't show hand 
*** SUMMARY ***
Total pot $2.50 | Rake $0 
Seat 1: ka100pka527 folded before Flop (didn't bet)
Seat 2: RICKA16 folded before Flop (didn't bet)
Seat 3: cn_chayanne collected ($2.50)
Seat 4: Bothfeld11 (button) folded before Flop (didn't bet)
Seat 5: sanpidk (small blind) folded before Flop
Seat 6: Pacifistas (big blind) folded before Flop
Seat 7: djammusic folded before Flop (didn't bet)
Seat 9: matiko09 folded before Flop (didn't bet)





PokerStars Hand #150708344381:  Hold'em No Limit (€0.25/€0.50 EUR) - 2016/03/21 17:19:42 CET [2016/03/21 12:19:42 ET]
Table 'Auravictrix II' 9-max Seat #9 is the button
Seat 1: Al3xAnd3r22 (€50 in chips) 
Seat 2: HeroWok (€62.26 in chips) 
Seat 3: matiko09 (€54.53 in chips) 
Seat 4: beluccix (€20 in chips) 
Seat 7: vasiy379 (€50 in chips) 
Seat 8: nombraalne1 (€69.16 in chips) 
Seat 9: carlouchi (€46.36 in chips) 
Al3xAnd3r22: posts small blind €0.25
HeroWok: posts big blind €0.50
ffac: sits out 
lysandrafly: sits out 
*** HOLE CARDS ***
Dealt to matiko09 [6d 9d]
matiko09: folds 
beluccix: raises €0.75 to €1.25
vasiy379: folds 
nombraalne1: folds 
carlouchi: folds 
Al3xAnd3r22: folds 
HeroWok: folds 
Uncalled bet (€0.75) returned to beluccix
beluccix collected €1.25 from pot
beluccix: doesn't show hand 
*** SUMMARY ***
Total pot €1.25 | Rake €0 
Seat 1: Al3xAnd3r22 (small blind) folded before Flop
Seat 2: HeroWok (big blind) folded before Flop
Seat 3: matiko09 folded before Flop (didn't bet)
Seat 4: beluccix collected (€1.25)
Seat 7: vasiy379 folded before Flop (didn't bet)
Seat 8: nombraalne1 folded before Flop (didn't bet)
Seat 9: carlouchi (button) folded before Flop (didn't bet)





PokerStars Hand #150708354176:  Hold'em No Limit ($0.50/$1.00 USD) - 2016/03/21 17:19:55 CET [2016/03/21 12:19:55 ET]
Table 'Goberta' 9-max Seat #3 is the button
Seat 2: mycka86 ($153.12 in chips) 
Seat 3: Khaine_CM ($122.67 in chips) 
Seat 4: matiko09 ($101.75 in chips) 
Seat 5: DevilisHEyz ($52.62 in chips) 
Seat 6: flk.Dasas ($104.92 in chips) 
Seat 7: Filojoes ($100 in chips) 
Seat 8: sanpidk ($101.50 in chips) 
matiko09: posts small blind $0.50
DevilisHEyz: posts big blind $1
*** HOLE CARDS ***
Dealt to matiko09 [8h 9s]
flk.Dasas: folds 
Filojoes: folds 
sanpidk: raises $2 to $3
mycka86: folds 
Khaine_CM: folds 
matiko09: folds 
DevilisHEyz: folds 
Uncalled bet ($2) returned to sanpidk
sanpidk collected $2.50 from pot
sanpidk: doesn't show hand 
*** SUMMARY ***
Total pot $2.50 | Rake $0 
Seat 2: mycka86 folded before Flop (didn't bet)
Seat 3: Khaine_CM (button) folded before Flop (didn't bet)
Seat 4: matiko09 (small blind) folded before Flop
Seat 5: DevilisHEyz (big blind) folded before Flop
Seat 6: flk.Dasas folded before Flop (didn't bet)
Seat 7: Filojoes folded before Flop (didn't bet)
Seat 8: sanpidk collected ($2.50)





PokerStars Hand #150708360250:  Hold'em No Limit (€0.25/€0.50 EUR) - 2016/03/21 17:20:03 CET [2016/03/21 12:20:03 ET]
Table 'Auravictrix II' 9-max Seat #1 is the button
Seat 1: Al3xAnd3r22 (€50 in chips) 
Seat 2: HeroWok (€61.76 in chips) 
Seat 3: matiko09 (€54.53 in chips) 
Seat 4: beluccix (€20.75 in chips) 
Seat 7: vasiy379 (€50 in chips) 
Seat 8: nombraalne1 (€69.16 in chips) 
Seat 9: carlouchi (€46.36 in chips) 
HeroWok: posts small blind €0.25
matiko09: posts big blind €0.50
ffac: sits out 
lysandrafly: sits out 
*** HOLE CARDS ***
Dealt to matiko09 [3h Tc]
beluccix: folds 
vasiy379: folds 
nombraalne1: raises €0.75 to €1.25
carlouchi: folds 
Al3xAnd3r22: folds 
HeroWok: folds 
matiko09: folds 
Uncalled bet (€0.75) returned to nombraalne1
nombraalne1 collected €1.25 from pot
nombraalne1: doesn't show hand 
*** SUMMARY ***
Total pot €1.25 | Rake €0 
Seat 1: Al3xAnd3r22 (button) folded before Flop (didn't bet)
Seat 2: HeroWok (small blind) folded before Flop
Seat 3: matiko09 (big blind) folded before Flop
Seat 4: beluccix folded before Flop (didn't bet)
Seat 7: vasiy379 folded before Flop (didn't bet)
Seat 8: nombraalne1 collected (€1.25)
Seat 9: carlouchi folded before Flop (didn't bet)





PokerStars Hand #150708362414:  Hold'em No Limit ($0.50/$1.00 USD) - 2016/03/21 17:20:06 CET [2016/03/21 12:20:06 ET]
Table 'Onnie II' 9-max Seat #5 is the button
Seat 1: ka100pka527 ($120.57 in chips) 
Seat 2: RICKA16 ($100 in chips) 
Seat 3: cn_chayanne ($133.03 in chips) 
Seat 4: Bothfeld11 ($155.06 in chips) 
Seat 5: sanpidk ($102 in chips) 
Seat 6: Pacifistas ($104.93 in chips) 
Seat 7: djammusic ($74.40 in chips) 
Seat 9: matiko09 ($127.69 in chips) 
Pacifistas: posts small blind $0.50
djammusic: posts big blind $1
solbi86: sits out 
*** HOLE CARDS ***
Dealt to matiko09 [5h 9d]
matiko09: folds 
ka100pka527: folds 
RICKA16: folds 
cn_chayanne: folds 
Bothfeld11: folds 
sanpidk: raises $1.24 to $2.24
Pacifistas: raises $5.76 to $8
djammusic: folds 
sanpidk: folds 
Uncalled bet ($5.76) returned to Pacifistas
Pacifistas collected $5.48 from pot
Pacifistas: doesn't show hand 
*** SUMMARY ***
Total pot $5.48 | Rake $0 
Seat 1: ka100pka527 folded before Flop (didn't bet)
Seat 2: RICKA16 folded before Flop (didn't bet)
Seat 3: cn_chayanne folded before Flop (didn't bet)
Seat 4: Bothfeld11 folded before Flop (didn't bet)
Seat 5: sanpidk (button) folded before Flop
Seat 6: Pacifistas (small blind) collected ($5.48)
Seat 7: djammusic (big blind) folded before Flop
Seat 9: matiko09 folded before Flop (didn't bet)





PokerStars Hand #150708367219:  Hold'em No Limit ($0.50/$1.00 USD) - 2016/03/21 17:20:12 CET [2016/03/21 12:20:12 ET]
Table 'Massalia II' 9-max Seat #3 is the button
Seat 1: Filojoes ($100 in chips) 
Seat 3: 123chambo ($170.03 in chips) 
Seat 4: OriginalTony ($97.80 in chips) 
Seat 5: Vikulja1993 ($100 in chips) 
Seat 6: Pacifistas ($107.91 in chips) 
Seat 7: flk.Dasas ($100 in chips) 
Seat 8: matiko09 ($180.88 in chips) 
Seat 9: DanishWiking ($107.96 in chips) 
OriginalTony: posts small blind $0.50
Vikulja1993: posts big blind $1
SiD11211: sits out 
Filojoes: posts the ante $0.20
123chambo: posts the ante $0.20
OriginalTony: posts the ante $0.20
Vikulja1993: posts the ante $0.20
Pacifistas: posts the ante $0.20
flk.Dasas: posts the ante $0.20
matiko09: posts the ante $0.20
DanishWiking: posts the ante $0.20
*** HOLE CARDS ***
Dealt to matiko09 [As Qs]
Pacifistas: folds 
flk.Dasas: folds 
matiko09: raises $2 to $3
DanishWiking: folds 
Filojoes: raises $6 to $9
123chambo: folds 
OriginalTony: folds 
Vikulja1993: folds 
matiko09: calls $6
*** FLOP *** [7c 6d 2d]
matiko09: checks 
Filojoes: bets $12
matiko09: folds 
Uncalled bet ($12) returned to Filojoes
Filojoes collected $20.15 from pot
Filojoes: doesn't show hand 
*** SUMMARY ***
Total pot $21.10 | Rake $0.95 
Board [7c 6d 2d]
Seat 1: Filojoes collected ($20.15)
Seat 3: 123chambo (button) folded before Flop (didn't bet)
Seat 4: OriginalTony (small blind) folded before Flop
Seat 5: Vikulja1993 (big blind) folded before Flop
Seat 6: Pacifistas folded before Flop (didn't bet)
Seat 7: flk.Dasas folded before Flop (didn't bet)
Seat 8: matiko09 folded on the Flop
Seat 9: DanishWiking folded before Flop (didn't bet)





PokerStars Hand #150708375209:  Hold'em No Limit ($0.50/$1.00 USD) - 2016/03/21 17:20:22 CET [2016/03/21 12:20:22 ET]
Table 'Hilda' 9-max Seat #3 is the button
Seat 1: djammusic ($50.43 in chips) 
Seat 2: blackmont111 ($104.59 in chips) 
Seat 3: Rikti ($42.36 in chips) 
Seat 4: Pacifistas ($109.57 in chips) 
Seat 5: solbi86 ($127.44 in chips) 
Seat 6: hemetcano ($216.96 in chips) 
Seat 7: R1aki ($110.38 in chips) 
Seat 8: sanpidk ($106.44 in chips) 
Seat 9: matiko09 ($107 in chips) 
Pacifistas: posts small blind $0.50
solbi86: posts big blind $1
*** HOLE CARDS ***
Dealt to matiko09 [Tc 4c]
hemetcano: calls $1
R1aki: folds 
sanpidk: raises $2 to $3
matiko09: folds 
djammusic: folds 
blackmont111: folds 
Rikti: folds 
Pacifistas: folds 
solbi86: raises $7 to $10
hemetcano: folds 
sanpidk: calls $7
*** FLOP *** [Js 8h Ks]
solbi86: checks 
sanpidk: checks 
*** TURN *** [Js 8h Ks] [4d]
solbi86: checks 
sanpidk: bets $14.50
solbi86: calls $14.50
*** RIVER *** [Js 8h Ks 4d] [6d]
solbi86: checks 
sanpidk: bets $32.50
solbi86: calls $32.50
*** SHOW DOWN ***
sanpidk: shows [Qh Ad] (high card Ace)
solbi86: shows [Qd Qs] (a pair of Queens)
solbi86 collected $112.70 from pot
*** SUMMARY ***
Total pot $115.50 | Rake $2.80 
Board [Js 8h Ks 4d 6d]
Seat 1: djammusic folded before Flop (didn't bet)
Seat 2: blackmont111 folded before Flop (didn't bet)
Seat 3: Rikti (button) folded before Flop (didn't bet)
Seat 4: Pacifistas (small blind) folded before Flop
Seat 5: solbi86 (big blind) showed [Qd Qs] and won ($112.70) with a pair of Queens
Seat 6: hemetcano folded before Flop
Seat 7: R1aki folded before Flop (didn't bet)
Seat 8: sanpidk showed [Qh Ad] and lost with high card Ace
Seat 9: matiko09 folded before Flop (didn't bet)





PokerStars Hand #150708375523:  Hold'em No Limit ($0.50/$1.00 USD) - 2016/03/21 17:20:23 CET [2016/03/21 12:20:23 ET]
Table 'Goberta' 9-max Seat #4 is the button
Seat 2: mycka86 ($153.12 in chips) 
Seat 3: Khaine_CM ($122.67 in chips) 
Seat 4: matiko09 ($101.25 in chips) 
Seat 5: DevilisHEyz ($51.62 in chips) 
Seat 7: Filojoes ($100 in chips) 
Seat 8: sanpidk ($103 in chips) 
DevilisHEyz: posts small blind $0.50
flk.Dasas: is sitting out 
Filojoes: posts big blind $1
*** HOLE CARDS ***
Dealt to matiko09 [Qh 3s]
sanpidk: raises $2 to $3
flk.Dasas leaves the table
mycka86: folds 
Khaine_CM: folds 
moffo13 joins the table at seat #6 
matiko09: folds 
DevilisHEyz: folds 
Filojoes: folds 
Uncalled bet ($2) returned to sanpidk
sanpidk collected $2.50 from pot
sanpidk: doesn't show hand 
*** SUMMARY ***
Total pot $2.50 | Rake $0 
Seat 2: mycka86 folded before Flop (didn't bet)
Seat 3: Khaine_CM folded before Flop (didn't bet)
Seat 4: matiko09 (button) folded before Flop (didn't bet)
Seat 5: DevilisHEyz (small blind) folded before Flop
Seat 7: Filojoes (big blind) folded before Flop
Seat 8: sanpidk collected ($2.50)





PokerStars Hand #150708381494:  Hold'em No Limit ($0.50/$1.00 USD) - 2016/03/21 17:20:31 CET [2016/03/21 12:20:31 ET]
Table 'Marmulla II' 9-max Seat #4 is the button
Seat 3: Vikulja1993 ($134 in chips) 
Seat 4: Dachish ($83.23 in chips) 
Seat 5: maaaGik88 ($70.97 in chips) 
Seat 6: R1aki ($131.64 in chips) 
Seat 7: Pacifistas ($114.10 in chips) 
Seat 8: sanpidk ($100 in chips) 
Seat 9: matiko09 ($100 in chips) 
maaaGik88: posts small blind $0.50
R1aki: posts big blind $1
flk.Dasas: sits out 
*** HOLE CARDS ***
Dealt to matiko09 [Kd 2d]
Pacifistas: folds 
sanpidk: folds 
matiko09: folds 
Vikulja1993: raises $1.50 to $2.50
Dachish: folds 
maaaGik88: calls $2
R1aki: folds 
*** FLOP *** [7d 6s Jh]
maaaGik88: bets $2
Vikulja1993: folds 
Uncalled bet ($2) returned to maaaGik88
maaaGik88 collected $5.73 from pot
maaaGik88: doesn't show hand 
*** SUMMARY ***
Total pot $6 | Rake $0.27 
Board [7d 6s Jh]
Seat 3: Vikulja1993 folded on the Flop
Seat 4: Dachish (button) folded before Flop (didn't bet)
Seat 5: maaaGik88 (small blind) collected ($5.73)
Seat 6: R1aki (big blind) folded before Flop
Seat 7: Pacifistas folded before Flop (didn't bet)
Seat 8: sanpidk folded before Flop (didn't bet)
Seat 9: matiko09 folded before Flop (didn't bet)





PokerStars Hand #150708386939:  Hold'em No Limit ($0.50/$1.00 USD) - 2016/03/21 17:20:38 CET [2016/03/21 12:20:38 ET]
Table 'Goberta' 9-max Seat #5 is the button
Seat 2: mycka86 ($153.12 in chips) 
Seat 3: Khaine_CM ($122.67 in chips) 
Seat 4: matiko09 ($101.25 in chips) 
Seat 5: DevilisHEyz ($51.12 in chips) 
Seat 7: Filojoes ($100 in chips) 
Seat 8: sanpidk ($104.50 in chips) 
moffo13 will be allowed to play after the button
Filojoes: posts small blind $0.50
sanpidk: posts big blind $1
*** HOLE CARDS ***
Dealt to matiko09 [Qh Jh]
mycka86: raises $2 to $3
Khaine_CM: folds 
matiko09: calls $3
DevilisHEyz: calls $3
Filojoes: calls $2.50
sanpidk: calls $2
*** FLOP *** [7c 6d 2d]
Filojoes: checks 
sanpidk: checks 
mycka86: checks 
matiko09: checks 
DevilisHEyz: bets $14.32
Filojoes: folds 
sanpidk: folds 
mycka86: folds 
matiko09: folds 
Uncalled bet ($14.32) returned to DevilisHEyz
DevilisHEyz collected $14.32 from pot
*** SUMMARY ***
Total pot $15 | Rake $0.68 
Board [7c 6d 2d]
Seat 2: mycka86 folded on the Flop
Seat 3: Khaine_CM folded before Flop (didn't bet)
Seat 4: matiko09 folded on the Flop
Seat 5: DevilisHEyz (button) collected ($14.32)
Seat 7: Filojoes (small blind) folded on the Flop
Seat 8: sanpidk (big blind) folded on the Flop





PokerStars Hand #150708390595:  Hold'em No Limit (€0.25/€0.50 EUR) - 2016/03/21 17:20:42 CET [2016/03/21 12:20:42 ET]
Table 'Auravictrix II' 9-max Seat #2 is the button
Seat 1: Al3xAnd3r22 (€50 in chips) 
Seat 2: HeroWok (€61.51 in chips) 
Seat 3: matiko09 (€54.03 in chips) 
Seat 5: ffac (€50 in chips) 
Seat 7: vasiy379 (€50 in chips) 
Seat 8: nombraalne1 (€69.91 in chips) 
Seat 9: carlouchi (€46.36 in chips) 
matiko09: posts small blind €0.25
beluccix: is sitting out 
beluccix leaves the table
ffac: posts big blind €0.50
lysandrafly: sits out 
*** HOLE CARDS ***
Dealt to matiko09 [9h 3s]
vasiy379: folds 
nombraalne1: folds 
carlouchi: raises €0.50 to €1
Al3xAnd3r22: folds 
HeroWok: folds 
HeroWok leaves the table
matiko09: folds 
ffac: folds 
Uncalled bet (€0.50) returned to carlouchi
carlouchi collected €1.25 from pot
carlouchi: doesn't show hand 
*** SUMMARY ***
Total pot €1.25 | Rake €0 
Seat 1: Al3xAnd3r22 folded before Flop (didn't bet)
Seat 2: HeroWok (button) folded before Flop (didn't bet)
Seat 3: matiko09 (small blind) folded before Flop
Seat 5: ffac (big blind) folded before Flop
Seat 7: vasiy379 folded before Flop (didn't bet)
Seat 8: nombraalne1 folded before Flop (didn't bet)
Seat 9: carlouchi collected (€1.25)





PokerStars Hand #150708399718:  Hold'em No Limit ($0.50/$1.00 USD) - 2016/03/21 17:20:54 CET [2016/03/21 12:20:54 ET]
Table 'Massalia II' 9-max Seat #4 is the button
Seat 1: Filojoes ($110.95 in chips) 
Seat 3: 123chambo ($169.83 in chips) 
Seat 4: OriginalTony ($97.10 in chips) 
Seat 5: Vikulja1993 ($100 in chips) 
Seat 6: Pacifistas ($107.71 in chips) 
Seat 7: flk.Dasas ($100 in chips) 
Seat 8: matiko09 ($171.68 in chips) 
Seat 9: DanishWiking ($107.76 in chips) 
Vikulja1993: posts small blind $0.50
Pacifistas: posts big blind $1
SiD11211: sits out 
Filojoes: posts the ante $0.20
123chambo: posts the ante $0.20
OriginalTony: posts the ante $0.20
Vikulja1993: posts the ante $0.20
Pacifistas: posts the ante $0.20
flk.Dasas: posts the ante $0.20
matiko09: posts the ante $0.20
DanishWiking: posts the ante $0.20
*** HOLE CARDS ***
Dealt to matiko09 [Jc As]
flk.Dasas: folds 
matiko09: raises $2 to $3
DanishWiking: folds 
Filojoes: raises $6 to $9
123chambo: folds 
OriginalTony: folds 
Vikulja1993: folds 
Pacifistas: raises $11 to $20
matiko09: folds 
Filojoes: raises $90.75 to $110.75 and is all-in
Pacifistas: calls $87.51 and is all-in
Uncalled bet ($3.24) returned to Filojoes
*** FIRST FLOP *** [3s 5s 4c]
*** FIRST TURN *** [3s 5s 4c] [Td]
*** FIRST RIVER *** [3s 5s 4c Td] [Ad]
*** SECOND FLOP *** [9d 2c Jh]
*** SECOND TURN *** [9d 2c Jh] [4s]
*** SECOND RIVER *** [9d 2c Jh 4s] [Kd]
*** FIRST SHOW DOWN ***
Pacifistas: shows [Qs Qh] (a pair of Queens)
Filojoes: shows [Qc Qd] (a pair of Queens)
Pacifistas collected $54.33 from pot
Filojoes collected $54.33 from pot
*** SECOND SHOW DOWN ***
Pacifistas: shows [Qs Qh] (a pair of Queens)
Filojoes: shows [Qc Qd] (a pair of Queens)
Pacifistas collected $54.33 from pot
Filojoes collected $54.33 from pot
*** SUMMARY ***
Total pot $220.12 | Rake $2.80 
Hand was run twice
FIRST Board [3s 5s 4c Td Ad]
SECOND Board [9d 2c Jh 4s Kd]
Seat 1: Filojoes showed [Qc Qd] and won ($54.33) with a pair of Queens, and won ($54.33) with a pair of Queens
Seat 3: 123chambo folded before Flop (didn't bet)
Seat 4: OriginalTony (button) folded before Flop (didn't bet)
Seat 5: Vikulja1993 (small blind) folded before Flop
Seat 6: Pacifistas (big blind) showed [Qs Qh] and won ($54.33) with a pair of Queens, and won ($54.33) with a pair of Queens
Seat 7: flk.Dasas folded before Flop (didn't bet)
Seat 8: matiko09 folded before Flop
Seat 9: DanishWiking folded before Flop (didn't bet)





PokerStars Hand #150708401068:  Hold'em No Limit ($0.50/$1.00 USD) - 2016/03/21 17:20:56 CET [2016/03/21 12:20:56 ET]
Table 'Onnie II' 9-max Seat #6 is the button
Seat 1: ka100pka527 ($120.57 in chips) 
Seat 2: RICKA16 ($100 in chips) 
Seat 3: cn_chayanne ($133.03 in chips) 
Seat 4: Bothfeld11 ($155.06 in chips) 
Seat 5: sanpidk ($100 in chips) 
Seat 6: Pacifistas ($108.17 in chips) 
Seat 7: djammusic ($73.40 in chips) 
Seat 8: solbi86 ($100 in chips) 
Seat 9: matiko09 ($127.69 in chips) 
djammusic: posts small blind $0.50
solbi86: posts big blind $1
*** HOLE CARDS ***
Dealt to matiko09 [6c 9h]
matiko09: folds 
ka100pka527: raises $2 to $3
RICKA16: folds 
cn_chayanne: folds 
Bothfeld11: folds 
sanpidk: folds 
Pacifistas: folds 
djammusic: folds 
solbi86: folds 
Uncalled bet ($2) returned to ka100pka527
ka100pka527 collected $2.50 from pot
ka100pka527: doesn't show hand 
*** SUMMARY ***
Total pot $2.50 | Rake $0 
Seat 1: ka100pka527 collected ($2.50)
Seat 2: RICKA16 folded before Flop (didn't bet)
Seat 3: cn_chayanne folded before Flop (didn't bet)
Seat 4: Bothfeld11 folded before Flop (didn't bet)
Seat 5: sanpidk folded before Flop (didn't bet)
Seat 6: Pacifistas (button) folded before Flop (didn't bet)
Seat 7: djammusic (small blind) folded before Flop
Seat 8: solbi86 (big blind) folded before Flop
Seat 9: matiko09 folded before Flop (didn't bet)





PokerStars Hand #150708407785:  Hold'em No Limit (€0.25/€0.50 EUR) - 2016/03/21 17:21:05 CET [2016/03/21 12:21:05 ET]
Table 'Auravictrix II' 9-max Seat #3 is the button
Seat 1: Al3xAnd3r22 (€50 in chips) 
Seat 3: matiko09 (€53.78 in chips) 
Seat 5: ffac (€50 in chips) 
Seat 6: lysandrafly (€50 in chips) 
Seat 7: vasiy379 (€50 in chips) 
Seat 8: nombraalne1 (€69.91 in chips) 
Seat 9: carlouchi (€47.11 in chips) 
ffac: posts small blind €0.25
lysandrafly: posts big blind €0.50
*** HOLE CARDS ***
Dealt to matiko09 [Kc 9h]
vasiy379: raises €1 to €1.50
nombraalne1: folds 
carlouchi: folds 
RvPersie joins the table at seat #4 
Al3xAnd3r22: folds 
matiko09: folds 
ffac: folds 
lysandrafly: folds 
Uncalled bet (€1) returned to vasiy379
vasiy379 collected €1.25 from pot
vasiy379: doesn't show hand 
*** SUMMARY ***
Total pot €1.25 | Rake €0 
Seat 1: Al3xAnd3r22 folded before Flop (didn't bet)
Seat 3: matiko09 (button) folded before Flop (didn't bet)
Seat 5: ffac (small blind) folded before Flop
Seat 6: lysandrafly (big blind) folded before Flop
Seat 7: vasiy379 collected (€1.25)
Seat 8: nombraalne1 folded before Flop (didn't bet)
Seat 9: carlouchi folded before Flop (didn't bet)





PokerStars Hand #150708424992:  Hold'em No Limit ($0.50/$1.00 USD) - 2016/03/21 17:21:27 CET [2016/03/21 12:21:27 ET]
Table 'Onnie II' 9-max Seat #7 is the button
Seat 1: ka100pka527 ($122.07 in chips) 
Seat 2: RICKA16 ($100 in chips) 
Seat 3: cn_chayanne ($133.03 in chips) 
Seat 4: Bothfeld11 ($155.06 in chips) 
Seat 5: sanpidk ($100 in chips) 
Seat 6: Pacifistas ($108.17 in chips) 
Seat 7: djammusic ($72.90 in chips) 
Seat 8: solbi86 ($100 in chips) 
Seat 9: matiko09 ($127.69 in chips) 
solbi86: posts small blind $0.50
matiko09: posts big blind $1
*** HOLE CARDS ***
Dealt to matiko09 [3h 2c]
ka100pka527: folds 
RICKA16: folds 
cn_chayanne: folds 
Bothfeld11: calls $1
sanpidk: folds 
Pacifistas has timed out
Pacifistas: folds 
djammusic: folds 
solbi86: folds 
matiko09: checks 
*** FLOP *** [8h Ad Kd]
matiko09: checks 
Bothfeld11: checks 
*** TURN *** [8h Ad Kd] [5s]
matiko09: checks 
Bothfeld11: checks 
*** RIVER *** [8h Ad Kd 5s] [4s]
matiko09: bets $2
Bothfeld11: folds 
Uncalled bet ($2) returned to matiko09
matiko09 collected $2.39 from pot
matiko09: doesn't show hand 
*** SUMMARY ***
Total pot $2.50 | Rake $0.11 
Board [8h Ad Kd 5s 4s]
Seat 1: ka100pka527 folded before Flop (didn't bet)
Seat 2: RICKA16 folded before Flop (didn't bet)
Seat 3: cn_chayanne folded before Flop (didn't bet)
Seat 4: Bothfeld11 folded on the River
Seat 5: sanpidk folded before Flop (didn't bet)
Seat 6: Pacifistas folded before Flop (didn't bet)
Seat 7: djammusic (button) folded before Flop (didn't bet)
Seat 8: solbi86 (small blind) folded before Flop
Seat 9: matiko09 (big blind) collected ($2.39)





PokerStars Hand #150708426077:  Hold'em No Limit (€0.25/€0.50 EUR) - 2016/03/21 17:21:29 CET [2016/03/21 12:21:29 ET]
Table 'Auravictrix II' 9-max Seat #5 is the button
Seat 1: Al3xAnd3r22 (€50 in chips) 
Seat 3: matiko09 (€53.78 in chips) 
Seat 5: ffac (€50 in chips) 
Seat 6: lysandrafly (€50 in chips) 
Seat 9: carlouchi (€47.11 in chips) 
lysandrafly: posts small blind €0.25
vasiy379: is sitting out 
nombraalne1: is sitting out 
carlouchi: posts big blind €0.50
*** HOLE CARDS ***
Dealt to matiko09 [Tc 7h]
RvPersie leaves the table
vasiy379 leaves the table
Al3xAnd3r22: raises €1 to €1.50
matiko09: folds 
ffac: folds 
nombraalne1 leaves the table
lysandrafly: folds 
carlouchi: folds 
Uncalled bet (€1) returned to Al3xAnd3r22
Al3xAnd3r22 collected €1.25 from pot
Al3xAnd3r22: doesn't show hand 
*** SUMMARY ***
Total pot €1.25 | Rake €0 
Seat 1: Al3xAnd3r22 collected (€1.25)
Seat 3: matiko09 folded before Flop (didn't bet)
Seat 5: ffac (button) folded before Flop (didn't bet)
Seat 6: lysandrafly (small blind) folded before Flop
Seat 9: carlouchi (big blind) folded before Flop





PokerStars Hand #150708439399:  Hold'em No Limit ($0.50/$1.00 USD) - 2016/03/21 17:21:46 CET [2016/03/21 12:21:46 ET]
Table 'Marmulla II' 9-max Seat #5 is the button
Seat 3: Vikulja1993 ($131.50 in chips) 
Seat 4: Dachish ($83.23 in chips) 
Seat 5: maaaGik88 ($74.20 in chips) 
Seat 6: R1aki ($130.64 in chips) 
Seat 7: Pacifistas ($114.10 in chips) 
Seat 8: sanpidk ($100 in chips) 
Seat 9: matiko09 ($100 in chips) 
R1aki: posts small blind $0.50
Pacifistas: posts big blind $1
flk.Dasas: sits out 
*** HOLE CARDS ***
Dealt to matiko09 [Kh Kc]
sanpidk: folds 
matiko09: raises $2 to $3
Vikulja1993: folds 
Dachish: folds 
maaaGik88: folds 
R1aki: folds 
Pacifistas: folds 
Uncalled bet ($2) returned to matiko09
matiko09 collected $2.50 from pot
matiko09: doesn't show hand 
*** SUMMARY ***
Total pot $2.50 | Rake $0 
Seat 3: Vikulja1993 folded before Flop (didn't bet)
Seat 4: Dachish folded before Flop (didn't bet)
Seat 5: maaaGik88 (button) folded before Flop (didn't bet)
Seat 6: R1aki (small blind) folded before Flop
Seat 7: Pacifistas (big blind) folded before Flop
Seat 8: sanpidk folded before Flop (didn't bet)
Seat 9: matiko09 collected ($2.50)





PokerStars Hand #150708444515:  Hold'em No Limit ($0.50/$1.00 USD) - 2016/03/21 17:21:53 CET [2016/03/21 12:21:53 ET]
Table 'Goberta' 9-max Seat #7 is the button
Seat 2: mycka86 ($150.12 in chips) 
Seat 3: Khaine_CM ($122.67 in chips) 
Seat 4: matiko09 ($100 in chips) 
Seat 5: DevilisHEyz ($62.44 in chips) 
Seat 7: Filojoes ($100 in chips) 
Seat 8: sanpidk ($101.50 in chips) 
Seat 9: blakenjaime ($80.18 in chips) 
sanpidk: posts small blind $0.50
blakenjaime: posts big blind $1
moffo13: sits out 
*** HOLE CARDS ***
Dealt to matiko09 [9c Jd]
mycka86: folds 
Khaine_CM: raises $2 to $3
matiko09: folds 
DevilisHEyz: calls $3
Filojoes: folds 
sanpidk: folds 
blakenjaime: folds 
*** FLOP *** [Kh 8c 3s]
Khaine_CM: bets $4
DevilisHEyz: folds 
Uncalled bet ($4) returned to Khaine_CM
Khaine_CM collected $7.16 from pot
Khaine_CM: doesn't show hand 
*** SUMMARY ***
Total pot $7.50 | Rake $0.34 
Board [Kh 8c 3s]
Seat 2: mycka86 folded before Flop (didn't bet)
Seat 3: Khaine_CM collected ($7.16)
Seat 4: matiko09 folded before Flop (didn't bet)
Seat 5: DevilisHEyz folded on the Flop
Seat 7: Filojoes (button) folded before Flop (didn't bet)
Seat 8: sanpidk (small blind) folded before Flop
Seat 9: blakenjaime (big blind) folded before Flop





PokerStars Hand #150708445723:  Hold'em No Limit (€0.25/€0.50 EUR) - 2016/03/21 17:21:54 CET [2016/03/21 12:21:54 ET]
Table 'Auravictrix II' 9-max Seat #6 is the button
Seat 3: matiko09 (€53.78 in chips) 
Seat 5: ffac (€50 in chips) 
Seat 6: lysandrafly (€50 in chips) 
Seat 9: carlouchi (€46.61 in chips) 
carlouchi: posts small blind €0.25
Al3xAnd3r22: is sitting out 
matiko09: posts big blind €0.50
*** HOLE CARDS ***
Dealt to matiko09 [9c Td]
Al3xAnd3r22 leaves the table
ffac: folds 
lysandrafly: folds 
lysandrafly leaves the table
carlouchi: folds 
Uncalled bet (€0.25) returned to matiko09
matiko09 collected €0.50 from pot
matiko09: doesn't show hand 
*** SUMMARY ***
Total pot €0.50 | Rake €0 
Seat 3: matiko09 (big blind) collected (€0.50)
Seat 5: ffac folded before Flop (didn't bet)
Seat 6: lysandrafly (button) folded before Flop (didn't bet)
Seat 9: carlouchi (small blind) folded before Flop





PokerStars Hand #150708451898:  Hold'em No Limit (€0.50/€1.00 EUR) - 2016/03/21 17:22:02 CET [2016/03/21 12:22:02 ET]
Table 'Anhui' 9-max Seat #6 is the button
Seat 4: cobrik23 (€98.08 in chips) 
Seat 5: filiplost (€83.56 in chips) 
Seat 6: R1aki (€101 in chips) 
Seat 7: lysandrafly (€100 in chips) 
Seat 8: matiko09 (€100 in chips) 
lysandrafly: posts small blind €0.50
matiko09: posts big blind €1
ceedonen: sits out 
ardo888: sits out 
*** HOLE CARDS ***
Dealt to matiko09 [2s Js]
cobrik23: folds 
filiplost: folds 
R1aki: folds 
Pearl Jam87 joins the table at seat #2 
lysandrafly: folds 
Uncalled bet (€0.50) returned to matiko09
matiko09 collected €1 from pot
matiko09: doesn't show hand 
*** SUMMARY ***
Total pot €1 | Rake €0 
Seat 4: cobrik23 folded before Flop (didn't bet)
Seat 5: filiplost folded before Flop (didn't bet)
Seat 6: R1aki (button) folded before Flop (didn't bet)
Seat 7: lysandrafly (small blind) folded before Flop
Seat 8: matiko09 (big blind) collected (€1)





PokerStars Hand #150708453961:  Hold'em No Limit (€0.25/€0.50 EUR) - 2016/03/21 17:22:05 CET [2016/03/21 12:22:05 ET]
Table 'Auravictrix II' 9-max Seat #3 is the button
Seat 3: matiko09 (€54.03 in chips) 
Seat 9: carlouchi (€46.36 in chips) 
matiko09: posts small blind €0.25
ffac: is sitting out 
carlouchi: posts big blind €0.50
*** HOLE CARDS ***
Dealt to matiko09 [Kd 6d]
matiko09: raises €0.75 to €1.25
carlouchi: folds 
Uncalled bet (€0.75) returned to matiko09
Al3xAnd3r22 joins the table at seat #4 
matiko09 collected €1 from pot
matiko09: doesn't show hand 
ffac leaves the table
*** SUMMARY ***
Total pot €1 | Rake €0 
Seat 3: matiko09 (button) (small blind) collected (€1)
Seat 9: carlouchi (big blind) folded before Flop





PokerStars Hand #150708462313:  Hold'em No Limit (€0.25/€0.50 EUR) - 2016/03/21 17:22:16 CET [2016/03/21 12:22:16 ET]
Table 'Auravictrix II' 9-max Seat #9 is the button
Seat 3: matiko09 (€54.53 in chips) 
Seat 9: carlouchi (€45.86 in chips) 
carlouchi: posts small blind €0.25
matiko09: posts big blind €0.50
*** HOLE CARDS ***
Dealt to matiko09 [Kd 6d]
carlouchi: folds 
Uncalled bet (€0.25) returned to matiko09
matiko09 collected €0.50 from pot
matiko09: doesn't show hand 
*** SUMMARY ***
Total pot €0.50 | Rake €0 
Seat 3: matiko09 (big blind) collected (€0.50)
Seat 9: carlouchi (button) (small blind) folded before Flop





PokerStars Hand #150708466353:  Hold'em No Limit ($0.50/$1.00 USD) - 2016/03/21 17:22:21 CET [2016/03/21 12:22:21 ET]
Table 'Hilda' 9-max Seat #4 is the button
Seat 1: djammusic ($50.43 in chips) 
Seat 2: blackmont111 ($104.59 in chips) 
Seat 3: Rikti ($42.36 in chips) 
Seat 4: Pacifistas ($109.07 in chips) 
Seat 5: solbi86 ($183.14 in chips) 
Seat 6: hemetcano ($215.96 in chips) 
Seat 7: R1aki ($110.38 in chips) 
Seat 8: sanpidk ($100 in chips) 
Seat 9: matiko09 ($107 in chips) 
solbi86: posts small blind $0.50
hemetcano: posts big blind $1
*** HOLE CARDS ***
Dealt to matiko09 [5h Kh]
R1aki: folds 
sanpidk: folds 
matiko09: folds 
djammusic: raises $1.50 to $2.50
blackmont111: folds 
Rikti: folds 
Pacifistas: folds 
solbi86: folds 
hemetcano: calls $1.50
*** FLOP *** [7d Jh Js]
hemetcano: checks 
djammusic: checks 
*** TURN *** [7d Jh Js] [As]
hemetcano: bets $1
djammusic: raises $3 to $4
hemetcano: folds 
Uncalled bet ($3) returned to djammusic
djammusic collected $7.16 from pot
djammusic: doesn't show hand 
*** SUMMARY ***
Total pot $7.50 | Rake $0.34 
Board [7d Jh Js As]
Seat 1: djammusic collected ($7.16)
Seat 2: blackmont111 folded before Flop (didn't bet)
Seat 3: Rikti folded before Flop (didn't bet)
Seat 4: Pacifistas (button) folded before Flop (didn't bet)
Seat 5: solbi86 (small blind) folded before Flop
Seat 6: hemetcano (big blind) folded on the Turn
Seat 7: R1aki folded before Flop (didn't bet)
Seat 8: sanpidk folded before Flop (didn't bet)
Seat 9: matiko09 folded before Flop (didn't bet)





PokerStars Hand #150708468538:  Hold'em No Limit (€0.50/€1.00 EUR) - 2016/03/21 17:22:24 CET [2016/03/21 12:22:24 ET]
Table 'Anhui' 9-max Seat #7 is the button
Seat 4: cobrik23 (€98.08 in chips) 
Seat 5: filiplost (€83.56 in chips) 
Seat 6: R1aki (€101 in chips) 
Seat 7: lysandrafly (€100 in chips) 
Seat 8: matiko09 (€100.50 in chips) 
Seat 9: ceedonen (€100 in chips) 
matiko09: posts small blind €0.50
ceedonen: posts big blind €1
ardo888: sits out 
Pearl Jam87: sits out 
*** HOLE CARDS ***
Dealt to matiko09 [8d Ac]
cobrik23: raises €1.50 to €2.50
filiplost: folds 
R1aki: folds 
filiplost leaves the table
lysandrafly: folds 
matiko09: folds 
ceedonen: folds 
Uncalled bet (€1.50) returned to cobrik23
cobrik23 collected €2.50 from pot
cobrik23: doesn't show hand 
*** SUMMARY ***
Total pot €2.50 | Rake €0 
Seat 4: cobrik23 collected (€2.50)
Seat 5: filiplost folded before Flop (didn't bet)
Seat 6: R1aki folded before Flop (didn't bet)
Seat 7: lysandrafly (button) folded before Flop (didn't bet)
Seat 8: matiko09 (small blind) folded before Flop
Seat 9: ceedonen (big blind) folded before Flop





PokerStars Hand #150708470327:  Hold'em No Limit (€0.25/€0.50 EUR) - 2016/03/21 17:22:27 CET [2016/03/21 12:22:27 ET]
Table 'Auravictrix II' 9-max Seat #9 is the button
Seat 3: matiko09 (€54.78 in chips) 
Seat 4: Al3xAnd3r22 (€50.75 in chips) 
Seat 9: carlouchi (€45.61 in chips) 
matiko09: posts small blind €0.25
Al3xAnd3r22: posts big blind €0.50
*** HOLE CARDS ***
Dealt to matiko09 [Js 8d]
carlouchi: folds 
carlouchi leaves the table
matiko09: folds 
Uncalled bet (€0.25) returned to Al3xAnd3r22
Al3xAnd3r22 collected €0.50 from pot
Al3xAnd3r22: doesn't show hand 
*** SUMMARY ***
Total pot €0.50 | Rake €0 
Seat 3: matiko09 (small blind) folded before Flop
Seat 4: Al3xAnd3r22 (big blind) collected (€0.50)
Seat 9: carlouchi (button) folded before Flop (didn't bet)





PokerStars Hand #150708484470:  Hold'em No Limit ($0.50/$1.00 USD) - 2016/03/21 17:22:45 CET [2016/03/21 12:22:45 ET]
Table 'Goberta' 9-max Seat #8 is the button
Seat 2: mycka86 ($150.12 in chips) 
Seat 3: Khaine_CM ($126.83 in chips) 
Seat 4: matiko09 ($100 in chips) 
Seat 5: DevilisHEyz ($59.44 in chips) 
Seat 7: Filojoes ($100 in chips) 
Seat 8: sanpidk ($101 in chips) 
Seat 9: blakenjaime ($79.18 in chips) 
blakenjaime: posts small blind $0.50
mycka86: posts big blind $1
moffo13: sits out 
*** HOLE CARDS ***
Dealt to matiko09 [4h 5h]
Khaine_CM: folds 
matiko09: folds 
DevilisHEyz: folds 
Filojoes: raises $1.50 to $2.50
sanpidk: folds 
blakenjaime: folds 
mycka86: folds 
Uncalled bet ($1.50) returned to Filojoes
Filojoes collected $2.50 from pot
Filojoes: doesn't show hand 
*** SUMMARY ***
Total pot $2.50 | Rake $0 
Seat 2: mycka86 (big blind) folded before Flop
Seat 3: Khaine_CM folded before Flop (didn't bet)
Seat 4: matiko09 folded before Flop (didn't bet)
Seat 5: DevilisHEyz folded before Flop (didn't bet)
Seat 7: Filojoes collected ($2.50)
Seat 8: sanpidk (button) folded before Flop (didn't bet)
Seat 9: blakenjaime (small blind) folded before Flop





PokerStars Hand #150708485850:  Hold'em No Limit ($0.50/$1.00 USD) - 2016/03/21 17:22:47 CET [2016/03/21 12:22:47 ET]
Table 'Marmulla II' 9-max Seat #6 is the button
Seat 3: Vikulja1993 ($131.50 in chips) 
Seat 4: Dachish ($83.23 in chips) 
Seat 5: maaaGik88 ($74.20 in chips) 
Seat 6: R1aki ($130.14 in chips) 
Seat 7: Pacifistas ($113.10 in chips) 
Seat 8: sanpidk ($100 in chips) 
Seat 9: matiko09 ($101.50 in chips) 
Pacifistas: posts small blind $0.50
sanpidk: posts big blind $1
flk.Dasas: sits out 
*** HOLE CARDS ***
Dealt to matiko09 [7h 8c]
matiko09: folds 
Vikulja1993: folds 
Dachish: raises $2 to $3
maaaGik88: folds 
R1aki: folds 
Pacifistas: folds 
sanpidk: folds 
Uncalled bet ($2) returned to Dachish
Dachish collected $2.50 from pot
Dachish: doesn't show hand 
*** SUMMARY ***
Total pot $2.50 | Rake $0 
Seat 3: Vikulja1993 folded before Flop (didn't bet)
Seat 4: Dachish collected ($2.50)
Seat 5: maaaGik88 folded before Flop (didn't bet)
Seat 6: R1aki (button) folded before Flop (didn't bet)
Seat 7: Pacifistas (small blind) folded before Flop
Seat 8: sanpidk (big blind) folded before Flop
Seat 9: matiko09 folded before Flop (didn't bet)





PokerStars Hand #150708486494:  Hold'em No Limit (€0.50/€1.00 EUR) - 2016/03/21 17:22:48 CET [2016/03/21 12:22:48 ET]
Table 'Anhui' 9-max Seat #8 is the button
Seat 1: ardo888 (€100 in chips) 
Seat 4: cobrik23 (€99.58 in chips) 
Seat 6: R1aki (€101 in chips) 
Seat 7: lysandrafly (€100 in chips) 
Seat 8: matiko09 (€100 in chips) 
Seat 9: ceedonen (€100 in chips) 
ceedonen: posts small blind €0.50
ardo888: posts big blind €1
Pearl Jam87: sits out 
*** HOLE CARDS ***
Dealt to matiko09 [Ac Qh]
cobrik23: folds 
R1aki: folds 
Pearl Jam87 leaves the table
lysandrafly: folds 
matiko09: raises €1.27 to €2.27
ceedonen: folds 
ardo888: folds 
Uncalled bet (€1.27) returned to matiko09
matiko09 collected €2.50 from pot
matiko09: doesn't show hand 
*** SUMMARY ***
Total pot €2.50 | Rake €0 
Seat 1: ardo888 (big blind) folded before Flop
Seat 4: cobrik23 folded before Flop (didn't bet)
Seat 6: R1aki folded before Flop (didn't bet)
Seat 7: lysandrafly folded before Flop (didn't bet)
Seat 8: matiko09 (button) collected (€2.50)
Seat 9: ceedonen (small blind) folded before Flop





PokerStars Hand #150708489422:  Hold'em No Limit ($0.50/$1.00 USD) - 2016/03/21 17:22:52 CET [2016/03/21 12:22:52 ET]
Table 'Massalia II' 9-max Seat #5 is the button
Seat 1: Filojoes ($111.90 in chips) 
Seat 3: 123chambo ($169.63 in chips) 
Seat 4: OriginalTony ($96.90 in chips) 
Seat 5: Vikulja1993 ($100 in chips) 
Seat 6: Pacifistas ($108.66 in chips) 
Seat 7: flk.Dasas ($100 in chips) 
Seat 8: matiko09 ($168.48 in chips) 
Seat 9: DanishWiking ($107.56 in chips) 
Pacifistas: posts small blind $0.50
flk.Dasas: posts big blind $1
SiD11211: sits out 
Filojoes: posts the ante $0.20
123chambo: posts the ante $0.20
OriginalTony: posts the ante $0.20
Vikulja1993: posts the ante $0.20
Pacifistas: posts the ante $0.20
flk.Dasas: posts the ante $0.20
matiko09: posts the ante $0.20
DanishWiking: posts the ante $0.20
*** HOLE CARDS ***
Dealt to matiko09 [2c 4s]
matiko09: folds 
DanishWiking: folds 
OriginalTony said, "lol"
Filojoes: raises $2 to $3
123chambo: folds 
OriginalTony: folds 
Vikulja1993: folds 
Pacifistas: folds 
flk.Dasas: folds 
Uncalled bet ($2) returned to Filojoes
Filojoes collected $4.10 from pot
Filojoes: doesn't show hand 
*** SUMMARY ***
Total pot $4.10 | Rake $0 
Seat 1: Filojoes collected ($4.10)
Seat 3: 123chambo folded before Flop (didn't bet)
Seat 4: OriginalTony folded before Flop (didn't bet)
Seat 5: Vikulja1993 (button) folded before Flop (didn't bet)
Seat 6: Pacifistas (small blind) folded before Flop
Seat 7: flk.Dasas (big blind) folded before Flop
Seat 8: matiko09 folded before Flop (didn't bet)
Seat 9: DanishWiking folded before Flop (didn't bet)





PokerStars Hand #150708500073:  Hold'em No Limit ($0.50/$1.00 USD) - 2016/03/21 17:23:05 CET [2016/03/21 12:23:05 ET]
Table 'Massalia II' 9-max Seat #6 is the button
Seat 1: Filojoes ($114.80 in chips) 
Seat 3: 123chambo ($169.43 in chips) 
Seat 4: OriginalTony ($96.70 in chips) 
Seat 5: Vikulja1993 ($100 in chips) 
Seat 6: Pacifistas ($107.96 in chips) 
Seat 7: flk.Dasas ($100 in chips) 
Seat 8: matiko09 ($168.28 in chips) 
Seat 9: DanishWiking ($107.36 in chips) 
flk.Dasas: posts small blind $0.50
matiko09: posts big blind $1
SiD11211: sits out 
Filojoes: posts the ante $0.20
123chambo: posts the ante $0.20
OriginalTony: posts the ante $0.20
Vikulja1993: posts the ante $0.20
Pacifistas: posts the ante $0.20
flk.Dasas: posts the ante $0.20
matiko09: posts the ante $0.20
DanishWiking: posts the ante $0.20
*** HOLE CARDS ***
Dealt to matiko09 [4s 5s]
DanishWiking: folds 
Filojoes: folds 
123chambo: folds 
OriginalTony: folds 
Vikulja1993: raises $1.50 to $2.50
Pacifistas: folds 
flk.Dasas: folds 
matiko09: folds 
Uncalled bet ($1.50) returned to Vikulja1993
Vikulja1993 collected $4.10 from pot
Vikulja1993: doesn't show hand 
*** SUMMARY ***
Total pot $4.10 | Rake $0 
Seat 1: Filojoes folded before Flop (didn't bet)
Seat 3: 123chambo folded before Flop (didn't bet)
Seat 4: OriginalTony folded before Flop (didn't bet)
Seat 5: Vikulja1993 collected ($4.10)
Seat 6: Pacifistas (button) folded before Flop (didn't bet)
Seat 7: flk.Dasas (small blind) folded before Flop
Seat 8: matiko09 (big blind) folded before Flop
Seat 9: DanishWiking folded before Flop (didn't bet)





PokerStars Hand #150708501646:  Hold'em No Limit ($0.50/$1.00 USD) - 2016/03/21 17:23:07 CET [2016/03/21 12:23:07 ET]
Table 'Onnie II' 9-max Seat #8 is the button
Seat 1: ka100pka527 ($122.07 in chips) 
Seat 2: RICKA16 ($100 in chips) 
Seat 3: cn_chayanne ($133.03 in chips) 
Seat 4: Bothfeld11 ($154.06 in chips) 
Seat 5: sanpidk ($100 in chips) 
Seat 6: Pacifistas ($108.17 in chips) 
Seat 7: djammusic ($72.90 in chips) 
Seat 8: solbi86 ($100 in chips) 
Seat 9: matiko09 ($129.08 in chips) 
matiko09: posts small blind $0.50
ka100pka527: posts big blind $1
*** HOLE CARDS ***
Dealt to matiko09 [7s Tc]
RICKA16: folds 
cn_chayanne: folds 
Bothfeld11: folds 
sanpidk: folds 
Pacifistas: folds 
djammusic: folds 
solbi86: folds 
matiko09: folds 
Uncalled bet ($0.50) returned to ka100pka527
ka100pka527 collected $1 from pot
ka100pka527: doesn't show hand 
*** SUMMARY ***
Total pot $1 | Rake $0 
Seat 1: ka100pka527 (big blind) collected ($1)
Seat 2: RICKA16 folded before Flop (didn't bet)
Seat 3: cn_chayanne folded before Flop (didn't bet)
Seat 4: Bothfeld11 folded before Flop (didn't bet)
Seat 5: sanpidk folded before Flop (didn't bet)
Seat 6: Pacifistas folded before Flop (didn't bet)
Seat 7: djammusic folded before Flop (didn't bet)
Seat 8: solbi86 (button) folded before Flop (didn't bet)
Seat 9: matiko09 (small blind) folded before Flop





PokerStars Hand #150708506704:  Hold'em No Limit ($0.50/$1.00 USD) - 2016/03/21 17:23:14 CET [2016/03/21 12:23:14 ET]
Table 'Hilda' 9-max Seat #5 is the button
Seat 1: djammusic ($54.09 in chips) 
Seat 2: blackmont111 ($104.59 in chips) 
Seat 3: Rikti ($42.36 in chips) 
Seat 4: Pacifistas ($109.07 in chips) 
Seat 5: solbi86 ($182.64 in chips) 
Seat 6: hemetcano ($212.46 in chips) 
Seat 7: R1aki ($110.38 in chips) 
Seat 8: sanpidk ($100 in chips) 
Seat 9: matiko09 ($107 in chips) 
hemetcano: posts small blind $0.50
R1aki: posts big blind $1
*** HOLE CARDS ***
Dealt to matiko09 [Tc 7s]
sanpidk: folds 
matiko09: folds 
djammusic: folds 
blackmont111: raises $2 to $3
Rikti: folds 
Pacifistas: folds 
solbi86: folds 
hemetcano: calls $2.50
R1aki: folds 
*** FLOP *** [8s 8c 4c]
hemetcano: bets $1
blackmont111: calls $1
*** TURN *** [8s 8c 4c] [2d]
hemetcano: checks 
blackmont111: checks 
*** RIVER *** [8s 8c 4c 2d] [9d]
hemetcano: checks 
blackmont111: checks 
*** SHOW DOWN ***
hemetcano: shows [9c 3d] (two pair, Nines and Eights)
blackmont111: mucks hand 
hemetcano collected $8.60 from pot
*** SUMMARY ***
Total pot $9 | Rake $0.40 
Board [8s 8c 4c 2d 9d]
Seat 1: djammusic folded before Flop (didn't bet)
Seat 2: blackmont111 mucked [3s As]
Seat 3: Rikti folded before Flop (didn't bet)
Seat 4: Pacifistas folded before Flop (didn't bet)
Seat 5: solbi86 (button) folded before Flop (didn't bet)
Seat 6: hemetcano (small blind) showed [9c 3d] and won ($8.60) with two pair, Nines and Eights
Seat 7: R1aki (big blind) folded before Flop
Seat 8: sanpidk folded before Flop (didn't bet)
Seat 9: matiko09 folded before Flop (didn't bet)





PokerStars Hand #150708515175:  Hold'em No Limit ($0.50/$1.00 USD) - 2016/03/21 17:23:25 CET [2016/03/21 12:23:25 ET]
Table 'Goberta' 9-max Seat #9 is the button
Seat 2: mycka86 ($149.12 in chips) 
Seat 3: Khaine_CM ($126.83 in chips) 
Seat 4: matiko09 ($100 in chips) 
Seat 5: DevilisHEyz ($59.44 in chips) 
Seat 7: Filojoes ($101.50 in chips) 
Seat 8: sanpidk ($101 in chips) 
Seat 9: blakenjaime ($78.68 in chips) 
mycka86: posts small blind $0.50
Khaine_CM: posts big blind $1
moffo13: sits out 
*** HOLE CARDS ***
Dealt to matiko09 [6h 8h]
matiko09: folds 
DevilisHEyz: folds 
Filojoes: folds 
sanpidk: raises $1.50 to $2.50
blakenjaime: calls $2.50
mycka86: folds 
Khaine_CM: raises $7.50 to $10
sanpidk: folds 
blakenjaime: calls $7.50
*** FLOP *** [2h Jd 4s]
Khaine_CM: bets $11
blakenjaime: calls $11
*** TURN *** [2h Jd 4s] [Kd]
Khaine_CM: bets $22
blakenjaime: raises $22 to $44
Khaine_CM: folds 
Uncalled bet ($22) returned to blakenjaime
blakenjaime collected $86.20 from pot
*** SUMMARY ***
Total pot $89 | Rake $2.80 
Board [2h Jd 4s Kd]
Seat 2: mycka86 (small blind) folded before Flop
Seat 3: Khaine_CM (big blind) folded on the Turn
Seat 4: matiko09 folded before Flop (didn't bet)
Seat 5: DevilisHEyz folded before Flop (didn't bet)
Seat 7: Filojoes folded before Flop (didn't bet)
Seat 8: sanpidk folded before Flop
Seat 9: blakenjaime (button) collected ($86.20)





PokerStars Hand #150708515571:  Hold'em No Limit ($0.50/$1.00 USD) - 2016/03/21 17:23:26 CET [2016/03/21 12:23:26 ET]
Table 'Marmulla II' 9-max Seat #7 is the button
Seat 3: Vikulja1993 ($131.50 in chips) 
Seat 4: Dachish ($84.73 in chips) 
Seat 5: maaaGik88 ($74.20 in chips) 
Seat 6: R1aki ($130.14 in chips) 
Seat 7: Pacifistas ($112.60 in chips) 
Seat 8: sanpidk ($100 in chips) 
Seat 9: matiko09 ($101.50 in chips) 
sanpidk: posts small blind $0.50
matiko09: posts big blind $1
flk.Dasas: sits out 
*** HOLE CARDS ***
Dealt to matiko09 [5c 3d]
Vikulja1993: folds 
Dachish: folds 
maaaGik88: folds 
R1aki: folds 
Pacifistas: folds 
sanpidk: raises $1.24 to $2.24
matiko09: folds 
Uncalled bet ($1.24) returned to sanpidk
sanpidk collected $2 from pot
sanpidk: doesn't show hand 
*** SUMMARY ***
Total pot $2 | Rake $0 
Seat 3: Vikulja1993 folded before Flop (didn't bet)
Seat 4: Dachish folded before Flop (didn't bet)
Seat 5: maaaGik88 folded before Flop (didn't bet)
Seat 6: R1aki folded before Flop (didn't bet)
Seat 7: Pacifistas (button) folded before Flop (didn't bet)
Seat 8: sanpidk (small blind) collected ($2)
Seat 9: matiko09 (big blind) folded before Flop





PokerStars Hand #150708526046:  Hold'em No Limit ($0.50/$1.00 USD) - 2016/03/21 17:23:39 CET [2016/03/21 12:23:39 ET]
Table 'Massalia II' 9-max Seat #7 is the button
Seat 1: Filojoes ($114.60 in chips) 
Seat 3: 123chambo ($169.23 in chips) 
Seat 4: OriginalTony ($96.50 in chips) 
Seat 5: Vikulja1993 ($102.90 in chips) 
Seat 6: Pacifistas ($107.76 in chips) 
Seat 7: flk.Dasas ($100 in chips) 
Seat 8: matiko09 ($167.08 in chips) 
Seat 9: DanishWiking ($107.16 in chips) 
matiko09: posts small blind $0.50
DanishWiking: posts big blind $1
SiD11211: sits out 
Filojoes: posts the ante $0.20
123chambo: posts the ante $0.20
OriginalTony: posts the ante $0.20
Vikulja1993: posts the ante $0.20
Pacifistas: posts the ante $0.20
flk.Dasas: posts the ante $0.20
matiko09: posts the ante $0.20
DanishWiking: posts the ante $0.20
*** HOLE CARDS ***
Dealt to matiko09 [9s Kc]
Filojoes: folds 
123chambo: folds 
OriginalTony: folds 
Vikulja1993: raises $2 to $3
Pacifistas: folds 
flk.Dasas: folds 
matiko09: folds 
DanishWiking: folds 
Uncalled bet ($2) returned to Vikulja1993
Vikulja1993 collected $4.10 from pot
Vikulja1993: doesn't show hand 
*** SUMMARY ***
Total pot $4.10 | Rake $0 
Seat 1: Filojoes folded before Flop (didn't bet)
Seat 3: 123chambo folded before Flop (didn't bet)
Seat 4: OriginalTony folded before Flop (didn't bet)
Seat 5: Vikulja1993 collected ($4.10)
Seat 6: Pacifistas folded before Flop (didn't bet)
Seat 7: flk.Dasas (button) folded before Flop (didn't bet)
Seat 8: matiko09 (small blind) folded before Flop
Seat 9: DanishWiking (big blind) folded before Flop





PokerStars Hand #150708528305:  Hold'em No Limit ($0.50/$1.00 USD) - 2016/03/21 17:23:42 CET [2016/03/21 12:23:42 ET]
Table 'Onnie II' 9-max Seat #9 is the button
Seat 1: ka100pka527 ($122.57 in chips) 
Seat 2: RICKA16 ($100 in chips) 
Seat 3: cn_chayanne ($133.03 in chips) 
Seat 4: Bothfeld11 ($154.06 in chips) 
Seat 5: sanpidk ($100 in chips) 
Seat 6: Pacifistas ($108.17 in chips) 
Seat 7: djammusic ($72.90 in chips) 
Seat 8: solbi86 ($100 in chips) 
Seat 9: matiko09 ($128.58 in chips) 
ka100pka527: posts small blind $0.50
RICKA16: posts big blind $1
*** HOLE CARDS ***
Dealt to matiko09 [7d Th]
cn_chayanne: raises $1.50 to $2.50
Bothfeld11: folds 
sanpidk: folds 
Pacifistas: folds 
djammusic: folds 
solbi86: folds 
matiko09: folds 
ka100pka527: folds 
RICKA16: folds 
Uncalled bet ($1.50) returned to cn_chayanne
cn_chayanne collected $2.50 from pot
*** SUMMARY ***
Total pot $2.50 | Rake $0 
Seat 1: ka100pka527 (small blind) folded before Flop
Seat 2: RICKA16 (big blind) folded before Flop
Seat 3: cn_chayanne collected ($2.50)
Seat 4: Bothfeld11 folded before Flop (didn't bet)
Seat 5: sanpidk folded before Flop (didn't bet)
Seat 6: Pacifistas folded before Flop (didn't bet)
Seat 7: djammusic folded before Flop (didn't bet)
Seat 8: solbi86 folded before Flop (didn't bet)
Seat 9: matiko09 (button) folded before Flop (didn't bet)





PokerStars Hand #150708540950:  Hold'em No Limit ($0.50/$1.00 USD) - 2016/03/21 17:23:59 CET [2016/03/21 12:23:59 ET]
Table 'Massalia II' 9-max Seat #8 is the button
Seat 2: SiD11211 ($100 in chips) 
Seat 3: 123chambo ($169.03 in chips) 
Seat 4: OriginalTony ($96.30 in chips) 
Seat 5: Vikulja1993 ($105.80 in chips) 
Seat 6: Pacifistas ($107.56 in chips) 
Seat 7: flk.Dasas ($100 in chips) 
Seat 8: matiko09 ($166.38 in chips) 
Seat 9: DanishWiking ($105.96 in chips) 
DanishWiking: posts small blind $0.50
Filojoes: is sitting out 
SiD11211: posts big blind $1
SiD11211: posts the ante $0.20
123chambo: posts the ante $0.20
OriginalTony: posts the ante $0.20
Vikulja1993: posts the ante $0.20
Pacifistas: posts the ante $0.20
flk.Dasas: posts the ante $0.20
matiko09: posts the ante $0.20
DanishWiking: posts the ante $0.20
*** HOLE CARDS ***
Dealt to matiko09 [Jd Qc]
Filojoes leaves the table
ceedonen joins the table at seat #1 
123chambo: raises $2 to $3
OriginalTony: folds 
Vikulja1993: folds 
Pacifistas: folds 
flk.Dasas: folds 
matiko09: folds 
DanishWiking: folds 
SiD11211: calls $2
*** FLOP *** [7h 3h 9c]
SiD11211: checks 
123chambo: bets $5
SiD11211: raises $10 to $15
123chambo: calls $10
*** TURN *** [7h 3h 9c] [8d]
SiD11211: bets $20
123chambo: folds 
Uncalled bet ($20) returned to SiD11211
SiD11211 collected $36.39 from pot
*** SUMMARY ***
Total pot $38.10 | Rake $1.71 
Board [7h 3h 9c 8d]
Seat 2: SiD11211 (big blind) collected ($36.39)
Seat 3: 123chambo folded on the Turn
Seat 4: OriginalTony folded before Flop (didn't bet)
Seat 5: Vikulja1993 folded before Flop (didn't bet)
Seat 6: Pacifistas folded before Flop (didn't bet)
Seat 7: flk.Dasas folded before Flop (didn't bet)
Seat 8: matiko09 (button) folded before Flop (didn't bet)
Seat 9: DanishWiking (small blind) folded before Flop





PokerStars Hand #150708547661:  Hold'em No Limit ($0.50/$1.00 USD) - 2016/03/21 17:24:07 CET [2016/03/21 12:24:07 ET]
Table 'Onnie II' 9-max Seat #1 is the button
Seat 1: ka100pka527 ($122.07 in chips) 
Seat 2: RICKA16 ($100 in chips) 
Seat 4: Bothfeld11 ($154.06 in chips) 
Seat 5: sanpidk ($100 in chips) 
Seat 6: Pacifistas ($108.17 in chips) 
Seat 7: djammusic ($72.90 in chips) 
Seat 8: solbi86 ($100 in chips) 
Seat 9: matiko09 ($128.58 in chips) 
RICKA16: posts small blind $0.50
cn_chayanne: is sitting out 
Bothfeld11: posts big blind $1
*** HOLE CARDS ***
Dealt to matiko09 [Td 8c]
cn_chayanne leaves the table
DanishWiking joins the table at seat #3 
sanpidk: folds 
Pacifistas has timed out
Pacifistas: folds 
djammusic: folds 
solbi86: folds 
matiko09: folds 
ka100pka527: folds 
RICKA16: raises $2 to $3
Bothfeld11: calls $2
*** FLOP *** [9h 3c 8h]
RICKA16: bets $4
Bothfeld11: calls $4
*** TURN *** [9h 3c 8h] [5s]
RICKA16: bets $9
Bothfeld11: folds 
Uncalled bet ($9) returned to RICKA16
RICKA16 collected $13.37 from pot
RICKA16: doesn't show hand 
*** SUMMARY ***
Total pot $14 | Rake $0.63 
Board [9h 3c 8h 5s]
Seat 1: ka100pka527 (button) folded before Flop (didn't bet)
Seat 2: RICKA16 (small blind) collected ($13.37)
Seat 4: Bothfeld11 (big blind) folded on the Turn
Seat 5: sanpidk folded before Flop (didn't bet)
Seat 6: Pacifistas folded before Flop (didn't bet)
Seat 7: djammusic folded before Flop (didn't bet)
Seat 8: solbi86 folded before Flop (didn't bet)
Seat 9: matiko09 folded before Flop (didn't bet)





PokerStars Hand #150708549615:  Hold'em No Limit ($0.50/$1.00 USD) - 2016/03/21 17:24:10 CET [2016/03/21 12:24:10 ET]
Table 'Hilda' 9-max Seat #6 is the button
Seat 1: djammusic ($54.09 in chips) 
Seat 2: blackmont111 ($100.59 in chips) 
Seat 3: Rikti ($42.36 in chips) 
Seat 4: Pacifistas ($109.07 in chips) 
Seat 5: solbi86 ($182.64 in chips) 
Seat 6: hemetcano ($217.06 in chips) 
Seat 7: R1aki ($109.38 in chips) 
Seat 9: matiko09 ($107 in chips) 
R1aki: posts small blind $0.50
sanpidk: is sitting out 
matiko09: posts big blind $1
*** HOLE CARDS ***
Dealt to matiko09 [8c 5h]
sanpidk leaves the table
djammusic: folds 
blackmont111: folds 
Rikti: folds 
flk.Dasas joins the table at seat #8 
Pacifistas: folds 
solbi86: raises $1.50 to $2.50
hemetcano: calls $2.50
R1aki: folds 
matiko09: folds 
*** FLOP *** [7s 8h 2c]
solbi86: bets $4
hemetcano: calls $4
*** TURN *** [7s 8h 2c] [6s]
solbi86: bets $10
hemetcano: calls $10
*** RIVER *** [7s 8h 2c 6s] [As]
solbi86: bets $22
hemetcano: folds 
Uncalled bet ($22) returned to solbi86
solbi86 collected $32.95 from pot
solbi86: doesn't show hand 
*** SUMMARY ***
Total pot $34.50 | Rake $1.55 
Board [7s 8h 2c 6s As]
Seat 1: djammusic folded before Flop (didn't bet)
Seat 2: blackmont111 folded before Flop (didn't bet)
Seat 3: Rikti folded before Flop (didn't bet)
Seat 4: Pacifistas folded before Flop (didn't bet)
Seat 5: solbi86 collected ($32.95)
Seat 6: hemetcano (button) folded on the River
Seat 7: R1aki (small blind) folded before Flop
Seat 9: matiko09 (big blind) folded before Flop





PokerStars Hand #150708556235:  Hold'em No Limit ($0.50/$1.00 USD) - 2016/03/21 17:24:19 CET [2016/03/21 12:24:19 ET]
Table 'Marmulla II' 9-max Seat #8 is the button
Seat 2: flk.Dasas ($100 in chips) 
Seat 3: Vikulja1993 ($131.50 in chips) 
Seat 4: Dachish ($84.73 in chips) 
Seat 5: maaaGik88 ($74.20 in chips) 
Seat 6: R1aki ($130.14 in chips) 
Seat 7: Pacifistas ($112.60 in chips) 
Seat 8: sanpidk ($101 in chips) 
Seat 9: matiko09 ($100.50 in chips) 
matiko09: posts small blind $0.50
flk.Dasas: posts big blind $1
*** HOLE CARDS ***
Dealt to matiko09 [Js 2h]
Vikulja1993: folds 
Dachish: folds 
maaaGik88: folds 
R1aki: folds 
Pacifistas: folds 
sanpidk: raises $1.24 to $2.24
matiko09: folds 
flk.Dasas: folds 
Uncalled bet ($1.24) returned to sanpidk
sanpidk collected $2.50 from pot
sanpidk: doesn't show hand 
*** SUMMARY ***
Total pot $2.50 | Rake $0 
Seat 2: flk.Dasas (big blind) folded before Flop
Seat 3: Vikulja1993 folded before Flop (didn't bet)
Seat 4: Dachish folded before Flop (didn't bet)
Seat 5: maaaGik88 folded before Flop (didn't bet)
Seat 6: R1aki folded before Flop (didn't bet)
Seat 7: Pacifistas folded before Flop (didn't bet)
Seat 8: sanpidk (button) collected ($2.50)
Seat 9: matiko09 (small blind) folded before Flop





PokerStars Hand #150708568572:  Hold'em No Limit ($0.50/$1.00 USD) - 2016/03/21 17:24:35 CET [2016/03/21 12:24:35 ET]
Table 'Goberta' 9-max Seat #2 is the button
Seat 2: mycka86 ($148.62 in chips) 
Seat 3: Khaine_CM ($100 in chips) 
Seat 4: matiko09 ($100 in chips) 
Seat 5: DevilisHEyz ($59.44 in chips) 
Seat 7: Filojoes ($101.50 in chips) 
Seat 8: sanpidk ($100 in chips) 
Seat 9: blakenjaime ($121.88 in chips) 
Khaine_CM: posts small blind $0.50
matiko09: posts big blind $1
moffo13: sits out 
*** HOLE CARDS ***
Dealt to matiko09 [Ah Kh]
DevilisHEyz has timed out
DevilisHEyz: folds 
Filojoes: folds 
sanpidk: folds 
blakenjaime: folds 
mycka86: folds 
Khaine_CM: folds 
Uncalled bet ($0.50) returned to matiko09
matiko09 collected $1 from pot
matiko09: doesn't show hand 
*** SUMMARY ***
Total pot $1 | Rake $0 
Seat 2: mycka86 (button) folded before Flop (didn't bet)
Seat 3: Khaine_CM (small blind) folded before Flop
Seat 4: matiko09 (big blind) collected ($1)
Seat 5: DevilisHEyz folded before Flop (didn't bet)
Seat 7: Filojoes folded before Flop (didn't bet)
Seat 8: sanpidk folded before Flop (didn't bet)
Seat 9: blakenjaime folded before Flop (didn't bet)





PokerStars Hand #150708594375:  Hold'em No Limit ($0.50/$1.00 USD) - 2016/03/21 17:25:08 CET [2016/03/21 12:25:08 ET]
Table 'Goberta' 9-max Seat #3 is the button
Seat 2: mycka86 ($148.62 in chips) 
Seat 3: Khaine_CM ($100 in chips) 
Seat 4: matiko09 ($100.50 in chips) 
Seat 5: DevilisHEyz ($59.44 in chips) 
Seat 7: Filojoes ($101.50 in chips) 
Seat 8: sanpidk ($100 in chips) 
Seat 9: blakenjaime ($121.88 in chips) 
matiko09: posts small blind $0.50
DevilisHEyz: posts big blind $1
moffo13: sits out 
*** HOLE CARDS ***
Dealt to matiko09 [8d 2s]
Filojoes: raises $2 to $3
sanpidk: folds 
blakenjaime: folds 
mycka86: folds 
Khaine_CM: folds 
matiko09: folds 
DevilisHEyz: folds 
Uncalled bet ($2) returned to Filojoes
Filojoes collected $2.50 from pot
Filojoes: doesn't show hand 
*** SUMMARY ***
Total pot $2.50 | Rake $0 
Seat 2: mycka86 folded before Flop (didn't bet)
Seat 3: Khaine_CM (button) folded before Flop (didn't bet)
Seat 4: matiko09 (small blind) folded before Flop
Seat 5: DevilisHEyz (big blind) folded before Flop
Seat 7: Filojoes collected ($2.50)
Seat 8: sanpidk folded before Flop (didn't bet)
Seat 9: blakenjaime folded before Flop (didn't bet)





PokerStars Hand #150708593995:  Hold'em No Limit ($0.50/$1.00 USD) - 2016/03/21 17:25:08 CET [2016/03/21 12:25:08 ET]
Table 'Marmulla II' 9-max Seat #9 is the button
Seat 2: flk.Dasas ($100 in chips) 
Seat 3: Vikulja1993 ($131.50 in chips) 
Seat 4: Dachish ($84.73 in chips) 
Seat 5: maaaGik88 ($74.20 in chips) 
Seat 6: R1aki ($130.14 in chips) 
Seat 7: Pacifistas ($112.60 in chips) 
Seat 8: sanpidk ($102.50 in chips) 
Seat 9: matiko09 ($100 in chips) 
flk.Dasas: posts small blind $0.50
Vikulja1993: posts big blind $1
*** HOLE CARDS ***
Dealt to matiko09 [Kh Jh]
Dachish: folds 
maaaGik88: folds 
R1aki: folds 
Pacifistas: folds 
sanpidk: folds 
matiko09: raises $1.27 to $2.27
flk.Dasas: folds 
Vikulja1993: calls $1.27
*** FLOP *** [3s 5d 8d]
Vikulja1993: checks 
matiko09: checks 
*** TURN *** [3s 5d 8d] [4d]
Vikulja1993: bets $3
matiko09: folds 
Uncalled bet ($3) returned to Vikulja1993
Vikulja1993 collected $4.81 from pot
Vikulja1993: doesn't show hand 
*** SUMMARY ***
Total pot $5.04 | Rake $0.23 
Board [3s 5d 8d 4d]
Seat 2: flk.Dasas (small blind) folded before Flop
Seat 3: Vikulja1993 (big blind) collected ($4.81)
Seat 4: Dachish folded before Flop (didn't bet)
Seat 5: maaaGik88 folded before Flop (didn't bet)
Seat 6: R1aki folded before Flop (didn't bet)
Seat 7: Pacifistas folded before Flop (didn't bet)
Seat 8: sanpidk folded before Flop (didn't bet)
Seat 9: matiko09 (button) folded on the Turn





PokerStars Hand #150708600890:  Hold'em No Limit ($0.50/$1.00 USD) - 2016/03/21 17:25:17 CET [2016/03/21 12:25:17 ET]
Table 'Hilda' 9-max Seat #7 is the button
Seat 1: djammusic ($54.09 in chips) 
Seat 2: blackmont111 ($100.59 in chips) 
Seat 3: Rikti ($42.36 in chips) 
Seat 4: Pacifistas ($109.07 in chips) 
Seat 5: solbi86 ($199.09 in chips) 
Seat 6: hemetcano ($200.56 in chips) 
Seat 7: R1aki ($108.88 in chips) 
Seat 9: matiko09 ($106 in chips) 
matiko09: posts small blind $0.50
djammusic: posts big blind $1
*** HOLE CARDS ***
Dealt to matiko09 [Jc 4s]
blackmont111: raises $2 to $3
flk.Dasas leaves the table
Dachish joins the table at seat #8 
Rikti: folds 
Pacifistas: folds 
solbi86: folds 
hemetcano: calls $3
R1aki: folds 
matiko09: folds 
djammusic: folds 
*** FLOP *** [Tc 3h Kd]
blackmont111: checks 
hemetcano: bets $1
blackmont111: calls $1
*** TURN *** [Tc 3h Kd] [Qh]
blackmont111: checks 
hemetcano: checks 
*** RIVER *** [Tc 3h Kd Qh] [7c]
blackmont111: bets $5
hemetcano: folds 
Uncalled bet ($5) returned to blackmont111
blackmont111 collected $9.07 from pot
blackmont111: doesn't show hand 
*** SUMMARY ***
Total pot $9.50 | Rake $0.43 
Board [Tc 3h Kd Qh 7c]
Seat 1: djammusic (big blind) folded before Flop
Seat 2: blackmont111 collected ($9.07)
Seat 3: Rikti folded before Flop (didn't bet)
Seat 4: Pacifistas folded before Flop (didn't bet)
Seat 5: solbi86 folded before Flop (didn't bet)
Seat 6: hemetcano folded on the River
Seat 7: R1aki (button) folded before Flop (didn't bet)
Seat 9: matiko09 (small blind) folded before Flop





PokerStars Hand #150708609235:  Hold'em No Limit ($0.50/$1.00 USD) - 2016/03/21 17:25:27 CET [2016/03/21 12:25:27 ET]
Table 'Onnie II' 9-max Seat #2 is the button
Seat 1: ka100pka527 ($122.07 in chips) 
Seat 2: RICKA16 ($106.37 in chips) 
Seat 4: Bothfeld11 ($147.06 in chips) 
Seat 6: Pacifistas ($108.17 in chips) 
Seat 7: djammusic ($72.90 in chips) 
Seat 8: solbi86 ($100 in chips) 
Seat 9: matiko09 ($128.58 in chips) 
DanishWiking will be allowed to play after the button
Bothfeld11: posts small blind $0.50
sanpidk: is sitting out 
Pacifistas: posts big blind $1
*** HOLE CARDS ***
Dealt to matiko09 [4h 8s]
sanpidk leaves the table
djammusic: folds 
solbi86: folds 
matiko09: folds 
ka100pka527: raises $1 to $2
Filojoes joins the table at seat #5 
RICKA16: calls $2
Bothfeld11: folds 
Pacifistas: folds 
*** FLOP *** [6s 7d Js]
ka100pka527: bets $3.49
RICKA16: folds 
Uncalled bet ($3.49) returned to ka100pka527
ka100pka527 collected $5.25 from pot
ka100pka527: doesn't show hand 
*** SUMMARY ***
Total pot $5.50 | Rake $0.25 
Board [6s 7d Js]
Seat 1: ka100pka527 collected ($5.25)
Seat 2: RICKA16 (button) folded on the Flop
Seat 4: Bothfeld11 (small blind) folded before Flop
Seat 6: Pacifistas (big blind) folded before Flop
Seat 7: djammusic folded before Flop (didn't bet)
Seat 8: solbi86 folded before Flop (didn't bet)
Seat 9: matiko09 folded before Flop (didn't bet)





PokerStars Hand #150708612834:  Hold'em No Limit ($0.50/$1.00 USD) - 2016/03/21 17:25:32 CET [2016/03/21 12:25:32 ET]
Table 'Massalia II' 9-max Seat #9 is the button
Seat 2: SiD11211 ($118.19 in chips) 
Seat 3: 123chambo ($150.83 in chips) 
Seat 4: OriginalTony ($96.10 in chips) 
Seat 5: Vikulja1993 ($105.60 in chips) 
Seat 6: Pacifistas ($107.36 in chips) 
Seat 7: flk.Dasas ($100 in chips) 
Seat 8: matiko09 ($166.18 in chips) 
Seat 9: DanishWiking ($105.26 in chips) 
ceedonen will be allowed to play after the button
SiD11211: posts small blind $0.50
123chambo: posts big blind $1
SiD11211: posts the ante $0.20
123chambo: posts the ante $0.20
OriginalTony: posts the ante $0.20
Vikulja1993: posts the ante $0.20
Pacifistas: posts the ante $0.20
flk.Dasas: posts the ante $0.20
matiko09: posts the ante $0.20
DanishWiking: posts the ante $0.20
*** HOLE CARDS ***
Dealt to matiko09 [3s 2d]
OriginalTony: folds 
Vikulja1993: folds 
Pacifistas: folds 
flk.Dasas: folds 
matiko09: folds 
DanishWiking: folds 
SiD11211: raises $2 to $3
123chambo: folds 
Uncalled bet ($2) returned to SiD11211
SiD11211 collected $3.60 from pot
*** SUMMARY ***
Total pot $3.60 | Rake $0 
Seat 2: SiD11211 (small blind) collected ($3.60)
Seat 3: 123chambo (big blind) folded before Flop
Seat 4: OriginalTony folded before Flop (didn't bet)
Seat 5: Vikulja1993 folded before Flop (didn't bet)
Seat 6: Pacifistas folded before Flop (didn't bet)
Seat 7: flk.Dasas folded before Flop (didn't bet)
Seat 8: matiko09 folded before Flop (didn't bet)
Seat 9: DanishWiking (button) folded before Flop (didn't bet)





PokerStars Hand #150708621855:  Hold'em No Limit ($0.50/$1.00 USD) - 2016/03/21 17:25:44 CET [2016/03/21 12:25:44 ET]
Table 'Goberta' 9-max Seat #4 is the button
Seat 2: mycka86 ($148.62 in chips) 
Seat 3: Khaine_CM ($100 in chips) 
Seat 4: matiko09 ($100 in chips) 
Seat 5: DevilisHEyz ($58.44 in chips) 
Seat 6: moffo13 ($44.98 in chips) 
Seat 7: Filojoes ($103 in chips) 
Seat 8: sanpidk ($100 in chips) 
Seat 9: blakenjaime ($121.88 in chips) 
DevilisHEyz: posts small blind $0.50
moffo13: posts big blind $1
*** HOLE CARDS ***
Dealt to matiko09 [6h 6c]
Filojoes: folds 
sanpidk: folds 
blakenjaime: folds 
mycka86: folds 
Khaine_CM: raises $1.50 to $2.50
matiko09: calls $2.50
DevilisHEyz: folds 
moffo13: folds 
*** FLOP *** [Jd Jh 8s]
Khaine_CM: bets $4
matiko09: calls $4
*** TURN *** [Jd Jh 8s] [2h]
Khaine_CM: checks 
matiko09: checks 
*** RIVER *** [Jd Jh 8s 2h] [Js]
Khaine_CM: checks 
matiko09: checks 
*** SHOW DOWN ***
Khaine_CM: shows [As 7h] (three of a kind, Jacks)
matiko09: shows [6h 6c] (a full house, Jacks full of Sixes)
matiko09 collected $13.85 from pot
*** SUMMARY ***
Total pot $14.50 | Rake $0.65 
Board [Jd Jh 8s 2h Js]
Seat 2: mycka86 folded before Flop (didn't bet)
Seat 3: Khaine_CM showed [As 7h] and lost with three of a kind, Jacks
Seat 4: matiko09 (button) showed [6h 6c] and won ($13.85) with a full house, Jacks full of Sixes
Seat 5: DevilisHEyz (small blind) folded before Flop
Seat 6: moffo13 (big blind) folded before Flop
Seat 7: Filojoes folded before Flop (didn't bet)
Seat 8: sanpidk folded before Flop (didn't bet)
Seat 9: blakenjaime folded before Flop (didn't bet)





PokerStars Hand #150708634767:  Hold'em No Limit ($0.50/$1.00 USD) - 2016/03/21 17:26:01 CET [2016/03/21 12:26:01 ET]
Table 'Massalia II' 9-max Seat #2 is the button
Seat 2: SiD11211 ($120.59 in chips) 
Seat 3: 123chambo ($149.63 in chips) 
Seat 4: OriginalTony ($95.90 in chips) 
Seat 5: Vikulja1993 ($105.40 in chips) 
Seat 6: Pacifistas ($107.16 in chips) 
Seat 7: flk.Dasas ($100 in chips) 
Seat 8: matiko09 ($165.98 in chips) 
Seat 9: DanishWiking ($105.06 in chips) 
123chambo: posts small blind $0.50
OriginalTony: posts big blind $1
ceedonen: sits out 
SiD11211: posts the ante $0.20
123chambo: posts the ante $0.20
OriginalTony: posts the ante $0.20
Vikulja1993: posts the ante $0.20
Pacifistas: posts the ante $0.20
flk.Dasas: posts the ante $0.20
matiko09: posts the ante $0.20
DanishWiking: posts the ante $0.20
*** HOLE CARDS ***
Dealt to matiko09 [6s 2c]
Vikulja1993: folds 
Pacifistas: raises $2 to $3
flk.Dasas: folds 
matiko09: folds 
DanishWiking: raises $7 to $10
SiD11211: folds 
123chambo: folds 
OriginalTony: folds 
Pacifistas: folds 
Uncalled bet ($7) returned to DanishWiking
DanishWiking collected $9.10 from pot
DanishWiking: doesn't show hand 
*** SUMMARY ***
Total pot $9.10 | Rake $0 
Seat 2: SiD11211 (button) folded before Flop (didn't bet)
Seat 3: 123chambo (small blind) folded before Flop
Seat 4: OriginalTony (big blind) folded before Flop
Seat 5: Vikulja1993 folded before Flop (didn't bet)
Seat 6: Pacifistas folded before Flop
Seat 7: flk.Dasas folded before Flop (didn't bet)
Seat 8: matiko09 folded before Flop (didn't bet)
Seat 9: DanishWiking collected ($9.10)





PokerStars Hand #150708639762:  Hold'em No Limit ($0.50/$1.00 USD) - 2016/03/21 17:26:07 CET [2016/03/21 12:26:07 ET]
Table 'Marmulla II' 9-max Seat #2 is the button
Seat 2: flk.Dasas ($100 in chips) 
Seat 3: Vikulja1993 ($134.04 in chips) 
Seat 4: Dachish ($84.73 in chips) 
Seat 5: maaaGik88 ($74.20 in chips) 
Seat 6: R1aki ($130.14 in chips) 
Seat 7: Pacifistas ($112.60 in chips) 
Seat 8: sanpidk ($102.50 in chips) 
Seat 9: matiko09 ($100 in chips) 
Vikulja1993: posts small blind $0.50
Dachish: posts big blind $1
*** HOLE CARDS ***
Dealt to matiko09 [Qs 9h]
maaaGik88: raises $1 to $2
R1aki: folds 
Pacifistas: raises $3.50 to $5.50
sanpidk: folds 
matiko09: folds 
flk.Dasas: folds 
Vikulja1993: folds 
Dachish: folds 
maaaGik88: calls $3.50
*** FLOP *** [3s 3c 2h]
maaaGik88: checks 
Pacifistas: bets $6
maaaGik88: calls $6
*** TURN *** [3s 3c 2h] [6s]
maaaGik88: checks 
Pacifistas: checks 
*** RIVER *** [3s 3c 2h 6s] [6h]
maaaGik88: bets $11.70
Pacifistas: folds 
Uncalled bet ($11.70) returned to maaaGik88
maaaGik88 collected $23.40 from pot
maaaGik88: doesn't show hand 
*** SUMMARY ***
Total pot $24.50 | Rake $1.10 
Board [3s 3c 2h 6s 6h]
Seat 2: flk.Dasas (button) folded before Flop (didn't bet)
Seat 3: Vikulja1993 (small blind) folded before Flop
Seat 4: Dachish (big blind) folded before Flop
Seat 5: maaaGik88 collected ($23.40)
Seat 6: R1aki folded before Flop (didn't bet)
Seat 7: Pacifistas folded on the River
Seat 8: sanpidk folded before Flop (didn't bet)
Seat 9: matiko09 folded before Flop (didn't bet)





PokerStars Hand #150708645115:  Hold'em No Limit ($0.50/$1.00 USD) - 2016/03/21 17:26:14 CET [2016/03/21 12:26:14 ET]
Table 'Onnie II' 9-max Seat #4 is the button
Seat 1: ka100pka527 ($125.32 in chips) 
Seat 2: RICKA16 ($104.37 in chips) 
Seat 4: Bothfeld11 ($146.56 in chips) 
Seat 6: Pacifistas ($107.17 in chips) 
Seat 7: djammusic ($72.90 in chips) 
Seat 8: solbi86 ($100 in chips) 
Seat 9: matiko09 ($128.58 in chips) 
Filojoes will be allowed to play after the button
Pacifistas: posts small blind $0.50
djammusic: posts big blind $1
DanishWiking: sits out 
*** HOLE CARDS ***
Dealt to matiko09 [2s Ad]
solbi86: folds 
matiko09: folds 
ka100pka527: folds 
RICKA16: folds 
Bothfeld11: folds 
Pacifistas: folds 
Uncalled bet ($0.50) returned to djammusic
djammusic collected $1 from pot
djammusic: doesn't show hand 
*** SUMMARY ***
Total pot $1 | Rake $0 
Seat 1: ka100pka527 folded before Flop (didn't bet)
Seat 2: RICKA16 folded before Flop (didn't bet)
Seat 4: Bothfeld11 (button) folded before Flop (didn't bet)
Seat 6: Pacifistas (small blind) folded before Flop
Seat 7: djammusic (big blind) collected ($1)
Seat 8: solbi86 folded before Flop (didn't bet)
Seat 9: matiko09 folded before Flop (didn't bet)





PokerStars Hand #150708654251:  Hold'em No Limit ($0.50/$1.00 USD) - 2016/03/21 17:26:26 CET [2016/03/21 12:26:26 ET]
Table 'Hilda' 9-max Seat #9 is the button
Seat 1: djammusic ($53.09 in chips) 
Seat 2: blackmont111 ($105.66 in chips) 
Seat 3: Rikti ($42.36 in chips) 
Seat 4: Pacifistas ($109.07 in chips) 
Seat 5: solbi86 ($199.09 in chips) 
Seat 6: hemetcano ($196.56 in chips) 
Seat 7: R1aki ($108.88 in chips) 
Seat 9: matiko09 ($105.50 in chips) 
djammusic: posts small blind $0.50
blackmont111: posts big blind $1
Dachish: sits out 
*** HOLE CARDS ***
Dealt to matiko09 [8h 6c]
Rikti: folds 
Pacifistas: folds 
solbi86: raises $2 to $3
hemetcano: folds 
R1aki: folds 
matiko09: folds 
djammusic: folds 
blackmont111: folds 
Uncalled bet ($2) returned to solbi86
solbi86 collected $2.50 from pot
solbi86: doesn't show hand 
*** SUMMARY ***
Total pot $2.50 | Rake $0 
Seat 1: djammusic (small blind) folded before Flop
Seat 2: blackmont111 (big blind) folded before Flop
Seat 3: Rikti folded before Flop (didn't bet)
Seat 4: Pacifistas folded before Flop (didn't bet)
Seat 5: solbi86 collected ($2.50)
Seat 6: hemetcano folded before Flop (didn't bet)
Seat 7: R1aki folded before Flop (didn't bet)
Seat 9: matiko09 (button) folded before Flop (didn't bet)





PokerStars Hand #150708656924:  Hold'em No Limit ($0.50/$1.00 USD) - 2016/03/21 17:26:29 CET [2016/03/21 12:26:29 ET]
Table 'Onnie II' 9-max Seat #6 is the button
Seat 1: ka100pka527 ($125.32 in chips) 
Seat 2: RICKA16 ($104.37 in chips) 
Seat 4: Bothfeld11 ($146.56 in chips) 
Seat 6: Pacifistas ($106.67 in chips) 
Seat 7: djammusic ($73.40 in chips) 
Seat 8: solbi86 ($100 in chips) 
Seat 9: matiko09 ($128.58 in chips) 
djammusic: posts small blind $0.50
solbi86: posts big blind $1
DanishWiking: sits out 
Filojoes: sits out 
*** HOLE CARDS ***
Dealt to matiko09 [Ad 2c]
matiko09: folds 
ka100pka527: raises $2 to $3
RICKA16: folds 
Bothfeld11: folds 
Pacifistas: folds 
djammusic: folds 
solbi86: folds 
Uncalled bet ($2) returned to ka100pka527
ka100pka527 collected $2.50 from pot
ka100pka527: doesn't show hand 
*** SUMMARY ***
Total pot $2.50 | Rake $0 
Seat 1: ka100pka527 collected ($2.50)
Seat 2: RICKA16 folded before Flop (didn't bet)
Seat 4: Bothfeld11 folded before Flop (didn't bet)
Seat 6: Pacifistas (button) folded before Flop (didn't bet)
Seat 7: djammusic (small blind) folded before Flop
Seat 8: solbi86 (big blind) folded before Flop
Seat 9: matiko09 folded before Flop (didn't bet)





PokerStars Hand #150708663946:  Hold'em No Limit ($0.50/$1.00 USD) - 2016/03/21 17:26:38 CET [2016/03/21 12:26:38 ET]
Table 'Massalia II' 9-max Seat #3 is the button
Seat 2: SiD11211 ($120.39 in chips) 
Seat 3: 123chambo ($148.93 in chips) 
Seat 4: OriginalTony ($94.70 in chips) 
Seat 5: Vikulja1993 ($105.20 in chips) 
Seat 6: Pacifistas ($103.96 in chips) 
Seat 7: flk.Dasas ($100 in chips) 
Seat 8: matiko09 ($165.78 in chips) 
Seat 9: DanishWiking ($110.96 in chips) 
OriginalTony: posts small blind $0.50
Vikulja1993: posts big blind $1
ceedonen: sits out 
SiD11211: posts the ante $0.20
123chambo: posts the ante $0.20
OriginalTony: posts the ante $0.20
Vikulja1993: posts the ante $0.20
Pacifistas: posts the ante $0.20
flk.Dasas: posts the ante $0.20
matiko09: posts the ante $0.20
DanishWiking: posts the ante $0.20
*** HOLE CARDS ***
Dealt to matiko09 [Ad 9d]
Pacifistas: folds 
flk.Dasas: raises $3 to $4
matiko09: folds 
DanishWiking: folds 
SiD11211: folds 
123chambo: folds 
OriginalTony: folds 
Vikulja1993: calls $3
*** FLOP *** [5d 3s Qc]
Vikulja1993: checks 
flk.Dasas: bets $5.69
Vikulja1993: calls $5.69
*** TURN *** [5d 3s Qc] [4c]
Vikulja1993: checks 
flk.Dasas: bets $15
Vikulja1993: folds 
Uncalled bet ($15) returned to flk.Dasas
flk.Dasas collected $20.51 from pot
flk.Dasas: doesn't show hand 
*** SUMMARY ***
Total pot $21.48 | Rake $0.97 
Board [5d 3s Qc 4c]
Seat 2: SiD11211 folded before Flop (didn't bet)
Seat 3: 123chambo (button) folded before Flop (didn't bet)
Seat 4: OriginalTony (small blind) folded before Flop
Seat 5: Vikulja1993 (big blind) folded on the Turn
Seat 6: Pacifistas folded before Flop (didn't bet)
Seat 7: flk.Dasas collected ($20.51)
Seat 8: matiko09 folded before Flop (didn't bet)
Seat 9: DanishWiking folded before Flop (didn't bet)





PokerStars Hand #150708668066:  Hold'em No Limit ($0.50/$1.00 USD) - 2016/03/21 17:26:43 CET [2016/03/21 12:26:43 ET]
Table 'Goberta' 9-max Seat #5 is the button
Seat 2: mycka86 ($148.62 in chips) 
Seat 3: Khaine_CM ($100 in chips) 
Seat 4: matiko09 ($107.35 in chips) 
Seat 5: DevilisHEyz ($57.94 in chips) 
Seat 6: moffo13 ($43.98 in chips) 
Seat 7: Filojoes ($103 in chips) 
Seat 8: sanpidk ($100 in chips) 
Seat 9: blakenjaime ($121.88 in chips) 
moffo13: posts small blind $0.50
Filojoes: posts big blind $1
*** HOLE CARDS ***
Dealt to matiko09 [9c 7c]
sanpidk: folds 
blakenjaime: folds 
mycka86: folds 
Khaine_CM: folds 
matiko09: raises $1.50 to $2.50
DevilisHEyz has timed out
DevilisHEyz: folds 
moffo13: folds 
Filojoes: folds 
Uncalled bet ($1.50) returned to matiko09
matiko09 collected $2.50 from pot
matiko09: doesn't show hand 
*** SUMMARY ***
Total pot $2.50 | Rake $0 
Seat 2: mycka86 folded before Flop (didn't bet)
Seat 3: Khaine_CM folded before Flop (didn't bet)
Seat 4: matiko09 collected ($2.50)
Seat 5: DevilisHEyz (button) folded before Flop (didn't bet)
Seat 6: moffo13 (small blind) folded before Flop
Seat 7: Filojoes (big blind) folded before Flop
Seat 8: sanpidk folded before Flop (didn't bet)
Seat 9: blakenjaime folded before Flop (didn't bet)





PokerStars Hand #150708667278:  Hold'em No Limit ($0.50/$1.00 USD) - 2016/03/21 17:26:43 CET [2016/03/21 12:26:43 ET]
Table 'Onnie II' 9-max Seat #7 is the button
Seat 1: ka100pka527 ($126.82 in chips) 
Seat 2: RICKA16 ($104.37 in chips) 
Seat 4: Bothfeld11 ($146.56 in chips) 
Seat 6: Pacifistas ($106.67 in chips) 
Seat 7: djammusic ($72.90 in chips) 
Seat 8: solbi86 ($100 in chips) 
Seat 9: matiko09 ($128.58 in chips) 
solbi86: posts small blind $0.50
matiko09: posts big blind $1
DanishWiking: sits out 
Filojoes: sits out 
*** HOLE CARDS ***
Dealt to matiko09 [Td 4s]
ka100pka527: folds 
RICKA16: folds 
Bothfeld11: raises $1 to $2
Pacifistas: folds 
djammusic: folds 
solbi86: folds 
matiko09: folds 
Uncalled bet ($1) returned to Bothfeld11
Bothfeld11 collected $2.50 from pot
*** SUMMARY ***
Total pot $2.50 | Rake $0 
Seat 1: ka100pka527 folded before Flop (didn't bet)
Seat 2: RICKA16 folded before Flop (didn't bet)
Seat 4: Bothfeld11 collected ($2.50)
Seat 6: Pacifistas folded before Flop (didn't bet)
Seat 7: djammusic (button) folded before Flop (didn't bet)
Seat 8: solbi86 (small blind) folded before Flop
Seat 9: matiko09 (big blind) folded before Flop





PokerStars Hand #150708688197:  Hold'em No Limit ($0.50/$1.00 USD) - 2016/03/21 17:27:01 CET [2016/03/21 12:27:01 ET]
Table 'Hilda' 9-max Seat #1 is the button
Seat 1: djammusic ($52.59 in chips) 
Seat 2: blackmont111 ($104.66 in chips) 
Seat 3: Rikti ($42.36 in chips) 
Seat 4: Pacifistas ($109.07 in chips) 
Seat 5: solbi86 ($200.59 in chips) 
Seat 7: R1aki ($108.88 in chips) 
Seat 9: matiko09 ($105.50 in chips) 
blackmont111: posts small blind $0.50
Rikti: posts big blind $1
Dachish: sits out 
*** HOLE CARDS ***
Dealt to matiko09 [3h 8s]
Pacifistas: folds 
solbi86: folds 
R1aki: folds 
matiko09: folds 
hemetcano leaves the table
djammusic: raises $1.25 to $2.25
blackmont111: folds 
Rikti: folds 
Uncalled bet ($1.25) returned to djammusic
djammusic collected $2.50 from pot
djammusic: doesn't show hand 
*** SUMMARY ***
Total pot $2.50 | Rake $0 
Seat 1: djammusic (button) collected ($2.50)
Seat 2: blackmont111 (small blind) folded before Flop
Seat 3: Rikti (big blind) folded before Flop
Seat 4: Pacifistas folded before Flop (didn't bet)
Seat 5: solbi86 folded before Flop (didn't bet)
Seat 7: R1aki folded before Flop (didn't bet)
Seat 9: matiko09 folded before Flop (didn't bet)





PokerStars Hand #150708702844:  Hold'em No Limit ($0.50/$1.00 USD) - 2016/03/21 17:27:20 CET [2016/03/21 12:27:20 ET]
Table 'Onnie II' 9-max Seat #8 is the button
Seat 1: ka100pka527 ($126.82 in chips) 
Seat 2: RICKA16 ($104.37 in chips) 
Seat 4: Bothfeld11 ($148.06 in chips) 
Seat 6: Pacifistas ($106.67 in chips) 
Seat 7: djammusic ($72.90 in chips) 
Seat 8: solbi86 ($100 in chips) 
Seat 9: matiko09 ($127.58 in chips) 
matiko09: posts small blind $0.50
ka100pka527: posts big blind $1
DanishWiking: sits out 
Filojoes: sits out 
*** HOLE CARDS ***
Dealt to matiko09 [8h Ad]
RICKA16: folds 
Bothfeld11: folds 
Pacifistas: folds 
djammusic: folds 
solbi86: folds 
matiko09: calls $0.50
ka100pka527: raises $3 to $4
matiko09: calls $3
*** FLOP *** [8s Jh 3h]
matiko09: checks 
ka100pka527: checks 
*** TURN *** [8s Jh 3h] [Kh]
matiko09: checks 
ka100pka527: bets $3.82
matiko09: calls $3.82
*** RIVER *** [8s Jh 3h Kh] [2c]
matiko09: checks 
ka100pka527: bets $7.47
matiko09: folds 
Uncalled bet ($7.47) returned to ka100pka527
ka100pka527 collected $14.94 from pot
ka100pka527: doesn't show hand 
*** SUMMARY ***
Total pot $15.64 | Rake $0.70 
Board [8s Jh 3h Kh 2c]
Seat 1: ka100pka527 (big blind) collected ($14.94)
Seat 2: RICKA16 folded before Flop (didn't bet)
Seat 4: Bothfeld11 folded before Flop (didn't bet)
Seat 6: Pacifistas folded before Flop (didn't bet)
Seat 7: djammusic folded before Flop (didn't bet)
Seat 8: solbi86 (button) folded before Flop (didn't bet)
Seat 9: matiko09 (small blind) folded on the River





PokerStars Hand #150708707977:  Hold'em No Limit ($0.50/$1.00 USD) - 2016/03/21 17:27:27 CET [2016/03/21 12:27:27 ET]
Table 'Goberta' 9-max Seat #6 is the button
Seat 2: mycka86 ($148.62 in chips) 
Seat 3: Khaine_CM ($100 in chips) 
Seat 4: matiko09 ($108.85 in chips) 
Seat 6: moffo13 ($43.48 in chips) 
Seat 7: Filojoes ($102 in chips) 
Filojoes: posts small blind $0.50
sanpidk: is sitting out 
blakenjaime: is sitting out 
sanpidk leaves the table
mycka86: posts big blind $1
*** HOLE CARDS ***
Dealt to matiko09 [Jc 5h]
blakenjaime leaves the table
Khaine_CM: raises $2 to $3
matiko09: folds 
moffo13: folds 
Filojoes: folds 
mycka86: calls $2
*** FLOP *** [Th 2h 8d]
mycka86: checks 
Khaine_CM: bets $4
mycka86: folds 
Uncalled bet ($4) returned to Khaine_CM
aseban11 leaves the table
Khaine_CM collected $6.21 from pot
Khaine_CM: doesn't show hand 
*** SUMMARY ***
Total pot $6.50 | Rake $0.29 
Board [Th 2h 8d]
Seat 2: mycka86 (big blind) folded on the Flop
Seat 3: Khaine_CM collected ($6.21)
Seat 4: matiko09 folded before Flop (didn't bet)
Seat 6: moffo13 (button) folded before Flop (didn't bet)
Seat 7: Filojoes (small blind) folded before Flop





PokerStars Hand #150708708908:  Hold'em No Limit ($0.50/$1.00 USD) - 2016/03/21 17:27:28 CET [2016/03/21 12:27:28 ET]
Table 'Marmulla II' 9-max Seat #3 is the button
Seat 2: flk.Dasas ($100 in chips) 
Seat 3: Vikulja1993 ($133.54 in chips) 
Seat 4: Dachish ($83.73 in chips) 
Seat 5: maaaGik88 ($86.10 in chips) 
Seat 6: R1aki ($130.14 in chips) 
Seat 7: Pacifistas ($101.10 in chips) 
Seat 8: sanpidk ($102.50 in chips) 
Seat 9: matiko09 ($100 in chips) 
Dachish: posts small blind $0.50
maaaGik88: posts big blind $1
*** HOLE CARDS ***
Dealt to matiko09 [8d 2c]
R1aki: folds 
Pacifistas: folds 
sanpidk: folds 
matiko09: folds 
flk.Dasas: folds 
Vikulja1993: raises $1 to $2
Dachish: raises $5 to $7
maaaGik88: folds 
Vikulja1993: calls $5
*** FLOP *** [Qd 4h Ah]
Dachish: bets $7.01
Vikulja1993: folds 
Uncalled bet ($7.01) returned to Dachish
Dachish collected $14.32 from pot
Dachish: doesn't show hand 
*** SUMMARY ***
Total pot $15 | Rake $0.68 
Board [Qd 4h Ah]
Seat 2: flk.Dasas folded before Flop (didn't bet)
Seat 3: Vikulja1993 (button) folded on the Flop
Seat 4: Dachish (small blind) collected ($14.32)
Seat 5: maaaGik88 (big blind) folded before Flop
Seat 6: R1aki folded before Flop (didn't bet)
Seat 7: Pacifistas folded before Flop (didn't bet)
Seat 8: sanpidk folded before Flop (didn't bet)
Seat 9: matiko09 folded before Flop (didn't bet)





PokerStars Hand #150708718269:  Hold'em No Limit ($0.50/$1.00 USD) - 2016/03/21 17:27:40 CET [2016/03/21 12:27:40 ET]
Table 'Hilda' 9-max Seat #2 is the button
Seat 1: djammusic ($54.09 in chips) 
Seat 2: blackmont111 ($104.16 in chips) 
Seat 3: Rikti ($41.36 in chips) 
Seat 4: Pacifistas ($109.07 in chips) 
Seat 5: solbi86 ($200.59 in chips) 
Seat 7: R1aki ($108.88 in chips) 
Seat 9: matiko09 ($105.50 in chips) 
Rikti: posts small blind $0.50
Pacifistas: posts big blind $1
Dachish: sits out 
*** HOLE CARDS ***
Dealt to matiko09 [3d Jd]
solbi86: folds 
R1aki has timed out
R1aki: folds 
matiko09: folds 
aseban11 joins the table at seat #6 
aseban11 leaves the table
djammusic: raises $1.50 to $2.50
IntsAA joins the table at seat #6 
blackmont111: raises $3.50 to $6
Rikti: folds 
Pacifistas: folds 
djammusic: calls $3.50
*** FLOP *** [Jc 5s Kd]
solbi86 leaves the table
djammusic: checks 
blackmont111: bets $6
djammusic: folds 
Uncalled bet ($6) returned to blackmont111
blackmont111 collected $12.89 from pot
blackmont111: doesn't show hand 
*** SUMMARY ***
Total pot $13.50 | Rake $0.61 
Board [Jc 5s Kd]
Seat 1: djammusic folded on the Flop
Seat 2: blackmont111 (button) collected ($12.89)
Seat 3: Rikti (small blind) folded before Flop
Seat 4: Pacifistas (big blind) folded before Flop
Seat 5: solbi86 folded before Flop (didn't bet)
Seat 7: R1aki folded before Flop (didn't bet)
Seat 9: matiko09 folded before Flop (didn't bet)





PokerStars Hand #150708739844:  Hold'em No Limit ($0.50/$1.00 USD) - 2016/03/21 17:28:08 CET [2016/03/21 12:28:08 ET]
Table 'Massalia II' 9-max Seat #4 is the button
Seat 2: SiD11211 ($120.19 in chips) 
Seat 3: 123chambo ($148.73 in chips) 
Seat 4: OriginalTony ($94 in chips) 
Seat 5: Vikulja1993 ($100 in chips) 
Seat 6: Pacifistas ($103.76 in chips) 
Seat 7: flk.Dasas ($110.62 in chips) 
Seat 8: matiko09 ($165.58 in chips) 
Seat 9: DanishWiking ($110.76 in chips) 
Vikulja1993: posts small blind $0.50
Pacifistas: posts big blind $1
ceedonen: sits out 
SiD11211: posts the ante $0.20
123chambo: posts the ante $0.20
OriginalTony: posts the ante $0.20
Vikulja1993: posts the ante $0.20
Pacifistas: posts the ante $0.20
flk.Dasas: posts the ante $0.20
matiko09: posts the ante $0.20
DanishWiking: posts the ante $0.20
*** HOLE CARDS ***
Dealt to matiko09 [Kd 8d]
flk.Dasas: folds 
flk.Dasas leaves the table
matiko09: folds 
DanishWiking: folds 
SiD11211: folds 
123chambo: folds 
OriginalTony: raises $2 to $3
Vikulja1993: calls $2.50
Pacifistas: calls $2
*** FLOP *** [4s 2c 9s]
volwebni4ek joins the table at seat #7 
Vikulja1993: checks 
Pacifistas: checks 
OriginalTony: checks 
*** TURN *** [4s 2c 9s] [Jc]
Vikulja1993: bets $7
Pacifistas: folds 
OriginalTony: folds 
Uncalled bet ($7) returned to Vikulja1993
Vikulja1993 collected $10.12 from pot
Vikulja1993: doesn't show hand 
*** SUMMARY ***
Total pot $10.60 | Rake $0.48 
Board [4s 2c 9s Jc]
Seat 2: SiD11211 folded before Flop (didn't bet)
Seat 3: 123chambo folded before Flop (didn't bet)
Seat 4: OriginalTony (button) folded on the Turn
Seat 5: Vikulja1993 (small blind) collected ($10.12)
Seat 6: Pacifistas (big blind) folded on the Turn
Seat 7: flk.Dasas folded before Flop (didn't bet)
Seat 8: matiko09 folded before Flop (didn't bet)
Seat 9: DanishWiking folded before Flop (didn't bet)





PokerStars Hand #150708751603:  Hold'em No Limit ($0.50/$1.00 USD) - 2016/03/21 17:28:23 CET [2016/03/21 12:28:23 ET]
Table 'Marmulla II' 9-max Seat #4 is the button
Seat 2: flk.Dasas ($100 in chips) 
Seat 3: Vikulja1993 ($126.54 in chips) 
Seat 4: Dachish ($91.05 in chips) 
Seat 5: maaaGik88 ($85.10 in chips) 
Seat 6: R1aki ($130.14 in chips) 
Seat 7: Pacifistas ($101.10 in chips) 
Seat 8: sanpidk ($102.50 in chips) 
Seat 9: matiko09 ($100 in chips) 
maaaGik88: posts small blind $0.50
R1aki: posts big blind $1
*** HOLE CARDS ***
Dealt to matiko09 [8c Kd]
Pacifistas: folds 
sanpidk: folds 
matiko09: folds 
flk.Dasas: raises $2 to $3
Vikulja1993: folds 
Dachish: folds 
maaaGik88: folds 
R1aki: folds 
Uncalled bet ($2) returned to flk.Dasas
flk.Dasas collected $2.50 from pot
flk.Dasas: doesn't show hand 
*** SUMMARY ***
Total pot $2.50 | Rake $0 
Seat 2: flk.Dasas collected ($2.50)
Seat 3: Vikulja1993 folded before Flop (didn't bet)
Seat 4: Dachish (button) folded before Flop (didn't bet)
Seat 5: maaaGik88 (small blind) folded before Flop
Seat 6: R1aki (big blind) folded before Flop
Seat 7: Pacifistas folded before Flop (didn't bet)
Seat 8: sanpidk folded before Flop (didn't bet)
Seat 9: matiko09 folded before Flop (didn't bet)





PokerStars Hand #150708752417:  Hold'em No Limit ($0.50/$1.00 USD) - 2016/03/21 17:28:25 CET [2016/03/21 12:28:25 ET]
Table 'Goberta' 9-max Seat #7 is the button
Seat 2: mycka86 ($145.62 in chips) 
Seat 3: Khaine_CM ($103.21 in chips) 
Seat 4: matiko09 ($108.85 in chips) 
Seat 5: DevilisHEyz ($57.94 in chips) 
Seat 6: moffo13 ($43.48 in chips) 
Seat 7: Filojoes ($101.50 in chips) 
mycka86: posts small blind $0.50
Khaine_CM: posts big blind $1
*** HOLE CARDS ***
Dealt to matiko09 [Qd 2d]
Pacifistas joins the table at seat #8 
matiko09: folds 
DevilisHEyz: folds 
moffo13: folds 
Filojoes: folds 
mycka86: raises $1.75 to $2.75
Khaine_CM: calls $1.75
*** FLOP *** [5s 4c 9h]
lysandrafly joins the table at seat #9 
mycka86: bets $2.88
Khaine_CM: calls $2.88
*** TURN *** [5s 4c 9h] [4h]
solbi86 joins the table at seat #1 
mycka86: bets $7.50
Khaine_CM: calls $7.50
*** RIVER *** [5s 4c 9h 4h] [6c]
mycka86: checks 
Khaine_CM: checks 
*** SHOW DOWN ***
mycka86: shows [Kh 2h] (a pair of Fours)
Khaine_CM: shows [9c 8h] (two pair, Nines and Fours)
Khaine_CM collected $25.08 from pot
*** SUMMARY ***
Total pot $26.26 | Rake $1.18 
Board [5s 4c 9h 4h 6c]
Seat 2: mycka86 (small blind) showed [Kh 2h] and lost with a pair of Fours
Seat 3: Khaine_CM (big blind) showed [9c 8h] and won ($25.08) with two pair, Nines and Fours
Seat 4: matiko09 folded before Flop (didn't bet)
Seat 5: DevilisHEyz folded before Flop (didn't bet)
Seat 6: moffo13 folded before Flop (didn't bet)
Seat 7: Filojoes (button) folded before Flop (didn't bet)





PokerStars Hand #150708763648:  Hold'em No Limit ($0.50/$1.00 USD) - 2016/03/21 17:28:39 CET [2016/03/21 12:28:39 ET]
Table 'Harding II' 9-max Seat #2 is the button
Seat 1: Vikulja1993 ($101.50 in chips) 
Seat 2: IntsAA ($220.62 in chips) 
Seat 3: iamkingan ($87.61 in chips) 
Seat 4: matiko09 ($100.23 in chips) 
Seat 7: MartinJ1234 ($78.26 in chips) 
Seat 8: solbi86 ($107.83 in chips) 
Seat 9: ka100pka527 ($40 in chips) 
iamkingan: posts small blind $0.50
matiko09: posts big blind $1
DanishWiking: sits out 
Dachish: sits out 
*** HOLE CARDS ***
Dealt to matiko09 [Td 8c]
MartinJ1234: folds 
solbi86: folds 
ka100pka527: folds 
Vikulja1993: folds 
IntsAA: raises $1.10 to $2.10
iamkingan: calls $1.60
matiko09: folds 
*** FLOP *** [Kd Ac 3s]
iamkingan: checks 
IntsAA: bets $3.42
iamkingan: calls $3.42
*** TURN *** [Kd Ac 3s] [9c]
iamkingan: checks 
IntsAA: checks 
*** RIVER *** [Kd Ac 3s 9c] [4c]
iamkingan: checks 
IntsAA: checks 
*** SHOW DOWN ***
iamkingan: shows [5d Ad] (a pair of Aces)
IntsAA: mucks hand 
iamkingan collected $11.50 from pot
*** SUMMARY ***
Total pot $12.04 | Rake $0.54 
Board [Kd Ac 3s 9c 4c]
Seat 1: Vikulja1993 folded before Flop (didn't bet)
Seat 2: IntsAA (button) mucked [6h 9h]
Seat 3: iamkingan (small blind) showed [5d Ad] and won ($11.50) with a pair of Aces
Seat 4: matiko09 (big blind) folded before Flop
Seat 7: MartinJ1234 folded before Flop (didn't bet)
Seat 8: solbi86 folded before Flop (didn't bet)
Seat 9: ka100pka527 folded before Flop (didn't bet)





PokerStars Hand #150708786626:  Hold'em No Limit ($0.50/$1.00 USD) - 2016/03/21 17:29:08 CET [2016/03/21 12:29:08 ET]
Table 'Marmulla II' 9-max Seat #5 is the button
Seat 2: flk.Dasas ($101.50 in chips) 
Seat 3: Vikulja1993 ($126.54 in chips) 
Seat 4: Dachish ($91.05 in chips) 
Seat 5: maaaGik88 ($84.60 in chips) 
Seat 6: R1aki ($129.14 in chips) 
Seat 7: Pacifistas ($101.10 in chips) 
Seat 8: sanpidk ($102.50 in chips) 
Seat 9: matiko09 ($100 in chips) 
R1aki: posts small blind $0.50
Pacifistas: posts big blind $1
*** HOLE CARDS ***
Dealt to matiko09 [9c 2h]
sanpidk: folds 
matiko09: folds 
flk.Dasas: folds 
Vikulja1993: raises $2 to $3
Dachish: calls $3
maaaGik88: folds 
R1aki: folds 
Pacifistas: calls $2
*** FLOP *** [Jc Qs 6s]
Pacifistas: checks 
Vikulja1993: bets $3
Dachish: folds 
Pacifistas: calls $3
*** TURN *** [Jc Qs 6s] [3d]
Pacifistas: checks 
Vikulja1993: bets $12
sanpidk leaves the table
ffac joins the table at seat #8 
Pacifistas: folds 
Uncalled bet ($12) returned to Vikulja1993
Vikulja1993 collected $14.80 from pot
Vikulja1993: doesn't show hand 
*** SUMMARY ***
Total pot $15.50 | Rake $0.70 
Board [Jc Qs 6s 3d]
Seat 2: flk.Dasas folded before Flop (didn't bet)
Seat 3: Vikulja1993 collected ($14.80)
Seat 4: Dachish folded on the Flop
Seat 5: maaaGik88 (button) folded before Flop (didn't bet)
Seat 6: R1aki (small blind) folded before Flop
Seat 7: Pacifistas (big blind) folded on the Turn
Seat 8: sanpidk folded before Flop (didn't bet)
Seat 9: matiko09 folded before Flop (didn't bet)





PokerStars Hand #150708788197:  Hold'em No Limit ($0.50/$1.00 USD) - 2016/03/21 17:29:10 CET [2016/03/21 12:29:10 ET]
Table 'Massalia II' 9-max Seat #5 is the button
Seat 2: SiD11211 ($119.99 in chips) 
Seat 3: 123chambo ($148.53 in chips) 
Seat 4: OriginalTony ($90.80 in chips) 
Seat 5: Vikulja1993 ($106.92 in chips) 
Seat 6: Pacifistas ($100.56 in chips) 
Seat 8: matiko09 ($165.38 in chips) 
Seat 9: DanishWiking ($110.56 in chips) 
Pacifistas: posts small blind $0.50
matiko09: posts big blind $1
ceedonen: sits out 
SiD11211: posts the ante $0.20
123chambo: posts the ante $0.20
OriginalTony: posts the ante $0.20
Vikulja1993: posts the ante $0.20
Pacifistas: posts the ante $0.20
matiko09: posts the ante $0.20
DanishWiking: posts the ante $0.20
*** HOLE CARDS ***
Dealt to matiko09 [4s 6c]
DanishWiking: raises $2 to $3
SiD11211: folds 
123chambo: folds 
OriginalTony: folds 
Vikulja1993: folds 
Pacifistas: folds 
matiko09: folds 
Uncalled bet ($2) returned to DanishWiking
DanishWiking collected $3.90 from pot
DanishWiking: doesn't show hand 
*** SUMMARY ***
Total pot $3.90 | Rake $0 
Seat 2: SiD11211 folded before Flop (didn't bet)
Seat 3: 123chambo folded before Flop (didn't bet)
Seat 4: OriginalTony folded before Flop (didn't bet)
Seat 5: Vikulja1993 (button) folded before Flop (didn't bet)
Seat 6: Pacifistas (small blind) folded before Flop
Seat 8: matiko09 (big blind) folded before Flop
Seat 9: DanishWiking collected ($3.90)





PokerStars Hand #150708794811:  Hold'em No Limit ($0.50/$1.00 USD) - 2016/03/21 17:29:19 CET [2016/03/21 12:29:19 ET]
Table 'Hilda' 9-max Seat #3 is the button
Seat 1: djammusic ($48.09 in chips) 
Seat 2: blackmont111 ($111.05 in chips) 
Seat 3: Rikti ($40.86 in chips) 
Seat 4: Pacifistas ($108.07 in chips) 
Seat 6: IntsAA ($96 in chips) 
Seat 7: R1aki ($108.88 in chips) 
Seat 9: matiko09 ($105.50 in chips) 
Pacifistas: posts small blind $0.50
IntsAA: posts big blind $1
Dachish: sits out 
*** HOLE CARDS ***
Dealt to matiko09 [8s 4h]
R1aki: folds 
R1aki leaves the table
matiko09: folds 
djammusic: folds 
blackmont111: folds 
DanishWiking joins the table at seat #7 
cobrik23 joins the table at seat #5 
Rikti: folds 
Pacifistas: raises $1.50 to $2.50
IntsAA: folds 
Uncalled bet ($1.50) returned to Pacifistas
Pacifistas collected $2 from pot
Pacifistas: doesn't show hand 
*** SUMMARY ***
Total pot $2 | Rake $0 
Seat 1: djammusic folded before Flop (didn't bet)
Seat 2: blackmont111 folded before Flop (didn't bet)
Seat 3: Rikti (button) folded before Flop (didn't bet)
Seat 4: Pacifistas (small blind) collected ($2)
Seat 6: IntsAA (big blind) folded before Flop
Seat 7: R1aki folded before Flop (didn't bet)
Seat 9: matiko09 folded before Flop (didn't bet)





PokerStars Hand #150708809543:  Hold'em No Limit ($0.50/$1.00 USD) - 2016/03/21 17:29:38 CET [2016/03/21 12:29:38 ET]
Table 'Massalia II' 9-max Seat #6 is the button
Seat 2: SiD11211 ($119.79 in chips) 
Seat 3: 123chambo ($148.33 in chips) 
Seat 4: OriginalTony ($90.60 in chips) 
Seat 5: Vikulja1993 ($106.72 in chips) 
Seat 6: Pacifistas ($100 in chips) 
Seat 8: matiko09 ($164.18 in chips) 
Seat 9: DanishWiking ($113.26 in chips) 
matiko09: posts small blind $0.50
DanishWiking: posts big blind $1
ceedonen: sits out 
SiD11211: posts the ante $0.20
123chambo: posts the ante $0.20
OriginalTony: posts the ante $0.20
Vikulja1993: posts the ante $0.20
Pacifistas: posts the ante $0.20
matiko09: posts the ante $0.20
DanishWiking: posts the ante $0.20
*** HOLE CARDS ***
Dealt to matiko09 [3s 4c]
SiD11211: folds 
123chambo: folds 
OriginalTony: folds 
Vikulja1993: raises $1.50 to $2.50
Pacifistas: calls $2.50
matiko09: folds 
DanishWiking: folds 
*** FLOP *** [5h 3c 8c]
Vikulja1993: bets $4
Pacifistas: calls $4
*** TURN *** [5h 3c 8c] [Ts]
Vikulja1993: bets $10
Pacifistas: calls $10
*** RIVER *** [5h 3c 8c Ts] [Jh]
Vikulja1993: bets $24
Pacifistas: folds 
Uncalled bet ($24) returned to Vikulja1993
Vikulja1993 collected $34.28 from pot
Vikulja1993: doesn't show hand 
*** SUMMARY ***
Total pot $35.90 | Rake $1.62 
Board [5h 3c 8c Ts Jh]
Seat 2: SiD11211 folded before Flop (didn't bet)
Seat 3: 123chambo folded before Flop (didn't bet)
Seat 4: OriginalTony folded before Flop (didn't bet)
Seat 5: Vikulja1993 collected ($34.28)
Seat 6: Pacifistas (button) folded on the River
Seat 8: matiko09 (small blind) folded before Flop
Seat 9: DanishWiking (big blind) folded before Flop





PokerStars Hand #150708817046:  Hold'em No Limit ($0.50/$1.00 USD) - 2016/03/21 17:29:47 CET [2016/03/21 12:29:47 ET]
Table 'Onnie II' 9-max Seat #9 is the button
Seat 1: ka100pka527 ($133.94 in chips) 
Seat 2: RICKA16 ($104.37 in chips) 
Seat 4: Bothfeld11 ($148.06 in chips) 
Seat 6: Pacifistas ($106.67 in chips) 
Seat 7: djammusic ($72.90 in chips) 
Seat 8: solbi86 ($100 in chips) 
Seat 9: matiko09 ($119.76 in chips) 
ka100pka527: posts small blind $0.50
RICKA16: posts big blind $1
DanishWiking: sits out 
Filojoes: sits out 
*** HOLE CARDS ***
Dealt to matiko09 [2d 5s]
Bothfeld11: folds 
Pacifistas: folds 
djammusic: folds 
solbi86: folds 
matiko09: folds 
ka100pka527: raises $2 to $3
RICKA16: calls $2
*** FLOP *** [Qs Ad 3s]
ka100pka527: bets $3.81
RICKA16: folds 
Uncalled bet ($3.81) returned to ka100pka527
ka100pka527 collected $5.73 from pot
ka100pka527: doesn't show hand 
*** SUMMARY ***
Total pot $6 | Rake $0.27 
Board [Qs Ad 3s]
Seat 1: ka100pka527 (small blind) collected ($5.73)
Seat 2: RICKA16 (big blind) folded on the Flop
Seat 4: Bothfeld11 folded before Flop (didn't bet)
Seat 6: Pacifistas folded before Flop (didn't bet)
Seat 7: djammusic folded before Flop (didn't bet)
Seat 8: solbi86 folded before Flop (didn't bet)
Seat 9: matiko09 (button) folded before Flop (didn't bet)





PokerStars Hand #150708834459:  Hold'em No Limit ($0.50/$1.00 USD) - 2016/03/21 17:30:09 CET [2016/03/21 12:30:09 ET]
Table 'Harding II' 9-max Seat #3 is the button
Seat 1: Vikulja1993 ($101.50 in chips) 
Seat 2: IntsAA ($215.10 in chips) 
Seat 3: iamkingan ($93.59 in chips) 
Seat 4: matiko09 ($100 in chips) 
Seat 5: DanishWiking ($100 in chips) 
Seat 7: MartinJ1234 ($78.26 in chips) 
Seat 8: solbi86 ($107.83 in chips) 
Seat 9: ka100pka527 ($40 in chips) 
matiko09: posts small blind $0.50
DanishWiking: posts big blind $1
Dachish: sits out 
*** HOLE CARDS ***
Dealt to matiko09 [6c Kh]
MartinJ1234: folds 
solbi86: folds 
ka100pka527: folds 
Vikulja1993: raises $2 to $3
IntsAA: folds 
iamkingan: folds 
matiko09: folds 
DanishWiking: calls $2
*** FLOP *** [8c 6h 2h]
DanishWiking: checks 
Vikulja1993: bets $3
DanishWiking: raises $7 to $10
Vikulja1993: folds 
Uncalled bet ($7) returned to DanishWiking
DanishWiking collected $11.94 from pot
DanishWiking: doesn't show hand 
*** SUMMARY ***
Total pot $12.50 | Rake $0.56 
Board [8c 6h 2h]
Seat 1: Vikulja1993 folded on the Flop
Seat 2: IntsAA folded before Flop (didn't bet)
Seat 3: iamkingan (button) folded before Flop (didn't bet)
Seat 4: matiko09 (small blind) folded before Flop
Seat 5: DanishWiking (big blind) collected ($11.94)
Seat 7: MartinJ1234 folded before Flop (didn't bet)
Seat 8: solbi86 folded before Flop (didn't bet)
Seat 9: ka100pka527 folded before Flop (didn't bet)





PokerStars Hand #150708834875:  Hold'em No Limit ($0.50/$1.00 USD) - 2016/03/21 17:30:10 CET [2016/03/21 12:30:10 ET]
Table 'Hilda' 9-max Seat #4 is the button
Seat 1: djammusic ($48.09 in chips) 
Seat 2: blackmont111 ($111.05 in chips) 
Seat 3: Rikti ($40.86 in chips) 
Seat 4: Pacifistas ($109.07 in chips) 
Seat 6: IntsAA ($96 in chips) 
Seat 7: DanishWiking ($100 in chips) 
Seat 9: matiko09 ($105.50 in chips) 
cobrik23 will be allowed to play after the button
IntsAA: posts small blind $0.50
DanishWiking: posts big blind $1
Dachish: sits out 
*** HOLE CARDS ***
Dealt to matiko09 [5c Ac]
matiko09: folds 
djammusic: folds 
blackmont111: raises $2 to $3
Rikti: folds 
Pacifistas: folds 
IntsAA: folds 
DanishWiking: folds 
Uncalled bet ($2) returned to blackmont111
blackmont111 collected $2.50 from pot
*** SUMMARY ***
Total pot $2.50 | Rake $0 
Seat 1: djammusic folded before Flop (didn't bet)
Seat 2: blackmont111 collected ($2.50)
Seat 3: Rikti folded before Flop (didn't bet)
Seat 4: Pacifistas (button) folded before Flop (didn't bet)
Seat 6: IntsAA (small blind) folded before Flop
Seat 7: DanishWiking (big blind) folded before Flop
Seat 9: matiko09 folded before Flop (didn't bet)





PokerStars Hand #150708848360:  Hold'em No Limit ($0.50/$1.00 USD) - 2016/03/21 17:30:28 CET [2016/03/21 12:30:28 ET]
Table 'Onnie II' 9-max Seat #1 is the button
Seat 1: ka100pka527 ($136.67 in chips) 
Seat 2: RICKA16 ($101.37 in chips) 
Seat 3: DanishWiking ($100 in chips) 
Seat 4: Bothfeld11 ($148.06 in chips) 
Seat 6: Pacifistas ($106.67 in chips) 
Seat 7: djammusic ($72.90 in chips) 
Seat 8: solbi86 ($100 in chips) 
Seat 9: matiko09 ($119.76 in chips) 
RICKA16: posts small blind $0.50
DanishWiking: posts big blind $1
Filojoes: sits out 
*** HOLE CARDS ***
Dealt to matiko09 [Qd Jd]
Bothfeld11: calls $1
Pacifistas: folds 
djammusic: raises $2.50 to $3.50
solbi86: folds 
matiko09: calls $3.50
ka100pka527: folds 
RICKA16: folds 
DanishWiking: folds 
Bothfeld11: calls $2.50
*** FLOP *** [3c 5d Ks]
Bothfeld11: bets $2
djammusic: folds 
matiko09: calls $2
*** TURN *** [3c 5d Ks] [9d]
Bothfeld11: bets $4
matiko09: calls $4
*** RIVER *** [3c 5d Ks 9d] [Ad]
Bothfeld11: bets $4
matiko09: raises $13 to $17
Bothfeld11: folds 
Uncalled bet ($13) returned to matiko09
matiko09 collected $30.56 from pot
matiko09: doesn't show hand 
*** SUMMARY ***
Total pot $32 | Rake $1.44 
Board [3c 5d Ks 9d Ad]
Seat 1: ka100pka527 (button) folded before Flop (didn't bet)
Seat 2: RICKA16 (small blind) folded before Flop
Seat 3: DanishWiking (big blind) folded before Flop
Seat 4: Bothfeld11 folded on the River
Seat 6: Pacifistas folded before Flop (didn't bet)
Seat 7: djammusic folded on the Flop
Seat 8: solbi86 folded before Flop (didn't bet)
Seat 9: matiko09 collected ($30.56)





PokerStars Hand #150708855378:  Hold'em No Limit ($0.50/$1.00 USD) - 2016/03/21 17:30:36 CET [2016/03/21 12:30:36 ET]
Table 'Marmulla II' 9-max Seat #6 is the button
Seat 2: flk.Dasas ($101.50 in chips) 
Seat 3: Vikulja1993 ($135.34 in chips) 
Seat 4: Dachish ($88.05 in chips) 
Seat 5: maaaGik88 ($84.60 in chips) 
Seat 6: R1aki ($128.64 in chips) 
Seat 7: Pacifistas ($100 in chips) 
Seat 8: ffac ($100 in chips) 
Seat 9: matiko09 ($100 in chips) 
Pacifistas: posts small blind $0.50
ffac: posts big blind $1
*** HOLE CARDS ***
Dealt to matiko09 [8s 4c]
matiko09: folds 
flk.Dasas: folds 
Vikulja1993: folds 
Dachish: folds 
maaaGik88: raises $1 to $2
R1aki: folds 
Pacifistas: folds 
ffac: folds 
Uncalled bet ($1) returned to maaaGik88
maaaGik88 collected $2.50 from pot
maaaGik88: doesn't show hand 
*** SUMMARY ***
Total pot $2.50 | Rake $0 
Seat 2: flk.Dasas folded before Flop (didn't bet)
Seat 3: Vikulja1993 folded before Flop (didn't bet)
Seat 4: Dachish folded before Flop (didn't bet)
Seat 5: maaaGik88 collected ($2.50)
Seat 6: R1aki (button) folded before Flop (didn't bet)
Seat 7: Pacifistas (small blind) folded before Flop
Seat 8: ffac (big blind) folded before Flop
Seat 9: matiko09 folded before Flop (didn't bet)





PokerStars Hand #150708888055:  Hold'em No Limit ($0.50/$1.00 USD) - 2016/03/21 17:31:18 CET [2016/03/21 12:31:18 ET]
Table 'Marmulla II' 9-max Seat #7 is the button
Seat 2: flk.Dasas ($101.50 in chips) 
Seat 3: Vikulja1993 ($135.34 in chips) 
Seat 4: Dachish ($88.05 in chips) 
Seat 5: maaaGik88 ($86.10 in chips) 
Seat 6: R1aki ($128.64 in chips) 
Seat 7: Pacifistas ($100 in chips) 
Seat 8: ffac ($100 in chips) 
Seat 9: matiko09 ($100 in chips) 
ffac: posts small blind $0.50
matiko09: posts big blind $1
*** HOLE CARDS ***
Dealt to matiko09 [4h Kc]
flk.Dasas: folds 
Vikulja1993: folds 
Dachish: folds 
maaaGik88: folds 
R1aki: folds 
Pacifistas: raises $1.50 to $2.50
ffac: folds 
matiko09: folds 
Uncalled bet ($1.50) returned to Pacifistas
Pacifistas collected $2.50 from pot
Pacifistas: doesn't show hand 
*** SUMMARY ***
Total pot $2.50 | Rake $0 
Seat 2: flk.Dasas folded before Flop (didn't bet)
Seat 3: Vikulja1993 folded before Flop (didn't bet)
Seat 4: Dachish folded before Flop (didn't bet)
Seat 5: maaaGik88 folded before Flop (didn't bet)
Seat 6: R1aki folded before Flop (didn't bet)
Seat 7: Pacifistas (button) collected ($2.50)
Seat 8: ffac (small blind) folded before Flop
Seat 9: matiko09 (big blind) folded before Flop





PokerStars Hand #150708894686:  Hold'em No Limit ($0.50/$1.00 USD) - 2016/03/21 17:31:27 CET [2016/03/21 12:31:27 ET]
Table 'Harding II' 9-max Seat #4 is the button
Seat 1: Vikulja1993 ($100 in chips) 
Seat 2: IntsAA ($215.10 in chips) 
Seat 3: iamkingan ($93.59 in chips) 
Seat 4: matiko09 ($100 in chips) 
Seat 5: DanishWiking ($105.94 in chips) 
Seat 6: Dachish ($70 in chips) 
Seat 7: MartinJ1234 ($78.26 in chips) 
Seat 8: solbi86 ($107.83 in chips) 
Seat 9: ka100pka527 ($40 in chips) 
DanishWiking: posts small blind $0.50
Dachish: posts big blind $1
*** HOLE CARDS ***
Dealt to matiko09 [2s Ah]
MartinJ1234: folds 
solbi86: folds 
ka100pka527: folds 
MartinJ1234 leaves the table
Vikulja1993 has timed out
Vikulja1993: folds 
IntsAA: folds 
iamkingan: calls $1
matiko09: raises $3 to $4
DanishWiking: folds 
Dachish: calls $3
iamkingan: calls $3
*** FLOP *** [9s Td 5s]
Dachish: checks 
RICKA16 joins the table at seat #7 
iamkingan: checks 
matiko09: checks 
*** TURN *** [9s Td 5s] [Th]
Dachish: checks 
iamkingan: checks 
matiko09: checks 
*** RIVER *** [9s Td 5s Th] [9d]
Dachish: checks 
iamkingan: bets $8
matiko09: folds 
Dachish: folds 
Uncalled bet ($8) returned to iamkingan
iamkingan collected $11.94 from pot
*** SUMMARY ***
Total pot $12.50 | Rake $0.56 
Board [9s Td 5s Th 9d]
Seat 1: Vikulja1993 folded before Flop (didn't bet)
Seat 2: IntsAA folded before Flop (didn't bet)
Seat 3: iamkingan collected ($11.94)
Seat 4: matiko09 (button) folded on the River
Seat 5: DanishWiking (small blind) folded before Flop
Seat 6: Dachish (big blind) folded on the River
Seat 7: MartinJ1234 folded before Flop (didn't bet)
Seat 8: solbi86 folded before Flop (didn't bet)
Seat 9: ka100pka527 folded before Flop (didn't bet)





PokerStars Hand #150708902526:  Hold'em No Limit ($0.50/$1.00 USD) - 2016/03/21 17:31:37 CET [2016/03/21 12:31:37 ET]
Table 'Onnie II' 9-max Seat #2 is the button
Seat 1: ka100pka527 ($136.67 in chips) 
Seat 2: RICKA16 ($100.87 in chips) 
Seat 3: DanishWiking ($100 in chips) 
Seat 4: Bothfeld11 ($134.56 in chips) 
Seat 6: Pacifistas ($106.67 in chips) 
Seat 7: djammusic ($69.40 in chips) 
Seat 8: solbi86 ($100 in chips) 
Seat 9: matiko09 ($136.82 in chips) 
DanishWiking: posts small blind $0.50
Bothfeld11: posts big blind $1
Filojoes: sits out 
*** HOLE CARDS ***
Dealt to matiko09 [Tc 5d]
Pacifistas: folds 
djammusic: folds 
solbi86: folds 
matiko09: folds 
ka100pka527: raises $2 to $3
RICKA16: folds 
DanishWiking: folds 
Bothfeld11: calls $2
*** FLOP *** [6s Qs Jc]
Bothfeld11: checks 
ka100pka527: bets $4.13
Bothfeld11: calls $4.13
*** TURN *** [6s Qs Jc] [2d]
Bothfeld11: checks 
ka100pka527: bets $9.39
Bothfeld11: folds 
Uncalled bet ($9.39) returned to ka100pka527
ka100pka527 collected $14.10 from pot
ka100pka527: doesn't show hand 
*** SUMMARY ***
Total pot $14.76 | Rake $0.66 
Board [6s Qs Jc 2d]
Seat 1: ka100pka527 collected ($14.10)
Seat 2: RICKA16 (button) folded before Flop (didn't bet)
Seat 3: DanishWiking (small blind) folded before Flop
Seat 4: Bothfeld11 (big blind) folded on the Turn
Seat 6: Pacifistas folded before Flop (didn't bet)
Seat 7: djammusic folded before Flop (didn't bet)
Seat 8: solbi86 folded before Flop (didn't bet)
Seat 9: matiko09 folded before Flop (didn't bet)





PokerStars Hand #150708926065:  Hold'em No Limit ($0.50/$1.00 USD) - 2016/03/21 17:32:07 CET [2016/03/21 12:32:07 ET]
Table 'Massalia II' 9-max Seat #8 is the button
Seat 1: ceedonen ($100 in chips) 
Seat 2: SiD11211 ($119.59 in chips) 
Seat 3: 123chambo ($148.13 in chips) 
Seat 4: OriginalTony ($90.40 in chips) 
Seat 5: Vikulja1993 ($124.30 in chips) 
Seat 6: Pacifistas ($100 in chips) 
Seat 8: matiko09 ($163.48 in chips) 
Seat 9: DanishWiking ($112.06 in chips) 
DanishWiking: posts small blind $0.50
ceedonen: posts big blind $1
volwebni4ek: sits out 
ceedonen: posts the ante $0.20
SiD11211: posts the ante $0.20
123chambo: posts the ante $0.20
OriginalTony: posts the ante $0.20
Vikulja1993: posts the ante $0.20
Pacifistas: posts the ante $0.20
matiko09: posts the ante $0.20
DanishWiking: posts the ante $0.20
*** HOLE CARDS ***
Dealt to matiko09 [7h Qd]
SiD11211: folds 
123chambo: folds 
OriginalTony: raises $1.75 to $2.75
Vikulja1993: folds 
Pacifistas: folds 
matiko09: folds 
DanishWiking: folds 
ceedonen: folds 
Uncalled bet ($1.75) returned to OriginalTony
OriginalTony collected $4.10 from pot
*** SUMMARY ***
Total pot $4.10 | Rake $0 
Seat 1: ceedonen (big blind) folded before Flop
Seat 2: SiD11211 folded before Flop (didn't bet)
Seat 3: 123chambo folded before Flop (didn't bet)
Seat 4: OriginalTony collected ($4.10)
Seat 5: Vikulja1993 folded before Flop (didn't bet)
Seat 6: Pacifistas folded before Flop (didn't bet)
Seat 8: matiko09 (button) folded before Flop (didn't bet)
Seat 9: DanishWiking (small blind) folded before Flop





PokerStars Hand #150708940134:  Hold'em No Limit ($0.50/$1.00 USD) - 2016/03/21 17:32:26 CET [2016/03/21 12:32:26 ET]
Table 'Marmulla II' 9-max Seat #8 is the button
Seat 3: Vikulja1993 ($135.34 in chips) 
Seat 4: Dachish ($88.05 in chips) 
Seat 5: maaaGik88 ($86.10 in chips) 
Seat 6: R1aki ($128.64 in chips) 
Seat 7: Pacifistas ($101.50 in chips) 
Seat 8: ffac ($100 in chips) 
Seat 9: matiko09 ($100 in chips) 
matiko09: posts small blind $0.50
flk.Dasas: is sitting out 
Vikulja1993: posts big blind $1
*** HOLE CARDS ***
Dealt to matiko09 [Th 8s]
flk.Dasas leaves the table
Dachish: folds 
maaaGik88: folds 
R1aki: folds 
Pacifistas: folds 
ffac: folds 
matiko09: folds 
Uncalled bet ($0.50) returned to Vikulja1993
Vikulja1993 collected $1 from pot
Vikulja1993: doesn't show hand 
*** SUMMARY ***
Total pot $1 | Rake $0 
Seat 3: Vikulja1993 (big blind) collected ($1)
Seat 4: Dachish folded before Flop (didn't bet)
Seat 5: maaaGik88 folded before Flop (didn't bet)
Seat 6: R1aki folded before Flop (didn't bet)
Seat 7: Pacifistas folded before Flop (didn't bet)
Seat 8: ffac (button) folded before Flop (didn't bet)
Seat 9: matiko09 (small blind) folded before Flop





PokerStars Hand #150708945082:  Hold'em No Limit ($0.50/$1.00 USD) - 2016/03/21 17:32:32 CET [2016/03/21 12:32:32 ET]
Table 'Onnie II' 9-max Seat #3 is the button
Seat 1: ka100pka527 ($143.64 in chips) 
Seat 2: RICKA16 ($100.87 in chips) 
Seat 3: DanishWiking ($100 in chips) 
Seat 4: Bothfeld11 ($127.43 in chips) 
Seat 5: Filojoes ($100 in chips) 
Seat 6: Pacifistas ($106.67 in chips) 
Seat 7: djammusic ($69.40 in chips) 
Seat 8: solbi86 ($100 in chips) 
Seat 9: matiko09 ($136.82 in chips) 
Bothfeld11: posts small blind $0.50
Filojoes: posts big blind $1
*** HOLE CARDS ***
Dealt to matiko09 [Ad 2h]
Pacifistas: folds 
djammusic: folds 
solbi86: folds 
matiko09: folds 
ka100pka527: raises $2 to $3
RICKA16: calls $3
DanishWiking: folds 
Bothfeld11: folds 
Filojoes: calls $2
*** FLOP *** [Kc 2c Kd]
Filojoes: checks 
ka100pka527: checks 
RICKA16: checks 
*** TURN *** [Kc 2c Kd] [Jh]
Filojoes: checks 
ka100pka527: bets $6.04
RICKA16: calls $6.04
Filojoes: folds 
*** RIVER *** [Kc 2c Kd Jh] [3s]
ka100pka527: bets $7.30
RICKA16: calls $7.30
*** SHOW DOWN ***
ka100pka527: shows [Ac Jc] (two pair, Kings and Jacks)
RICKA16: mucks hand 
ka100pka527 collected $34.55 from pot
*** SUMMARY ***
Total pot $36.18 | Rake $1.63 
Board [Kc 2c Kd Jh 3s]
Seat 1: ka100pka527 showed [Ac Jc] and won ($34.55) with two pair, Kings and Jacks
Seat 2: RICKA16 mucked [Jd 9d]
Seat 3: DanishWiking (button) folded before Flop (didn't bet)
Seat 4: Bothfeld11 (small blind) folded before Flop
Seat 5: Filojoes (big blind) folded on the Turn
Seat 6: Pacifistas folded before Flop (didn't bet)
Seat 7: djammusic folded before Flop (didn't bet)
Seat 8: solbi86 folded before Flop (didn't bet)
Seat 9: matiko09 folded before Flop (didn't bet)





PokerStars Hand #150708948447:  Hold'em No Limit ($0.50/$1.00 USD) - 2016/03/21 17:32:36 CET [2016/03/21 12:32:36 ET]
Table 'Massalia II' 9-max Seat #9 is the button
Seat 1: ceedonen ($100 in chips) 
Seat 2: SiD11211 ($119.39 in chips) 
Seat 3: 123chambo ($147.93 in chips) 
Seat 4: OriginalTony ($93.30 in chips) 
Seat 5: Vikulja1993 ($124.10 in chips) 
Seat 6: Pacifistas ($100 in chips) 
Seat 8: matiko09 ($163.28 in chips) 
Seat 9: DanishWiking ($111.36 in chips) 
ceedonen: posts small blind $0.50
SiD11211: posts big blind $1
volwebni4ek: sits out 
ceedonen: posts the ante $0.20
SiD11211: posts the ante $0.20
123chambo: posts the ante $0.20
OriginalTony: posts the ante $0.20
Vikulja1993: posts the ante $0.20
Pacifistas: posts the ante $0.20
matiko09: posts the ante $0.20
DanishWiking: posts the ante $0.20
*** HOLE CARDS ***
Dealt to matiko09 [9h 3d]
123chambo: folds 
OriginalTony: folds 
Vikulja1993: raises $2 to $3
Pacifistas: folds 
matiko09: folds 
DanishWiking: calls $3
ceedonen: folds 
SiD11211: folds 
*** FLOP *** [2s 7c Ad]
Vikulja1993: checks 
DanishWiking: checks 
*** TURN *** [2s 7c Ad] [2c]
Vikulja1993: checks 
DanishWiking: bets $5
Vikulja1993: folds 
Uncalled bet ($5) returned to DanishWiking
DanishWiking collected $8.69 from pot
DanishWiking: doesn't show hand 
*** SUMMARY ***
Total pot $9.10 | Rake $0.41 
Board [2s 7c Ad 2c]
Seat 1: ceedonen (small blind) folded before Flop
Seat 2: SiD11211 (big blind) folded before Flop
Seat 3: 123chambo folded before Flop (didn't bet)
Seat 4: OriginalTony folded before Flop (didn't bet)
Seat 5: Vikulja1993 folded on the Turn
Seat 6: Pacifistas folded before Flop (didn't bet)
Seat 8: matiko09 folded before Flop (didn't bet)
Seat 9: DanishWiking (button) collected ($8.69)





PokerStars Hand #150708952640:  Hold'em No Limit ($0.50/$1.00 USD) - 2016/03/21 17:32:42 CET [2016/03/21 12:32:42 ET]
Table 'Harding II' 9-max Seat #5 is the button
Seat 1: Vikulja1993 ($100 in chips) 
Seat 2: IntsAA ($215.10 in chips) 
Seat 3: iamkingan ($101.53 in chips) 
Seat 4: matiko09 ($100 in chips) 
Seat 5: DanishWiking ($105.44 in chips) 
Seat 6: Dachish ($66 in chips) 
Seat 7: RICKA16 ($100 in chips) 
Seat 8: solbi86 ($107.83 in chips) 
Seat 9: ka100pka527 ($40 in chips) 
Dachish: posts small blind $0.50
RICKA16: posts big blind $1
*** HOLE CARDS ***
Dealt to matiko09 [5h 5s]
solbi86: folds 
ka100pka527: folds 
Vikulja1993: folds 
IntsAA: folds 
iamkingan: folds 
matiko09: raises $1.50 to $2.50
DanishWiking: folds 
Dachish: folds 
RICKA16: folds 
Uncalled bet ($1.50) returned to matiko09
matiko09 collected $2.50 from pot
matiko09: doesn't show hand 
*** SUMMARY ***
Total pot $2.50 | Rake $0 
Seat 1: Vikulja1993 folded before Flop (didn't bet)
Seat 2: IntsAA folded before Flop (didn't bet)
Seat 3: iamkingan folded before Flop (didn't bet)
Seat 4: matiko09 collected ($2.50)
Seat 5: DanishWiking (button) folded before Flop (didn't bet)
Seat 6: Dachish (small blind) folded before Flop
Seat 7: RICKA16 (big blind) folded before Flop
Seat 8: solbi86 folded before Flop (didn't bet)
Seat 9: ka100pka527 folded before Flop (didn't bet)





PokerStars Hand #150708955676:  Hold'em No Limit ($0.50/$1.00 USD) - 2016/03/21 17:32:46 CET [2016/03/21 12:32:46 ET]
Table 'Marmulla II' 9-max Seat #9 is the button
Seat 3: Vikulja1993 ($135.84 in chips) 
Seat 4: Dachish ($88.05 in chips) 
Seat 5: maaaGik88 ($86.10 in chips) 
Seat 6: R1aki ($128.64 in chips) 
Seat 7: Pacifistas ($101.50 in chips) 
Seat 8: ffac ($100 in chips) 
Seat 9: matiko09 ($100 in chips) 
Vikulja1993: posts small blind $0.50
Dachish: posts big blind $1
*** HOLE CARDS ***
Dealt to matiko09 [6c 5h]
maaaGik88: raises $1 to $2
R1aki: folds 
volwebni4ek joins the table at seat #2 
Pacifistas: folds 
ffac: folds 
matiko09: folds 
Vikulja1993: folds 
Dachish: folds 
Uncalled bet ($1) returned to maaaGik88
maaaGik88 collected $2.50 from pot
maaaGik88: doesn't show hand 
*** SUMMARY ***
Total pot $2.50 | Rake $0 
Seat 3: Vikulja1993 (small blind) folded before Flop
Seat 4: Dachish (big blind) folded before Flop
Seat 5: maaaGik88 collected ($2.50)
Seat 6: R1aki folded before Flop (didn't bet)
Seat 7: Pacifistas folded before Flop (didn't bet)
Seat 8: ffac folded before Flop (didn't bet)
Seat 9: matiko09 (button) folded before Flop (didn't bet)





PokerStars Hand #150708981653:  Hold'em No Limit ($0.50/$1.00 USD) - 2016/03/21 17:33:19 CET [2016/03/21 12:33:19 ET]
Table 'Marmulla II' 9-max Seat #3 is the button
Seat 3: Vikulja1993 ($135.34 in chips) 
Seat 4: Dachish ($87.05 in chips) 
Seat 5: maaaGik88 ($87.60 in chips) 
Seat 6: R1aki ($128.64 in chips) 
Seat 7: Pacifistas ($101.50 in chips) 
Seat 8: ffac ($100 in chips) 
Seat 9: matiko09 ($100 in chips) 
Dachish: posts small blind $0.50
maaaGik88: posts big blind $1
volwebni4ek: sits out 
*** HOLE CARDS ***
Dealt to matiko09 [9d 7c]
R1aki: folds 
Pacifistas: folds 
ffac: raises $2 to $3
matiko09: folds 
Vikulja1993: folds 
Dachish: folds 
maaaGik88: calls $2
*** FLOP *** [3d Ah Ad]
maaaGik88: bets $1
ffac: raises $4 to $5
maaaGik88: folds 
Uncalled bet ($4) returned to ffac
ffac collected $8.12 from pot
ffac: doesn't show hand 
*** SUMMARY ***
Total pot $8.50 | Rake $0.38 
Board [3d Ah Ad]
Seat 3: Vikulja1993 (button) folded before Flop (didn't bet)
Seat 4: Dachish (small blind) folded before Flop
Seat 5: maaaGik88 (big blind) folded on the Flop
Seat 6: R1aki folded before Flop (didn't bet)
Seat 7: Pacifistas folded before Flop (didn't bet)
Seat 8: ffac collected ($8.12)
Seat 9: matiko09 folded before Flop (didn't bet)





PokerStars Hand #150708986271:  Hold'em No Limit ($0.50/$1.00 USD) - 2016/03/21 17:33:25 CET [2016/03/21 12:33:25 ET]
Table 'Harding II' 9-max Seat #6 is the button
Seat 1: Vikulja1993 ($100 in chips) 
Seat 2: IntsAA ($215.10 in chips) 
Seat 3: iamkingan ($101.53 in chips) 
Seat 4: matiko09 ($101.50 in chips) 
Seat 5: DanishWiking ($105.44 in chips) 
Seat 6: Dachish ($65.50 in chips) 
Seat 7: RICKA16 ($99 in chips) 
Seat 8: solbi86 ($107.83 in chips) 
Seat 9: ka100pka527 ($40 in chips) 
RICKA16: posts small blind $0.50
solbi86: posts big blind $1
*** HOLE CARDS ***
Dealt to matiko09 [Ks 9c]
ka100pka527: folds 
Vikulja1993: folds 
IntsAA: folds 
iamkingan: folds 
matiko09: folds 
DanishWiking: raises $1.50 to $2.50
Dachish: folds 
RICKA16: folds 
solbi86: raises $6 to $8.50
DanishWiking: folds 
Uncalled bet ($6) returned to solbi86
solbi86 collected $5.50 from pot
solbi86: doesn't show hand 
*** SUMMARY ***
Total pot $5.50 | Rake $0 
Seat 1: Vikulja1993 folded before Flop (didn't bet)
Seat 2: IntsAA folded before Flop (didn't bet)
Seat 3: iamkingan folded before Flop (didn't bet)
Seat 4: matiko09 folded before Flop (didn't bet)
Seat 5: DanishWiking folded before Flop
Seat 6: Dachish (button) folded before Flop (didn't bet)
Seat 7: RICKA16 (small blind) folded before Flop
Seat 8: solbi86 (big blind) collected ($5.50)
Seat 9: ka100pka527 folded before Flop (didn't bet)





PokerStars Hand #150708988383:  Hold'em No Limit ($0.50/$1.00 USD) - 2016/03/21 17:33:27 CET [2016/03/21 12:33:27 ET]
Table 'Toutatis II' 9-max Seat #1 is the button
Seat 1: Linghem ($77.45 in chips) 
Seat 2: Filojoes ($105.44 in chips) 
Seat 3: matiko09 ($106.84 in chips) 
Seat 4: cn_chayanne ($110.81 in chips) 
Seat 6: djammusic ($71.59 in chips) 
Seat 7: Pacifistas ($100 in chips) 
Seat 8: Dachish ($69.07 in chips) 
Seat 9: bvavan ($35.83 in chips) 
Filojoes: posts small blind $0.50
matiko09: posts big blind $1
solbi86: sits out 
*** HOLE CARDS ***
Dealt to matiko09 [Js 9d]
cn_chayanne: folds 
djammusic: folds 
Pacifistas: folds 
Dachish: folds 
bvavan: calls $1
Linghem: folds 
Filojoes: calls $0.50
matiko09: checks 
*** FLOP *** [Qd 7d Kd]
Filojoes: checks 
matiko09: checks 
bvavan: checks 
*** TURN *** [Qd 7d Kd] [8d]
Filojoes: checks 
matiko09: checks 
bvavan: checks 
*** RIVER *** [Qd 7d Kd 8d] [5d]
Filojoes: bets $1.72
matiko09: calls $1.72
bvavan: folds 
*** SHOW DOWN ***
Filojoes: shows [Th Kc] (a flush, King high)
matiko09: shows [Js 9d] (a flush, King high - Nine higher)
matiko09 collected $6.15 from pot
*** SUMMARY ***
Total pot $6.44 | Rake $0.29 
Board [Qd 7d Kd 8d 5d]
Seat 1: Linghem (button) folded before Flop (didn't bet)
Seat 2: Filojoes (small blind) showed [Th Kc] and lost with a flush, King high
Seat 3: matiko09 (big blind) showed [Js 9d] and won ($6.15) with a flush, King high
Seat 4: cn_chayanne folded before Flop (didn't bet)
Seat 6: djammusic folded before Flop (didn't bet)
Seat 7: Pacifistas folded before Flop (didn't bet)
Seat 8: Dachish folded before Flop (didn't bet)
Seat 9: bvavan folded on the River





PokerStars Hand #150709004820:  Hold'em No Limit ($0.50/$1.00 USD) - 2016/03/21 17:33:48 CET [2016/03/21 12:33:48 ET]
Table 'Odysseus II' 9-max Seat #5 is the button
Seat 2: Vikulja1993 ($122.42 in chips) 
Seat 3: vsbhandari ($100 in chips) 
Seat 4: aseban11 ($102.71 in chips) 
Seat 5: Rikti ($36.21 in chips) 
Seat 6: R1aki ($100 in chips) 
Seat 7: matiko09 ($100 in chips) 
Seat 8: fanmtZ ($40 in chips) 
Seat 9: grifkaaa ($119.36 in chips) 
R1aki: posts small blind $0.50
matiko09: posts big blind $1
Pacifistas: sits out 
*** HOLE CARDS ***
Dealt to matiko09 [Kc As]
fanmtZ: folds 
grifkaaa: folds 
Vikulja1993: folds 
vsbhandari: folds 
aseban11: folds 
Rikti: raises $1 to $2
R1aki: folds 
matiko09: raises $6 to $8
Rikti: folds 
Uncalled bet ($6) returned to matiko09
matiko09 collected $4.50 from pot
matiko09: doesn't show hand 
*** SUMMARY ***
Total pot $4.50 | Rake $0 
Seat 2: Vikulja1993 folded before Flop (didn't bet)
Seat 3: vsbhandari folded before Flop (didn't bet)
Seat 4: aseban11 folded before Flop (didn't bet)
Seat 5: Rikti (button) folded before Flop
Seat 6: R1aki (small blind) folded before Flop
Seat 7: matiko09 (big blind) collected ($4.50)
Seat 8: fanmtZ folded before Flop (didn't bet)
Seat 9: grifkaaa folded before Flop (didn't bet)





PokerStars Hand #150709015666:  Hold'em No Limit ($0.50/$1.00 USD) - 2016/03/21 17:34:02 CET [2016/03/21 12:34:02 ET]
Table 'Massalia II' 9-max Seat #1 is the button
Seat 1: ceedonen ($100 in chips) 
Seat 2: SiD11211 ($118.19 in chips) 
Seat 3: 123chambo ($147.73 in chips) 
Seat 4: OriginalTony ($93.10 in chips) 
Seat 5: Vikulja1993 ($120.90 in chips) 
Seat 6: Pacifistas ($100 in chips) 
Seat 8: matiko09 ($163.08 in chips) 
Seat 9: DanishWiking ($116.85 in chips) 
SiD11211: posts small blind $0.50
123chambo: posts big blind $1
volwebni4ek: sits out 
ceedonen: posts the ante $0.20
SiD11211: posts the ante $0.20
123chambo: posts the ante $0.20
OriginalTony: posts the ante $0.20
Vikulja1993: posts the ante $0.20
Pacifistas: posts the ante $0.20
matiko09: posts the ante $0.20
DanishWiking: posts the ante $0.20
*** HOLE CARDS ***
Dealt to matiko09 [6s 8c]
OriginalTony: folds 
Vikulja1993: folds 
Pacifistas: folds 
matiko09: folds 
DanishWiking: folds 
ceedonen: folds 
SiD11211: raises $2 to $3
123chambo: calls $2
*** FLOP *** [9s 9d Kh]
SiD11211: bets $4.86
123chambo: calls $4.86
*** TURN *** [9s 9d Kh] [3d]
SiD11211: bets $8.93
123chambo: calls $8.93
*** RIVER *** [9s 9d Kh 3d] [Qs]
SiD11211: checks 
123chambo: checks 
*** SHOW DOWN ***
SiD11211: shows [Th Kc] (two pair, Kings and Nines)
123chambo: mucks hand 
SiD11211 collected $33.60 from pot
*** SUMMARY ***
Total pot $35.18 | Rake $1.58 
Board [9s 9d Kh 3d Qs]
Seat 1: ceedonen (button) folded before Flop (didn't bet)
Seat 2: SiD11211 (small blind) showed [Th Kc] and won ($33.60) with two pair, Kings and Nines
Seat 3: 123chambo (big blind) mucked [7s 7h]
Seat 4: OriginalTony folded before Flop (didn't bet)
Seat 5: Vikulja1993 folded before Flop (didn't bet)
Seat 6: Pacifistas folded before Flop (didn't bet)
Seat 8: matiko09 folded before Flop (didn't bet)
Seat 9: DanishWiking folded before Flop (didn't bet)





PokerStars Hand #150709017032:  Hold'em No Limit ($0.50/$1.00 USD) - 2016/03/21 17:34:04 CET [2016/03/21 12:34:04 ET]
Table 'Onnie II' 9-max Seat #4 is the button
Seat 1: ka100pka527 ($161.85 in chips) 
Seat 2: RICKA16 ($84.53 in chips) 
Seat 3: DanishWiking ($100 in chips) 
Seat 4: Bothfeld11 ($126.93 in chips) 
Seat 5: Filojoes ($100 in chips) 
Seat 6: Pacifistas ($106.67 in chips) 
Seat 7: djammusic ($69.40 in chips) 
Seat 8: solbi86 ($100 in chips) 
Seat 9: matiko09 ($136.82 in chips) 
Filojoes: posts small blind $0.50
Pacifistas: posts big blind $1
*** HOLE CARDS ***
Dealt to matiko09 [Tc 5d]
djammusic: folds 
solbi86: folds 
matiko09: folds 
ka100pka527: folds 
RICKA16: folds 
DanishWiking: folds 
Bothfeld11: folds 
Filojoes: folds 
Uncalled bet ($0.50) returned to Pacifistas
Pacifistas collected $1 from pot
Pacifistas: doesn't show hand 
*** SUMMARY ***
Total pot $1 | Rake $0 
Seat 1: ka100pka527 folded before Flop (didn't bet)
Seat 2: RICKA16 folded before Flop (didn't bet)
Seat 3: DanishWiking folded before Flop (didn't bet)
Seat 4: Bothfeld11 (button) folded before Flop (didn't bet)
Seat 5: Filojoes (small blind) folded before Flop
Seat 6: Pacifistas (big blind) collected ($1)
Seat 7: djammusic folded before Flop (didn't bet)
Seat 8: solbi86 folded before Flop (didn't bet)
Seat 9: matiko09 folded before Flop (didn't bet)





PokerStars Hand #150709022676:  Hold'em No Limit ($0.50/$1.00 USD) - 2016/03/21 17:34:11 CET [2016/03/21 12:34:11 ET]
Table 'Marmulla II' 9-max Seat #4 is the button
Seat 3: Vikulja1993 ($135.34 in chips) 
Seat 4: Dachish ($86.55 in chips) 
Seat 5: maaaGik88 ($83.60 in chips) 
Seat 6: R1aki ($128.64 in chips) 
Seat 7: Pacifistas ($101.50 in chips) 
Seat 8: ffac ($104.12 in chips) 
Seat 9: matiko09 ($100 in chips) 
maaaGik88: posts small blind $0.50
R1aki: posts big blind $1
volwebni4ek: sits out 
*** HOLE CARDS ***
Dealt to matiko09 [Kc 3d]
Pacifistas: folds 
ffac: folds 
matiko09: folds 
Vikulja1993: folds 
Dachish: folds 
maaaGik88: calls $0.50
R1aki: checks 
*** FLOP *** [9d Js 7d]
maaaGik88: checks 
R1aki: bets $2
maaaGik88: raises $3 to $5
R1aki: raises $14.50 to $19.50
maaaGik88: calls $14.50
*** TURN *** [9d Js 7d] [Kh]
maaaGik88: bets $13
R1aki: raises $21.50 to $34.50
maaaGik88: folds 
Uncalled bet ($21.50) returned to R1aki
R1aki collected $64.20 from pot
R1aki: doesn't show hand 
*** SUMMARY ***
Total pot $67 | Rake $2.80 
Board [9d Js 7d Kh]
Seat 3: Vikulja1993 folded before Flop (didn't bet)
Seat 4: Dachish (button) folded before Flop (didn't bet)
Seat 5: maaaGik88 (small blind) folded on the Turn
Seat 6: R1aki (big blind) collected ($64.20)
Seat 7: Pacifistas folded before Flop (didn't bet)
Seat 8: ffac folded before Flop (didn't bet)
Seat 9: matiko09 folded before Flop (didn't bet)





PokerStars Hand #150709026426:  Hold'em No Limit ($0.50/$1.00 USD) - 2016/03/21 17:34:16 CET [2016/03/21 12:34:16 ET]
Table 'Harding II' 9-max Seat #7 is the button
Seat 1: Vikulja1993 ($100 in chips) 
Seat 2: IntsAA ($215.10 in chips) 
Seat 3: iamkingan ($101.53 in chips) 
Seat 4: matiko09 ($101.50 in chips) 
Seat 5: DanishWiking ($102.94 in chips) 
Seat 6: Dachish ($65.50 in chips) 
Seat 7: RICKA16 ($98.50 in chips) 
Seat 8: solbi86 ($110.83 in chips) 
Seat 9: ka100pka527 ($40 in chips) 
solbi86: posts small blind $0.50
ka100pka527: posts big blind $1
*** HOLE CARDS ***
Dealt to matiko09 [Ad Tc]
Vikulja1993: folds 
Vikulja1993 leaves the table
IntsAA: folds 
iamkingan: folds 
matiko09: raises $2 to $3
DanishWiking: folds 
Dachish: folds 
RICKA16: folds 
solbi86: folds 
cobrik23 joins the table at seat #1 
ka100pka527: folds 
Uncalled bet ($2) returned to matiko09
matiko09 collected $2.50 from pot
matiko09: doesn't show hand 
*** SUMMARY ***
Total pot $2.50 | Rake $0 
Seat 1: Vikulja1993 folded before Flop (didn't bet)
Seat 2: IntsAA folded before Flop (didn't bet)
Seat 3: iamkingan folded before Flop (didn't bet)
Seat 4: matiko09 collected ($2.50)
Seat 5: DanishWiking folded before Flop (didn't bet)
Seat 6: Dachish folded before Flop (didn't bet)
Seat 7: RICKA16 (button) folded before Flop (didn't bet)
Seat 8: solbi86 (small blind) folded before Flop
Seat 9: ka100pka527 (big blind) folded before Flop





PokerStars Hand #150709032124:  Hold'em No Limit ($0.50/$1.00 USD) - 2016/03/21 17:34:23 CET [2016/03/21 12:34:23 ET]
Table 'Onnie II' 9-max Seat #5 is the button
Seat 1: ka100pka527 ($161.85 in chips) 
Seat 2: RICKA16 ($100 in chips) 
Seat 3: DanishWiking ($100 in chips) 
Seat 4: Bothfeld11 ($126.93 in chips) 
Seat 5: Filojoes ($100 in chips) 
Seat 6: Pacifistas ($107.17 in chips) 
Seat 7: djammusic ($69.40 in chips) 
Seat 8: solbi86 ($100 in chips) 
Seat 9: matiko09 ($136.82 in chips) 
Pacifistas: posts small blind $0.50
djammusic: posts big blind $1
*** HOLE CARDS ***
Dealt to matiko09 [Ah 5h]
solbi86: folds 
matiko09: folds 
ka100pka527: folds 
RICKA16: folds 
DanishWiking: folds 
Bothfeld11: folds 
Filojoes: folds 
Pacifistas: raises $1.18 to $2.18
djammusic: folds 
Uncalled bet ($1.18) returned to Pacifistas
Pacifistas collected $2 from pot
Pacifistas: doesn't show hand 
*** SUMMARY ***
Total pot $2 | Rake $0 
Seat 1: ka100pka527 folded before Flop (didn't bet)
Seat 2: RICKA16 folded before Flop (didn't bet)
Seat 3: DanishWiking folded before Flop (didn't bet)
Seat 4: Bothfeld11 folded before Flop (didn't bet)
Seat 5: Filojoes (button) folded before Flop (didn't bet)
Seat 6: Pacifistas (small blind) collected ($2)
Seat 7: djammusic (big blind) folded before Flop
Seat 8: solbi86 folded before Flop (didn't bet)
Seat 9: matiko09 folded before Flop (didn't bet)





PokerStars Hand #150709032647:  Hold'em No Limit ($0.50/$1.00 USD) - 2016/03/21 17:34:24 CET [2016/03/21 12:34:24 ET]
Table 'Toutatis II' 9-max Seat #2 is the button
Seat 1: Linghem ($77.45 in chips) 
Seat 2: Filojoes ($102.72 in chips) 
Seat 3: matiko09 ($110.27 in chips) 
Seat 4: cn_chayanne ($110.81 in chips) 
Seat 6: djammusic ($71.59 in chips) 
Seat 7: Pacifistas ($100 in chips) 
Seat 8: Dachish ($69.07 in chips) 
Seat 9: bvavan ($34.83 in chips) 
matiko09: posts small blind $0.50
cn_chayanne: posts big blind $1
solbi86: sits out 
*** HOLE CARDS ***
Dealt to matiko09 [3s 6d]
djammusic: folds 
Pacifistas: folds 
Dachish: folds 
bvavan: calls $1
Linghem: folds 
Filojoes: folds 
matiko09: folds 
cn_chayanne: checks 
*** FLOP *** [7h 8h 4d]
cn_chayanne: checks 
bvavan: checks 
*** TURN *** [7h 8h 4d] [Ad]
cn_chayanne: checks 
bvavan: checks 
*** RIVER *** [7h 8h 4d Ad] [Jd]
cn_chayanne: checks 
bvavan: bets $1
cn_chayanne: folds 
Uncalled bet ($1) returned to bvavan
bvavan collected $2.39 from pot
*** SUMMARY ***
Total pot $2.50 | Rake $0.11 
Board [7h 8h 4d Ad Jd]
Seat 1: Linghem folded before Flop (didn't bet)
Seat 2: Filojoes (button) folded before Flop (didn't bet)
Seat 3: matiko09 (small blind) folded before Flop
Seat 4: cn_chayanne (big blind) folded on the River
Seat 6: djammusic folded before Flop (didn't bet)
Seat 7: Pacifistas folded before Flop (didn't bet)
Seat 8: Dachish folded before Flop (didn't bet)
Seat 9: bvavan collected ($2.39)





PokerStars Hand #150709040313:  Hold'em No Limit ($0.50/$1.00 USD) - 2016/03/21 17:34:33 CET [2016/03/21 12:34:33 ET]
Table 'Odysseus II' 9-max Seat #6 is the button
Seat 2: Vikulja1993 ($122.42 in chips) 
Seat 3: vsbhandari ($100 in chips) 
Seat 4: aseban11 ($102.71 in chips) 
Seat 5: Rikti ($34.21 in chips) 
Seat 6: R1aki ($100 in chips) 
Seat 7: matiko09 ($102.50 in chips) 
Seat 8: fanmtZ ($40 in chips) 
Seat 9: grifkaaa ($119.36 in chips) 
matiko09: posts small blind $0.50
fanmtZ: posts big blind $1
Pacifistas: sits out 
*** HOLE CARDS ***
Dealt to matiko09 [5h 2d]
grifkaaa: raises $2 to $3
Vikulja1993: calls $3
vsbhandari: folds 
aseban11: calls $3
Rikti: calls $3
R1aki: folds 
matiko09: folds 
fanmtZ: folds 
*** FLOP *** [6s Qs Qc]
grifkaaa: checks 
Vikulja1993: checks 
aseban11: checks 
Rikti: bets $4.50
grifkaaa: calls $4.50
Vikulja1993: folds 
aseban11: folds 
*** TURN *** [6s Qs Qc] [Ad]
grifkaaa: checks 
Rikti: checks 
*** RIVER *** [6s Qs Qc Ad] [8d]
grifkaaa: bets $10.74
Rikti: folds 
Uncalled bet ($10.74) returned to grifkaaa
grifkaaa collected $21.49 from pot
*** SUMMARY ***
Total pot $22.50 | Rake $1.01 
Board [6s Qs Qc Ad 8d]
Seat 2: Vikulja1993 folded on the Flop
Seat 3: vsbhandari folded before Flop (didn't bet)
Seat 4: aseban11 folded on the Flop
Seat 5: Rikti folded on the River
Seat 6: R1aki (button) folded before Flop (didn't bet)
Seat 7: matiko09 (small blind) folded before Flop
Seat 8: fanmtZ (big blind) folded before Flop
Seat 9: grifkaaa collected ($21.49)





PokerStars Hand #150709049085:  Hold'em No Limit ($0.50/$1.00 USD) - 2016/03/21 17:34:45 CET [2016/03/21 12:34:45 ET]
Table 'Onnie II' 9-max Seat #6 is the button
Seat 1: ka100pka527 ($161.85 in chips) 
Seat 2: RICKA16 ($100 in chips) 
Seat 3: DanishWiking ($100 in chips) 
Seat 4: Bothfeld11 ($126.93 in chips) 
Seat 5: Filojoes ($100 in chips) 
Seat 6: Pacifistas ($108.17 in chips) 
Seat 7: djammusic ($68.40 in chips) 
Seat 8: solbi86 ($100 in chips) 
Seat 9: matiko09 ($136.82 in chips) 
djammusic: posts small blind $0.50
solbi86: posts big blind $1
*** HOLE CARDS ***
Dealt to matiko09 [2d Jc]
matiko09: folds 
ka100pka527: folds 
RICKA16: folds 
DanishWiking: folds 
Bothfeld11: calls $1
Filojoes: folds 
Pacifistas: folds 
djammusic: folds 
solbi86: checks 
*** FLOP *** [Ks 9c 5d]
solbi86: checks 
Bothfeld11: checks 
*** TURN *** [Ks 9c 5d] [8c]
solbi86: bets $2
Bothfeld11: folds 
Uncalled bet ($2) returned to solbi86
solbi86 collected $2.39 from pot
solbi86: doesn't show hand 
*** SUMMARY ***
Total pot $2.50 | Rake $0.11 
Board [Ks 9c 5d 8c]
Seat 1: ka100pka527 folded before Flop (didn't bet)
Seat 2: RICKA16 folded before Flop (didn't bet)
Seat 3: DanishWiking folded before Flop (didn't bet)
Seat 4: Bothfeld11 folded on the Turn
Seat 5: Filojoes folded before Flop (didn't bet)
Seat 6: Pacifistas (button) folded before Flop (didn't bet)
Seat 7: djammusic (small blind) folded before Flop
Seat 8: solbi86 (big blind) collected ($2.39)
Seat 9: matiko09 folded before Flop (didn't bet)





PokerStars Hand #150709061320:  Hold'em No Limit ($0.50/$1.00 USD) - 2016/03/21 17:35:00 CET [2016/03/21 12:35:00 ET]
Table 'Harding II' 9-max Seat #8 is the button
Seat 1: cobrik23 ($40.50 in chips) 
Seat 2: IntsAA ($215.10 in chips) 
Seat 3: iamkingan ($101.53 in chips) 
Seat 4: matiko09 ($103 in chips) 
Seat 5: DanishWiking ($102.94 in chips) 
Seat 6: Dachish ($65.50 in chips) 
Seat 7: RICKA16 ($98.50 in chips) 
Seat 8: solbi86 ($110.33 in chips) 
Seat 9: ka100pka527 ($39 in chips) 
ka100pka527: posts small blind $0.50
cobrik23: posts big blind $1
*** HOLE CARDS ***
Dealt to matiko09 [5d 5h]
IntsAA: folds 
iamkingan: calls $1
matiko09: raises $2 to $3
DanishWiking: folds 
Dachish: folds 
RICKA16: calls $3
solbi86: folds 
ka100pka527: folds 
cobrik23: folds 
iamkingan: calls $2
*** FLOP *** [Kh 8d 6h]
iamkingan: checks 
matiko09: checks 
RICKA16: bets $7
iamkingan: folds 
matiko09: folds 
Uncalled bet ($7) returned to RICKA16
RICKA16 collected $10.03 from pot
RICKA16: doesn't show hand 
*** SUMMARY ***
Total pot $10.50 | Rake $0.47 
Board [Kh 8d 6h]
Seat 1: cobrik23 (big blind) folded before Flop
Seat 2: IntsAA folded before Flop (didn't bet)
Seat 3: iamkingan folded on the Flop
Seat 4: matiko09 folded on the Flop
Seat 5: DanishWiking folded before Flop (didn't bet)
Seat 6: Dachish folded before Flop (didn't bet)
Seat 7: RICKA16 collected ($10.03)
Seat 8: solbi86 (button) folded before Flop (didn't bet)
Seat 9: ka100pka527 (small blind) folded before Flop





PokerStars Hand #150709066057:  Hold'em No Limit ($0.50/$1.00 USD) - 2016/03/21 17:35:06 CET [2016/03/21 12:35:06 ET]
Table 'Massalia II' 9-max Seat #2 is the button
Seat 1: ceedonen ($100 in chips) 
Seat 2: SiD11211 ($134.80 in chips) 
Seat 3: 123chambo ($130.74 in chips) 
Seat 4: OriginalTony ($92.90 in chips) 
Seat 5: Vikulja1993 ($120.70 in chips) 
Seat 6: Pacifistas ($100 in chips) 
Seat 8: matiko09 ($162.88 in chips) 
Seat 9: DanishWiking ($116.65 in chips) 
123chambo: posts small blind $0.50
OriginalTony: posts big blind $1
volwebni4ek: sits out 
ceedonen: posts the ante $0.20
SiD11211: posts the ante $0.20
123chambo: posts the ante $0.20
OriginalTony: posts the ante $0.20
Vikulja1993: posts the ante $0.20
Pacifistas: posts the ante $0.20
matiko09: posts the ante $0.20
DanishWiking: posts the ante $0.20
*** HOLE CARDS ***
Dealt to matiko09 [2h 5h]
Vikulja1993: folds 
Pacifistas: folds 
matiko09: folds 
DanishWiking: folds 
ceedonen: raises $1.50 to $2.50
SiD11211: raises $5 to $7.50
123chambo: folds 
OriginalTony: folds 
ceedonen: calls $5
*** FLOP *** [5d Tc 9h]
ceedonen: checks 
SiD11211: bets $9.50
ceedonen: folds 
Uncalled bet ($9.50) returned to SiD11211
SiD11211 collected $17.29 from pot
*** SUMMARY ***
Total pot $18.10 | Rake $0.81 
Board [5d Tc 9h]
Seat 1: ceedonen folded on the Flop
Seat 2: SiD11211 (button) collected ($17.29)
Seat 3: 123chambo (small blind) folded before Flop
Seat 4: OriginalTony (big blind) folded before Flop
Seat 5: Vikulja1993 folded before Flop (didn't bet)
Seat 6: Pacifistas folded before Flop (didn't bet)
Seat 8: matiko09 folded before Flop (didn't bet)
Seat 9: DanishWiking folded before Flop (didn't bet)





PokerStars Hand #150709081363:  Hold'em No Limit ($0.50/$1.00 USD) - 2016/03/21 17:35:26 CET [2016/03/21 12:35:26 ET]
Table 'Toutatis II' 9-max Seat #3 is the button
Seat 1: Linghem ($77.45 in chips) 
Seat 2: Filojoes ($102.72 in chips) 
Seat 3: matiko09 ($109.77 in chips) 
Seat 4: cn_chayanne ($109.81 in chips) 
Seat 5: solbi86 ($100 in chips) 
Seat 6: djammusic ($71.59 in chips) 
Seat 7: Pacifistas ($100 in chips) 
Seat 8: Dachish ($69.07 in chips) 
Seat 9: bvavan ($36.22 in chips) 
cn_chayanne: posts small blind $0.50
solbi86: posts big blind $1
*** HOLE CARDS ***
Dealt to matiko09 [Jh Qs]
djammusic: folds 
Pacifistas: folds 
Dachish: folds 
bvavan: calls $1
Linghem: folds 
Filojoes: folds 
matiko09: raises $3 to $4
cn_chayanne: folds 
solbi86: folds 
bvavan: calls $3
*** FLOP *** [4d 4h 8c]
bvavan: checks 
matiko09: checks 
*** TURN *** [4d 4h 8c] [Ad]
bvavan: checks 
matiko09: checks 
*** RIVER *** [4d 4h 8c Ad] [Td]
bvavan: checks 
matiko09: checks 
*** SHOW DOWN ***
bvavan: shows [Kh 3c] (a pair of Fours)
matiko09: mucks hand 
bvavan collected $9.07 from pot
*** SUMMARY ***
Total pot $9.50 | Rake $0.43 
Board [4d 4h 8c Ad Td]
Seat 1: Linghem folded before Flop (didn't bet)
Seat 2: Filojoes folded before Flop (didn't bet)
Seat 3: matiko09 (button) mucked [Jh Qs]
Seat 4: cn_chayanne (small blind) folded before Flop
Seat 5: solbi86 (big blind) folded before Flop
Seat 6: djammusic folded before Flop (didn't bet)
Seat 7: Pacifistas folded before Flop (didn't bet)
Seat 8: Dachish folded before Flop (didn't bet)
Seat 9: bvavan showed [Kh 3c] and won ($9.07) with a pair of Fours





PokerStars Hand #150709082608:  Hold'em No Limit ($0.50/$1.00 USD) - 2016/03/21 17:35:27 CET [2016/03/21 12:35:27 ET]
Table 'Onnie II' 9-max Seat #7 is the button
Seat 1: ka100pka527 ($161.85 in chips) 
Seat 2: RICKA16 ($100 in chips) 
Seat 3: DanishWiking ($100 in chips) 
Seat 4: Bothfeld11 ($125.93 in chips) 
Seat 5: Filojoes ($100 in chips) 
Seat 6: Pacifistas ($108.17 in chips) 
Seat 7: djammusic ($67.90 in chips) 
Seat 8: solbi86 ($101.39 in chips) 
Seat 9: matiko09 ($136.82 in chips) 
solbi86: posts small blind $0.50
matiko09: posts big blind $1
*** HOLE CARDS ***
Dealt to matiko09 [6s Qc]
ka100pka527: folds 
RICKA16: folds 
DanishWiking: raises $2 to $3
Bothfeld11: folds 
Filojoes: folds 
Pacifistas: folds 
djammusic: raises $5 to $8
solbi86: folds 
matiko09: folds 
DanishWiking: folds 
Uncalled bet ($5) returned to djammusic
djammusic collected $7.50 from pot
djammusic: doesn't show hand 
*** SUMMARY ***
Total pot $7.50 | Rake $0 
Seat 1: ka100pka527 folded before Flop (didn't bet)
Seat 2: RICKA16 folded before Flop (didn't bet)
Seat 3: DanishWiking folded before Flop
Seat 4: Bothfeld11 folded before Flop (didn't bet)
Seat 5: Filojoes folded before Flop (didn't bet)
Seat 6: Pacifistas folded before Flop (didn't bet)
Seat 7: djammusic (button) collected ($7.50)
Seat 8: solbi86 (small blind) folded before Flop
Seat 9: matiko09 (big blind) folded before Flop





PokerStars Hand #150709095670:  Hold'em No Limit ($0.50/$1.00 USD) - 2016/03/21 17:35:43 CET [2016/03/21 12:35:43 ET]
Table 'Harding II' 9-max Seat #9 is the button
Seat 1: cobrik23 ($39.50 in chips) 
Seat 2: IntsAA ($215.10 in chips) 
Seat 3: iamkingan ($98.53 in chips) 
Seat 4: matiko09 ($100 in chips) 
Seat 5: DanishWiking ($102.94 in chips) 
Seat 6: Dachish ($65.50 in chips) 
Seat 7: RICKA16 ($105.53 in chips) 
Seat 8: solbi86 ($110.33 in chips) 
Seat 9: ka100pka527 ($38.50 in chips) 
cobrik23: posts small blind $0.50
IntsAA: posts big blind $1
*** HOLE CARDS ***
Dealt to matiko09 [9s 3c]
iamkingan: calls $1
matiko09: folds 
DanishWiking: folds 
Dachish: folds 
RICKA16: folds 
solbi86: raises $3 to $4
ka100pka527: folds 
cobrik23: folds 
IntsAA: folds 
iamkingan: calls $3
*** FLOP *** [Tc 8h 4h]
iamkingan: checks 
solbi86: bets $5
iamkingan: folds 
Uncalled bet ($5) returned to solbi86
solbi86 collected $9.07 from pot
solbi86: doesn't show hand 
*** SUMMARY ***
Total pot $9.50 | Rake $0.43 
Board [Tc 8h 4h]
Seat 1: cobrik23 (small blind) folded before Flop
Seat 2: IntsAA (big blind) folded before Flop
Seat 3: iamkingan folded on the Flop
Seat 4: matiko09 folded before Flop (didn't bet)
Seat 5: DanishWiking folded before Flop (didn't bet)
Seat 6: Dachish folded before Flop (didn't bet)
Seat 7: RICKA16 folded before Flop (didn't bet)
Seat 8: solbi86 collected ($9.07)
Seat 9: ka100pka527 (button) folded before Flop (didn't bet)





PokerStars Hand #150709103286:  Hold'em No Limit ($0.50/$1.00 USD) - 2016/03/21 17:35:53 CET [2016/03/21 12:35:53 ET]
Table 'Marmulla II' 9-max Seat #5 is the button
Seat 3: Vikulja1993 ($135.34 in chips) 
Seat 4: Dachish ($86.55 in chips) 
Seat 5: maaaGik88 ($50.10 in chips) 
Seat 6: R1aki ($159.34 in chips) 
Seat 7: Pacifistas ($101.50 in chips) 
Seat 8: ffac ($104.12 in chips) 
Seat 9: matiko09 ($100 in chips) 
R1aki: posts small blind $0.50
Pacifistas: posts big blind $1
volwebni4ek: sits out 
*** HOLE CARDS ***
Dealt to matiko09 [4h Ks]
ffac: folds 
matiko09: folds 
Vikulja1993: folds 
Dachish: folds 
maaaGik88: calls $1
R1aki: calls $0.50
Pacifistas: checks 
*** FLOP *** [Ts 9d Kd]
R1aki: checks 
Pacifistas: checks 
maaaGik88: checks 
*** TURN *** [Ts 9d Kd] [3c]
R1aki: checks 
Pacifistas: checks 
maaaGik88: bets $3
R1aki: folds 
Pacifistas: folds 
Uncalled bet ($3) returned to maaaGik88
maaaGik88 collected $2.86 from pot
maaaGik88: doesn't show hand 
*** SUMMARY ***
Total pot $3 | Rake $0.14 
Board [Ts 9d Kd 3c]
Seat 3: Vikulja1993 folded before Flop (didn't bet)
Seat 4: Dachish folded before Flop (didn't bet)
Seat 5: maaaGik88 (button) collected ($2.86)
Seat 6: R1aki (small blind) folded on the Turn
Seat 7: Pacifistas (big blind) folded on the Turn
Seat 8: ffac folded before Flop (didn't bet)
Seat 9: matiko09 folded before Flop (didn't bet)





PokerStars Hand #150709108360:  Hold'em No Limit ($0.50/$1.00 USD) - 2016/03/21 17:36:00 CET [2016/03/21 12:36:00 ET]
Table 'Massalia II' 9-max Seat #3 is the button
Seat 1: ceedonen ($100 in chips) 
Seat 2: SiD11211 ($144.39 in chips) 
Seat 3: 123chambo ($130.04 in chips) 
Seat 4: OriginalTony ($91.70 in chips) 
Seat 5: Vikulja1993 ($120.50 in chips) 
Seat 6: Pacifistas ($100 in chips) 
Seat 8: matiko09 ($162.68 in chips) 
Seat 9: DanishWiking ($116.45 in chips) 
OriginalTony: posts small blind $0.50
Vikulja1993: posts big blind $1
volwebni4ek: sits out 
ceedonen: posts the ante $0.20
SiD11211: posts the ante $0.20
123chambo: posts the ante $0.20
OriginalTony: posts the ante $0.20
Vikulja1993: posts the ante $0.20
Pacifistas: posts the ante $0.20
matiko09: posts the ante $0.20
DanishWiking: posts the ante $0.20
*** HOLE CARDS ***
Dealt to matiko09 [4d 7c]
Pacifistas: raises $2 to $3
matiko09: folds 
DanishWiking: folds 
ceedonen: folds 
SiD11211: folds 
123chambo: folds 
OriginalTony: raises $5 to $8
Vikulja1993: folds 
Pacifistas: calls $5
*** FLOP *** [3h Jh 8s]
OriginalTony: bets $9
Pacifistas: calls $9
*** TURN *** [3h Jh 8s] [9d]
OriginalTony: bets $12
Pacifistas: calls $12
*** RIVER *** [3h Jh 8s 9d] [9s]
OriginalTony: bets $25
Pacifistas: calls $25
*** SHOW DOWN ***
OriginalTony: shows [Ac Ah] (two pair, Aces and Nines)
Pacifistas: mucks hand 
OriginalTony collected $107.80 from pot
*** SUMMARY ***
Total pot $110.60 | Rake $2.80 
Board [3h Jh 8s 9d 9s]
Seat 1: ceedonen folded before Flop (didn't bet)
Seat 2: SiD11211 folded before Flop (didn't bet)
Seat 3: 123chambo (button) folded before Flop (didn't bet)
Seat 4: OriginalTony (small blind) showed [Ac Ah] and won ($107.80) with two pair, Aces and Nines
Seat 5: Vikulja1993 (big blind) folded before Flop
Seat 6: Pacifistas mucked [Ad Jd]
Seat 8: matiko09 folded before Flop (didn't bet)
Seat 9: DanishWiking folded before Flop (didn't bet)





PokerStars Hand #150709119598:  Hold'em No Limit ($0.50/$1.00 USD) - 2016/03/21 17:36:14 CET [2016/03/21 12:36:14 ET]
Table 'Onnie II' 9-max Seat #8 is the button
Seat 1: ka100pka527 ($161.85 in chips) 
Seat 2: RICKA16 ($100 in chips) 
Seat 3: DanishWiking ($100 in chips) 
Seat 4: Bothfeld11 ($125.93 in chips) 
Seat 5: Filojoes ($100 in chips) 
Seat 6: Pacifistas ($108.17 in chips) 
Seat 7: djammusic ($72.40 in chips) 
Seat 8: solbi86 ($100.89 in chips) 
Seat 9: matiko09 ($135.82 in chips) 
matiko09: posts small blind $0.50
ka100pka527: posts big blind $1
*** HOLE CARDS ***
Dealt to matiko09 [3h 9c]
RICKA16: folds 
DanishWiking: folds 
Bothfeld11: folds 
Filojoes: raises $2 to $3
Pacifistas: folds 
djammusic: folds 
solbi86: folds 
matiko09: folds 
ka100pka527: folds 
Uncalled bet ($2) returned to Filojoes
Filojoes collected $2.50 from pot
Filojoes: doesn't show hand 
*** SUMMARY ***
Total pot $2.50 | Rake $0 
Seat 1: ka100pka527 (big blind) folded before Flop
Seat 2: RICKA16 folded before Flop (didn't bet)
Seat 3: DanishWiking folded before Flop (didn't bet)
Seat 4: Bothfeld11 folded before Flop (didn't bet)
Seat 5: Filojoes collected ($2.50)
Seat 6: Pacifistas folded before Flop (didn't bet)
Seat 7: djammusic folded before Flop (didn't bet)
Seat 8: solbi86 (button) folded before Flop (didn't bet)
Seat 9: matiko09 (small blind) folded before Flop





PokerStars Hand #150709121856:  Hold'em No Limit ($0.50/$1.00 USD) - 2016/03/21 17:36:17 CET [2016/03/21 12:36:17 ET]
Table 'Toutatis II' 9-max Seat #4 is the button
Seat 1: Linghem ($77.45 in chips) 
Seat 2: Filojoes ($102.72 in chips) 
Seat 3: matiko09 ($105.77 in chips) 
Seat 4: cn_chayanne ($109.31 in chips) 
Seat 5: solbi86 ($100 in chips) 
Seat 6: djammusic ($71.59 in chips) 
Seat 7: Pacifistas ($100 in chips) 
Seat 8: Dachish ($69.07 in chips) 
Seat 9: bvavan ($41.29 in chips) 
solbi86: posts small blind $0.50
djammusic: posts big blind $1
*** HOLE CARDS ***
Dealt to matiko09 [8h 4d]
Pacifistas: folds 
Dachish: folds 
bvavan: folds 
Linghem: folds 
Filojoes: raises $2 to $3
matiko09: folds 
cn_chayanne: folds 
solbi86: folds 
djammusic: folds 
Uncalled bet ($2) returned to Filojoes
Filojoes collected $2.50 from pot
Filojoes: doesn't show hand 
*** SUMMARY ***
Total pot $2.50 | Rake $0 
Seat 1: Linghem folded before Flop (didn't bet)
Seat 2: Filojoes collected ($2.50)
Seat 3: matiko09 folded before Flop (didn't bet)
Seat 4: cn_chayanne (button) folded before Flop (didn't bet)
Seat 5: solbi86 (small blind) folded before Flop
Seat 6: djammusic (big blind) folded before Flop
Seat 7: Pacifistas folded before Flop (didn't bet)
Seat 8: Dachish folded before Flop (didn't bet)
Seat 9: bvavan folded before Flop (didn't bet)





PokerStars Hand #150709123252:  Hold'em No Limit ($0.50/$1.00 USD) - 2016/03/21 17:36:19 CET [2016/03/21 12:36:19 ET]
Table 'Harding II' 9-max Seat #1 is the button
Seat 1: cobrik23 ($39 in chips) 
Seat 2: IntsAA ($214.10 in chips) 
Seat 3: iamkingan ($94.53 in chips) 
Seat 4: matiko09 ($100 in chips) 
Seat 5: DanishWiking ($102.94 in chips) 
Seat 6: Dachish ($65.50 in chips) 
Seat 7: RICKA16 ($105.53 in chips) 
Seat 8: solbi86 ($115.40 in chips) 
Seat 9: ka100pka527 ($38.50 in chips) 
IntsAA: posts small blind $0.50
iamkingan: posts big blind $1
*** HOLE CARDS ***
Dealt to matiko09 [Qh Jh]
matiko09: raises $2 to $3
DanishWiking: folds 
Dachish: calls $3
RICKA16: folds 
solbi86: folds 
ka100pka527: folds 
cobrik23: folds 
IntsAA: folds 
iamkingan: folds 
*** FLOP *** [8c 5c Th]
matiko09: bets $4.15
Dachish: calls $4.15
*** TURN *** [8c 5c Th] [9h]
matiko09: bets $11.69
Dachish: folds 
Uncalled bet ($11.69) returned to matiko09
matiko09 collected $15.09 from pot
matiko09: doesn't show hand 
*** SUMMARY ***
Total pot $15.80 | Rake $0.71 
Board [8c 5c Th 9h]
Seat 1: cobrik23 (button) folded before Flop (didn't bet)
Seat 2: IntsAA (small blind) folded before Flop
Seat 3: iamkingan (big blind) folded before Flop
Seat 4: matiko09 collected ($15.09)
Seat 5: DanishWiking folded before Flop (didn't bet)
Seat 6: Dachish folded on the Turn
Seat 7: RICKA16 folded before Flop (didn't bet)
Seat 8: solbi86 folded before Flop (didn't bet)
Seat 9: ka100pka527 folded before Flop (didn't bet)





PokerStars Hand #150709131136:  Hold'em No Limit ($0.50/$1.00 USD) - 2016/03/21 17:36:29 CET [2016/03/21 12:36:29 ET]
Table 'Odysseus II' 9-max Seat #7 is the button
Seat 2: Vikulja1993 ($119.42 in chips) 
Seat 3: vsbhandari ($100 in chips) 
Seat 4: aseban11 ($100 in chips) 
Seat 5: Rikti ($26.71 in chips) 
Seat 6: R1aki ($100 in chips) 
Seat 7: matiko09 ($102 in chips) 
Seat 8: fanmtZ ($40 in chips) 
Seat 9: grifkaaa ($133.35 in chips) 
fanmtZ: posts small blind $0.50
grifkaaa: posts big blind $1
Pacifistas: sits out 
*** HOLE CARDS ***
Dealt to matiko09 [5c 8c]
Vikulja1993: folds 
vsbhandari: folds 
aseban11: folds 
Rikti: folds 
R1aki: folds 
matiko09: folds 
fanmtZ: raises $1.58 to $2.58
grifkaaa: folds 
Uncalled bet ($1.58) returned to fanmtZ
fanmtZ collected $2 from pot
fanmtZ: doesn't show hand 
*** SUMMARY ***
Total pot $2 | Rake $0 
Seat 2: Vikulja1993 folded before Flop (didn't bet)
Seat 3: vsbhandari folded before Flop (didn't bet)
Seat 4: aseban11 folded before Flop (didn't bet)
Seat 5: Rikti folded before Flop (didn't bet)
Seat 6: R1aki folded before Flop (didn't bet)
Seat 7: matiko09 (button) folded before Flop (didn't bet)
Seat 8: fanmtZ (small blind) collected ($2)
Seat 9: grifkaaa (big blind) folded before Flop





PokerStars Hand #150709141510:  Hold'em No Limit ($0.50/$1.00 USD) - 2016/03/21 17:36:42 CET [2016/03/21 12:36:42 ET]
Table 'Onnie II' 9-max Seat #9 is the button
Seat 1: ka100pka527 ($160.85 in chips) 
Seat 2: RICKA16 ($100 in chips) 
Seat 3: DanishWiking ($100 in chips) 
Seat 4: Bothfeld11 ($125.93 in chips) 
Seat 5: Filojoes ($101.50 in chips) 
Seat 6: Pacifistas ($108.17 in chips) 
Seat 7: djammusic ($72.40 in chips) 
Seat 8: solbi86 ($100.89 in chips) 
Seat 9: matiko09 ($135.32 in chips) 
ka100pka527: posts small blind $0.50
RICKA16: posts big blind $1
*** HOLE CARDS ***
Dealt to matiko09 [3h 3s]
DanishWiking: folds 
Bothfeld11: raises $1 to $2
Filojoes: folds 
Pacifistas: folds 
djammusic: folds 
solbi86: calls $2
matiko09: calls $2
ka100pka527: calls $1.50
RICKA16: raises $13 to $15
Bothfeld11: raises $110.93 to $125.93 and is all-in
solbi86: folds 
matiko09: folds 
ka100pka527: folds 
RICKA16: calls $85 and is all-in
Uncalled bet ($25.93) returned to Bothfeld11
*** FLOP *** [8h 8c Td]
*** TURN *** [8h 8c Td] [Ac]
*** RIVER *** [8h 8c Td Ac] [9d]
*** SHOW DOWN ***
RICKA16: shows [Jh Jc] (two pair, Jacks and Eights)
Bothfeld11: shows [Qc Qs] (two pair, Queens and Eights)
Bothfeld11 collected $203.20 from pot
*** SUMMARY ***
Total pot $206 | Rake $2.80 
Board [8h 8c Td Ac 9d]
Seat 1: ka100pka527 (small blind) folded before Flop
Seat 2: RICKA16 (big blind) showed [Jh Jc] and lost with two pair, Jacks and Eights
Seat 3: DanishWiking folded before Flop (didn't bet)
Seat 4: Bothfeld11 showed [Qc Qs] and won ($203.20) with two pair, Queens and Eights
Seat 5: Filojoes folded before Flop (didn't bet)
Seat 6: Pacifistas folded before Flop (didn't bet)
Seat 7: djammusic folded before Flop (didn't bet)
Seat 8: solbi86 folded before Flop
Seat 9: matiko09 (button) folded before Flop





PokerStars Hand #150709147733:  Hold'em No Limit ($0.50/$1.00 USD) - 2016/03/21 17:36:50 CET [2016/03/21 12:36:50 ET]
Table 'Toutatis II' 9-max Seat #5 is the button
Seat 1: Linghem ($77.45 in chips) 
Seat 2: Filojoes ($104.22 in chips) 
Seat 3: matiko09 ($105.77 in chips) 
Seat 4: cn_chayanne ($109.31 in chips) 
Seat 5: solbi86 ($100 in chips) 
Seat 6: djammusic ($70.59 in chips) 
Seat 7: Pacifistas ($100 in chips) 
Seat 8: Dachish ($69.07 in chips) 
Seat 9: bvavan ($41.29 in chips) 
djammusic: posts small blind $0.50
Pacifistas: posts big blind $1
*** HOLE CARDS ***
Dealt to matiko09 [Ad Th]
Dachish: folds 
bvavan: calls $1
Linghem: folds 
Filojoes: folds 
matiko09: raises $3 to $4
cn_chayanne: folds 
solbi86: folds 
djammusic: folds 
Pacifistas: folds 
bvavan: calls $3
*** FLOP *** [3h 2d 3c]
bvavan: checks 
matiko09: checks 
*** TURN *** [3h 2d 3c] [Qh]
bvavan: checks 
matiko09: checks 
*** RIVER *** [3h 2d 3c Qh] [Qs]
bvavan: checks 
matiko09: checks 
*** SHOW DOWN ***
bvavan: shows [9s Ah] (two pair, Queens and Threes)
matiko09: shows [Ad Th] (two pair, Queens and Threes)
bvavan collected $4.54 from pot
matiko09 collected $4.53 from pot
*** SUMMARY ***
Total pot $9.50 | Rake $0.43 
Board [3h 2d 3c Qh Qs]
Seat 1: Linghem folded before Flop (didn't bet)
Seat 2: Filojoes folded before Flop (didn't bet)
Seat 3: matiko09 showed [Ad Th] and won ($4.53) with two pair, Queens and Threes
Seat 4: cn_chayanne folded before Flop (didn't bet)
Seat 5: solbi86 (button) folded before Flop (didn't bet)
Seat 6: djammusic (small blind) folded before Flop
Seat 7: Pacifistas (big blind) folded before Flop
Seat 8: Dachish folded before Flop (didn't bet)
Seat 9: bvavan showed [9s Ah] and won ($4.54) with two pair, Queens and Threes





PokerStars Hand #150709149151:  Hold'em No Limit ($0.50/$1.00 USD) - 2016/03/21 17:36:52 CET [2016/03/21 12:36:52 ET]
Table 'Marmulla II' 9-max Seat #6 is the button
Seat 3: Vikulja1993 ($135.34 in chips) 
Seat 4: Dachish ($86.55 in chips) 
Seat 5: maaaGik88 ($51.96 in chips) 
Seat 6: R1aki ($158.34 in chips) 
Seat 7: Pacifistas ($100.50 in chips) 
Seat 9: matiko09 ($100 in chips) 
Pacifistas: posts small blind $0.50
ffac: is sitting out 
matiko09: posts big blind $1
volwebni4ek: sits out 
*** HOLE CARDS ***
Dealt to matiko09 [3h Ts]
ffac leaves the table
Vikulja1993: folds 
Dachish: raises $2 to $3
maaaGik88: folds 
R1aki: folds 
Pacifistas: folds 
matiko09: folds 
Uncalled bet ($2) returned to Dachish
Dachish collected $2.50 from pot
Dachish: doesn't show hand 
*** SUMMARY ***
Total pot $2.50 | Rake $0 
Seat 3: Vikulja1993 folded before Flop (didn't bet)
Seat 4: Dachish collected ($2.50)
Seat 5: maaaGik88 folded before Flop (didn't bet)
Seat 6: R1aki (button) folded before Flop (didn't bet)
Seat 7: Pacifistas (small blind) folded before Flop
Seat 9: matiko09 (big blind) folded before Flop





PokerStars Hand #150709152460:  Hold'em No Limit ($0.50/$1.00 USD) - 2016/03/21 17:36:56 CET [2016/03/21 12:36:56 ET]
Table 'Odysseus II' 9-max Seat #8 is the button
Seat 1: Pacifistas ($100 in chips) 
Seat 2: Vikulja1993 ($119.42 in chips) 
Seat 3: vsbhandari ($100 in chips) 
Seat 4: aseban11 ($100 in chips) 
Seat 5: Rikti ($26.71 in chips) 
Seat 6: R1aki ($100 in chips) 
Seat 7: matiko09 ($102 in chips) 
Seat 8: fanmtZ ($41 in chips) 
Seat 9: grifkaaa ($132.35 in chips) 
grifkaaa: posts small blind $0.50
Pacifistas: posts big blind $1
*** HOLE CARDS ***
Dealt to matiko09 [Qd 6s]
Vikulja1993: folds 
vsbhandari: folds 
aseban11: folds 
Rikti: folds 
R1aki: folds 
matiko09: folds 
fanmtZ: raises $1.02 to $2.02
grifkaaa: folds 
Pacifistas: folds 
Uncalled bet ($1.02) returned to fanmtZ
fanmtZ collected $2.50 from pot
fanmtZ: doesn't show hand 
*** SUMMARY ***
Total pot $2.50 | Rake $0 
Seat 1: Pacifistas (big blind) folded before Flop
Seat 2: Vikulja1993 folded before Flop (didn't bet)
Seat 3: vsbhandari folded before Flop (didn't bet)
Seat 4: aseban11 folded before Flop (didn't bet)
Seat 5: Rikti folded before Flop (didn't bet)
Seat 6: R1aki folded before Flop (didn't bet)
Seat 7: matiko09 folded before Flop (didn't bet)
Seat 8: fanmtZ (button) collected ($2.50)
Seat 9: grifkaaa (small blind) folded before Flop





PokerStars Hand #150709166108:  Hold'em No Limit ($0.50/$1.00 USD) - 2016/03/21 17:37:13 CET [2016/03/21 12:37:13 ET]
Table 'Harding II' 9-max Seat #2 is the button
Seat 1: cobrik23 ($39 in chips) 
Seat 2: IntsAA ($213.60 in chips) 
Seat 3: iamkingan ($93.53 in chips) 
Seat 4: matiko09 ($107.94 in chips) 
Seat 5: DanishWiking ($102.94 in chips) 
Seat 6: Dachish ($70 in chips) 
Seat 7: RICKA16 ($105.53 in chips) 
Seat 8: solbi86 ($115.40 in chips) 
Seat 9: ka100pka527 ($38.50 in chips) 
iamkingan: posts small blind $0.50
matiko09: posts big blind $1
*** HOLE CARDS ***
Dealt to matiko09 [Qd 5d]
DanishWiking: folds 
Dachish: raises $2 to $3
RICKA16: folds 
solbi86: folds 
ka100pka527: folds 
cobrik23: folds 
IntsAA: folds 
iamkingan: calls $2.50
matiko09: folds 
*** FLOP *** [4s Kd 3d]
iamkingan: checks 
Dachish: checks 
*** TURN *** [4s Kd 3d] [Ad]
iamkingan: checks 
Dachish: bets $4.74
iamkingan: folds 
Uncalled bet ($4.74) returned to Dachish
Dachish collected $6.68 from pot
Dachish: doesn't show hand 
*** SUMMARY ***
Total pot $7 | Rake $0.32 
Board [4s Kd 3d Ad]
Seat 1: cobrik23 folded before Flop (didn't bet)
Seat 2: IntsAA (button) folded before Flop (didn't bet)
Seat 3: iamkingan (small blind) folded on the Turn
Seat 4: matiko09 (big blind) folded before Flop
Seat 5: DanishWiking folded before Flop (didn't bet)
Seat 6: Dachish collected ($6.68)
Seat 7: RICKA16 folded before Flop (didn't bet)
Seat 8: solbi86 folded before Flop (didn't bet)
Seat 9: ka100pka527 folded before Flop (didn't bet)





PokerStars Hand #150709173941:  Hold'em No Limit ($0.50/$1.00 USD) - 2016/03/21 17:37:23 CET [2016/03/21 12:37:23 ET]
Table 'Marmulla II' 9-max Seat #7 is the button
Seat 2: volwebni4ek ($100 in chips) 
Seat 3: Vikulja1993 ($135.34 in chips) 
Seat 4: Dachish ($88.05 in chips) 
Seat 5: maaaGik88 ($51.96 in chips) 
Seat 6: R1aki ($158.34 in chips) 
Seat 7: Pacifistas ($100 in chips) 
Seat 9: matiko09 ($100 in chips) 
matiko09: posts small blind $0.50
fanmtZ was removed from the table for failing to post
volwebni4ek: posts big blind $1
*** HOLE CARDS ***
Dealt to matiko09 [Tc 5c]
Vikulja1993: folds 
Dachish: folds 
maaaGik88: raises $1 to $2
ceedonen joins the table at seat #1 
R1aki: folds 
ceedonen leaves the table
Pacifistas: folds 
matiko09: folds 
volwebni4ek: folds 
Uncalled bet ($1) returned to maaaGik88
maaaGik88 collected $2.50 from pot
maaaGik88: doesn't show hand 
*** SUMMARY ***
Total pot $2.50 | Rake $0 
Seat 2: volwebni4ek (big blind) folded before Flop
Seat 3: Vikulja1993 folded before Flop (didn't bet)
Seat 4: Dachish folded before Flop (didn't bet)
Seat 5: maaaGik88 collected ($2.50)
Seat 6: R1aki folded before Flop (didn't bet)
Seat 7: Pacifistas (button) folded before Flop (didn't bet)
Seat 9: matiko09 (small blind) folded before Flop





PokerStars Hand #150709177621:  Hold'em No Limit ($0.50/$1.00 USD) - 2016/03/21 17:37:27 CET [2016/03/21 12:37:27 ET]
Table 'Odysseus II' 9-max Seat #9 is the button
Seat 1: Pacifistas ($100 in chips) 
Seat 2: Vikulja1993 ($119.42 in chips) 
Seat 3: vsbhandari ($100 in chips) 
Seat 4: aseban11 ($100 in chips) 
Seat 5: Rikti ($26.71 in chips) 
Seat 6: R1aki ($100 in chips) 
Seat 7: matiko09 ($102 in chips) 
Seat 8: fanmtZ ($42.50 in chips) 
Seat 9: grifkaaa ($131.85 in chips) 
Pacifistas: posts small blind $0.50
Vikulja1993: posts big blind $1
*** HOLE CARDS ***
Dealt to matiko09 [3h 6c]
vsbhandari: raises $2 to $3
aseban11: folds 
Rikti: folds 
R1aki: calls $3
matiko09: folds 
fanmtZ: folds 
grifkaaa: calls $3
Pacifistas: folds 
Vikulja1993: folds 
*** FLOP *** [As Ks 4d]
vsbhandari: bets $6
R1aki: folds 
grifkaaa: folds 
Uncalled bet ($6) returned to vsbhandari
vsbhandari collected $10.03 from pot
*** SUMMARY ***
Total pot $10.50 | Rake $0.47 
Board [As Ks 4d]
Seat 1: Pacifistas (small blind) folded before Flop
Seat 2: Vikulja1993 (big blind) folded before Flop
Seat 3: vsbhandari collected ($10.03)
Seat 4: aseban11 folded before Flop (didn't bet)
Seat 5: Rikti folded before Flop (didn't bet)
Seat 6: R1aki folded on the Flop
Seat 7: matiko09 folded before Flop (didn't bet)
Seat 8: fanmtZ folded before Flop (didn't bet)
Seat 9: grifkaaa (button) folded on the Flop





PokerStars Hand #150709194252:  Hold'em No Limit ($0.50/$1.00 USD) - 2016/03/21 17:37:48 CET [2016/03/21 12:37:48 ET]
Table 'Marmulla II' 9-max Seat #9 is the button
Seat 2: volwebni4ek ($99 in chips) 
Seat 3: Vikulja1993 ($135.34 in chips) 
Seat 4: Dachish ($88.05 in chips) 
Seat 5: maaaGik88 ($53.46 in chips) 
Seat 6: R1aki ($158.34 in chips) 
Seat 7: Pacifistas ($100 in chips) 
Seat 9: matiko09 ($100 in chips) 
volwebni4ek: posts small blind $0.50
Vikulja1993: posts big blind $1
*** HOLE CARDS ***
Dealt to matiko09 [Ac Ah]
aseban11 joins the table at seat #8 
Dachish: folds 
cobrik23 joins the table at seat #1 
maaaGik88: raises $1 to $2
R1aki: folds 
Pacifistas: folds 
matiko09: raises $6 to $8
volwebni4ek: folds 
Vikulja1993: folds 
maaaGik88: folds 
Uncalled bet ($6) returned to matiko09
matiko09 collected $5.50 from pot
matiko09: doesn't show hand 
*** SUMMARY ***
Total pot $5.50 | Rake $0 
Seat 2: volwebni4ek (small blind) folded before Flop
Seat 3: Vikulja1993 (big blind) folded before Flop
Seat 4: Dachish folded before Flop (didn't bet)
Seat 5: maaaGik88 folded before Flop
Seat 6: R1aki folded before Flop (didn't bet)
Seat 7: Pacifistas folded before Flop (didn't bet)
Seat 9: matiko09 (button) collected ($5.50)





PokerStars Hand #150709194787:  Hold'em No Limit ($0.50/$1.00 USD) - 2016/03/21 17:37:49 CET [2016/03/21 12:37:49 ET]
Table 'Toutatis II' 9-max Seat #6 is the button
Seat 1: Linghem ($77.45 in chips) 
Seat 2: Filojoes ($104.22 in chips) 
Seat 3: matiko09 ($106.30 in chips) 
Seat 4: cn_chayanne ($109.31 in chips) 
Seat 5: solbi86 ($100 in chips) 
Seat 6: djammusic ($70.09 in chips) 
Seat 7: Pacifistas ($100 in chips) 
Seat 8: Dachish ($69.07 in chips) 
Seat 9: bvavan ($41.83 in chips) 
Pacifistas: posts small blind $0.50
Dachish: posts big blind $1
*** HOLE CARDS ***
Dealt to matiko09 [7s Qc]
bvavan: folds 
Linghem: folds 
Filojoes: folds 
matiko09: folds 
cn_chayanne: folds 
solbi86: folds 
djammusic: folds 
Pacifistas: raises $1.50 to $2.50
Dachish: folds 
Uncalled bet ($1.50) returned to Pacifistas
Pacifistas collected $2 from pot
Pacifistas: doesn't show hand 
*** SUMMARY ***
Total pot $2 | Rake $0 
Seat 1: Linghem folded before Flop (didn't bet)
Seat 2: Filojoes folded before Flop (didn't bet)
Seat 3: matiko09 folded before Flop (didn't bet)
Seat 4: cn_chayanne folded before Flop (didn't bet)
Seat 5: solbi86 folded before Flop (didn't bet)
Seat 6: djammusic (button) folded before Flop (didn't bet)
Seat 7: Pacifistas (small blind) collected ($2)
Seat 8: Dachish (big blind) folded before Flop
Seat 9: bvavan folded before Flop (didn't bet)





PokerStars Hand #150709201479:  Hold'em No Limit ($0.50/$1.00 USD) - 2016/03/21 17:37:58 CET [2016/03/21 12:37:58 ET]
Table 'Massalia II' 9-max Seat #4 is the button
Seat 1: ceedonen ($100 in chips) 
Seat 2: SiD11211 ($144.19 in chips) 
Seat 3: 123chambo ($129.84 in chips) 
Seat 4: OriginalTony ($145.30 in chips) 
Seat 5: Vikulja1993 ($119.30 in chips) 
Seat 6: Pacifistas ($100 in chips) 
Seat 8: matiko09 ($162.48 in chips) 
Seat 9: DanishWiking ($116.25 in chips) 
Vikulja1993: posts small blind $0.50
Pacifistas: posts big blind $1
volwebni4ek: sits out 
ceedonen: posts the ante $0.20
SiD11211: posts the ante $0.20
123chambo: posts the ante $0.20
OriginalTony: posts the ante $0.20
Vikulja1993: posts the ante $0.20
Pacifistas: posts the ante $0.20
matiko09: posts the ante $0.20
DanishWiking: posts the ante $0.20
*** HOLE CARDS ***
Dealt to matiko09 [5s 6c]
matiko09: folds 
DanishWiking: folds 
ceedonen: raises $2 to $3
SiD11211: calls $3
123chambo: folds 
OriginalTony: folds 
Vikulja1993: folds 
Pacifistas: calls $2
*** FLOP *** [Js 8h Ks]
Pacifistas: checks 
ceedonen: checks 
SiD11211: checks 
*** TURN *** [Js 8h Ks] [Qd]
Pacifistas: bets $5.72
ceedonen: calls $5.72
SiD11211: calls $5.72
*** RIVER *** [Js 8h Ks Qd] [8c]
Pacifistas: bets $8.50
ceedonen: raises $16 to $24.50
SiD11211: folds 
Pacifistas has timed out
Pacifistas: folds 
Uncalled bet ($16) returned to ceedonen
ceedonen collected $43.22 from pot
ceedonen: doesn't show hand 
*** SUMMARY ***
Total pot $45.26 | Rake $2.04 
Board [Js 8h Ks Qd 8c]
Seat 1: ceedonen collected ($43.22)
Seat 2: SiD11211 folded on the River
Seat 3: 123chambo folded before Flop (didn't bet)
Seat 4: OriginalTony (button) folded before Flop (didn't bet)
Seat 5: Vikulja1993 (small blind) folded before Flop
Seat 6: Pacifistas (big blind) folded on the River
Seat 8: matiko09 folded before Flop (didn't bet)
Seat 9: DanishWiking folded before Flop (didn't bet)





PokerStars Hand #150709212682:  Hold'em No Limit ($0.50/$1.00 USD) - 2016/03/21 17:38:12 CET [2016/03/21 12:38:12 ET]
Table 'Onnie II' 9-max Seat #1 is the button
Seat 1: ka100pka527 ($158.85 in chips) 
Seat 2: RICKA16 ($40 in chips) 
Seat 3: DanishWiking ($100 in chips) 
Seat 4: Bothfeld11 ($229.13 in chips) 
Seat 5: Filojoes ($101.50 in chips) 
Seat 6: Pacifistas ($108.17 in chips) 
Seat 7: djammusic ($72.40 in chips) 
Seat 8: solbi86 ($100 in chips) 
Seat 9: matiko09 ($133.32 in chips) 
RICKA16: posts small blind $0.50
DanishWiking: posts big blind $1
*** HOLE CARDS ***
Dealt to matiko09 [5s 4h]
Bothfeld11: calls $1
Filojoes: folds 
Pacifistas: folds 
djammusic: folds 
solbi86: raises $3 to $4
matiko09: folds 
ka100pka527: folds 
RICKA16: folds 
DanishWiking: folds 
Bothfeld11: calls $3
*** FLOP *** [9h 4s Qs]
Bothfeld11: checks 
solbi86: bets $4.98
Bothfeld11: folds 
Uncalled bet ($4.98) returned to solbi86
solbi86 collected $9.07 from pot
solbi86: doesn't show hand 
*** SUMMARY ***
Total pot $9.50 | Rake $0.43 
Board [9h 4s Qs]
Seat 1: ka100pka527 (button) folded before Flop (didn't bet)
Seat 2: RICKA16 (small blind) folded before Flop
Seat 3: DanishWiking (big blind) folded before Flop
Seat 4: Bothfeld11 folded on the Flop
Seat 5: Filojoes folded before Flop (didn't bet)
Seat 6: Pacifistas folded before Flop (didn't bet)
Seat 7: djammusic folded before Flop (didn't bet)
Seat 8: solbi86 collected ($9.07)
Seat 9: matiko09 folded before Flop (didn't bet)





PokerStars Hand #150709217487:  Hold'em No Limit ($0.50/$1.00 USD) - 2016/03/21 17:38:18 CET [2016/03/21 12:38:18 ET]
Table 'Odysseus II' 9-max Seat #1 is the button
Seat 1: Pacifistas ($100 in chips) 
Seat 2: Vikulja1993 ($118.42 in chips) 
Seat 3: vsbhandari ($107.03 in chips) 
Seat 4: aseban11 ($100 in chips) 
Seat 5: Rikti ($26.71 in chips) 
Seat 6: R1aki ($100 in chips) 
Seat 7: matiko09 ($102 in chips) 
Seat 8: fanmtZ ($42.50 in chips) 
Seat 9: grifkaaa ($128.85 in chips) 
Vikulja1993: posts small blind $0.50
vsbhandari: posts big blind $1
*** HOLE CARDS ***
Dealt to matiko09 [7c Jc]
aseban11: folds 
Rikti: folds 
R1aki: folds 
matiko09: folds 
fanmtZ: folds 
grifkaaa: raises $2 to $3
Pacifistas: folds 
Vikulja1993: folds 
vsbhandari: folds 
Uncalled bet ($2) returned to grifkaaa
grifkaaa collected $2.50 from pot
*** SUMMARY ***
Total pot $2.50 | Rake $0 
Seat 1: Pacifistas (button) folded before Flop (didn't bet)
Seat 2: Vikulja1993 (small blind) folded before Flop
Seat 3: vsbhandari (big blind) folded before Flop
Seat 4: aseban11 folded before Flop (didn't bet)
Seat 5: Rikti folded before Flop (didn't bet)
Seat 6: R1aki folded before Flop (didn't bet)
Seat 7: matiko09 folded before Flop (didn't bet)
Seat 8: fanmtZ folded before Flop (didn't bet)
Seat 9: grifkaaa collected ($2.50)





PokerStars Hand #150709218841:  Hold'em No Limit ($0.50/$1.00 USD) - 2016/03/21 17:38:19 CET [2016/03/21 12:38:19 ET]
Table 'Marmulla II' 9-max Seat #2 is the button
Seat 2: volwebni4ek ($98.50 in chips) 
Seat 3: Vikulja1993 ($134.34 in chips) 
Seat 4: Dachish ($88.05 in chips) 
Seat 5: maaaGik88 ($51.46 in chips) 
Seat 6: R1aki ($158.34 in chips) 
Seat 7: Pacifistas ($100 in chips) 
Seat 9: matiko09 ($103.50 in chips) 
Vikulja1993: posts small blind $0.50
Dachish: posts big blind $1
aseban11: sits out 
cobrik23: sits out 
*** HOLE CARDS ***
Dealt to matiko09 [5h 4c]
maaaGik88: folds 
R1aki: folds 
Pacifistas: folds 
matiko09: folds 
volwebni4ek: raises $1 to $2
Vikulja1993: folds 
Dachish: folds 
Uncalled bet ($1) returned to volwebni4ek
volwebni4ek collected $2.50 from pot
volwebni4ek: doesn't show hand 
*** SUMMARY ***
Total pot $2.50 | Rake $0 
Seat 2: volwebni4ek (button) collected ($2.50)
Seat 3: Vikulja1993 (small blind) folded before Flop
Seat 4: Dachish (big blind) folded before Flop
Seat 5: maaaGik88 folded before Flop (didn't bet)
Seat 6: R1aki folded before Flop (didn't bet)
Seat 7: Pacifistas folded before Flop (didn't bet)
Seat 9: matiko09 folded before Flop (didn't bet)





PokerStars Hand #150709228266:  Hold'em No Limit ($0.50/$1.00 USD) - 2016/03/21 17:38:31 CET [2016/03/21 12:38:31 ET]
Table 'Harding II' 9-max Seat #3 is the button
Seat 1: cobrik23 ($39 in chips) 
Seat 2: IntsAA ($213.60 in chips) 
Seat 3: iamkingan ($90.53 in chips) 
Seat 4: matiko09 ($106.94 in chips) 
Seat 5: DanishWiking ($102.94 in chips) 
Seat 6: Dachish ($73.68 in chips) 
Seat 7: RICKA16 ($105.53 in chips) 
Seat 8: solbi86 ($115.40 in chips) 
Seat 9: ka100pka527 ($38.50 in chips) 
matiko09: posts small blind $0.50
DanishWiking: posts big blind $1
*** HOLE CARDS ***
Dealt to matiko09 [7d Ts]
Dachish: folds 
RICKA16: folds 
solbi86: folds 
ka100pka527: folds 
cobrik23: folds 
IntsAA: folds 
iamkingan: calls $1
matiko09: folds 
DanishWiking: checks 
*** FLOP *** [Ad Jd Ah]
DanishWiking: checks 
iamkingan: bets $1
DanishWiking: folds 
Uncalled bet ($1) returned to iamkingan
iamkingan collected $2.39 from pot
*** SUMMARY ***
Total pot $2.50 | Rake $0.11 
Board [Ad Jd Ah]
Seat 1: cobrik23 folded before Flop (didn't bet)
Seat 2: IntsAA folded before Flop (didn't bet)
Seat 3: iamkingan (button) collected ($2.39)
Seat 4: matiko09 (small blind) folded before Flop
Seat 5: DanishWiking (big blind) folded on the Flop
Seat 6: Dachish folded before Flop (didn't bet)
Seat 7: RICKA16 folded before Flop (didn't bet)
Seat 8: solbi86 folded before Flop (didn't bet)
Seat 9: ka100pka527 folded before Flop (didn't bet)





PokerStars Hand #150709234509:  Hold'em No Limit ($0.50/$1.00 USD) - 2016/03/21 17:38:39 CET [2016/03/21 12:38:39 ET]
Table 'Toutatis II' 9-max Seat #7 is the button
Seat 1: Linghem ($77.45 in chips) 
Seat 2: Filojoes ($104.22 in chips) 
Seat 3: matiko09 ($106.30 in chips) 
Seat 4: cn_chayanne ($109.31 in chips) 
Seat 5: solbi86 ($100 in chips) 
Seat 6: djammusic ($70.09 in chips) 
Seat 7: Pacifistas ($101 in chips) 
Seat 8: Dachish ($68.07 in chips) 
Seat 9: bvavan ($41.83 in chips) 
Dachish: posts small blind $0.50
bvavan: posts big blind $1
*** HOLE CARDS ***
Dealt to matiko09 [Ks 6s]
Linghem: folds 
Filojoes: folds 
matiko09: folds 
cn_chayanne: folds 
solbi86: folds 
djammusic: folds 
Pacifistas: folds 
Dachish: folds 
Uncalled bet ($0.50) returned to bvavan
bvavan collected $1 from pot
*** SUMMARY ***
Total pot $1 | Rake $0 
Seat 1: Linghem folded before Flop (didn't bet)
Seat 2: Filojoes folded before Flop (didn't bet)
Seat 3: matiko09 folded before Flop (didn't bet)
Seat 4: cn_chayanne folded before Flop (didn't bet)
Seat 5: solbi86 folded before Flop (didn't bet)
Seat 6: djammusic folded before Flop (didn't bet)
Seat 7: Pacifistas (button) folded before Flop (didn't bet)
Seat 8: Dachish (small blind) folded before Flop
Seat 9: bvavan (big blind) collected ($1)





PokerStars Hand #150709243907:  Hold'em No Limit ($0.50/$1.00 USD) - 2016/03/21 17:38:51 CET [2016/03/21 12:38:51 ET]
Table 'Odysseus II' 9-max Seat #2 is the button
Seat 1: Pacifistas ($100 in chips) 
Seat 2: Vikulja1993 ($117.92 in chips) 
Seat 3: vsbhandari ($106.03 in chips) 
Seat 4: aseban11 ($100 in chips) 
Seat 5: Rikti ($26.71 in chips) 
Seat 6: R1aki ($100 in chips) 
Seat 7: matiko09 ($102 in chips) 
Seat 8: fanmtZ ($42.50 in chips) 
Seat 9: grifkaaa ($130.35 in chips) 
vsbhandari: posts small blind $0.50
aseban11: posts big blind $1
*** HOLE CARDS ***
Dealt to matiko09 [8h 3h]
Rikti: folds 
R1aki: folds 
matiko09: folds 
fanmtZ: raises $1.38 to $2.38
grifkaaa: folds 
Pacifistas: folds 
Vikulja1993: calls $2.38
vsbhandari: folds 
aseban11: folds 
*** FLOP *** [8d 8s 6s]
fanmtZ: checks 
Vikulja1993: bets $3
fanmtZ: folds 
Uncalled bet ($3) returned to Vikulja1993
Vikulja1993 collected $5.98 from pot
Vikulja1993: doesn't show hand 
*** SUMMARY ***
Total pot $6.26 | Rake $0.28 
Board [8d 8s 6s]
Seat 1: Pacifistas folded before Flop (didn't bet)
Seat 2: Vikulja1993 (button) collected ($5.98)
Seat 3: vsbhandari (small blind) folded before Flop
Seat 4: aseban11 (big blind) folded before Flop
Seat 5: Rikti folded before Flop (didn't bet)
Seat 6: R1aki folded before Flop (didn't bet)
Seat 7: matiko09 folded before Flop (didn't bet)
Seat 8: fanmtZ folded on the Flop
Seat 9: grifkaaa folded before Flop (didn't bet)





PokerStars Hand #150709244077:  Hold'em No Limit ($0.50/$1.00 USD) - 2016/03/21 17:38:51 CET [2016/03/21 12:38:51 ET]
Table 'Marmulla II' 9-max Seat #3 is the button
Seat 2: volwebni4ek ($100 in chips) 
Seat 3: Vikulja1993 ($133.84 in chips) 
Seat 4: Dachish ($87.05 in chips) 
Seat 5: maaaGik88 ($51.46 in chips) 
Seat 6: R1aki ($158.34 in chips) 
Seat 7: Pacifistas ($100 in chips) 
Seat 9: matiko09 ($103.50 in chips) 
Dachish: posts small blind $0.50
maaaGik88: posts big blind $1
aseban11: sits out 
cobrik23: sits out 
*** HOLE CARDS ***
Dealt to matiko09 [Td Kh]
R1aki: folds 
Pacifistas: raises $2 to $3
matiko09: folds 
volwebni4ek: folds 
Vikulja1993: folds 
Dachish: folds 
maaaGik88: folds 
Uncalled bet ($2) returned to Pacifistas
Pacifistas collected $2.50 from pot
Pacifistas: doesn't show hand 
*** SUMMARY ***
Total pot $2.50 | Rake $0 
Seat 2: volwebni4ek folded before Flop (didn't bet)
Seat 3: Vikulja1993 (button) folded before Flop (didn't bet)
Seat 4: Dachish (small blind) folded before Flop
Seat 5: maaaGik88 (big blind) folded before Flop
Seat 6: R1aki folded before Flop (didn't bet)
Seat 7: Pacifistas collected ($2.50)
Seat 9: matiko09 folded before Flop (didn't bet)





PokerStars Hand #150709251915:  Hold'em No Limit ($0.50/$1.00 USD) - 2016/03/21 17:39:01 CET [2016/03/21 12:39:01 ET]
Table 'Toutatis II' 9-max Seat #8 is the button
Seat 1: Linghem ($77.45 in chips) 
Seat 2: Filojoes ($104.22 in chips) 
Seat 3: matiko09 ($106.30 in chips) 
Seat 4: cn_chayanne ($109.31 in chips) 
Seat 5: solbi86 ($100 in chips) 
Seat 6: djammusic ($70.09 in chips) 
Seat 7: Pacifistas ($101 in chips) 
Seat 8: Dachish ($67.57 in chips) 
Seat 9: bvavan ($42.33 in chips) 
bvavan: posts small blind $0.50
Linghem: posts big blind $1
*** HOLE CARDS ***
Dealt to matiko09 [2s 6h]
Filojoes: folds 
matiko09: folds 
cn_chayanne: folds 
solbi86: folds 
djammusic: folds 
Pacifistas: raises $1.50 to $2.50
Dachish: folds 
bvavan: calls $2
Linghem: folds 
*** FLOP *** [8s 4d 6s]
bvavan: checks 
Pacifistas: bets $3.09
bvavan: folds 
Uncalled bet ($3.09) returned to Pacifistas
Pacifistas collected $5.73 from pot
Pacifistas: doesn't show hand 
*** SUMMARY ***
Total pot $6 | Rake $0.27 
Board [8s 4d 6s]
Seat 1: Linghem (big blind) folded before Flop
Seat 2: Filojoes folded before Flop (didn't bet)
Seat 3: matiko09 folded before Flop (didn't bet)
Seat 4: cn_chayanne folded before Flop (didn't bet)
Seat 5: solbi86 folded before Flop (didn't bet)
Seat 6: djammusic folded before Flop (didn't bet)
Seat 7: Pacifistas collected ($5.73)
Seat 8: Dachish (button) folded before Flop (didn't bet)
Seat 9: bvavan (small blind) folded on the Flop





PokerStars Hand #150709263262:  Hold'em No Limit ($0.50/$1.00 USD) - 2016/03/21 17:39:15 CET [2016/03/21 12:39:15 ET]
Table 'Onnie II' 9-max Seat #2 is the button
Seat 1: ka100pka527 ($158.85 in chips) 
Seat 2: RICKA16 ($100 in chips) 
Seat 3: DanishWiking ($100 in chips) 
Seat 4: Bothfeld11 ($225.13 in chips) 
Seat 5: Filojoes ($101.50 in chips) 
Seat 6: Pacifistas ($108.17 in chips) 
Seat 7: djammusic ($72.40 in chips) 
Seat 8: solbi86 ($105.07 in chips) 
Seat 9: matiko09 ($133.32 in chips) 
DanishWiking: posts small blind $0.50
Bothfeld11: posts big blind $1
*** HOLE CARDS ***
Dealt to matiko09 [2s Ts]
Filojoes: folds 
Pacifistas has timed out
Pacifistas: folds 
djammusic: folds 
solbi86: folds 
matiko09: folds 
ka100pka527: folds 
RICKA16: raises $2 to $3
DanishWiking: folds 
Bothfeld11: folds 
Uncalled bet ($2) returned to RICKA16
RICKA16 collected $2.50 from pot
RICKA16: doesn't show hand 
*** SUMMARY ***
Total pot $2.50 | Rake $0 
Seat 1: ka100pka527 folded before Flop (didn't bet)
Seat 2: RICKA16 (button) collected ($2.50)
Seat 3: DanishWiking (small blind) folded before Flop
Seat 4: Bothfeld11 (big blind) folded before Flop
Seat 5: Filojoes folded before Flop (didn't bet)
Seat 6: Pacifistas folded before Flop (didn't bet)
Seat 7: djammusic folded before Flop (didn't bet)
Seat 8: solbi86 folded before Flop (didn't bet)
Seat 9: matiko09 folded before Flop (didn't bet)





PokerStars Hand #150709262915:  Hold'em No Limit ($0.50/$1.00 USD) - 2016/03/21 17:39:15 CET [2016/03/21 12:39:15 ET]
Table 'Harding II' 9-max Seat #4 is the button
Seat 1: cobrik23 ($39 in chips) 
Seat 2: IntsAA ($213.60 in chips) 
Seat 3: iamkingan ($91.92 in chips) 
Seat 4: matiko09 ($106.44 in chips) 
Seat 5: DanishWiking ($101.94 in chips) 
Seat 6: Dachish ($73.68 in chips) 
Seat 7: RICKA16 ($105.53 in chips) 
Seat 8: solbi86 ($115.40 in chips) 
Seat 9: ka100pka527 ($38.50 in chips) 
DanishWiking: posts small blind $0.50
Dachish: posts big blind $1
*** HOLE CARDS ***
Dealt to matiko09 [7h 3d]
RICKA16: folds 
solbi86: raises $2 to $3
ka100pka527: folds 
cobrik23: folds 
IntsAA: folds 
iamkingan: folds 
matiko09: folds 
DanishWiking: folds 
Dachish: folds 
Uncalled bet ($2) returned to solbi86
solbi86 collected $2.50 from pot
solbi86: doesn't show hand 
*** SUMMARY ***
Total pot $2.50 | Rake $0 
Seat 1: cobrik23 folded before Flop (didn't bet)
Seat 2: IntsAA folded before Flop (didn't bet)
Seat 3: iamkingan folded before Flop (didn't bet)
Seat 4: matiko09 (button) folded before Flop (didn't bet)
Seat 5: DanishWiking (small blind) folded before Flop
Seat 6: Dachish (big blind) folded before Flop
Seat 7: RICKA16 folded before Flop (didn't bet)
Seat 8: solbi86 collected ($2.50)
Seat 9: ka100pka527 folded before Flop (didn't bet)





PokerStars Hand #150709267165:  Hold'em No Limit ($0.50/$1.00 USD) - 2016/03/21 17:39:20 CET [2016/03/21 12:39:20 ET]
Table 'Marmulla II' 9-max Seat #4 is the button
Seat 2: volwebni4ek ($100 in chips) 
Seat 3: Vikulja1993 ($133.84 in chips) 
Seat 4: Dachish ($86.55 in chips) 
Seat 5: maaaGik88 ($50.46 in chips) 
Seat 6: R1aki ($158.34 in chips) 
Seat 7: Pacifistas ($101.50 in chips) 
Seat 9: matiko09 ($103.50 in chips) 
maaaGik88: posts small blind $0.50
R1aki: posts big blind $1
cobrik23: sits out 
*** HOLE CARDS ***
Dealt to matiko09 [Tc 4c]
Pacifistas: folds 
matiko09: folds 
volwebni4ek: folds 
Vikulja1993: folds 
Dachish: raises $1.50 to $2.50
maaaGik88: raises $3.50 to $6
R1aki: folds 
Dachish: folds 
Uncalled bet ($3.50) returned to maaaGik88
maaaGik88 collected $6 from pot
maaaGik88: doesn't show hand 
*** SUMMARY ***
Total pot $6 | Rake $0 
Seat 2: volwebni4ek folded before Flop (didn't bet)
Seat 3: Vikulja1993 folded before Flop (didn't bet)
Seat 4: Dachish (button) folded before Flop
Seat 5: maaaGik88 (small blind) collected ($6)
Seat 6: R1aki (big blind) folded before Flop
Seat 7: Pacifistas folded before Flop (didn't bet)
Seat 9: matiko09 folded before Flop (didn't bet)





PokerStars Hand #150709282097:  Hold'em No Limit ($0.50/$1.00 USD) - 2016/03/21 17:39:39 CET [2016/03/21 12:39:39 ET]
Table 'Harding II' 9-max Seat #5 is the button
Seat 1: cobrik23 ($39 in chips) 
Seat 2: IntsAA ($213.60 in chips) 
Seat 3: iamkingan ($91.92 in chips) 
Seat 4: matiko09 ($106.44 in chips) 
Seat 5: DanishWiking ($101.44 in chips) 
Seat 6: Dachish ($72.68 in chips) 
Seat 7: RICKA16 ($105.53 in chips) 
Seat 8: solbi86 ($116.90 in chips) 
Seat 9: ka100pka527 ($38.50 in chips) 
Dachish: posts small blind $0.50
RICKA16: posts big blind $1
*** HOLE CARDS ***
Dealt to matiko09 [8c 2h]
solbi86: folds 
ka100pka527: folds 
cobrik23: folds 
IntsAA: folds 
iamkingan: calls $1
matiko09: folds 
DanishWiking: folds 
Dachish: folds 
RICKA16: checks 
*** FLOP *** [8h Kd 7h]
RICKA16: checks 
iamkingan: checks 
*** TURN *** [8h Kd 7h] [Kc]
RICKA16: checks 
iamkingan: checks 
*** RIVER *** [8h Kd 7h Kc] [Ah]
RICKA16: checks 
iamkingan: bets $1
RICKA16: folds 
Uncalled bet ($1) returned to iamkingan
iamkingan collected $2.39 from pot
*** SUMMARY ***
Total pot $2.50 | Rake $0.11 
Board [8h Kd 7h Kc Ah]
Seat 1: cobrik23 folded before Flop (didn't bet)
Seat 2: IntsAA folded before Flop (didn't bet)
Seat 3: iamkingan collected ($2.39)
Seat 4: matiko09 folded before Flop (didn't bet)
Seat 5: DanishWiking (button) folded before Flop (didn't bet)
Seat 6: Dachish (small blind) folded before Flop
Seat 7: RICKA16 (big blind) folded on the River
Seat 8: solbi86 folded before Flop (didn't bet)
Seat 9: ka100pka527 folded before Flop (didn't bet)





PokerStars Hand #150709291702:  Hold'em No Limit ($0.50/$1.00 USD) - 2016/03/21 17:39:51 CET [2016/03/21 12:39:51 ET]
Table 'Toutatis II' 9-max Seat #9 is the button
Seat 1: Linghem ($76.45 in chips) 
Seat 2: Filojoes ($104.22 in chips) 
Seat 3: matiko09 ($106.30 in chips) 
Seat 4: cn_chayanne ($109.31 in chips) 
Seat 5: solbi86 ($100 in chips) 
Seat 6: djammusic ($70.09 in chips) 
Seat 7: Pacifistas ($104.23 in chips) 
Seat 8: Dachish ($67.57 in chips) 
Seat 9: bvavan ($39.83 in chips) 
Linghem: posts small blind $0.50
Filojoes: posts big blind $1
*** HOLE CARDS ***
Dealt to matiko09 [4d 6d]
matiko09: folds 
cn_chayanne: folds 
solbi86: folds 
djammusic: folds 
Pacifistas: folds 
Dachish: folds 
bvavan: folds 
Linghem: raises $1 to $2
Filojoes: calls $1
*** FLOP *** [Ac Kh 6h]
Linghem: bets $3.82
Filojoes: calls $3.82
*** TURN *** [Ac Kh 6h] [9h]
Linghem: checks 
Filojoes: checks 
*** RIVER *** [Ac Kh 6h 9h] [2s]
Linghem: checks 
Filojoes: bets $5.42
Linghem: calls $5.42
*** SHOW DOWN ***
Filojoes: shows [Ah Td] (a pair of Aces)
Linghem: shows [As Jh] (a pair of Aces - King+Jack kicker)
Linghem collected $21.47 from pot
*** SUMMARY ***
Total pot $22.48 | Rake $1.01 
Board [Ac Kh 6h 9h 2s]
Seat 1: Linghem (small blind) showed [As Jh] and won ($21.47) with a pair of Aces
Seat 2: Filojoes (big blind) showed [Ah Td] and lost with a pair of Aces
Seat 3: matiko09 folded before Flop (didn't bet)
Seat 4: cn_chayanne folded before Flop (didn't bet)
Seat 5: solbi86 folded before Flop (didn't bet)
Seat 6: djammusic folded before Flop (didn't bet)
Seat 7: Pacifistas folded before Flop (didn't bet)
Seat 8: Dachish folded before Flop (didn't bet)
Seat 9: bvavan (button) folded before Flop (didn't bet)





PokerStars Hand #150709291706:  Hold'em No Limit ($0.50/$1.00 USD) - 2016/03/21 17:39:51 CET [2016/03/21 12:39:51 ET]
Table 'Onnie II' 9-max Seat #3 is the button
Seat 1: ka100pka527 ($158.85 in chips) 
Seat 2: RICKA16 ($101.50 in chips) 
Seat 3: DanishWiking ($100 in chips) 
Seat 4: Bothfeld11 ($224.13 in chips) 
Seat 5: Filojoes ($101.50 in chips) 
Seat 6: Pacifistas ($108.17 in chips) 
Seat 7: djammusic ($72.40 in chips) 
Seat 8: solbi86 ($105.07 in chips) 
Seat 9: matiko09 ($133.32 in chips) 
Bothfeld11: posts small blind $0.50
Filojoes: posts big blind $1
*** HOLE CARDS ***
Dealt to matiko09 [Jh 6s]
Pacifistas: folds 
djammusic: folds 
solbi86: folds 
matiko09: folds 
ka100pka527: folds 
RICKA16: raises $2 to $3
DanishWiking: folds 
Bothfeld11: folds 
Filojoes: calls $2
*** FLOP *** [2s Ac Kc]
Filojoes: checks 
RICKA16: bets $4
Filojoes: calls $4
*** TURN *** [2s Ac Kc] [Td]
Filojoes: checks 
RICKA16: bets $10
Filojoes: folds 
Uncalled bet ($10) returned to RICKA16
RICKA16 collected $13.85 from pot
RICKA16: doesn't show hand 
*** SUMMARY ***
Total pot $14.50 | Rake $0.65 
Board [2s Ac Kc Td]
Seat 1: ka100pka527 folded before Flop (didn't bet)
Seat 2: RICKA16 collected ($13.85)
Seat 3: DanishWiking (button) folded before Flop (didn't bet)
Seat 4: Bothfeld11 (small blind) folded before Flop
Seat 5: Filojoes (big blind) folded on the Turn
Seat 6: Pacifistas folded before Flop (didn't bet)
Seat 7: djammusic folded before Flop (didn't bet)
Seat 8: solbi86 folded before Flop (didn't bet)
Seat 9: matiko09 folded before Flop (didn't bet)





PokerStars Hand #150709304661:  Hold'em No Limit ($0.50/$1.00 USD) - 2016/03/21 17:40:08 CET [2016/03/21 12:40:08 ET]
Table 'Marmulla II' 9-max Seat #5 is the button
Seat 2: volwebni4ek ($100 in chips) 
Seat 3: Vikulja1993 ($133.84 in chips) 
Seat 4: Dachish ($84.05 in chips) 
Seat 5: maaaGik88 ($53.96 in chips) 
Seat 6: R1aki ($157.34 in chips) 
Seat 7: Pacifistas ($101.50 in chips) 
Seat 9: matiko09 ($103.50 in chips) 
R1aki: posts small blind $0.50
Pacifistas: posts big blind $1
cobrik23: sits out 
*** HOLE CARDS ***
Dealt to matiko09 [Qd 5d]
matiko09: folds 
volwebni4ek: folds 
Vikulja1993: folds 
Dachish: folds 
maaaGik88: folds 
R1aki: raises $2 to $3
Pacifistas: calls $2
*** FLOP *** [6s 4d 3h]
R1aki: checks 
Pacifistas: bets $3.09
R1aki: folds 
Uncalled bet ($3.09) returned to Pacifistas
Pacifistas collected $5.73 from pot
Pacifistas: doesn't show hand 
*** SUMMARY ***
Total pot $6 | Rake $0.27 
Board [6s 4d 3h]
Seat 2: volwebni4ek folded before Flop (didn't bet)
Seat 3: Vikulja1993 folded before Flop (didn't bet)
Seat 4: Dachish folded before Flop (didn't bet)
Seat 5: maaaGik88 (button) folded before Flop (didn't bet)
Seat 6: R1aki (small blind) folded on the Flop
Seat 7: Pacifistas (big blind) collected ($5.73)
Seat 9: matiko09 folded before Flop (didn't bet)





PokerStars Hand #150709317260:  Hold'em No Limit ($0.50/$1.00 USD) - 2016/03/21 17:40:24 CET [2016/03/21 12:40:24 ET]
Table 'Odysseus II' 9-max Seat #3 is the button
Seat 1: Pacifistas ($100 in chips) 
Seat 2: Vikulja1993 ($121.52 in chips) 
Seat 3: vsbhandari ($105.53 in chips) 
Seat 4: aseban11 ($100 in chips) 
Seat 7: matiko09 ($102 in chips) 
Seat 8: fanmtZ ($40.12 in chips) 
Seat 9: grifkaaa ($130.35 in chips) 
aseban11: posts small blind $0.50
Rikti: is sitting out 
R1aki: is sitting out 
matiko09: posts big blind $1
*** HOLE CARDS ***
Dealt to matiko09 [8h 5h]
Rikti leaves the table
R1aki leaves the table
Filojoes joins the table at seat #5 
fanmtZ: folds 
grifkaaa: folds 
Pacifistas: raises $2 to $3
DUkalisUA joins the table at seat #6 
Vikulja1993: folds 
vsbhandari: raises $6 to $9
aseban11: raises $13.50 to $22.50
matiko09: folds 
Pacifistas: folds 
vsbhandari: calls $13.50
*** FLOP *** [7h Tc Th]
aseban11: bets $18.50
vsbhandari: calls $18.50
*** TURN *** [7h Tc Th] [9d]
aseban11: bets $59 and is all-in
vsbhandari: calls $59
*** RIVER *** [7h Tc Th 9d] [4h]
*** SHOW DOWN ***
aseban11: shows [Ac As] (two pair, Aces and Tens)
vsbhandari: shows [Qh Qs] (two pair, Queens and Tens)
aseban11 collected $201.20 from pot
*** SUMMARY ***
Total pot $204 | Rake $2.80 
Board [7h Tc Th 9d 4h]
Seat 1: Pacifistas folded before Flop
Seat 2: Vikulja1993 folded before Flop (didn't bet)
Seat 3: vsbhandari (button) showed [Qh Qs] and lost with two pair, Queens and Tens
Seat 4: aseban11 (small blind) showed [Ac As] and won ($201.20) with two pair, Aces and Tens
Seat 7: matiko09 (big blind) folded before Flop
Seat 8: fanmtZ folded before Flop (didn't bet)
Seat 9: grifkaaa folded before Flop (didn't bet)





PokerStars Hand #150709333373:  Hold'em No Limit ($0.50/$1.00 USD) - 2016/03/21 17:40:44 CET [2016/03/21 12:40:44 ET]
Table 'Harding II' 9-max Seat #6 is the button
Seat 1: cobrik23 ($39 in chips) 
Seat 2: IntsAA ($213.60 in chips) 
Seat 3: iamkingan ($93.31 in chips) 
Seat 4: matiko09 ($106.44 in chips) 
Seat 5: DanishWiking ($101.44 in chips) 
Seat 6: Dachish ($72.18 in chips) 
Seat 7: RICKA16 ($104.53 in chips) 
Seat 9: ka100pka527 ($38.50 in chips) 
RICKA16: posts small blind $0.50
solbi86: is sitting out 
ka100pka527: posts big blind $1
*** HOLE CARDS ***
Dealt to matiko09 [8c Td]
solbi86 leaves the table
cobrik23: folds 
IntsAA: folds 
iamkingan: folds 
iamkingan leaves the table
matiko09: folds 
DanishWiking: folds 
DUkalisUA joins the table at seat #3 
Dachish: folds 
RICKA16: folds 
Uncalled bet ($0.50) returned to ka100pka527
ka100pka527 collected $1 from pot
ka100pka527: doesn't show hand 
*** SUMMARY ***
Total pot $1 | Rake $0 
Seat 1: cobrik23 folded before Flop (didn't bet)
Seat 2: IntsAA folded before Flop (didn't bet)
Seat 3: iamkingan folded before Flop (didn't bet)
Seat 4: matiko09 folded before Flop (didn't bet)
Seat 5: DanishWiking folded before Flop (didn't bet)
Seat 6: Dachish (button) folded before Flop (didn't bet)
Seat 7: RICKA16 (small blind) folded before Flop
Seat 9: ka100pka527 (big blind) collected ($1)





PokerStars Hand #150709334274:  Hold'em No Limit ($0.50/$1.00 USD) - 2016/03/21 17:40:45 CET [2016/03/21 12:40:45 ET]
Table 'Toutatis II' 9-max Seat #1 is the button
Seat 1: Linghem ($86.68 in chips) 
Seat 2: Filojoes ($100 in chips) 
Seat 3: matiko09 ($106.30 in chips) 
Seat 4: cn_chayanne ($109.31 in chips) 
Seat 5: solbi86 ($100 in chips) 
Seat 6: djammusic ($70.09 in chips) 
Seat 7: Pacifistas ($104.23 in chips) 
Seat 8: Dachish ($67.57 in chips) 
Seat 9: bvavan ($39.83 in chips) 
Filojoes: posts small blind $0.50
matiko09: posts big blind $1
*** HOLE CARDS ***
Dealt to matiko09 [As 2c]
cn_chayanne: folds 
solbi86: raises $2 to $3
djammusic: folds 
Pacifistas: folds 
Dachish: folds 
bvavan: calls $3
Linghem: folds 
Filojoes: folds 
matiko09: folds 
*** FLOP *** [9s 6d 9c]
solbi86: checks 
bvavan: checks 
*** TURN *** [9s 6d 9c] [Ks]
solbi86: checks 
bvavan: checks 
*** RIVER *** [9s 6d 9c Ks] [6s]
solbi86: checks 
bvavan: bets $1
solbi86: calls $1
*** SHOW DOWN ***
bvavan: shows [4s 6c] (a full house, Sixes full of Nines)
solbi86: mucks hand 
bvavan collected $9.07 from pot
*** SUMMARY ***
Total pot $9.50 | Rake $0.43 
Board [9s 6d 9c Ks 6s]
Seat 1: Linghem (button) folded before Flop (didn't bet)
Seat 2: Filojoes (small blind) folded before Flop
Seat 3: matiko09 (big blind) folded before Flop
Seat 4: cn_chayanne folded before Flop (didn't bet)
Seat 5: solbi86 mucked [Ah 2h]
Seat 6: djammusic folded before Flop (didn't bet)
Seat 7: Pacifistas folded before Flop (didn't bet)
Seat 8: Dachish folded before Flop (didn't bet)
Seat 9: bvavan showed [4s 6c] and won ($9.07) with a full house, Sixes full of Nines





PokerStars Hand #150709336702:  Hold'em No Limit ($0.50/$1.00 USD) - 2016/03/21 17:40:48 CET [2016/03/21 12:40:48 ET]
Table 'Marmulla II' 9-max Seat #6 is the button
Seat 2: volwebni4ek ($100 in chips) 
Seat 3: Vikulja1993 ($133.84 in chips) 
Seat 4: Dachish ($84.05 in chips) 
Seat 5: maaaGik88 ($53.96 in chips) 
Seat 6: R1aki ($154.34 in chips) 
Seat 7: Pacifistas ($104.23 in chips) 
Seat 9: matiko09 ($103.50 in chips) 
Pacifistas: posts small blind $0.50
matiko09: posts big blind $1
cobrik23: sits out 
*** HOLE CARDS ***
Dealt to matiko09 [9h 7h]
volwebni4ek: folds 
aseban11 leaves the table
SanychStar joins the table at seat #8 
Vikulja1993: folds 
Dachish: folds 
maaaGik88: folds 
R1aki: raises $1.50 to $2.50
Pacifistas: raises $6.50 to $9
matiko09: folds 
R1aki: folds 
Uncalled bet ($6.50) returned to Pacifistas
Pacifistas collected $6 from pot
Pacifistas: doesn't show hand 
*** SUMMARY ***
Total pot $6 | Rake $0 
Seat 2: volwebni4ek folded before Flop (didn't bet)
Seat 3: Vikulja1993 folded before Flop (didn't bet)
Seat 4: Dachish folded before Flop (didn't bet)
Seat 5: maaaGik88 folded before Flop (didn't bet)
Seat 6: R1aki (button) folded before Flop
Seat 7: Pacifistas (small blind) collected ($6)
Seat 9: matiko09 (big blind) folded before Flop





PokerStars Hand #150709340870:  Hold'em No Limit ($0.50/$1.00 USD) - 2016/03/21 17:40:53 CET [2016/03/21 12:40:53 ET]
Table 'Massalia II' 9-max Seat #5 is the button
Seat 1: ceedonen ($125.80 in chips) 
Seat 2: SiD11211 ($135.27 in chips) 
Seat 3: 123chambo ($129.64 in chips) 
Seat 4: OriginalTony ($145.10 in chips) 
Seat 5: Vikulja1993 ($118.60 in chips) 
Seat 6: Pacifistas ($100 in chips) 
Seat 7: volwebni4ek ($60 in chips) 
Seat 8: matiko09 ($162.28 in chips) 
Seat 9: DanishWiking ($116.05 in chips) 
Pacifistas: posts small blind $0.50
volwebni4ek: posts big blind $1
ceedonen: posts the ante $0.20
SiD11211: posts the ante $0.20
123chambo: posts the ante $0.20
OriginalTony: posts the ante $0.20
Vikulja1993: posts the ante $0.20
Pacifistas: posts the ante $0.20
volwebni4ek: posts the ante $0.20
matiko09: posts the ante $0.20
DanishWiking: posts the ante $0.20
*** HOLE CARDS ***
Dealt to matiko09 [Jd 3c]
matiko09: folds 
DanishWiking: folds 
ceedonen: folds 
SiD11211: folds 
123chambo: raises $3 to $4
OriginalTony: folds 
Vikulja1993: folds 
Pacifistas: calls $3.50
volwebni4ek: calls $3
*** FLOP *** [Qc Js 4s]
Pacifistas: checks 
volwebni4ek: checks 
123chambo: bets $7
Pacifistas: raises $14 to $21
volwebni4ek: folds 
123chambo: folds 
Uncalled bet ($14) returned to Pacifistas
Pacifistas collected $26.55 from pot
Pacifistas: doesn't show hand 
*** SUMMARY ***
Total pot $27.80 | Rake $1.25 
Board [Qc Js 4s]
Seat 1: ceedonen folded before Flop (didn't bet)
Seat 2: SiD11211 folded before Flop (didn't bet)
Seat 3: 123chambo folded on the Flop
Seat 4: OriginalTony folded before Flop (didn't bet)
Seat 5: Vikulja1993 (button) folded before Flop (didn't bet)
Seat 6: Pacifistas (small blind) collected ($26.55)
Seat 7: volwebni4ek (big blind) folded on the Flop
Seat 8: matiko09 folded before Flop (didn't bet)
Seat 9: DanishWiking folded before Flop (didn't bet)





PokerStars Hand #150709347776:  Hold'em No Limit ($0.50/$1.00 USD) - 2016/03/21 17:41:02 CET [2016/03/21 12:41:02 ET]
Table 'Onnie II' 9-max Seat #4 is the button
Seat 1: ka100pka527 ($158.85 in chips) 
Seat 2: RICKA16 ($108.35 in chips) 
Seat 3: DanishWiking ($100 in chips) 
Seat 4: Bothfeld11 ($223.63 in chips) 
Seat 5: Filojoes ($100 in chips) 
Seat 6: Pacifistas ($108.17 in chips) 
Seat 7: djammusic ($72.40 in chips) 
Seat 8: solbi86 ($105.07 in chips) 
Seat 9: matiko09 ($133.32 in chips) 
Filojoes: posts small blind $0.50
Pacifistas: posts big blind $1
*** HOLE CARDS ***
Dealt to matiko09 [4d As]
djammusic: raises $1.50 to $2.50
solbi86: folds 
matiko09: folds 
ka100pka527: folds 
RICKA16: folds 
DanishWiking: folds 
Bothfeld11: folds 
Filojoes: folds 
Pacifistas: folds 
Uncalled bet ($1.50) returned to djammusic
djammusic collected $2.50 from pot
djammusic: doesn't show hand 
*** SUMMARY ***
Total pot $2.50 | Rake $0 
Seat 1: ka100pka527 folded before Flop (didn't bet)
Seat 2: RICKA16 folded before Flop (didn't bet)
Seat 3: DanishWiking folded before Flop (didn't bet)
Seat 4: Bothfeld11 (button) folded before Flop (didn't bet)
Seat 5: Filojoes (small blind) folded before Flop
Seat 6: Pacifistas (big blind) folded before Flop
Seat 7: djammusic collected ($2.50)
Seat 8: solbi86 folded before Flop (didn't bet)
Seat 9: matiko09 folded before Flop (didn't bet)





PokerStars Hand #150709369163:  Hold'em No Limit ($0.50/$1.00 USD) - 2016/03/21 17:41:29 CET [2016/03/21 12:41:29 ET]
Table 'Onnie II' 9-max Seat #5 is the button
Seat 1: ka100pka527 ($158.85 in chips) 
Seat 2: RICKA16 ($108.35 in chips) 
Seat 3: DanishWiking ($100 in chips) 
Seat 4: Bothfeld11 ($223.63 in chips) 
Seat 5: Filojoes ($100 in chips) 
Seat 6: Pacifistas ($107.17 in chips) 
Seat 7: djammusic ($73.90 in chips) 
Seat 8: solbi86 ($105.07 in chips) 
Seat 9: matiko09 ($133.32 in chips) 
Pacifistas: posts small blind $0.50
djammusic: posts big blind $1
*** HOLE CARDS ***
Dealt to matiko09 [Ah 4s]
solbi86: raises $2 to $3
matiko09: folds 
ka100pka527: folds 
RICKA16: folds 
DanishWiking: calls $3
Bothfeld11: folds 
Filojoes: folds 
Pacifistas: folds 
djammusic: calls $2
*** FLOP *** [Ks Kc 4h]
Bothfeld11 leaves the table
djammusic: checks 
solbi86: bets $4.98
DanishWiking: folds 
DUkalisUA joins the table at seat #4 
djammusic: calls $4.98
*** TURN *** [Ks Kc 4h] [Kh]
djammusic: checks 
solbi86: checks 
*** RIVER *** [Ks Kc 4h Kh] [Tc]
DUkalisUA leaves the table
djammusic: bets $7
solbi86: folds 
Uncalled bet ($7) returned to djammusic
djammusic collected $18.58 from pot
djammusic: doesn't show hand 
*** SUMMARY ***
Total pot $19.46 | Rake $0.88 
Board [Ks Kc 4h Kh Tc]
Seat 1: ka100pka527 folded before Flop (didn't bet)
Seat 2: RICKA16 folded before Flop (didn't bet)
Seat 3: DanishWiking folded on the Flop
Seat 4: Bothfeld11 folded before Flop (didn't bet)
Seat 5: Filojoes (button) folded before Flop (didn't bet)
Seat 6: Pacifistas (small blind) folded before Flop
Seat 7: djammusic (big blind) collected ($18.58)
Seat 8: solbi86 folded on the River
Seat 9: matiko09 folded before Flop (didn't bet)





PokerStars Hand #150709376610:  Hold'em No Limit ($0.50/$1.00 USD) - 2016/03/21 17:41:38 CET [2016/03/21 12:41:38 ET]
Table 'Toutatis II' 9-max Seat #2 is the button
Seat 1: Linghem ($86.68 in chips) 
Seat 2: Filojoes ($100 in chips) 
Seat 3: matiko09 ($105.30 in chips) 
Seat 4: cn_chayanne ($109.31 in chips) 
Seat 5: solbi86 ($100 in chips) 
Seat 6: djammusic ($70.09 in chips) 
Seat 7: Pacifistas ($104.23 in chips) 
Seat 8: Dachish ($67.57 in chips) 
Seat 9: bvavan ($44.90 in chips) 
matiko09: posts small blind $0.50
cn_chayanne: posts big blind $1
*** HOLE CARDS ***
Dealt to matiko09 [5s 3h]
solbi86: folds 
djammusic: folds 
Pacifistas: folds 
Dachish: folds 
bvavan: folds 
Linghem: folds 
Filojoes: folds 
matiko09: folds 
Uncalled bet ($0.50) returned to cn_chayanne
cn_chayanne collected $1 from pot
cn_chayanne: doesn't show hand 
*** SUMMARY ***
Total pot $1 | Rake $0 
Seat 1: Linghem folded before Flop (didn't bet)
Seat 2: Filojoes (button) folded before Flop (didn't bet)
Seat 3: matiko09 (small blind) folded before Flop
Seat 4: cn_chayanne (big blind) collected ($1)
Seat 5: solbi86 folded before Flop (didn't bet)
Seat 6: djammusic folded before Flop (didn't bet)
Seat 7: Pacifistas folded before Flop (didn't bet)
Seat 8: Dachish folded before Flop (didn't bet)
Seat 9: bvavan folded before Flop (didn't bet)





PokerStars Hand #150709378666:  Hold'em No Limit ($0.50/$1.00 USD) - 2016/03/21 17:41:41 CET [2016/03/21 12:41:41 ET]
Table 'Odysseus II' 9-max Seat #4 is the button
Seat 1: Pacifistas ($100 in chips) 
Seat 2: Vikulja1993 ($121.52 in chips) 
Seat 3: vsbhandari ($5.53 in chips) 
Seat 4: aseban11 ($201.20 in chips) 
Seat 7: matiko09 ($101 in chips) 
Seat 8: fanmtZ ($40.12 in chips) 
Seat 9: grifkaaa ($130.35 in chips) 
Filojoes will be allowed to play after the button
DUkalisUA will be allowed to play after the button
matiko09: posts small blind $0.50
fanmtZ: posts big blind $1
*** HOLE CARDS ***
Dealt to matiko09 [6c 2d]
grifkaaa: folds 
Pacifistas: folds 
Vikulja1993: folds 
vsbhandari: folds 
vsbhandari leaves the table
aseban11: folds 
matiko09: folds 
Uncalled bet ($0.50) returned to fanmtZ
fanmtZ collected $1 from pot
fanmtZ: doesn't show hand 
*** SUMMARY ***
Total pot $1 | Rake $0 
Seat 1: Pacifistas folded before Flop (didn't bet)
Seat 2: Vikulja1993 folded before Flop (didn't bet)
Seat 3: vsbhandari folded before Flop (didn't bet)
Seat 4: aseban11 (button) folded before Flop (didn't bet)
Seat 7: matiko09 (small blind) folded before Flop
Seat 8: fanmtZ (big blind) collected ($1)
Seat 9: grifkaaa folded before Flop (didn't bet)





PokerStars Hand #150709383145:  Hold'em No Limit ($0.50/$1.00 USD) - 2016/03/21 17:41:46 CET [2016/03/21 12:41:46 ET]
Table 'Marmulla II' 9-max Seat #7 is the button
Seat 1: cobrik23 ($58.90 in chips) 
Seat 2: volwebni4ek ($100 in chips) 
Seat 3: Vikulja1993 ($133.84 in chips) 
Seat 4: Dachish ($84.05 in chips) 
Seat 5: maaaGik88 ($53.96 in chips) 
Seat 6: R1aki ($151.84 in chips) 
Seat 7: Pacifistas ($107.73 in chips) 
Seat 9: matiko09 ($102.50 in chips) 
SanychStar will be allowed to play after the button
matiko09: posts small blind $0.50
cobrik23: posts big blind $1
*** HOLE CARDS ***
Dealt to matiko09 [2c Td]
volwebni4ek: folds 
Vikulja1993: folds 
Dachish: folds 
maaaGik88: calls $1
R1aki: folds 
Pacifistas: folds 
matiko09: folds 
cobrik23: checks 
*** FLOP *** [9s Ac Kc]
cobrik23: checks 
maaaGik88: checks 
*** TURN *** [9s Ac Kc] [2d]
cobrik23: checks 
maaaGik88: checks 
*** RIVER *** [9s Ac Kc 2d] [8h]
cobrik23: checks 
maaaGik88: checks 
*** SHOW DOWN ***
cobrik23: shows [Qs 6s] (high card Ace)
maaaGik88: mucks hand 
cobrik23 collected $2.39 from pot
*** SUMMARY ***
Total pot $2.50 | Rake $0.11 
Board [9s Ac Kc 2d 8h]
Seat 1: cobrik23 (big blind) showed [Qs 6s] and won ($2.39) with high card Ace
Seat 2: volwebni4ek folded before Flop (didn't bet)
Seat 3: Vikulja1993 folded before Flop (didn't bet)
Seat 4: Dachish folded before Flop (didn't bet)
Seat 5: maaaGik88 mucked [Th Jd]
Seat 6: R1aki folded before Flop (didn't bet)
Seat 7: Pacifistas (button) folded before Flop (didn't bet)
Seat 9: matiko09 (small blind) folded before Flop





PokerStars Hand #150709394255:  Hold'em No Limit ($0.50/$1.00 USD) - 2016/03/21 17:42:00 CET [2016/03/21 12:42:00 ET]
Table 'Odysseus II' 9-max Seat #7 is the button
Seat 1: Pacifistas ($100 in chips) 
Seat 2: Vikulja1993 ($121.52 in chips) 
Seat 4: aseban11 ($201.20 in chips) 
Seat 7: matiko09 ($100.50 in chips) 
Seat 8: fanmtZ ($40.62 in chips) 
Seat 9: grifkaaa ($130.35 in chips) 
fanmtZ: posts small blind $0.50
grifkaaa: posts big blind $1
Filojoes: sits out 
DUkalisUA: sits out 
*** HOLE CARDS ***
Dealt to matiko09 [7h 9c]
Pacifistas: folds 
Pacifistas leaves the table
Vikulja1993: folds 
Vikulja1993 leaves the table
aseban11: raises $2 to $3
matiko09: folds 
fanmtZ: raises $5 to $8
grifkaaa: folds 
aseban11: folds 
Uncalled bet ($5) returned to fanmtZ
fanmtZ collected $7 from pot
fanmtZ: doesn't show hand 
*** SUMMARY ***
Total pot $7 | Rake $0 
Seat 1: Pacifistas folded before Flop (didn't bet)
Seat 2: Vikulja1993 folded before Flop (didn't bet)
Seat 4: aseban11 folded before Flop
Seat 7: matiko09 (button) folded before Flop (didn't bet)
Seat 8: fanmtZ (small blind) collected ($7)
Seat 9: grifkaaa (big blind) folded before Flop





PokerStars Hand #150709393662:  Hold'em No Limit ($0.50/$1.00 USD) - 2016/03/21 17:42:00 CET [2016/03/21 12:42:00 ET]
Table 'Toutatis II' 9-max Seat #3 is the button
Seat 1: Linghem ($86.68 in chips) 
Seat 2: Filojoes ($100 in chips) 
Seat 3: matiko09 ($104.80 in chips) 
Seat 4: cn_chayanne ($109.81 in chips) 
Seat 6: djammusic ($70.09 in chips) 
Seat 7: Pacifistas ($104.23 in chips) 
Seat 8: Dachish ($67.57 in chips) 
Seat 9: bvavan ($44.90 in chips) 
cn_chayanne: posts small blind $0.50
solbi86: is sitting out 
djammusic: posts big blind $1
*** HOLE CARDS ***
Dealt to matiko09 [9d 8s]
Pacifistas: folds 
Dachish: folds 
bvavan has timed out
bvavan: folds 
Linghem: folds 
Filojoes: folds 
matiko09: folds 
cn_chayanne: raises $2 to $3
solbi86 leaves the table
Vikulja1993 joins the table at seat #5 
djammusic: folds 
Uncalled bet ($2) returned to cn_chayanne
cn_chayanne collected $2 from pot
cn_chayanne: doesn't show hand 
*** SUMMARY ***
Total pot $2 | Rake $0 
Seat 1: Linghem folded before Flop (didn't bet)
Seat 2: Filojoes folded before Flop (didn't bet)
Seat 3: matiko09 (button) folded before Flop (didn't bet)
Seat 4: cn_chayanne (small blind) collected ($2)
Seat 6: djammusic (big blind) folded before Flop
Seat 7: Pacifistas folded before Flop (didn't bet)
Seat 8: Dachish folded before Flop (didn't bet)
Seat 9: bvavan folded before Flop (didn't bet)





PokerStars Hand #150709425716:  Hold'em No Limit ($0.50/$1.00 USD) - 2016/03/21 17:42:40 CET [2016/03/21 12:42:40 ET]
Table 'Odysseus II' 9-max Seat #8 is the button
Seat 5: Filojoes ($100 in chips) 
Seat 7: matiko09 ($100.50 in chips) 
Seat 8: fanmtZ ($44.62 in chips) 
Seat 9: grifkaaa ($129.35 in chips) 
grifkaaa: posts small blind $0.50
aseban11: is sitting out 
Filojoes: posts big blind $1
DUkalisUA: sits out 
*** HOLE CARDS ***
Dealt to matiko09 [7h 7c]
matiko09: raises $1.50 to $2.50
fanmtZ: folds 
grifkaaa: folds 
Filojoes: folds 
Uncalled bet ($1.50) returned to matiko09
matiko09 collected $2.50 from pot
matiko09: doesn't show hand 
*** SUMMARY ***
Total pot $2.50 | Rake $0 
Seat 5: Filojoes (big blind) folded before Flop
Seat 7: matiko09 collected ($2.50)
Seat 8: fanmtZ (button) folded before Flop (didn't bet)
Seat 9: grifkaaa (small blind) folded before Flop





PokerStars Hand #150709437136:  Hold'em No Limit ($0.50/$1.00 USD) - 2016/03/21 17:42:54 CET [2016/03/21 12:42:54 ET]
Table 'Marmulla II' 9-max Seat #9 is the button
Seat 1: cobrik23 ($60.29 in chips) 
Seat 2: volwebni4ek ($100 in chips) 
Seat 3: Vikulja1993 ($133.84 in chips) 
Seat 4: Dachish ($84.05 in chips) 
Seat 5: maaaGik88 ($52.96 in chips) 
Seat 6: R1aki ($151.84 in chips) 
Seat 7: Pacifistas ($107.73 in chips) 
Seat 9: matiko09 ($102 in chips) 
cobrik23: posts small blind $0.50
volwebni4ek: posts big blind $1
SanychStar: sits out 
*** HOLE CARDS ***
Dealt to matiko09 [Kc 9h]
Vikulja1993: folds 
Dachish: folds 
maaaGik88: calls $1
R1aki: folds 
Pacifistas: folds 
matiko09: raises $3 to $4
cobrik23: folds 
volwebni4ek: folds 
maaaGik88: calls $3
*** FLOP *** [7c As 8s]
maaaGik88: checks 
matiko09: checks 
*** TURN *** [7c As 8s] [Qs]
maaaGik88: bets $3
matiko09: folds 
Uncalled bet ($3) returned to maaaGik88
maaaGik88 collected $9.07 from pot
maaaGik88: doesn't show hand 
*** SUMMARY ***
Total pot $9.50 | Rake $0.43 
Board [7c As 8s Qs]
Seat 1: cobrik23 (small blind) folded before Flop
Seat 2: volwebni4ek (big blind) folded before Flop
Seat 3: Vikulja1993 folded before Flop (didn't bet)
Seat 4: Dachish folded before Flop (didn't bet)
Seat 5: maaaGik88 collected ($9.07)
Seat 6: R1aki folded before Flop (didn't bet)
Seat 7: Pacifistas folded before Flop (didn't bet)
Seat 9: matiko09 (button) folded on the Turn





PokerStars Hand #150709443609:  Hold'em No Limit ($0.50/$1.00 USD) - 2016/03/21 17:43:02 CET [2016/03/21 12:43:02 ET]
Table 'Odysseus II' 9-max Seat #9 is the button
Seat 5: Filojoes ($100 in chips) 
Seat 6: DUkalisUA ($100 in chips) 
Seat 7: matiko09 ($102 in chips) 
Seat 8: fanmtZ ($44.62 in chips) 
Seat 9: grifkaaa ($128.85 in chips) 
Filojoes: posts small blind $0.50
DUkalisUA: posts big blind $1
*** HOLE CARDS ***
Dealt to matiko09 [3d 3s]
matiko09: raises $2 to $3
fanmtZ: folds 
aseban11 leaves the table
grifkaaa: folds 
Filojoes: folds 
DUkalisUA: folds 
Uncalled bet ($2) returned to matiko09
matiko09 collected $2.50 from pot
matiko09: doesn't show hand 
*** SUMMARY ***
Total pot $2.50 | Rake $0 
Seat 5: Filojoes (small blind) folded before Flop
Seat 6: DUkalisUA (big blind) folded before Flop
Seat 7: matiko09 collected ($2.50)
Seat 8: fanmtZ folded before Flop (didn't bet)
Seat 9: grifkaaa (button) folded before Flop (didn't bet)





PokerStars Hand #150709459191:  Hold'em No Limit ($0.50/$1.00 USD) - 2016/03/21 17:43:22 CET [2016/03/21 12:43:22 ET]
Table 'Toutatis II' 9-max Seat #4 is the button
Seat 1: Linghem ($86.68 in chips) 
Seat 2: Filojoes ($100 in chips) 
Seat 3: matiko09 ($104.80 in chips) 
Seat 4: cn_chayanne ($110.81 in chips) 
Seat 6: djammusic ($69.09 in chips) 
Seat 7: Pacifistas ($104.23 in chips) 
Seat 8: Dachish ($67.57 in chips) 
Seat 9: bvavan ($44.90 in chips) 
Vikulja1993 will be allowed to play after the button
djammusic: posts small blind $0.50
Pacifistas: posts big blind $1
*** HOLE CARDS ***
Dealt to matiko09 [8s Kc]
Dachish: folds 
bvavan: calls $1
Linghem: folds 
Filojoes: folds 
matiko09: raises $3 to $4
cn_chayanne: folds 
djammusic: folds 
Pacifistas: folds 
bvavan: calls $3
*** FLOP *** [9c Qd 7h]
bvavan: bets $1
matiko09: calls $1
*** TURN *** [9c Qd 7h] [5d]
bvavan: bets $1
matiko09: calls $1
*** RIVER *** [9c Qd 7h 5d] [Kh]
bvavan: bets $1
matiko09: calls $1
*** SHOW DOWN ***
bvavan: shows [Ad 7d] (a pair of Sevens)
matiko09: shows [8s Kc] (a pair of Kings)
matiko09 collected $14.80 from pot
*** SUMMARY ***
Total pot $15.50 | Rake $0.70 
Board [9c Qd 7h 5d Kh]
Seat 1: Linghem folded before Flop (didn't bet)
Seat 2: Filojoes folded before Flop (didn't bet)
Seat 3: matiko09 showed [8s Kc] and won ($14.80) with a pair of Kings
Seat 4: cn_chayanne (button) folded before Flop (didn't bet)
Seat 6: djammusic (small blind) folded before Flop
Seat 7: Pacifistas (big blind) folded before Flop
Seat 8: Dachish folded before Flop (didn't bet)
Seat 9: bvavan showed [Ad 7d] and lost with a pair of Sevens





PokerStars Hand #150709504047:  Hold'em No Limit ($0.50/$1.00 USD) - 2016/03/21 17:44:18 CET [2016/03/21 12:44:18 ET]
Table 'Toutatis II' 9-max Seat #6 is the button
Seat 1: Linghem ($86.68 in chips) 
Seat 2: Filojoes ($100 in chips) 
Seat 3: matiko09 ($112.60 in chips) 
Seat 4: cn_chayanne ($110.81 in chips) 
Seat 6: djammusic ($68.59 in chips) 
Seat 7: Pacifistas ($103.23 in chips) 
Seat 8: Dachish ($67.57 in chips) 
Seat 9: bvavan ($37.90 in chips) 
Pacifistas: posts small blind $0.50
Dachish: posts big blind $1
Vikulja1993: sits out 
*** HOLE CARDS ***
Dealt to matiko09 [8c 8s]
bvavan: calls $1
Linghem: raises $3.50 to $4.50
Filojoes: folds 
matiko09: calls $4.50
cn_chayanne: folds 
djammusic: folds 
Pacifistas: calls $4
Dachish: folds 
bvavan: folds 
*** FLOP *** [Kd Qc 4s]
Pacifistas: checks 
Linghem: bets $5
matiko09: folds 
Pacifistas: calls $5
*** TURN *** [Kd Qc 4s] [4c]
Pacifistas: checks 
Linghem: bets $7
Pacifistas: folds 
Uncalled bet ($7) returned to Linghem
Linghem collected $24.35 from pot
Linghem: doesn't show hand 
*** SUMMARY ***
Total pot $25.50 | Rake $1.15 
Board [Kd Qc 4s 4c]
Seat 1: Linghem collected ($24.35)
Seat 2: Filojoes folded before Flop (didn't bet)
Seat 3: matiko09 folded on the Flop
Seat 4: cn_chayanne folded before Flop (didn't bet)
Seat 6: djammusic (button) folded before Flop (didn't bet)
Seat 7: Pacifistas (small blind) folded on the Turn
Seat 8: Dachish (big blind) folded before Flop
Seat 9: bvavan folded before Flop





PokerStars Hand #150709511289:  Hold'em No Limit ($0.50/$1.00 USD) - 2016/03/21 17:44:27 CET [2016/03/21 12:44:27 ET]
Table 'Marmulla II' 9-max Seat #1 is the button
Seat 1: cobrik23 ($59.79 in chips) 
Seat 2: volwebni4ek ($99 in chips) 
Seat 3: Vikulja1993 ($133.84 in chips) 
Seat 4: Dachish ($84.05 in chips) 
Seat 5: maaaGik88 ($58.03 in chips) 
Seat 6: R1aki ($151.84 in chips) 
Seat 7: Pacifistas ($107.73 in chips) 
Seat 9: matiko09 ($100 in chips) 
volwebni4ek: posts small blind $0.50
Vikulja1993: posts big blind $1
SanychStar: sits out 
*** HOLE CARDS ***
Dealt to matiko09 [5d 6h]
Dachish: folds 
maaaGik88: raises $1 to $2
R1aki: raises $5.50 to $7.50
Pacifistas: folds 
matiko09: folds 
cobrik23: folds 
volwebni4ek: folds 
Vikulja1993: folds 
maaaGik88: calls $5.50
*** FLOP *** [Th 7h 2h]
maaaGik88: bets $7.88
R1aki: raises $136.46 to $144.34 and is all-in
maaaGik88: folds 
Uncalled bet ($136.46) returned to R1aki
R1aki collected $30.81 from pot
R1aki: doesn't show hand 
*** SUMMARY ***
Total pot $32.26 | Rake $1.45 
Board [Th 7h 2h]
Seat 1: cobrik23 (button) folded before Flop (didn't bet)
Seat 2: volwebni4ek (small blind) folded before Flop
Seat 3: Vikulja1993 (big blind) folded before Flop
Seat 4: Dachish folded before Flop (didn't bet)
Seat 5: maaaGik88 folded on the Flop
Seat 6: R1aki collected ($30.81)
Seat 7: Pacifistas folded before Flop (didn't bet)
Seat 9: matiko09 folded before Flop (didn't bet)





PokerStars Hand #150709569422:  Hold'em No Limit ($0.50/$1.00 USD) - 2016/03/21 17:45:39 CET [2016/03/21 12:45:39 ET]
Table 'Marmulla II' 9-max Seat #2 is the button
Seat 1: cobrik23 ($59.79 in chips) 
Seat 2: volwebni4ek ($98.50 in chips) 
Seat 3: Vikulja1993 ($132.84 in chips) 
Seat 4: Dachish ($84.05 in chips) 
Seat 5: maaaGik88 ($42.65 in chips) 
Seat 6: R1aki ($167.27 in chips) 
Seat 7: Pacifistas ($107.73 in chips) 
Seat 9: matiko09 ($100 in chips) 
Vikulja1993: posts small blind $0.50
Dachish: posts big blind $1
SanychStar: sits out 
*** HOLE CARDS ***
Dealt to matiko09 [Ts 8d]
maaaGik88: folds 
R1aki: folds 
Pacifistas: folds 
matiko09: folds 
cobrik23 has timed out
cobrik23: folds 
volwebni4ek: raises $1 to $2
Vikulja1993: folds 
Dachish: folds 
Uncalled bet ($1) returned to volwebni4ek
volwebni4ek collected $2.50 from pot
volwebni4ek: doesn't show hand 
*** SUMMARY ***
Total pot $2.50 | Rake $0 
Seat 1: cobrik23 folded before Flop (didn't bet)
Seat 2: volwebni4ek (button) collected ($2.50)
Seat 3: Vikulja1993 (small blind) folded before Flop
Seat 4: Dachish (big blind) folded before Flop
Seat 5: maaaGik88 folded before Flop (didn't bet)
Seat 6: R1aki folded before Flop (didn't bet)
Seat 7: Pacifistas folded before Flop (didn't bet)
Seat 9: matiko09 folded before Flop (didn't bet)





PokerStars Hand #150709612829:  Hold'em No Limit ($0.50/$1.00 USD) - 2016/03/21 17:46:33 CET [2016/03/21 12:46:33 ET]
Table 'Toutatis II' 9-max Seat #7 is the button
Seat 1: Linghem ($101.53 in chips) 
Seat 2: Filojoes ($100 in chips) 
Seat 3: matiko09 ($108.10 in chips) 
Seat 4: cn_chayanne ($110.81 in chips) 
Seat 6: djammusic ($68.59 in chips) 
Seat 7: Pacifistas ($100 in chips) 
Seat 8: Dachish ($66.57 in chips) 
Seat 9: bvavan ($36.90 in chips) 
Dachish: posts small blind $0.50
bvavan: posts big blind $1
Vikulja1993: sits out 
*** HOLE CARDS ***
Dealt to matiko09 [4c 5s]
Linghem: folds 
Filojoes: raises $2 to $3
matiko09: folds 
cn_chayanne: folds 
djammusic: folds 
Pacifistas: folds 
Dachish: folds 
bvavan: calls $2
*** FLOP *** [8h Ah Kh]
Linghem leaves the table
bvavan: checks 
Filojoes: bets $4
bvavan: folds 
Uncalled bet ($4) returned to Filojoes
Filojoes collected $6.21 from pot
Filojoes: doesn't show hand 
*** SUMMARY ***
Total pot $6.50 | Rake $0.29 
Board [8h Ah Kh]
Seat 1: Linghem folded before Flop (didn't bet)
Seat 2: Filojoes collected ($6.21)
Seat 3: matiko09 folded before Flop (didn't bet)
Seat 4: cn_chayanne folded before Flop (didn't bet)
Seat 6: djammusic folded before Flop (didn't bet)
Seat 7: Pacifistas (button) folded before Flop (didn't bet)
Seat 8: Dachish (small blind) folded before Flop
Seat 9: bvavan (big blind) folded on the Flop





PokerStars Hand #150709645441:  Hold'em No Limit ($0.50/$1.00 USD) - 2016/03/21 17:47:13 CET [2016/03/21 12:47:13 ET]
Table 'Marmulla II' 9-max Seat #3 is the button
Seat 2: volwebni4ek ($100 in chips) 
Seat 3: Vikulja1993 ($132.34 in chips) 
Seat 4: Dachish ($83.05 in chips) 
Seat 5: maaaGik88 ($42.65 in chips) 
Seat 6: R1aki ($167.27 in chips) 
Seat 7: Pacifistas ($107.73 in chips) 
Seat 9: matiko09 ($100 in chips) 
Dachish: posts small blind $0.50
maaaGik88: posts big blind $1
SanychStar: sits out 
*** HOLE CARDS ***
Dealt to matiko09 [2d 9s]
R1aki: folds 
Pacifistas: folds 
matiko09: folds 
volwebni4ek: folds 
Vikulja1993: raises $1 to $2
Dachish: folds 
maaaGik88: calls $1
*** FLOP *** [8h 6s 9h]
maaaGik88: checks 
Vikulja1993: bets $3.45
maaaGik88: folds 
Uncalled bet ($3.45) returned to Vikulja1993
Vikulja1993 collected $4.30 from pot
Vikulja1993: doesn't show hand 
*** SUMMARY ***
Total pot $4.50 | Rake $0.20 
Board [8h 6s 9h]
Seat 2: volwebni4ek folded before Flop (didn't bet)
Seat 3: Vikulja1993 (button) collected ($4.30)
Seat 4: Dachish (small blind) folded before Flop
Seat 5: maaaGik88 (big blind) folded on the Flop
Seat 6: R1aki folded before Flop (didn't bet)
Seat 7: Pacifistas folded before Flop (didn't bet)
Seat 9: matiko09 folded before Flop (didn't bet)





PokerStars Hand #150709646939:  Hold'em No Limit ($0.50/$1.00 USD) - 2016/03/21 17:47:14 CET [2016/03/21 12:47:14 ET]
Table 'Toutatis II' 9-max Seat #8 is the button
Seat 2: Filojoes ($103.21 in chips) 
Seat 3: matiko09 ($108.10 in chips) 
Seat 4: cn_chayanne ($110.81 in chips) 
Seat 6: djammusic ($68.59 in chips) 
Seat 7: Pacifistas ($100 in chips) 
Seat 8: Dachish ($66.07 in chips) 
Seat 9: bvavan ($33.90 in chips) 
bvavan: posts small blind $0.50
Filojoes: posts big blind $1
Vikulja1993: sits out 
*** HOLE CARDS ***
Dealt to matiko09 [Qc 4s]
matiko09: folds 
cn_chayanne: folds 
djammusic: raises $1.50 to $2.50
Pacifistas: folds 
Dachish: folds 
bvavan: calls $2
Filojoes: folds 
*** FLOP *** [3s Td 6s]
bvavan: bets $1
djammusic: raises $4 to $5
bvavan: calls $4
*** TURN *** [3s Td 6s] [2c]
DUkalisUA joins the table at seat #1 
bvavan: checks 
djammusic: bets $10.08
bvavan: folds 
Uncalled bet ($10.08) returned to djammusic
djammusic collected $15.28 from pot
djammusic: doesn't show hand 
*** SUMMARY ***
Total pot $16 | Rake $0.72 
Board [3s Td 6s 2c]
Seat 2: Filojoes (big blind) folded before Flop
Seat 3: matiko09 folded before Flop (didn't bet)
Seat 4: cn_chayanne folded before Flop (didn't bet)
Seat 6: djammusic collected ($15.28)
Seat 7: Pacifistas folded before Flop (didn't bet)
Seat 8: Dachish (button) folded before Flop (didn't bet)
Seat 9: bvavan (small blind) folded on the Turn





PokerStars Hand #150709679514:  Hold'em No Limit ($0.50/$1.00 USD) - 2016/03/21 17:47:53 CET [2016/03/21 12:47:53 ET]
Table 'Marmulla II' 9-max Seat #4 is the button
Seat 2: volwebni4ek ($100 in chips) 
Seat 3: Vikulja1993 ($134.64 in chips) 
Seat 4: Dachish ($82.55 in chips) 
Seat 5: maaaGik88 ($40.65 in chips) 
Seat 6: R1aki ($167.27 in chips) 
Seat 7: Pacifistas ($107.73 in chips) 
Seat 9: matiko09 ($100 in chips) 
maaaGik88: posts small blind $0.50
R1aki: posts big blind $1
SanychStar: sits out 
*** HOLE CARDS ***
Dealt to matiko09 [4d Qc]
Pacifistas: folds 
matiko09: folds 
volwebni4ek: folds 
Vikulja1993: folds 
Dachish: raises $1.50 to $2.50
maaaGik88: folds 
R1aki: calls $1.50
*** FLOP *** [4h 5c Jh]
R1aki: checks 
Dachish: bets $3.72
R1aki: calls $3.72
*** TURN *** [4h 5c Jh] [Ts]
R1aki: checks 
Dachish: checks 
*** RIVER *** [4h 5c Jh Ts] [Ah]
R1aki: bets $4.50
Dachish: raises $10.46 to $14.96
R1aki: calls $10.46
*** SHOW DOWN ***
Dachish: shows [8h 5h] (a flush, Ace high)
R1aki: shows [7h 9h] (a flush, Ace high - Nine higher)
R1aki collected $40.93 from pot
*** SUMMARY ***
Total pot $42.86 | Rake $1.93 
Board [4h 5c Jh Ts Ah]
Seat 2: volwebni4ek folded before Flop (didn't bet)
Seat 3: Vikulja1993 folded before Flop (didn't bet)
Seat 4: Dachish (button) showed [8h 5h] and lost with a flush, Ace high
Seat 5: maaaGik88 (small blind) folded before Flop
Seat 6: R1aki (big blind) showed [7h 9h] and won ($40.93) with a flush, Ace high
Seat 7: Pacifistas folded before Flop (didn't bet)
Seat 9: matiko09 folded before Flop (didn't bet)





PokerStars Hand #150709741074:  Hold'em No Limit ($0.50/$1.00 USD) - 2016/03/21 17:49:05 CET [2016/03/21 12:49:05 ET]
Table 'Marmulla II' 9-max Seat #5 is the button
Seat 2: volwebni4ek ($100 in chips) 
Seat 3: Vikulja1993 ($134.64 in chips) 
Seat 4: Dachish ($70 in chips) 
Seat 5: maaaGik88 ($40.15 in chips) 
Seat 6: R1aki ($187.02 in chips) 
Seat 8: SanychStar ($101.50 in chips) 
Seat 9: matiko09 ($100 in chips) 
R1aki: posts small blind $0.50
Pacifistas: is sitting out 
Pacifistas leaves the table
SanychStar: posts big blind $1
*** HOLE CARDS ***
Dealt to matiko09 [Td Ad]
ceedonen joins the table at seat #7 
ceedonen leaves the table
Avtovo joins the table at seat #7 
matiko09: raises $2 to $3
volwebni4ek: folds 
Vikulja1993: folds 
Dachish: folds 
maaaGik88: folds 
R1aki: folds 
SanychStar: folds 
Uncalled bet ($2) returned to matiko09
matiko09 collected $2.50 from pot
matiko09: doesn't show hand 
*** SUMMARY ***
Total pot $2.50 | Rake $0 
Seat 2: volwebni4ek folded before Flop (didn't bet)
Seat 3: Vikulja1993 folded before Flop (didn't bet)
Seat 4: Dachish folded before Flop (didn't bet)
Seat 5: maaaGik88 (button) folded before Flop (didn't bet)
Seat 6: R1aki (small blind) folded before Flop
Seat 8: SanychStar (big blind) folded before Flop
Seat 9: matiko09 collected ($2.50)





PokerStars Hand #150751200103:  Hold'em No Limit ($0.50/$1.00 USD) - 2016/03/22 13:49:43 CET [2016/03/22 8:49:43 ET]
Table 'Arabis' 9-max Seat #8 is the button
Seat 5: matiko09 ($100 in chips) 
Seat 6: I The King I ($167.18 in chips) 
Seat 8: Bro_Happy ($105.53 in chips) 
Seat 9: cobrik23 ($40.50 in chips) 
cobrik23: posts small blind $0.50
matiko09: posts big blind $1
*** HOLE CARDS ***
Dealt to matiko09 [4h 9s]
I The King I: folds 
Bro_Happy: folds 
cobrik23: raises $2 to $3
matiko09: folds 
Uncalled bet ($2) returned to cobrik23
cobrik23 collected $2 from pot
cobrik23: doesn't show hand 
*** SUMMARY ***
Total pot $2 | Rake $0 
Seat 5: matiko09 (big blind) folded before Flop
Seat 6: I The King I folded before Flop (didn't bet)
Seat 8: Bro_Happy (button) folded before Flop (didn't bet)
Seat 9: cobrik23 (small blind) collected ($2)





PokerStars Hand #150751206523:  Hold'em No Limit ($0.50/$1.00 USD) - 2016/03/22 13:49:54 CET [2016/03/22 8:49:54 ET]
Table 'Arabis' 9-max Seat #9 is the button
Seat 5: matiko09 ($100 in chips) 
Seat 6: I The King I ($167.18 in chips) 
Seat 8: Bro_Happy ($105.53 in chips) 
Seat 9: cobrik23 ($41.50 in chips) 
matiko09: posts small blind $0.50
I The King I: posts big blind $1
*** HOLE CARDS ***
Dealt to matiko09 [8c Th]
Bro_Happy: folds 
cobrik23: raises $1.50 to $2.50
matiko09: folds 
I The King I: calls $1.50
*** FLOP *** [9c 2d 2s]
howsiao joins the table at seat #7 
Chiddy83 joins the table at seat #1 
I The King I: checks 
ilaviiitech joins the table at seat #2 
cobrik23: checks 
*** TURN *** [9c 2d 2s] [5h]
tipner joins the table at seat #3 
I The King I: checks 
Painkiller72 joins the table at seat #4 
cobrik23: checks 
*** RIVER *** [9c 2d 2s 5h] [Qd]
I The King I: checks 
cobrik23: checks 
*** SHOW DOWN ***
I The King I: shows [Jc Td] (a pair of Deuces)
cobrik23: shows [8h Ac] (a pair of Deuces - Ace kicker)
cobrik23 collected $5.25 from pot
*** SUMMARY ***
Total pot $5.50 | Rake $0.25 
Board [9c 2d 2s 5h Qd]
Seat 5: matiko09 (small blind) folded before Flop
Seat 6: I The King I (big blind) showed [Jc Td] and lost with a pair of Deuces
Seat 8: Bro_Happy folded before Flop (didn't bet)
Seat 9: cobrik23 (button) showed [8h Ac] and won ($5.25) with a pair of Deuces





PokerStars Hand #150751243293:  Hold'em No Limit ($0.50/$1.00 USD) - 2016/03/22 13:51:00 CET [2016/03/22 8:51:00 ET]
Table 'Arabis' 9-max Seat #5 is the button
Seat 1: Chiddy83 ($60 in chips) 
Seat 5: matiko09 ($100 in chips) 
Seat 6: I The King I ($164.68 in chips) 
Seat 7: howsiao ($40 in chips) 
Seat 8: Bro_Happy ($105.53 in chips) 
Seat 9: cobrik23 ($44.25 in chips) 
I The King I: posts small blind $0.50
howsiao: posts big blind $1
Chiddy83: posts big blind $1
ilaviiitech: sits out 
tipner: sits out 
Painkiller72: sits out 
*** HOLE CARDS ***
Dealt to matiko09 [2c 6c]
Bro_Happy: raises $2 to $3
cobrik23: calls $3
Chiddy83: folds 
matiko09: folds 
I The King I: calls $2.50
howsiao: calls $2
*** FLOP *** [Ac As Jh]
I The King I: checks 
howsiao: checks 
Bro_Happy: bets $8
cobrik23: folds 
I The King I: folds 
howsiao: calls $8
*** TURN *** [Ac As Jh] [9s]
howsiao: checks 
Bro_Happy: bets $14.40
howsiao: raises $14.40 to $28.80
Bro_Happy: raises $14.40 to $43.20
howsiao: calls $0.20 and is all-in
Uncalled bet ($14.20) returned to Bro_Happy
*** RIVER *** [Ac As Jh 9s] [Jc]
*** SHOW DOWN ***
howsiao: shows [Qh Js] (a full house, Jacks full of Aces)
Bro_Happy: shows [9c 9d] (a full house, Nines full of Aces)
howsiao collected $84.20 from pot
*** SUMMARY ***
Total pot $87 | Rake $2.80 
Board [Ac As Jh 9s Jc]
Seat 1: Chiddy83 folded before Flop
Seat 5: matiko09 (button) folded before Flop (didn't bet)
Seat 6: I The King I (small blind) folded on the Flop
Seat 7: howsiao (big blind) showed [Qh Js] and won ($84.20) with a full house, Jacks full of Aces
Seat 8: Bro_Happy showed [9c 9d] and lost with a full house, Nines full of Aces
Seat 9: cobrik23 folded on the Flop





PokerStars Hand #150751291199:  Hold'em No Limit ($0.50/$1.00 USD) - 2016/03/22 13:52:25 CET [2016/03/22 8:52:25 ET]
Table 'Arabis' 9-max Seat #6 is the button
Seat 1: Chiddy83 ($59 in chips) 
Seat 5: matiko09 ($100 in chips) 
Seat 6: I The King I ($161.68 in chips) 
Seat 7: howsiao ($84.20 in chips) 
Seat 9: cobrik23 ($41.25 in chips) 
howsiao: posts small blind $0.50
Bro_Happy: is sitting out 
cobrik23: posts big blind $1
ilaviiitech: sits out 
tipner: sits out 
*** HOLE CARDS ***
Dealt to matiko09 [Tc 6h]
Chiddy83: folds 
matiko09: folds 
I The King I: folds 
howsiao: folds 
Uncalled bet ($0.50) returned to cobrik23
cobrik23 collected $1 from pot
cobrik23: doesn't show hand 
*** SUMMARY ***
Total pot $1 | Rake $0 
Seat 1: Chiddy83 folded before Flop (didn't bet)
Seat 5: matiko09 folded before Flop (didn't bet)
Seat 6: I The King I (button) folded before Flop (didn't bet)
Seat 7: howsiao (small blind) folded before Flop
Seat 9: cobrik23 (big blind) collected ($1)





PokerStars Hand #150751298005:  Hold'em No Limit ($0.50/$1.00 USD) - 2016/03/22 13:52:37 CET [2016/03/22 8:52:37 ET]
Table 'Arabis' 9-max Seat #7 is the button
Seat 1: Chiddy83 ($59 in chips) 
Seat 5: matiko09 ($100 in chips) 
Seat 6: I The King I ($161.68 in chips) 
Seat 7: howsiao ($83.70 in chips) 
Seat 9: cobrik23 ($41.75 in chips) 
cobrik23: posts small blind $0.50
Chiddy83: posts big blind $1
ilaviiitech: sits out 
tipner: sits out 
*** HOLE CARDS ***
Dealt to matiko09 [7h 8s]
matiko09: folds 
I The King I: raises $1.50 to $2.50
howsiao: calls $2.50
cobrik23: folds 
Chiddy83: raises $3.50 to $6
I The King I: calls $3.50
howsiao: calls $3.50
*** FLOP *** [8c Td 2c]
Chiddy83: bets $9
I The King I: calls $9
howsiao: calls $9
*** TURN *** [8c Td 2c] [5h]
Chiddy83: bets $16
I The King I: calls $16
howsiao: folds 
*** RIVER *** [8c Td 2c 5h] [4d]
Chiddy83: bets $28 and is all-in
I The King I: folds 
Uncalled bet ($28) returned to Chiddy83
Chiddy83 collected $74.70 from pot
Chiddy83: doesn't show hand 
*** SUMMARY ***
Total pot $77.50 | Rake $2.80 
Board [8c Td 2c 5h 4d]
Seat 1: Chiddy83 (big blind) collected ($74.70)
Seat 5: matiko09 folded before Flop (didn't bet)
Seat 6: I The King I folded on the River
Seat 7: howsiao (button) folded on the Turn
Seat 9: cobrik23 (small blind) folded before Flop





PokerStars Hand #150751316133:  Hold'em No Limit ($0.50/$1.00 USD) - 2016/03/22 13:53:10 CET [2016/03/22 8:53:10 ET]
Table 'Blaauw' 9-max Seat #5 is the button
Seat 5: Sluggishboy ($40 in chips) 
Seat 6: ilaviiitech ($100 in chips) 
Seat 7: matiko09 ($100 in chips) 
Seat 8: tipner ($100.62 in chips) 
Seat 9: AWATAR 21 ($100 in chips) 
ilaviiitech: posts small blind $0.50
ardo888 joins the table at seat #1 
matiko09: posts big blind $1
*** HOLE CARDS ***
Dealt to matiko09 [Qs Ad]
tipner: folds 
AWATAR 21: folds 
Sluggishboy: calls $1
ilaviiitech: folds 
matiko09: raises $4 to $5
Sluggishboy: calls $4
*** FLOP *** [9h 4s 3c]
lumen21 joins the table at seat #2 
Sreshta222 joins the table at seat #4 
matiko09: checks 
Sreshta222 leaves the table
Muinmyheart joins the table at seat #4 
Sluggishboy: bets $9
matiko09: folds 
Uncalled bet ($9) returned to Sluggishboy
Sluggishboy collected $10.03 from pot
Sluggishboy: doesn't show hand 
*** SUMMARY ***
Total pot $10.50 | Rake $0.47 
Board [9h 4s 3c]
Seat 5: Sluggishboy (button) collected ($10.03)
Seat 6: ilaviiitech (small blind) folded before Flop
Seat 7: matiko09 (big blind) folded on the Flop
Seat 8: tipner folded before Flop (didn't bet)
Seat 9: AWATAR 21 folded before Flop (didn't bet)





PokerStars Hand #150751318234:  Hold'em No Limit ($0.50/$1.00 USD) - 2016/03/22 13:53:13 CET [2016/03/22 8:53:13 ET]
Table 'Saturn III' 9-max Seat #6 is the button
Seat 1: cobrik23 ($42.49 in chips) 
Seat 2: ka100pka527 ($64.07 in chips) 
Seat 4: Merida900 ($98.50 in chips) 
Seat 5: Harbinger X ($100.23 in chips) 
Seat 6: I The King I ($100 in chips) 
Seat 8: di0d80 ($100 in chips) 
Seat 9: matiko09 ($100 in chips) 
di0d80: posts small blind $0.50
matiko09: posts big blind $1
*** HOLE CARDS ***
Dealt to matiko09 [7c 3s]
edidaz leaves the table
Ilov3NBA joins the table at seat #7 
cobrik23 has timed out
cobrik23: folds 
ka100pka527: folds 
Merida900: calls $1
Harbinger X: folds 
I The King I: raises $3 to $4
di0d80: folds 
matiko09: folds 
Merida900: folds 
Uncalled bet ($3) returned to I The King I
I The King I collected $3.50 from pot
I The King I: doesn't show hand 
*** SUMMARY ***
Total pot $3.50 | Rake $0 
Seat 1: cobrik23 folded before Flop (didn't bet)
Seat 2: ka100pka527 folded before Flop (didn't bet)
Seat 4: Merida900 folded before Flop
Seat 5: Harbinger X folded before Flop (didn't bet)
Seat 6: I The King I (button) collected ($3.50)
Seat 8: di0d80 (small blind) folded before Flop
Seat 9: matiko09 (big blind) folded before Flop





PokerStars Hand #150751346163:  Hold'em No Limit ($0.50/$1.00 USD) - 2016/03/22 13:54:03 CET [2016/03/22 8:54:03 ET]
Table 'Blaauw' 9-max Seat #6 is the button
Seat 5: Sluggishboy ($45.03 in chips) 
Seat 6: ilaviiitech ($100 in chips) 
Seat 7: matiko09 ($100 in chips) 
Seat 8: tipner ($100.62 in chips) 
Seat 9: AWATAR 21 ($100 in chips) 
matiko09: posts small blind $0.50
tipner: posts big blind $1
ardo888: sits out 
lumen21: sits out 
Muinmyheart: sits out 
*** HOLE CARDS ***
Dealt to matiko09 [8d 6d]
Muinmyheart leaves the table
edidaz joins the table at seat #4 
AWATAR 21: folds 
Sluggishboy: folds 
ilaviiitech: folds 
edidaz leaves the table
matiko09: raises $1.50 to $2.50
tipner: calls $1.50
*** FLOP *** [5h Qc 7s]
matiko09: bets $3.11
tipner: calls $3.11
*** TURN *** [5h Qc 7s] [9d]
matiko09: bets $7.45
fanmtZ joins the table at seat #4 
tipner: folds 
Uncalled bet ($7.45) returned to matiko09
matiko09 collected $10.72 from pot
matiko09: doesn't show hand 
*** SUMMARY ***
Total pot $11.22 | Rake $0.50 
Board [5h Qc 7s 9d]
Seat 5: Sluggishboy folded before Flop (didn't bet)
Seat 6: ilaviiitech (button) folded before Flop (didn't bet)
Seat 7: matiko09 (small blind) collected ($10.72)
Seat 8: tipner (big blind) folded on the Turn
Seat 9: AWATAR 21 folded before Flop (didn't bet)





PokerStars Hand #150751351399:  Hold'em No Limit ($0.50/$1.00 USD) - 2016/03/22 13:54:13 CET [2016/03/22 8:54:13 ET]
Table 'Arabis' 9-max Seat #9 is the button
Seat 1: Chiddy83 ($102.70 in chips) 
Seat 2: ilaviiitech ($100 in chips) 
Seat 5: matiko09 ($100 in chips) 
Seat 6: I The King I ($130.68 in chips) 
Seat 7: howsiao ($68.70 in chips) 
Seat 9: cobrik23 ($41.25 in chips) 
Chiddy83: posts small blind $0.50
ilaviiitech: posts big blind $1
tipner: sits out 
Bro_Happy: sits out 
*** HOLE CARDS ***
Dealt to matiko09 [3h 6s]
matiko09: folds 
I The King I: folds 
howsiao: folds 
cobrik23: folds 
Chiddy83: folds 
Uncalled bet ($0.50) returned to ilaviiitech
ilaviiitech collected $1 from pot
ilaviiitech: doesn't show hand 
*** SUMMARY ***
Total pot $1 | Rake $0 
Seat 1: Chiddy83 (small blind) folded before Flop
Seat 2: ilaviiitech (big blind) collected ($1)
Seat 5: matiko09 folded before Flop (didn't bet)
Seat 6: I The King I folded before Flop (didn't bet)
Seat 7: howsiao folded before Flop (didn't bet)
Seat 9: cobrik23 (button) folded before Flop (didn't bet)





PokerStars Hand #150751353816:  Hold'em No Limit ($0.50/$1.00 USD) - 2016/03/22 13:54:17 CET [2016/03/22 8:54:17 ET]
Table 'Saturn III' 9-max Seat #8 is the button
Seat 2: ka100pka527 ($64.07 in chips) 
Seat 4: Merida900 ($97.50 in chips) 
Seat 5: Harbinger X ($100.23 in chips) 
Seat 6: I The King I ($102.50 in chips) 
Seat 8: di0d80 ($100 in chips) 
Seat 9: matiko09 ($100 in chips) 
matiko09: posts small blind $0.50
ka100pka527: posts big blind $1
Ilov3NBA: sits out 
*** HOLE CARDS ***
Dealt to matiko09 [6c Kd]
Merida900: folds 
Harbinger X: folds 
I The King I: folds 
di0d80: folds 
matiko09: folds 
Uncalled bet ($0.50) returned to ka100pka527
ka100pka527 collected $1 from pot
ka100pka527: doesn't show hand 
*** SUMMARY ***
Total pot $1 | Rake $0 
Seat 2: ka100pka527 (big blind) collected ($1)
Seat 4: Merida900 folded before Flop (didn't bet)
Seat 5: Harbinger X folded before Flop (didn't bet)
Seat 6: I The King I folded before Flop (didn't bet)
Seat 8: di0d80 (button) folded before Flop (didn't bet)
Seat 9: matiko09 (small blind) folded before Flop





PokerStars Hand #150751359396:  Hold'em No Limit ($0.50/$1.00 USD) - 2016/03/22 13:54:27 CET [2016/03/22 8:54:27 ET]
Table 'Arabis' 9-max Seat #1 is the button
Seat 1: Chiddy83 ($102.20 in chips) 
Seat 2: ilaviiitech ($100.50 in chips) 
Seat 3: tipner ($100 in chips) 
Seat 5: matiko09 ($100 in chips) 
Seat 6: I The King I ($130.68 in chips) 
Seat 7: howsiao ($68.70 in chips) 
Seat 9: cobrik23 ($41.25 in chips) 
ilaviiitech: posts small blind $0.50
tipner: posts big blind $1
Bro_Happy: sits out 
*** HOLE CARDS ***
Dealt to matiko09 [Qs 3d]
matiko09: folds 
I The King I: folds 
howsiao: folds 
cobrik23: folds 
Chiddy83: raises $1 to $2
ilaviiitech: folds 
tipner: folds 
Uncalled bet ($1) returned to Chiddy83
Chiddy83 collected $2.50 from pot
Chiddy83: doesn't show hand 
*** SUMMARY ***
Total pot $2.50 | Rake $0 
Seat 1: Chiddy83 (button) collected ($2.50)
Seat 2: ilaviiitech (small blind) folded before Flop
Seat 3: tipner (big blind) folded before Flop
Seat 5: matiko09 folded before Flop (didn't bet)
Seat 6: I The King I folded before Flop (didn't bet)
Seat 7: howsiao folded before Flop (didn't bet)
Seat 9: cobrik23 folded before Flop (didn't bet)





PokerStars Hand #150751364663:  Hold'em No Limit ($0.50/$1.00 USD) - 2016/03/22 13:54:36 CET [2016/03/22 8:54:36 ET]
Table 'Saturn III' 9-max Seat #9 is the button
Seat 2: ka100pka527 ($64.57 in chips) 
Seat 4: Merida900 ($97.50 in chips) 
Seat 5: Harbinger X ($100.23 in chips) 
Seat 6: I The King I ($102.50 in chips) 
Seat 8: di0d80 ($100 in chips) 
Seat 9: matiko09 ($100 in chips) 
ka100pka527: posts small blind $0.50
Merida900: posts big blind $1
Ilov3NBA: sits out 
*** HOLE CARDS ***
Dealt to matiko09 [3h Th]
Harbinger X: folds 
I The King I: folds 
di0d80: folds 
matiko09: folds 
ka100pka527: folds 
Uncalled bet ($0.50) returned to Merida900
Merida900 collected $1 from pot
Merida900: doesn't show hand 
*** SUMMARY ***
Total pot $1 | Rake $0 
Seat 2: ka100pka527 (small blind) folded before Flop
Seat 4: Merida900 (big blind) collected ($1)
Seat 5: Harbinger X folded before Flop (didn't bet)
Seat 6: I The King I folded before Flop (didn't bet)
Seat 8: di0d80 folded before Flop (didn't bet)
Seat 9: matiko09 (button) folded before Flop (didn't bet)





PokerStars Hand #150751367280:  Hold'em No Limit ($0.50/$1.00 USD) - 2016/03/22 13:54:41 CET [2016/03/22 8:54:41 ET]
Table 'Blaauw' 9-max Seat #7 is the button
Seat 5: Sluggishboy ($45.03 in chips) 
Seat 6: ilaviiitech ($100 in chips) 
Seat 7: matiko09 ($105.11 in chips) 
Seat 8: tipner ($100 in chips) 
Seat 9: AWATAR 21 ($100 in chips) 
tipner: posts small blind $0.50
AWATAR 21: posts big blind $1
ardo888: sits out 
lumen21: sits out 
*** HOLE CARDS ***
Dealt to matiko09 [3s 9c]
Sluggishboy: calls $1
ilaviiitech: raises $3.50 to $4.50
matiko09: folds 
tipner: folds 
AWATAR 21: folds 
Sluggishboy: calls $3.50
*** FLOP *** [Jd 2h 2d]
Sluggishboy: checks 
ilaviiitech: bets $6.01
Sluggishboy: calls $6.01
*** TURN *** [Jd 2h 2d] [6d]
Sluggishboy: checks 
ilaviiitech: bets $17.20
Sluggishboy: raises $17.20 to $34.40
ilaviiitech: raises $17.20 to $51.60
Sluggishboy: calls $0.12 and is all-in
Uncalled bet ($17.08) returned to ilaviiitech
*** RIVER *** [Jd 2h 2d 6d] [8h]
*** SHOW DOWN ***
Sluggishboy: shows [Js 7s] (two pair, Jacks and Deuces)
ilaviiitech: shows [Kc Kh] (two pair, Kings and Deuces)
ilaviiitech collected $88.76 from pot
*** SUMMARY ***
Total pot $91.56 | Rake $2.80 
Board [Jd 2h 2d 6d 8h]
Seat 5: Sluggishboy showed [Js 7s] and lost with two pair, Jacks and Deuces
Seat 6: ilaviiitech showed [Kc Kh] and won ($88.76) with two pair, Kings and Deuces
Seat 7: matiko09 (button) folded before Flop (didn't bet)
Seat 8: tipner (small blind) folded before Flop
Seat 9: AWATAR 21 (big blind) folded before Flop





PokerStars Hand #150751373112:  Hold'em No Limit ($0.50/$1.00 USD) - 2016/03/22 13:54:51 CET [2016/03/22 8:54:51 ET]
Table 'Arabis' 9-max Seat #2 is the button
Seat 1: Chiddy83 ($103.70 in chips) 
Seat 2: ilaviiitech ($100 in chips) 
Seat 3: tipner ($100 in chips) 
Seat 5: matiko09 ($100 in chips) 
Seat 6: I The King I ($130.68 in chips) 
Seat 7: howsiao ($68.70 in chips) 
Seat 9: cobrik23 ($41.25 in chips) 
tipner: posts small blind $0.50
matiko09: posts big blind $1
Bro_Happy: sits out 
*** HOLE CARDS ***
Dealt to matiko09 [8d 7h]
I The King I: folds 
howsiao: folds 
cobrik23: folds 
Chiddy83: calls $1
ilaviiitech: folds 
tipner: raises $3 to $4
matiko09: folds 
Chiddy83: folds 
Uncalled bet ($3) returned to tipner
tipner collected $3 from pot
tipner: doesn't show hand 
*** SUMMARY ***
Total pot $3 | Rake $0 
Seat 1: Chiddy83 folded before Flop
Seat 2: ilaviiitech (button) folded before Flop (didn't bet)
Seat 3: tipner (small blind) collected ($3)
Seat 5: matiko09 (big blind) folded before Flop
Seat 6: I The King I folded before Flop (didn't bet)
Seat 7: howsiao folded before Flop (didn't bet)
Seat 9: cobrik23 folded before Flop (didn't bet)





PokerStars Hand #150751381350:  Hold'em No Limit ($0.50/$1.00 USD) - 2016/03/22 13:55:06 CET [2016/03/22 8:55:06 ET]
Table 'Saturn III' 9-max Seat #2 is the button
Seat 2: ka100pka527 ($64.07 in chips) 
Seat 4: Merida900 ($98 in chips) 
Seat 5: Harbinger X ($100.23 in chips) 
Seat 6: I The King I ($102.50 in chips) 
Seat 8: di0d80 ($100 in chips) 
Seat 9: matiko09 ($100 in chips) 
Merida900: posts small blind $0.50
Harbinger X: posts big blind $1
Ilov3NBA: sits out 
*** HOLE CARDS ***
Dealt to matiko09 [4c Kc]
I The King I: folds 
di0d80: folds 
matiko09: folds 
ka100pka527: raises $2 to $3
Merida900: folds 
Harbinger X: folds 
Uncalled bet ($2) returned to ka100pka527
ka100pka527 collected $2.50 from pot
ka100pka527: doesn't show hand 
*** SUMMARY ***
Total pot $2.50 | Rake $0 
Seat 2: ka100pka527 (button) collected ($2.50)
Seat 4: Merida900 (small blind) folded before Flop
Seat 5: Harbinger X (big blind) folded before Flop
Seat 6: I The King I folded before Flop (didn't bet)
Seat 8: di0d80 folded before Flop (didn't bet)
Seat 9: matiko09 folded before Flop (didn't bet)





PokerStars Hand #150751390745:  Hold'em No Limit ($0.50/$1.00 USD) - 2016/03/22 13:55:25 CET [2016/03/22 8:55:25 ET]
Table 'Arabis' 9-max Seat #3 is the button
Seat 1: Chiddy83 ($102.70 in chips) 
Seat 2: ilaviiitech ($100 in chips) 
Seat 3: tipner ($102 in chips) 
Seat 5: matiko09 ($100 in chips) 
Seat 6: I The King I ($130.68 in chips) 
Seat 7: howsiao ($68.70 in chips) 
Seat 9: cobrik23 ($41.25 in chips) 
matiko09: posts small blind $0.50
I The King I: posts big blind $1
Bro_Happy: sits out 
*** HOLE CARDS ***
Dealt to matiko09 [9d 3h]
howsiao: folds 
cobrik23: folds 
Chiddy83: calls $1
ilaviiitech: raises $3 to $4
tipner: folds 
matiko09: folds 
I The King I: folds 
Chiddy83: calls $3
*** FLOP *** [5h Qd Ts]
Chiddy83: checks 
ilaviiitech: bets $5
Chiddy83: calls $5
*** TURN *** [5h Qd Ts] [2c]
Chiddy83: checks 
ilaviiitech: bets $9
Chiddy83: calls $9
*** RIVER *** [5h Qd Ts 2c] [3s]
Chiddy83: checks 
ilaviiitech: checks 
*** SHOW DOWN ***
Chiddy83: shows [Tc 8c] (a pair of Tens)
ilaviiitech: shows [Td Ad] (a pair of Tens - Ace kicker)
ilaviiitech collected $35.81 from pot
*** SUMMARY ***
Total pot $37.50 | Rake $1.69 
Board [5h Qd Ts 2c 3s]
Seat 1: Chiddy83 showed [Tc 8c] and lost with a pair of Tens
Seat 2: ilaviiitech showed [Td Ad] and won ($35.81) with a pair of Tens
Seat 3: tipner (button) folded before Flop (didn't bet)
Seat 5: matiko09 (small blind) folded before Flop
Seat 6: I The King I (big blind) folded before Flop
Seat 7: howsiao folded before Flop (didn't bet)
Seat 9: cobrik23 folded before Flop (didn't bet)





PokerStars Hand #150751391246:  Hold'em No Limit ($0.50/$1.00 USD) - 2016/03/22 13:55:26 CET [2016/03/22 8:55:26 ET]
Table 'Blaauw' 9-max Seat #8 is the button
Seat 1: ardo888 ($100 in chips) 
Seat 6: ilaviiitech ($143.73 in chips) 
Seat 7: matiko09 ($105.11 in chips) 
Seat 8: tipner ($100 in chips) 
Seat 9: AWATAR 21 ($99 in chips) 
AWATAR 21: posts small blind $0.50
ardo888: posts big blind $1
lumen21: sits out 
fanmtZ: sits out 
*** HOLE CARDS ***
Dealt to matiko09 [Jc Js]
Sluggishboy leaves the table
Muinmyheart joins the table at seat #5 
ilaviiitech: folds 
Muinmyheart leaves the table
matiko09: raises $1.50 to $2.50
myatiy 96 joins the table at seat #5 
myatiy 96 leaves the table
tipner: folds 
edidaz joins the table at seat #5 
edidaz leaves the table
AWATAR 21: folds 
lumen21 leaves the table
ardo888: calls $1.50
*** FLOP *** [Ad 3d 9c]
ardo888: checks 
fanmtZ leaves the table
matiko09: checks 
*** TURN *** [Ad 3d 9c] [Kc]
ardo888: checks 
matiko09: checks 
*** RIVER *** [Ad 3d 9c Kc] [8c]
Ilov3NBA joins the table at seat #2 
ardo888: checks 
matiko09: checks 
*** SHOW DOWN ***
ardo888: shows [Ks Jd] (a pair of Kings)
matiko09: mucks hand 
ardo888 collected $5.25 from pot
*** SUMMARY ***
Total pot $5.50 | Rake $0.25 
Board [Ad 3d 9c Kc 8c]
Seat 1: ardo888 (big blind) showed [Ks Jd] and won ($5.25) with a pair of Kings
Seat 6: ilaviiitech folded before Flop (didn't bet)
Seat 7: matiko09 mucked [Jc Js]
Seat 8: tipner (button) folded before Flop (didn't bet)
Seat 9: AWATAR 21 (small blind) folded before Flop





PokerStars Hand #150751403887:  Hold'em No Limit ($0.50/$1.00 USD) - 2016/03/22 13:55:52 CET [2016/03/22 8:55:52 ET]
Table 'Saturn III' 9-max Seat #4 is the button
Seat 2: ka100pka527 ($65.57 in chips) 
Seat 4: Merida900 ($97.50 in chips) 
Seat 5: Harbinger X ($99.23 in chips) 
Seat 6: I The King I ($102.50 in chips) 
Seat 8: di0d80 ($100 in chips) 
Seat 9: matiko09 ($100 in chips) 
Harbinger X: posts small blind $0.50
I The King I: posts big blind $1
Ilov3NBA: sits out 
Painkiller72: sits out 
*** HOLE CARDS ***
Dealt to matiko09 [Jd Td]
di0d80: folds 
matiko09: raises $2 to $3
ka100pka527: folds 
Merida900: folds 
Harbinger X: folds 
I The King I: folds 
Uncalled bet ($2) returned to matiko09
matiko09 collected $2.50 from pot
matiko09: doesn't show hand 
*** SUMMARY ***
Total pot $2.50 | Rake $0 
Seat 2: ka100pka527 folded before Flop (didn't bet)
Seat 4: Merida900 (button) folded before Flop (didn't bet)
Seat 5: Harbinger X (small blind) folded before Flop
Seat 6: I The King I (big blind) folded before Flop
Seat 8: di0d80 folded before Flop (didn't bet)
Seat 9: matiko09 collected ($2.50)





PokerStars Hand #150751411402:  Hold'em No Limit ($0.50/$1.00 USD) - 2016/03/22 13:56:07 CET [2016/03/22 8:56:07 ET]
Table 'Blaauw' 9-max Seat #9 is the button
Seat 1: ardo888 ($102.75 in chips) 
Seat 2: Ilov3NBA ($100 in chips) 
Seat 6: ilaviiitech ($143.73 in chips) 
Seat 7: matiko09 ($102.61 in chips) 
Seat 8: tipner ($100 in chips) 
Seat 9: AWATAR 21 ($98.50 in chips) 
ardo888: posts small blind $0.50
Ilov3NBA: posts big blind $1
cobrik23: sits out 
*** HOLE CARDS ***
Dealt to matiko09 [6c 9c]
ilaviiitech: folds 
matiko09: folds 
tipner: folds 
AWATAR 21: raises $1 to $2
ardo888: folds 
Ilov3NBA: calls $1
*** FLOP *** [2h Tc Kd]
Ilov3NBA: checks 
AWATAR 21: bets $2.50
Ilov3NBA: folds 
Uncalled bet ($2.50) returned to AWATAR 21
AWATAR 21 collected $4.30 from pot
*** SUMMARY ***
Total pot $4.50 | Rake $0.20 
Board [2h Tc Kd]
Seat 1: ardo888 (small blind) folded before Flop
Seat 2: Ilov3NBA (big blind) folded on the Flop
Seat 6: ilaviiitech folded before Flop (didn't bet)
Seat 7: matiko09 folded before Flop (didn't bet)
Seat 8: tipner folded before Flop (didn't bet)
Seat 9: AWATAR 21 (button) collected ($4.30)





PokerStars Hand #150751417774:  Hold'em No Limit ($0.50/$1.00 USD) - 2016/03/22 13:56:20 CET [2016/03/22 8:56:20 ET]
Table 'Colchis' 9-max Seat #2 is the button
Seat 1: theluckyjoe ($24.52 in chips) 
Seat 2: tipner ($139.73 in chips) 
Seat 3: edidaz ($251.63 in chips) 
Seat 4: matiko09 ($100 in chips) 
Seat 5: lumen21 ($112.81 in chips) 
Seat 6: Avtovo ($100 in chips) 
Seat 7: ka100pka527 ($60.26 in chips) 
Seat 9: ardo888 ($104.23 in chips) 
edidaz: posts small blind $0.50
matiko09: posts big blind $1
cobrik23: sits out 
*** HOLE CARDS ***
Dealt to matiko09 [9c 9d]
lumen21: folds 
Avtovo: folds 
ka100pka527: folds 
ardo888: folds 
theluckyjoe: calls $1
tipner: raises $3 to $4
edidaz: folds 
matiko09: calls $3
theluckyjoe: folds 
*** FLOP *** [4c Kd 6h]
matiko09: checks 
tipner: checks 
*** TURN *** [4c Kd 6h] [Jc]
matiko09: checks 
tipner: checks 
*** RIVER *** [4c Kd 6h Jc] [5c]
matiko09: checks 
tipner: checks 
*** SHOW DOWN ***
matiko09: shows [9c 9d] (a pair of Nines)
tipner: mucks hand 
matiko09 collected $9.07 from pot
*** SUMMARY ***
Total pot $9.50 | Rake $0.43 
Board [4c Kd 6h Jc 5c]
Seat 1: theluckyjoe folded before Flop
Seat 2: tipner (button) mucked [Ah Qc]
Seat 3: edidaz (small blind) folded before Flop
Seat 4: matiko09 (big blind) showed [9c 9d] and won ($9.07) with a pair of Nines
Seat 5: lumen21 folded before Flop (didn't bet)
Seat 6: Avtovo folded before Flop (didn't bet)
Seat 7: ka100pka527 folded before Flop (didn't bet)
Seat 9: ardo888 folded before Flop (didn't bet)





PokerStars Hand #150751421196:  Hold'em No Limit ($0.50/$1.00 USD) - 2016/03/22 13:56:27 CET [2016/03/22 8:56:27 ET]
Table 'Saturn III' 9-max Seat #5 is the button
Seat 2: ka100pka527 ($65.57 in chips) 
Seat 4: Merida900 ($97.50 in chips) 
Seat 5: Harbinger X ($98.73 in chips) 
Seat 6: I The King I ($101.50 in chips) 
Seat 7: Ilov3NBA ($100 in chips) 
Seat 8: di0d80 ($100 in chips) 
Seat 9: matiko09 ($101.50 in chips) 
I The King I: posts small blind $0.50
Ilov3NBA: posts big blind $1
Painkiller72: sits out 
*** HOLE CARDS ***
Dealt to matiko09 [As 5s]
di0d80: folds 
matiko09: raises $2 to $3
ka100pka527: folds 
Merida900: folds 
Harbinger X: folds 
I The King I: folds 
Ilov3NBA: folds 
Uncalled bet ($2) returned to matiko09
matiko09 collected $2.50 from pot
matiko09: doesn't show hand 
*** SUMMARY ***
Total pot $2.50 | Rake $0 
Seat 2: ka100pka527 folded before Flop (didn't bet)
Seat 4: Merida900 folded before Flop (didn't bet)
Seat 5: Harbinger X (button) folded before Flop (didn't bet)
Seat 6: I The King I (small blind) folded before Flop
Seat 7: Ilov3NBA (big blind) folded before Flop
Seat 8: di0d80 folded before Flop (didn't bet)
Seat 9: matiko09 collected ($2.50)





PokerStars Hand #150751429416:  Hold'em No Limit ($0.50/$1.00 USD) - 2016/03/22 13:56:44 CET [2016/03/22 8:56:44 ET]
Table 'Saturn III' 9-max Seat #6 is the button
Seat 2: ka100pka527 ($65.57 in chips) 
Seat 4: Merida900 ($97.50 in chips) 
Seat 5: Harbinger X ($98.73 in chips) 
Seat 6: I The King I ($101 in chips) 
Seat 7: Ilov3NBA ($100 in chips) 
Seat 8: di0d80 ($100 in chips) 
Seat 9: matiko09 ($103 in chips) 
Ilov3NBA: posts small blind $0.50
di0d80: posts big blind $1
Painkiller72: sits out 
*** HOLE CARDS ***
Dealt to matiko09 [Jd Qh]
matiko09: folds 
ka100pka527: folds 
Merida900 has timed out
Merida900: folds 
Harbinger X: folds 
I The King I: folds 
Ilov3NBA: folds 
Uncalled bet ($0.50) returned to di0d80
di0d80 collected $1 from pot
di0d80: doesn't show hand 
*** SUMMARY ***
Total pot $1 | Rake $0 
Seat 2: ka100pka527 folded before Flop (didn't bet)
Seat 4: Merida900 folded before Flop (didn't bet)
Seat 5: Harbinger X folded before Flop (didn't bet)
Seat 6: I The King I (button) folded before Flop (didn't bet)
Seat 7: Ilov3NBA (small blind) folded before Flop
Seat 8: di0d80 (big blind) collected ($1)
Seat 9: matiko09 folded before Flop (didn't bet)





PokerStars Hand #150751431645:  Hold'em No Limit ($0.50/$1.00 USD) - 2016/03/22 13:56:48 CET [2016/03/22 8:56:48 ET]
Table 'Blaauw' 9-max Seat #1 is the button
Seat 1: ardo888 ($102.25 in chips) 
Seat 2: Ilov3NBA ($100 in chips) 
Seat 3: cobrik23 ($38.50 in chips) 
Seat 6: ilaviiitech ($143.73 in chips) 
Seat 7: matiko09 ($102.61 in chips) 
Seat 8: tipner ($100 in chips) 
Seat 9: AWATAR 21 ($100.80 in chips) 
Ilov3NBA: posts small blind $0.50
cobrik23: posts big blind $1
*** HOLE CARDS ***
Dealt to matiko09 [Tc 5c]
ilaviiitech: folds 
matiko09: folds 
tipner: folds 
AWATAR 21: folds 
ardo888: folds 
Ilov3NBA: raises $1.50 to $2.50
cobrik23: raises $3.50 to $6
Ilov3NBA: raises $94 to $100 and is all-in
cobrik23: folds 
Uncalled bet ($94) returned to Ilov3NBA
Ilov3NBA collected $12 from pot
Ilov3NBA: doesn't show hand 
*** SUMMARY ***
Total pot $12 | Rake $0 
Seat 1: ardo888 (button) folded before Flop (didn't bet)
Seat 2: Ilov3NBA (small blind) collected ($12)
Seat 3: cobrik23 (big blind) folded before Flop
Seat 6: ilaviiitech folded before Flop (didn't bet)
Seat 7: matiko09 folded before Flop (didn't bet)
Seat 8: tipner folded before Flop (didn't bet)
Seat 9: AWATAR 21 folded before Flop (didn't bet)





PokerStars Hand #150751433361:  Hold'em No Limit ($0.50/$1.00 USD) - 2016/03/22 13:56:52 CET [2016/03/22 8:56:52 ET]
Table 'Arabis' 9-max Seat #5 is the button
Seat 1: Chiddy83 ($84.70 in chips) 
Seat 2: ilaviiitech ($117.81 in chips) 
Seat 3: tipner ($102 in chips) 
Seat 5: matiko09 ($100 in chips) 
Seat 6: I The King I ($129.68 in chips) 
Seat 7: howsiao ($68.70 in chips) 
Seat 9: cobrik23 ($41.25 in chips) 
I The King I: posts small blind $0.50
howsiao: posts big blind $1
Bro_Happy: sits out 
Painkiller72: sits out 
*** HOLE CARDS ***
Dealt to matiko09 [4s Kh]
cobrik23: raises $2 to $3
Chiddy83: folds 
ilaviiitech: folds 
tipner: folds 
matiko09: folds 
I The King I: folds 
howsiao: folds 
Uncalled bet ($2) returned to cobrik23
cobrik23 collected $2.50 from pot
cobrik23: doesn't show hand 
*** SUMMARY ***
Total pot $2.50 | Rake $0 
Seat 1: Chiddy83 folded before Flop (didn't bet)
Seat 2: ilaviiitech folded before Flop (didn't bet)
Seat 3: tipner folded before Flop (didn't bet)
Seat 5: matiko09 (button) folded before Flop (didn't bet)
Seat 6: I The King I (small blind) folded before Flop
Seat 7: howsiao (big blind) folded before Flop
Seat 9: cobrik23 collected ($2.50)





PokerStars Hand #150751445904:  Hold'em No Limit ($0.50/$1.00 USD) - 2016/03/22 13:57:17 CET [2016/03/22 8:57:17 ET]
Table 'Harding' 9-max Seat #8 is the button
Seat 1: matiko09 ($100 in chips) 
Seat 2: I The King I ($179.30 in chips) 
Seat 3: Avtovo ($101.50 in chips) 
Seat 4: lixiangli ($106 in chips) 
Seat 5: DevilisHEyz ($98.54 in chips) 
Seat 6: Ilov3NBA ($100 in chips) 
Seat 7: mrhighryza ($110.38 in chips) 
Seat 8: di0d80 ($120.15 in chips) 
Seat 9: ka100pka527 ($40.50 in chips) 
ka100pka527: posts small blind $0.50
matiko09: posts big blind $1
*** HOLE CARDS ***
Dealt to matiko09 [5h Jd]
I The King I: folds 
Avtovo: folds 
lixiangli: folds 
DevilisHEyz: folds 
Ilov3NBA: raises $2 to $3
mrhighryza: folds 
di0d80: folds 
ka100pka527: folds 
matiko09: folds 
Uncalled bet ($2) returned to Ilov3NBA
Ilov3NBA collected $2.50 from pot
Ilov3NBA: doesn't show hand 
*** SUMMARY ***
Total pot $2.50 | Rake $0 
Seat 1: matiko09 (big blind) folded before Flop
Seat 2: I The King I folded before Flop (didn't bet)
Seat 3: Avtovo folded before Flop (didn't bet)
Seat 4: lixiangli folded before Flop (didn't bet)
Seat 5: DevilisHEyz folded before Flop (didn't bet)
Seat 6: Ilov3NBA collected ($2.50)
Seat 7: mrhighryza folded before Flop (didn't bet)
Seat 8: di0d80 (button) folded before Flop (didn't bet)
Seat 9: ka100pka527 (small blind) folded before Flop





PokerStars Hand #150751450903:  Hold'em No Limit ($0.50/$1.00 USD) - 2016/03/22 13:57:27 CET [2016/03/22 8:57:27 ET]
Table 'Saturn III' 9-max Seat #7 is the button
Seat 2: ka100pka527 ($65.57 in chips) 
Seat 4: Merida900 ($97.50 in chips) 
Seat 5: Harbinger X ($98.73 in chips) 
Seat 6: I The King I ($101 in chips) 
Seat 7: Ilov3NBA ($100 in chips) 
Seat 8: di0d80 ($100.50 in chips) 
Seat 9: matiko09 ($103 in chips) 
di0d80: posts small blind $0.50
matiko09: posts big blind $1
cobrik23: sits out 
Painkiller72: sits out 
*** HOLE CARDS ***
Dealt to matiko09 [Js Qd]
ka100pka527: folds 
Merida900: folds 
Harbinger X: folds 
I The King I: folds 
Ilov3NBA: raises $1 to $2
di0d80: folds 
matiko09: calls $1
*** FLOP *** [Qh 6s 3d]
matiko09: checks 
Ilov3NBA: bets $2.36
matiko09: calls $2.36
*** TURN *** [Qh 6s 3d] [2h]
matiko09: checks 
Ilov3NBA: checks 
*** RIVER *** [Qh 6s 3d 2h] [Kd]
matiko09: checks 
Ilov3NBA: checks 
*** SHOW DOWN ***
matiko09: shows [Js Qd] (a pair of Queens)
Ilov3NBA: mucks hand 
matiko09 collected $8.81 from pot
*** SUMMARY ***
Total pot $9.22 | Rake $0.41 
Board [Qh 6s 3d 2h Kd]
Seat 2: ka100pka527 folded before Flop (didn't bet)
Seat 4: Merida900 folded before Flop (didn't bet)
Seat 5: Harbinger X folded before Flop (didn't bet)
Seat 6: I The King I folded before Flop (didn't bet)
Seat 7: Ilov3NBA (button) mucked [9h Td]
Seat 8: di0d80 (small blind) folded before Flop
Seat 9: matiko09 (big blind) showed [Js Qd] and won ($8.81) with a pair of Queens





PokerStars Hand #150751452464:  Hold'em No Limit ($0.50/$1.00 USD) - 2016/03/22 13:57:30 CET [2016/03/22 8:57:30 ET]
Table 'Arabis' 9-max Seat #6 is the button
Seat 1: Chiddy83 ($84.70 in chips) 
Seat 2: ilaviiitech ($117.81 in chips) 
Seat 3: tipner ($102 in chips) 
Seat 5: matiko09 ($100 in chips) 
Seat 6: I The King I ($129.18 in chips) 
Seat 7: howsiao ($67.70 in chips) 
Seat 8: Bro_Happy ($100 in chips) 
Seat 9: cobrik23 ($42.75 in chips) 
howsiao: posts small blind $0.50
Bro_Happy: posts big blind $1
Painkiller72: sits out 
*** HOLE CARDS ***
Dealt to matiko09 [Ac 8s]
cobrik23: raises $2 to $3
Chiddy83: folds 
ilaviiitech: folds 
tipner: folds 
matiko09: folds 
I The King I: folds 
howsiao: folds 
Bro_Happy: folds 
Uncalled bet ($2) returned to cobrik23
cobrik23 collected $2.50 from pot
cobrik23: doesn't show hand 
*** SUMMARY ***
Total pot $2.50 | Rake $0 
Seat 1: Chiddy83 folded before Flop (didn't bet)
Seat 2: ilaviiitech folded before Flop (didn't bet)
Seat 3: tipner folded before Flop (didn't bet)
Seat 5: matiko09 folded before Flop (didn't bet)
Seat 6: I The King I (button) folded before Flop (didn't bet)
Seat 7: howsiao (small blind) folded before Flop
Seat 8: Bro_Happy (big blind) folded before Flop
Seat 9: cobrik23 collected ($2.50)





PokerStars Hand #150751453875:  Hold'em No Limit ($0.50/$1.00 USD) - 2016/03/22 13:57:33 CET [2016/03/22 8:57:33 ET]
Table 'Colchis' 9-max Seat #3 is the button
Seat 1: theluckyjoe ($23.52 in chips) 
Seat 2: tipner ($135.73 in chips) 
Seat 3: edidaz ($251.13 in chips) 
Seat 4: matiko09 ($105.07 in chips) 
Seat 5: lumen21 ($112.81 in chips) 
Seat 6: Avtovo ($100 in chips) 
Seat 7: ka100pka527 ($60.26 in chips) 
Seat 9: ardo888 ($104.23 in chips) 
matiko09: posts small blind $0.50
lumen21: posts big blind $1
cobrik23: sits out 
*** HOLE CARDS ***
Dealt to matiko09 [8c 5c]
Avtovo: folds 
ka100pka527: folds 
ardo888: folds 
theluckyjoe: folds 
tipner: folds 
edidaz: raises $1.04 to $2.04
matiko09: folds 
lumen21: calls $1.04
*** FLOP *** [Jc 6h Qc]
lumen21: checks 
edidaz: bets $2.20
lumen21: folds 
Uncalled bet ($2.20) returned to edidaz
edidaz collected $4.37 from pot
edidaz: doesn't show hand 
*** SUMMARY ***
Total pot $4.58 | Rake $0.21 
Board [Jc 6h Qc]
Seat 1: theluckyjoe folded before Flop (didn't bet)
Seat 2: tipner folded before Flop (didn't bet)
Seat 3: edidaz (button) collected ($4.37)
Seat 4: matiko09 (small blind) folded before Flop
Seat 5: lumen21 (big blind) folded on the Flop
Seat 6: Avtovo folded before Flop (didn't bet)
Seat 7: ka100pka527 folded before Flop (didn't bet)
Seat 9: ardo888 folded before Flop (didn't bet)





PokerStars Hand #150751458734:  Hold'em No Limit ($0.50/$1.00 USD) - 2016/03/22 13:57:42 CET [2016/03/22 8:57:42 ET]
Table 'Blaauw' 9-max Seat #2 is the button
Seat 1: ardo888 ($102.25 in chips) 
Seat 2: Ilov3NBA ($106 in chips) 
Seat 3: cobrik23 ($32.50 in chips) 
Seat 7: matiko09 ($102.61 in chips) 
Seat 8: tipner ($100 in chips) 
Seat 9: AWATAR 21 ($100.80 in chips) 
cobrik23: posts small blind $0.50
ilaviiitech: is sitting out 
matiko09: posts big blind $1
*** HOLE CARDS ***
Dealt to matiko09 [Th 9c]
tipner: folds 
AWATAR 21: folds 
ardo888: folds 
Ilov3NBA: folds 
cobrik23: raises $1.50 to $2.50
matiko09: calls $1.50
*** FLOP *** [5h 3s 7d]
cobrik23: bets $2.39
matiko09: folds 
Uncalled bet ($2.39) returned to cobrik23
cobrik23 collected $4.78 from pot
cobrik23: doesn't show hand 
*** SUMMARY ***
Total pot $5 | Rake $0.22 
Board [5h 3s 7d]
Seat 1: ardo888 folded before Flop (didn't bet)
Seat 2: Ilov3NBA (button) folded before Flop (didn't bet)
Seat 3: cobrik23 (small blind) collected ($4.78)
Seat 7: matiko09 (big blind) folded on the Flop
Seat 8: tipner folded before Flop (didn't bet)
Seat 9: AWATAR 21 folded before Flop (didn't bet)





PokerStars Hand #150751462207:  Hold'em No Limit ($0.50/$1.00 USD) - 2016/03/22 13:57:49 CET [2016/03/22 8:57:49 ET]
Table 'Arabis' 9-max Seat #7 is the button
Seat 1: Chiddy83 ($84.70 in chips) 
Seat 2: ilaviiitech ($117.81 in chips) 
Seat 3: tipner ($102 in chips) 
Seat 5: matiko09 ($100 in chips) 
Seat 6: I The King I ($129.18 in chips) 
Seat 7: howsiao ($67.20 in chips) 
Seat 8: Bro_Happy ($100 in chips) 
Seat 9: cobrik23 ($44.25 in chips) 
Bro_Happy: posts small blind $0.50
cobrik23: posts big blind $1
Painkiller72: sits out 
*** HOLE CARDS ***
Dealt to matiko09 [8d 4h]
Chiddy83: calls $1
ilaviiitech: folds 
tipner: folds 
matiko09: folds 
I The King I: folds 
howsiao: folds 
Bro_Happy: raises $4 to $5
cobrik23: folds 
Chiddy83: folds 
Uncalled bet ($4) returned to Bro_Happy
Bro_Happy collected $3 from pot
Bro_Happy: doesn't show hand 
*** SUMMARY ***
Total pot $3 | Rake $0 
Seat 1: Chiddy83 folded before Flop
Seat 2: ilaviiitech folded before Flop (didn't bet)
Seat 3: tipner folded before Flop (didn't bet)
Seat 5: matiko09 folded before Flop (didn't bet)
Seat 6: I The King I folded before Flop (didn't bet)
Seat 7: howsiao (button) folded before Flop (didn't bet)
Seat 8: Bro_Happy (small blind) collected ($3)
Seat 9: cobrik23 (big blind) folded before Flop





PokerStars Hand #150751462497:  Hold'em No Limit ($0.50/$1.00 USD) - 2016/03/22 13:57:50 CET [2016/03/22 8:57:50 ET]
Table 'Harding' 9-max Seat #9 is the button
Seat 1: matiko09 ($100 in chips) 
Seat 2: I The King I ($179.30 in chips) 
Seat 3: Avtovo ($101.50 in chips) 
Seat 4: lixiangli ($106 in chips) 
Seat 5: DevilisHEyz ($98.54 in chips) 
Seat 6: Ilov3NBA ($101.50 in chips) 
Seat 7: mrhighryza ($110.38 in chips) 
Seat 8: di0d80 ($120.15 in chips) 
Seat 9: ka100pka527 ($40 in chips) 
matiko09: posts small blind $0.50
I The King I: posts big blind $1
*** HOLE CARDS ***
Dealt to matiko09 [Ah Th]
Avtovo: folds 
lixiangli: folds 
DevilisHEyz: folds 
Ilov3NBA: folds 
mrhighryza: calls $1
di0d80: folds 
ka100pka527: raises $3 to $4
matiko09: calls $3.50
I The King I: folds 
mrhighryza: calls $3
*** FLOP *** [2s 7c 3d]
matiko09: checks 
mrhighryza: bets $5
ka100pka527: folds 
matiko09: folds 
Uncalled bet ($5) returned to mrhighryza
mrhighryza collected $12.42 from pot
*** SUMMARY ***
Total pot $13 | Rake $0.58 
Board [2s 7c 3d]
Seat 1: matiko09 (small blind) folded on the Flop
Seat 2: I The King I (big blind) folded before Flop
Seat 3: Avtovo folded before Flop (didn't bet)
Seat 4: lixiangli folded before Flop (didn't bet)
Seat 5: DevilisHEyz folded before Flop (didn't bet)
Seat 6: Ilov3NBA folded before Flop (didn't bet)
Seat 7: mrhighryza collected ($12.42)
Seat 8: di0d80 folded before Flop (didn't bet)
Seat 9: ka100pka527 (button) folded on the Flop





PokerStars Hand #150751471735:  Hold'em No Limit ($0.50/$1.00 USD) - 2016/03/22 13:58:08 CET [2016/03/22 8:58:08 ET]
Table 'Blaauw' 9-max Seat #3 is the button
Seat 1: ardo888 ($102.25 in chips) 
Seat 2: Ilov3NBA ($106 in chips) 
Seat 3: cobrik23 ($34.78 in chips) 
Seat 7: matiko09 ($100.11 in chips) 
Seat 9: AWATAR 21 ($100.80 in chips) 
matiko09: posts small blind $0.50
tipner: is sitting out 
AWATAR 21: posts big blind $1
*** HOLE CARDS ***
Dealt to matiko09 [9s Ts]
tipner leaves the table
ardo888: folds 
Ilov3NBA: folds 
ardo888 leaves the table
cobrik23: raises $1.50 to $2.50
matiko09: raises $4.50 to $7
AWATAR 21: folds 
cobrik23: folds 
Uncalled bet ($4.50) returned to matiko09
matiko09 collected $6 from pot
matiko09: doesn't show hand 
*** SUMMARY ***
Total pot $6 | Rake $0 
Seat 1: ardo888 folded before Flop (didn't bet)
Seat 2: Ilov3NBA folded before Flop (didn't bet)
Seat 3: cobrik23 (button) folded before Flop
Seat 7: matiko09 (small blind) collected ($6)
Seat 9: AWATAR 21 (big blind) folded before Flop





PokerStars Hand #150751475612:  Hold'em No Limit ($0.50/$1.00 USD) - 2016/03/22 13:58:16 CET [2016/03/22 8:58:16 ET]
Table 'Saturn III' 9-max Seat #8 is the button
Seat 1: cobrik23 ($42.49 in chips) 
Seat 2: ka100pka527 ($65.57 in chips) 
Seat 4: Merida900 ($97.50 in chips) 
Seat 5: Harbinger X ($98.73 in chips) 
Seat 6: I The King I ($101 in chips) 
Seat 7: Ilov3NBA ($100 in chips) 
Seat 8: di0d80 ($100 in chips) 
Seat 9: matiko09 ($107.45 in chips) 
matiko09: posts small blind $0.50
cobrik23: posts big blind $1
Painkiller72: sits out 
*** HOLE CARDS ***
Dealt to matiko09 [6c 9h]
ka100pka527: folds 
Merida900: folds 
Harbinger X: raises $2 to $3
I The King I: folds 
Ilov3NBA: folds 
di0d80: folds 
matiko09: folds 
cobrik23: folds 
Uncalled bet ($2) returned to Harbinger X
Harbinger X collected $2.50 from pot
Harbinger X: doesn't show hand 
*** SUMMARY ***
Total pot $2.50 | Rake $0 
Seat 1: cobrik23 (big blind) folded before Flop
Seat 2: ka100pka527 folded before Flop (didn't bet)
Seat 4: Merida900 folded before Flop (didn't bet)
Seat 5: Harbinger X collected ($2.50)
Seat 6: I The King I folded before Flop (didn't bet)
Seat 7: Ilov3NBA folded before Flop (didn't bet)
Seat 8: di0d80 (button) folded before Flop (didn't bet)
Seat 9: matiko09 (small blind) folded before Flop





PokerStars Hand #150751478285:  Hold'em No Limit ($0.50/$1.00 USD) - 2016/03/22 13:58:21 CET [2016/03/22 8:58:21 ET]
Table 'Colchis' 9-max Seat #4 is the button
Seat 1: theluckyjoe ($23.52 in chips) 
Seat 2: tipner ($135.73 in chips) 
Seat 3: edidaz ($253.46 in chips) 
Seat 4: matiko09 ($104.57 in chips) 
Seat 5: lumen21 ($110.77 in chips) 
Seat 6: Avtovo ($100 in chips) 
Seat 7: ka100pka527 ($60.26 in chips) 
Seat 9: ardo888 ($104.23 in chips) 
lumen21: posts small blind $0.50
Avtovo: posts big blind $1
cobrik23: sits out 
*** HOLE CARDS ***
Dealt to matiko09 [2c 8c]
ka100pka527: folds 
ardo888: folds 
theluckyjoe: calls $1
tipner: folds 
edidaz: folds 
matiko09: folds 
lumen21: calls $0.50
Avtovo: checks 
*** FLOP *** [2h 5d 3d]
lumen21: bets $1.50
Avtovo: folds 
theluckyjoe: calls $1.50
*** TURN *** [2h 5d 3d] [Jh]
lumen21: bets $3.50
theluckyjoe: folds 
Uncalled bet ($3.50) returned to lumen21
lumen21 collected $5.73 from pot
lumen21: doesn't show hand 
*** SUMMARY ***
Total pot $6 | Rake $0.27 
Board [2h 5d 3d Jh]
Seat 1: theluckyjoe folded on the Turn
Seat 2: tipner folded before Flop (didn't bet)
Seat 3: edidaz folded before Flop (didn't bet)
Seat 4: matiko09 (button) folded before Flop (didn't bet)
Seat 5: lumen21 (small blind) collected ($5.73)
Seat 6: Avtovo (big blind) folded on the Flop
Seat 7: ka100pka527 folded before Flop (didn't bet)
Seat 9: ardo888 folded before Flop (didn't bet)





PokerStars Hand #150751481151:  Hold'em No Limit ($0.50/$1.00 USD) - 2016/03/22 13:58:27 CET [2016/03/22 8:58:27 ET]
Table 'Arabis' 9-max Seat #8 is the button
Seat 1: Chiddy83 ($83.70 in chips) 
Seat 2: ilaviiitech ($117.81 in chips) 
Seat 3: tipner ($102 in chips) 
Seat 5: matiko09 ($100 in chips) 
Seat 6: I The King I ($129.18 in chips) 
Seat 7: howsiao ($67.20 in chips) 
Seat 8: Bro_Happy ($102 in chips) 
Seat 9: cobrik23 ($43.25 in chips) 
cobrik23: posts small blind $0.50
Chiddy83: posts big blind $1
Painkiller72: sits out 
*** HOLE CARDS ***
Dealt to matiko09 [Th 4c]
ilaviiitech: folds 
tipner: folds 
matiko09: folds 
I The King I: raises $2 to $3
howsiao: calls $3
Bro_Happy: calls $3
cobrik23: folds 
Chiddy83: folds 
*** FLOP *** [7c 2h 8h]
I The King I: checks 
howsiao: bets $10.03
Bro_Happy: calls $10.03
I The King I: folds 
*** TURN *** [7c 2h 8h] [Qc]
howsiao: bets $14.59
Bro_Happy: raises $74.38 to $88.97 and is all-in
howsiao: calls $39.58 and is all-in
Uncalled bet ($34.80) returned to Bro_Happy
*** RIVER *** [7c 2h 8h Qc] [Ts]
*** SHOW DOWN ***
howsiao: shows [Ac 7h] (a pair of Sevens)
Bro_Happy: shows [Qh Jh] (a pair of Queens)
Bro_Happy collected $136.10 from pot
*** SUMMARY ***
Total pot $138.90 | Rake $2.80 
Board [7c 2h 8h Qc Ts]
Seat 1: Chiddy83 (big blind) folded before Flop
Seat 2: ilaviiitech folded before Flop (didn't bet)
Seat 3: tipner folded before Flop (didn't bet)
Seat 5: matiko09 folded before Flop (didn't bet)
Seat 6: I The King I folded on the Flop
Seat 7: howsiao showed [Ac 7h] and lost with a pair of Sevens
Seat 8: Bro_Happy (button) showed [Qh Jh] and won ($136.10) with a pair of Queens
Seat 9: cobrik23 (small blind) folded before Flop





PokerStars Hand #150751490216:  Hold'em No Limit ($0.50/$1.00 USD) - 2016/03/22 13:58:45 CET [2016/03/22 8:58:45 ET]
Table 'Saturn III' 9-max Seat #9 is the button
Seat 1: cobrik23 ($41.49 in chips) 
Seat 2: ka100pka527 ($65.57 in chips) 
Seat 4: Merida900 ($97.50 in chips) 
Seat 5: Harbinger X ($100.23 in chips) 
Seat 6: I The King I ($101 in chips) 
Seat 7: Ilov3NBA ($100 in chips) 
Seat 8: di0d80 ($100 in chips) 
Seat 9: matiko09 ($106.95 in chips) 
cobrik23: posts small blind $0.50
ka100pka527: posts big blind $1
Painkiller72: sits out 
*** HOLE CARDS ***
Dealt to matiko09 [Qd 5h]
Merida900: folds 
Harbinger X: folds 
I The King I: folds 
Ilov3NBA: folds 
di0d80: folds 
matiko09: folds 
cobrik23: raises $1.50 to $2.50
ka100pka527: folds 
Uncalled bet ($1.50) returned to cobrik23
cobrik23 collected $2 from pot
cobrik23: doesn't show hand 
*** SUMMARY ***
Total pot $2 | Rake $0 
Seat 1: cobrik23 (small blind) collected ($2)
Seat 2: ka100pka527 (big blind) folded before Flop
Seat 4: Merida900 folded before Flop (didn't bet)
Seat 5: Harbinger X folded before Flop (didn't bet)
Seat 6: I The King I folded before Flop (didn't bet)
Seat 7: Ilov3NBA folded before Flop (didn't bet)
Seat 8: di0d80 folded before Flop (didn't bet)
Seat 9: matiko09 (button) folded before Flop (didn't bet)





PokerStars Hand #150751493385:  Hold'em No Limit ($0.50/$1.00 USD) - 2016/03/22 13:58:52 CET [2016/03/22 8:58:52 ET]
Table 'Harding' 9-max Seat #1 is the button
Seat 1: matiko09 ($100 in chips) 
Seat 2: I The King I ($178.30 in chips) 
Seat 3: Avtovo ($101.50 in chips) 
Seat 4: lixiangli ($106 in chips) 
Seat 5: DevilisHEyz ($98.54 in chips) 
Seat 6: Ilov3NBA ($101.50 in chips) 
Seat 7: mrhighryza ($118.80 in chips) 
Seat 8: di0d80 ($120.15 in chips) 
Seat 9: ka100pka527 ($36 in chips) 
I The King I: posts small blind $0.50
Avtovo: posts big blind $1
*** HOLE CARDS ***
Dealt to matiko09 [Qd 9d]
lixiangli: folds 
DevilisHEyz: calls $1
Ilov3NBA: folds 
mrhighryza: calls $1
di0d80: folds 
ka100pka527: folds 
matiko09: calls $1
I The King I: folds 
Avtovo: checks 
*** FLOP *** [Qs 5d Ts]
Avtovo: checks 
DevilisHEyz: checks 
mrhighryza: bets $2
matiko09: calls $2
Avtovo: calls $2
DevilisHEyz: folds 
*** TURN *** [Qs 5d Ts] [6d]
Avtovo: checks 
mrhighryza: bets $2
matiko09: calls $2
Avtovo: calls $2
*** RIVER *** [Qs 5d Ts 6d] [Jd]
Avtovo: checks 
mrhighryza: checks 
matiko09: bets $12
Avtovo: folds 
mrhighryza: folds 
Uncalled bet ($12) returned to matiko09
matiko09 collected $15.76 from pot
matiko09: doesn't show hand 
*** SUMMARY ***
Total pot $16.50 | Rake $0.74 
Board [Qs 5d Ts 6d Jd]
Seat 1: matiko09 (button) collected ($15.76)
Seat 2: I The King I (small blind) folded before Flop
Seat 3: Avtovo (big blind) folded on the River
Seat 4: lixiangli folded before Flop (didn't bet)
Seat 5: DevilisHEyz folded on the Flop
Seat 6: Ilov3NBA folded before Flop (didn't bet)
Seat 7: mrhighryza folded on the River
Seat 8: di0d80 folded before Flop (didn't bet)
Seat 9: ka100pka527 folded before Flop (didn't bet)





PokerStars Hand #150751501881:  Hold'em No Limit ($0.50/$1.00 USD) - 2016/03/22 13:59:09 CET [2016/03/22 8:59:09 ET]
Table 'Colchis' 9-max Seat #5 is the button
Seat 1: theluckyjoe ($21.02 in chips) 
Seat 2: tipner ($135.73 in chips) 
Seat 3: edidaz ($253.46 in chips) 
Seat 4: matiko09 ($104.57 in chips) 
Seat 5: lumen21 ($114 in chips) 
Seat 6: Avtovo ($100 in chips) 
Seat 7: ka100pka527 ($60.26 in chips) 
Seat 9: ardo888 ($104.23 in chips) 
Avtovo: posts small blind $0.50
ka100pka527: posts big blind $1
cobrik23: sits out 
*** HOLE CARDS ***
Dealt to matiko09 [5h 6d]
ardo888: folds 
theluckyjoe: calls $1
tipner: folds 
edidaz: folds 
matiko09: folds 
lumen21: folds 
Avtovo: folds 
ka100pka527: checks 
*** FLOP *** [Kh 5s Ac]
ka100pka527: checks 
theluckyjoe: checks 
*** TURN *** [Kh 5s Ac] [6c]
ka100pka527: bets $1.59
theluckyjoe: folds 
Uncalled bet ($1.59) returned to ka100pka527
ka100pka527 collected $2.39 from pot
*** SUMMARY ***
Total pot $2.50 | Rake $0.11 
Board [Kh 5s Ac 6c]
Seat 1: theluckyjoe folded on the Turn
Seat 2: tipner folded before Flop (didn't bet)
Seat 3: edidaz folded before Flop (didn't bet)
Seat 4: matiko09 folded before Flop (didn't bet)
Seat 5: lumen21 (button) folded before Flop (didn't bet)
Seat 6: Avtovo (small blind) folded before Flop
Seat 7: ka100pka527 (big blind) collected ($2.39)
Seat 9: ardo888 folded before Flop (didn't bet)





PokerStars Hand #150751504922:  Hold'em No Limit ($0.50/$1.00 USD) - 2016/03/22 13:59:15 CET [2016/03/22 8:59:15 ET]
Table 'Saturn III' 9-max Seat #1 is the button
Seat 1: cobrik23 ($42.49 in chips) 
Seat 2: ka100pka527 ($64.57 in chips) 
Seat 3: Painkiller72 ($100 in chips) 
Seat 4: Merida900 ($97.50 in chips) 
Seat 5: Harbinger X ($100.23 in chips) 
Seat 6: I The King I ($101 in chips) 
Seat 7: Ilov3NBA ($100 in chips) 
Seat 8: di0d80 ($100 in chips) 
Seat 9: matiko09 ($106.95 in chips) 
ka100pka527: posts small blind $0.50
Painkiller72: posts big blind $1
*** HOLE CARDS ***
Dealt to matiko09 [Jc Jd]
Merida900: calls $1
Harbinger X: folds 
I The King I: folds 
Ilov3NBA: folds 
di0d80: raises $3 to $4
matiko09: calls $4
cobrik23: folds 
ka100pka527: folds 
Painkiller72: folds 
Merida900: calls $3
*** FLOP *** [4h Kd 6d]
Merida900: checks 
di0d80: bets $8
matiko09: calls $8
Merida900: folds 
*** TURN *** [4h Kd 6d] [2d]
di0d80: checks 
matiko09: checks 
*** RIVER *** [4h Kd 6d 2d] [4d]
di0d80: bets $17
matiko09: calls $17
*** SHOW DOWN ***
di0d80: shows [8d 8h] (a flush, King high)
matiko09: shows [Jc Jd] (a flush, King high - Jack higher)
matiko09 collected $60.70 from pot
*** SUMMARY ***
Total pot $63.50 | Rake $2.80 
Board [4h Kd 6d 2d 4d]
Seat 1: cobrik23 (button) folded before Flop (didn't bet)
Seat 2: ka100pka527 (small blind) folded before Flop
Seat 3: Painkiller72 (big blind) folded before Flop
Seat 4: Merida900 folded on the Flop
Seat 5: Harbinger X folded before Flop (didn't bet)
Seat 6: I The King I folded before Flop (didn't bet)
Seat 7: Ilov3NBA folded before Flop (didn't bet)
Seat 8: di0d80 showed [8d 8h] and lost with a flush, King high
Seat 9: matiko09 showed [Jc Jd] and won ($60.70) with a flush, King high





PokerStars Hand #150751512202:  Hold'em No Limit ($0.50/$1.00 USD) - 2016/03/22 13:59:30 CET [2016/03/22 8:59:30 ET]
Table 'Arabis' 9-max Seat #9 is the button
Seat 1: Chiddy83 ($82.70 in chips) 
Seat 2: ilaviiitech ($117.81 in chips) 
Seat 3: tipner ($102 in chips) 
Seat 5: matiko09 ($100 in chips) 
Seat 6: I The King I ($126.18 in chips) 
Seat 8: Bro_Happy ($170.90 in chips) 
Seat 9: cobrik23 ($42.75 in chips) 
Chiddy83: posts small blind $0.50
ilaviiitech: posts big blind $1
Painkiller72: sits out 
*** HOLE CARDS ***
Dealt to matiko09 [4d Kh]
tipner: folds 
matiko09: folds 
I The King I: raises $2 to $3
Bro_Happy: folds 
cobrik23: raises $5 to $8
Chiddy83: folds 
ilaviiitech: folds 
I The King I: raises $40 to $48
cobrik23: calls $34.75 and is all-in
Uncalled bet ($5.25) returned to I The King I
*** FLOP *** [8s Ac Ts]
*** TURN *** [8s Ac Ts] [Tc]
*** RIVER *** [8s Ac Ts Tc] [Js]
*** SHOW DOWN ***
I The King I: shows [6h 6s] (two pair, Tens and Sixes)
cobrik23: shows [Kd Ad] (two pair, Aces and Tens)
cobrik23 collected $84.20 from pot
*** SUMMARY ***
Total pot $87 | Rake $2.80 
Board [8s Ac Ts Tc Js]
Seat 1: Chiddy83 (small blind) folded before Flop
Seat 2: ilaviiitech (big blind) folded before Flop
Seat 3: tipner folded before Flop (didn't bet)
Seat 5: matiko09 folded before Flop (didn't bet)
Seat 6: I The King I showed [6h 6s] and lost with two pair, Tens and Sixes
Seat 8: Bro_Happy folded before Flop (didn't bet)
Seat 9: cobrik23 (button) showed [Kd Ad] and won ($84.20) with two pair, Aces and Tens





PokerStars Hand #150751528890:  Hold'em No Limit ($0.50/$1.00 USD) - 2016/03/22 14:00:03 CET [2016/03/22 9:00:03 ET]
Table 'Colchis' 9-max Seat #6 is the button
Seat 1: theluckyjoe ($20.02 in chips) 
Seat 2: tipner ($135.73 in chips) 
Seat 3: edidaz ($253.46 in chips) 
Seat 4: matiko09 ($104.57 in chips) 
Seat 5: lumen21 ($114 in chips) 
Seat 6: Avtovo ($100 in chips) 
Seat 7: ka100pka527 ($61.65 in chips) 
Seat 8: cobrik23 ($45.53 in chips) 
Seat 9: ardo888 ($104.23 in chips) 
ka100pka527: posts small blind $0.50
cobrik23: posts big blind $1
*** HOLE CARDS ***
Dealt to matiko09 [Kd 9d]
ardo888: folds 
theluckyjoe: folds 
tipner: folds 
edidaz: folds 
matiko09: folds 
lumen21: folds 
Avtovo: folds 
ka100pka527: folds 
Uncalled bet ($0.50) returned to cobrik23
cobrik23 collected $1 from pot
cobrik23: doesn't show hand 
*** SUMMARY ***
Total pot $1 | Rake $0 
Seat 1: theluckyjoe folded before Flop (didn't bet)
Seat 2: tipner folded before Flop (didn't bet)
Seat 3: edidaz folded before Flop (didn't bet)
Seat 4: matiko09 folded before Flop (didn't bet)
Seat 5: lumen21 folded before Flop (didn't bet)
Seat 6: Avtovo (button) folded before Flop (didn't bet)
Seat 7: ka100pka527 (small blind) folded before Flop
Seat 8: cobrik23 (big blind) collected ($1)
Seat 9: ardo888 folded before Flop (didn't bet)





PokerStars Hand #150751531476:  Hold'em No Limit ($0.50/$1.00 USD) - 2016/03/22 14:00:07 CET [2016/03/22 9:00:07 ET]
Table 'Arabis' 9-max Seat #1 is the button
Seat 1: Chiddy83 ($82.20 in chips) 
Seat 2: ilaviiitech ($116.81 in chips) 
Seat 4: Painkiller72 ($131.17 in chips) 
Seat 5: matiko09 ($100 in chips) 
Seat 6: I The King I ($100 in chips) 
Seat 8: Bro_Happy ($170.90 in chips) 
Seat 9: cobrik23 ($84.20 in chips) 
ilaviiitech: posts small blind $0.50
tipner: is sitting out 
tipner leaves the table
Painkiller72: posts big blind $1
*** HOLE CARDS ***
Dealt to matiko09 [Ts Qd]
myatiy 96 joins the table at seat #3 
matiko09: folds 
I The King I: folds 
Bro_Happy: folds 
cobrik23: folds 
Chiddy83: raises $2 to $3
ilaviiitech: folds 
Painkiller72: folds 
Uncalled bet ($2) returned to Chiddy83
Chiddy83 collected $2.50 from pot
Chiddy83: doesn't show hand 
*** SUMMARY ***
Total pot $2.50 | Rake $0 
Seat 1: Chiddy83 (button) collected ($2.50)
Seat 2: ilaviiitech (small blind) folded before Flop
Seat 4: Painkiller72 (big blind) folded before Flop
Seat 5: matiko09 folded before Flop (didn't bet)
Seat 6: I The King I folded before Flop (didn't bet)
Seat 8: Bro_Happy folded before Flop (didn't bet)
Seat 9: cobrik23 folded before Flop (didn't bet)





PokerStars Hand #150751543383:  Hold'em No Limit ($0.50/$1.00 USD) - 2016/03/22 14:00:31 CET [2016/03/22 9:00:31 ET]
Table 'Arabis' 9-max Seat #2 is the button
Seat 1: Chiddy83 ($83.70 in chips) 
Seat 2: ilaviiitech ($116.31 in chips) 
Seat 4: Painkiller72 ($130.17 in chips) 
Seat 5: matiko09 ($100 in chips) 
Seat 6: I The King I ($100 in chips) 
Seat 7: howsiao ($40 in chips) 
Seat 8: Bro_Happy ($170.90 in chips) 
Seat 9: cobrik23 ($84.20 in chips) 
myatiy 96 will be allowed to play after the button
Painkiller72: posts small blind $0.50
matiko09: posts big blind $1
*** HOLE CARDS ***
Dealt to matiko09 [8h 7d]
I The King I: raises $2 to $3
howsiao: folds 
Bro_Happy: calls $3
cobrik23: folds 
Chiddy83: folds 
ilaviiitech: folds 
Painkiller72: folds 
matiko09: folds 
*** FLOP *** [9h 2h 7s]
I The King I: checks 
Bro_Happy: bets $5
I The King I: folds 
Uncalled bet ($5) returned to Bro_Happy
Bro_Happy collected $7.16 from pot
*** SUMMARY ***
Total pot $7.50 | Rake $0.34 
Board [9h 2h 7s]
Seat 1: Chiddy83 folded before Flop (didn't bet)
Seat 2: ilaviiitech (button) folded before Flop (didn't bet)
Seat 4: Painkiller72 (small blind) folded before Flop
Seat 5: matiko09 (big blind) folded before Flop
Seat 6: I The King I folded on the Flop
Seat 7: howsiao folded before Flop (didn't bet)
Seat 8: Bro_Happy collected ($7.16)
Seat 9: cobrik23 folded before Flop (didn't bet)





PokerStars Hand #150751550021:  Hold'em No Limit ($0.50/$1.00 USD) - 2016/03/22 14:00:44 CET [2016/03/22 9:00:44 ET]
Table 'Saturn III' 9-max Seat #2 is the button
Seat 1: cobrik23 ($42.49 in chips) 
Seat 2: ka100pka527 ($64.07 in chips) 
Seat 3: Painkiller72 ($100 in chips) 
Seat 4: Merida900 ($93.50 in chips) 
Seat 5: Harbinger X ($100.23 in chips) 
Seat 6: I The King I ($101 in chips) 
Seat 7: Ilov3NBA ($100 in chips) 
Seat 8: di0d80 ($100 in chips) 
Seat 9: matiko09 ($138.65 in chips) 
Painkiller72: posts small blind $0.50
Merida900: posts big blind $1
*** HOLE CARDS ***
Dealt to matiko09 [Kc 2d]
Harbinger X: folds 
I The King I: folds 
Ilov3NBA: folds 
di0d80: folds 
matiko09: folds 
cobrik23: raises $2 to $3
ka100pka527: folds 
Painkiller72: folds 
Merida900: folds 
Uncalled bet ($2) returned to cobrik23
cobrik23 collected $2.50 from pot
cobrik23: doesn't show hand 
*** SUMMARY ***
Total pot $2.50 | Rake $0 
Seat 1: cobrik23 collected ($2.50)
Seat 2: ka100pka527 (button) folded before Flop (didn't bet)
Seat 3: Painkiller72 (small blind) folded before Flop
Seat 4: Merida900 (big blind) folded before Flop
Seat 5: Harbinger X folded before Flop (didn't bet)
Seat 6: I The King I folded before Flop (didn't bet)
Seat 7: Ilov3NBA folded before Flop (didn't bet)
Seat 8: di0d80 folded before Flop (didn't bet)
Seat 9: matiko09 folded before Flop (didn't bet)





PokerStars Hand #150751552372:  Hold'em No Limit ($0.50/$1.00 USD) - 2016/03/22 14:00:48 CET [2016/03/22 9:00:48 ET]
Table 'Harding' 9-max Seat #2 is the button
Seat 1: matiko09 ($110.76 in chips) 
Seat 2: I The King I ($177.80 in chips) 
Seat 3: Avtovo ($100 in chips) 
Seat 4: lixiangli ($106 in chips) 
Seat 5: DevilisHEyz ($97.54 in chips) 
Seat 6: Ilov3NBA ($101.50 in chips) 
Seat 7: mrhighryza ($113.80 in chips) 
Seat 8: di0d80 ($120.15 in chips) 
Seat 9: ka100pka527 ($36 in chips) 
Avtovo: posts small blind $0.50
lixiangli: posts big blind $1
*** HOLE CARDS ***
Dealt to matiko09 [3d 8h]
DevilisHEyz: raises $1.50 to $2.50
Ilov3NBA: folds 
mrhighryza: calls $2.50
di0d80: folds 
ka100pka527: folds 
matiko09: folds 
I The King I: raises $8.50 to $11
Avtovo: folds 
lixiangli: folds 
DevilisHEyz: calls $8.50
mrhighryza: folds 
*** FLOP *** [6s 6h 8c]
DevilisHEyz: checks 
I The King I: bets $11
DevilisHEyz: calls $11
*** TURN *** [6s 6h 8c] [5d]
DevilisHEyz: checks 
I The King I: bets $19
DevilisHEyz: raises $20 to $39
I The King I: folds 
Uncalled bet ($20) returned to DevilisHEyz
DevilisHEyz collected $83.20 from pot
*** SUMMARY ***
Total pot $86 | Rake $2.80 
Board [6s 6h 8c 5d]
Seat 1: matiko09 folded before Flop (didn't bet)
Seat 2: I The King I (button) folded on the Turn
Seat 3: Avtovo (small blind) folded before Flop
Seat 4: lixiangli (big blind) folded before Flop
Seat 5: DevilisHEyz collected ($83.20)
Seat 6: Ilov3NBA folded before Flop (didn't bet)
Seat 7: mrhighryza folded before Flop
Seat 8: di0d80 folded before Flop (didn't bet)
Seat 9: ka100pka527 folded before Flop (didn't bet)





PokerStars Hand #150751556450:  Hold'em No Limit ($0.50/$1.00 USD) - 2016/03/22 14:00:56 CET [2016/03/22 9:00:56 ET]
Table 'Colchis' 9-max Seat #7 is the button
Seat 1: theluckyjoe ($20.02 in chips) 
Seat 2: tipner ($135.73 in chips) 
Seat 3: edidaz ($253.46 in chips) 
Seat 4: matiko09 ($104.57 in chips) 
Seat 5: lumen21 ($114 in chips) 
Seat 6: Avtovo ($100 in chips) 
Seat 7: ka100pka527 ($61.15 in chips) 
Seat 8: cobrik23 ($46.03 in chips) 
Seat 9: ardo888 ($104.23 in chips) 
cobrik23: posts small blind $0.50
ardo888: posts big blind $1
*** HOLE CARDS ***
Dealt to matiko09 [Jh 4d]
theluckyjoe: folds 
tipner: folds 
edidaz: raises $2 to $3
matiko09: folds 
lumen21: folds 
Avtovo: calls $3
ka100pka527: raises $10.50 to $13.50
cobrik23: folds 
ardo888: folds 
edidaz: calls $10.50
Avtovo: folds 
*** FLOP *** [9d Tc 4s]
edidaz: checks 
ka100pka527: bets $15.04
edidaz: raises $224.92 to $239.96 and is all-in
ka100pka527: calls $32.61 and is all-in
Uncalled bet ($192.31) returned to edidaz
*** TURN *** [9d Tc 4s] [7h]
*** RIVER *** [9d Tc 4s 7h] [7d]
*** SHOW DOWN ***
edidaz: shows [Qd Qc] (two pair, Queens and Sevens)
ka100pka527: shows [Ad Ah] (two pair, Aces and Sevens)
ka100pka527 collected $124 from pot
*** SUMMARY ***
Total pot $126.80 | Rake $2.80 
Board [9d Tc 4s 7h 7d]
Seat 1: theluckyjoe folded before Flop (didn't bet)
Seat 2: tipner folded before Flop (didn't bet)
Seat 3: edidaz showed [Qd Qc] and lost with two pair, Queens and Sevens
Seat 4: matiko09 folded before Flop (didn't bet)
Seat 5: lumen21 folded before Flop (didn't bet)
Seat 6: Avtovo folded before Flop
Seat 7: ka100pka527 (button) showed [Ad Ah] and won ($124) with two pair, Aces and Sevens
Seat 8: cobrik23 (small blind) folded before Flop
Seat 9: ardo888 (big blind) folded before Flop





PokerStars Hand #150751563031:  Hold'em No Limit ($0.50/$1.00 USD) - 2016/03/22 14:01:08 CET [2016/03/22 9:01:08 ET]
Table 'Arabis' 9-max Seat #4 is the button
Seat 1: Chiddy83 ($83.70 in chips) 
Seat 2: ilaviiitech ($116.31 in chips) 
Seat 4: Painkiller72 ($129.67 in chips) 
Seat 5: matiko09 ($100 in chips) 
Seat 6: I The King I ($100 in chips) 
Seat 7: howsiao ($40 in chips) 
Seat 8: Bro_Happy ($175.06 in chips) 
Seat 9: cobrik23 ($84.20 in chips) 
matiko09: posts small blind $0.50
I The King I: posts big blind $1
myatiy 96: sits out 
*** HOLE CARDS ***
Dealt to matiko09 [9d 4d]
howsiao: folds 
Bro_Happy: folds 
cobrik23: raises $2 to $3
Chiddy83: folds 
ilaviiitech: folds 
Painkiller72: folds 
matiko09: folds 
I The King I: folds 
Uncalled bet ($2) returned to cobrik23
cobrik23 collected $2.50 from pot
cobrik23: doesn't show hand 
*** SUMMARY ***
Total pot $2.50 | Rake $0 
Seat 1: Chiddy83 folded before Flop (didn't bet)
Seat 2: ilaviiitech folded before Flop (didn't bet)
Seat 4: Painkiller72 (button) folded before Flop (didn't bet)
Seat 5: matiko09 (small blind) folded before Flop
Seat 6: I The King I (big blind) folded before Flop
Seat 7: howsiao folded before Flop (didn't bet)
Seat 8: Bro_Happy folded before Flop (didn't bet)
Seat 9: cobrik23 collected ($2.50)





PokerStars Hand #150751571312:  Hold'em No Limit ($0.50/$1.00 USD) - 2016/03/22 14:01:23 CET [2016/03/22 9:01:23 ET]
Table 'Saturn III' 9-max Seat #3 is the button
Seat 1: cobrik23 ($43.99 in chips) 
Seat 2: ka100pka527 ($64.07 in chips) 
Seat 3: Painkiller72 ($100 in chips) 
Seat 4: Merida900 ($92.50 in chips) 
Seat 5: Harbinger X ($100.23 in chips) 
Seat 6: I The King I ($101 in chips) 
Seat 7: Ilov3NBA ($100 in chips) 
Seat 8: di0d80 ($100 in chips) 
Seat 9: matiko09 ($138.65 in chips) 
Merida900: posts small blind $0.50
Harbinger X: posts big blind $1
*** HOLE CARDS ***
Dealt to matiko09 [4h Jh]
I The King I: folds 
Ilov3NBA: folds 
di0d80: folds 
matiko09: folds 
cobrik23: folds 
ka100pka527: raises $2 to $3
Painkiller72: folds 
Merida900: calls $2.50
Harbinger X: calls $2
*** FLOP *** [Kh Kd Qc]
Merida900: checks 
Harbinger X: checks 
ka100pka527: checks 
*** TURN *** [Kh Kd Qc] [2d]
Merida900: checks 
Harbinger X: checks 
ka100pka527: checks 
*** RIVER *** [Kh Kd Qc 2d] [6s]
Merida900: bets $3
Harbinger X: folds 
ka100pka527: raises $9.73 to $12.73
Merida900: calls $9.73
*** SHOW DOWN ***
ka100pka527: shows [6d 6c] (a full house, Sixes full of Kings)
Merida900: mucks hand 
ka100pka527 collected $32.91 from pot
*** SUMMARY ***
Total pot $34.46 | Rake $1.55 
Board [Kh Kd Qc 2d 6s]
Seat 1: cobrik23 folded before Flop (didn't bet)
Seat 2: ka100pka527 showed [6d 6c] and won ($32.91) with a full house, Sixes full of Kings
Seat 3: Painkiller72 (button) folded before Flop (didn't bet)
Seat 4: Merida900 (small blind) mucked [Kc Jd]
Seat 5: Harbinger X (big blind) folded on the River
Seat 6: I The King I folded before Flop (didn't bet)
Seat 7: Ilov3NBA folded before Flop (didn't bet)
Seat 8: di0d80 folded before Flop (didn't bet)
Seat 9: matiko09 folded before Flop (didn't bet)





PokerStars Hand #150751578981:  Hold'em No Limit ($0.50/$1.00 USD) - 2016/03/22 14:01:36 CET [2016/03/22 9:01:36 ET]
Table 'Arabis' 9-max Seat #5 is the button
Seat 1: Chiddy83 ($83.70 in chips) 
Seat 2: ilaviiitech ($116.31 in chips) 
Seat 4: Painkiller72 ($129.67 in chips) 
Seat 5: matiko09 ($100 in chips) 
Seat 6: I The King I ($100 in chips) 
Seat 7: howsiao ($40 in chips) 
Seat 8: Bro_Happy ($175.06 in chips) 
Seat 9: cobrik23 ($85.70 in chips) 
I The King I: posts small blind $0.50
howsiao: posts big blind $1
myatiy 96: sits out 
*** HOLE CARDS ***
Dealt to matiko09 [Td 4d]
Bro_Happy: folds 
cobrik23: folds 
Chiddy83: folds 
ilaviiitech: folds 
Painkiller72: folds 
matiko09: folds 
I The King I: folds 
Uncalled bet ($0.50) returned to howsiao
howsiao collected $1 from pot
howsiao: doesn't show hand 
*** SUMMARY ***
Total pot $1 | Rake $0 
Seat 1: Chiddy83 folded before Flop (didn't bet)
Seat 2: ilaviiitech folded before Flop (didn't bet)
Seat 4: Painkiller72 folded before Flop (didn't bet)
Seat 5: matiko09 (button) folded before Flop (didn't bet)
Seat 6: I The King I (small blind) folded before Flop
Seat 7: howsiao (big blind) collected ($1)
Seat 8: Bro_Happy folded before Flop (didn't bet)
Seat 9: cobrik23 folded before Flop (didn't bet)





PokerStars Hand #150751593796:  Hold'em No Limit ($0.50/$1.00 USD) - 2016/03/22 14:02:02 CET [2016/03/22 9:02:02 ET]
Table 'Arabis' 9-max Seat #6 is the button
Seat 1: Chiddy83 ($83.70 in chips) 
Seat 2: ilaviiitech ($116.31 in chips) 
Seat 4: Painkiller72 ($129.67 in chips) 
Seat 5: matiko09 ($100 in chips) 
Seat 6: I The King I ($100 in chips) 
Seat 7: howsiao ($40.50 in chips) 
Seat 9: cobrik23 ($85.70 in chips) 
howsiao: posts small blind $0.50
Bro_Happy: is sitting out 
cobrik23: posts big blind $1
myatiy 96: sits out 
*** HOLE CARDS ***
Dealt to matiko09 [8d 6s]
Chiddy83: raises $2 to $3
ilaviiitech: folds 
Painkiller72: folds 
matiko09: folds 
I The King I: folds 
howsiao: raises $2 to $5
cobrik23: folds 
Chiddy83: calls $2
*** FLOP *** [8h 9d 3s]
howsiao: bets $5.25
Chiddy83: calls $5.25
*** TURN *** [8h 9d 3s] [2s]
howsiao: checks 
Chiddy83: bets $11
howsiao: calls $11
*** RIVER *** [8h 9d 3s 2s] [Jd]
howsiao: checks 
Chiddy83: bets $62.45 and is all-in
howsiao: calls $19.25 and is all-in
Uncalled bet ($43.20) returned to Chiddy83
*** SHOW DOWN ***
Chiddy83: shows [Jh 9h] (two pair, Jacks and Nines)
howsiao: shows [Qc Td] (a straight, Eight to Queen)
howsiao collected $79.20 from pot
*** SUMMARY ***
Total pot $82 | Rake $2.80 
Board [8h 9d 3s 2s Jd]
Seat 1: Chiddy83 showed [Jh 9h] and lost with two pair, Jacks and Nines
Seat 2: ilaviiitech folded before Flop (didn't bet)
Seat 4: Painkiller72 folded before Flop (didn't bet)
Seat 5: matiko09 folded before Flop (didn't bet)
Seat 6: I The King I (button) folded before Flop (didn't bet)
Seat 7: howsiao (small blind) showed [Qc Td] and won ($79.20) with a straight, Eight to Queen
Seat 9: cobrik23 (big blind) folded before Flop





PokerStars Hand #150751603759:  Hold'em No Limit ($0.50/$1.00 USD) - 2016/03/22 14:02:20 CET [2016/03/22 9:02:20 ET]
Table 'Harding' 9-max Seat #3 is the button
Seat 1: matiko09 ($110.76 in chips) 
Seat 2: I The King I ($136.80 in chips) 
Seat 3: Avtovo ($100 in chips) 
Seat 4: lixiangli ($105 in chips) 
Seat 5: DevilisHEyz ($139.74 in chips) 
Seat 6: Ilov3NBA ($101.50 in chips) 
Seat 7: mrhighryza ($111.30 in chips) 
Seat 8: di0d80 ($120.15 in chips) 
Seat 9: ka100pka527 ($36 in chips) 
lixiangli: posts small blind $0.50
DevilisHEyz: posts big blind $1
*** HOLE CARDS ***
Dealt to matiko09 [Jc Th]
Ilov3NBA: folds 
mrhighryza: folds 
di0d80: folds 
ka100pka527: folds 
matiko09: folds 
I The King I: raises $1.50 to $2.50
Avtovo: folds 
lixiangli: calls $2
DevilisHEyz: folds 
*** FLOP *** [Ad 4c 4d]
lixiangli: checks 
I The King I: checks 
*** TURN *** [Ad 4c 4d] [Jh]
lixiangli: bets $3
I The King I: folds 
Uncalled bet ($3) returned to lixiangli
lixiangli collected $5.73 from pot
*** SUMMARY ***
Total pot $6 | Rake $0.27 
Board [Ad 4c 4d Jh]
Seat 1: matiko09 folded before Flop (didn't bet)
Seat 2: I The King I folded on the Turn
Seat 3: Avtovo (button) folded before Flop (didn't bet)
Seat 4: lixiangli (small blind) collected ($5.73)
Seat 5: DevilisHEyz (big blind) folded before Flop
Seat 6: Ilov3NBA folded before Flop (didn't bet)
Seat 7: mrhighryza folded before Flop (didn't bet)
Seat 8: di0d80 folded before Flop (didn't bet)
Seat 9: ka100pka527 folded before Flop (didn't bet)





PokerStars Hand #150751606681:  Hold'em No Limit ($0.50/$1.00 USD) - 2016/03/22 14:02:25 CET [2016/03/22 9:02:25 ET]
Table 'Colchis' 9-max Seat #8 is the button
Seat 1: theluckyjoe ($20.02 in chips) 
Seat 2: tipner ($135.73 in chips) 
Seat 3: edidaz ($192.31 in chips) 
Seat 4: matiko09 ($104.57 in chips) 
Seat 5: lumen21 ($114 in chips) 
Seat 6: Avtovo ($100 in chips) 
Seat 7: ka100pka527 ($124 in chips) 
Seat 8: cobrik23 ($45.53 in chips) 
Seat 9: ardo888 ($103.23 in chips) 
ardo888: posts small blind $0.50
theluckyjoe: posts big blind $1
*** HOLE CARDS ***
Dealt to matiko09 [Qs 4h]
tipner: folds 
edidaz: folds 
matiko09: folds 
lumen21: folds 
Avtovo: folds 
ka100pka527: folds 
cobrik23: raises $2 to $3
ardo888: folds 
theluckyjoe: calls $2
*** FLOP *** [8c 7h Kh]
theluckyjoe: checks 
cobrik23: checks 
*** TURN *** [8c 7h Kh] [As]
theluckyjoe: checks 
cobrik23: checks 
*** RIVER *** [8c 7h Kh As] [3d]
theluckyjoe: checks 
cobrik23: checks 
*** SHOW DOWN ***
theluckyjoe: shows [9s 8d] (a pair of Eights)
cobrik23: shows [Js Jc] (a pair of Jacks)
cobrik23 collected $6.21 from pot
*** SUMMARY ***
Total pot $6.50 | Rake $0.29 
Board [8c 7h Kh As 3d]
Seat 1: theluckyjoe (big blind) showed [9s 8d] and lost with a pair of Eights
Seat 2: tipner folded before Flop (didn't bet)
Seat 3: edidaz folded before Flop (didn't bet)
Seat 4: matiko09 folded before Flop (didn't bet)
Seat 5: lumen21 folded before Flop (didn't bet)
Seat 6: Avtovo folded before Flop (didn't bet)
Seat 7: ka100pka527 folded before Flop (didn't bet)
Seat 8: cobrik23 (button) showed [Js Jc] and won ($6.21) with a pair of Jacks
Seat 9: ardo888 (small blind) folded before Flop





PokerStars Hand #150751630309:  Hold'em No Limit ($0.50/$1.00 USD) - 2016/03/22 14:03:07 CET [2016/03/22 9:03:07 ET]
Table 'Saturn III' 9-max Seat #4 is the button
Seat 1: cobrik23 ($43.99 in chips) 
Seat 2: ka100pka527 ($81.25 in chips) 
Seat 3: Painkiller72 ($100 in chips) 
Seat 4: Merida900 ($76.77 in chips) 
Seat 5: Harbinger X ($97.23 in chips) 
Seat 6: I The King I ($101 in chips) 
Seat 7: Ilov3NBA ($100 in chips) 
Seat 8: di0d80 ($100 in chips) 
Seat 9: matiko09 ($138.65 in chips) 
Harbinger X: posts small blind $0.50
I The King I: posts big blind $1
*** HOLE CARDS ***
Dealt to matiko09 [Kc Ac]
Ilov3NBA: folds 
di0d80: raises $1.50 to $2.50
matiko09: calls $2.50
cobrik23: folds 
ka100pka527: folds 
Painkiller72: folds 
Merida900: folds 
Harbinger X: folds 
I The King I: folds 
*** FLOP *** [3h As 4h]
di0d80: checks 
matiko09: bets $4.04
di0d80: calls $4.04
*** TURN *** [3h As 4h] [7c]
di0d80: checks 
matiko09: bets $9.05
di0d80: folds 
Uncalled bet ($9.05) returned to matiko09
matiko09 collected $13.92 from pot
matiko09: doesn't show hand 
*** SUMMARY ***
Total pot $14.58 | Rake $0.66 
Board [3h As 4h 7c]
Seat 1: cobrik23 folded before Flop (didn't bet)
Seat 2: ka100pka527 folded before Flop (didn't bet)
Seat 3: Painkiller72 folded before Flop (didn't bet)
Seat 4: Merida900 (button) folded before Flop (didn't bet)
Seat 5: Harbinger X (small blind) folded before Flop
Seat 6: I The King I (big blind) folded before Flop
Seat 7: Ilov3NBA folded before Flop (didn't bet)
Seat 8: di0d80 folded on the Turn
Seat 9: matiko09 collected ($13.92)





PokerStars Hand #150751637587:  Hold'em No Limit ($0.50/$1.00 USD) - 2016/03/22 14:03:19 CET [2016/03/22 9:03:19 ET]
Table 'Colchis' 9-max Seat #9 is the button
Seat 1: theluckyjoe ($17.02 in chips) 
Seat 4: matiko09 ($104.57 in chips) 
Seat 5: lumen21 ($114 in chips) 
Seat 6: Avtovo ($100 in chips) 
Seat 7: ka100pka527 ($124 in chips) 
Seat 8: cobrik23 ($48.74 in chips) 
Seat 9: ardo888 ($102.73 in chips) 
theluckyjoe: posts small blind $0.50
tipner: is sitting out 
tipner leaves the table
edidaz: is sitting out 
matiko09: posts big blind $1
*** HOLE CARDS ***
Dealt to matiko09 [8h 7h]
lumen21: folds 
Ilov3NBA joins the table at seat #2 
Avtovo: folds 
ka100pka527: folds 
cobrik23: folds 
ardo888: folds 
theluckyjoe: calls $0.50
matiko09: checks 
*** FLOP *** [7d Ts Ac]
theluckyjoe: bets $1
matiko09: folds 
Uncalled bet ($1) returned to theluckyjoe
theluckyjoe collected $1.91 from pot
theluckyjoe: doesn't show hand 
*** SUMMARY ***
Total pot $2 | Rake $0.09 
Board [7d Ts Ac]
Seat 1: theluckyjoe (small blind) collected ($1.91)
Seat 4: matiko09 (big blind) folded on the Flop
Seat 5: lumen21 folded before Flop (didn't bet)
Seat 6: Avtovo folded before Flop (didn't bet)
Seat 7: ka100pka527 folded before Flop (didn't bet)
Seat 8: cobrik23 folded before Flop (didn't bet)
Seat 9: ardo888 (button) folded before Flop (didn't bet)





PokerStars Hand #150751640591:  Hold'em No Limit ($0.50/$1.00 USD) - 2016/03/22 14:03:25 CET [2016/03/22 9:03:25 ET]
Table 'Arabis' 9-max Seat #7 is the button
Seat 1: Chiddy83 ($43.20 in chips) 
Seat 2: ilaviiitech ($116.31 in chips) 
Seat 4: Painkiller72 ($129.67 in chips) 
Seat 5: matiko09 ($100 in chips) 
Seat 6: I The King I ($100 in chips) 
Seat 7: howsiao ($79.20 in chips) 
Seat 9: cobrik23 ($84.70 in chips) 
Bro_Happy will be allowed to play after the button
cobrik23: posts small blind $0.50
Chiddy83: posts big blind $1
myatiy 96: sits out 
*** HOLE CARDS ***
Dealt to matiko09 [2c Qs]
ilaviiitech: folds 
Painkiller72: folds 
matiko09: folds 
I The King I: raises $1.50 to $2.50
howsiao: folds 
cobrik23: folds 
Chiddy83: calls $1.50
*** FLOP *** [5s 7s Qc]
Chiddy83: checks 
I The King I: checks 
*** TURN *** [5s 7s Qc] [8h]
Chiddy83: checks 
I The King I: checks 
*** RIVER *** [5s 7s Qc 8h] [6h]
Chiddy83: bets $3
I The King I: folds 
Uncalled bet ($3) returned to Chiddy83
Chiddy83 collected $5.25 from pot
Chiddy83: doesn't show hand 
*** SUMMARY ***
Total pot $5.50 | Rake $0.25 
Board [5s 7s Qc 8h 6h]
Seat 1: Chiddy83 (big blind) collected ($5.25)
Seat 2: ilaviiitech folded before Flop (didn't bet)
Seat 4: Painkiller72 folded before Flop (didn't bet)
Seat 5: matiko09 folded before Flop (didn't bet)
Seat 6: I The King I folded on the River
Seat 7: howsiao (button) folded before Flop (didn't bet)
Seat 9: cobrik23 (small blind) folded before Flop





PokerStars Hand #150751642985:  Hold'em No Limit ($0.50/$1.00 USD) - 2016/03/22 14:03:29 CET [2016/03/22 9:03:29 ET]
Table 'Harding' 9-max Seat #4 is the button
Seat 1: matiko09 ($110.76 in chips) 
Seat 2: I The King I ($134.30 in chips) 
Seat 3: Avtovo ($100 in chips) 
Seat 4: lixiangli ($108.23 in chips) 
Seat 5: DevilisHEyz ($138.74 in chips) 
Seat 6: Ilov3NBA ($101.50 in chips) 
Seat 7: mrhighryza ($111.30 in chips) 
Seat 8: di0d80 ($120.15 in chips) 
Seat 9: ka100pka527 ($36 in chips) 
DevilisHEyz: posts small blind $0.50
Ilov3NBA: posts big blind $1
*** HOLE CARDS ***
Dealt to matiko09 [3s 6s]
mrhighryza: folds 
di0d80: folds 
ka100pka527: folds 
matiko09: folds 
I The King I: raises $2 to $3
Avtovo: folds 
lixiangli: folds 
DevilisHEyz: folds 
Ilov3NBA: calls $2
*** FLOP *** [2d Jh 9s]
Ilov3NBA: checks 
I The King I: checks 
*** TURN *** [2d Jh 9s] [3h]
Ilov3NBA: bets $4.59
I The King I: calls $4.59
*** RIVER *** [2d Jh 9s 3h] [As]
Ilov3NBA: checks 
I The King I: bets $9
Ilov3NBA: folds 
Uncalled bet ($9) returned to I The King I
I The King I collected $14.97 from pot
I The King I: doesn't show hand 
*** SUMMARY ***
Total pot $15.68 | Rake $0.71 
Board [2d Jh 9s 3h As]
Seat 1: matiko09 folded before Flop (didn't bet)
Seat 2: I The King I collected ($14.97)
Seat 3: Avtovo folded before Flop (didn't bet)
Seat 4: lixiangli (button) folded before Flop (didn't bet)
Seat 5: DevilisHEyz (small blind) folded before Flop
Seat 6: Ilov3NBA (big blind) folded on the River
Seat 7: mrhighryza folded before Flop (didn't bet)
Seat 8: di0d80 folded before Flop (didn't bet)
Seat 9: ka100pka527 folded before Flop (didn't bet)





PokerStars Hand #150751663672:  Hold'em No Limit ($0.50/$1.00 USD) - 2016/03/22 14:04:05 CET [2016/03/22 9:04:05 ET]
Table 'Colchis' 9-max Seat #1 is the button
Seat 1: theluckyjoe ($17.93 in chips) 
Seat 4: matiko09 ($103.57 in chips) 
Seat 5: lumen21 ($114 in chips) 
Seat 6: Avtovo ($100 in chips) 
Seat 7: ka100pka527 ($124 in chips) 
Seat 8: cobrik23 ($48.74 in chips) 
Seat 9: ardo888 ($102.73 in chips) 
Ilov3NBA will be allowed to play after the button
matiko09: posts small blind $0.50
lumen21: posts big blind $1
*** HOLE CARDS ***
Dealt to matiko09 [Kc 5d]
Avtovo: folds 
ka100pka527: folds 
cobrik23: folds 
edidaz leaves the table
I The King I joins the table at seat #3 
ardo888: folds 
theluckyjoe: raises $2 to $3
matiko09: folds 
lumen21: folds 
Uncalled bet ($2) returned to theluckyjoe
theluckyjoe collected $2.50 from pot
theluckyjoe: doesn't show hand 
*** SUMMARY ***
Total pot $2.50 | Rake $0 
Seat 1: theluckyjoe (button) collected ($2.50)
Seat 4: matiko09 (small blind) folded before Flop
Seat 5: lumen21 (big blind) folded before Flop
Seat 6: Avtovo folded before Flop (didn't bet)
Seat 7: ka100pka527 folded before Flop (didn't bet)
Seat 8: cobrik23 folded before Flop (didn't bet)
Seat 9: ardo888 folded before Flop (didn't bet)





PokerStars Hand #150751675618:  Hold'em No Limit ($0.50/$1.00 USD) - 2016/03/22 14:04:26 CET [2016/03/22 9:04:26 ET]
Table 'Stephano II' 9-max Seat #7 is the button
Seat 6: kotan05 ($41.32 in chips) 
Seat 7: ilaviiitech ($100 in chips) 
Seat 8: Painkiller72 ($100.50 in chips) 
Seat 9: matiko09 ($100 in chips) 
Painkiller72: posts small blind $0.50
matiko09: posts big blind $1
*** HOLE CARDS ***
Dealt to matiko09 [5c Qs]
kotan05: raises $1 to $2
ilaviiitech: raises $7.50 to $9.50
ardo888 joins the table at seat #1 
Painkiller72: folds 
mb2part joins the table at seat #5 
matiko09: folds 
kotan05: folds 
Uncalled bet ($7.50) returned to ilaviiitech
ilaviiitech collected $5.50 from pot
ilaviiitech: doesn't show hand 
*** SUMMARY ***
Total pot $5.50 | Rake $0 
Seat 6: kotan05 folded before Flop
Seat 7: ilaviiitech (button) collected ($5.50)
Seat 8: Painkiller72 (small blind) folded before Flop
Seat 9: matiko09 (big blind) folded before Flop





PokerStars Hand #150751688085:  Hold'em No Limit ($0.50/$1.00 USD) - 2016/03/22 14:04:47 CET [2016/03/22 9:04:47 ET]
Table 'Saturn III' 9-max Seat #5 is the button
Seat 1: cobrik23 ($43.99 in chips) 
Seat 2: ka100pka527 ($81.25 in chips) 
Seat 3: Painkiller72 ($100 in chips) 
Seat 4: Merida900 ($76.77 in chips) 
Seat 5: Harbinger X ($96.73 in chips) 
Seat 6: I The King I ($100 in chips) 
Seat 7: Ilov3NBA ($100 in chips) 
Seat 8: di0d80 ($100 in chips) 
Seat 9: matiko09 ($146.03 in chips) 
I The King I: posts small blind $0.50
Ilov3NBA: posts big blind $1
*** HOLE CARDS ***
Dealt to matiko09 [Ac 7s]
di0d80: folds 
matiko09: folds 
cobrik23: folds 
ka100pka527: folds 
Painkiller72: folds 
Merida900: folds 
Harbinger X: folds 
I The King I: raises $2 to $3
Ilov3NBA: calls $2
*** FLOP *** [2d 4s Kc]
I The King I: bets $4
Ilov3NBA: calls $4
*** TURN *** [2d 4s Kc] [6s]
I The King I: bets $9
Ilov3NBA: folds 
Uncalled bet ($9) returned to I The King I
I The King I collected $13.37 from pot
I The King I: doesn't show hand 
*** SUMMARY ***
Total pot $14 | Rake $0.63 
Board [2d 4s Kc 6s]
Seat 1: cobrik23 folded before Flop (didn't bet)
Seat 2: ka100pka527 folded before Flop (didn't bet)
Seat 3: Painkiller72 folded before Flop (didn't bet)
Seat 4: Merida900 folded before Flop (didn't bet)
Seat 5: Harbinger X (button) folded before Flop (didn't bet)
Seat 6: I The King I (small blind) collected ($13.37)
Seat 7: Ilov3NBA (big blind) folded on the Turn
Seat 8: di0d80 folded before Flop (didn't bet)
Seat 9: matiko09 folded before Flop (didn't bet)





PokerStars Hand #150751688845:  Hold'em No Limit ($0.50/$1.00 USD) - 2016/03/22 14:04:49 CET [2016/03/22 9:04:49 ET]
Table 'Stephano II' 9-max Seat #8 is the button
Seat 1: ardo888 ($100 in chips) 
Seat 6: kotan05 ($39.32 in chips) 
Seat 7: ilaviiitech ($103.50 in chips) 
Seat 8: Painkiller72 ($100 in chips) 
Seat 9: matiko09 ($100 in chips) 
matiko09: posts small blind $0.50
ardo888: posts big blind $1
mb2part: sits out 
*** HOLE CARDS ***
Dealt to matiko09 [Jc 7d]
kotan05: folds 
ilaviiitech: folds 
AWATAR 21 joins the table at seat #4 
Painkiller72: folds 
matiko09: folds 
Uncalled bet ($0.50) returned to ardo888
ardo888 collected $1 from pot
ardo888: doesn't show hand 
*** SUMMARY ***
Total pot $1 | Rake $0 
Seat 1: ardo888 (big blind) collected ($1)
Seat 6: kotan05 folded before Flop (didn't bet)
Seat 7: ilaviiitech folded before Flop (didn't bet)
Seat 8: Painkiller72 (button) folded before Flop (didn't bet)
Seat 9: matiko09 (small blind) folded before Flop





PokerStars Hand #150751691157:  Hold'em No Limit ($0.50/$1.00 USD) - 2016/03/22 14:04:53 CET [2016/03/22 9:04:53 ET]
Table 'Colchis' 9-max Seat #4 is the button
Seat 1: theluckyjoe ($19.43 in chips) 
Seat 4: matiko09 ($103.07 in chips) 
Seat 5: lumen21 ($113 in chips) 
Seat 6: Avtovo ($100 in chips) 
Seat 7: ka100pka527 ($124 in chips) 
Seat 8: cobrik23 ($48.74 in chips) 
Seat 9: ardo888 ($102.73 in chips) 
lumen21: posts small blind $0.50
Avtovo: posts big blind $1
Ilov3NBA: sits out 
I The King I: sits out 
*** HOLE CARDS ***
Dealt to matiko09 [Js 3d]
ka100pka527: folds 
cobrik23: folds 
I The King I leaves the table
ardo888: folds 
edidaz joins the table at seat #3 
theluckyjoe: calls $1
edidaz leaves the table
myatiy 96 joins the table at seat #3 
matiko09: folds 
myatiy 96 leaves the table
lumen21: folds 
Sreshta222 joins the table at seat #3 
Avtovo: checks 
*** FLOP *** [8c Qc Ah]
Sreshta222 leaves the table
Avtovo: checks 
theluckyjoe: checks 
*** TURN *** [8c Qc Ah] [7h]
bragutza joins the table at seat #3 
Avtovo: checks 
theluckyjoe: checks 
*** RIVER *** [8c Qc Ah 7h] [6d]
Avtovo: checks 
theluckyjoe: checks 
*** SHOW DOWN ***
Avtovo: shows [5s Kh] (high card Ace)
theluckyjoe: mucks hand 
Avtovo collected $2.39 from pot
*** SUMMARY ***
Total pot $2.50 | Rake $0.11 
Board [8c Qc Ah 7h 6d]
Seat 1: theluckyjoe mucked [5d Td]
Seat 4: matiko09 (button) folded before Flop (didn't bet)
Seat 5: lumen21 (small blind) folded before Flop
Seat 6: Avtovo (big blind) showed [5s Kh] and won ($2.39) with high card Ace
Seat 7: ka100pka527 folded before Flop (didn't bet)
Seat 8: cobrik23 folded before Flop (didn't bet)
Seat 9: ardo888 folded before Flop (didn't bet)





PokerStars Hand #150751699895:  Hold'em No Limit ($0.50/$1.00 USD) - 2016/03/22 14:05:06 CET [2016/03/22 9:05:06 ET]
Table 'Stephano II' 9-max Seat #9 is the button
Seat 1: ardo888 ($100.50 in chips) 
Seat 4: AWATAR 21 ($100 in chips) 
Seat 6: kotan05 ($39.32 in chips) 
Seat 7: ilaviiitech ($103.50 in chips) 
Seat 8: Painkiller72 ($100 in chips) 
Seat 9: matiko09 ($100 in chips) 
ardo888: posts small blind $0.50
AWATAR 21: posts big blind $1
mb2part: sits out 
*** HOLE CARDS ***
Dealt to matiko09 [6h 8s]
kotan05: calls $1
ilaviiitech: folds 
Painkiller72: folds 
matiko09: folds 
ardo888: folds 
AWATAR 21: checks 
*** FLOP *** [Td 7d 3c]
lombardo11 joins the table at seat #3 
AWATAR 21: checks 
kotan05: bets $1
AWATAR 21: folds 
Uncalled bet ($1) returned to kotan05
kotan05 collected $2.39 from pot
kotan05: doesn't show hand 
*** SUMMARY ***
Total pot $2.50 | Rake $0.11 
Board [Td 7d 3c]
Seat 1: ardo888 (small blind) folded before Flop
Seat 4: AWATAR 21 (big blind) folded on the Flop
Seat 6: kotan05 collected ($2.39)
Seat 7: ilaviiitech folded before Flop (didn't bet)
Seat 8: Painkiller72 folded before Flop (didn't bet)
Seat 9: matiko09 (button) folded before Flop (didn't bet)





PokerStars Hand #150751701238:  Hold'em No Limit ($0.50/$1.00 USD) - 2016/03/22 14:05:08 CET [2016/03/22 9:05:08 ET]
Table 'Arabis' 9-max Seat #9 is the button
Seat 1: Chiddy83 ($45.95 in chips) 
Seat 2: ilaviiitech ($116.31 in chips) 
Seat 4: Painkiller72 ($129.67 in chips) 
Seat 5: matiko09 ($100 in chips) 
Seat 6: I The King I ($100 in chips) 
Seat 7: howsiao ($79.20 in chips) 
Seat 8: Bro_Happy ($175.06 in chips) 
Seat 9: cobrik23 ($84.20 in chips) 
Chiddy83: posts small blind $0.50
ilaviiitech: posts big blind $1
myatiy 96: sits out 
Bro_Happy: posts small & big blinds $1.50
*** HOLE CARDS ***
Dealt to matiko09 [Qd 9d]
Painkiller72: folds 
matiko09: folds 
I The King I: folds 
howsiao: raises $4 to $5
Bro_Happy: calls $4
cobrik23: folds 
Chiddy83: folds 
ilaviiitech: folds 
*** FLOP *** [Tc 3h Js]
howsiao: checks 
Bro_Happy: checks 
*** TURN *** [Tc 3h Js] [5s]
howsiao: bets $7
Bro_Happy: calls $7
*** RIVER *** [Tc 3h Js 5s] [2h]
howsiao: checks 
Bro_Happy: checks 
*** SHOW DOWN ***
howsiao: shows [Qh 8h] (high card Queen)
Bro_Happy: shows [Ad Qc] (high card Ace)
Bro_Happy collected $24.83 from pot
*** SUMMARY ***
Total pot $26 | Rake $1.17 
Board [Tc 3h Js 5s 2h]
Seat 1: Chiddy83 (small blind) folded before Flop
Seat 2: ilaviiitech (big blind) folded before Flop
Seat 4: Painkiller72 folded before Flop (didn't bet)
Seat 5: matiko09 folded before Flop (didn't bet)
Seat 6: I The King I folded before Flop (didn't bet)
Seat 7: howsiao showed [Qh 8h] and lost with high card Queen
Seat 8: Bro_Happy showed [Ad Qc] and won ($24.83) with high card Ace
Seat 9: cobrik23 (button) folded before Flop (didn't bet)





PokerStars Hand #150751708030:  Hold'em No Limit ($0.50/$1.00 USD) - 2016/03/22 14:05:20 CET [2016/03/22 9:05:20 ET]
Table 'Harding' 9-max Seat #5 is the button
Seat 1: matiko09 ($110.76 in chips) 
Seat 2: I The King I ($141.68 in chips) 
Seat 3: Avtovo ($100 in chips) 
Seat 4: lixiangli ($108.23 in chips) 
Seat 5: DevilisHEyz ($138.24 in chips) 
Seat 6: Ilov3NBA ($100 in chips) 
Seat 7: mrhighryza ($111.30 in chips) 
Seat 8: di0d80 ($120.15 in chips) 
Seat 9: ka100pka527 ($36 in chips) 
Ilov3NBA: posts small blind $0.50
mrhighryza: posts big blind $1
*** HOLE CARDS ***
Dealt to matiko09 [3h 6c]
di0d80: folds 
ka100pka527: folds 
matiko09: folds 
I The King I: folds 
Avtovo: folds 
lixiangli: folds 
DevilisHEyz: folds 
Ilov3NBA: raises $1.50 to $2.50
mrhighryza: calls $1.50
*** FLOP *** [Ts 6d 9c]
Ilov3NBA: checks 
mrhighryza: bets $2
Ilov3NBA: folds 
Uncalled bet ($2) returned to mrhighryza
mrhighryza collected $4.78 from pot
*** SUMMARY ***
Total pot $5 | Rake $0.22 
Board [Ts 6d 9c]
Seat 1: matiko09 folded before Flop (didn't bet)
Seat 2: I The King I folded before Flop (didn't bet)
Seat 3: Avtovo folded before Flop (didn't bet)
Seat 4: lixiangli folded before Flop (didn't bet)
Seat 5: DevilisHEyz (button) folded before Flop (didn't bet)
Seat 6: Ilov3NBA (small blind) folded on the Flop
Seat 7: mrhighryza (big blind) collected ($4.78)
Seat 8: di0d80 folded before Flop (didn't bet)
Seat 9: ka100pka527 folded before Flop (didn't bet)





PokerStars Hand #150751717739:  Hold'em No Limit ($0.50/$1.00 USD) - 2016/03/22 14:05:37 CET [2016/03/22 9:05:37 ET]
Table 'Stephano II' 9-max Seat #1 is the button
Seat 1: ardo888 ($100 in chips) 
Seat 4: AWATAR 21 ($99 in chips) 
Seat 5: mb2part ($100 in chips) 
Seat 6: kotan05 ($40.71 in chips) 
Seat 7: ilaviiitech ($103.50 in chips) 
Seat 8: Painkiller72 ($100 in chips) 
Seat 9: matiko09 ($100 in chips) 
lombardo11 will be allowed to play after the button
AWATAR 21: posts small blind $0.50
mb2part: posts big blind $1
*** HOLE CARDS ***
Dealt to matiko09 [Qc 4s]
kotan05: folds 
ilaviiitech: folds 
Painkiller72: folds 
matiko09: folds 
ardo888: raises $1.50 to $2.50
AWATAR 21: folds 
buckshot150 joins the table at seat #2 
mb2part: folds 
Uncalled bet ($1.50) returned to ardo888
ardo888 collected $2.50 from pot
ardo888: doesn't show hand 
*** SUMMARY ***
Total pot $2.50 | Rake $0 
Seat 1: ardo888 (button) collected ($2.50)
Seat 4: AWATAR 21 (small blind) folded before Flop
Seat 5: mb2part (big blind) folded before Flop
Seat 6: kotan05 folded before Flop (didn't bet)
Seat 7: ilaviiitech folded before Flop (didn't bet)
Seat 8: Painkiller72 folded before Flop (didn't bet)
Seat 9: matiko09 folded before Flop (didn't bet)





PokerStars Hand #150751718001:  Hold'em No Limit ($0.50/$1.00 USD) - 2016/03/22 14:05:37 CET [2016/03/22 9:05:37 ET]
Table 'Colchis' 9-max Seat #5 is the button
Seat 1: theluckyjoe ($18.43 in chips) 
Seat 3: bragutza ($51.89 in chips) 
Seat 4: matiko09 ($103.07 in chips) 
Seat 5: lumen21 ($112.50 in chips) 
Seat 6: Avtovo ($101.39 in chips) 
Seat 8: cobrik23 ($48.74 in chips) 
Seat 9: ardo888 ($102.73 in chips) 
Avtovo: posts small blind $0.50
ka100pka527: is sitting out 
ka100pka527 leaves the table
cobrik23: posts big blind $1
Ilov3NBA: sits out 
bragutza: posts big blind $1
*** HOLE CARDS ***
Dealt to matiko09 [Kc 6h]
Dantist1122 joins the table at seat #7 
ardo888: folds 
theluckyjoe: folds 
bragutza: checks 
matiko09: folds 
lumen21: raises $3.50 to $4.50
Avtovo: folds 
cobrik23: raises $8.50 to $13
bragutza: folds 
lumen21: raises $99.50 to $112.50 and is all-in
cobrik23: calls $35.74 and is all-in
Uncalled bet ($63.76) returned to lumen21
*** FLOP *** [2s Kh 6c]
*** TURN *** [2s Kh 6c] [Td]
*** RIVER *** [2s Kh 6c Td] [Ah]
*** SHOW DOWN ***
cobrik23: shows [7s 7d] (a pair of Sevens)
lumen21: shows [Qs Qh] (a pair of Queens)
lumen21 collected $96.18 from pot
*** SUMMARY ***
Total pot $98.98 | Rake $2.80 
Board [2s Kh 6c Td Ah]
Seat 1: theluckyjoe folded before Flop (didn't bet)
Seat 3: bragutza folded before Flop
Seat 4: matiko09 folded before Flop (didn't bet)
Seat 5: lumen21 (button) showed [Qs Qh] and won ($96.18) with a pair of Queens
Seat 6: Avtovo (small blind) folded before Flop
Seat 8: cobrik23 (big blind) showed [7s 7d] and lost with a pair of Sevens
Seat 9: ardo888 folded before Flop (didn't bet)





PokerStars Hand #150751731146:  Hold'em No Limit ($0.50/$1.00 USD) - 2016/03/22 14:06:00 CET [2016/03/22 9:06:00 ET]
Table 'Stephano II' 9-max Seat #4 is the button
Seat 1: ardo888 ($101.50 in chips) 
Seat 2: buckshot150 ($79.20 in chips) 
Seat 4: AWATAR 21 ($98.50 in chips) 
Seat 5: mb2part ($99 in chips) 
Seat 6: kotan05 ($40.71 in chips) 
Seat 7: ilaviiitech ($103.50 in chips) 
Seat 8: Painkiller72 ($100 in chips) 
Seat 9: matiko09 ($100 in chips) 
mb2part: posts small blind $0.50
kotan05: posts big blind $1
buckshot150: posts big blind $1
lombardo11: sits out 
*** HOLE CARDS ***
Dealt to matiko09 [5d 8s]
ilaviiitech: raises $3 to $4
Painkiller72: folds 
matiko09: folds 
ardo888: folds 
buckshot150: calls $3
AWATAR 21: calls $4
mb2part: calls $3.50
kotan05: folds 
*** FLOP *** [4s 8d 6c]
mb2part: checks 
ilaviiitech: bets $8
buckshot150: folds 
AWATAR 21: calls $8
mb2part: calls $8
*** TURN *** [4s 8d 6c] [Qc]
mb2part: checks 
ilaviiitech: checks 
AWATAR 21: checks 
*** RIVER *** [4s 8d 6c Qc] [5h]
mb2part: checks 
ilaviiitech: checks 
AWATAR 21: bets $14
mb2part: calls $14
ilaviiitech: folds 
*** SHOW DOWN ***
AWATAR 21: shows [Ts 7s] (a straight, Four to Eight)
mb2part: mucks hand 
AWATAR 21 collected $66.20 from pot
*** SUMMARY ***
Total pot $69 | Rake $2.80 
Board [4s 8d 6c Qc 5h]
Seat 1: ardo888 folded before Flop (didn't bet)
Seat 2: buckshot150 folded on the Flop
Seat 4: AWATAR 21 (button) showed [Ts 7s] and won ($66.20) with a straight, Four to Eight
Seat 5: mb2part (small blind) mucked [9h 9s]
Seat 6: kotan05 (big blind) folded before Flop
Seat 7: ilaviiitech folded on the River
Seat 8: Painkiller72 folded before Flop (didn't bet)
Seat 9: matiko09 folded before Flop (didn't bet)





PokerStars Hand #150751739377:  Hold'em No Limit ($0.50/$1.00 USD) - 2016/03/22 14:06:14 CET [2016/03/22 9:06:14 ET]
Table 'Harding' 9-max Seat #6 is the button
Seat 1: matiko09 ($110.76 in chips) 
Seat 2: I The King I ($141.68 in chips) 
Seat 3: Avtovo ($100 in chips) 
Seat 4: lixiangli ($108.23 in chips) 
Seat 5: DevilisHEyz ($138.24 in chips) 
Seat 6: Ilov3NBA ($100 in chips) 
Seat 7: mrhighryza ($113.58 in chips) 
mrhighryza: posts small blind $0.50
di0d80: is sitting out 
ka100pka527: is sitting out 
matiko09: posts big blind $1
*** HOLE CARDS ***
Dealt to matiko09 [6h 4c]
ka100pka527 leaves the table
omorfadramou joins the table at seat #9 
I The King I: folds 
Avtovo: folds 
lixiangli: raises $1 to $2
DevilisHEyz: folds 
Ilov3NBA: folds 
mrhighryza: calls $1.50
matiko09: folds 
*** FLOP *** [6d 7s 8h]
mrhighryza: checks 
lixiangli: checks 
*** TURN *** [6d 7s 8h] [4h]
mrhighryza: checks 
lixiangli: bets $2.39
mrhighryza: calls $2.39
*** RIVER *** [6d 7s 8h 4h] [9d]
mrhighryza: checks 
lixiangli: checks 
*** SHOW DOWN ***
mrhighryza: shows [Ad Qh] (high card Ace)
lixiangli: shows [Ah Qd] (high card Ace)
mrhighryza collected $4.67 from pot
lixiangli collected $4.67 from pot
*** SUMMARY ***
Total pot $9.78 | Rake $0.44 
Board [6d 7s 8h 4h 9d]
Seat 1: matiko09 (big blind) folded before Flop
Seat 2: I The King I folded before Flop (didn't bet)
Seat 3: Avtovo folded before Flop (didn't bet)
Seat 4: lixiangli showed [Ah Qd] and won ($4.67) with high card Ace
Seat 5: DevilisHEyz folded before Flop (didn't bet)
Seat 6: Ilov3NBA (button) folded before Flop (didn't bet)
Seat 7: mrhighryza (small blind) showed [Ad Qh] and won ($4.67) with high card Ace





PokerStars Hand #150751742175:  Hold'em No Limit ($0.50/$1.00 USD) - 2016/03/22 14:06:18 CET [2016/03/22 9:06:18 ET]
Table 'Saturn III' 9-max Seat #6 is the button
Seat 1: cobrik23 ($43.99 in chips) 
Seat 2: ka100pka527 ($81.25 in chips) 
Seat 3: Painkiller72 ($100 in chips) 
Seat 4: Merida900 ($76.77 in chips) 
Seat 5: Harbinger X ($96.73 in chips) 
Seat 6: I The King I ($106.37 in chips) 
Seat 7: Ilov3NBA ($100 in chips) 
Seat 9: matiko09 ($146.03 in chips) 
Ilov3NBA: posts small blind $0.50
di0d80: is sitting out 
matiko09: posts big blind $1
*** HOLE CARDS ***
Dealt to matiko09 [Ah 5c]
cobrik23: folds 
ka100pka527: folds 
Painkiller72: folds 
Merida900: raises $2 to $3
Harbinger X: folds 
I The King I: raises $6 to $9
Ilov3NBA: folds 
matiko09: folds 
Merida900: calls $6
*** FLOP *** [Ts 7s Qc]
Merida900: checks 
I The King I: checks 
*** TURN *** [Ts 7s Qc] [6h]
Merida900: bets $9.50
I The King I: folds 
Uncalled bet ($9.50) returned to Merida900
Merida900 collected $18.62 from pot
Merida900: doesn't show hand 
*** SUMMARY ***
Total pot $19.50 | Rake $0.88 
Board [Ts 7s Qc 6h]
Seat 1: cobrik23 folded before Flop (didn't bet)
Seat 2: ka100pka527 folded before Flop (didn't bet)
Seat 3: Painkiller72 folded before Flop (didn't bet)
Seat 4: Merida900 collected ($18.62)
Seat 5: Harbinger X folded before Flop (didn't bet)
Seat 6: I The King I (button) folded on the Turn
Seat 7: Ilov3NBA (small blind) folded before Flop
Seat 9: matiko09 (big blind) folded before Flop





PokerStars Hand #150751742489:  Hold'em No Limit ($0.50/$1.00 USD) - 2016/03/22 14:06:19 CET [2016/03/22 9:06:19 ET]
Table 'Arabis' 9-max Seat #1 is the button
Seat 1: Chiddy83 ($45.45 in chips) 
Seat 2: ilaviiitech ($115.31 in chips) 
Seat 3: myatiy 96 ($100 in chips) 
Seat 4: Painkiller72 ($129.67 in chips) 
Seat 5: matiko09 ($100 in chips) 
Seat 6: I The King I ($100 in chips) 
Seat 7: howsiao ($67.20 in chips) 
Seat 8: Bro_Happy ($187.39 in chips) 
Seat 9: cobrik23 ($84.20 in chips) 
ilaviiitech: posts small blind $0.50
myatiy 96: posts big blind $1
*** HOLE CARDS ***
Dealt to matiko09 [3s Kd]
Painkiller72: folds 
matiko09: folds 
I The King I: folds 
howsiao: raises $4 to $5
Bro_Happy: folds 
cobrik23: folds 
Chiddy83 is disconnected 
Chiddy83 has timed out while disconnected
Chiddy83: folds 
ilaviiitech: folds 
myatiy 96: folds 
Uncalled bet ($4) returned to howsiao
howsiao collected $2.50 from pot
howsiao: doesn't show hand 
*** SUMMARY ***
Total pot $2.50 | Rake $0 
Seat 1: Chiddy83 (button) folded before Flop (didn't bet)
Seat 2: ilaviiitech (small blind) folded before Flop
Seat 3: myatiy 96 (big blind) folded before Flop
Seat 4: Painkiller72 folded before Flop (didn't bet)
Seat 5: matiko09 folded before Flop (didn't bet)
Seat 6: I The King I folded before Flop (didn't bet)
Seat 7: howsiao collected ($2.50)
Seat 8: Bro_Happy folded before Flop (didn't bet)
Seat 9: cobrik23 folded before Flop (didn't bet)





PokerStars Hand #150751753427:  Hold'em No Limit ($0.50/$1.00 USD) - 2016/03/22 14:06:37 CET [2016/03/22 9:06:37 ET]
Table 'Taygeta II' 9-max Seat #2 is the button
Seat 1: DevilisHEyz ($95.20 in chips) 
Seat 2: khan Erkesh ($130.74 in chips) 
Seat 3: Muinmyheart ($100.50 in chips) 
Seat 4: matiko09 ($100 in chips) 
Seat 5: RICKA16 ($102.50 in chips) 
Seat 6: I The King I ($150.70 in chips) 
Seat 8: Avtovo ($102.50 in chips) 
Seat 9: cobrik23 ($52.31 in chips) 
Muinmyheart: posts small blind $0.50
matiko09: posts big blind $1
Szevasztopol: sits out 
*** HOLE CARDS ***
Dealt to matiko09 [6d Kd]
RICKA16: folds 
I The King I: raises $2 to $3
Avtovo: folds 
cobrik23: calls $3
DevilisHEyz has timed out
DevilisHEyz: folds 
khan Erkesh: calls $3
Muinmyheart: folds 
matiko09: folds 
*** FLOP *** [Kc 2h 5h]
I The King I: bets $6
cobrik23: folds 
khan Erkesh: raises $9 to $15
I The King I: calls $9
*** TURN *** [Kc 2h 5h] [2d]
I The King I: checks 
khan Erkesh: checks 
*** RIVER *** [Kc 2h 5h 2d] [4c]
I The King I: checks 
khan Erkesh: bets $38.68
I The King I: calls $38.68
*** SHOW DOWN ***
khan Erkesh: shows [5d 5s] (a full house, Fives full of Deuces)
I The King I: mucks hand 
khan Erkesh collected $115.06 from pot
*** SUMMARY ***
Total pot $117.86 | Rake $2.80 
Board [Kc 2h 5h 2d 4c]
Seat 1: DevilisHEyz folded before Flop (didn't bet)
Seat 2: khan Erkesh (button) showed [5d 5s] and won ($115.06) with a full house, Fives full of Deuces
Seat 3: Muinmyheart (small blind) folded before Flop
Seat 4: matiko09 (big blind) folded before Flop
Seat 5: RICKA16 folded before Flop (didn't bet)
Seat 6: I The King I mucked [Jh Kh]
Seat 8: Avtovo folded before Flop (didn't bet)
Seat 9: cobrik23 folded on the Flop





PokerStars Hand #150751762200:  Hold'em No Limit ($0.50/$1.00 USD) - 2016/03/22 14:06:52 CET [2016/03/22 9:06:52 ET]
Table 'Colchis' 9-max Seat #6 is the button
Seat 1: theluckyjoe ($18.43 in chips) 
Seat 3: bragutza ($50.89 in chips) 
Seat 4: matiko09 ($103.07 in chips) 
Seat 5: lumen21 ($159.94 in chips) 
Seat 6: Avtovo ($100.89 in chips) 
Seat 8: cobrik23 ($40 in chips) 
Seat 9: ardo888 ($102.73 in chips) 
Dantist1122 will be allowed to play after the button
cobrik23: posts small blind $0.50
ardo888: posts big blind $1
Ilov3NBA: sits out 
*** HOLE CARDS ***
Dealt to matiko09 [Qh 7h]
theluckyjoe: calls $1
bragutza: folds 
matiko09: folds 
lumen21: folds 
Avtovo: folds 
cobrik23: folds 
ardo888: checks 
*** FLOP *** [Qc 8d Kh]
ardo888: checks 
theluckyjoe: bets $1
ardo888: folds 
Uncalled bet ($1) returned to theluckyjoe
theluckyjoe collected $2.39 from pot
theluckyjoe: doesn't show hand 
*** SUMMARY ***
Total pot $2.50 | Rake $0.11 
Board [Qc 8d Kh]
Seat 1: theluckyjoe collected ($2.39)
Seat 3: bragutza folded before Flop (didn't bet)
Seat 4: matiko09 folded before Flop (didn't bet)
Seat 5: lumen21 folded before Flop (didn't bet)
Seat 6: Avtovo (button) folded before Flop (didn't bet)
Seat 8: cobrik23 (small blind) folded before Flop
Seat 9: ardo888 (big blind) folded on the Flop





PokerStars Hand #150751771107:  Hold'em No Limit ($0.50/$1.00 USD) - 2016/03/22 14:07:07 CET [2016/03/22 9:07:07 ET]
Table 'Stephano II' 9-max Seat #5 is the button
Seat 1: ardo888 ($101.50 in chips) 
Seat 2: buckshot150 ($75.20 in chips) 
Seat 4: AWATAR 21 ($138.70 in chips) 
Seat 5: mb2part ($73 in chips) 
Seat 6: kotan05 ($39.71 in chips) 
Seat 7: ilaviiitech ($100 in chips) 
Seat 8: Painkiller72 ($100 in chips) 
Seat 9: matiko09 ($100 in chips) 
kotan05: posts small blind $0.50
ilaviiitech: posts big blind $1
lombardo11: sits out 
*** HOLE CARDS ***
Dealt to matiko09 [4s Kc]
Painkiller72: folds 
matiko09: folds 
ardo888: folds 
buckshot150: raises $4 to $5
AWATAR 21: folds 
mb2part: folds 
kotan05: folds 
ilaviiitech: folds 
Uncalled bet ($4) returned to buckshot150
buckshot150 collected $2.50 from pot
buckshot150: doesn't show hand 
*** SUMMARY ***
Total pot $2.50 | Rake $0 
Seat 1: ardo888 folded before Flop (didn't bet)
Seat 2: buckshot150 collected ($2.50)
Seat 4: AWATAR 21 folded before Flop (didn't bet)
Seat 5: mb2part (button) folded before Flop (didn't bet)
Seat 6: kotan05 (small blind) folded before Flop
Seat 7: ilaviiitech (big blind) folded before Flop
Seat 8: Painkiller72 folded before Flop (didn't bet)
Seat 9: matiko09 folded before Flop (didn't bet)





PokerStars Hand #150751778520:  Hold'em No Limit ($0.50/$1.00 USD) - 2016/03/22 14:07:19 CET [2016/03/22 9:07:19 ET]
Table 'Arabis' 9-max Seat #2 is the button
Seat 2: ilaviiitech ($114.81 in chips) 
Seat 3: myatiy 96 ($100 in chips) 
Seat 4: Painkiller72 ($129.67 in chips) 
Seat 5: matiko09 ($100 in chips) 
Seat 6: I The King I ($100 in chips) 
Seat 7: howsiao ($68.70 in chips) 
Seat 8: Bro_Happy ($187.39 in chips) 
Seat 9: cobrik23 ($84.20 in chips) 
myatiy 96: posts small blind $0.50
Painkiller72: posts big blind $1
*** HOLE CARDS ***
Dealt to matiko09 [Ah 2d]
matiko09: folds 
I The King I: folds 
howsiao: calls $1
Bro_Happy: folds 
cobrik23: folds 
ilaviiitech: folds 
myatiy 96: folds 
Painkiller72: checks 
*** FLOP *** [6c Jc Jh]
Painkiller72: checks 
howsiao: checks 
*** TURN *** [6c Jc Jh] [2c]
Painkiller72: checks 
howsiao: bets $2
Painkiller72: folds 
Uncalled bet ($2) returned to howsiao
howsiao collected $2.39 from pot
howsiao: doesn't show hand 
*** SUMMARY ***
Total pot $2.50 | Rake $0.11 
Board [6c Jc Jh 2c]
Seat 2: ilaviiitech (button) folded before Flop (didn't bet)
Seat 3: myatiy 96 (small blind) folded before Flop
Seat 4: Painkiller72 (big blind) folded on the Turn
Seat 5: matiko09 folded before Flop (didn't bet)
Seat 6: I The King I folded before Flop (didn't bet)
Seat 7: howsiao collected ($2.39)
Seat 8: Bro_Happy folded before Flop (didn't bet)
Seat 9: cobrik23 folded before Flop (didn't bet)





PokerStars Hand #150751781956:  Hold'em No Limit ($0.50/$1.00 USD) - 2016/03/22 14:07:25 CET [2016/03/22 9:07:25 ET]
Table 'Saturn III' 9-max Seat #7 is the button
Seat 1: cobrik23 ($43.99 in chips) 
Seat 2: ka100pka527 ($81.25 in chips) 
Seat 3: Painkiller72 ($100 in chips) 
Seat 4: Merida900 ($86.39 in chips) 
Seat 5: Harbinger X ($96.73 in chips) 
Seat 6: I The King I ($100 in chips) 
Seat 7: Ilov3NBA ($100 in chips) 
Seat 9: matiko09 ($145.03 in chips) 
matiko09: posts small blind $0.50
cobrik23: posts big blind $1
*** HOLE CARDS ***
Dealt to matiko09 [2h 9d]
ka100pka527: folds 
Painkiller72: folds 
Merida900: folds 
Harbinger X: raises $2 to $3
I The King I: folds 
Ilov3NBA: raises $6.50 to $9.50
matiko09: folds 
cobrik23: folds 
Harbinger X: folds 
Uncalled bet ($6.50) returned to Ilov3NBA
Ilov3NBA collected $7.50 from pot
Ilov3NBA: doesn't show hand 
*** SUMMARY ***
Total pot $7.50 | Rake $0 
Seat 1: cobrik23 (big blind) folded before Flop
Seat 2: ka100pka527 folded before Flop (didn't bet)
Seat 3: Painkiller72 folded before Flop (didn't bet)
Seat 4: Merida900 folded before Flop (didn't bet)
Seat 5: Harbinger X folded before Flop
Seat 6: I The King I folded before Flop (didn't bet)
Seat 7: Ilov3NBA (button) collected ($7.50)
Seat 9: matiko09 (small blind) folded before Flop





PokerStars Hand #150751782688:  Hold'em No Limit ($0.50/$1.00 USD) - 2016/03/22 14:07:26 CET [2016/03/22 9:07:26 ET]
Table 'Colchis' 9-max Seat #8 is the button
Seat 1: theluckyjoe ($19.82 in chips) 
Seat 3: bragutza ($50.89 in chips) 
Seat 4: matiko09 ($103.07 in chips) 
Seat 5: lumen21 ($159.94 in chips) 
Seat 6: Avtovo ($100.89 in chips) 
Seat 8: cobrik23 ($39.50 in chips) 
Seat 9: ardo888 ($101.73 in chips) 
ardo888: posts small blind $0.50
theluckyjoe: posts big blind $1
Ilov3NBA: sits out 
Dantist1122: sits out 
*** HOLE CARDS ***
Dealt to matiko09 [Ks 6s]
bragutza: folds 
matiko09: folds 
lumen21: folds 
Avtovo: raises $1.50 to $2.50
cobrik23: folds 
ardo888: folds 
theluckyjoe: calls $1.50
*** FLOP *** [3s Ah As]
theluckyjoe: checks 
Avtovo: checks 
*** TURN *** [3s Ah As] [Td]
theluckyjoe: checks 
Avtovo: checks 
*** RIVER *** [3s Ah As Td] [6d]
theluckyjoe: checks 
Avtovo: checks 
*** SHOW DOWN ***
theluckyjoe: shows [Qc Kh] (a pair of Aces)
Avtovo: shows [5d 5h] (two pair, Aces and Fives)
Avtovo collected $5.25 from pot
*** SUMMARY ***
Total pot $5.50 | Rake $0.25 
Board [3s Ah As Td 6d]
Seat 1: theluckyjoe (big blind) showed [Qc Kh] and lost with a pair of Aces
Seat 3: bragutza folded before Flop (didn't bet)
Seat 4: matiko09 folded before Flop (didn't bet)
Seat 5: lumen21 folded before Flop (didn't bet)
Seat 6: Avtovo showed [5d 5h] and won ($5.25) with two pair, Aces and Fives
Seat 8: cobrik23 (button) folded before Flop (didn't bet)
Seat 9: ardo888 (small blind) folded before Flop





PokerStars Hand #150751785390:  Hold'em No Limit ($0.50/$1.00 USD) - 2016/03/22 14:07:31 CET [2016/03/22 9:07:31 ET]
Table 'Harding' 9-max Seat #7 is the button
Seat 1: matiko09 ($109.76 in chips) 
Seat 2: I The King I ($141.68 in chips) 
Seat 3: Avtovo ($100 in chips) 
Seat 4: lixiangli ($108.51 in chips) 
Seat 5: DevilisHEyz ($138.24 in chips) 
Seat 6: Ilov3NBA ($100 in chips) 
Seat 7: mrhighryza ($113.86 in chips) 
omorfadramou will be allowed to play after the button
matiko09: posts small blind $0.50
I The King I: posts big blind $1
*** HOLE CARDS ***
Dealt to matiko09 [2c 6h]
Avtovo: folds 
lixiangli: folds 
DevilisHEyz: folds 
Ilov3NBA: folds 
mrhighryza: calls $1
matiko09: folds 
I The King I: checks 
*** FLOP *** [2h 8c Kh]
I The King I: checks 
mrhighryza: checks 
*** TURN *** [2h 8c Kh] [4s]
I The King I: checks 
mrhighryza: checks 
*** RIVER *** [2h 8c Kh 4s] [Th]
I The King I: checks 
mrhighryza: checks 
*** SHOW DOWN ***
I The King I: shows [7h Js] (high card King)
mrhighryza: shows [3d 2d] (a pair of Deuces)
mrhighryza collected $2.39 from pot
*** SUMMARY ***
Total pot $2.50 | Rake $0.11 
Board [2h 8c Kh 4s Th]
Seat 1: matiko09 (small blind) folded before Flop
Seat 2: I The King I (big blind) showed [7h Js] and lost with high card King
Seat 3: Avtovo folded before Flop (didn't bet)
Seat 4: lixiangli folded before Flop (didn't bet)
Seat 5: DevilisHEyz folded before Flop (didn't bet)
Seat 6: Ilov3NBA folded before Flop (didn't bet)
Seat 7: mrhighryza (button) showed [3d 2d] and won ($2.39) with a pair of Deuces





PokerStars Hand #150751790705:  Hold'em No Limit ($0.50/$1.00 USD) - 2016/03/22 14:07:40 CET [2016/03/22 9:07:40 ET]
Table 'Crater II' 9-max Seat #8 is the button
Seat 1: matiko09 ($100 in chips) 
Seat 2: Eisbaerli85 ($122.67 in chips) 
Seat 3: lixiangli ($105.05 in chips) 
Seat 5: Avtovo ($102.75 in chips) 
Seat 6: Kobiroga150 ($50 in chips) 
Seat 7: AWATAR 21 ($73 in chips) 
Seat 8: KronosAK ($100 in chips) 
Seat 9: I The King I ($128.20 in chips) 
I The King I: posts small blind $0.50
matiko09: posts big blind $1
Kobiroga150: posts big blind $1
*** HOLE CARDS ***
Dealt to matiko09 [Ac 6d]
Eisbaerli85: folds 
lixiangli: folds 
Avtovo: folds 
Kobiroga150: checks 
AWATAR 21: calls $1
KronosAK: raises $3.50 to $4.50
I The King I: folds 
matiko09: folds 
Kobiroga150: folds 
AWATAR 21: folds 
Uncalled bet ($3.50) returned to KronosAK
KronosAK collected $4.50 from pot
KronosAK: doesn't show hand 
*** SUMMARY ***
Total pot $4.50 | Rake $0 
Seat 1: matiko09 (big blind) folded before Flop
Seat 2: Eisbaerli85 folded before Flop (didn't bet)
Seat 3: lixiangli folded before Flop (didn't bet)
Seat 5: Avtovo folded before Flop (didn't bet)
Seat 6: Kobiroga150 folded before Flop
Seat 7: AWATAR 21 folded before Flop
Seat 8: KronosAK (button) collected ($4.50)
Seat 9: I The King I (small blind) folded before Flop





PokerStars Hand #150751794525:  Hold'em No Limit ($0.50/$1.00 USD) - 2016/03/22 14:07:46 CET [2016/03/22 9:07:46 ET]
Table 'Stephano II' 9-max Seat #6 is the button
Seat 1: ardo888 ($101.50 in chips) 
Seat 2: buckshot150 ($76.70 in chips) 
Seat 4: AWATAR 21 ($138.70 in chips) 
Seat 5: mb2part ($100 in chips) 
Seat 6: kotan05 ($39.21 in chips) 
Seat 7: ilaviiitech ($100 in chips) 
Seat 8: Painkiller72 ($100 in chips) 
Seat 9: matiko09 ($100 in chips) 
ilaviiitech: posts small blind $0.50
Painkiller72: posts big blind $1
lombardo11: sits out 
*** HOLE CARDS ***
Dealt to matiko09 [Jd 7d]
matiko09: folds 
ardo888: folds 
buckshot150: folds 
AWATAR 21: raises $1 to $2
mb2part: folds 
kotan05: folds 
ilaviiitech: folds 
Painkiller72: folds 
Uncalled bet ($1) returned to AWATAR 21
AWATAR 21 collected $2.50 from pot
*** SUMMARY ***
Total pot $2.50 | Rake $0 
Seat 1: ardo888 folded before Flop (didn't bet)
Seat 2: buckshot150 folded before Flop (didn't bet)
Seat 4: AWATAR 21 collected ($2.50)
Seat 5: mb2part folded before Flop (didn't bet)
Seat 6: kotan05 (button) folded before Flop (didn't bet)
Seat 7: ilaviiitech (small blind) folded before Flop
Seat 8: Painkiller72 (big blind) folded before Flop
Seat 9: matiko09 folded before Flop (didn't bet)





PokerStars Hand #150751805244:  Hold'em No Limit ($0.50/$1.00 USD) - 2016/03/22 14:08:05 CET [2016/03/22 9:08:05 ET]
Table 'Arabis' 9-max Seat #3 is the button
Seat 1: Chiddy83 ($45.45 in chips) 
Seat 2: ilaviiitech ($114.81 in chips) 
Seat 3: myatiy 96 ($100 in chips) 
Seat 4: Painkiller72 ($128.67 in chips) 
Seat 5: matiko09 ($100 in chips) 
Seat 6: I The King I ($100 in chips) 
Seat 7: howsiao ($70.09 in chips) 
Seat 8: Bro_Happy ($187.39 in chips) 
Seat 9: cobrik23 ($84.20 in chips) 
Painkiller72: posts small blind $0.50
matiko09: posts big blind $1
*** HOLE CARDS ***
Dealt to matiko09 [5d 8d]
I The King I: raises $2 to $3
howsiao: calls $3
Bro_Happy: folds 
cobrik23: folds 
Chiddy83: calls $3
ilaviiitech: calls $3
myatiy 96: folds 
Painkiller72: folds 
matiko09: folds 
*** FLOP *** [8h 6c Qs]
I The King I: checks 
howsiao: checks 
Chiddy83: checks 
ilaviiitech: checks 
*** TURN *** [8h 6c Qs] [9h]
I The King I: bets $9
howsiao: calls $9
Chiddy83: raises $12 to $21
ilaviiitech: calls $21
I The King I: calls $12
howsiao: calls $12
*** RIVER *** [8h 6c Qs 9h] [6d]
I The King I: checks 
howsiao: checks 
Chiddy83: bets $21.45 and is all-in
ilaviiitech: raises $69.36 to $90.81 and is all-in
I The King I: folds 
howsiao: calls $46.09 and is all-in
Uncalled bet ($44.72) returned to ilaviiitech
*** SHOW DOWN ***
ilaviiitech: shows [9c 9s] (a full house, Nines full of Sixes)
howsiao: shows [Qh Qc] (a full house, Queens full of Sixes)
howsiao collected $49.28 from side pot
Chiddy83: shows [Js Ts] (a straight, Eight to Queen)
howsiao collected $159.05 from main pot
*** SUMMARY ***
Total pot $211.13 Main pot $159.05. Side pot $49.28. | Rake $2.80 
Board [8h 6c Qs 9h 6d]
Seat 1: Chiddy83 showed [Js Ts] and lost with a straight, Eight to Queen
Seat 2: ilaviiitech showed [9c 9s] and lost with a full house, Nines full of Sixes
Seat 3: myatiy 96 (button) folded before Flop (didn't bet)
Seat 4: Painkiller72 (small blind) folded before Flop
Seat 5: matiko09 (big blind) folded before Flop
Seat 6: I The King I folded on the River
Seat 7: howsiao showed [Qh Qc] and won ($208.33) with a full house, Queens full of Sixes
Seat 8: Bro_Happy folded before Flop (didn't bet)
Seat 9: cobrik23 folded before Flop (didn't bet)





PokerStars Hand #150751806757:  Hold'em No Limit ($0.50/$1.00 USD) - 2016/03/22 14:08:08 CET [2016/03/22 9:08:08 ET]
Table 'Stephano II' 9-max Seat #7 is the button
Seat 1: ardo888 ($101.50 in chips) 
Seat 2: buckshot150 ($76.70 in chips) 
Seat 4: AWATAR 21 ($140.20 in chips) 
Seat 5: mb2part ($100 in chips) 
Seat 6: kotan05 ($39.21 in chips) 
Seat 7: ilaviiitech ($100 in chips) 
Seat 8: Painkiller72 ($100 in chips) 
Seat 9: matiko09 ($100 in chips) 
Painkiller72: posts small blind $0.50
matiko09: posts big blind $1
lombardo11: sits out 
*** HOLE CARDS ***
Dealt to matiko09 [Ts Qs]
ardo888: folds 
buckshot150: folds 
AWATAR 21: folds 
mb2part: folds 
kotan05: folds 
ilaviiitech: raises $2 to $3
Painkiller72: folds 
matiko09: calls $2
*** FLOP *** [7c Th 6c]
matiko09: checks 
ilaviiitech: checks 
*** TURN *** [7c Th 6c] [4c]
matiko09: bets $5.03
ilaviiitech: calls $5.03
*** RIVER *** [7c Th 6c 4c] [2s]
matiko09: bets $13
ilaviiitech: folds 
Uncalled bet ($13) returned to matiko09
matiko09 collected $15.81 from pot
matiko09: doesn't show hand 
*** SUMMARY ***
Total pot $16.56 | Rake $0.75 
Board [7c Th 6c 4c 2s]
Seat 1: ardo888 folded before Flop (didn't bet)
Seat 2: buckshot150 folded before Flop (didn't bet)
Seat 4: AWATAR 21 folded before Flop (didn't bet)
Seat 5: mb2part folded before Flop (didn't bet)
Seat 6: kotan05 folded before Flop (didn't bet)
Seat 7: ilaviiitech (button) folded on the River
Seat 8: Painkiller72 (small blind) folded before Flop
Seat 9: matiko09 (big blind) collected ($15.81)





PokerStars Hand #150751806703:  Hold'em No Limit ($0.50/$1.00 USD) - 2016/03/22 14:08:08 CET [2016/03/22 9:08:08 ET]
Table 'Saturn III' 9-max Seat #9 is the button
Seat 1: cobrik23 ($42.99 in chips) 
Seat 3: Painkiller72 ($100 in chips) 
Seat 4: Merida900 ($86.39 in chips) 
Seat 5: Harbinger X ($93.73 in chips) 
Seat 6: I The King I ($100 in chips) 
Seat 7: Ilov3NBA ($104.50 in chips) 
Seat 9: matiko09 ($144.53 in chips) 
cobrik23: posts small blind $0.50
ka100pka527: is sitting out 
ka100pka527 leaves the table
Painkiller72: posts big blind $1
*** HOLE CARDS ***
Dealt to matiko09 [5h 6s]
myatiy 96 joins the table at seat #2 
myatiy 96 leaves the table
Merida900: folds 
Harbinger X: folds 
I The King I: folds 
Ilov3NBA: folds 
matiko09: folds 
cobrik23: raises $1.50 to $2.50
Painkiller72: calls $1.50
*** FLOP *** [7h 6d Th]
cobrik23: bets $2.39
Painkiller72: folds 
Uncalled bet ($2.39) returned to cobrik23
cobrik23 collected $4.78 from pot
cobrik23: doesn't show hand 
*** SUMMARY ***
Total pot $5 | Rake $0.22 
Board [7h 6d Th]
Seat 1: cobrik23 (small blind) collected ($4.78)
Seat 3: Painkiller72 (big blind) folded on the Flop
Seat 4: Merida900 folded before Flop (didn't bet)
Seat 5: Harbinger X folded before Flop (didn't bet)
Seat 6: I The King I folded before Flop (didn't bet)
Seat 7: Ilov3NBA folded before Flop (didn't bet)
Seat 9: matiko09 (button) folded before Flop (didn't bet)





PokerStars Hand #150751810844:  Hold'em No Limit ($0.50/$1.00 USD) - 2016/03/22 14:08:14 CET [2016/03/22 9:08:14 ET]
Table 'Harding' 9-max Seat #1 is the button
Seat 1: matiko09 ($109.26 in chips) 
Seat 2: I The King I ($140.68 in chips) 
Seat 3: Avtovo ($100 in chips) 
Seat 4: lixiangli ($108.51 in chips) 
Seat 5: DevilisHEyz ($138.24 in chips) 
Seat 6: Ilov3NBA ($100 in chips) 
Seat 7: mrhighryza ($115.25 in chips) 
I The King I: posts small blind $0.50
Avtovo: posts big blind $1
omorfadramou: sits out 
*** HOLE CARDS ***
Dealt to matiko09 [4h Tc]
lixiangli: folds 
DevilisHEyz has timed out
DevilisHEyz: folds 
Ilov3NBA: folds 
mrhighryza: calls $1
matiko09: folds 
I The King I: folds 
Avtovo: checks 
*** FLOP *** [6c 7d Kd]
Avtovo: checks 
mrhighryza: bets $3
Avtovo: folds 
Uncalled bet ($3) returned to mrhighryza
mrhighryza collected $2.39 from pot
*** SUMMARY ***
Total pot $2.50 | Rake $0.11 
Board [6c 7d Kd]
Seat 1: matiko09 (button) folded before Flop (didn't bet)
Seat 2: I The King I (small blind) folded before Flop
Seat 3: Avtovo (big blind) folded on the Flop
Seat 4: lixiangli folded before Flop (didn't bet)
Seat 5: DevilisHEyz folded before Flop (didn't bet)
Seat 6: Ilov3NBA folded before Flop (didn't bet)
Seat 7: mrhighryza collected ($2.39)





PokerStars Hand #150751820137:  Hold'em No Limit ($0.50/$1.00 USD) - 2016/03/22 14:08:30 CET [2016/03/22 9:08:30 ET]
Table 'Colchis' 9-max Seat #9 is the button
Seat 1: theluckyjoe ($17.32 in chips) 
Seat 2: Ilov3NBA ($100 in chips) 
Seat 3: bragutza ($50.89 in chips) 
Seat 4: matiko09 ($103.07 in chips) 
Seat 5: lumen21 ($159.94 in chips) 
Seat 6: Avtovo ($103.64 in chips) 
Seat 8: cobrik23 ($39.50 in chips) 
Seat 9: ardo888 ($101.23 in chips) 
theluckyjoe: posts small blind $0.50
Ilov3NBA: posts big blind $1
Dantist1122: sits out 
*** HOLE CARDS ***
Dealt to matiko09 [5c Ks]
bragutza: raises $1 to $2
matiko09: folds 
lumen21: folds 
Avtovo: folds 
cobrik23: folds 
ardo888: folds 
theluckyjoe: folds 
Ilov3NBA: folds 
Uncalled bet ($1) returned to bragutza
bragutza collected $2.50 from pot
bragutza: doesn't show hand 
*** SUMMARY ***
Total pot $2.50 | Rake $0 
Seat 1: theluckyjoe (small blind) folded before Flop
Seat 2: Ilov3NBA (big blind) folded before Flop
Seat 3: bragutza collected ($2.50)
Seat 4: matiko09 folded before Flop (didn't bet)
Seat 5: lumen21 folded before Flop (didn't bet)
Seat 6: Avtovo folded before Flop (didn't bet)
Seat 8: cobrik23 folded before Flop (didn't bet)
Seat 9: ardo888 (button) folded before Flop (didn't bet)





PokerStars Hand #150751832217:  Hold'em No Limit ($0.50/$1.00 USD) - 2016/03/22 14:08:51 CET [2016/03/22 9:08:51 ET]
Table 'Crater II' 9-max Seat #9 is the button
Seat 1: matiko09 ($100 in chips) 
Seat 2: Eisbaerli85 ($122.67 in chips) 
Seat 3: lixiangli ($105.05 in chips) 
Seat 5: Avtovo ($102.75 in chips) 
Seat 6: Kobiroga150 ($49 in chips) 
Seat 7: AWATAR 21 ($72 in chips) 
Seat 8: KronosAK ($103.50 in chips) 
Seat 9: I The King I ($127.70 in chips) 
matiko09: posts small blind $0.50
Eisbaerli85: posts big blind $1
*** HOLE CARDS ***
Dealt to matiko09 [Qc Kc]
lixiangli: folds 
Avtovo: raises $1.50 to $2.50
Kobiroga150: folds 
AWATAR 21: calls $2.50
KronosAK: raises $6.25 to $8.75
I The King I: folds 
matiko09: folds 
Eisbaerli85: folds 
Avtovo: folds 
AWATAR 21: calls $6.25
*** FLOP *** [2h 7c 5c]
AWATAR 21: checks 
KronosAK: bets $9
AWATAR 21: folds 
Uncalled bet ($9) returned to KronosAK
KronosAK collected $20.53 from pot
KronosAK: doesn't show hand 
*** SUMMARY ***
Total pot $21.50 | Rake $0.97 
Board [2h 7c 5c]
Seat 1: matiko09 (small blind) folded before Flop
Seat 2: Eisbaerli85 (big blind) folded before Flop
Seat 3: lixiangli folded before Flop (didn't bet)
Seat 5: Avtovo folded before Flop
Seat 6: Kobiroga150 folded before Flop (didn't bet)
Seat 7: AWATAR 21 folded on the Flop
Seat 8: KronosAK collected ($20.53)
Seat 9: I The King I (button) folded before Flop (didn't bet)





PokerStars Hand #150751840872:  Hold'em No Limit ($0.50/$1.00 USD) - 2016/03/22 14:09:05 CET [2016/03/22 9:09:05 ET]
Table 'Stephano II' 9-max Seat #8 is the button
Seat 1: ardo888 ($101.50 in chips) 
Seat 2: buckshot150 ($76.70 in chips) 
Seat 4: AWATAR 21 ($140.20 in chips) 
Seat 5: mb2part ($100 in chips) 
Seat 6: kotan05 ($39.21 in chips) 
Seat 7: ilaviiitech ($100 in chips) 
Seat 8: Painkiller72 ($100 in chips) 
Seat 9: matiko09 ($107.78 in chips) 
matiko09: posts small blind $0.50
ardo888: posts big blind $1
lombardo11: sits out 
*** HOLE CARDS ***
Dealt to matiko09 [Ks Kd]
buckshot150: folds 
AWATAR 21: raises $1 to $2
mb2part: folds 
kotan05: raises $1 to $3
ilaviiitech: folds 
Painkiller72: folds 
matiko09: raises $8 to $11
ardo888: folds 
AWATAR 21: folds 
kotan05: calls $8
*** FLOP *** [3s Qh Th]
matiko09: bets $12
kotan05: raises $16.21 to $28.21 and is all-in
matiko09: calls $16.21
*** TURN *** [3s Qh Th] [5c]
*** RIVER *** [3s Qh Th 5c] [5h]
*** SHOW DOWN ***
matiko09: shows [Ks Kd] (two pair, Kings and Fives)
kotan05: mucks hand 
matiko09 collected $78.62 from pot
*** SUMMARY ***
Total pot $81.42 | Rake $2.80 
Board [3s Qh Th 5c 5h]
Seat 1: ardo888 (big blind) folded before Flop
Seat 2: buckshot150 folded before Flop (didn't bet)
Seat 4: AWATAR 21 folded before Flop
Seat 5: mb2part folded before Flop (didn't bet)
Seat 6: kotan05 mucked [Kc Td]
Seat 7: ilaviiitech folded before Flop (didn't bet)
Seat 8: Painkiller72 (button) folded before Flop (didn't bet)
Seat 9: matiko09 (small blind) showed [Ks Kd] and won ($78.62) with two pair, Kings and Fives





PokerStars Hand #150751842356:  Hold'em No Limit ($0.50/$1.00 USD) - 2016/03/22 14:09:08 CET [2016/03/22 9:09:08 ET]
Table 'Saturn III' 9-max Seat #1 is the button
Seat 1: cobrik23 ($85.27 in chips) 
Seat 3: Painkiller72 ($100 in chips) 
Seat 5: Harbinger X ($93.73 in chips) 
Seat 6: I The King I ($100 in chips) 
Seat 7: Ilov3NBA ($104.50 in chips) 
Seat 9: matiko09 ($144.53 in chips) 
Painkiller72: posts small blind $0.50
Merida900: is sitting out 
Harbinger X: posts big blind $1
*** HOLE CARDS ***
Dealt to matiko09 [5h Ad]
Muinmyheart joins the table at seat #2 
I The King I: folds 
Ilov3NBA: folds 
matiko09: folds 
cobrik23: folds 
Painkiller72: raises $2 to $3
Harbinger X: calls $2
*** FLOP *** [Tc 3h Ks]
Painkiller72: checks 
Harbinger X: bets $5
Painkiller72: folds 
Uncalled bet ($5) returned to Harbinger X
Harbinger X collected $5.73 from pot
Harbinger X: doesn't show hand 
*** SUMMARY ***
Total pot $6 | Rake $0.27 
Board [Tc 3h Ks]
Seat 1: cobrik23 (button) folded before Flop (didn't bet)
Seat 3: Painkiller72 (small blind) folded on the Flop
Seat 5: Harbinger X (big blind) collected ($5.73)
Seat 6: I The King I folded before Flop (didn't bet)
Seat 7: Ilov3NBA folded before Flop (didn't bet)
Seat 9: matiko09 folded before Flop (didn't bet)





PokerStars Hand #150751845556:  Hold'em No Limit ($0.50/$1.00 USD) - 2016/03/22 14:09:13 CET [2016/03/22 9:09:13 ET]
Table 'Colchis' 9-max Seat #1 is the button
Seat 1: theluckyjoe ($16.82 in chips) 
Seat 2: Ilov3NBA ($100 in chips) 
Seat 3: bragutza ($52.39 in chips) 
Seat 4: matiko09 ($103.07 in chips) 
Seat 5: lumen21 ($159.94 in chips) 
Seat 6: Avtovo ($103.64 in chips) 
Seat 8: cobrik23 ($39.50 in chips) 
Seat 9: ardo888 ($101.23 in chips) 
Ilov3NBA: posts small blind $0.50
bragutza: posts big blind $1
Dantist1122: sits out 
*** HOLE CARDS ***
Dealt to matiko09 [Js 8s]
matiko09: folds 
lumen21: folds 
Avtovo: folds 
cobrik23: folds 
ardo888: raises $1.50 to $2.50
theluckyjoe: folds 
Ilov3NBA: folds 
bragutza: folds 
Uncalled bet ($1.50) returned to ardo888
ardo888 collected $2.50 from pot
ardo888: doesn't show hand 
*** SUMMARY ***
Total pot $2.50 | Rake $0 
Seat 1: theluckyjoe (button) folded before Flop (didn't bet)
Seat 2: Ilov3NBA (small blind) folded before Flop
Seat 3: bragutza (big blind) folded before Flop
Seat 4: matiko09 folded before Flop (didn't bet)
Seat 5: lumen21 folded before Flop (didn't bet)
Seat 6: Avtovo folded before Flop (didn't bet)
Seat 8: cobrik23 folded before Flop (didn't bet)
Seat 9: ardo888 collected ($2.50)





PokerStars Hand #150751847118:  Hold'em No Limit ($0.50/$1.00 USD) - 2016/03/22 14:09:16 CET [2016/03/22 9:09:16 ET]
Table 'Harding' 9-max Seat #2 is the button
Seat 1: matiko09 ($109.26 in chips) 
Seat 2: I The King I ($140.18 in chips) 
Seat 3: Avtovo ($100 in chips) 
Seat 4: lixiangli ($108.51 in chips) 
Seat 5: DevilisHEyz ($138.24 in chips) 
Seat 6: Ilov3NBA ($100 in chips) 
Seat 7: mrhighryza ($116.64 in chips) 
Avtovo: posts small blind $0.50
lixiangli: posts big blind $1
omorfadramou: sits out 
*** HOLE CARDS ***
Dealt to matiko09 [Ks 3c]
DevilisHEyz: folds 
Ilov3NBA: folds 
mrhighryza: calls $1
matiko09: folds 
I The King I: folds 
Avtovo: folds 
lixiangli: checks 
*** FLOP *** [Kd Qs Ac]
lixiangli: checks 
mrhighryza: checks 
*** TURN *** [Kd Qs Ac] [9d]
lixiangli: bets $1
mrhighryza: raises $2 to $3
lixiangli: calls $2
*** RIVER *** [Kd Qs Ac 9d] [6h]
lixiangli: checks 
mrhighryza: checks 
*** SHOW DOWN ***
lixiangli: shows [Qd 7d] (a pair of Queens)
mrhighryza: mucks hand 
lixiangli collected $8.12 from pot
*** SUMMARY ***
Total pot $8.50 | Rake $0.38 
Board [Kd Qs Ac 9d 6h]
Seat 1: matiko09 folded before Flop (didn't bet)
Seat 2: I The King I (button) folded before Flop (didn't bet)
Seat 3: Avtovo (small blind) folded before Flop
Seat 4: lixiangli (big blind) showed [Qd 7d] and won ($8.12) with a pair of Queens
Seat 5: DevilisHEyz folded before Flop (didn't bet)
Seat 6: Ilov3NBA folded before Flop (didn't bet)
Seat 7: mrhighryza mucked [4c 5c]





PokerStars Hand #150751853854:  Hold'em No Limit ($0.50/$1.00 USD) - 2016/03/22 14:09:27 CET [2016/03/22 9:09:27 ET]
Table 'Taygeta II' 9-max Seat #3 is the button
Seat 1: DevilisHEyz ($95.20 in chips) 
Seat 2: khan Erkesh ($189.12 in chips) 
Seat 3: Muinmyheart ($100 in chips) 
Seat 4: matiko09 ($100 in chips) 
Seat 5: RICKA16 ($102.50 in chips) 
Seat 6: I The King I ($100 in chips) 
Seat 8: Avtovo ($102.50 in chips) 
Seat 9: cobrik23 ($49.31 in chips) 
matiko09: posts small blind $0.50
RICKA16: posts big blind $1
Szevasztopol: sits out 
*** HOLE CARDS ***
Dealt to matiko09 [5d 9c]
I The King I: folds 
Avtovo: raises $1.50 to $2.50
cobrik23: folds 
DevilisHEyz: folds 
khan Erkesh: folds 
Muinmyheart: folds 
matiko09: folds 
RICKA16: folds 
Uncalled bet ($1.50) returned to Avtovo
Avtovo collected $2.50 from pot
Avtovo: doesn't show hand 
*** SUMMARY ***
Total pot $2.50 | Rake $0 
Seat 1: DevilisHEyz folded before Flop (didn't bet)
Seat 2: khan Erkesh folded before Flop (didn't bet)
Seat 3: Muinmyheart (button) folded before Flop (didn't bet)
Seat 4: matiko09 (small blind) folded before Flop
Seat 5: RICKA16 (big blind) folded before Flop
Seat 6: I The King I folded before Flop (didn't bet)
Seat 8: Avtovo collected ($2.50)
Seat 9: cobrik23 folded before Flop (didn't bet)





PokerStars Hand #150751862048:  Hold'em No Limit ($0.50/$1.00 USD) - 2016/03/22 14:09:41 CET [2016/03/22 9:09:41 ET]
Table 'Crater II' 9-max Seat #1 is the button
Seat 1: matiko09 ($100 in chips) 
Seat 2: Eisbaerli85 ($121.67 in chips) 
Seat 3: lixiangli ($105.05 in chips) 
Seat 5: Avtovo ($100.25 in chips) 
Seat 6: Kobiroga150 ($49 in chips) 
Seat 7: AWATAR 21 ($63.25 in chips) 
Seat 8: KronosAK ($115.28 in chips) 
Seat 9: I The King I ($127.70 in chips) 
Eisbaerli85: posts small blind $0.50
lixiangli: posts big blind $1
*** HOLE CARDS ***
Dealt to matiko09 [Jd 5s]
Avtovo: raises $1.50 to $2.50
Kobiroga150: folds 
AWATAR 21: folds 
KronosAK: folds 
I The King I: raises $6.50 to $9
matiko09: folds 
Eisbaerli85: folds 
lixiangli: folds 
Avtovo: raises $13 to $22
I The King I: folds 
Uncalled bet ($13) returned to Avtovo
Avtovo collected $19.50 from pot
Avtovo: doesn't show hand 
*** SUMMARY ***
Total pot $19.50 | Rake $0 
Seat 1: matiko09 (button) folded before Flop (didn't bet)
Seat 2: Eisbaerli85 (small blind) folded before Flop
Seat 3: lixiangli (big blind) folded before Flop
Seat 5: Avtovo collected ($19.50)
Seat 6: Kobiroga150 folded before Flop (didn't bet)
Seat 7: AWATAR 21 folded before Flop (didn't bet)
Seat 8: KronosAK folded before Flop (didn't bet)
Seat 9: I The King I folded before Flop





PokerStars Hand #150751866804:  Hold'em No Limit ($0.50/$1.00 USD) - 2016/03/22 14:09:49 CET [2016/03/22 9:09:49 ET]
Table 'Colchis' 9-max Seat #2 is the button
Seat 1: theluckyjoe ($16.82 in chips) 
Seat 2: Ilov3NBA ($100 in chips) 
Seat 3: bragutza ($51.39 in chips) 
Seat 4: matiko09 ($103.07 in chips) 
Seat 5: lumen21 ($159.94 in chips) 
Seat 6: Avtovo ($103.64 in chips) 
Seat 8: cobrik23 ($39.50 in chips) 
Seat 9: ardo888 ($102.73 in chips) 
bragutza: posts small blind $0.50
matiko09: posts big blind $1
Dantist1122: sits out 
*** HOLE CARDS ***
Dealt to matiko09 [6d 8c]
lumen21: folds 
Avtovo: folds 
cobrik23: raises $2 to $3
ardo888: folds 
theluckyjoe: folds 
Ilov3NBA: folds 
bragutza: folds 
matiko09: folds 
Uncalled bet ($2) returned to cobrik23
cobrik23 collected $2.50 from pot
cobrik23: doesn't show hand 
*** SUMMARY ***
Total pot $2.50 | Rake $0 
Seat 1: theluckyjoe folded before Flop (didn't bet)
Seat 2: Ilov3NBA (button) folded before Flop (didn't bet)
Seat 3: bragutza (small blind) folded before Flop
Seat 4: matiko09 (big blind) folded before Flop
Seat 5: lumen21 folded before Flop (didn't bet)
Seat 6: Avtovo folded before Flop (didn't bet)
Seat 8: cobrik23 collected ($2.50)
Seat 9: ardo888 folded before Flop (didn't bet)





PokerStars Hand #150751868604:  Hold'em No Limit ($0.50/$1.00 USD) - 2016/03/22 14:09:52 CET [2016/03/22 9:09:52 ET]
Table 'Stephano II' 9-max Seat #9 is the button
Seat 1: ardo888 ($100.50 in chips) 
Seat 2: buckshot150 ($76.70 in chips) 
Seat 4: AWATAR 21 ($138.20 in chips) 
Seat 5: mb2part ($100 in chips) 
Seat 7: ilaviiitech ($100 in chips) 
Seat 8: Painkiller72 ($100 in chips) 
Seat 9: matiko09 ($147.19 in chips) 
ardo888: posts small blind $0.50
buckshot150: posts big blind $1
lombardo11: sits out 
*** HOLE CARDS ***
Dealt to matiko09 [6s Th]
kotan05 leaves the table
edidaz joins the table at seat #6 
edidaz leaves the table
AWATAR 21: folds 
mb2part: folds 
ilaviiitech: folds 
myatiy 96 joins the table at seat #6 
myatiy 96 leaves the table
Muinmyheart joins the table at seat #6 
Painkiller72: raises $1.50 to $2.50
matiko09: folds 
ardo888: folds 
buckshot150: calls $1.50
*** FLOP *** [4c 3s 5s]
buckshot150: checks 
Painkiller72: checks 
*** TURN *** [4c 3s 5s] [3c]
buckshot150: checks 
Painkiller72: checks 
*** RIVER *** [4c 3s 5s 3c] [Qc]
buckshot150: checks 
Painkiller72: checks 
*** SHOW DOWN ***
buckshot150: shows [Js 8s] (a pair of Threes)
Painkiller72: shows [Kd Ah] (a pair of Threes - Ace kicker)
Painkiller72 collected $5.25 from pot
*** SUMMARY ***
Total pot $5.50 | Rake $0.25 
Board [4c 3s 5s 3c Qc]
Seat 1: ardo888 (small blind) folded before Flop
Seat 2: buckshot150 (big blind) showed [Js 8s] and lost with a pair of Threes
Seat 4: AWATAR 21 folded before Flop (didn't bet)
Seat 5: mb2part folded before Flop (didn't bet)
Seat 7: ilaviiitech folded before Flop (didn't bet)
Seat 8: Painkiller72 showed [Kd Ah] and won ($5.25) with a pair of Threes
Seat 9: matiko09 (button) folded before Flop (didn't bet)





PokerStars Hand #150751868271:  Hold'em No Limit ($0.50/$1.00 USD) - 2016/03/22 14:09:52 CET [2016/03/22 9:09:52 ET]
Table 'Saturn III' 9-max Seat #3 is the button
Seat 1: cobrik23 ($85.27 in chips) 
Seat 3: Painkiller72 ($100 in chips) 
Seat 5: Harbinger X ($96.46 in chips) 
Seat 6: I The King I ($100 in chips) 
Seat 7: Ilov3NBA ($104.50 in chips) 
Seat 9: matiko09 ($144.53 in chips) 
Harbinger X: posts small blind $0.50
I The King I: posts big blind $1
Muinmyheart: sits out 
*** HOLE CARDS ***
Dealt to matiko09 [4s 9s]
Ilov3NBA: folds 
matiko09: folds 
cobrik23: folds 
Painkiller72: raises $1 to $2
Harbinger X: folds 
I The King I: raises $5 to $7
Painkiller72: folds 
Uncalled bet ($5) returned to I The King I
I The King I collected $4.50 from pot
I The King I: doesn't show hand 
*** SUMMARY ***
Total pot $4.50 | Rake $0 
Seat 1: cobrik23 folded before Flop (didn't bet)
Seat 3: Painkiller72 (button) folded before Flop
Seat 5: Harbinger X (small blind) folded before Flop
Seat 6: I The King I (big blind) collected ($4.50)
Seat 7: Ilov3NBA folded before Flop (didn't bet)
Seat 9: matiko09 folded before Flop (didn't bet)





PokerStars Hand #150751870403:  Hold'em No Limit ($0.50/$1.00 USD) - 2016/03/22 14:09:55 CET [2016/03/22 9:09:55 ET]
Table 'Arabis' 9-max Seat #4 is the button
Seat 2: ilaviiitech ($100 in chips) 
Seat 3: myatiy 96 ($100 in chips) 
Seat 4: Painkiller72 ($128.17 in chips) 
Seat 5: matiko09 ($100 in chips) 
Seat 6: I The King I ($100 in chips) 
Seat 7: howsiao ($208.33 in chips) 
Seat 8: Bro_Happy ($187.39 in chips) 
Seat 9: cobrik23 ($84.20 in chips) 
matiko09: posts small blind $0.50
I The King I: posts big blind $1
*** HOLE CARDS ***
Dealt to matiko09 [9c 6h]
howsiao: folds 
Bro_Happy: folds 
cobrik23: folds 
ilaviiitech: folds 
myatiy 96: folds 
Painkiller72: raises $1 to $2
matiko09: folds 
Chiddy83 leaves the table
I The King I: folds 
Uncalled bet ($1) returned to Painkiller72
di0d80 joins the table at seat #1 
Painkiller72 collected $2.50 from pot
Painkiller72: doesn't show hand 
*** SUMMARY ***
Total pot $2.50 | Rake $0 
Seat 2: ilaviiitech folded before Flop (didn't bet)
Seat 3: myatiy 96 folded before Flop (didn't bet)
Seat 4: Painkiller72 (button) collected ($2.50)
Seat 5: matiko09 (small blind) folded before Flop
Seat 6: I The King I (big blind) folded before Flop
Seat 7: howsiao folded before Flop (didn't bet)
Seat 8: Bro_Happy folded before Flop (didn't bet)
Seat 9: cobrik23 folded before Flop (didn't bet)





PokerStars Hand #150751875955:  Hold'em No Limit ($0.50/$1.00 USD) - 2016/03/22 14:10:04 CET [2016/03/22 9:10:04 ET]
Table 'Taygeta II' 9-max Seat #4 is the button
Seat 1: DevilisHEyz ($95.20 in chips) 
Seat 2: khan Erkesh ($189.12 in chips) 
Seat 3: Muinmyheart ($100 in chips) 
Seat 4: matiko09 ($100 in chips) 
Seat 5: RICKA16 ($101.50 in chips) 
Seat 6: I The King I ($100 in chips) 
Seat 8: Avtovo ($104 in chips) 
Seat 9: cobrik23 ($49.31 in chips) 
RICKA16: posts small blind $0.50
I The King I: posts big blind $1
Szevasztopol: sits out 
*** HOLE CARDS ***
Dealt to matiko09 [7d 8s]
Avtovo: folds 
cobrik23: folds 
DevilisHEyz: folds 
khan Erkesh: folds 
Muinmyheart: raises $1.50 to $2.50
matiko09: folds 
RICKA16: folds 
I The King I: folds 
Uncalled bet ($1.50) returned to Muinmyheart
Muinmyheart collected $2.50 from pot
Muinmyheart: doesn't show hand 
*** SUMMARY ***
Total pot $2.50 | Rake $0 
Seat 1: DevilisHEyz folded before Flop (didn't bet)
Seat 2: khan Erkesh folded before Flop (didn't bet)
Seat 3: Muinmyheart collected ($2.50)
Seat 4: matiko09 (button) folded before Flop (didn't bet)
Seat 5: RICKA16 (small blind) folded before Flop
Seat 6: I The King I (big blind) folded before Flop
Seat 8: Avtovo folded before Flop (didn't bet)
Seat 9: cobrik23 folded before Flop (didn't bet)





PokerStars Hand #150751882382:  Hold'em No Limit ($0.50/$1.00 USD) - 2016/03/22 14:10:16 CET [2016/03/22 9:10:16 ET]
Table 'Colchis' 9-max Seat #3 is the button
Seat 1: theluckyjoe ($16.82 in chips) 
Seat 2: Ilov3NBA ($100 in chips) 
Seat 3: bragutza ($50.89 in chips) 
Seat 4: matiko09 ($102.07 in chips) 
Seat 5: lumen21 ($159.94 in chips) 
Seat 6: Avtovo ($103.64 in chips) 
Seat 8: cobrik23 ($41 in chips) 
Seat 9: ardo888 ($102.73 in chips) 
matiko09: posts small blind $0.50
lumen21: posts big blind $1
Dantist1122: sits out 
*** HOLE CARDS ***
Dealt to matiko09 [Ks Jc]
Avtovo: folds 
cobrik23: folds 
ardo888: folds 
theluckyjoe: calls $1
Ilov3NBA: folds 
bragutza: folds 
matiko09: calls $0.50
lumen21: checks 
*** FLOP *** [As 3d 8c]
matiko09: checks 
lumen21: checks 
theluckyjoe: checks 
*** TURN *** [As 3d 8c] [9s]
matiko09: checks 
lumen21: bets $2
theluckyjoe: folds 
matiko09: folds 
Uncalled bet ($2) returned to lumen21
lumen21 collected $2.86 from pot
lumen21: doesn't show hand 
*** SUMMARY ***
Total pot $3 | Rake $0.14 
Board [As 3d 8c 9s]
Seat 1: theluckyjoe folded on the Turn
Seat 2: Ilov3NBA folded before Flop (didn't bet)
Seat 3: bragutza (button) folded before Flop (didn't bet)
Seat 4: matiko09 (small blind) folded on the Turn
Seat 5: lumen21 (big blind) collected ($2.86)
Seat 6: Avtovo folded before Flop (didn't bet)
Seat 8: cobrik23 folded before Flop (didn't bet)
Seat 9: ardo888 folded before Flop (didn't bet)





PokerStars Hand #150751883766:  Hold'em No Limit ($0.50/$1.00 USD) - 2016/03/22 14:10:18 CET [2016/03/22 9:10:18 ET]
Table 'Arabis' 9-max Seat #5 is the button
Seat 2: ilaviiitech ($100 in chips) 
Seat 3: myatiy 96 ($100 in chips) 
Seat 4: Painkiller72 ($129.67 in chips) 
Seat 5: matiko09 ($100 in chips) 
Seat 6: I The King I ($100 in chips) 
Seat 7: howsiao ($208.33 in chips) 
Seat 8: Bro_Happy ($187.39 in chips) 
Seat 9: cobrik23 ($84.20 in chips) 
I The King I: posts small blind $0.50
howsiao: posts big blind $1
di0d80: sits out 
*** HOLE CARDS ***
Dealt to matiko09 [Jc 6c]
Bro_Happy: folds 
cobrik23: folds 
ilaviiitech: folds 
myatiy 96: folds 
Painkiller72: folds 
matiko09: raises $1.27 to $2.27
I The King I: folds 
howsiao: calls $1.27
*** FLOP *** [8s 4d Ks]
howsiao: checks 
matiko09: checks 
*** TURN *** [8s 4d Ks] [2h]
howsiao: bets $4.81
matiko09: folds 
Uncalled bet ($4.81) returned to howsiao
howsiao collected $4.81 from pot
howsiao: doesn't show hand 
*** SUMMARY ***
Total pot $5.04 | Rake $0.23 
Board [8s 4d Ks 2h]
Seat 2: ilaviiitech folded before Flop (didn't bet)
Seat 3: myatiy 96 folded before Flop (didn't bet)
Seat 4: Painkiller72 folded before Flop (didn't bet)
Seat 5: matiko09 (button) folded on the Turn
Seat 6: I The King I (small blind) folded before Flop
Seat 7: howsiao (big blind) collected ($4.81)
Seat 8: Bro_Happy folded before Flop (didn't bet)
Seat 9: cobrik23 folded before Flop (didn't bet)





PokerStars Hand #150751888363:  Hold'em No Limit ($0.50/$1.00 USD) - 2016/03/22 14:10:26 CET [2016/03/22 9:10:26 ET]
Table 'Saturn III' 9-max Seat #5 is the button
Seat 1: cobrik23 ($85.27 in chips) 
Seat 3: Painkiller72 ($100 in chips) 
Seat 5: Harbinger X ($95.96 in chips) 
Seat 6: I The King I ($102.50 in chips) 
Seat 7: Ilov3NBA ($104.50 in chips) 
Seat 9: matiko09 ($144.53 in chips) 
I The King I: posts small blind $0.50
Ilov3NBA: posts big blind $1
Muinmyheart: sits out 
*** HOLE CARDS ***
Dealt to matiko09 [4c 5s]
matiko09: folds 
cobrik23: folds 
Painkiller72: folds 
Harbinger X: folds 
I The King I: raises $2 to $3
Ilov3NBA: folds 
Uncalled bet ($2) returned to I The King I
I The King I collected $2 from pot
I The King I: doesn't show hand 
*** SUMMARY ***
Total pot $2 | Rake $0 
Seat 1: cobrik23 folded before Flop (didn't bet)
Seat 3: Painkiller72 folded before Flop (didn't bet)
Seat 5: Harbinger X (button) folded before Flop (didn't bet)
Seat 6: I The King I (small blind) collected ($2)
Seat 7: Ilov3NBA (big blind) folded before Flop
Seat 9: matiko09 folded before Flop (didn't bet)





PokerStars Hand #150751892872:  Hold'em No Limit ($0.50/$1.00 USD) - 2016/03/22 14:10:33 CET [2016/03/22 9:10:33 ET]
Table 'Crater II' 9-max Seat #2 is the button
Seat 1: matiko09 ($100 in chips) 
Seat 2: Eisbaerli85 ($121.17 in chips) 
Seat 3: lixiangli ($104.05 in chips) 
Seat 6: Kobiroga150 ($49 in chips) 
Seat 7: AWATAR 21 ($63.25 in chips) 
Seat 8: KronosAK ($115.28 in chips) 
Seat 9: I The King I ($118.70 in chips) 
lixiangli: posts small blind $0.50
Avtovo: is sitting out 
Kobiroga150: posts big blind $1
*** HOLE CARDS ***
Dealt to matiko09 [4h 5d]
AWATAR 21: folds 
KronosAK: folds 
I The King I: folds 
matiko09: folds 
Eisbaerli85: raises $1.25 to $2.25
lixiangli: folds 
Kobiroga150: calls $1.25
*** FLOP *** [Kh 9s Qs]
Kobiroga150: checks 
Eisbaerli85: bets $1.81
Kobiroga150: calls $1.81
*** TURN *** [Kh 9s Qs] [Jd]
Kobiroga150: checks 
Eisbaerli85: checks 
*** RIVER *** [Kh 9s Qs Jd] [Td]
Kobiroga150: checks 
Eisbaerli85: checks 
*** SHOW DOWN ***
Kobiroga150: shows [9c 8c] (a straight, Nine to King)
Eisbaerli85: shows [2d 2c] (a straight, Nine to King)
Kobiroga150 collected $4.12 from pot
Eisbaerli85 collected $4.11 from pot
*** SUMMARY ***
Total pot $8.62 | Rake $0.39 
Board [Kh 9s Qs Jd Td]
Seat 1: matiko09 folded before Flop (didn't bet)
Seat 2: Eisbaerli85 (button) showed [2d 2c] and won ($4.11) with a straight, Nine to King
Seat 3: lixiangli (small blind) folded before Flop
Seat 6: Kobiroga150 (big blind) showed [9c 8c] and won ($4.12) with a straight, Nine to King
Seat 7: AWATAR 21 folded before Flop (didn't bet)
Seat 8: KronosAK folded before Flop (didn't bet)
Seat 9: I The King I folded before Flop (didn't bet)





PokerStars Hand #150751894794:  Hold'em No Limit ($0.50/$1.00 USD) - 2016/03/22 14:10:37 CET [2016/03/22 9:10:37 ET]
Table 'Harding' 9-max Seat #3 is the button
Seat 1: matiko09 ($109.26 in chips) 
Seat 2: I The King I ($140.18 in chips) 
Seat 3: Avtovo ($100 in chips) 
Seat 4: lixiangli ($112.63 in chips) 
Seat 5: DevilisHEyz ($138.24 in chips) 
Seat 6: Ilov3NBA ($100 in chips) 
Seat 7: mrhighryza ($112.64 in chips) 
lixiangli: posts small blind $0.50
DevilisHEyz: posts big blind $1
omorfadramou: sits out 
*** HOLE CARDS ***
Dealt to matiko09 [6d 6h]
Ilov3NBA: folds 
mrhighryza: calls $1
matiko09: raises $2.50 to $3.50
I The King I: raises $5.50 to $9
Avtovo: folds 
lixiangli: folds 
DevilisHEyz: folds 
mrhighryza: folds 
matiko09: folds 
Uncalled bet ($5.50) returned to I The King I
I The King I collected $9.50 from pot
I The King I: doesn't show hand 
*** SUMMARY ***
Total pot $9.50 | Rake $0 
Seat 1: matiko09 folded before Flop
Seat 2: I The King I collected ($9.50)
Seat 3: Avtovo (button) folded before Flop (didn't bet)
Seat 4: lixiangli (small blind) folded before Flop
Seat 5: DevilisHEyz (big blind) folded before Flop
Seat 6: Ilov3NBA folded before Flop (didn't bet)
Seat 7: mrhighryza folded before Flop





PokerStars Hand #150751897327:  Hold'em No Limit ($0.50/$1.00 USD) - 2016/03/22 14:10:41 CET [2016/03/22 9:10:41 ET]
Table 'Stephano II' 9-max Seat #1 is the button
Seat 1: ardo888 ($100 in chips) 
Seat 2: buckshot150 ($74.20 in chips) 
Seat 3: lombardo11 ($80 in chips) 
Seat 4: AWATAR 21 ($138.20 in chips) 
Seat 5: mb2part ($100 in chips) 
Seat 7: ilaviiitech ($100 in chips) 
Seat 8: Painkiller72 ($102.75 in chips) 
Seat 9: matiko09 ($147.19 in chips) 
buckshot150: posts small blind $0.50
lombardo11: posts big blind $1
Muinmyheart: sits out 
*** HOLE CARDS ***
Dealt to matiko09 [8s Ts]
AWATAR 21: raises $1 to $2
mb2part: folds 
ilaviiitech: folds 
Painkiller72: folds 
matiko09: folds 
ardo888: folds 
Muinmyheart leaves the table
buckshot150: calls $1.50
edidaz joins the table at seat #6 
lombardo11: folds 
*** FLOP *** [6h 3s Qs]
edidaz leaves the table
buckshot150: checks 
AWATAR 21: bets $2
buckshot150: folds 
Uncalled bet ($2) returned to AWATAR 21
AWATAR 21 collected $4.78 from pot
*** SUMMARY ***
Total pot $5 | Rake $0.22 
Board [6h 3s Qs]
Seat 1: ardo888 (button) folded before Flop (didn't bet)
Seat 2: buckshot150 (small blind) folded on the Flop
Seat 3: lombardo11 (big blind) folded before Flop
Seat 4: AWATAR 21 collected ($4.78)
Seat 5: mb2part folded before Flop (didn't bet)
Seat 7: ilaviiitech folded before Flop (didn't bet)
Seat 8: Painkiller72 folded before Flop (didn't bet)
Seat 9: matiko09 folded before Flop (didn't bet)





PokerStars Hand #150751903926:  Hold'em No Limit ($0.50/$1.00 USD) - 2016/03/22 14:10:52 CET [2016/03/22 9:10:52 ET]
Table 'Taygeta II' 9-max Seat #5 is the button
Seat 1: DevilisHEyz ($95.20 in chips) 
Seat 2: khan Erkesh ($189.12 in chips) 
Seat 3: Muinmyheart ($101.50 in chips) 
Seat 4: matiko09 ($100 in chips) 
Seat 5: RICKA16 ($101 in chips) 
Seat 6: I The King I ($100 in chips) 
Seat 7: Szevasztopol ($100 in chips) 
Seat 8: Avtovo ($104 in chips) 
Seat 9: cobrik23 ($49.31 in chips) 
I The King I: posts small blind $0.50
Szevasztopol: posts big blind $1
*** HOLE CARDS ***
Dealt to matiko09 [6s Qh]
Avtovo: folds 
cobrik23 has timed out
cobrik23: folds 
DevilisHEyz: folds 
khan Erkesh: raises $2 to $3
Muinmyheart: folds 
matiko09: folds 
RICKA16: folds 
I The King I: raises $7 to $10
Szevasztopol: folds 
khan Erkesh: folds 
Uncalled bet ($7) returned to I The King I
I The King I collected $7 from pot
I The King I: doesn't show hand 
*** SUMMARY ***
Total pot $7 | Rake $0 
Seat 1: DevilisHEyz folded before Flop (didn't bet)
Seat 2: khan Erkesh folded before Flop
Seat 3: Muinmyheart folded before Flop (didn't bet)
Seat 4: matiko09 folded before Flop (didn't bet)
Seat 5: RICKA16 (button) folded before Flop (didn't bet)
Seat 6: I The King I (small blind) collected ($7)
Seat 7: Szevasztopol (big blind) folded before Flop
Seat 8: Avtovo folded before Flop (didn't bet)
Seat 9: cobrik23 folded before Flop (didn't bet)





PokerStars Hand #150751913892:  Hold'em No Limit ($0.50/$1.00 USD) - 2016/03/22 14:11:09 CET [2016/03/22 9:11:09 ET]
Table 'Crater II' 9-max Seat #3 is the button
Seat 1: matiko09 ($100 in chips) 
Seat 2: Eisbaerli85 ($121.22 in chips) 
Seat 3: lixiangli ($103.55 in chips) 
Seat 6: Kobiroga150 ($49.06 in chips) 
Seat 7: AWATAR 21 ($77.36 in chips) 
Seat 8: KronosAK ($115.28 in chips) 
Seat 9: I The King I ($118.70 in chips) 
Kobiroga150: posts small blind $0.50
AWATAR 21: posts big blind $1
*** HOLE CARDS ***
Dealt to matiko09 [Ac Jd]
KronosAK: folds 
I The King I: folds 
matiko09: raises $2 to $3
Eisbaerli85: folds 
lixiangli: folds 
Kobiroga150: calls $2.50
AWATAR 21: calls $2
*** FLOP *** [Jc 3h Qs]
Kobiroga150: checks 
AWATAR 21: checks 
matiko09: checks 
*** TURN *** [Jc 3h Qs] [Kh]
Kobiroga150: bets $4
AWATAR 21: folds 
matiko09: folds 
Uncalled bet ($4) returned to Kobiroga150
Kobiroga150 collected $8.60 from pot
Kobiroga150: doesn't show hand 
*** SUMMARY ***
Total pot $9 | Rake $0.40 
Board [Jc 3h Qs Kh]
Seat 1: matiko09 folded on the Turn
Seat 2: Eisbaerli85 folded before Flop (didn't bet)
Seat 3: lixiangli (button) folded before Flop (didn't bet)
Seat 6: Kobiroga150 (small blind) collected ($8.60)
Seat 7: AWATAR 21 (big blind) folded on the Turn
Seat 8: KronosAK folded before Flop (didn't bet)
Seat 9: I The King I folded before Flop (didn't bet)





PokerStars Hand #150751927169:  Hold'em No Limit ($0.50/$1.00 USD) - 2016/03/22 14:11:31 CET [2016/03/22 9:11:31 ET]
Table 'Arabis' 9-max Seat #6 is the button
Seat 2: ilaviiitech ($100 in chips) 
Seat 3: myatiy 96 ($100 in chips) 
Seat 4: Painkiller72 ($129.67 in chips) 
Seat 5: matiko09 ($100 in chips) 
Seat 6: I The King I ($100 in chips) 
Seat 7: howsiao ($210.87 in chips) 
Seat 8: Bro_Happy ($187.39 in chips) 
Seat 9: cobrik23 ($84.20 in chips) 
howsiao: posts small blind $0.50
Bro_Happy: posts big blind $1
*** HOLE CARDS ***
Dealt to matiko09 [Td 8h]
cobrik23: folds 
ilaviiitech: raises $2 to $3
myatiy 96: folds 
Painkiller72: calls $3
matiko09: folds 
I The King I: folds 
howsiao: calls $2.50
Bro_Happy: folds 
*** FLOP *** [Jc 4c 4h]
howsiao: checks 
ilaviiitech: bets $6.68
Painkiller72: folds 
howsiao: calls $6.68
*** TURN *** [Jc 4c 4h] [Qh]
howsiao: checks 
ilaviiitech: bets $15.61
howsiao: calls $15.61
*** RIVER *** [Jc 4c 4h Qh] [2c]
howsiao: checks 
ilaviiitech: checks 
*** SHOW DOWN ***
howsiao: shows [Js 7s] (two pair, Jacks and Fours)
ilaviiitech: mucks hand 
howsiao collected $52.12 from pot
*** SUMMARY ***
Total pot $54.58 | Rake $2.46 
Board [Jc 4c 4h Qh 2c]
Seat 2: ilaviiitech mucked [Kd As]
Seat 3: myatiy 96 folded before Flop (didn't bet)
Seat 4: Painkiller72 folded on the Flop
Seat 5: matiko09 folded before Flop (didn't bet)
Seat 6: I The King I (button) folded before Flop (didn't bet)
Seat 7: howsiao (small blind) showed [Js 7s] and won ($52.12) with two pair, Jacks and Fours
Seat 8: Bro_Happy (big blind) folded before Flop
Seat 9: cobrik23 folded before Flop (didn't bet)





PokerStars Hand #150751928261:  Hold'em No Limit ($0.50/$1.00 USD) - 2016/03/22 14:11:33 CET [2016/03/22 9:11:33 ET]
Table 'Harding' 9-max Seat #4 is the button
Seat 1: matiko09 ($105.76 in chips) 
Seat 2: I The King I ($146.18 in chips) 
Seat 3: Avtovo ($100 in chips) 
Seat 4: lixiangli ($112.13 in chips) 
Seat 5: DevilisHEyz ($137.24 in chips) 
Seat 6: Ilov3NBA ($100 in chips) 
Seat 7: mrhighryza ($111.64 in chips) 
DevilisHEyz: posts small blind $0.50
Ilov3NBA: posts big blind $1
omorfadramou: sits out 
*** HOLE CARDS ***
Dealt to matiko09 [3h 7h]
mrhighryza: folds 
matiko09: folds 
I The King I: folds 
Avtovo: folds 
lixiangli: raises $1.50 to $2.50
DevilisHEyz: folds 
Ilov3NBA: raises $5.50 to $8
lixiangli: calls $5.50
*** FLOP *** [Qd Jc 7c]
Ilov3NBA: bets $9.50
lixiangli: calls $9.50
*** TURN *** [Qd Jc 7c] [Ac]
Ilov3NBA: checks 
lixiangli: bets $19
Ilov3NBA: calls $19
*** RIVER *** [Qd Jc 7c Ac] [9h]
Ilov3NBA: checks 
lixiangli: bets $52
Ilov3NBA: folds 
Uncalled bet ($52) returned to lixiangli
lixiangli collected $70.70 from pot
*** SUMMARY ***
Total pot $73.50 | Rake $2.80 
Board [Qd Jc 7c Ac 9h]
Seat 1: matiko09 folded before Flop (didn't bet)
Seat 2: I The King I folded before Flop (didn't bet)
Seat 3: Avtovo folded before Flop (didn't bet)
Seat 4: lixiangli (button) collected ($70.70)
Seat 5: DevilisHEyz (small blind) folded before Flop
Seat 6: Ilov3NBA (big blind) folded on the River
Seat 7: mrhighryza folded before Flop (didn't bet)





PokerStars Hand #150751930326:  Hold'em No Limit ($0.50/$1.00 USD) - 2016/03/22 14:11:36 CET [2016/03/22 9:11:36 ET]
Table 'Stephano II' 9-max Seat #2 is the button
Seat 1: ardo888 ($100 in chips) 
Seat 2: buckshot150 ($72.20 in chips) 
Seat 3: lombardo11 ($79 in chips) 
Seat 4: AWATAR 21 ($140.98 in chips) 
Seat 5: mb2part ($100 in chips) 
Seat 7: ilaviiitech ($100 in chips) 
Seat 8: Painkiller72 ($102.75 in chips) 
Seat 9: matiko09 ($147.19 in chips) 
lombardo11: posts small blind $0.50
AWATAR 21: posts big blind $1
*** HOLE CARDS ***
Dealt to matiko09 [8d 9h]
mb2part: folds 
beterc0re joins the table at seat #6 
ilaviiitech: folds 
Painkiller72: folds 
matiko09: folds 
ardo888: folds 
buckshot150: raises $1 to $2
lombardo11: calls $1.50
AWATAR 21: calls $1
*** FLOP *** [4h Qd Ah]
lombardo11: checks 
AWATAR 21: bets $2
buckshot150: raises $3 to $5
lombardo11: folds 
AWATAR 21: folds 
Uncalled bet ($3) returned to buckshot150
buckshot150 collected $9.55 from pot
buckshot150: doesn't show hand 
*** SUMMARY ***
Total pot $10 | Rake $0.45 
Board [4h Qd Ah]
Seat 1: ardo888 folded before Flop (didn't bet)
Seat 2: buckshot150 (button) collected ($9.55)
Seat 3: lombardo11 (small blind) folded on the Flop
Seat 4: AWATAR 21 (big blind) folded on the Flop
Seat 5: mb2part folded before Flop (didn't bet)
Seat 7: ilaviiitech folded before Flop (didn't bet)
Seat 8: Painkiller72 folded before Flop (didn't bet)
Seat 9: matiko09 folded before Flop (didn't bet)





PokerStars Hand #150751938392:  Hold'em No Limit ($0.50/$1.00 USD) - 2016/03/22 14:11:50 CET [2016/03/22 9:11:50 ET]
Table 'Taygeta II' 9-max Seat #6 is the button
Seat 1: DevilisHEyz ($95.20 in chips) 
Seat 2: khan Erkesh ($186.12 in chips) 
Seat 3: Muinmyheart ($101.50 in chips) 
Seat 4: matiko09 ($100 in chips) 
Seat 5: RICKA16 ($101 in chips) 
Seat 6: I The King I ($104 in chips) 
Seat 7: Szevasztopol ($100 in chips) 
Seat 9: cobrik23 ($49.31 in chips) 
Szevasztopol: posts small blind $0.50
Avtovo: is sitting out 
cobrik23: posts big blind $1
*** HOLE CARDS ***
Dealt to matiko09 [Js Ac]
DevilisHEyz: raises $2 to $3
khan Erkesh: calls $3
Muinmyheart: folds 
matiko09: folds 
RICKA16: folds 
I The King I: folds 
Szevasztopol: folds 
cobrik23: folds 
*** FLOP *** [2d 3h Ts]
DevilisHEyz: bets $3.58
khan Erkesh: raises $3.58 to $7.16
DevilisHEyz: folds 
Uncalled bet ($3.58) returned to khan Erkesh
khan Erkesh collected $14 from pot
khan Erkesh: doesn't show hand 
*** SUMMARY ***
Total pot $14.66 | Rake $0.66 
Board [2d 3h Ts]
Seat 1: DevilisHEyz folded on the Flop
Seat 2: khan Erkesh collected ($14)
Seat 3: Muinmyheart folded before Flop (didn't bet)
Seat 4: matiko09 folded before Flop (didn't bet)
Seat 5: RICKA16 folded before Flop (didn't bet)
Seat 6: I The King I (button) folded before Flop (didn't bet)
Seat 7: Szevasztopol (small blind) folded before Flop
Seat 9: cobrik23 (big blind) folded before Flop





PokerStars Hand #150751943463:  Hold'em No Limit ($0.50/$1.00 USD) - 2016/03/22 14:11:58 CET [2016/03/22 9:11:58 ET]
Table 'Colchis' 9-max Seat #4 is the button
Seat 1: theluckyjoe ($15.82 in chips) 
Seat 2: Ilov3NBA ($100 in chips) 
Seat 3: bragutza ($50.89 in chips) 
Seat 4: matiko09 ($101.07 in chips) 
Seat 5: lumen21 ($161.80 in chips) 
Seat 7: Dantist1122 ($100 in chips) 
Seat 8: cobrik23 ($41 in chips) 
Seat 9: ardo888 ($102.73 in chips) 
lumen21: posts small blind $0.50
Avtovo: is sitting out 
Dantist1122: posts big blind $1
*** HOLE CARDS ***
Dealt to matiko09 [8h 6c]
cobrik23: folds 
ardo888: folds 
theluckyjoe: calls $1
Ilov3NBA: folds 
bragutza: folds 
matiko09: folds 
lumen21: folds 
Dantist1122: raises $4 to $5
theluckyjoe: folds 
Uncalled bet ($4) returned to Dantist1122
Dantist1122 collected $2.50 from pot
Dantist1122: doesn't show hand 
*** SUMMARY ***
Total pot $2.50 | Rake $0 
Seat 1: theluckyjoe folded before Flop
Seat 2: Ilov3NBA folded before Flop (didn't bet)
Seat 3: bragutza folded before Flop (didn't bet)
Seat 4: matiko09 (button) folded before Flop (didn't bet)
Seat 5: lumen21 (small blind) folded before Flop
Seat 7: Dantist1122 (big blind) collected ($2.50)
Seat 8: cobrik23 folded before Flop (didn't bet)
Seat 9: ardo888 folded before Flop (didn't bet)





PokerStars Hand #150751953345:  Hold'em No Limit ($0.50/$1.00 USD) - 2016/03/22 14:12:15 CET [2016/03/22 9:12:15 ET]
Table 'Crater II' 9-max Seat #6 is the button
Seat 1: matiko09 ($100 in chips) 
Seat 2: Eisbaerli85 ($121.22 in chips) 
Seat 3: lixiangli ($103.55 in chips) 
Seat 6: Kobiroga150 ($54.66 in chips) 
Seat 7: AWATAR 21 ($74.36 in chips) 
Seat 8: KronosAK ($115.28 in chips) 
Seat 9: I The King I ($118.70 in chips) 
AWATAR 21: posts small blind $0.50
KronosAK: posts big blind $1
*** HOLE CARDS ***
Dealt to matiko09 [3h Kd]
I The King I: folds 
matiko09: folds 
Eisbaerli85: folds 
lixiangli: folds 
Kobiroga150: folds 
AWATAR 21: folds 
Uncalled bet ($0.50) returned to KronosAK
KronosAK collected $1 from pot
KronosAK: doesn't show hand 
*** SUMMARY ***
Total pot $1 | Rake $0 
Seat 1: matiko09 folded before Flop (didn't bet)
Seat 2: Eisbaerli85 folded before Flop (didn't bet)
Seat 3: lixiangli folded before Flop (didn't bet)
Seat 6: Kobiroga150 (button) folded before Flop (didn't bet)
Seat 7: AWATAR 21 (small blind) folded before Flop
Seat 8: KronosAK (big blind) collected ($1)
Seat 9: I The King I folded before Flop (didn't bet)





PokerStars Hand #150751962175:  Hold'em No Limit ($0.50/$1.00 USD) - 2016/03/22 14:12:30 CET [2016/03/22 9:12:30 ET]
Table 'Crater II' 9-max Seat #7 is the button
Seat 1: matiko09 ($100 in chips) 
Seat 2: Eisbaerli85 ($121.22 in chips) 
Seat 3: lixiangli ($103.55 in chips) 
Seat 6: Kobiroga150 ($54.66 in chips) 
Seat 7: AWATAR 21 ($73.86 in chips) 
Seat 8: KronosAK ($115.78 in chips) 
Seat 9: I The King I ($118.70 in chips) 
KronosAK: posts small blind $0.50
I The King I: posts big blind $1
*** HOLE CARDS ***
Dealt to matiko09 [Jh Kc]
matiko09: folds 
Eisbaerli85: folds 
lixiangli: folds 
Kobiroga150: raises $2 to $3
AWATAR 21: folds 
KronosAK: folds 
I The King I: folds 
Uncalled bet ($2) returned to Kobiroga150
Kobiroga150 collected $2.50 from pot
Kobiroga150: doesn't show hand 
*** SUMMARY ***
Total pot $2.50 | Rake $0 
Seat 1: matiko09 folded before Flop (didn't bet)
Seat 2: Eisbaerli85 folded before Flop (didn't bet)
Seat 3: lixiangli folded before Flop (didn't bet)
Seat 6: Kobiroga150 collected ($2.50)
Seat 7: AWATAR 21 (button) folded before Flop (didn't bet)
Seat 8: KronosAK (small blind) folded before Flop
Seat 9: I The King I (big blind) folded before Flop





PokerStars Hand #150751962773:  Hold'em No Limit ($0.50/$1.00 USD) - 2016/03/22 14:12:31 CET [2016/03/22 9:12:31 ET]
Table 'Colchis' 9-max Seat #5 is the button
Seat 1: theluckyjoe ($14.82 in chips) 
Seat 2: Ilov3NBA ($100 in chips) 
Seat 3: bragutza ($50.89 in chips) 
Seat 4: matiko09 ($101.07 in chips) 
Seat 5: lumen21 ($161.30 in chips) 
Seat 7: Dantist1122 ($101.50 in chips) 
Seat 8: cobrik23 ($41 in chips) 
Seat 9: ardo888 ($102.73 in chips) 
Dantist1122: posts small blind $0.50
cobrik23: posts big blind $1
*** HOLE CARDS ***
Dealt to matiko09 [5h 2s]
ardo888: folds 
theluckyjoe: folds 
Ilov3NBA: folds 
bragutza: raises $1 to $2
matiko09: folds 
lumen21: folds 
Dantist1122: folds 
cobrik23: raises $6 to $8
bragutza: calls $6
*** FLOP *** [4c 2d Kc]
cobrik23: bets $8
bragutza: folds 
Uncalled bet ($8) returned to cobrik23
cobrik23 collected $15.76 from pot
cobrik23: doesn't show hand 
*** SUMMARY ***
Total pot $16.50 | Rake $0.74 
Board [4c 2d Kc]
Seat 1: theluckyjoe folded before Flop (didn't bet)
Seat 2: Ilov3NBA folded before Flop (didn't bet)
Seat 3: bragutza folded on the Flop
Seat 4: matiko09 folded before Flop (didn't bet)
Seat 5: lumen21 (button) folded before Flop (didn't bet)
Seat 7: Dantist1122 (small blind) folded before Flop
Seat 8: cobrik23 (big blind) collected ($15.76)
Seat 9: ardo888 folded before Flop (didn't bet)





PokerStars Hand #150751967717:  Hold'em No Limit ($0.50/$1.00 USD) - 2016/03/22 14:12:39 CET [2016/03/22 9:12:39 ET]
Table 'Arabis' 9-max Seat #7 is the button
Seat 2: ilaviiitech ($100 in chips) 
Seat 3: myatiy 96 ($100 in chips) 
Seat 4: Painkiller72 ($126.67 in chips) 
Seat 5: matiko09 ($100 in chips) 
Seat 6: I The King I ($100 in chips) 
Seat 7: howsiao ($237.70 in chips) 
Seat 8: Bro_Happy ($186.39 in chips) 
Seat 9: cobrik23 ($84.20 in chips) 
Bro_Happy: posts small blind $0.50
cobrik23: posts big blind $1
*** HOLE CARDS ***
Dealt to matiko09 [3s Tc]
ilaviiitech: folds 
myatiy 96: folds 
Painkiller72: folds 
matiko09: folds 
I The King I: raises $1.50 to $2.50
howsiao: calls $2.50
Bro_Happy: raises $7.50 to $10
cobrik23: folds 
I The King I: folds 
howsiao: calls $7.50
*** FLOP *** [Qc 3h 9d]
Bro_Happy: bets $15.70
howsiao: folds 
Uncalled bet ($15.70) returned to Bro_Happy
Bro_Happy collected $22.44 from pot
Bro_Happy: doesn't show hand 
*** SUMMARY ***
Total pot $23.50 | Rake $1.06 
Board [Qc 3h 9d]
Seat 2: ilaviiitech folded before Flop (didn't bet)
Seat 3: myatiy 96 folded before Flop (didn't bet)
Seat 4: Painkiller72 folded before Flop (didn't bet)
Seat 5: matiko09 folded before Flop (didn't bet)
Seat 6: I The King I folded before Flop
Seat 7: howsiao (button) folded on the Flop
Seat 8: Bro_Happy (small blind) collected ($22.44)
Seat 9: cobrik23 (big blind) folded before Flop





PokerStars Hand #150751973709:  Hold'em No Limit ($0.50/$1.00 USD) - 2016/03/22 14:12:49 CET [2016/03/22 9:12:49 ET]
Table 'Crater II' 9-max Seat #8 is the button
Seat 1: matiko09 ($100 in chips) 
Seat 2: Eisbaerli85 ($121.22 in chips) 
Seat 3: lixiangli ($103.55 in chips) 
Seat 6: Kobiroga150 ($56.16 in chips) 
Seat 7: AWATAR 21 ($73.86 in chips) 
Seat 8: KronosAK ($115.28 in chips) 
Seat 9: I The King I ($117.70 in chips) 
I The King I: posts small blind $0.50
matiko09: posts big blind $1
*** HOLE CARDS ***
Dealt to matiko09 [As 4d]
Eisbaerli85: folds 
lixiangli: folds 
Kobiroga150: folds 
AWATAR 21: raises $1 to $2
KronosAK: folds 
I The King I: folds 
matiko09: calls $1
*** FLOP *** [5s 4c 9s]
matiko09: checks 
AWATAR 21: bets $3
matiko09: calls $3
*** TURN *** [5s 4c 9s] [Js]
matiko09: checks 
AWATAR 21: checks 
*** RIVER *** [5s 4c 9s Js] [5c]
matiko09: checks 
AWATAR 21: checks 
*** SHOW DOWN ***
matiko09: shows [As 4d] (two pair, Fives and Fours)
AWATAR 21: mucks hand 
matiko09 collected $10.03 from pot
*** SUMMARY ***
Total pot $10.50 | Rake $0.47 
Board [5s 4c 9s Js 5c]
Seat 1: matiko09 (big blind) showed [As 4d] and won ($10.03) with two pair, Fives and Fours
Seat 2: Eisbaerli85 folded before Flop (didn't bet)
Seat 3: lixiangli folded before Flop (didn't bet)
Seat 6: Kobiroga150 folded before Flop (didn't bet)
Seat 7: AWATAR 21 mucked [7h 3h]
Seat 8: KronosAK (button) folded before Flop (didn't bet)
Seat 9: I The King I (small blind) folded before Flop





PokerStars Hand #150751977642:  Hold'em No Limit ($0.50/$1.00 USD) - 2016/03/22 14:12:56 CET [2016/03/22 9:12:56 ET]
Table 'Stephano II' 9-max Seat #3 is the button
Seat 1: ardo888 ($100 in chips) 
Seat 2: buckshot150 ($77.75 in chips) 
Seat 3: lombardo11 ($77 in chips) 
Seat 4: AWATAR 21 ($136.98 in chips) 
Seat 5: mb2part ($100 in chips) 
Seat 7: ilaviiitech ($100 in chips) 
Seat 8: Painkiller72 ($102.75 in chips) 
Seat 9: matiko09 ($147.19 in chips) 
AWATAR 21: posts small blind $0.50
mb2part: posts big blind $1
beterc0re: sits out 
*** HOLE CARDS ***
Dealt to matiko09 [Tc 8c]
ilaviiitech: folds 
Painkiller72: folds 
matiko09: folds 
ardo888: folds 
buckshot150: folds 
lombardo11: folds 
AWATAR 21: raises $1 to $2
mb2part: folds 
Uncalled bet ($1) returned to AWATAR 21
AWATAR 21 collected $2 from pot
*** SUMMARY ***
Total pot $2 | Rake $0 
Seat 1: ardo888 folded before Flop (didn't bet)
Seat 2: buckshot150 folded before Flop (didn't bet)
Seat 3: lombardo11 (button) folded before Flop (didn't bet)
Seat 4: AWATAR 21 (small blind) collected ($2)
Seat 5: mb2part (big blind) folded before Flop
Seat 7: ilaviiitech folded before Flop (didn't bet)
Seat 8: Painkiller72 folded before Flop (didn't bet)
Seat 9: matiko09 folded before Flop (didn't bet)





PokerStars Hand #150751980400:  Hold'em No Limit ($0.50/$1.00 USD) - 2016/03/22 14:13:01 CET [2016/03/22 9:13:01 ET]
Table 'Taygeta II' 9-max Seat #7 is the button
Seat 1: DevilisHEyz ($88.62 in chips) 
Seat 2: khan Erkesh ($193.54 in chips) 
Seat 3: Muinmyheart ($101.50 in chips) 
Seat 4: matiko09 ($100 in chips) 
Seat 5: RICKA16 ($101 in chips) 
Seat 6: I The King I ($104 in chips) 
Seat 7: Szevasztopol ($100 in chips) 
Seat 9: cobrik23 ($48.31 in chips) 
cobrik23: posts small blind $0.50
DevilisHEyz: posts big blind $1
*** HOLE CARDS ***
Dealt to matiko09 [8c 9c]
khan Erkesh: folds 
Muinmyheart: folds 
matiko09: raises $2 to $3
RICKA16: folds 
I The King I: raises $6 to $9
Szevasztopol: folds 
cobrik23: folds 
DevilisHEyz: folds 
matiko09: folds 
Uncalled bet ($6) returned to I The King I
I The King I collected $7.50 from pot
I The King I: doesn't show hand 
*** SUMMARY ***
Total pot $7.50 | Rake $0 
Seat 1: DevilisHEyz (big blind) folded before Flop
Seat 2: khan Erkesh folded before Flop (didn't bet)
Seat 3: Muinmyheart folded before Flop (didn't bet)
Seat 4: matiko09 folded before Flop
Seat 5: RICKA16 folded before Flop (didn't bet)
Seat 6: I The King I collected ($7.50)
Seat 7: Szevasztopol (button) folded before Flop (didn't bet)
Seat 9: cobrik23 (small blind) folded before Flop





PokerStars Hand #150751991023:  Hold'em No Limit ($0.50/$1.00 USD) - 2016/03/22 14:13:19 CET [2016/03/22 9:13:19 ET]
Table 'Stephano II' 9-max Seat #4 is the button
Seat 1: ardo888 ($100 in chips) 
Seat 2: buckshot150 ($77.75 in chips) 
Seat 3: lombardo11 ($77 in chips) 
Seat 4: AWATAR 21 ($137.98 in chips) 
Seat 5: mb2part ($99 in chips) 
Seat 6: beterc0re ($100 in chips) 
Seat 7: ilaviiitech ($100 in chips) 
Seat 8: Painkiller72 ($102.75 in chips) 
Seat 9: matiko09 ($147.19 in chips) 
mb2part: posts small blind $0.50
beterc0re: posts big blind $1
*** HOLE CARDS ***
Dealt to matiko09 [3c Js]
ilaviiitech: folds 
Painkiller72: raises $1.50 to $2.50
matiko09: folds 
ardo888: calls $2.50
buckshot150: folds 
lombardo11: folds 
AWATAR 21: folds 
mb2part: folds 
beterc0re: calls $1.50
*** FLOP *** [9d 5s 4d]
beterc0re: checks 
Painkiller72: checks 
ardo888: bets $4.50
beterc0re: calls $4.50
Painkiller72: raises $11.57 to $16.07
ardo888: folds 
beterc0re: calls $11.57
*** TURN *** [9d 5s 4d] [6h]
beterc0re: checks 
Painkiller72: bets $29.84
beterc0re: folds 
Uncalled bet ($29.84) returned to Painkiller72
Painkiller72 collected $42.63 from pot
Painkiller72: doesn't show hand 
*** SUMMARY ***
Total pot $44.64 | Rake $2.01 
Board [9d 5s 4d 6h]
Seat 1: ardo888 folded on the Flop
Seat 2: buckshot150 folded before Flop (didn't bet)
Seat 3: lombardo11 folded before Flop (didn't bet)
Seat 4: AWATAR 21 (button) folded before Flop (didn't bet)
Seat 5: mb2part (small blind) folded before Flop
Seat 6: beterc0re (big blind) folded on the Turn
Seat 7: ilaviiitech folded before Flop (didn't bet)
Seat 8: Painkiller72 collected ($42.63)
Seat 9: matiko09 folded before Flop (didn't bet)





PokerStars Hand #150752001234:  Hold'em No Limit ($0.50/$1.00 USD) - 2016/03/22 14:13:36 CET [2016/03/22 9:13:36 ET]
Table 'Crater II' 9-max Seat #9 is the button
Seat 1: matiko09 ($105.03 in chips) 
Seat 2: Eisbaerli85 ($121.22 in chips) 
Seat 3: lixiangli ($103.55 in chips) 
Seat 6: Kobiroga150 ($56.16 in chips) 
Seat 7: AWATAR 21 ($68.86 in chips) 
Seat 8: KronosAK ($115.28 in chips) 
Seat 9: I The King I ($117.20 in chips) 
matiko09: posts small blind $0.50
Eisbaerli85: posts big blind $1
*** HOLE CARDS ***
Dealt to matiko09 [8s Qs]
lixiangli: folds 
Kobiroga150: folds 
AWATAR 21: folds 
KronosAK: folds 
I The King I: folds 
matiko09: raises $1.50 to $2.50
Eisbaerli85: folds 
Uncalled bet ($1.50) returned to matiko09
matiko09 collected $2 from pot
matiko09: doesn't show hand 
*** SUMMARY ***
Total pot $2 | Rake $0 
Seat 1: matiko09 (small blind) collected ($2)
Seat 2: Eisbaerli85 (big blind) folded before Flop
Seat 3: lixiangli folded before Flop (didn't bet)
Seat 6: Kobiroga150 folded before Flop (didn't bet)
Seat 7: AWATAR 21 folded before Flop (didn't bet)
Seat 8: KronosAK folded before Flop (didn't bet)
Seat 9: I The King I (button) folded before Flop (didn't bet)





PokerStars Hand #150752002023:  Hold'em No Limit ($0.50/$1.00 USD) - 2016/03/22 14:13:38 CET [2016/03/22 9:13:38 ET]
Table 'Arabis' 9-max Seat #8 is the button
Seat 2: ilaviiitech ($100 in chips) 
Seat 3: myatiy 96 ($100 in chips) 
Seat 4: Painkiller72 ($126.67 in chips) 
Seat 5: matiko09 ($100 in chips) 
Seat 6: I The King I ($100 in chips) 
Seat 7: howsiao ($227.70 in chips) 
Seat 8: Bro_Happy ($198.83 in chips) 
Seat 9: cobrik23 ($83.20 in chips) 
cobrik23: posts small blind $0.50
ilaviiitech: posts big blind $1
*** HOLE CARDS ***
Dealt to matiko09 [2h 8c]
myatiy 96: folds 
myatiy 96 leaves the table
Painkiller72: folds 
matiko09: folds 
lumen21 joins the table at seat #3 
I The King I: raises $2 to $3
howsiao: calls $3
Bro_Happy: folds 
cobrik23: raises $10 to $13
ilaviiitech: folds 
I The King I: calls $10
howsiao: folds 
*** FLOP *** [Jh 2d 4c]
cobrik23: bets $14.32
I The King I: folds 
Uncalled bet ($14.32) returned to cobrik23
cobrik23 collected $28.65 from pot
cobrik23: doesn't show hand 
*** SUMMARY ***
Total pot $30 | Rake $1.35 
Board [Jh 2d 4c]
Seat 2: ilaviiitech (big blind) folded before Flop
Seat 3: myatiy 96 folded before Flop (didn't bet)
Seat 4: Painkiller72 folded before Flop (didn't bet)
Seat 5: matiko09 folded before Flop (didn't bet)
Seat 6: I The King I folded on the Flop
Seat 7: howsiao folded before Flop
Seat 8: Bro_Happy (button) folded before Flop (didn't bet)
Seat 9: cobrik23 (small blind) collected ($28.65)





PokerStars Hand #150752016704:  Hold'em No Limit ($0.50/$1.00 USD) - 2016/03/22 14:14:02 CET [2016/03/22 9:14:02 ET]
Table 'Colchis' 9-max Seat #7 is the button
Seat 1: theluckyjoe ($14.82 in chips) 
Seat 2: Ilov3NBA ($100 in chips) 
Seat 3: bragutza ($42.89 in chips) 
Seat 4: matiko09 ($101.07 in chips) 
Seat 5: lumen21 ($161.30 in chips) 
Seat 7: Dantist1122 ($101 in chips) 
Seat 8: cobrik23 ($48.76 in chips) 
Seat 9: ardo888 ($102.73 in chips) 
cobrik23: posts small blind $0.50
ardo888: posts big blind $1
*** HOLE CARDS ***
Dealt to matiko09 [6h 7s]
theluckyjoe: folds 
Ilov3NBA: folds 
bragutza: folds 
matiko09: folds 
lumen21: folds 
Dantist1122: raises $1.05 to $2.05
cobrik23: folds 
ardo888: calls $1.05
*** FLOP *** [9d Ad 5s]
ardo888: checks 
Dantist1122: checks 
*** TURN *** [9d Ad 5s] [Ks]
ardo888: bets $3.20
Dantist1122: folds 
Uncalled bet ($3.20) returned to ardo888
ardo888 collected $4.39 from pot
ardo888: doesn't show hand 
*** SUMMARY ***
Total pot $4.60 | Rake $0.21 
Board [9d Ad 5s Ks]
Seat 1: theluckyjoe folded before Flop (didn't bet)
Seat 2: Ilov3NBA folded before Flop (didn't bet)
Seat 3: bragutza folded before Flop (didn't bet)
Seat 4: matiko09 folded before Flop (didn't bet)
Seat 5: lumen21 folded before Flop (didn't bet)
Seat 7: Dantist1122 (button) folded on the Turn
Seat 8: cobrik23 (small blind) folded before Flop
Seat 9: ardo888 (big blind) collected ($4.39)





PokerStars Hand #150752016606:  Hold'em No Limit ($0.50/$1.00 USD) - 2016/03/22 14:14:02 CET [2016/03/22 9:14:02 ET]
Table 'Taygeta II' 9-max Seat #9 is the button
Seat 1: DevilisHEyz ($87.62 in chips) 
Seat 2: khan Erkesh ($193.54 in chips) 
Seat 3: Muinmyheart ($101.50 in chips) 
Seat 4: matiko09 ($100 in chips) 
Seat 5: RICKA16 ($101 in chips) 
Seat 6: I The King I ($108.50 in chips) 
Seat 7: Szevasztopol ($100 in chips) 
Seat 9: cobrik23 ($47.81 in chips) 
DevilisHEyz: posts small blind $0.50
khan Erkesh: posts big blind $1
*** HOLE CARDS ***
Dealt to matiko09 [4d 9c]
Muinmyheart: folds 
matiko09: folds 
RICKA16: folds 
I The King I: folds 
Szevasztopol: folds 
cobrik23: folds 
DevilisHEyz: folds 
Uncalled bet ($0.50) returned to khan Erkesh
khan Erkesh collected $1 from pot
khan Erkesh: doesn't show hand 
*** SUMMARY ***
Total pot $1 | Rake $0 
Seat 1: DevilisHEyz (small blind) folded before Flop
Seat 2: khan Erkesh (big blind) collected ($1)
Seat 3: Muinmyheart folded before Flop (didn't bet)
Seat 4: matiko09 folded before Flop (didn't bet)
Seat 5: RICKA16 folded before Flop (didn't bet)
Seat 6: I The King I folded before Flop (didn't bet)
Seat 7: Szevasztopol folded before Flop (didn't bet)
Seat 9: cobrik23 (button) folded before Flop (didn't bet)





PokerStars Hand #150752024590:  Hold'em No Limit ($0.50/$1.00 USD) - 2016/03/22 14:14:16 CET [2016/03/22 9:14:16 ET]
Table 'Crater II' 9-max Seat #1 is the button
Seat 1: matiko09 ($106.03 in chips) 
Seat 2: Eisbaerli85 ($120.22 in chips) 
Seat 3: lixiangli ($103.55 in chips) 
Seat 6: Kobiroga150 ($56.16 in chips) 
Seat 7: AWATAR 21 ($68.86 in chips) 
Seat 8: KronosAK ($115.28 in chips) 
Seat 9: I The King I ($117.20 in chips) 
Eisbaerli85: posts small blind $0.50
lixiangli: posts big blind $1
*** HOLE CARDS ***
Dealt to matiko09 [6h 5s]
Kobiroga150: folds 
AWATAR 21: folds 
KronosAK: folds 
I The King I: folds 
matiko09: folds 
Eisbaerli85: folds 
Uncalled bet ($0.50) returned to lixiangli
lixiangli collected $1 from pot
lixiangli: doesn't show hand 
*** SUMMARY ***
Total pot $1 | Rake $0 
Seat 1: matiko09 (button) folded before Flop (didn't bet)
Seat 2: Eisbaerli85 (small blind) folded before Flop
Seat 3: lixiangli (big blind) collected ($1)
Seat 6: Kobiroga150 folded before Flop (didn't bet)
Seat 7: AWATAR 21 folded before Flop (didn't bet)
Seat 8: KronosAK folded before Flop (didn't bet)
Seat 9: I The King I folded before Flop (didn't bet)





PokerStars Hand #150752027282:  Hold'em No Limit ($0.50/$1.00 USD) - 2016/03/22 14:14:20 CET [2016/03/22 9:14:20 ET]
Table 'Harding' 9-max Seat #5 is the button
Seat 1: matiko09 ($105.76 in chips) 
Seat 2: I The King I ($146.18 in chips) 
Seat 3: Avtovo ($100 in chips) 
Seat 4: lixiangli ($146.33 in chips) 
Seat 5: DevilisHEyz ($136.74 in chips) 
Seat 6: Ilov3NBA ($100 in chips) 
Seat 7: mrhighryza ($111.64 in chips) 
Ilov3NBA: posts small blind $0.50
mrhighryza: posts big blind $1
omorfadramou: sits out 
*** HOLE CARDS ***
Dealt to matiko09 [As 2d]
matiko09: folds 
I The King I: folds 
Avtovo: folds 
lixiangli: raises $1 to $2
DevilisHEyz: folds 
Ilov3NBA: calls $1.50
mrhighryza: calls $1
*** FLOP *** [Kc 4h 3d]
Ilov3NBA: checks 
mrhighryza: checks 
lixiangli: checks 
*** TURN *** [Kc 4h 3d] [9s]
Ilov3NBA: bets $3.72
mrhighryza: folds 
lixiangli: calls $3.72
*** RIVER *** [Kc 4h 3d 9s] [Ks]
Ilov3NBA: bets $9.50
lixiangli: folds 
Uncalled bet ($9.50) returned to Ilov3NBA
Ilov3NBA collected $12.84 from pot
Ilov3NBA: doesn't show hand 
*** SUMMARY ***
Total pot $13.44 | Rake $0.60 
Board [Kc 4h 3d 9s Ks]
Seat 1: matiko09 folded before Flop (didn't bet)
Seat 2: I The King I folded before Flop (didn't bet)
Seat 3: Avtovo folded before Flop (didn't bet)
Seat 4: lixiangli folded on the River
Seat 5: DevilisHEyz (button) folded before Flop (didn't bet)
Seat 6: Ilov3NBA (small blind) collected ($12.84)
Seat 7: mrhighryza (big blind) folded on the Turn





PokerStars Hand #150752030639:  Hold'em No Limit ($1/$2 USD) - 2016/03/22 14:14:26 CET [2016/03/22 9:14:26 ET]
Table 'Kiso II' 9-max Seat #7 is the button
Seat 1: Avtovo ($346.98 in chips) 
Seat 3: seouljam ($392.99 in chips) 
Seat 4: AMIRsuperfre ($34.50 in chips) 
Seat 5: Ilov3NBA ($309.84 in chips) 
Seat 6: KT90 ($286.84 in chips) 
Seat 7: Igoriah ($209.01 in chips) 
Seat 8: bananajoe001 ($86.72 in chips) 
Seat 9: matiko09 ($200 in chips) 
bananajoe001: posts small blind $1
matiko09: posts big blind $2
*** HOLE CARDS ***
Dealt to matiko09 [Ad 3h]
Avtovo: folds 
seouljam: folds 
AMIRsuperfre: raises $2 to $4
Ilov3NBA: folds 
KT90: folds 
Igoriah: folds 
bananajoe001: folds 
matiko09: folds 
Uncalled bet ($2) returned to AMIRsuperfre
AMIRsuperfre collected $5 from pot
AMIRsuperfre: doesn't show hand 
*** SUMMARY ***
Total pot $5 | Rake $0 
Seat 1: Avtovo folded before Flop (didn't bet)
Seat 3: seouljam folded before Flop (didn't bet)
Seat 4: AMIRsuperfre collected ($5)
Seat 5: Ilov3NBA folded before Flop (didn't bet)
Seat 6: KT90 folded before Flop (didn't bet)
Seat 7: Igoriah (button) folded before Flop (didn't bet)
Seat 8: bananajoe001 (small blind) folded before Flop
Seat 9: matiko09 (big blind) folded before Flop





PokerStars Hand #150752033398:  Hold'em No Limit ($0.50/$1.00 USD) - 2016/03/22 14:14:31 CET [2016/03/22 9:14:31 ET]
Table 'Polyxena' 9-max Seat #5 is the button
Seat 1: I The King I ($111.23 in chips) 
Seat 2: cobrik23 ($66.61 in chips) 
Seat 4: fanmtZ ($43.95 in chips) 
Seat 5: MrAndMisses ($78.95 in chips) 
Seat 6: lixiangli ($122.05 in chips) 
Seat 7: matiko09 ($100 in chips) 
Seat 8: kift74 ($124.17 in chips) 
Seat 9: ardo888 ($106.67 in chips) 
lixiangli: posts small blind $0.50
matiko09: posts big blind $1
*** HOLE CARDS ***
Dealt to matiko09 [8c 5h]
kift74: folds 
ardo888: folds 
I The King I: folds 
cobrik23: raises $2 to $3
fanmtZ: folds 
MrAndMisses: folds 
lixiangli: folds 
matiko09: folds 
Uncalled bet ($2) returned to cobrik23
cobrik23 collected $2.50 from pot
cobrik23: doesn't show hand 
*** SUMMARY ***
Total pot $2.50 | Rake $0 
Seat 1: I The King I folded before Flop (didn't bet)
Seat 2: cobrik23 collected ($2.50)
Seat 4: fanmtZ folded before Flop (didn't bet)
Seat 5: MrAndMisses (button) folded before Flop (didn't bet)
Seat 6: lixiangli (small blind) folded before Flop
Seat 7: matiko09 (big blind) folded before Flop
Seat 8: kift74 folded before Flop (didn't bet)
Seat 9: ardo888 folded before Flop (didn't bet)





PokerStars Hand #150752037041:  Hold'em No Limit ($0.50/$1.00 USD) - 2016/03/22 14:14:37 CET [2016/03/22 9:14:37 ET]
Table 'Arabis' 9-max Seat #9 is the button
Seat 2: ilaviiitech ($100 in chips) 
Seat 4: Painkiller72 ($126.67 in chips) 
Seat 5: matiko09 ($100 in chips) 
Seat 6: I The King I ($100 in chips) 
Seat 7: howsiao ($224.70 in chips) 
Seat 8: Bro_Happy ($198.83 in chips) 
Seat 9: cobrik23 ($98.85 in chips) 
ilaviiitech: posts small blind $0.50
Painkiller72: posts big blind $1
*** HOLE CARDS ***
Dealt to matiko09 [6h Ts]
matiko09: folds 
I The King I: folds 
howsiao: folds 
Bro_Happy: folds 
cobrik23: folds 
ilaviiitech: folds 
Uncalled bet ($0.50) returned to Painkiller72
Painkiller72 collected $1 from pot
Painkiller72: doesn't show hand 
*** SUMMARY ***
Total pot $1 | Rake $0 
Seat 2: ilaviiitech (small blind) folded before Flop
Seat 4: Painkiller72 (big blind) collected ($1)
Seat 5: matiko09 folded before Flop (didn't bet)
Seat 6: I The King I folded before Flop (didn't bet)
Seat 7: howsiao folded before Flop (didn't bet)
Seat 8: Bro_Happy folded before Flop (didn't bet)
Seat 9: cobrik23 (button) folded before Flop (didn't bet)





PokerStars Hand #150752039577:  Hold'em No Limit ($0.50/$1.00 USD) - 2016/03/22 14:14:41 CET [2016/03/22 9:14:41 ET]
Table 'Taygeta II' 9-max Seat #1 is the button
Seat 1: DevilisHEyz ($87.12 in chips) 
Seat 2: khan Erkesh ($194.04 in chips) 
Seat 3: Muinmyheart ($101.50 in chips) 
Seat 4: matiko09 ($100 in chips) 
Seat 5: RICKA16 ($101 in chips) 
Seat 6: I The King I ($108.50 in chips) 
Seat 7: Szevasztopol ($100 in chips) 
Seat 9: cobrik23 ($47.81 in chips) 
khan Erkesh: posts small blind $0.50
Muinmyheart: posts big blind $1
*** HOLE CARDS ***
Dealt to matiko09 [4c 5h]
matiko09: folds 
RICKA16: folds 
I The King I: folds 
Szevasztopol: folds 
cobrik23: raises $2 to $3
DevilisHEyz: calls $3
khan Erkesh: folds 
Muinmyheart: folds 
*** FLOP *** [3c 6d 9d]
cobrik23: checks 
DevilisHEyz: bets $3.58
cobrik23 has timed out
cobrik23: folds 
Uncalled bet ($3.58) returned to DevilisHEyz
DevilisHEyz collected $7.16 from pot
*** SUMMARY ***
Total pot $7.50 | Rake $0.34 
Board [3c 6d 9d]
Seat 1: DevilisHEyz (button) collected ($7.16)
Seat 2: khan Erkesh (small blind) folded before Flop
Seat 3: Muinmyheart (big blind) folded before Flop
Seat 4: matiko09 folded before Flop (didn't bet)
Seat 5: RICKA16 folded before Flop (didn't bet)
Seat 6: I The King I folded before Flop (didn't bet)
Seat 7: Szevasztopol folded before Flop (didn't bet)
Seat 9: cobrik23 folded on the Flop





PokerStars Hand #150752040694:  Hold'em No Limit ($0.50/$1.00 USD) - 2016/03/22 14:14:43 CET [2016/03/22 9:14:43 ET]
Table 'Crater II' 9-max Seat #2 is the button
Seat 1: matiko09 ($106.03 in chips) 
Seat 2: Eisbaerli85 ($119.72 in chips) 
Seat 3: lixiangli ($104.05 in chips) 
Seat 6: Kobiroga150 ($56.16 in chips) 
Seat 7: AWATAR 21 ($68.86 in chips) 
Seat 8: KronosAK ($115.28 in chips) 
Seat 9: I The King I ($117.20 in chips) 
lixiangli: posts small blind $0.50
Kobiroga150: posts big blind $1
*** HOLE CARDS ***
Dealt to matiko09 [Ts 8c]
AWATAR 21: raises $1 to $2
KronosAK: folds 
I The King I: folds 
matiko09: folds 
Eisbaerli85: folds 
lixiangli: folds 
Kobiroga150: calls $1
*** FLOP *** [5c Jd 4c]
Kobiroga150: checks 
AWATAR 21: checks 
*** TURN *** [5c Jd 4c] [Qc]
Kobiroga150: checks 
AWATAR 21: bets $4
Kobiroga150: folds 
Uncalled bet ($4) returned to AWATAR 21
AWATAR 21 collected $4.30 from pot
*** SUMMARY ***
Total pot $4.50 | Rake $0.20 
Board [5c Jd 4c Qc]
Seat 1: matiko09 folded before Flop (didn't bet)
Seat 2: Eisbaerli85 (button) folded before Flop (didn't bet)
Seat 3: lixiangli (small blind) folded before Flop
Seat 6: Kobiroga150 (big blind) folded on the Turn
Seat 7: AWATAR 21 collected ($4.30)
Seat 8: KronosAK folded before Flop (didn't bet)
Seat 9: I The King I folded before Flop (didn't bet)





PokerStars Hand #150752044477:  Hold'em No Limit ($1/$2 USD) - 2016/03/22 14:14:49 CET [2016/03/22 9:14:49 ET]
Table 'Kiso II' 9-max Seat #8 is the button
Seat 3: seouljam ($392.99 in chips) 
Seat 4: AMIRsuperfre ($37.50 in chips) 
Seat 5: Ilov3NBA ($309.84 in chips) 
Seat 6: KT90 ($286.84 in chips) 
Seat 7: Igoriah ($209.01 in chips) 
Seat 8: bananajoe001 ($85.72 in chips) 
Seat 9: matiko09 ($200 in chips) 
matiko09: posts small blind $1
Avtovo: is sitting out 
seouljam: posts big blind $2
*** HOLE CARDS ***
Dealt to matiko09 [Js Ah]
AMIRsuperfre: folds 
Ilov3NBA: folds 
KT90: folds 
Igoriah: folds 
bananajoe001: folds 
matiko09: raises $3 to $5
seouljam: calls $3
*** FLOP *** [Jc 7c 6c]
matiko09: bets $6.21
seouljam: calls $6.21
*** TURN *** [Jc 7c 6c] [4s]
matiko09: bets $14
seouljam: raises $18 to $32
matiko09: folds 
Uncalled bet ($18) returned to seouljam
seouljam collected $48.15 from pot
seouljam: doesn't show hand 
*** SUMMARY ***
Total pot $50.42 | Rake $2.27 
Board [Jc 7c 6c 4s]
Seat 3: seouljam (big blind) collected ($48.15)
Seat 4: AMIRsuperfre folded before Flop (didn't bet)
Seat 5: Ilov3NBA folded before Flop (didn't bet)
Seat 6: KT90 folded before Flop (didn't bet)
Seat 7: Igoriah folded before Flop (didn't bet)
Seat 8: bananajoe001 (button) folded before Flop (didn't bet)
Seat 9: matiko09 (small blind) folded on the Turn





PokerStars Hand #150752049179:  Hold'em No Limit ($0.50/$1.00 USD) - 2016/03/22 14:14:57 CET [2016/03/22 9:14:57 ET]
Table 'Arabis' 9-max Seat #2 is the button
Seat 2: ilaviiitech ($100 in chips) 
Seat 4: Painkiller72 ($127.17 in chips) 
Seat 5: matiko09 ($100 in chips) 
Seat 6: I The King I ($100 in chips) 
Seat 7: howsiao ($224.70 in chips) 
Seat 8: Bro_Happy ($198.83 in chips) 
Seat 9: cobrik23 ($98.85 in chips) 
Painkiller72: posts small blind $0.50
matiko09: posts big blind $1
*** HOLE CARDS ***
Dealt to matiko09 [6c Qc]
I The King I: folds 
I The King I leaves the table
howsiao: folds 
Bro_Happy: raises $2 to $3
cobrik23: folds 
ilaviiitech: folds 
Painkiller72: folds 
matiko09: folds 
Uncalled bet ($2) returned to Bro_Happy
Ilov3NBA joins the table at seat #6 
Bro_Happy collected $2.50 from pot
Bro_Happy: doesn't show hand 
*** SUMMARY ***
Total pot $2.50 | Rake $0 
Seat 2: ilaviiitech (button) folded before Flop (didn't bet)
Seat 4: Painkiller72 (small blind) folded before Flop
Seat 5: matiko09 (big blind) folded before Flop
Seat 6: I The King I folded before Flop (didn't bet)
Seat 7: howsiao folded before Flop (didn't bet)
Seat 8: Bro_Happy collected ($2.50)
Seat 9: cobrik23 folded before Flop (didn't bet)





PokerStars Hand #150752052340:  Hold'em No Limit ($0.50/$1.00 USD) - 2016/03/22 14:15:02 CET [2016/03/22 9:15:02 ET]
Table 'Colchis' 9-max Seat #8 is the button
Seat 1: theluckyjoe ($14.82 in chips) 
Seat 2: Ilov3NBA ($100 in chips) 
Seat 3: bragutza ($42.89 in chips) 
Seat 4: matiko09 ($101.07 in chips) 
Seat 5: lumen21 ($161.30 in chips) 
Seat 7: Dantist1122 ($100 in chips) 
Seat 8: cobrik23 ($48.26 in chips) 
Seat 9: ardo888 ($105.07 in chips) 
ardo888: posts small blind $0.50
theluckyjoe: posts big blind $1
*** HOLE CARDS ***
Dealt to matiko09 [Tc 8d]
Ilov3NBA: folds 
bragutza: folds 
matiko09: folds 
lumen21: folds 
Dantist1122: folds 
cobrik23: folds 
ardo888: folds 
Uncalled bet ($0.50) returned to theluckyjoe
theluckyjoe collected $1 from pot
theluckyjoe: doesn't show hand 
*** SUMMARY ***
Total pot $1 | Rake $0 
Seat 1: theluckyjoe (big blind) collected ($1)
Seat 2: Ilov3NBA folded before Flop (didn't bet)
Seat 3: bragutza folded before Flop (didn't bet)
Seat 4: matiko09 folded before Flop (didn't bet)
Seat 5: lumen21 folded before Flop (didn't bet)
Seat 7: Dantist1122 folded before Flop (didn't bet)
Seat 8: cobrik23 (button) folded before Flop (didn't bet)
Seat 9: ardo888 (small blind) folded before Flop





PokerStars Hand #150752058472:  Hold'em No Limit ($0.50/$1.00 USD) - 2016/03/22 14:15:13 CET [2016/03/22 9:15:13 ET]
Table 'Polyxena' 9-max Seat #6 is the button
Seat 1: I The King I ($111.23 in chips) 
Seat 2: cobrik23 ($68.11 in chips) 
Seat 4: fanmtZ ($43.95 in chips) 
Seat 5: MrAndMisses ($78.95 in chips) 
Seat 6: lixiangli ($121.55 in chips) 
Seat 7: matiko09 ($100 in chips) 
Seat 8: kift74 ($124.17 in chips) 
Seat 9: ardo888 ($106.67 in chips) 
matiko09: posts small blind $0.50
kift74: posts big blind $1
*** HOLE CARDS ***
Dealt to matiko09 [Kd 9d]
ardo888: folds 
I The King I: folds 
cobrik23: folds 
fanmtZ: folds 
MrAndMisses: folds 
lixiangli: folds 
matiko09: raises $1.50 to $2.50
kift74: calls $1.50
*** FLOP *** [2s 3s 3c]
matiko09: checks 
kift74: checks 
*** TURN *** [2s 3s 3c] [7d]
matiko09: checks 
kift74: checks 
*** RIVER *** [2s 3s 3c 7d] [2h]
matiko09: checks 
kift74: checks 
*** SHOW DOWN ***
matiko09: shows [Kd 9d] (two pair, Threes and Deuces)
kift74: shows [Kh 5h] (two pair, Threes and Deuces)
matiko09 collected $2.39 from pot
kift74 collected $2.39 from pot
*** SUMMARY ***
Total pot $5 | Rake $0.22 
Board [2s 3s 3c 7d 2h]
Seat 1: I The King I folded before Flop (didn't bet)
Seat 2: cobrik23 folded before Flop (didn't bet)
Seat 4: fanmtZ folded before Flop (didn't bet)
Seat 5: MrAndMisses folded before Flop (didn't bet)
Seat 6: lixiangli (button) folded before Flop (didn't bet)
Seat 7: matiko09 (small blind) showed [Kd 9d] and won ($2.39) with two pair, Threes and Deuces
Seat 8: kift74 (big blind) showed [Kh 5h] and won ($2.39) with two pair, Threes and Deuces
Seat 9: ardo888 folded before Flop (didn't bet)





PokerStars Hand #150752064695:  Hold'em No Limit ($0.50/$1.00 USD) - 2016/03/22 14:15:23 CET [2016/03/22 9:15:23 ET]
Table 'Arabis' 9-max Seat #4 is the button
Seat 2: ilaviiitech ($100 in chips) 
Seat 4: Painkiller72 ($126.67 in chips) 
Seat 5: matiko09 ($100 in chips) 
Seat 6: Ilov3NBA ($100 in chips) 
Seat 7: howsiao ($224.70 in chips) 
Seat 8: Bro_Happy ($200.33 in chips) 
Seat 9: cobrik23 ($98.85 in chips) 
matiko09: posts small blind $0.50
Ilov3NBA: posts big blind $1
*** HOLE CARDS ***
Dealt to matiko09 [Jc 4s]
howsiao: raises $2.50 to $3.50
Bro_Happy: folds 
cobrik23: folds 
ilaviiitech: folds 
Painkiller72: folds 
matiko09: folds 
Ilov3NBA: folds 
Uncalled bet ($2.50) returned to howsiao
howsiao collected $2.50 from pot
howsiao: doesn't show hand 
*** SUMMARY ***
Total pot $2.50 | Rake $0 
Seat 2: ilaviiitech folded before Flop (didn't bet)
Seat 4: Painkiller72 (button) folded before Flop (didn't bet)
Seat 5: matiko09 (small blind) folded before Flop
Seat 6: Ilov3NBA (big blind) folded before Flop
Seat 7: howsiao collected ($2.50)
Seat 8: Bro_Happy folded before Flop (didn't bet)
Seat 9: cobrik23 folded before Flop (didn't bet)





PokerStars Hand #150752081821:  Hold'em No Limit ($0.50/$1.00 USD) - 2016/03/22 14:15:51 CET [2016/03/22 9:15:51 ET]
Table 'Crater II' 9-max Seat #3 is the button
Seat 1: matiko09 ($106.03 in chips) 
Seat 2: Eisbaerli85 ($119.72 in chips) 
Seat 3: lixiangli ($103.55 in chips) 
Seat 6: Kobiroga150 ($54.16 in chips) 
Seat 7: AWATAR 21 ($71.16 in chips) 
Seat 8: KronosAK ($115.28 in chips) 
Seat 9: I The King I ($117.20 in chips) 
Kobiroga150: posts small blind $0.50
AWATAR 21: posts big blind $1
*** HOLE CARDS ***
Dealt to matiko09 [9h 2h]
KronosAK: folds 
I The King I: folds 
matiko09: folds 
Eisbaerli85: folds 
lixiangli: raises $1.50 to $2.50
Kobiroga150: folds 
AWATAR 21: folds 
Uncalled bet ($1.50) returned to lixiangli
lixiangli collected $2.50 from pot
*** SUMMARY ***
Total pot $2.50 | Rake $0 
Seat 1: matiko09 folded before Flop (didn't bet)
Seat 2: Eisbaerli85 folded before Flop (didn't bet)
Seat 3: lixiangli (button) collected ($2.50)
Seat 6: Kobiroga150 (small blind) folded before Flop
Seat 7: AWATAR 21 (big blind) folded before Flop
Seat 8: KronosAK folded before Flop (didn't bet)
Seat 9: I The King I folded before Flop (didn't bet)





PokerStars Hand #150752082373:  Hold'em No Limit ($0.50/$1.00 USD) - 2016/03/22 14:15:52 CET [2016/03/22 9:15:52 ET]
Table 'Colchis' 9-max Seat #9 is the button
Seat 1: theluckyjoe ($15.32 in chips) 
Seat 2: Ilov3NBA ($100 in chips) 
Seat 3: bragutza ($42.89 in chips) 
Seat 4: matiko09 ($101.07 in chips) 
Seat 5: lumen21 ($161.30 in chips) 
Seat 7: Dantist1122 ($100 in chips) 
Seat 8: cobrik23 ($48.26 in chips) 
Seat 9: ardo888 ($104.57 in chips) 
theluckyjoe: posts small blind $0.50
Ilov3NBA: posts big blind $1
*** HOLE CARDS ***
Dealt to matiko09 [Js 4s]
bragutza: folds 
matiko09: folds 
lumen21: folds 
Dantist1122: folds 
cobrik23: folds 
ardo888: folds 
theluckyjoe: raises $1 to $2
Ilov3NBA: folds 
Uncalled bet ($1) returned to theluckyjoe
theluckyjoe collected $2 from pot
theluckyjoe: doesn't show hand 
*** SUMMARY ***
Total pot $2 | Rake $0 
Seat 1: theluckyjoe (small blind) collected ($2)
Seat 2: Ilov3NBA (big blind) folded before Flop
Seat 3: bragutza folded before Flop (didn't bet)
Seat 4: matiko09 folded before Flop (didn't bet)
Seat 5: lumen21 folded before Flop (didn't bet)
Seat 7: Dantist1122 folded before Flop (didn't bet)
Seat 8: cobrik23 folded before Flop (didn't bet)
Seat 9: ardo888 (button) folded before Flop (didn't bet)





PokerStars Hand #150752086954:  Hold'em No Limit ($0.50/$1.00 USD) - 2016/03/22 14:16:00 CET [2016/03/22 9:16:00 ET]
Table 'Taygeta II' 9-max Seat #2 is the button
Seat 1: DevilisHEyz ($91.28 in chips) 
Seat 2: khan Erkesh ($193.54 in chips) 
Seat 3: Muinmyheart ($100.50 in chips) 
Seat 4: matiko09 ($100 in chips) 
Seat 5: RICKA16 ($101 in chips) 
Seat 6: I The King I ($108.50 in chips) 
Seat 7: Szevasztopol ($100 in chips) 
Seat 9: cobrik23 ($44.81 in chips) 
Muinmyheart: posts small blind $0.50
matiko09: posts big blind $1
*** HOLE CARDS ***
Dealt to matiko09 [Js 6c]
RICKA16: folds 
I The King I: folds 
Szevasztopol: raises $2 to $3
cobrik23: folds 
DevilisHEyz: folds 
khan Erkesh: folds 
Muinmyheart: folds 
matiko09: folds 
Uncalled bet ($2) returned to Szevasztopol
Szevasztopol collected $2.50 from pot
Szevasztopol: doesn't show hand 
*** SUMMARY ***
Total pot $2.50 | Rake $0 
Seat 1: DevilisHEyz folded before Flop (didn't bet)
Seat 2: khan Erkesh (button) folded before Flop (didn't bet)
Seat 3: Muinmyheart (small blind) folded before Flop
Seat 4: matiko09 (big blind) folded before Flop
Seat 5: RICKA16 folded before Flop (didn't bet)
Seat 6: I The King I folded before Flop (didn't bet)
Seat 7: Szevasztopol collected ($2.50)
Seat 9: cobrik23 folded before Flop (didn't bet)





PokerStars Hand #150752087809:  Hold'em No Limit ($1/$2 USD) - 2016/03/22 14:16:01 CET [2016/03/22 9:16:01 ET]
Table 'Kiso II' 9-max Seat #9 is the button
Seat 3: seouljam ($415.93 in chips) 
Seat 4: AMIRsuperfre ($37.50 in chips) 
Seat 5: Ilov3NBA ($309.84 in chips) 
Seat 6: KT90 ($286.84 in chips) 
Seat 7: Igoriah ($209.01 in chips) 
Seat 8: bananajoe001 ($85.72 in chips) 
Seat 9: matiko09 ($200 in chips) 
seouljam: posts small blind $1
AMIRsuperfre: posts big blind $2
*** HOLE CARDS ***
Dealt to matiko09 [8c Th]
Ilov3NBA: folds 
KT90: folds 
Igoriah: folds 
bananajoe001: calls $2
matiko09: folds 
seouljam: calls $1
AMIRsuperfre: checks 
*** FLOP *** [Kh 5c 8h]
seouljam: bets $3
AMIRsuperfre: folds 
bananajoe001: folds 
Uncalled bet ($3) returned to seouljam
seouljam collected $5.73 from pot
*** SUMMARY ***
Total pot $6 | Rake $0.27 
Board [Kh 5c 8h]
Seat 3: seouljam (small blind) collected ($5.73)
Seat 4: AMIRsuperfre (big blind) folded on the Flop
Seat 5: Ilov3NBA folded before Flop (didn't bet)
Seat 6: KT90 folded before Flop (didn't bet)
Seat 7: Igoriah folded before Flop (didn't bet)
Seat 8: bananajoe001 folded on the Flop
Seat 9: matiko09 (button) folded before Flop (didn't bet)





PokerStars Hand #150752088165:  Hold'em No Limit ($0.50/$1.00 USD) - 2016/03/22 14:16:02 CET [2016/03/22 9:16:02 ET]
Table 'Arabis' 9-max Seat #5 is the button
Seat 2: ilaviiitech ($100 in chips) 
Seat 4: Painkiller72 ($126.67 in chips) 
Seat 5: matiko09 ($100 in chips) 
Seat 6: Ilov3NBA ($100 in chips) 
Seat 7: howsiao ($226.20 in chips) 
Seat 8: Bro_Happy ($200.33 in chips) 
Seat 9: cobrik23 ($98.85 in chips) 
Ilov3NBA: posts small blind $0.50
howsiao: posts big blind $1
*** HOLE CARDS ***
Dealt to matiko09 [Qc Qs]
Bro_Happy: folds 
cobrik23: raises $2 to $3
ilaviiitech: folds 
Painkiller72: folds 
matiko09: calls $3
Ilov3NBA: folds 
howsiao: folds 
*** FLOP *** [6d 5h Qh]
cobrik23: bets $4.70
matiko09: calls $4.70
*** TURN *** [6d 5h Qh] [Tc]
cobrik23: bets $11
matiko09: calls $11
*** RIVER *** [6d 5h Qh Tc] [Kd]
cobrik23: bets $23
matiko09: raises $58.30 to $81.30 and is all-in
cobrik23 has timed out
cobrik23: folds 
Uncalled bet ($58.30) returned to matiko09
matiko09 collected $82.10 from pot
matiko09: doesn't show hand 
*** SUMMARY ***
Total pot $84.90 | Rake $2.80 
Board [6d 5h Qh Tc Kd]
Seat 2: ilaviiitech folded before Flop (didn't bet)
Seat 4: Painkiller72 folded before Flop (didn't bet)
Seat 5: matiko09 (button) collected ($82.10)
Seat 6: Ilov3NBA (small blind) folded before Flop
Seat 7: howsiao (big blind) folded before Flop
Seat 8: Bro_Happy folded before Flop (didn't bet)
Seat 9: cobrik23 folded on the River





PokerStars Hand #150752093063:  Hold'em No Limit ($0.50/$1.00 USD) - 2016/03/22 14:16:10 CET [2016/03/22 9:16:10 ET]
Table 'Stephano II' 9-max Seat #5 is the button
Seat 1: ardo888 ($100 in chips) 
Seat 2: buckshot150 ($77.75 in chips) 
Seat 3: lombardo11 ($77 in chips) 
Seat 4: AWATAR 21 ($137.98 in chips) 
Seat 5: mb2part ($98.50 in chips) 
Seat 6: beterc0re ($100 in chips) 
Seat 7: ilaviiitech ($100 in chips) 
Seat 8: Painkiller72 ($126.81 in chips) 
Seat 9: matiko09 ($147.19 in chips) 
beterc0re: posts small blind $0.50
ilaviiitech: posts big blind $1
*** HOLE CARDS ***
Dealt to matiko09 [7d 3c]
Painkiller72: folds 
matiko09: folds 
ardo888: folds 
buckshot150: raises $2 to $3
lombardo11: folds 
AWATAR 21: folds 
mb2part: folds 
beterc0re: folds 
ilaviiitech: folds 
Uncalled bet ($2) returned to buckshot150
buckshot150 collected $2.50 from pot
buckshot150: doesn't show hand 
*** SUMMARY ***
Total pot $2.50 | Rake $0 
Seat 1: ardo888 folded before Flop (didn't bet)
Seat 2: buckshot150 collected ($2.50)
Seat 3: lombardo11 folded before Flop (didn't bet)
Seat 4: AWATAR 21 folded before Flop (didn't bet)
Seat 5: mb2part (button) folded before Flop (didn't bet)
Seat 6: beterc0re (small blind) folded before Flop
Seat 7: ilaviiitech (big blind) folded before Flop
Seat 8: Painkiller72 folded before Flop (didn't bet)
Seat 9: matiko09 folded before Flop (didn't bet)





PokerStars Hand #150752094830:  Hold'em No Limit ($0.50/$1.00 USD) - 2016/03/22 14:16:13 CET [2016/03/22 9:16:13 ET]
Table 'Crater II' 9-max Seat #6 is the button
Seat 1: matiko09 ($106.03 in chips) 
Seat 2: Eisbaerli85 ($119.72 in chips) 
Seat 3: lixiangli ($105.05 in chips) 
Seat 6: Kobiroga150 ($53.66 in chips) 
Seat 7: AWATAR 21 ($70.16 in chips) 
Seat 8: KronosAK ($115.28 in chips) 
Seat 9: I The King I ($117.20 in chips) 
AWATAR 21: posts small blind $0.50
KronosAK: posts big blind $1
*** HOLE CARDS ***
Dealt to matiko09 [4c Qs]
I The King I: folds 
matiko09: folds 
Eisbaerli85: folds 
lixiangli: folds 
Kobiroga150: raises $1 to $2
AWATAR 21: folds 
KronosAK: folds 
Uncalled bet ($1) returned to Kobiroga150
Kobiroga150 collected $2.50 from pot
Kobiroga150: doesn't show hand 
*** SUMMARY ***
Total pot $2.50 | Rake $0 
Seat 1: matiko09 folded before Flop (didn't bet)
Seat 2: Eisbaerli85 folded before Flop (didn't bet)
Seat 3: lixiangli folded before Flop (didn't bet)
Seat 6: Kobiroga150 (button) collected ($2.50)
Seat 7: AWATAR 21 (small blind) folded before Flop
Seat 8: KronosAK (big blind) folded before Flop
Seat 9: I The King I folded before Flop (didn't bet)





PokerStars Hand #150752096814:  Hold'em No Limit ($0.50/$1.00 USD) - 2016/03/22 14:16:16 CET [2016/03/22 9:16:16 ET]
Table 'Harding' 9-max Seat #6 is the button
Seat 1: matiko09 ($105.76 in chips) 
Seat 2: I The King I ($146.18 in chips) 
Seat 3: Avtovo ($100 in chips) 
Seat 4: lixiangli ($140.61 in chips) 
Seat 5: DevilisHEyz ($136.74 in chips) 
Seat 6: Ilov3NBA ($107.12 in chips) 
Seat 7: mrhighryza ($109.64 in chips) 
Seat 9: omorfadramou ($100 in chips) 
mrhighryza: posts small blind $0.50
omorfadramou: posts big blind $1
*** HOLE CARDS ***
Dealt to matiko09 [8h As]
matiko09: folds 
I The King I: folds 
lixiangli is disconnected 
Avtovo has timed out
Avtovo: folds 
lixiangli is connected 
lixiangli: raises $1.50 to $2.50
DevilisHEyz: folds 
Ilov3NBA: folds 
mrhighryza: calls $2
omorfadramou: folds 
*** FLOP *** [2h 6s 7c]
mrhighryza: bets $1
lixiangli: calls $1
*** TURN *** [2h 6s 7c] [5h]
mrhighryza: bets $3
lixiangli: calls $3
*** RIVER *** [2h 6s 7c 5h] [Ah]
mrhighryza: checks 
lixiangli: checks 
*** SHOW DOWN ***
mrhighryza: shows [2c 9c] (a pair of Deuces)
lixiangli: shows [8c 8s] (a pair of Eights)
lixiangli collected $13.37 from pot
*** SUMMARY ***
Total pot $14 | Rake $0.63 
Board [2h 6s 7c 5h Ah]
Seat 1: matiko09 folded before Flop (didn't bet)
Seat 2: I The King I folded before Flop (didn't bet)
Seat 3: Avtovo folded before Flop (didn't bet)
Seat 4: lixiangli showed [8c 8s] and won ($13.37) with a pair of Eights
Seat 5: DevilisHEyz folded before Flop (didn't bet)
Seat 6: Ilov3NBA (button) folded before Flop (didn't bet)
Seat 7: mrhighryza (small blind) showed [2c 9c] and lost with a pair of Deuces
Seat 9: omorfadramou (big blind) folded before Flop





PokerStars Hand #150752099129:  Hold'em No Limit ($0.50/$1.00 USD) - 2016/03/22 14:16:20 CET [2016/03/22 9:16:20 ET]
Table 'Polyxena' 9-max Seat #7 is the button
Seat 1: I The King I ($111.23 in chips) 
Seat 2: cobrik23 ($68.11 in chips) 
Seat 4: fanmtZ ($43.95 in chips) 
Seat 5: MrAndMisses ($78.95 in chips) 
Seat 6: lixiangli ($121.55 in chips) 
Seat 7: matiko09 ($100 in chips) 
Seat 8: kift74 ($124.06 in chips) 
Seat 9: ardo888 ($106.67 in chips) 
kift74: posts small blind $0.50
ardo888: posts big blind $1
*** HOLE CARDS ***
Dealt to matiko09 [Qh Td]
I The King I: folds 
cobrik23: folds 
fanmtZ: folds 
MrAndMisses: calls $1
lixiangli: folds 
matiko09: raises $3 to $4
kift74: folds 
ardo888: calls $3
MrAndMisses: calls $3
*** FLOP *** [3d Qd 2h]
ardo888: checks 
MrAndMisses: checks 
matiko09: bets $7
ardo888: calls $7
lixiangli is disconnected 
MrAndMisses: calls $7
*** TURN *** [3d Qd 2h] [4h]
ardo888: bets $24.50
MrAndMisses: calls $24.50
matiko09: folds 
*** RIVER *** [3d Qd 2h 4h] [9c]
ardo888: bets $58.18
MrAndMisses: folds 
Uncalled bet ($58.18) returned to ardo888
ardo888 collected $79.70 from pot
ardo888: doesn't show hand 
*** SUMMARY ***
Total pot $82.50 | Rake $2.80 
Board [3d Qd 2h 4h 9c]
Seat 1: I The King I folded before Flop (didn't bet)
Seat 2: cobrik23 folded before Flop (didn't bet)
Seat 4: fanmtZ folded before Flop (didn't bet)
Seat 5: MrAndMisses folded on the River
Seat 6: lixiangli folded before Flop (didn't bet)
Seat 7: matiko09 (button) folded on the Turn
Seat 8: kift74 (small blind) folded before Flop
Seat 9: ardo888 (big blind) collected ($79.70)





PokerStars Hand #150752103403:  Hold'em No Limit ($0.50/$1.00 USD) - 2016/03/22 14:16:27 CET [2016/03/22 9:16:27 ET]
Table 'Colchis' 9-max Seat #1 is the button
Seat 1: theluckyjoe ($16.32 in chips) 
Seat 2: Ilov3NBA ($100 in chips) 
Seat 3: bragutza ($42.89 in chips) 
Seat 4: matiko09 ($101.07 in chips) 
Seat 5: lumen21 ($161.30 in chips) 
Seat 7: Dantist1122 ($100 in chips) 
Seat 8: cobrik23 ($48.26 in chips) 
Seat 9: ardo888 ($104.57 in chips) 
Ilov3NBA: posts small blind $0.50
bragutza: posts big blind $1
*** HOLE CARDS ***
Dealt to matiko09 [8h 7d]
matiko09: folds 
lumen21: raises $2 to $3
Dantist1122: folds 
cobrik23: folds 
ardo888: folds 
theluckyjoe: folds 
Ilov3NBA: folds 
bragutza: calls $2
*** FLOP *** [4s 6h 3d]
bragutza: checks 
lumen21: checks 
*** TURN *** [4s 6h 3d] [Tc]
bragutza: bets $3
lumen21: folds 
Uncalled bet ($3) returned to bragutza
bragutza collected $6.21 from pot
bragutza: doesn't show hand 
*** SUMMARY ***
Total pot $6.50 | Rake $0.29 
Board [4s 6h 3d Tc]
Seat 1: theluckyjoe (button) folded before Flop (didn't bet)
Seat 2: Ilov3NBA (small blind) folded before Flop
Seat 3: bragutza (big blind) collected ($6.21)
Seat 4: matiko09 folded before Flop (didn't bet)
Seat 5: lumen21 folded on the Turn
Seat 7: Dantist1122 folded before Flop (didn't bet)
Seat 8: cobrik23 folded before Flop (didn't bet)
Seat 9: ardo888 folded before Flop (didn't bet)





PokerStars Hand #150752108084:  Hold'em No Limit ($0.50/$1.00 USD) - 2016/03/22 14:16:35 CET [2016/03/22 9:16:35 ET]
Table 'Taygeta II' 9-max Seat #3 is the button
Seat 1: DevilisHEyz ($91.28 in chips) 
Seat 2: khan Erkesh ($193.54 in chips) 
Seat 3: Muinmyheart ($100 in chips) 
Seat 4: matiko09 ($100 in chips) 
Seat 5: RICKA16 ($101 in chips) 
Seat 6: I The King I ($108.50 in chips) 
Seat 7: Szevasztopol ($101.50 in chips) 
Seat 9: cobrik23 ($44.81 in chips) 
matiko09: posts small blind $0.50
RICKA16: posts big blind $1
*** HOLE CARDS ***
Dealt to matiko09 [Qd Jh]
I The King I: folds 
Szevasztopol: folds 
cobrik23: folds 
DevilisHEyz: folds 
khan Erkesh: folds 
Muinmyheart: raises $1 to $2
matiko09: folds 
RICKA16: folds 
Uncalled bet ($1) returned to Muinmyheart
Muinmyheart collected $2.50 from pot
Muinmyheart: doesn't show hand 
*** SUMMARY ***
Total pot $2.50 | Rake $0 
Seat 1: DevilisHEyz folded before Flop (didn't bet)
Seat 2: khan Erkesh folded before Flop (didn't bet)
Seat 3: Muinmyheart (button) collected ($2.50)
Seat 4: matiko09 (small blind) folded before Flop
Seat 5: RICKA16 (big blind) folded before Flop
Seat 6: I The King I folded before Flop (didn't bet)
Seat 7: Szevasztopol folded before Flop (didn't bet)
Seat 9: cobrik23 folded before Flop (didn't bet)





PokerStars Hand #150752108861:  Hold'em No Limit ($0.50/$1.00 USD) - 2016/03/22 14:16:36 CET [2016/03/22 9:16:36 ET]
Table 'Stephano II' 9-max Seat #6 is the button
Seat 1: ardo888 ($100 in chips) 
Seat 2: buckshot150 ($79.25 in chips) 
Seat 3: lombardo11 ($77 in chips) 
Seat 4: AWATAR 21 ($137.98 in chips) 
Seat 5: mb2part ($98.50 in chips) 
Seat 6: beterc0re ($100 in chips) 
Seat 7: ilaviiitech ($100 in chips) 
Seat 9: matiko09 ($147.19 in chips) 
ilaviiitech: posts small blind $0.50
Painkiller72: is sitting out 
matiko09: posts big blind $1
*** HOLE CARDS ***
Dealt to matiko09 [6s 4s]
Painkiller72 leaves the table
omorfadramou joins the table at seat #8 
ardo888: folds 
buckshot150: folds 
ardo888 leaves the table
I The King I joins the table at seat #1 
lombardo11: folds 
omorfadramou leaves the table
AWATAR 21: raises $1 to $2
I The King I leaves the table
mb2part: folds 
beterc0re: calls $2
ilaviiitech: folds 
buckshot150 is disconnected 
matiko09: folds 
*** FLOP *** [Jh 6c 8h]
AWATAR 21: bets $2.50
KingCastle77 joins the table at seat #8 
beterc0re: raises $6.23 to $8.73
AWATAR 21: calls $6.23
*** TURN *** [Jh 6c 8h] [9d]
AWATAR 21: checks 
beterc0re: bets $16.59
cipriank11 joins the table at seat #1 
AWATAR 21: calls $16.59
*** RIVER *** [Jh 6c 8h 9d] [Th]
AWATAR 21: checks 
beterc0re: bets $28.94
AWATAR 21: folds 
Uncalled bet ($28.94) returned to beterc0re
beterc0re collected $53.61 from pot
beterc0re: doesn't show hand 
*** SUMMARY ***
Total pot $56.14 | Rake $2.53 
Board [Jh 6c 8h 9d Th]
Seat 1: ardo888 folded before Flop (didn't bet)
Seat 2: buckshot150 folded before Flop (didn't bet)
Seat 3: lombardo11 folded before Flop (didn't bet)
Seat 4: AWATAR 21 folded on the River
Seat 5: mb2part folded before Flop (didn't bet)
Seat 6: beterc0re (button) collected ($53.61)
Seat 7: ilaviiitech (small blind) folded before Flop
Seat 9: matiko09 (big blind) folded before Flop





PokerStars Hand #150752114598:  Hold'em No Limit ($1/$2 USD) - 2016/03/22 14:16:45 CET [2016/03/22 9:16:45 ET]
Table 'Kiso II' 9-max Seat #3 is the button
Seat 3: seouljam ($419.66 in chips) 
Seat 4: AMIRsuperfre ($35.50 in chips) 
Seat 5: Ilov3NBA ($309.84 in chips) 
Seat 6: KT90 ($286.84 in chips) 
Seat 7: Igoriah ($209.01 in chips) 
Seat 8: bananajoe001 ($83.72 in chips) 
Seat 9: matiko09 ($200 in chips) 
AMIRsuperfre: posts small blind $1
Ilov3NBA: posts big blind $2
*** HOLE CARDS ***
Dealt to matiko09 [Th 3d]
KT90: folds 
Igoriah: folds 
bananajoe001: folds 
matiko09: folds 
seouljam: folds 
AMIRsuperfre: calls $1
Ilov3NBA: checks 
*** FLOP *** [5h Jc Td]
AMIRsuperfre: checks 
Ilov3NBA: checks 
*** TURN *** [5h Jc Td] [Ah]
AMIRsuperfre: checks 
Ilov3NBA: checks 
*** RIVER *** [5h Jc Td Ah] [Qh]
AMIRsuperfre: checks 
Ilov3NBA: checks 
*** SHOW DOWN ***
AMIRsuperfre: shows [Js 9h] (a pair of Jacks)
Ilov3NBA: mucks hand 
AMIRsuperfre collected $3.82 from pot
*** SUMMARY ***
Total pot $4 | Rake $0.18 
Board [5h Jc Td Ah Qh]
Seat 3: seouljam (button) folded before Flop (didn't bet)
Seat 4: AMIRsuperfre (small blind) showed [Js 9h] and won ($3.82) with a pair of Jacks
Seat 5: Ilov3NBA (big blind) mucked [3c 5s]
Seat 6: KT90 folded before Flop (didn't bet)
Seat 7: Igoriah folded before Flop (didn't bet)
Seat 8: bananajoe001 folded before Flop (didn't bet)
Seat 9: matiko09 folded before Flop (didn't bet)





PokerStars Hand #150752122705:  Hold'em No Limit ($0.50/$1.00 USD) - 2016/03/22 14:16:59 CET [2016/03/22 9:16:59 ET]
Table 'Crater II' 9-max Seat #7 is the button
Seat 1: matiko09 ($106.03 in chips) 
Seat 2: Eisbaerli85 ($119.72 in chips) 
Seat 3: lixiangli ($105.05 in chips) 
Seat 6: Kobiroga150 ($55.16 in chips) 
Seat 7: AWATAR 21 ($69.66 in chips) 
Seat 8: KronosAK ($114.28 in chips) 
Seat 9: I The King I ($117.20 in chips) 
KronosAK: posts small blind $0.50
I The King I: posts big blind $1
*** HOLE CARDS ***
Dealt to matiko09 [Kc 5d]
matiko09: folds 
Eisbaerli85: raises $2 to $3
lixiangli is disconnected 
lixiangli is connected 
lixiangli: folds 
Kobiroga150: folds 
AWATAR 21: folds 
KronosAK: folds 
I The King I: folds 
Uncalled bet ($2) returned to Eisbaerli85
Eisbaerli85 collected $2.50 from pot
*** SUMMARY ***
Total pot $2.50 | Rake $0 
Seat 1: matiko09 folded before Flop (didn't bet)
Seat 2: Eisbaerli85 collected ($2.50)
Seat 3: lixiangli folded before Flop (didn't bet)
Seat 6: Kobiroga150 folded before Flop (didn't bet)
Seat 7: AWATAR 21 (button) folded before Flop (didn't bet)
Seat 8: KronosAK (small blind) folded before Flop
Seat 9: I The King I (big blind) folded before Flop





PokerStars Hand #150752124154:  Hold'em No Limit ($0.50/$1.00 USD) - 2016/03/22 14:17:01 CET [2016/03/22 9:17:01 ET]
Table 'Taygeta II' 9-max Seat #4 is the button
Seat 1: DevilisHEyz ($91.28 in chips) 
Seat 2: khan Erkesh ($193.54 in chips) 
Seat 3: Muinmyheart ($101.50 in chips) 
Seat 4: matiko09 ($100 in chips) 
Seat 5: RICKA16 ($100 in chips) 
Seat 6: I The King I ($108.50 in chips) 
Seat 7: Szevasztopol ($101.50 in chips) 
Seat 9: cobrik23 ($44.81 in chips) 
RICKA16: posts small blind $0.50
I The King I: posts big blind $1
*** HOLE CARDS ***
Dealt to matiko09 [6s 6c]
Szevasztopol: folds 
cobrik23: folds 
DevilisHEyz has timed out
DevilisHEyz: folds 
khan Erkesh: raises $2 to $3
Muinmyheart: calls $3
matiko09: calls $3
RICKA16: folds 
I The King I: folds 
*** FLOP *** [Kh 3s Td]
khan Erkesh: checks 
Muinmyheart: checks 
matiko09: checks 
*** TURN *** [Kh 3s Td] [7c]
khan Erkesh: checks 
Muinmyheart: checks 
matiko09: checks 
*** RIVER *** [Kh 3s Td 7c] [4h]
khan Erkesh: bets $6
Muinmyheart: folds 
matiko09: folds 
Uncalled bet ($6) returned to khan Erkesh
khan Erkesh collected $10.03 from pot
khan Erkesh: doesn't show hand 
*** SUMMARY ***
Total pot $10.50 | Rake $0.47 
Board [Kh 3s Td 7c 4h]
Seat 1: DevilisHEyz folded before Flop (didn't bet)
Seat 2: khan Erkesh collected ($10.03)
Seat 3: Muinmyheart folded on the River
Seat 4: matiko09 (button) folded on the River
Seat 5: RICKA16 (small blind) folded before Flop
Seat 6: I The King I (big blind) folded before Flop
Seat 7: Szevasztopol folded before Flop (didn't bet)
Seat 9: cobrik23 folded before Flop (didn't bet)





PokerStars Hand #150752136339:  Hold'em No Limit ($0.50/$1.00 USD) - 2016/03/22 14:17:21 CET [2016/03/22 9:17:21 ET]
Table 'Colchis' 9-max Seat #2 is the button
Seat 1: theluckyjoe ($16.32 in chips) 
Seat 2: Ilov3NBA ($100 in chips) 
Seat 3: bragutza ($46.10 in chips) 
Seat 4: matiko09 ($101.07 in chips) 
Seat 5: lumen21 ($158.30 in chips) 
Seat 7: Dantist1122 ($100 in chips) 
Seat 8: cobrik23 ($48.26 in chips) 
Seat 9: ardo888 ($104.57 in chips) 
bragutza: posts small blind $0.50
matiko09: posts big blind $1
*** HOLE CARDS ***
Dealt to matiko09 [9h Td]
lumen21: folds 
Dantist1122: folds 
cobrik23: folds 
ardo888: folds 
theluckyjoe: calls $1
Ilov3NBA: raises $4 to $5
bragutza: calls $4.50
matiko09: folds 
theluckyjoe: folds 
*** FLOP *** [Qs 3c Ac]
bragutza: checks 
Ilov3NBA: bets $8.48
bragutza: calls $8.48
*** TURN *** [Qs 3c Ac] [3h]
bragutza: checks 
Ilov3NBA: bets $19.50
bragutza: raises $13.12 to $32.62 and is all-in
Ilov3NBA: calls $13.12
*** RIVER *** [Qs 3c Ac 3h] [5c]
*** SHOW DOWN ***
bragutza: shows [As 2s] (two pair, Aces and Threes)
Ilov3NBA: shows [Qd Ad] (two pair, Aces and Queens)
Ilov3NBA collected $91.40 from pot
*** SUMMARY ***
Total pot $94.20 | Rake $2.80 
Board [Qs 3c Ac 3h 5c]
Seat 1: theluckyjoe folded before Flop
Seat 2: Ilov3NBA (button) showed [Qd Ad] and won ($91.40) with two pair, Aces and Queens
Seat 3: bragutza (small blind) showed [As 2s] and lost with two pair, Aces and Threes
Seat 4: matiko09 (big blind) folded before Flop
Seat 5: lumen21 folded before Flop (didn't bet)
Seat 7: Dantist1122 folded before Flop (didn't bet)
Seat 8: cobrik23 folded before Flop (didn't bet)
Seat 9: ardo888 folded before Flop (didn't bet)





PokerStars Hand #150752137242:  Hold'em No Limit ($0.50/$1.00 USD) - 2016/03/22 14:17:23 CET [2016/03/22 9:17:23 ET]
Table 'Miranda' 9-max Seat #3 is the button
Seat 1: cobrik23 ($61.53 in chips) 
Seat 2: Szevasztopol ($110.44 in chips) 
Seat 3: Muinmyheart ($100 in chips) 
Seat 4: bilukm ($59.71 in chips) 
Seat 6: matiko09 ($100 in chips) 
Seat 7: RICKA16 ($104.71 in chips) 
Seat 8: hammerwife ($101.50 in chips) 
Seat 9: ardo888 ($168.41 in chips) 
bilukm: posts small blind $0.50
matiko09: posts big blind $1
*** HOLE CARDS ***
Dealt to matiko09 [Js Jd]
RICKA16: folds 
hammerwife: folds 
ardo888: folds 
cobrik23: folds 
Szevasztopol: folds 
Muinmyheart: raises $1.20 to $2.20
bilukm: calls $1.70
matiko09: raises $7.80 to $10
Muinmyheart: folds 
bilukm: folds 
Uncalled bet ($7.80) returned to matiko09
matiko09 collected $6.60 from pot
matiko09: doesn't show hand 
*** SUMMARY ***
Total pot $6.60 | Rake $0 
Seat 1: cobrik23 folded before Flop (didn't bet)
Seat 2: Szevasztopol folded before Flop (didn't bet)
Seat 3: Muinmyheart (button) folded before Flop
Seat 4: bilukm (small blind) folded before Flop
Seat 6: matiko09 (big blind) collected ($6.60)
Seat 7: RICKA16 folded before Flop (didn't bet)
Seat 8: hammerwife folded before Flop (didn't bet)
Seat 9: ardo888 folded before Flop (didn't bet)





PokerStars Hand #150752141757:  Hold'em No Limit ($1/$2 USD) - 2016/03/22 14:17:30 CET [2016/03/22 9:17:30 ET]
Table 'Kiso II' 9-max Seat #4 is the button
Seat 3: seouljam ($419.66 in chips) 
Seat 4: AMIRsuperfre ($37.32 in chips) 
Seat 5: Ilov3NBA ($307.84 in chips) 
Seat 6: KT90 ($286.84 in chips) 
Seat 7: Igoriah ($209.01 in chips) 
Seat 8: bananajoe001 ($83.72 in chips) 
Seat 9: matiko09 ($200 in chips) 
Ilov3NBA: posts small blind $1
KT90: posts big blind $2
*** HOLE CARDS ***
Dealt to matiko09 [9d Jd]
Igoriah: folds 
bananajoe001: folds 
matiko09: raises $3 to $5
seouljam: folds 
AMIRsuperfre: calls $5
Ilov3NBA: folds 
KT90: folds 
*** FLOP *** [6d Ac Kh]
matiko09: checks 
AMIRsuperfre: checks 
*** TURN *** [6d Ac Kh] [Jc]
matiko09: checks 
AMIRsuperfre: bets $7
matiko09: folds 
Uncalled bet ($7) returned to AMIRsuperfre
AMIRsuperfre collected $12.42 from pot
AMIRsuperfre: doesn't show hand 
*** SUMMARY ***
Total pot $13 | Rake $0.58 
Board [6d Ac Kh Jc]
Seat 3: seouljam folded before Flop (didn't bet)
Seat 4: AMIRsuperfre (button) collected ($12.42)
Seat 5: Ilov3NBA (small blind) folded before Flop
Seat 6: KT90 (big blind) folded before Flop
Seat 7: Igoriah folded before Flop (didn't bet)
Seat 8: bananajoe001 folded before Flop (didn't bet)
Seat 9: matiko09 folded on the Turn





PokerStars Hand #150752156002:  Hold'em No Limit ($0.50/$1.00 USD) - 2016/03/22 14:17:54 CET [2016/03/22 9:17:54 ET]
Table 'Miranda' 9-max Seat #4 is the button
Seat 1: cobrik23 ($61.53 in chips) 
Seat 2: Szevasztopol ($110.44 in chips) 
Seat 3: Muinmyheart ($100 in chips) 
Seat 4: bilukm ($57.51 in chips) 
Seat 6: matiko09 ($104.40 in chips) 
Seat 7: RICKA16 ($104.71 in chips) 
Seat 8: hammerwife ($101.50 in chips) 
Seat 9: ardo888 ($168.41 in chips) 
matiko09: posts small blind $0.50
RICKA16: posts big blind $1
*** HOLE CARDS ***
Dealt to matiko09 [5s Tc]
hammerwife: folds 
ardo888: raises $2 to $3
cobrik23: folds 
Szevasztopol: folds 
Muinmyheart: folds 
bilukm: calls $3
matiko09: folds 
RICKA16: folds 
*** FLOP *** [6c Ah Td]
ardo888: checks 
bilukm: checks 
*** TURN *** [6c Ah Td] [3s]
ardo888: bets $4.50
bilukm: calls $4.50
*** RIVER *** [6c Ah Td 3s] [8s]
ardo888: bets $9.50
bilukm: folds 
Uncalled bet ($9.50) returned to ardo888
ardo888 collected $15.76 from pot
ardo888: doesn't show hand 
*** SUMMARY ***
Total pot $16.50 | Rake $0.74 
Board [6c Ah Td 3s 8s]
Seat 1: cobrik23 folded before Flop (didn't bet)
Seat 2: Szevasztopol folded before Flop (didn't bet)
Seat 3: Muinmyheart folded before Flop (didn't bet)
Seat 4: bilukm (button) folded on the River
Seat 6: matiko09 (small blind) folded before Flop
Seat 7: RICKA16 (big blind) folded before Flop
Seat 8: hammerwife folded before Flop (didn't bet)
Seat 9: ardo888 collected ($15.76)





PokerStars Hand #150752163196:  Hold'em No Limit ($0.50/$1.00 USD) - 2016/03/22 14:18:05 CET [2016/03/22 9:18:05 ET]
Table 'Crater II' 9-max Seat #8 is the button
Seat 1: matiko09 ($106.03 in chips) 
Seat 2: Eisbaerli85 ($121.22 in chips) 
Seat 3: lixiangli ($105.05 in chips) 
Seat 6: Kobiroga150 ($55.16 in chips) 
Seat 7: AWATAR 21 ($69.66 in chips) 
Seat 8: KronosAK ($113.78 in chips) 
Seat 9: I The King I ($116.20 in chips) 
I The King I: posts small blind $0.50
matiko09: posts big blind $1
*** HOLE CARDS ***
Dealt to matiko09 [6h 5h]
Eisbaerli85: raises $2 to $3
lixiangli: folds 
Kobiroga150: folds 
AWATAR 21: folds 
KronosAK: folds 
I The King I: folds 
matiko09: folds 
Uncalled bet ($2) returned to Eisbaerli85
Eisbaerli85 collected $2.50 from pot
*** SUMMARY ***
Total pot $2.50 | Rake $0 
Seat 1: matiko09 (big blind) folded before Flop
Seat 2: Eisbaerli85 collected ($2.50)
Seat 3: lixiangli folded before Flop (didn't bet)
Seat 6: Kobiroga150 folded before Flop (didn't bet)
Seat 7: AWATAR 21 folded before Flop (didn't bet)
Seat 8: KronosAK (button) folded before Flop (didn't bet)
Seat 9: I The King I (small blind) folded before Flop





PokerStars Hand #150752168614:  Hold'em No Limit ($1/$2 USD) - 2016/03/22 14:18:14 CET [2016/03/22 9:18:14 ET]
Table 'Kiso II' 9-max Seat #5 is the button
Seat 3: seouljam ($419.66 in chips) 
Seat 4: AMIRsuperfre ($44.74 in chips) 
Seat 5: Ilov3NBA ($306.84 in chips) 
Seat 6: KT90 ($284.84 in chips) 
Seat 7: Igoriah ($209.01 in chips) 
Seat 8: bananajoe001 ($83.72 in chips) 
Seat 9: matiko09 ($200 in chips) 
KT90: posts small blind $1
Igoriah: posts big blind $2
*** HOLE CARDS ***
Dealt to matiko09 [8c 5c]
bananajoe001: folds 
matiko09: folds 
seouljam: folds 
AMIRsuperfre: calls $2
Ilov3NBA: folds 
KT90: raises $4 to $6
Igoriah: folds 
AMIRsuperfre: calls $4
*** FLOP *** [Kc 8h 6d]
KT90: bets $8
AMIRsuperfre: calls $8
*** TURN *** [Kc 8h 6d] [2c]
KT90: bets $20
AMIRsuperfre: calls $20
*** RIVER *** [Kc 8h 6d 2c] [Ts]
KT90: bets $12
AMIRsuperfre: calls $10.74 and is all-in
Uncalled bet ($1.26) returned to KT90
*** SHOW DOWN ***
KT90: shows [2s 2h] (three of a kind, Deuces)
AMIRsuperfre: shows [Kh Jc] (a pair of Kings)
KT90 collected $88.68 from pot
*** SUMMARY ***
Total pot $91.48 | Rake $2.80 
Board [Kc 8h 6d 2c Ts]
Seat 3: seouljam folded before Flop (didn't bet)
Seat 4: AMIRsuperfre showed [Kh Jc] and lost with a pair of Kings
Seat 5: Ilov3NBA (button) folded before Flop (didn't bet)
Seat 6: KT90 (small blind) showed [2s 2h] and won ($88.68) with three of a kind, Deuces
Seat 7: Igoriah (big blind) folded before Flop
Seat 8: bananajoe001 folded before Flop (didn't bet)
Seat 9: matiko09 folded before Flop (didn't bet)





PokerStars Hand #150752169960:  Hold'em No Limit ($0.50/$1.00 USD) - 2016/03/22 14:18:16 CET [2016/03/22 9:18:16 ET]
Table 'Polyxena' 9-max Seat #8 is the button
Seat 1: I The King I ($111.23 in chips) 
Seat 2: cobrik23 ($68.11 in chips) 
Seat 4: fanmtZ ($43.95 in chips) 
Seat 5: MrAndMisses ($43.45 in chips) 
Seat 6: lixiangli ($121.55 in chips) 
Seat 7: matiko09 ($100 in chips) 
Seat 8: kift74 ($123.56 in chips) 
Seat 9: ardo888 ($150.87 in chips) 
ardo888: posts small blind $0.50
I The King I: posts big blind $1
*** HOLE CARDS ***
Dealt to matiko09 [6h Qd]
cobrik23: folds 
fanmtZ: folds 
MrAndMisses: folds 
lixiangli: folds 
matiko09: folds 
kift74: folds 
ardo888: folds 
Uncalled bet ($0.50) returned to I The King I
I The King I collected $1 from pot
I The King I: doesn't show hand 
*** SUMMARY ***
Total pot $1 | Rake $0 
Seat 1: I The King I (big blind) collected ($1)
Seat 2: cobrik23 folded before Flop (didn't bet)
Seat 4: fanmtZ folded before Flop (didn't bet)
Seat 5: MrAndMisses folded before Flop (didn't bet)
Seat 6: lixiangli folded before Flop (didn't bet)
Seat 7: matiko09 folded before Flop (didn't bet)
Seat 8: kift74 (button) folded before Flop (didn't bet)
Seat 9: ardo888 (small blind) folded before Flop





PokerStars Hand #150752177604:  Hold'em No Limit ($0.50/$1.00 USD) - 2016/03/22 14:18:29 CET [2016/03/22 9:18:29 ET]
Table 'Harding' 9-max Seat #7 is the button
Seat 1: matiko09 ($105.76 in chips) 
Seat 2: I The King I ($146.18 in chips) 
Seat 3: Avtovo ($100 in chips) 
Seat 4: lixiangli ($147.48 in chips) 
Seat 5: DevilisHEyz ($136.74 in chips) 
Seat 6: Ilov3NBA ($107.12 in chips) 
Seat 7: mrhighryza ($103.14 in chips) 
Seat 9: omorfadramou ($100 in chips) 
omorfadramou: posts small blind $0.50
matiko09: posts big blind $1
*** HOLE CARDS ***
Dealt to matiko09 [Ad 3h]
I The King I: folds 
I The King I leaves the table
RICKA16 joins the table at seat #2 
Avtovo has timed out
Avtovo: folds 
lixiangli: folds 
DevilisHEyz: folds 
Ilov3NBA: folds 
mrhighryza: folds 
omorfadramou: raises $2 to $3
matiko09: calls $2
*** FLOP *** [Qs 2s 8c]
omorfadramou: checks 
matiko09: checks 
*** TURN *** [Qs 2s 8c] [Ts]
omorfadramou: checks 
matiko09: checks 
*** RIVER *** [Qs 2s 8c Ts] [Kh]
omorfadramou: checks 
matiko09: bets $3.72
omorfadramou: folds 
Uncalled bet ($3.72) returned to matiko09
matiko09 collected $5.73 from pot
matiko09: doesn't show hand 
*** SUMMARY ***
Total pot $6 | Rake $0.27 
Board [Qs 2s 8c Ts Kh]
Seat 1: matiko09 (big blind) collected ($5.73)
Seat 2: I The King I folded before Flop (didn't bet)
Seat 3: Avtovo folded before Flop (didn't bet)
Seat 4: lixiangli folded before Flop (didn't bet)
Seat 5: DevilisHEyz folded before Flop (didn't bet)
Seat 6: Ilov3NBA folded before Flop (didn't bet)
Seat 7: mrhighryza (button) folded before Flop (didn't bet)
Seat 9: omorfadramou (small blind) folded on the River





PokerStars Hand #150752177891:  Hold'em No Limit ($0.50/$1.00 USD) - 2016/03/22 14:18:30 CET [2016/03/22 9:18:30 ET]
Table 'Crater II' 9-max Seat #9 is the button
Seat 1: matiko09 ($105.03 in chips) 
Seat 2: Eisbaerli85 ($122.72 in chips) 
Seat 3: lixiangli ($105.05 in chips) 
Seat 6: Kobiroga150 ($55.16 in chips) 
Seat 7: AWATAR 21 ($69.66 in chips) 
Seat 8: KronosAK ($113.78 in chips) 
Seat 9: I The King I ($115.70 in chips) 
matiko09: posts small blind $0.50
Eisbaerli85: posts big blind $1
*** HOLE CARDS ***
Dealt to matiko09 [2s 6c]
lixiangli: folds 
Kobiroga150: raises $1 to $2
AWATAR 21: folds 
KronosAK: folds 
I The King I: folds 
matiko09: folds 
Eisbaerli85: folds 
Uncalled bet ($1) returned to Kobiroga150
Kobiroga150 collected $2.50 from pot
Kobiroga150: doesn't show hand 
*** SUMMARY ***
Total pot $2.50 | Rake $0 
Seat 1: matiko09 (small blind) folded before Flop
Seat 2: Eisbaerli85 (big blind) folded before Flop
Seat 3: lixiangli folded before Flop (didn't bet)
Seat 6: Kobiroga150 collected ($2.50)
Seat 7: AWATAR 21 folded before Flop (didn't bet)
Seat 8: KronosAK folded before Flop (didn't bet)
Seat 9: I The King I (button) folded before Flop (didn't bet)





PokerStars Hand #150752184261:  Hold'em No Limit ($0.50/$1.00 USD) - 2016/03/22 14:18:40 CET [2016/03/22 9:18:40 ET]
Table 'Polyxena' 9-max Seat #9 is the button
Seat 1: I The King I ($111.73 in chips) 
Seat 2: cobrik23 ($68.11 in chips) 
Seat 4: fanmtZ ($43.95 in chips) 
Seat 5: MrAndMisses ($43.45 in chips) 
Seat 6: lixiangli ($121.55 in chips) 
Seat 7: matiko09 ($100 in chips) 
Seat 8: kift74 ($123.56 in chips) 
Seat 9: ardo888 ($150.37 in chips) 
I The King I: posts small blind $0.50
cobrik23: posts big blind $1
*** HOLE CARDS ***
Dealt to matiko09 [Tc Js]
fanmtZ: folds 
MrAndMisses: folds 
lixiangli: folds 
matiko09: folds 
kift74: raises $2 to $3
ardo888: folds 
I The King I: folds 
cobrik23: folds 
Uncalled bet ($2) returned to kift74
kift74 collected $2.50 from pot
kift74: doesn't show hand 
*** SUMMARY ***
Total pot $2.50 | Rake $0 
Seat 1: I The King I (small blind) folded before Flop
Seat 2: cobrik23 (big blind) folded before Flop
Seat 4: fanmtZ folded before Flop (didn't bet)
Seat 5: MrAndMisses folded before Flop (didn't bet)
Seat 6: lixiangli folded before Flop (didn't bet)
Seat 7: matiko09 folded before Flop (didn't bet)
Seat 8: kift74 collected ($2.50)
Seat 9: ardo888 (button) folded before Flop (didn't bet)





PokerStars Hand #150752184364:  Hold'em No Limit ($0.50/$1.00 USD) - 2016/03/22 14:18:40 CET [2016/03/22 9:18:40 ET]
Table 'Arabis' 9-max Seat #6 is the button
Seat 2: ilaviiitech ($100 in chips) 
Seat 4: Painkiller72 ($126.67 in chips) 
Seat 5: matiko09 ($140.40 in chips) 
Seat 6: Ilov3NBA ($100 in chips) 
Seat 7: howsiao ($225.20 in chips) 
Seat 8: Bro_Happy ($200.33 in chips) 
howsiao: posts small blind $0.50
Bro_Happy: posts big blind $1
*** HOLE CARDS ***
Dealt to matiko09 [Qc 2c]
ilaviiitech: folds 
Painkiller72: folds 
matiko09: folds 
Ilov3NBA: folds 
howsiao: calls $0.50
Bro_Happy: checks 
*** FLOP *** [8s Ad 6h]
howsiao: checks 
Bro_Happy: bets $1
howsiao: folds 
Uncalled bet ($1) returned to Bro_Happy
Bro_Happy collected $1.91 from pot
Bro_Happy: doesn't show hand 
*** SUMMARY ***
Total pot $2 | Rake $0.09 
Board [8s Ad 6h]
Seat 2: ilaviiitech folded before Flop (didn't bet)
Seat 4: Painkiller72 folded before Flop (didn't bet)
Seat 5: matiko09 folded before Flop (didn't bet)
Seat 6: Ilov3NBA (button) folded before Flop (didn't bet)
Seat 7: howsiao (small blind) folded on the Flop
Seat 8: Bro_Happy (big blind) collected ($1.91)





PokerStars Hand #150752185391:  Hold'em No Limit ($0.50/$1.00 USD) - 2016/03/22 14:18:42 CET [2016/03/22 9:18:42 ET]
Table 'Miranda' 9-max Seat #6 is the button
Seat 1: cobrik23 ($61.53 in chips) 
Seat 2: Szevasztopol ($110.44 in chips) 
Seat 3: Muinmyheart ($100 in chips) 
Seat 4: bilukm ($50.01 in chips) 
Seat 6: matiko09 ($103.90 in chips) 
Seat 7: RICKA16 ($103.71 in chips) 
Seat 8: hammerwife ($101.50 in chips) 
Seat 9: ardo888 ($176.67 in chips) 
RICKA16: posts small blind $0.50
hammerwife: posts big blind $1
*** HOLE CARDS ***
Dealt to matiko09 [Kh 5c]
ardo888: folds 
cobrik23: folds 
Szevasztopol: folds 
Muinmyheart: folds 
bilukm: calls $1
matiko09: folds 
RICKA16: folds 
hammerwife: checks 
*** FLOP *** [9c 8c Ah]
hammerwife: checks 
bilukm: bets $1
hammerwife: folds 
Uncalled bet ($1) returned to bilukm
bilukm collected $2.39 from pot
bilukm: doesn't show hand 
*** SUMMARY ***
Total pot $2.50 | Rake $0.11 
Board [9c 8c Ah]
Seat 1: cobrik23 folded before Flop (didn't bet)
Seat 2: Szevasztopol folded before Flop (didn't bet)
Seat 3: Muinmyheart folded before Flop (didn't bet)
Seat 4: bilukm collected ($2.39)
Seat 6: matiko09 (button) folded before Flop (didn't bet)
Seat 7: RICKA16 (small blind) folded before Flop
Seat 8: hammerwife (big blind) folded on the Flop
Seat 9: ardo888 folded before Flop (didn't bet)





PokerStars Hand #150752187127:  Hold'em No Limit ($0.50/$1.00 USD) - 2016/03/22 14:18:45 CET [2016/03/22 9:18:45 ET]
Table 'Colchis' 9-max Seat #4 is the button
Seat 1: theluckyjoe ($15.32 in chips) 
Seat 2: Ilov3NBA ($145.30 in chips) 
Seat 4: matiko09 ($100.07 in chips) 
Seat 7: Dantist1122 ($100 in chips) 
Seat 8: cobrik23 ($48.26 in chips) 
Seat 9: ardo888 ($104.57 in chips) 
Dantist1122: posts small blind $0.50
cobrik23: posts big blind $1
*** HOLE CARDS ***
Dealt to matiko09 [Qd 5d]
ardo888: folds 
theluckyjoe: folds 
Ilov3NBA: raises $1.50 to $2.50
matiko09: folds 
Dantist1122: folds 
cobrik23: folds 
Uncalled bet ($1.50) returned to Ilov3NBA
Ilov3NBA collected $2.50 from pot
Ilov3NBA: doesn't show hand 
*** SUMMARY ***
Total pot $2.50 | Rake $0 
Seat 1: theluckyjoe folded before Flop (didn't bet)
Seat 2: Ilov3NBA collected ($2.50)
Seat 4: matiko09 (button) folded before Flop (didn't bet)
Seat 7: Dantist1122 (small blind) folded before Flop
Seat 8: cobrik23 (big blind) folded before Flop
Seat 9: ardo888 folded before Flop (didn't bet)





PokerStars Hand #150752187897:  Hold'em No Limit ($0.50/$1.00 USD) - 2016/03/22 14:18:46 CET [2016/03/22 9:18:46 ET]
Table 'Taygeta II' 9-max Seat #5 is the button
Seat 1: DevilisHEyz ($91.28 in chips) 
Seat 2: khan Erkesh ($200.57 in chips) 
Seat 3: Muinmyheart ($100 in chips) 
Seat 4: matiko09 ($100 in chips) 
Seat 5: RICKA16 ($99.50 in chips) 
Seat 6: I The King I ($107.50 in chips) 
Seat 7: Szevasztopol ($101.50 in chips) 
Seat 9: cobrik23 ($44.81 in chips) 
I The King I: posts small blind $0.50
Szevasztopol: posts big blind $1
*** HOLE CARDS ***
Dealt to matiko09 [Qh Ks]
cobrik23: raises $2 to $3
DevilisHEyz: folds 
khan Erkesh: calls $3
Muinmyheart: folds 
matiko09: folds 
RICKA16: calls $3
I The King I: folds 
Szevasztopol: folds 
*** FLOP *** [9h 3s 9c]
cobrik23: bets $5.01
khan Erkesh: calls $5.01
RICKA16: folds 
*** TURN *** [9h 3s 9c] [6c]
cobrik23: bets $14
khan Erkesh: folds 
Uncalled bet ($14) returned to cobrik23
cobrik23 collected $19.60 from pot
cobrik23: doesn't show hand 
*** SUMMARY ***
Total pot $20.52 | Rake $0.92 
Board [9h 3s 9c 6c]
Seat 1: DevilisHEyz folded before Flop (didn't bet)
Seat 2: khan Erkesh folded on the Turn
Seat 3: Muinmyheart folded before Flop (didn't bet)
Seat 4: matiko09 folded before Flop (didn't bet)
Seat 5: RICKA16 (button) folded on the Flop
Seat 6: I The King I (small blind) folded before Flop
Seat 7: Szevasztopol (big blind) folded before Flop
Seat 9: cobrik23 collected ($19.60)





PokerStars Hand #150752190447:  Hold'em No Limit ($0.50/$1.00 USD) - 2016/03/22 14:18:50 CET [2016/03/22 9:18:50 ET]
Table 'Crater II' 9-max Seat #1 is the button
Seat 1: matiko09 ($104.53 in chips) 
Seat 2: Eisbaerli85 ($121.72 in chips) 
Seat 3: lixiangli ($105.05 in chips) 
Seat 6: Kobiroga150 ($56.66 in chips) 
Seat 7: AWATAR 21 ($69.66 in chips) 
Seat 8: KronosAK ($113.78 in chips) 
Seat 9: I The King I ($115.70 in chips) 
Eisbaerli85: posts small blind $0.50
lixiangli: posts big blind $1
*** HOLE CARDS ***
Dealt to matiko09 [Qd Td]
Kobiroga150: folds 
AWATAR 21: raises $1 to $2
KronosAK: folds 
I The King I: folds 
matiko09: calls $2
Eisbaerli85: folds 
lixiangli: calls $1
*** FLOP *** [7d 5c 6d]
lixiangli: checks 
AWATAR 21: bets $2.50
matiko09: calls $2.50
lixiangli: calls $2.50
*** TURN *** [7d 5c 6d] [Qh]
lixiangli: checks 
AWATAR 21: checks 
matiko09: checks 
*** RIVER *** [7d 5c 6d Qh] [5d]
lixiangli: checks 
AWATAR 21: bets $12.50
matiko09: raises $14.50 to $27
lixiangli: folds 
AWATAR 21: folds 
Uncalled bet ($14.50) returned to matiko09
matiko09 collected $37.24 from pot
matiko09: doesn't show hand 
*** SUMMARY ***
Total pot $39 | Rake $1.76 
Board [7d 5c 6d Qh 5d]
Seat 1: matiko09 (button) collected ($37.24)
Seat 2: Eisbaerli85 (small blind) folded before Flop
Seat 3: lixiangli (big blind) folded on the River
Seat 6: Kobiroga150 folded before Flop (didn't bet)
Seat 7: AWATAR 21 folded on the River
Seat 8: KronosAK folded before Flop (didn't bet)
Seat 9: I The King I folded before Flop (didn't bet)





PokerStars Hand #150752200654:  Hold'em No Limit ($0.50/$1.00 USD) - 2016/03/22 14:19:07 CET [2016/03/22 9:19:07 ET]
Table 'Arabis' 9-max Seat #7 is the button
Seat 2: ilaviiitech ($100 in chips) 
Seat 4: Painkiller72 ($126.67 in chips) 
Seat 5: matiko09 ($140.40 in chips) 
Seat 6: Ilov3NBA ($100 in chips) 
Seat 7: howsiao ($224.20 in chips) 
Seat 8: Bro_Happy ($201.24 in chips) 
Bro_Happy: posts small blind $0.50
ilaviiitech: posts big blind $1
*** HOLE CARDS ***
Dealt to matiko09 [2s 3s]
Painkiller72: folds 
matiko09: folds 
Ilov3NBA: folds 
howsiao: raises $2 to $3
Bro_Happy: folds 
ilaviiitech: raises $9 to $12
howsiao: calls $9
*** FLOP *** [4d 9c 5c]
ilaviiitech: bets $13.50
howsiao: folds 
Uncalled bet ($13.50) returned to ilaviiitech
ilaviiitech collected $23.40 from pot
ilaviiitech: doesn't show hand 
*** SUMMARY ***
Total pot $24.50 | Rake $1.10 
Board [4d 9c 5c]
Seat 2: ilaviiitech (big blind) collected ($23.40)
Seat 4: Painkiller72 folded before Flop (didn't bet)
Seat 5: matiko09 folded before Flop (didn't bet)
Seat 6: Ilov3NBA folded before Flop (didn't bet)
Seat 7: howsiao (button) folded on the Flop
Seat 8: Bro_Happy (small blind) folded before Flop





PokerStars Hand #150752202405:  Hold'em No Limit ($1/$2 USD) - 2016/03/22 14:19:10 CET [2016/03/22 9:19:10 ET]
Table 'Kiso II' 9-max Seat #6 is the button
Seat 3: seouljam ($419.66 in chips) 
Seat 5: Ilov3NBA ($306.84 in chips) 
Seat 6: KT90 ($328.78 in chips) 
Seat 7: Igoriah ($207.01 in chips) 
Seat 8: bananajoe001 ($183.72 in chips) 
Seat 9: matiko09 ($200 in chips) 
Igoriah: posts small blind $1
bananajoe001: posts big blind $2
*** HOLE CARDS ***
Dealt to matiko09 [Jc 3s]
matiko09: folds 
seouljam: folds 
Ilov3NBA: folds 
AMIRsuperfre leaves the table
KT90: raises $2 to $4
Igoriah: calls $3
bananajoe001: calls $2
*** FLOP *** [6c Ad 4h]
N4$H joins the table at seat #4 
Igoriah: checks 
bananajoe001: checks 
KT90: bets $8
Igoriah: folds 
bananajoe001: folds 
Uncalled bet ($8) returned to KT90
KT90 collected $11.46 from pot
KT90: doesn't show hand 
*** SUMMARY ***
Total pot $12 | Rake $0.54 
Board [6c Ad 4h]
Seat 3: seouljam folded before Flop (didn't bet)
Seat 5: Ilov3NBA folded before Flop (didn't bet)
Seat 6: KT90 (button) collected ($11.46)
Seat 7: Igoriah (small blind) folded on the Flop
Seat 8: bananajoe001 (big blind) folded on the Flop
Seat 9: matiko09 folded before Flop (didn't bet)





PokerStars Hand #150752202922:  Hold'em No Limit ($0.50/$1.00 USD) - 2016/03/22 14:19:11 CET [2016/03/22 9:19:11 ET]
Table 'Colchis' 9-max Seat #7 is the button
Seat 1: theluckyjoe ($15.32 in chips) 
Seat 2: Ilov3NBA ($146.80 in chips) 
Seat 4: matiko09 ($100.07 in chips) 
Seat 7: Dantist1122 ($100 in chips) 
Seat 8: cobrik23 ($47.26 in chips) 
Seat 9: ardo888 ($104.57 in chips) 
cobrik23: posts small blind $0.50
ardo888: posts big blind $1
*** HOLE CARDS ***
Dealt to matiko09 [2s 4h]
theluckyjoe: folds 
Ilov3NBA: folds 
matiko09: folds 
Dantist1122: folds 
cobrik23: folds 
Uncalled bet ($0.50) returned to ardo888
ardo888 collected $1 from pot
ardo888: doesn't show hand 
*** SUMMARY ***
Total pot $1 | Rake $0 
Seat 1: theluckyjoe folded before Flop (didn't bet)
Seat 2: Ilov3NBA folded before Flop (didn't bet)
Seat 4: matiko09 folded before Flop (didn't bet)
Seat 7: Dantist1122 (button) folded before Flop (didn't bet)
Seat 8: cobrik23 (small blind) folded before Flop
Seat 9: ardo888 (big blind) collected ($1)





PokerStars Hand #150752204194:  Hold'em No Limit ($0.50/$1.00 USD) - 2016/03/22 14:19:13 CET [2016/03/22 9:19:13 ET]
Table 'Polyxena' 9-max Seat #1 is the button
Seat 1: I The King I ($111.23 in chips) 
Seat 2: cobrik23 ($67.11 in chips) 
Seat 4: fanmtZ ($43.95 in chips) 
Seat 5: MrAndMisses ($43.45 in chips) 
Seat 6: lixiangli ($121.55 in chips) 
Seat 7: matiko09 ($100 in chips) 
Seat 8: kift74 ($125.06 in chips) 
Seat 9: ardo888 ($150.37 in chips) 
cobrik23: posts small blind $0.50
fanmtZ: posts big blind $1
*** HOLE CARDS ***
Dealt to matiko09 [2h 7h]
MrAndMisses: calls $1
lixiangli: folds 
matiko09: folds 
kift74: folds 
ardo888: folds 
I The King I: folds 
cobrik23: raises $4 to $5
fanmtZ: folds 
MrAndMisses: calls $4
*** FLOP *** [7s 4h 5c]
cobrik23: bets $7
MrAndMisses: folds 
Uncalled bet ($7) returned to cobrik23
cobrik23 collected $10.50 from pot
cobrik23: doesn't show hand 
*** SUMMARY ***
Total pot $11 | Rake $0.50 
Board [7s 4h 5c]
Seat 1: I The King I (button) folded before Flop (didn't bet)
Seat 2: cobrik23 (small blind) collected ($10.50)
Seat 4: fanmtZ (big blind) folded before Flop
Seat 5: MrAndMisses folded on the Flop
Seat 6: lixiangli folded before Flop (didn't bet)
Seat 7: matiko09 folded before Flop (didn't bet)
Seat 8: kift74 folded before Flop (didn't bet)
Seat 9: ardo888 folded before Flop (didn't bet)





PokerStars Hand #150752214364:  Hold'em No Limit ($0.50/$1.00 USD) - 2016/03/22 14:19:29 CET [2016/03/22 9:19:29 ET]
Table 'Colchis' 9-max Seat #8 is the button
Seat 1: theluckyjoe ($15.32 in chips) 
Seat 2: Ilov3NBA ($146.80 in chips) 
Seat 4: matiko09 ($100.07 in chips) 
Seat 7: Dantist1122 ($100 in chips) 
Seat 8: cobrik23 ($46.76 in chips) 
Seat 9: ardo888 ($105.07 in chips) 
ardo888: posts small blind $0.50
theluckyjoe: posts big blind $1
*** HOLE CARDS ***
Dealt to matiko09 [7d 2h]
Ilov3NBA: folds 
matiko09: folds 
Dantist1122: folds 
cobrik23: folds 
ardo888: raises $1.50 to $2.50
theluckyjoe: calls $1.50
*** FLOP *** [5c Qh 6s]
ardo888: checks 
theluckyjoe: checks 
*** TURN *** [5c Qh 6s] [3h]
ardo888: bets $2.53
theluckyjoe: calls $2.53
*** RIVER *** [5c Qh 6s 3h] [4s]
ardo888: checks 
theluckyjoe: checks 
*** SHOW DOWN ***
ardo888: shows [8d Qc] (a pair of Queens)
theluckyjoe: mucks hand 
ardo888 collected $9.61 from pot
*** SUMMARY ***
Total pot $10.06 | Rake $0.45 
Board [5c Qh 6s 3h 4s]
Seat 1: theluckyjoe (big blind) mucked [4c 9h]
Seat 2: Ilov3NBA folded before Flop (didn't bet)
Seat 4: matiko09 folded before Flop (didn't bet)
Seat 7: Dantist1122 folded before Flop (didn't bet)
Seat 8: cobrik23 (button) folded before Flop (didn't bet)
Seat 9: ardo888 (small blind) showed [8d Qc] and won ($9.61) with a pair of Queens





PokerStars Hand #150752216180:  Hold'em No Limit ($0.50/$1.00 USD) - 2016/03/22 14:19:32 CET [2016/03/22 9:19:32 ET]
Table 'Stephano II' 9-max Seat #7 is the button
Seat 1: cipriank11 ($80 in chips) 
Seat 2: buckshot150 ($79.25 in chips) 
Seat 3: lombardo11 ($77 in chips) 
Seat 4: AWATAR 21 ($110.66 in chips) 
Seat 5: mb2part ($98.50 in chips) 
Seat 6: beterc0re ($126.29 in chips) 
Seat 7: ilaviiitech ($100 in chips) 
Seat 9: matiko09 ($146.19 in chips) 
KingCastle77 will be allowed to play after the button
matiko09: posts small blind $0.50
cipriank11: posts big blind $1
*** HOLE CARDS ***
Dealt to matiko09 [Jd 8s]
buckshot150: folds 
lombardo11: folds 
AWATAR 21: folds 
mb2part: folds 
beterc0re: folds 
ilaviiitech: folds 
matiko09: folds 
Uncalled bet ($0.50) returned to cipriank11
cipriank11 collected $1 from pot
cipriank11: doesn't show hand 
*** SUMMARY ***
Total pot $1 | Rake $0 
Seat 1: cipriank11 (big blind) collected ($1)
Seat 2: buckshot150 folded before Flop (didn't bet)
Seat 3: lombardo11 folded before Flop (didn't bet)
Seat 4: AWATAR 21 folded before Flop (didn't bet)
Seat 5: mb2part folded before Flop (didn't bet)
Seat 6: beterc0re folded before Flop (didn't bet)
Seat 7: ilaviiitech (button) folded before Flop (didn't bet)
Seat 9: matiko09 (small blind) folded before Flop





PokerStars Hand #150752217367:  Hold'em No Limit ($0.50/$1.00 USD) - 2016/03/22 14:19:34 CET [2016/03/22 9:19:34 ET]
Table 'Miranda' 9-max Seat #7 is the button
Seat 1: cobrik23 ($61.53 in chips) 
Seat 2: Szevasztopol ($110.44 in chips) 
Seat 3: Muinmyheart ($100 in chips) 
Seat 4: bilukm ($51.40 in chips) 
Seat 6: matiko09 ($103.90 in chips) 
Seat 7: RICKA16 ($103.21 in chips) 
Seat 8: hammerwife ($100.50 in chips) 
Seat 9: ardo888 ($176.67 in chips) 
hammerwife: posts small blind $0.50
ardo888: posts big blind $1
*** HOLE CARDS ***
Dealt to matiko09 [5s Ks]
cobrik23: folds 
Szevasztopol: folds 
Muinmyheart: folds 
bilukm: folds 
matiko09: folds 
RICKA16: folds 
hammerwife: raises $1.60 to $2.60
ardo888: calls $1.60
*** FLOP *** [8c 4h Kc]
hammerwife: checks 
ardo888: checks 
*** TURN *** [8c 4h Kc] [Ah]
hammerwife: checks 
ardo888: checks 
*** RIVER *** [8c 4h Kc Ah] [Kd]
hammerwife: bets $3
ardo888: folds 
Uncalled bet ($3) returned to hammerwife
hammerwife collected $4.97 from pot
hammerwife: doesn't show hand 
*** SUMMARY ***
Total pot $5.20 | Rake $0.23 
Board [8c 4h Kc Ah Kd]
Seat 1: cobrik23 folded before Flop (didn't bet)
Seat 2: Szevasztopol folded before Flop (didn't bet)
Seat 3: Muinmyheart folded before Flop (didn't bet)
Seat 4: bilukm folded before Flop (didn't bet)
Seat 6: matiko09 folded before Flop (didn't bet)
Seat 7: RICKA16 (button) folded before Flop (didn't bet)
Seat 8: hammerwife (small blind) collected ($4.97)
Seat 9: ardo888 (big blind) folded on the River





PokerStars Hand #150752220880:  Hold'em No Limit ($0.50/$1.00 USD) - 2016/03/22 14:19:40 CET [2016/03/22 9:19:40 ET]
Table 'Arabis' 9-max Seat #8 is the button
Seat 2: ilaviiitech ($111.40 in chips) 
Seat 4: Painkiller72 ($126.67 in chips) 
Seat 5: matiko09 ($140.40 in chips) 
Seat 6: Ilov3NBA ($100 in chips) 
Seat 7: howsiao ($212.20 in chips) 
Seat 8: Bro_Happy ($200.74 in chips) 
cobrik23 will be allowed to play after the button
ilaviiitech: posts small blind $0.50
Painkiller72: posts big blind $1
*** HOLE CARDS ***
Dealt to matiko09 [4h Ts]
matiko09: folds 
Ilov3NBA: folds 
howsiao: folds 
Bro_Happy: folds 
ilaviiitech: raises $2 to $3
Painkiller72: folds 
Uncalled bet ($2) returned to ilaviiitech
ilaviiitech collected $2 from pot
ilaviiitech: doesn't show hand 
*** SUMMARY ***
Total pot $2 | Rake $0 
Seat 2: ilaviiitech (small blind) collected ($2)
Seat 4: Painkiller72 (big blind) folded before Flop
Seat 5: matiko09 folded before Flop (didn't bet)
Seat 6: Ilov3NBA folded before Flop (didn't bet)
Seat 7: howsiao folded before Flop (didn't bet)
Seat 8: Bro_Happy (button) folded before Flop (didn't bet)





PokerStars Hand #150752225698:  Hold'em No Limit ($0.50/$1.00 USD) - 2016/03/22 14:19:48 CET [2016/03/22 9:19:48 ET]
Table 'Stephano II' 9-max Seat #9 is the button
Seat 1: cipriank11 ($80.50 in chips) 
Seat 2: buckshot150 ($79.25 in chips) 
Seat 3: lombardo11 ($77 in chips) 
Seat 4: AWATAR 21 ($110.66 in chips) 
Seat 5: mb2part ($98.50 in chips) 
Seat 6: beterc0re ($126.29 in chips) 
Seat 7: ilaviiitech ($100 in chips) 
Seat 9: matiko09 ($145.69 in chips) 
cipriank11: posts small blind $0.50
buckshot150: posts big blind $1
KingCastle77: sits out 
*** HOLE CARDS ***
Dealt to matiko09 [Qc Jh]
lombardo11: folds 
AWATAR 21: folds 
mb2part: folds 
beterc0re: folds 
ilaviiitech: raises $2 to $3
matiko09: folds 
cipriank11: folds 
buckshot150: calls $2
*** FLOP *** [Qh 3d 4s]
buckshot150: bets $4
ilaviiitech: folds 
Uncalled bet ($4) returned to buckshot150
buckshot150 collected $6.21 from pot
buckshot150: doesn't show hand 
*** SUMMARY ***
Total pot $6.50 | Rake $0.29 
Board [Qh 3d 4s]
Seat 1: cipriank11 (small blind) folded before Flop
Seat 2: buckshot150 (big blind) collected ($6.21)
Seat 3: lombardo11 folded before Flop (didn't bet)
Seat 4: AWATAR 21 folded before Flop (didn't bet)
Seat 5: mb2part folded before Flop (didn't bet)
Seat 6: beterc0re folded before Flop (didn't bet)
Seat 7: ilaviiitech folded on the Flop
Seat 9: matiko09 (button) folded before Flop (didn't bet)





PokerStars Hand #150752230029:  Hold'em No Limit ($0.50/$1.00 USD) - 2016/03/22 14:19:55 CET [2016/03/22 9:19:55 ET]
Table 'Taygeta II' 9-max Seat #6 is the button
Seat 1: DevilisHEyz ($91.28 in chips) 
Seat 2: khan Erkesh ($192.56 in chips) 
Seat 3: Muinmyheart ($100 in chips) 
Seat 4: matiko09 ($100 in chips) 
Seat 5: RICKA16 ($100 in chips) 
Seat 6: I The King I ($107 in chips) 
Seat 7: Szevasztopol ($100.50 in chips) 
Seat 9: cobrik23 ($56.40 in chips) 
Szevasztopol: posts small blind $0.50
cobrik23: posts big blind $1
*** HOLE CARDS ***
Dealt to matiko09 [7h 3s]
DevilisHEyz: folds 
khan Erkesh: raises $2 to $3
Muinmyheart: folds 
matiko09: folds 
RICKA16: folds 
I The King I: folds 
Szevasztopol: folds 
cobrik23: folds 
Uncalled bet ($2) returned to khan Erkesh
khan Erkesh collected $2.50 from pot
khan Erkesh: doesn't show hand 
*** SUMMARY ***
Total pot $2.50 | Rake $0 
Seat 1: DevilisHEyz folded before Flop (didn't bet)
Seat 2: khan Erkesh collected ($2.50)
Seat 3: Muinmyheart folded before Flop (didn't bet)
Seat 4: matiko09 folded before Flop (didn't bet)
Seat 5: RICKA16 folded before Flop (didn't bet)
Seat 6: I The King I (button) folded before Flop (didn't bet)
Seat 7: Szevasztopol (small blind) folded before Flop
Seat 9: cobrik23 (big blind) folded before Flop





PokerStars Hand #150752229784:  Hold'em No Limit ($1/$2 USD) - 2016/03/22 14:19:55 CET [2016/03/22 9:19:55 ET]
Table 'Kiso II' 9-max Seat #7 is the button
Seat 3: seouljam ($419.66 in chips) 
Seat 5: Ilov3NBA ($306.84 in chips) 
Seat 6: KT90 ($336.24 in chips) 
Seat 7: Igoriah ($203.01 in chips) 
Seat 8: bananajoe001 ($179.72 in chips) 
Seat 9: matiko09 ($200 in chips) 
bananajoe001: posts small blind $1
matiko09: posts big blind $2
N4$H: sits out 
*** HOLE CARDS ***
Dealt to matiko09 [8c 7d]
seouljam: folds 
Ilov3NBA: folds 
KT90: folds 
Igoriah: folds 
bananajoe001: raises $2 to $4
matiko09: calls $2
*** FLOP *** [Qs Th Kh]
bananajoe001: bets $8
matiko09: folds 
Uncalled bet ($8) returned to bananajoe001
bananajoe001 collected $7.64 from pot
bananajoe001: doesn't show hand 
*** SUMMARY ***
Total pot $8 | Rake $0.36 
Board [Qs Th Kh]
Seat 3: seouljam folded before Flop (didn't bet)
Seat 5: Ilov3NBA folded before Flop (didn't bet)
Seat 6: KT90 folded before Flop (didn't bet)
Seat 7: Igoriah (button) folded before Flop (didn't bet)
Seat 8: bananajoe001 (small blind) collected ($7.64)
Seat 9: matiko09 (big blind) folded on the Flop





PokerStars Hand #150752231710:  Hold'em No Limit ($0.50/$1.00 USD) - 2016/03/22 14:19:58 CET [2016/03/22 9:19:58 ET]
Table 'Arabis' 9-max Seat #2 is the button
Seat 2: ilaviiitech ($112.40 in chips) 
Seat 4: Painkiller72 ($125.67 in chips) 
Seat 5: matiko09 ($140.40 in chips) 
Seat 6: Ilov3NBA ($100 in chips) 
Seat 7: howsiao ($212.20 in chips) 
Seat 8: Bro_Happy ($200.74 in chips) 
Painkiller72: posts small blind $0.50
matiko09: posts big blind $1
cobrik23: sits out 
*** HOLE CARDS ***
Dealt to matiko09 [Ks 3c]
Ilov3NBA: folds 
howsiao: raises $2 to $3
Bro_Happy: folds 
ilaviiitech: folds 
Painkiller72: folds 
matiko09: folds 
Uncalled bet ($2) returned to howsiao
howsiao collected $2.50 from pot
howsiao: doesn't show hand 
*** SUMMARY ***
Total pot $2.50 | Rake $0 
Seat 2: ilaviiitech (button) folded before Flop (didn't bet)
Seat 4: Painkiller72 (small blind) folded before Flop
Seat 5: matiko09 (big blind) folded before Flop
Seat 6: Ilov3NBA folded before Flop (didn't bet)
Seat 7: howsiao collected ($2.50)
Seat 8: Bro_Happy folded before Flop (didn't bet)





PokerStars Hand #150752237009:  Hold'em No Limit ($0.50/$1.00 USD) - 2016/03/22 14:20:06 CET [2016/03/22 9:20:06 ET]
Table 'Polyxena' 9-max Seat #2 is the button
Seat 1: I The King I ($111.23 in chips) 
Seat 2: cobrik23 ($72.61 in chips) 
Seat 4: fanmtZ ($42.95 in chips) 
Seat 5: MrAndMisses ($38.45 in chips) 
Seat 6: lixiangli ($121.55 in chips) 
Seat 7: matiko09 ($100 in chips) 
Seat 8: kift74 ($125.06 in chips) 
Seat 9: ardo888 ($150.37 in chips) 
fanmtZ: posts small blind $0.50
MrAndMisses: posts big blind $1
*** HOLE CARDS ***
Dealt to matiko09 [6s 9h]
lixiangli: folds 
matiko09: folds 
lixiangli leaves the table
kift74: folds 
ardo888: folds 
I The King I: folds 
cobrik23: folds 
fanmtZ: raises $1.58 to $2.58
MrAndMisses: folds 
Uncalled bet ($1.58) returned to fanmtZ
fanmtZ collected $2 from pot
fanmtZ: doesn't show hand 
*** SUMMARY ***
Total pot $2 | Rake $0 
Seat 1: I The King I folded before Flop (didn't bet)
Seat 2: cobrik23 (button) folded before Flop (didn't bet)
Seat 4: fanmtZ (small blind) collected ($2)
Seat 5: MrAndMisses (big blind) folded before Flop
Seat 6: lixiangli folded before Flop (didn't bet)
Seat 7: matiko09 folded before Flop (didn't bet)
Seat 8: kift74 folded before Flop (didn't bet)
Seat 9: ardo888 folded before Flop (didn't bet)





PokerStars Hand #150752237139:  Hold'em No Limit ($0.50/$1.00 USD) - 2016/03/22 14:20:07 CET [2016/03/22 9:20:07 ET]
Table 'Harding' 9-max Seat #9 is the button
Seat 1: matiko09 ($108.49 in chips) 
Seat 2: RICKA16 ($100 in chips) 
Seat 4: lixiangli ($147.48 in chips) 
Seat 5: DevilisHEyz ($136.74 in chips) 
Seat 6: Ilov3NBA ($107.12 in chips) 
Seat 7: mrhighryza ($103.14 in chips) 
Seat 9: omorfadramou ($100 in chips) 
matiko09: posts small blind $0.50
RICKA16: posts big blind $1
*** HOLE CARDS ***
Dealt to matiko09 [Ks 7s]
lixiangli: folds 
DevilisHEyz: folds 
Ilov3NBA: folds 
mrhighryza: calls $1
omorfadramou: folds 
matiko09: calls $0.50
RICKA16: checks 
*** FLOP *** [Qc 7c Th]
matiko09: checks 
RICKA16: checks 
mrhighryza: bets $3
matiko09: folds 
RICKA16: folds 
Uncalled bet ($3) returned to mrhighryza
mrhighryza collected $2.86 from pot
*** SUMMARY ***
Total pot $3 | Rake $0.14 
Board [Qc 7c Th]
Seat 1: matiko09 (small blind) folded on the Flop
Seat 2: RICKA16 (big blind) folded on the Flop
Seat 4: lixiangli folded before Flop (didn't bet)
Seat 5: DevilisHEyz folded before Flop (didn't bet)
Seat 6: Ilov3NBA folded before Flop (didn't bet)
Seat 7: mrhighryza collected ($2.86)
Seat 9: omorfadramou (button) folded before Flop (didn't bet)





PokerStars Hand #150752243066:  Hold'em No Limit ($0.50/$1.00 USD) - 2016/03/22 14:20:17 CET [2016/03/22 9:20:17 ET]
Table 'Arabis' 9-max Seat #4 is the button
Seat 2: ilaviiitech ($112.40 in chips) 
Seat 4: Painkiller72 ($125.17 in chips) 
Seat 5: matiko09 ($139.40 in chips) 
Seat 6: Ilov3NBA ($100 in chips) 
Seat 7: howsiao ($213.70 in chips) 
Seat 8: Bro_Happy ($200.74 in chips) 
matiko09: posts small blind $0.50
Ilov3NBA: posts big blind $1
cobrik23: sits out 
*** HOLE CARDS ***
Dealt to matiko09 [6c 4d]
howsiao: folds 
Bro_Happy: folds 
ilaviiitech: raises $2 to $3
Painkiller72: folds 
matiko09: folds 
Ilov3NBA: folds 
Uncalled bet ($2) returned to ilaviiitech
ilaviiitech collected $2.50 from pot
ilaviiitech: doesn't show hand 
*** SUMMARY ***
Total pot $2.50 | Rake $0 
Seat 2: ilaviiitech collected ($2.50)
Seat 4: Painkiller72 (button) folded before Flop (didn't bet)
Seat 5: matiko09 (small blind) folded before Flop
Seat 6: Ilov3NBA (big blind) folded before Flop
Seat 7: howsiao folded before Flop (didn't bet)
Seat 8: Bro_Happy folded before Flop (didn't bet)





PokerStars Hand #150752245499:  Hold'em No Limit ($0.50/$1.00 USD) - 2016/03/22 14:20:20 CET [2016/03/22 9:20:20 ET]
Table 'Colchis' 9-max Seat #9 is the button
Seat 1: theluckyjoe ($10.29 in chips) 
Seat 2: Ilov3NBA ($146.80 in chips) 
Seat 4: matiko09 ($100.07 in chips) 
Seat 7: Dantist1122 ($100 in chips) 
Seat 8: cobrik23 ($46.76 in chips) 
Seat 9: ardo888 ($109.65 in chips) 
theluckyjoe: posts small blind $0.50
Ilov3NBA: posts big blind $1
*** HOLE CARDS ***
Dealt to matiko09 [7d 6h]
matiko09: folds 
Dantist1122: folds 
cobrik23: raises $2 to $3
ardo888: folds 
theluckyjoe: folds 
Ilov3NBA: folds 
Uncalled bet ($2) returned to cobrik23
cobrik23 collected $2.50 from pot
cobrik23: doesn't show hand 
*** SUMMARY ***
Total pot $2.50 | Rake $0 
Seat 1: theluckyjoe (small blind) folded before Flop
Seat 2: Ilov3NBA (big blind) folded before Flop
Seat 4: matiko09 folded before Flop (didn't bet)
Seat 7: Dantist1122 folded before Flop (didn't bet)
Seat 8: cobrik23 collected ($2.50)
Seat 9: ardo888 (button) folded before Flop (didn't bet)





PokerStars Hand #150752250281:  Hold'em No Limit ($1/$2 USD) - 2016/03/22 14:20:28 CET [2016/03/22 9:20:28 ET]
Table 'Kiso II' 9-max Seat #8 is the button
Seat 3: seouljam ($419.66 in chips) 
Seat 5: Ilov3NBA ($306.84 in chips) 
Seat 6: KT90 ($336.24 in chips) 
Seat 7: Igoriah ($203.01 in chips) 
Seat 8: bananajoe001 ($183.36 in chips) 
Seat 9: matiko09 ($200 in chips) 
matiko09: posts small blind $1
seouljam: posts big blind $2
N4$H: sits out 
*** HOLE CARDS ***
Dealt to matiko09 [7c 3s]
Ilov3NBA: folds 
KT90: folds 
Igoriah: folds 
bananajoe001: folds 
matiko09: folds 
Uncalled bet ($1) returned to seouljam
seouljam collected $2 from pot
seouljam: doesn't show hand 
*** SUMMARY ***
Total pot $2 | Rake $0 
Seat 3: seouljam (big blind) collected ($2)
Seat 5: Ilov3NBA folded before Flop (didn't bet)
Seat 6: KT90 folded before Flop (didn't bet)
Seat 7: Igoriah folded before Flop (didn't bet)
Seat 8: bananajoe001 (button) folded before Flop (didn't bet)
Seat 9: matiko09 (small blind) folded before Flop





PokerStars Hand #150752250432:  Hold'em No Limit ($0.50/$1.00 USD) - 2016/03/22 14:20:29 CET [2016/03/22 9:20:29 ET]
Table 'Crater II' 9-max Seat #2 is the button
Seat 1: matiko09 ($124.77 in chips) 
Seat 2: Eisbaerli85 ($121.22 in chips) 
Seat 3: lixiangli ($100.55 in chips) 
Seat 6: Kobiroga150 ($56.66 in chips) 
Seat 7: AWATAR 21 ($52.66 in chips) 
Seat 8: KronosAK ($113.78 in chips) 
Seat 9: I The King I ($115.70 in chips) 
lixiangli: posts small blind $0.50
di0d80 was removed from the table for failing to post
Kobiroga150: posts big blind $1
*** HOLE CARDS ***
Dealt to matiko09 [Tc Jd]
fanmtZ joins the table at seat #4 
AWATAR 21: folds 
KronosAK: folds 
I The King I: folds 
matiko09: folds 
Eisbaerli85: raises $1.25 to $2.25
lixiangli: folds 
Kobiroga150: calls $1.25
*** FLOP *** [9h Ad 5c]
Kobiroga150: checks 
Eisbaerli85: bets $1.81
Kobiroga150: folds 
Uncalled bet ($1.81) returned to Eisbaerli85
Eisbaerli85 collected $4.78 from pot
*** SUMMARY ***
Total pot $5 | Rake $0.22 
Board [9h Ad 5c]
Seat 1: matiko09 folded before Flop (didn't bet)
Seat 2: Eisbaerli85 (button) collected ($4.78)
Seat 3: lixiangli (small blind) folded before Flop
Seat 6: Kobiroga150 (big blind) folded on the Flop
Seat 7: AWATAR 21 folded before Flop (didn't bet)
Seat 8: KronosAK folded before Flop (didn't bet)
Seat 9: I The King I folded before Flop (didn't bet)





PokerStars Hand #150752256451:  Hold'em No Limit ($0.50/$1.00 USD) - 2016/03/22 14:20:38 CET [2016/03/22 9:20:38 ET]
Table 'Taygeta II' 9-max Seat #7 is the button
Seat 1: DevilisHEyz ($91.28 in chips) 
Seat 2: khan Erkesh ($194.06 in chips) 
Seat 3: Muinmyheart ($100 in chips) 
Seat 4: matiko09 ($100 in chips) 
Seat 5: RICKA16 ($100 in chips) 
Seat 6: I The King I ($107 in chips) 
Seat 7: Szevasztopol ($100 in chips) 
Seat 9: cobrik23 ($55.40 in chips) 
cobrik23: posts small blind $0.50
DevilisHEyz: posts big blind $1
*** HOLE CARDS ***
Dealt to matiko09 [7h 9c]
khan Erkesh: folds 
Muinmyheart: folds 
matiko09: folds 
RICKA16: folds 
I The King I: folds 
Szevasztopol: raises $2 to $3
cobrik23: calls $2.50
DevilisHEyz: folds 
*** FLOP *** [8c 2d Qd]
cobrik23: checks 
Szevasztopol: checks 
*** TURN *** [8c 2d Qd] [Jd]
cobrik23: checks 
Szevasztopol: bets $4
cobrik23: folds 
Uncalled bet ($4) returned to Szevasztopol
Szevasztopol collected $6.68 from pot
Szevasztopol: doesn't show hand 
*** SUMMARY ***
Total pot $7 | Rake $0.32 
Board [8c 2d Qd Jd]
Seat 1: DevilisHEyz (big blind) folded before Flop
Seat 2: khan Erkesh folded before Flop (didn't bet)
Seat 3: Muinmyheart folded before Flop (didn't bet)
Seat 4: matiko09 folded before Flop (didn't bet)
Seat 5: RICKA16 folded before Flop (didn't bet)
Seat 6: I The King I folded before Flop (didn't bet)
Seat 7: Szevasztopol (button) collected ($6.68)
Seat 9: cobrik23 (small blind) folded on the Turn





PokerStars Hand #150752260088:  Hold'em No Limit ($1/$2 USD) - 2016/03/22 14:20:44 CET [2016/03/22 9:20:44 ET]
Table 'Kiso II' 9-max Seat #9 is the button
Seat 3: seouljam ($420.66 in chips) 
Seat 4: N4$H ($200 in chips) 
Seat 5: Ilov3NBA ($306.84 in chips) 
Seat 6: KT90 ($336.24 in chips) 
Seat 7: Igoriah ($203.01 in chips) 
Seat 8: bananajoe001 ($183.36 in chips) 
Seat 9: matiko09 ($200 in chips) 
seouljam: posts small blind $1
N4$H: posts big blind $2
*** HOLE CARDS ***
Dealt to matiko09 [5d 6h]
Ilov3NBA: folds 
KT90: folds 
Igoriah: folds 
bananajoe001: calls $2
matiko09: folds 
seouljam: folds 
N4$H: checks 
*** FLOP *** [Ad 5c Qh]
N4$H: checks 
bananajoe001: bets $4
N4$H: folds 
Uncalled bet ($4) returned to bananajoe001
bananajoe001 collected $4.78 from pot
bananajoe001: doesn't show hand 
*** SUMMARY ***
Total pot $5 | Rake $0.22 
Board [Ad 5c Qh]
Seat 3: seouljam (small blind) folded before Flop
Seat 4: N4$H (big blind) folded on the Flop
Seat 5: Ilov3NBA folded before Flop (didn't bet)
Seat 6: KT90 folded before Flop (didn't bet)
Seat 7: Igoriah folded before Flop (didn't bet)
Seat 8: bananajoe001 collected ($4.78)
Seat 9: matiko09 (button) folded before Flop (didn't bet)





PokerStars Hand #150752260657:  Hold'em No Limit ($0.50/$1.00 USD) - 2016/03/22 14:20:45 CET [2016/03/22 9:20:45 ET]
Table 'Stephano II' 9-max Seat #1 is the button
Seat 1: cipriank11 ($80 in chips) 
Seat 2: buckshot150 ($82.46 in chips) 
Seat 3: lombardo11 ($77 in chips) 
Seat 4: AWATAR 21 ($110.66 in chips) 
Seat 5: mb2part ($98.50 in chips) 
Seat 6: beterc0re ($126.29 in chips) 
Seat 7: ilaviiitech ($100 in chips) 
Seat 9: matiko09 ($145.69 in chips) 
buckshot150: posts small blind $0.50
lombardo11: posts big blind $1
KingCastle77: sits out 
*** HOLE CARDS ***
Dealt to matiko09 [Kh Ks]
AWATAR 21: folds 
mb2part: folds 
beterc0re: folds 
ilaviiitech: folds 
matiko09: raises $1.50 to $2.50
cipriank11: folds 
buckshot150: folds 
lombardo11: raises $4.50 to $7
matiko09: raises $14 to $21
lombardo11: calls $14
*** FLOP *** [2s Js Th]
buckshot150 leaves the table
I The King I joins the table at seat #2 
lombardo11: checks 
matiko09: bets $19
lombardo11: calls $19
*** TURN *** [2s Js Th] [9d]
lombardo11: checks 
matiko09: bets $50
lombardo11: calls $37 and is all-in
Uncalled bet ($13) returned to matiko09
*** RIVER *** [2s Js Th 9d] [2c]
*** SHOW DOWN ***
lombardo11: shows [Kd Qc] (a straight, Nine to King)
matiko09: mucks hand 
lombardo11 collected $151.70 from pot
*** SUMMARY ***
Total pot $154.50 | Rake $2.80 
Board [2s Js Th 9d 2c]
Seat 1: cipriank11 (button) folded before Flop (didn't bet)
Seat 2: buckshot150 (small blind) folded before Flop
Seat 3: lombardo11 (big blind) showed [Kd Qc] and won ($151.70) with a straight, Nine to King
Seat 4: AWATAR 21 folded before Flop (didn't bet)
Seat 5: mb2part folded before Flop (didn't bet)
Seat 6: beterc0re folded before Flop (didn't bet)
Seat 7: ilaviiitech folded before Flop (didn't bet)
Seat 9: matiko09 mucked [Kh Ks]





PokerStars Hand #150752260279:  Hold'em No Limit ($0.50/$1.00 USD) - 2016/03/22 14:20:45 CET [2016/03/22 9:20:45 ET]
Table 'Polyxena' 9-max Seat #4 is the button
Seat 1: I The King I ($111.23 in chips) 
Seat 2: cobrik23 ($72.61 in chips) 
Seat 4: fanmtZ ($43.95 in chips) 
Seat 5: MrAndMisses ($37.45 in chips) 
Seat 7: matiko09 ($100 in chips) 
Seat 8: kift74 ($125.06 in chips) 
Seat 9: ardo888 ($150.37 in chips) 
MrAndMisses: posts small blind $0.50
matiko09: posts big blind $1
*** HOLE CARDS ***
Dealt to matiko09 [Js Kd]
kift74: raises $2 to $3
ardo888: folds 
I The King I: folds 
cobrik23: folds 
fanmtZ: folds 
MrAndMisses: folds 
Ilov3NBA joins the table at seat #6 
matiko09: folds 
Uncalled bet ($2) returned to kift74
kift74 collected $2.50 from pot
*** SUMMARY ***
Total pot $2.50 | Rake $0 
Seat 1: I The King I folded before Flop (didn't bet)
Seat 2: cobrik23 folded before Flop (didn't bet)
Seat 4: fanmtZ (button) folded before Flop (didn't bet)
Seat 5: MrAndMisses (small blind) folded before Flop
Seat 7: matiko09 (big blind) folded before Flop
Seat 8: kift74 collected ($2.50)
Seat 9: ardo888 folded before Flop (didn't bet)





PokerStars Hand #150752262132:  Hold'em No Limit ($0.50/$1.00 USD) - 2016/03/22 14:20:48 CET [2016/03/22 9:20:48 ET]
Table 'Colchis' 9-max Seat #1 is the button
Seat 1: theluckyjoe ($9.79 in chips) 
Seat 2: Ilov3NBA ($145.80 in chips) 
Seat 4: matiko09 ($100.07 in chips) 
Seat 7: Dantist1122 ($100 in chips) 
Seat 8: cobrik23 ($48.26 in chips) 
Seat 9: ardo888 ($109.65 in chips) 
Ilov3NBA: posts small blind $0.50
matiko09: posts big blind $1
*** HOLE CARDS ***
Dealt to matiko09 [9d Ad]
Dantist1122: folds 
cobrik23: folds 
ardo888: folds 
theluckyjoe: calls $1
Ilov3NBA: calls $0.50
matiko09: raises $4 to $5
theluckyjoe: folds 
Ilov3NBA: folds 
Uncalled bet ($4) returned to matiko09
matiko09 collected $3 from pot
matiko09: doesn't show hand 
*** SUMMARY ***
Total pot $3 | Rake $0 
Seat 1: theluckyjoe (button) folded before Flop
Seat 2: Ilov3NBA (small blind) folded before Flop
Seat 4: matiko09 (big blind) collected ($3)
Seat 7: Dantist1122 folded before Flop (didn't bet)
Seat 8: cobrik23 folded before Flop (didn't bet)
Seat 9: ardo888 folded before Flop (didn't bet)





PokerStars Hand #150752263758:  Hold'em No Limit ($0.50/$1.00 USD) - 2016/03/22 14:20:50 CET [2016/03/22 9:20:50 ET]
Table 'Miranda' 9-max Seat #8 is the button
Seat 1: cobrik23 ($61.53 in chips) 
Seat 2: Szevasztopol ($110.44 in chips) 
Seat 3: Muinmyheart ($100 in chips) 
Seat 4: bilukm ($51.40 in chips) 
Seat 6: matiko09 ($103.90 in chips) 
Seat 7: RICKA16 ($103.21 in chips) 
Seat 8: hammerwife ($102.87 in chips) 
Seat 9: ardo888 ($174.07 in chips) 
ardo888: posts small blind $0.50
cobrik23: posts big blind $1
*** HOLE CARDS ***
Dealt to matiko09 [Jd 5d]
Szevasztopol: folds 
Muinmyheart: folds 
bilukm: calls $1
matiko09: folds 
RICKA16: raises $4 to $5
hammerwife: folds 
ardo888: folds 
cobrik23: raises $10 to $15
bilukm: folds 
RICKA16: calls $10
*** FLOP *** [6h Js 5c]
cobrik23: checks 
RICKA16: bets $15
cobrik23: raises $31.53 to $46.53 and is all-in
RICKA16: folds 
Uncalled bet ($31.53) returned to cobrik23
cobrik23 collected $58.73 from pot
cobrik23: doesn't show hand 
*** SUMMARY ***
Total pot $61.50 | Rake $2.77 
Board [6h Js 5c]
Seat 1: cobrik23 (big blind) collected ($58.73)
Seat 2: Szevasztopol folded before Flop (didn't bet)
Seat 3: Muinmyheart folded before Flop (didn't bet)
Seat 4: bilukm folded before Flop
Seat 6: matiko09 folded before Flop (didn't bet)
Seat 7: RICKA16 folded on the Flop
Seat 8: hammerwife (button) folded before Flop (didn't bet)
Seat 9: ardo888 (small blind) folded before Flop





PokerStars Hand #150752266801:  Hold'em No Limit ($0.50/$1.00 USD) - 2016/03/22 14:20:55 CET [2016/03/22 9:20:55 ET]
Table 'Harding' 9-max Seat #1 is the button
Seat 1: matiko09 ($107.49 in chips) 
Seat 2: RICKA16 ($99 in chips) 
Seat 4: lixiangli ($147.48 in chips) 
Seat 5: DevilisHEyz ($136.74 in chips) 
Seat 6: Ilov3NBA ($107.12 in chips) 
Seat 7: mrhighryza ($105 in chips) 
Seat 9: omorfadramou ($100 in chips) 
RICKA16: posts small blind $0.50
lixiangli: posts big blind $1
*** HOLE CARDS ***
Dealt to matiko09 [Kh As]
DevilisHEyz: folds 
Ilov3NBA: folds 
mrhighryza: calls $1
omorfadramou: folds 
matiko09: raises $3 to $4
RICKA16: folds 
lixiangli: folds 
mrhighryza: calls $3
*** FLOP *** [6h Qh Qc]
mrhighryza: checks 
matiko09: checks 
*** TURN *** [6h Qh Qc] [Kd]
mrhighryza: bets $2
matiko09: calls $2
*** RIVER *** [6h Qh Qc Kd] [8s]
mrhighryza: checks 
matiko09: bets $8
mrhighryza: calls $8
*** SHOW DOWN ***
matiko09: shows [Kh As] (two pair, Kings and Queens)
mrhighryza: mucks hand 
matiko09 collected $28.17 from pot
*** SUMMARY ***
Total pot $29.50 | Rake $1.33 
Board [6h Qh Qc Kd 8s]
Seat 1: matiko09 (button) showed [Kh As] and won ($28.17) with two pair, Kings and Queens
Seat 2: RICKA16 (small blind) folded before Flop
Seat 4: lixiangli (big blind) folded before Flop
Seat 5: DevilisHEyz folded before Flop (didn't bet)
Seat 6: Ilov3NBA folded before Flop (didn't bet)
Seat 7: mrhighryza mucked [6c Kc]
Seat 9: omorfadramou folded before Flop (didn't bet)





PokerStars Hand #150752272540:  Hold'em No Limit ($0.50/$1.00 USD) - 2016/03/22 14:21:05 CET [2016/03/22 9:21:05 ET]
Table 'Arabis' 9-max Seat #5 is the button
Seat 2: ilaviiitech ($113.90 in chips) 
Seat 4: Painkiller72 ($125.17 in chips) 
Seat 5: matiko09 ($138.90 in chips) 
Seat 6: Ilov3NBA ($100 in chips) 
Seat 7: howsiao ($213.70 in chips) 
Seat 8: Bro_Happy ($200.74 in chips) 
Ilov3NBA: posts small blind $0.50
howsiao: posts big blind $1
cobrik23: sits out 
*** HOLE CARDS ***
Dealt to matiko09 [3h Tc]
Bro_Happy: folds 
ilaviiitech: folds 
Painkiller72: raises $1.50 to $2.50
matiko09: folds 
Ilov3NBA: folds 
howsiao: calls $1.50
*** FLOP *** [7d Jh 5s]
howsiao: checks 
Painkiller72: bets $3.67
howsiao: raises $3.67 to $7.34
Painkiller72: calls $3.67
*** TURN *** [7d Jh 5s] [4s]
howsiao: checks 
Painkiller72: checks 
*** RIVER *** [7d Jh 5s 4s] [3c]
howsiao: checks 
Painkiller72: checks 
*** SHOW DOWN ***
howsiao: shows [7s 8s] (a pair of Sevens)
Painkiller72: shows [Th Td] (a pair of Tens)
Painkiller72 collected $19.27 from pot
*** SUMMARY ***
Total pot $20.18 | Rake $0.91 
Board [7d Jh 5s 4s 3c]
Seat 2: ilaviiitech folded before Flop (didn't bet)
Seat 4: Painkiller72 showed [Th Td] and won ($19.27) with a pair of Tens
Seat 5: matiko09 (button) folded before Flop (didn't bet)
Seat 6: Ilov3NBA (small blind) folded before Flop
Seat 7: howsiao (big blind) showed [7s 8s] and lost with a pair of Sevens
Seat 8: Bro_Happy folded before Flop (didn't bet)





PokerStars Hand #150752272703:  Hold'em No Limit ($0.50/$1.00 USD) - 2016/03/22 14:21:05 CET [2016/03/22 9:21:05 ET]
Table 'Polyxena' 9-max Seat #5 is the button
Seat 1: I The King I ($111.23 in chips) 
Seat 2: cobrik23 ($72.61 in chips) 
Seat 4: fanmtZ ($43.95 in chips) 
Seat 5: MrAndMisses ($36.95 in chips) 
Seat 7: matiko09 ($100 in chips) 
Seat 8: kift74 ($126.56 in chips) 
Seat 9: ardo888 ($150.37 in chips) 
Ilov3NBA will be allowed to play after the button
matiko09: posts small blind $0.50
kift74: posts big blind $1
*** HOLE CARDS ***
Dealt to matiko09 [5h Td]
ardo888: folds 
I The King I: folds 
cobrik23: folds 
fanmtZ: raises $1.50 to $2.50
MrAndMisses: calls $2.50
matiko09: folds 
kift74: folds 
*** FLOP *** [2d Ks Tc]
fanmtZ: checks 
MrAndMisses: checks 
*** TURN *** [2d Ks Tc] [3c]
fanmtZ: checks 
MrAndMisses: bets $3
fanmtZ: calls $3
*** RIVER *** [2d Ks Tc 3c] [9h]
fanmtZ: checks 
MrAndMisses: bets $8
fanmtZ: calls $8
*** SHOW DOWN ***
MrAndMisses: shows [2s 3s] (two pair, Threes and Deuces)
fanmtZ: mucks hand 
MrAndMisses collected $27.22 from pot
*** SUMMARY ***
Total pot $28.50 | Rake $1.28 
Board [2d Ks Tc 3c 9h]
Seat 1: I The King I folded before Flop (didn't bet)
Seat 2: cobrik23 folded before Flop (didn't bet)
Seat 4: fanmtZ mucked [Ts Ah]
Seat 5: MrAndMisses (button) showed [2s 3s] and won ($27.22) with two pair, Threes and Deuces
Seat 7: matiko09 (small blind) folded before Flop
Seat 8: kift74 (big blind) folded before Flop
Seat 9: ardo888 folded before Flop (didn't bet)





PokerStars Hand #150752277809:  Hold'em No Limit ($0.50/$1.00 USD) - 2016/03/22 14:21:13 CET [2016/03/22 9:21:13 ET]
Table 'Crater II' 9-max Seat #3 is the button
Seat 1: matiko09 ($124.77 in chips) 
Seat 2: Eisbaerli85 ($123.75 in chips) 
Seat 3: lixiangli ($100.05 in chips) 
Seat 6: Kobiroga150 ($54.41 in chips) 
Seat 7: AWATAR 21 ($52.66 in chips) 
Seat 8: KronosAK ($113.78 in chips) 
Seat 9: I The King I ($115.70 in chips) 
fanmtZ will be allowed to play after the button
Kobiroga150: posts small blind $0.50
AWATAR 21: posts big blind $1
*** HOLE CARDS ***
Dealt to matiko09 [2h 5d]
KronosAK: folds 
I The King I: folds 
matiko09: folds 
Eisbaerli85: folds 
lixiangli: folds 
Kobiroga150: calls $0.50
AWATAR 21: checks 
*** FLOP *** [Jh Ad 4c]
Kobiroga150: bets $1
AWATAR 21: folds 
Uncalled bet ($1) returned to Kobiroga150
Kobiroga150 collected $1.91 from pot
Kobiroga150: doesn't show hand 
*** SUMMARY ***
Total pot $2 | Rake $0.09 
Board [Jh Ad 4c]
Seat 1: matiko09 folded before Flop (didn't bet)
Seat 2: Eisbaerli85 folded before Flop (didn't bet)
Seat 3: lixiangli (button) folded before Flop (didn't bet)
Seat 6: Kobiroga150 (small blind) collected ($1.91)
Seat 7: AWATAR 21 (big blind) folded on the Flop
Seat 8: KronosAK folded before Flop (didn't bet)
Seat 9: I The King I folded before Flop (didn't bet)





PokerStars Hand #150752279169:  Hold'em No Limit ($0.50/$1.00 USD) - 2016/03/22 14:21:16 CET [2016/03/22 9:21:16 ET]
Table 'Colchis' 9-max Seat #2 is the button
Seat 1: theluckyjoe ($8.79 in chips) 
Seat 2: Ilov3NBA ($144.80 in chips) 
Seat 4: matiko09 ($102.07 in chips) 
Seat 7: Dantist1122 ($100 in chips) 
Seat 8: cobrik23 ($48.26 in chips) 
Seat 9: ardo888 ($109.65 in chips) 
matiko09: posts small blind $0.50
Dantist1122: posts big blind $1
*** HOLE CARDS ***
Dealt to matiko09 [8h 2s]
cobrik23: folds 
ardo888: folds 
theluckyjoe: calls $1
Ilov3NBA: folds 
matiko09: folds 
Dantist1122: checks 
*** FLOP *** [Ad 8c Tc]
Dantist1122: checks 
theluckyjoe: bets $1
Dantist1122: folds 
Uncalled bet ($1) returned to theluckyjoe
theluckyjoe collected $2.39 from pot
theluckyjoe: doesn't show hand 
*** SUMMARY ***
Total pot $2.50 | Rake $0.11 
Board [Ad 8c Tc]
Seat 1: theluckyjoe collected ($2.39)
Seat 2: Ilov3NBA (button) folded before Flop (didn't bet)
Seat 4: matiko09 (small blind) folded before Flop
Seat 7: Dantist1122 (big blind) folded on the Flop
Seat 8: cobrik23 folded before Flop (didn't bet)
Seat 9: ardo888 folded before Flop (didn't bet)





PokerStars Hand #150752293964:  Hold'em No Limit ($0.50/$1.00 USD) - 2016/03/22 14:21:40 CET [2016/03/22 9:21:40 ET]
Table 'Taygeta II' 9-max Seat #9 is the button
Seat 1: DevilisHEyz ($90.28 in chips) 
Seat 2: khan Erkesh ($194.06 in chips) 
Seat 3: Muinmyheart ($100 in chips) 
Seat 4: matiko09 ($100 in chips) 
Seat 5: RICKA16 ($100 in chips) 
Seat 6: I The King I ($107 in chips) 
Seat 7: Szevasztopol ($103.68 in chips) 
Seat 9: cobrik23 ($52.40 in chips) 
DevilisHEyz: posts small blind $0.50
khan Erkesh: posts big blind $1
*** HOLE CARDS ***
Dealt to matiko09 [9c 2d]
Muinmyheart: folds 
matiko09: folds 
RICKA16: folds 
I The King I: folds 
Szevasztopol: folds 
cobrik23: folds 
DevilisHEyz: folds 
Uncalled bet ($0.50) returned to khan Erkesh
khan Erkesh collected $1 from pot
khan Erkesh: doesn't show hand 
*** SUMMARY ***
Total pot $1 | Rake $0 
Seat 1: DevilisHEyz (small blind) folded before Flop
Seat 2: khan Erkesh (big blind) collected ($1)
Seat 3: Muinmyheart folded before Flop (didn't bet)
Seat 4: matiko09 folded before Flop (didn't bet)
Seat 5: RICKA16 folded before Flop (didn't bet)
Seat 6: I The King I folded before Flop (didn't bet)
Seat 7: Szevasztopol folded before Flop (didn't bet)
Seat 9: cobrik23 (button) folded before Flop (didn't bet)





PokerStars Hand #150752295889:  Hold'em No Limit ($0.50/$1.00 USD) - 2016/03/22 14:21:43 CET [2016/03/22 9:21:43 ET]
Table 'Crater II' 9-max Seat #6 is the button
Seat 1: matiko09 ($124.77 in chips) 
Seat 2: Eisbaerli85 ($123.75 in chips) 
Seat 3: lixiangli ($100.05 in chips) 
Seat 6: Kobiroga150 ($55.32 in chips) 
Seat 7: AWATAR 21 ($51.66 in chips) 
Seat 8: KronosAK ($113.78 in chips) 
Seat 9: I The King I ($115.70 in chips) 
AWATAR 21: posts small blind $0.50
KronosAK: posts big blind $1
fanmtZ: sits out 
*** HOLE CARDS ***
Dealt to matiko09 [Ts Jd]
I The King I: folds 
matiko09: folds 
Eisbaerli85: folds 
lixiangli: folds 
Kobiroga150: folds 
AWATAR 21: calls $0.50
KronosAK: checks 
*** FLOP *** [9h 6h 3d]
AWATAR 21: checks 
KronosAK: checks 
*** TURN *** [9h 6h 3d] [2c]
AWATAR 21: bets $1
KronosAK: calls $1
*** RIVER *** [9h 6h 3d 2c] [Kh]
AWATAR 21: bets $1
KronosAK: folds 
Uncalled bet ($1) returned to AWATAR 21
AWATAR 21 collected $3.82 from pot
*** SUMMARY ***
Total pot $4 | Rake $0.18 
Board [9h 6h 3d 2c Kh]
Seat 1: matiko09 folded before Flop (didn't bet)
Seat 2: Eisbaerli85 folded before Flop (didn't bet)
Seat 3: lixiangli folded before Flop (didn't bet)
Seat 6: Kobiroga150 (button) folded before Flop (didn't bet)
Seat 7: AWATAR 21 (small blind) collected ($3.82)
Seat 8: KronosAK (big blind) folded on the River
Seat 9: I The King I folded before Flop (didn't bet)





PokerStars Hand #150752296681:  Hold'em No Limit ($0.50/$1.00 USD) - 2016/03/22 14:21:44 CET [2016/03/22 9:21:44 ET]
Table 'Arabis' 9-max Seat #6 is the button
Seat 2: ilaviiitech ($113.90 in chips) 
Seat 4: Painkiller72 ($134.60 in chips) 
Seat 5: matiko09 ($138.90 in chips) 
Seat 6: Ilov3NBA ($100 in chips) 
Seat 7: howsiao ($203.86 in chips) 
Seat 8: Bro_Happy ($200.74 in chips) 
howsiao: posts small blind $0.50
Bro_Happy: posts big blind $1
cobrik23: sits out 
*** HOLE CARDS ***
Dealt to matiko09 [9d 8h]
ilaviiitech: raises $2 to $3
Painkiller72: folds 
matiko09: folds 
Ilov3NBA: folds 
howsiao: raises $2 to $5
Bro_Happy: folds 
ilaviiitech: calls $2
*** FLOP *** [7h 6d Ac]
howsiao: checks 
ilaviiitech: checks 
*** TURN *** [7h 6d Ac] [Qd]
howsiao: bets $10.50
ilaviiitech: folds 
Uncalled bet ($10.50) returned to howsiao
howsiao collected $10.50 from pot
howsiao: doesn't show hand 
*** SUMMARY ***
Total pot $11 | Rake $0.50 
Board [7h 6d Ac Qd]
Seat 2: ilaviiitech folded on the Turn
Seat 4: Painkiller72 folded before Flop (didn't bet)
Seat 5: matiko09 folded before Flop (didn't bet)
Seat 6: Ilov3NBA (button) folded before Flop (didn't bet)
Seat 7: howsiao (small blind) collected ($10.50)
Seat 8: Bro_Happy (big blind) folded before Flop





PokerStars Hand #150752297723:  Hold'em No Limit ($0.50/$1.00 USD) - 2016/03/22 14:21:46 CET [2016/03/22 9:21:46 ET]
Table 'Harding' 9-max Seat #2 is the button
Seat 1: matiko09 ($121.66 in chips) 
Seat 2: RICKA16 ($98.50 in chips) 
Seat 4: lixiangli ($146.48 in chips) 
Seat 5: DevilisHEyz ($136.74 in chips) 
Seat 6: Ilov3NBA ($107.12 in chips) 
Seat 7: mrhighryza ($91 in chips) 
Seat 9: omorfadramou ($100 in chips) 
lixiangli: posts small blind $0.50
DevilisHEyz: posts big blind $1
*** HOLE CARDS ***
Dealt to matiko09 [4c 7c]
Ilov3NBA: folds 
mrhighryza: calls $1
omorfadramou: folds 
matiko09: folds 
RICKA16: raises $3 to $4
lixiangli: folds 
DevilisHEyz: folds 
mrhighryza: calls $3
*** FLOP *** [8s 3s 2h]
mrhighryza: checks 
RICKA16: bets $6
mrhighryza: calls $6
*** TURN *** [8s 3s 2h] [As]
mrhighryza: checks 
RICKA16: checks 
*** RIVER *** [8s 3s 2h As] [Ah]
mrhighryza: bets $20.53
RICKA16: calls $20.53
*** SHOW DOWN ***
mrhighryza: shows [Ad Qs] (three of a kind, Aces)
RICKA16: mucks hand 
mrhighryza collected $59.76 from pot
*** SUMMARY ***
Total pot $62.56 | Rake $2.80 
Board [8s 3s 2h As Ah]
Seat 1: matiko09 folded before Flop (didn't bet)
Seat 2: RICKA16 (button) mucked [Jc 8c]
Seat 4: lixiangli (small blind) folded before Flop
Seat 5: DevilisHEyz (big blind) folded before Flop
Seat 6: Ilov3NBA folded before Flop (didn't bet)
Seat 7: mrhighryza showed [Ad Qs] and won ($59.76) with three of a kind, Aces
Seat 9: omorfadramou folded before Flop (didn't bet)





PokerStars Hand #150752301563:  Hold'em No Limit ($0.50/$1.00 USD) - 2016/03/22 14:21:52 CET [2016/03/22 9:21:52 ET]
Table 'Colchis' 9-max Seat #4 is the button
Seat 1: theluckyjoe ($10.18 in chips) 
Seat 2: Ilov3NBA ($144.80 in chips) 
Seat 4: matiko09 ($101.57 in chips) 
Seat 7: Dantist1122 ($100 in chips) 
Seat 8: cobrik23 ($48.26 in chips) 
Seat 9: ardo888 ($109.65 in chips) 
Dantist1122: posts small blind $0.50
cobrik23: posts big blind $1
*** HOLE CARDS ***
Dealt to matiko09 [Ah Kh]
ardo888: folds 
theluckyjoe: folds 
Ilov3NBA: raises $1.50 to $2.50
matiko09: calls $2.50
Dantist1122: folds 
cobrik23: folds 
*** FLOP *** [8d 6d Th]
Ilov3NBA: bets $4.59
matiko09: calls $4.59
*** TURN *** [8d 6d Th] [6h]
Ilov3NBA: checks 
matiko09: checks 
*** RIVER *** [8d 6d Th 6h] [2d]
Ilov3NBA: bets $8.50
matiko09: folds 
Uncalled bet ($8.50) returned to Ilov3NBA
Ilov3NBA collected $14.97 from pot
Ilov3NBA: doesn't show hand 
*** SUMMARY ***
Total pot $15.68 | Rake $0.71 
Board [8d 6d Th 6h 2d]
Seat 1: theluckyjoe folded before Flop (didn't bet)
Seat 2: Ilov3NBA collected ($14.97)
Seat 4: matiko09 (button) folded on the River
Seat 7: Dantist1122 (small blind) folded before Flop
Seat 8: cobrik23 (big blind) folded before Flop
Seat 9: ardo888 folded before Flop (didn't bet)





PokerStars Hand #150752305184:  Hold'em No Limit ($0.50/$1.00 USD) - 2016/03/22 14:21:58 CET [2016/03/22 9:21:58 ET]
Table 'Taygeta II' 9-max Seat #1 is the button
Seat 1: DevilisHEyz ($89.78 in chips) 
Seat 2: khan Erkesh ($194.56 in chips) 
Seat 3: Muinmyheart ($100 in chips) 
Seat 4: matiko09 ($100 in chips) 
Seat 5: RICKA16 ($100 in chips) 
Seat 6: I The King I ($107 in chips) 
Seat 7: Szevasztopol ($103.68 in chips) 
Seat 9: cobrik23 ($52.40 in chips) 
khan Erkesh: posts small blind $0.50
Muinmyheart: posts big blind $1
*** HOLE CARDS ***
Dealt to matiko09 [2h Kc]
matiko09: folds 
RICKA16: folds 
I The King I: folds 
Szevasztopol: folds 
cobrik23: folds 
DevilisHEyz: folds 
khan Erkesh: folds 
Uncalled bet ($0.50) returned to Muinmyheart
Muinmyheart collected $1 from pot
Muinmyheart: doesn't show hand 
*** SUMMARY ***
Total pot $1 | Rake $0 
Seat 1: DevilisHEyz (button) folded before Flop (didn't bet)
Seat 2: khan Erkesh (small blind) folded before Flop
Seat 3: Muinmyheart (big blind) collected ($1)
Seat 4: matiko09 folded before Flop (didn't bet)
Seat 5: RICKA16 folded before Flop (didn't bet)
Seat 6: I The King I folded before Flop (didn't bet)
Seat 7: Szevasztopol folded before Flop (didn't bet)
Seat 9: cobrik23 folded before Flop (didn't bet)





PokerStars Hand #150752308511:  Hold'em No Limit ($1/$2 USD) - 2016/03/22 14:22:04 CET [2016/03/22 9:22:04 ET]
Table 'Kiso II' 9-max Seat #3 is the button
Seat 3: seouljam ($419.66 in chips) 
Seat 4: N4$H ($200 in chips) 
Seat 5: Ilov3NBA ($306.84 in chips) 
Seat 6: KT90 ($336.24 in chips) 
Seat 7: Igoriah ($203.01 in chips) 
Seat 8: bananajoe001 ($186.14 in chips) 
Seat 9: matiko09 ($200 in chips) 
N4$H: posts small blind $1
Ilov3NBA: posts big blind $2
*** HOLE CARDS ***
Dealt to matiko09 [2s Ts]
KT90 has timed out
KT90: folds 
Igoriah: raises $3 to $5
bananajoe001: folds 
matiko09: folds 
seouljam: folds 
N4$H: folds 
Ilov3NBA: folds 
Uncalled bet ($3) returned to Igoriah
Igoriah collected $5 from pot
Igoriah: doesn't show hand 
*** SUMMARY ***
Total pot $5 | Rake $0 
Seat 3: seouljam (button) folded before Flop (didn't bet)
Seat 4: N4$H (small blind) folded before Flop
Seat 5: Ilov3NBA (big blind) folded before Flop
Seat 6: KT90 folded before Flop (didn't bet)
Seat 7: Igoriah collected ($5)
Seat 8: bananajoe001 folded before Flop (didn't bet)
Seat 9: matiko09 folded before Flop (didn't bet)





PokerStars Hand #150752311081:  Hold'em No Limit ($0.50/$1.00 USD) - 2016/03/22 14:22:08 CET [2016/03/22 9:22:08 ET]
Table 'Polyxena' 9-max Seat #7 is the button
Seat 1: I The King I ($111.23 in chips) 
Seat 2: cobrik23 ($72.61 in chips) 
Seat 4: fanmtZ ($40 in chips) 
Seat 5: MrAndMisses ($50.67 in chips) 
Seat 7: matiko09 ($100 in chips) 
Seat 8: kift74 ($125.56 in chips) 
Seat 9: ardo888 ($150.37 in chips) 
kift74: posts small blind $0.50
ardo888: posts big blind $1
Ilov3NBA: sits out 
*** HOLE CARDS ***
Dealt to matiko09 [6h 2c]
I The King I: folds 
cobrik23: folds 
fanmtZ: raises $2 to $3
MrAndMisses: folds 
matiko09: folds 
kift74: folds 
ardo888: calls $2
*** FLOP *** [Ks 5d 9h]
ardo888: checks 
fanmtZ: checks 
*** TURN *** [Ks 5d 9h] [Ac]
ardo888: bets $4.53
fanmtZ: folds 
Uncalled bet ($4.53) returned to ardo888
ardo888 collected $6.21 from pot
ardo888: doesn't show hand 
*** SUMMARY ***
Total pot $6.50 | Rake $0.29 
Board [Ks 5d 9h Ac]
Seat 1: I The King I folded before Flop (didn't bet)
Seat 2: cobrik23 folded before Flop (didn't bet)
Seat 4: fanmtZ folded on the Turn
Seat 5: MrAndMisses folded before Flop (didn't bet)
Seat 7: matiko09 (button) folded before Flop (didn't bet)
Seat 8: kift74 (small blind) folded before Flop
Seat 9: ardo888 (big blind) collected ($6.21)





PokerStars Hand #150752319821:  Hold'em No Limit ($0.50/$1.00 USD) - 2016/03/22 14:22:22 CET [2016/03/22 9:22:22 ET]
Table 'Stephano II' 9-max Seat #3 is the button
Seat 1: cipriank11 ($80 in chips) 
Seat 3: lombardo11 ($151.70 in chips) 
Seat 4: AWATAR 21 ($110.66 in chips) 
Seat 5: mb2part ($98.50 in chips) 
Seat 6: beterc0re ($126.29 in chips) 
Seat 7: ilaviiitech ($100 in chips) 
Seat 9: matiko09 ($100 in chips) 
AWATAR 21: posts small blind $0.50
mb2part: posts big blind $1
KingCastle77: sits out 
I The King I: sits out 
*** HOLE CARDS ***
Dealt to matiko09 [3h Qs]
beterc0re: folds 
ilaviiitech: folds 
matiko09: folds 
cipriank11: folds 
lombardo11: folds 
AWATAR 21: calls $0.50
mb2part: checks 
*** FLOP *** [9s Jc 4d]
AWATAR 21: checks 
mb2part: checks 
*** TURN *** [9s Jc 4d] [8d]
AWATAR 21: checks 
mb2part: checks 
*** RIVER *** [9s Jc 4d 8d] [6d]
AWATAR 21: checks 
mb2part: checks 
*** SHOW DOWN ***
AWATAR 21: shows [5d Kc] (high card King)
mb2part: shows [4s Tc] (a pair of Fours)
mb2part collected $1.91 from pot
*** SUMMARY ***
Total pot $2 | Rake $0.09 
Board [9s Jc 4d 8d 6d]
Seat 1: cipriank11 folded before Flop (didn't bet)
Seat 3: lombardo11 (button) folded before Flop (didn't bet)
Seat 4: AWATAR 21 (small blind) showed [5d Kc] and lost with high card King
Seat 5: mb2part (big blind) showed [4s Tc] and won ($1.91) with a pair of Fours
Seat 6: beterc0re folded before Flop (didn't bet)
Seat 7: ilaviiitech folded before Flop (didn't bet)
Seat 9: matiko09 folded before Flop (didn't bet)





PokerStars Hand #150752322085:  Hold'em No Limit ($0.50/$1.00 USD) - 2016/03/22 14:22:25 CET [2016/03/22 9:22:25 ET]
Table 'Miranda' 9-max Seat #9 is the button
Seat 1: cobrik23 ($90.26 in chips) 
Seat 2: Szevasztopol ($110.44 in chips) 
Seat 3: Muinmyheart ($100 in chips) 
Seat 4: bilukm ($50.40 in chips) 
Seat 6: matiko09 ($103.90 in chips) 
Seat 7: RICKA16 ($100 in chips) 
Seat 8: hammerwife ($102.87 in chips) 
Seat 9: ardo888 ($173.57 in chips) 
cobrik23: posts small blind $0.50
Szevasztopol: posts big blind $1
*** HOLE CARDS ***
Dealt to matiko09 [2s Qs]
Muinmyheart: raises $2 to $3
bilukm: folds 
matiko09: folds 
RICKA16: folds 
hammerwife: folds 
ardo888: calls $3
cobrik23: folds 
Szevasztopol: folds 
*** FLOP *** [Kh 3d 7h]
Muinmyheart: checks 
ardo888: checks 
*** TURN *** [Kh 3d 7h] [4s]
Muinmyheart: checks 
ardo888: bets $3.79
Muinmyheart: folds 
Uncalled bet ($3.79) returned to ardo888
ardo888 collected $7.16 from pot
ardo888: doesn't show hand 
*** SUMMARY ***
Total pot $7.50 | Rake $0.34 
Board [Kh 3d 7h 4s]
Seat 1: cobrik23 (small blind) folded before Flop
Seat 2: Szevasztopol (big blind) folded before Flop
Seat 3: Muinmyheart folded on the Turn
Seat 4: bilukm folded before Flop (didn't bet)
Seat 6: matiko09 folded before Flop (didn't bet)
Seat 7: RICKA16 folded before Flop (didn't bet)
Seat 8: hammerwife folded before Flop (didn't bet)
Seat 9: ardo888 (button) collected ($7.16)





PokerStars Hand #150752325179:  Hold'em No Limit ($0.50/$1.00 USD) - 2016/03/22 14:22:30 CET [2016/03/22 9:22:30 ET]
Table 'Taygeta II' 9-max Seat #2 is the button
Seat 1: DevilisHEyz ($89.78 in chips) 
Seat 2: khan Erkesh ($194.06 in chips) 
Seat 3: Muinmyheart ($100.50 in chips) 
Seat 4: matiko09 ($100 in chips) 
Seat 5: RICKA16 ($100 in chips) 
Seat 6: I The King I ($107 in chips) 
Seat 7: Szevasztopol ($103.68 in chips) 
Seat 9: cobrik23 ($52.40 in chips) 
Muinmyheart: posts small blind $0.50
matiko09: posts big blind $1
*** HOLE CARDS ***
Dealt to matiko09 [8h 4d]
RICKA16: raises $2 to $3
I The King I: calls $3
Szevasztopol: folds 
cobrik23: folds 
DevilisHEyz: calls $3
khan Erkesh: calls $3
Muinmyheart: folds 
matiko09: folds 
*** FLOP *** [Th 6s 8d]
RICKA16: checks 
I The King I: checks 
DevilisHEyz: checks 
khan Erkesh: checks 
*** TURN *** [Th 6s 8d] [2c]
RICKA16: checks 
I The King I: bets $8
DevilisHEyz: calls $8
khan Erkesh: folds 
RICKA16: folds 
*** RIVER *** [Th 6s 8d 2c] [2d]
I The King I: bets $14
DevilisHEyz: calls $14
*** SHOW DOWN ***
I The King I: shows [Td Ts] (a full house, Tens full of Deuces)
DevilisHEyz: mucks hand 
I The King I collected $54.91 from pot
*** SUMMARY ***
Total pot $57.50 | Rake $2.59 
Board [Th 6s 8d 2c 2d]
Seat 1: DevilisHEyz mucked [Tc 9c]
Seat 2: khan Erkesh (button) folded on the Turn
Seat 3: Muinmyheart (small blind) folded before Flop
Seat 4: matiko09 (big blind) folded before Flop
Seat 5: RICKA16 folded on the Turn
Seat 6: I The King I showed [Td Ts] and won ($54.91) with a full house, Tens full of Deuces
Seat 7: Szevasztopol folded before Flop (didn't bet)
Seat 9: cobrik23 folded before Flop (didn't bet)





PokerStars Hand #150752325335:  Hold'em No Limit ($0.50/$1.00 USD) - 2016/03/22 14:22:31 CET [2016/03/22 9:22:31 ET]
Table 'Arabis' 9-max Seat #7 is the button
Seat 2: ilaviiitech ($108.90 in chips) 
Seat 4: Painkiller72 ($134.60 in chips) 
Seat 5: matiko09 ($138.90 in chips) 
Seat 6: Ilov3NBA ($100 in chips) 
Seat 7: howsiao ($209.36 in chips) 
Seat 8: Bro_Happy ($199.74 in chips) 
Seat 9: cobrik23 ($57.15 in chips) 
Bro_Happy: posts small blind $0.50
cobrik23: posts big blind $1
*** HOLE CARDS ***
Dealt to matiko09 [8h 5h]
ilaviiitech: folds 
Painkiller72: folds 
matiko09: folds 
Ilov3NBA: folds 
howsiao: folds 
Bro_Happy: folds 
Uncalled bet ($0.50) returned to cobrik23
cobrik23 collected $1 from pot
cobrik23: doesn't show hand 
*** SUMMARY ***
Total pot $1 | Rake $0 
Seat 2: ilaviiitech folded before Flop (didn't bet)
Seat 4: Painkiller72 folded before Flop (didn't bet)
Seat 5: matiko09 folded before Flop (didn't bet)
Seat 6: Ilov3NBA folded before Flop (didn't bet)
Seat 7: howsiao (button) folded before Flop (didn't bet)
Seat 8: Bro_Happy (small blind) folded before Flop
Seat 9: cobrik23 (big blind) collected ($1)





PokerStars Hand #150752332662:  Hold'em No Limit ($0.50/$1.00 USD) - 2016/03/22 14:22:42 CET [2016/03/22 9:22:42 ET]
Table 'Crater II' 9-max Seat #7 is the button
Seat 1: matiko09 ($124.77 in chips) 
Seat 2: Eisbaerli85 ($123.75 in chips) 
Seat 3: lixiangli ($100.05 in chips) 
Seat 6: Kobiroga150 ($55.32 in chips) 
Seat 7: AWATAR 21 ($53.48 in chips) 
Seat 8: KronosAK ($111.78 in chips) 
Seat 9: I The King I ($115.70 in chips) 
KronosAK: posts small blind $0.50
I The King I: posts big blind $1
fanmtZ: sits out 
*** HOLE CARDS ***
Dealt to matiko09 [7s 7h]
matiko09: raises $2 to $3
Eisbaerli85: folds 
lixiangli: folds 
Kobiroga150: folds 
AWATAR 21: folds 
KronosAK: folds 
I The King I: folds 
Uncalled bet ($2) returned to matiko09
matiko09 collected $2.50 from pot
matiko09: doesn't show hand 
*** SUMMARY ***
Total pot $2.50 | Rake $0 
Seat 1: matiko09 collected ($2.50)
Seat 2: Eisbaerli85 folded before Flop (didn't bet)
Seat 3: lixiangli folded before Flop (didn't bet)
Seat 6: Kobiroga150 folded before Flop (didn't bet)
Seat 7: AWATAR 21 (button) folded before Flop (didn't bet)
Seat 8: KronosAK (small blind) folded before Flop
Seat 9: I The King I (big blind) folded before Flop





PokerStars Hand #150752332563:  Hold'em No Limit ($1/$2 USD) - 2016/03/22 14:22:42 CET [2016/03/22 9:22:42 ET]
Table 'Kiso II' 9-max Seat #4 is the button
Seat 3: seouljam ($419.66 in chips) 
Seat 4: N4$H ($200 in chips) 
Seat 5: Ilov3NBA ($304.84 in chips) 
Seat 6: KT90 ($336.24 in chips) 
Seat 7: Igoriah ($206.01 in chips) 
Seat 8: bananajoe001 ($186.14 in chips) 
Seat 9: matiko09 ($200 in chips) 
Ilov3NBA: posts small blind $1
KT90: posts big blind $2
*** HOLE CARDS ***
Dealt to matiko09 [4h 5d]
Igoriah: folds 
bananajoe001: raises $4 to $6
matiko09: folds 
seouljam: folds 
N4$H: folds 
Ilov3NBA: folds 
KT90: folds 
Uncalled bet ($4) returned to bananajoe001
bananajoe001 collected $5 from pot
bananajoe001: doesn't show hand 
*** SUMMARY ***
Total pot $5 | Rake $0 
Seat 3: seouljam folded before Flop (didn't bet)
Seat 4: N4$H (button) folded before Flop (didn't bet)
Seat 5: Ilov3NBA (small blind) folded before Flop
Seat 6: KT90 (big blind) folded before Flop
Seat 7: Igoriah folded before Flop (didn't bet)
Seat 8: bananajoe001 collected ($5)
Seat 9: matiko09 folded before Flop (didn't bet)





PokerStars Hand #150752340759:  Hold'em No Limit ($0.50/$1.00 USD) - 2016/03/22 14:22:56 CET [2016/03/22 9:22:56 ET]
Table 'Arabis' 9-max Seat #8 is the button
Seat 2: ilaviiitech ($108.90 in chips) 
Seat 4: Painkiller72 ($134.60 in chips) 
Seat 5: matiko09 ($138.90 in chips) 
Seat 6: Ilov3NBA ($100 in chips) 
Seat 7: howsiao ($209.36 in chips) 
Seat 8: Bro_Happy ($199.24 in chips) 
Seat 9: cobrik23 ($57.65 in chips) 
cobrik23: posts small blind $0.50
ilaviiitech: posts big blind $1
*** HOLE CARDS ***
Dealt to matiko09 [Qc Qh]
Painkiller72: folds 
matiko09: raises $2 to $3
Ilov3NBA: folds 
howsiao: folds 
Bro_Happy: folds 
cobrik23: folds 
ilaviiitech: folds 
Uncalled bet ($2) returned to matiko09
matiko09 collected $2.50 from pot
matiko09: doesn't show hand 
*** SUMMARY ***
Total pot $2.50 | Rake $0 
Seat 2: ilaviiitech (big blind) folded before Flop
Seat 4: Painkiller72 folded before Flop (didn't bet)
Seat 5: matiko09 collected ($2.50)
Seat 6: Ilov3NBA folded before Flop (didn't bet)
Seat 7: howsiao folded before Flop (didn't bet)
Seat 8: Bro_Happy (button) folded before Flop (didn't bet)
Seat 9: cobrik23 (small blind) folded before Flop





PokerStars Hand #150752341339:  Hold'em No Limit ($0.50/$1.00 USD) - 2016/03/22 14:22:57 CET [2016/03/22 9:22:57 ET]
Table 'Colchis' 9-max Seat #7 is the button
Seat 1: theluckyjoe ($10.18 in chips) 
Seat 2: Ilov3NBA ($152.68 in chips) 
Seat 4: matiko09 ($100 in chips) 
Seat 7: Dantist1122 ($100 in chips) 
Seat 8: cobrik23 ($47.26 in chips) 
Seat 9: ardo888 ($109.65 in chips) 
cobrik23: posts small blind $0.50
ardo888: posts big blind $1
*** HOLE CARDS ***
Dealt to matiko09 [Jc 3h]
theluckyjoe: folds 
Ilov3NBA: folds 
matiko09: folds 
Dantist1122: folds 
cobrik23: raises $2 to $3
ardo888: folds 
Uncalled bet ($2) returned to cobrik23
cobrik23 collected $2 from pot
cobrik23: doesn't show hand 
*** SUMMARY ***
Total pot $2 | Rake $0 
Seat 1: theluckyjoe folded before Flop (didn't bet)
Seat 2: Ilov3NBA folded before Flop (didn't bet)
Seat 4: matiko09 folded before Flop (didn't bet)
Seat 7: Dantist1122 (button) folded before Flop (didn't bet)
Seat 8: cobrik23 (small blind) collected ($2)
Seat 9: ardo888 (big blind) folded before Flop





PokerStars Hand #150752343757:  Hold'em No Limit ($0.50/$1.00 USD) - 2016/03/22 14:23:00 CET [2016/03/22 9:23:00 ET]
Table 'Harding' 9-max Seat #4 is the button
Seat 1: matiko09 ($121.66 in chips) 
Seat 2: RICKA16 ($67.97 in chips) 
Seat 4: lixiangli ($145.98 in chips) 
Seat 5: DevilisHEyz ($135.74 in chips) 
Seat 6: Ilov3NBA ($107.12 in chips) 
Seat 7: mrhighryza ($120.23 in chips) 
Seat 9: omorfadramou ($100 in chips) 
DevilisHEyz: posts small blind $0.50
Ilov3NBA: posts big blind $1
*** HOLE CARDS ***
Dealt to matiko09 [6d 7c]
mrhighryza: folds 
omorfadramou: folds 
matiko09: folds 
RICKA16: folds 
lixiangli: raises $2 to $3
DevilisHEyz: calls $2.50
Ilov3NBA: folds 
*** FLOP *** [8s 5d Tc]
DevilisHEyz: checks 
lixiangli: bets $3.34
DevilisHEyz: folds 
Uncalled bet ($3.34) returned to lixiangli
lixiangli collected $6.68 from pot
lixiangli: doesn't show hand 
*** SUMMARY ***
Total pot $7 | Rake $0.32 
Board [8s 5d Tc]
Seat 1: matiko09 folded before Flop (didn't bet)
Seat 2: RICKA16 folded before Flop (didn't bet)
Seat 4: lixiangli (button) collected ($6.68)
Seat 5: DevilisHEyz (small blind) folded on the Flop
Seat 6: Ilov3NBA (big blind) folded before Flop
Seat 7: mrhighryza folded before Flop (didn't bet)
Seat 9: omorfadramou folded before Flop (didn't bet)





PokerStars Hand #150752345530:  Hold'em No Limit ($1/$2 USD) - 2016/03/22 14:23:03 CET [2016/03/22 9:23:03 ET]
Table 'Kiso II' 9-max Seat #5 is the button
Seat 3: seouljam ($419.66 in chips) 
Seat 4: N4$H ($200 in chips) 
Seat 5: Ilov3NBA ($303.84 in chips) 
Seat 6: KT90 ($334.24 in chips) 
Seat 7: Igoriah ($206.01 in chips) 
Seat 8: bananajoe001 ($189.14 in chips) 
Seat 9: matiko09 ($200 in chips) 
KT90: posts small blind $1
Igoriah: posts big blind $2
*** HOLE CARDS ***
Dealt to matiko09 [Tc Jc]
bananajoe001: folds 
matiko09: raises $3 to $5
seouljam: calls $5
N4$H: folds 
Ilov3NBA: folds 
KT90: folds 
Igoriah: folds 
*** FLOP *** [4c 9s Th]
matiko09: checks 
seouljam: bets $6
matiko09: calls $6
*** TURN *** [4c 9s Th] [6s]
matiko09: checks 
seouljam: bets $12
matiko09: calls $12
*** RIVER *** [4c 9s Th 6s] [4h]
matiko09: checks 
seouljam: bets $30
matiko09: calls $30
*** SHOW DOWN ***
seouljam: shows [Jd Qc] (a pair of Fours)
matiko09: shows [Tc Jc] (two pair, Tens and Fours)
matiko09 collected $106.20 from pot
*** SUMMARY ***
Total pot $109 | Rake $2.80 
Board [4c 9s Th 6s 4h]
Seat 3: seouljam showed [Jd Qc] and lost with a pair of Fours
Seat 4: N4$H folded before Flop (didn't bet)
Seat 5: Ilov3NBA (button) folded before Flop (didn't bet)
Seat 6: KT90 (small blind) folded before Flop
Seat 7: Igoriah (big blind) folded before Flop
Seat 8: bananajoe001 folded before Flop (didn't bet)
Seat 9: matiko09 showed [Tc Jc] and won ($106.20) with two pair, Tens and Fours





PokerStars Hand #150752348835:  Hold'em No Limit ($0.50/$1.00 USD) - 2016/03/22 14:23:09 CET [2016/03/22 9:23:09 ET]
Table 'Crater II' 9-max Seat #8 is the button
Seat 1: matiko09 ($126.27 in chips) 
Seat 2: Eisbaerli85 ($123.75 in chips) 
Seat 3: lixiangli ($100.05 in chips) 
Seat 6: Kobiroga150 ($55.32 in chips) 
Seat 7: AWATAR 21 ($53.48 in chips) 
Seat 8: KronosAK ($111.28 in chips) 
Seat 9: I The King I ($114.70 in chips) 
I The King I: posts small blind $0.50
matiko09: posts big blind $1
fanmtZ: sits out 
*** HOLE CARDS ***
Dealt to matiko09 [5d 8h]
Eisbaerli85: folds 
lixiangli: folds 
Kobiroga150: folds 
AWATAR 21: folds 
KronosAK: folds 
I The King I: folds 
Uncalled bet ($0.50) returned to matiko09
matiko09 collected $1 from pot
matiko09: doesn't show hand 
*** SUMMARY ***
Total pot $1 | Rake $0 
Seat 1: matiko09 (big blind) collected ($1)
Seat 2: Eisbaerli85 folded before Flop (didn't bet)
Seat 3: lixiangli folded before Flop (didn't bet)
Seat 6: Kobiroga150 folded before Flop (didn't bet)
Seat 7: AWATAR 21 folded before Flop (didn't bet)
Seat 8: KronosAK (button) folded before Flop (didn't bet)
Seat 9: I The King I (small blind) folded before Flop





PokerStars Hand #150752351945:  Hold'em No Limit ($0.50/$1.00 USD) - 2016/03/22 14:23:14 CET [2016/03/22 9:23:14 ET]
Table 'Stephano II' 9-max Seat #4 is the button
Seat 1: cipriank11 ($80 in chips) 
Seat 3: lombardo11 ($151.70 in chips) 
Seat 4: AWATAR 21 ($109.66 in chips) 
Seat 5: mb2part ($99.41 in chips) 
Seat 6: beterc0re ($126.29 in chips) 
Seat 7: ilaviiitech ($100 in chips) 
Seat 9: matiko09 ($100 in chips) 
mb2part: posts small blind $0.50
beterc0re: posts big blind $1
KingCastle77: sits out 
I The King I: sits out 
*** HOLE CARDS ***
Dealt to matiko09 [4h 9s]
ilaviiitech: folds 
matiko09: folds 
cipriank11: folds 
lombardo11: folds 
AWATAR 21: raises $1 to $2
mb2part: folds 
cipriank11 leaves the table
beterc0re: folds 
Uncalled bet ($1) returned to AWATAR 21
AWATAR 21 collected $2.50 from pot
*** SUMMARY ***
Total pot $2.50 | Rake $0 
Seat 1: cipriank11 folded before Flop (didn't bet)
Seat 3: lombardo11 folded before Flop (didn't bet)
Seat 4: AWATAR 21 (button) collected ($2.50)
Seat 5: mb2part (small blind) folded before Flop
Seat 6: beterc0re (big blind) folded before Flop
Seat 7: ilaviiitech folded before Flop (didn't bet)
Seat 9: matiko09 folded before Flop (didn't bet)





PokerStars Hand #150752355685:  Hold'em No Limit ($0.50/$1.00 USD) - 2016/03/22 14:23:20 CET [2016/03/22 9:23:20 ET]
Table 'Miranda' 9-max Seat #1 is the button
Seat 1: cobrik23 ($89.76 in chips) 
Seat 2: Szevasztopol ($109.44 in chips) 
Seat 3: Muinmyheart ($100 in chips) 
Seat 4: bilukm ($50.40 in chips) 
Seat 6: matiko09 ($103.90 in chips) 
Seat 7: RICKA16 ($100 in chips) 
Seat 8: hammerwife ($102.87 in chips) 
Seat 9: ardo888 ($177.73 in chips) 
Szevasztopol: posts small blind $0.50
Muinmyheart: posts big blind $1
*** HOLE CARDS ***
Dealt to matiko09 [5h Qc]
bilukm: raises $1 to $2
matiko09: folds 
RICKA16: folds 
hammerwife: folds 
ardo888: raises $5 to $7
cobrik23: folds 
Szevasztopol: folds 
Muinmyheart: folds 
bilukm: calls $5
*** FLOP *** [8h Kc 6h]
bilukm: checks 
ardo888: bets $6.50
bilukm: folds 
Uncalled bet ($6.50) returned to ardo888
ardo888 collected $14.80 from pot
ardo888: doesn't show hand 
*** SUMMARY ***
Total pot $15.50 | Rake $0.70 
Board [8h Kc 6h]
Seat 1: cobrik23 (button) folded before Flop (didn't bet)
Seat 2: Szevasztopol (small blind) folded before Flop
Seat 3: Muinmyheart (big blind) folded before Flop
Seat 4: bilukm folded on the Flop
Seat 6: matiko09 folded before Flop (didn't bet)
Seat 7: RICKA16 folded before Flop (didn't bet)
Seat 8: hammerwife folded before Flop (didn't bet)
Seat 9: ardo888 collected ($14.80)





PokerStars Hand #150752362349:  Hold'em No Limit ($0.50/$1.00 USD) - 2016/03/22 14:23:31 CET [2016/03/22 9:23:31 ET]
Table 'Polyxena' 9-max Seat #8 is the button
Seat 1: I The King I ($111.23 in chips) 
Seat 2: cobrik23 ($72.61 in chips) 
Seat 4: fanmtZ ($40 in chips) 
Seat 5: MrAndMisses ($50.67 in chips) 
Seat 7: matiko09 ($100 in chips) 
Seat 8: kift74 ($125.06 in chips) 
Seat 9: ardo888 ($153.58 in chips) 
ardo888: posts small blind $0.50
I The King I: posts big blind $1
Ilov3NBA: sits out 
*** HOLE CARDS ***
Dealt to matiko09 [5h Ts]
cobrik23: folds 
fanmtZ: folds 
MrAndMisses: folds 
matiko09: folds 
kift74: folds 
ardo888: folds 
Uncalled bet ($0.50) returned to I The King I
I The King I collected $1 from pot
I The King I: doesn't show hand 
*** SUMMARY ***
Total pot $1 | Rake $0 
Seat 1: I The King I (big blind) collected ($1)
Seat 2: cobrik23 folded before Flop (didn't bet)
Seat 4: fanmtZ folded before Flop (didn't bet)
Seat 5: MrAndMisses folded before Flop (didn't bet)
Seat 7: matiko09 folded before Flop (didn't bet)
Seat 8: kift74 (button) folded before Flop (didn't bet)
Seat 9: ardo888 (small blind) folded before Flop





PokerStars Hand #150752362660:  Hold'em No Limit ($0.50/$1.00 USD) - 2016/03/22 14:23:31 CET [2016/03/22 9:23:31 ET]
Table 'Stephano II' 9-max Seat #5 is the button
Seat 3: lombardo11 ($151.70 in chips) 
Seat 4: AWATAR 21 ($111.16 in chips) 
Seat 5: mb2part ($98.91 in chips) 
Seat 6: beterc0re ($125.29 in chips) 
Seat 7: ilaviiitech ($100 in chips) 
Seat 9: matiko09 ($100 in chips) 
beterc0re: posts small blind $0.50
ilaviiitech: posts big blind $1
KingCastle77: sits out 
I The King I: sits out 
*** HOLE CARDS ***
Dealt to matiko09 [4d Jd]
omorfadramou joins the table at seat #1 
matiko09: folds 
lombardo11: folds 
AWATAR 21: raises $1 to $2
mb2part: folds 
beterc0re: folds 
ilaviiitech: folds 
Uncalled bet ($1) returned to AWATAR 21
AWATAR 21 collected $2.50 from pot
*** SUMMARY ***
Total pot $2.50 | Rake $0 
Seat 3: lombardo11 folded before Flop (didn't bet)
Seat 4: AWATAR 21 collected ($2.50)
Seat 5: mb2part (button) folded before Flop (didn't bet)
Seat 6: beterc0re (small blind) folded before Flop
Seat 7: ilaviiitech (big blind) folded before Flop
Seat 9: matiko09 folded before Flop (didn't bet)





PokerStars Hand #150752364008:  Hold'em No Limit ($0.50/$1.00 USD) - 2016/03/22 14:23:33 CET [2016/03/22 9:23:33 ET]
Table 'Arabis' 9-max Seat #9 is the button
Seat 2: ilaviiitech ($107.90 in chips) 
Seat 4: Painkiller72 ($134.60 in chips) 
Seat 5: matiko09 ($140.40 in chips) 
Seat 6: Ilov3NBA ($100 in chips) 
Seat 7: howsiao ($209.36 in chips) 
Seat 8: Bro_Happy ($199.24 in chips) 
Seat 9: cobrik23 ($57.15 in chips) 
ilaviiitech: posts small blind $0.50
Painkiller72: posts big blind $1
*** HOLE CARDS ***
Dealt to matiko09 [7d 9h]
matiko09: folds 
Ilov3NBA: folds 
howsiao: folds 
Bro_Happy: folds 
cobrik23: raises $1 to $2
ilaviiitech: folds 
Painkiller72: folds 
Uncalled bet ($1) returned to cobrik23
cobrik23 collected $2.50 from pot
cobrik23: doesn't show hand 
*** SUMMARY ***
Total pot $2.50 | Rake $0 
Seat 2: ilaviiitech (small blind) folded before Flop
Seat 4: Painkiller72 (big blind) folded before Flop
Seat 5: matiko09 folded before Flop (didn't bet)
Seat 6: Ilov3NBA folded before Flop (didn't bet)
Seat 7: howsiao folded before Flop (didn't bet)
Seat 8: Bro_Happy folded before Flop (didn't bet)
Seat 9: cobrik23 (button) collected ($2.50)





PokerStars Hand #150752364522:  Hold'em No Limit ($0.50/$1.00 USD) - 2016/03/22 14:23:34 CET [2016/03/22 9:23:34 ET]
Table 'Colchis' 9-max Seat #8 is the button
Seat 1: theluckyjoe ($10.18 in chips) 
Seat 2: Ilov3NBA ($152.68 in chips) 
Seat 4: matiko09 ($100 in chips) 
Seat 7: Dantist1122 ($100 in chips) 
Seat 8: cobrik23 ($48.26 in chips) 
Seat 9: ardo888 ($108.65 in chips) 
ardo888: posts small blind $0.50
theluckyjoe: posts big blind $1
*** HOLE CARDS ***
Dealt to matiko09 [2c Td]
Ilov3NBA: folds 
matiko09: folds 
Dantist1122: folds 
cobrik23: folds 
ardo888: folds 
Uncalled bet ($0.50) returned to theluckyjoe
theluckyjoe collected $1 from pot
theluckyjoe: doesn't show hand 
*** SUMMARY ***
Total pot $1 | Rake $0 
Seat 1: theluckyjoe (big blind) collected ($1)
Seat 2: Ilov3NBA folded before Flop (didn't bet)
Seat 4: matiko09 folded before Flop (didn't bet)
Seat 7: Dantist1122 folded before Flop (didn't bet)
Seat 8: cobrik23 (button) folded before Flop (didn't bet)
Seat 9: ardo888 (small blind) folded before Flop





PokerStars Hand #150752368906:  Hold'em No Limit ($0.50/$1.00 USD) - 2016/03/22 14:23:41 CET [2016/03/22 9:23:41 ET]
Table 'Crater II' 9-max Seat #9 is the button
Seat 1: matiko09 ($126.77 in chips) 
Seat 2: Eisbaerli85 ($123.75 in chips) 
Seat 3: lixiangli ($100.05 in chips) 
Seat 6: Kobiroga150 ($55.32 in chips) 
Seat 7: AWATAR 21 ($53.48 in chips) 
Seat 8: KronosAK ($111.28 in chips) 
Seat 9: I The King I ($114.20 in chips) 
matiko09: posts small blind $0.50
Eisbaerli85: posts big blind $1
fanmtZ: sits out 
*** HOLE CARDS ***
Dealt to matiko09 [Ac 8s]
lixiangli: folds 
Kobiroga150: folds 
AWATAR 21: raises $1 to $2
lixiangli leaves the table
KronosAK: folds 
hammerwife joins the table at seat #3 
I The King I: folds 
matiko09: folds 
Eisbaerli85: folds 
Uncalled bet ($1) returned to AWATAR 21
AWATAR 21 collected $2.50 from pot
*** SUMMARY ***
Total pot $2.50 | Rake $0 
Seat 1: matiko09 (small blind) folded before Flop
Seat 2: Eisbaerli85 (big blind) folded before Flop
Seat 3: lixiangli folded before Flop (didn't bet)
Seat 6: Kobiroga150 folded before Flop (didn't bet)
Seat 7: AWATAR 21 collected ($2.50)
Seat 8: KronosAK folded before Flop (didn't bet)
Seat 9: I The King I (button) folded before Flop (didn't bet)





PokerStars Hand #150752369753:  Hold'em No Limit ($0.50/$1.00 USD) - 2016/03/22 14:23:43 CET [2016/03/22 9:23:43 ET]
Table 'Harding' 9-max Seat #5 is the button
Seat 1: matiko09 ($121.66 in chips) 
Seat 2: RICKA16 ($100 in chips) 
Seat 4: lixiangli ($149.66 in chips) 
Seat 5: DevilisHEyz ($132.74 in chips) 
Seat 6: Ilov3NBA ($106.12 in chips) 
Seat 7: mrhighryza ($120.23 in chips) 
Seat 9: omorfadramou ($100 in chips) 
Ilov3NBA: posts small blind $0.50
mrhighryza: posts big blind $1
*** HOLE CARDS ***
Dealt to matiko09 [3h 5d]
omorfadramou: folds 
matiko09: folds 
RICKA16: folds 
lixiangli: raises $2 to $3
DevilisHEyz: folds 
Ilov3NBA: calls $2.50
mrhighryza: folds 
*** FLOP *** [Jd 7s 8s]
Ilov3NBA: checks 
lixiangli: bets $3.34
Ilov3NBA: folds 
Uncalled bet ($3.34) returned to lixiangli
lixiangli collected $6.68 from pot
lixiangli: doesn't show hand 
*** SUMMARY ***
Total pot $7 | Rake $0.32 
Board [Jd 7s 8s]
Seat 1: matiko09 folded before Flop (didn't bet)
Seat 2: RICKA16 folded before Flop (didn't bet)
Seat 4: lixiangli collected ($6.68)
Seat 5: DevilisHEyz (button) folded before Flop (didn't bet)
Seat 6: Ilov3NBA (small blind) folded on the Flop
Seat 7: mrhighryza (big blind) folded before Flop
Seat 9: omorfadramou folded before Flop (didn't bet)





PokerStars Hand #150752374081:  Hold'em No Limit ($0.50/$1.00 USD) - 2016/03/22 14:23:50 CET [2016/03/22 9:23:50 ET]
Table 'Polyxena' 9-max Seat #9 is the button
Seat 1: I The King I ($111.73 in chips) 
Seat 2: cobrik23 ($72.61 in chips) 
Seat 4: fanmtZ ($40 in chips) 
Seat 5: MrAndMisses ($50.67 in chips) 
Seat 7: matiko09 ($100 in chips) 
Seat 8: kift74 ($125.06 in chips) 
Seat 9: ardo888 ($153.08 in chips) 
I The King I: posts small blind $0.50
cobrik23: posts big blind $1
Ilov3NBA: sits out 
*** HOLE CARDS ***
Dealt to matiko09 [Kc 5c]
fanmtZ: folds 
MrAndMisses: folds 
matiko09: folds 
kift74: folds 
ardo888: folds 
I The King I: folds 
Uncalled bet ($0.50) returned to cobrik23
cobrik23 collected $1 from pot
cobrik23: doesn't show hand 
*** SUMMARY ***
Total pot $1 | Rake $0 
Seat 1: I The King I (small blind) folded before Flop
Seat 2: cobrik23 (big blind) collected ($1)
Seat 4: fanmtZ folded before Flop (didn't bet)
Seat 5: MrAndMisses folded before Flop (didn't bet)
Seat 7: matiko09 folded before Flop (didn't bet)
Seat 8: kift74 folded before Flop (didn't bet)
Seat 9: ardo888 (button) folded before Flop (didn't bet)





PokerStars Hand #150752374570:  Hold'em No Limit ($0.50/$1.00 USD) - 2016/03/22 14:23:50 CET [2016/03/22 9:23:50 ET]
Table 'Colchis' 9-max Seat #9 is the button
Seat 1: theluckyjoe ($10.68 in chips) 
Seat 2: Ilov3NBA ($152.68 in chips) 
Seat 4: matiko09 ($100 in chips) 
Seat 7: Dantist1122 ($100 in chips) 
Seat 8: cobrik23 ($48.26 in chips) 
Seat 9: ardo888 ($108.15 in chips) 
theluckyjoe: posts small blind $0.50
Ilov3NBA: posts big blind $1
*** HOLE CARDS ***
Dealt to matiko09 [4s 9d]
matiko09: folds 
Dantist1122: folds 
cobrik23: folds 
ardo888: folds 
theluckyjoe: calls $0.50
Ilov3NBA: raises $2 to $3
theluckyjoe: calls $2
*** FLOP *** [2d Kd 8c]
theluckyjoe: checks 
Ilov3NBA: bets $3.15
theluckyjoe: folds [6c]
Uncalled bet ($3.15) returned to Ilov3NBA
Ilov3NBA collected $5.73 from pot
Ilov3NBA: doesn't show hand 
*** SUMMARY ***
Total pot $6 | Rake $0.27 
Board [2d Kd 8c]
Seat 1: theluckyjoe (small blind) folded on the Flop
Seat 2: Ilov3NBA (big blind) collected ($5.73)
Seat 4: matiko09 folded before Flop (didn't bet)
Seat 7: Dantist1122 folded before Flop (didn't bet)
Seat 8: cobrik23 folded before Flop (didn't bet)
Seat 9: ardo888 (button) folded before Flop (didn't bet)





PokerStars Hand #150752377837:  Hold'em No Limit ($0.50/$1.00 USD) - 2016/03/22 14:23:56 CET [2016/03/22 9:23:56 ET]
Table 'Arabis' 9-max Seat #2 is the button
Seat 2: ilaviiitech ($107.40 in chips) 
Seat 4: Painkiller72 ($133.60 in chips) 
Seat 5: matiko09 ($140.40 in chips) 
Seat 6: Ilov3NBA ($100 in chips) 
Seat 7: howsiao ($209.36 in chips) 
Seat 8: Bro_Happy ($199.24 in chips) 
Seat 9: cobrik23 ($58.65 in chips) 
Painkiller72: posts small blind $0.50
matiko09: posts big blind $1
*** HOLE CARDS ***
Dealt to matiko09 [Ts Th]
Ilov3NBA: raises $2 to $3
howsiao: folds 
Bro_Happy: folds 
cobrik23: folds 
ilaviiitech: folds 
Painkiller72: folds 
matiko09: calls $2
*** FLOP *** [Jc 7s 7c]
matiko09: checks 
Ilov3NBA: bets $3.41
matiko09: calls $3.41
*** TURN *** [Jc 7s 7c] [9c]
matiko09: checks 
Ilov3NBA: checks 
*** RIVER *** [Jc 7s 7c 9c] [Qd]
matiko09: checks 
Ilov3NBA: checks 
*** SHOW DOWN ***
matiko09: shows [Ts Th] (two pair, Tens and Sevens)
Ilov3NBA: shows [Jh As] (two pair, Jacks and Sevens)
Ilov3NBA collected $12.72 from pot
*** SUMMARY ***
Total pot $13.32 | Rake $0.60 
Board [Jc 7s 7c 9c Qd]
Seat 2: ilaviiitech (button) folded before Flop (didn't bet)
Seat 4: Painkiller72 (small blind) folded before Flop
Seat 5: matiko09 (big blind) showed [Ts Th] and lost with two pair, Tens and Sevens
Seat 6: Ilov3NBA showed [Jh As] and won ($12.72) with two pair, Jacks and Sevens
Seat 7: howsiao folded before Flop (didn't bet)
Seat 8: Bro_Happy folded before Flop (didn't bet)
Seat 9: cobrik23 folded before Flop (didn't bet)





PokerStars Hand #150752378759:  Hold'em No Limit ($0.50/$1.00 USD) - 2016/03/22 14:23:57 CET [2016/03/22 9:23:57 ET]
Table 'Stephano II' 9-max Seat #6 is the button
Seat 3: lombardo11 ($151.70 in chips) 
Seat 4: AWATAR 21 ($112.66 in chips) 
Seat 5: mb2part ($98.91 in chips) 
Seat 6: beterc0re ($124.79 in chips) 
Seat 7: ilaviiitech ($100 in chips) 
Seat 8: KingCastle77 ($80 in chips) 
Seat 9: matiko09 ($100 in chips) 
ilaviiitech: posts small blind $0.50
KingCastle77: posts big blind $1
omorfadramou: sits out 
I The King I: sits out 
*** HOLE CARDS ***
Dealt to matiko09 [3d 5d]
matiko09: folds 
lombardo11: folds 
AWATAR 21: folds 
mb2part: raises $2 to $3
beterc0re: calls $3
ilaviiitech: folds 
KingCastle77: folds 
*** FLOP *** [Jc 5h 7d]
mb2part: bets $4
beterc0re: raises $9.29 to $13.29
mb2part: folds 
Uncalled bet ($9.29) returned to beterc0re
beterc0re collected $14.80 from pot
beterc0re: doesn't show hand 
*** SUMMARY ***
Total pot $15.50 | Rake $0.70 
Board [Jc 5h 7d]
Seat 3: lombardo11 folded before Flop (didn't bet)
Seat 4: AWATAR 21 folded before Flop (didn't bet)
Seat 5: mb2part folded on the Flop
Seat 6: beterc0re (button) collected ($14.80)
Seat 7: ilaviiitech (small blind) folded before Flop
Seat 8: KingCastle77 (big blind) folded before Flop
Seat 9: matiko09 folded before Flop (didn't bet)





PokerStars Hand #150752383276:  Hold'em No Limit ($0.50/$1.00 USD) - 2016/03/22 14:24:05 CET [2016/03/22 9:24:05 ET]
Table 'Crater II' 9-max Seat #1 is the button
Seat 1: matiko09 ($126.27 in chips) 
Seat 2: Eisbaerli85 ($122.75 in chips) 
Seat 3: hammerwife ($100 in chips) 
Seat 6: Kobiroga150 ($55.32 in chips) 
Seat 7: AWATAR 21 ($54.98 in chips) 
Seat 8: KronosAK ($111.28 in chips) 
Seat 9: I The King I ($114.20 in chips) 
Eisbaerli85: posts small blind $0.50
hammerwife: posts big blind $1
fanmtZ: sits out 
*** HOLE CARDS ***
Dealt to matiko09 [4d 5c]
Kobiroga150: raises $1 to $2
AWATAR 21: calls $2
KronosAK: folds 
I The King I: folds 
matiko09: folds 
Eisbaerli85: folds 
hammerwife: raises $10.50 to $12.50
Kobiroga150: folds 
AWATAR 21: raises $42.48 to $54.98 and is all-in
hammerwife: folds 
Uncalled bet ($42.48) returned to AWATAR 21
AWATAR 21 collected $27.50 from pot
*** SUMMARY ***
Total pot $27.50 | Rake $0 
Seat 1: matiko09 (button) folded before Flop (didn't bet)
Seat 2: Eisbaerli85 (small blind) folded before Flop
Seat 3: hammerwife (big blind) folded before Flop
Seat 6: Kobiroga150 folded before Flop
Seat 7: AWATAR 21 collected ($27.50)
Seat 8: KronosAK folded before Flop (didn't bet)
Seat 9: I The King I folded before Flop (didn't bet)





PokerStars Hand #150752383787:  Hold'em No Limit ($0.50/$1.00 USD) - 2016/03/22 14:24:05 CET [2016/03/22 9:24:05 ET]
Table 'Polyxena' 9-max Seat #1 is the button
Seat 1: I The King I ($111.23 in chips) 
Seat 2: cobrik23 ($73.11 in chips) 
Seat 4: fanmtZ ($40 in chips) 
Seat 5: MrAndMisses ($50.67 in chips) 
Seat 7: matiko09 ($100 in chips) 
Seat 8: kift74 ($125.06 in chips) 
Seat 9: ardo888 ($153.08 in chips) 
cobrik23: posts small blind $0.50
fanmtZ: posts big blind $1
Ilov3NBA: sits out 
*** HOLE CARDS ***
Dealt to matiko09 [4s Js]
MrAndMisses: folds 
matiko09: folds 
kift74: raises $2 to $3
ardo888: folds 
I The King I: folds 
cobrik23: folds 
fanmtZ: folds 
Uncalled bet ($2) returned to kift74
kift74 collected $2.50 from pot
kift74: doesn't show hand 
*** SUMMARY ***
Total pot $2.50 | Rake $0 
Seat 1: I The King I (button) folded before Flop (didn't bet)
Seat 2: cobrik23 (small blind) folded before Flop
Seat 4: fanmtZ (big blind) folded before Flop
Seat 5: MrAndMisses folded before Flop (didn't bet)
Seat 7: matiko09 folded before Flop (didn't bet)
Seat 8: kift74 collected ($2.50)
Seat 9: ardo888 folded before Flop (didn't bet)





PokerStars Hand #150752388767:  Hold'em No Limit ($0.50/$1.00 USD) - 2016/03/22 14:24:13 CET [2016/03/22 9:24:13 ET]
Table 'Miranda' 9-max Seat #2 is the button
Seat 1: cobrik23 ($89.76 in chips) 
Seat 2: Szevasztopol ($108.94 in chips) 
Seat 3: Muinmyheart ($100 in chips) 
Seat 4: bilukm ($43.40 in chips) 
Seat 6: matiko09 ($103.90 in chips) 
Seat 7: RICKA16 ($100 in chips) 
Seat 8: hammerwife ($102.87 in chips) 
Seat 9: ardo888 ($185.53 in chips) 
Muinmyheart: posts small blind $0.50
bilukm: posts big blind $1
*** HOLE CARDS ***
Dealt to matiko09 [Qc 8d]
matiko09: folds 
RICKA16: raises $2 to $3
hammerwife: folds 
ardo888: folds 
cobrik23: raises $6 to $9
Szevasztopol: folds 
Muinmyheart: folds 
bilukm: folds 
RICKA16: folds 
Uncalled bet ($6) returned to cobrik23
cobrik23 collected $7.50 from pot
cobrik23: doesn't show hand 
*** SUMMARY ***
Total pot $7.50 | Rake $0 
Seat 1: cobrik23 collected ($7.50)
Seat 2: Szevasztopol (button) folded before Flop (didn't bet)
Seat 3: Muinmyheart (small blind) folded before Flop
Seat 4: bilukm (big blind) folded before Flop
Seat 6: matiko09 folded before Flop (didn't bet)
Seat 7: RICKA16 folded before Flop
Seat 8: hammerwife folded before Flop (didn't bet)
Seat 9: ardo888 folded before Flop (didn't bet)





PokerStars Hand #150752392270:  Hold'em No Limit ($0.50/$1.00 USD) - 2016/03/22 14:24:19 CET [2016/03/22 9:24:19 ET]
Table 'Colchis' 9-max Seat #1 is the button
Seat 1: theluckyjoe ($7.68 in chips) 
Seat 2: Ilov3NBA ($155.41 in chips) 
Seat 4: matiko09 ($100 in chips) 
Seat 7: Dantist1122 ($100 in chips) 
Seat 8: cobrik23 ($48.26 in chips) 
Seat 9: ardo888 ($108.15 in chips) 
Ilov3NBA: posts small blind $0.50
matiko09: posts big blind $1
*** HOLE CARDS ***
Dealt to matiko09 [5s 9c]
Dantist1122: raises $2 to $3
cobrik23: folds 
ardo888: folds 
theluckyjoe: folds 
Ilov3NBA: folds 
matiko09: folds 
Uncalled bet ($2) returned to Dantist1122
Dantist1122 collected $2.50 from pot
Dantist1122: doesn't show hand 
*** SUMMARY ***
Total pot $2.50 | Rake $0 
Seat 1: theluckyjoe (button) folded before Flop (didn't bet)
Seat 2: Ilov3NBA (small blind) folded before Flop
Seat 4: matiko09 (big blind) folded before Flop
Seat 7: Dantist1122 collected ($2.50)
Seat 8: cobrik23 folded before Flop (didn't bet)
Seat 9: ardo888 folded before Flop (didn't bet)





PokerStars Hand #150752394137:  Hold'em No Limit ($0.50/$1.00 USD) - 2016/03/22 14:24:22 CET [2016/03/22 9:24:22 ET]
Table 'Harding' 9-max Seat #6 is the button
Seat 1: matiko09 ($121.66 in chips) 
Seat 2: RICKA16 ($100 in chips) 
Seat 4: lixiangli ($153.34 in chips) 
Seat 5: DevilisHEyz ($132.74 in chips) 
Seat 6: Ilov3NBA ($103.12 in chips) 
Seat 7: mrhighryza ($119.23 in chips) 
Seat 9: omorfadramou ($100 in chips) 
mrhighryza: posts small blind $0.50
omorfadramou: posts big blind $1
*** HOLE CARDS ***
Dealt to matiko09 [2c Jc]
matiko09: folds 
RICKA16: folds 
lixiangli: folds 
DevilisHEyz: calls $1
Ilov3NBA: raises $3.50 to $4.50
mrhighryza: folds 
omorfadramou: folds 
DevilisHEyz: calls $3.50
*** FLOP *** [9h 3c 9d]
DevilisHEyz: checks 
Ilov3NBA: bets $5.51
DevilisHEyz: calls $5.51
*** TURN *** [9h 3c 9d] [5s]
DevilisHEyz: checks 
Ilov3NBA: checks 
*** RIVER *** [9h 3c 9d 5s] [7h]
DevilisHEyz: bets $10.27
Ilov3NBA: folds 
Uncalled bet ($10.27) returned to DevilisHEyz
DevilisHEyz collected $20.55 from pot
*** SUMMARY ***
Total pot $21.52 | Rake $0.97 
Board [9h 3c 9d 5s 7h]
Seat 1: matiko09 folded before Flop (didn't bet)
Seat 2: RICKA16 folded before Flop (didn't bet)
Seat 4: lixiangli folded before Flop (didn't bet)
Seat 5: DevilisHEyz collected ($20.55)
Seat 6: Ilov3NBA (button) folded on the River
Seat 7: mrhighryza (small blind) folded before Flop
Seat 9: omorfadramou (big blind) folded before Flop





PokerStars Hand #150752404186:  Hold'em No Limit ($0.50/$1.00 USD) - 2016/03/22 14:24:38 CET [2016/03/22 9:24:38 ET]
Table 'Colchis' 9-max Seat #2 is the button
Seat 1: theluckyjoe ($7.68 in chips) 
Seat 2: Ilov3NBA ($154.91 in chips) 
Seat 4: matiko09 ($100 in chips) 
Seat 7: Dantist1122 ($101.50 in chips) 
Seat 8: cobrik23 ($48.26 in chips) 
Seat 9: ardo888 ($108.15 in chips) 
matiko09: posts small blind $0.50
Dantist1122: posts big blind $1
*** HOLE CARDS ***
Dealt to matiko09 [5c Qh]
cobrik23: folds 
ardo888: folds 
theluckyjoe: folds 
Ilov3NBA: raises $1 to $2
matiko09: folds 
Dantist1122: raises $6 to $8
Ilov3NBA: folds 
Uncalled bet ($6) returned to Dantist1122
Dantist1122 collected $4.50 from pot
Dantist1122: doesn't show hand 
*** SUMMARY ***
Total pot $4.50 | Rake $0 
Seat 1: theluckyjoe folded before Flop (didn't bet)
Seat 2: Ilov3NBA (button) folded before Flop
Seat 4: matiko09 (small blind) folded before Flop
Seat 7: Dantist1122 (big blind) collected ($4.50)
Seat 8: cobrik23 folded before Flop (didn't bet)
Seat 9: ardo888 folded before Flop (didn't bet)





PokerStars Hand #150752411859:  Hold'em No Limit ($0.50/$1.00 USD) - 2016/03/22 14:24:51 CET [2016/03/22 9:24:51 ET]
Table 'Taygeta II' 9-max Seat #3 is the button
Seat 1: DevilisHEyz ($64.78 in chips) 
Seat 2: khan Erkesh ($191.06 in chips) 
Seat 3: Muinmyheart ($100 in chips) 
Seat 4: matiko09 ($100 in chips) 
Seat 5: RICKA16 ($100 in chips) 
Seat 6: I The King I ($136.91 in chips) 
Seat 7: Szevasztopol ($103.68 in chips) 
Seat 9: cobrik23 ($52.40 in chips) 
matiko09: posts small blind $0.50
RICKA16: posts big blind $1
*** HOLE CARDS ***
Dealt to matiko09 [Tc Jh]
I The King I: folds 
Szevasztopol: folds 
cobrik23: folds 
DevilisHEyz: folds 
khan Erkesh: raises $2 to $3
Muinmyheart: calls $3
matiko09: folds 
RICKA16: folds 
*** FLOP *** [3h Ah Qc]
khan Erkesh: bets $4
Muinmyheart: calls $4
*** TURN *** [3h Ah Qc] [Qh]
khan Erkesh: checks 
Muinmyheart: bets $7.50
khan Erkesh: folds 
Uncalled bet ($7.50) returned to Muinmyheart
Muinmyheart collected $14.80 from pot
Muinmyheart: doesn't show hand 
*** SUMMARY ***
Total pot $15.50 | Rake $0.70 
Board [3h Ah Qc Qh]
Seat 1: DevilisHEyz folded before Flop (didn't bet)
Seat 2: khan Erkesh folded on the Turn
Seat 3: Muinmyheart (button) collected ($14.80)
Seat 4: matiko09 (small blind) folded before Flop
Seat 5: RICKA16 (big blind) folded before Flop
Seat 6: I The King I folded before Flop (didn't bet)
Seat 7: Szevasztopol folded before Flop (didn't bet)
Seat 9: cobrik23 folded before Flop (didn't bet)





PokerStars Hand #150752416407:  Hold'em No Limit ($0.50/$1.00 USD) - 2016/03/22 14:24:58 CET [2016/03/22 9:24:58 ET]
Table 'Miranda' 9-max Seat #3 is the button
Seat 1: cobrik23 ($94.26 in chips) 
Seat 2: Szevasztopol ($108.94 in chips) 
Seat 3: Muinmyheart ($100 in chips) 
Seat 4: bilukm ($42.40 in chips) 
Seat 6: matiko09 ($103.90 in chips) 
Seat 7: RICKA16 ($100 in chips) 
Seat 8: hammerwife ($102.87 in chips) 
Seat 9: ardo888 ($185.53 in chips) 
bilukm: posts small blind $0.50
matiko09: posts big blind $1
*** HOLE CARDS ***
Dealt to matiko09 [8d Td]
RICKA16: folds 
hammerwife: folds 
ardo888: folds 
cobrik23: raises $2 to $3
Szevasztopol: folds 
Muinmyheart: folds 
bilukm: calls $2.50
matiko09: folds 
*** FLOP *** [Tc 4c As]
bilukm: checks 
cobrik23: bets $5
bilukm: folds 
Uncalled bet ($5) returned to cobrik23
cobrik23 collected $6.68 from pot
cobrik23: doesn't show hand 
*** SUMMARY ***
Total pot $7 | Rake $0.32 
Board [Tc 4c As]
Seat 1: cobrik23 collected ($6.68)
Seat 2: Szevasztopol folded before Flop (didn't bet)
Seat 3: Muinmyheart (button) folded before Flop (didn't bet)
Seat 4: bilukm (small blind) folded on the Flop
Seat 6: matiko09 (big blind) folded before Flop
Seat 7: RICKA16 folded before Flop (didn't bet)
Seat 8: hammerwife folded before Flop (didn't bet)
Seat 9: ardo888 folded before Flop (didn't bet)





PokerStars Hand #150752416575:  Hold'em No Limit ($0.50/$1.00 USD) - 2016/03/22 14:24:58 CET [2016/03/22 9:24:58 ET]
Table 'Stephano II' 9-max Seat #7 is the button
Seat 3: lombardo11 ($151.70 in chips) 
Seat 4: AWATAR 21 ($112.66 in chips) 
Seat 5: mb2part ($91.91 in chips) 
Seat 6: beterc0re ($132.59 in chips) 
Seat 7: ilaviiitech ($100 in chips) 
Seat 8: KingCastle77 ($79 in chips) 
Seat 9: matiko09 ($100 in chips) 
KingCastle77: posts small blind $0.50
matiko09: posts big blind $1
omorfadramou: sits out 
I The King I: sits out 
*** HOLE CARDS ***
Dealt to matiko09 [6c 8h]
lombardo11: folds 
AWATAR 21: folds 
mb2part: folds 
beterc0re: folds 
ilaviiitech: raises $2 to $3
KingCastle77: folds 
matiko09: folds 
Uncalled bet ($2) returned to ilaviiitech
ilaviiitech collected $2.50 from pot
ilaviiitech: doesn't show hand 
*** SUMMARY ***
Total pot $2.50 | Rake $0 
Seat 3: lombardo11 folded before Flop (didn't bet)
Seat 4: AWATAR 21 folded before Flop (didn't bet)
Seat 5: mb2part folded before Flop (didn't bet)
Seat 6: beterc0re folded before Flop (didn't bet)
Seat 7: ilaviiitech (button) collected ($2.50)
Seat 8: KingCastle77 (small blind) folded before Flop
Seat 9: matiko09 (big blind) folded before Flop





PokerStars Hand #150752419106:  Hold'em No Limit ($0.50/$1.00 USD) - 2016/03/22 14:25:02 CET [2016/03/22 9:25:02 ET]
Table 'Polyxena' 9-max Seat #2 is the button
Seat 1: I The King I ($111.23 in chips) 
Seat 2: cobrik23 ($72.61 in chips) 
Seat 4: fanmtZ ($40 in chips) 
Seat 5: MrAndMisses ($50.67 in chips) 
Seat 7: matiko09 ($100 in chips) 
Seat 8: kift74 ($126.56 in chips) 
Seat 9: ardo888 ($153.08 in chips) 
fanmtZ: posts small blind $0.50
MrAndMisses: posts big blind $1
Ilov3NBA: sits out 
*** HOLE CARDS ***
Dealt to matiko09 [7s Th]
matiko09: folds 
kift74: folds 
ardo888: folds 
I The King I: raises $1.50 to $2.50
cobrik23: raises $4.50 to $7
fanmtZ: folds 
MrAndMisses: folds 
I The King I: folds 
Uncalled bet ($4.50) returned to cobrik23
cobrik23 collected $6.50 from pot
cobrik23: doesn't show hand 
*** SUMMARY ***
Total pot $6.50 | Rake $0 
Seat 1: I The King I folded before Flop
Seat 2: cobrik23 (button) collected ($6.50)
Seat 4: fanmtZ (small blind) folded before Flop
Seat 5: MrAndMisses (big blind) folded before Flop
Seat 7: matiko09 folded before Flop (didn't bet)
Seat 8: kift74 folded before Flop (didn't bet)
Seat 9: ardo888 folded before Flop (didn't bet)





PokerStars Hand #150752421689:  Hold'em No Limit ($0.50/$1.00 USD) - 2016/03/22 14:25:07 CET [2016/03/22 9:25:07 ET]
Table 'Arabis' 9-max Seat #4 is the button
Seat 2: ilaviiitech ($107.40 in chips) 
Seat 4: Painkiller72 ($133.10 in chips) 
Seat 5: matiko09 ($133.99 in chips) 
Seat 6: Ilov3NBA ($106.31 in chips) 
Seat 7: howsiao ($209.36 in chips) 
Seat 8: Bro_Happy ($199.24 in chips) 
Seat 9: cobrik23 ($58.65 in chips) 
matiko09: posts small blind $0.50
Ilov3NBA: posts big blind $1
*** HOLE CARDS ***
Dealt to matiko09 [Jc 5c]
howsiao: raises $2.50 to $3.50
Bro_Happy: folds 
cobrik23: folds 
ilaviiitech: folds 
Painkiller72: raises $7.50 to $11
matiko09: folds 
Ilov3NBA: folds 
howsiao: calls $7.50
*** FLOP *** [6s 4h Ks]
howsiao: bets $11.22
Painkiller72: calls $11.22
*** TURN *** [6s 4h Ks] [6d]
howsiao: bets $21.93
Painkiller72: calls $21.93
*** RIVER *** [6s 4h Ks 6d] [7c]
howsiao: checks 
Painkiller72: checks 
*** SHOW DOWN ***
howsiao: shows [Th Ac] (a pair of Sixes)
Painkiller72: shows [8c 8s] (two pair, Eights and Sixes)
Painkiller72 collected $87 from pot
*** SUMMARY ***
Total pot $89.80 | Rake $2.80 
Board [6s 4h Ks 6d 7c]
Seat 2: ilaviiitech folded before Flop (didn't bet)
Seat 4: Painkiller72 (button) showed [8c 8s] and won ($87) with two pair, Eights and Sixes
Seat 5: matiko09 (small blind) folded before Flop
Seat 6: Ilov3NBA (big blind) folded before Flop
Seat 7: howsiao showed [Th Ac] and lost with a pair of Sixes
Seat 8: Bro_Happy folded before Flop (didn't bet)
Seat 9: cobrik23 folded before Flop (didn't bet)





PokerStars Hand #150752422934:  Hold'em No Limit ($1/$2 USD) - 2016/03/22 14:25:09 CET [2016/03/22 9:25:09 ET]
Table 'Kiso II' 9-max Seat #6 is the button
Seat 3: seouljam ($366.66 in chips) 
Seat 4: N4$H ($200 in chips) 
Seat 5: Ilov3NBA ($303.84 in chips) 
Seat 6: KT90 ($333.24 in chips) 
Seat 7: Igoriah ($204.01 in chips) 
Seat 8: bananajoe001 ($189.14 in chips) 
Seat 9: matiko09 ($253.20 in chips) 
Igoriah: posts small blind $1
bananajoe001: posts big blind $2
*** HOLE CARDS ***
Dealt to matiko09 [2s 7d]
matiko09: folds 
seouljam: folds 
N4$H: folds 
Ilov3NBA: folds 
KT90: raises $2 to $4
Igoriah: folds 
bananajoe001: calls $2
*** FLOP *** [8s 5h 4c]
bananajoe001: checks 
KT90: bets $6
bananajoe001: calls $6
*** TURN *** [8s 5h 4c] [6s]
bananajoe001: checks 
KT90: checks 
*** RIVER *** [8s 5h 4c 6s] [Qc]
bananajoe001: checks 
KT90: checks 
*** SHOW DOWN ***
bananajoe001: shows [Td Kd] (high card King)
KT90: shows [6h Th] (a pair of Sixes)
KT90 collected $20.06 from pot
*** SUMMARY ***
Total pot $21 | Rake $0.94 
Board [8s 5h 4c 6s Qc]
Seat 3: seouljam folded before Flop (didn't bet)
Seat 4: N4$H folded before Flop (didn't bet)
Seat 5: Ilov3NBA folded before Flop (didn't bet)
Seat 6: KT90 (button) showed [6h Th] and won ($20.06) with a pair of Sixes
Seat 7: Igoriah (small blind) folded before Flop
Seat 8: bananajoe001 (big blind) showed [Td Kd] and lost with high card King
Seat 9: matiko09 folded before Flop (didn't bet)





PokerStars Hand #150752423323:  Hold'em No Limit ($0.50/$1.00 USD) - 2016/03/22 14:25:09 CET [2016/03/22 9:25:09 ET]
Table 'Colchis' 9-max Seat #4 is the button
Seat 1: theluckyjoe ($7.68 in chips) 
Seat 2: Ilov3NBA ($152.91 in chips) 
Seat 4: matiko09 ($100 in chips) 
Seat 7: Dantist1122 ($104 in chips) 
Seat 8: cobrik23 ($48.26 in chips) 
Seat 9: ardo888 ($108.15 in chips) 
Dantist1122: posts small blind $0.50
cobrik23: posts big blind $1
*** HOLE CARDS ***
Dealt to matiko09 [Tc Jc]
ardo888: folds 
theluckyjoe: calls $1
Ilov3NBA: folds 
matiko09: folds 
Dantist1122: folds 
cobrik23: checks 
*** FLOP *** [4c Kc Jh]
cobrik23: checks 
theluckyjoe: checks 
*** TURN *** [4c Kc Jh] [8s]
cobrik23: bets $1
theluckyjoe: calls $1
*** RIVER *** [4c Kc Jh 8s] [3h]
cobrik23: bets $2.86
theluckyjoe: folds 
Uncalled bet ($2.86) returned to cobrik23
cobrik23 collected $4.30 from pot
cobrik23: doesn't show hand 
*** SUMMARY ***
Total pot $4.50 | Rake $0.20 
Board [4c Kc Jh 8s 3h]
Seat 1: theluckyjoe folded on the River
Seat 2: Ilov3NBA folded before Flop (didn't bet)
Seat 4: matiko09 (button) folded before Flop (didn't bet)
Seat 7: Dantist1122 (small blind) folded before Flop
Seat 8: cobrik23 (big blind) collected ($4.30)
Seat 9: ardo888 folded before Flop (didn't bet)





PokerStars Hand #150752429410:  Hold'em No Limit ($0.50/$1.00 USD) - 2016/03/22 14:25:19 CET [2016/03/22 9:25:19 ET]
Table 'Stephano II' 9-max Seat #8 is the button
Seat 1: omorfadramou ($100 in chips) 
Seat 3: lombardo11 ($151.70 in chips) 
Seat 4: AWATAR 21 ($112.66 in chips) 
Seat 5: mb2part ($91.91 in chips) 
Seat 6: beterc0re ($132.59 in chips) 
Seat 7: ilaviiitech ($101.50 in chips) 
Seat 8: KingCastle77 ($78.50 in chips) 
Seat 9: matiko09 ($100 in chips) 
matiko09: posts small blind $0.50
omorfadramou: posts big blind $1
I The King I: sits out 
*** HOLE CARDS ***
Dealt to matiko09 [Ks 9d]
lombardo11: raises $1 to $2
AWATAR 21: calls $2
mb2part: folds 
beterc0re: folds 
ilaviiitech: folds 
KingCastle77: calls $2
matiko09: folds 
omorfadramou: folds 
*** FLOP *** [As 8s 2h]
lombardo11: checks 
AWATAR 21: checks 
KingCastle77: bets $3.58
lombardo11: folds 
AWATAR 21: calls $3.58
*** TURN *** [As 8s 2h] [Ac]
AWATAR 21: checks 
KingCastle77: checks 
*** RIVER *** [As 8s 2h Ac] [5h]
AWATAR 21: bets $7
KingCastle77: folds 
Uncalled bet ($7) returned to AWATAR 21
AWATAR 21 collected $14 from pot
*** SUMMARY ***
Total pot $14.66 | Rake $0.66 
Board [As 8s 2h Ac 5h]
Seat 1: omorfadramou (big blind) folded before Flop
Seat 3: lombardo11 folded on the Flop
Seat 4: AWATAR 21 collected ($14)
Seat 5: mb2part folded before Flop (didn't bet)
Seat 6: beterc0re folded before Flop (didn't bet)
Seat 7: ilaviiitech folded before Flop (didn't bet)
Seat 8: KingCastle77 (button) folded on the River
Seat 9: matiko09 (small blind) folded before Flop





PokerStars Hand #150752433777:  Hold'em No Limit ($0.50/$1.00 USD) - 2016/03/22 14:25:26 CET [2016/03/22 9:25:26 ET]
Table 'Polyxena' 9-max Seat #4 is the button
Seat 1: I The King I ($108.73 in chips) 
Seat 2: cobrik23 ($76.61 in chips) 
Seat 4: fanmtZ ($40 in chips) 
Seat 5: MrAndMisses ($49.67 in chips) 
Seat 6: Ilov3NBA ($100 in chips) 
Seat 7: matiko09 ($100 in chips) 
Seat 8: kift74 ($126.56 in chips) 
Seat 9: ardo888 ($153.08 in chips) 
MrAndMisses: posts small blind $0.50
Ilov3NBA: posts big blind $1
di0d80: sits out 
*** HOLE CARDS ***
Dealt to matiko09 [4c Td]
matiko09: folds 
kift74: folds 
ardo888: folds 
I The King I: folds 
cobrik23: folds 
fanmtZ: folds 
MrAndMisses: calls $0.50
Ilov3NBA: checks 
*** FLOP *** [3h Jc Kh]
MrAndMisses: checks 
Ilov3NBA: checks 
*** TURN *** [3h Jc Kh] [6h]
MrAndMisses: checks 
Ilov3NBA: checks 
*** RIVER *** [3h Jc Kh 6h] [Kc]
MrAndMisses: checks 
Ilov3NBA: checks 
*** SHOW DOWN ***
MrAndMisses: shows [5c 7c] (a pair of Kings)
Ilov3NBA: shows [3d 9s] (two pair, Kings and Threes)
Ilov3NBA collected $1.91 from pot
*** SUMMARY ***
Total pot $2 | Rake $0.09 
Board [3h Jc Kh 6h Kc]
Seat 1: I The King I folded before Flop (didn't bet)
Seat 2: cobrik23 folded before Flop (didn't bet)
Seat 4: fanmtZ (button) folded before Flop (didn't bet)
Seat 5: MrAndMisses (small blind) showed [5c 7c] and lost with a pair of Kings
Seat 6: Ilov3NBA (big blind) showed [3d 9s] and won ($1.91) with two pair, Kings and Threes
Seat 7: matiko09 folded before Flop (didn't bet)
Seat 8: kift74 folded before Flop (didn't bet)
Seat 9: ardo888 folded before Flop (didn't bet)





PokerStars Hand #150752438352:  Hold'em No Limit ($0.50/$1.00 USD) - 2016/03/22 14:25:34 CET [2016/03/22 9:25:34 ET]
Table 'Miranda' 9-max Seat #4 is the button
Seat 1: cobrik23 ($97.94 in chips) 
Seat 2: Szevasztopol ($108.94 in chips) 
Seat 3: Muinmyheart ($100 in chips) 
Seat 4: bilukm ($39.40 in chips) 
Seat 6: matiko09 ($102.90 in chips) 
Seat 7: RICKA16 ($100 in chips) 
Seat 8: hammerwife ($102.87 in chips) 
Seat 9: ardo888 ($185.53 in chips) 
matiko09: posts small blind $0.50
RICKA16: posts big blind $1
*** HOLE CARDS ***
Dealt to matiko09 [Qs Jc]
hammerwife: folds 
ardo888: folds 
cobrik23: folds 
Szevasztopol: folds 
Muinmyheart: folds 
bilukm: folds 
matiko09: raises $1.50 to $2.50
RICKA16: folds 
Uncalled bet ($1.50) returned to matiko09
matiko09 collected $2 from pot
matiko09: doesn't show hand 
*** SUMMARY ***
Total pot $2 | Rake $0 
Seat 1: cobrik23 folded before Flop (didn't bet)
Seat 2: Szevasztopol folded before Flop (didn't bet)
Seat 3: Muinmyheart folded before Flop (didn't bet)
Seat 4: bilukm (button) folded before Flop (didn't bet)
Seat 6: matiko09 (small blind) collected ($2)
Seat 7: RICKA16 (big blind) folded before Flop
Seat 8: hammerwife folded before Flop (didn't bet)
Seat 9: ardo888 folded before Flop (didn't bet)





PokerStars Hand #150752441910:  Hold'em No Limit ($0.50/$1.00 USD) - 2016/03/22 14:25:40 CET [2016/03/22 9:25:40 ET]
Table 'Harding' 9-max Seat #7 is the button
Seat 1: matiko09 ($121.66 in chips) 
Seat 2: RICKA16 ($100 in chips) 
Seat 4: lixiangli ($153.34 in chips) 
Seat 5: DevilisHEyz ($143.28 in chips) 
Seat 6: Ilov3NBA ($100 in chips) 
Seat 7: mrhighryza ($118.73 in chips) 
Seat 9: omorfadramou ($100 in chips) 
di0d80 will be allowed to play after the button
omorfadramou: posts small blind $0.50
matiko09: posts big blind $1
*** HOLE CARDS ***
Dealt to matiko09 [4d 3c]
RICKA16: raises $2 to $3
lixiangli: folds 
DevilisHEyz: calls $3
Ilov3NBA: folds 
mrhighryza: folds 
omorfadramou: folds 
matiko09: folds 
*** FLOP *** [6d Qs 8c]
RICKA16: bets $5
DevilisHEyz: folds 
Uncalled bet ($5) returned to RICKA16
RICKA16 collected $7.16 from pot
RICKA16: doesn't show hand 
*** SUMMARY ***
Total pot $7.50 | Rake $0.34 
Board [6d Qs 8c]
Seat 1: matiko09 (big blind) folded before Flop
Seat 2: RICKA16 collected ($7.16)
Seat 4: lixiangli folded before Flop (didn't bet)
Seat 5: DevilisHEyz folded on the Flop
Seat 6: Ilov3NBA folded before Flop (didn't bet)
Seat 7: mrhighryza (button) folded before Flop (didn't bet)
Seat 9: omorfadramou (small blind) folded before Flop





PokerStars Hand #150752443986:  Hold'em No Limit ($0.50/$1.00 USD) - 2016/03/22 14:25:43 CET [2016/03/22 9:25:43 ET]
Table 'Crater II' 9-max Seat #2 is the button
Seat 1: matiko09 ($126.27 in chips) 
Seat 2: Eisbaerli85 ($122.25 in chips) 
Seat 3: hammerwife ($100 in chips) 
Seat 4: fanmtZ ($40 in chips) 
Seat 6: Kobiroga150 ($53.32 in chips) 
Seat 7: AWATAR 21 ($69.98 in chips) 
Seat 8: KronosAK ($111.28 in chips) 
Seat 9: I The King I ($114.20 in chips) 
hammerwife: posts small blind $0.50
fanmtZ: posts big blind $1
*** HOLE CARDS ***
Dealt to matiko09 [8s Kc]
Kobiroga150: folds 
AWATAR 21: folds 
KronosAK: folds 
I The King I: raises $2 to $3
matiko09: folds 
Eisbaerli85: folds 
hammerwife: folds 
fanmtZ: folds 
Uncalled bet ($2) returned to I The King I
I The King I collected $2.50 from pot
I The King I: doesn't show hand 
*** SUMMARY ***
Total pot $2.50 | Rake $0 
Seat 1: matiko09 folded before Flop (didn't bet)
Seat 2: Eisbaerli85 (button) folded before Flop (didn't bet)
Seat 3: hammerwife (small blind) folded before Flop
Seat 4: fanmtZ (big blind) folded before Flop
Seat 6: Kobiroga150 folded before Flop (didn't bet)
Seat 7: AWATAR 21 folded before Flop (didn't bet)
Seat 8: KronosAK folded before Flop (didn't bet)
Seat 9: I The King I collected ($2.50)





PokerStars Hand #150752452232:  Hold'em No Limit ($0.50/$1.00 USD) - 2016/03/22 14:25:56 CET [2016/03/22 9:25:56 ET]
Table 'Colchis' 9-max Seat #7 is the button
Seat 1: theluckyjoe ($5.68 in chips) 
Seat 2: Ilov3NBA ($152.91 in chips) 
Seat 4: matiko09 ($100 in chips) 
Seat 7: Dantist1122 ($103.50 in chips) 
Seat 8: cobrik23 ($50.56 in chips) 
Seat 9: ardo888 ($108.15 in chips) 
cobrik23: posts small blind $0.50
ardo888: posts big blind $1
*** HOLE CARDS ***
Dealt to matiko09 [8s 4c]
theluckyjoe: folds 
Ilov3NBA: raises $2 to $3
matiko09: folds 
Dantist1122: folds 
cobrik23: folds 
ardo888: folds 
Uncalled bet ($2) returned to Ilov3NBA
Ilov3NBA collected $2.50 from pot
Ilov3NBA: doesn't show hand 
*** SUMMARY ***
Total pot $2.50 | Rake $0 
Seat 1: theluckyjoe folded before Flop (didn't bet)
Seat 2: Ilov3NBA collected ($2.50)
Seat 4: matiko09 folded before Flop (didn't bet)
Seat 7: Dantist1122 (button) folded before Flop (didn't bet)
Seat 8: cobrik23 (small blind) folded before Flop
Seat 9: ardo888 (big blind) folded before Flop





PokerStars Hand #150752453228:  Hold'em No Limit ($1/$2 USD) - 2016/03/22 14:25:58 CET [2016/03/22 9:25:58 ET]
Table 'Kiso II' 9-max Seat #7 is the button
Seat 3: seouljam ($366.66 in chips) 
Seat 4: N4$H ($200 in chips) 
Seat 5: Ilov3NBA ($303.84 in chips) 
Seat 6: KT90 ($343.30 in chips) 
Seat 7: Igoriah ($203.01 in chips) 
Seat 8: bananajoe001 ($179.14 in chips) 
Seat 9: matiko09 ($253.20 in chips) 
bananajoe001: posts small blind $1
matiko09: posts big blind $2
di0d80: sits out 
*** HOLE CARDS ***
Dealt to matiko09 [9h 5d]
seouljam: folds 
N4$H: folds 
Ilov3NBA: folds 
KT90: folds 
Igoriah: folds 
bananajoe001: calls $1
matiko09: checks 
*** FLOP *** [5h Ks Ah]
bananajoe001: checks 
matiko09: checks 
*** TURN *** [5h Ks Ah] [3s]
bananajoe001: checks 
matiko09: checks 
*** RIVER *** [5h Ks Ah 3s] [9s]
bananajoe001: checks 
matiko09: bets $4
bananajoe001: folds 
Uncalled bet ($4) returned to matiko09
matiko09 collected $3.82 from pot
matiko09: doesn't show hand 
*** SUMMARY ***
Total pot $4 | Rake $0.18 
Board [5h Ks Ah 3s 9s]
Seat 3: seouljam folded before Flop (didn't bet)
Seat 4: N4$H folded before Flop (didn't bet)
Seat 5: Ilov3NBA folded before Flop (didn't bet)
Seat 6: KT90 folded before Flop (didn't bet)
Seat 7: Igoriah (button) folded before Flop (didn't bet)
Seat 8: bananajoe001 (small blind) folded on the River
Seat 9: matiko09 (big blind) collected ($3.82)





PokerStars Hand #150752454839:  Hold'em No Limit ($0.50/$1.00 USD) - 2016/03/22 14:26:01 CET [2016/03/22 9:26:01 ET]
Table 'Miranda' 9-max Seat #6 is the button
Seat 1: cobrik23 ($97.94 in chips) 
Seat 2: Szevasztopol ($108.94 in chips) 
Seat 3: Muinmyheart ($100 in chips) 
Seat 4: bilukm ($39.40 in chips) 
Seat 6: matiko09 ($103.90 in chips) 
Seat 7: RICKA16 ($99 in chips) 
Seat 8: hammerwife ($102.87 in chips) 
Seat 9: ardo888 ($185.53 in chips) 
RICKA16: posts small blind $0.50
hammerwife: posts big blind $1
*** HOLE CARDS ***
Dealt to matiko09 [Kc Js]
ardo888: folds 
cobrik23: folds 
Szevasztopol: raises $2 to $3
Muinmyheart: folds 
bilukm: calls $3
matiko09: folds 
RICKA16: folds 
hammerwife: calls $2
*** FLOP *** [7s 3s 5s]
hammerwife: checks 
Szevasztopol: checks 
bilukm: checks 
*** TURN *** [7s 3s 5s] [Kd]
hammerwife: checks 
Szevasztopol: bets $5
bilukm: folds 
hammerwife: folds 
Uncalled bet ($5) returned to Szevasztopol
Szevasztopol collected $9.07 from pot
Szevasztopol: doesn't show hand 
*** SUMMARY ***
Total pot $9.50 | Rake $0.43 
Board [7s 3s 5s Kd]
Seat 1: cobrik23 folded before Flop (didn't bet)
Seat 2: Szevasztopol collected ($9.07)
Seat 3: Muinmyheart folded before Flop (didn't bet)
Seat 4: bilukm folded on the Turn
Seat 6: matiko09 (button) folded before Flop (didn't bet)
Seat 7: RICKA16 (small blind) folded before Flop
Seat 8: hammerwife (big blind) folded on the Turn
Seat 9: ardo888 folded before Flop (didn't bet)





PokerStars Hand #150752458820:  Hold'em No Limit ($0.50/$1.00 USD) - 2016/03/22 14:26:07 CET [2016/03/22 9:26:07 ET]
Table 'Crater II' 9-max Seat #3 is the button
Seat 1: matiko09 ($126.27 in chips) 
Seat 2: Eisbaerli85 ($122.25 in chips) 
Seat 3: hammerwife ($100 in chips) 
Seat 4: fanmtZ ($40 in chips) 
Seat 6: Kobiroga150 ($53.32 in chips) 
Seat 7: AWATAR 21 ($69.98 in chips) 
Seat 8: KronosAK ($111.28 in chips) 
Seat 9: I The King I ($115.70 in chips) 
fanmtZ: posts small blind $0.50
Kobiroga150: posts big blind $1
*** HOLE CARDS ***
Dealt to matiko09 [6c 3h]
AWATAR 21: folds 
KronosAK: folds 
I The King I: folds 
matiko09: folds 
Eisbaerli85: folds 
hammerwife: folds 
fanmtZ: raises $1.58 to $2.58
Kobiroga150: folds 
Uncalled bet ($1.58) returned to fanmtZ
fanmtZ collected $2 from pot
fanmtZ: doesn't show hand 
*** SUMMARY ***
Total pot $2 | Rake $0 
Seat 1: matiko09 folded before Flop (didn't bet)
Seat 2: Eisbaerli85 folded before Flop (didn't bet)
Seat 3: hammerwife (button) folded before Flop (didn't bet)
Seat 4: fanmtZ (small blind) collected ($2)
Seat 6: Kobiroga150 (big blind) folded before Flop
Seat 7: AWATAR 21 folded before Flop (didn't bet)
Seat 8: KronosAK folded before Flop (didn't bet)
Seat 9: I The King I folded before Flop (didn't bet)





PokerStars Hand #150752460148:  Hold'em No Limit ($0.50/$1.00 USD) - 2016/03/22 14:26:09 CET [2016/03/22 9:26:09 ET]
Table 'Taygeta II' 9-max Seat #4 is the button
Seat 1: DevilisHEyz ($64.78 in chips) 
Seat 2: khan Erkesh ($184.06 in chips) 
Seat 3: Muinmyheart ($107.80 in chips) 
Seat 4: matiko09 ($100 in chips) 
Seat 5: RICKA16 ($99 in chips) 
Seat 6: I The King I ($136.91 in chips) 
Seat 7: Szevasztopol ($103.68 in chips) 
Seat 9: cobrik23 ($52.40 in chips) 
RICKA16: posts small blind $0.50
I The King I: posts big blind $1
*** HOLE CARDS ***
Dealt to matiko09 [2h 2s]
Szevasztopol: folds 
cobrik23: folds 
DevilisHEyz: folds 
khan Erkesh: folds 
Muinmyheart: folds 
matiko09: raises $1.27 to $2.27
RICKA16: raises $7.73 to $10
I The King I: folds 
matiko09: folds 
Uncalled bet ($7.73) returned to RICKA16
RICKA16 collected $5.54 from pot
RICKA16: doesn't show hand 
*** SUMMARY ***
Total pot $5.54 | Rake $0 
Seat 1: DevilisHEyz folded before Flop (didn't bet)
Seat 2: khan Erkesh folded before Flop (didn't bet)
Seat 3: Muinmyheart folded before Flop (didn't bet)
Seat 4: matiko09 (button) folded before Flop
Seat 5: RICKA16 (small blind) collected ($5.54)
Seat 6: I The King I (big blind) folded before Flop
Seat 7: Szevasztopol folded before Flop (didn't bet)
Seat 9: cobrik23 folded before Flop (didn't bet)





PokerStars Hand #150752461975:  Hold'em No Limit ($0.50/$1.00 USD) - 2016/03/22 14:26:12 CET [2016/03/22 9:26:12 ET]
Table 'Arabis' 9-max Seat #5 is the button
Seat 2: ilaviiitech ($107.40 in chips) 
Seat 4: Painkiller72 ($175.95 in chips) 
Seat 5: matiko09 ($133.49 in chips) 
Seat 6: Ilov3NBA ($105.31 in chips) 
Seat 7: howsiao ($165.21 in chips) 
Seat 8: Bro_Happy ($199.24 in chips) 
Seat 9: cobrik23 ($58.65 in chips) 
Ilov3NBA: posts small blind $0.50
howsiao: posts big blind $1
di0d80: sits out 
*** HOLE CARDS ***
Dealt to matiko09 [8c 6c]
Bro_Happy: folds 
cobrik23: raises $2 to $3
ilaviiitech: folds 
Painkiller72: folds 
matiko09: folds 
Ilov3NBA: folds 
howsiao: folds 
Uncalled bet ($2) returned to cobrik23
cobrik23 collected $2.50 from pot
cobrik23: doesn't show hand 
*** SUMMARY ***
Total pot $2.50 | Rake $0 
Seat 2: ilaviiitech folded before Flop (didn't bet)
Seat 4: Painkiller72 folded before Flop (didn't bet)
Seat 5: matiko09 (button) folded before Flop (didn't bet)
Seat 6: Ilov3NBA (small blind) folded before Flop
Seat 7: howsiao (big blind) folded before Flop
Seat 8: Bro_Happy folded before Flop (didn't bet)
Seat 9: cobrik23 collected ($2.50)





PokerStars Hand #150752472425:  Hold'em No Limit ($0.50/$1.00 USD) - 2016/03/22 14:26:29 CET [2016/03/22 9:26:29 ET]
Table 'Polyxena' 9-max Seat #5 is the button
Seat 1: I The King I ($108.73 in chips) 
Seat 2: cobrik23 ($76.61 in chips) 
Seat 4: fanmtZ ($40 in chips) 
Seat 5: MrAndMisses ($48.67 in chips) 
Seat 6: Ilov3NBA ($100.91 in chips) 
Seat 7: matiko09 ($100 in chips) 
Seat 8: kift74 ($126.56 in chips) 
Seat 9: ardo888 ($153.08 in chips) 
Ilov3NBA: posts small blind $0.50
matiko09: posts big blind $1
di0d80: sits out 
*** HOLE CARDS ***
Dealt to matiko09 [2d 6s]
kift74: folds 
ardo888: folds 
I The King I: folds 
cobrik23: raises $2 to $3
fanmtZ: folds 
MrAndMisses: folds 
Ilov3NBA: folds 
matiko09: folds 
Uncalled bet ($2) returned to cobrik23
cobrik23 collected $2.50 from pot
cobrik23: doesn't show hand 
*** SUMMARY ***
Total pot $2.50 | Rake $0 
Seat 1: I The King I folded before Flop (didn't bet)
Seat 2: cobrik23 collected ($2.50)
Seat 4: fanmtZ folded before Flop (didn't bet)
Seat 5: MrAndMisses (button) folded before Flop (didn't bet)
Seat 6: Ilov3NBA (small blind) folded before Flop
Seat 7: matiko09 (big blind) folded before Flop
Seat 8: kift74 folded before Flop (didn't bet)
Seat 9: ardo888 folded before Flop (didn't bet)





PokerStars Hand #150752473905:  Hold'em No Limit ($0.50/$1.00 USD) - 2016/03/22 14:26:32 CET [2016/03/22 9:26:32 ET]
Table 'Harding' 9-max Seat #9 is the button
Seat 1: matiko09 ($120.66 in chips) 
Seat 2: RICKA16 ($104.16 in chips) 
Seat 4: lixiangli ($153.34 in chips) 
Seat 5: DevilisHEyz ($140.28 in chips) 
Seat 6: Ilov3NBA ($100 in chips) 
Seat 7: mrhighryza ($118.73 in chips) 
Seat 9: omorfadramou ($100 in chips) 
matiko09: posts small blind $0.50
RICKA16: posts big blind $1
di0d80: sits out 
*** HOLE CARDS ***
Dealt to matiko09 [2s 3h]
lixiangli: folds 
DevilisHEyz: folds 
Ilov3NBA: folds 
mrhighryza: calls $1
omorfadramou: raises $3 to $4
matiko09: folds 
RICKA16: folds 
mrhighryza has timed out
mrhighryza: folds 
Uncalled bet ($3) returned to omorfadramou
omorfadramou collected $3.50 from pot
omorfadramou: doesn't show hand 
*** SUMMARY ***
Total pot $3.50 | Rake $0 
Seat 1: matiko09 (small blind) folded before Flop
Seat 2: RICKA16 (big blind) folded before Flop
Seat 4: lixiangli folded before Flop (didn't bet)
Seat 5: DevilisHEyz folded before Flop (didn't bet)
Seat 6: Ilov3NBA folded before Flop (didn't bet)
Seat 7: mrhighryza folded before Flop
Seat 9: omorfadramou (button) collected ($3.50)





PokerStars Hand #150752476189:  Hold'em No Limit ($0.50/$1.00 USD) - 2016/03/22 14:26:35 CET [2016/03/22 9:26:35 ET]
Table 'Colchis' 9-max Seat #8 is the button
Seat 1: theluckyjoe ($5.68 in chips) 
Seat 2: Ilov3NBA ($154.41 in chips) 
Seat 4: matiko09 ($100 in chips) 
Seat 7: Dantist1122 ($103.50 in chips) 
Seat 8: cobrik23 ($50.06 in chips) 
Seat 9: ardo888 ($107.15 in chips) 
ardo888: posts small blind $0.50
theluckyjoe: posts big blind $1
*** HOLE CARDS ***
Dealt to matiko09 [5d 4s]
Ilov3NBA: folds 
matiko09: folds 
Dantist1122: folds 
cobrik23: folds 
ardo888: raises $2 to $3
theluckyjoe: raises $2.68 to $5.68 and is all-in
ardo888: calls $2.68
*** FLOP *** [Th 8h 6d]
*** TURN *** [Th 8h 6d] [Qd]
*** RIVER *** [Th 8h 6d Qd] [5s]
*** SHOW DOWN ***
ardo888: shows [Qc Ah] (a pair of Queens)
theluckyjoe: shows [Qh 5h] (two pair, Queens and Fives)
theluckyjoe collected $10.85 from pot
*** SUMMARY ***
Total pot $11.36 | Rake $0.51 
Board [Th 8h 6d Qd 5s]
Seat 1: theluckyjoe (big blind) showed [Qh 5h] and won ($10.85) with two pair, Queens and Fives
Seat 2: Ilov3NBA folded before Flop (didn't bet)
Seat 4: matiko09 folded before Flop (didn't bet)
Seat 7: Dantist1122 folded before Flop (didn't bet)
Seat 8: cobrik23 (button) folded before Flop (didn't bet)
Seat 9: ardo888 (small blind) showed [Qc Ah] and lost with a pair of Queens





PokerStars Hand #150752475809:  Hold'em No Limit ($0.50/$1.00 USD) - 2016/03/22 14:26:35 CET [2016/03/22 9:26:35 ET]
Table 'Crater II' 9-max Seat #4 is the button
Seat 1: matiko09 ($126.27 in chips) 
Seat 2: Eisbaerli85 ($122.25 in chips) 
Seat 3: hammerwife ($100 in chips) 
Seat 4: fanmtZ ($41 in chips) 
Seat 6: Kobiroga150 ($52.32 in chips) 
Seat 7: AWATAR 21 ($69.98 in chips) 
Seat 8: KronosAK ($111.28 in chips) 
Seat 9: I The King I ($115.70 in chips) 
Kobiroga150: posts small blind $0.50
AWATAR 21: posts big blind $1
*** HOLE CARDS ***
Dealt to matiko09 [2h Kc]
KronosAK: folds 
I The King I: folds 
matiko09: folds 
Eisbaerli85: raises $2 to $3
hammerwife: folds 
fanmtZ: folds 
Kobiroga150: folds 
AWATAR 21: folds 
Uncalled bet ($2) returned to Eisbaerli85
Eisbaerli85 collected $2.50 from pot
*** SUMMARY ***
Total pot $2.50 | Rake $0 
Seat 1: matiko09 folded before Flop (didn't bet)
Seat 2: Eisbaerli85 collected ($2.50)
Seat 3: hammerwife folded before Flop (didn't bet)
Seat 4: fanmtZ (button) folded before Flop (didn't bet)
Seat 6: Kobiroga150 (small blind) folded before Flop
Seat 7: AWATAR 21 (big blind) folded before Flop
Seat 8: KronosAK folded before Flop (didn't bet)
Seat 9: I The King I folded before Flop (didn't bet)





PokerStars Hand #150752479064:  Hold'em No Limit ($0.50/$1.00 USD) - 2016/03/22 14:26:40 CET [2016/03/22 9:26:40 ET]
Table 'Arabis' 9-max Seat #6 is the button
Seat 2: ilaviiitech ($107.40 in chips) 
Seat 4: Painkiller72 ($175.95 in chips) 
Seat 5: matiko09 ($133.49 in chips) 
Seat 6: Ilov3NBA ($104.81 in chips) 
Seat 7: howsiao ($164.21 in chips) 
Seat 8: Bro_Happy ($199.24 in chips) 
Seat 9: cobrik23 ($60.15 in chips) 
howsiao: posts small blind $0.50
Bro_Happy: posts big blind $1
di0d80: sits out 
*** HOLE CARDS ***
Dealt to matiko09 [Js 2d]
cobrik23: raises $2 to $3
ilaviiitech: folds 
Painkiller72: folds 
matiko09: folds 
Ilov3NBA: folds 
howsiao: folds 
Bro_Happy: folds 
Uncalled bet ($2) returned to cobrik23
cobrik23 collected $2.50 from pot
cobrik23: doesn't show hand 
*** SUMMARY ***
Total pot $2.50 | Rake $0 
Seat 2: ilaviiitech folded before Flop (didn't bet)
Seat 4: Painkiller72 folded before Flop (didn't bet)
Seat 5: matiko09 folded before Flop (didn't bet)
Seat 6: Ilov3NBA (button) folded before Flop (didn't bet)
Seat 7: howsiao (small blind) folded before Flop
Seat 8: Bro_Happy (big blind) folded before Flop
Seat 9: cobrik23 collected ($2.50)





PokerStars Hand #150752486077:  Hold'em No Limit ($0.50/$1.00 USD) - 2016/03/22 14:26:51 CET [2016/03/22 9:26:51 ET]
Table 'Taygeta II' 9-max Seat #5 is the button
Seat 1: DevilisHEyz ($64.78 in chips) 
Seat 2: khan Erkesh ($184.06 in chips) 
Seat 3: Muinmyheart ($107.80 in chips) 
Seat 4: matiko09 ($100 in chips) 
Seat 5: RICKA16 ($102.27 in chips) 
Seat 6: I The King I ($135.91 in chips) 
Seat 7: Szevasztopol ($103.68 in chips) 
Seat 9: cobrik23 ($52.40 in chips) 
I The King I: posts small blind $0.50
Szevasztopol: posts big blind $1
*** HOLE CARDS ***
Dealt to matiko09 [6h 2d]
cobrik23: raises $1 to $2
DevilisHEyz: calls $2
khan Erkesh: folds 
Muinmyheart: folds 
matiko09: folds 
RICKA16: folds 
I The King I: folds 
Szevasztopol: folds 
*** FLOP *** [4c Qh 4h]
cobrik23: checks 
DevilisHEyz: bets $3.93
cobrik23: folds 
Uncalled bet ($3.93) returned to DevilisHEyz
DevilisHEyz collected $5.25 from pot
*** SUMMARY ***
Total pot $5.50 | Rake $0.25 
Board [4c Qh 4h]
Seat 1: DevilisHEyz collected ($5.25)
Seat 2: khan Erkesh folded before Flop (didn't bet)
Seat 3: Muinmyheart folded before Flop (didn't bet)
Seat 4: matiko09 folded before Flop (didn't bet)
Seat 5: RICKA16 (button) folded before Flop (didn't bet)
Seat 6: I The King I (small blind) folded before Flop
Seat 7: Szevasztopol (big blind) folded before Flop
Seat 9: cobrik23 folded on the Flop





PokerStars Hand #150752489327:  Hold'em No Limit ($1/$2 USD) - 2016/03/22 14:26:56 CET [2016/03/22 9:26:56 ET]
Table 'Kiso II' 9-max Seat #8 is the button
Seat 2: di0d80 ($456.13 in chips) 
Seat 3: seouljam ($366.66 in chips) 
Seat 4: N4$H ($200 in chips) 
Seat 5: Ilov3NBA ($303.84 in chips) 
Seat 6: KT90 ($343.30 in chips) 
Seat 7: Igoriah ($203.01 in chips) 
Seat 8: bananajoe001 ($177.14 in chips) 
Seat 9: matiko09 ($255.02 in chips) 
matiko09: posts small blind $1
di0d80: posts big blind $2
*** HOLE CARDS ***
Dealt to matiko09 [Qh 3h]
seouljam: folds 
N4$H: folds 
Ilov3NBA: raises $4 to $6
KT90: folds 
Igoriah: folds 
bananajoe001: folds 
matiko09: folds 
di0d80: folds 
Uncalled bet ($4) returned to Ilov3NBA
Ilov3NBA collected $5 from pot
Ilov3NBA: doesn't show hand 
*** SUMMARY ***
Total pot $5 | Rake $0 
Seat 2: di0d80 (big blind) folded before Flop
Seat 3: seouljam folded before Flop (didn't bet)
Seat 4: N4$H folded before Flop (didn't bet)
Seat 5: Ilov3NBA collected ($5)
Seat 6: KT90 folded before Flop (didn't bet)
Seat 7: Igoriah folded before Flop (didn't bet)
Seat 8: bananajoe001 (button) folded before Flop (didn't bet)
Seat 9: matiko09 (small blind) folded before Flop





PokerStars Hand #150752494096:  Hold'em No Limit ($0.50/$1.00 USD) - 2016/03/22 14:27:04 CET [2016/03/22 9:27:04 ET]
Table 'Colchis' 9-max Seat #9 is the button
Seat 1: theluckyjoe ($10.85 in chips) 
Seat 2: Ilov3NBA ($154.41 in chips) 
Seat 4: matiko09 ($100 in chips) 
Seat 7: Dantist1122 ($103.50 in chips) 
Seat 8: cobrik23 ($50.06 in chips) 
Seat 9: ardo888 ($101.47 in chips) 
theluckyjoe: posts small blind $0.50
Ilov3NBA: posts big blind $1
*** HOLE CARDS ***
Dealt to matiko09 [Kh Qc]
matiko09: raises $2 to $3
Dantist1122: folds 
cobrik23: folds 
ardo888: folds 
theluckyjoe: folds 
Ilov3NBA: folds 
Uncalled bet ($2) returned to matiko09
matiko09 collected $2.50 from pot
matiko09: doesn't show hand 
*** SUMMARY ***
Total pot $2.50 | Rake $0 
Seat 1: theluckyjoe (small blind) folded before Flop
Seat 2: Ilov3NBA (big blind) folded before Flop
Seat 4: matiko09 collected ($2.50)
Seat 7: Dantist1122 folded before Flop (didn't bet)
Seat 8: cobrik23 folded before Flop (didn't bet)
Seat 9: ardo888 (button) folded before Flop (didn't bet)





PokerStars Hand #150752496806:  Hold'em No Limit ($0.50/$1.00 USD) - 2016/03/22 14:27:08 CET [2016/03/22 9:27:08 ET]
Table 'Polyxena' 9-max Seat #6 is the button
Seat 1: I The King I ($108.73 in chips) 
Seat 2: cobrik23 ($78.11 in chips) 
Seat 4: fanmtZ ($40 in chips) 
Seat 5: MrAndMisses ($48.67 in chips) 
Seat 6: Ilov3NBA ($100.41 in chips) 
Seat 7: matiko09 ($100 in chips) 
Seat 8: kift74 ($126.56 in chips) 
Seat 9: ardo888 ($153.08 in chips) 
matiko09: posts small blind $0.50
kift74: posts big blind $1
di0d80: sits out 
*** HOLE CARDS ***
Dealt to matiko09 [5s Kd]
ardo888: folds 
I The King I: raises $2 to $3
cobrik23: raises $5 to $8
fanmtZ: folds 
MrAndMisses: folds 
Ilov3NBA: folds 
matiko09: folds 
kift74: folds 
I The King I: folds 
Uncalled bet ($5) returned to cobrik23
cobrik23 collected $7.50 from pot
cobrik23: doesn't show hand 
*** SUMMARY ***
Total pot $7.50 | Rake $0 
Seat 1: I The King I folded before Flop
Seat 2: cobrik23 collected ($7.50)
Seat 4: fanmtZ folded before Flop (didn't bet)
Seat 5: MrAndMisses folded before Flop (didn't bet)
Seat 6: Ilov3NBA (button) folded before Flop (didn't bet)
Seat 7: matiko09 (small blind) folded before Flop
Seat 8: kift74 (big blind) folded before Flop
Seat 9: ardo888 folded before Flop (didn't bet)





PokerStars Hand #150752500383:  Hold'em No Limit ($0.50/$1.00 USD) - 2016/03/22 14:27:14 CET [2016/03/22 9:27:14 ET]
Table 'Arabis' 9-max Seat #7 is the button
Seat 2: ilaviiitech ($107.40 in chips) 
Seat 4: Painkiller72 ($175.95 in chips) 
Seat 5: matiko09 ($133.49 in chips) 
Seat 6: Ilov3NBA ($104.81 in chips) 
Seat 7: howsiao ($163.71 in chips) 
Seat 8: Bro_Happy ($198.24 in chips) 
Seat 9: cobrik23 ($61.65 in chips) 
Bro_Happy: posts small blind $0.50
cobrik23: posts big blind $1
di0d80: sits out 
*** HOLE CARDS ***
Dealt to matiko09 [Qc Ks]
ilaviiitech: folds 
Painkiller72: folds 
matiko09: raises $2 to $3
Ilov3NBA: raises $5.50 to $8.50
howsiao: folds 
Bro_Happy: folds 
cobrik23: raises $11.50 to $20
matiko09: folds 
Ilov3NBA: folds 
Uncalled bet ($11.50) returned to cobrik23
cobrik23 collected $20.50 from pot
cobrik23: doesn't show hand 
*** SUMMARY ***
Total pot $20.50 | Rake $0 
Seat 2: ilaviiitech folded before Flop (didn't bet)
Seat 4: Painkiller72 folded before Flop (didn't bet)
Seat 5: matiko09 folded before Flop
Seat 6: Ilov3NBA folded before Flop
Seat 7: howsiao (button) folded before Flop (didn't bet)
Seat 8: Bro_Happy (small blind) folded before Flop
Seat 9: cobrik23 (big blind) collected ($20.50)





PokerStars Hand #150752501205:  Hold'em No Limit ($1/$2 USD) - 2016/03/22 14:27:16 CET [2016/03/22 9:27:16 ET]
Table 'Deipylos' 9-max Seat #4 is the button
Seat 1: playggsolty ($155.96 in chips) 
Seat 2: N4$H ($200 in chips) 
Seat 3: KT90 ($200 in chips) 
Seat 4: Igoriah ($200 in chips) 
Seat 5: IntsAA ($192 in chips) 
Seat 6: di0d80 ($200 in chips) 
Seat 7: matiko09 ($200 in chips) 
Seat 8: luckbox6666 ($200 in chips) 
Seat 9: nickreason17 ($200 in chips) 
IntsAA: posts small blind $1
di0d80: posts big blind $2
*** HOLE CARDS ***
Dealt to matiko09 [4h 7c]
matiko09: folds 
luckbox6666: folds 
nickreason17: folds 
playggsolty: folds 
playggsolty leaves the table
Ravnica11 joins the table at seat #1 
N4$H: folds 
KT90: folds 
Igoriah: folds 
IntsAA: calls $1
di0d80: raises $6 to $8
Ravnica11 leaves the table
DUkalisUA joins the table at seat #1 
IntsAA: folds 
Uncalled bet ($6) returned to di0d80
di0d80 collected $4 from pot
di0d80: doesn't show hand 
*** SUMMARY ***
Total pot $4 | Rake $0 
Seat 1: playggsolty folded before Flop (didn't bet)
Seat 2: N4$H folded before Flop (didn't bet)
Seat 3: KT90 folded before Flop (didn't bet)
Seat 4: Igoriah (button) folded before Flop (didn't bet)
Seat 5: IntsAA (small blind) folded before Flop
Seat 6: di0d80 (big blind) collected ($4)
Seat 7: matiko09 folded before Flop (didn't bet)
Seat 8: luckbox6666 folded before Flop (didn't bet)
Seat 9: nickreason17 folded before Flop (didn't bet)





PokerStars Hand #150752502704:  Hold'em No Limit ($0.50/$1.00 USD) - 2016/03/22 14:27:18 CET [2016/03/22 9:27:18 ET]
Table 'Crater II' 9-max Seat #6 is the button
Seat 1: matiko09 ($126.27 in chips) 
Seat 2: Eisbaerli85 ($123.75 in chips) 
Seat 3: hammerwife ($100 in chips) 
Seat 4: fanmtZ ($41 in chips) 
Seat 6: Kobiroga150 ($51.82 in chips) 
Seat 7: AWATAR 21 ($68.98 in chips) 
Seat 8: KronosAK ($111.28 in chips) 
Seat 9: I The King I ($115.70 in chips) 
AWATAR 21: posts small blind $0.50
KronosAK: posts big blind $1
*** HOLE CARDS ***
Dealt to matiko09 [Qc 9h]
I The King I: raises $2 to $3
matiko09: folds 
Eisbaerli85: folds 
hammerwife: folds 
fanmtZ: folds 
Kobiroga150: calls $3
AWATAR 21: folds 
KronosAK: folds 
*** FLOP *** [2s 8h 9s]
I The King I: bets $5
Kobiroga150: calls $5
*** TURN *** [2s 8h 9s] [8s]
I The King I: bets $10
Kobiroga150: folds 
Uncalled bet ($10) returned to I The King I
I The King I collected $16.71 from pot
I The King I: doesn't show hand 
*** SUMMARY ***
Total pot $17.50 | Rake $0.79 
Board [2s 8h 9s 8s]
Seat 1: matiko09 folded before Flop (didn't bet)
Seat 2: Eisbaerli85 folded before Flop (didn't bet)
Seat 3: hammerwife folded before Flop (didn't bet)
Seat 4: fanmtZ folded before Flop (didn't bet)
Seat 6: Kobiroga150 (button) folded on the Turn
Seat 7: AWATAR 21 (small blind) folded before Flop
Seat 8: KronosAK (big blind) folded before Flop
Seat 9: I The King I collected ($16.71)





PokerStars Hand #150752503413:  Hold'em No Limit ($0.50/$1.00 USD) - 2016/03/22 14:27:19 CET [2016/03/22 9:27:19 ET]
Table 'Stephano II' 9-max Seat #9 is the button
Seat 1: omorfadramou ($100 in chips) 
Seat 2: I The King I ($100 in chips) 
Seat 3: lombardo11 ($149.70 in chips) 
Seat 4: AWATAR 21 ($121.08 in chips) 
Seat 5: mb2part ($91.91 in chips) 
Seat 6: beterc0re ($132.59 in chips) 
Seat 7: ilaviiitech ($101.50 in chips) 
Seat 8: KingCastle77 ($72.92 in chips) 
Seat 9: matiko09 ($100 in chips) 
omorfadramou: posts small blind $0.50
I The King I: posts big blind $1
*** HOLE CARDS ***
Dealt to matiko09 [Ad 8c]
lombardo11: raises $1 to $2
AWATAR 21: folds 
mb2part: folds 
beterc0re: folds 
ilaviiitech: calls $2
KingCastle77: calls $2
matiko09: folds 
omorfadramou: raises $14 to $16
I The King I: folds 
lombardo11: calls $14
ilaviiitech: folds 
KingCastle77: folds 
*** FLOP *** [Ks 5c Qh]
omorfadramou: bets $15
lombardo11: calls $15
*** TURN *** [Ks 5c Qh] [8s]
omorfadramou: bets $20
lombardo11: raises $44 to $64
omorfadramou: raises $5 to $69 and is all-in
lombardo11: calls $5
*** RIVER *** [Ks 5c Qh 8s] [4s]
*** SHOW DOWN ***
omorfadramou: shows [Kh Kc] (three of a kind, Kings)
lombardo11: shows [Qc Qd] (three of a kind, Queens)
omorfadramou collected $202.20 from pot
*** SUMMARY ***
Total pot $205 | Rake $2.80 
Board [Ks 5c Qh 8s 4s]
Seat 1: omorfadramou (small blind) showed [Kh Kc] and won ($202.20) with three of a kind, Kings
Seat 2: I The King I (big blind) folded before Flop
Seat 3: lombardo11 showed [Qc Qd] and lost with three of a kind, Queens
Seat 4: AWATAR 21 folded before Flop (didn't bet)
Seat 5: mb2part folded before Flop (didn't bet)
Seat 6: beterc0re folded before Flop (didn't bet)
Seat 7: ilaviiitech folded before Flop
Seat 8: KingCastle77 folded before Flop
Seat 9: matiko09 (button) folded before Flop (didn't bet)





PokerStars Hand #150752515632:  Hold'em No Limit ($0.50/$1.00 USD) - 2016/03/22 14:27:39 CET [2016/03/22 9:27:39 ET]
Table 'Taygeta II' 9-max Seat #6 is the button
Seat 1: DevilisHEyz ($68.03 in chips) 
Seat 2: khan Erkesh ($184.06 in chips) 
Seat 3: Muinmyheart ($107.80 in chips) 
Seat 4: matiko09 ($100 in chips) 
Seat 5: RICKA16 ($102.27 in chips) 
Seat 6: I The King I ($135.41 in chips) 
Seat 7: Szevasztopol ($102.68 in chips) 
Seat 9: cobrik23 ($50.40 in chips) 
Szevasztopol: posts small blind $0.50
cobrik23: posts big blind $1
*** HOLE CARDS ***
Dealt to matiko09 [5h Ks]
DevilisHEyz: folds 
khan Erkesh: folds 
Muinmyheart: folds 
matiko09: folds 
RICKA16: folds 
I The King I: raises $1 to $2
Szevasztopol: folds 
cobrik23: folds 
Uncalled bet ($1) returned to I The King I
I The King I collected $2.50 from pot
I The King I: doesn't show hand 
*** SUMMARY ***
Total pot $2.50 | Rake $0 
Seat 1: DevilisHEyz folded before Flop (didn't bet)
Seat 2: khan Erkesh folded before Flop (didn't bet)
Seat 3: Muinmyheart folded before Flop (didn't bet)
Seat 4: matiko09 folded before Flop (didn't bet)
Seat 5: RICKA16 folded before Flop (didn't bet)
Seat 6: I The King I (button) collected ($2.50)
Seat 7: Szevasztopol (small blind) folded before Flop
Seat 9: cobrik23 (big blind) folded before Flop





PokerStars Hand #150752516658:  Hold'em No Limit ($1/$2 USD) - 2016/03/22 14:27:41 CET [2016/03/22 9:27:41 ET]
Table 'Kiso II' 9-max Seat #9 is the button
Seat 2: di0d80 ($454.13 in chips) 
Seat 3: seouljam ($366.66 in chips) 
Seat 4: N4$H ($200 in chips) 
Seat 5: Ilov3NBA ($306.84 in chips) 
Seat 6: KT90 ($343.30 in chips) 
Seat 7: Igoriah ($203.01 in chips) 
Seat 8: bananajoe001 ($177.14 in chips) 
Seat 9: matiko09 ($254.02 in chips) 
di0d80: posts small blind $1
seouljam: posts big blind $2
*** HOLE CARDS ***
Dealt to matiko09 [Ah 7d]
N4$H: raises $2.35 to $4.35
Ilov3NBA: folds 
KT90: folds 
Igoriah: folds 
bananajoe001: folds 
matiko09: folds 
di0d80: folds 
seouljam: folds 
Uncalled bet ($2.35) returned to N4$H
N4$H collected $5 from pot
N4$H: doesn't show hand 
*** SUMMARY ***
Total pot $5 | Rake $0 
Seat 2: di0d80 (small blind) folded before Flop
Seat 3: seouljam (big blind) folded before Flop
Seat 4: N4$H collected ($5)
Seat 5: Ilov3NBA folded before Flop (didn't bet)
Seat 6: KT90 folded before Flop (didn't bet)
Seat 7: Igoriah folded before Flop (didn't bet)
Seat 8: bananajoe001 folded before Flop (didn't bet)
Seat 9: matiko09 (button) folded before Flop (didn't bet)





PokerStars Hand #150752517277:  Hold'em No Limit ($0.50/$1.00 USD) - 2016/03/22 14:27:42 CET [2016/03/22 9:27:42 ET]
Table 'Polyxena' 9-max Seat #7 is the button
Seat 1: I The King I ($105.73 in chips) 
Seat 2: cobrik23 ($82.61 in chips) 
Seat 4: fanmtZ ($40 in chips) 
Seat 5: MrAndMisses ($48.67 in chips) 
Seat 6: Ilov3NBA ($100.41 in chips) 
Seat 7: matiko09 ($100 in chips) 
Seat 8: kift74 ($125.56 in chips) 
Seat 9: ardo888 ($153.08 in chips) 
kift74: posts small blind $0.50
ardo888: posts big blind $1
di0d80: sits out 
*** HOLE CARDS ***
Dealt to matiko09 [5d 6d]
I The King I: folds 
cobrik23: folds 
fanmtZ: folds 
MrAndMisses: folds 
Ilov3NBA: raises $1.50 to $2.50
matiko09: folds 
kift74: folds 
ardo888: folds 
Uncalled bet ($1.50) returned to Ilov3NBA
Ilov3NBA collected $2.50 from pot
Ilov3NBA: doesn't show hand 
*** SUMMARY ***
Total pot $2.50 | Rake $0 
Seat 1: I The King I folded before Flop (didn't bet)
Seat 2: cobrik23 folded before Flop (didn't bet)
Seat 4: fanmtZ folded before Flop (didn't bet)
Seat 5: MrAndMisses folded before Flop (didn't bet)
Seat 6: Ilov3NBA collected ($2.50)
Seat 7: matiko09 (button) folded before Flop (didn't bet)
Seat 8: kift74 (small blind) folded before Flop
Seat 9: ardo888 (big blind) folded before Flop





PokerStars Hand #150752518440:  Hold'em No Limit ($0.50/$1.00 USD) - 2016/03/22 14:27:44 CET [2016/03/22 9:27:44 ET]
Table 'Colchis' 9-max Seat #1 is the button
Seat 1: theluckyjoe ($10.35 in chips) 
Seat 2: Ilov3NBA ($153.41 in chips) 
Seat 4: matiko09 ($101.50 in chips) 
Seat 7: Dantist1122 ($103.50 in chips) 
Seat 8: cobrik23 ($50.06 in chips) 
Seat 9: ardo888 ($101.47 in chips) 
Ilov3NBA: posts small blind $0.50
matiko09: posts big blind $1
*** HOLE CARDS ***
Dealt to matiko09 [5c 3c]
Dantist1122: folds 
cobrik23: folds 
ardo888: folds 
theluckyjoe: folds 
Ilov3NBA: folds 
Uncalled bet ($0.50) returned to matiko09
matiko09 collected $1 from pot
matiko09: doesn't show hand 
*** SUMMARY ***
Total pot $1 | Rake $0 
Seat 1: theluckyjoe (button) folded before Flop (didn't bet)
Seat 2: Ilov3NBA (small blind) folded before Flop
Seat 4: matiko09 (big blind) collected ($1)
Seat 7: Dantist1122 folded before Flop (didn't bet)
Seat 8: cobrik23 folded before Flop (didn't bet)
Seat 9: ardo888 folded before Flop (didn't bet)





PokerStars Hand #150752521813:  Hold'em No Limit ($0.50/$1.00 USD) - 2016/03/22 14:27:49 CET [2016/03/22 9:27:49 ET]
Table 'Miranda' 9-max Seat #7 is the button
Seat 1: cobrik23 ($97.94 in chips) 
Seat 2: Szevasztopol ($115.01 in chips) 
Seat 3: Muinmyheart ($100 in chips) 
Seat 4: bilukm ($36.40 in chips) 
Seat 6: matiko09 ($103.90 in chips) 
Seat 7: RICKA16 ($98.50 in chips) 
Seat 8: hammerwife ($100 in chips) 
Seat 9: ardo888 ($185.53 in chips) 
hammerwife: posts small blind $0.50
ardo888: posts big blind $1
*** HOLE CARDS ***
Dealt to matiko09 [6h 8s]
cobrik23: folds 
Szevasztopol: folds 
Muinmyheart: folds 
bilukm: folds 
matiko09: folds 
RICKA16: folds 
hammerwife: raises $1.60 to $2.60
ardo888: raises $6.40 to $9
hammerwife: calls $6.40
*** FLOP *** [4s As 3h]
hammerwife: checks 
ardo888: bets $9.11
hammerwife: calls $9.11
*** TURN *** [4s As 3h] [8d]
hammerwife: checks 
ardo888: checks 
*** RIVER *** [4s As 3h 8d] [9h]
hammerwife: bets $23.50
ardo888: folds 
Uncalled bet ($23.50) returned to hammerwife
hammerwife collected $34.59 from pot
hammerwife: doesn't show hand 
*** SUMMARY ***
Total pot $36.22 | Rake $1.63 
Board [4s As 3h 8d 9h]
Seat 1: cobrik23 folded before Flop (didn't bet)
Seat 2: Szevasztopol folded before Flop (didn't bet)
Seat 3: Muinmyheart folded before Flop (didn't bet)
Seat 4: bilukm folded before Flop (didn't bet)
Seat 6: matiko09 folded before Flop (didn't bet)
Seat 7: RICKA16 (button) folded before Flop (didn't bet)
Seat 8: hammerwife (small blind) collected ($34.59)
Seat 9: ardo888 (big blind) folded on the River





PokerStars Hand #150752530644:  Hold'em No Limit ($1/$2 USD) - 2016/03/22 14:28:03 CET [2016/03/22 9:28:03 ET]
Table 'Kiso II' 9-max Seat #2 is the button
Seat 2: di0d80 ($453.13 in chips) 
Seat 3: seouljam ($364.66 in chips) 
Seat 4: N4$H ($203 in chips) 
Seat 5: Ilov3NBA ($306.84 in chips) 
Seat 6: KT90 ($343.30 in chips) 
Seat 7: Igoriah ($203.01 in chips) 
Seat 8: bananajoe001 ($177.14 in chips) 
Seat 9: matiko09 ($254.02 in chips) 
seouljam: posts small blind $1
N4$H: posts big blind $2
*** HOLE CARDS ***
Dealt to matiko09 [Qd Qc]
Ilov3NBA: raises $4 to $6
KT90: folds 
Igoriah: folds 
bananajoe001: calls $6
matiko09: raises $18 to $24
di0d80: calls $24
seouljam: folds 
N4$H: folds 
Ilov3NBA: calls $18
bananajoe001: calls $18
*** FLOP *** [8d 6d 7h]
Ilov3NBA: checks 
bananajoe001: checks 
matiko09: bets $38
di0d80: calls $38
Ilov3NBA: folds 
bananajoe001: folds 
*** TURN *** [8d 6d 7h] [5s]
matiko09: checks 
di0d80: checks 
*** RIVER *** [8d 6d 7h 5s] [8c]
matiko09: checks 
di0d80: bets $30
matiko09: calls $30
*** SHOW DOWN ***
di0d80: shows [Kd Kh] (two pair, Kings and Eights)
matiko09: mucks hand 
di0d80 collected $232.20 from pot
*** SUMMARY ***
Total pot $235 | Rake $2.80 
Board [8d 6d 7h 5s 8c]
Seat 2: di0d80 (button) showed [Kd Kh] and won ($232.20) with two pair, Kings and Eights
Seat 3: seouljam (small blind) folded before Flop
Seat 4: N4$H (big blind) folded before Flop
Seat 5: Ilov3NBA folded on the Flop
Seat 6: KT90 folded before Flop (didn't bet)
Seat 7: Igoriah folded before Flop (didn't bet)
Seat 8: bananajoe001 folded on the Flop
Seat 9: matiko09 mucked [Qd Qc]





PokerStars Hand #150752531738:  Hold'em No Limit ($0.50/$1.00 USD) - 2016/03/22 14:28:05 CET [2016/03/22 9:28:05 ET]
Table 'Colchis' 9-max Seat #2 is the button
Seat 1: theluckyjoe ($10.35 in chips) 
Seat 2: Ilov3NBA ($152.91 in chips) 
Seat 4: matiko09 ($102 in chips) 
Seat 7: Dantist1122 ($103.50 in chips) 
Seat 8: cobrik23 ($50.06 in chips) 
Seat 9: ardo888 ($101.47 in chips) 
matiko09: posts small blind $0.50
Avtovo was removed from the table for failing to post
Dantist1122: posts big blind $1
*** HOLE CARDS ***
Dealt to matiko09 [3h 8h]
hammerwife joins the table at seat #6 
cobrik23: folds 
ardo888: raises $2 to $3
theluckyjoe: folds 
Ilov3NBA: folds 
matiko09: folds 
Dantist1122: folds 
Uncalled bet ($2) returned to ardo888
ardo888 collected $2.50 from pot
ardo888: doesn't show hand 
*** SUMMARY ***
Total pot $2.50 | Rake $0 
Seat 1: theluckyjoe folded before Flop (didn't bet)
Seat 2: Ilov3NBA (button) folded before Flop (didn't bet)
Seat 4: matiko09 (small blind) folded before Flop
Seat 7: Dantist1122 (big blind) folded before Flop
Seat 8: cobrik23 folded before Flop (didn't bet)
Seat 9: ardo888 collected ($2.50)





PokerStars Hand #150752532294:  Hold'em No Limit ($0.50/$1.00 USD) - 2016/03/22 14:28:06 CET [2016/03/22 9:28:06 ET]
Table 'Arabis' 9-max Seat #8 is the button
Seat 1: di0d80 ($100 in chips) 
Seat 2: ilaviiitech ($107.40 in chips) 
Seat 4: Painkiller72 ($175.95 in chips) 
Seat 5: matiko09 ($130.49 in chips) 
Seat 6: Ilov3NBA ($100 in chips) 
Seat 7: howsiao ($163.71 in chips) 
Seat 8: Bro_Happy ($197.74 in chips) 
Seat 9: cobrik23 ($73.65 in chips) 
cobrik23: posts small blind $0.50
di0d80: posts big blind $1
*** HOLE CARDS ***
Dealt to matiko09 [Kc Ts]
ilaviiitech: folds 
Painkiller72: folds 
matiko09: folds 
Ilov3NBA: folds 
howsiao: raises $2.50 to $3.50
Bro_Happy: raises $5.50 to $9
cobrik23: folds 
di0d80: folds 
howsiao: calls $5.50
*** FLOP *** [6c 3s Qd]
howsiao: checks 
Bro_Happy: bets $9.68
howsiao: folds 
Uncalled bet ($9.68) returned to Bro_Happy
Bro_Happy collected $18.62 from pot
Bro_Happy: doesn't show hand 
*** SUMMARY ***
Total pot $19.50 | Rake $0.88 
Board [6c 3s Qd]
Seat 1: di0d80 (big blind) folded before Flop
Seat 2: ilaviiitech folded before Flop (didn't bet)
Seat 4: Painkiller72 folded before Flop (didn't bet)
Seat 5: matiko09 folded before Flop (didn't bet)
Seat 6: Ilov3NBA folded before Flop (didn't bet)
Seat 7: howsiao folded on the Flop
Seat 8: Bro_Happy (button) collected ($18.62)
Seat 9: cobrik23 (small blind) folded before Flop





PokerStars Hand #150752537553:  Hold'em No Limit ($0.50/$1.00 USD) - 2016/03/22 14:28:15 CET [2016/03/22 9:28:15 ET]
Table 'Taygeta II' 9-max Seat #7 is the button
Seat 1: DevilisHEyz ($68.03 in chips) 
Seat 2: khan Erkesh ($184.06 in chips) 
Seat 3: Muinmyheart ($107.80 in chips) 
Seat 4: matiko09 ($100 in chips) 
Seat 5: RICKA16 ($102.27 in chips) 
Seat 6: I The King I ($136.91 in chips) 
Seat 7: Szevasztopol ($102.18 in chips) 
Seat 9: cobrik23 ($49.40 in chips) 
cobrik23: posts small blind $0.50
DevilisHEyz: posts big blind $1
*** HOLE CARDS ***
Dealt to matiko09 [Ad 3s]
khan Erkesh: raises $2 to $3
Muinmyheart: folds 
matiko09: folds 
RICKA16: folds 
I The King I: folds 
Szevasztopol: folds 
cobrik23: folds 
DevilisHEyz: folds 
Uncalled bet ($2) returned to khan Erkesh
khan Erkesh collected $2.50 from pot
khan Erkesh: doesn't show hand 
*** SUMMARY ***
Total pot $2.50 | Rake $0 
Seat 1: DevilisHEyz (big blind) folded before Flop
Seat 2: khan Erkesh collected ($2.50)
Seat 3: Muinmyheart folded before Flop (didn't bet)
Seat 4: matiko09 folded before Flop (didn't bet)
Seat 5: RICKA16 folded before Flop (didn't bet)
Seat 6: I The King I folded before Flop (didn't bet)
Seat 7: Szevasztopol (button) folded before Flop (didn't bet)
Seat 9: cobrik23 (small blind) folded before Flop





PokerStars Hand #150752538537:  Hold'em No Limit ($0.50/$1.00 USD) - 2016/03/22 14:28:17 CET [2016/03/22 9:28:17 ET]
Table 'Harding' 9-max Seat #1 is the button
Seat 1: matiko09 ($120.16 in chips) 
Seat 2: RICKA16 ($103.16 in chips) 
Seat 5: DevilisHEyz ($140.28 in chips) 
Seat 6: Ilov3NBA ($100 in chips) 
Seat 9: omorfadramou ($102.50 in chips) 
RICKA16: posts small blind $0.50
lixiangli has timed out while being disconnected
lixiangli: is sitting out 
DevilisHEyz: posts big blind $1
di0d80: sits out 
*** HOLE CARDS ***
Dealt to matiko09 [Kc 4c]
Ilov3NBA: raises $2 to $3
omorfadramou: folds 
lixiangli is disconnected 
lixiangli leaves the table
beterc0re joins the table at seat #4 
matiko09: folds 
RICKA16: folds 
DevilisHEyz: folds 
Uncalled bet ($2) returned to Ilov3NBA
Ilov3NBA collected $2.50 from pot
Ilov3NBA: doesn't show hand 
*** SUMMARY ***
Total pot $2.50 | Rake $0 
Seat 1: matiko09 (button) folded before Flop (didn't bet)
Seat 2: RICKA16 (small blind) folded before Flop
Seat 5: DevilisHEyz (big blind) folded before Flop
Seat 6: Ilov3NBA collected ($2.50)
Seat 9: omorfadramou folded before Flop (didn't bet)





PokerStars Hand #150752551704:  Hold'em No Limit ($0.50/$1.00 USD) - 2016/03/22 14:28:38 CET [2016/03/22 9:28:38 ET]
Table 'Crater II' 9-max Seat #7 is the button
Seat 1: matiko09 ($126.27 in chips) 
Seat 2: Eisbaerli85 ($123.75 in chips) 
Seat 3: hammerwife ($100 in chips) 
Seat 4: fanmtZ ($41 in chips) 
Seat 6: Kobiroga150 ($43.82 in chips) 
Seat 7: AWATAR 21 ($68.48 in chips) 
Seat 8: KronosAK ($110.28 in chips) 
Seat 9: I The King I ($124.41 in chips) 
KronosAK: posts small blind $0.50
I The King I: posts big blind $1
*** HOLE CARDS ***
Dealt to matiko09 [5d As]
matiko09: folds 
Eisbaerli85: raises $2 to $3
hammerwife: folds 
fanmtZ: folds 
Kobiroga150: folds 
AWATAR 21: calls $3
KronosAK: folds 
I The King I: folds 
*** FLOP *** [Td 8h Qs]
Eisbaerli85: bets $3.93
AWATAR 21: folds 
Uncalled bet ($3.93) returned to Eisbaerli85
Eisbaerli85 collected $7.16 from pot
*** SUMMARY ***
Total pot $7.50 | Rake $0.34 
Board [Td 8h Qs]
Seat 1: matiko09 folded before Flop (didn't bet)
Seat 2: Eisbaerli85 collected ($7.16)
Seat 3: hammerwife folded before Flop (didn't bet)
Seat 4: fanmtZ folded before Flop (didn't bet)
Seat 6: Kobiroga150 folded before Flop (didn't bet)
Seat 7: AWATAR 21 (button) folded on the Flop
Seat 8: KronosAK (small blind) folded before Flop
Seat 9: I The King I (big blind) folded before Flop





PokerStars Hand #150752557410:  Hold'em No Limit ($0.50/$1.00 USD) - 2016/03/22 14:28:47 CET [2016/03/22 9:28:47 ET]
Table 'Polyxena' 9-max Seat #8 is the button
Seat 1: I The King I ($105.73 in chips) 
Seat 2: cobrik23 ($82.61 in chips) 
Seat 4: fanmtZ ($40 in chips) 
Seat 5: MrAndMisses ($48.67 in chips) 
Seat 6: Ilov3NBA ($101.91 in chips) 
Seat 7: matiko09 ($100 in chips) 
Seat 8: kift74 ($125.06 in chips) 
Seat 9: ardo888 ($152.08 in chips) 
ardo888: posts small blind $0.50
I The King I: posts big blind $1
di0d80: sits out 
*** HOLE CARDS ***
Dealt to matiko09 [2h Qd]
cobrik23: folds 
fanmtZ: folds 
MrAndMisses: folds 
Ilov3NBA: folds 
matiko09: folds 
kift74: raises $2 to $3
ardo888: folds 
I The King I: folds 
Uncalled bet ($2) returned to kift74
kift74 collected $2.50 from pot
kift74: doesn't show hand 
*** SUMMARY ***
Total pot $2.50 | Rake $0 
Seat 1: I The King I (big blind) folded before Flop
Seat 2: cobrik23 folded before Flop (didn't bet)
Seat 4: fanmtZ folded before Flop (didn't bet)
Seat 5: MrAndMisses folded before Flop (didn't bet)
Seat 6: Ilov3NBA folded before Flop (didn't bet)
Seat 7: matiko09 folded before Flop (didn't bet)
Seat 8: kift74 (button) collected ($2.50)
Seat 9: ardo888 (small blind) folded before Flop





PokerStars Hand #150752560578:  Hold'em No Limit ($0.50/$1.00 USD) - 2016/03/22 14:28:52 CET [2016/03/22 9:28:52 ET]
Table 'Colchis' 9-max Seat #4 is the button
Seat 1: theluckyjoe ($10.35 in chips) 
Seat 2: Ilov3NBA ($152.91 in chips) 
Seat 4: matiko09 ($101.50 in chips) 
Seat 7: Dantist1122 ($102.50 in chips) 
Seat 8: cobrik23 ($50.06 in chips) 
Seat 9: ardo888 ($102.97 in chips) 
Dantist1122: posts small blind $0.50
cobrik23: posts big blind $1
*** HOLE CARDS ***
Dealt to matiko09 [9s 8s]
ardo888: folds 
theluckyjoe: folds 
Ilov3NBA: folds 
matiko09: raises $1.27 to $2.27
Dantist1122: folds 
cobrik23: folds 
Uncalled bet ($1.27) returned to matiko09
matiko09 collected $2.50 from pot
matiko09: doesn't show hand 
*** SUMMARY ***
Total pot $2.50 | Rake $0 
Seat 1: theluckyjoe folded before Flop (didn't bet)
Seat 2: Ilov3NBA folded before Flop (didn't bet)
Seat 4: matiko09 (button) collected ($2.50)
Seat 7: Dantist1122 (small blind) folded before Flop
Seat 8: cobrik23 (big blind) folded before Flop
Seat 9: ardo888 folded before Flop (didn't bet)





PokerStars Hand #150752564418:  Hold'em No Limit ($0.50/$1.00 USD) - 2016/03/22 14:28:58 CET [2016/03/22 9:28:58 ET]
Table 'Arabis' 9-max Seat #9 is the button
Seat 1: di0d80 ($100 in chips) 
Seat 4: Painkiller72 ($175.95 in chips) 
Seat 5: matiko09 ($130.49 in chips) 
Seat 6: Ilov3NBA ($100 in chips) 
Seat 7: howsiao ($154.71 in chips) 
Seat 8: Bro_Happy ($207.36 in chips) 
Seat 9: cobrik23 ($73.15 in chips) 
di0d80: posts small blind $0.50
Painkiller72: posts big blind $1
*** HOLE CARDS ***
Dealt to matiko09 [Td 4h]
matiko09: folds 
Ilov3NBA: folds 
howsiao: calls $1
Bro_Happy: folds 
cobrik23: folds 
di0d80: folds 
Painkiller72: checks 
*** FLOP *** [5c 9d 8s]
Painkiller72: checks 
howsiao: bets $2.39
Painkiller72: calls $2.39
*** TURN *** [5c 9d 8s] [7c]
Painkiller72: checks 
howsiao: bets $6.95
Painkiller72: calls $6.95
*** RIVER *** [5c 9d 8s 7c] [8h]
Painkiller72: checks 
howsiao: checks 
*** SHOW DOWN ***
Painkiller72: shows [2s 9h] (two pair, Nines and Eights)
howsiao: mucks hand 
Painkiller72 collected $20.23 from pot
*** SUMMARY ***
Total pot $21.18 | Rake $0.95 
Board [5c 9d 8s 7c 8h]
Seat 1: di0d80 (small blind) folded before Flop
Seat 4: Painkiller72 (big blind) showed [2s 9h] and won ($20.23) with two pair, Nines and Eights
Seat 5: matiko09 folded before Flop (didn't bet)
Seat 6: Ilov3NBA folded before Flop (didn't bet)
Seat 7: howsiao mucked [7d 5d]
Seat 8: Bro_Happy folded before Flop (didn't bet)
Seat 9: cobrik23 (button) folded before Flop (didn't bet)





PokerStars Hand #150752564526:  Hold'em No Limit ($0.50/$1.00 USD) - 2016/03/22 14:28:58 CET [2016/03/22 9:28:58 ET]
Table 'Taygeta II' 9-max Seat #9 is the button
Seat 1: DevilisHEyz ($67.03 in chips) 
Seat 2: khan Erkesh ($185.56 in chips) 
Seat 3: Muinmyheart ($107.80 in chips) 
Seat 4: matiko09 ($100 in chips) 
Seat 5: RICKA16 ($102.27 in chips) 
Seat 6: I The King I ($136.91 in chips) 
Seat 7: Szevasztopol ($102.18 in chips) 
Seat 9: cobrik23 ($48.90 in chips) 
DevilisHEyz: posts small blind $0.50
khan Erkesh: posts big blind $1
*** HOLE CARDS ***
Dealt to matiko09 [As 3d]
Muinmyheart: folds 
matiko09: folds 
RICKA16: folds 
I The King I: folds 
Szevasztopol: folds 
cobrik23: folds 
DevilisHEyz: folds 
Uncalled bet ($0.50) returned to khan Erkesh
khan Erkesh collected $1 from pot
khan Erkesh: doesn't show hand 
*** SUMMARY ***
Total pot $1 | Rake $0 
Seat 1: DevilisHEyz (small blind) folded before Flop
Seat 2: khan Erkesh (big blind) collected ($1)
Seat 3: Muinmyheart folded before Flop (didn't bet)
Seat 4: matiko09 folded before Flop (didn't bet)
Seat 5: RICKA16 folded before Flop (didn't bet)
Seat 6: I The King I folded before Flop (didn't bet)
Seat 7: Szevasztopol folded before Flop (didn't bet)
Seat 9: cobrik23 (button) folded before Flop (didn't bet)





PokerStars Hand #150752567495:  Hold'em No Limit ($1/$2 USD) - 2016/03/22 14:29:03 CET [2016/03/22 9:29:03 ET]
Table 'Deipylos' 9-max Seat #5 is the button
Seat 2: N4$H ($200 in chips) 
Seat 3: KT90 ($200 in chips) 
Seat 4: Igoriah ($200 in chips) 
Seat 5: IntsAA ($192 in chips) 
Seat 6: di0d80 ($202 in chips) 
Seat 7: matiko09 ($200 in chips) 
Seat 8: luckbox6666 ($200 in chips) 
Seat 9: nickreason17 ($200 in chips) 
di0d80: posts small blind $1
matiko09: posts big blind $2
DUkalisUA: sits out 
*** HOLE CARDS ***
Dealt to matiko09 [9d Ts]
luckbox6666: folds 
nickreason17: folds 
N4$H: folds 
KT90: folds 
Igoriah: folds 
IntsAA: folds 
di0d80: folds 
Uncalled bet ($1) returned to matiko09
matiko09 collected $2 from pot
matiko09: doesn't show hand 
*** SUMMARY ***
Total pot $2 | Rake $0 
Seat 2: N4$H folded before Flop (didn't bet)
Seat 3: KT90 folded before Flop (didn't bet)
Seat 4: Igoriah folded before Flop (didn't bet)
Seat 5: IntsAA (button) folded before Flop (didn't bet)
Seat 6: di0d80 (small blind) folded before Flop
Seat 7: matiko09 (big blind) collected ($2)
Seat 8: luckbox6666 folded before Flop (didn't bet)
Seat 9: nickreason17 folded before Flop (didn't bet)





PokerStars Hand #150752574276:  Hold'em No Limit ($0.50/$1.00 USD) - 2016/03/22 14:29:14 CET [2016/03/22 9:29:14 ET]
Table 'Polyxena' 9-max Seat #9 is the button
Seat 1: I The King I ($104.73 in chips) 
Seat 2: cobrik23 ($82.61 in chips) 
Seat 4: fanmtZ ($40 in chips) 
Seat 5: MrAndMisses ($48.67 in chips) 
Seat 6: Ilov3NBA ($101.91 in chips) 
Seat 7: matiko09 ($100 in chips) 
Seat 8: kift74 ($126.56 in chips) 
Seat 9: ardo888 ($151.58 in chips) 
I The King I: posts small blind $0.50
cobrik23: posts big blind $1
di0d80: sits out 
*** HOLE CARDS ***
Dealt to matiko09 [Kd 3h]
fanmtZ: folds 
MrAndMisses: calls $1
Ilov3NBA: folds 
matiko09: folds 
kift74: raises $2 to $3
ardo888: folds 
I The King I: folds 
cobrik23: folds 
MrAndMisses: calls $2
*** FLOP *** [Jh 9s Js]
MrAndMisses: checks 
kift74: bets $3.58
MrAndMisses: folds 
Uncalled bet ($3.58) returned to kift74
kift74 collected $7.16 from pot
kift74: doesn't show hand 
*** SUMMARY ***
Total pot $7.50 | Rake $0.34 
Board [Jh 9s Js]
Seat 1: I The King I (small blind) folded before Flop
Seat 2: cobrik23 (big blind) folded before Flop
Seat 4: fanmtZ folded before Flop (didn't bet)
Seat 5: MrAndMisses folded on the Flop
Seat 6: Ilov3NBA folded before Flop (didn't bet)
Seat 7: matiko09 folded before Flop (didn't bet)
Seat 8: kift74 collected ($7.16)
Seat 9: ardo888 (button) folded before Flop (didn't bet)





PokerStars Hand #150752578620:  Hold'em No Limit ($0.50/$1.00 USD) - 2016/03/22 14:29:21 CET [2016/03/22 9:29:21 ET]
Table 'Colchis' 9-max Seat #7 is the button
Seat 1: theluckyjoe ($10.35 in chips) 
Seat 2: Ilov3NBA ($152.91 in chips) 
Seat 4: matiko09 ($103 in chips) 
Seat 7: Dantist1122 ($102 in chips) 
Seat 8: cobrik23 ($49.06 in chips) 
Seat 9: ardo888 ($102.97 in chips) 
cobrik23: posts small blind $0.50
ardo888: posts big blind $1
*** HOLE CARDS ***
Dealt to matiko09 [9d 3s]
theluckyjoe: folds 
Ilov3NBA: folds 
matiko09: folds 
Dantist1122: raises $1.05 to $2.05
cobrik23: folds 
ardo888: calls $1.05
*** FLOP *** [7h 4h 5d]
ardo888: checks 
Dantist1122: checks 
*** TURN *** [7h 4h 5d] [Ks]
ardo888: checks 
Dantist1122: bets $3.51
ardo888: folds 
Uncalled bet ($3.51) returned to Dantist1122
Dantist1122 collected $4.39 from pot
Dantist1122: doesn't show hand 
*** SUMMARY ***
Total pot $4.60 | Rake $0.21 
Board [7h 4h 5d Ks]
Seat 1: theluckyjoe folded before Flop (didn't bet)
Seat 2: Ilov3NBA folded before Flop (didn't bet)
Seat 4: matiko09 folded before Flop (didn't bet)
Seat 7: Dantist1122 (button) collected ($4.39)
Seat 8: cobrik23 (small blind) folded before Flop
Seat 9: ardo888 (big blind) folded on the Turn





PokerStars Hand #150752579471:  Hold'em No Limit ($0.50/$1.00 USD) - 2016/03/22 14:29:23 CET [2016/03/22 9:29:23 ET]
Table 'Crater II' 9-max Seat #8 is the button
Seat 1: matiko09 ($126.27 in chips) 
Seat 2: Eisbaerli85 ($127.91 in chips) 
Seat 3: hammerwife ($100 in chips) 
Seat 4: fanmtZ ($41 in chips) 
Seat 6: Kobiroga150 ($43.82 in chips) 
Seat 7: AWATAR 21 ($65.48 in chips) 
Seat 8: KronosAK ($109.78 in chips) 
Seat 9: I The King I ($123.41 in chips) 
I The King I: posts small blind $0.50
matiko09: posts big blind $1
*** HOLE CARDS ***
Dealt to matiko09 [9c 9h]
Eisbaerli85: folds 
hammerwife: raises $2 to $3
fanmtZ: folds 
Kobiroga150: folds 
AWATAR 21: folds 
KronosAK: folds 
I The King I: folds 
matiko09: calls $2
*** FLOP *** [7s 7c 8s]
matiko09: checks 
hammerwife: bets $4
matiko09: calls $4
*** TURN *** [7s 7c 8s] [Qh]
matiko09: checks 
hammerwife: checks 
*** RIVER *** [7s 7c 8s Qh] [9d]
matiko09: bets $9
hammerwife: folds 
Uncalled bet ($9) returned to matiko09
matiko09 collected $13.85 from pot
matiko09: doesn't show hand 
*** SUMMARY ***
Total pot $14.50 | Rake $0.65 
Board [7s 7c 8s Qh 9d]
Seat 1: matiko09 (big blind) collected ($13.85)
Seat 2: Eisbaerli85 folded before Flop (didn't bet)
Seat 3: hammerwife folded on the River
Seat 4: fanmtZ folded before Flop (didn't bet)
Seat 6: Kobiroga150 folded before Flop (didn't bet)
Seat 7: AWATAR 21 folded before Flop (didn't bet)
Seat 8: KronosAK (button) folded before Flop (didn't bet)
Seat 9: I The King I (small blind) folded before Flop





PokerStars Hand #150752580247:  Hold'em No Limit ($1/$2 USD) - 2016/03/22 14:29:24 CET [2016/03/22 9:29:24 ET]
Table 'Deipylos' 9-max Seat #6 is the button
Seat 2: N4$H ($200 in chips) 
Seat 3: KT90 ($200 in chips) 
Seat 4: Igoriah ($200 in chips) 
Seat 5: IntsAA ($192 in chips) 
Seat 6: di0d80 ($201 in chips) 
Seat 7: matiko09 ($201 in chips) 
Seat 8: luckbox6666 ($200 in chips) 
Seat 9: nickreason17 ($200 in chips) 
matiko09: posts small blind $1
luckbox6666: posts big blind $2
DUkalisUA: sits out 
*** HOLE CARDS ***
Dealt to matiko09 [Ts 9h]
nickreason17: raises $4 to $6
N4$H: folds 
KT90: folds 
Igoriah: folds 
IntsAA: folds 
di0d80: folds 
matiko09: folds 
luckbox6666: calls $4
*** FLOP *** [2d 8h 4d]
luckbox6666: bets $10
nickreason17: folds 
Uncalled bet ($10) returned to luckbox6666
luckbox6666 collected $12.42 from pot
luckbox6666: doesn't show hand 
*** SUMMARY ***
Total pot $13 | Rake $0.58 
Board [2d 8h 4d]
Seat 2: N4$H folded before Flop (didn't bet)
Seat 3: KT90 folded before Flop (didn't bet)
Seat 4: Igoriah folded before Flop (didn't bet)
Seat 5: IntsAA folded before Flop (didn't bet)
Seat 6: di0d80 (button) folded before Flop (didn't bet)
Seat 7: matiko09 (small blind) folded before Flop
Seat 8: luckbox6666 (big blind) collected ($12.42)
Seat 9: nickreason17 folded on the Flop





PokerStars Hand #150752580793:  Hold'em No Limit ($0.50/$1.00 USD) - 2016/03/22 14:29:25 CET [2016/03/22 9:29:25 ET]
Table 'Miranda' 9-max Seat #8 is the button
Seat 1: cobrik23 ($97.94 in chips) 
Seat 2: Szevasztopol ($115.01 in chips) 
Seat 3: Muinmyheart ($100 in chips) 
Seat 4: bilukm ($36.40 in chips) 
Seat 6: matiko09 ($103.90 in chips) 
Seat 7: RICKA16 ($100 in chips) 
Seat 8: hammerwife ($116.48 in chips) 
Seat 9: ardo888 ($167.42 in chips) 
ardo888: posts small blind $0.50
cobrik23: posts big blind $1
*** HOLE CARDS ***
Dealt to matiko09 [4c 4h]
Szevasztopol: folds 
Muinmyheart: folds 
bilukm: folds 
matiko09: raises $2 to $3
RICKA16: raises $7 to $10
hammerwife: folds 
ardo888: folds 
cobrik23: folds 
matiko09: folds 
Uncalled bet ($7) returned to RICKA16
RICKA16 collected $7.50 from pot
RICKA16: doesn't show hand 
*** SUMMARY ***
Total pot $7.50 | Rake $0 
Seat 1: cobrik23 (big blind) folded before Flop
Seat 2: Szevasztopol folded before Flop (didn't bet)
Seat 3: Muinmyheart folded before Flop (didn't bet)
Seat 4: bilukm folded before Flop (didn't bet)
Seat 6: matiko09 folded before Flop
Seat 7: RICKA16 collected ($7.50)
Seat 8: hammerwife (button) folded before Flop (didn't bet)
Seat 9: ardo888 (small blind) folded before Flop





PokerStars Hand #150752589240:  Hold'em No Limit ($0.50/$1.00 USD) - 2016/03/22 14:29:39 CET [2016/03/22 9:29:39 ET]
Table 'Harding' 9-max Seat #2 is the button
Seat 1: matiko09 ($120.16 in chips) 
Seat 2: RICKA16 ($102.66 in chips) 
Seat 5: DevilisHEyz ($139.28 in chips) 
Seat 6: Ilov3NBA ($101.50 in chips) 
Seat 7: mrhighryza ($117.73 in chips) 
Seat 9: omorfadramou ($102.50 in chips) 
beterc0re will be allowed to play after the button
DevilisHEyz: posts small blind $0.50
Ilov3NBA: posts big blind $1
di0d80: sits out 
*** HOLE CARDS ***
Dealt to matiko09 [7c 4s]
mrhighryza: folds 
omorfadramou: raises $2 to $3
matiko09: folds 
RICKA16: folds 
DevilisHEyz: folds 
Ilov3NBA: folds 
Uncalled bet ($2) returned to omorfadramou
omorfadramou collected $2.50 from pot
omorfadramou: doesn't show hand 
*** SUMMARY ***
Total pot $2.50 | Rake $0 
Seat 1: matiko09 folded before Flop (didn't bet)
Seat 2: RICKA16 (button) folded before Flop (didn't bet)
Seat 5: DevilisHEyz (small blind) folded before Flop
Seat 6: Ilov3NBA (big blind) folded before Flop
Seat 7: mrhighryza folded before Flop (didn't bet)
Seat 9: omorfadramou collected ($2.50)





PokerStars Hand #150752591653:  Hold'em No Limit ($0.50/$1.00 USD) - 2016/03/22 14:29:43 CET [2016/03/22 9:29:43 ET]
Table 'Stephano II' 9-max Seat #1 is the button
Seat 1: omorfadramou ($202.20 in chips) 
Seat 2: I The King I ($100 in chips) 
Seat 3: lombardo11 ($49.70 in chips) 
Seat 4: AWATAR 21 ($121.08 in chips) 
Seat 5: mb2part ($91.91 in chips) 
Seat 6: beterc0re ($132.59 in chips) 
Seat 7: ilaviiitech ($100 in chips) 
Seat 8: KingCastle77 ($70.92 in chips) 
Seat 9: matiko09 ($100 in chips) 
I The King I: posts small blind $0.50
lombardo11: posts big blind $1
*** HOLE CARDS ***
Dealt to matiko09 [6s 3c]
AWATAR 21: folds 
mb2part: folds 
beterc0re: folds 
ilaviiitech: folds 
KingCastle77: raises $2 to $3
matiko09: folds 
omorfadramou: folds 
I The King I: folds 
lombardo11: raises $6.50 to $9.50
KingCastle77: calls $6.50
*** FLOP *** [4d 3d Tc]
lombardo11: bets $11
KingCastle77: folds 
Uncalled bet ($11) returned to lombardo11
lombardo11 collected $18.62 from pot
lombardo11: doesn't show hand 
*** SUMMARY ***
Total pot $19.50 | Rake $0.88 
Board [4d 3d Tc]
Seat 1: omorfadramou (button) folded before Flop (didn't bet)
Seat 2: I The King I (small blind) folded before Flop
Seat 3: lombardo11 (big blind) collected ($18.62)
Seat 4: AWATAR 21 folded before Flop (didn't bet)
Seat 5: mb2part folded before Flop (didn't bet)
Seat 6: beterc0re folded before Flop (didn't bet)
Seat 7: ilaviiitech folded before Flop (didn't bet)
Seat 8: KingCastle77 folded on the Flop
Seat 9: matiko09 folded before Flop (didn't bet)





PokerStars Hand #150752596175:  Hold'em No Limit ($0.50/$1.00 USD) - 2016/03/22 14:29:50 CET [2016/03/22 9:29:50 ET]
Table 'Taygeta II' 9-max Seat #1 is the button
Seat 1: DevilisHEyz ($66.53 in chips) 
Seat 2: khan Erkesh ($186.06 in chips) 
Seat 3: Muinmyheart ($107.80 in chips) 
Seat 4: matiko09 ($100 in chips) 
Seat 5: RICKA16 ($102.27 in chips) 
Seat 6: I The King I ($136.91 in chips) 
Seat 7: Szevasztopol ($102.18 in chips) 
Seat 9: cobrik23 ($48.90 in chips) 
khan Erkesh: posts small blind $0.50
Muinmyheart: posts big blind $1
*** HOLE CARDS ***
Dealt to matiko09 [6h Jh]
matiko09: folds 
RICKA16: folds 
I The King I: folds 
Szevasztopol: folds 
cobrik23: folds 
DevilisHEyz: folds 
khan Erkesh: raises $1 to $2
Muinmyheart: folds 
Uncalled bet ($1) returned to khan Erkesh
khan Erkesh collected $2 from pot
khan Erkesh: doesn't show hand 
*** SUMMARY ***
Total pot $2 | Rake $0 
Seat 1: DevilisHEyz (button) folded before Flop (didn't bet)
Seat 2: khan Erkesh (small blind) collected ($2)
Seat 3: Muinmyheart (big blind) folded before Flop
Seat 4: matiko09 folded before Flop (didn't bet)
Seat 5: RICKA16 folded before Flop (didn't bet)
Seat 6: I The King I folded before Flop (didn't bet)
Seat 7: Szevasztopol folded before Flop (didn't bet)
Seat 9: cobrik23 folded before Flop (didn't bet)





PokerStars Hand #150752601593:  Hold'em No Limit ($0.50/$1.00 USD) - 2016/03/22 14:29:59 CET [2016/03/22 9:29:59 ET]
Table 'Harding' 9-max Seat #5 is the button
Seat 1: matiko09 ($120.16 in chips) 
Seat 2: RICKA16 ($102.66 in chips) 
Seat 5: DevilisHEyz ($138.78 in chips) 
Seat 6: Ilov3NBA ($100.50 in chips) 
Seat 7: mrhighryza ($117.73 in chips) 
Seat 9: omorfadramou ($104 in chips) 
Ilov3NBA: posts small blind $0.50
mrhighryza: posts big blind $1
di0d80: sits out 
beterc0re: sits out 
*** HOLE CARDS ***
Dealt to matiko09 [5h Qc]
omorfadramou: folds 
matiko09: folds 
RICKA16: raises $2 to $3
DevilisHEyz: folds 
Ilov3NBA: calls $2.50
mrhighryza: folds 
*** FLOP *** [3d 9h Jh]
Ilov3NBA: checks 
DevilisHEyz leaves the table
RICKA16: bets $5
Ilov3NBA: folds 
Uncalled bet ($5) returned to RICKA16
RICKA16 collected $6.68 from pot
RICKA16: doesn't show hand 
*** SUMMARY ***
Total pot $7 | Rake $0.32 
Board [3d 9h Jh]
Seat 1: matiko09 folded before Flop (didn't bet)
Seat 2: RICKA16 collected ($6.68)
Seat 5: DevilisHEyz (button) folded before Flop (didn't bet)
Seat 6: Ilov3NBA (small blind) folded on the Flop
Seat 7: mrhighryza (big blind) folded before Flop
Seat 9: omorfadramou folded before Flop (didn't bet)





PokerStars Hand #150752605974:  Hold'em No Limit ($0.50/$1.00 USD) - 2016/03/22 14:30:04 CET [2016/03/22 9:30:04 ET]
Table 'Miranda' 9-max Seat #9 is the button
Seat 1: cobrik23 ($96.94 in chips) 
Seat 2: Szevasztopol ($115.01 in chips) 
Seat 3: Muinmyheart ($100 in chips) 
Seat 4: bilukm ($100 in chips) 
Seat 6: matiko09 ($100.90 in chips) 
Seat 7: RICKA16 ($104.50 in chips) 
Seat 8: hammerwife ($116.48 in chips) 
Seat 9: ardo888 ($166.92 in chips) 
cobrik23: posts small blind $0.50
Szevasztopol: posts big blind $1
*** HOLE CARDS ***
Dealt to matiko09 [2s 6s]
Muinmyheart: folds 
bilukm: folds 
matiko09: folds 
RICKA16: folds 
hammerwife: folds 
ardo888: folds 
cobrik23: raises $2 to $3
Szevasztopol: raises $6 to $9
cobrik23 has timed out
cobrik23: folds 
Uncalled bet ($6) returned to Szevasztopol
Szevasztopol collected $6 from pot
Szevasztopol: doesn't show hand 
*** SUMMARY ***
Total pot $6 | Rake $0 
Seat 1: cobrik23 (small blind) folded before Flop
Seat 2: Szevasztopol (big blind) collected ($6)
Seat 3: Muinmyheart folded before Flop (didn't bet)
Seat 4: bilukm folded before Flop (didn't bet)
Seat 6: matiko09 folded before Flop (didn't bet)
Seat 7: RICKA16 folded before Flop (didn't bet)
Seat 8: hammerwife folded before Flop (didn't bet)
Seat 9: ardo888 (button) folded before Flop (didn't bet)





PokerStars Hand #150752608183:  Hold'em No Limit ($0.50/$1.00 USD) - 2016/03/22 14:30:08 CET [2016/03/22 9:30:08 ET]
Table 'Arabis' 9-max Seat #1 is the button
Seat 1: di0d80 ($100 in chips) 
Seat 4: Painkiller72 ($185.84 in chips) 
Seat 5: matiko09 ($130.49 in chips) 
Seat 6: Ilov3NBA ($100 in chips) 
Seat 7: howsiao ($144.37 in chips) 
Seat 8: Bro_Happy ($207.36 in chips) 
Seat 9: cobrik23 ($73.15 in chips) 
Painkiller72: posts small blind $0.50
matiko09: posts big blind $1
*** HOLE CARDS ***
Dealt to matiko09 [5c 3s]
Ilov3NBA: folds 
howsiao: folds 
Bro_Happy: folds 
cobrik23: folds 
di0d80: raises $1 to $2
Painkiller72: raises $6 to $8
matiko09: folds 
di0d80: folds 
Uncalled bet ($6) returned to Painkiller72
Painkiller72 collected $5 from pot
Painkiller72: doesn't show hand 
*** SUMMARY ***
Total pot $5 | Rake $0 
Seat 1: di0d80 (button) folded before Flop
Seat 4: Painkiller72 (small blind) collected ($5)
Seat 5: matiko09 (big blind) folded before Flop
Seat 6: Ilov3NBA folded before Flop (didn't bet)
Seat 7: howsiao folded before Flop (didn't bet)
Seat 8: Bro_Happy folded before Flop (didn't bet)
Seat 9: cobrik23 folded before Flop (didn't bet)





PokerStars Hand #150752609985:  Hold'em No Limit ($0.50/$1.00 USD) - 2016/03/22 14:30:11 CET [2016/03/22 9:30:11 ET]
Table 'Polyxena' 9-max Seat #1 is the button
Seat 1: I The King I ($104.23 in chips) 
Seat 2: cobrik23 ($81.61 in chips) 
Seat 3: di0d80 ($113.76 in chips) 
Seat 4: fanmtZ ($40 in chips) 
Seat 5: MrAndMisses ($45.67 in chips) 
Seat 6: Ilov3NBA ($101.91 in chips) 
Seat 7: matiko09 ($100 in chips) 
Seat 8: kift74 ($130.72 in chips) 
Seat 9: ardo888 ($151.58 in chips) 
cobrik23: posts small blind $0.50
di0d80: posts big blind $1
*** HOLE CARDS ***
Dealt to matiko09 [2h Ac]
fanmtZ: folds 
MrAndMisses: folds 
Ilov3NBA: raises $2 to $3
matiko09: folds 
kift74: folds 
ardo888: folds 
I The King I: folds 
cobrik23: folds 
di0d80: folds 
Uncalled bet ($2) returned to Ilov3NBA
Ilov3NBA collected $2.50 from pot
Ilov3NBA: doesn't show hand 
*** SUMMARY ***
Total pot $2.50 | Rake $0 
Seat 1: I The King I (button) folded before Flop (didn't bet)
Seat 2: cobrik23 (small blind) folded before Flop
Seat 3: di0d80 (big blind) folded before Flop
Seat 4: fanmtZ folded before Flop (didn't bet)
Seat 5: MrAndMisses folded before Flop (didn't bet)
Seat 6: Ilov3NBA collected ($2.50)
Seat 7: matiko09 folded before Flop (didn't bet)
Seat 8: kift74 folded before Flop (didn't bet)
Seat 9: ardo888 folded before Flop (didn't bet)





PokerStars Hand #150752611240:  Hold'em No Limit ($1/$2 USD) - 2016/03/22 14:30:13 CET [2016/03/22 9:30:13 ET]
Table 'Deipylos' 9-max Seat #7 is the button
Seat 1: DUkalisUA ($200 in chips) 
Seat 2: N4$H ($200 in chips) 
Seat 3: KT90 ($200 in chips) 
Seat 4: Igoriah ($200 in chips) 
Seat 5: IntsAA ($192 in chips) 
Seat 6: di0d80 ($201 in chips) 
Seat 7: matiko09 ($200 in chips) 
Seat 8: luckbox6666 ($206.42 in chips) 
luckbox6666: posts small blind $1
nickreason17: is sitting out 
DUkalisUA: posts big blind $2
*** HOLE CARDS ***
Dealt to matiko09 [Ah 4s]
N4$H: folds 
nickreason17 leaves the table
KT90: folds 
Igoriah: raises $3 to $5
o.miro joins the table at seat #9 
IntsAA: folds 
di0d80: folds 
matiko09: folds 
luckbox6666: folds 
DUkalisUA: folds 
Uncalled bet ($3) returned to Igoriah
Igoriah collected $5 from pot
Igoriah: doesn't show hand 
*** SUMMARY ***
Total pot $5 | Rake $0 
Seat 1: DUkalisUA (big blind) folded before Flop
Seat 2: N4$H folded before Flop (didn't bet)
Seat 3: KT90 folded before Flop (didn't bet)
Seat 4: Igoriah collected ($5)
Seat 5: IntsAA folded before Flop (didn't bet)
Seat 6: di0d80 folded before Flop (didn't bet)
Seat 7: matiko09 (button) folded before Flop (didn't bet)
Seat 8: luckbox6666 (small blind) folded before Flop





PokerStars Hand #150752617173:  Hold'em No Limit ($0.50/$1.00 USD) - 2016/03/22 14:30:23 CET [2016/03/22 9:30:23 ET]
Table 'Colchis' 9-max Seat #8 is the button
Seat 1: theluckyjoe ($10.35 in chips) 
Seat 2: Ilov3NBA ($152.91 in chips) 
Seat 4: matiko09 ($103 in chips) 
Seat 7: Dantist1122 ($104.34 in chips) 
Seat 8: cobrik23 ($48.56 in chips) 
Seat 9: ardo888 ($100.92 in chips) 
ardo888: posts small blind $0.50
theluckyjoe: posts big blind $1
lumen21: sits out 
hammerwife: sits out 
*** HOLE CARDS ***
Dealt to matiko09 [Kc 4c]
Ilov3NBA: folds 
matiko09: folds 
Dantist1122: raises $1.70 to $2.70
cobrik23: folds 
ardo888: folds 
theluckyjoe: calls $1.70
*** FLOP *** [4d Ac 6c]
theluckyjoe: checks 
Dantist1122: bets $4.34
theluckyjoe: calls $4.34
*** TURN *** [4d Ac 6c] [3s]
theluckyjoe: bets $3.31 and is all-in
Dantist1122: calls $3.31
*** RIVER *** [4d Ac 6c 3s] [3c]
*** SHOW DOWN ***
theluckyjoe: shows [8c Tc] (a flush, Ace high)
Dantist1122: shows [9d 9c] (two pair, Nines and Threes)
theluckyjoe collected $20.25 from pot
*** SUMMARY ***
Total pot $21.20 | Rake $0.95 
Board [4d Ac 6c 3s 3c]
Seat 1: theluckyjoe (big blind) showed [8c Tc] and won ($20.25) with a flush, Ace high
Seat 2: Ilov3NBA folded before Flop (didn't bet)
Seat 4: matiko09 folded before Flop (didn't bet)
Seat 7: Dantist1122 showed [9d 9c] and lost with two pair, Nines and Threes
Seat 8: cobrik23 (button) folded before Flop (didn't bet)
Seat 9: ardo888 (small blind) folded before Flop





PokerStars Hand #150752621368:  Hold'em No Limit ($0.50/$1.00 USD) - 2016/03/22 14:30:30 CET [2016/03/22 9:30:30 ET]
Table 'Taygeta II' 9-max Seat #2 is the button
Seat 1: DevilisHEyz ($66.53 in chips) 
Seat 2: khan Erkesh ($187.06 in chips) 
Seat 3: Muinmyheart ($106.80 in chips) 
Seat 4: matiko09 ($100 in chips) 
Seat 5: RICKA16 ($102.27 in chips) 
Seat 6: I The King I ($136.91 in chips) 
Seat 7: Szevasztopol ($102.18 in chips) 
Seat 9: cobrik23 ($48.90 in chips) 
Muinmyheart: posts small blind $0.50
matiko09: posts big blind $1
*** HOLE CARDS ***
Dealt to matiko09 [7h 5s]
RICKA16: raises $2 to $3
I The King I: raises $6 to $9
Szevasztopol: folds 
cobrik23: folds 
DevilisHEyz: folds 
DevilisHEyz leaves the table
khan Erkesh: folds 
Muinmyheart: folds 
matiko09: folds 
RICKA16: calls $6
*** FLOP *** [Ts 6d Js]
RICKA16: checks 
DUkalisUA joins the table at seat #1 
Avtovo leaves the table
Effort92 joins the table at seat #8 
I The King I: bets $10
RICKA16: calls $10
*** TURN *** [Ts 6d Js] [5h]
RICKA16: checks 
I The King I: checks 
*** RIVER *** [Ts 6d Js 5h] [9d]
RICKA16: bets $28
I The King I: folds 
Uncalled bet ($28) returned to RICKA16
RICKA16 collected $37.72 from pot
RICKA16: doesn't show hand 
*** SUMMARY ***
Total pot $39.50 | Rake $1.78 
Board [Ts 6d Js 5h 9d]
Seat 1: DevilisHEyz folded before Flop (didn't bet)
Seat 2: khan Erkesh (button) folded before Flop (didn't bet)
Seat 3: Muinmyheart (small blind) folded before Flop
Seat 4: matiko09 (big blind) folded before Flop
Seat 5: RICKA16 collected ($37.72)
Seat 6: I The King I folded on the River
Seat 7: Szevasztopol folded before Flop (didn't bet)
Seat 9: cobrik23 folded before Flop (didn't bet)





PokerStars Hand #150752627161:  Hold'em No Limit ($0.50/$1.00 USD) - 2016/03/22 14:30:39 CET [2016/03/22 9:30:39 ET]
Table 'Stephano II' 9-max Seat #2 is the button
Seat 1: omorfadramou ($202.20 in chips) 
Seat 2: I The King I ($100 in chips) 
Seat 3: lombardo11 ($58.82 in chips) 
Seat 4: AWATAR 21 ($121.08 in chips) 
Seat 5: mb2part ($91.91 in chips) 
Seat 6: beterc0re ($132.59 in chips) 
Seat 7: ilaviiitech ($100 in chips) 
Seat 8: KingCastle77 ($61.42 in chips) 
Seat 9: matiko09 ($100 in chips) 
lombardo11: posts small blind $0.50
AWATAR 21: posts big blind $1
*** HOLE CARDS ***
Dealt to matiko09 [7h As]
mb2part: folds 
beterc0re: folds 
ilaviiitech: folds 
KingCastle77: calls $1
matiko09: folds 
omorfadramou: folds 
I The King I: folds 
lombardo11: folds 
AWATAR 21: checks 
*** FLOP *** [Ts Qs 9c]
AWATAR 21: checks 
KingCastle77: bets $2.39
AWATAR 21: calls $2.39
*** TURN *** [Ts Qs 9c] [Kd]
AWATAR 21: checks 
KingCastle77: bets $6.95
AWATAR 21: calls $6.95
*** RIVER *** [Ts Qs 9c Kd] [Kh]
AWATAR 21: checks 
KingCastle77: bets $20.23
AWATAR 21: calls $20.23
*** SHOW DOWN ***
KingCastle77: shows [9h 9s] (a full house, Nines full of Kings)
AWATAR 21: mucks hand 
KingCastle77 collected $58.87 from pot
*** SUMMARY ***
Total pot $61.64 | Rake $2.77 
Board [Ts Qs 9c Kd Kh]
Seat 1: omorfadramou folded before Flop (didn't bet)
Seat 2: I The King I (button) folded before Flop (didn't bet)
Seat 3: lombardo11 (small blind) folded before Flop
Seat 4: AWATAR 21 (big blind) mucked [6d Js]
Seat 5: mb2part folded before Flop (didn't bet)
Seat 6: beterc0re folded before Flop (didn't bet)
Seat 7: ilaviiitech folded before Flop (didn't bet)
Seat 8: KingCastle77 showed [9h 9s] and won ($58.87) with a full house, Nines full of Kings
Seat 9: matiko09 folded before Flop (didn't bet)





PokerStars Hand #150752632300:  Hold'em No Limit ($0.50/$1.00 USD) - 2016/03/22 14:30:47 CET [2016/03/22 9:30:47 ET]
Table 'Harding' 9-max Seat #6 is the button
Seat 1: matiko09 ($120.16 in chips) 
Seat 2: RICKA16 ($106.34 in chips) 
Seat 6: Ilov3NBA ($100 in chips) 
Seat 7: mrhighryza ($116.73 in chips) 
Seat 8: di0d80 ($120.15 in chips) 
Seat 9: omorfadramou ($104 in chips) 
mrhighryza: posts small blind $0.50
di0d80: posts big blind $1
beterc0re: sits out 
*** HOLE CARDS ***
Dealt to matiko09 [9s 3c]
omorfadramou: folds 
matiko09: folds 
RICKA16: folds 
I The King I joins the table at seat #5 
Ilov3NBA: folds 
Avtovo leaves the table
I The King I leaves the table
mrhighryza: calls $0.50
DUkalisUA joins the table at seat #3 
di0d80: checks 
*** FLOP *** [Kd As 8h]
nickreason17 joins the table at seat #5 
mrhighryza: bets $1
di0d80: folds 
Uncalled bet ($1) returned to mrhighryza
mrhighryza collected $1.91 from pot
*** SUMMARY ***
Total pot $2 | Rake $0.09 
Board [Kd As 8h]
Seat 1: matiko09 folded before Flop (didn't bet)
Seat 2: RICKA16 folded before Flop (didn't bet)
Seat 6: Ilov3NBA (button) folded before Flop (didn't bet)
Seat 7: mrhighryza (small blind) collected ($1.91)
Seat 8: di0d80 (big blind) folded on the Flop
Seat 9: omorfadramou folded before Flop (didn't bet)





PokerStars Hand #150752633511:  Hold'em No Limit ($0.50/$1.00 USD) - 2016/03/22 14:30:49 CET [2016/03/22 9:30:49 ET]
Table 'Polyxena' 9-max Seat #2 is the button
Seat 1: I The King I ($104.23 in chips) 
Seat 2: cobrik23 ($81.11 in chips) 
Seat 3: di0d80 ($112.76 in chips) 
Seat 4: fanmtZ ($40 in chips) 
Seat 5: MrAndMisses ($45.67 in chips) 
Seat 6: Ilov3NBA ($103.41 in chips) 
Seat 7: matiko09 ($100 in chips) 
Seat 8: kift74 ($130.72 in chips) 
Seat 9: ardo888 ($151.58 in chips) 
di0d80: posts small blind $0.50
fanmtZ: posts big blind $1
*** HOLE CARDS ***
Dealt to matiko09 [Qc 7h]
MrAndMisses: folds 
Ilov3NBA: folds 
matiko09: folds 
kift74: folds 
ardo888: folds 
I The King I: raises $1.50 to $2.50
cobrik23: folds 
di0d80: folds 
fanmtZ: folds 
Uncalled bet ($1.50) returned to I The King I
I The King I collected $2.50 from pot
I The King I: doesn't show hand 
*** SUMMARY ***
Total pot $2.50 | Rake $0 
Seat 1: I The King I collected ($2.50)
Seat 2: cobrik23 (button) folded before Flop (didn't bet)
Seat 3: di0d80 (small blind) folded before Flop
Seat 4: fanmtZ (big blind) folded before Flop
Seat 5: MrAndMisses folded before Flop (didn't bet)
Seat 6: Ilov3NBA folded before Flop (didn't bet)
Seat 7: matiko09 folded before Flop (didn't bet)
Seat 8: kift74 folded before Flop (didn't bet)
Seat 9: ardo888 folded before Flop (didn't bet)





PokerStars Hand #150752634113:  Hold'em No Limit ($0.50/$1.00 USD) - 2016/03/22 14:30:50 CET [2016/03/22 9:30:50 ET]
Table 'Arabis' 9-max Seat #4 is the button
Seat 1: di0d80 ($100 in chips) 
Seat 4: Painkiller72 ($188.84 in chips) 
Seat 5: matiko09 ($129.49 in chips) 
Seat 6: Ilov3NBA ($100 in chips) 
Seat 7: howsiao ($144.37 in chips) 
Seat 8: Bro_Happy ($207.36 in chips) 
Seat 9: cobrik23 ($73.15 in chips) 
matiko09: posts small blind $0.50
Ilov3NBA: posts big blind $1
lumen21: sits out 
*** HOLE CARDS ***
Dealt to matiko09 [8d Ac]
howsiao: folds 
Bro_Happy: folds 
cobrik23: raises $2 to $3
di0d80: folds 
Painkiller72: folds 
matiko09: folds 
Ilov3NBA: folds 
Uncalled bet ($2) returned to cobrik23
cobrik23 collected $2.50 from pot
cobrik23: doesn't show hand 
*** SUMMARY ***
Total pot $2.50 | Rake $0 
Seat 1: di0d80 folded before Flop (didn't bet)
Seat 4: Painkiller72 (button) folded before Flop (didn't bet)
Seat 5: matiko09 (small blind) folded before Flop
Seat 6: Ilov3NBA (big blind) folded before Flop
Seat 7: howsiao folded before Flop (didn't bet)
Seat 8: Bro_Happy folded before Flop (didn't bet)
Seat 9: cobrik23 collected ($2.50)





PokerStars Hand #150752638003:  Hold'em No Limit ($0.50/$1.00 USD) - 2016/03/22 14:30:56 CET [2016/03/22 9:30:56 ET]
Table 'Crater II' 9-max Seat #9 is the button
Seat 1: matiko09 ($133.12 in chips) 
Seat 2: Eisbaerli85 ($127.91 in chips) 
Seat 3: hammerwife ($100 in chips) 
Seat 4: fanmtZ ($41 in chips) 
Seat 6: Kobiroga150 ($43.82 in chips) 
Seat 7: AWATAR 21 ($65.48 in chips) 
Seat 8: KronosAK ($109.78 in chips) 
Seat 9: I The King I ($122.91 in chips) 
matiko09: posts small blind $0.50
Eisbaerli85: posts big blind $1
*** HOLE CARDS ***
Dealt to matiko09 [8d 9d]
hammerwife: folds 
fanmtZ: raises $1.38 to $2.38
Kobiroga150: folds 
AWATAR 21: calls $2.38
KronosAK: folds 
Avtovo leaves the table
I The King I: folds 
matiko09: folds 
Eisbaerli85: folds 
*** FLOP *** [2h 5s Tc]
fanmtZ: bets $3.63
AWATAR 21: folds 
Uncalled bet ($3.63) returned to fanmtZ
fanmtZ collected $5.98 from pot
fanmtZ: doesn't show hand 
*** SUMMARY ***
Total pot $6.26 | Rake $0.28 
Board [2h 5s Tc]
Seat 1: matiko09 (small blind) folded before Flop
Seat 2: Eisbaerli85 (big blind) folded before Flop
Seat 3: hammerwife folded before Flop (didn't bet)
Seat 4: fanmtZ collected ($5.98)
Seat 6: Kobiroga150 folded before Flop (didn't bet)
Seat 7: AWATAR 21 folded on the Flop
Seat 8: KronosAK folded before Flop (didn't bet)
Seat 9: I The King I (button) folded before Flop (didn't bet)





PokerStars Hand #150752638976:  Hold'em No Limit ($1/$2 USD) - 2016/03/22 14:30:57 CET [2016/03/22 9:30:57 ET]
Table 'Deipylos' 9-max Seat #8 is the button
Seat 1: DUkalisUA ($200 in chips) 
Seat 2: N4$H ($200 in chips) 
Seat 3: KT90 ($200 in chips) 
Seat 4: Igoriah ($203 in chips) 
Seat 5: IntsAA ($192 in chips) 
Seat 6: di0d80 ($201 in chips) 
Seat 7: matiko09 ($200 in chips) 
Seat 8: luckbox6666 ($205.42 in chips) 
o.miro will be allowed to play after the button
DUkalisUA: posts small blind $1
N4$H: posts big blind $2
*** HOLE CARDS ***
Dealt to matiko09 [3d 4c]
KT90: folds 
Igoriah: folds 
IntsAA: folds 
di0d80: folds 
matiko09: folds 
luckbox6666: folds 
DUkalisUA: folds 
Uncalled bet ($1) returned to N4$H
N4$H collected $2 from pot
N4$H: doesn't show hand 
*** SUMMARY ***
Total pot $2 | Rake $0 
Seat 1: DUkalisUA (small blind) folded before Flop
Seat 2: N4$H (big blind) collected ($2)
Seat 3: KT90 folded before Flop (didn't bet)
Seat 4: Igoriah folded before Flop (didn't bet)
Seat 5: IntsAA folded before Flop (didn't bet)
Seat 6: di0d80 folded before Flop (didn't bet)
Seat 7: matiko09 folded before Flop (didn't bet)
Seat 8: luckbox6666 (button) folded before Flop (didn't bet)





PokerStars Hand #150752640538:  Hold'em No Limit ($1/$2 USD) - 2016/03/22 14:31:00 CET [2016/03/22 9:31:00 ET]
Table 'Kiso II' 9-max Seat #3 is the button
Seat 2: di0d80 ($593.33 in chips) 
Seat 3: seouljam ($363.66 in chips) 
Seat 4: N4$H ($201 in chips) 
Seat 6: KT90 ($343.30 in chips) 
Seat 7: Igoriah ($203.01 in chips) 
Seat 8: bananajoe001 ($153.14 in chips) 
Seat 9: matiko09 ($200 in chips) 
N4$H: posts small blind $1
Ilov3NBA: is sitting out 
KT90: posts big blind $2
*** HOLE CARDS ***
Dealt to matiko09 [4h 2h]
Igoriah: folds 
bananajoe001: folds 
matiko09: folds 
di0d80: folds 
seouljam: folds 
N4$H: raises $4 to $6
KT90: folds 
Uncalled bet ($4) returned to N4$H
N4$H collected $4 from pot
N4$H: doesn't show hand 
*** SUMMARY ***
Total pot $4 | Rake $0 
Seat 2: di0d80 folded before Flop (didn't bet)
Seat 3: seouljam (button) folded before Flop (didn't bet)
Seat 4: N4$H (small blind) collected ($4)
Seat 6: KT90 (big blind) folded before Flop
Seat 7: Igoriah folded before Flop (didn't bet)
Seat 8: bananajoe001 folded before Flop (didn't bet)
Seat 9: matiko09 folded before Flop (didn't bet)





PokerStars Hand #150752645123:  Hold'em No Limit ($0.50/$1.00 USD) - 2016/03/22 14:31:07 CET [2016/03/22 9:31:07 ET]
Table 'Arabis' 9-max Seat #5 is the button
Seat 1: di0d80 ($100 in chips) 
Seat 4: Painkiller72 ($188.84 in chips) 
Seat 5: matiko09 ($128.99 in chips) 
Seat 6: Ilov3NBA ($100 in chips) 
Seat 7: howsiao ($144.37 in chips) 
Seat 8: Bro_Happy ($207.36 in chips) 
Seat 9: cobrik23 ($74.65 in chips) 
Ilov3NBA: posts small blind $0.50
howsiao: posts big blind $1
lumen21: sits out 
*** HOLE CARDS ***
Dealt to matiko09 [Js 6h]
Bro_Happy: folds 
cobrik23: raises $2 to $3
di0d80: folds 
Painkiller72: folds 
matiko09: folds 
Ilov3NBA: folds 
howsiao: raises $6.50 to $9.50
cobrik23: calls $6.50
*** FLOP *** [Qc 6c 6d]
howsiao: checks 
cobrik23: checks 
*** TURN *** [Qc 6c 6d] [2h]
howsiao: bets $18.62
cobrik23: folds 
Uncalled bet ($18.62) returned to howsiao
howsiao collected $18.62 from pot
howsiao: doesn't show hand 
*** SUMMARY ***
Total pot $19.50 | Rake $0.88 
Board [Qc 6c 6d 2h]
Seat 1: di0d80 folded before Flop (didn't bet)
Seat 4: Painkiller72 folded before Flop (didn't bet)
Seat 5: matiko09 (button) folded before Flop (didn't bet)
Seat 6: Ilov3NBA (small blind) folded before Flop
Seat 7: howsiao (big blind) collected ($18.62)
Seat 8: Bro_Happy folded before Flop (didn't bet)
Seat 9: cobrik23 folded on the Turn





PokerStars Hand #150752646075:  Hold'em No Limit ($0.50/$1.00 USD) - 2016/03/22 14:31:09 CET [2016/03/22 9:31:09 ET]
Table 'Colchis' 9-max Seat #9 is the button
Seat 1: theluckyjoe ($20.25 in chips) 
Seat 2: Ilov3NBA ($152.91 in chips) 
Seat 4: matiko09 ($103 in chips) 
Seat 7: Dantist1122 ($100 in chips) 
Seat 8: cobrik23 ($48.56 in chips) 
Seat 9: ardo888 ($100.42 in chips) 
theluckyjoe: posts small blind $0.50
Ilov3NBA: posts big blind $1
lumen21: sits out 
hammerwife: sits out 
*** HOLE CARDS ***
Dealt to matiko09 [3d Ac]
matiko09: folds 
Dantist1122: raises $2 to $3
cobrik23: folds 
ardo888: folds 
theluckyjoe: calls $2.50
Ilov3NBA: raises $9 to $12
Dantist1122: folds 
theluckyjoe: folds 
Uncalled bet ($9) returned to Ilov3NBA
Ilov3NBA collected $9 from pot
Ilov3NBA: doesn't show hand 
*** SUMMARY ***
Total pot $9 | Rake $0 
Seat 1: theluckyjoe (small blind) folded before Flop
Seat 2: Ilov3NBA (big blind) collected ($9)
Seat 4: matiko09 folded before Flop (didn't bet)
Seat 7: Dantist1122 folded before Flop
Seat 8: cobrik23 folded before Flop (didn't bet)
Seat 9: ardo888 (button) folded before Flop (didn't bet)





PokerStars Hand #150752652169:  Hold'em No Limit ($1/$2 USD) - 2016/03/22 14:31:18 CET [2016/03/22 9:31:18 ET]
Table 'Kiso II' 9-max Seat #4 is the button
Seat 2: di0d80 ($593.33 in chips) 
Seat 3: seouljam ($363.66 in chips) 
Seat 4: N4$H ($203 in chips) 
Seat 6: KT90 ($341.30 in chips) 
Seat 7: Igoriah ($203.01 in chips) 
Seat 8: bananajoe001 ($153.14 in chips) 
Seat 9: matiko09 ($200 in chips) 
KT90: posts small blind $1
Igoriah: posts big blind $2
*** HOLE CARDS ***
Dealt to matiko09 [7c Js]
Avtovo leaves the table
bananajoe001: folds 
Ilov3NBA leaves the table
Durnichka joins the table at seat #1 
matiko09: folds 
di0d80: raises $3 to $5
seouljam: folds 
IntsAA joins the table at seat #5 
N4$H: calls $5
KT90: folds 
Igoriah: folds 
*** FLOP *** [5d 2c 9h]
di0d80: checks 
Durnichka leaves the table
N4$H: checks 
*** TURN *** [5d 2c 9h] [6h]
nickreason17 joins the table at seat #1 
nickreason17 leaves the table
DUkalisUA joins the table at seat #1 
di0d80: checks 
N4$H: checks 
*** RIVER *** [5d 2c 9h 6h] [6s]
di0d80: checks 
N4$H: checks 
*** SHOW DOWN ***
di0d80: shows [As Qc] (a pair of Sixes)
N4$H: mucks hand 
di0d80 collected $12.42 from pot
*** SUMMARY ***
Total pot $13 | Rake $0.58 
Board [5d 2c 9h 6h 6s]
Seat 2: di0d80 showed [As Qc] and won ($12.42) with a pair of Sixes
Seat 3: seouljam folded before Flop (didn't bet)
Seat 4: N4$H (button) mucked [Jd Ac]
Seat 6: KT90 (small blind) folded before Flop
Seat 7: Igoriah (big blind) folded before Flop
Seat 8: bananajoe001 folded before Flop (didn't bet)
Seat 9: matiko09 folded before Flop (didn't bet)





PokerStars Hand #150752654669:  Hold'em No Limit ($1/$2 USD) - 2016/03/22 14:31:22 CET [2016/03/22 9:31:22 ET]
Table 'Deipylos' 9-max Seat #1 is the button
Seat 1: DUkalisUA ($200 in chips) 
Seat 2: N4$H ($201 in chips) 
Seat 3: KT90 ($200 in chips) 
Seat 4: Igoriah ($203 in chips) 
Seat 5: IntsAA ($192 in chips) 
Seat 6: di0d80 ($201 in chips) 
Seat 7: matiko09 ($200 in chips) 
Seat 8: luckbox6666 ($205.42 in chips) 
N4$H: posts small blind $1
KT90: posts big blind $2
o.miro: sits out 
*** HOLE CARDS ***
Dealt to matiko09 [5d 3d]
Igoriah: folds 
IntsAA: folds 
di0d80: folds 
matiko09: folds 
luckbox6666: raises $2 to $4
DUkalisUA: folds 
N4$H: folds 
KT90: folds 
Uncalled bet ($2) returned to luckbox6666
luckbox6666 collected $5 from pot
luckbox6666: doesn't show hand 
*** SUMMARY ***
Total pot $5 | Rake $0 
Seat 1: DUkalisUA (button) folded before Flop (didn't bet)
Seat 2: N4$H (small blind) folded before Flop
Seat 3: KT90 (big blind) folded before Flop
Seat 4: Igoriah folded before Flop (didn't bet)
Seat 5: IntsAA folded before Flop (didn't bet)
Seat 6: di0d80 folded before Flop (didn't bet)
Seat 7: matiko09 folded before Flop (didn't bet)
Seat 8: luckbox6666 collected ($5)





PokerStars Hand #150752658148:  Hold'em No Limit ($0.50/$1.00 USD) - 2016/03/22 14:31:28 CET [2016/03/22 9:31:28 ET]
Table 'Miranda' 9-max Seat #1 is the button
Seat 1: cobrik23 ($93.94 in chips) 
Seat 2: Szevasztopol ($118.01 in chips) 
Seat 3: Muinmyheart ($100 in chips) 
Seat 4: bilukm ($100 in chips) 
Seat 6: matiko09 ($100.90 in chips) 
Seat 7: RICKA16 ($104.50 in chips) 
Seat 8: hammerwife ($116.48 in chips) 
Seat 9: ardo888 ($166.92 in chips) 
Szevasztopol: posts small blind $0.50
Muinmyheart: posts big blind $1
*** HOLE CARDS ***
Dealt to matiko09 [Qh 3s]
bilukm: calls $1
Avtovo leaves the table
matiko09: folds 
RICKA16: folds 
hammerwife: folds 
ardo888: folds 
cobrik23: raises $4 to $5
Szevasztopol: folds 
beterc0re joins the table at seat #5 
Muinmyheart: calls $4
bilukm: folds 
*** FLOP *** [Jd Ts Qc]
Muinmyheart: checks 
cobrik23: checks 
*** TURN *** [Jd Ts Qc] [Td]
Muinmyheart: bets $5.50
cobrik23: calls $5.50
*** RIVER *** [Jd Ts Qc Td] [7c]
Muinmyheart: bets $11
cobrik23: calls $11
*** SHOW DOWN ***
Muinmyheart: shows [Qd Ac] (two pair, Queens and Tens)
cobrik23: shows [Tc 9c] (three of a kind, Tens)
cobrik23 collected $42.50 from pot
*** SUMMARY ***
Total pot $44.50 | Rake $2 
Board [Jd Ts Qc Td 7c]
Seat 1: cobrik23 (button) showed [Tc 9c] and won ($42.50) with three of a kind, Tens
Seat 2: Szevasztopol (small blind) folded before Flop
Seat 3: Muinmyheart (big blind) showed [Qd Ac] and lost with two pair, Queens and Tens
Seat 4: bilukm folded before Flop
Seat 6: matiko09 folded before Flop (didn't bet)
Seat 7: RICKA16 folded before Flop (didn't bet)
Seat 8: hammerwife folded before Flop (didn't bet)
Seat 9: ardo888 folded before Flop (didn't bet)





PokerStars Hand #150752664030:  Hold'em No Limit ($0.50/$1.00 USD) - 2016/03/22 14:31:37 CET [2016/03/22 9:31:37 ET]
Table 'Harding' 9-max Seat #7 is the button
Seat 1: matiko09 ($120.16 in chips) 
Seat 2: RICKA16 ($106.34 in chips) 
Seat 6: Ilov3NBA ($100 in chips) 
Seat 7: mrhighryza ($117.64 in chips) 
Seat 8: di0d80 ($119.15 in chips) 
Seat 9: omorfadramou ($104 in chips) 
di0d80: posts small blind $0.50
omorfadramou: posts big blind $1
DUkalisUA: sits out 
beterc0re: sits out 
nickreason17: sits out 
*** HOLE CARDS ***
Dealt to matiko09 [7c 5c]
matiko09: folds 
RICKA16: folds 
Ilov3NBA: folds 
mrhighryza: folds 
di0d80: folds 
Uncalled bet ($0.50) returned to omorfadramou
omorfadramou collected $1 from pot
omorfadramou: doesn't show hand 
*** SUMMARY ***
Total pot $1 | Rake $0 
Seat 1: matiko09 folded before Flop (didn't bet)
Seat 2: RICKA16 folded before Flop (didn't bet)
Seat 6: Ilov3NBA folded before Flop (didn't bet)
Seat 7: mrhighryza (button) folded before Flop (didn't bet)
Seat 8: di0d80 (small blind) folded before Flop
Seat 9: omorfadramou (big blind) collected ($1)





PokerStars Hand #150752667558:  Hold'em No Limit ($0.50/$1.00 USD) - 2016/03/22 14:31:43 CET [2016/03/22 9:31:43 ET]
Table 'Polyxena' 9-max Seat #3 is the button
Seat 1: I The King I ($105.73 in chips) 
Seat 2: cobrik23 ($81.11 in chips) 
Seat 3: di0d80 ($112.26 in chips) 
Seat 4: fanmtZ ($40 in chips) 
Seat 5: MrAndMisses ($45.67 in chips) 
Seat 6: Ilov3NBA ($103.41 in chips) 
Seat 7: matiko09 ($100 in chips) 
Seat 8: kift74 ($130.72 in chips) 
Seat 9: ardo888 ($151.58 in chips) 
fanmtZ: posts small blind $0.50
MrAndMisses: posts big blind $1
*** HOLE CARDS ***
Dealt to matiko09 [4s 6c]
Ilov3NBA: folds 
matiko09: folds 
kift74: raises $2 to $3
ardo888: folds 
I The King I: calls $3
cobrik23: folds 
di0d80: folds 
fanmtZ: raises $7.20 to $10.20
MrAndMisses: folds 
kift74: folds 
I The King I: folds 
Uncalled bet ($7.20) returned to fanmtZ
fanmtZ collected $10 from pot
fanmtZ: doesn't show hand 
*** SUMMARY ***
Total pot $10 | Rake $0 
Seat 1: I The King I folded before Flop
Seat 2: cobrik23 folded before Flop (didn't bet)
Seat 3: di0d80 (button) folded before Flop (didn't bet)
Seat 4: fanmtZ (small blind) collected ($10)
Seat 5: MrAndMisses (big blind) folded before Flop
Seat 6: Ilov3NBA folded before Flop (didn't bet)
Seat 7: matiko09 folded before Flop (didn't bet)
Seat 8: kift74 folded before Flop
Seat 9: ardo888 folded before Flop (didn't bet)





PokerStars Hand #150752672055:  Hold'em No Limit ($0.50/$1.00 USD) - 2016/03/22 14:31:50 CET [2016/03/22 9:31:50 ET]
Table 'Crater II' 9-max Seat #1 is the button
Seat 1: matiko09 ($132.62 in chips) 
Seat 2: Eisbaerli85 ($126.91 in chips) 
Seat 3: hammerwife ($100 in chips) 
Seat 4: fanmtZ ($44.60 in chips) 
Seat 6: Kobiroga150 ($43.82 in chips) 
Seat 7: AWATAR 21 ($63.10 in chips) 
Seat 8: KronosAK ($109.78 in chips) 
Seat 9: I The King I ($122.91 in chips) 
Eisbaerli85: posts small blind $0.50
hammerwife: posts big blind $1
*** HOLE CARDS ***
Dealt to matiko09 [2h 7s]
fanmtZ: folds 
Kobiroga150: folds 
AWATAR 21: folds 
KronosAK: folds 
I The King I: folds 
matiko09: folds 
Eisbaerli85: folds 
Uncalled bet ($0.50) returned to hammerwife
hammerwife collected $1 from pot
hammerwife: doesn't show hand 
*** SUMMARY ***
Total pot $1 | Rake $0 
Seat 1: matiko09 (button) folded before Flop (didn't bet)
Seat 2: Eisbaerli85 (small blind) folded before Flop
Seat 3: hammerwife (big blind) collected ($1)
Seat 4: fanmtZ folded before Flop (didn't bet)
Seat 6: Kobiroga150 folded before Flop (didn't bet)
Seat 7: AWATAR 21 folded before Flop (didn't bet)
Seat 8: KronosAK folded before Flop (didn't bet)
Seat 9: I The King I folded before Flop (didn't bet)





PokerStars Hand #150752673963:  Hold'em No Limit ($0.50/$1.00 USD) - 2016/03/22 14:31:53 CET [2016/03/22 9:31:53 ET]
Table 'Harding' 9-max Seat #8 is the button
Seat 1: matiko09 ($120.16 in chips) 
Seat 2: RICKA16 ($106.34 in chips) 
Seat 6: Ilov3NBA ($100 in chips) 
Seat 7: mrhighryza ($117.64 in chips) 
Seat 8: di0d80 ($118.65 in chips) 
Seat 9: omorfadramou ($104.50 in chips) 
omorfadramou: posts small blind $0.50
matiko09: posts big blind $1
DUkalisUA: sits out 
beterc0re: sits out 
nickreason17: sits out 
*** HOLE CARDS ***
Dealt to matiko09 [6h 5s]
RICKA16: raises $2 to $3
Ilov3NBA: folds 
mrhighryza: calls $3
di0d80: folds 
omorfadramou: folds 
matiko09: folds 
*** FLOP *** [Ah 3d 9s]
RICKA16: checks 
mrhighryza: checks 
*** TURN *** [Ah 3d 9s] [Ks]
RICKA16: checks 
mrhighryza: checks 
*** RIVER *** [Ah 3d 9s Ks] [Kh]
RICKA16: bets $3
mrhighryza: calls $3
*** SHOW DOWN ***
RICKA16: shows [Jc Js] (two pair, Kings and Jacks)
mrhighryza: mucks hand 
RICKA16 collected $12.89 from pot
*** SUMMARY ***
Total pot $13.50 | Rake $0.61 
Board [Ah 3d 9s Ks Kh]
Seat 1: matiko09 (big blind) folded before Flop
Seat 2: RICKA16 showed [Jc Js] and won ($12.89) with two pair, Kings and Jacks
Seat 6: Ilov3NBA folded before Flop (didn't bet)
Seat 7: mrhighryza mucked [2c 3c]
Seat 8: di0d80 (button) folded before Flop (didn't bet)
Seat 9: omorfadramou (small blind) folded before Flop





PokerStars Hand #150752676069:  Hold'em No Limit ($0.50/$1.00 USD) - 2016/03/22 14:31:56 CET [2016/03/22 9:31:56 ET]
Table 'Colchis' 9-max Seat #1 is the button
Seat 1: theluckyjoe ($17.25 in chips) 
Seat 2: Ilov3NBA ($158.91 in chips) 
Seat 4: matiko09 ($103 in chips) 
Seat 7: Dantist1122 ($100 in chips) 
Seat 8: cobrik23 ($48.56 in chips) 
Seat 9: ardo888 ($100.42 in chips) 
Ilov3NBA: posts small blind $0.50
matiko09: posts big blind $1
lumen21: sits out 
hammerwife: sits out 
*** HOLE CARDS ***
Dealt to matiko09 [8d 9c]
Dantist1122: raises $2 to $3
cobrik23: calls $3
ardo888: folds 
theluckyjoe: folds 
Ilov3NBA: folds 
matiko09: folds 
*** FLOP *** [Jc 4s 4d]
Dantist1122: checks 
cobrik23: bets $4
Dantist1122: folds 
Uncalled bet ($4) returned to cobrik23
cobrik23 collected $7.16 from pot
cobrik23: doesn't show hand 
*** SUMMARY ***
Total pot $7.50 | Rake $0.34 
Board [Jc 4s 4d]
Seat 1: theluckyjoe (button) folded before Flop (didn't bet)
Seat 2: Ilov3NBA (small blind) folded before Flop
Seat 4: matiko09 (big blind) folded before Flop
Seat 7: Dantist1122 folded on the Flop
Seat 8: cobrik23 collected ($7.16)
Seat 9: ardo888 folded before Flop (didn't bet)





PokerStars Hand #150752678684:  Hold'em No Limit ($1/$2 USD) - 2016/03/22 14:32:00 CET [2016/03/22 9:32:00 ET]
Table 'Deipylos' 9-max Seat #2 is the button
Seat 1: DUkalisUA ($200 in chips) 
Seat 2: N4$H ($200 in chips) 
Seat 3: KT90 ($198 in chips) 
Seat 4: Igoriah ($203 in chips) 
Seat 5: IntsAA ($192 in chips) 
Seat 6: di0d80 ($201 in chips) 
Seat 7: matiko09 ($200 in chips) 
Seat 8: luckbox6666 ($208.42 in chips) 
KT90: posts small blind $1
Igoriah: posts big blind $2
o.miro: sits out 
*** HOLE CARDS ***
Dealt to matiko09 [2d Ad]
IntsAA: folds 
di0d80: folds 
matiko09: folds 
luckbox6666: folds 
DUkalisUA: folds 
N4$H: folds 
KT90: raises $2 to $4
Igoriah: folds 
Uncalled bet ($2) returned to KT90
KT90 collected $4 from pot
KT90: doesn't show hand 
*** SUMMARY ***
Total pot $4 | Rake $0 
Seat 1: DUkalisUA folded before Flop (didn't bet)
Seat 2: N4$H (button) folded before Flop (didn't bet)
Seat 3: KT90 (small blind) collected ($4)
Seat 4: Igoriah (big blind) folded before Flop
Seat 5: IntsAA folded before Flop (didn't bet)
Seat 6: di0d80 folded before Flop (didn't bet)
Seat 7: matiko09 folded before Flop (didn't bet)
Seat 8: luckbox6666 folded before Flop (didn't bet)





PokerStars Hand #150752679184:  Hold'em No Limit ($0.50/$1.00 USD) - 2016/03/22 14:32:01 CET [2016/03/22 9:32:01 ET]
Table 'Taygeta II' 9-max Seat #3 is the button
Seat 2: khan Erkesh ($187.06 in chips) 
Seat 3: Muinmyheart ($106.30 in chips) 
Seat 4: matiko09 ($100 in chips) 
Seat 5: RICKA16 ($120.99 in chips) 
Seat 6: I The King I ($117.91 in chips) 
Seat 7: Szevasztopol ($102.18 in chips) 
Seat 9: cobrik23 ($48.90 in chips) 
matiko09: posts small blind $0.50
RICKA16: posts big blind $1
Effort92: sits out 
DUkalisUA: sits out 
*** HOLE CARDS ***
Dealt to matiko09 [9h Qd]
I The King I: folds 
Szevasztopol: folds 
cobrik23: folds 
khan Erkesh: raises $2 to $3
Muinmyheart: folds 
matiko09: folds 
RICKA16: calls $2
*** FLOP *** [2h Jh Tc]
RICKA16: checks 
khan Erkesh: bets $4
RICKA16: folds 
Uncalled bet ($4) returned to khan Erkesh
khan Erkesh collected $6.21 from pot
khan Erkesh: doesn't show hand 
*** SUMMARY ***
Total pot $6.50 | Rake $0.29 
Board [2h Jh Tc]
Seat 2: khan Erkesh collected ($6.21)
Seat 3: Muinmyheart (button) folded before Flop (didn't bet)
Seat 4: matiko09 (small blind) folded before Flop
Seat 5: RICKA16 (big blind) folded on the Flop
Seat 6: I The King I folded before Flop (didn't bet)
Seat 7: Szevasztopol folded before Flop (didn't bet)
Seat 9: cobrik23 folded before Flop (didn't bet)





PokerStars Hand #150752685742:  Hold'em No Limit ($0.50/$1.00 USD) - 2016/03/22 14:32:12 CET [2016/03/22 9:32:12 ET]
Table 'Stephano II' 9-max Seat #3 is the button
Seat 1: omorfadramou ($202.20 in chips) 
Seat 2: I The King I ($100 in chips) 
Seat 3: lombardo11 ($58.32 in chips) 
Seat 4: AWATAR 21 ($90.51 in chips) 
Seat 5: mb2part ($91.91 in chips) 
Seat 6: beterc0re ($132.59 in chips) 
Seat 8: KingCastle77 ($89.72 in chips) 
Seat 9: matiko09 ($100 in chips) 
AWATAR 21: posts small blind $0.50
mb2part: posts big blind $1
*** HOLE CARDS ***
Dealt to matiko09 [Ks Qh]
beterc0re: raises $2 to $3
KingCastle77: folds 
matiko09: folds 
omorfadramou: folds 
I The King I: folds 
lombardo11: folds 
AWATAR 21: calls $2.50
mb2part: folds 
*** FLOP *** [3c Ac 5s]
AWATAR 21: checks 
beterc0re: bets $4.39
AWATAR 21: calls $4.39
*** TURN *** [3c Ac 5s] [9c]
AWATAR 21: checks 
beterc0re: checks 
*** RIVER *** [3c Ac 5s 9c] [8s]
ilaviiitech leaves the table
nickreason17 joins the table at seat #7 
AWATAR 21: bets $14.50
beterc0re: folds 
Uncalled bet ($14.50) returned to AWATAR 21
AWATAR 21 collected $15.07 from pot
*** SUMMARY ***
Total pot $15.78 | Rake $0.71 
Board [3c Ac 5s 9c 8s]
Seat 1: omorfadramou folded before Flop (didn't bet)
Seat 2: I The King I folded before Flop (didn't bet)
Seat 3: lombardo11 (button) folded before Flop (didn't bet)
Seat 4: AWATAR 21 (small blind) collected ($15.07)
Seat 5: mb2part (big blind) folded before Flop
Seat 6: beterc0re folded on the River
Seat 8: KingCastle77 folded before Flop (didn't bet)
Seat 9: matiko09 folded before Flop (didn't bet)





PokerStars Hand #150752687631:  Hold'em No Limit ($0.50/$1.00 USD) - 2016/03/22 14:32:15 CET [2016/03/22 9:32:15 ET]
Table 'Arabis' 9-max Seat #6 is the button
Seat 1: di0d80 ($100 in chips) 
Seat 4: Painkiller72 ($188.84 in chips) 
Seat 5: matiko09 ($128.99 in chips) 
Seat 6: Ilov3NBA ($100 in chips) 
Seat 7: howsiao ($153.49 in chips) 
Seat 8: Bro_Happy ($207.36 in chips) 
Seat 9: cobrik23 ($65.15 in chips) 
howsiao: posts small blind $0.50
Bro_Happy: posts big blind $1
lumen21: sits out 
*** HOLE CARDS ***
Dealt to matiko09 [8h 9d]
cobrik23: folds 
di0d80: raises $1.50 to $2.50
Painkiller72: folds 
matiko09: folds 
Ilov3NBA: folds 
howsiao: raises $6 to $8.50
Bro_Happy: folds 
di0d80: raises $13.50 to $22
howsiao: folds [7c 7h]
Uncalled bet ($13.50) returned to di0d80
di0d80 collected $18 from pot
di0d80: doesn't show hand 
*** SUMMARY ***
Total pot $18 | Rake $0 
Seat 1: di0d80 collected ($18)
Seat 4: Painkiller72 folded before Flop (didn't bet)
Seat 5: matiko09 folded before Flop (didn't bet)
Seat 6: Ilov3NBA (button) folded before Flop (didn't bet)
Seat 7: howsiao (small blind) folded before Flop
Seat 8: Bro_Happy (big blind) folded before Flop
Seat 9: cobrik23 folded before Flop (didn't bet)





PokerStars Hand #150752691522:  Hold'em No Limit ($0.50/$1.00 USD) - 2016/03/22 14:32:21 CET [2016/03/22 9:32:21 ET]
Table 'Crater II' 9-max Seat #2 is the button
Seat 1: matiko09 ($132.62 in chips) 
Seat 2: Eisbaerli85 ($126.41 in chips) 
Seat 3: hammerwife ($100.50 in chips) 
Seat 4: fanmtZ ($44.60 in chips) 
Seat 6: Kobiroga150 ($43.82 in chips) 
Seat 7: AWATAR 21 ($63.10 in chips) 
Seat 8: KronosAK ($109.78 in chips) 
Seat 9: I The King I ($122.91 in chips) 
hammerwife: posts small blind $0.50
fanmtZ: posts big blind $1
*** HOLE CARDS ***
Dealt to matiko09 [6h Qc]
Kobiroga150: folds 
AWATAR 21: folds 
KronosAK: folds 
I The King I: raises $2 to $3
matiko09: folds 
Eisbaerli85: folds 
hammerwife: folds 
fanmtZ: folds 
Uncalled bet ($2) returned to I The King I
I The King I collected $2.50 from pot
I The King I: doesn't show hand 
*** SUMMARY ***
Total pot $2.50 | Rake $0 
Seat 1: matiko09 folded before Flop (didn't bet)
Seat 2: Eisbaerli85 (button) folded before Flop (didn't bet)
Seat 3: hammerwife (small blind) folded before Flop
Seat 4: fanmtZ (big blind) folded before Flop
Seat 6: Kobiroga150 folded before Flop (didn't bet)
Seat 7: AWATAR 21 folded before Flop (didn't bet)
Seat 8: KronosAK folded before Flop (didn't bet)
Seat 9: I The King I collected ($2.50)





PokerStars Hand #150752695419:  Hold'em No Limit ($0.50/$1.00 USD) - 2016/03/22 14:32:27 CET [2016/03/22 9:32:27 ET]
Table 'Colchis' 9-max Seat #2 is the button
Seat 1: theluckyjoe ($17.25 in chips) 
Seat 2: Ilov3NBA ($158.41 in chips) 
Seat 4: matiko09 ($102 in chips) 
Seat 5: lumen21 ($158.30 in chips) 
Seat 7: Dantist1122 ($100 in chips) 
Seat 8: cobrik23 ($52.72 in chips) 
Seat 9: ardo888 ($100.42 in chips) 
matiko09: posts small blind $0.50
lumen21: posts big blind $1
hammerwife: sits out 
*** HOLE CARDS ***
Dealt to matiko09 [8c 7c]
Dantist1122: folds 
cobrik23: raises $1 to $2
ardo888: folds 
theluckyjoe: folds 
Ilov3NBA: folds 
matiko09: folds 
lumen21: raises $6 to $8
cobrik23: folds 
Uncalled bet ($6) returned to lumen21
lumen21 collected $4.50 from pot
lumen21: doesn't show hand 
*** SUMMARY ***
Total pot $4.50 | Rake $0 
Seat 1: theluckyjoe folded before Flop (didn't bet)
Seat 2: Ilov3NBA (button) folded before Flop (didn't bet)
Seat 4: matiko09 (small blind) folded before Flop
Seat 5: lumen21 (big blind) collected ($4.50)
Seat 7: Dantist1122 folded before Flop (didn't bet)
Seat 8: cobrik23 folded before Flop
Seat 9: ardo888 folded before Flop (didn't bet)





PokerStars Hand #150752701498:  Hold'em No Limit ($0.50/$1.00 USD) - 2016/03/22 14:32:37 CET [2016/03/22 9:32:37 ET]
Table 'Harding' 9-max Seat #9 is the button
Seat 1: matiko09 ($119.16 in chips) 
Seat 2: RICKA16 ($113.23 in chips) 
Seat 6: Ilov3NBA ($100 in chips) 
Seat 7: mrhighryza ($111.64 in chips) 
Seat 8: di0d80 ($118.65 in chips) 
Seat 9: omorfadramou ($104 in chips) 
matiko09: posts small blind $0.50
RICKA16: posts big blind $1
DUkalisUA: sits out 
beterc0re: sits out 
nickreason17: sits out 
*** HOLE CARDS ***
Dealt to matiko09 [7s Js]
Ilov3NBA: raises $2 to $3
mrhighryza: folds 
di0d80: folds 
omorfadramou: folds 
matiko09: folds 
RICKA16: folds 
Uncalled bet ($2) returned to Ilov3NBA
Ilov3NBA collected $2.50 from pot
Ilov3NBA: doesn't show hand 
*** SUMMARY ***
Total pot $2.50 | Rake $0 
Seat 1: matiko09 (small blind) folded before Flop
Seat 2: RICKA16 (big blind) folded before Flop
Seat 6: Ilov3NBA collected ($2.50)
Seat 7: mrhighryza folded before Flop (didn't bet)
Seat 8: di0d80 folded before Flop (didn't bet)
Seat 9: omorfadramou (button) folded before Flop (didn't bet)





PokerStars Hand #150752703575:  Hold'em No Limit ($0.50/$1.00 USD) - 2016/03/22 14:32:40 CET [2016/03/22 9:32:40 ET]
Table 'Crater II' 9-max Seat #3 is the button
Seat 1: matiko09 ($132.62 in chips) 
Seat 2: Eisbaerli85 ($126.41 in chips) 
Seat 3: hammerwife ($100 in chips) 
Seat 4: fanmtZ ($43.60 in chips) 
Seat 6: Kobiroga150 ($43.82 in chips) 
Seat 7: AWATAR 21 ($63.10 in chips) 
Seat 8: KronosAK ($109.78 in chips) 
Seat 9: I The King I ($124.41 in chips) 
fanmtZ: posts small blind $0.50
Kobiroga150: posts big blind $1
*** HOLE CARDS ***
Dealt to matiko09 [Qd 8d]
nickreason17 joins the table at seat #5 
AWATAR 21: raises $1 to $2
KronosAK: folds 
I The King I: folds 
matiko09: folds 
Eisbaerli85: folds 
hammerwife: folds 
fanmtZ: folds 
Kobiroga150: folds 
Uncalled bet ($1) returned to AWATAR 21
AWATAR 21 collected $2.50 from pot
*** SUMMARY ***
Total pot $2.50 | Rake $0 
Seat 1: matiko09 folded before Flop (didn't bet)
Seat 2: Eisbaerli85 folded before Flop (didn't bet)
Seat 3: hammerwife (button) folded before Flop (didn't bet)
Seat 4: fanmtZ (small blind) folded before Flop
Seat 6: Kobiroga150 (big blind) folded before Flop
Seat 7: AWATAR 21 collected ($2.50)
Seat 8: KronosAK folded before Flop (didn't bet)
Seat 9: I The King I folded before Flop (didn't bet)





PokerStars Hand #150752706384:  Hold'em No Limit ($0.50/$1.00 USD) - 2016/03/22 14:32:44 CET [2016/03/22 9:32:44 ET]
Table 'Polyxena' 9-max Seat #4 is the button
Seat 1: I The King I ($102.73 in chips) 
Seat 2: cobrik23 ($81.11 in chips) 
Seat 3: di0d80 ($112.26 in chips) 
Seat 4: fanmtZ ($47 in chips) 
Seat 5: MrAndMisses ($44.67 in chips) 
Seat 6: Ilov3NBA ($103.41 in chips) 
Seat 7: matiko09 ($100 in chips) 
Seat 8: kift74 ($127.72 in chips) 
Seat 9: ardo888 ($151.58 in chips) 
MrAndMisses: posts small blind $0.50
Ilov3NBA: posts big blind $1
*** HOLE CARDS ***
Dealt to matiko09 [3h Qh]
matiko09: folds 
kift74: folds 
ardo888: folds 
I The King I: folds 
cobrik23: folds 
di0d80: folds 
fanmtZ: folds 
MrAndMisses: folds 
Uncalled bet ($0.50) returned to Ilov3NBA
Ilov3NBA collected $1 from pot
Ilov3NBA: doesn't show hand 
*** SUMMARY ***
Total pot $1 | Rake $0 
Seat 1: I The King I folded before Flop (didn't bet)
Seat 2: cobrik23 folded before Flop (didn't bet)
Seat 3: di0d80 folded before Flop (didn't bet)
Seat 4: fanmtZ (button) folded before Flop (didn't bet)
Seat 5: MrAndMisses (small blind) folded before Flop
Seat 6: Ilov3NBA (big blind) collected ($1)
Seat 7: matiko09 folded before Flop (didn't bet)
Seat 8: kift74 folded before Flop (didn't bet)
Seat 9: ardo888 folded before Flop (didn't bet)





PokerStars Hand #150752707631:  Hold'em No Limit ($1/$2 USD) - 2016/03/22 14:32:46 CET [2016/03/22 9:32:46 ET]
Table 'Deipylos' 9-max Seat #3 is the button
Seat 1: DUkalisUA ($200 in chips) 
Seat 2: N4$H ($200 in chips) 
Seat 3: KT90 ($200 in chips) 
Seat 4: Igoriah ($201 in chips) 
Seat 5: IntsAA ($192 in chips) 
Seat 6: di0d80 ($201 in chips) 
Seat 7: matiko09 ($200 in chips) 
Seat 8: luckbox6666 ($208.42 in chips) 
Igoriah: posts small blind $1
IntsAA: posts big blind $2
o.miro: sits out 
*** HOLE CARDS ***
Dealt to matiko09 [6c Qh]
di0d80: folds 
matiko09: folds 
luckbox6666: folds 
DUkalisUA: folds 
N4$H: folds 
KT90: folds 
Igoriah: folds 
Uncalled bet ($1) returned to IntsAA
IntsAA collected $2 from pot
IntsAA: doesn't show hand 
*** SUMMARY ***
Total pot $2 | Rake $0 
Seat 1: DUkalisUA folded before Flop (didn't bet)
Seat 2: N4$H folded before Flop (didn't bet)
Seat 3: KT90 (button) folded before Flop (didn't bet)
Seat 4: Igoriah (small blind) folded before Flop
Seat 5: IntsAA (big blind) collected ($2)
Seat 6: di0d80 folded before Flop (didn't bet)
Seat 7: matiko09 folded before Flop (didn't bet)
Seat 8: luckbox6666 folded before Flop (didn't bet)





PokerStars Hand #150752709206:  Hold'em No Limit ($0.50/$1.00 USD) - 2016/03/22 14:32:49 CET [2016/03/22 9:32:49 ET]
Table 'Taygeta II' 9-max Seat #4 is the button
Seat 2: khan Erkesh ($190.27 in chips) 
Seat 3: Muinmyheart ($106.30 in chips) 
Seat 4: matiko09 ($100 in chips) 
Seat 5: RICKA16 ($117.99 in chips) 
Seat 6: I The King I ($117.91 in chips) 
Seat 7: Szevasztopol ($102.18 in chips) 
Seat 9: cobrik23 ($48.90 in chips) 
RICKA16: posts small blind $0.50
I The King I: posts big blind $1
Effort92: sits out 
DUkalisUA: sits out 
*** HOLE CARDS ***
Dealt to matiko09 [Ks Js]
Szevasztopol: folds 
cobrik23: raises $2 to $3
khan Erkesh: calls $3
Muinmyheart: folds 
matiko09: calls $3
RICKA16: folds 
I The King I: folds 
*** FLOP *** [4d 3d 8d]
cobrik23: checks 
khan Erkesh: bets $7
matiko09: folds 
cobrik23: folds 
Uncalled bet ($7) returned to khan Erkesh
khan Erkesh collected $10.03 from pot
khan Erkesh: doesn't show hand 
*** SUMMARY ***
Total pot $10.50 | Rake $0.47 
Board [4d 3d 8d]
Seat 2: khan Erkesh collected ($10.03)
Seat 3: Muinmyheart folded before Flop (didn't bet)
Seat 4: matiko09 (button) folded on the Flop
Seat 5: RICKA16 (small blind) folded before Flop
Seat 6: I The King I (big blind) folded before Flop
Seat 7: Szevasztopol folded before Flop (didn't bet)
Seat 9: cobrik23 folded on the Flop





PokerStars Hand #150752718002:  Hold'em No Limit ($0.50/$1.00 USD) - 2016/03/22 14:33:03 CET [2016/03/22 9:33:03 ET]
Table 'Crater II' 9-max Seat #4 is the button
Seat 1: matiko09 ($132.62 in chips) 
Seat 2: Eisbaerli85 ($126.41 in chips) 
Seat 3: hammerwife ($100 in chips) 
Seat 4: fanmtZ ($43.10 in chips) 
Seat 6: Kobiroga150 ($42.82 in chips) 
Seat 7: AWATAR 21 ($64.60 in chips) 
Seat 8: KronosAK ($109.78 in chips) 
Seat 9: I The King I ($124.41 in chips) 
nickreason17 will be allowed to play after the button
Kobiroga150: posts small blind $0.50
AWATAR 21: posts big blind $1
*** HOLE CARDS ***
Dealt to matiko09 [5s Tc]
KronosAK: folds 
I The King I: folds 
matiko09: folds 
Eisbaerli85: folds 
hammerwife: raises $1.50 to $2.50
fanmtZ: folds 
Kobiroga150: calls $2
AWATAR 21: folds 
*** FLOP *** [8h Jd 4h]
Kobiroga150: checks 
hammerwife: bets $3.50
Kobiroga150: raises $3.50 to $7
hammerwife: calls $3.50
*** TURN *** [8h Jd 4h] [2h]
Kobiroga150: bets $8
hammerwife: calls $8
*** RIVER *** [8h Jd 4h 2h] [Jc]
Kobiroga150: bets $25.32 and is all-in
hammerwife: calls $25.32
*** SHOW DOWN ***
Kobiroga150: shows [Th Kh] (a flush, King high)
hammerwife: mucks hand 
Kobiroga150 collected $83.84 from pot
*** SUMMARY ***
Total pot $86.64 | Rake $2.80 
Board [8h Jd 4h 2h Jc]
Seat 1: matiko09 folded before Flop (didn't bet)
Seat 2: Eisbaerli85 folded before Flop (didn't bet)
Seat 3: hammerwife mucked [7h 9h]
Seat 4: fanmtZ (button) folded before Flop (didn't bet)
Seat 6: Kobiroga150 (small blind) showed [Th Kh] and won ($83.84) with a flush, King high
Seat 7: AWATAR 21 (big blind) folded before Flop
Seat 8: KronosAK folded before Flop (didn't bet)
Seat 9: I The King I folded before Flop (didn't bet)





PokerStars Hand #150752719697:  Hold'em No Limit ($0.50/$1.00 USD) - 2016/03/22 14:33:05 CET [2016/03/22 9:33:05 ET]
Table 'Miranda' 9-max Seat #2 is the button
Seat 1: cobrik23 ($114.94 in chips) 
Seat 2: Szevasztopol ($117.51 in chips) 
Seat 3: Muinmyheart ($100 in chips) 
Seat 4: bilukm ($99 in chips) 
Seat 6: matiko09 ($100.90 in chips) 
Seat 7: RICKA16 ($104.50 in chips) 
Seat 8: hammerwife ($116.48 in chips) 
Seat 9: ardo888 ($166.92 in chips) 
Muinmyheart: posts small blind $0.50
bilukm: posts big blind $1
beterc0re: sits out 
*** HOLE CARDS ***
Dealt to matiko09 [5s 9h]
matiko09: folds 
RICKA16 has timed out
RICKA16: folds 
hammerwife: folds 
ardo888: folds 
cobrik23: folds 
Szevasztopol: folds 
Muinmyheart: folds 
Uncalled bet ($0.50) returned to bilukm
bilukm collected $1 from pot
bilukm: doesn't show hand 
*** SUMMARY ***
Total pot $1 | Rake $0 
Seat 1: cobrik23 folded before Flop (didn't bet)
Seat 2: Szevasztopol (button) folded before Flop (didn't bet)
Seat 3: Muinmyheart (small blind) folded before Flop
Seat 4: bilukm (big blind) collected ($1)
Seat 6: matiko09 folded before Flop (didn't bet)
Seat 7: RICKA16 folded before Flop (didn't bet)
Seat 8: hammerwife folded before Flop (didn't bet)
Seat 9: ardo888 folded before Flop (didn't bet)





PokerStars Hand #150752726756:  Hold'em No Limit ($0.50/$1.00 USD) - 2016/03/22 14:33:17 CET [2016/03/22 9:33:17 ET]
Table 'Colchis' 9-max Seat #4 is the button
Seat 1: theluckyjoe ($17.25 in chips) 
Seat 2: Ilov3NBA ($158.41 in chips) 
Seat 4: matiko09 ($101.50 in chips) 
Seat 5: lumen21 ($160.80 in chips) 
Seat 6: hammerwife ($100 in chips) 
Seat 7: Dantist1122 ($100 in chips) 
Seat 8: cobrik23 ($50.72 in chips) 
Seat 9: ardo888 ($100.42 in chips) 
lumen21: posts small blind $0.50
hammerwife: posts big blind $1
*** HOLE CARDS ***
Dealt to matiko09 [2c 9c]
Dantist1122: folds 
cobrik23: folds 
ardo888: folds 
theluckyjoe: folds 
Ilov3NBA: folds 
matiko09: folds 
lumen21: raises $2 to $3
hammerwife: calls $2
*** FLOP *** [Kc 7c 3d]
lumen21: checks 
hammerwife: checks 
*** TURN *** [Kc 7c 3d] [Jd]
lumen21: checks 
hammerwife: checks 
*** RIVER *** [Kc 7c 3d Jd] [5c]
lumen21: checks 
hammerwife: checks 
*** SHOW DOWN ***
lumen21: shows [8h 8c] (a pair of Eights)
hammerwife: mucks hand 
lumen21 collected $5.73 from pot
*** SUMMARY ***
Total pot $6 | Rake $0.27 
Board [Kc 7c 3d Jd 5c]
Seat 1: theluckyjoe folded before Flop (didn't bet)
Seat 2: Ilov3NBA folded before Flop (didn't bet)
Seat 4: matiko09 (button) folded before Flop (didn't bet)
Seat 5: lumen21 (small blind) showed [8h 8c] and won ($5.73) with a pair of Eights
Seat 6: hammerwife (big blind) mucked [Ah Qh]
Seat 7: Dantist1122 folded before Flop (didn't bet)
Seat 8: cobrik23 folded before Flop (didn't bet)
Seat 9: ardo888 folded before Flop (didn't bet)





PokerStars Hand #150752726642:  Hold'em No Limit ($0.50/$1.00 USD) - 2016/03/22 14:33:17 CET [2016/03/22 9:33:17 ET]
Table 'Polyxena' 9-max Seat #5 is the button
Seat 1: I The King I ($102.73 in chips) 
Seat 2: cobrik23 ($81.11 in chips) 
Seat 3: di0d80 ($112.26 in chips) 
Seat 4: fanmtZ ($47 in chips) 
Seat 5: MrAndMisses ($44.17 in chips) 
Seat 6: Ilov3NBA ($103.91 in chips) 
Seat 7: matiko09 ($100 in chips) 
Seat 8: kift74 ($127.72 in chips) 
Seat 9: ardo888 ($151.58 in chips) 
Ilov3NBA: posts small blind $0.50
matiko09: posts big blind $1
*** HOLE CARDS ***
Dealt to matiko09 [8c 3s]
kift74: folds 
ardo888: folds 
I The King I: folds 
cobrik23: raises $2 to $3
di0d80: folds 
fanmtZ: folds 
MrAndMisses: folds 
Ilov3NBA: folds 
matiko09: folds 
Uncalled bet ($2) returned to cobrik23
cobrik23 collected $2.50 from pot
cobrik23: doesn't show hand 
*** SUMMARY ***
Total pot $2.50 | Rake $0 
Seat 1: I The King I folded before Flop (didn't bet)
Seat 2: cobrik23 collected ($2.50)
Seat 3: di0d80 folded before Flop (didn't bet)
Seat 4: fanmtZ folded before Flop (didn't bet)
Seat 5: MrAndMisses (button) folded before Flop (didn't bet)
Seat 6: Ilov3NBA (small blind) folded before Flop
Seat 7: matiko09 (big blind) folded before Flop
Seat 8: kift74 folded before Flop (didn't bet)
Seat 9: ardo888 folded before Flop (didn't bet)





PokerStars Hand #150752728476:  Hold'em No Limit ($0.50/$1.00 USD) - 2016/03/22 14:33:19 CET [2016/03/22 9:33:19 ET]
Table 'Arabis' 9-max Seat #7 is the button
Seat 1: di0d80 ($109.50 in chips) 
Seat 4: Painkiller72 ($188.84 in chips) 
Seat 5: matiko09 ($128.99 in chips) 
Seat 6: Ilov3NBA ($100 in chips) 
Seat 7: howsiao ($144.99 in chips) 
Seat 8: Bro_Happy ($206.36 in chips) 
Seat 9: cobrik23 ($65.15 in chips) 
Bro_Happy: posts small blind $0.50
cobrik23: posts big blind $1
lumen21: sits out 
*** HOLE CARDS ***
Dealt to matiko09 [9c 2h]
di0d80: folds 
ilaviiitech leaves the table
I The King I joins the table at seat #2 
Painkiller72: folds 
matiko09: folds 
Ilov3NBA: folds 
howsiao: calls $1
Bro_Happy: folds 
I The King I leaves the table
hammerwife joins the table at seat #2 
cobrik23: checks 
*** FLOP *** [9h 3d 9d]
cobrik23: checks 
howsiao: bets $2.39
cobrik23: folds 
Uncalled bet ($2.39) returned to howsiao
howsiao collected $2.39 from pot
howsiao: doesn't show hand 
*** SUMMARY ***
Total pot $2.50 | Rake $0.11 
Board [9h 3d 9d]
Seat 1: di0d80 folded before Flop (didn't bet)
Seat 4: Painkiller72 folded before Flop (didn't bet)
Seat 5: matiko09 folded before Flop (didn't bet)
Seat 6: Ilov3NBA folded before Flop (didn't bet)
Seat 7: howsiao (button) collected ($2.39)
Seat 8: Bro_Happy (small blind) folded before Flop
Seat 9: cobrik23 (big blind) folded on the Flop





PokerStars Hand #150752732200:  Hold'em No Limit ($1/$2 USD) - 2016/03/22 14:33:25 CET [2016/03/22 9:33:25 ET]
Table 'Kiso II' 9-max Seat #6 is the button
Seat 2: di0d80 ($600.75 in chips) 
Seat 3: seouljam ($363.66 in chips) 
Seat 4: N4$H ($200 in chips) 
Seat 6: KT90 ($340.30 in chips) 
Seat 7: Igoriah ($201.01 in chips) 
Seat 8: bananajoe001 ($153.14 in chips) 
Seat 9: matiko09 ($200 in chips) 
Igoriah: posts small blind $1
bananajoe001: posts big blind $2
DUkalisUA: sits out 
IntsAA: sits out 
*** HOLE CARDS ***
Dealt to matiko09 [Tc 5h]
matiko09: folds 
di0d80: folds 
seouljam: folds 
N4$H: folds 
KT90: folds 
Igoriah: folds 
Uncalled bet ($1) returned to bananajoe001
bananajoe001 collected $2 from pot
bananajoe001: doesn't show hand 
*** SUMMARY ***
Total pot $2 | Rake $0 
Seat 2: di0d80 folded before Flop (didn't bet)
Seat 3: seouljam folded before Flop (didn't bet)
Seat 4: N4$H folded before Flop (didn't bet)
Seat 6: KT90 (button) folded before Flop (didn't bet)
Seat 7: Igoriah (small blind) folded before Flop
Seat 8: bananajoe001 (big blind) collected ($2)
Seat 9: matiko09 folded before Flop (didn't bet)





PokerStars Hand #150752739826:  Hold'em No Limit ($0.50/$1.00 USD) - 2016/03/22 14:33:38 CET [2016/03/22 9:33:38 ET]
Table 'Harding' 9-max Seat #1 is the button
Seat 1: matiko09 ($118.66 in chips) 
Seat 2: RICKA16 ($112.23 in chips) 
Seat 3: DUkalisUA ($100 in chips) 
Seat 6: Ilov3NBA ($101.50 in chips) 
Seat 7: mrhighryza ($111.64 in chips) 
Seat 8: di0d80 ($118.65 in chips) 
Seat 9: omorfadramou ($104 in chips) 
RICKA16: posts small blind $0.50
DUkalisUA: posts big blind $1
beterc0re: sits out 
nickreason17: sits out 
*** HOLE CARDS ***
Dealt to matiko09 [6h Ad]
Ilov3NBA: folds 
mrhighryza: folds 
di0d80: folds 
omorfadramou: folds 
matiko09: raises $1.27 to $2.27
RICKA16: calls $1.77
DUkalisUA: folds 
*** FLOP *** [9d Jd 6c]
RICKA16: checks 
matiko09: checks 
*** TURN *** [9d Jd 6c] [Tc]
RICKA16: bets $3
matiko09: folds 
Uncalled bet ($3) returned to RICKA16
RICKA16 collected $5.29 from pot
RICKA16: doesn't show hand 
*** SUMMARY ***
Total pot $5.54 | Rake $0.25 
Board [9d Jd 6c Tc]
Seat 1: matiko09 (button) folded on the Turn
Seat 2: RICKA16 (small blind) collected ($5.29)
Seat 3: DUkalisUA (big blind) folded before Flop
Seat 6: Ilov3NBA folded before Flop (didn't bet)
Seat 7: mrhighryza folded before Flop (didn't bet)
Seat 8: di0d80 folded before Flop (didn't bet)
Seat 9: omorfadramou folded before Flop (didn't bet)





PokerStars Hand #150752740165:  Hold'em No Limit ($0.50/$1.00 USD) - 2016/03/22 14:33:38 CET [2016/03/22 9:33:38 ET]
Table 'Miranda' 9-max Seat #3 is the button
Seat 1: cobrik23 ($114.94 in chips) 
Seat 2: Szevasztopol ($117.51 in chips) 
Seat 3: Muinmyheart ($100 in chips) 
Seat 4: bilukm ($99.50 in chips) 
Seat 5: beterc0re ($100 in chips) 
Seat 6: matiko09 ($100.90 in chips) 
Seat 8: hammerwife ($116.48 in chips) 
Seat 9: ardo888 ($166.92 in chips) 
bilukm: posts small blind $0.50
beterc0re: posts big blind $1
*** HOLE CARDS ***
Dealt to matiko09 [Tc 2h]
matiko09: folds 
hammerwife: folds 
ardo888: folds 
cobrik23: folds 
Szevasztopol: folds 
Muinmyheart: raises $1.50 to $2.50
bilukm: folds 
beterc0re: raises $7.50 to $10
Muinmyheart: folds 
Uncalled bet ($7.50) returned to beterc0re
beterc0re collected $5.50 from pot
beterc0re: doesn't show hand 
*** SUMMARY ***
Total pot $5.50 | Rake $0 
Seat 1: cobrik23 folded before Flop (didn't bet)
Seat 2: Szevasztopol folded before Flop (didn't bet)
Seat 3: Muinmyheart (button) folded before Flop
Seat 4: bilukm (small blind) folded before Flop
Seat 5: beterc0re (big blind) collected ($5.50)
Seat 6: matiko09 folded before Flop (didn't bet)
Seat 8: hammerwife folded before Flop (didn't bet)
Seat 9: ardo888 folded before Flop (didn't bet)





PokerStars Hand #150752749103:  Hold'em No Limit ($0.50/$1.00 USD) - 2016/03/22 14:33:52 CET [2016/03/22 9:33:52 ET]
Table 'Polyxena' 9-max Seat #6 is the button
Seat 1: I The King I ($102.73 in chips) 
Seat 2: cobrik23 ($82.61 in chips) 
Seat 3: di0d80 ($112.26 in chips) 
Seat 4: fanmtZ ($47 in chips) 
Seat 5: MrAndMisses ($44.17 in chips) 
Seat 6: Ilov3NBA ($103.41 in chips) 
Seat 7: matiko09 ($100 in chips) 
Seat 8: kift74 ($127.72 in chips) 
Seat 9: ardo888 ($151.58 in chips) 
matiko09: posts small blind $0.50
kift74: posts big blind $1
*** HOLE CARDS ***
Dealt to matiko09 [Kd 4c]
ardo888: raises $2 to $3
I The King I: folds 
cobrik23: calls $3
di0d80: folds 
fanmtZ: calls $3
MrAndMisses: folds 
Ilov3NBA: folds 
matiko09: folds 
kift74: calls $2
*** FLOP *** [9s Jc 3d]
kift74: checks 
ardo888: checks 
cobrik23: checks 
fanmtZ: bets $6.63
kift74: folds 
ardo888: folds 
cobrik23: folds 
Uncalled bet ($6.63) returned to fanmtZ
fanmtZ collected $11.94 from pot
fanmtZ: doesn't show hand 
*** SUMMARY ***
Total pot $12.50 | Rake $0.56 
Board [9s Jc 3d]
Seat 1: I The King I folded before Flop (didn't bet)
Seat 2: cobrik23 folded on the Flop
Seat 3: di0d80 folded before Flop (didn't bet)
Seat 4: fanmtZ collected ($11.94)
Seat 5: MrAndMisses folded before Flop (didn't bet)
Seat 6: Ilov3NBA (button) folded before Flop (didn't bet)
Seat 7: matiko09 (small blind) folded before Flop
Seat 8: kift74 (big blind) folded on the Flop
Seat 9: ardo888 folded on the Flop





PokerStars Hand #150752755417:  Hold'em No Limit ($0.50/$1.00 USD) - 2016/03/22 14:34:02 CET [2016/03/22 9:34:02 ET]
Table 'Stephano II' 9-max Seat #4 is the button
Seat 1: omorfadramou ($202.20 in chips) 
Seat 2: I The King I ($100 in chips) 
Seat 3: lombardo11 ($58.32 in chips) 
Seat 4: AWATAR 21 ($98.19 in chips) 
Seat 5: mb2part ($90.91 in chips) 
Seat 6: beterc0re ($125.20 in chips) 
Seat 8: KingCastle77 ($89.72 in chips) 
Seat 9: matiko09 ($100 in chips) 
mb2part: posts small blind $0.50
beterc0re: posts big blind $1
nickreason17: sits out 
*** HOLE CARDS ***
Dealt to matiko09 [Ts 3h]
KingCastle77: folds 
matiko09: folds 
omorfadramou: folds 
I The King I: folds 
lombardo11: folds 
AWATAR 21: raises $1.50 to $2.50
mb2part: folds 
beterc0re: raises $7.50 to $10
AWATAR 21: raises $88.19 to $98.19 and is all-in
beterc0re: calls $88.19
*** FLOP *** [3c 5s Qs]
*** TURN *** [3c 5s Qs] [Tc]
*** RIVER *** [3c 5s Qs Tc] [Ah]
*** SHOW DOWN ***
beterc0re: shows [Jd Js] (a pair of Jacks)
AWATAR 21: shows [Ad Kh] (a pair of Aces)
AWATAR 21 collected $194.08 from pot
*** SUMMARY ***
Total pot $196.88 | Rake $2.80 
Board [3c 5s Qs Tc Ah]
Seat 1: omorfadramou folded before Flop (didn't bet)
Seat 2: I The King I folded before Flop (didn't bet)
Seat 3: lombardo11 folded before Flop (didn't bet)
Seat 4: AWATAR 21 (button) showed [Ad Kh] and won ($194.08) with a pair of Aces
Seat 5: mb2part (small blind) folded before Flop
Seat 6: beterc0re (big blind) showed [Jd Js] and lost with a pair of Jacks
Seat 8: KingCastle77 folded before Flop (didn't bet)
Seat 9: matiko09 folded before Flop (didn't bet)





PokerStars Hand #150752756272:  Hold'em No Limit ($1/$2 USD) - 2016/03/22 14:34:04 CET [2016/03/22 9:34:04 ET]
Table 'Kiso II' 9-max Seat #7 is the button
Seat 2: di0d80 ($600.75 in chips) 
Seat 3: seouljam ($363.66 in chips) 
Seat 4: N4$H ($200 in chips) 
Seat 6: KT90 ($340.30 in chips) 
Seat 7: Igoriah ($200.01 in chips) 
Seat 8: bananajoe001 ($154.14 in chips) 
Seat 9: matiko09 ($200 in chips) 
bananajoe001: posts small blind $1
matiko09: posts big blind $2
DUkalisUA: sits out 
IntsAA: sits out 
*** HOLE CARDS ***
Dealt to matiko09 [7h 6h]
di0d80: folds 
seouljam: folds 
N4$H: folds 
KT90: folds 
Igoriah: raises $2 to $4
bananajoe001: calls $3
matiko09: calls $2
*** FLOP *** [Jh Jd 2s]
bananajoe001: checks 
matiko09: checks 
Igoriah: checks 
*** TURN *** [Jh Jd 2s] [Ah]
bananajoe001: bets $4
matiko09: calls $4
Igoriah: folds 
*** RIVER *** [Jh Jd 2s Ah] [4d]
bananajoe001: checks 
matiko09: checks 
*** SHOW DOWN ***
bananajoe001: shows [5d Ad] (two pair, Aces and Jacks)
matiko09: mucks hand 
bananajoe001 collected $19.10 from pot
*** SUMMARY ***
Total pot $20 | Rake $0.90 
Board [Jh Jd 2s Ah 4d]
Seat 2: di0d80 folded before Flop (didn't bet)
Seat 3: seouljam folded before Flop (didn't bet)
Seat 4: N4$H folded before Flop (didn't bet)
Seat 6: KT90 folded before Flop (didn't bet)
Seat 7: Igoriah (button) folded on the Turn
Seat 8: bananajoe001 (small blind) showed [5d Ad] and won ($19.10) with two pair, Aces and Jacks
Seat 9: matiko09 (big blind) mucked [7h 6h]





PokerStars Hand #150752759444:  Hold'em No Limit ($0.50/$1.00 USD) - 2016/03/22 14:34:09 CET [2016/03/22 9:34:09 ET]
Table 'Taygeta II' 9-max Seat #5 is the button
Seat 2: khan Erkesh ($197.30 in chips) 
Seat 3: Muinmyheart ($106.30 in chips) 
Seat 4: matiko09 ($100 in chips) 
Seat 5: RICKA16 ($117.49 in chips) 
Seat 6: I The King I ($116.91 in chips) 
Seat 7: Szevasztopol ($102.18 in chips) 
Seat 9: cobrik23 ($45.90 in chips) 
I The King I: posts small blind $0.50
Szevasztopol: posts big blind $1
Effort92: sits out 
DUkalisUA: sits out 
*** HOLE CARDS ***
Dealt to matiko09 [Ad As]
cobrik23: raises $2 to $3
khan Erkesh: calls $3
Muinmyheart: folds 
matiko09: raises $8 to $11
RICKA16: folds 
I The King I: folds 
Szevasztopol: calls $10
cobrik23: folds 
khan Erkesh: calls $8
*** FLOP *** [Qh 6h Td]
Szevasztopol: checks 
khan Erkesh: checks 
matiko09: bets $21
Szevasztopol: folds 
khan Erkesh: folds 
Uncalled bet ($21) returned to matiko09
matiko09 collected $34.86 from pot
matiko09: doesn't show hand 
*** SUMMARY ***
Total pot $36.50 | Rake $1.64 
Board [Qh 6h Td]
Seat 2: khan Erkesh folded on the Flop
Seat 3: Muinmyheart folded before Flop (didn't bet)
Seat 4: matiko09 collected ($34.86)
Seat 5: RICKA16 (button) folded before Flop (didn't bet)
Seat 6: I The King I (small blind) folded before Flop
Seat 7: Szevasztopol (big blind) folded on the Flop
Seat 9: cobrik23 folded before Flop





PokerStars Hand #150752760079:  Hold'em No Limit ($0.50/$1.00 USD) - 2016/03/22 14:34:10 CET [2016/03/22 9:34:10 ET]
Table 'Colchis' 9-max Seat #5 is the button
Seat 1: theluckyjoe ($17.25 in chips) 
Seat 2: Ilov3NBA ($158.41 in chips) 
Seat 3: bragutza ($97.31 in chips) 
Seat 4: matiko09 ($101.50 in chips) 
Seat 5: lumen21 ($163.53 in chips) 
Seat 6: hammerwife ($100 in chips) 
Seat 7: Dantist1122 ($100 in chips) 
Seat 8: cobrik23 ($50.72 in chips) 
Seat 9: ardo888 ($100.42 in chips) 
hammerwife: posts small blind $0.50
Dantist1122: posts big blind $1
bragutza: posts small & big blinds $1.50
*** HOLE CARDS ***
Dealt to matiko09 [9h Th]
cobrik23: folds 
ardo888: folds 
theluckyjoe: calls $1
Ilov3NBA: folds 
bragutza: checks 
matiko09: calls $1
lumen21: folds 
hammerwife: folds 
Dantist1122: checks 
*** FLOP *** [6d 6h 3h]
Dantist1122: checks 
theluckyjoe: checks 
bragutza: checks 
matiko09: bets $4
Dantist1122: folds 
theluckyjoe: folds 
bragutza: folds 
Uncalled bet ($4) returned to matiko09
matiko09 collected $4.78 from pot
matiko09: doesn't show hand 
*** SUMMARY ***
Total pot $5 | Rake $0.22 
Board [6d 6h 3h]
Seat 1: theluckyjoe folded on the Flop
Seat 2: Ilov3NBA folded before Flop (didn't bet)
Seat 3: bragutza folded on the Flop
Seat 4: matiko09 collected ($4.78)
Seat 5: lumen21 (button) folded before Flop (didn't bet)
Seat 6: hammerwife (small blind) folded before Flop
Seat 7: Dantist1122 (big blind) folded on the Flop
Seat 8: cobrik23 folded before Flop (didn't bet)
Seat 9: ardo888 folded before Flop (didn't bet)





PokerStars Hand #150752761782:  Hold'em No Limit ($0.50/$1.00 USD) - 2016/03/22 14:34:13 CET [2016/03/22 9:34:13 ET]
Table 'Harding' 9-max Seat #2 is the button
Seat 1: matiko09 ($116.39 in chips) 
Seat 2: RICKA16 ($115.25 in chips) 
Seat 3: DUkalisUA ($100 in chips) 
Seat 4: beterc0re ($100 in chips) 
Seat 6: Ilov3NBA ($101.50 in chips) 
Seat 7: mrhighryza ($111.64 in chips) 
Seat 8: di0d80 ($118.65 in chips) 
Seat 9: omorfadramou ($104 in chips) 
DUkalisUA: posts small blind $0.50
beterc0re: posts big blind $1
nickreason17: sits out 
*** HOLE CARDS ***
Dealt to matiko09 [Th 8c]
Ilov3NBA: folds 
mrhighryza: calls $1
di0d80: raises $3 to $4
omorfadramou: folds 
matiko09: folds 
RICKA16: folds 
DUkalisUA: folds 
beterc0re: folds 
mrhighryza: calls $3
*** FLOP *** [2d 2s Kd]
mrhighryza: checks 
di0d80: checks 
*** TURN *** [2d 2s Kd] [3h]
mrhighryza: bets $3
di0d80: calls $3
*** RIVER *** [2d 2s Kd 3h] [6c]
mrhighryza: bets $3
di0d80: calls $3
*** SHOW DOWN ***
mrhighryza: shows [7h Kh] (two pair, Kings and Deuces)
di0d80: mucks hand 
mrhighryza collected $20.53 from pot
*** SUMMARY ***
Total pot $21.50 | Rake $0.97 
Board [2d 2s Kd 3h 6c]
Seat 1: matiko09 folded before Flop (didn't bet)
Seat 2: RICKA16 (button) folded before Flop (didn't bet)
Seat 3: DUkalisUA (small blind) folded before Flop
Seat 4: beterc0re (big blind) folded before Flop
Seat 6: Ilov3NBA folded before Flop (didn't bet)
Seat 7: mrhighryza showed [7h Kh] and won ($20.53) with two pair, Kings and Deuces
Seat 8: di0d80 mucked [Ad Jd]
Seat 9: omorfadramou folded before Flop (didn't bet)





PokerStars Hand #150752763395:  Hold'em No Limit ($0.50/$1.00 USD) - 2016/03/22 14:34:15 CET [2016/03/22 9:34:15 ET]
Table 'Arabis' 9-max Seat #8 is the button
Seat 1: di0d80 ($109.50 in chips) 
Seat 4: Painkiller72 ($188.84 in chips) 
Seat 5: matiko09 ($128.99 in chips) 
Seat 6: Ilov3NBA ($100 in chips) 
Seat 7: howsiao ($146.38 in chips) 
Seat 8: Bro_Happy ($205.86 in chips) 
Seat 9: cobrik23 ($64.15 in chips) 
cobrik23: posts small blind $0.50
di0d80: posts big blind $1
hammerwife: sits out 
lumen21: sits out 
*** HOLE CARDS ***
Dealt to matiko09 [4h Ac]
Painkiller72: folds 
matiko09: folds 
Ilov3NBA: folds 
howsiao: folds 
Bro_Happy: folds 
cobrik23: folds 
Uncalled bet ($0.50) returned to di0d80
di0d80 collected $1 from pot
di0d80: doesn't show hand 
*** SUMMARY ***
Total pot $1 | Rake $0 
Seat 1: di0d80 (big blind) collected ($1)
Seat 4: Painkiller72 folded before Flop (didn't bet)
Seat 5: matiko09 folded before Flop (didn't bet)
Seat 6: Ilov3NBA folded before Flop (didn't bet)
Seat 7: howsiao folded before Flop (didn't bet)
Seat 8: Bro_Happy (button) folded before Flop (didn't bet)
Seat 9: cobrik23 (small blind) folded before Flop





PokerStars Hand #150752775469:  Hold'em No Limit ($0.50/$1.00 USD) - 2016/03/22 14:34:34 CET [2016/03/22 9:34:34 ET]
Table 'Miranda' 9-max Seat #4 is the button
Seat 1: cobrik23 ($114.94 in chips) 
Seat 2: Szevasztopol ($117.51 in chips) 
Seat 3: Muinmyheart ($100 in chips) 
Seat 4: bilukm ($99 in chips) 
Seat 5: beterc0re ($103 in chips) 
Seat 6: matiko09 ($100.90 in chips) 
Seat 7: RICKA16 ($104.50 in chips) 
Seat 8: hammerwife ($116.48 in chips) 
Seat 9: ardo888 ($166.92 in chips) 
beterc0re: posts small blind $0.50
matiko09: posts big blind $1
*** HOLE CARDS ***
Dealt to matiko09 [Kh 8d]
RICKA16: folds 
hammerwife: folds 
ardo888: folds 
cobrik23: folds 
Szevasztopol: folds 
Muinmyheart: raises $2 to $3
bilukm: calls $3
beterc0re: raises $11 to $14
matiko09: folds 
Muinmyheart: raises $18 to $32
bilukm: folds 
beterc0re: raises $71 to $103 and is all-in
Muinmyheart: calls $68 and is all-in
Uncalled bet ($3) returned to beterc0re
*** FLOP *** [3d 2s Kd]
*** TURN *** [3d 2s Kd] [2c]
*** RIVER *** [3d 2s Kd 2c] [4c]
*** SHOW DOWN ***
beterc0re: shows [Qc Qs] (two pair, Queens and Deuces)
Muinmyheart: shows [Kc Ac] (two pair, Kings and Deuces)
Muinmyheart collected $201.20 from pot
*** SUMMARY ***
Total pot $204 | Rake $2.80 
Board [3d 2s Kd 2c 4c]
Seat 1: cobrik23 folded before Flop (didn't bet)
Seat 2: Szevasztopol folded before Flop (didn't bet)
Seat 3: Muinmyheart showed [Kc Ac] and won ($201.20) with two pair, Kings and Deuces
Seat 4: bilukm (button) folded before Flop
Seat 5: beterc0re (small blind) showed [Qc Qs] and lost with two pair, Queens and Deuces
Seat 6: matiko09 (big blind) folded before Flop
Seat 7: RICKA16 folded before Flop (didn't bet)
Seat 8: hammerwife folded before Flop (didn't bet)
Seat 9: ardo888 folded before Flop (didn't bet)





PokerStars Hand #150752782971:  Hold'em No Limit ($0.50/$1.00 USD) - 2016/03/22 14:34:46 CET [2016/03/22 9:34:46 ET]
Table 'Arabis' 9-max Seat #9 is the button
Seat 1: di0d80 ($110 in chips) 
Seat 2: hammerwife ($100 in chips) 
Seat 4: Painkiller72 ($188.84 in chips) 
Seat 5: matiko09 ($128.99 in chips) 
Seat 6: Ilov3NBA ($100 in chips) 
Seat 7: howsiao ($146.38 in chips) 
Seat 8: Bro_Happy ($205.86 in chips) 
Seat 9: cobrik23 ($63.65 in chips) 
di0d80: posts small blind $0.50
hammerwife: posts big blind $1
lumen21: sits out 
*** HOLE CARDS ***
Dealt to matiko09 [Qc 2h]
Painkiller72: folds 
matiko09: folds 
Ilov3NBA: folds 
howsiao: folds 
Bro_Happy: raises $2 to $3
cobrik23: folds 
di0d80: folds 
hammerwife: folds 
Uncalled bet ($2) returned to Bro_Happy
Bro_Happy collected $2.50 from pot
Bro_Happy: doesn't show hand 
*** SUMMARY ***
Total pot $2.50 | Rake $0 
Seat 1: di0d80 (small blind) folded before Flop
Seat 2: hammerwife (big blind) folded before Flop
Seat 4: Painkiller72 folded before Flop (didn't bet)
Seat 5: matiko09 folded before Flop (didn't bet)
Seat 6: Ilov3NBA folded before Flop (didn't bet)
Seat 7: howsiao folded before Flop (didn't bet)
Seat 8: Bro_Happy collected ($2.50)
Seat 9: cobrik23 (button) folded before Flop (didn't bet)





PokerStars Hand #150752788523:  Hold'em No Limit ($0.50/$1.00 USD) - 2016/03/22 14:34:55 CET [2016/03/22 9:34:55 ET]
Table 'Crater II' 9-max Seat #6 is the button
Seat 1: matiko09 ($132.62 in chips) 
Seat 2: Eisbaerli85 ($126.41 in chips) 
Seat 3: hammerwife ($100 in chips) 
Seat 4: fanmtZ ($43.10 in chips) 
Seat 6: Kobiroga150 ($83.84 in chips) 
Seat 7: AWATAR 21 ($63.60 in chips) 
Seat 8: KronosAK ($109.78 in chips) 
Seat 9: I The King I ($124.41 in chips) 
AWATAR 21: posts small blind $0.50
nickreason17 leaves the table
KronosAK: posts big blind $1
*** HOLE CARDS ***
Dealt to matiko09 [Jc Ad]
di0d80 joins the table at seat #5 
I The King I: folds 
di0d80 leaves the table
matiko09: raises $2 to $3
Effort92 joins the table at seat #5 
Eisbaerli85: folds 
hammerwife: calls $3
fanmtZ: folds 
Kobiroga150: folds 
AWATAR 21: calls $2.50
KronosAK: folds 
*** FLOP *** [5c 4h 2d]
AWATAR 21: bets $4
matiko09: folds 
hammerwife: raises $8 to $12
AWATAR 21: folds 
Uncalled bet ($8) returned to hammerwife
hammerwife collected $17.19 from pot
hammerwife: doesn't show hand 
*** SUMMARY ***
Total pot $18 | Rake $0.81 
Board [5c 4h 2d]
Seat 1: matiko09 folded on the Flop
Seat 2: Eisbaerli85 folded before Flop (didn't bet)
Seat 3: hammerwife collected ($17.19)
Seat 4: fanmtZ folded before Flop (didn't bet)
Seat 6: Kobiroga150 (button) folded before Flop (didn't bet)
Seat 7: AWATAR 21 (small blind) folded on the Flop
Seat 8: KronosAK (big blind) folded before Flop
Seat 9: I The King I folded before Flop (didn't bet)





PokerStars Hand #150752797102:  Hold'em No Limit ($0.50/$1.00 USD) - 2016/03/22 14:35:09 CET [2016/03/22 9:35:09 ET]
Table 'Colchis' 9-max Seat #6 is the button
Seat 1: theluckyjoe ($16.25 in chips) 
Seat 2: Ilov3NBA ($158.41 in chips) 
Seat 3: bragutza ($95.81 in chips) 
Seat 4: matiko09 ($105.28 in chips) 
Seat 5: lumen21 ($163.53 in chips) 
Seat 6: hammerwife ($100 in chips) 
Seat 7: Dantist1122 ($100 in chips) 
Seat 8: cobrik23 ($50.72 in chips) 
Seat 9: ardo888 ($100.42 in chips) 
Dantist1122: posts small blind $0.50
cobrik23: posts big blind $1
*** HOLE CARDS ***
Dealt to matiko09 [2c Kc]
ardo888: folds 
theluckyjoe: calls $1
Ilov3NBA: folds 
bragutza: folds 
matiko09: folds 
lumen21: folds 
hammerwife: folds 
Dantist1122: folds 
cobrik23: checks 
*** FLOP *** [Jc Ah 8c]
cobrik23: checks 
theluckyjoe: bets $1
cobrik23: folds 
Uncalled bet ($1) returned to theluckyjoe
theluckyjoe collected $2.39 from pot
theluckyjoe: doesn't show hand 
*** SUMMARY ***
Total pot $2.50 | Rake $0.11 
Board [Jc Ah 8c]
Seat 1: theluckyjoe collected ($2.39)
Seat 2: Ilov3NBA folded before Flop (didn't bet)
Seat 3: bragutza folded before Flop (didn't bet)
Seat 4: matiko09 folded before Flop (didn't bet)
Seat 5: lumen21 folded before Flop (didn't bet)
Seat 6: hammerwife (button) folded before Flop (didn't bet)
Seat 7: Dantist1122 (small blind) folded before Flop
Seat 8: cobrik23 (big blind) folded on the Flop
Seat 9: ardo888 folded before Flop (didn't bet)





PokerStars Hand #150752799871:  Hold'em No Limit ($1/$2 USD) - 2016/03/22 14:35:13 CET [2016/03/22 9:35:13 ET]
Table 'Kiso II' 9-max Seat #8 is the button
Seat 1: DUkalisUA ($200 in chips) 
Seat 2: di0d80 ($600.75 in chips) 
Seat 3: seouljam ($363.66 in chips) 
Seat 4: N4$H ($200 in chips) 
Seat 6: KT90 ($340.30 in chips) 
Seat 7: Igoriah ($200 in chips) 
Seat 8: bananajoe001 ($165.24 in chips) 
Seat 9: matiko09 ($200 in chips) 
matiko09: posts small blind $1
DUkalisUA: posts big blind $2
IntsAA: sits out 
*** HOLE CARDS ***
Dealt to matiko09 [7h 2d]
di0d80: folds 
seouljam: folds 
N4$H: folds 
KT90: folds 
Igoriah: folds 
bananajoe001: raises $2 to $4
matiko09: folds 
DUkalisUA: calls $2
*** FLOP *** [9c 5c Jh]
DUkalisUA: checks 
bananajoe001: bets $6
DUkalisUA: folds 
Uncalled bet ($6) returned to bananajoe001
bananajoe001 collected $8.60 from pot
bananajoe001: doesn't show hand 
*** SUMMARY ***
Total pot $9 | Rake $0.40 
Board [9c 5c Jh]
Seat 1: DUkalisUA (big blind) folded on the Flop
Seat 2: di0d80 folded before Flop (didn't bet)
Seat 3: seouljam folded before Flop (didn't bet)
Seat 4: N4$H folded before Flop (didn't bet)
Seat 6: KT90 folded before Flop (didn't bet)
Seat 7: Igoriah folded before Flop (didn't bet)
Seat 8: bananajoe001 (button) collected ($8.60)
Seat 9: matiko09 (small blind) folded before Flop





PokerStars Hand #150752800796:  Hold'em No Limit ($0.50/$1.00 USD) - 2016/03/22 14:35:14 CET [2016/03/22 9:35:14 ET]
Table 'Arabis' 9-max Seat #1 is the button
Seat 1: di0d80 ($109.50 in chips) 
Seat 2: hammerwife ($100 in chips) 
Seat 3: lumen21 ($100 in chips) 
Seat 4: Painkiller72 ($188.84 in chips) 
Seat 5: matiko09 ($128.99 in chips) 
Seat 6: Ilov3NBA ($100 in chips) 
Seat 7: howsiao ($146.38 in chips) 
Seat 8: Bro_Happy ($207.36 in chips) 
Seat 9: cobrik23 ($63.65 in chips) 
hammerwife: posts small blind $0.50
lumen21: posts big blind $1
*** HOLE CARDS ***
Dealt to matiko09 [9d Jh]
Painkiller72: folds 
matiko09: folds 
Ilov3NBA: folds 
howsiao: folds 
Bro_Happy: folds 
cobrik23: folds 
di0d80: raises $1 to $2
hammerwife: folds 
lumen21: folds 
Uncalled bet ($1) returned to di0d80
di0d80 collected $2.50 from pot
di0d80: doesn't show hand 
*** SUMMARY ***
Total pot $2.50 | Rake $0 
Seat 1: di0d80 (button) collected ($2.50)
Seat 2: hammerwife (small blind) folded before Flop
Seat 3: lumen21 (big blind) folded before Flop
Seat 4: Painkiller72 folded before Flop (didn't bet)
Seat 5: matiko09 folded before Flop (didn't bet)
Seat 6: Ilov3NBA folded before Flop (didn't bet)
Seat 7: howsiao folded before Flop (didn't bet)
Seat 8: Bro_Happy folded before Flop (didn't bet)
Seat 9: cobrik23 folded before Flop (didn't bet)





PokerStars Hand #150752800750:  Hold'em No Limit ($0.50/$1.00 USD) - 2016/03/22 14:35:14 CET [2016/03/22 9:35:14 ET]
Table 'Harding' 9-max Seat #3 is the button
Seat 1: matiko09 ($116.39 in chips) 
Seat 2: RICKA16 ($115.25 in chips) 
Seat 3: DUkalisUA ($100 in chips) 
Seat 4: beterc0re ($100 in chips) 
Seat 5: nickreason17 ($100 in chips) 
Seat 6: Ilov3NBA ($101.50 in chips) 
Seat 7: mrhighryza ($122.17 in chips) 
Seat 8: di0d80 ($108.65 in chips) 
Seat 9: omorfadramou ($104 in chips) 
beterc0re: posts small blind $0.50
nickreason17: posts big blind $1
*** HOLE CARDS ***
Dealt to matiko09 [Qd 7c]
Ilov3NBA: raises $2 to $3
mrhighryza: folds 
di0d80: calls $3
omorfadramou: folds 
matiko09: folds 
RICKA16: folds 
DUkalisUA: calls $3
beterc0re: folds 
nickreason17: folds 
*** FLOP *** [Js 7h 8d]
Ilov3NBA: checks 
di0d80: checks 
DUkalisUA: bets $7.52
Ilov3NBA: calls $7.52
di0d80: folds 
*** TURN *** [Js 7h 8d] [Jd]
Ilov3NBA: checks 
DUkalisUA: bets $18.29
Ilov3NBA: folds 
Uncalled bet ($18.29) returned to DUkalisUA
DUkalisUA collected $24.39 from pot
DUkalisUA: doesn't show hand 
*** SUMMARY ***
Total pot $25.54 | Rake $1.15 
Board [Js 7h 8d Jd]
Seat 1: matiko09 folded before Flop (didn't bet)
Seat 2: RICKA16 folded before Flop (didn't bet)
Seat 3: DUkalisUA (button) collected ($24.39)
Seat 4: beterc0re (small blind) folded before Flop
Seat 5: nickreason17 (big blind) folded before Flop
Seat 6: Ilov3NBA folded on the Turn
Seat 7: mrhighryza folded before Flop (didn't bet)
Seat 8: di0d80 folded on the Flop
Seat 9: omorfadramou folded before Flop (didn't bet)





PokerStars Hand #150752802707:  Hold'em No Limit ($1/$2 USD) - 2016/03/22 14:35:17 CET [2016/03/22 9:35:17 ET]
Table 'Garlena II' 9-max Seat #7 is the button
Seat 2: di0d80 ($245.68 in chips) 
Seat 3: N4$H ($200 in chips) 
Seat 4: KT90 ($207.92 in chips) 
Seat 5: IntsAA ($206.19 in chips) 
Seat 7: Bothfeld11 ($159.35 in chips) 
Seat 8: samps777 ($37.70 in chips) 
Seat 9: matiko09 ($200 in chips) 
samps777: posts small blind $1
matiko09: posts big blind $2
nickreason17: sits out 
*** HOLE CARDS ***
Dealt to matiko09 [Kd Qd]
di0d80: folds 
N4$H: folds 
KT90: raises $4 to $6
IntsAA: folds 
Bothfeld11: folds 
samps777: folds 
matiko09: calls $4
*** FLOP *** [6c Jd Tc]
matiko09: checks 
KT90: checks 
*** TURN *** [6c Jd Tc] [9d]
matiko09: bets $8.07
KT90: folds 
Uncalled bet ($8.07) returned to matiko09
matiko09 collected $12.42 from pot
matiko09: doesn't show hand 
*** SUMMARY ***
Total pot $13 | Rake $0.58 
Board [6c Jd Tc 9d]
Seat 2: di0d80 folded before Flop (didn't bet)
Seat 3: N4$H folded before Flop (didn't bet)
Seat 4: KT90 folded on the Turn
Seat 5: IntsAA folded before Flop (didn't bet)
Seat 7: Bothfeld11 (button) folded before Flop (didn't bet)
Seat 8: samps777 (small blind) folded before Flop
Seat 9: matiko09 (big blind) collected ($12.42)





PokerStars Hand #150752808329:  Hold'em No Limit ($0.50/$1.00 USD) - 2016/03/22 14:35:26 CET [2016/03/22 9:35:26 ET]
Table 'Stephano II' 9-max Seat #5 is the button
Seat 1: omorfadramou ($202.20 in chips) 
Seat 2: I The King I ($100 in chips) 
Seat 3: lombardo11 ($58.32 in chips) 
Seat 4: AWATAR 21 ($194.08 in chips) 
Seat 5: mb2part ($90.41 in chips) 
Seat 6: beterc0re ($100 in chips) 
Seat 7: nickreason17 ($100 in chips) 
Seat 8: KingCastle77 ($89.72 in chips) 
Seat 9: matiko09 ($100 in chips) 
beterc0re: posts small blind $0.50
nickreason17: posts big blind $1
*** HOLE CARDS ***
Dealt to matiko09 [7h Th]
KingCastle77: folds 
matiko09: folds 
omorfadramou: folds 
I The King I: folds 
lombardo11: folds 
AWATAR 21: folds 
mb2part: folds 
beterc0re: folds 
Uncalled bet ($0.50) returned to nickreason17
nickreason17 collected $1 from pot
*** SUMMARY ***
Total pot $1 | Rake $0 
Seat 1: omorfadramou folded before Flop (didn't bet)
Seat 2: I The King I folded before Flop (didn't bet)
Seat 3: lombardo11 folded before Flop (didn't bet)
Seat 4: AWATAR 21 folded before Flop (didn't bet)
Seat 5: mb2part (button) folded before Flop (didn't bet)
Seat 6: beterc0re (small blind) folded before Flop
Seat 7: nickreason17 (big blind) collected ($1)
Seat 8: KingCastle77 folded before Flop (didn't bet)
Seat 9: matiko09 folded before Flop (didn't bet)





PokerStars Hand #150752810161:  Hold'em No Limit ($0.50/$1.00 USD) - 2016/03/22 14:35:29 CET [2016/03/22 9:35:29 ET]
Table 'Polyxena' 9-max Seat #7 is the button
Seat 1: I The King I ($102.73 in chips) 
Seat 2: cobrik23 ($79.61 in chips) 
Seat 3: di0d80 ($112.26 in chips) 
Seat 4: fanmtZ ($55.94 in chips) 
Seat 5: MrAndMisses ($44.17 in chips) 
Seat 6: Ilov3NBA ($103.41 in chips) 
Seat 7: matiko09 ($100 in chips) 
Seat 8: kift74 ($124.72 in chips) 
Seat 9: ardo888 ($148.58 in chips) 
kift74: posts small blind $0.50
ardo888: posts big blind $1
*** HOLE CARDS ***
Dealt to matiko09 [8c 7d]
I The King I: folds 
cobrik23: raises $2 to $3
di0d80: folds 
fanmtZ: folds 
MrAndMisses: folds 
Ilov3NBA: calls $3
matiko09: folds 
kift74: folds 
ardo888: folds 
*** FLOP *** [Tc Ts 7s]
cobrik23: checks 
Ilov3NBA: bets $3.93
cobrik23: raises $8.07 to $12
Ilov3NBA: calls $8.07
*** TURN *** [Tc Ts 7s] [Js]
cobrik23: bets $18
Ilov3NBA: folds 
Uncalled bet ($18) returned to cobrik23
cobrik23 collected $30.08 from pot
cobrik23: doesn't show hand 
*** SUMMARY ***
Total pot $31.50 | Rake $1.42 
Board [Tc Ts 7s Js]
Seat 1: I The King I folded before Flop (didn't bet)
Seat 2: cobrik23 collected ($30.08)
Seat 3: di0d80 folded before Flop (didn't bet)
Seat 4: fanmtZ folded before Flop (didn't bet)
Seat 5: MrAndMisses folded before Flop (didn't bet)
Seat 6: Ilov3NBA folded on the Turn
Seat 7: matiko09 (button) folded before Flop (didn't bet)
Seat 8: kift74 (small blind) folded before Flop
Seat 9: ardo888 (big blind) folded before Flop





PokerStars Hand #150752822309:  Hold'em No Limit ($0.50/$1.00 USD) - 2016/03/22 14:35:48 CET [2016/03/22 9:35:48 ET]
Table 'Miranda' 9-max Seat #5 is the button
Seat 1: cobrik23 ($114.94 in chips) 
Seat 2: Szevasztopol ($117.51 in chips) 
Seat 3: Muinmyheart ($201.20 in chips) 
Seat 4: bilukm ($96 in chips) 
Seat 5: beterc0re ($100 in chips) 
Seat 6: matiko09 ($100 in chips) 
Seat 7: RICKA16 ($104.50 in chips) 
Seat 8: hammerwife ($116.48 in chips) 
Seat 9: ardo888 ($166.92 in chips) 
matiko09: posts small blind $0.50
RICKA16: posts big blind $1
*** HOLE CARDS ***
Dealt to matiko09 [9c 9s]
hammerwife: folds 
ardo888: folds 
cobrik23 has timed out
cobrik23: folds 
Szevasztopol: folds 
Muinmyheart: folds 
bilukm: raises $2 to $3
beterc0re: calls $3
matiko09: raises $9 to $12
RICKA16: folds 
bilukm: calls $9
beterc0re: calls $9
*** FLOP *** [9d Ts 7c]
matiko09: bets $19
bilukm: folds 
beterc0re: calls $19
*** TURN *** [9d Ts 7c] [As]
matiko09: bets $15
beterc0re: raises $54 to $69 and is all-in
matiko09: calls $54 and is all-in
*** RIVER *** [9d Ts 7c As] [7h]
*** SHOW DOWN ***
matiko09: shows [9c 9s] (a full house, Nines full of Sevens)
beterc0re: mucks hand 
matiko09 collected $210.20 from pot
*** SUMMARY ***
Total pot $213 | Rake $2.80 
Board [9d Ts 7c As 7h]
Seat 1: cobrik23 folded before Flop (didn't bet)
Seat 2: Szevasztopol folded before Flop (didn't bet)
Seat 3: Muinmyheart folded before Flop (didn't bet)
Seat 4: bilukm folded on the Flop
Seat 5: beterc0re (button) mucked [Qc Tc]
Seat 6: matiko09 (small blind) showed [9c 9s] and won ($210.20) with a full house, Nines full of Sevens
Seat 7: RICKA16 (big blind) folded before Flop
Seat 8: hammerwife folded before Flop (didn't bet)
Seat 9: ardo888 folded before Flop (didn't bet)





PokerStars Hand #150752826881:  Hold'em No Limit ($0.50/$1.00 USD) - 2016/03/22 14:35:56 CET [2016/03/22 9:35:56 ET]
Table 'Colchis' 9-max Seat #7 is the button
Seat 1: theluckyjoe ($17.64 in chips) 
Seat 2: Ilov3NBA ($158.41 in chips) 
Seat 3: bragutza ($95.81 in chips) 
Seat 4: matiko09 ($105.28 in chips) 
Seat 5: lumen21 ($163.53 in chips) 
Seat 6: hammerwife ($100 in chips) 
Seat 7: Dantist1122 ($100 in chips) 
Seat 8: cobrik23 ($49.72 in chips) 
Seat 9: ardo888 ($100.42 in chips) 
cobrik23: posts small blind $0.50
ardo888: posts big blind $1
*** HOLE CARDS ***
Dealt to matiko09 [6s 8c]
theluckyjoe: folds 
Ilov3NBA: folds 
bragutza: folds 
matiko09: folds 
lumen21: raises $2 to $3
hammerwife: folds 
Dantist1122: folds 
cobrik23: folds 
ardo888: calls $2
*** FLOP *** [9h Td 2s]
ardo888: checks 
lumen21: bets $3.41
ardo888: calls $3.41
*** TURN *** [9h Td 2s] [As]
ardo888: checks 
lumen21: checks 
*** RIVER *** [9h Td 2s As] [Th]
ardo888: checks 
lumen21: bets $9.79
ardo888: folds 
Uncalled bet ($9.79) returned to lumen21
lumen21 collected $12.72 from pot
lumen21: doesn't show hand 
*** SUMMARY ***
Total pot $13.32 | Rake $0.60 
Board [9h Td 2s As Th]
Seat 1: theluckyjoe folded before Flop (didn't bet)
Seat 2: Ilov3NBA folded before Flop (didn't bet)
Seat 3: bragutza folded before Flop (didn't bet)
Seat 4: matiko09 folded before Flop (didn't bet)
Seat 5: lumen21 collected ($12.72)
Seat 6: hammerwife folded before Flop (didn't bet)
Seat 7: Dantist1122 (button) folded before Flop (didn't bet)
Seat 8: cobrik23 (small blind) folded before Flop
Seat 9: ardo888 (big blind) folded on the River





PokerStars Hand #150752828137:  Hold'em No Limit ($0.50/$1.00 USD) - 2016/03/22 14:35:58 CET [2016/03/22 9:35:58 ET]
Table 'Stephano II' 9-max Seat #6 is the button
Seat 1: omorfadramou ($202.20 in chips) 
Seat 2: I The King I ($100 in chips) 
Seat 3: lombardo11 ($58.32 in chips) 
Seat 4: AWATAR 21 ($194.08 in chips) 
Seat 5: mb2part ($90.41 in chips) 
Seat 6: beterc0re ($100 in chips) 
Seat 7: nickreason17 ($100.50 in chips) 
Seat 8: KingCastle77 ($89.72 in chips) 
Seat 9: matiko09 ($100 in chips) 
nickreason17: posts small blind $0.50
KingCastle77: posts big blind $1
*** HOLE CARDS ***
Dealt to matiko09 [8s 4d]
matiko09: folds 
omorfadramou: folds 
I The King I: raises $2 to $3
lombardo11: folds 
AWATAR 21: folds 
mb2part: folds 
beterc0re: folds 
nickreason17: folds 
KingCastle77: folds 
Uncalled bet ($2) returned to I The King I
I The King I collected $2.50 from pot
I The King I: doesn't show hand 
*** SUMMARY ***
Total pot $2.50 | Rake $0 
Seat 1: omorfadramou folded before Flop (didn't bet)
Seat 2: I The King I collected ($2.50)
Seat 3: lombardo11 folded before Flop (didn't bet)
Seat 4: AWATAR 21 folded before Flop (didn't bet)
Seat 5: mb2part folded before Flop (didn't bet)
Seat 6: beterc0re (button) folded before Flop (didn't bet)
Seat 7: nickreason17 (small blind) folded before Flop
Seat 8: KingCastle77 (big blind) folded before Flop
Seat 9: matiko09 folded before Flop (didn't bet)





PokerStars Hand #150752829101:  Hold'em No Limit ($0.50/$1.00 USD) - 2016/03/22 14:35:59 CET [2016/03/22 9:35:59 ET]
Table 'Arabis' 9-max Seat #2 is the button
Seat 1: di0d80 ($111 in chips) 
Seat 2: hammerwife ($100 in chips) 
Seat 3: lumen21 ($100 in chips) 
Seat 4: Painkiller72 ($188.84 in chips) 
Seat 5: matiko09 ($128.99 in chips) 
Seat 6: Ilov3NBA ($100 in chips) 
Seat 7: howsiao ($146.38 in chips) 
Seat 8: Bro_Happy ($207.36 in chips) 
Seat 9: cobrik23 ($63.65 in chips) 
lumen21: posts small blind $0.50
Painkiller72: posts big blind $1
*** HOLE CARDS ***
Dealt to matiko09 [Js Td]
matiko09: folds 
Ilov3NBA: folds 
howsiao: folds 
Bro_Happy: folds 
cobrik23: folds 
di0d80: raises $1.50 to $2.50
hammerwife: folds 
lumen21: folds 
Painkiller72: folds 
Uncalled bet ($1.50) returned to di0d80
di0d80 collected $2.50 from pot
di0d80: doesn't show hand 
*** SUMMARY ***
Total pot $2.50 | Rake $0 
Seat 1: di0d80 collected ($2.50)
Seat 2: hammerwife (button) folded before Flop (didn't bet)
Seat 3: lumen21 (small blind) folded before Flop
Seat 4: Painkiller72 (big blind) folded before Flop
Seat 5: matiko09 folded before Flop (didn't bet)
Seat 6: Ilov3NBA folded before Flop (didn't bet)
Seat 7: howsiao folded before Flop (didn't bet)
Seat 8: Bro_Happy folded before Flop (didn't bet)
Seat 9: cobrik23 folded before Flop (didn't bet)





PokerStars Hand #150752831029:  Hold'em No Limit ($1/$2 USD) - 2016/03/22 14:36:02 CET [2016/03/22 9:36:02 ET]
Table 'Garlena II' 9-max Seat #8 is the button
Seat 1: nickreason17 ($200 in chips) 
Seat 2: di0d80 ($245.68 in chips) 
Seat 3: N4$H ($200 in chips) 
Seat 4: KT90 ($201.92 in chips) 
Seat 5: IntsAA ($206.19 in chips) 
Seat 7: Bothfeld11 ($159.35 in chips) 
Seat 8: samps777 ($36.70 in chips) 
Seat 9: matiko09 ($206.42 in chips) 
matiko09: posts small blind $1
nickreason17: posts big blind $2
*** HOLE CARDS ***
Dealt to matiko09 [9s 7c]
di0d80: folds 
N4$H: raises $2.35 to $4.35
KT90: folds 
IntsAA: folds 
Bothfeld11: folds 
samps777: folds 
matiko09: folds 
nickreason17: folds 
Uncalled bet ($2.35) returned to N4$H
N4$H collected $5 from pot
N4$H: doesn't show hand 
*** SUMMARY ***
Total pot $5 | Rake $0 
Seat 1: nickreason17 (big blind) folded before Flop
Seat 2: di0d80 folded before Flop (didn't bet)
Seat 3: N4$H collected ($5)
Seat 4: KT90 folded before Flop (didn't bet)
Seat 5: IntsAA folded before Flop (didn't bet)
Seat 7: Bothfeld11 folded before Flop (didn't bet)
Seat 8: samps777 (button) folded before Flop (didn't bet)
Seat 9: matiko09 (small blind) folded before Flop





PokerStars Hand #150752836243:  Hold'em No Limit ($0.50/$1.00 USD) - 2016/03/22 14:36:10 CET [2016/03/22 9:36:10 ET]
Table 'Taygeta II' 9-max Seat #6 is the button
Seat 2: khan Erkesh ($186.30 in chips) 
Seat 3: Muinmyheart ($106.30 in chips) 
Seat 4: matiko09 ($123.86 in chips) 
Seat 5: RICKA16 ($117.49 in chips) 
Seat 6: I The King I ($116.41 in chips) 
Seat 7: Szevasztopol ($100 in chips) 
Seat 8: Effort92 ($100 in chips) 
Seat 9: cobrik23 ($42.90 in chips) 
Szevasztopol: posts small blind $0.50
Effort92: posts big blind $1
DUkalisUA: sits out 
*** HOLE CARDS ***
Dealt to matiko09 [3c 9c]
cobrik23: folds 
khan Erkesh: folds 
Muinmyheart: folds 
matiko09: folds 
RICKA16: folds 
I The King I: folds 
Szevasztopol: folds 
Uncalled bet ($0.50) returned to Effort92
Effort92 collected $1 from pot
Effort92: doesn't show hand 
*** SUMMARY ***
Total pot $1 | Rake $0 
Seat 2: khan Erkesh folded before Flop (didn't bet)
Seat 3: Muinmyheart folded before Flop (didn't bet)
Seat 4: matiko09 folded before Flop (didn't bet)
Seat 5: RICKA16 folded before Flop (didn't bet)
Seat 6: I The King I (button) folded before Flop (didn't bet)
Seat 7: Szevasztopol (small blind) folded before Flop
Seat 8: Effort92 (big blind) collected ($1)
Seat 9: cobrik23 folded before Flop (didn't bet)





PokerStars Hand #150752837570:  Hold'em No Limit ($0.50/$1.00 USD) - 2016/03/22 14:36:12 CET [2016/03/22 9:36:12 ET]
Table 'Crater II' 9-max Seat #7 is the button
Seat 1: matiko09 ($129.62 in chips) 
Seat 2: Eisbaerli85 ($126.41 in chips) 
Seat 3: hammerwife ($110.19 in chips) 
Seat 4: fanmtZ ($43.10 in chips) 
Seat 6: Kobiroga150 ($83.84 in chips) 
Seat 7: AWATAR 21 ($56.60 in chips) 
Seat 8: KronosAK ($108.78 in chips) 
Seat 9: I The King I ($124.41 in chips) 
KronosAK: posts small blind $0.50
I The King I: posts big blind $1
Effort92: sits out 
*** HOLE CARDS ***
Dealt to matiko09 [3c 7s]
matiko09: folds 
Eisbaerli85: folds 
hammerwife: folds 
fanmtZ: folds 
Kobiroga150: raises $1 to $2
AWATAR 21: folds 
KronosAK: folds 
I The King I: calls $1
*** FLOP *** [4c Jd 8c]
I The King I: checks 
Kobiroga150: checks 
*** TURN *** [4c Jd 8c] [4h]
I The King I: checks 
Kobiroga150: checks 
*** RIVER *** [4c Jd 8c 4h] [3d]
I The King I: checks 
Kobiroga150: bets $4
I The King I: folds 
Uncalled bet ($4) returned to Kobiroga150
Kobiroga150 collected $4.30 from pot
Kobiroga150: doesn't show hand 
*** SUMMARY ***
Total pot $4.50 | Rake $0.20 
Board [4c Jd 8c 4h 3d]
Seat 1: matiko09 folded before Flop (didn't bet)
Seat 2: Eisbaerli85 folded before Flop (didn't bet)
Seat 3: hammerwife folded before Flop (didn't bet)
Seat 4: fanmtZ folded before Flop (didn't bet)
Seat 6: Kobiroga150 collected ($4.30)
Seat 7: AWATAR 21 (button) folded before Flop (didn't bet)
Seat 8: KronosAK (small blind) folded before Flop
Seat 9: I The King I (big blind) folded on the River





PokerStars Hand #150752840523:  Hold'em No Limit ($1/$2 USD) - 2016/03/22 14:36:17 CET [2016/03/22 9:36:17 ET]
Table 'Kiso II' 9-max Seat #9 is the button
Seat 1: DUkalisUA ($200 in chips) 
Seat 2: di0d80 ($600.75 in chips) 
Seat 3: seouljam ($363.66 in chips) 
Seat 4: N4$H ($200 in chips) 
Seat 6: KT90 ($340.30 in chips) 
Seat 7: Igoriah ($200 in chips) 
Seat 8: bananajoe001 ($169.84 in chips) 
Seat 9: matiko09 ($200 in chips) 
DUkalisUA: posts small blind $1
di0d80: posts big blind $2
IntsAA: sits out 
*** HOLE CARDS ***
Dealt to matiko09 [3s Kc]
seouljam: folds 
N4$H: folds 
KT90: raises $4 to $6
Igoriah: folds 
bananajoe001: folds 
matiko09: folds 
DUkalisUA: folds 
di0d80: folds 
Uncalled bet ($4) returned to KT90
KT90 collected $5 from pot
KT90: doesn't show hand 
*** SUMMARY ***
Total pot $5 | Rake $0 
Seat 1: DUkalisUA (small blind) folded before Flop
Seat 2: di0d80 (big blind) folded before Flop
Seat 3: seouljam folded before Flop (didn't bet)
Seat 4: N4$H folded before Flop (didn't bet)
Seat 6: KT90 collected ($5)
Seat 7: Igoriah folded before Flop (didn't bet)
Seat 8: bananajoe001 folded before Flop (didn't bet)
Seat 9: matiko09 (button) folded before Flop (didn't bet)





PokerStars Hand #150752844200:  Hold'em No Limit ($0.50/$1.00 USD) - 2016/03/22 14:36:23 CET [2016/03/22 9:36:23 ET]
Table 'Stephano II' 9-max Seat #7 is the button
Seat 1: omorfadramou ($202.20 in chips) 
Seat 2: I The King I ($101.50 in chips) 
Seat 3: lombardo11 ($58.32 in chips) 
Seat 4: AWATAR 21 ($194.08 in chips) 
Seat 5: mb2part ($90.41 in chips) 
Seat 6: beterc0re ($100 in chips) 
Seat 7: nickreason17 ($100 in chips) 
Seat 8: KingCastle77 ($88.72 in chips) 
Seat 9: matiko09 ($100 in chips) 
KingCastle77: posts small blind $0.50
matiko09: posts big blind $1
*** HOLE CARDS ***
Dealt to matiko09 [7h 8d]
omorfadramou: folds 
I The King I: folds 
lombardo11: raises $2 to $3
AWATAR 21: calls $3
mb2part: folds 
beterc0re: folds 
nickreason17: folds 
KingCastle77: folds 
matiko09: folds 
*** FLOP *** [9d 9s Qh]
lombardo11: bets $4
AWATAR 21: folds 
Uncalled bet ($4) returned to lombardo11
lombardo11 collected $7.16 from pot
lombardo11: doesn't show hand 
*** SUMMARY ***
Total pot $7.50 | Rake $0.34 
Board [9d 9s Qh]
Seat 1: omorfadramou folded before Flop (didn't bet)
Seat 2: I The King I folded before Flop (didn't bet)
Seat 3: lombardo11 collected ($7.16)
Seat 4: AWATAR 21 folded on the Flop
Seat 5: mb2part folded before Flop (didn't bet)
Seat 6: beterc0re folded before Flop (didn't bet)
Seat 7: nickreason17 (button) folded before Flop (didn't bet)
Seat 8: KingCastle77 (small blind) folded before Flop
Seat 9: matiko09 (big blind) folded before Flop





PokerStars Hand #150752845854:  Hold'em No Limit ($1/$2 USD) - 2016/03/22 14:36:26 CET [2016/03/22 9:36:26 ET]
Table 'Garlena II' 9-max Seat #9 is the button
Seat 1: nickreason17 ($200 in chips) 
Seat 2: di0d80 ($245.68 in chips) 
Seat 3: N4$H ($203 in chips) 
Seat 4: KT90 ($201.92 in chips) 
Seat 5: IntsAA ($206.19 in chips) 
Seat 7: Bothfeld11 ($159.35 in chips) 
Seat 8: samps777 ($36.70 in chips) 
Seat 9: matiko09 ($205.42 in chips) 
nickreason17: posts small blind $1
di0d80: posts big blind $2
*** HOLE CARDS ***
Dealt to matiko09 [8h Jh]
N4$H: folds 
KT90: folds 
IntsAA: folds 
Bothfeld11: folds 
samps777: folds 
matiko09: raises $2.54 to $4.54
nickreason17: folds 
di0d80: folds 
Uncalled bet ($2.54) returned to matiko09
matiko09 collected $5 from pot
matiko09: doesn't show hand 
*** SUMMARY ***
Total pot $5 | Rake $0 
Seat 1: nickreason17 (small blind) folded before Flop
Seat 2: di0d80 (big blind) folded before Flop
Seat 3: N4$H folded before Flop (didn't bet)
Seat 4: KT90 folded before Flop (didn't bet)
Seat 5: IntsAA folded before Flop (didn't bet)
Seat 7: Bothfeld11 folded before Flop (didn't bet)
Seat 8: samps777 folded before Flop (didn't bet)
Seat 9: matiko09 (button) collected ($5)





PokerStars Hand #150752849912:  Hold'em No Limit ($0.50/$1.00 USD) - 2016/03/22 14:36:32 CET [2016/03/22 9:36:32 ET]
Table 'Harding' 9-max Seat #4 is the button
Seat 1: matiko09 ($116.39 in chips) 
Seat 2: RICKA16 ($115.25 in chips) 
Seat 3: DUkalisUA ($113.87 in chips) 
Seat 4: beterc0re ($100 in chips) 
Seat 5: nickreason17 ($100 in chips) 
Seat 7: mrhighryza ($122.17 in chips) 
Seat 8: di0d80 ($105.65 in chips) 
Seat 9: omorfadramou ($104 in chips) 
nickreason17: posts small blind $0.50
Ilov3NBA: is sitting out 
mrhighryza: posts big blind $1
*** HOLE CARDS ***
Dealt to matiko09 [6d 8d]
di0d80: folds 
omorfadramou: folds 
matiko09: folds 
RICKA16: folds 
DUkalisUA: folds 
beterc0re: folds 
nickreason17: raises $1.04 to $2.04
mrhighryza: calls $1.04
*** FLOP *** [4d 4h 8s]
nickreason17: bets $2.37
mrhighryza: folds 
Uncalled bet ($2.37) returned to nickreason17
nickreason17 collected $3.90 from pot
*** SUMMARY ***
Total pot $4.08 | Rake $0.18 
Board [4d 4h 8s]
Seat 1: matiko09 folded before Flop (didn't bet)
Seat 2: RICKA16 folded before Flop (didn't bet)
Seat 3: DUkalisUA folded before Flop (didn't bet)
Seat 4: beterc0re (button) folded before Flop (didn't bet)
Seat 5: nickreason17 (small blind) collected ($3.90)
Seat 7: mrhighryza (big blind) folded on the Flop
Seat 8: di0d80 folded before Flop (didn't bet)
Seat 9: omorfadramou folded before Flop (didn't bet)





PokerStars Hand #150752858614:  Hold'em No Limit ($0.50/$1.00 USD) - 2016/03/22 14:36:46 CET [2016/03/22 9:36:46 ET]
Table 'Arabis' 9-max Seat #3 is the button
Seat 1: di0d80 ($112.50 in chips) 
Seat 2: hammerwife ($100 in chips) 
Seat 3: lumen21 ($100 in chips) 
Seat 4: Painkiller72 ($187.84 in chips) 
Seat 5: matiko09 ($128.99 in chips) 
Seat 6: Ilov3NBA ($100 in chips) 
Seat 7: howsiao ($146.38 in chips) 
Seat 8: Bro_Happy ($207.36 in chips) 
Seat 9: cobrik23 ($63.65 in chips) 
Painkiller72: posts small blind $0.50
matiko09: posts big blind $1
*** HOLE CARDS ***
Dealt to matiko09 [3h Kc]
Ilov3NBA has timed out
Ilov3NBA: folds 
howsiao: folds 
Bro_Happy: folds 
cobrik23: folds 
di0d80: folds 
hammerwife: folds 
lumen21: raises $1.25 to $2.25
Painkiller72: raises $6.25 to $8.50
matiko09: folds 
lumen21: folds 
Uncalled bet ($6.25) returned to Painkiller72
Painkiller72 collected $5.50 from pot
Painkiller72: doesn't show hand 
*** SUMMARY ***
Total pot $5.50 | Rake $0 
Seat 1: di0d80 folded before Flop (didn't bet)
Seat 2: hammerwife folded before Flop (didn't bet)
Seat 3: lumen21 (button) folded before Flop
Seat 4: Painkiller72 (small blind) collected ($5.50)
Seat 5: matiko09 (big blind) folded before Flop
Seat 6: Ilov3NBA folded before Flop (didn't bet)
Seat 7: howsiao folded before Flop (didn't bet)
Seat 8: Bro_Happy folded before Flop (didn't bet)
Seat 9: cobrik23 folded before Flop (didn't bet)





PokerStars Hand #150752862712:  Hold'em No Limit ($1/$2 USD) - 2016/03/22 14:36:53 CET [2016/03/22 9:36:53 ET]
Table 'Garlena II' 9-max Seat #1 is the button
Seat 1: nickreason17 ($200 in chips) 
Seat 2: di0d80 ($243.68 in chips) 
Seat 3: N4$H ($203 in chips) 
Seat 4: KT90 ($201.92 in chips) 
Seat 5: IntsAA ($206.19 in chips) 
Seat 7: Bothfeld11 ($159.35 in chips) 
Seat 8: samps777 ($36.70 in chips) 
Seat 9: matiko09 ($208.42 in chips) 
di0d80: posts small blind $1
N4$H: posts big blind $2
*** HOLE CARDS ***
Dealt to matiko09 [8c 4h]
KT90: folds 
IntsAA: folds 
Bothfeld11: folds 
samps777: folds 
matiko09: folds 
nickreason17: raises $2.08 to $4.08
di0d80: folds 
N4$H: calls $2.08
*** FLOP *** [8h 9h Qd]
N4$H: checks 
nickreason17: bets $6.56
N4$H: raises $11.37 to $17.93
nickreason17: raises $34.07 to $52
N4$H: folds 
Uncalled bet ($34.07) returned to nickreason17
nickreason17 collected $42.99 from pot
*** SUMMARY ***
Total pot $45.02 | Rake $2.03 
Board [8h 9h Qd]
Seat 1: nickreason17 (button) collected ($42.99)
Seat 2: di0d80 (small blind) folded before Flop
Seat 3: N4$H (big blind) folded on the Flop
Seat 4: KT90 folded before Flop (didn't bet)
Seat 5: IntsAA folded before Flop (didn't bet)
Seat 7: Bothfeld11 folded before Flop (didn't bet)
Seat 8: samps777 folded before Flop (didn't bet)
Seat 9: matiko09 folded before Flop (didn't bet)





PokerStars Hand #150752862920:  Hold'em No Limit ($0.50/$1.00 USD) - 2016/03/22 14:36:53 CET [2016/03/22 9:36:53 ET]
Table 'Taygeta II' 9-max Seat #7 is the button
Seat 2: khan Erkesh ($186.30 in chips) 
Seat 3: Muinmyheart ($106.30 in chips) 
Seat 4: matiko09 ($123.86 in chips) 
Seat 5: RICKA16 ($117.49 in chips) 
Seat 6: I The King I ($116.41 in chips) 
Seat 7: Szevasztopol ($100 in chips) 
Seat 8: Effort92 ($100.50 in chips) 
Seat 9: cobrik23 ($42.90 in chips) 
Effort92: posts small blind $0.50
cobrik23: posts big blind $1
DUkalisUA: sits out 
*** HOLE CARDS ***
Dealt to matiko09 [Ad Jc]
khan Erkesh: folds 
Muinmyheart: folds 
matiko09: raises $2 to $3
RICKA16: folds 
I The King I: folds 
Szevasztopol: folds 
Effort92: folds 
cobrik23: folds 
Uncalled bet ($2) returned to matiko09
matiko09 collected $2.50 from pot
matiko09: doesn't show hand 
*** SUMMARY ***
Total pot $2.50 | Rake $0 
Seat 2: khan Erkesh folded before Flop (didn't bet)
Seat 3: Muinmyheart folded before Flop (didn't bet)
Seat 4: matiko09 collected ($2.50)
Seat 5: RICKA16 folded before Flop (didn't bet)
Seat 6: I The King I folded before Flop (didn't bet)
Seat 7: Szevasztopol (button) folded before Flop (didn't bet)
Seat 8: Effort92 (small blind) folded before Flop
Seat 9: cobrik23 (big blind) folded before Flop





PokerStars Hand #150752870542:  Hold'em No Limit ($1/$2 USD) - 2016/03/22 14:37:05 CET [2016/03/22 9:37:05 ET]
Table 'Kiso II' 9-max Seat #1 is the button
Seat 1: DUkalisUA ($200 in chips) 
Seat 2: di0d80 ($598.75 in chips) 
Seat 3: seouljam ($363.66 in chips) 
Seat 4: N4$H ($200 in chips) 
Seat 6: KT90 ($343.30 in chips) 
Seat 7: Igoriah ($200 in chips) 
Seat 8: bananajoe001 ($169.84 in chips) 
Seat 9: matiko09 ($200 in chips) 
di0d80: posts small blind $1
seouljam: posts big blind $2
IntsAA: sits out 
*** HOLE CARDS ***
Dealt to matiko09 [4s 8d]
N4$H: folds 
KT90: folds 
Igoriah: folds 
bananajoe001: calls $2
matiko09: folds 
DUkalisUA: raises $6 to $8
di0d80: folds 
seouljam: folds 
bananajoe001: folds 
Uncalled bet ($6) returned to DUkalisUA
DUkalisUA collected $7 from pot
DUkalisUA: doesn't show hand 
*** SUMMARY ***
Total pot $7 | Rake $0 
Seat 1: DUkalisUA (button) collected ($7)
Seat 2: di0d80 (small blind) folded before Flop
Seat 3: seouljam (big blind) folded before Flop
Seat 4: N4$H folded before Flop (didn't bet)
Seat 6: KT90 folded before Flop (didn't bet)
Seat 7: Igoriah folded before Flop (didn't bet)
Seat 8: bananajoe001 folded before Flop
Seat 9: matiko09 folded before Flop (didn't bet)





PokerStars Hand #150752875961:  Hold'em No Limit ($0.50/$1.00 USD) - 2016/03/22 14:37:14 CET [2016/03/22 9:37:14 ET]
Table 'Stephano II' 9-max Seat #8 is the button
Seat 1: omorfadramou ($202.20 in chips) 
Seat 2: I The King I ($101.50 in chips) 
Seat 3: lombardo11 ($62.48 in chips) 
Seat 4: AWATAR 21 ($191.08 in chips) 
Seat 5: mb2part ($90.41 in chips) 
Seat 6: beterc0re ($100 in chips) 
Seat 7: nickreason17 ($100 in chips) 
Seat 8: KingCastle77 ($88.22 in chips) 
Seat 9: matiko09 ($100 in chips) 
matiko09: posts small blind $0.50
omorfadramou: posts big blind $1
*** HOLE CARDS ***
Dealt to matiko09 [7c Qs]
I The King I: raises $2 to $3
lombardo11: folds 
AWATAR 21: folds 
mb2part: folds 
beterc0re: folds 
nickreason17: calls $3
KingCastle77: folds 
matiko09: folds 
omorfadramou: raises $10.50 to $13.50
I The King I: folds 
nickreason17: folds 
Uncalled bet ($10.50) returned to omorfadramou
omorfadramou collected $9.50 from pot
omorfadramou: doesn't show hand 
*** SUMMARY ***
Total pot $9.50 | Rake $0 
Seat 1: omorfadramou (big blind) collected ($9.50)
Seat 2: I The King I folded before Flop
Seat 3: lombardo11 folded before Flop (didn't bet)
Seat 4: AWATAR 21 folded before Flop (didn't bet)
Seat 5: mb2part folded before Flop (didn't bet)
Seat 6: beterc0re folded before Flop (didn't bet)
Seat 7: nickreason17 folded before Flop
Seat 8: KingCastle77 (button) folded before Flop (didn't bet)
Seat 9: matiko09 (small blind) folded before Flop





PokerStars Hand #150752876745:  Hold'em No Limit ($0.50/$1.00 USD) - 2016/03/22 14:37:15 CET [2016/03/22 9:37:15 ET]
Table 'Crater II' 9-max Seat #8 is the button
Seat 1: matiko09 ($129.62 in chips) 
Seat 2: Eisbaerli85 ($126.41 in chips) 
Seat 3: hammerwife ($110.19 in chips) 
Seat 4: fanmtZ ($43.10 in chips) 
Seat 6: Kobiroga150 ($86.14 in chips) 
Seat 7: AWATAR 21 ($56.60 in chips) 
Seat 8: KronosAK ($108.28 in chips) 
Seat 9: I The King I ($122.41 in chips) 
I The King I: posts small blind $0.50
matiko09: posts big blind $1
Effort92: sits out 
*** HOLE CARDS ***
Dealt to matiko09 [Tc Jc]
Eisbaerli85: folds 
hammerwife: folds 
fanmtZ: folds 
Kobiroga150: folds 
AWATAR 21: folds 
KronosAK: folds 
I The King I: folds 
Uncalled bet ($0.50) returned to matiko09
matiko09 collected $1 from pot
matiko09: doesn't show hand 
*** SUMMARY ***
Total pot $1 | Rake $0 
Seat 1: matiko09 (big blind) collected ($1)
Seat 2: Eisbaerli85 folded before Flop (didn't bet)
Seat 3: hammerwife folded before Flop (didn't bet)
Seat 4: fanmtZ folded before Flop (didn't bet)
Seat 6: Kobiroga150 folded before Flop (didn't bet)
Seat 7: AWATAR 21 folded before Flop (didn't bet)
Seat 8: KronosAK (button) folded before Flop (didn't bet)
Seat 9: I The King I (small blind) folded before Flop





PokerStars Hand #150752878135:  Hold'em No Limit ($0.50/$1.00 USD) - 2016/03/22 14:37:17 CET [2016/03/22 9:37:17 ET]
Table 'Colchis' 9-max Seat #8 is the button
Seat 1: theluckyjoe ($17.64 in chips) 
Seat 2: Ilov3NBA ($158.41 in chips) 
Seat 3: bragutza ($95.81 in chips) 
Seat 4: matiko09 ($105.28 in chips) 
Seat 5: lumen21 ($169.84 in chips) 
Seat 6: hammerwife ($100 in chips) 
Seat 7: Dantist1122 ($100 in chips) 
Seat 8: cobrik23 ($49.22 in chips) 
Seat 9: ardo888 ($100 in chips) 
ardo888: posts small blind $0.50
theluckyjoe: posts big blind $1
*** HOLE CARDS ***
Dealt to matiko09 [Ks Ad]
Ilov3NBA: folds 
bragutza: folds 
matiko09: raises $2 to $3
lumen21: folds 
hammerwife: folds 
Dantist1122: folds 
cobrik23: folds 
ardo888: folds 
theluckyjoe: folds 
Uncalled bet ($2) returned to matiko09
matiko09 collected $2.50 from pot
matiko09: doesn't show hand 
*** SUMMARY ***
Total pot $2.50 | Rake $0 
Seat 1: theluckyjoe (big blind) folded before Flop
Seat 2: Ilov3NBA folded before Flop (didn't bet)
Seat 3: bragutza folded before Flop (didn't bet)
Seat 4: matiko09 collected ($2.50)
Seat 5: lumen21 folded before Flop (didn't bet)
Seat 6: hammerwife folded before Flop (didn't bet)
Seat 7: Dantist1122 folded before Flop (didn't bet)
Seat 8: cobrik23 (button) folded before Flop (didn't bet)
Seat 9: ardo888 (small blind) folded before Flop





PokerStars Hand #150752879894:  Hold'em No Limit ($0.50/$1.00 USD) - 2016/03/22 14:37:20 CET [2016/03/22 9:37:20 ET]
Table 'Harding' 9-max Seat #5 is the button
Seat 1: matiko09 ($116.39 in chips) 
Seat 2: RICKA16 ($115.25 in chips) 
Seat 3: DUkalisUA ($113.87 in chips) 
Seat 4: beterc0re ($100 in chips) 
Seat 5: nickreason17 ($101.86 in chips) 
Seat 7: mrhighryza ($120.13 in chips) 
Seat 8: di0d80 ($105.65 in chips) 
Seat 9: omorfadramou ($104 in chips) 
mrhighryza: posts small blind $0.50
di0d80: posts big blind $1
*** HOLE CARDS ***
Dealt to matiko09 [3h Td]
omorfadramou: folds 
matiko09: folds 
RICKA16: folds 
DUkalisUA: folds 
beterc0re: folds 
nickreason17: folds 
mrhighryza: calls $0.50
di0d80: checks 
*** FLOP *** [5d 9h Qh]
mrhighryza: checks 
di0d80: checks 
*** TURN *** [5d 9h Qh] [8d]
mrhighryza: checks 
di0d80: checks 
*** RIVER *** [5d 9h Qh 8d] [Th]
mrhighryza: checks 
di0d80: checks 
*** SHOW DOWN ***
mrhighryza: shows [6d Jh] (a straight, Eight to Queen)
di0d80: mucks hand 
mrhighryza collected $1.91 from pot
*** SUMMARY ***
Total pot $2 | Rake $0.09 
Board [5d 9h Qh 8d Th]
Seat 1: matiko09 folded before Flop (didn't bet)
Seat 2: RICKA16 folded before Flop (didn't bet)
Seat 3: DUkalisUA folded before Flop (didn't bet)
Seat 4: beterc0re folded before Flop (didn't bet)
Seat 5: nickreason17 (button) folded before Flop (didn't bet)
Seat 7: mrhighryza (small blind) showed [6d Jh] and won ($1.91) with a straight, Eight to Queen
Seat 8: di0d80 (big blind) mucked [4c 3d]
Seat 9: omorfadramou folded before Flop (didn't bet)





PokerStars Hand #150752888922:  Hold'em No Limit ($0.50/$1.00 USD) - 2016/03/22 14:37:34 CET [2016/03/22 9:37:34 ET]
Table 'Taygeta II' 9-max Seat #8 is the button
Seat 1: DUkalisUA ($100 in chips) 
Seat 2: khan Erkesh ($186.30 in chips) 
Seat 3: Muinmyheart ($106.30 in chips) 
Seat 4: matiko09 ($125.36 in chips) 
Seat 5: RICKA16 ($117.49 in chips) 
Seat 6: I The King I ($116.41 in chips) 
Seat 7: Szevasztopol ($100 in chips) 
Seat 8: Effort92 ($100 in chips) 
Seat 9: cobrik23 ($41.90 in chips) 
cobrik23: posts small blind $0.50
DUkalisUA: posts big blind $1
*** HOLE CARDS ***
Dealt to matiko09 [Kh Kd]
khan Erkesh: folds 
Muinmyheart: folds 
matiko09: raises $2 to $3
khan Erkesh leaves the table
RICKA16: folds 
I The King I: folds 
Szevasztopol: folds 
DevilisHEyz joins the table at seat #2 
Effort92: folds 
cobrik23: folds 
DUkalisUA: folds 
Uncalled bet ($2) returned to matiko09
matiko09 collected $2.50 from pot
matiko09: doesn't show hand 
*** SUMMARY ***
Total pot $2.50 | Rake $0 
Seat 1: DUkalisUA (big blind) folded before Flop
Seat 2: khan Erkesh folded before Flop (didn't bet)
Seat 3: Muinmyheart folded before Flop (didn't bet)
Seat 4: matiko09 collected ($2.50)
Seat 5: RICKA16 folded before Flop (didn't bet)
Seat 6: I The King I folded before Flop (didn't bet)
Seat 7: Szevasztopol folded before Flop (didn't bet)
Seat 8: Effort92 (button) folded before Flop (didn't bet)
Seat 9: cobrik23 (small blind) folded before Flop





PokerStars Hand #150752894023:  Hold'em No Limit ($0.50/$1.00 USD) - 2016/03/22 14:37:42 CET [2016/03/22 9:37:42 ET]
Table 'Crater II' 9-max Seat #9 is the button
Seat 1: matiko09 ($130.12 in chips) 
Seat 2: Eisbaerli85 ($126.41 in chips) 
Seat 3: hammerwife ($110.19 in chips) 
Seat 4: fanmtZ ($43.10 in chips) 
Seat 6: Kobiroga150 ($86.14 in chips) 
Seat 7: AWATAR 21 ($56.60 in chips) 
Seat 8: KronosAK ($108.28 in chips) 
Seat 9: I The King I ($121.91 in chips) 
matiko09: posts small blind $0.50
Eisbaerli85: posts big blind $1
Effort92: sits out 
*** HOLE CARDS ***
Dealt to matiko09 [9s 9c]
hammerwife: folds 
fanmtZ: raises $1.38 to $2.38
Kobiroga150: folds 
AWATAR 21: folds 
KronosAK: folds 
I The King I: folds 
matiko09: folds 
Eisbaerli85: calls $1.38
*** FLOP *** [Qd 8d Qh]
Eisbaerli85: checks 
fanmtZ: bets $3.36
Eisbaerli85: calls $3.36
*** TURN *** [Qd 8d Qh] [Jh]
Eisbaerli85: checks 
fanmtZ: checks 
*** RIVER *** [Qd 8d Qh Jh] [Ah]
Eisbaerli85: bets $4.34
fanmtZ: calls $4.34
*** SHOW DOWN ***
Eisbaerli85: shows [Jc Qc] (a full house, Queens full of Jacks)
fanmtZ: mucks hand 
Eisbaerli85 collected $19.73 from pot
*** SUMMARY ***
Total pot $20.66 | Rake $0.93 
Board [Qd 8d Qh Jh Ah]
Seat 1: matiko09 (small blind) folded before Flop
Seat 2: Eisbaerli85 (big blind) showed [Jc Qc] and won ($19.73) with a full house, Queens full of Jacks
Seat 3: hammerwife folded before Flop (didn't bet)
Seat 4: fanmtZ mucked [As 7s]
Seat 6: Kobiroga150 folded before Flop (didn't bet)
Seat 7: AWATAR 21 folded before Flop (didn't bet)
Seat 8: KronosAK folded before Flop (didn't bet)
Seat 9: I The King I (button) folded before Flop (didn't bet)





PokerStars Hand #150752897741:  Hold'em No Limit ($1/$2 USD) - 2016/03/22 14:37:48 CET [2016/03/22 9:37:48 ET]
Table 'Kiso II' 9-max Seat #2 is the button
Seat 1: DUkalisUA ($205 in chips) 
Seat 2: di0d80 ($597.75 in chips) 
Seat 3: seouljam ($361.66 in chips) 
Seat 4: N4$H ($200 in chips) 
Seat 6: KT90 ($343.30 in chips) 
Seat 7: Igoriah ($200 in chips) 
Seat 8: bananajoe001 ($167.84 in chips) 
Seat 9: matiko09 ($200 in chips) 
seouljam: posts small blind $1
N4$H: posts big blind $2
IntsAA: sits out 
*** HOLE CARDS ***
Dealt to matiko09 [3s Ts]
KT90: folds 
Igoriah: folds 
bananajoe001: calls $2
matiko09: folds 
DUkalisUA: folds 
di0d80: folds 
seouljam: folds 
N4$H: checks 
*** FLOP *** [8d Kh Th]
N4$H: checks 
bananajoe001: bets $6
N4$H: folds 
Uncalled bet ($6) returned to bananajoe001
bananajoe001 collected $4.78 from pot
bananajoe001: doesn't show hand 
*** SUMMARY ***
Total pot $5 | Rake $0.22 
Board [8d Kh Th]
Seat 1: DUkalisUA folded before Flop (didn't bet)
Seat 2: di0d80 (button) folded before Flop (didn't bet)
Seat 3: seouljam (small blind) folded before Flop
Seat 4: N4$H (big blind) folded on the Flop
Seat 6: KT90 folded before Flop (didn't bet)
Seat 7: Igoriah folded before Flop (didn't bet)
Seat 8: bananajoe001 collected ($4.78)
Seat 9: matiko09 folded before Flop (didn't bet)





PokerStars Hand #150752903504:  Hold'em No Limit ($0.50/$1.00 USD) - 2016/03/22 14:37:57 CET [2016/03/22 9:37:57 ET]
Table 'Arabis' 9-max Seat #4 is the button
Seat 1: di0d80 ($112.50 in chips) 
Seat 2: hammerwife ($100 in chips) 
Seat 3: lumen21 ($100 in chips) 
Seat 4: Painkiller72 ($191.09 in chips) 
Seat 5: matiko09 ($127.99 in chips) 
Seat 7: howsiao ($146.38 in chips) 
Seat 8: Bro_Happy ($207.36 in chips) 
Seat 9: cobrik23 ($63.65 in chips) 
matiko09: posts small blind $0.50
howsiao: posts big blind $1
*** HOLE CARDS ***
Dealt to matiko09 [Jd 2c]
Bro_Happy: folds 
cobrik23: folds 
di0d80: folds 
hammerwife: folds 
lumen21: folds 
Painkiller72: folds 
matiko09: folds 
Uncalled bet ($0.50) returned to howsiao
howsiao collected $1 from pot
howsiao: doesn't show hand 
*** SUMMARY ***
Total pot $1 | Rake $0 
Seat 1: di0d80 folded before Flop (didn't bet)
Seat 2: hammerwife folded before Flop (didn't bet)
Seat 3: lumen21 folded before Flop (didn't bet)
Seat 4: Painkiller72 (button) folded before Flop (didn't bet)
Seat 5: matiko09 (small blind) folded before Flop
Seat 7: howsiao (big blind) collected ($1)
Seat 8: Bro_Happy folded before Flop (didn't bet)
Seat 9: cobrik23 folded before Flop (didn't bet)





PokerStars Hand #150752913565:  Hold'em No Limit ($0.50/$1.00 USD) - 2016/03/22 14:38:13 CET [2016/03/22 9:38:13 ET]
Table 'Polyxena' 9-max Seat #8 is the button
Seat 1: I The King I ($102.73 in chips) 
Seat 2: cobrik23 ($94.69 in chips) 
Seat 3: di0d80 ($112.26 in chips) 
Seat 4: fanmtZ ($55.94 in chips) 
Seat 5: MrAndMisses ($44.17 in chips) 
Seat 6: Ilov3NBA ($100 in chips) 
Seat 7: matiko09 ($100 in chips) 
Seat 8: kift74 ($124.22 in chips) 
Seat 9: ardo888 ($147.58 in chips) 
ardo888: posts small blind $0.50
I The King I: posts big blind $1
*** HOLE CARDS ***
Dealt to matiko09 [6d 5s]
cobrik23: folds 
di0d80: folds 
fanmtZ: raises $1.38 to $2.38
MrAndMisses: raises $1.38 to $3.76
Ilov3NBA: folds 
matiko09: folds 
kift74: folds 
ardo888: folds 
I The King I: folds 
fanmtZ: calls $1.38
*** FLOP *** [8c 9h 6c]
fanmtZ: checks 
MrAndMisses: bets $40.41 and is all-in
fanmtZ: folds 
Uncalled bet ($40.41) returned to MrAndMisses
MrAndMisses collected $8.61 from pot
MrAndMisses: doesn't show hand 
*** SUMMARY ***
Total pot $9.02 | Rake $0.41 
Board [8c 9h 6c]
Seat 1: I The King I (big blind) folded before Flop
Seat 2: cobrik23 folded before Flop (didn't bet)
Seat 3: di0d80 folded before Flop (didn't bet)
Seat 4: fanmtZ folded on the Flop
Seat 5: MrAndMisses collected ($8.61)
Seat 6: Ilov3NBA folded before Flop (didn't bet)
Seat 7: matiko09 folded before Flop (didn't bet)
Seat 8: kift74 (button) folded before Flop (didn't bet)
Seat 9: ardo888 (small blind) folded before Flop





PokerStars Hand #150752913281:  Hold'em No Limit ($0.50/$1.00 USD) - 2016/03/22 14:38:13 CET [2016/03/22 9:38:13 ET]
Table 'Harding' 9-max Seat #7 is the button
Seat 1: matiko09 ($116.39 in chips) 
Seat 2: RICKA16 ($115.25 in chips) 
Seat 3: DUkalisUA ($113.87 in chips) 
Seat 4: beterc0re ($100 in chips) 
Seat 5: nickreason17 ($101.86 in chips) 
Seat 7: mrhighryza ($121.04 in chips) 
Seat 8: di0d80 ($104.65 in chips) 
Seat 9: omorfadramou ($104 in chips) 
di0d80: posts small blind $0.50
omorfadramou: posts big blind $1
*** HOLE CARDS ***
Dealt to matiko09 [Kd 2c]
matiko09: folds 
RICKA16: folds 
DUkalisUA: folds 
beterc0re: folds 
nickreason17: raises $1.50 to $2.50
mrhighryza: calls $2.50
di0d80: folds 
omorfadramou: folds 
*** FLOP *** [Ts 7d 8h]
nickreason17: bets $3.25
mrhighryza: calls $3.25
*** TURN *** [Ts 7d 8h] [Qs]
nickreason17: checks 
mrhighryza: bets $6
nickreason17: folds 
Uncalled bet ($6) returned to mrhighryza
mrhighryza collected $12.42 from pot
*** SUMMARY ***
Total pot $13 | Rake $0.58 
Board [Ts 7d 8h Qs]
Seat 1: matiko09 folded before Flop (didn't bet)
Seat 2: RICKA16 folded before Flop (didn't bet)
Seat 3: DUkalisUA folded before Flop (didn't bet)
Seat 4: beterc0re folded before Flop (didn't bet)
Seat 5: nickreason17 folded on the Turn
Seat 7: mrhighryza (button) collected ($12.42)
Seat 8: di0d80 (small blind) folded before Flop
Seat 9: omorfadramou (big blind) folded before Flop





PokerStars Hand #150752914079:  Hold'em No Limit (€0.50/€1.00 EUR) - 2016/03/22 14:38:14 CET [2016/03/22 9:38:14 ET]
Table 'Mavis II' 9-max Seat #7 is the button
Seat 1: cobrik23 (€102.50 in chips) 
Seat 5: omarr22 (€33.50 in chips) 
Seat 6: hammerwife (€101 in chips) 
Seat 7: Painkiller72 (€106.33 in chips) 
Seat 8: Kukuryzka (€99 in chips) 
Seat 9: matiko09 (€100 in chips) 
Kukuryzka: posts small blind €0.50
matiko09: posts big blind €1
Dantist1122: sits out 
*** HOLE CARDS ***
Dealt to matiko09 [Kc 9s]
cobrik23: raises €2 to €3
omarr22: calls €3
hammerwife: folds 
Painkiller72: folds 
Kukuryzka: folds 
matiko09: folds 
*** FLOP *** [3s 9d 3h]
cobrik23: checks 
omarr22: bets €4
cobrik23: folds 
Uncalled bet (€4) returned to omarr22
omarr22 collected €7.16 from pot
omarr22: doesn't show hand 
*** SUMMARY ***
Total pot €7.50 | Rake €0.34 
Board [3s 9d 3h]
Seat 1: cobrik23 folded on the Flop
Seat 5: omarr22 collected (€7.16)
Seat 6: hammerwife folded before Flop (didn't bet)
Seat 7: Painkiller72 (button) folded before Flop (didn't bet)
Seat 8: Kukuryzka (small blind) folded before Flop
Seat 9: matiko09 (big blind) folded before Flop





PokerStars Hand #150752914299:  Hold'em No Limit ($0.50/$1.00 USD) - 2016/03/22 14:38:15 CET [2016/03/22 9:38:15 ET]
Table 'Colchis' 9-max Seat #9 is the button
Seat 1: theluckyjoe ($16.64 in chips) 
Seat 3: bragutza ($95.81 in chips) 
Seat 4: matiko09 ($106.78 in chips) 
Seat 5: lumen21 ($169.84 in chips) 
Seat 6: hammerwife ($100 in chips) 
Seat 7: Dantist1122 ($100 in chips) 
Seat 8: cobrik23 ($49.22 in chips) 
Seat 9: ardo888 ($100 in chips) 
theluckyjoe: posts small blind $0.50
Ilov3NBA: is sitting out 
bragutza: posts big blind $1
*** HOLE CARDS ***
Dealt to matiko09 [3d 4c]
matiko09: folds 
lumen21: folds 
hammerwife: folds 
Dantist1122: folds 
cobrik23: raises $2 to $3
ardo888: folds 
theluckyjoe: folds 
bragutza: folds 
Uncalled bet ($2) returned to cobrik23
cobrik23 collected $2.50 from pot
cobrik23: doesn't show hand 
*** SUMMARY ***
Total pot $2.50 | Rake $0 
Seat 1: theluckyjoe (small blind) folded before Flop
Seat 3: bragutza (big blind) folded before Flop
Seat 4: matiko09 folded before Flop (didn't bet)
Seat 5: lumen21 folded before Flop (didn't bet)
Seat 6: hammerwife folded before Flop (didn't bet)
Seat 7: Dantist1122 folded before Flop (didn't bet)
Seat 8: cobrik23 collected ($2.50)
Seat 9: ardo888 (button) folded before Flop (didn't bet)





PokerStars Hand #150752917704:  Hold'em No Limit ($0.50/$1.00 USD) - 2016/03/22 14:38:20 CET [2016/03/22 9:38:20 ET]
Table 'Miranda' 9-max Seat #6 is the button
Seat 1: cobrik23 ($114.94 in chips) 
Seat 2: Szevasztopol ($117.51 in chips) 
Seat 3: Muinmyheart ($201.20 in chips) 
Seat 4: bilukm ($100 in chips) 
Seat 5: beterc0re ($100 in chips) 
Seat 6: matiko09 ($210.20 in chips) 
Seat 7: RICKA16 ($103.50 in chips) 
Seat 8: hammerwife ($116.48 in chips) 
Seat 9: ardo888 ($166.92 in chips) 
RICKA16: posts small blind $0.50
hammerwife: posts big blind $1
*** HOLE CARDS ***
Dealt to matiko09 [8d Th]
ardo888: folds 
cobrik23: folds 
Szevasztopol: folds 
Muinmyheart: folds 
bilukm: folds 
beterc0re: raises $2 to $3
matiko09: folds 
RICKA16: folds 
hammerwife: folds 
Uncalled bet ($2) returned to beterc0re
beterc0re collected $2.50 from pot
beterc0re: doesn't show hand 
*** SUMMARY ***
Total pot $2.50 | Rake $0 
Seat 1: cobrik23 folded before Flop (didn't bet)
Seat 2: Szevasztopol folded before Flop (didn't bet)
Seat 3: Muinmyheart folded before Flop (didn't bet)
Seat 4: bilukm folded before Flop (didn't bet)
Seat 5: beterc0re collected ($2.50)
Seat 6: matiko09 (button) folded before Flop (didn't bet)
Seat 7: RICKA16 (small blind) folded before Flop
Seat 8: hammerwife (big blind) folded before Flop
Seat 9: ardo888 folded before Flop (didn't bet)





PokerStars Hand #150752919337:  Hold'em No Limit ($1/$2 USD) - 2016/03/22 14:38:23 CET [2016/03/22 9:38:23 ET]
Table 'Garlena II' 9-max Seat #2 is the button
Seat 1: nickreason17 ($220.98 in chips) 
Seat 2: di0d80 ($242.68 in chips) 
Seat 3: N4$H ($200 in chips) 
Seat 4: KT90 ($201.92 in chips) 
Seat 5: IntsAA ($206.19 in chips) 
Seat 7: Bothfeld11 ($159.35 in chips) 
Seat 8: samps777 ($36.70 in chips) 
Seat 9: matiko09 ($208.42 in chips) 
N4$H: posts small blind $1
KT90: posts big blind $2
*** HOLE CARDS ***
Dealt to matiko09 [3s 3c]
IntsAA: folds 
Bothfeld11: calls $2
samps777: folds 
matiko09: raises $4 to $6
nickreason17: folds 
di0d80: folds 
N4$H: folds 
KT90: raises $14 to $20
Bothfeld11: folds 
matiko09: folds 
Uncalled bet ($14) returned to KT90
KT90 collected $15 from pot
KT90: doesn't show hand 
*** SUMMARY ***
Total pot $15 | Rake $0 
Seat 1: nickreason17 folded before Flop (didn't bet)
Seat 2: di0d80 (button) folded before Flop (didn't bet)
Seat 3: N4$H (small blind) folded before Flop
Seat 4: KT90 (big blind) collected ($15)
Seat 5: IntsAA folded before Flop (didn't bet)
Seat 7: Bothfeld11 folded before Flop
Seat 8: samps777 folded before Flop (didn't bet)
Seat 9: matiko09 folded before Flop





PokerStars Hand #150752926772:  Hold'em No Limit ($0.50/$1.00 USD) - 2016/03/22 14:38:34 CET [2016/03/22 9:38:34 ET]
Table 'Arabis' 9-max Seat #5 is the button
Seat 1: di0d80 ($112.50 in chips) 
Seat 2: hammerwife ($100 in chips) 
Seat 3: lumen21 ($100 in chips) 
Seat 4: Painkiller72 ($191.09 in chips) 
Seat 5: matiko09 ($127.49 in chips) 
Seat 7: howsiao ($146.88 in chips) 
Seat 8: Bro_Happy ($207.36 in chips) 
Seat 9: cobrik23 ($63.65 in chips) 
howsiao: posts small blind $0.50
Bro_Happy: posts big blind $1
*** HOLE CARDS ***
Dealt to matiko09 [Qh 7d]
cobrik23: folds 
di0d80: folds 
hammerwife: folds 
lumen21: folds 
Painkiller72: folds 
matiko09: raises $1.27 to $2.27
howsiao: folds 
Bro_Happy has timed out
Bro_Happy: folds 
Uncalled bet ($1.27) returned to matiko09
matiko09 collected $2.50 from pot
matiko09: doesn't show hand 
*** SUMMARY ***
Total pot $2.50 | Rake $0 
Seat 1: di0d80 folded before Flop (didn't bet)
Seat 2: hammerwife folded before Flop (didn't bet)
Seat 3: lumen21 folded before Flop (didn't bet)
Seat 4: Painkiller72 folded before Flop (didn't bet)
Seat 5: matiko09 (button) collected ($2.50)
Seat 7: howsiao (small blind) folded before Flop
Seat 8: Bro_Happy (big blind) folded before Flop
Seat 9: cobrik23 folded before Flop (didn't bet)





PokerStars Hand #150752928875:  Hold'em No Limit ($0.50/$1.00 USD) - 2016/03/22 14:38:38 CET [2016/03/22 9:38:38 ET]
Table 'Stephano II' 9-max Seat #9 is the button
Seat 1: omorfadramou ($208.70 in chips) 
Seat 2: I The King I ($100 in chips) 
Seat 3: lombardo11 ($62.48 in chips) 
Seat 4: AWATAR 21 ($191.08 in chips) 
Seat 5: mb2part ($90.41 in chips) 
Seat 6: beterc0re ($100 in chips) 
Seat 7: nickreason17 ($100 in chips) 
Seat 8: KingCastle77 ($88.22 in chips) 
Seat 9: matiko09 ($100 in chips) 
omorfadramou: posts small blind $0.50
I The King I: posts big blind $1
*** HOLE CARDS ***
Dealt to matiko09 [7h Js]
lombardo11 has timed out
lombardo11: folds 
AWATAR 21: folds 
mb2part: folds 
beterc0re: folds 
nickreason17: folds 
KingCastle77 has timed out
KingCastle77: folds 
matiko09: folds 
omorfadramou: folds 
Uncalled bet ($0.50) returned to I The King I
I The King I collected $1 from pot
I The King I: doesn't show hand 
*** SUMMARY ***
Total pot $1 | Rake $0 
Seat 1: omorfadramou (small blind) folded before Flop
Seat 2: I The King I (big blind) collected ($1)
Seat 3: lombardo11 folded before Flop (didn't bet)
Seat 4: AWATAR 21 folded before Flop (didn't bet)
Seat 5: mb2part folded before Flop (didn't bet)
Seat 6: beterc0re folded before Flop (didn't bet)
Seat 7: nickreason17 folded before Flop (didn't bet)
Seat 8: KingCastle77 folded before Flop (didn't bet)
Seat 9: matiko09 (button) folded before Flop (didn't bet)





PokerStars Hand #150752933970:  Hold'em No Limit ($0.50/$1.00 USD) - 2016/03/22 14:38:46 CET [2016/03/22 9:38:46 ET]
Table 'Miranda' 9-max Seat #7 is the button
Seat 1: cobrik23 ($114.94 in chips) 
Seat 2: Szevasztopol ($117.51 in chips) 
Seat 3: Muinmyheart ($201.20 in chips) 
Seat 4: bilukm ($100 in chips) 
Seat 5: beterc0re ($101.50 in chips) 
Seat 6: matiko09 ($210.20 in chips) 
Seat 7: RICKA16 ($103 in chips) 
Seat 8: hammerwife ($115.48 in chips) 
Seat 9: ardo888 ($166.92 in chips) 
hammerwife: posts small blind $0.50
ardo888: posts big blind $1
*** HOLE CARDS ***
Dealt to matiko09 [Js 8h]
cobrik23: folds 
Szevasztopol: folds 
Muinmyheart: folds 
bilukm: folds 
beterc0re: raises $2 to $3
matiko09: folds 
RICKA16: folds 
hammerwife: folds 
ardo888: folds 
Uncalled bet ($2) returned to beterc0re
beterc0re collected $2.50 from pot
beterc0re: doesn't show hand 
*** SUMMARY ***
Total pot $2.50 | Rake $0 
Seat 1: cobrik23 folded before Flop (didn't bet)
Seat 2: Szevasztopol folded before Flop (didn't bet)
Seat 3: Muinmyheart folded before Flop (didn't bet)
Seat 4: bilukm folded before Flop (didn't bet)
Seat 5: beterc0re collected ($2.50)
Seat 6: matiko09 folded before Flop (didn't bet)
Seat 7: RICKA16 (button) folded before Flop (didn't bet)
Seat 8: hammerwife (small blind) folded before Flop
Seat 9: ardo888 (big blind) folded before Flop





PokerStars Hand #150752935046:  Hold'em No Limit (€0.50/€1.00 EUR) - 2016/03/22 14:38:47 CET [2016/03/22 9:38:47 ET]
Table 'Mavis II' 9-max Seat #8 is the button
Seat 1: cobrik23 (€99.50 in chips) 
Seat 5: omarr22 (€37.66 in chips) 
Seat 6: hammerwife (€101 in chips) 
Seat 7: Painkiller72 (€106.33 in chips) 
Seat 8: Kukuryzka (€100 in chips) 
Seat 9: matiko09 (€100 in chips) 
matiko09: posts small blind €0.50
cobrik23: posts big blind €1
Dantist1122: sits out 
*** HOLE CARDS ***
Dealt to matiko09 [5d Ks]
omarr22: folds 
hammerwife: folds 
Painkiller72: folds 
Kukuryzka: folds 
matiko09: folds 
Uncalled bet (€0.50) returned to cobrik23
cobrik23 collected €1 from pot
cobrik23: doesn't show hand 
*** SUMMARY ***
Total pot €1 | Rake €0 
Seat 1: cobrik23 (big blind) collected (€1)
Seat 5: omarr22 folded before Flop (didn't bet)
Seat 6: hammerwife folded before Flop (didn't bet)
Seat 7: Painkiller72 folded before Flop (didn't bet)
Seat 8: Kukuryzka (button) folded before Flop (didn't bet)
Seat 9: matiko09 (small blind) folded before Flop





