PokerStars Hand #153065514521:  Hold'em No Limit ($0.50/$1.00 USD) - 2016/05/09 15:41:48 CET [2016/05/09 9:41:48 ET]
Table 'Reiss' 9-max Seat #2 is the button
Seat 1: birdie1970 ($443.44 in chips) 
Seat 2: mycka86 ($115.81 in chips) 
Seat 3: chaps1988 ($117.49 in chips) 
Seat 4: MichaLabam ($148.61 in chips) 
Seat 5: matiko09 ($113.63 in chips) 
Seat 6: Spid1 ($100 in chips) 
Seat 7: Bimaxa ($100 in chips) 
Seat 8: Filojoes ($203.18 in chips) 
Seat 9: maxxmeister ($139.46 in chips) 
chaps1988: posts small blind $0.50
MichaLabam: posts big blind $1
*** HOLE CARDS ***
Dealt to matiko09 [5c 4d]
matiko09: folds 
Spid1: folds 
Bimaxa: folds 
Filojoes: raises $2 to $3
maxxmeister: folds 
birdie1970: folds 
mycka86: folds 
chaps1988: folds 
MichaLabam: calls $2
*** FLOP *** [Ts Th 3h]
MichaLabam: checks 
Filojoes: checks 
*** TURN *** [Ts Th 3h] [7c]
MichaLabam: bets $3
Filojoes: calls $3
*** RIVER *** [Ts Th 3h 7c] [6d]
MichaLabam: checks 
Filojoes: checks 
*** SHOW DOWN ***
MichaLabam: shows [6s 9s] (two pair, Tens and Sixes)
Filojoes: mucks hand 
MichaLabam collected $11.88 from pot
*** SUMMARY ***
Total pot $12.50 | Rake $0.62 
Board [Ts Th 3h 7c 6d]
Seat 1: birdie1970 folded before Flop (didn't bet)
Seat 2: mycka86 (button) folded before Flop (didn't bet)
Seat 3: chaps1988 (small blind) folded before Flop
Seat 4: MichaLabam (big blind) showed [6s 9s] and won ($11.88) with two pair, Tens and Sixes
Seat 5: matiko09 folded before Flop (didn't bet)
Seat 6: Spid1 folded before Flop (didn't bet)
Seat 7: Bimaxa folded before Flop (didn't bet)
Seat 8: Filojoes mucked [Ah Qs]
Seat 9: maxxmeister folded before Flop (didn't bet)





PokerStars Hand #153065515246:  Hold'em No Limit ($0.50/$1.00 USD) - 2016/05/09 15:41:50 CET [2016/05/09 9:41:50 ET]
Table 'Mentha' 9-max Seat #9 is the button
Seat 1: maxxmeister ($126.75 in chips) 
Seat 2: guoweiAA ($178.47 in chips) 
Seat 3: r4mz3s ($103.68 in chips) 
Seat 4: duggy2016 ($68.94 in chips) 
Seat 5: mycka86 ($126.38 in chips) 
Seat 6: Filojoes ($164.61 in chips) 
Seat 7: matiko09 ($117.85 in chips) 
Seat 8: Spid1 ($100 in chips) 
Seat 9: Adi218 ($97.86 in chips) 
maxxmeister: posts small blind $0.50
guoweiAA: posts big blind $1
*** HOLE CARDS ***
Dealt to matiko09 [Js 9c]
r4mz3s: folds 
duggy2016: folds 
mycka86: folds 
Filojoes: folds 
matiko09: folds 
Spid1: folds 
Adi218: folds 
Adi218 leaves the table
maxxmeister: raises $2.50 to $3.50
nubpoker joins the table at seat #9 
guoweiAA: folds 
Uncalled bet ($2.50) returned to maxxmeister
nubpoker leaves the table
Kukuryzka joins the table at seat #9 
maxxmeister collected $2 from pot
maxxmeister: doesn't show hand 
*** SUMMARY ***
Total pot $2 | Rake $0 
Seat 1: maxxmeister (small blind) collected ($2)
Seat 2: guoweiAA (big blind) folded before Flop
Seat 3: r4mz3s folded before Flop (didn't bet)
Seat 4: duggy2016 folded before Flop (didn't bet)
Seat 5: mycka86 folded before Flop (didn't bet)
Seat 6: Filojoes folded before Flop (didn't bet)
Seat 7: matiko09 folded before Flop (didn't bet)
Seat 8: Spid1 folded before Flop (didn't bet)
Seat 9: Adi218 (button) folded before Flop (didn't bet)





PokerStars Hand #153065518749:  Hold'em No Limit ($0.50/$1.00 USD) - 2016/05/09 15:41:56 CET [2016/05/09 9:41:56 ET]
Table 'Jetta' 9-max Seat #2 is the button
Seat 1: maxxmeister ($118.24 in chips) 
Seat 2: Aghmir77 ($102.02 in chips) 
Seat 4: wholeweed ($89.51 in chips) 
Seat 5: guoweiAA ($258.02 in chips) 
Seat 6: Filojoes ($240.81 in chips) 
Seat 7: mycka86 ($103.08 in chips) 
Seat 8: matiko09 ($105.65 in chips) 
wholeweed: posts small blind $0.50
guoweiAA: posts big blind $1
*** HOLE CARDS ***
Dealt to matiko09 [Qh 5d]
Filojoes: folds 
Filojoes leaves the table
mycka86: folds 
matiko09: folds 
maxxmeister: folds 
Aghmir77: raises $1.20 to $2.20
wholeweed: raises $4.20 to $6.40
guoweiAA: folds 
Aghmir77: folds 
Uncalled bet ($4.20) returned to wholeweed
wholeweed collected $5.40 from pot
wholeweed: doesn't show hand 
*** SUMMARY ***
Total pot $5.40 | Rake $0 
Seat 1: maxxmeister folded before Flop (didn't bet)
Seat 2: Aghmir77 (button) folded before Flop
Seat 4: wholeweed (small blind) collected ($5.40)
Seat 5: guoweiAA (big blind) folded before Flop
Seat 6: Filojoes folded before Flop (didn't bet)
Seat 7: mycka86 folded before Flop (didn't bet)
Seat 8: matiko09 folded before Flop (didn't bet)





PokerStars Hand #153065524737:  Hold'em No Limit ($1/$2 USD) - 2016/05/09 15:42:07 CET [2016/05/09 9:42:07 ET]
Table 'Celaeno II' 9-max Seat #6 is the button
Seat 1: Li Shaobo ($280.45 in chips) 
Seat 2: J0k3rF4c3_FD ($200 in chips) 
Seat 3: Fredstar56 ($134.23 in chips) 
Seat 4: FTPbannedMe ($200 in chips) 
Seat 5: stan_09319 ($238.92 in chips) 
Seat 6: matiko09 ($305.08 in chips) 
Seat 7: Mister_b44 ($122.07 in chips) 
Seat 8: chaps1988 ($241.77 in chips) 
Seat 9: Spid1 ($200 in chips) 
Mister_b44: posts small blind $1
chaps1988: posts big blind $2
*** HOLE CARDS ***
Dealt to matiko09 [Kc 2h]
Spid1: folds 
Li Shaobo: folds 
J0k3rF4c3_FD: folds 
Fredstar56: folds 
FTPbannedMe: folds 
stan_09319: folds 
matiko09: folds 
Mister_b44: folds 
Uncalled bet ($1) returned to chaps1988
chaps1988 collected $2 from pot
chaps1988: doesn't show hand 
*** SUMMARY ***
Total pot $2 | Rake $0 
Seat 1: Li Shaobo folded before Flop (didn't bet)
Seat 2: J0k3rF4c3_FD folded before Flop (didn't bet)
Seat 3: Fredstar56 folded before Flop (didn't bet)
Seat 4: FTPbannedMe folded before Flop (didn't bet)
Seat 5: stan_09319 folded before Flop (didn't bet)
Seat 6: matiko09 (button) folded before Flop (didn't bet)
Seat 7: Mister_b44 (small blind) folded before Flop
Seat 8: chaps1988 (big blind) collected ($2)
Seat 9: Spid1 folded before Flop (didn't bet)





PokerStars Hand #153065541590:  Hold'em No Limit ($1/$2 USD) - 2016/05/09 15:42:37 CET [2016/05/09 9:42:37 ET]
Table 'Celaeno II' 9-max Seat #7 is the button
Seat 1: Li Shaobo ($280.45 in chips) 
Seat 2: J0k3rF4c3_FD ($200 in chips) 
Seat 3: Fredstar56 ($134.23 in chips) 
Seat 4: FTPbannedMe ($200 in chips) 
Seat 5: stan_09319 ($238.92 in chips) 
Seat 6: matiko09 ($305.08 in chips) 
Seat 7: Mister_b44 ($121.07 in chips) 
Seat 8: chaps1988 ($242.77 in chips) 
Seat 9: Spid1 ($200 in chips) 
chaps1988: posts small blind $1
Spid1: posts big blind $2
*** HOLE CARDS ***
Dealt to matiko09 [Kd Td]
Li Shaobo: folds 
J0k3rF4c3_FD: folds 
Fredstar56: calls $2
FTPbannedMe: folds 
stan_09319: folds 
matiko09: raises $6 to $8
Mister_b44: folds 
chaps1988: folds 
Spid1: folds 
Fredstar56: calls $6
*** FLOP *** [Kc 3d 5d]
Fredstar56: checks 
matiko09: bets $10
Fredstar56: folds 
Uncalled bet ($10) returned to matiko09
matiko09 collected $18.05 from pot
matiko09: doesn't show hand 
*** SUMMARY ***
Total pot $19 | Rake $0.95 
Board [Kc 3d 5d]
Seat 1: Li Shaobo folded before Flop (didn't bet)
Seat 2: J0k3rF4c3_FD folded before Flop (didn't bet)
Seat 3: Fredstar56 folded on the Flop
Seat 4: FTPbannedMe folded before Flop (didn't bet)
Seat 5: stan_09319 folded before Flop (didn't bet)
Seat 6: matiko09 collected ($18.05)
Seat 7: Mister_b44 (button) folded before Flop (didn't bet)
Seat 8: chaps1988 (small blind) folded before Flop
Seat 9: Spid1 (big blind) folded before Flop





PokerStars Hand #153065543493:  Hold'em No Limit ($0.50/$1.00 USD) - 2016/05/09 15:42:41 CET [2016/05/09 9:42:41 ET]
Table 'Mentha' 9-max Seat #1 is the button
Seat 1: maxxmeister ($127.75 in chips) 
Seat 2: guoweiAA ($177.47 in chips) 
Seat 3: r4mz3s ($103.68 in chips) 
Seat 4: duggy2016 ($68.94 in chips) 
Seat 5: mycka86 ($126.38 in chips) 
Seat 6: Filojoes ($164.61 in chips) 
Seat 7: matiko09 ($117.85 in chips) 
Seat 8: Spid1 ($100 in chips) 
guoweiAA: posts small blind $0.50
r4mz3s: posts big blind $1
Kukuryzka: sits out 
*** HOLE CARDS ***
Dealt to matiko09 [Ah 6d]
Kukuryzka leaves the table
duggy2016: raises $2 to $3
mycka86: folds 
Filojoes: folds 
matiko09: folds 
Spid1: folds 
maxxmeister: folds 
guoweiAA: folds 
r4mz3s: folds 
Uncalled bet ($2) returned to duggy2016
duggy2016 collected $2.50 from pot
duggy2016: doesn't show hand 
*** SUMMARY ***
Total pot $2.50 | Rake $0 
Seat 1: maxxmeister (button) folded before Flop (didn't bet)
Seat 2: guoweiAA (small blind) folded before Flop
Seat 3: r4mz3s (big blind) folded before Flop
Seat 4: duggy2016 collected ($2.50)
Seat 5: mycka86 folded before Flop (didn't bet)
Seat 6: Filojoes folded before Flop (didn't bet)
Seat 7: matiko09 folded before Flop (didn't bet)
Seat 8: Spid1 folded before Flop (didn't bet)





PokerStars Hand #153065546637:  Hold'em No Limit ($0.50/$1.00 USD) - 2016/05/09 15:42:46 CET [2016/05/09 9:42:46 ET]
Table 'Reiss' 9-max Seat #3 is the button
Seat 1: birdie1970 ($443.44 in chips) 
Seat 2: mycka86 ($115.81 in chips) 
Seat 3: chaps1988 ($116.99 in chips) 
Seat 4: MichaLabam ($154.49 in chips) 
Seat 5: matiko09 ($113.63 in chips) 
Seat 6: Spid1 ($100 in chips) 
Seat 7: Bimaxa ($100 in chips) 
Seat 8: Filojoes ($197.18 in chips) 
Seat 9: maxxmeister ($139.46 in chips) 
MichaLabam: posts small blind $0.50
matiko09: posts big blind $1
*** HOLE CARDS ***
Dealt to matiko09 [4c 4d]
Spid1: folds 
Bimaxa: folds 
Filojoes: folds 
maxxmeister: folds 
birdie1970: raises $2 to $3
mycka86: folds 
chaps1988: folds 
MichaLabam: folds 
matiko09: calls $2
*** FLOP *** [Ah 8h Td]
matiko09: checks 
birdie1970: bets $4
matiko09: folds 
Uncalled bet ($4) returned to birdie1970
birdie1970 collected $6.18 from pot
birdie1970: doesn't show hand 
*** SUMMARY ***
Total pot $6.50 | Rake $0.32 
Board [Ah 8h Td]
Seat 1: birdie1970 collected ($6.18)
Seat 2: mycka86 folded before Flop (didn't bet)
Seat 3: chaps1988 (button) folded before Flop (didn't bet)
Seat 4: MichaLabam (small blind) folded before Flop
Seat 5: matiko09 (big blind) folded on the Flop
Seat 6: Spid1 folded before Flop (didn't bet)
Seat 7: Bimaxa folded before Flop (didn't bet)
Seat 8: Filojoes folded before Flop (didn't bet)
Seat 9: maxxmeister folded before Flop (didn't bet)





PokerStars Hand #153065549481:  Hold'em No Limit ($0.50/$1.00 USD) - 2016/05/09 15:42:51 CET [2016/05/09 9:42:51 ET]
Table 'Merga II' 9-max Seat #7 is the button
Seat 1: luckyluke24 ($37.68 in chips) 
Seat 2: Filojoes ($100 in chips) 
Seat 3: xhinostrabli ($59.51 in chips) 
Seat 4: nubpoker ($104.62 in chips) 
Seat 5: LRVAV7 ($283 in chips) 
Seat 6: Spid1 ($165.53 in chips) 
Seat 7: matiko09 ($100.28 in chips) 
Seat 8: GrandOldFart ($97.50 in chips) 
Seat 9: chaps1988 ($227.49 in chips) 
GrandOldFart: posts small blind $0.50
chaps1988: posts big blind $1
*** HOLE CARDS ***
Dealt to matiko09 [7c 7d]
luckyluke24: folds 
Filojoes: folds 
xhinostrabli: folds 
nubpoker: folds 
LRVAV7: folds 
Spid1: folds 
matiko09: raises $1.27 to $2.27
GrandOldFart: folds 
chaps1988: calls $1.27
*** FLOP *** [Ad 2c 7s]
chaps1988: checks 
matiko09: bets $3.11
chaps1988: calls $3.11
*** TURN *** [Ad 2c 7s] [Jd]
chaps1988: checks 
matiko09: bets $7
chaps1988: folds 
Uncalled bet ($7) returned to matiko09
matiko09 collected $10.70 from pot
matiko09: doesn't show hand 
*** SUMMARY ***
Total pot $11.26 | Rake $0.56 
Board [Ad 2c 7s Jd]
Seat 1: luckyluke24 folded before Flop (didn't bet)
Seat 2: Filojoes folded before Flop (didn't bet)
Seat 3: xhinostrabli folded before Flop (didn't bet)
Seat 4: nubpoker folded before Flop (didn't bet)
Seat 5: LRVAV7 folded before Flop (didn't bet)
Seat 6: Spid1 folded before Flop (didn't bet)
Seat 7: matiko09 (button) collected ($10.70)
Seat 8: GrandOldFart (small blind) folded before Flop
Seat 9: chaps1988 (big blind) folded on the Turn





PokerStars Hand #153065551356:  Hold'em No Limit ($0.50/$1.00 USD) - 2016/05/09 15:42:55 CET [2016/05/09 9:42:55 ET]
Table 'Thalassa II' 9-max Seat #9 is the button
Seat 2: Filojoes ($147.74 in chips) 
Seat 3: mycka86 ($100 in chips) 
Seat 4: Salmin666 ($170.58 in chips) 
Seat 5: chaps1988 ($108 in chips) 
Seat 7: matiko09 ($100 in chips) 
Seat 8: FunkyDonkey1 ($96.93 in chips) 
Seat 9: maxxmeister ($453.92 in chips) 
Filojoes: posts small blind $0.50
mycka86: posts big blind $1
*** HOLE CARDS ***
Dealt to matiko09 [Th Tc]
Salmin666: folds 
chaps1988: folds 
matiko09: raises $2 to $3
FunkyDonkey1: folds 
maxxmeister: folds 
Filojoes: folds 
mycka86: folds 
Uncalled bet ($2) returned to matiko09
matiko09 collected $2.50 from pot
matiko09: doesn't show hand 
*** SUMMARY ***
Total pot $2.50 | Rake $0 
Seat 2: Filojoes (small blind) folded before Flop
Seat 3: mycka86 (big blind) folded before Flop
Seat 4: Salmin666 folded before Flop (didn't bet)
Seat 5: chaps1988 folded before Flop (didn't bet)
Seat 7: matiko09 collected ($2.50)
Seat 8: FunkyDonkey1 folded before Flop (didn't bet)
Seat 9: maxxmeister (button) folded before Flop (didn't bet)





PokerStars Hand #153065553424:  Hold'em No Limit ($0.50/$1.00 USD) - 2016/05/09 15:42:59 CET [2016/05/09 9:42:59 ET]
Table 'Terpsichore' 9-max Seat #6 is the button
Seat 1: 7hiro ($210.64 in chips) 
Seat 2: J0k3rF4c3_FD ($187.16 in chips) 
Seat 3: matiko09 ($107.12 in chips) 
Seat 4: maxxmeister ($111.92 in chips) 
Seat 5: mycka86 ($106.77 in chips) 
Seat 6: Filojoes ($103.18 in chips) 
Seat 7: xhinostrabli ($93.07 in chips) 
Seat 9: FTPbannedMe ($100 in chips) 
xhinostrabli: posts small blind $0.50
FTPbannedMe: posts big blind $1
*** HOLE CARDS ***
Dealt to matiko09 [Kc Qh]
7hiro: folds 
J0k3rF4c3_FD: folds 
matiko09: folds 
maxxmeister: raises $2 to $3
mycka86: folds 
Filojoes: folds 
xhinostrabli: folds 
FTPbannedMe: folds 
Uncalled bet ($2) returned to maxxmeister
maxxmeister collected $2.50 from pot
maxxmeister: doesn't show hand 
*** SUMMARY ***
Total pot $2.50 | Rake $0 
Seat 1: 7hiro folded before Flop (didn't bet)
Seat 2: J0k3rF4c3_FD folded before Flop (didn't bet)
Seat 3: matiko09 folded before Flop (didn't bet)
Seat 4: maxxmeister collected ($2.50)
Seat 5: mycka86 folded before Flop (didn't bet)
Seat 6: Filojoes (button) folded before Flop (didn't bet)
Seat 7: xhinostrabli (small blind) folded before Flop
Seat 9: FTPbannedMe (big blind) folded before Flop





PokerStars Hand #153065559507:  Hold'em No Limit ($1/$2 USD) - 2016/05/09 15:43:10 CET [2016/05/09 9:43:10 ET]
Table 'Luda' 9-max Seat #7 is the button
Seat 1: stan_09319 ($377.16 in chips) 
Seat 2: matiko09 ($200 in chips) 
Seat 3: Monsthand ($210.05 in chips) 
Seat 4: Igoriah ($200 in chips) 
Seat 5: J0k3rF4c3_FD ($253.25 in chips) 
Seat 6: Iggso ($202.05 in chips) 
Seat 7: chaps1988 ($237.25 in chips) 
Seat 8: ramseyg117 ($237.70 in chips) 
Seat 9: solano20000 ($256.17 in chips) 
ramseyg117: posts small blind $1
solano20000: posts big blind $2
*** HOLE CARDS ***
Dealt to matiko09 [Qc 2d]
stan_09319: folds 
ramseyg117 said, "nice hand chaps"
matiko09: folds 
Monsthand: folds 
Igoriah: folds 
J0k3rF4c3_FD: raises $3 to $5
Iggso: folds 
chaps1988: calls $5
ramseyg117: calls $4
solano20000: calls $3
*** FLOP *** [6d 3d 9h]
ramseyg117: checks 
solano20000: bets $19
J0k3rF4c3_FD: folds 
chaps1988: folds 
ramseyg117: calls $19
*** TURN *** [6d 3d 9h] [Qd]
ramseyg117: bets $55.25
solano20000: calls $55.25
*** RIVER *** [6d 3d 9h Qd] [3c]
ramseyg117: bets $158.45 and is all-in
solano20000: folds 
Uncalled bet ($158.45) returned to ramseyg117
ramseyg117 collected $165.75 from pot
ramseyg117: doesn't show hand 
*** SUMMARY ***
Total pot $168.50 | Rake $2.75 
Board [6d 3d 9h Qd 3c]
Seat 1: stan_09319 folded before Flop (didn't bet)
Seat 2: matiko09 folded before Flop (didn't bet)
Seat 3: Monsthand folded before Flop (didn't bet)
Seat 4: Igoriah folded before Flop (didn't bet)
Seat 5: J0k3rF4c3_FD folded on the Flop
Seat 6: Iggso folded before Flop (didn't bet)
Seat 7: chaps1988 (button) folded on the Flop
Seat 8: ramseyg117 (small blind) collected ($165.75)
Seat 9: solano20000 (big blind) folded on the River





PokerStars Hand #153065563971:  Hold'em No Limit ($0.50/$1.00 USD) - 2016/05/09 15:43:18 CET [2016/05/09 9:43:18 ET]
Table 'Mentha' 9-max Seat #2 is the button
Seat 1: maxxmeister ($127.75 in chips) 
Seat 2: guoweiAA ($176.97 in chips) 
Seat 3: r4mz3s ($102.68 in chips) 
Seat 4: duggy2016 ($70.44 in chips) 
Seat 5: mycka86 ($126.38 in chips) 
Seat 6: Filojoes ($164.61 in chips) 
Seat 7: matiko09 ($117.85 in chips) 
Seat 8: Spid1 ($100 in chips) 
r4mz3s: posts small blind $0.50
duggy2016: posts big blind $1
*** HOLE CARDS ***
Dealt to matiko09 [Qs 2s]
mycka86: folds 
Filojoes: raises $2 to $3
matiko09: folds 
Spid1: folds 
maxxmeister: folds 
guoweiAA: folds 
Dickyxxx joins the table at seat #9 
r4mz3s: folds 
duggy2016 is disconnected 
duggy2016 is connected 
duggy2016: folds 
Uncalled bet ($2) returned to Filojoes
Filojoes collected $2.50 from pot
Filojoes: doesn't show hand 
*** SUMMARY ***
Total pot $2.50 | Rake $0 
Seat 1: maxxmeister folded before Flop (didn't bet)
Seat 2: guoweiAA (button) folded before Flop (didn't bet)
Seat 3: r4mz3s (small blind) folded before Flop
Seat 4: duggy2016 (big blind) folded before Flop
Seat 5: mycka86 folded before Flop (didn't bet)
Seat 6: Filojoes collected ($2.50)
Seat 7: matiko09 folded before Flop (didn't bet)
Seat 8: Spid1 folded before Flop (didn't bet)





PokerStars Hand #153065568522:  Hold'em No Limit ($0.50/$1.00 USD) - 2016/05/09 15:43:26 CET [2016/05/09 9:43:26 ET]
Table 'Thalassa II' 9-max Seat #2 is the button
Seat 2: Filojoes ($147.24 in chips) 
Seat 3: mycka86 ($100 in chips) 
Seat 4: Salmin666 ($170.58 in chips) 
Seat 5: chaps1988 ($108 in chips) 
Seat 7: matiko09 ($101.50 in chips) 
Seat 8: FunkyDonkey1 ($96.93 in chips) 
Seat 9: maxxmeister ($453.92 in chips) 
mycka86: posts small blind $0.50
Salmin666: posts big blind $1
*** HOLE CARDS ***
Dealt to matiko09 [7d Qd]
chaps1988: raises $2 to $3
matiko09: folds 
FunkyDonkey1: folds 
maxxmeister: folds 
Filojoes: folds 
mycka86: folds 
Salmin666: calls $2
*** FLOP *** [2c Js 9h]
Salmin666: checks 
chaps1988: bets $4
Salmin666: folds 
Uncalled bet ($4) returned to chaps1988
chaps1988 collected $6.18 from pot
chaps1988: doesn't show hand 
*** SUMMARY ***
Total pot $6.50 | Rake $0.32 
Board [2c Js 9h]
Seat 2: Filojoes (button) folded before Flop (didn't bet)
Seat 3: mycka86 (small blind) folded before Flop
Seat 4: Salmin666 (big blind) folded on the Flop
Seat 5: chaps1988 collected ($6.18)
Seat 7: matiko09 folded before Flop (didn't bet)
Seat 8: FunkyDonkey1 folded before Flop (didn't bet)
Seat 9: maxxmeister folded before Flop (didn't bet)





PokerStars Hand #153065570683:  Hold'em No Limit ($1/$2 USD) - 2016/05/09 15:43:30 CET [2016/05/09 9:43:30 ET]
Table 'Celaeno II' 9-max Seat #8 is the button
Seat 1: Li Shaobo ($280.45 in chips) 
Seat 2: J0k3rF4c3_FD ($200 in chips) 
Seat 3: Fredstar56 ($126.23 in chips) 
Seat 4: FTPbannedMe ($200 in chips) 
Seat 5: stan_09319 ($238.92 in chips) 
Seat 6: matiko09 ($315.13 in chips) 
Seat 7: Mister_b44 ($121.07 in chips) 
Seat 8: chaps1988 ($241.77 in chips) 
Seat 9: Spid1 ($200 in chips) 
Spid1: posts small blind $1
Li Shaobo: posts big blind $2
*** HOLE CARDS ***
Dealt to matiko09 [3d 3c]
J0k3rF4c3_FD: folds 
Fredstar56: folds 
FTPbannedMe: raises $4 to $6
stan_09319: folds 
matiko09: folds 
Mister_b44: folds 
chaps1988: folds 
Spid1: folds 
Li Shaobo: folds 
Uncalled bet ($4) returned to FTPbannedMe
FTPbannedMe collected $5 from pot
FTPbannedMe: doesn't show hand 
*** SUMMARY ***
Total pot $5 | Rake $0 
Seat 1: Li Shaobo (big blind) folded before Flop
Seat 2: J0k3rF4c3_FD folded before Flop (didn't bet)
Seat 3: Fredstar56 folded before Flop (didn't bet)
Seat 4: FTPbannedMe collected ($5)
Seat 5: stan_09319 folded before Flop (didn't bet)
Seat 6: matiko09 folded before Flop (didn't bet)
Seat 7: Mister_b44 folded before Flop (didn't bet)
Seat 8: chaps1988 (button) folded before Flop (didn't bet)
Seat 9: Spid1 (small blind) folded before Flop





PokerStars Hand #153065574424:  Hold'em No Limit ($0.50/$1.00 USD) - 2016/05/09 15:43:37 CET [2016/05/09 9:43:37 ET]
Table 'Terpsichore' 9-max Seat #7 is the button
Seat 1: 7hiro ($210.64 in chips) 
Seat 2: J0k3rF4c3_FD ($187.16 in chips) 
Seat 3: matiko09 ($107.12 in chips) 
Seat 4: maxxmeister ($113.42 in chips) 
Seat 5: mycka86 ($106.77 in chips) 
Seat 6: Filojoes ($103.18 in chips) 
Seat 7: xhinostrabli ($92.57 in chips) 
Seat 9: FTPbannedMe ($100 in chips) 
FTPbannedMe: posts small blind $0.50
7hiro: posts big blind $1
*** HOLE CARDS ***
Dealt to matiko09 [3s Ah]
J0k3rF4c3_FD: folds 
matiko09: folds 
maxxmeister: folds 
mycka86: raises $1.50 to $2.50
Filojoes: folds 
xhinostrabli: folds 
FTPbannedMe: folds 
7hiro: folds 
Uncalled bet ($1.50) returned to mycka86
mycka86 collected $2.50 from pot
*** SUMMARY ***
Total pot $2.50 | Rake $0 
Seat 1: 7hiro (big blind) folded before Flop
Seat 2: J0k3rF4c3_FD folded before Flop (didn't bet)
Seat 3: matiko09 folded before Flop (didn't bet)
Seat 4: maxxmeister folded before Flop (didn't bet)
Seat 5: mycka86 collected ($2.50)
Seat 6: Filojoes folded before Flop (didn't bet)
Seat 7: xhinostrabli (button) folded before Flop (didn't bet)
Seat 9: FTPbannedMe (small blind) folded before Flop





PokerStars Hand #153065576060:  Hold'em No Limit ($0.50/$1.00 USD) - 2016/05/09 15:43:40 CET [2016/05/09 9:43:40 ET]
Table 'Reiss' 9-max Seat #4 is the button
Seat 1: birdie1970 ($446.62 in chips) 
Seat 2: mycka86 ($115.81 in chips) 
Seat 3: chaps1988 ($116.99 in chips) 
Seat 4: MichaLabam ($153.99 in chips) 
Seat 5: matiko09 ($110.63 in chips) 
Seat 6: Spid1 ($100 in chips) 
Seat 7: Bimaxa ($100 in chips) 
Seat 8: Filojoes ($197.18 in chips) 
Seat 9: maxxmeister ($139.46 in chips) 
matiko09: posts small blind $0.50
Spid1: posts big blind $1
*** HOLE CARDS ***
Dealt to matiko09 [7c Ad]
Bimaxa: folds 
Filojoes: folds 
maxxmeister: folds 
birdie1970: raises $2 to $3
mycka86: folds 
chaps1988: folds 
MichaLabam: folds 
matiko09: folds 
Spid1: folds 
Uncalled bet ($2) returned to birdie1970
birdie1970 collected $2.50 from pot
birdie1970: doesn't show hand 
*** SUMMARY ***
Total pot $2.50 | Rake $0 
Seat 1: birdie1970 collected ($2.50)
Seat 2: mycka86 folded before Flop (didn't bet)
Seat 3: chaps1988 folded before Flop (didn't bet)
Seat 4: MichaLabam (button) folded before Flop (didn't bet)
Seat 5: matiko09 (small blind) folded before Flop
Seat 6: Spid1 (big blind) folded before Flop
Seat 7: Bimaxa folded before Flop (didn't bet)
Seat 8: Filojoes folded before Flop (didn't bet)
Seat 9: maxxmeister folded before Flop (didn't bet)





PokerStars Hand #153065584152:  Hold'em No Limit ($0.50/$1.00 USD) - 2016/05/09 15:43:55 CET [2016/05/09 9:43:55 ET]
Table 'Mentha' 9-max Seat #3 is the button
Seat 1: maxxmeister ($127.75 in chips) 
Seat 2: guoweiAA ($176.97 in chips) 
Seat 3: r4mz3s ($102.18 in chips) 
Seat 4: duggy2016 ($69.44 in chips) 
Seat 5: mycka86 ($126.38 in chips) 
Seat 6: Filojoes ($166.11 in chips) 
Seat 7: matiko09 ($117.85 in chips) 
Seat 8: Spid1 ($100 in chips) 
duggy2016: posts small blind $0.50
mycka86: posts big blind $1
Dickyxxx: sits out 
*** HOLE CARDS ***
Dealt to matiko09 [6h 6d]
Filojoes: folds 
matiko09: raises $2 to $3
Spid1: folds 
maxxmeister: folds 
guoweiAA: folds 
r4mz3s: folds 
duggy2016: folds 
mycka86: folds 
Uncalled bet ($2) returned to matiko09
matiko09 collected $2.50 from pot
matiko09: doesn't show hand 
*** SUMMARY ***
Total pot $2.50 | Rake $0 
Seat 1: maxxmeister folded before Flop (didn't bet)
Seat 2: guoweiAA folded before Flop (didn't bet)
Seat 3: r4mz3s (button) folded before Flop (didn't bet)
Seat 4: duggy2016 (small blind) folded before Flop
Seat 5: mycka86 (big blind) folded before Flop
Seat 6: Filojoes folded before Flop (didn't bet)
Seat 7: matiko09 collected ($2.50)
Seat 8: Spid1 folded before Flop (didn't bet)





PokerStars Hand #153065590833:  Hold'em No Limit ($0.50/$1.00 USD) - 2016/05/09 15:44:07 CET [2016/05/09 9:44:07 ET]
Table 'Terpsichore' 9-max Seat #9 is the button
Seat 1: 7hiro ($209.64 in chips) 
Seat 2: J0k3rF4c3_FD ($187.16 in chips) 
Seat 3: matiko09 ($107.12 in chips) 
Seat 4: maxxmeister ($113.42 in chips) 
Seat 5: mycka86 ($108.27 in chips) 
Seat 6: Filojoes ($103.18 in chips) 
Seat 7: xhinostrabli ($92.57 in chips) 
Seat 9: FTPbannedMe ($100 in chips) 
7hiro: posts small blind $0.50
J0k3rF4c3_FD: posts big blind $1
*** HOLE CARDS ***
Dealt to matiko09 [9s 9d]
matiko09: raises $2 to $3
maxxmeister: folds 
mycka86: calls $3
Filojoes: folds 
xhinostrabli: raises $6 to $9
FTPbannedMe: folds 
7hiro: folds 
J0k3rF4c3_FD: folds 
matiko09: folds 
mycka86: folds 
Uncalled bet ($6) returned to xhinostrabli
xhinostrabli collected $10.50 from pot
*** SUMMARY ***
Total pot $10.50 | Rake $0 
Seat 1: 7hiro (small blind) folded before Flop
Seat 2: J0k3rF4c3_FD (big blind) folded before Flop
Seat 3: matiko09 folded before Flop
Seat 4: maxxmeister folded before Flop (didn't bet)
Seat 5: mycka86 folded before Flop
Seat 6: Filojoes folded before Flop (didn't bet)
Seat 7: xhinostrabli collected ($10.50)
Seat 9: FTPbannedMe (button) folded before Flop (didn't bet)





PokerStars Hand #153065593564:  Hold'em No Limit ($1/$2 USD) - 2016/05/09 15:44:12 CET [2016/05/09 9:44:12 ET]
Table 'Celaeno II' 9-max Seat #9 is the button
Seat 1: Li Shaobo ($278.45 in chips) 
Seat 2: J0k3rF4c3_FD ($200 in chips) 
Seat 3: Fredstar56 ($126.23 in chips) 
Seat 4: FTPbannedMe ($203 in chips) 
Seat 5: stan_09319 ($238.92 in chips) 
Seat 6: matiko09 ($315.13 in chips) 
Seat 7: Mister_b44 ($121.07 in chips) 
Seat 8: chaps1988 ($241.77 in chips) 
Seat 9: Spid1 ($200 in chips) 
Li Shaobo: posts small blind $1
J0k3rF4c3_FD: posts big blind $2
*** HOLE CARDS ***
Dealt to matiko09 [Ah Ks]
Fredstar56: folds 
FTPbannedMe: raises $4 to $6
stan_09319: folds 
matiko09: raises $12.75 to $18.75
Mister_b44: folds 
chaps1988: folds 
Spid1: folds 
Li Shaobo: folds 
J0k3rF4c3_FD: folds 
FTPbannedMe: raises $21.75 to $40.50
matiko09: calls $21.75
*** FLOP *** [2s 4c Qs]
FTPbannedMe: bets $25.81
matiko09: folds 
Uncalled bet ($25.81) returned to FTPbannedMe
FTPbannedMe collected $81.25 from pot
FTPbannedMe: doesn't show hand 
*** SUMMARY ***
Total pot $84 | Rake $2.75 
Board [2s 4c Qs]
Seat 1: Li Shaobo (small blind) folded before Flop
Seat 2: J0k3rF4c3_FD (big blind) folded before Flop
Seat 3: Fredstar56 folded before Flop (didn't bet)
Seat 4: FTPbannedMe collected ($81.25)
Seat 5: stan_09319 folded before Flop (didn't bet)
Seat 6: matiko09 folded on the Flop
Seat 7: Mister_b44 folded before Flop (didn't bet)
Seat 8: chaps1988 folded before Flop (didn't bet)
Seat 9: Spid1 (button) folded before Flop (didn't bet)





PokerStars Hand #153065593850:  Hold'em No Limit ($0.50/$1.00 USD) - 2016/05/09 15:44:13 CET [2016/05/09 9:44:13 ET]
Table 'Reiss' 9-max Seat #5 is the button
Seat 1: birdie1970 ($448.12 in chips) 
Seat 2: mycka86 ($115.81 in chips) 
Seat 3: chaps1988 ($116.99 in chips) 
Seat 4: MichaLabam ($153.99 in chips) 
Seat 5: matiko09 ($110.13 in chips) 
Seat 6: Spid1 ($100 in chips) 
Seat 8: Filojoes ($197.18 in chips) 
Seat 9: maxxmeister ($139.46 in chips) 
Spid1: posts small blind $0.50
Bimaxa: is sitting out 
Filojoes: posts big blind $1
*** HOLE CARDS ***
Dealt to matiko09 [Kc 5d]
Bimaxa leaves the table
maxxmeister: folds 
birdie1970: folds 
mycka86: raises $2 to $3
chaps1988: folds 
MichaLabam: calls $3
matiko09: folds 
Spid1: folds 
Filojoes: folds 
*** FLOP *** [2h 8d As]
nubpoker joins the table at seat #7 
mycka86: checks 
MichaLabam: bets $4
mycka86: folds 
Uncalled bet ($4) returned to MichaLabam
MichaLabam collected $7.12 from pot
MichaLabam: doesn't show hand 
*** SUMMARY ***
Total pot $7.50 | Rake $0.38 
Board [2h 8d As]
Seat 1: birdie1970 folded before Flop (didn't bet)
Seat 2: mycka86 folded on the Flop
Seat 3: chaps1988 folded before Flop (didn't bet)
Seat 4: MichaLabam collected ($7.12)
Seat 5: matiko09 (button) folded before Flop (didn't bet)
Seat 6: Spid1 (small blind) folded before Flop
Seat 8: Filojoes (big blind) folded before Flop
Seat 9: maxxmeister folded before Flop (didn't bet)





PokerStars Hand #153065595740:  Hold'em No Limit ($1/$2 USD) - 2016/05/09 15:44:16 CET [2016/05/09 9:44:16 ET]
Table 'Hagar II' 9-max Seat #6 is the button
Seat 1: azzad2007 ($258.62 in chips) 
Seat 2: billynomates ($104.06 in chips) 
Seat 3: stan_09319 ($202 in chips) 
Seat 4: matiko09 ($200 in chips) 
Seat 5: darren1031 ($249.10 in chips) 
Seat 6: Piniker85 ($578.14 in chips) 
Seat 7: Monsthand ($202.78 in chips) 
Seat 8: J0k3rF4c3_FD ($316.07 in chips) 
Seat 9: chaps1988 ($200 in chips) 
Monsthand: posts small blind $1
J0k3rF4c3_FD: posts big blind $2
*** HOLE CARDS ***
Dealt to matiko09 [3s 6s]
chaps1988: folds 
azzad2007: folds 
billynomates: folds 
stan_09319: folds 
matiko09: folds 
darren1031: calls $2
Piniker85: folds 
Monsthand: folds 
J0k3rF4c3_FD: checks 
*** FLOP *** [7c 9d Jc]
J0k3rF4c3_FD: checks 
darren1031: checks 
*** TURN *** [7c 9d Jc] [As]
J0k3rF4c3_FD: bets $6.65
darren1031: calls $6.65
*** RIVER *** [7c 9d Jc As] [6d]
J0k3rF4c3_FD: bets $12.86
darren1031: folds 
Uncalled bet ($12.86) returned to J0k3rF4c3_FD
J0k3rF4c3_FD collected $17.38 from pot
J0k3rF4c3_FD: doesn't show hand 
*** SUMMARY ***
Total pot $18.30 | Rake $0.92 
Board [7c 9d Jc As 6d]
Seat 1: azzad2007 folded before Flop (didn't bet)
Seat 2: billynomates folded before Flop (didn't bet)
Seat 3: stan_09319 folded before Flop (didn't bet)
Seat 4: matiko09 folded before Flop (didn't bet)
Seat 5: darren1031 folded on the River
Seat 6: Piniker85 (button) folded before Flop (didn't bet)
Seat 7: Monsthand (small blind) folded before Flop
Seat 8: J0k3rF4c3_FD (big blind) collected ($17.38)
Seat 9: chaps1988 folded before Flop (didn't bet)





PokerStars Hand #153065599114:  Hold'em No Limit ($0.50/$1.00 USD) - 2016/05/09 15:44:22 CET [2016/05/09 9:44:22 ET]
Table 'Mentha' 9-max Seat #4 is the button
Seat 1: maxxmeister ($127.75 in chips) 
Seat 2: guoweiAA ($176.97 in chips) 
Seat 3: r4mz3s ($102.18 in chips) 
Seat 4: duggy2016 ($68.94 in chips) 
Seat 5: mycka86 ($125.38 in chips) 
Seat 6: Filojoes ($166.11 in chips) 
Seat 7: matiko09 ($119.35 in chips) 
Seat 8: Spid1 ($100 in chips) 
mycka86: posts small blind $0.50
Filojoes: posts big blind $1
Dickyxxx: sits out 
*** HOLE CARDS ***
Dealt to matiko09 [Th Jd]
matiko09: folds 
Spid1: folds 
maxxmeister: folds 
guoweiAA: folds 
r4mz3s: folds 
duggy2016: folds 
mycka86: folds 
Uncalled bet ($0.50) returned to Filojoes
Filojoes collected $1 from pot
Filojoes: doesn't show hand 
*** SUMMARY ***
Total pot $1 | Rake $0 
Seat 1: maxxmeister folded before Flop (didn't bet)
Seat 2: guoweiAA folded before Flop (didn't bet)
Seat 3: r4mz3s folded before Flop (didn't bet)
Seat 4: duggy2016 (button) folded before Flop (didn't bet)
Seat 5: mycka86 (small blind) folded before Flop
Seat 6: Filojoes (big blind) collected ($1)
Seat 7: matiko09 folded before Flop (didn't bet)
Seat 8: Spid1 folded before Flop (didn't bet)





PokerStars Hand #153065602093:  Hold'em No Limit ($0.50/$1.00 USD) - 2016/05/09 15:44:28 CET [2016/05/09 9:44:28 ET]
Table 'Merga II' 9-max Seat #8 is the button
Seat 1: luckyluke24 ($37.68 in chips) 
Seat 2: Filojoes ($100 in chips) 
Seat 3: xhinostrabli ($59.51 in chips) 
Seat 4: nubpoker ($104.62 in chips) 
Seat 5: LRVAV7 ($283 in chips) 
Seat 6: Spid1 ($165.53 in chips) 
Seat 7: matiko09 ($105.60 in chips) 
Seat 8: GrandOldFart ($97 in chips) 
Seat 9: chaps1988 ($222.11 in chips) 
chaps1988: posts small blind $0.50
luckyluke24: posts big blind $1
*** HOLE CARDS ***
Dealt to matiko09 [As 3s]
Filojoes: raises $2 to $3
xhinostrabli: folds 
LRVAV7 is disconnected 
nubpoker: folds 
LRVAV7 is connected 
LRVAV7: folds 
Spid1: folds 
matiko09: folds 
GrandOldFart: folds 
chaps1988: folds 
luckyluke24: raises $7 to $10
Filojoes: folds 
Uncalled bet ($7) returned to luckyluke24
luckyluke24 collected $6.50 from pot
luckyluke24: doesn't show hand 
*** SUMMARY ***
Total pot $6.50 | Rake $0 
Seat 1: luckyluke24 (big blind) collected ($6.50)
Seat 2: Filojoes folded before Flop
Seat 3: xhinostrabli folded before Flop (didn't bet)
Seat 4: nubpoker folded before Flop (didn't bet)
Seat 5: LRVAV7 folded before Flop (didn't bet)
Seat 6: Spid1 folded before Flop (didn't bet)
Seat 7: matiko09 folded before Flop (didn't bet)
Seat 8: GrandOldFart (button) folded before Flop (didn't bet)
Seat 9: chaps1988 (small blind) folded before Flop





PokerStars Hand #153065604700:  Hold'em No Limit ($1/$2 USD) - 2016/05/09 15:44:32 CET [2016/05/09 9:44:32 ET]
Table 'Luda' 9-max Seat #8 is the button
Seat 1: stan_09319 ($377.16 in chips) 
Seat 2: matiko09 ($200 in chips) 
Seat 3: Monsthand ($210.05 in chips) 
Seat 4: Igoriah ($200 in chips) 
Seat 5: J0k3rF4c3_FD ($248.25 in chips) 
Seat 6: Iggso ($202.05 in chips) 
Seat 7: chaps1988 ($232.25 in chips) 
Seat 8: ramseyg117 ($324.20 in chips) 
Seat 9: solano20000 ($176.92 in chips) 
solano20000: posts small blind $1
stan_09319: posts big blind $2
*** HOLE CARDS ***
Dealt to matiko09 [3s Td]
matiko09: folds 
Monsthand: folds 
Igoriah: raises $3 to $5
J0k3rF4c3_FD: folds 
Iggso: folds 
chaps1988: folds 
ramseyg117: calls $5
solano20000: folds 
stan_09319: calls $3
*** FLOP *** [5s 7h Ad]
stan_09319: checks 
Igoriah: bets $10.03
ramseyg117: folds 
stan_09319: calls $10.03
*** TURN *** [5s 7h Ad] [Kd]
stan_09319: checks 
Igoriah: checks 
*** RIVER *** [5s 7h Ad Kd] [Qc]
stan_09319: checks 
Igoriah: checks 
*** SHOW DOWN ***
stan_09319: shows [Ah Ts] (a pair of Aces)
Igoriah: mucks hand 
stan_09319 collected $34.26 from pot
*** SUMMARY ***
Total pot $36.06 | Rake $1.80 
Board [5s 7h Ad Kd Qc]
Seat 1: stan_09319 (big blind) showed [Ah Ts] and won ($34.26) with a pair of Aces
Seat 2: matiko09 folded before Flop (didn't bet)
Seat 3: Monsthand folded before Flop (didn't bet)
Seat 4: Igoriah mucked [3c Ac]
Seat 5: J0k3rF4c3_FD folded before Flop (didn't bet)
Seat 6: Iggso folded before Flop (didn't bet)
Seat 7: chaps1988 folded before Flop (didn't bet)
Seat 8: ramseyg117 (button) folded on the Flop
Seat 9: solano20000 (small blind) folded before Flop





PokerStars Hand #153065620533:  Hold'em No Limit ($0.50/$1.00 USD) - 2016/05/09 15:45:01 CET [2016/05/09 9:45:01 ET]
Table 'Mentha' 9-max Seat #5 is the button
Seat 1: maxxmeister ($127.75 in chips) 
Seat 2: guoweiAA ($176.97 in chips) 
Seat 3: r4mz3s ($102.18 in chips) 
Seat 4: duggy2016 ($68.94 in chips) 
Seat 5: mycka86 ($124.88 in chips) 
Seat 6: Filojoes ($166.61 in chips) 
Seat 7: matiko09 ($119.35 in chips) 
Seat 8: Spid1 ($100 in chips) 
Filojoes: posts small blind $0.50
matiko09: posts big blind $1
Dickyxxx: sits out 
*** HOLE CARDS ***
Dealt to matiko09 [8s Kh]
Spid1: folds 
maxxmeister: raises $2.50 to $3.50
guoweiAA: folds 
r4mz3s: folds 
duggy2016: folds 
mycka86: calls $3.50
Filojoes: folds 
matiko09: folds 
*** FLOP *** [4c 3h 6d]
maxxmeister: bets $4.19
mycka86: calls $4.19
*** TURN *** [4c 3h 6d] [2h]
maxxmeister: checks 
mycka86: checks 
*** RIVER *** [4c 3h 6d 2h] [Tc]
maxxmeister: bets $7.04
mycka86: folds 
Uncalled bet ($7.04) returned to maxxmeister
maxxmeister collected $16.04 from pot
maxxmeister: doesn't show hand 
*** SUMMARY ***
Total pot $16.88 | Rake $0.84 
Board [4c 3h 6d 2h Tc]
Seat 1: maxxmeister collected ($16.04)
Seat 2: guoweiAA folded before Flop (didn't bet)
Seat 3: r4mz3s folded before Flop (didn't bet)
Seat 4: duggy2016 folded before Flop (didn't bet)
Seat 5: mycka86 (button) folded on the River
Seat 6: Filojoes (small blind) folded before Flop
Seat 7: matiko09 (big blind) folded before Flop
Seat 8: Spid1 folded before Flop (didn't bet)





PokerStars Hand #153065621495:  Hold'em No Limit ($1/$2 USD) - 2016/05/09 15:45:03 CET [2016/05/09 9:45:03 ET]
Table 'Hagar II' 9-max Seat #7 is the button
Seat 1: azzad2007 ($258.62 in chips) 
Seat 2: billynomates ($104.06 in chips) 
Seat 3: stan_09319 ($202 in chips) 
Seat 4: matiko09 ($200 in chips) 
Seat 5: darren1031 ($240.45 in chips) 
Seat 6: Piniker85 ($578.14 in chips) 
Seat 7: Monsthand ($201.78 in chips) 
Seat 8: J0k3rF4c3_FD ($324.80 in chips) 
Seat 9: chaps1988 ($200 in chips) 
J0k3rF4c3_FD: posts small blind $1
chaps1988: posts big blind $2
*** HOLE CARDS ***
Dealt to matiko09 [8h 2s]
azzad2007: folds 
billynomates: folds 
stan_09319: folds 
matiko09: folds 
darren1031: folds 
Piniker85: folds 
Monsthand: folds 
J0k3rF4c3_FD: folds 
Uncalled bet ($1) returned to chaps1988
chaps1988 collected $2 from pot
chaps1988: doesn't show hand 
*** SUMMARY ***
Total pot $2 | Rake $0 
Seat 1: azzad2007 folded before Flop (didn't bet)
Seat 2: billynomates folded before Flop (didn't bet)
Seat 3: stan_09319 folded before Flop (didn't bet)
Seat 4: matiko09 folded before Flop (didn't bet)
Seat 5: darren1031 folded before Flop (didn't bet)
Seat 6: Piniker85 folded before Flop (didn't bet)
Seat 7: Monsthand (button) folded before Flop (didn't bet)
Seat 8: J0k3rF4c3_FD (small blind) folded before Flop
Seat 9: chaps1988 (big blind) collected ($2)





PokerStars Hand #153065627668:  Hold'em No Limit ($0.50/$1.00 USD) - 2016/05/09 15:45:14 CET [2016/05/09 9:45:14 ET]
Table 'Terpsichore' 9-max Seat #1 is the button
Seat 1: 7hiro ($209.14 in chips) 
Seat 2: J0k3rF4c3_FD ($186.16 in chips) 
Seat 3: matiko09 ($104.12 in chips) 
Seat 4: maxxmeister ($113.42 in chips) 
Seat 5: mycka86 ($105.27 in chips) 
Seat 6: Filojoes ($103.18 in chips) 
Seat 7: xhinostrabli ($100.07 in chips) 
Seat 9: FTPbannedMe ($100 in chips) 
J0k3rF4c3_FD: posts small blind $0.50
matiko09: posts big blind $1
Kiosk230472: sits out 
*** HOLE CARDS ***
Dealt to matiko09 [6h 2s]
maxxmeister: folds 
mycka86: folds 
Filojoes: folds 
xhinostrabli: raises $1.50 to $2.50
FTPbannedMe: folds 
7hiro: folds 
J0k3rF4c3_FD: folds 
matiko09: folds 
Uncalled bet ($1.50) returned to xhinostrabli
xhinostrabli collected $2.50 from pot
*** SUMMARY ***
Total pot $2.50 | Rake $0 
Seat 1: 7hiro (button) folded before Flop (didn't bet)
Seat 2: J0k3rF4c3_FD (small blind) folded before Flop
Seat 3: matiko09 (big blind) folded before Flop
Seat 4: maxxmeister folded before Flop (didn't bet)
Seat 5: mycka86 folded before Flop (didn't bet)
Seat 6: Filojoes folded before Flop (didn't bet)
Seat 7: xhinostrabli collected ($2.50)
Seat 9: FTPbannedMe folded before Flop (didn't bet)





PokerStars Hand #153065629626:  Hold'em No Limit ($0.50/$1.00 USD) - 2016/05/09 15:45:18 CET [2016/05/09 9:45:18 ET]
Table 'Reiss' 9-max Seat #6 is the button
Seat 1: birdie1970 ($448.12 in chips) 
Seat 2: mycka86 ($112.81 in chips) 
Seat 3: chaps1988 ($116.99 in chips) 
Seat 4: MichaLabam ($158.11 in chips) 
Seat 5: matiko09 ($110.13 in chips) 
Seat 6: Spid1 ($100 in chips) 
Seat 8: Filojoes ($196.18 in chips) 
Seat 9: maxxmeister ($139.46 in chips) 
nubpoker will be allowed to play after the button
Filojoes: posts small blind $0.50
maxxmeister: posts big blind $1
*** HOLE CARDS ***
Dealt to matiko09 [Th Qs]
birdie1970: raises $2 to $3
mycka86: folds 
chaps1988: folds 
MichaLabam: folds 
matiko09: folds 
Spid1: folds 
Filojoes: calls $2.50
maxxmeister: calls $2
*** FLOP *** [Ac Qd 6d]
Filojoes: checks 
maxxmeister: bets $8
birdie1970: calls $8
Filojoes: folds 
*** TURN *** [Ac Qd 6d] [5s]
maxxmeister: bets $22
birdie1970: folds [7d 7h]
Uncalled bet ($22) returned to maxxmeister
maxxmeister collected $23.75 from pot
maxxmeister: doesn't show hand 
*** SUMMARY ***
Total pot $25 | Rake $1.25 
Board [Ac Qd 6d 5s]
Seat 1: birdie1970 folded on the Turn
Seat 2: mycka86 folded before Flop (didn't bet)
Seat 3: chaps1988 folded before Flop (didn't bet)
Seat 4: MichaLabam folded before Flop (didn't bet)
Seat 5: matiko09 folded before Flop (didn't bet)
Seat 6: Spid1 (button) folded before Flop (didn't bet)
Seat 8: Filojoes (small blind) folded on the Flop
Seat 9: maxxmeister (big blind) collected ($23.75)





PokerStars Hand #153065632812:  Hold'em No Limit ($0.50/$1.00 USD) - 2016/05/09 15:45:23 CET [2016/05/09 9:45:23 ET]
Table 'Merga II' 9-max Seat #9 is the button
Seat 1: luckyluke24 ($41.18 in chips) 
Seat 2: Filojoes ($100 in chips) 
Seat 3: xhinostrabli ($59.51 in chips) 
Seat 4: nubpoker ($104.62 in chips) 
Seat 5: LRVAV7 ($283 in chips) 
Seat 6: Spid1 ($165.53 in chips) 
Seat 7: matiko09 ($105.60 in chips) 
Seat 8: GrandOldFart ($97 in chips) 
Seat 9: chaps1988 ($221.61 in chips) 
luckyluke24: posts small blind $0.50
Filojoes: posts big blind $1
*** HOLE CARDS ***
Dealt to matiko09 [Jh 6s]
xhinostrabli: folds 
nubpoker: folds 
LRVAV7: folds 
Spid1: folds 
matiko09: folds 
GrandOldFart: folds 
chaps1988: folds 
luckyluke24: calls $0.50
Filojoes: checks 
*** FLOP *** [7s Qd Kc]
luckyluke24: checks 
Filojoes: checks 
*** TURN *** [7s Qd Kc] [5h]
luckyluke24: bets $1
Filojoes: folds 
Uncalled bet ($1) returned to luckyluke24
luckyluke24 collected $1.90 from pot
luckyluke24: doesn't show hand 
*** SUMMARY ***
Total pot $2 | Rake $0.10 
Board [7s Qd Kc 5h]
Seat 1: luckyluke24 (small blind) collected ($1.90)
Seat 2: Filojoes (big blind) folded on the Turn
Seat 3: xhinostrabli folded before Flop (didn't bet)
Seat 4: nubpoker folded before Flop (didn't bet)
Seat 5: LRVAV7 folded before Flop (didn't bet)
Seat 6: Spid1 folded before Flop (didn't bet)
Seat 7: matiko09 folded before Flop (didn't bet)
Seat 8: GrandOldFart folded before Flop (didn't bet)
Seat 9: chaps1988 (button) folded before Flop (didn't bet)





PokerStars Hand #153065633104:  Hold'em No Limit ($1/$2 USD) - 2016/05/09 15:45:24 CET [2016/05/09 9:45:24 ET]
Table 'Hagar II' 9-max Seat #8 is the button
Seat 1: azzad2007 ($258.62 in chips) 
Seat 2: billynomates ($104.06 in chips) 
Seat 3: stan_09319 ($202 in chips) 
Seat 4: matiko09 ($200 in chips) 
Seat 5: darren1031 ($240.45 in chips) 
Seat 6: Piniker85 ($578.14 in chips) 
Seat 7: Monsthand ($201.78 in chips) 
Seat 8: J0k3rF4c3_FD ($323.80 in chips) 
Seat 9: chaps1988 ($201 in chips) 
chaps1988: posts small blind $1
azzad2007: posts big blind $2
*** HOLE CARDS ***
Dealt to matiko09 [2c Ts]
billynomates: folds 
stan_09319: folds 
matiko09: folds 
darren1031: calls $2
Piniker85: calls $2
Monsthand: raises $7.30 to $9.30
J0k3rF4c3_FD: folds 
chaps1988: folds 
azzad2007: folds 
darren1031: calls $7.30
Piniker85: calls $7.30
*** FLOP *** [3h Kc Th]
darren1031: checks 
Piniker85: checks 
Monsthand: bets $19
darren1031: calls $19
Piniker85: folds 
*** TURN *** [3h Kc Th] [2s]
darren1031: checks 
Monsthand: checks 
*** RIVER *** [3h Kc Th 2s] [7s]
darren1031: checks 
Monsthand: checks 
*** SHOW DOWN ***
darren1031: shows [Kh Qc] (a pair of Kings)
Monsthand: mucks hand 
darren1031 collected $66.15 from pot
*** SUMMARY ***
Total pot $68.90 | Rake $2.75 
Board [3h Kc Th 2s 7s]
Seat 1: azzad2007 (big blind) folded before Flop
Seat 2: billynomates folded before Flop (didn't bet)
Seat 3: stan_09319 folded before Flop (didn't bet)
Seat 4: matiko09 folded before Flop (didn't bet)
Seat 5: darren1031 showed [Kh Qc] and won ($66.15) with a pair of Kings
Seat 6: Piniker85 folded on the Flop
Seat 7: Monsthand mucked [Qd Jh]
Seat 8: J0k3rF4c3_FD (button) folded before Flop (didn't bet)
Seat 9: chaps1988 (small blind) folded before Flop





PokerStars Hand #153065641199:  Hold'em No Limit ($1/$2 USD) - 2016/05/09 15:45:38 CET [2016/05/09 9:45:38 ET]
Table 'Celaeno II' 9-max Seat #1 is the button
Seat 1: Li Shaobo ($277.45 in chips) 
Seat 2: J0k3rF4c3_FD ($200 in chips) 
Seat 3: Fredstar56 ($126.23 in chips) 
Seat 4: FTPbannedMe ($243.75 in chips) 
Seat 5: stan_09319 ($238.92 in chips) 
Seat 6: matiko09 ($274.63 in chips) 
Seat 7: Mister_b44 ($121.07 in chips) 
Seat 8: chaps1988 ($241.77 in chips) 
Seat 9: Spid1 ($200 in chips) 
J0k3rF4c3_FD: posts small blind $1
Fredstar56: posts big blind $2
*** HOLE CARDS ***
Dealt to matiko09 [Qs Js]
FTPbannedMe: folds 
stan_09319: folds 
matiko09: raises $3 to $5
Mister_b44: folds 
chaps1988: folds 
Spid1: folds 
Li Shaobo: folds 
J0k3rF4c3_FD: folds 
Fredstar56: calls $3
*** FLOP *** [Ts 2h 3h]
Fredstar56: checks 
matiko09: bets $6.79
Fredstar56: folds 
Uncalled bet ($6.79) returned to matiko09
matiko09 collected $10.45 from pot
matiko09: doesn't show hand 
*** SUMMARY ***
Total pot $11 | Rake $0.55 
Board [Ts 2h 3h]
Seat 1: Li Shaobo (button) folded before Flop (didn't bet)
Seat 2: J0k3rF4c3_FD (small blind) folded before Flop
Seat 3: Fredstar56 (big blind) folded on the Flop
Seat 4: FTPbannedMe folded before Flop (didn't bet)
Seat 5: stan_09319 folded before Flop (didn't bet)
Seat 6: matiko09 collected ($10.45)
Seat 7: Mister_b44 folded before Flop (didn't bet)
Seat 8: chaps1988 folded before Flop (didn't bet)
Seat 9: Spid1 folded before Flop (didn't bet)





PokerStars Hand #153065641443:  Hold'em No Limit ($1/$2 USD) - 2016/05/09 15:45:39 CET [2016/05/09 9:45:39 ET]
Table 'Luda' 9-max Seat #9 is the button
Seat 1: stan_09319 ($396.39 in chips) 
Seat 2: matiko09 ($200 in chips) 
Seat 3: Monsthand ($210.05 in chips) 
Seat 4: Igoriah ($200 in chips) 
Seat 5: J0k3rF4c3_FD ($248.25 in chips) 
Seat 6: Iggso ($202.05 in chips) 
Seat 7: chaps1988 ($232.25 in chips) 
Seat 8: ramseyg117 ($319.20 in chips) 
Seat 9: solano20000 ($175.92 in chips) 
stan_09319: posts small blind $1
matiko09: posts big blind $2
*** HOLE CARDS ***
Dealt to matiko09 [4d As]
Monsthand: folds 
Igoriah: folds 
J0k3rF4c3_FD: folds 
Iggso: folds 
chaps1988: folds 
ramseyg117: calls $2
solano20000: folds 
stan_09319: raises $6 to $8
matiko09: folds 
ramseyg117: raises $6 to $14
stan_09319: calls $6
*** FLOP *** [7s 2c 9c]
stan_09319: checks 
ramseyg117: folds 
stan_09319 collected $28.50 from pot
stan_09319: doesn't show hand 
*** SUMMARY ***
Total pot $30 | Rake $1.50 
Board [7s 2c 9c]
Seat 1: stan_09319 (small blind) collected ($28.50)
Seat 2: matiko09 (big blind) folded before Flop
Seat 3: Monsthand folded before Flop (didn't bet)
Seat 4: Igoriah folded before Flop (didn't bet)
Seat 5: J0k3rF4c3_FD folded before Flop (didn't bet)
Seat 6: Iggso folded before Flop (didn't bet)
Seat 7: chaps1988 folded before Flop (didn't bet)
Seat 8: ramseyg117 folded on the Flop
Seat 9: solano20000 (button) folded before Flop (didn't bet)





PokerStars Hand #153065663534:  Hold'em No Limit ($1/$2 USD) - 2016/05/09 15:46:19 CET [2016/05/09 9:46:19 ET]
Table 'Luda' 9-max Seat #1 is the button
Seat 1: stan_09319 ($410.89 in chips) 
Seat 2: matiko09 ($200 in chips) 
Seat 3: Monsthand ($210.05 in chips) 
Seat 4: Igoriah ($200 in chips) 
Seat 5: J0k3rF4c3_FD ($248.25 in chips) 
Seat 6: Iggso ($202.05 in chips) 
Seat 7: chaps1988 ($232.25 in chips) 
Seat 8: ramseyg117 ($305.20 in chips) 
Seat 9: solano20000 ($175.92 in chips) 
matiko09: posts small blind $1
Monsthand: posts big blind $2
*** HOLE CARDS ***
Dealt to matiko09 [9s 5d]
Igoriah: folds 
J0k3rF4c3_FD: folds 
Iggso: folds 
chaps1988: folds 
ramseyg117: calls $2
solano20000: folds 
stan_09319: raises $7 to $9
matiko09: folds 
Monsthand: folds 
ramseyg117: calls $7
*** FLOP *** [5c 3h 6h]
ramseyg117: folds 
stan_09319 collected $19.95 from pot
stan_09319: doesn't show hand 
*** SUMMARY ***
Total pot $21 | Rake $1.05 
Board [5c 3h 6h]
Seat 1: stan_09319 (button) collected ($19.95)
Seat 2: matiko09 (small blind) folded before Flop
Seat 3: Monsthand (big blind) folded before Flop
Seat 4: Igoriah folded before Flop (didn't bet)
Seat 5: J0k3rF4c3_FD folded before Flop (didn't bet)
Seat 6: Iggso folded before Flop (didn't bet)
Seat 7: chaps1988 folded before Flop (didn't bet)
Seat 8: ramseyg117 folded on the Flop
Seat 9: solano20000 folded before Flop (didn't bet)





PokerStars Hand #153065666399:  Hold'em No Limit ($0.50/$1.00 USD) - 2016/05/09 15:46:24 CET [2016/05/09 9:46:24 ET]
Table 'Terpsichore' 9-max Seat #2 is the button
Seat 1: 7hiro ($209.14 in chips) 
Seat 2: J0k3rF4c3_FD ($185.66 in chips) 
Seat 3: matiko09 ($103.12 in chips) 
Seat 4: maxxmeister ($113.42 in chips) 
Seat 5: mycka86 ($105.27 in chips) 
Seat 6: Filojoes ($103.18 in chips) 
Seat 7: xhinostrabli ($101.57 in chips) 
Seat 9: FTPbannedMe ($100 in chips) 
matiko09: posts small blind $0.50
maxxmeister: posts big blind $1
Kiosk230472: sits out 
*** HOLE CARDS ***
Dealt to matiko09 [8c 8d]
mycka86: folds 
Filojoes: folds 
xhinostrabli: folds 
FTPbannedMe: folds 
7hiro: folds 
J0k3rF4c3_FD: folds 
matiko09: raises $1.50 to $2.50
maxxmeister: calls $1.50
*** FLOP *** [8s 6s 7s]
matiko09: checks 
maxxmeister: checks 
*** TURN *** [8s 6s 7s] [9d]
matiko09: checks 
maxxmeister: checks 
*** RIVER *** [8s 6s 7s 9d] [Kh]
matiko09: bets $3.09
maxxmeister: folds 
Uncalled bet ($3.09) returned to matiko09
matiko09 collected $4.75 from pot
matiko09: doesn't show hand 
*** SUMMARY ***
Total pot $5 | Rake $0.25 
Board [8s 6s 7s 9d Kh]
Seat 1: 7hiro folded before Flop (didn't bet)
Seat 2: J0k3rF4c3_FD (button) folded before Flop (didn't bet)
Seat 3: matiko09 (small blind) collected ($4.75)
Seat 4: maxxmeister (big blind) folded on the River
Seat 5: mycka86 folded before Flop (didn't bet)
Seat 6: Filojoes folded before Flop (didn't bet)
Seat 7: xhinostrabli folded before Flop (didn't bet)
Seat 9: FTPbannedMe folded before Flop (didn't bet)





PokerStars Hand #153065667548:  Hold'em No Limit ($1/$2 USD) - 2016/05/09 15:46:26 CET [2016/05/09 9:46:26 ET]
Table 'Celaeno II' 9-max Seat #2 is the button
Seat 1: Li Shaobo ($277.45 in chips) 
Seat 2: J0k3rF4c3_FD ($200 in chips) 
Seat 3: Fredstar56 ($121.23 in chips) 
Seat 4: FTPbannedMe ($243.75 in chips) 
Seat 5: stan_09319 ($238.92 in chips) 
Seat 6: matiko09 ($280.08 in chips) 
Seat 7: Mister_b44 ($121.07 in chips) 
Seat 8: chaps1988 ($241.77 in chips) 
Seat 9: Spid1 ($200 in chips) 
Fredstar56: posts small blind $1
FTPbannedMe: posts big blind $2
*** HOLE CARDS ***
Dealt to matiko09 [3d 2s]
stan_09319: folds 
matiko09: folds 
Mister_b44: folds 
chaps1988: folds 
Spid1: folds 
Li Shaobo: raises $4 to $6
J0k3rF4c3_FD: calls $6
Fredstar56: folds 
FTPbannedMe: calls $4
*** FLOP *** [5d 2d 8h]
FTPbannedMe: bets $12.53
Li Shaobo: folds 
J0k3rF4c3_FD: calls $12.53
*** TURN *** [5d 2d 8h] [8s]
FTPbannedMe: checks 
J0k3rF4c3_FD: bets $28.97
FTPbannedMe: folds 
Uncalled bet ($28.97) returned to J0k3rF4c3_FD
J0k3rF4c3_FD collected $41.86 from pot
J0k3rF4c3_FD: doesn't show hand 
*** SUMMARY ***
Total pot $44.06 | Rake $2.20 
Board [5d 2d 8h 8s]
Seat 1: Li Shaobo folded on the Flop
Seat 2: J0k3rF4c3_FD (button) collected ($41.86)
Seat 3: Fredstar56 (small blind) folded before Flop
Seat 4: FTPbannedMe (big blind) folded on the Turn
Seat 5: stan_09319 folded before Flop (didn't bet)
Seat 6: matiko09 folded before Flop (didn't bet)
Seat 7: Mister_b44 folded before Flop (didn't bet)
Seat 8: chaps1988 folded before Flop (didn't bet)
Seat 9: Spid1 folded before Flop (didn't bet)





PokerStars Hand #153065668093:  Hold'em No Limit ($0.50/$1.00 USD) - 2016/05/09 15:46:27 CET [2016/05/09 9:46:27 ET]
Table 'Merga II' 9-max Seat #1 is the button
Seat 1: luckyluke24 ($42.08 in chips) 
Seat 2: Filojoes ($100 in chips) 
Seat 3: xhinostrabli ($59.51 in chips) 
Seat 4: nubpoker ($104.62 in chips) 
Seat 5: LRVAV7 ($283 in chips) 
Seat 6: Spid1 ($165.53 in chips) 
Seat 7: matiko09 ($105.60 in chips) 
Seat 8: GrandOldFart ($97 in chips) 
Seat 9: chaps1988 ($221.61 in chips) 
Filojoes: posts small blind $0.50
xhinostrabli: posts big blind $1
*** HOLE CARDS ***
Dealt to matiko09 [Ad 9s]
nubpoker: folds 
LRVAV7: raises $2 to $3
Spid1: folds 
matiko09: folds 
GrandOldFart: folds 
chaps1988: folds 
luckyluke24: folds 
Filojoes: folds 
xhinostrabli: raises $6.50 to $9.50
LRVAV7: calls $6.50
*** FLOP *** [2h As Jc]
xhinostrabli: bets $10
LRVAV7: calls $10
*** TURN *** [2h As Jc] [6d]
xhinostrabli: checks 
LRVAV7: bets $18.76
xhinostrabli: folds 
Uncalled bet ($18.76) returned to LRVAV7
LRVAV7 collected $37.52 from pot
LRVAV7: doesn't show hand 
*** SUMMARY ***
Total pot $39.50 | Rake $1.98 
Board [2h As Jc 6d]
Seat 1: luckyluke24 (button) folded before Flop (didn't bet)
Seat 2: Filojoes (small blind) folded before Flop
Seat 3: xhinostrabli (big blind) folded on the Turn
Seat 4: nubpoker folded before Flop (didn't bet)
Seat 5: LRVAV7 collected ($37.52)
Seat 6: Spid1 folded before Flop (didn't bet)
Seat 7: matiko09 folded before Flop (didn't bet)
Seat 8: GrandOldFart folded before Flop (didn't bet)
Seat 9: chaps1988 folded before Flop (didn't bet)





PokerStars Hand #153065693576:  Hold'em No Limit ($0.50/$1.00 USD) - 2016/05/09 15:47:06 CET [2016/05/09 9:47:06 ET]
Table 'Mentha' 9-max Seat #6 is the button
Seat 1: maxxmeister ($136.10 in chips) 
Seat 2: guoweiAA ($176.97 in chips) 
Seat 3: r4mz3s ($102.18 in chips) 
Seat 4: duggy2016 ($68.94 in chips) 
Seat 5: mycka86 ($117.19 in chips) 
Seat 6: Filojoes ($166.11 in chips) 
Seat 7: matiko09 ($118.35 in chips) 
Seat 9: Dickyxxx ($100 in chips) 
matiko09: posts small blind $0.50
Spid1: is sitting out 
Dickyxxx: posts big blind $1
*** HOLE CARDS ***
Dealt to matiko09 [Jc 4s]
Spid1 leaves the table
maxxmeister: folds 
Lycaon23 joins the table at seat #8 
guoweiAA: folds 
r4mz3s: folds 
duggy2016: folds 
mycka86: folds 
Filojoes: raises $1 to $2
matiko09: folds 
Dickyxxx: folds 
Uncalled bet ($1) returned to Filojoes
Filojoes collected $2.50 from pot
Filojoes: doesn't show hand 
*** SUMMARY ***
Total pot $2.50 | Rake $0 
Seat 1: maxxmeister folded before Flop (didn't bet)
Seat 2: guoweiAA folded before Flop (didn't bet)
Seat 3: r4mz3s folded before Flop (didn't bet)
Seat 4: duggy2016 folded before Flop (didn't bet)
Seat 5: mycka86 folded before Flop (didn't bet)
Seat 6: Filojoes (button) collected ($2.50)
Seat 7: matiko09 (small blind) folded before Flop
Seat 9: Dickyxxx (big blind) folded before Flop





PokerStars Hand #153065698159:  Hold'em No Limit ($1/$2 USD) - 2016/05/09 15:47:15 CET [2016/05/09 9:47:15 ET]
Table 'Luda' 9-max Seat #2 is the button
Seat 1: stan_09319 ($421.84 in chips) 
Seat 2: matiko09 ($200 in chips) 
Seat 3: Monsthand ($208.05 in chips) 
Seat 4: Igoriah ($200 in chips) 
Seat 5: J0k3rF4c3_FD ($248.25 in chips) 
Seat 6: Iggso ($202.05 in chips) 
Seat 7: chaps1988 ($232.25 in chips) 
Seat 8: ramseyg117 ($296.20 in chips) 
Seat 9: solano20000 ($175.92 in chips) 
Monsthand: posts small blind $1
Igoriah: posts big blind $2
*** HOLE CARDS ***
Dealt to matiko09 [9c 3d]
J0k3rF4c3_FD: folds 
Iggso: folds 
chaps1988: folds 
ramseyg117: calls $2
solano20000: calls $2
stan_09319: folds 
matiko09: folds 
Monsthand: calls $1
Igoriah: raises $12 to $14
ramseyg117: calls $12
solano20000: calls $12
Monsthand: folds 
*** FLOP *** [Ad 2s Qs]
Igoriah: bets $25
ramseyg117: folds 
solano20000: folds 
Uncalled bet ($25) returned to Igoriah
Igoriah collected $41.80 from pot
Igoriah: doesn't show hand 
*** SUMMARY ***
Total pot $44 | Rake $2.20 
Board [Ad 2s Qs]
Seat 1: stan_09319 folded before Flop (didn't bet)
Seat 2: matiko09 (button) folded before Flop (didn't bet)
Seat 3: Monsthand (small blind) folded before Flop
Seat 4: Igoriah (big blind) collected ($41.80)
Seat 5: J0k3rF4c3_FD folded before Flop (didn't bet)
Seat 6: Iggso folded before Flop (didn't bet)
Seat 7: chaps1988 folded before Flop (didn't bet)
Seat 8: ramseyg117 folded on the Flop
Seat 9: solano20000 folded on the Flop





PokerStars Hand #153065705111:  Hold'em No Limit ($1/$2 USD) - 2016/05/09 15:47:20 CET [2016/05/09 9:47:20 ET]
Table 'Hagar II' 9-max Seat #9 is the button
Seat 1: azzad2007 ($256.62 in chips) 
Seat 2: billynomates ($104.06 in chips) 
Seat 3: stan_09319 ($202 in chips) 
Seat 4: matiko09 ($200 in chips) 
Seat 5: darren1031 ($278.30 in chips) 
Seat 6: Piniker85 ($568.84 in chips) 
Seat 7: Monsthand ($200 in chips) 
Seat 8: J0k3rF4c3_FD ($323.80 in chips) 
Seat 9: chaps1988 ($200 in chips) 
azzad2007: posts small blind $1
billynomates: posts big blind $2
*** HOLE CARDS ***
Dealt to matiko09 [9c Qs]
stan_09319: folds 
matiko09: folds 
darren1031: folds 
Piniker85: folds 
Monsthand: folds 
J0k3rF4c3_FD: folds 
chaps1988: folds 
azzad2007: raises $4 to $6
billynomates: folds 
Uncalled bet ($4) returned to azzad2007
azzad2007 collected $4 from pot
azzad2007: doesn't show hand 
*** SUMMARY ***
Total pot $4 | Rake $0 
Seat 1: azzad2007 (small blind) collected ($4)
Seat 2: billynomates (big blind) folded before Flop
Seat 3: stan_09319 folded before Flop (didn't bet)
Seat 4: matiko09 folded before Flop (didn't bet)
Seat 5: darren1031 folded before Flop (didn't bet)
Seat 6: Piniker85 folded before Flop (didn't bet)
Seat 7: Monsthand folded before Flop (didn't bet)
Seat 8: J0k3rF4c3_FD folded before Flop (didn't bet)
Seat 9: chaps1988 (button) folded before Flop (didn't bet)





PokerStars Hand #153065714798:  Hold'em No Limit ($0.50/$1.00 USD) - 2016/05/09 15:47:32 CET [2016/05/09 9:47:32 ET]
Table 'Mentha' 9-max Seat #7 is the button
Seat 2: guoweiAA ($176.97 in chips) 
Seat 3: r4mz3s ($102.18 in chips) 
Seat 4: duggy2016 ($68.94 in chips) 
Seat 5: mycka86 ($117.19 in chips) 
Seat 6: Filojoes ($167.61 in chips) 
Seat 7: matiko09 ($117.85 in chips) 
Seat 9: Dickyxxx ($100 in chips) 
Lycaon23 will be allowed to play after the button
Dickyxxx: posts small blind $0.50
maxxmeister: is sitting out 
guoweiAA: posts big blind $1
*** HOLE CARDS ***
Dealt to matiko09 [3h 9d]
r4mz3s: raises $2 to $3
duggy2016: calls $3
mycka86: folds 
Filojoes: folds 
matiko09: folds 
Dickyxxx: folds 
guoweiAA: folds 
*** FLOP *** [Ah 7h Qd]
r4mz3s: bets $5.25
duggy2016: folds 
Uncalled bet ($5.25) returned to r4mz3s
r4mz3s collected $7.12 from pot
r4mz3s: doesn't show hand 
*** SUMMARY ***
Total pot $7.50 | Rake $0.38 
Board [Ah 7h Qd]
Seat 2: guoweiAA (big blind) folded before Flop
Seat 3: r4mz3s collected ($7.12)
Seat 4: duggy2016 folded on the Flop
Seat 5: mycka86 folded before Flop (didn't bet)
Seat 6: Filojoes folded before Flop (didn't bet)
Seat 7: matiko09 (button) folded before Flop (didn't bet)
Seat 9: Dickyxxx (small blind) folded before Flop





PokerStars Hand #153065722626:  Hold'em No Limit ($0.50/$1.00 USD) - 2016/05/09 15:47:43 CET [2016/05/09 9:47:43 ET]
Table 'Reiss' 9-max Seat #8 is the button
Seat 2: mycka86 ($112.81 in chips) 
Seat 3: chaps1988 ($116.99 in chips) 
Seat 4: MichaLabam ($158.11 in chips) 
Seat 5: matiko09 ($110.13 in chips) 
Seat 6: Spid1 ($100 in chips) 
Seat 8: Filojoes ($193.18 in chips) 
Seat 9: maxxmeister ($152.21 in chips) 
maxxmeister: posts small blind $0.50
birdie1970: is sitting out 
mycka86: posts big blind $1
nubpoker: sits out 
*** HOLE CARDS ***
Dealt to matiko09 [Ts 2s]
chaps1988: folds 
birdie1970 leaves the table
Dickyxxx joins the table at seat #1 
MichaLabam has timed out
MichaLabam: folds 
matiko09: folds 
Spid1: folds 
Filojoes: folds 
maxxmeister: raises $3 to $4
mycka86: calls $3
*** FLOP *** [Qd Kh Jc]
maxxmeister: checks 
mycka86: checks 
*** TURN *** [Qd Kh Jc] [Qh]
maxxmeister: checks 
mycka86: checks 
*** RIVER *** [Qd Kh Jc Qh] [Jd]
maxxmeister: bets $4.14
mycka86: calls $4.14
*** SHOW DOWN ***
maxxmeister: shows [3d 5h] (two pair, Queens and Jacks)
mycka86: shows [9d Ac] (two pair, Queens and Jacks - Ace kicker)
mycka86 collected $15.47 from pot
*** SUMMARY ***
Total pot $16.28 | Rake $0.81 
Board [Qd Kh Jc Qh Jd]
Seat 2: mycka86 (big blind) showed [9d Ac] and won ($15.47) with two pair, Queens and Jacks
Seat 3: chaps1988 folded before Flop (didn't bet)
Seat 4: MichaLabam folded before Flop (didn't bet)
Seat 5: matiko09 folded before Flop (didn't bet)
Seat 6: Spid1 folded before Flop (didn't bet)
Seat 8: Filojoes (button) folded before Flop (didn't bet)
Seat 9: maxxmeister (small blind) showed [3d 5h] and lost with two pair, Queens and Jacks





PokerStars Hand #153065726553:  Hold'em No Limit ($1/$2 USD) - 2016/05/09 15:47:49 CET [2016/05/09 9:47:49 ET]
Table 'Hagar II' 9-max Seat #1 is the button
Seat 1: azzad2007 ($258.62 in chips) 
Seat 2: billynomates ($102.06 in chips) 
Seat 3: stan_09319 ($202 in chips) 
Seat 4: matiko09 ($200 in chips) 
Seat 5: darren1031 ($278.30 in chips) 
Seat 6: Piniker85 ($568.84 in chips) 
Seat 7: Monsthand ($200 in chips) 
Seat 8: J0k3rF4c3_FD ($323.80 in chips) 
Seat 9: chaps1988 ($200 in chips) 
billynomates: posts small blind $1
stan_09319: posts big blind $2
*** HOLE CARDS ***
Dealt to matiko09 [9d Qh]
matiko09: folds 
darren1031: folds 
Piniker85: folds 
Monsthand: folds 
J0k3rF4c3_FD: folds 
chaps1988: raises $3 to $5
azzad2007: folds 
billynomates: calls $4
stan_09319: calls $3
*** FLOP *** [6h Ad 5s]
billynomates: checks 
stan_09319: checks 
chaps1988: bets $6.50
billynomates: folds 
stan_09319: calls $6.50
*** TURN *** [6h Ad 5s] [Tc]
stan_09319: checks 
chaps1988: checks 
*** RIVER *** [6h Ad 5s Tc] [7h]
stan_09319: checks 
chaps1988: checks 
*** SHOW DOWN ***
stan_09319: shows [4s As] (a pair of Aces)
chaps1988: mucks hand 
stan_09319 collected $26.60 from pot
*** SUMMARY ***
Total pot $28 | Rake $1.40 
Board [6h Ad 5s Tc 7h]
Seat 1: azzad2007 (button) folded before Flop (didn't bet)
Seat 2: billynomates (small blind) folded on the Flop
Seat 3: stan_09319 (big blind) showed [4s As] and won ($26.60) with a pair of Aces
Seat 4: matiko09 folded before Flop (didn't bet)
Seat 5: darren1031 folded before Flop (didn't bet)
Seat 6: Piniker85 folded before Flop (didn't bet)
Seat 7: Monsthand folded before Flop (didn't bet)
Seat 8: J0k3rF4c3_FD folded before Flop (didn't bet)
Seat 9: chaps1988 mucked [8s 8d]





PokerStars Hand #153065738398:  Hold'em No Limit ($1/$2 USD) - 2016/05/09 15:48:10 CET [2016/05/09 9:48:10 ET]
Table 'Luda' 9-max Seat #3 is the button
Seat 1: stan_09319 ($421.84 in chips) 
Seat 2: matiko09 ($200 in chips) 
Seat 3: Monsthand ($206.05 in chips) 
Seat 4: Igoriah ($227.80 in chips) 
Seat 5: J0k3rF4c3_FD ($248.25 in chips) 
Seat 6: Iggso ($202.05 in chips) 
Seat 7: chaps1988 ($232.25 in chips) 
Seat 8: ramseyg117 ($282.20 in chips) 
Seat 9: solano20000 ($161.92 in chips) 
Igoriah: posts small blind $1
J0k3rF4c3_FD: posts big blind $2
*** HOLE CARDS ***
Dealt to matiko09 [Ah Js]
Iggso: folds 
chaps1988: folds 
ramseyg117: folds 
solano20000: calls $2
stan_09319: raises $6 to $8
matiko09: calls $8
Monsthand: folds 
Igoriah: folds 
J0k3rF4c3_FD: raises $24 to $32
solano20000: folds 
stan_09319: folds 
matiko09: folds 
Uncalled bet ($24) returned to J0k3rF4c3_FD
J0k3rF4c3_FD collected $27 from pot
J0k3rF4c3_FD: doesn't show hand 
*** SUMMARY ***
Total pot $27 | Rake $0 
Seat 1: stan_09319 folded before Flop
Seat 2: matiko09 folded before Flop
Seat 3: Monsthand (button) folded before Flop (didn't bet)
Seat 4: Igoriah (small blind) folded before Flop
Seat 5: J0k3rF4c3_FD (big blind) collected ($27)
Seat 6: Iggso folded before Flop (didn't bet)
Seat 7: chaps1988 folded before Flop (didn't bet)
Seat 8: ramseyg117 folded before Flop (didn't bet)
Seat 9: solano20000 folded before Flop





PokerStars Hand #153065739200:  Hold'em No Limit ($1/$2 USD) - 2016/05/09 15:48:11 CET [2016/05/09 9:48:11 ET]
Table 'Celaeno II' 9-max Seat #3 is the button
Seat 1: Li Shaobo ($271.45 in chips) 
Seat 2: J0k3rF4c3_FD ($223.33 in chips) 
Seat 3: Fredstar56 ($120.23 in chips) 
Seat 4: FTPbannedMe ($225.22 in chips) 
Seat 5: stan_09319 ($238.92 in chips) 
Seat 6: matiko09 ($280.08 in chips) 
Seat 7: Mister_b44 ($121.07 in chips) 
Seat 8: chaps1988 ($241.77 in chips) 
Seat 9: Spid1 ($200 in chips) 
FTPbannedMe: posts small blind $1
stan_09319: posts big blind $2
*** HOLE CARDS ***
Dealt to matiko09 [2h Ac]
matiko09: folds 
Mister_b44: folds 
chaps1988: raises $4 to $6
Spid1: folds 
Li Shaobo: folds 
J0k3rF4c3_FD: folds 
Fredstar56: folds 
FTPbannedMe: folds 
stan_09319: folds 
Uncalled bet ($4) returned to chaps1988
chaps1988 collected $5 from pot
chaps1988: doesn't show hand 
*** SUMMARY ***
Total pot $5 | Rake $0 
Seat 1: Li Shaobo folded before Flop (didn't bet)
Seat 2: J0k3rF4c3_FD folded before Flop (didn't bet)
Seat 3: Fredstar56 (button) folded before Flop (didn't bet)
Seat 4: FTPbannedMe (small blind) folded before Flop
Seat 5: stan_09319 (big blind) folded before Flop
Seat 6: matiko09 folded before Flop (didn't bet)
Seat 7: Mister_b44 folded before Flop (didn't bet)
Seat 8: chaps1988 collected ($5)
Seat 9: Spid1 folded before Flop (didn't bet)





PokerStars Hand #153065741292:  Hold'em No Limit ($0.50/$1.00 USD) - 2016/05/09 15:48:15 CET [2016/05/09 9:48:15 ET]
Table 'Merga II' 9-max Seat #2 is the button
Seat 1: luckyluke24 ($42.08 in chips) 
Seat 2: Filojoes ($100 in chips) 
Seat 3: xhinostrabli ($40.01 in chips) 
Seat 4: nubpoker ($104.62 in chips) 
Seat 5: LRVAV7 ($301.02 in chips) 
Seat 6: Spid1 ($165.53 in chips) 
Seat 7: matiko09 ($105.60 in chips) 
Seat 8: GrandOldFart ($97 in chips) 
Seat 9: chaps1988 ($221.61 in chips) 
xhinostrabli: posts small blind $0.50
nubpoker: posts big blind $1
*** HOLE CARDS ***
Dealt to matiko09 [6c Qs]
LRVAV7: folds 
Spid1: raises $2 to $3
matiko09: folds 
GrandOldFart: calls $3
chaps1988: calls $3
luckyluke24: calls $3
Filojoes: folds 
xhinostrabli: folds 
nubpoker: folds 
*** FLOP *** [3c 2h Qh]
Spid1: checks 
GrandOldFart: bets $8
chaps1988: folds 
luckyluke24: calls $8
Spid1: folds 
*** TURN *** [3c 2h Qh] [9d]
GrandOldFart: bets $16
luckyluke24: folds 
Uncalled bet ($16) returned to GrandOldFart
GrandOldFart collected $28.02 from pot
*** SUMMARY ***
Total pot $29.50 | Rake $1.48 
Board [3c 2h Qh 9d]
Seat 1: luckyluke24 folded on the Turn
Seat 2: Filojoes (button) folded before Flop (didn't bet)
Seat 3: xhinostrabli (small blind) folded before Flop
Seat 4: nubpoker (big blind) folded before Flop
Seat 5: LRVAV7 folded before Flop (didn't bet)
Seat 6: Spid1 folded on the Flop
Seat 7: matiko09 folded before Flop (didn't bet)
Seat 8: GrandOldFart collected ($28.02)
Seat 9: chaps1988 folded on the Flop





PokerStars Hand #153065743899:  Hold'em No Limit ($0.50/$1.00 USD) - 2016/05/09 15:48:20 CET [2016/05/09 9:48:20 ET]
Table 'Terpsichore' 9-max Seat #3 is the button
Seat 1: 7hiro ($209.14 in chips) 
Seat 2: J0k3rF4c3_FD ($185.66 in chips) 
Seat 3: matiko09 ($105.37 in chips) 
Seat 4: maxxmeister ($110.92 in chips) 
Seat 5: mycka86 ($105.27 in chips) 
Seat 6: Filojoes ($103.18 in chips) 
Seat 7: xhinostrabli ($101.57 in chips) 
Seat 9: FTPbannedMe ($100 in chips) 
maxxmeister: posts small blind $0.50
mycka86: posts big blind $1
Kiosk230472: sits out 
*** HOLE CARDS ***
Dealt to matiko09 [7c 5d]
Filojoes: folds 
xhinostrabli: folds 
FTPbannedMe: folds 
7hiro: raises $1 to $2
J0k3rF4c3_FD: folds 
matiko09: folds 
maxxmeister: folds 
mycka86: folds 
Uncalled bet ($1) returned to 7hiro
7hiro collected $2.50 from pot
7hiro: doesn't show hand 
*** SUMMARY ***
Total pot $2.50 | Rake $0 
Seat 1: 7hiro collected ($2.50)
Seat 2: J0k3rF4c3_FD folded before Flop (didn't bet)
Seat 3: matiko09 (button) folded before Flop (didn't bet)
Seat 4: maxxmeister (small blind) folded before Flop
Seat 5: mycka86 (big blind) folded before Flop
Seat 6: Filojoes folded before Flop (didn't bet)
Seat 7: xhinostrabli folded before Flop (didn't bet)
Seat 9: FTPbannedMe folded before Flop (didn't bet)





PokerStars Hand #153065749462:  Hold'em No Limit ($1/$2 USD) - 2016/05/09 15:48:30 CET [2016/05/09 9:48:30 ET]
Table 'Celaeno II' 9-max Seat #4 is the button
Seat 1: Li Shaobo ($271.45 in chips) 
Seat 2: J0k3rF4c3_FD ($223.33 in chips) 
Seat 3: Fredstar56 ($120.23 in chips) 
Seat 4: FTPbannedMe ($224.22 in chips) 
Seat 5: stan_09319 ($236.92 in chips) 
Seat 6: matiko09 ($280.08 in chips) 
Seat 7: Mister_b44 ($121.07 in chips) 
Seat 8: chaps1988 ($244.77 in chips) 
Seat 9: Spid1 ($200 in chips) 
stan_09319: posts small blind $1
matiko09: posts big blind $2
*** HOLE CARDS ***
Dealt to matiko09 [Qc Tc]
Mister_b44: folds 
chaps1988: folds 
Spid1: folds 
Li Shaobo: folds 
J0k3rF4c3_FD: raises $3 to $5
Fredstar56: folds 
FTPbannedMe: raises $13 to $18
stan_09319: folds 
matiko09: folds 
J0k3rF4c3_FD: folds 
Uncalled bet ($13) returned to FTPbannedMe
FTPbannedMe collected $13 from pot
FTPbannedMe: doesn't show hand 
*** SUMMARY ***
Total pot $13 | Rake $0 
Seat 1: Li Shaobo folded before Flop (didn't bet)
Seat 2: J0k3rF4c3_FD folded before Flop
Seat 3: Fredstar56 folded before Flop (didn't bet)
Seat 4: FTPbannedMe (button) collected ($13)
Seat 5: stan_09319 (small blind) folded before Flop
Seat 6: matiko09 (big blind) folded before Flop
Seat 7: Mister_b44 folded before Flop (didn't bet)
Seat 8: chaps1988 folded before Flop (didn't bet)
Seat 9: Spid1 folded before Flop (didn't bet)





PokerStars Hand #153065755606:  Hold'em No Limit ($0.50/$1.00 USD) - 2016/05/09 15:48:40 CET [2016/05/09 9:48:40 ET]
Table 'Mentha' 9-max Seat #9 is the button
Seat 2: guoweiAA ($175.97 in chips) 
Seat 3: r4mz3s ($106.30 in chips) 
Seat 4: duggy2016 ($65.94 in chips) 
Seat 5: mycka86 ($117.19 in chips) 
Seat 6: Filojoes ($167.61 in chips) 
Seat 7: matiko09 ($117.85 in chips) 
Seat 9: Dickyxxx ($100 in chips) 
maxxmeister will be allowed to play after the button
guoweiAA: posts small blind $0.50
r4mz3s: posts big blind $1
Lycaon23: sits out 
*** HOLE CARDS ***
Dealt to matiko09 [5c 4s]
duggy2016: folds 
mycka86: folds 
Filojoes: folds 
matiko09: folds 
Dickyxxx: folds 
guoweiAA: folds 
Uncalled bet ($0.50) returned to r4mz3s
r4mz3s collected $1 from pot
r4mz3s: doesn't show hand 
*** SUMMARY ***
Total pot $1 | Rake $0 
Seat 2: guoweiAA (small blind) folded before Flop
Seat 3: r4mz3s (big blind) collected ($1)
Seat 4: duggy2016 folded before Flop (didn't bet)
Seat 5: mycka86 folded before Flop (didn't bet)
Seat 6: Filojoes folded before Flop (didn't bet)
Seat 7: matiko09 folded before Flop (didn't bet)
Seat 9: Dickyxxx (button) folded before Flop (didn't bet)





PokerStars Hand #153065770394:  Hold'em No Limit ($0.50/$1.00 USD) - 2016/05/09 15:49:07 CET [2016/05/09 9:49:07 ET]
Table 'Mentha' 9-max Seat #2 is the button
Seat 2: guoweiAA ($175.47 in chips) 
Seat 3: r4mz3s ($106.80 in chips) 
Seat 4: duggy2016 ($65.94 in chips) 
Seat 5: mycka86 ($117.19 in chips) 
Seat 6: Filojoes ($167.61 in chips) 
Seat 7: matiko09 ($117.85 in chips) 
Seat 9: Dickyxxx ($100 in chips) 
r4mz3s: posts small blind $0.50
duggy2016: posts big blind $1
Lycaon23: sits out 
maxxmeister: sits out 
*** HOLE CARDS ***
Dealt to matiko09 [Ks 2d]
mycka86: folds 
Filojoes: folds 
matiko09: folds 
Dickyxxx: folds 
guoweiAA: folds 
r4mz3s: raises $2 to $3
duggy2016: folds 
Uncalled bet ($2) returned to r4mz3s
r4mz3s collected $2 from pot
r4mz3s: doesn't show hand 
*** SUMMARY ***
Total pot $2 | Rake $0 
Seat 2: guoweiAA (button) folded before Flop (didn't bet)
Seat 3: r4mz3s (small blind) collected ($2)
Seat 4: duggy2016 (big blind) folded before Flop
Seat 5: mycka86 folded before Flop (didn't bet)
Seat 6: Filojoes folded before Flop (didn't bet)
Seat 7: matiko09 folded before Flop (didn't bet)
Seat 9: Dickyxxx folded before Flop (didn't bet)





PokerStars Hand #153065775449:  Hold'em No Limit ($1/$2 USD) - 2016/05/09 15:49:16 CET [2016/05/09 9:49:16 ET]
Table 'Hagar II' 9-max Seat #2 is the button
Seat 1: azzad2007 ($258.62 in chips) 
Seat 2: billynomates ($97.06 in chips) 
Seat 3: stan_09319 ($217.10 in chips) 
Seat 4: matiko09 ($200 in chips) 
Seat 5: darren1031 ($278.30 in chips) 
Seat 6: Piniker85 ($568.84 in chips) 
Seat 7: Monsthand ($200 in chips) 
Seat 8: J0k3rF4c3_FD ($323.80 in chips) 
Seat 9: chaps1988 ($200 in chips) 
stan_09319: posts small blind $1
matiko09: posts big blind $2
*** HOLE CARDS ***
Dealt to matiko09 [Ks 9c]
darren1031: folds 
Piniker85: calls $2
Monsthand: folds 
J0k3rF4c3_FD: folds 
chaps1988: raises $5 to $7
azzad2007: folds 
billynomates has timed out
billynomates: folds 
stan_09319: folds 
matiko09: folds 
Piniker85: calls $5
*** FLOP *** [Qs Qc 5h]
Piniker85: checks 
chaps1988: bets $8
Piniker85: raises $8 to $16
chaps1988: folds 
Uncalled bet ($8) returned to Piniker85
Piniker85 collected $31.35 from pot
Piniker85: doesn't show hand 
*** SUMMARY ***
Total pot $33 | Rake $1.65 
Board [Qs Qc 5h]
Seat 1: azzad2007 folded before Flop (didn't bet)
Seat 2: billynomates (button) folded before Flop (didn't bet)
Seat 3: stan_09319 (small blind) folded before Flop
Seat 4: matiko09 (big blind) folded before Flop
Seat 5: darren1031 folded before Flop (didn't bet)
Seat 6: Piniker85 collected ($31.35)
Seat 7: Monsthand folded before Flop (didn't bet)
Seat 8: J0k3rF4c3_FD folded before Flop (didn't bet)
Seat 9: chaps1988 folded on the Flop





PokerStars Hand #153065775548:  Hold'em No Limit ($1/$2 USD) - 2016/05/09 15:49:16 CET [2016/05/09 9:49:16 ET]
Table 'Luda' 9-max Seat #4 is the button
Seat 1: stan_09319 ($413.84 in chips) 
Seat 2: matiko09 ($200 in chips) 
Seat 3: Monsthand ($206.05 in chips) 
Seat 4: Igoriah ($226.80 in chips) 
Seat 5: J0k3rF4c3_FD ($267.25 in chips) 
Seat 6: Iggso ($202.05 in chips) 
Seat 7: chaps1988 ($232.25 in chips) 
Seat 8: ramseyg117 ($282.20 in chips) 
Seat 9: solano20000 ($159.92 in chips) 
J0k3rF4c3_FD: posts small blind $1
Iggso: posts big blind $2
*** HOLE CARDS ***
Dealt to matiko09 [Ah 8s]
chaps1988: folds 
ramseyg117: raises $5 to $7
solano20000: folds 
stan_09319: calls $7
matiko09: folds 
Monsthand: folds 
Igoriah: folds 
J0k3rF4c3_FD: folds 
Iggso: folds 
*** FLOP *** [4d Th Tc]
ramseyg117: checks 
stan_09319: checks 
*** TURN *** [4d Th Tc] [4c]
ramseyg117: checks 
stan_09319: bets $11.30
ramseyg117: folds 
Uncalled bet ($11.30) returned to stan_09319
stan_09319 collected $16.15 from pot
stan_09319: doesn't show hand 
*** SUMMARY ***
Total pot $17 | Rake $0.85 
Board [4d Th Tc 4c]
Seat 1: stan_09319 collected ($16.15)
Seat 2: matiko09 folded before Flop (didn't bet)
Seat 3: Monsthand folded before Flop (didn't bet)
Seat 4: Igoriah (button) folded before Flop (didn't bet)
Seat 5: J0k3rF4c3_FD (small blind) folded before Flop
Seat 6: Iggso (big blind) folded before Flop
Seat 7: chaps1988 folded before Flop (didn't bet)
Seat 8: ramseyg117 folded on the Turn
Seat 9: solano20000 folded before Flop (didn't bet)





PokerStars Hand #153065775918:  Hold'em No Limit ($1/$2 USD) - 2016/05/09 15:49:17 CET [2016/05/09 9:49:17 ET]
Table 'Celaeno II' 9-max Seat #5 is the button
Seat 1: Li Shaobo ($271.45 in chips) 
Seat 2: J0k3rF4c3_FD ($218.33 in chips) 
Seat 3: Fredstar56 ($120.23 in chips) 
Seat 4: FTPbannedMe ($232.22 in chips) 
Seat 5: stan_09319 ($235.92 in chips) 
Seat 6: matiko09 ($278.08 in chips) 
Seat 7: Mister_b44 ($121.07 in chips) 
Seat 8: chaps1988 ($244.77 in chips) 
Seat 9: Spid1 ($200 in chips) 
matiko09: posts small blind $1
Mister_b44: posts big blind $2
*** HOLE CARDS ***
Dealt to matiko09 [6c 9d]
chaps1988: folds 
Spid1: folds 
Li Shaobo: raises $2 to $4
J0k3rF4c3_FD: folds 
Fredstar56: folds 
FTPbannedMe: folds 
stan_09319: folds 
matiko09: folds 
Mister_b44: folds 
Uncalled bet ($2) returned to Li Shaobo
Li Shaobo collected $5 from pot
Li Shaobo: doesn't show hand 
*** SUMMARY ***
Total pot $5 | Rake $0 
Seat 1: Li Shaobo collected ($5)
Seat 2: J0k3rF4c3_FD folded before Flop (didn't bet)
Seat 3: Fredstar56 folded before Flop (didn't bet)
Seat 4: FTPbannedMe folded before Flop (didn't bet)
Seat 5: stan_09319 (button) folded before Flop (didn't bet)
Seat 6: matiko09 (small blind) folded before Flop
Seat 7: Mister_b44 (big blind) folded before Flop
Seat 8: chaps1988 folded before Flop (didn't bet)
Seat 9: Spid1 folded before Flop (didn't bet)





PokerStars Hand #153065777529:  Hold'em No Limit ($0.50/$1.00 USD) - 2016/05/09 15:49:20 CET [2016/05/09 9:49:20 ET]
Table 'Terpsichore' 9-max Seat #4 is the button
Seat 1: 7hiro ($210.64 in chips) 
Seat 2: J0k3rF4c3_FD ($185.66 in chips) 
Seat 3: matiko09 ($105.37 in chips) 
Seat 4: maxxmeister ($110.42 in chips) 
Seat 5: mycka86 ($104.27 in chips) 
Seat 6: Filojoes ($103.18 in chips) 
Seat 7: xhinostrabli ($101.57 in chips) 
Seat 9: FTPbannedMe ($100 in chips) 
mycka86: posts small blind $0.50
Filojoes: posts big blind $1
Kiosk230472: sits out 
*** HOLE CARDS ***
Dealt to matiko09 [3c Kc]
xhinostrabli: folds 
FTPbannedMe: folds 
7hiro: raises $1 to $2
J0k3rF4c3_FD: folds 
matiko09: folds 
maxxmeister: calls $2
mycka86: folds 
Filojoes: folds 
*** FLOP *** [Ks Ah 4h]
7hiro: checks 
maxxmeister: checks 
*** TURN *** [Ks Ah 4h] [8h]
7hiro: checks 
maxxmeister: bets $5
7hiro: folds 
Uncalled bet ($5) returned to maxxmeister
maxxmeister collected $5.22 from pot
maxxmeister: doesn't show hand 
*** SUMMARY ***
Total pot $5.50 | Rake $0.28 
Board [Ks Ah 4h 8h]
Seat 1: 7hiro folded on the Turn
Seat 2: J0k3rF4c3_FD folded before Flop (didn't bet)
Seat 3: matiko09 folded before Flop (didn't bet)
Seat 4: maxxmeister (button) collected ($5.22)
Seat 5: mycka86 (small blind) folded before Flop
Seat 6: Filojoes (big blind) folded before Flop
Seat 7: xhinostrabli folded before Flop (didn't bet)
Seat 9: FTPbannedMe folded before Flop (didn't bet)





PokerStars Hand #153065789939:  Hold'em No Limit ($0.50/$1.00 USD) - 2016/05/09 15:49:42 CET [2016/05/09 9:49:42 ET]
Table 'Merga II' 9-max Seat #3 is the button
Seat 1: luckyluke24 ($31.08 in chips) 
Seat 2: Filojoes ($100 in chips) 
Seat 3: xhinostrabli ($39.51 in chips) 
Seat 4: nubpoker ($103.62 in chips) 
Seat 5: LRVAV7 ($301.02 in chips) 
Seat 6: Spid1 ($162.53 in chips) 
Seat 7: matiko09 ($105.60 in chips) 
Seat 8: GrandOldFart ($114.02 in chips) 
Seat 9: chaps1988 ($218.61 in chips) 
nubpoker: posts small blind $0.50
LRVAV7: posts big blind $1
*** HOLE CARDS ***
Dealt to matiko09 [2h Ks]
Spid1: folds 
matiko09: folds 
GrandOldFart: folds 
chaps1988: folds 
luckyluke24: raises $1.50 to $2.50
Filojoes: folds 
xhinostrabli: folds 
nubpoker: folds 
LRVAV7: calls $1.50
*** FLOP *** [6h 4s Qc]
LRVAV7: bets $3
luckyluke24: calls $3
*** TURN *** [6h 4s Qc] [8d]
LRVAV7: bets $10.92
luckyluke24: folds 
Uncalled bet ($10.92) returned to LRVAV7
LRVAV7 collected $10.92 from pot
LRVAV7: doesn't show hand 
*** SUMMARY ***
Total pot $11.50 | Rake $0.58 
Board [6h 4s Qc 8d]
Seat 1: luckyluke24 folded on the Turn
Seat 2: Filojoes folded before Flop (didn't bet)
Seat 3: xhinostrabli (button) folded before Flop (didn't bet)
Seat 4: nubpoker (small blind) folded before Flop
Seat 5: LRVAV7 (big blind) collected ($10.92)
Seat 6: Spid1 folded before Flop (didn't bet)
Seat 7: matiko09 folded before Flop (didn't bet)
Seat 8: GrandOldFart folded before Flop (didn't bet)
Seat 9: chaps1988 folded before Flop (didn't bet)





PokerStars Hand #153065790017:  Hold'em No Limit ($1/$2 USD) - 2016/05/09 15:49:42 CET [2016/05/09 9:49:42 ET]
Table 'Celaeno II' 9-max Seat #6 is the button
Seat 1: Li Shaobo ($274.45 in chips) 
Seat 2: J0k3rF4c3_FD ($218.33 in chips) 
Seat 3: Fredstar56 ($120.23 in chips) 
Seat 4: FTPbannedMe ($232.22 in chips) 
Seat 5: stan_09319 ($235.92 in chips) 
Seat 6: matiko09 ($277.08 in chips) 
Seat 7: Mister_b44 ($119.07 in chips) 
Seat 8: chaps1988 ($244.77 in chips) 
Seat 9: Spid1 ($200 in chips) 
Mister_b44: posts small blind $1
chaps1988: posts big blind $2
*** HOLE CARDS ***
Dealt to matiko09 [As 8c]
Spid1: folds 
Li Shaobo: folds 
J0k3rF4c3_FD: folds 
Fredstar56: calls $2
FTPbannedMe: folds 
stan_09319: folds 
matiko09: raises $6 to $8
Mister_b44: folds 
chaps1988: folds 
Fredstar56: calls $6
*** FLOP *** [3s Ac Jd]
Fredstar56: checks 
matiko09: checks 
*** TURN *** [3s Ac Jd] [6d]
Fredstar56: bets $9.02
matiko09: calls $9.02
*** RIVER *** [3s Ac Jd 6d] [7h]
Fredstar56: checks 
matiko09: bets $16
Fredstar56: folds 
Uncalled bet ($16) returned to matiko09
matiko09 collected $35.19 from pot
matiko09: doesn't show hand 
*** SUMMARY ***
Total pot $37.04 | Rake $1.85 
Board [3s Ac Jd 6d 7h]
Seat 1: Li Shaobo folded before Flop (didn't bet)
Seat 2: J0k3rF4c3_FD folded before Flop (didn't bet)
Seat 3: Fredstar56 folded on the River
Seat 4: FTPbannedMe folded before Flop (didn't bet)
Seat 5: stan_09319 folded before Flop (didn't bet)
Seat 6: matiko09 (button) collected ($35.19)
Seat 7: Mister_b44 (small blind) folded before Flop
Seat 8: chaps1988 (big blind) folded before Flop
Seat 9: Spid1 folded before Flop (didn't bet)





PokerStars Hand #153065790990:  Hold'em No Limit ($0.50/$1.00 USD) - 2016/05/09 15:49:44 CET [2016/05/09 9:49:44 ET]
Table 'Mentha' 9-max Seat #3 is the button
Seat 2: guoweiAA ($175.47 in chips) 
Seat 3: r4mz3s ($107.80 in chips) 
Seat 4: duggy2016 ($64.94 in chips) 
Seat 5: mycka86 ($117.19 in chips) 
Seat 6: Filojoes ($167.61 in chips) 
Seat 7: matiko09 ($117.85 in chips) 
Seat 9: Dickyxxx ($100 in chips) 
duggy2016: posts small blind $0.50
mycka86: posts big blind $1
Lycaon23: sits out 
maxxmeister: sits out 
*** HOLE CARDS ***
Dealt to matiko09 [3s 5d]
Filojoes: folds 
matiko09: folds 
Dickyxxx: folds 
guoweiAA: folds 
r4mz3s: raises $1.14 to $2.14
duggy2016: calls $1.64
mycka86: folds 
*** FLOP *** [3d 3c 3h]
duggy2016: checks 
r4mz3s: checks 
*** TURN *** [3d 3c 3h] [Jd]
duggy2016: bets $3
r4mz3s: folds 
Uncalled bet ($3) returned to duggy2016
duggy2016 collected $5.02 from pot
duggy2016: doesn't show hand 
*** SUMMARY ***
Total pot $5.28 | Rake $0.26 
Board [3d 3c 3h Jd]
Seat 2: guoweiAA folded before Flop (didn't bet)
Seat 3: r4mz3s (button) folded on the Turn
Seat 4: duggy2016 (small blind) collected ($5.02)
Seat 5: mycka86 (big blind) folded before Flop
Seat 6: Filojoes folded before Flop (didn't bet)
Seat 7: matiko09 folded before Flop (didn't bet)
Seat 9: Dickyxxx folded before Flop (didn't bet)





PokerStars Hand #153065791849:  Hold'em No Limit ($0.50/$1.00 USD) - 2016/05/09 15:49:46 CET [2016/05/09 9:49:46 ET]
Table 'Reiss' 9-max Seat #9 is the button
Seat 2: mycka86 ($120.14 in chips) 
Seat 3: chaps1988 ($116.99 in chips) 
Seat 4: MichaLabam ($158.11 in chips) 
Seat 5: matiko09 ($110.13 in chips) 
Seat 6: Spid1 ($100 in chips) 
Seat 8: Filojoes ($193.18 in chips) 
Seat 9: maxxmeister ($144.07 in chips) 
Dickyxxx will be allowed to play after the button
mycka86: posts small blind $0.50
chaps1988: posts big blind $1
nubpoker: sits out 
*** HOLE CARDS ***
Dealt to matiko09 [Jc Qh]
MichaLabam: raises $2 to $3
matiko09: folds 
Spid1: folds 
Filojoes: folds 
maxxmeister: folds 
mycka86: folds 
chaps1988: folds 
Uncalled bet ($2) returned to MichaLabam
MichaLabam collected $2.50 from pot
MichaLabam: doesn't show hand 
*** SUMMARY ***
Total pot $2.50 | Rake $0 
Seat 2: mycka86 (small blind) folded before Flop
Seat 3: chaps1988 (big blind) folded before Flop
Seat 4: MichaLabam collected ($2.50)
Seat 5: matiko09 folded before Flop (didn't bet)
Seat 6: Spid1 folded before Flop (didn't bet)
Seat 8: Filojoes folded before Flop (didn't bet)
Seat 9: maxxmeister (button) folded before Flop (didn't bet)





PokerStars Hand #153065802185:  Hold'em No Limit ($0.50/$1.00 USD) - 2016/05/09 15:50:04 CET [2016/05/09 9:50:04 ET]
Table 'Reiss' 9-max Seat #2 is the button
Seat 2: mycka86 ($119.64 in chips) 
Seat 3: chaps1988 ($115.99 in chips) 
Seat 4: MichaLabam ($159.61 in chips) 
Seat 5: matiko09 ($110.13 in chips) 
Seat 6: Spid1 ($100 in chips) 
Seat 8: Filojoes ($193.18 in chips) 
Seat 9: maxxmeister ($144.07 in chips) 
chaps1988: posts small blind $0.50
MichaLabam: posts big blind $1
nubpoker: sits out 
Dickyxxx: sits out 
*** HOLE CARDS ***
Dealt to matiko09 [7h Qd]
matiko09: folds 
Spid1: folds 
Filojoes: folds 
maxxmeister: folds 
mycka86: raises $1.10 to $2.10
chaps1988: folds 
MichaLabam: calls $1.10
*** FLOP *** [2d 6h 3d]
MichaLabam: checks 
mycka86: bets $3
MichaLabam: folds 
Uncalled bet ($3) returned to mycka86
mycka86 collected $4.46 from pot
*** SUMMARY ***
Total pot $4.70 | Rake $0.24 
Board [2d 6h 3d]
Seat 2: mycka86 (button) collected ($4.46)
Seat 3: chaps1988 (small blind) folded before Flop
Seat 4: MichaLabam (big blind) folded on the Flop
Seat 5: matiko09 folded before Flop (didn't bet)
Seat 6: Spid1 folded before Flop (didn't bet)
Seat 8: Filojoes folded before Flop (didn't bet)
Seat 9: maxxmeister folded before Flop (didn't bet)





PokerStars Hand #153065808101:  Hold'em No Limit ($1/$2 USD) - 2016/05/09 15:50:15 CET [2016/05/09 9:50:15 ET]
Table 'Luda' 9-max Seat #5 is the button
Seat 1: stan_09319 ($422.99 in chips) 
Seat 2: matiko09 ($200 in chips) 
Seat 3: Monsthand ($206.05 in chips) 
Seat 4: Igoriah ($226.80 in chips) 
Seat 5: J0k3rF4c3_FD ($266.25 in chips) 
Seat 6: Iggso ($200.05 in chips) 
Seat 7: chaps1988 ($232.25 in chips) 
Seat 8: ramseyg117 ($275.20 in chips) 
Seat 9: solano20000 ($159.92 in chips) 
Iggso: posts small blind $1
chaps1988: posts big blind $2
*** HOLE CARDS ***
Dealt to matiko09 [7h Qs]
ramseyg117: raises $2 to $4
solano20000: folds 
stan_09319: folds 
matiko09: folds 
Monsthand: raises $10 to $14
Igoriah: folds 
J0k3rF4c3_FD: folds 
Iggso: folds 
chaps1988: folds 
ramseyg117: raises $10 to $24
Monsthand: calls $10
*** FLOP *** [6d Ac Ad]
ramseyg117: checks 
Monsthand: checks 
*** TURN *** [6d Ac Ad] [5s]
ramseyg117: checks 
Monsthand: checks 
*** RIVER *** [6d Ac Ad 5s] [Kc]
ramseyg117: bets $251.20 and is all-in
Monsthand: folds 
Uncalled bet ($251.20) returned to ramseyg117
ramseyg117 collected $48.45 from pot
ramseyg117: doesn't show hand 
*** SUMMARY ***
Total pot $51 | Rake $2.55 
Board [6d Ac Ad 5s Kc]
Seat 1: stan_09319 folded before Flop (didn't bet)
Seat 2: matiko09 folded before Flop (didn't bet)
Seat 3: Monsthand folded on the River
Seat 4: Igoriah folded before Flop (didn't bet)
Seat 5: J0k3rF4c3_FD (button) folded before Flop (didn't bet)
Seat 6: Iggso (small blind) folded before Flop
Seat 7: chaps1988 (big blind) folded before Flop
Seat 8: ramseyg117 collected ($48.45)
Seat 9: solano20000 folded before Flop (didn't bet)





PokerStars Hand #153065814582:  Hold'em No Limit ($0.50/$1.00 USD) - 2016/05/09 15:50:27 CET [2016/05/09 9:50:27 ET]
Table 'Mentha' 9-max Seat #4 is the button
Seat 2: guoweiAA ($175.47 in chips) 
Seat 3: r4mz3s ($105.66 in chips) 
Seat 4: duggy2016 ($67.82 in chips) 
Seat 5: mycka86 ($116.19 in chips) 
Seat 6: Filojoes ($167.61 in chips) 
Seat 7: matiko09 ($117.85 in chips) 
Seat 9: Dickyxxx ($100 in chips) 
mycka86: posts small blind $0.50
Filojoes: posts big blind $1
Lycaon23: sits out 
maxxmeister: sits out 
*** HOLE CARDS ***
Dealt to matiko09 [Qc Jh]
matiko09: folds 
Dickyxxx: raises $2 to $3
guoweiAA: folds 
r4mz3s: folds 
duggy2016: folds 
mycka86: folds 
Filojoes: folds 
Uncalled bet ($2) returned to Dickyxxx
Dickyxxx collected $2.50 from pot
Dickyxxx: doesn't show hand 
*** SUMMARY ***
Total pot $2.50 | Rake $0 
Seat 2: guoweiAA folded before Flop (didn't bet)
Seat 3: r4mz3s folded before Flop (didn't bet)
Seat 4: duggy2016 (button) folded before Flop (didn't bet)
Seat 5: mycka86 (small blind) folded before Flop
Seat 6: Filojoes (big blind) folded before Flop
Seat 7: matiko09 folded before Flop (didn't bet)
Seat 9: Dickyxxx collected ($2.50)





PokerStars Hand #153065821936:  Hold'em No Limit ($0.50/$1.00 USD) - 2016/05/09 15:50:40 CET [2016/05/09 9:50:40 ET]
Table 'Reiss' 9-max Seat #3 is the button
Seat 2: mycka86 ($122 in chips) 
Seat 3: chaps1988 ($115.49 in chips) 
Seat 4: MichaLabam ($157.51 in chips) 
Seat 5: matiko09 ($110.13 in chips) 
Seat 6: Spid1 ($100 in chips) 
Seat 8: Filojoes ($193.18 in chips) 
Seat 9: maxxmeister ($144.07 in chips) 
MichaLabam: posts small blind $0.50
matiko09: posts big blind $1
nubpoker: sits out 
Dickyxxx: sits out 
*** HOLE CARDS ***
Dealt to matiko09 [4s 6c]
Spid1: folds 
Filojoes: folds 
maxxmeister: folds 
mycka86: folds 
chaps1988: raises $1 to $2
MichaLabam: calls $1.50
matiko09: folds 
*** FLOP *** [6h Qh 9s]
MichaLabam: checks 
chaps1988: bets $2.50
MichaLabam: calls $2.50
*** TURN *** [6h Qh 9s] [Th]
MichaLabam: checks 
chaps1988: checks 
*** RIVER *** [6h Qh 9s Th] [Kd]
MichaLabam: bets $5
chaps1988: folds 
Uncalled bet ($5) returned to MichaLabam
MichaLabam collected $9.50 from pot
MichaLabam: doesn't show hand 
*** SUMMARY ***
Total pot $10 | Rake $0.50 
Board [6h Qh 9s Th Kd]
Seat 2: mycka86 folded before Flop (didn't bet)
Seat 3: chaps1988 (button) folded on the River
Seat 4: MichaLabam (small blind) collected ($9.50)
Seat 5: matiko09 (big blind) folded before Flop
Seat 6: Spid1 folded before Flop (didn't bet)
Seat 8: Filojoes folded before Flop (didn't bet)
Seat 9: maxxmeister folded before Flop (didn't bet)





PokerStars Hand #153065822578:  Hold'em No Limit ($0.50/$1.00 USD) - 2016/05/09 15:50:41 CET [2016/05/09 9:50:41 ET]
Table 'Terpsichore' 9-max Seat #5 is the button
Seat 1: 7hiro ($208.64 in chips) 
Seat 2: J0k3rF4c3_FD ($185.66 in chips) 
Seat 3: matiko09 ($105.37 in chips) 
Seat 4: maxxmeister ($113.64 in chips) 
Seat 5: mycka86 ($103.77 in chips) 
Seat 6: Filojoes ($102.18 in chips) 
Seat 7: xhinostrabli ($101.57 in chips) 
Seat 9: FTPbannedMe ($100 in chips) 
Filojoes: posts small blind $0.50
xhinostrabli: posts big blind $1
Kiosk230472: sits out 
*** HOLE CARDS ***
Dealt to matiko09 [Ah Ts]
FTPbannedMe: folds 
7hiro: raises $1 to $2
J0k3rF4c3_FD: folds 
matiko09: folds 
maxxmeister: folds 
mycka86: folds 
Filojoes: calls $1.50
xhinostrabli: folds 
*** FLOP *** [7d 9c 6d]
Filojoes: bets $2.85
7hiro: folds 
Uncalled bet ($2.85) returned to Filojoes
Filojoes collected $4.75 from pot
Filojoes: doesn't show hand 
*** SUMMARY ***
Total pot $5 | Rake $0.25 
Board [7d 9c 6d]
Seat 1: 7hiro folded on the Flop
Seat 2: J0k3rF4c3_FD folded before Flop (didn't bet)
Seat 3: matiko09 folded before Flop (didn't bet)
Seat 4: maxxmeister folded before Flop (didn't bet)
Seat 5: mycka86 (button) folded before Flop (didn't bet)
Seat 6: Filojoes (small blind) collected ($4.75)
Seat 7: xhinostrabli (big blind) folded before Flop
Seat 9: FTPbannedMe folded before Flop (didn't bet)





PokerStars Hand #153065824678:  Hold'em No Limit ($1/$2 USD) - 2016/05/09 15:50:45 CET [2016/05/09 9:50:45 ET]
Table 'Celaeno II' 9-max Seat #7 is the button
Seat 1: Li Shaobo ($274.45 in chips) 
Seat 2: J0k3rF4c3_FD ($218.33 in chips) 
Seat 3: Fredstar56 ($103.21 in chips) 
Seat 4: FTPbannedMe ($232.22 in chips) 
Seat 5: stan_09319 ($235.92 in chips) 
Seat 6: matiko09 ($295.25 in chips) 
Seat 7: Mister_b44 ($118.07 in chips) 
Seat 8: chaps1988 ($242.77 in chips) 
Seat 9: Spid1 ($200 in chips) 
chaps1988: posts small blind $1
Spid1: posts big blind $2
*** HOLE CARDS ***
Dealt to matiko09 [6c 8d]
Li Shaobo: folds 
J0k3rF4c3_FD: raises $3 to $5
Fredstar56: folds 
FTPbannedMe: folds 
stan_09319: folds 
matiko09: folds 
Mister_b44: folds 
chaps1988: folds 
Spid1: folds 
Uncalled bet ($3) returned to J0k3rF4c3_FD
J0k3rF4c3_FD collected $5 from pot
J0k3rF4c3_FD: doesn't show hand 
*** SUMMARY ***
Total pot $5 | Rake $0 
Seat 1: Li Shaobo folded before Flop (didn't bet)
Seat 2: J0k3rF4c3_FD collected ($5)
Seat 3: Fredstar56 folded before Flop (didn't bet)
Seat 4: FTPbannedMe folded before Flop (didn't bet)
Seat 5: stan_09319 folded before Flop (didn't bet)
Seat 6: matiko09 folded before Flop (didn't bet)
Seat 7: Mister_b44 (button) folded before Flop (didn't bet)
Seat 8: chaps1988 (small blind) folded before Flop
Seat 9: Spid1 (big blind) folded before Flop





PokerStars Hand #153065827135:  Hold'em No Limit ($1/$2 USD) - 2016/05/09 15:50:49 CET [2016/05/09 9:50:49 ET]
Table 'Hagar II' 9-max Seat #3 is the button
Seat 1: azzad2007 ($258.62 in chips) 
Seat 2: billynomates ($97.06 in chips) 
Seat 3: stan_09319 ($216.10 in chips) 
Seat 4: matiko09 ($200 in chips) 
Seat 5: darren1031 ($278.30 in chips) 
Seat 6: Piniker85 ($585.19 in chips) 
Seat 7: Monsthand ($200 in chips) 
Seat 8: J0k3rF4c3_FD ($323.80 in chips) 
Seat 9: chaps1988 ($200 in chips) 
matiko09: posts small blind $1
darren1031: posts big blind $2
*** HOLE CARDS ***
Dealt to matiko09 [Js 5s]
Piniker85: folds 
Monsthand: folds 
J0k3rF4c3_FD: folds 
chaps1988: folds 
azzad2007: folds 
billynomates: calls $2
stan_09319: folds 
matiko09: folds 
darren1031: checks 
*** FLOP *** [7s 9s 5h]
darren1031: checks 
billynomates: bets $2
darren1031: calls $2
*** TURN *** [7s 9s 5h] [Th]
darren1031: checks 
billynomates: bets $2
darren1031: raises $10 to $12
billynomates said, "12 to win 8?"
billynomates: folds 
Uncalled bet ($10) returned to darren1031
darren1031 collected $12.35 from pot
darren1031: doesn't show hand 
*** SUMMARY ***
Total pot $13 | Rake $0.65 
Board [7s 9s 5h Th]
Seat 1: azzad2007 folded before Flop (didn't bet)
Seat 2: billynomates folded on the Turn
Seat 3: stan_09319 (button) folded before Flop (didn't bet)
Seat 4: matiko09 (small blind) folded before Flop
Seat 5: darren1031 (big blind) collected ($12.35)
Seat 6: Piniker85 folded before Flop (didn't bet)
Seat 7: Monsthand folded before Flop (didn't bet)
Seat 8: J0k3rF4c3_FD folded before Flop (didn't bet)
Seat 9: chaps1988 folded before Flop (didn't bet)





PokerStars Hand #153065831649:  Hold'em No Limit ($0.50/$1.00 USD) - 2016/05/09 15:50:57 CET [2016/05/09 9:50:57 ET]
Table 'Mentha' 9-max Seat #5 is the button
Seat 2: guoweiAA ($175.47 in chips) 
Seat 3: r4mz3s ($105.66 in chips) 
Seat 4: duggy2016 ($67.82 in chips) 
Seat 5: mycka86 ($115.69 in chips) 
Seat 6: Filojoes ($166.61 in chips) 
Seat 7: matiko09 ($117.85 in chips) 
Seat 9: Dickyxxx ($101.50 in chips) 
Filojoes: posts small blind $0.50
matiko09: posts big blind $1
Lycaon23: sits out 
maxxmeister: sits out 
*** HOLE CARDS ***
Dealt to matiko09 [7c Th]
Dickyxxx: raises $2 to $3
guoweiAA: folds 
r4mz3s: folds 
duggy2016: folds 
mycka86: folds 
Filojoes: folds 
matiko09: folds 
Uncalled bet ($2) returned to Dickyxxx
Dickyxxx collected $2.50 from pot
Dickyxxx: doesn't show hand 
*** SUMMARY ***
Total pot $2.50 | Rake $0 
Seat 2: guoweiAA folded before Flop (didn't bet)
Seat 3: r4mz3s folded before Flop (didn't bet)
Seat 4: duggy2016 folded before Flop (didn't bet)
Seat 5: mycka86 (button) folded before Flop (didn't bet)
Seat 6: Filojoes (small blind) folded before Flop
Seat 7: matiko09 (big blind) folded before Flop
Seat 9: Dickyxxx collected ($2.50)





PokerStars Hand #153065840109:  Hold'em No Limit ($1/$2 USD) - 2016/05/09 15:51:12 CET [2016/05/09 9:51:12 ET]
Table 'Celaeno II' 9-max Seat #8 is the button
Seat 1: Li Shaobo ($274.45 in chips) 
Seat 2: J0k3rF4c3_FD ($221.33 in chips) 
Seat 3: Fredstar56 ($103.21 in chips) 
Seat 4: FTPbannedMe ($232.22 in chips) 
Seat 5: stan_09319 ($235.92 in chips) 
Seat 6: matiko09 ($295.25 in chips) 
Seat 7: Mister_b44 ($118.07 in chips) 
Seat 8: chaps1988 ($241.77 in chips) 
Seat 9: Spid1 ($200 in chips) 
Spid1: posts small blind $1
Li Shaobo: posts big blind $2
*** HOLE CARDS ***
Dealt to matiko09 [Td 2h]
J0k3rF4c3_FD: folds 
Fredstar56: folds 
FTPbannedMe: folds 
stan_09319: folds 
matiko09: folds 
Mister_b44: raises $4 to $6
chaps1988: folds 
Spid1: folds 
Li Shaobo: raises $14 to $20
Mister_b44: calls $14
*** FLOP *** [7h 7c 4d]
Li Shaobo: bets $22
Mister_b44: folds 
Uncalled bet ($22) returned to Li Shaobo
Li Shaobo collected $38.95 from pot
Li Shaobo: doesn't show hand 
*** SUMMARY ***
Total pot $41 | Rake $2.05 
Board [7h 7c 4d]
Seat 1: Li Shaobo (big blind) collected ($38.95)
Seat 2: J0k3rF4c3_FD folded before Flop (didn't bet)
Seat 3: Fredstar56 folded before Flop (didn't bet)
Seat 4: FTPbannedMe folded before Flop (didn't bet)
Seat 5: stan_09319 folded before Flop (didn't bet)
Seat 6: matiko09 folded before Flop (didn't bet)
Seat 7: Mister_b44 folded on the Flop
Seat 8: chaps1988 (button) folded before Flop (didn't bet)
Seat 9: Spid1 (small blind) folded before Flop





PokerStars Hand #153065839673:  Hold'em No Limit ($0.50/$1.00 USD) - 2016/05/09 15:51:12 CET [2016/05/09 9:51:12 ET]
Table 'Merga II' 9-max Seat #4 is the button
Seat 1: luckyluke24 ($25.58 in chips) 
Seat 2: Filojoes ($100 in chips) 
Seat 3: xhinostrabli ($39.51 in chips) 
Seat 4: nubpoker ($103.12 in chips) 
Seat 5: LRVAV7 ($306.44 in chips) 
Seat 6: Spid1 ($162.53 in chips) 
Seat 7: matiko09 ($105.60 in chips) 
Seat 8: GrandOldFart ($114.02 in chips) 
Seat 9: chaps1988 ($218.61 in chips) 
LRVAV7: posts small blind $0.50
Spid1: posts big blind $1
*** HOLE CARDS ***
Dealt to matiko09 [6c 2d]
matiko09: folds 
GrandOldFart: folds 
chaps1988: folds 
luckyluke24: folds 
Filojoes: raises $2 to $3
xhinostrabli: folds 
nubpoker: folds 
LRVAV7: folds 
Spid1: calls $2
*** FLOP *** [Ah Qh 5c]
Spid1: checks 
Filojoes: checks 
*** TURN *** [Ah Qh 5c] [8c]
Spid1: checks 
Filojoes: checks 
*** RIVER *** [Ah Qh 5c 8c] [4d]
Spid1: checks 
Filojoes: bets $3.71
Spid1: folds 
Uncalled bet ($3.71) returned to Filojoes
Filojoes collected $6.18 from pot
Filojoes: doesn't show hand 
*** SUMMARY ***
Total pot $6.50 | Rake $0.32 
Board [Ah Qh 5c 8c 4d]
Seat 1: luckyluke24 folded before Flop (didn't bet)
Seat 2: Filojoes collected ($6.18)
Seat 3: xhinostrabli folded before Flop (didn't bet)
Seat 4: nubpoker (button) folded before Flop (didn't bet)
Seat 5: LRVAV7 (small blind) folded before Flop
Seat 6: Spid1 (big blind) folded on the River
Seat 7: matiko09 folded before Flop (didn't bet)
Seat 8: GrandOldFart folded before Flop (didn't bet)
Seat 9: chaps1988 folded before Flop (didn't bet)





PokerStars Hand #153065841727:  Hold'em No Limit ($0.50/$1.00 USD) - 2016/05/09 15:51:15 CET [2016/05/09 9:51:15 ET]
Table 'Mentha' 9-max Seat #6 is the button
Seat 2: guoweiAA ($175.47 in chips) 
Seat 3: r4mz3s ($105.66 in chips) 
Seat 4: duggy2016 ($67.82 in chips) 
Seat 5: mycka86 ($115.69 in chips) 
Seat 6: Filojoes ($166.11 in chips) 
Seat 7: matiko09 ($116.85 in chips) 
Seat 8: Lycaon23 ($100 in chips) 
Seat 9: Dickyxxx ($103 in chips) 
matiko09: posts small blind $0.50
Lycaon23: posts big blind $1
*** HOLE CARDS ***
Dealt to matiko09 [Ah Kh]
Dickyxxx: folds 
guoweiAA: folds 
r4mz3s: folds 
duggy2016: folds 
mycka86: folds 
Filojoes: folds 
matiko09: raises $2 to $3
Lycaon23: folds 
Uncalled bet ($2) returned to matiko09
matiko09 collected $2 from pot
matiko09: doesn't show hand 
*** SUMMARY ***
Total pot $2 | Rake $0 
Seat 2: guoweiAA folded before Flop (didn't bet)
Seat 3: r4mz3s folded before Flop (didn't bet)
Seat 4: duggy2016 folded before Flop (didn't bet)
Seat 5: mycka86 folded before Flop (didn't bet)
Seat 6: Filojoes (button) folded before Flop (didn't bet)
Seat 7: matiko09 (small blind) collected ($2)
Seat 8: Lycaon23 (big blind) folded before Flop
Seat 9: Dickyxxx folded before Flop (didn't bet)





PokerStars Hand #153065843113:  Hold'em No Limit ($0.50/$1.00 USD) - 2016/05/09 15:51:18 CET [2016/05/09 9:51:18 ET]
Table 'Terpsichore' 9-max Seat #6 is the button
Seat 1: 7hiro ($206.64 in chips) 
Seat 2: J0k3rF4c3_FD ($185.66 in chips) 
Seat 3: matiko09 ($105.37 in chips) 
Seat 4: maxxmeister ($113.64 in chips) 
Seat 5: mycka86 ($103.77 in chips) 
Seat 6: Filojoes ($104.93 in chips) 
Seat 7: xhinostrabli ($100.57 in chips) 
Seat 8: Kiosk230472 ($134.36 in chips) 
Seat 9: FTPbannedMe ($100 in chips) 
xhinostrabli: posts small blind $0.50
Kiosk230472: posts big blind $1
*** HOLE CARDS ***
Dealt to matiko09 [Ah 3c]
FTPbannedMe: raises $2 to $3
7hiro: folds 
J0k3rF4c3_FD: folds 
matiko09: folds 
maxxmeister: folds 
mycka86: folds 
Filojoes: calls $3
xhinostrabli: folds 
Kiosk230472: calls $2
*** FLOP *** [3d Ad 7d]
Kiosk230472: checks 
FTPbannedMe: bets $6.26
Filojoes: calls $6.26
Kiosk230472: folds 
*** TURN *** [3d Ad 7d] [Ac]
FTPbannedMe: checks 
Filojoes: bets $10.46
FTPbannedMe: folds 
Uncalled bet ($10.46) returned to Filojoes
Filojoes collected $20.92 from pot
Filojoes: doesn't show hand 
*** SUMMARY ***
Total pot $22.02 | Rake $1.10 
Board [3d Ad 7d Ac]
Seat 1: 7hiro folded before Flop (didn't bet)
Seat 2: J0k3rF4c3_FD folded before Flop (didn't bet)
Seat 3: matiko09 folded before Flop (didn't bet)
Seat 4: maxxmeister folded before Flop (didn't bet)
Seat 5: mycka86 folded before Flop (didn't bet)
Seat 6: Filojoes (button) collected ($20.92)
Seat 7: xhinostrabli (small blind) folded before Flop
Seat 8: Kiosk230472 (big blind) folded on the Flop
Seat 9: FTPbannedMe folded on the Turn





PokerStars Hand #153065847417:  Hold'em No Limit ($1/$2 USD) - 2016/05/09 15:51:26 CET [2016/05/09 9:51:26 ET]
Table 'Luda' 9-max Seat #6 is the button
Seat 1: stan_09319 ($422.99 in chips) 
Seat 2: matiko09 ($200 in chips) 
Seat 3: Monsthand ($200 in chips) 
Seat 4: Igoriah ($226.80 in chips) 
Seat 5: J0k3rF4c3_FD ($266.25 in chips) 
Seat 6: Iggso ($200 in chips) 
Seat 7: chaps1988 ($230.25 in chips) 
Seat 8: ramseyg117 ($299.65 in chips) 
Seat 9: solano20000 ($159.92 in chips) 
chaps1988: posts small blind $1
ramseyg117: posts big blind $2
*** HOLE CARDS ***
Dealt to matiko09 [3c 3h]
solano20000: folds 
stan_09319: folds 
matiko09: raises $3 to $5
Monsthand: folds 
Igoriah: calls $5
J0k3rF4c3_FD: folds 
Iggso: folds 
chaps1988: folds 
ramseyg117: raises $3 to $8
matiko09: calls $3
Igoriah: calls $3
*** FLOP *** [Jc Th Qc]
ramseyg117: bets $23.75
matiko09: folds 
Igoriah: raises $195.05 to $218.80 and is all-in
ramseyg117: folds 
Uncalled bet ($195.05) returned to Igoriah
Igoriah collected $69.75 from pot
Igoriah: doesn't show hand 
*** SUMMARY ***
Total pot $72.50 | Rake $2.75 
Board [Jc Th Qc]
Seat 1: stan_09319 folded before Flop (didn't bet)
Seat 2: matiko09 folded on the Flop
Seat 3: Monsthand folded before Flop (didn't bet)
Seat 4: Igoriah collected ($69.75)
Seat 5: J0k3rF4c3_FD folded before Flop (didn't bet)
Seat 6: Iggso (button) folded before Flop (didn't bet)
Seat 7: chaps1988 (small blind) folded before Flop
Seat 8: ramseyg117 (big blind) folded on the Flop
Seat 9: solano20000 folded before Flop (didn't bet)





PokerStars Hand #153065854090:  Hold'em No Limit ($0.50/$1.00 USD) - 2016/05/09 15:51:38 CET [2016/05/09 9:51:38 ET]
Table 'Mentha' 9-max Seat #7 is the button
Seat 2: guoweiAA ($175.47 in chips) 
Seat 3: r4mz3s ($105.66 in chips) 
Seat 4: duggy2016 ($67.82 in chips) 
Seat 5: mycka86 ($115.69 in chips) 
Seat 6: Filojoes ($166.11 in chips) 
Seat 7: matiko09 ($117.85 in chips) 
Seat 8: Lycaon23 ($99 in chips) 
Seat 9: Dickyxxx ($103 in chips) 
Lycaon23: posts small blind $0.50
Dickyxxx: posts big blind $1
*** HOLE CARDS ***
Dealt to matiko09 [5h 5s]
guoweiAA: folds 
r4mz3s: folds 
duggy2016: raises $2 to $3
mycka86: folds 
Filojoes: calls $3
matiko09: calls $3
Lycaon23: folds 
Dickyxxx: folds 
*** FLOP *** [2s 6d Ac]
duggy2016: checks 
Filojoes: bets $5.99
matiko09: folds 
duggy2016: folds 
Uncalled bet ($5.99) returned to Filojoes
Filojoes collected $9.98 from pot
Filojoes: doesn't show hand 
*** SUMMARY ***
Total pot $10.50 | Rake $0.52 
Board [2s 6d Ac]
Seat 2: guoweiAA folded before Flop (didn't bet)
Seat 3: r4mz3s folded before Flop (didn't bet)
Seat 4: duggy2016 folded on the Flop
Seat 5: mycka86 folded before Flop (didn't bet)
Seat 6: Filojoes collected ($9.98)
Seat 7: matiko09 (button) folded on the Flop
Seat 8: Lycaon23 (small blind) folded before Flop
Seat 9: Dickyxxx (big blind) folded before Flop





PokerStars Hand #153065863390:  Hold'em No Limit ($1/$2 USD) - 2016/05/09 15:51:55 CET [2016/05/09 9:51:55 ET]
Table 'Celaeno II' 9-max Seat #9 is the button
Seat 1: Li Shaobo ($293.40 in chips) 
Seat 2: J0k3rF4c3_FD ($221.33 in chips) 
Seat 3: Fredstar56 ($103.21 in chips) 
Seat 4: FTPbannedMe ($232.22 in chips) 
Seat 5: stan_09319 ($235.92 in chips) 
Seat 6: matiko09 ($295.25 in chips) 
Seat 7: Mister_b44 ($98.07 in chips) 
Seat 8: chaps1988 ($241.77 in chips) 
Seat 9: Spid1 ($200 in chips) 
Li Shaobo: posts small blind $1
J0k3rF4c3_FD: posts big blind $2
*** HOLE CARDS ***
Dealt to matiko09 [Qd 6d]
Fredstar56: folds 
FTPbannedMe: folds 
stan_09319: folds 
matiko09: folds 
Mister_b44: raises $4 to $6
chaps1988: folds 
Spid1: folds 
Li Shaobo: folds 
J0k3rF4c3_FD: calls $4
*** FLOP *** [3h 2d 4c]
J0k3rF4c3_FD: checks 
Mister_b44: checks 
*** TURN *** [3h 2d 4c] [4h]
J0k3rF4c3_FD: bets $6.41
Mister_b44: folds 
Uncalled bet ($6.41) returned to J0k3rF4c3_FD
J0k3rF4c3_FD collected $12.35 from pot
J0k3rF4c3_FD: doesn't show hand 
*** SUMMARY ***
Total pot $13 | Rake $0.65 
Board [3h 2d 4c 4h]
Seat 1: Li Shaobo (small blind) folded before Flop
Seat 2: J0k3rF4c3_FD (big blind) collected ($12.35)
Seat 3: Fredstar56 folded before Flop (didn't bet)
Seat 4: FTPbannedMe folded before Flop (didn't bet)
Seat 5: stan_09319 folded before Flop (didn't bet)
Seat 6: matiko09 folded before Flop (didn't bet)
Seat 7: Mister_b44 folded on the Turn
Seat 8: chaps1988 folded before Flop (didn't bet)
Seat 9: Spid1 (button) folded before Flop (didn't bet)





PokerStars Hand #153065864808:  Hold'em No Limit ($0.50/$1.00 USD) - 2016/05/09 15:51:57 CET [2016/05/09 9:51:57 ET]
Table 'Reiss' 9-max Seat #4 is the button
Seat 2: mycka86 ($122 in chips) 
Seat 3: chaps1988 ($110.99 in chips) 
Seat 4: MichaLabam ($162.51 in chips) 
Seat 5: matiko09 ($109.13 in chips) 
Seat 6: Spid1 ($100 in chips) 
Seat 8: Filojoes ($193.18 in chips) 
Seat 9: maxxmeister ($144.07 in chips) 
matiko09: posts small blind $0.50
Spid1: posts big blind $1
nubpoker: sits out 
Dickyxxx: sits out 
*** HOLE CARDS ***
Dealt to matiko09 [Ks 2s]
Filojoes: folds 
maxxmeister: raises $2.50 to $3.50
mycka86: calls $3.50
chaps1988: folds 
MichaLabam: calls $3.50
matiko09: folds 
Spid1: folds 
*** FLOP *** [9h Qc 2d]
maxxmeister: bets $9
mycka86: folds 
MichaLabam: folds 
Uncalled bet ($9) returned to maxxmeister
maxxmeister collected $11.40 from pot
maxxmeister: doesn't show hand 
*** SUMMARY ***
Total pot $12 | Rake $0.60 
Board [9h Qc 2d]
Seat 2: mycka86 folded on the Flop
Seat 3: chaps1988 folded before Flop (didn't bet)
Seat 4: MichaLabam (button) folded on the Flop
Seat 5: matiko09 (small blind) folded before Flop
Seat 6: Spid1 (big blind) folded before Flop
Seat 8: Filojoes folded before Flop (didn't bet)
Seat 9: maxxmeister collected ($11.40)





PokerStars Hand #153065868076:  Hold'em No Limit ($0.50/$1.00 USD) - 2016/05/09 15:52:03 CET [2016/05/09 9:52:03 ET]
Table 'Merga II' 9-max Seat #5 is the button
Seat 1: luckyluke24 ($25.58 in chips) 
Seat 2: Filojoes ($103.18 in chips) 
Seat 3: xhinostrabli ($39.51 in chips) 
Seat 4: nubpoker ($103.12 in chips) 
Seat 5: LRVAV7 ($305.94 in chips) 
Seat 6: Spid1 ($159.53 in chips) 
Seat 7: matiko09 ($105.60 in chips) 
Seat 8: GrandOldFart ($114.02 in chips) 
Seat 9: chaps1988 ($218.61 in chips) 
Spid1: posts small blind $0.50
matiko09: posts big blind $1
*** HOLE CARDS ***
Dealt to matiko09 [Jd Js]
GrandOldFart: folds 
chaps1988: folds 
luckyluke24: folds 
Filojoes: folds 
xhinostrabli: folds 
nubpoker: folds 
LRVAV7: raises $2 to $3
Spid1: folds 
matiko09: raises $8 to $11
LRVAV7: calls $8
*** FLOP *** [As 3s 7c]
matiko09: checks 
LRVAV7: bets $10.69
matiko09: calls $10.69
*** TURN *** [As 3s 7c] [Jh]
matiko09: checks 
LRVAV7: checks 
*** RIVER *** [As 3s 7c Jh] [4h]
matiko09: bets $27
LRVAV7: calls $27
*** SHOW DOWN ***
matiko09: shows [Jd Js] (three of a kind, Jacks)
LRVAV7: mucks hand 
matiko09 collected $95.38 from pot
*** SUMMARY ***
Total pot $97.88 | Rake $2.50 
Board [As 3s 7c Jh 4h]
Seat 1: luckyluke24 folded before Flop (didn't bet)
Seat 2: Filojoes folded before Flop (didn't bet)
Seat 3: xhinostrabli folded before Flop (didn't bet)
Seat 4: nubpoker folded before Flop (didn't bet)
Seat 5: LRVAV7 (button) mucked [Ah 9d]
Seat 6: Spid1 (small blind) folded before Flop
Seat 7: matiko09 (big blind) showed [Jd Js] and won ($95.38) with three of a kind, Jacks
Seat 8: GrandOldFart folded before Flop (didn't bet)
Seat 9: chaps1988 folded before Flop (didn't bet)





PokerStars Hand #153065876019:  Hold'em No Limit ($1/$2 USD) - 2016/05/09 15:52:17 CET [2016/05/09 9:52:17 ET]
Table 'Hagar II' 9-max Seat #4 is the button
Seat 1: azzad2007 ($258.62 in chips) 
Seat 2: billynomates ($91.06 in chips) 
Seat 3: stan_09319 ($216.10 in chips) 
Seat 4: matiko09 ($200 in chips) 
Seat 5: darren1031 ($284.65 in chips) 
Seat 6: Piniker85 ($585.19 in chips) 
Seat 7: Monsthand ($200 in chips) 
Seat 8: J0k3rF4c3_FD ($323.80 in chips) 
Seat 9: chaps1988 ($200 in chips) 
darren1031: posts small blind $1
Piniker85: posts big blind $2
*** HOLE CARDS ***
Dealt to matiko09 [4c Kc]
Monsthand: folds 
J0k3rF4c3_FD: folds 
chaps1988: folds 
azzad2007: raises $4 to $6
billynomates: folds 
stan_09319: folds 
matiko09: folds 
darren1031: folds 
Piniker85: folds 
Uncalled bet ($4) returned to azzad2007
azzad2007 collected $5 from pot
azzad2007: doesn't show hand 
*** SUMMARY ***
Total pot $5 | Rake $0 
Seat 1: azzad2007 collected ($5)
Seat 2: billynomates folded before Flop (didn't bet)
Seat 3: stan_09319 folded before Flop (didn't bet)
Seat 4: matiko09 (button) folded before Flop (didn't bet)
Seat 5: darren1031 (small blind) folded before Flop
Seat 6: Piniker85 (big blind) folded before Flop
Seat 7: Monsthand folded before Flop (didn't bet)
Seat 8: J0k3rF4c3_FD folded before Flop (didn't bet)
Seat 9: chaps1988 folded before Flop (didn't bet)





PokerStars Hand #153065882280:  Hold'em No Limit ($1/$2 USD) - 2016/05/09 15:52:29 CET [2016/05/09 9:52:29 ET]
Table 'Luda' 9-max Seat #7 is the button
Seat 1: stan_09319 ($422.99 in chips) 
Seat 2: matiko09 ($200 in chips) 
Seat 3: Monsthand ($200 in chips) 
Seat 4: Igoriah ($264.80 in chips) 
Seat 5: J0k3rF4c3_FD ($266.25 in chips) 
Seat 6: Iggso ($200 in chips) 
Seat 7: chaps1988 ($229.25 in chips) 
Seat 8: ramseyg117 ($267.90 in chips) 
Seat 9: solano20000 ($159.92 in chips) 
ramseyg117: posts small blind $1
solano20000: posts big blind $2
*** HOLE CARDS ***
Dealt to matiko09 [6h Jc]
stan_09319: folds 
matiko09: folds 
Monsthand: raises $4 to $6
Igoriah: folds 
J0k3rF4c3_FD: folds 
Iggso: calls $6
chaps1988: folds 
ramseyg117: raises $4 to $10
solano20000: calls $8
Monsthand: calls $4
Iggso: calls $4
*** FLOP *** [Qc 8s Ac]
ramseyg117: bets $257.90 and is all-in
solano20000: calls $149.92 and is all-in
Monsthand: folds 
Iggso: folds 
Uncalled bet ($107.98) returned to ramseyg117
*** TURN *** [Qc 8s Ac] [7d]
*** RIVER *** [Qc 8s Ac 7d] [4h]
*** SHOW DOWN ***
ramseyg117: shows [9s As] (a pair of Aces)
solano20000: shows [9h Ah] (a pair of Aces)
ramseyg117 collected $168.55 from pot
solano20000 collected $168.54 from pot
*** SUMMARY ***
Total pot $339.84 | Rake $2.75 
Board [Qc 8s Ac 7d 4h]
Seat 1: stan_09319 folded before Flop (didn't bet)
Seat 2: matiko09 folded before Flop (didn't bet)
Seat 3: Monsthand folded on the Flop
Seat 4: Igoriah folded before Flop (didn't bet)
Seat 5: J0k3rF4c3_FD folded before Flop (didn't bet)
Seat 6: Iggso folded on the Flop
Seat 7: chaps1988 (button) folded before Flop (didn't bet)
Seat 8: ramseyg117 (small blind) showed [9s As] and won ($168.55) with a pair of Aces
Seat 9: solano20000 (big blind) showed [9h Ah] and won ($168.54) with a pair of Aces





PokerStars Hand #153065882800:  Hold'em No Limit ($0.50/$1.00 USD) - 2016/05/09 15:52:30 CET [2016/05/09 9:52:30 ET]
Table 'Mentha' 9-max Seat #8 is the button
Seat 2: guoweiAA ($175.47 in chips) 
Seat 3: r4mz3s ($105.66 in chips) 
Seat 4: duggy2016 ($64.82 in chips) 
Seat 5: mycka86 ($115.69 in chips) 
Seat 6: Filojoes ($173.09 in chips) 
Seat 7: matiko09 ($114.85 in chips) 
Seat 8: Lycaon23 ($98.50 in chips) 
Seat 9: Dickyxxx ($102 in chips) 
Dickyxxx: posts small blind $0.50
guoweiAA: posts big blind $1
*** HOLE CARDS ***
Dealt to matiko09 [7s Kc]
r4mz3s: folds 
duggy2016: folds 
mycka86: folds 
Filojoes: folds 
matiko09: folds 
Lycaon23: raises $2 to $3
Dickyxxx: folds 
guoweiAA: raises $6.50 to $9.50
Lycaon23: calls $6.50
*** FLOP *** [Td Js 9c]
guoweiAA: checks 
Lycaon23: checks 
*** TURN *** [Td Js 9c] [5d]
guoweiAA: bets $9.26
Lycaon23: calls $9.26
*** RIVER *** [Td Js 9c 5d] [9h]
guoweiAA: checks 
Lycaon23: bets $20
guoweiAA: calls $20
*** SHOW DOWN ***
Lycaon23: shows [Ad 4d] (a pair of Nines)
guoweiAA: shows [Ac Ah] (two pair, Aces and Nines)
guoweiAA collected $75.52 from pot
*** SUMMARY ***
Total pot $78.02 | Rake $2.50 
Board [Td Js 9c 5d 9h]
Seat 2: guoweiAA (big blind) showed [Ac Ah] and won ($75.52) with two pair, Aces and Nines
Seat 3: r4mz3s folded before Flop (didn't bet)
Seat 4: duggy2016 folded before Flop (didn't bet)
Seat 5: mycka86 folded before Flop (didn't bet)
Seat 6: Filojoes folded before Flop (didn't bet)
Seat 7: matiko09 folded before Flop (didn't bet)
Seat 8: Lycaon23 (button) showed [Ad 4d] and lost with a pair of Nines
Seat 9: Dickyxxx (small blind) folded before Flop





PokerStars Hand #153065885351:  Hold'em No Limit ($0.50/$1.00 USD) - 2016/05/09 15:52:34 CET [2016/05/09 9:52:34 ET]
Table 'Reiss' 9-max Seat #5 is the button
Seat 2: mycka86 ($118.50 in chips) 
Seat 3: chaps1988 ($110.99 in chips) 
Seat 4: MichaLabam ($159.01 in chips) 
Seat 5: matiko09 ($108.63 in chips) 
Seat 6: Spid1 ($100 in chips) 
Seat 7: nubpoker ($100 in chips) 
Seat 8: Filojoes ($193.18 in chips) 
Seat 9: maxxmeister ($151.97 in chips) 
Spid1: posts small blind $0.50
nubpoker: posts big blind $1
Dickyxxx: sits out 
*** HOLE CARDS ***
Dealt to matiko09 [8h 5h]
Filojoes: folds 
maxxmeister: folds 
mycka86: folds 
chaps1988: folds 
MichaLabam: raises $2 to $3
matiko09: folds 
Spid1: calls $2.50
nubpoker: folds 
*** FLOP *** [4h 4c Kd]
Spid1: checks 
MichaLabam: bets $3
Spid1: calls $3
*** TURN *** [4h 4c Kd] [Kh]
Spid1: checks 
MichaLabam: checks 
*** RIVER *** [4h 4c Kd Kh] [Ad]
Spid1: checks 
MichaLabam: bets $8
Spid1: calls $8
*** SHOW DOWN ***
MichaLabam: shows [Qs Jc] (two pair, Kings and Fours)
Spid1: shows [As Qc] (two pair, Aces and Kings)
Spid1 collected $27.55 from pot
*** SUMMARY ***
Total pot $29 | Rake $1.45 
Board [4h 4c Kd Kh Ad]
Seat 2: mycka86 folded before Flop (didn't bet)
Seat 3: chaps1988 folded before Flop (didn't bet)
Seat 4: MichaLabam showed [Qs Jc] and lost with two pair, Kings and Fours
Seat 5: matiko09 (button) folded before Flop (didn't bet)
Seat 6: Spid1 (small blind) showed [As Qc] and won ($27.55) with two pair, Aces and Kings
Seat 7: nubpoker (big blind) folded before Flop
Seat 8: Filojoes folded before Flop (didn't bet)
Seat 9: maxxmeister folded before Flop (didn't bet)





PokerStars Hand #153065888359:  Hold'em No Limit ($1/$2 USD) - 2016/05/09 15:52:40 CET [2016/05/09 9:52:40 ET]
Table 'Celaeno II' 9-max Seat #1 is the button
Seat 1: Li Shaobo ($292.40 in chips) 
Seat 2: J0k3rF4c3_FD ($227.68 in chips) 
Seat 3: Fredstar56 ($103.21 in chips) 
Seat 4: FTPbannedMe ($232.22 in chips) 
Seat 5: stan_09319 ($235.92 in chips) 
Seat 6: matiko09 ($295.25 in chips) 
Seat 7: Mister_b44 ($92.07 in chips) 
Seat 8: chaps1988 ($241.77 in chips) 
Seat 9: Spid1 ($200 in chips) 
J0k3rF4c3_FD: posts small blind $1
Fredstar56: posts big blind $2
*** HOLE CARDS ***
Dealt to matiko09 [Jc 2d]
FTPbannedMe: folds 
stan_09319: folds 
matiko09: folds 
Mister_b44: folds 
chaps1988: folds 
Spid1: folds 
Li Shaobo: raises $2 to $4
J0k3rF4c3_FD: folds 
Fredstar56: raises $9 to $13
Li Shaobo: calls $9
*** FLOP *** [Qs 6d 2s]
Fredstar56: bets $12.82
Li Shaobo: folds 
Uncalled bet ($12.82) returned to Fredstar56
Fredstar56 collected $25.65 from pot
*** SUMMARY ***
Total pot $27 | Rake $1.35 
Board [Qs 6d 2s]
Seat 1: Li Shaobo (button) folded on the Flop
Seat 2: J0k3rF4c3_FD (small blind) folded before Flop
Seat 3: Fredstar56 (big blind) collected ($25.65)
Seat 4: FTPbannedMe folded before Flop (didn't bet)
Seat 5: stan_09319 folded before Flop (didn't bet)
Seat 6: matiko09 folded before Flop (didn't bet)
Seat 7: Mister_b44 folded before Flop (didn't bet)
Seat 8: chaps1988 folded before Flop (didn't bet)
Seat 9: Spid1 folded before Flop (didn't bet)





PokerStars Hand #153065888525:  Hold'em No Limit ($0.50/$1.00 USD) - 2016/05/09 15:52:40 CET [2016/05/09 9:52:40 ET]
Table 'Terpsichore' 9-max Seat #7 is the button
Seat 1: 7hiro ($206.64 in chips) 
Seat 2: J0k3rF4c3_FD ($185.66 in chips) 
Seat 3: matiko09 ($105.37 in chips) 
Seat 4: maxxmeister ($113.64 in chips) 
Seat 5: mycka86 ($103.77 in chips) 
Seat 6: Filojoes ($116.59 in chips) 
Seat 7: xhinostrabli ($100.07 in chips) 
Seat 8: Kiosk230472 ($131.36 in chips) 
Seat 9: FTPbannedMe ($100 in chips) 
Kiosk230472: posts small blind $0.50
FTPbannedMe: posts big blind $1
*** HOLE CARDS ***
Dealt to matiko09 [Qd Jh]
7hiro: folds 
J0k3rF4c3_FD: folds 
matiko09: folds 
maxxmeister: folds 
mycka86: folds 
Filojoes: folds 
xhinostrabli: folds 
Kiosk230472: folds 
Uncalled bet ($0.50) returned to FTPbannedMe
FTPbannedMe collected $1 from pot
FTPbannedMe: doesn't show hand 
*** SUMMARY ***
Total pot $1 | Rake $0 
Seat 1: 7hiro folded before Flop (didn't bet)
Seat 2: J0k3rF4c3_FD folded before Flop (didn't bet)
Seat 3: matiko09 folded before Flop (didn't bet)
Seat 4: maxxmeister folded before Flop (didn't bet)
Seat 5: mycka86 folded before Flop (didn't bet)
Seat 6: Filojoes folded before Flop (didn't bet)
Seat 7: xhinostrabli (button) folded before Flop (didn't bet)
Seat 8: Kiosk230472 (small blind) folded before Flop
Seat 9: FTPbannedMe (big blind) collected ($1)





PokerStars Hand #153065896731:  Hold'em No Limit ($1/$2 USD) - 2016/05/09 15:52:55 CET [2016/05/09 9:52:55 ET]
Table 'Hagar II' 9-max Seat #5 is the button
Seat 1: azzad2007 ($261.62 in chips) 
Seat 2: billynomates ($91.06 in chips) 
Seat 3: stan_09319 ($216.10 in chips) 
Seat 4: matiko09 ($200 in chips) 
Seat 5: darren1031 ($283.65 in chips) 
Seat 6: Piniker85 ($583.19 in chips) 
Seat 7: Monsthand ($200 in chips) 
Seat 8: J0k3rF4c3_FD ($323.80 in chips) 
Seat 9: chaps1988 ($200 in chips) 
Piniker85: posts small blind $1
Monsthand: posts big blind $2
*** HOLE CARDS ***
Dealt to matiko09 [3s 5d]
J0k3rF4c3_FD: folds 
chaps1988: folds 
azzad2007: folds 
billynomates: folds 
stan_09319: raises $2.70 to $4.70
matiko09: folds 
darren1031: folds 
Piniker85: calls $3.70
Monsthand: folds 
*** FLOP *** [8h 9c Tc]
Piniker85: bets $5
stan_09319: calls $5
*** TURN *** [8h 9c Tc] [Ah]
Piniker85: checks 
stan_09319: bets $17.28
Piniker85: calls $17.28
*** RIVER *** [8h 9c Tc Ah] [7c]
Piniker85: bets $20
stan_09319: folds 
Uncalled bet ($20) returned to Piniker85
Piniker85 collected $53.21 from pot
Piniker85: doesn't show hand 
*** SUMMARY ***
Total pot $55.96 | Rake $2.75 
Board [8h 9c Tc Ah 7c]
Seat 1: azzad2007 folded before Flop (didn't bet)
Seat 2: billynomates folded before Flop (didn't bet)
Seat 3: stan_09319 folded on the River
Seat 4: matiko09 folded before Flop (didn't bet)
Seat 5: darren1031 (button) folded before Flop (didn't bet)
Seat 6: Piniker85 (small blind) collected ($53.21)
Seat 7: Monsthand (big blind) folded before Flop
Seat 8: J0k3rF4c3_FD folded before Flop (didn't bet)
Seat 9: chaps1988 folded before Flop (didn't bet)





PokerStars Hand #153065903241:  Hold'em No Limit ($0.50/$1.00 USD) - 2016/05/09 15:53:07 CET [2016/05/09 9:53:07 ET]
Table 'Merga II' 9-max Seat #6 is the button
Seat 1: luckyluke24 ($25.58 in chips) 
Seat 2: Filojoes ($103.18 in chips) 
Seat 3: xhinostrabli ($39.51 in chips) 
Seat 4: nubpoker ($103.12 in chips) 
Seat 5: LRVAV7 ($257.25 in chips) 
Seat 6: Spid1 ($159.03 in chips) 
Seat 7: matiko09 ($152.29 in chips) 
Seat 8: GrandOldFart ($114.02 in chips) 
Seat 9: chaps1988 ($218.61 in chips) 
matiko09: posts small blind $0.50
GrandOldFart: posts big blind $1
*** HOLE CARDS ***
Dealt to matiko09 [5c Qc]
chaps1988: folds 
luckyluke24: folds 
Filojoes: folds 
xhinostrabli: folds 
nubpoker: folds 
LRVAV7: folds 
Spid1: folds 
matiko09: folds 
Uncalled bet ($0.50) returned to GrandOldFart
GrandOldFart collected $1 from pot
*** SUMMARY ***
Total pot $1 | Rake $0 
Seat 1: luckyluke24 folded before Flop (didn't bet)
Seat 2: Filojoes folded before Flop (didn't bet)
Seat 3: xhinostrabli folded before Flop (didn't bet)
Seat 4: nubpoker folded before Flop (didn't bet)
Seat 5: LRVAV7 folded before Flop (didn't bet)
Seat 6: Spid1 (button) folded before Flop (didn't bet)
Seat 7: matiko09 (small blind) folded before Flop
Seat 8: GrandOldFart (big blind) collected ($1)
Seat 9: chaps1988 folded before Flop (didn't bet)





PokerStars Hand #153065912967:  Hold'em No Limit ($0.50/$1.00 USD) - 2016/05/09 15:53:25 CET [2016/05/09 9:53:25 ET]
Table 'Terpsichore' 9-max Seat #8 is the button
Seat 1: 7hiro ($206.64 in chips) 
Seat 2: J0k3rF4c3_FD ($185.66 in chips) 
Seat 3: matiko09 ($105.37 in chips) 
Seat 4: maxxmeister ($113.64 in chips) 
Seat 5: mycka86 ($103.77 in chips) 
Seat 6: Filojoes ($116.59 in chips) 
Seat 7: xhinostrabli ($100.07 in chips) 
Seat 8: Kiosk230472 ($130.86 in chips) 
Seat 9: FTPbannedMe ($100.50 in chips) 
FTPbannedMe: posts small blind $0.50
7hiro: posts big blind $1
*** HOLE CARDS ***
Dealt to matiko09 [Tc 7c]
J0k3rF4c3_FD: folds 
matiko09: folds 
maxxmeister: folds 
mycka86: folds 
Filojoes: folds 
xhinostrabli: folds 
Kiosk230472 has timed out
Kiosk230472: folds 
FTPbannedMe: raises $2 to $3
7hiro: calls $2
*** FLOP *** [Ad 4h 8c]
FTPbannedMe: checks 
7hiro: checks 
*** TURN *** [Ad 4h 8c] [As]
FTPbannedMe: checks 
7hiro: checks 
*** RIVER *** [Ad 4h 8c As] [Ts]
FTPbannedMe: checks 
7hiro: checks 
*** SHOW DOWN ***
FTPbannedMe: shows [Js Kh] (a pair of Aces)
7hiro: shows [8h 9h] (two pair, Aces and Eights)
7hiro collected $5.70 from pot
*** SUMMARY ***
Total pot $6 | Rake $0.30 
Board [Ad 4h 8c As Ts]
Seat 1: 7hiro (big blind) showed [8h 9h] and won ($5.70) with two pair, Aces and Eights
Seat 2: J0k3rF4c3_FD folded before Flop (didn't bet)
Seat 3: matiko09 folded before Flop (didn't bet)
Seat 4: maxxmeister folded before Flop (didn't bet)
Seat 5: mycka86 folded before Flop (didn't bet)
Seat 6: Filojoes folded before Flop (didn't bet)
Seat 7: xhinostrabli folded before Flop (didn't bet)
Seat 8: Kiosk230472 (button) folded before Flop (didn't bet)
Seat 9: FTPbannedMe (small blind) showed [Js Kh] and lost with a pair of Aces





PokerStars Hand #153065916488:  Hold'em No Limit ($1/$2 USD) - 2016/05/09 15:53:31 CET [2016/05/09 9:53:31 ET]
Table 'Luda' 9-max Seat #8 is the button
Seat 1: stan_09319 ($422.99 in chips) 
Seat 2: matiko09 ($200 in chips) 
Seat 3: Monsthand ($200 in chips) 
Seat 4: Igoriah ($264.80 in chips) 
Seat 5: J0k3rF4c3_FD ($266.25 in chips) 
Seat 6: Iggso ($200 in chips) 
Seat 7: chaps1988 ($229.25 in chips) 
Seat 8: ramseyg117 ($276.53 in chips) 
Seat 9: solano20000 ($168.54 in chips) 
solano20000: posts small blind $1
stan_09319: posts big blind $2
*** HOLE CARDS ***
Dealt to matiko09 [2d 9c]
matiko09: folds 
ramseyg117 said, "lol lucky"
Monsthand: folds 
Igoriah: folds 
J0k3rF4c3_FD: folds 
Iggso: folds 
chaps1988: folds 
solano20000 said, "i didnt see what happened"
ramseyg117: folds 
ramseyg117 said, "we both had ace 9"
solano20000 said, "too much lag"
ramseyg117 said, "so we split the game"
solano20000 said, "haha"
solano20000: folds 
Uncalled bet ($1) returned to stan_09319
ramseyg117 said, "th winnings"
stan_09319 collected $2 from pot
stan_09319: doesn't show hand 
*** SUMMARY ***
Total pot $2 | Rake $0 
Seat 1: stan_09319 (big blind) collected ($2)
Seat 2: matiko09 folded before Flop (didn't bet)
Seat 3: Monsthand folded before Flop (didn't bet)
Seat 4: Igoriah folded before Flop (didn't bet)
Seat 5: J0k3rF4c3_FD folded before Flop (didn't bet)
Seat 6: Iggso folded before Flop (didn't bet)
Seat 7: chaps1988 folded before Flop (didn't bet)
Seat 8: ramseyg117 (button) folded before Flop (didn't bet)
Seat 9: solano20000 (small blind) folded before Flop





PokerStars Hand #153065918520:  Hold'em No Limit ($0.50/$1.00 USD) - 2016/05/09 15:53:35 CET [2016/05/09 9:53:35 ET]
Table 'Merga II' 9-max Seat #7 is the button
Seat 1: luckyluke24 ($25.58 in chips) 
Seat 2: Filojoes ($103.18 in chips) 
Seat 3: xhinostrabli ($39.51 in chips) 
Seat 4: nubpoker ($103.12 in chips) 
Seat 5: LRVAV7 ($257.25 in chips) 
Seat 6: Spid1 ($159.03 in chips) 
Seat 7: matiko09 ($151.79 in chips) 
Seat 8: GrandOldFart ($114.52 in chips) 
Seat 9: chaps1988 ($218.61 in chips) 
GrandOldFart: posts small blind $0.50
chaps1988: posts big blind $1
*** HOLE CARDS ***
Dealt to matiko09 [Qc 6c]
luckyluke24: folds 
Filojoes: folds 
xhinostrabli: folds 
nubpoker: folds 
LRVAV7: raises $1.50 to $2.50
Spid1: folds 
matiko09: folds 
GrandOldFart: calls $2
chaps1988: folds 
*** FLOP *** [6h Ks 9h]
GrandOldFart: checks 
LRVAV7: bets $4
GrandOldFart: folds 
Uncalled bet ($4) returned to LRVAV7
LRVAV7 collected $5.70 from pot
LRVAV7: doesn't show hand 
*** SUMMARY ***
Total pot $6 | Rake $0.30 
Board [6h Ks 9h]
Seat 1: luckyluke24 folded before Flop (didn't bet)
Seat 2: Filojoes folded before Flop (didn't bet)
Seat 3: xhinostrabli folded before Flop (didn't bet)
Seat 4: nubpoker folded before Flop (didn't bet)
Seat 5: LRVAV7 collected ($5.70)
Seat 6: Spid1 folded before Flop (didn't bet)
Seat 7: matiko09 (button) folded before Flop (didn't bet)
Seat 8: GrandOldFart (small blind) folded on the Flop
Seat 9: chaps1988 (big blind) folded before Flop





PokerStars Hand #153065921467:  Hold'em No Limit ($1/$2 USD) - 2016/05/09 15:53:40 CET [2016/05/09 9:53:40 ET]
Table 'Celaeno II' 9-max Seat #2 is the button
Seat 1: Li Shaobo ($279.40 in chips) 
Seat 2: J0k3rF4c3_FD ($226.68 in chips) 
Seat 3: Fredstar56 ($115.86 in chips) 
Seat 4: FTPbannedMe ($232.22 in chips) 
Seat 5: stan_09319 ($235.92 in chips) 
Seat 6: matiko09 ($295.25 in chips) 
Seat 7: Mister_b44 ($92.07 in chips) 
Seat 8: chaps1988 ($241.77 in chips) 
Seat 9: Spid1 ($200 in chips) 
Fredstar56: posts small blind $1
FTPbannedMe: posts big blind $2
*** HOLE CARDS ***
Dealt to matiko09 [7c Ts]
stan_09319: folds 
matiko09: folds 
Mister_b44: folds 
chaps1988: folds 
Spid1: folds 
Li Shaobo: folds 
J0k3rF4c3_FD: folds 
Fredstar56: folds 
Uncalled bet ($1) returned to FTPbannedMe
FTPbannedMe collected $2 from pot
FTPbannedMe: doesn't show hand 
*** SUMMARY ***
Total pot $2 | Rake $0 
Seat 1: Li Shaobo folded before Flop (didn't bet)
Seat 2: J0k3rF4c3_FD (button) folded before Flop (didn't bet)
Seat 3: Fredstar56 (small blind) folded before Flop
Seat 4: FTPbannedMe (big blind) collected ($2)
Seat 5: stan_09319 folded before Flop (didn't bet)
Seat 6: matiko09 folded before Flop (didn't bet)
Seat 7: Mister_b44 folded before Flop (didn't bet)
Seat 8: chaps1988 folded before Flop (didn't bet)
Seat 9: Spid1 folded before Flop (didn't bet)





PokerStars Hand #153065927684:  Hold'em No Limit ($0.50/$1.00 USD) - 2016/05/09 15:53:51 CET [2016/05/09 9:53:51 ET]
Table 'Reiss' 9-max Seat #6 is the button
Seat 2: mycka86 ($118.50 in chips) 
Seat 3: chaps1988 ($110.99 in chips) 
Seat 4: MichaLabam ($145.01 in chips) 
Seat 5: matiko09 ($108.63 in chips) 
Seat 6: Spid1 ($113.55 in chips) 
Seat 7: nubpoker ($100 in chips) 
Seat 8: Filojoes ($193.18 in chips) 
Seat 9: maxxmeister ($151.97 in chips) 
nubpoker: posts small blind $0.50
Filojoes: posts big blind $1
Dickyxxx: sits out 
*** HOLE CARDS ***
Dealt to matiko09 [Ah 4s]
maxxmeister: folds 
mycka86: folds 
chaps1988: folds 
maxxmeister leaves the table
MichaLabam: raises $2 to $3
matiko09: folds 
Aghmir77 joins the table at seat #9 
Spid1: folds 
nubpoker: calls $2.50
Filojoes: folds 
*** FLOP *** [6c 5h Ac]
nubpoker: checks 
MichaLabam: checks 
*** TURN *** [6c 5h Ac] [4c]
nubpoker: bets $4.43
MichaLabam: calls $4.43
*** RIVER *** [6c 5h Ac 4c] [5c]
nubpoker: bets $12.05
MichaLabam: folds 
Uncalled bet ($12.05) returned to nubpoker
nubpoker collected $15.07 from pot
nubpoker: doesn't show hand 
*** SUMMARY ***
Total pot $15.86 | Rake $0.79 
Board [6c 5h Ac 4c 5c]
Seat 2: mycka86 folded before Flop (didn't bet)
Seat 3: chaps1988 folded before Flop (didn't bet)
Seat 4: MichaLabam folded on the River
Seat 5: matiko09 folded before Flop (didn't bet)
Seat 6: Spid1 (button) folded before Flop (didn't bet)
Seat 7: nubpoker (small blind) collected ($15.07)
Seat 8: Filojoes (big blind) folded before Flop
Seat 9: maxxmeister folded before Flop (didn't bet)





PokerStars Hand #153065932050:  Hold'em No Limit ($0.50/$1.00 USD) - 2016/05/09 15:53:59 CET [2016/05/09 9:53:59 ET]
Table 'Mentha' 9-max Seat #9 is the button
Seat 2: guoweiAA ($212.23 in chips) 
Seat 3: r4mz3s ($105.66 in chips) 
Seat 4: duggy2016 ($64.82 in chips) 
Seat 5: mycka86 ($115.69 in chips) 
Seat 6: Filojoes ($173.09 in chips) 
Seat 7: matiko09 ($114.85 in chips) 
Seat 8: Lycaon23 ($59.74 in chips) 
Seat 9: Dickyxxx ($101.50 in chips) 
guoweiAA: posts small blind $0.50
r4mz3s: posts big blind $1
*** HOLE CARDS ***
Dealt to matiko09 [6d 4h]
duggy2016: folds 
mycka86: folds 
Filojoes: folds 
matiko09: folds 
Lycaon23: raises $2 to $3
Dickyxxx: folds 
guoweiAA: folds 
r4mz3s: folds 
Uncalled bet ($2) returned to Lycaon23
Lycaon23 collected $2.50 from pot
Lycaon23: doesn't show hand 
*** SUMMARY ***
Total pot $2.50 | Rake $0 
Seat 2: guoweiAA (small blind) folded before Flop
Seat 3: r4mz3s (big blind) folded before Flop
Seat 4: duggy2016 folded before Flop (didn't bet)
Seat 5: mycka86 folded before Flop (didn't bet)
Seat 6: Filojoes folded before Flop (didn't bet)
Seat 7: matiko09 folded before Flop (didn't bet)
Seat 8: Lycaon23 collected ($2.50)
Seat 9: Dickyxxx (button) folded before Flop (didn't bet)





PokerStars Hand #153065938703:  Hold'em No Limit ($1/$2 USD) - 2016/05/09 15:54:11 CET [2016/05/09 9:54:11 ET]
Table 'Celaeno II' 9-max Seat #3 is the button
Seat 1: Li Shaobo ($279.40 in chips) 
Seat 2: J0k3rF4c3_FD ($226.68 in chips) 
Seat 3: Fredstar56 ($114.86 in chips) 
Seat 4: FTPbannedMe ($233.22 in chips) 
Seat 5: stan_09319 ($235.92 in chips) 
Seat 6: matiko09 ($295.25 in chips) 
Seat 7: Mister_b44 ($92.07 in chips) 
Seat 8: chaps1988 ($241.77 in chips) 
Seat 9: Spid1 ($200 in chips) 
FTPbannedMe: posts small blind $1
stan_09319: posts big blind $2
*** HOLE CARDS ***
Dealt to matiko09 [6h 8h]
matiko09: folds 
Mister_b44: folds 
chaps1988: folds 
Spid1: folds 
Li Shaobo: raises $2 to $4
J0k3rF4c3_FD: folds 
Fredstar56: calls $4
FTPbannedMe: folds 
stan_09319: folds 
*** FLOP *** [3s Jc 4s]
Li Shaobo: checks 
Fredstar56: bets $5.22
Li Shaobo: folds 
Uncalled bet ($5.22) returned to Fredstar56
Fredstar56 collected $10.45 from pot
*** SUMMARY ***
Total pot $11 | Rake $0.55 
Board [3s Jc 4s]
Seat 1: Li Shaobo folded on the Flop
Seat 2: J0k3rF4c3_FD folded before Flop (didn't bet)
Seat 3: Fredstar56 (button) collected ($10.45)
Seat 4: FTPbannedMe (small blind) folded before Flop
Seat 5: stan_09319 (big blind) folded before Flop
Seat 6: matiko09 folded before Flop (didn't bet)
Seat 7: Mister_b44 folded before Flop (didn't bet)
Seat 8: chaps1988 folded before Flop (didn't bet)
Seat 9: Spid1 folded before Flop (didn't bet)





PokerStars Hand #153065940201:  Hold'em No Limit ($1/$2 USD) - 2016/05/09 15:54:14 CET [2016/05/09 9:54:14 ET]
Table 'Luda' 9-max Seat #9 is the button
Seat 1: stan_09319 ($423.99 in chips) 
Seat 2: matiko09 ($200 in chips) 
Seat 3: Monsthand ($200 in chips) 
Seat 4: Igoriah ($264.80 in chips) 
Seat 5: J0k3rF4c3_FD ($266.25 in chips) 
Seat 6: Iggso ($200 in chips) 
Seat 7: chaps1988 ($229.25 in chips) 
Seat 8: ramseyg117 ($276.53 in chips) 
Seat 9: solano20000 ($167.54 in chips) 
stan_09319: posts small blind $1
matiko09: posts big blind $2
*** HOLE CARDS ***
Dealt to matiko09 [3c 9h]
Monsthand: folds 
ramseyg117 said, "ye lag big time"
ramseyg117 said, "where in aus r u?"
Igoriah has timed out
Igoriah: folds 
J0k3rF4c3_FD: raises $3 to $5
Iggso: folds 
chaps1988: folds 
ramseyg117: folds 
solano20000: folds 
stan_09319: folds 
matiko09: folds 
Uncalled bet ($3) returned to J0k3rF4c3_FD
J0k3rF4c3_FD collected $5 from pot
J0k3rF4c3_FD: doesn't show hand 
*** SUMMARY ***
Total pot $5 | Rake $0 
Seat 1: stan_09319 (small blind) folded before Flop
Seat 2: matiko09 (big blind) folded before Flop
Seat 3: Monsthand folded before Flop (didn't bet)
Seat 4: Igoriah folded before Flop (didn't bet)
Seat 5: J0k3rF4c3_FD collected ($5)
Seat 6: Iggso folded before Flop (didn't bet)
Seat 7: chaps1988 folded before Flop (didn't bet)
Seat 8: ramseyg117 folded before Flop (didn't bet)
Seat 9: solano20000 (button) folded before Flop (didn't bet)





PokerStars Hand #153065946395:  Hold'em No Limit ($0.50/$1.00 USD) - 2016/05/09 15:54:25 CET [2016/05/09 9:54:25 ET]
Table 'Mentha' 9-max Seat #2 is the button
Seat 2: guoweiAA ($211.73 in chips) 
Seat 3: r4mz3s ($104.66 in chips) 
Seat 4: duggy2016 ($64.82 in chips) 
Seat 5: mycka86 ($115.69 in chips) 
Seat 6: Filojoes ($173.09 in chips) 
Seat 7: matiko09 ($114.85 in chips) 
Seat 8: Lycaon23 ($100 in chips) 
Seat 9: Dickyxxx ($101.50 in chips) 
r4mz3s: posts small blind $0.50
duggy2016: posts big blind $1
*** HOLE CARDS ***
Dealt to matiko09 [Ah 5c]
mycka86: folds 
Filojoes: folds 
matiko09: folds 
Lycaon23: raises $2 to $3
Dickyxxx: folds 
guoweiAA: calls $3
r4mz3s: folds 
duggy2016: folds 
*** FLOP *** [4c 7c 8d]
Lycaon23: bets $4
guoweiAA: calls $4
*** TURN *** [4c 7c 8d] [As]
Lycaon23: checks 
guoweiAA: bets $7.36
Lycaon23: folds 
Uncalled bet ($7.36) returned to guoweiAA
guoweiAA collected $14.72 from pot
guoweiAA: doesn't show hand 
*** SUMMARY ***
Total pot $15.50 | Rake $0.78 
Board [4c 7c 8d As]
Seat 2: guoweiAA (button) collected ($14.72)
Seat 3: r4mz3s (small blind) folded before Flop
Seat 4: duggy2016 (big blind) folded before Flop
Seat 5: mycka86 folded before Flop (didn't bet)
Seat 6: Filojoes folded before Flop (didn't bet)
Seat 7: matiko09 folded before Flop (didn't bet)
Seat 8: Lycaon23 folded on the Turn
Seat 9: Dickyxxx folded before Flop (didn't bet)





PokerStars Hand #153065947864:  Hold'em No Limit ($0.50/$1.00 USD) - 2016/05/09 15:54:28 CET [2016/05/09 9:54:28 ET]
Table 'Merga II' 9-max Seat #8 is the button
Seat 1: luckyluke24 ($25.58 in chips) 
Seat 2: Filojoes ($103.18 in chips) 
Seat 3: xhinostrabli ($39.51 in chips) 
Seat 4: nubpoker ($103.12 in chips) 
Seat 5: LRVAV7 ($260.45 in chips) 
Seat 6: Spid1 ($159.03 in chips) 
Seat 7: matiko09 ($151.79 in chips) 
Seat 8: GrandOldFart ($112.02 in chips) 
Seat 9: chaps1988 ($217.61 in chips) 
chaps1988: posts small blind $0.50
luckyluke24: posts big blind $1
*** HOLE CARDS ***
Dealt to matiko09 [3h 4d]
Filojoes: raises $2 to $3
xhinostrabli: folds 
nubpoker: folds 
LRVAV7: calls $3
Spid1: folds 
matiko09: folds 
GrandOldFart: raises $12 to $15
chaps1988: folds 
luckyluke24: folds 
Filojoes: folds 
LRVAV7: calls $12
*** FLOP *** [3s 5d Ks]
LRVAV7: checks 
GrandOldFart: bets $20
LRVAV7: folds 
Uncalled bet ($20) returned to GrandOldFart
GrandOldFart collected $32.78 from pot
*** SUMMARY ***
Total pot $34.50 | Rake $1.72 
Board [3s 5d Ks]
Seat 1: luckyluke24 (big blind) folded before Flop
Seat 2: Filojoes folded before Flop
Seat 3: xhinostrabli folded before Flop (didn't bet)
Seat 4: nubpoker folded before Flop (didn't bet)
Seat 5: LRVAV7 folded on the Flop
Seat 6: Spid1 folded before Flop (didn't bet)
Seat 7: matiko09 folded before Flop (didn't bet)
Seat 8: GrandOldFart (button) collected ($32.78)
Seat 9: chaps1988 (small blind) folded before Flop





PokerStars Hand #153065952601:  Hold'em No Limit ($0.50/$1.00 USD) - 2016/05/09 15:54:36 CET [2016/05/09 9:54:36 ET]
Table 'Terpsichore' 9-max Seat #9 is the button
Seat 1: 7hiro ($209.34 in chips) 
Seat 2: J0k3rF4c3_FD ($185.66 in chips) 
Seat 3: matiko09 ($105.37 in chips) 
Seat 4: maxxmeister ($113.64 in chips) 
Seat 5: mycka86 ($103.77 in chips) 
Seat 6: Filojoes ($116.59 in chips) 
Seat 7: xhinostrabli ($100.07 in chips) 
Seat 9: FTPbannedMe ($100 in chips) 
7hiro: posts small blind $0.50
J0k3rF4c3_FD: posts big blind $1
*** HOLE CARDS ***
Dealt to matiko09 [Qh Th]
matiko09: raises $2 to $3
maxxmeister: folds 
mycka86: folds 
Filojoes: folds 
xhinostrabli: folds 
FTPbannedMe: folds 
7hiro: folds 
J0k3rF4c3_FD: folds 
Uncalled bet ($2) returned to matiko09
matiko09 collected $2.50 from pot
matiko09: doesn't show hand 
*** SUMMARY ***
Total pot $2.50 | Rake $0 
Seat 1: 7hiro (small blind) folded before Flop
Seat 2: J0k3rF4c3_FD (big blind) folded before Flop
Seat 3: matiko09 collected ($2.50)
Seat 4: maxxmeister folded before Flop (didn't bet)
Seat 5: mycka86 folded before Flop (didn't bet)
Seat 6: Filojoes folded before Flop (didn't bet)
Seat 7: xhinostrabli folded before Flop (didn't bet)
Seat 9: FTPbannedMe (button) folded before Flop (didn't bet)





PokerStars Hand #153065954474:  Hold'em No Limit ($1/$2 USD) - 2016/05/09 15:54:40 CET [2016/05/09 9:54:40 ET]
Table 'Hagar II' 9-max Seat #6 is the button
Seat 1: azzad2007 ($261.62 in chips) 
Seat 2: billynomates ($91.06 in chips) 
Seat 3: stan_09319 ($200 in chips) 
Seat 4: matiko09 ($200 in chips) 
Seat 5: darren1031 ($283.65 in chips) 
Seat 6: Piniker85 ($609.42 in chips) 
Seat 7: Monsthand ($200 in chips) 
Seat 8: J0k3rF4c3_FD ($323.80 in chips) 
Seat 9: chaps1988 ($200 in chips) 
Monsthand: posts small blind $1
J0k3rF4c3_FD: posts big blind $2
*** HOLE CARDS ***
Dealt to matiko09 [Ts 7s]
chaps1988: folds 
azzad2007: folds 
billynomates: calls $2
stan_09319: folds 
matiko09: folds 
darren1031: folds 
Piniker85: folds 
Monsthand: folds 
J0k3rF4c3_FD: checks 
*** FLOP *** [6s 9c Kc]
J0k3rF4c3_FD: checks 
billynomates: checks 
*** TURN *** [6s 9c Kc] [7c]
J0k3rF4c3_FD: bets $6.65
billynomates: folds 
Uncalled bet ($6.65) returned to J0k3rF4c3_FD
J0k3rF4c3_FD collected $4.75 from pot
J0k3rF4c3_FD: doesn't show hand 
*** SUMMARY ***
Total pot $5 | Rake $0.25 
Board [6s 9c Kc 7c]
Seat 1: azzad2007 folded before Flop (didn't bet)
Seat 2: billynomates folded on the Turn
Seat 3: stan_09319 folded before Flop (didn't bet)
Seat 4: matiko09 folded before Flop (didn't bet)
Seat 5: darren1031 folded before Flop (didn't bet)
Seat 6: Piniker85 (button) folded before Flop (didn't bet)
Seat 7: Monsthand (small blind) folded before Flop
Seat 8: J0k3rF4c3_FD (big blind) collected ($4.75)
Seat 9: chaps1988 folded before Flop (didn't bet)





PokerStars Hand #153065955904:  Hold'em No Limit ($1/$2 USD) - 2016/05/09 15:54:42 CET [2016/05/09 9:54:42 ET]
Table 'Celaeno II' 9-max Seat #4 is the button
Seat 1: Li Shaobo ($275.40 in chips) 
Seat 2: J0k3rF4c3_FD ($226.68 in chips) 
Seat 3: Fredstar56 ($121.31 in chips) 
Seat 4: FTPbannedMe ($232.22 in chips) 
Seat 5: stan_09319 ($233.92 in chips) 
Seat 6: matiko09 ($295.25 in chips) 
Seat 7: Mister_b44 ($92.07 in chips) 
Seat 8: chaps1988 ($241.77 in chips) 
Seat 9: Spid1 ($200 in chips) 
stan_09319: posts small blind $1
matiko09: posts big blind $2
*** HOLE CARDS ***
Dealt to matiko09 [Kh Qd]
Mister_b44: folds 
chaps1988: folds 
Spid1: folds 
Li Shaobo: folds 
J0k3rF4c3_FD: folds 
Fredstar56: folds 
FTPbannedMe: raises $2 to $4
stan_09319: raises $12 to $16
matiko09: folds 
FTPbannedMe: calls $12
*** FLOP *** [4c 2c 2s]
stan_09319: bets $17.11
FTPbannedMe: calls $17.11
*** TURN *** [4c 2c 2s] [9h]
stan_09319: checks 
FTPbannedMe: checks 
*** RIVER *** [4c 2c 2s 9h] [Qh]
stan_09319: bets $45.82
FTPbannedMe: calls $45.82
*** SHOW DOWN ***
stan_09319: shows [Ts As] (a pair of Deuces)
FTPbannedMe: shows [Ah 4h] (two pair, Fours and Deuces)
FTPbannedMe collected $157.11 from pot
*** SUMMARY ***
Total pot $159.86 | Rake $2.75 
Board [4c 2c 2s 9h Qh]
Seat 1: Li Shaobo folded before Flop (didn't bet)
Seat 2: J0k3rF4c3_FD folded before Flop (didn't bet)
Seat 3: Fredstar56 folded before Flop (didn't bet)
Seat 4: FTPbannedMe (button) showed [Ah 4h] and won ($157.11) with two pair, Fours and Deuces
Seat 5: stan_09319 (small blind) showed [Ts As] and lost with a pair of Deuces
Seat 6: matiko09 (big blind) folded before Flop
Seat 7: Mister_b44 folded before Flop (didn't bet)
Seat 8: chaps1988 folded before Flop (didn't bet)
Seat 9: Spid1 folded before Flop (didn't bet)





PokerStars Hand #153065961668:  Hold'em No Limit ($1/$2 USD) - 2016/05/09 15:54:53 CET [2016/05/09 9:54:53 ET]
Table 'Luda' 9-max Seat #1 is the button
Seat 1: stan_09319 ($422.99 in chips) 
Seat 2: matiko09 ($200 in chips) 
Seat 3: Monsthand ($200 in chips) 
Seat 4: Igoriah ($264.80 in chips) 
Seat 5: J0k3rF4c3_FD ($269.25 in chips) 
Seat 6: Iggso ($200 in chips) 
Seat 7: chaps1988 ($229.25 in chips) 
Seat 8: ramseyg117 ($276.53 in chips) 
Seat 9: solano20000 ($167.54 in chips) 
matiko09: posts small blind $1
Monsthand: posts big blind $2
*** HOLE CARDS ***
Dealt to matiko09 [Qh 6c]
Igoriah: folds 
J0k3rF4c3_FD: folds 
Iggso: folds 
chaps1988 has timed out
chaps1988: folds 
ramseyg117: folds 
solano20000: raises $6 to $8
stan_09319: folds 
matiko09: folds 
Monsthand: folds 
Uncalled bet ($6) returned to solano20000
solano20000 collected $5 from pot
*** SUMMARY ***
Total pot $5 | Rake $0 
Seat 1: stan_09319 (button) folded before Flop (didn't bet)
Seat 2: matiko09 (small blind) folded before Flop
Seat 3: Monsthand (big blind) folded before Flop
Seat 4: Igoriah folded before Flop (didn't bet)
Seat 5: J0k3rF4c3_FD folded before Flop (didn't bet)
Seat 6: Iggso folded before Flop (didn't bet)
Seat 7: chaps1988 folded before Flop (didn't bet)
Seat 8: ramseyg117 folded before Flop (didn't bet)
Seat 9: solano20000 collected ($5)





PokerStars Hand #153065966825:  Hold'em No Limit ($0.50/$1.00 USD) - 2016/05/09 15:55:02 CET [2016/05/09 9:55:02 ET]
Table 'Terpsichore' 9-max Seat #1 is the button
Seat 1: 7hiro ($208.84 in chips) 
Seat 2: J0k3rF4c3_FD ($184.66 in chips) 
Seat 3: matiko09 ($106.87 in chips) 
Seat 4: maxxmeister ($113.64 in chips) 
Seat 5: mycka86 ($103.77 in chips) 
Seat 6: Filojoes ($116.59 in chips) 
Seat 7: xhinostrabli ($100.07 in chips) 
Seat 9: FTPbannedMe ($100 in chips) 
J0k3rF4c3_FD: posts small blind $0.50
matiko09: posts big blind $1
*** HOLE CARDS ***
Dealt to matiko09 [5h Kc]
maxxmeister: folds 
mycka86: folds 
Filojoes: folds 
xhinostrabli: folds 
FTPbannedMe: folds 
7hiro: folds 
J0k3rF4c3_FD: folds 
Uncalled bet ($0.50) returned to matiko09
matiko09 collected $1 from pot
matiko09: doesn't show hand 
*** SUMMARY ***
Total pot $1 | Rake $0 
Seat 1: 7hiro (button) folded before Flop (didn't bet)
Seat 2: J0k3rF4c3_FD (small blind) folded before Flop
Seat 3: matiko09 (big blind) collected ($1)
Seat 4: maxxmeister folded before Flop (didn't bet)
Seat 5: mycka86 folded before Flop (didn't bet)
Seat 6: Filojoes folded before Flop (didn't bet)
Seat 7: xhinostrabli folded before Flop (didn't bet)
Seat 9: FTPbannedMe folded before Flop (didn't bet)





PokerStars Hand #153065973174:  Hold'em No Limit ($0.50/$1.00 USD) - 2016/05/09 15:55:15 CET [2016/05/09 9:55:15 ET]
Table 'Mentha' 9-max Seat #3 is the button
Seat 2: guoweiAA ($219.45 in chips) 
Seat 3: r4mz3s ($104.16 in chips) 
Seat 4: duggy2016 ($63.82 in chips) 
Seat 5: mycka86 ($115.69 in chips) 
Seat 6: Filojoes ($173.09 in chips) 
Seat 7: matiko09 ($114.85 in chips) 
Seat 8: Lycaon23 ($93 in chips) 
Seat 9: Dickyxxx ($101.50 in chips) 
duggy2016: posts small blind $0.50
mycka86: posts big blind $1
*** HOLE CARDS ***
Dealt to matiko09 [8h Kd]
Filojoes: folds 
matiko09: folds 
Lycaon23: raises $2 to $3
Dickyxxx: folds 
guoweiAA: folds 
r4mz3s: folds 
duggy2016: folds 
mycka86: folds 
Uncalled bet ($2) returned to Lycaon23
Lycaon23 collected $2.50 from pot
Lycaon23: doesn't show hand 
*** SUMMARY ***
Total pot $2.50 | Rake $0 
Seat 2: guoweiAA folded before Flop (didn't bet)
Seat 3: r4mz3s (button) folded before Flop (didn't bet)
Seat 4: duggy2016 (small blind) folded before Flop
Seat 5: mycka86 (big blind) folded before Flop
Seat 6: Filojoes folded before Flop (didn't bet)
Seat 7: matiko09 folded before Flop (didn't bet)
Seat 8: Lycaon23 collected ($2.50)
Seat 9: Dickyxxx folded before Flop (didn't bet)





PokerStars Hand #153065974307:  Hold'em No Limit ($1/$2 USD) - 2016/05/09 15:55:17 CET [2016/05/09 9:55:17 ET]
Table 'Hagar II' 9-max Seat #7 is the button
Seat 1: azzad2007 ($261.62 in chips) 
Seat 2: billynomates ($89.06 in chips) 
Seat 3: stan_09319 ($200 in chips) 
Seat 4: matiko09 ($200 in chips) 
Seat 5: darren1031 ($283.65 in chips) 
Seat 6: Piniker85 ($609.42 in chips) 
Seat 7: Monsthand ($200 in chips) 
Seat 8: J0k3rF4c3_FD ($326.55 in chips) 
Seat 9: chaps1988 ($200 in chips) 
J0k3rF4c3_FD: posts small blind $1
chaps1988: posts big blind $2
*** HOLE CARDS ***
Dealt to matiko09 [Ac As]
azzad2007: folds 
billynomates: folds 
stan_09319: raises $2.70 to $4.70
matiko09: calls $4.70
darren1031: calls $4.70
Piniker85: folds 
Monsthand: folds 
J0k3rF4c3_FD: folds 
chaps1988: folds 
*** FLOP *** [6h Jc Kc]
stan_09319: checks 
matiko09: bets $11
darren1031: calls $11
stan_09319: folds 
*** TURN *** [6h Jc Kc] [8d]
matiko09: bets $26.50
darren1031: calls $26.50
*** RIVER *** [6h Jc Kc 8d] [Td]
matiko09: checks 
darren1031: checks 
*** SHOW DOWN ***
matiko09: shows [Ac As] (a pair of Aces)
darren1031: mucks hand 
matiko09 collected $89.35 from pot
*** SUMMARY ***
Total pot $92.10 | Rake $2.75 
Board [6h Jc Kc 8d Td]
Seat 1: azzad2007 folded before Flop (didn't bet)
Seat 2: billynomates folded before Flop (didn't bet)
Seat 3: stan_09319 folded on the Flop
Seat 4: matiko09 showed [Ac As] and won ($89.35) with a pair of Aces
Seat 5: darren1031 mucked [9d Kd]
Seat 6: Piniker85 folded before Flop (didn't bet)
Seat 7: Monsthand (button) folded before Flop (didn't bet)
Seat 8: J0k3rF4c3_FD (small blind) folded before Flop
Seat 9: chaps1988 (big blind) folded before Flop





PokerStars Hand #153065974413:  Hold'em No Limit ($0.50/$1.00 USD) - 2016/05/09 15:55:18 CET [2016/05/09 9:55:18 ET]
Table 'Reiss' 9-max Seat #7 is the button
Seat 2: mycka86 ($118.50 in chips) 
Seat 3: chaps1988 ($110.99 in chips) 
Seat 4: MichaLabam ($137.58 in chips) 
Seat 5: matiko09 ($108.63 in chips) 
Seat 6: Spid1 ($113.55 in chips) 
Seat 7: nubpoker ($107.64 in chips) 
Seat 8: Filojoes ($192.18 in chips) 
Seat 9: Aghmir77 ($100 in chips) 
Filojoes: posts small blind $0.50
Aghmir77: posts big blind $1
Dickyxxx: sits out 
*** HOLE CARDS ***
Dealt to matiko09 [Js Kh]
mycka86: folds 
chaps1988: folds 
MichaLabam: folds 
matiko09: raises $2 to $3
Spid1: folds 
nubpoker: folds 
Filojoes: folds 
Aghmir77: calls $2
*** FLOP *** [Jc As 4s]
Aghmir77: bets $3.09
matiko09: calls $3.09
*** TURN *** [Jc As 4s] [Qh]
Aghmir77: checks 
matiko09: checks 
*** RIVER *** [Jc As 4s Qh] [7c]
Aghmir77: checks 
matiko09: checks 
*** SHOW DOWN ***
Aghmir77: shows [7h Ah] (two pair, Aces and Sevens)
matiko09: mucks hand 
Aghmir77 collected $12.05 from pot
*** SUMMARY ***
Total pot $12.68 | Rake $0.63 
Board [Jc As 4s Qh 7c]
Seat 2: mycka86 folded before Flop (didn't bet)
Seat 3: chaps1988 folded before Flop (didn't bet)
Seat 4: MichaLabam folded before Flop (didn't bet)
Seat 5: matiko09 mucked [Js Kh]
Seat 6: Spid1 folded before Flop (didn't bet)
Seat 7: nubpoker (button) folded before Flop (didn't bet)
Seat 8: Filojoes (small blind) folded before Flop
Seat 9: Aghmir77 (big blind) showed [7h Ah] and won ($12.05) with two pair, Aces and Sevens





PokerStars Hand #153065975034:  Hold'em No Limit ($0.50/$1.00 USD) - 2016/05/09 15:55:19 CET [2016/05/09 9:55:19 ET]
Table 'Terpsichore' 9-max Seat #2 is the button
Seat 1: 7hiro ($208.84 in chips) 
Seat 2: J0k3rF4c3_FD ($184.16 in chips) 
Seat 3: matiko09 ($107.37 in chips) 
Seat 5: mycka86 ($103.77 in chips) 
Seat 6: Filojoes ($116.59 in chips) 
Seat 7: xhinostrabli ($100.07 in chips) 
Seat 9: FTPbannedMe ($100 in chips) 
matiko09: posts small blind $0.50
mycka86: posts big blind $1
*** HOLE CARDS ***
Dealt to matiko09 [Tc 6d]
Filojoes: folds 
xhinostrabli: folds 
FTPbannedMe: raises $1.50 to $2.50
7hiro: folds 
J0k3rF4c3_FD: folds 
matiko09: folds 
mycka86: folds 
Uncalled bet ($1.50) returned to FTPbannedMe
FTPbannedMe collected $2.50 from pot
FTPbannedMe: doesn't show hand 
*** SUMMARY ***
Total pot $2.50 | Rake $0 
Seat 1: 7hiro folded before Flop (didn't bet)
Seat 2: J0k3rF4c3_FD (button) folded before Flop (didn't bet)
Seat 3: matiko09 (small blind) folded before Flop
Seat 5: mycka86 (big blind) folded before Flop
Seat 6: Filojoes folded before Flop (didn't bet)
Seat 7: xhinostrabli folded before Flop (didn't bet)
Seat 9: FTPbannedMe collected ($2.50)





PokerStars Hand #153065978178:  Hold'em No Limit ($0.50/$1.00 USD) - 2016/05/09 15:55:26 CET [2016/05/09 9:55:26 ET]
Table 'Merga II' 9-max Seat #9 is the button
Seat 1: luckyluke24 ($24.58 in chips) 
Seat 2: Filojoes ($100.18 in chips) 
Seat 3: xhinostrabli ($39.51 in chips) 
Seat 4: nubpoker ($103.12 in chips) 
Seat 5: LRVAV7 ($245.45 in chips) 
Seat 6: Spid1 ($159.03 in chips) 
Seat 7: matiko09 ($151.79 in chips) 
Seat 8: GrandOldFart ($129.80 in chips) 
Seat 9: chaps1988 ($217.11 in chips) 
luckyluke24: posts small blind $0.50
Filojoes: posts big blind $1
*** HOLE CARDS ***
Dealt to matiko09 [Ts 8h]
xhinostrabli: folds 
nubpoker: folds 
LRVAV7: folds 
Spid1: folds 
matiko09: folds 
GrandOldFart: folds 
chaps1988: folds 
luckyluke24: folds 
Uncalled bet ($0.50) returned to Filojoes
Filojoes collected $1 from pot
Filojoes: doesn't show hand 
*** SUMMARY ***
Total pot $1 | Rake $0 
Seat 1: luckyluke24 (small blind) folded before Flop
Seat 2: Filojoes (big blind) collected ($1)
Seat 3: xhinostrabli folded before Flop (didn't bet)
Seat 4: nubpoker folded before Flop (didn't bet)
Seat 5: LRVAV7 folded before Flop (didn't bet)
Seat 6: Spid1 folded before Flop (didn't bet)
Seat 7: matiko09 folded before Flop (didn't bet)
Seat 8: GrandOldFart folded before Flop (didn't bet)
Seat 9: chaps1988 (button) folded before Flop (didn't bet)





PokerStars Hand #153065982791:  Hold'em No Limit ($0.50/$1.00 USD) - 2016/05/09 15:55:36 CET [2016/05/09 9:55:36 ET]
Table 'Mentha' 9-max Seat #4 is the button
Seat 2: guoweiAA ($219.45 in chips) 
Seat 3: r4mz3s ($104.16 in chips) 
Seat 4: duggy2016 ($63.32 in chips) 
Seat 5: mycka86 ($114.69 in chips) 
Seat 6: Filojoes ($173.09 in chips) 
Seat 7: matiko09 ($114.85 in chips) 
Seat 8: Lycaon23 ($94.50 in chips) 
Seat 9: Dickyxxx ($101.50 in chips) 
mycka86: posts small blind $0.50
Filojoes: posts big blind $1
*** HOLE CARDS ***
Dealt to matiko09 [7c 2s]
matiko09: folds 
Lycaon23: folds 
Lycaon23 leaves the table
Dickyxxx: folds 
guoweiAA: folds 
r4mz3s: folds 
nubpoker joins the table at seat #8 
nubpoker leaves the table
duggy2016: raises $2 to $3
mycka86: folds 
Filojoes: raises $6 to $9
duggy2016: calls $6
*** FLOP *** [5s 8s 7s]
Filojoes: checks 
duggy2016: checks 
*** TURN *** [5s 8s 7s] [Tc]
Filojoes: checks 
duggy2016: checks 
*** RIVER *** [5s 8s 7s Tc] [Jh]
Filojoes: bets $10.55
duggy2016: raises $14.45 to $25
Filojoes: folds 
Uncalled bet ($14.45) returned to duggy2016
duggy2016 collected $37.62 from pot
duggy2016: doesn't show hand 
ipashutapkom joins the table at seat #8 
*** SUMMARY ***
Total pot $39.60 | Rake $1.98 
Board [5s 8s 7s Tc Jh]
Seat 2: guoweiAA folded before Flop (didn't bet)
Seat 3: r4mz3s folded before Flop (didn't bet)
Seat 4: duggy2016 (button) collected ($37.62)
Seat 5: mycka86 (small blind) folded before Flop
Seat 6: Filojoes (big blind) folded on the River
Seat 7: matiko09 folded before Flop (didn't bet)
Seat 8: Lycaon23 folded before Flop (didn't bet)
Seat 9: Dickyxxx folded before Flop (didn't bet)





PokerStars Hand #153065983738:  Hold'em No Limit ($0.50/$1.00 USD) - 2016/05/09 15:55:38 CET [2016/05/09 9:55:38 ET]
Table 'Terpsichore' 9-max Seat #3 is the button
Seat 1: 7hiro ($208.84 in chips) 
Seat 2: J0k3rF4c3_FD ($184.16 in chips) 
Seat 3: matiko09 ($106.87 in chips) 
Seat 5: mycka86 ($102.77 in chips) 
Seat 6: Filojoes ($116.59 in chips) 
Seat 7: xhinostrabli ($100.07 in chips) 
Seat 9: FTPbannedMe ($101.50 in chips) 
mycka86: posts small blind $0.50
Filojoes: posts big blind $1
*** HOLE CARDS ***
Dealt to matiko09 [4c Ad]
xhinostrabli: folds 
FTPbannedMe: raises $1.50 to $2.50
7hiro: folds 
J0k3rF4c3_FD: folds 
matiko09: folds 
mycka86: raises $6.50 to $9
Filojoes: folds 
FTPbannedMe: folds 
Uncalled bet ($6.50) returned to mycka86
mycka86 collected $6 from pot
*** SUMMARY ***
Total pot $6 | Rake $0 
Seat 1: 7hiro folded before Flop (didn't bet)
Seat 2: J0k3rF4c3_FD folded before Flop (didn't bet)
Seat 3: matiko09 (button) folded before Flop (didn't bet)
Seat 5: mycka86 (small blind) collected ($6)
Seat 6: Filojoes (big blind) folded before Flop
Seat 7: xhinostrabli folded before Flop (didn't bet)
Seat 9: FTPbannedMe folded before Flop





PokerStars Hand #153065984830:  Hold'em No Limit ($1/$2 USD) - 2016/05/09 15:55:40 CET [2016/05/09 9:55:40 ET]
Table 'Luda' 9-max Seat #2 is the button
Seat 1: stan_09319 ($422.99 in chips) 
Seat 2: matiko09 ($200 in chips) 
Seat 3: Monsthand ($200 in chips) 
Seat 4: Igoriah ($264.80 in chips) 
Seat 5: J0k3rF4c3_FD ($269.25 in chips) 
Seat 6: Iggso ($200 in chips) 
Seat 7: chaps1988 ($229.25 in chips) 
Seat 8: ramseyg117 ($276.53 in chips) 
Seat 9: solano20000 ($170.54 in chips) 
Monsthand: posts small blind $1
Igoriah: posts big blind $2
*** HOLE CARDS ***
Dealt to matiko09 [6s Tc]
J0k3rF4c3_FD: folds 
Iggso: raises $4 to $6
chaps1988: folds 
ramseyg117: folds 
solano20000: folds 
stan_09319: folds 
matiko09: folds 
Monsthand: folds 
Igoriah: folds 
Uncalled bet ($4) returned to Iggso
Iggso collected $5 from pot
Iggso: doesn't show hand 
*** SUMMARY ***
Total pot $5 | Rake $0 
Seat 1: stan_09319 folded before Flop (didn't bet)
Seat 2: matiko09 (button) folded before Flop (didn't bet)
Seat 3: Monsthand (small blind) folded before Flop
Seat 4: Igoriah (big blind) folded before Flop
Seat 5: J0k3rF4c3_FD folded before Flop (didn't bet)
Seat 6: Iggso collected ($5)
Seat 7: chaps1988 folded before Flop (didn't bet)
Seat 8: ramseyg117 folded before Flop (didn't bet)
Seat 9: solano20000 folded before Flop (didn't bet)





PokerStars Hand #153065988615:  Hold'em No Limit ($0.50/$1.00 USD) - 2016/05/09 15:55:48 CET [2016/05/09 9:55:48 ET]
Table 'Merga II' 9-max Seat #1 is the button
Seat 1: luckyluke24 ($24.08 in chips) 
Seat 2: Filojoes ($100.68 in chips) 
Seat 3: xhinostrabli ($39.51 in chips) 
Seat 4: nubpoker ($103.12 in chips) 
Seat 5: LRVAV7 ($245.45 in chips) 
Seat 6: Spid1 ($159.03 in chips) 
Seat 7: matiko09 ($151.79 in chips) 
Seat 8: GrandOldFart ($129.80 in chips) 
Seat 9: chaps1988 ($217.11 in chips) 
Filojoes: posts small blind $0.50
xhinostrabli: posts big blind $1
*** HOLE CARDS ***
Dealt to matiko09 [3d Kc]
nubpoker: folds 
LRVAV7: folds 
Spid1: folds 
matiko09: folds 
GrandOldFart: folds 
chaps1988: raises $1.50 to $2.50
luckyluke24: folds 
Filojoes: folds 
xhinostrabli: calls $1.50
*** FLOP *** [3h 2h Jh]
xhinostrabli: checks 
chaps1988: bets $4
xhinostrabli: calls $4
*** TURN *** [3h 2h Jh] [Kd]
xhinostrabli: checks 
chaps1988: checks 
*** RIVER *** [3h 2h Jh Kd] [Kh]
xhinostrabli: checks 
chaps1988: checks 
*** SHOW DOWN ***
xhinostrabli: shows [Qd Jd] (two pair, Kings and Jacks)
chaps1988: shows [Qs Qc] (two pair, Kings and Queens)
chaps1988 collected $12.82 from pot
*** SUMMARY ***
Total pot $13.50 | Rake $0.68 
Board [3h 2h Jh Kd Kh]
Seat 1: luckyluke24 (button) folded before Flop (didn't bet)
Seat 2: Filojoes (small blind) folded before Flop
Seat 3: xhinostrabli (big blind) showed [Qd Jd] and lost with two pair, Kings and Jacks
Seat 4: nubpoker folded before Flop (didn't bet)
Seat 5: LRVAV7 folded before Flop (didn't bet)
Seat 6: Spid1 folded before Flop (didn't bet)
Seat 7: matiko09 folded before Flop (didn't bet)
Seat 8: GrandOldFart folded before Flop (didn't bet)
Seat 9: chaps1988 showed [Qs Qc] and won ($12.82) with two pair, Kings and Queens





PokerStars Hand #153065998327:  Hold'em No Limit ($1/$2 USD) - 2016/05/09 15:56:09 CET [2016/05/09 9:56:09 ET]
Table 'Luda' 9-max Seat #3 is the button
Seat 1: stan_09319 ($422.99 in chips) 
Seat 2: matiko09 ($200 in chips) 
Seat 3: Monsthand ($200 in chips) 
Seat 4: Igoriah ($262.80 in chips) 
Seat 5: J0k3rF4c3_FD ($269.25 in chips) 
Seat 6: Iggso ($203 in chips) 
Seat 7: chaps1988 ($229.25 in chips) 
Seat 8: ramseyg117 ($276.53 in chips) 
Seat 9: solano20000 ($170.54 in chips) 
Igoriah: posts small blind $1
J0k3rF4c3_FD: posts big blind $2
*** HOLE CARDS ***
Dealt to matiko09 [8d 4h]
Iggso: folds 
chaps1988: folds 
ramseyg117: raises $5 to $7
solano20000: folds 
stan_09319: folds 
matiko09: folds 
Monsthand: calls $7
Igoriah: folds 
J0k3rF4c3_FD: folds 
*** FLOP *** [Th 9c Ts]
ramseyg117: checks 
Monsthand: bets $10
ramseyg117: calls $10
*** TURN *** [Th 9c Ts] [Kc]
ramseyg117: checks 
Monsthand: bets $21
ramseyg117: folds 
Uncalled bet ($21) returned to Monsthand
Monsthand collected $35.15 from pot
Monsthand: doesn't show hand 
*** SUMMARY ***
Total pot $37 | Rake $1.85 
Board [Th 9c Ts Kc]
Seat 1: stan_09319 folded before Flop (didn't bet)
Seat 2: matiko09 folded before Flop (didn't bet)
Seat 3: Monsthand (button) collected ($35.15)
Seat 4: Igoriah (small blind) folded before Flop
Seat 5: J0k3rF4c3_FD (big blind) folded before Flop
Seat 6: Iggso folded before Flop (didn't bet)
Seat 7: chaps1988 folded before Flop (didn't bet)
Seat 8: ramseyg117 folded on the Turn
Seat 9: solano20000 folded before Flop (didn't bet)





PokerStars Hand #153066000556:  Hold'em No Limit ($0.50/$1.00 USD) - 2016/05/09 15:56:14 CET [2016/05/09 9:56:14 ET]
Table 'Terpsichore' 9-max Seat #5 is the button
Seat 1: 7hiro ($208.84 in chips) 
Seat 2: J0k3rF4c3_FD ($184.16 in chips) 
Seat 3: matiko09 ($106.87 in chips) 
Seat 5: mycka86 ($106.27 in chips) 
Seat 6: Filojoes ($115.59 in chips) 
Seat 7: xhinostrabli ($100.07 in chips) 
Seat 9: FTPbannedMe ($100 in chips) 
Filojoes: posts small blind $0.50
xhinostrabli: posts big blind $1
*** HOLE CARDS ***
Dealt to matiko09 [8h Qh]
FTPbannedMe: folds 
7hiro: folds 
J0k3rF4c3_FD: folds 
matiko09: folds 
mycka86: folds 
Filojoes: raises $1.50 to $2.50
7hiro leaves the table
xhinostrabli: calls $1.50
*** FLOP *** [4c 8d 7s]
ipashutapkom joins the table at seat #1 
Filojoes: checks 
xhinostrabli: checks 
*** TURN *** [4c 8d 7s] [7d]
Filojoes: checks 
xhinostrabli: checks 
*** RIVER *** [4c 8d 7s 7d] [Tc]
Filojoes: checks 
xhinostrabli: bets $3
Filojoes: calls $3
*** SHOW DOWN ***
xhinostrabli: shows [Ts Ks] (two pair, Tens and Sevens)
Filojoes: mucks hand 
xhinostrabli collected $10.45 from pot
*** SUMMARY ***
Total pot $11 | Rake $0.55 
Board [4c 8d 7s 7d Tc]
Seat 1: 7hiro folded before Flop (didn't bet)
Seat 2: J0k3rF4c3_FD folded before Flop (didn't bet)
Seat 3: matiko09 folded before Flop (didn't bet)
Seat 5: mycka86 (button) folded before Flop (didn't bet)
Seat 6: Filojoes (small blind) mucked [2d 2s]
Seat 7: xhinostrabli (big blind) showed [Ts Ks] and won ($10.45) with two pair, Tens and Sevens
Seat 9: FTPbannedMe folded before Flop (didn't bet)





PokerStars Hand #153066004530:  Hold'em No Limit ($0.50/$1.00 USD) - 2016/05/09 15:56:22 CET [2016/05/09 9:56:22 ET]
Table 'Reiss' 9-max Seat #8 is the button
Seat 1: Dickyxxx ($197.67 in chips) 
Seat 2: mycka86 ($118.50 in chips) 
Seat 3: chaps1988 ($110.99 in chips) 
Seat 4: MichaLabam ($137.58 in chips) 
Seat 5: matiko09 ($102.54 in chips) 
Seat 6: Spid1 ($113.55 in chips) 
Seat 7: nubpoker ($107.64 in chips) 
Seat 8: Filojoes ($191.68 in chips) 
Seat 9: Aghmir77 ($105.96 in chips) 
Aghmir77: posts small blind $0.50
Dickyxxx: posts big blind $1
*** HOLE CARDS ***
Dealt to matiko09 [8h 2h]
mycka86: folds 
chaps1988: folds 
MichaLabam: folds 
matiko09: folds 
Spid1: raises $2 to $3
nubpoker: folds 
Filojoes: folds 
Aghmir77: folds 
Dickyxxx: calls $2
*** FLOP *** [8s 6h Kc]
Dickyxxx: checks 
Spid1: bets $3
Dickyxxx: calls $3
*** TURN *** [8s 6h Kc] [8d]
Dickyxxx: checks 
Spid1: bets $8
Dickyxxx: folds 
Uncalled bet ($8) returned to Spid1
Spid1 collected $11.88 from pot
Spid1: doesn't show hand 
*** SUMMARY ***
Total pot $12.50 | Rake $0.62 
Board [8s 6h Kc 8d]
Seat 1: Dickyxxx (big blind) folded on the Turn
Seat 2: mycka86 folded before Flop (didn't bet)
Seat 3: chaps1988 folded before Flop (didn't bet)
Seat 4: MichaLabam folded before Flop (didn't bet)
Seat 5: matiko09 folded before Flop (didn't bet)
Seat 6: Spid1 collected ($11.88)
Seat 7: nubpoker folded before Flop (didn't bet)
Seat 8: Filojoes (button) folded before Flop (didn't bet)
Seat 9: Aghmir77 (small blind) folded before Flop





PokerStars Hand #153066014919:  Hold'em No Limit ($1/$2 USD) - 2016/05/09 15:56:45 CET [2016/05/09 9:56:45 ET]
Table 'Hagar II' 9-max Seat #8 is the button
Seat 1: azzad2007 ($261.62 in chips) 
Seat 2: billynomates ($89.06 in chips) 
Seat 3: stan_09319 ($200 in chips) 
Seat 4: matiko09 ($247.15 in chips) 
Seat 5: darren1031 ($241.45 in chips) 
Seat 6: Piniker85 ($609.42 in chips) 
Seat 7: Monsthand ($200 in chips) 
Seat 8: J0k3rF4c3_FD ($325.55 in chips) 
Seat 9: chaps1988 ($200 in chips) 
chaps1988: posts small blind $1
azzad2007: posts big blind $2
*** HOLE CARDS ***
Dealt to matiko09 [2d Th]
billynomates: calls $2
stan_09319: folds 
matiko09: folds 
darren1031: folds 
Piniker85: calls $2
Monsthand: raises $7 to $9
J0k3rF4c3_FD: folds 
chaps1988: folds 
azzad2007: folds 
billynomates: calls $7
Piniker85: calls $7
*** FLOP *** [3h 2s 8h]
billynomates: checks 
Piniker85: checks 
Monsthand: checks 
*** TURN *** [3h 2s 8h] [2c]
billynomates: bets $12
Piniker85: folds 
Monsthand: folds 
Uncalled bet ($12) returned to billynomates
billynomates collected $28.50 from pot
billynomates: doesn't show hand 
*** SUMMARY ***
Total pot $30 | Rake $1.50 
Board [3h 2s 8h 2c]
Seat 1: azzad2007 (big blind) folded before Flop
Seat 2: billynomates collected ($28.50)
Seat 3: stan_09319 folded before Flop (didn't bet)
Seat 4: matiko09 folded before Flop (didn't bet)
Seat 5: darren1031 folded before Flop (didn't bet)
Seat 6: Piniker85 folded on the Turn
Seat 7: Monsthand folded on the Turn
Seat 8: J0k3rF4c3_FD (button) folded before Flop (didn't bet)
Seat 9: chaps1988 (small blind) folded before Flop





PokerStars Hand #153066015883:  Hold'em No Limit ($1/$2 USD) - 2016/05/09 15:56:47 CET [2016/05/09 9:56:47 ET]
Table 'Celaeno II' 9-max Seat #5 is the button
Seat 1: Li Shaobo ($275.40 in chips) 
Seat 2: J0k3rF4c3_FD ($226.68 in chips) 
Seat 3: Fredstar56 ($121.31 in chips) 
Seat 4: FTPbannedMe ($310.40 in chips) 
Seat 5: stan_09319 ($200 in chips) 
Seat 6: matiko09 ($293.25 in chips) 
Seat 7: Mister_b44 ($92.07 in chips) 
Seat 8: chaps1988 ($241.77 in chips) 
Seat 9: Spid1 ($200 in chips) 
matiko09: posts small blind $1
Mister_b44: posts big blind $2
*** HOLE CARDS ***
Dealt to matiko09 [6d 8h]
chaps1988: folds 
Spid1: folds 
Li Shaobo: folds 
J0k3rF4c3_FD: folds 
Fredstar56: folds 
FTPbannedMe: raises $3 to $5
stan_09319: folds 
matiko09: folds 
Mister_b44: folds 
Uncalled bet ($3) returned to FTPbannedMe
FTPbannedMe collected $5 from pot
FTPbannedMe: doesn't show hand 
*** SUMMARY ***
Total pot $5 | Rake $0 
Seat 1: Li Shaobo folded before Flop (didn't bet)
Seat 2: J0k3rF4c3_FD folded before Flop (didn't bet)
Seat 3: Fredstar56 folded before Flop (didn't bet)
Seat 4: FTPbannedMe collected ($5)
Seat 5: stan_09319 (button) folded before Flop (didn't bet)
Seat 6: matiko09 (small blind) folded before Flop
Seat 7: Mister_b44 (big blind) folded before Flop
Seat 8: chaps1988 folded before Flop (didn't bet)
Seat 9: Spid1 folded before Flop (didn't bet)





PokerStars Hand #153066017493:  Hold'em No Limit ($0.50/$1.00 USD) - 2016/05/09 15:56:50 CET [2016/05/09 9:56:50 ET]
Table 'Mentha' 9-max Seat #5 is the button
Seat 2: guoweiAA ($219.45 in chips) 
Seat 3: r4mz3s ($104.16 in chips) 
Seat 4: duggy2016 ($81.39 in chips) 
Seat 5: mycka86 ($114.19 in chips) 
Seat 6: Filojoes ($153.54 in chips) 
Seat 7: matiko09 ($114.85 in chips) 
Seat 9: Dickyxxx ($101.50 in chips) 
Filojoes: posts small blind $0.50
matiko09: posts big blind $1
ipashutapkom: sits out 
*** HOLE CARDS ***
Dealt to matiko09 [Qc 9h]
Dickyxxx: folds 
guoweiAA: folds 
r4mz3s: raises $1.50 to $2.50
duggy2016: folds 
mycka86: raises $5.85 to $8.35
ipashutapkom leaves the table
Filojoes: folds 
matiko09: folds 
Chef-Zizou joins the table at seat #8 
r4mz3s: folds 
Uncalled bet ($5.85) returned to mycka86
mycka86 collected $6.50 from pot
*** SUMMARY ***
Total pot $6.50 | Rake $0 
Seat 2: guoweiAA folded before Flop (didn't bet)
Seat 3: r4mz3s folded before Flop
Seat 4: duggy2016 folded before Flop (didn't bet)
Seat 5: mycka86 (button) collected ($6.50)
Seat 6: Filojoes (small blind) folded before Flop
Seat 7: matiko09 (big blind) folded before Flop
Seat 9: Dickyxxx folded before Flop (didn't bet)





PokerStars Hand #153066025643:  Hold'em No Limit ($0.50/$1.00 USD) - 2016/05/09 15:57:07 CET [2016/05/09 9:57:07 ET]
Table 'Merga II' 9-max Seat #2 is the button
Seat 1: luckyluke24 ($24.08 in chips) 
Seat 2: Filojoes ($100.18 in chips) 
Seat 3: xhinostrabli ($33.01 in chips) 
Seat 4: nubpoker ($103.12 in chips) 
Seat 5: LRVAV7 ($245.45 in chips) 
Seat 6: Spid1 ($159.03 in chips) 
Seat 7: matiko09 ($151.79 in chips) 
Seat 8: GrandOldFart ($129.80 in chips) 
Seat 9: chaps1988 ($223.43 in chips) 
xhinostrabli: posts small blind $0.50
nubpoker: posts big blind $1
*** HOLE CARDS ***
Dealt to matiko09 [7d 5c]
LRVAV7: folds 
Spid1: folds 
matiko09: folds 
GrandOldFart: folds 
chaps1988: folds 
luckyluke24: folds 
Filojoes: raises $1 to $2
xhinostrabli: folds 
nubpoker: folds 
Uncalled bet ($1) returned to Filojoes
Filojoes collected $2.50 from pot
Filojoes: doesn't show hand 
*** SUMMARY ***
Total pot $2.50 | Rake $0 
Seat 1: luckyluke24 folded before Flop (didn't bet)
Seat 2: Filojoes (button) collected ($2.50)
Seat 3: xhinostrabli (small blind) folded before Flop
Seat 4: nubpoker (big blind) folded before Flop
Seat 5: LRVAV7 folded before Flop (didn't bet)
Seat 6: Spid1 folded before Flop (didn't bet)
Seat 7: matiko09 folded before Flop (didn't bet)
Seat 8: GrandOldFart folded before Flop (didn't bet)
Seat 9: chaps1988 folded before Flop (didn't bet)





PokerStars Hand #153066026558:  Hold'em No Limit ($0.50/$1.00 USD) - 2016/05/09 15:57:09 CET [2016/05/09 9:57:09 ET]
Table 'Terpsichore' 9-max Seat #6 is the button
Seat 2: J0k3rF4c3_FD ($184.16 in chips) 
Seat 3: matiko09 ($106.87 in chips) 
Seat 5: mycka86 ($106.27 in chips) 
Seat 6: Filojoes ($110.09 in chips) 
Seat 7: xhinostrabli ($105.02 in chips) 
Seat 9: FTPbannedMe ($100 in chips) 
xhinostrabli: posts small blind $0.50
FTPbannedMe: posts big blind $1
ipashutapkom: sits out 
*** HOLE CARDS ***
Dealt to matiko09 [Ks 4d]
J0k3rF4c3_FD: folds 
matiko09: folds 
mycka86: raises $1.10 to $2.10
Filojoes: folds 
xhinostrabli: folds 
FTPbannedMe: folds 
Uncalled bet ($1.10) returned to mycka86
mycka86 collected $2.50 from pot
*** SUMMARY ***
Total pot $2.50 | Rake $0 
Seat 2: J0k3rF4c3_FD folded before Flop (didn't bet)
Seat 3: matiko09 folded before Flop (didn't bet)
Seat 5: mycka86 collected ($2.50)
Seat 6: Filojoes (button) folded before Flop (didn't bet)
Seat 7: xhinostrabli (small blind) folded before Flop
Seat 9: FTPbannedMe (big blind) folded before Flop





PokerStars Hand #153066029786:  Hold'em No Limit ($1/$2 USD) - 2016/05/09 15:57:16 CET [2016/05/09 9:57:16 ET]
Table 'Luda' 9-max Seat #4 is the button
Seat 1: stan_09319 ($422.99 in chips) 
Seat 2: matiko09 ($200 in chips) 
Seat 3: Monsthand ($218.15 in chips) 
Seat 4: Igoriah ($261.80 in chips) 
Seat 5: J0k3rF4c3_FD ($267.25 in chips) 
Seat 6: Iggso ($203 in chips) 
Seat 7: chaps1988 ($229.25 in chips) 
Seat 8: ramseyg117 ($259.53 in chips) 
Seat 9: solano20000 ($170.54 in chips) 
J0k3rF4c3_FD: posts small blind $1
Iggso: posts big blind $2
*** HOLE CARDS ***
Dealt to matiko09 [9d 8h]
chaps1988: folds 
ramseyg117: folds 
solano20000: folds 
stan_09319: folds 
matiko09: folds 
Monsthand: raises $3 to $5
Igoriah: folds 
J0k3rF4c3_FD: raises $14 to $19
Iggso: folds 
Monsthand: calls $14
*** FLOP *** [Tc 6d Ac]
J0k3rF4c3_FD: bets $15.54
Monsthand: calls $15.54
*** TURN *** [Tc 6d Ac] [Ks]
J0k3rF4c3_FD: bets $48
Monsthand: calls $48
*** RIVER *** [Tc 6d Ac Ks] [3s]
J0k3rF4c3_FD: bets $184.71 and is all-in
Monsthand: calls $135.61 and is all-in
Uncalled bet ($49.10) returned to J0k3rF4c3_FD
*** SHOW DOWN ***
J0k3rF4c3_FD: shows [8s 8c] (a pair of Eights)
Monsthand: shows [Kc Ah] (two pair, Aces and Kings)
Monsthand collected $435.55 from pot
*** SUMMARY ***
Total pot $438.30 | Rake $2.75 
Board [Tc 6d Ac Ks 3s]
Seat 1: stan_09319 folded before Flop (didn't bet)
Seat 2: matiko09 folded before Flop (didn't bet)
Seat 3: Monsthand showed [Kc Ah] and won ($435.55) with two pair, Aces and Kings
Seat 4: Igoriah (button) folded before Flop (didn't bet)
Seat 5: J0k3rF4c3_FD (small blind) showed [8s 8c] and lost with a pair of Eights
Seat 6: Iggso (big blind) folded before Flop
Seat 7: chaps1988 folded before Flop (didn't bet)
Seat 8: ramseyg117 folded before Flop (didn't bet)
Seat 9: solano20000 folded before Flop (didn't bet)





PokerStars Hand #153066031686:  Hold'em No Limit ($1/$2 USD) - 2016/05/09 15:57:20 CET [2016/05/09 9:57:20 ET]
Table 'Celaeno II' 9-max Seat #6 is the button
Seat 1: Li Shaobo ($275.40 in chips) 
Seat 2: J0k3rF4c3_FD ($226.68 in chips) 
Seat 3: Fredstar56 ($121.31 in chips) 
Seat 4: FTPbannedMe ($313.40 in chips) 
Seat 5: stan_09319 ($200 in chips) 
Seat 6: matiko09 ($292.25 in chips) 
Seat 7: Mister_b44 ($90.07 in chips) 
Seat 8: chaps1988 ($241.77 in chips) 
Seat 9: Spid1 ($200 in chips) 
Mister_b44: posts small blind $1
chaps1988: posts big blind $2
*** HOLE CARDS ***
Dealt to matiko09 [2h Kh]
Spid1: folds 
Li Shaobo: raises $4 to $6
J0k3rF4c3_FD: folds 
Fredstar56: folds 
FTPbannedMe: folds 
stan_09319: folds 
matiko09: folds 
Mister_b44: folds 
chaps1988: calls $4
*** FLOP *** [2d 6s 5c]
chaps1988: checks 
Li Shaobo: bets $10
chaps1988: calls $10
*** TURN *** [2d 6s 5c] [Ac]
chaps1988: checks 
Li Shaobo: checks 
*** RIVER *** [2d 6s 5c Ac] [6c]
chaps1988: checks 
Li Shaobo: checks 
*** SHOW DOWN ***
chaps1988: shows [7c 7h] (two pair, Sevens and Sixes)
Li Shaobo: shows [Jc Jd] (two pair, Jacks and Sixes)
Li Shaobo collected $31.35 from pot
*** SUMMARY ***
Total pot $33 | Rake $1.65 
Board [2d 6s 5c Ac 6c]
Seat 1: Li Shaobo showed [Jc Jd] and won ($31.35) with two pair, Jacks and Sixes
Seat 2: J0k3rF4c3_FD folded before Flop (didn't bet)
Seat 3: Fredstar56 folded before Flop (didn't bet)
Seat 4: FTPbannedMe folded before Flop (didn't bet)
Seat 5: stan_09319 folded before Flop (didn't bet)
Seat 6: matiko09 (button) folded before Flop (didn't bet)
Seat 7: Mister_b44 (small blind) folded before Flop
Seat 8: chaps1988 (big blind) showed [7c 7h] and lost with two pair, Sevens and Sixes
Seat 9: Spid1 folded before Flop (didn't bet)





PokerStars Hand #153066037510:  Hold'em No Limit ($0.50/$1.00 USD) - 2016/05/09 15:57:32 CET [2016/05/09 9:57:32 ET]
Table 'Mentha' 9-max Seat #6 is the button
Seat 2: guoweiAA ($219.45 in chips) 
Seat 3: r4mz3s ($101.66 in chips) 
Seat 4: duggy2016 ($81.39 in chips) 
Seat 5: mycka86 ($118.19 in chips) 
Seat 6: Filojoes ($153.04 in chips) 
Seat 7: matiko09 ($113.85 in chips) 
Seat 8: Chef-Zizou ($81 in chips) 
Seat 9: Dickyxxx ($101.50 in chips) 
matiko09: posts small blind $0.50
Chef-Zizou: posts big blind $1
*** HOLE CARDS ***
Dealt to matiko09 [Ad As]
Dickyxxx: folds 
guoweiAA: folds 
r4mz3s: folds 
duggy2016: folds 
mycka86: folds 
Filojoes: folds 
matiko09: raises $2 to $3
Chef-Zizou: folds 
Uncalled bet ($2) returned to matiko09
matiko09 collected $2 from pot
matiko09: doesn't show hand 
*** SUMMARY ***
Total pot $2 | Rake $0 
Seat 2: guoweiAA folded before Flop (didn't bet)
Seat 3: r4mz3s folded before Flop (didn't bet)
Seat 4: duggy2016 folded before Flop (didn't bet)
Seat 5: mycka86 folded before Flop (didn't bet)
Seat 6: Filojoes (button) folded before Flop (didn't bet)
Seat 7: matiko09 (small blind) collected ($2)
Seat 8: Chef-Zizou (big blind) folded before Flop
Seat 9: Dickyxxx folded before Flop (didn't bet)





PokerStars Hand #153066037729:  Hold'em No Limit ($0.50/$1.00 USD) - 2016/05/09 15:57:33 CET [2016/05/09 9:57:33 ET]
Table 'Merga II' 9-max Seat #3 is the button
Seat 1: luckyluke24 ($24.08 in chips) 
Seat 2: Filojoes ($101.68 in chips) 
Seat 3: xhinostrabli ($32.51 in chips) 
Seat 4: nubpoker ($102.12 in chips) 
Seat 5: LRVAV7 ($245.45 in chips) 
Seat 6: Spid1 ($159.03 in chips) 
Seat 7: matiko09 ($151.79 in chips) 
Seat 8: GrandOldFart ($129.80 in chips) 
Seat 9: chaps1988 ($223.43 in chips) 
nubpoker: posts small blind $0.50
LRVAV7: posts big blind $1
*** HOLE CARDS ***
Dealt to matiko09 [Jc 2c]
Spid1: folds 
matiko09: folds 
GrandOldFart: folds 
chaps1988: folds 
luckyluke24: folds 
Filojoes: folds 
xhinostrabli: raises $2 to $3
nubpoker: folds 
LRVAV7: calls $2
*** FLOP *** [Th 9c Qc]
LRVAV7: checks 
xhinostrabli: checks 
*** TURN *** [Th 9c Qc] [4h]
LRVAV7: checks 
xhinostrabli: checks 
*** RIVER *** [Th 9c Qc 4h] [4d]
LRVAV7: bets $6.18
xhinostrabli: folds 
Uncalled bet ($6.18) returned to LRVAV7
LRVAV7 collected $6.18 from pot
LRVAV7: doesn't show hand 
*** SUMMARY ***
Total pot $6.50 | Rake $0.32 
Board [Th 9c Qc 4h 4d]
Seat 1: luckyluke24 folded before Flop (didn't bet)
Seat 2: Filojoes folded before Flop (didn't bet)
Seat 3: xhinostrabli (button) folded on the River
Seat 4: nubpoker (small blind) folded before Flop
Seat 5: LRVAV7 (big blind) collected ($6.18)
Seat 6: Spid1 folded before Flop (didn't bet)
Seat 7: matiko09 folded before Flop (didn't bet)
Seat 8: GrandOldFart folded before Flop (didn't bet)
Seat 9: chaps1988 folded before Flop (didn't bet)





PokerStars Hand #153066041429:  Hold'em No Limit ($0.50/$1.00 USD) - 2016/05/09 15:57:40 CET [2016/05/09 9:57:40 ET]
Table 'Reiss' 9-max Seat #9 is the button
Seat 1: Dickyxxx ($191.67 in chips) 
Seat 2: mycka86 ($118.50 in chips) 
Seat 3: chaps1988 ($110.99 in chips) 
Seat 4: MichaLabam ($137.58 in chips) 
Seat 5: matiko09 ($102.54 in chips) 
Seat 6: Spid1 ($119.43 in chips) 
Seat 7: nubpoker ($107.64 in chips) 
Seat 8: Filojoes ($191.68 in chips) 
Seat 9: Aghmir77 ($105.46 in chips) 
Dickyxxx: posts small blind $0.50
mycka86: posts big blind $1
*** HOLE CARDS ***
Dealt to matiko09 [Qs 8h]
chaps1988: raises $2 to $3
MichaLabam: folds 
matiko09: folds 
Spid1: folds 
nubpoker: folds 
Filojoes: folds 
Aghmir77: folds 
Dickyxxx: folds 
mycka86: folds 
Uncalled bet ($2) returned to chaps1988
chaps1988 collected $2.50 from pot
chaps1988: doesn't show hand 
*** SUMMARY ***
Total pot $2.50 | Rake $0 
Seat 1: Dickyxxx (small blind) folded before Flop
Seat 2: mycka86 (big blind) folded before Flop
Seat 3: chaps1988 collected ($2.50)
Seat 4: MichaLabam folded before Flop (didn't bet)
Seat 5: matiko09 folded before Flop (didn't bet)
Seat 6: Spid1 folded before Flop (didn't bet)
Seat 7: nubpoker folded before Flop (didn't bet)
Seat 8: Filojoes folded before Flop (didn't bet)
Seat 9: Aghmir77 (button) folded before Flop (didn't bet)





PokerStars Hand #153066046681:  Hold'em No Limit ($0.50/$1.00 USD) - 2016/05/09 15:57:51 CET [2016/05/09 9:57:51 ET]
Table 'Alderamin' 9-max Seat #2 is the button
Seat 1: r4mz3s ($101.65 in chips) 
Seat 2: Filojoes ($123.43 in chips) 
Seat 3: NSL0808 ($103.18 in chips) 
Seat 4: matiko09 ($100 in chips) 
Seat 5: tanmayh ($92.03 in chips) 
Seat 6: Spid1 ($105.70 in chips) 
Seat 7: azzad2007 ($100.94 in chips) 
Seat 8: nubpoker ($102.25 in chips) 
Seat 9: ipashutapkom ($40 in chips) 
NSL0808: posts small blind $0.50
matiko09: posts big blind $1
*** HOLE CARDS ***
Dealt to matiko09 [4c 5d]
tanmayh: folds 
Spid1: folds 
azzad2007: raises $2 to $3
nubpoker: folds 
ipashutapkom: folds 
r4mz3s: folds 
Filojoes: folds 
NSL0808: folds 
matiko09: folds 
Uncalled bet ($2) returned to azzad2007
azzad2007 collected $2.50 from pot
azzad2007: doesn't show hand 
*** SUMMARY ***
Total pot $2.50 | Rake $0 
Seat 1: r4mz3s folded before Flop (didn't bet)
Seat 2: Filojoes (button) folded before Flop (didn't bet)
Seat 3: NSL0808 (small blind) folded before Flop
Seat 4: matiko09 (big blind) folded before Flop
Seat 5: tanmayh folded before Flop (didn't bet)
Seat 6: Spid1 folded before Flop (didn't bet)
Seat 7: azzad2007 collected ($2.50)
Seat 8: nubpoker folded before Flop (didn't bet)
Seat 9: ipashutapkom folded before Flop (didn't bet)





PokerStars Hand #153066046662:  Hold'em No Limit ($1/$2 USD) - 2016/05/09 15:57:51 CET [2016/05/09 9:57:51 ET]
Table 'Hagar II' 9-max Seat #9 is the button
Seat 1: azzad2007 ($259.62 in chips) 
Seat 2: billynomates ($108.56 in chips) 
Seat 3: stan_09319 ($200 in chips) 
Seat 4: matiko09 ($247.15 in chips) 
Seat 5: darren1031 ($241.45 in chips) 
Seat 6: Piniker85 ($600.42 in chips) 
Seat 7: Monsthand ($200 in chips) 
Seat 8: J0k3rF4c3_FD ($325.55 in chips) 
Seat 9: chaps1988 ($200 in chips) 
azzad2007: posts small blind $1
billynomates: posts big blind $2
*** HOLE CARDS ***
Dealt to matiko09 [7d 3c]
stan_09319: raises $2.70 to $4.70
matiko09: folds 
darren1031: calls $4.70
Piniker85: raises $5.30 to $10
Monsthand: folds 
J0k3rF4c3_FD: folds 
chaps1988: folds 
azzad2007: folds 
billynomates: folds 
stan_09319: calls $5.30
darren1031: calls $5.30
*** FLOP *** [8h 4h 3h]
stan_09319: checks 
darren1031: bets $18
Piniker85: folds 
stan_09319: folds 
Uncalled bet ($18) returned to darren1031
darren1031 collected $31.35 from pot
darren1031: doesn't show hand 
*** SUMMARY ***
Total pot $33 | Rake $1.65 
Board [8h 4h 3h]
Seat 1: azzad2007 (small blind) folded before Flop
Seat 2: billynomates (big blind) folded before Flop
Seat 3: stan_09319 folded on the Flop
Seat 4: matiko09 folded before Flop (didn't bet)
Seat 5: darren1031 collected ($31.35)
Seat 6: Piniker85 folded on the Flop
Seat 7: Monsthand folded before Flop (didn't bet)
Seat 8: J0k3rF4c3_FD folded before Flop (didn't bet)
Seat 9: chaps1988 (button) folded before Flop (didn't bet)





PokerStars Hand #153066047015:  Hold'em No Limit ($0.50/$1.00 USD) - 2016/05/09 15:57:52 CET [2016/05/09 9:57:52 ET]
Table 'Terpsichore' 9-max Seat #7 is the button
Seat 1: ipashutapkom ($40 in chips) 
Seat 2: J0k3rF4c3_FD ($184.16 in chips) 
Seat 3: matiko09 ($106.87 in chips) 
Seat 5: mycka86 ($107.77 in chips) 
Seat 6: Filojoes ($110.09 in chips) 
Seat 7: xhinostrabli ($104.52 in chips) 
Seat 9: FTPbannedMe ($100 in chips) 
FTPbannedMe: posts small blind $0.50
ipashutapkom: posts big blind $1
*** HOLE CARDS ***
Dealt to matiko09 [Qd 8s]
J0k3rF4c3_FD: folds 
matiko09: folds 
mycka86: folds 
Filojoes: folds 
xhinostrabli: folds 
FTPbannedMe: raises $1.50 to $2.50
ipashutapkom: calls $1.50
*** FLOP *** [5s Qc 6s]
FTPbannedMe: bets $2.37
ipashutapkom: calls $2.37
*** TURN *** [5s Qc 6s] [7h]
FTPbannedMe: checks 
ipashutapkom: checks 
*** RIVER *** [5s Qc 6s 7h] [Qh]
FTPbannedMe: bets $6.93
ipashutapkom: calls $6.93
*** SHOW DOWN ***
FTPbannedMe: shows [Ks Th] (a pair of Queens)
ipashutapkom: shows [6c Kd] (two pair, Queens and Sixes)
ipashutapkom collected $22.42 from pot
*** SUMMARY ***
Total pot $23.60 | Rake $1.18 
Board [5s Qc 6s 7h Qh]
Seat 1: ipashutapkom (big blind) showed [6c Kd] and won ($22.42) with two pair, Queens and Sixes
Seat 2: J0k3rF4c3_FD folded before Flop (didn't bet)
Seat 3: matiko09 folded before Flop (didn't bet)
Seat 5: mycka86 folded before Flop (didn't bet)
Seat 6: Filojoes folded before Flop (didn't bet)
Seat 7: xhinostrabli (button) folded before Flop (didn't bet)
Seat 9: FTPbannedMe (small blind) showed [Ks Th] and lost with a pair of Queens





PokerStars Hand #153066047857:  Hold'em No Limit ($0.50/$1.00 USD) - 2016/05/09 15:57:54 CET [2016/05/09 9:57:54 ET]
Table 'Mentha' 9-max Seat #7 is the button
Seat 2: guoweiAA ($219.45 in chips) 
Seat 3: r4mz3s ($101.66 in chips) 
Seat 4: duggy2016 ($81.39 in chips) 
Seat 5: mycka86 ($118.19 in chips) 
Seat 6: Filojoes ($153.04 in chips) 
Seat 7: matiko09 ($114.85 in chips) 
Seat 8: Chef-Zizou ($80 in chips) 
Seat 9: Dickyxxx ($101.50 in chips) 
Chef-Zizou: posts small blind $0.50
Dickyxxx: posts big blind $1
*** HOLE CARDS ***
Dealt to matiko09 [9s Jd]
guoweiAA: folds 
r4mz3s: raises $1.50 to $2.50
duggy2016: folds 
mycka86: folds 
Filojoes: folds 
matiko09: folds 
Chef-Zizou: folds 
Dickyxxx: folds 
Uncalled bet ($1.50) returned to r4mz3s
r4mz3s collected $2.50 from pot
r4mz3s: doesn't show hand 
*** SUMMARY ***
Total pot $2.50 | Rake $0 
Seat 2: guoweiAA folded before Flop (didn't bet)
Seat 3: r4mz3s collected ($2.50)
Seat 4: duggy2016 folded before Flop (didn't bet)
Seat 5: mycka86 folded before Flop (didn't bet)
Seat 6: Filojoes folded before Flop (didn't bet)
Seat 7: matiko09 (button) folded before Flop (didn't bet)
Seat 8: Chef-Zizou (small blind) folded before Flop
Seat 9: Dickyxxx (big blind) folded before Flop





PokerStars Hand #153066059123:  Hold'em No Limit ($0.50/$1.00 USD) - 2016/05/09 15:58:18 CET [2016/05/09 9:58:18 ET]
Table 'Reiss' 9-max Seat #1 is the button
Seat 1: Dickyxxx ($191.17 in chips) 
Seat 2: mycka86 ($117.50 in chips) 
Seat 3: chaps1988 ($112.49 in chips) 
Seat 4: MichaLabam ($137.58 in chips) 
Seat 5: matiko09 ($102.54 in chips) 
Seat 6: Spid1 ($119.43 in chips) 
Seat 7: nubpoker ($107.64 in chips) 
Seat 8: Filojoes ($191.68 in chips) 
Seat 9: Aghmir77 ($105.46 in chips) 
mycka86: posts small blind $0.50
chaps1988: posts big blind $1
*** HOLE CARDS ***
Dealt to matiko09 [Jd 8h]
MichaLabam: raises $2 to $3
matiko09: folds 
Spid1: folds 
nubpoker: folds 
Filojoes: folds 
Aghmir77: folds 
Dickyxxx: folds 
mycka86: folds 
chaps1988: folds 
Uncalled bet ($2) returned to MichaLabam
MichaLabam collected $2.50 from pot
MichaLabam: doesn't show hand 
*** SUMMARY ***
Total pot $2.50 | Rake $0 
Seat 1: Dickyxxx (button) folded before Flop (didn't bet)
Seat 2: mycka86 (small blind) folded before Flop
Seat 3: chaps1988 (big blind) folded before Flop
Seat 4: MichaLabam collected ($2.50)
Seat 5: matiko09 folded before Flop (didn't bet)
Seat 6: Spid1 folded before Flop (didn't bet)
Seat 7: nubpoker folded before Flop (didn't bet)
Seat 8: Filojoes folded before Flop (didn't bet)
Seat 9: Aghmir77 folded before Flop (didn't bet)





PokerStars Hand #153066059122:  Hold'em No Limit ($1/$2 USD) - 2016/05/09 15:58:18 CET [2016/05/09 9:58:18 ET]
Table 'Celaeno II' 9-max Seat #7 is the button
Seat 1: Li Shaobo ($290.75 in chips) 
Seat 2: J0k3rF4c3_FD ($226.68 in chips) 
Seat 3: Fredstar56 ($121.31 in chips) 
Seat 4: FTPbannedMe ($313.40 in chips) 
Seat 5: stan_09319 ($200 in chips) 
Seat 6: matiko09 ($292.25 in chips) 
Seat 7: Mister_b44 ($89.07 in chips) 
Seat 8: chaps1988 ($225.77 in chips) 
Seat 9: Spid1 ($200 in chips) 
chaps1988: posts small blind $1
Spid1: posts big blind $2
*** HOLE CARDS ***
Dealt to matiko09 [Kd 8h]
Li Shaobo: folds 
J0k3rF4c3_FD: folds 
Fredstar56: folds 
FTPbannedMe: folds 
stan_09319: folds 
matiko09: folds 
Mister_b44: folds 
chaps1988: raises $4 to $6
Spid1: raises $12 to $18
chaps1988: folds 
Uncalled bet ($12) returned to Spid1
Spid1 collected $12 from pot
Spid1: doesn't show hand 
*** SUMMARY ***
Total pot $12 | Rake $0 
Seat 1: Li Shaobo folded before Flop (didn't bet)
Seat 2: J0k3rF4c3_FD folded before Flop (didn't bet)
Seat 3: Fredstar56 folded before Flop (didn't bet)
Seat 4: FTPbannedMe folded before Flop (didn't bet)
Seat 5: stan_09319 folded before Flop (didn't bet)
Seat 6: matiko09 folded before Flop (didn't bet)
Seat 7: Mister_b44 (button) folded before Flop (didn't bet)
Seat 8: chaps1988 (small blind) folded before Flop
Seat 9: Spid1 (big blind) collected ($12)





PokerStars Hand #153066061972:  Hold'em No Limit ($0.50/$1.00 USD) - 2016/05/09 15:58:24 CET [2016/05/09 9:58:24 ET]
Table 'Mentha' 9-max Seat #8 is the button
Seat 2: guoweiAA ($219.45 in chips) 
Seat 3: r4mz3s ($103.16 in chips) 
Seat 4: duggy2016 ($81.39 in chips) 
Seat 5: mycka86 ($118.19 in chips) 
Seat 6: Filojoes ($153.04 in chips) 
Seat 7: matiko09 ($114.85 in chips) 
Seat 8: Chef-Zizou ($79.50 in chips) 
Seat 9: Dickyxxx ($100.50 in chips) 
Dickyxxx: posts small blind $0.50
guoweiAA: posts big blind $1
*** HOLE CARDS ***
Dealt to matiko09 [Kc 3d]
r4mz3s: folds 
duggy2016: folds 
mycka86: folds 
Filojoes: folds 
matiko09: folds 
Chef-Zizou: folds 
Dickyxxx: raises $2 to $3
guoweiAA: raises $6 to $9
Dickyxxx: folds 
Uncalled bet ($6) returned to guoweiAA
guoweiAA collected $6 from pot
guoweiAA: doesn't show hand 
*** SUMMARY ***
Total pot $6 | Rake $0 
Seat 2: guoweiAA (big blind) collected ($6)
Seat 3: r4mz3s folded before Flop (didn't bet)
Seat 4: duggy2016 folded before Flop (didn't bet)
Seat 5: mycka86 folded before Flop (didn't bet)
Seat 6: Filojoes folded before Flop (didn't bet)
Seat 7: matiko09 folded before Flop (didn't bet)
Seat 8: Chef-Zizou (button) folded before Flop (didn't bet)
Seat 9: Dickyxxx (small blind) folded before Flop





PokerStars Hand #153066062054:  Hold'em No Limit ($0.50/$1.00 USD) - 2016/05/09 15:58:24 CET [2016/05/09 9:58:24 ET]
Table 'Alderamin' 9-max Seat #3 is the button
Seat 1: r4mz3s ($101.65 in chips) 
Seat 2: Filojoes ($123.43 in chips) 
Seat 3: NSL0808 ($102.68 in chips) 
Seat 4: matiko09 ($100 in chips) 
Seat 5: tanmayh ($92.03 in chips) 
Seat 6: Spid1 ($105.70 in chips) 
Seat 7: azzad2007 ($102.44 in chips) 
Seat 8: nubpoker ($102.25 in chips) 
Seat 9: ipashutapkom ($40 in chips) 
matiko09: posts small blind $0.50
tanmayh: posts big blind $1
*** HOLE CARDS ***
Dealt to matiko09 [9h 4d]
Spid1: raises $2 to $3
azzad2007: folds 
nubpoker: folds 
ipashutapkom: folds 
r4mz3s: calls $3
Filojoes: folds 
NSL0808: folds 
matiko09: folds 
tanmayh: calls $2
*** FLOP *** [Ks 4c 3s]
tanmayh: checks 
Spid1: bets $7.50
r4mz3s: calls $7.50
tanmayh has timed out
tanmayh: folds 
*** TURN *** [Ks 4c 3s] [As]
Spid1: checks 
r4mz3s: checks 
*** RIVER *** [Ks 4c 3s As] [7s]
Spid1: checks 
r4mz3s: checks 
*** SHOW DOWN ***
Spid1: shows [Ac Ah] (three of a kind, Aces)
r4mz3s: mucks hand 
Spid1 collected $23.28 from pot
*** SUMMARY ***
Total pot $24.50 | Rake $1.22 
Board [Ks 4c 3s As 7s]
Seat 1: r4mz3s mucked [Kd Jd]
Seat 2: Filojoes folded before Flop (didn't bet)
Seat 3: NSL0808 (button) folded before Flop (didn't bet)
Seat 4: matiko09 (small blind) folded before Flop
Seat 5: tanmayh (big blind) folded on the Flop
Seat 6: Spid1 showed [Ac Ah] and won ($23.28) with three of a kind, Aces
Seat 7: azzad2007 folded before Flop (didn't bet)
Seat 8: nubpoker folded before Flop (didn't bet)
Seat 9: ipashutapkom folded before Flop (didn't bet)





PokerStars Hand #153066066347:  Hold'em No Limit ($0.50/$1.00 USD) - 2016/05/09 15:58:33 CET [2016/05/09 9:58:33 ET]
Table 'Merga II' 9-max Seat #4 is the button
Seat 1: luckyluke24 ($24.08 in chips) 
Seat 2: Filojoes ($101.68 in chips) 
Seat 3: xhinostrabli ($29.51 in chips) 
Seat 4: nubpoker ($101.62 in chips) 
Seat 5: LRVAV7 ($248.63 in chips) 
Seat 6: Spid1 ($159.03 in chips) 
Seat 7: matiko09 ($151.79 in chips) 
Seat 8: GrandOldFart ($129.80 in chips) 
Seat 9: chaps1988 ($223.43 in chips) 
LRVAV7: posts small blind $0.50
Spid1: posts big blind $1
*** HOLE CARDS ***
Dealt to matiko09 [Qs 9c]
matiko09: folds 
GrandOldFart: folds 
chaps1988: folds 
luckyluke24: folds 
Filojoes: folds 
xhinostrabli: folds 
nubpoker: raises $1.50 to $2.50
LRVAV7: folds 
Spid1: folds 
Uncalled bet ($1.50) returned to nubpoker
nubpoker collected $2.50 from pot
nubpoker: doesn't show hand 
*** SUMMARY ***
Total pot $2.50 | Rake $0 
Seat 1: luckyluke24 folded before Flop (didn't bet)
Seat 2: Filojoes folded before Flop (didn't bet)
Seat 3: xhinostrabli folded before Flop (didn't bet)
Seat 4: nubpoker (button) collected ($2.50)
Seat 5: LRVAV7 (small blind) folded before Flop
Seat 6: Spid1 (big blind) folded before Flop
Seat 7: matiko09 folded before Flop (didn't bet)
Seat 8: GrandOldFart folded before Flop (didn't bet)
Seat 9: chaps1988 folded before Flop (didn't bet)





PokerStars Hand #153066069886:  Hold'em No Limit ($0.50/$1.00 USD) - 2016/05/09 15:58:40 CET [2016/05/09 9:58:40 ET]
Table 'Reiss' 9-max Seat #2 is the button
Seat 1: Dickyxxx ($191.17 in chips) 
Seat 2: mycka86 ($117 in chips) 
Seat 3: chaps1988 ($111.49 in chips) 
Seat 4: MichaLabam ($139.08 in chips) 
Seat 5: matiko09 ($102.54 in chips) 
Seat 6: Spid1 ($119.43 in chips) 
Seat 7: nubpoker ($107.64 in chips) 
Seat 8: Filojoes ($191.68 in chips) 
Seat 9: Aghmir77 ($105.46 in chips) 
chaps1988: posts small blind $0.50
MichaLabam: posts big blind $1
*** HOLE CARDS ***
Dealt to matiko09 [Jc Kh]
matiko09: folds 
Spid1: folds 
nubpoker: folds 
Filojoes: raises $2 to $3
Aghmir77: folds 
Dickyxxx: folds 
mycka86: folds 
chaps1988: folds 
MichaLabam: calls $2
*** FLOP *** [Qc Ts 6c]
MichaLabam: checks 
Filojoes: checks 
*** TURN *** [Qc Ts 6c] [Tc]
MichaLabam: bets $3
Filojoes: folds 
Uncalled bet ($3) returned to MichaLabam
MichaLabam collected $6.18 from pot
MichaLabam: doesn't show hand 
*** SUMMARY ***
Total pot $6.50 | Rake $0.32 
Board [Qc Ts 6c Tc]
Seat 1: Dickyxxx folded before Flop (didn't bet)
Seat 2: mycka86 (button) folded before Flop (didn't bet)
Seat 3: chaps1988 (small blind) folded before Flop
Seat 4: MichaLabam (big blind) collected ($6.18)
Seat 5: matiko09 folded before Flop (didn't bet)
Seat 6: Spid1 folded before Flop (didn't bet)
Seat 7: nubpoker folded before Flop (didn't bet)
Seat 8: Filojoes folded on the Turn
Seat 9: Aghmir77 folded before Flop (didn't bet)





PokerStars Hand #153066076333:  Hold'em No Limit ($1/$2 USD) - 2016/05/09 15:58:54 CET [2016/05/09 9:58:54 ET]
Table 'Celaeno II' 9-max Seat #8 is the button
Seat 1: Li Shaobo ($290.75 in chips) 
Seat 2: J0k3rF4c3_FD ($226.68 in chips) 
Seat 3: Fredstar56 ($121.31 in chips) 
Seat 4: FTPbannedMe ($313.40 in chips) 
Seat 5: stan_09319 ($200 in chips) 
Seat 6: matiko09 ($292.25 in chips) 
Seat 7: Mister_b44 ($89.07 in chips) 
Seat 8: chaps1988 ($219.77 in chips) 
Seat 9: Spid1 ($206 in chips) 
Spid1: posts small blind $1
Li Shaobo: posts big blind $2
*** HOLE CARDS ***
Dealt to matiko09 [Qc Kc]
J0k3rF4c3_FD: folds 
Fredstar56: folds 
FTPbannedMe: raises $4 to $6
stan_09319: folds 
matiko09: calls $6
Mister_b44: folds 
chaps1988: folds 
Spid1: folds 
Li Shaobo: calls $4
*** FLOP *** [Qh 6h 5s]
Li Shaobo: checks 
FTPbannedMe: checks 
matiko09: bets $12
Li Shaobo: folds 
FTPbannedMe: folds 
Uncalled bet ($12) returned to matiko09
matiko09 collected $18.05 from pot
matiko09: doesn't show hand 
*** SUMMARY ***
Total pot $19 | Rake $0.95 
Board [Qh 6h 5s]
Seat 1: Li Shaobo (big blind) folded on the Flop
Seat 2: J0k3rF4c3_FD folded before Flop (didn't bet)
Seat 3: Fredstar56 folded before Flop (didn't bet)
Seat 4: FTPbannedMe folded on the Flop
Seat 5: stan_09319 folded before Flop (didn't bet)
Seat 6: matiko09 collected ($18.05)
Seat 7: Mister_b44 folded before Flop (didn't bet)
Seat 8: chaps1988 (button) folded before Flop (didn't bet)
Seat 9: Spid1 (small blind) folded before Flop





PokerStars Hand #153066077690:  Hold'em No Limit ($0.50/$1.00 USD) - 2016/05/09 15:58:57 CET [2016/05/09 9:58:57 ET]
Table 'Mentha' 9-max Seat #9 is the button
Seat 2: guoweiAA ($222.45 in chips) 
Seat 3: r4mz3s ($103.16 in chips) 
Seat 4: duggy2016 ($81.39 in chips) 
Seat 5: mycka86 ($118.19 in chips) 
Seat 6: Filojoes ($153.04 in chips) 
Seat 7: matiko09 ($114.85 in chips) 
Seat 8: Chef-Zizou ($79.50 in chips) 
Seat 9: Dickyxxx ($100 in chips) 
guoweiAA: posts small blind $0.50
r4mz3s: posts big blind $1
*** HOLE CARDS ***
Dealt to matiko09 [Qd 3c]
duggy2016: folds 
mycka86: raises $2 to $3
Filojoes: folds 
matiko09: folds 
Chef-Zizou: folds 
Dickyxxx: folds 
guoweiAA: folds 
r4mz3s: folds 
Uncalled bet ($2) returned to mycka86
mycka86 collected $2.50 from pot
*** SUMMARY ***
Total pot $2.50 | Rake $0 
Seat 2: guoweiAA (small blind) folded before Flop
Seat 3: r4mz3s (big blind) folded before Flop
Seat 4: duggy2016 folded before Flop (didn't bet)
Seat 5: mycka86 collected ($2.50)
Seat 6: Filojoes folded before Flop (didn't bet)
Seat 7: matiko09 folded before Flop (didn't bet)
Seat 8: Chef-Zizou folded before Flop (didn't bet)
Seat 9: Dickyxxx (button) folded before Flop (didn't bet)





PokerStars Hand #153066080334:  Hold'em No Limit ($0.50/$1.00 USD) - 2016/05/09 15:59:02 CET [2016/05/09 9:59:02 ET]
Table 'Hajek' 9-max Seat #9 is the button
Seat 1: Mukhin1 ($100 in chips) 
Seat 2: Spid1 ($80 in chips) 
Seat 3: mycka86 ($100 in chips) 
Seat 4: LRVAV7 ($69.63 in chips) 
Seat 5: ozone2003 ($100 in chips) 
Seat 6: Filojoes ($100 in chips) 
Seat 7: 1st Morgoth ($80 in chips) 
Seat 8: Kukuryzka ($80 in chips) 
Seat 9: matiko09 ($100 in chips) 
Mukhin1: posts the ante $0.20
Spid1: posts the ante $0.20
mycka86: posts the ante $0.20
LRVAV7: posts the ante $0.20
ozone2003: posts the ante $0.20
Filojoes: posts the ante $0.20
1st Morgoth: posts the ante $0.20
Kukuryzka: posts the ante $0.20
matiko09: posts the ante $0.20
Mukhin1: posts small blind $0.50
Spid1: posts big blind $1
*** HOLE CARDS ***
Dealt to matiko09 [Ah 4c]
mycka86: folds 
LRVAV7: folds 
ozone2003: folds 
Filojoes: raises $2 to $3
1st Morgoth: folds 
1st Morgoth leaves the table
Monsthand joins the table at seat #7 
Kukuryzka: folds 
matiko09: folds 
Mukhin1: folds 
Spid1: folds 
Uncalled bet ($2) returned to Filojoes
Filojoes collected $4.30 from pot
Filojoes: doesn't show hand 
*** SUMMARY ***
Total pot $4.30 | Rake $0 
Seat 1: Mukhin1 (small blind) folded before Flop
Seat 2: Spid1 (big blind) folded before Flop
Seat 3: mycka86 folded before Flop (didn't bet)
Seat 4: LRVAV7 folded before Flop (didn't bet)
Seat 5: ozone2003 folded before Flop (didn't bet)
Seat 6: Filojoes collected ($4.30)
Seat 7: 1st Morgoth folded before Flop (didn't bet)
Seat 8: Kukuryzka folded before Flop (didn't bet)
Seat 9: matiko09 (button) folded before Flop (didn't bet)





PokerStars Hand #153066083566:  Hold'em No Limit ($0.50/$1.00 USD) - 2016/05/09 15:59:09 CET [2016/05/09 9:59:09 ET]
Table 'Merga II' 9-max Seat #5 is the button
Seat 1: luckyluke24 ($24.08 in chips) 
Seat 2: Filojoes ($101.68 in chips) 
Seat 3: xhinostrabli ($29.51 in chips) 
Seat 4: nubpoker ($103.12 in chips) 
Seat 5: LRVAV7 ($248.13 in chips) 
Seat 6: Spid1 ($158.03 in chips) 
Seat 7: matiko09 ($151.79 in chips) 
Seat 8: GrandOldFart ($129.80 in chips) 
Seat 9: chaps1988 ($223.43 in chips) 
Spid1: posts small blind $0.50
matiko09: posts big blind $1
*** HOLE CARDS ***
Dealt to matiko09 [7c 5s]
GrandOldFart: folds 
chaps1988: folds 
luckyluke24: folds 
Filojoes: folds 
xhinostrabli: folds 
nubpoker: raises $1.50 to $2.50
LRVAV7: folds 
Spid1: folds 
matiko09: folds 
Uncalled bet ($1.50) returned to nubpoker
nubpoker collected $2.50 from pot
nubpoker: doesn't show hand 
*** SUMMARY ***
Total pot $2.50 | Rake $0 
Seat 1: luckyluke24 folded before Flop (didn't bet)
Seat 2: Filojoes folded before Flop (didn't bet)
Seat 3: xhinostrabli folded before Flop (didn't bet)
Seat 4: nubpoker collected ($2.50)
Seat 5: LRVAV7 (button) folded before Flop (didn't bet)
Seat 6: Spid1 (small blind) folded before Flop
Seat 7: matiko09 (big blind) folded before Flop
Seat 8: GrandOldFart folded before Flop (didn't bet)
Seat 9: chaps1988 folded before Flop (didn't bet)





PokerStars Hand #153066087605:  Hold'em No Limit ($0.50/$1.00 USD) - 2016/05/09 15:59:18 CET [2016/05/09 9:59:18 ET]
Table 'Terpsichore' 9-max Seat #9 is the button
Seat 1: ipashutapkom ($50.62 in chips) 
Seat 2: J0k3rF4c3_FD ($184.16 in chips) 
Seat 3: matiko09 ($106.87 in chips) 
Seat 5: mycka86 ($107.77 in chips) 
Seat 6: Filojoes ($110.09 in chips) 
Seat 7: xhinostrabli ($104.52 in chips) 
Seat 9: FTPbannedMe ($100 in chips) 
ipashutapkom: posts small blind $0.50
J0k3rF4c3_FD: posts big blind $1
*** HOLE CARDS ***
Dealt to matiko09 [Ah 9c]
matiko09: folds 
mycka86: folds 
Filojoes: folds 
xhinostrabli: folds 
FTPbannedMe: raises $1 to $2
ipashutapkom: folds 
J0k3rF4c3_FD: folds 
Uncalled bet ($1) returned to FTPbannedMe
FTPbannedMe collected $2.50 from pot
FTPbannedMe: doesn't show hand 
*** SUMMARY ***
Total pot $2.50 | Rake $0 
Seat 1: ipashutapkom (small blind) folded before Flop
Seat 2: J0k3rF4c3_FD (big blind) folded before Flop
Seat 3: matiko09 folded before Flop (didn't bet)
Seat 5: mycka86 folded before Flop (didn't bet)
Seat 6: Filojoes folded before Flop (didn't bet)
Seat 7: xhinostrabli folded before Flop (didn't bet)
Seat 9: FTPbannedMe (button) collected ($2.50)





PokerStars Hand #153066089516:  Hold'em No Limit ($0.50/$1.00 USD) - 2016/05/09 15:59:22 CET [2016/05/09 9:59:22 ET]
Table 'Reiss' 9-max Seat #3 is the button
Seat 1: Dickyxxx ($191.17 in chips) 
Seat 2: mycka86 ($117 in chips) 
Seat 3: chaps1988 ($110.99 in chips) 
Seat 4: MichaLabam ($142.26 in chips) 
Seat 5: matiko09 ($102.54 in chips) 
Seat 6: Spid1 ($119.43 in chips) 
Seat 7: nubpoker ($107.64 in chips) 
Seat 8: Filojoes ($188.68 in chips) 
Seat 9: Aghmir77 ($105.46 in chips) 
MichaLabam: posts small blind $0.50
matiko09: posts big blind $1
*** HOLE CARDS ***
Dealt to matiko09 [8d Qh]
Spid1: folds 
nubpoker: folds 
Filojoes: folds 
Aghmir77: folds 
Dickyxxx: folds 
mycka86: folds 
chaps1988: raises $1.25 to $2.25
MichaLabam: folds 
matiko09: folds 
Uncalled bet ($1.25) returned to chaps1988
chaps1988 collected $2.50 from pot
chaps1988: doesn't show hand 
*** SUMMARY ***
Total pot $2.50 | Rake $0 
Seat 1: Dickyxxx folded before Flop (didn't bet)
Seat 2: mycka86 folded before Flop (didn't bet)
Seat 3: chaps1988 (button) collected ($2.50)
Seat 4: MichaLabam (small blind) folded before Flop
Seat 5: matiko09 (big blind) folded before Flop
Seat 6: Spid1 folded before Flop (didn't bet)
Seat 7: nubpoker folded before Flop (didn't bet)
Seat 8: Filojoes folded before Flop (didn't bet)
Seat 9: Aghmir77 folded before Flop (didn't bet)





PokerStars Hand #153066091843:  Hold'em No Limit ($0.50/$1.00 USD) - 2016/05/09 15:59:26 CET [2016/05/09 9:59:26 ET]
Table 'Mentha' 9-max Seat #2 is the button
Seat 2: guoweiAA ($221.95 in chips) 
Seat 3: r4mz3s ($102.16 in chips) 
Seat 4: duggy2016 ($81.39 in chips) 
Seat 5: mycka86 ($119.69 in chips) 
Seat 6: Filojoes ($153.04 in chips) 
Seat 7: matiko09 ($114.85 in chips) 
Seat 8: Chef-Zizou ($79.50 in chips) 
Seat 9: Dickyxxx ($100 in chips) 
r4mz3s: posts small blind $0.50
duggy2016: posts big blind $1
*** HOLE CARDS ***
Dealt to matiko09 [Ad Jd]
mycka86: folds 
Filojoes: folds 
matiko09: raises $2 to $3
Chef-Zizou: calls $3
Dickyxxx: folds 
guoweiAA: folds 
r4mz3s: folds 
duggy2016: folds 
*** FLOP *** [6s 6c 7d]
matiko09: checks 
Chef-Zizou: bets $3
matiko09: calls $3
*** TURN *** [6s 6c 7d] [9s]
matiko09: checks 
Chef-Zizou: bets $5
matiko09: folds 
Uncalled bet ($5) returned to Chef-Zizou
Chef-Zizou collected $12.82 from pot
*** SUMMARY ***
Total pot $13.50 | Rake $0.68 
Board [6s 6c 7d 9s]
Seat 2: guoweiAA (button) folded before Flop (didn't bet)
Seat 3: r4mz3s (small blind) folded before Flop
Seat 4: duggy2016 (big blind) folded before Flop
Seat 5: mycka86 folded before Flop (didn't bet)
Seat 6: Filojoes folded before Flop (didn't bet)
Seat 7: matiko09 folded on the Turn
Seat 8: Chef-Zizou collected ($12.82)
Seat 9: Dickyxxx folded before Flop (didn't bet)





PokerStars Hand #153066092225:  Hold'em No Limit ($1/$2 USD) - 2016/05/09 15:59:27 CET [2016/05/09 9:59:27 ET]
Table 'Hagar II' 9-max Seat #1 is the button
Seat 1: azzad2007 ($258.62 in chips) 
Seat 2: billynomates ($106.56 in chips) 
Seat 3: stan_09319 ($200 in chips) 
Seat 4: matiko09 ($247.15 in chips) 
Seat 5: darren1031 ($262.80 in chips) 
Seat 6: Piniker85 ($590.42 in chips) 
Seat 7: Monsthand ($200 in chips) 
Seat 8: J0k3rF4c3_FD ($325.55 in chips) 
Seat 9: chaps1988 ($200 in chips) 
billynomates: posts small blind $1
stan_09319: posts big blind $2
*** HOLE CARDS ***
Dealt to matiko09 [3c 5d]
matiko09: folds 
darren1031: calls $2
Piniker85: calls $2
Monsthand: folds 
J0k3rF4c3_FD: folds 
chaps1988: folds 
azzad2007: folds 
billynomates: calls $1
stan_09319: checks 
*** FLOP *** [6s Qc Tc]
billynomates: checks 
stan_09319: checks 
darren1031: bets $6
Piniker85: calls $6
billynomates: folds 
stan_09319: folds 
*** TURN *** [6s Qc Tc] [3d]
darren1031: bets $30
Piniker85: raises $30 to $60
darren1031: raises $194.80 to $254.80 and is all-in
Piniker85: calls $194.80
*** RIVER *** [6s Qc Tc 3d] [7c]
*** SHOW DOWN ***
darren1031: shows [Kh Qs] (a pair of Queens)
Piniker85: shows [Qh Qd] (three of a kind, Queens)
Piniker85 collected $526.85 from pot
*** SUMMARY ***
Total pot $529.60 | Rake $2.75 
Board [6s Qc Tc 3d 7c]
Seat 1: azzad2007 (button) folded before Flop (didn't bet)
Seat 2: billynomates (small blind) folded on the Flop
Seat 3: stan_09319 (big blind) folded on the Flop
Seat 4: matiko09 folded before Flop (didn't bet)
Seat 5: darren1031 showed [Kh Qs] and lost with a pair of Queens
Seat 6: Piniker85 showed [Qh Qd] and won ($526.85) with three of a kind, Queens
Seat 7: Monsthand folded before Flop (didn't bet)
Seat 8: J0k3rF4c3_FD folded before Flop (didn't bet)
Seat 9: chaps1988 folded before Flop (didn't bet)





PokerStars Hand #153066095734:  Hold'em No Limit ($0.50/$1.00 USD) - 2016/05/09 15:59:35 CET [2016/05/09 9:59:35 ET]
Table 'Merga II' 9-max Seat #6 is the button
Seat 1: luckyluke24 ($24.08 in chips) 
Seat 2: Filojoes ($101.68 in chips) 
Seat 3: xhinostrabli ($29.51 in chips) 
Seat 4: nubpoker ($104.62 in chips) 
Seat 5: LRVAV7 ($248.13 in chips) 
Seat 6: Spid1 ($157.53 in chips) 
Seat 7: matiko09 ($150.79 in chips) 
Seat 8: GrandOldFart ($129.80 in chips) 
Seat 9: chaps1988 ($223.43 in chips) 
matiko09: posts small blind $0.50
GrandOldFart: posts big blind $1
*** HOLE CARDS ***
Dealt to matiko09 [4s 9s]
chaps1988: folds 
luckyluke24: folds 
Filojoes: folds 
xhinostrabli: folds 
nubpoker: folds 
LRVAV7: folds 
Spid1: raises $1.50 to $2.50
matiko09: folds 
GrandOldFart: raises $4.50 to $7
Spid1: calls $4.50
*** FLOP *** [4h 4c 8h]
GrandOldFart: bets $6.89
Spid1: raises $12.61 to $19.50
GrandOldFart: raises $20.50 to $40
Spid1: raises $110.53 to $150.53 and is all-in
GrandOldFart: calls $82.80 and is all-in
Uncalled bet ($27.73) returned to Spid1
*** TURN *** [4h 4c 8h] [2s]
*** RIVER *** [4h 4c 8h 2s] [7c]
*** SHOW DOWN ***
GrandOldFart: shows [8d As] (two pair, Eights and Fours)
Spid1: shows [Ad 4d] (three of a kind, Fours)
Spid1 collected $257.60 from pot
*** SUMMARY ***
Total pot $260.10 | Rake $2.50 
Board [4h 4c 8h 2s 7c]
Seat 1: luckyluke24 folded before Flop (didn't bet)
Seat 2: Filojoes folded before Flop (didn't bet)
Seat 3: xhinostrabli folded before Flop (didn't bet)
Seat 4: nubpoker folded before Flop (didn't bet)
Seat 5: LRVAV7 folded before Flop (didn't bet)
Seat 6: Spid1 (button) showed [Ad 4d] and won ($257.60) with three of a kind, Fours
Seat 7: matiko09 (small blind) folded before Flop
Seat 8: GrandOldFart (big blind) showed [8d As] and lost with two pair, Eights and Fours
Seat 9: chaps1988 folded before Flop (didn't bet)





PokerStars Hand #153066097248:  Hold'em No Limit ($1/$2 USD) - 2016/05/09 15:59:38 CET [2016/05/09 9:59:38 ET]
Table 'Celaeno II' 9-max Seat #9 is the button
Seat 1: Li Shaobo ($284.75 in chips) 
Seat 2: J0k3rF4c3_FD ($226.68 in chips) 
Seat 3: Fredstar56 ($121.31 in chips) 
Seat 4: FTPbannedMe ($307.40 in chips) 
Seat 5: stan_09319 ($200 in chips) 
Seat 6: matiko09 ($304.30 in chips) 
Seat 7: Mister_b44 ($89.07 in chips) 
Seat 8: chaps1988 ($219.77 in chips) 
Seat 9: Spid1 ($205 in chips) 
Li Shaobo: posts small blind $1
J0k3rF4c3_FD: posts big blind $2
*** HOLE CARDS ***
Dealt to matiko09 [4c 5s]
Fredstar56: folds 
FTPbannedMe: raises $4 to $6
stan_09319: folds 
matiko09: folds 
Mister_b44: folds 
chaps1988: folds 
Spid1: folds 
Li Shaobo: folds 
J0k3rF4c3_FD: folds 
Uncalled bet ($4) returned to FTPbannedMe
FTPbannedMe collected $5 from pot
FTPbannedMe: doesn't show hand 
*** SUMMARY ***
Total pot $5 | Rake $0 
Seat 1: Li Shaobo (small blind) folded before Flop
Seat 2: J0k3rF4c3_FD (big blind) folded before Flop
Seat 3: Fredstar56 folded before Flop (didn't bet)
Seat 4: FTPbannedMe collected ($5)
Seat 5: stan_09319 folded before Flop (didn't bet)
Seat 6: matiko09 folded before Flop (didn't bet)
Seat 7: Mister_b44 folded before Flop (didn't bet)
Seat 8: chaps1988 folded before Flop (didn't bet)
Seat 9: Spid1 (button) folded before Flop (didn't bet)





PokerStars Hand #153066099901:  Hold'em No Limit ($0.50/$1.00 USD) - 2016/05/09 15:59:43 CET [2016/05/09 9:59:43 ET]
Table 'Reiss' 9-max Seat #4 is the button
Seat 1: Dickyxxx ($191.17 in chips) 
Seat 2: mycka86 ($117 in chips) 
Seat 3: chaps1988 ($112.49 in chips) 
Seat 4: MichaLabam ($141.76 in chips) 
Seat 5: matiko09 ($101.54 in chips) 
Seat 6: Spid1 ($119.43 in chips) 
Seat 7: nubpoker ($107.64 in chips) 
Seat 8: Filojoes ($188.68 in chips) 
Seat 9: Aghmir77 ($105.46 in chips) 
matiko09: posts small blind $0.50
Spid1: posts big blind $1
*** HOLE CARDS ***
Dealt to matiko09 [6h 5c]
nubpoker: folds 
Filojoes: folds 
Aghmir77: folds 
Dickyxxx: folds 
mycka86: raises $1.50 to $2.50
chaps1988: calls $2.50
MichaLabam: folds 
matiko09: folds 
Spid1: raises $10 to $12.50
mycka86: folds 
chaps1988: folds 
Uncalled bet ($10) returned to Spid1
Spid1 collected $8 from pot
Spid1: doesn't show hand 
*** SUMMARY ***
Total pot $8 | Rake $0 
Seat 1: Dickyxxx folded before Flop (didn't bet)
Seat 2: mycka86 folded before Flop
Seat 3: chaps1988 folded before Flop
Seat 4: MichaLabam (button) folded before Flop (didn't bet)
Seat 5: matiko09 (small blind) folded before Flop
Seat 6: Spid1 (big blind) collected ($8)
Seat 7: nubpoker folded before Flop (didn't bet)
Seat 8: Filojoes folded before Flop (didn't bet)
Seat 9: Aghmir77 folded before Flop (didn't bet)





PokerStars Hand #153066103173:  Hold'em No Limit ($1/$2 USD) - 2016/05/09 15:59:50 CET [2016/05/09 9:59:50 ET]
Table 'Luda' 9-max Seat #5 is the button
Seat 1: stan_09319 ($422.99 in chips) 
Seat 2: matiko09 ($200 in chips) 
Seat 3: Monsthand ($435.55 in chips) 
Seat 4: Igoriah ($261.80 in chips) 
Seat 5: J0k3rF4c3_FD ($200 in chips) 
Seat 6: Iggso ($201 in chips) 
Seat 7: chaps1988 ($229.25 in chips) 
Seat 8: ramseyg117 ($259.53 in chips) 
Seat 9: solano20000 ($170.54 in chips) 
Iggso: posts small blind $1
chaps1988: posts big blind $2
*** HOLE CARDS ***
Dealt to matiko09 [Qs 6c]
ramseyg117: raises $5 to $7
solano20000: folds 
stan_09319: folds 
ramseyg117 said, "idiot"
matiko09: folds 
Monsthand: folds 
Igoriah: folds 
J0k3rF4c3_FD: folds 
Iggso: folds 
chaps1988: calls $5
*** FLOP *** [5c As 9d]
chaps1988: checks 
ramseyg117: checks 
*** TURN *** [5c As 9d] [7c]
chaps1988: checks 
ramseyg117: checks 
*** RIVER *** [5c As 9d 7c] [3h]
chaps1988: checks 
ramseyg117: bets $14.25
chaps1988: folds 
Uncalled bet ($14.25) returned to ramseyg117
ramseyg117 collected $14.25 from pot
ramseyg117: doesn't show hand 
*** SUMMARY ***
Total pot $15 | Rake $0.75 
Board [5c As 9d 7c 3h]
Seat 1: stan_09319 folded before Flop (didn't bet)
Seat 2: matiko09 folded before Flop (didn't bet)
Seat 3: Monsthand folded before Flop (didn't bet)
Seat 4: Igoriah folded before Flop (didn't bet)
Seat 5: J0k3rF4c3_FD (button) folded before Flop (didn't bet)
Seat 6: Iggso (small blind) folded before Flop
Seat 7: chaps1988 (big blind) folded on the River
Seat 8: ramseyg117 collected ($14.25)
Seat 9: solano20000 folded before Flop (didn't bet)





PokerStars Hand #153066105267:  Hold'em No Limit ($0.50/$1.00 USD) - 2016/05/09 15:59:54 CET [2016/05/09 9:59:54 ET]
Table 'Terpsichore' 9-max Seat #1 is the button
Seat 1: ipashutapkom ($50.12 in chips) 
Seat 2: J0k3rF4c3_FD ($183.16 in chips) 
Seat 3: matiko09 ($106.87 in chips) 
Seat 5: mycka86 ($107.77 in chips) 
Seat 6: Filojoes ($110.09 in chips) 
Seat 7: xhinostrabli ($104.52 in chips) 
Seat 9: FTPbannedMe ($101.50 in chips) 
J0k3rF4c3_FD: posts small blind $0.50
matiko09: posts big blind $1
*** HOLE CARDS ***
Dealt to matiko09 [Jc Kd]
mycka86: raises $2 to $3
Filojoes: folds 
xhinostrabli: folds 
FTPbannedMe: folds 
ipashutapkom: folds 
J0k3rF4c3_FD: folds 
matiko09: folds 
Uncalled bet ($2) returned to mycka86
mycka86 collected $2.50 from pot
*** SUMMARY ***
Total pot $2.50 | Rake $0 
Seat 1: ipashutapkom (button) folded before Flop (didn't bet)
Seat 2: J0k3rF4c3_FD (small blind) folded before Flop
Seat 3: matiko09 (big blind) folded before Flop
Seat 5: mycka86 collected ($2.50)
Seat 6: Filojoes folded before Flop (didn't bet)
Seat 7: xhinostrabli folded before Flop (didn't bet)
Seat 9: FTPbannedMe folded before Flop (didn't bet)





PokerStars Hand #153066111315:  Hold'em No Limit ($1/$2 USD) - 2016/05/09 16:00:06 CET [2016/05/09 10:00:06 ET]
Table 'Celaeno II' 9-max Seat #1 is the button
Seat 1: Li Shaobo ($283.75 in chips) 
Seat 2: J0k3rF4c3_FD ($224.68 in chips) 
Seat 3: Fredstar56 ($121.31 in chips) 
Seat 4: FTPbannedMe ($310.40 in chips) 
Seat 5: stan_09319 ($200 in chips) 
Seat 6: matiko09 ($304.30 in chips) 
Seat 7: Mister_b44 ($89.07 in chips) 
Seat 8: chaps1988 ($219.77 in chips) 
Seat 9: Spid1 ($205 in chips) 
J0k3rF4c3_FD: posts small blind $1
Fredstar56: posts big blind $2
*** HOLE CARDS ***
Dealt to matiko09 [3h Qh]
FTPbannedMe: raises $4 to $6
stan_09319: folds 
matiko09: folds 
Mister_b44: folds 
chaps1988: folds 
Spid1: folds 
Li Shaobo: folds 
J0k3rF4c3_FD: calls $5
Fredstar56: folds 
*** FLOP *** [Ac Qc Js]
J0k3rF4c3_FD: bets $8.65
FTPbannedMe: folds 
Uncalled bet ($8.65) returned to J0k3rF4c3_FD
J0k3rF4c3_FD collected $13.30 from pot
J0k3rF4c3_FD: doesn't show hand 
*** SUMMARY ***
Total pot $14 | Rake $0.70 
Board [Ac Qc Js]
Seat 1: Li Shaobo (button) folded before Flop (didn't bet)
Seat 2: J0k3rF4c3_FD (small blind) collected ($13.30)
Seat 3: Fredstar56 (big blind) folded before Flop
Seat 4: FTPbannedMe folded on the Flop
Seat 5: stan_09319 folded before Flop (didn't bet)
Seat 6: matiko09 folded before Flop (didn't bet)
Seat 7: Mister_b44 folded before Flop (didn't bet)
Seat 8: chaps1988 folded before Flop (didn't bet)
Seat 9: Spid1 folded before Flop (didn't bet)





PokerStars Hand #153066114063:  Hold'em No Limit ($0.50/$1.00 USD) - 2016/05/09 16:00:11 CET [2016/05/09 10:00:11 ET]
Table 'Terpsichore' 9-max Seat #2 is the button
Seat 1: ipashutapkom ($50.12 in chips) 
Seat 2: J0k3rF4c3_FD ($182.66 in chips) 
Seat 3: matiko09 ($105.87 in chips) 
Seat 5: mycka86 ($109.27 in chips) 
Seat 6: Filojoes ($110.09 in chips) 
Seat 7: xhinostrabli ($104.52 in chips) 
Seat 9: FTPbannedMe ($101.50 in chips) 
matiko09: posts small blind $0.50
mycka86: posts big blind $1
*** HOLE CARDS ***
Dealt to matiko09 [8c 9c]
Filojoes: folds 
xhinostrabli: raises $2 to $3
FTPbannedMe: folds 
ipashutapkom: raises $6 to $9
J0k3rF4c3_FD: folds 
matiko09: folds 
mycka86: folds 
xhinostrabli: folds 
Uncalled bet ($6) returned to ipashutapkom
ipashutapkom collected $7.50 from pot
ipashutapkom: doesn't show hand 
*** SUMMARY ***
Total pot $7.50 | Rake $0 
Seat 1: ipashutapkom collected ($7.50)
Seat 2: J0k3rF4c3_FD (button) folded before Flop (didn't bet)
Seat 3: matiko09 (small blind) folded before Flop
Seat 5: mycka86 (big blind) folded before Flop
Seat 6: Filojoes folded before Flop (didn't bet)
Seat 7: xhinostrabli folded before Flop
Seat 9: FTPbannedMe folded before Flop (didn't bet)





PokerStars Hand #153066120467:  Hold'em No Limit ($0.50/$1.00 USD) - 2016/05/09 16:00:24 CET [2016/05/09 10:00:24 ET]
Table 'Reiss' 9-max Seat #5 is the button
Seat 1: Dickyxxx ($191.17 in chips) 
Seat 2: mycka86 ($114.50 in chips) 
Seat 4: MichaLabam ($141.76 in chips) 
Seat 5: matiko09 ($101.04 in chips) 
Seat 6: Spid1 ($124.93 in chips) 
Seat 7: nubpoker ($107.64 in chips) 
Seat 8: Filojoes ($188.68 in chips) 
Seat 9: Aghmir77 ($105.46 in chips) 
Spid1: posts small blind $0.50
nubpoker: posts big blind $1
*** HOLE CARDS ***
Dealt to matiko09 [Kh 5h]
Filojoes: folds 
Aghmir77: folds 
Dickyxxx: folds 
mycka86: folds 
MichaLabam: folds 
matiko09: raises $1.27 to $2.27
Spid1: folds 
nubpoker: folds 
Uncalled bet ($1.27) returned to matiko09
matiko09 collected $2.50 from pot
matiko09: doesn't show hand 
*** SUMMARY ***
Total pot $2.50 | Rake $0 
Seat 1: Dickyxxx folded before Flop (didn't bet)
Seat 2: mycka86 folded before Flop (didn't bet)
Seat 4: MichaLabam folded before Flop (didn't bet)
Seat 5: matiko09 (button) collected ($2.50)
Seat 6: Spid1 (small blind) folded before Flop
Seat 7: nubpoker (big blind) folded before Flop
Seat 8: Filojoes folded before Flop (didn't bet)
Seat 9: Aghmir77 folded before Flop (didn't bet)





PokerStars Hand #153066121621:  Hold'em No Limit ($0.50/$1.00 USD) - 2016/05/09 16:00:27 CET [2016/05/09 10:00:27 ET]
Table 'Mentha' 9-max Seat #3 is the button
Seat 2: guoweiAA ($221.95 in chips) 
Seat 3: r4mz3s ($101.66 in chips) 
Seat 4: duggy2016 ($80.39 in chips) 
Seat 5: mycka86 ($119.69 in chips) 
Seat 6: Filojoes ($153.04 in chips) 
Seat 7: matiko09 ($108.85 in chips) 
Seat 8: Chef-Zizou ($86.32 in chips) 
Seat 9: Dickyxxx ($100 in chips) 
duggy2016: posts small blind $0.50
mycka86: posts big blind $1
*** HOLE CARDS ***
Dealt to matiko09 [Ts 6s]
Filojoes: folds 
Filojoes leaves the table
nubpoker joins the table at seat #6 
matiko09: folds 
Chef-Zizou: folds 
Dickyxxx: folds 
guoweiAA: folds 
r4mz3s: folds 
duggy2016: folds 
Uncalled bet ($0.50) returned to mycka86
mycka86 collected $1 from pot
*** SUMMARY ***
Total pot $1 | Rake $0 
Seat 2: guoweiAA folded before Flop (didn't bet)
Seat 3: r4mz3s (button) folded before Flop (didn't bet)
Seat 4: duggy2016 (small blind) folded before Flop
Seat 5: mycka86 (big blind) collected ($1)
Seat 6: Filojoes folded before Flop (didn't bet)
Seat 7: matiko09 folded before Flop (didn't bet)
Seat 8: Chef-Zizou folded before Flop (didn't bet)
Seat 9: Dickyxxx folded before Flop (didn't bet)





PokerStars Hand #153066125384:  Hold'em No Limit ($1/$2 USD) - 2016/05/09 16:00:34 CET [2016/05/09 10:00:34 ET]
Table 'Luda' 9-max Seat #6 is the button
Seat 1: stan_09319 ($422.99 in chips) 
Seat 2: matiko09 ($200 in chips) 
Seat 3: Monsthand ($435.55 in chips) 
Seat 4: Igoriah ($261.80 in chips) 
Seat 5: J0k3rF4c3_FD ($200 in chips) 
Seat 6: Iggso ($200 in chips) 
Seat 8: ramseyg117 ($266.78 in chips) 
Seat 9: solano20000 ($170.54 in chips) 
ramseyg117: posts small blind $1
solano20000: posts big blind $2
*** HOLE CARDS ***
Dealt to matiko09 [Qd Jc]
stan_09319: folds 
matiko09: raises $3 to $5
Monsthand: folds 
Igoriah: folds 
J0k3rF4c3_FD: calls $5
Iggso: folds 
ramseyg117: calls $4
solano20000: calls $3
*** FLOP *** [Jd 4h 6h]
ramseyg117: checks 
solano20000: checks 
matiko09: bets $12
J0k3rF4c3_FD: folds 
ramseyg117: folds 
solano20000: calls $12
*** TURN *** [Jd 4h 6h] [Qh]
solano20000: checks 
matiko09: bets $23
solano20000: folds 
Uncalled bet ($23) returned to matiko09
matiko09 collected $41.80 from pot
matiko09: doesn't show hand 
*** SUMMARY ***
Total pot $44 | Rake $2.20 
Board [Jd 4h 6h Qh]
Seat 1: stan_09319 folded before Flop (didn't bet)
Seat 2: matiko09 collected ($41.80)
Seat 3: Monsthand folded before Flop (didn't bet)
Seat 4: Igoriah folded before Flop (didn't bet)
Seat 5: J0k3rF4c3_FD folded on the Flop
Seat 6: Iggso (button) folded before Flop (didn't bet)
Seat 8: ramseyg117 (small blind) folded on the Flop
Seat 9: solano20000 (big blind) folded on the Turn





PokerStars Hand #153066131456:  Hold'em No Limit ($0.50/$1.00 USD) - 2016/05/09 16:00:46 CET [2016/05/09 10:00:46 ET]
Table 'Mentha' 9-max Seat #4 is the button
Seat 2: guoweiAA ($221.95 in chips) 
Seat 3: r4mz3s ($101.66 in chips) 
Seat 4: duggy2016 ($79.89 in chips) 
Seat 5: mycka86 ($120.19 in chips) 
Seat 6: nubpoker ($100 in chips) 
Seat 7: matiko09 ($108.85 in chips) 
Seat 8: Chef-Zizou ($86.32 in chips) 
Seat 9: Dickyxxx ($100 in chips) 
mycka86: posts small blind $0.50
nubpoker: posts big blind $1
*** HOLE CARDS ***
Dealt to matiko09 [3s 5h]
matiko09: folds 
Chef-Zizou: calls $1
Dickyxxx: folds 
guoweiAA: folds 
r4mz3s: folds 
duggy2016: folds 
mycka86: raises $3.50 to $4.50
nubpoker: folds 
Chef-Zizou: calls $3.50
*** FLOP *** [7s 8h 3h]
mycka86: bets $6.50
Chef-Zizou: folds 
Uncalled bet ($6.50) returned to mycka86
mycka86 collected $9.50 from pot
*** SUMMARY ***
Total pot $10 | Rake $0.50 
Board [7s 8h 3h]
Seat 2: guoweiAA folded before Flop (didn't bet)
Seat 3: r4mz3s folded before Flop (didn't bet)
Seat 4: duggy2016 (button) folded before Flop (didn't bet)
Seat 5: mycka86 (small blind) collected ($9.50)
Seat 6: nubpoker (big blind) folded before Flop
Seat 7: matiko09 folded before Flop (didn't bet)
Seat 8: Chef-Zizou folded on the Flop
Seat 9: Dickyxxx folded before Flop (didn't bet)





PokerStars Hand #153066134185:  Hold'em No Limit ($1/$2 USD) - 2016/05/09 16:00:51 CET [2016/05/09 10:00:51 ET]
Table 'Celaeno II' 9-max Seat #2 is the button
Seat 1: Li Shaobo ($283.75 in chips) 
Seat 2: J0k3rF4c3_FD ($231.98 in chips) 
Seat 3: Fredstar56 ($119.31 in chips) 
Seat 4: FTPbannedMe ($304.40 in chips) 
Seat 5: stan_09319 ($200 in chips) 
Seat 6: matiko09 ($304.30 in chips) 
Seat 7: Mister_b44 ($89.07 in chips) 
Seat 9: Spid1 ($205 in chips) 
Fredstar56: posts small blind $1
FTPbannedMe: posts big blind $2
*** HOLE CARDS ***
Dealt to matiko09 [2d 4d]
stan_09319: folds 
matiko09: folds 
Mister_b44: folds 
Spid1: folds 
Li Shaobo: folds 
J0k3rF4c3_FD: raises $3 to $5
Fredstar56: folds 
FTPbannedMe: folds 
Uncalled bet ($3) returned to J0k3rF4c3_FD
J0k3rF4c3_FD collected $5 from pot
J0k3rF4c3_FD: doesn't show hand 
*** SUMMARY ***
Total pot $5 | Rake $0 
Seat 1: Li Shaobo folded before Flop (didn't bet)
Seat 2: J0k3rF4c3_FD (button) collected ($5)
Seat 3: Fredstar56 (small blind) folded before Flop
Seat 4: FTPbannedMe (big blind) folded before Flop
Seat 5: stan_09319 folded before Flop (didn't bet)
Seat 6: matiko09 folded before Flop (didn't bet)
Seat 7: Mister_b44 folded before Flop (didn't bet)
Seat 9: Spid1 folded before Flop (didn't bet)





PokerStars Hand #153066138948:  Hold'em No Limit ($0.50/$1.00 USD) - 2016/05/09 16:01:00 CET [2016/05/09 10:01:00 ET]
Table 'Hajek' 9-max Seat #1 is the button
Seat 1: Mukhin1 ($100 in chips) 
Seat 2: Spid1 ($100 in chips) 
Seat 3: mycka86 ($100 in chips) 
Seat 4: LRVAV7 ($69.43 in chips) 
Seat 5: ozone2003 ($100 in chips) 
Seat 6: Filojoes ($103.10 in chips) 
Seat 8: Kukuryzka ($100 in chips) 
Seat 9: matiko09 ($100 in chips) 
Spid1: posts small blind $0.50
mycka86: posts big blind $1
Monsthand: sits out 
Mukhin1: posts the ante $0.20
Spid1: posts the ante $0.20
mycka86: posts the ante $0.20
LRVAV7: posts the ante $0.20
ozone2003: posts the ante $0.20
Filojoes: posts the ante $0.20
Kukuryzka: posts the ante $0.20
matiko09: posts the ante $0.20
*** HOLE CARDS ***
Dealt to matiko09 [Kh 2h]
LRVAV7: folds 
Monsthand leaves the table
ozone2003: folds 
Filojoes: folds 
Kukuryzka: folds 
DancerNN1 joins the table at seat #7 
matiko09: folds 
Mukhin1: raises $1.50 to $2.50
Spid1: folds 
mycka86: raises $6.50 to $9
Mukhin1: calls $6.50
*** FLOP *** [Qd 6c 6s]
mycka86: checks 
Mukhin1: checks 
*** TURN *** [Qd 6c 6s] [8c]
mycka86: checks 
Mukhin1: bets $11.84
mycka86: folds 
Uncalled bet ($11.84) returned to Mukhin1
Mukhin1 collected $19.10 from pot
Mukhin1: doesn't show hand 
*** SUMMARY ***
Total pot $20.10 | Rake $1 
Board [Qd 6c 6s 8c]
Seat 1: Mukhin1 (button) collected ($19.10)
Seat 2: Spid1 (small blind) folded before Flop
Seat 3: mycka86 (big blind) folded on the Turn
Seat 4: LRVAV7 folded before Flop (didn't bet)
Seat 5: ozone2003 folded before Flop (didn't bet)
Seat 6: Filojoes folded before Flop (didn't bet)
Seat 8: Kukuryzka folded before Flop (didn't bet)
Seat 9: matiko09 folded before Flop (didn't bet)





PokerStars Hand #153066140137:  Hold'em No Limit ($0.50/$1.00 USD) - 2016/05/09 16:01:03 CET [2016/05/09 10:01:03 ET]
Table 'Merga II' 9-max Seat #7 is the button
Seat 1: luckyluke24 ($24.08 in chips) 
Seat 2: Filojoes ($101.68 in chips) 
Seat 3: xhinostrabli ($29.51 in chips) 
Seat 4: nubpoker ($104.62 in chips) 
Seat 5: LRVAV7 ($248.13 in chips) 
Seat 6: Spid1 ($285.33 in chips) 
Seat 7: matiko09 ($150.29 in chips) 
luckyluke24: posts small blind $0.50
Filojoes: posts big blind $1
*** HOLE CARDS ***
Dealt to matiko09 [As 6d]
xhinostrabli: folds 
nubpoker: folds 
LRVAV7: folds 
Spid1: folds 
matiko09: raises $1.27 to $2.27
luckyluke24: folds 
Filojoes: folds 
Uncalled bet ($1.27) returned to matiko09
matiko09 collected $2.50 from pot
matiko09: doesn't show hand 
*** SUMMARY ***
Total pot $2.50 | Rake $0 
Seat 1: luckyluke24 (small blind) folded before Flop
Seat 2: Filojoes (big blind) folded before Flop
Seat 3: xhinostrabli folded before Flop (didn't bet)
Seat 4: nubpoker folded before Flop (didn't bet)
Seat 5: LRVAV7 folded before Flop (didn't bet)
Seat 6: Spid1 folded before Flop (didn't bet)
Seat 7: matiko09 (button) collected ($2.50)





PokerStars Hand #153066142822:  Hold'em No Limit ($0.50/$1.00 USD) - 2016/05/09 16:01:07 CET [2016/05/09 10:01:07 ET]
Table 'Reiss' 9-max Seat #6 is the button
Seat 1: Dickyxxx ($191.17 in chips) 
Seat 2: mycka86 ($114.50 in chips) 
Seat 4: MichaLabam ($141.76 in chips) 
Seat 5: matiko09 ($102.54 in chips) 
Seat 6: Spid1 ($124.43 in chips) 
Seat 7: nubpoker ($106.64 in chips) 
Seat 8: Filojoes ($188.68 in chips) 
Seat 9: Aghmir77 ($105.46 in chips) 
nubpoker: posts small blind $0.50
Filojoes: posts big blind $1
*** HOLE CARDS ***
Dealt to matiko09 [Qc 5c]
Aghmir77: folds 
Dickyxxx: folds 
mycka86: raises $2 to $3
MichaLabam: folds 
matiko09: folds 
Spid1: folds 
nubpoker: calls $2.50
Filojoes: folds 
*** FLOP *** [Ad Kc 6d]
nubpoker: checks 
mycka86: bets $4.50
nubpoker: folds 
Uncalled bet ($4.50) returned to mycka86
mycka86 collected $6.65 from pot
*** SUMMARY ***
Total pot $7 | Rake $0.35 
Board [Ad Kc 6d]
Seat 1: Dickyxxx folded before Flop (didn't bet)
Seat 2: mycka86 collected ($6.65)
Seat 4: MichaLabam folded before Flop (didn't bet)
Seat 5: matiko09 folded before Flop (didn't bet)
Seat 6: Spid1 (button) folded before Flop (didn't bet)
Seat 7: nubpoker (small blind) folded on the Flop
Seat 8: Filojoes (big blind) folded before Flop
Seat 9: Aghmir77 folded before Flop (didn't bet)





PokerStars Hand #153066145004:  Hold'em No Limit ($0.50/$1.00 USD) - 2016/05/09 16:01:11 CET [2016/05/09 10:01:11 ET]
Table 'Alderamin' 9-max Seat #4 is the button
Seat 1: r4mz3s ($100 in chips) 
Seat 2: Filojoes ($123.43 in chips) 
Seat 3: NSL0808 ($102.68 in chips) 
Seat 4: matiko09 ($100 in chips) 
Seat 5: tanmayh ($89.03 in chips) 
Seat 6: Spid1 ($118.48 in chips) 
Seat 7: azzad2007 ($102.44 in chips) 
Seat 8: nubpoker ($102.25 in chips) 
Seat 9: ipashutapkom ($40 in chips) 
tanmayh: posts small blind $0.50
Spid1: posts big blind $1
*** HOLE CARDS ***
Dealt to matiko09 [2h 5c]
azzad2007: folds 
nubpoker: folds 
ipashutapkom: folds 
r4mz3s: folds 
Filojoes: folds 
NSL0808: calls $1
matiko09: folds 
tanmayh: calls $0.50
Spid1: checks 
*** FLOP *** [Jc Ad 6c]
tanmayh: checks 
Spid1: checks 
NSL0808: checks 
*** TURN *** [Jc Ad 6c] [5d]
tanmayh: bets $3
Spid1: folds 
NSL0808: calls $3
*** RIVER *** [Jc Ad 6c 5d] [3c]
tanmayh: bets $9
NSL0808: raises $12 to $21
tanmayh: calls $12
*** SHOW DOWN ***
NSL0808: shows [Jd 2d] (a pair of Jacks)
tanmayh: shows [Ac 6d] (two pair, Aces and Sixes)
tanmayh collected $48.50 from pot
*** SUMMARY ***
Total pot $51 | Rake $2.50 
Board [Jc Ad 6c 5d 3c]
Seat 1: r4mz3s folded before Flop (didn't bet)
Seat 2: Filojoes folded before Flop (didn't bet)
Seat 3: NSL0808 showed [Jd 2d] and lost with a pair of Jacks
Seat 4: matiko09 (button) folded before Flop (didn't bet)
Seat 5: tanmayh (small blind) showed [Ac 6d] and won ($48.50) with two pair, Aces and Sixes
Seat 6: Spid1 (big blind) folded on the Turn
Seat 7: azzad2007 folded before Flop (didn't bet)
Seat 8: nubpoker folded before Flop (didn't bet)
Seat 9: ipashutapkom folded before Flop (didn't bet)





PokerStars Hand #153066147387:  Hold'em No Limit ($0.50/$1.00 USD) - 2016/05/09 16:01:16 CET [2016/05/09 10:01:16 ET]
Table 'Terpsichore' 9-max Seat #3 is the button
Seat 1: ipashutapkom ($54.62 in chips) 
Seat 2: J0k3rF4c3_FD ($182.66 in chips) 
Seat 3: matiko09 ($105.37 in chips) 
Seat 5: mycka86 ($108.27 in chips) 
Seat 7: xhinostrabli ($101.52 in chips) 
Seat 9: FTPbannedMe ($101.50 in chips) 
mycka86: posts small blind $0.50
Filojoes: is sitting out 
xhinostrabli: posts big blind $1
Kiosk230472: sits out 
*** HOLE CARDS ***
Dealt to matiko09 [7s 9h]
Filojoes leaves the table
r4mz3s joins the table at seat #6 
FTPbannedMe: folds 
ipashutapkom: folds 
J0k3rF4c3_FD: folds 
matiko09: folds 
mycka86: raises $1.75 to $2.75
xhinostrabli: calls $1.75
*** FLOP *** [Kc 9s Tc]
mycka86: bets $3.50
maxxmeister leaves the table
xhinostrabli: folds 
Uncalled bet ($3.50) returned to mycka86
mycka86 collected $5.22 from pot
*** SUMMARY ***
Total pot $5.50 | Rake $0.28 
Board [Kc 9s Tc]
Seat 1: ipashutapkom folded before Flop (didn't bet)
Seat 2: J0k3rF4c3_FD folded before Flop (didn't bet)
Seat 3: matiko09 (button) folded before Flop (didn't bet)
Seat 5: mycka86 (small blind) collected ($5.22)
Seat 7: xhinostrabli (big blind) folded on the Flop
Seat 9: FTPbannedMe folded before Flop (didn't bet)





PokerStars Hand #153066154214:  Hold'em No Limit ($1/$2 USD) - 2016/05/09 16:01:29 CET [2016/05/09 10:01:29 ET]
Table 'Celaeno II' 9-max Seat #3 is the button
Seat 1: Li Shaobo ($283.75 in chips) 
Seat 2: J0k3rF4c3_FD ($234.98 in chips) 
Seat 3: Fredstar56 ($118.31 in chips) 
Seat 4: FTPbannedMe ($302.40 in chips) 
Seat 6: matiko09 ($304.30 in chips) 
Seat 7: Mister_b44 ($89.07 in chips) 
Seat 9: Spid1 ($205 in chips) 
FTPbannedMe: posts small blind $1
stan_09319: is sitting out 
matiko09: posts big blind $2
*** HOLE CARDS ***
Dealt to matiko09 [7s Qh]
Mister_b44: folds 
Spid1: folds 
Li Shaobo: folds 
J0k3rF4c3_FD: folds 
Fredstar56: calls $2
FTPbannedMe: calls $1
matiko09: checks 
*** FLOP *** [Ks Ad As]
FTPbannedMe: checks 
matiko09: checks 
Fredstar56: bets $2.85
FTPbannedMe: folds 
matiko09: folds 
Uncalled bet ($2.85) returned to Fredstar56
Fredstar56 collected $5.70 from pot
*** SUMMARY ***
Total pot $6 | Rake $0.30 
Board [Ks Ad As]
Seat 1: Li Shaobo folded before Flop (didn't bet)
Seat 2: J0k3rF4c3_FD folded before Flop (didn't bet)
Seat 3: Fredstar56 (button) collected ($5.70)
Seat 4: FTPbannedMe (small blind) folded on the Flop
Seat 6: matiko09 (big blind) folded on the Flop
Seat 7: Mister_b44 folded before Flop (didn't bet)
Seat 9: Spid1 folded before Flop (didn't bet)





PokerStars Hand #153066156758:  Hold'em No Limit ($0.50/$1.00 USD) - 2016/05/09 16:01:33 CET [2016/05/09 10:01:33 ET]
Table 'Merga II' 9-max Seat #1 is the button
Seat 1: luckyluke24 ($23.58 in chips) 
Seat 2: Filojoes ($100.68 in chips) 
Seat 3: xhinostrabli ($29.51 in chips) 
Seat 4: nubpoker ($104.62 in chips) 
Seat 5: LRVAV7 ($248.13 in chips) 
Seat 6: Spid1 ($285.33 in chips) 
Seat 7: matiko09 ($151.79 in chips) 
Filojoes: posts small blind $0.50
xhinostrabli: posts big blind $1
GrandOldFart: sits out 
*** HOLE CARDS ***
Dealt to matiko09 [6c Qc]
nubpoker: folds 
LRVAV7: raises $2 to $3
Spid1: folds 
matiko09: folds 
luckyluke24: folds 
Filojoes: folds 
xhinostrabli: calls $2
*** FLOP *** [Qh 2h 8h]
xhinostrabli: checks 
LRVAV7: bets $4
xhinostrabli: calls $4
*** TURN *** [Qh 2h 8h] [3c]
xhinostrabli: checks 
LRVAV7: bets $13.78
xhinostrabli: folds 
Uncalled bet ($13.78) returned to LRVAV7
LRVAV7 collected $13.78 from pot
LRVAV7: doesn't show hand 
*** SUMMARY ***
Total pot $14.50 | Rake $0.72 
Board [Qh 2h 8h 3c]
Seat 1: luckyluke24 (button) folded before Flop (didn't bet)
Seat 2: Filojoes (small blind) folded before Flop
Seat 3: xhinostrabli (big blind) folded on the Turn
Seat 4: nubpoker folded before Flop (didn't bet)
Seat 5: LRVAV7 collected ($13.78)
Seat 6: Spid1 folded before Flop (didn't bet)
Seat 7: matiko09 folded before Flop (didn't bet)





PokerStars Hand #153066159025:  Hold'em No Limit ($1/$2 USD) - 2016/05/09 16:01:38 CET [2016/05/09 10:01:38 ET]
Table 'Hagar II' 9-max Seat #2 is the button
Seat 1: azzad2007 ($258.62 in chips) 
Seat 2: billynomates ($104.56 in chips) 
Seat 3: stan_09319 ($200 in chips) 
Seat 4: matiko09 ($247.15 in chips) 
Seat 5: darren1031 ($160 in chips) 
Seat 6: Piniker85 ($854.47 in chips) 
Seat 7: Monsthand ($200 in chips) 
Seat 8: J0k3rF4c3_FD ($325.55 in chips) 
stan_09319: posts small blind $1
matiko09: posts big blind $2
*** HOLE CARDS ***
Dealt to matiko09 [8s 7h]
darren1031: folds 
darren1031 leaves the table
Piniker85: folds 
FTPbannedMe joins the table at seat #5 
Monsthand: folds 
J0k3rF4c3_FD: folds 
azzad2007: folds 
billynomates: calls $2
stan_09319: folds 
matiko09: checks 
*** FLOP *** [2s Ks 5s]
matiko09: checks 
billynomates: bets $2
matiko09: folds 
Uncalled bet ($2) returned to billynomates
billynomates collected $4.75 from pot
billynomates: doesn't show hand 
*** SUMMARY ***
Total pot $5 | Rake $0.25 
Board [2s Ks 5s]
Seat 1: azzad2007 folded before Flop (didn't bet)
Seat 2: billynomates (button) collected ($4.75)
Seat 3: stan_09319 (small blind) folded before Flop
Seat 4: matiko09 (big blind) folded on the Flop
Seat 5: darren1031 folded before Flop (didn't bet)
Seat 6: Piniker85 folded before Flop (didn't bet)
Seat 7: Monsthand folded before Flop (didn't bet)
Seat 8: J0k3rF4c3_FD folded before Flop (didn't bet)





PokerStars Hand #153066170032:  Hold'em No Limit ($0.50/$1.00 USD) - 2016/05/09 16:01:57 CET [2016/05/09 10:01:57 ET]
Table 'Reiss' 9-max Seat #7 is the button
Seat 1: Dickyxxx ($191.17 in chips) 
Seat 2: mycka86 ($118.15 in chips) 
Seat 4: MichaLabam ($141.76 in chips) 
Seat 5: matiko09 ($102.54 in chips) 
Seat 6: Spid1 ($124.43 in chips) 
Seat 7: nubpoker ($103.64 in chips) 
Seat 8: Filojoes ($187.68 in chips) 
Seat 9: Aghmir77 ($105.46 in chips) 
Filojoes: posts small blind $0.50
Aghmir77: posts big blind $1
*** HOLE CARDS ***
Dealt to matiko09 [9h Jh]
Dickyxxx: folds 
mycka86: folds 
MichaLabam: folds 
matiko09: raises $2 to $3
Spid1: raises $6 to $9
nubpoker: raises $11 to $20
Filojoes: folds 
Aghmir77: folds 
matiko09: folds 
Spid1: raises $104.43 to $124.43 and is all-in
nubpoker: folds 
Uncalled bet ($104.43) returned to Spid1
Spid1 collected $44.50 from pot
Spid1: doesn't show hand 
*** SUMMARY ***
Total pot $44.50 | Rake $0 
Seat 1: Dickyxxx folded before Flop (didn't bet)
Seat 2: mycka86 folded before Flop (didn't bet)
Seat 4: MichaLabam folded before Flop (didn't bet)
Seat 5: matiko09 folded before Flop
Seat 6: Spid1 collected ($44.50)
Seat 7: nubpoker (button) folded before Flop
Seat 8: Filojoes (small blind) folded before Flop
Seat 9: Aghmir77 (big blind) folded before Flop





PokerStars Hand #153066171854:  Hold'em No Limit ($1/$2 USD) - 2016/05/09 16:02:00 CET [2016/05/09 10:02:00 ET]
Table 'Luda' 9-max Seat #8 is the button
Seat 1: stan_09319 ($422.99 in chips) 
Seat 2: matiko09 ($224.80 in chips) 
Seat 3: Monsthand ($435.55 in chips) 
Seat 4: Igoriah ($261.80 in chips) 
Seat 5: J0k3rF4c3_FD ($200 in chips) 
Seat 6: Iggso ($200 in chips) 
Seat 8: ramseyg117 ($261.78 in chips) 
Seat 9: solano20000 ($153.54 in chips) 
solano20000: posts small blind $1
stan_09319: posts big blind $2
*** HOLE CARDS ***
Dealt to matiko09 [Js 7s]
matiko09: folds 
Monsthand: folds 
Igoriah: folds 
J0k3rF4c3_FD: folds 
Iggso: folds 
ramseyg117: raises $2 to $4
solano20000: calls $3
stan_09319: folds 
*** FLOP *** [Th 6c 2h]
solano20000: checks 
ramseyg117: bets $2
solano20000: calls $2
*** TURN *** [Th 6c 2h] [Ts]
solano20000: checks 
ramseyg117: bets $13.30
solano20000: calls $13.30
*** RIVER *** [Th 6c 2h Ts] [Jd]
solano20000: checks 
ramseyg117: bets $38.57
solano20000: folds 
Uncalled bet ($38.57) returned to ramseyg117
ramseyg117 collected $38.57 from pot
ramseyg117: doesn't show hand 
*** SUMMARY ***
Total pot $40.60 | Rake $2.03 
Board [Th 6c 2h Ts Jd]
Seat 1: stan_09319 (big blind) folded before Flop
Seat 2: matiko09 folded before Flop (didn't bet)
Seat 3: Monsthand folded before Flop (didn't bet)
Seat 4: Igoriah folded before Flop (didn't bet)
Seat 5: J0k3rF4c3_FD folded before Flop (didn't bet)
Seat 6: Iggso folded before Flop (didn't bet)
Seat 8: ramseyg117 (button) collected ($38.57)
Seat 9: solano20000 (small blind) folded on the River





PokerStars Hand #153066175369:  Hold'em No Limit ($1/$2 USD) - 2016/05/09 16:02:07 CET [2016/05/09 10:02:07 ET]
Table 'Hagar II' 9-max Seat #3 is the button
Seat 1: azzad2007 ($258.62 in chips) 
Seat 2: billynomates ($107.31 in chips) 
Seat 3: stan_09319 ($200 in chips) 
Seat 4: matiko09 ($245.15 in chips) 
Seat 6: Piniker85 ($854.47 in chips) 
Seat 7: Monsthand ($200 in chips) 
Seat 8: J0k3rF4c3_FD ($325.55 in chips) 
matiko09: posts small blind $1
Piniker85: posts big blind $2
*** HOLE CARDS ***
Dealt to matiko09 [Ah 7d]
Monsthand: raises $4 to $6
FTPbannedMe leaves the table
J0k3rF4c3_FD: folds 
azzad2007: folds 
billynomates: folds 
stan_09319: folds 
matiko09: folds 
Piniker85: folds 
Uncalled bet ($4) returned to Monsthand
Monsthand collected $5 from pot
Monsthand: doesn't show hand 
*** SUMMARY ***
Total pot $5 | Rake $0 
Seat 1: azzad2007 folded before Flop (didn't bet)
Seat 2: billynomates folded before Flop (didn't bet)
Seat 3: stan_09319 (button) folded before Flop (didn't bet)
Seat 4: matiko09 (small blind) folded before Flop
Seat 6: Piniker85 (big blind) folded before Flop
Seat 7: Monsthand collected ($5)
Seat 8: J0k3rF4c3_FD folded before Flop (didn't bet)





PokerStars Hand #153066181015:  Hold'em No Limit ($1/$2 USD) - 2016/05/09 16:02:16 CET [2016/05/09 10:02:16 ET]
Table 'Celaeno II' 9-max Seat #4 is the button
Seat 1: Li Shaobo ($283.75 in chips) 
Seat 2: J0k3rF4c3_FD ($234.98 in chips) 
Seat 3: Fredstar56 ($122.01 in chips) 
Seat 4: FTPbannedMe ($300.40 in chips) 
Seat 6: matiko09 ($302.30 in chips) 
Seat 7: Mister_b44 ($89.07 in chips) 
Seat 9: Spid1 ($205 in chips) 
matiko09: posts small blind $1
Mister_b44: posts big blind $2
*** HOLE CARDS ***
Dealt to matiko09 [8h Ac]
Spid1: folds 
Li Shaobo: folds 
J0k3rF4c3_FD: folds 
Fredstar56: folds 
FTPbannedMe: folds 
matiko09: raises $3 to $5
Mister_b44: raises $10 to $15
matiko09: folds 
Uncalled bet ($10) returned to Mister_b44
Mister_b44 collected $10 from pot
Mister_b44: doesn't show hand 
*** SUMMARY ***
Total pot $10 | Rake $0 
Seat 1: Li Shaobo folded before Flop (didn't bet)
Seat 2: J0k3rF4c3_FD folded before Flop (didn't bet)
Seat 3: Fredstar56 folded before Flop (didn't bet)
Seat 4: FTPbannedMe (button) folded before Flop (didn't bet)
Seat 6: matiko09 (small blind) folded before Flop
Seat 7: Mister_b44 (big blind) collected ($10)
Seat 9: Spid1 folded before Flop (didn't bet)





PokerStars Hand #153066187995:  Hold'em No Limit ($0.50/$1.00 USD) - 2016/05/09 16:02:28 CET [2016/05/09 10:02:28 ET]
Table 'Alderamin' 9-max Seat #5 is the button
Seat 1: r4mz3s ($100 in chips) 
Seat 2: Filojoes ($123.43 in chips) 
Seat 3: NSL0808 ($77.68 in chips) 
Seat 4: matiko09 ($100 in chips) 
Seat 5: tanmayh ($112.53 in chips) 
Seat 6: Spid1 ($117.48 in chips) 
Seat 7: azzad2007 ($102.44 in chips) 
Seat 8: nubpoker ($102.25 in chips) 
Seat 9: ipashutapkom ($40 in chips) 
Spid1: posts small blind $0.50
azzad2007: posts big blind $1
*** HOLE CARDS ***
Dealt to matiko09 [Qc Js]
nubpoker: folds 
ipashutapkom: folds 
r4mz3s: folds 
Filojoes: folds 
NSL0808: folds 
matiko09: raises $1.50 to $2.50
tanmayh: calls $2.50
Spid1: folds 
azzad2007: folds 
*** FLOP *** [8d 2d 2h]
matiko09: bets $4
tanmayh: folds 
Uncalled bet ($4) returned to matiko09
matiko09 collected $6.18 from pot
matiko09: doesn't show hand 
*** SUMMARY ***
Total pot $6.50 | Rake $0.32 
Board [8d 2d 2h]
Seat 1: r4mz3s folded before Flop (didn't bet)
Seat 2: Filojoes folded before Flop (didn't bet)
Seat 3: NSL0808 folded before Flop (didn't bet)
Seat 4: matiko09 collected ($6.18)
Seat 5: tanmayh (button) folded on the Flop
Seat 6: Spid1 (small blind) folded before Flop
Seat 7: azzad2007 (big blind) folded before Flop
Seat 8: nubpoker folded before Flop (didn't bet)
Seat 9: ipashutapkom folded before Flop (didn't bet)





PokerStars Hand #153066188805:  Hold'em No Limit ($1/$2 USD) - 2016/05/09 16:02:30 CET [2016/05/09 10:02:30 ET]
Table 'Hagar II' 9-max Seat #4 is the button
Seat 1: azzad2007 ($258.62 in chips) 
Seat 2: billynomates ($107.31 in chips) 
Seat 3: stan_09319 ($200 in chips) 
Seat 4: matiko09 ($244.15 in chips) 
Seat 6: Piniker85 ($852.47 in chips) 
Seat 7: Monsthand ($203 in chips) 
Seat 8: J0k3rF4c3_FD ($325.55 in chips) 
Piniker85: posts small blind $1
Monsthand: posts big blind $2
*** HOLE CARDS ***
Dealt to matiko09 [6h Td]
J0k3rF4c3_FD: raises $3 to $5
azzad2007: folds 
billynomates: folds 
stan_09319: calls $5
matiko09: folds 
Piniker85: folds 
Monsthand: folds 
*** FLOP *** [7h 4s 3s]
J0k3rF4c3_FD: bets $7.18
stan_09319: folds 
Uncalled bet ($7.18) returned to J0k3rF4c3_FD
J0k3rF4c3_FD collected $12.35 from pot
J0k3rF4c3_FD: doesn't show hand 
*** SUMMARY ***
Total pot $13 | Rake $0.65 
Board [7h 4s 3s]
Seat 1: azzad2007 folded before Flop (didn't bet)
Seat 2: billynomates folded before Flop (didn't bet)
Seat 3: stan_09319 folded on the Flop
Seat 4: matiko09 (button) folded before Flop (didn't bet)
Seat 6: Piniker85 (small blind) folded before Flop
Seat 7: Monsthand (big blind) folded before Flop
Seat 8: J0k3rF4c3_FD collected ($12.35)





PokerStars Hand #153066192012:  Hold'em No Limit ($1/$2 USD) - 2016/05/09 16:02:36 CET [2016/05/09 10:02:36 ET]
Table 'Celaeno II' 9-max Seat #6 is the button
Seat 1: Li Shaobo ($283.75 in chips) 
Seat 2: J0k3rF4c3_FD ($234.98 in chips) 
Seat 3: Fredstar56 ($122.01 in chips) 
Seat 4: FTPbannedMe ($300.40 in chips) 
Seat 6: matiko09 ($297.30 in chips) 
Seat 7: Mister_b44 ($94.07 in chips) 
Seat 9: Spid1 ($205 in chips) 
Mister_b44: posts small blind $1
Spid1: posts big blind $2
*** HOLE CARDS ***
Dealt to matiko09 [Tc Kd]
Li Shaobo: folds 
J0k3rF4c3_FD: folds 
Fredstar56: folds 
FTPbannedMe: folds 
matiko09: raises $2.54 to $4.54
Mister_b44: folds 
Spid1: folds 
Uncalled bet ($2.54) returned to matiko09
matiko09 collected $5 from pot
matiko09: doesn't show hand 
*** SUMMARY ***
Total pot $5 | Rake $0 
Seat 1: Li Shaobo folded before Flop (didn't bet)
Seat 2: J0k3rF4c3_FD folded before Flop (didn't bet)
Seat 3: Fredstar56 folded before Flop (didn't bet)
Seat 4: FTPbannedMe folded before Flop (didn't bet)
Seat 6: matiko09 (button) collected ($5)
Seat 7: Mister_b44 (small blind) folded before Flop
Seat 9: Spid1 (big blind) folded before Flop





PokerStars Hand #153066194198:  Hold'em No Limit ($0.50/$1.00 USD) - 2016/05/09 16:02:40 CET [2016/05/09 10:02:40 ET]
Table 'Hajek' 9-max Seat #2 is the button
Seat 1: Mukhin1 ($109.90 in chips) 
Seat 2: Spid1 ($100 in chips) 
Seat 3: mycka86 ($100 in chips) 
Seat 4: LRVAV7 ($69.23 in chips) 
Seat 5: ozone2003 ($100 in chips) 
Seat 6: Filojoes ($102.90 in chips) 
Seat 8: Kukuryzka ($99.80 in chips) 
Seat 9: matiko09 ($100 in chips) 
mycka86: posts small blind $0.50
LRVAV7: posts big blind $1
DancerNN1: sits out 
Mukhin1: posts the ante $0.20
Spid1: posts the ante $0.20
mycka86: posts the ante $0.20
LRVAV7: posts the ante $0.20
ozone2003: posts the ante $0.20
Filojoes: posts the ante $0.20
Kukuryzka: posts the ante $0.20
matiko09: posts the ante $0.20
*** HOLE CARDS ***
Dealt to matiko09 [9h 7h]
ozone2003: folds 
Filojoes: folds 
Kukuryzka: folds 
matiko09: raises $2 to $3
Mukhin1: folds 
Spid1: folds 
mycka86: folds 
LRVAV7: calls $2
*** FLOP *** [2d As Tc]
LRVAV7: checks 
matiko09: bets $4
LRVAV7: calls $4
*** TURN *** [2d As Tc] [8s]
LRVAV7: checks 
matiko09: bets $9
LRVAV7: calls $9
*** RIVER *** [2d As Tc 8s] [Kd]
LRVAV7: checks 
matiko09: checks 
*** SHOW DOWN ***
LRVAV7: shows [Ah 6h] (a pair of Aces)
matiko09: mucks hand 
LRVAV7 collected $32.40 from pot
*** SUMMARY ***
Total pot $34.10 | Rake $1.70 
Board [2d As Tc 8s Kd]
Seat 1: Mukhin1 folded before Flop (didn't bet)
Seat 2: Spid1 (button) folded before Flop (didn't bet)
Seat 3: mycka86 (small blind) folded before Flop
Seat 4: LRVAV7 (big blind) showed [Ah 6h] and won ($32.40) with a pair of Aces
Seat 5: ozone2003 folded before Flop (didn't bet)
Seat 6: Filojoes folded before Flop (didn't bet)
Seat 8: Kukuryzka folded before Flop (didn't bet)
Seat 9: matiko09 mucked [9h 7h]





PokerStars Hand #153066195878:  Hold'em No Limit ($0.50/$1.00 USD) - 2016/05/09 16:02:43 CET [2016/05/09 10:02:43 ET]
Table 'Terpsichore' 9-max Seat #5 is the button
Seat 1: ipashutapkom ($54.62 in chips) 
Seat 2: J0k3rF4c3_FD ($182.66 in chips) 
Seat 3: matiko09 ($105.37 in chips) 
Seat 5: mycka86 ($110.74 in chips) 
Seat 7: xhinostrabli ($98.77 in chips) 
Seat 8: Kiosk230472 ($130.86 in chips) 
Seat 9: FTPbannedMe ($101.50 in chips) 
r4mz3s will be allowed to play after the button
xhinostrabli: posts small blind $0.50
Kiosk230472: posts big blind $1
nubpoker: sits out 
*** HOLE CARDS ***
Dealt to matiko09 [9d Ad]
FTPbannedMe: folds 
ipashutapkom: raises $1.26 to $2.26
J0k3rF4c3_FD: folds 
matiko09: folds 
mycka86: folds 
xhinostrabli: folds 
Kiosk230472: calls $1.26
*** FLOP *** [9s 8c Kh]
Kiosk230472: bets $2
ipashutapkom: folds 
Uncalled bet ($2) returned to Kiosk230472
Kiosk230472 collected $4.77 from pot
Kiosk230472: doesn't show hand 
*** SUMMARY ***
Total pot $5.02 | Rake $0.25 
Board [9s 8c Kh]
Seat 1: ipashutapkom folded on the Flop
Seat 2: J0k3rF4c3_FD folded before Flop (didn't bet)
Seat 3: matiko09 folded before Flop (didn't bet)
Seat 5: mycka86 (button) folded before Flop (didn't bet)
Seat 7: xhinostrabli (small blind) folded before Flop
Seat 8: Kiosk230472 (big blind) collected ($4.77)
Seat 9: FTPbannedMe folded before Flop (didn't bet)





PokerStars Hand #153066198688:  Hold'em No Limit ($1/$2 USD) - 2016/05/09 16:02:48 CET [2016/05/09 10:02:48 ET]
Table 'Luda' 9-max Seat #9 is the button
Seat 1: stan_09319 ($420.99 in chips) 
Seat 2: matiko09 ($224.80 in chips) 
Seat 3: Monsthand ($435.55 in chips) 
Seat 4: Igoriah ($261.80 in chips) 
Seat 5: J0k3rF4c3_FD ($200 in chips) 
Seat 6: Iggso ($200 in chips) 
Seat 8: ramseyg117 ($281.05 in chips) 
Seat 9: solano20000 ($134.24 in chips) 
stan_09319: posts small blind $1
matiko09: posts big blind $2
chaps1988: sits out 
*** HOLE CARDS ***
Dealt to matiko09 [7d 4h]
Monsthand: folds 
Igoriah: folds 
J0k3rF4c3_FD: raises $3 to $5
Iggso: folds 
ramseyg117: folds 
solano20000: folds 
stan_09319: folds 
matiko09: folds 
Uncalled bet ($3) returned to J0k3rF4c3_FD
J0k3rF4c3_FD collected $5 from pot
J0k3rF4c3_FD: doesn't show hand 
*** SUMMARY ***
Total pot $5 | Rake $0 
Seat 1: stan_09319 (small blind) folded before Flop
Seat 2: matiko09 (big blind) folded before Flop
Seat 3: Monsthand folded before Flop (didn't bet)
Seat 4: Igoriah folded before Flop (didn't bet)
Seat 5: J0k3rF4c3_FD collected ($5)
Seat 6: Iggso folded before Flop (didn't bet)
Seat 8: ramseyg117 folded before Flop (didn't bet)
Seat 9: solano20000 (button) folded before Flop (didn't bet)





PokerStars Hand #153066201917:  Hold'em No Limit ($0.50/$1.00 USD) - 2016/05/09 16:02:53 CET [2016/05/09 10:02:53 ET]
Table 'Merga II' 9-max Seat #2 is the button
Seat 1: luckyluke24 ($23.58 in chips) 
Seat 2: Filojoes ($100.18 in chips) 
Seat 3: xhinostrabli ($22.51 in chips) 
Seat 4: nubpoker ($104.62 in chips) 
Seat 5: LRVAV7 ($254.91 in chips) 
Seat 6: Spid1 ($285.33 in chips) 
Seat 7: matiko09 ($151.79 in chips) 
xhinostrabli: posts small blind $0.50
nubpoker: posts big blind $1
GrandOldFart: sits out 
chaps1988: sits out 
*** HOLE CARDS ***
Dealt to matiko09 [4h Ad]
LRVAV7: folds 
Spid1: raises $2 to $3
matiko09: folds 
luckyluke24: folds 
Filojoes: folds 
xhinostrabli: calls $2.50
nubpoker: folds 
*** FLOP *** [7s 3s 6s]
xhinostrabli: checks 
Spid1: checks 
*** TURN *** [7s 3s 6s] [8d]
xhinostrabli: checks 
Spid1: checks 
*** RIVER *** [7s 3s 6s 8d] [7c]
xhinostrabli: checks 
Spid1: checks 
*** SHOW DOWN ***
xhinostrabli: shows [9d Ac] (a pair of Sevens)
Spid1: shows [Jd Ah] (a pair of Sevens - Ace+Jack kicker)
Spid1 collected $6.65 from pot
*** SUMMARY ***
Total pot $7 | Rake $0.35 
Board [7s 3s 6s 8d 7c]
Seat 1: luckyluke24 folded before Flop (didn't bet)
Seat 2: Filojoes (button) folded before Flop (didn't bet)
Seat 3: xhinostrabli (small blind) showed [9d Ac] and lost with a pair of Sevens
Seat 4: nubpoker (big blind) folded before Flop
Seat 5: LRVAV7 folded before Flop (didn't bet)
Seat 6: Spid1 showed [Jd Ah] and won ($6.65) with a pair of Sevens
Seat 7: matiko09 folded before Flop (didn't bet)





PokerStars Hand #153066204047:  Hold'em No Limit ($0.50/$1.00 USD) - 2016/05/09 16:02:57 CET [2016/05/09 10:02:57 ET]
Table 'Reiss' 9-max Seat #8 is the button
Seat 1: Dickyxxx ($191.17 in chips) 
Seat 2: mycka86 ($118.15 in chips) 
Seat 3: chaps1988 ($109.99 in chips) 
Seat 4: MichaLabam ($141.76 in chips) 
Seat 5: matiko09 ($100 in chips) 
Seat 6: Spid1 ($148.93 in chips) 
Seat 7: nubpoker ($100 in chips) 
Seat 8: Filojoes ($187.18 in chips) 
Seat 9: Aghmir77 ($104.46 in chips) 
Aghmir77: posts small blind $0.50
Dickyxxx: posts big blind $1
*** HOLE CARDS ***
Dealt to matiko09 [8d 5d]
mycka86: folds 
chaps1988: folds 
MichaLabam: raises $2 to $3
matiko09: folds 
Spid1: folds 
nubpoker: folds 
Filojoes: folds 
Aghmir77: folds 
Dickyxxx: calls $2
*** FLOP *** [Qh Qs 9d]
Dickyxxx: checks 
MichaLabam: bets $3.50
Dickyxxx: calls $3.50
*** TURN *** [Qh Qs 9d] [Ts]
Dickyxxx: checks 
MichaLabam: checks 
*** RIVER *** [Qh Qs 9d Ts] [Qd]
Dickyxxx: bets $6.41
MichaLabam: folds 
Uncalled bet ($6.41) returned to Dickyxxx
Dickyxxx collected $12.82 from pot
Dickyxxx: doesn't show hand 
*** SUMMARY ***
Total pot $13.50 | Rake $0.68 
Board [Qh Qs 9d Ts Qd]
Seat 1: Dickyxxx (big blind) collected ($12.82)
Seat 2: mycka86 folded before Flop (didn't bet)
Seat 3: chaps1988 folded before Flop (didn't bet)
Seat 4: MichaLabam folded on the River
Seat 5: matiko09 folded before Flop (didn't bet)
Seat 6: Spid1 folded before Flop (didn't bet)
Seat 7: nubpoker folded before Flop (didn't bet)
Seat 8: Filojoes (button) folded before Flop (didn't bet)
Seat 9: Aghmir77 (small blind) folded before Flop





PokerStars Hand #153066205810:  Hold'em No Limit ($1/$2 USD) - 2016/05/09 16:03:00 CET [2016/05/09 10:03:00 ET]
Table 'Celaeno II' 9-max Seat #7 is the button
Seat 1: Li Shaobo ($283.75 in chips) 
Seat 2: J0k3rF4c3_FD ($234.98 in chips) 
Seat 3: Fredstar56 ($122.01 in chips) 
Seat 4: FTPbannedMe ($300.40 in chips) 
Seat 6: matiko09 ($300.30 in chips) 
Seat 7: Mister_b44 ($93.07 in chips) 
Seat 9: Spid1 ($203 in chips) 
chaps1988 will be allowed to play after the button
Spid1: posts small blind $1
Li Shaobo: posts big blind $2
*** HOLE CARDS ***
Dealt to matiko09 [Kh Qd]
J0k3rF4c3_FD: folds 
Fredstar56: folds 
FTPbannedMe: folds 
matiko09: raises $3 to $5
Mister_b44: folds 
Spid1: folds 
Li Shaobo: calls $3
*** FLOP *** [3h 3d Qh]
Li Shaobo: bets $6
matiko09: calls $6
*** TURN *** [3h 3d Qh] [2h]
Li Shaobo: checks 
matiko09: bets $14
Li Shaobo: folds 
Uncalled bet ($14) returned to matiko09
matiko09 collected $21.85 from pot
matiko09: doesn't show hand 
*** SUMMARY ***
Total pot $23 | Rake $1.15 
Board [3h 3d Qh 2h]
Seat 1: Li Shaobo (big blind) folded on the Turn
Seat 2: J0k3rF4c3_FD folded before Flop (didn't bet)
Seat 3: Fredstar56 folded before Flop (didn't bet)
Seat 4: FTPbannedMe folded before Flop (didn't bet)
Seat 6: matiko09 collected ($21.85)
Seat 7: Mister_b44 (button) folded before Flop (didn't bet)
Seat 9: Spid1 (small blind) folded before Flop





PokerStars Hand #153066206930:  Hold'em No Limit ($1/$2 USD) - 2016/05/09 16:03:02 CET [2016/05/09 10:03:02 ET]
Table 'Luda' 9-max Seat #1 is the button
Seat 1: stan_09319 ($419.99 in chips) 
Seat 2: matiko09 ($222.80 in chips) 
Seat 3: Monsthand ($435.55 in chips) 
Seat 4: Igoriah ($261.80 in chips) 
Seat 5: J0k3rF4c3_FD ($203 in chips) 
Seat 6: Iggso ($200 in chips) 
Seat 8: ramseyg117 ($281.05 in chips) 
Seat 9: solano20000 ($134.24 in chips) 
matiko09: posts small blind $1
Monsthand: posts big blind $2
chaps1988: sits out 
*** HOLE CARDS ***
Dealt to matiko09 [Kh Ah]
Igoriah: folds 
J0k3rF4c3_FD: folds 
Iggso: folds 
ramseyg117: calls $2
solano20000: folds 
stan_09319: raises $6 to $8
matiko09: raises $18 to $26
Monsthand: folds 
ramseyg117: folds 
stan_09319: folds 
Uncalled bet ($18) returned to matiko09
matiko09 collected $20 from pot
matiko09: doesn't show hand 
*** SUMMARY ***
Total pot $20 | Rake $0 
Seat 1: stan_09319 (button) folded before Flop
Seat 2: matiko09 (small blind) collected ($20)
Seat 3: Monsthand (big blind) folded before Flop
Seat 4: Igoriah folded before Flop (didn't bet)
Seat 5: J0k3rF4c3_FD folded before Flop (didn't bet)
Seat 6: Iggso folded before Flop (didn't bet)
Seat 8: ramseyg117 folded before Flop
Seat 9: solano20000 folded before Flop (didn't bet)





PokerStars Hand #153066215551:  Hold'em No Limit ($1/$2 USD) - 2016/05/09 16:03:18 CET [2016/05/09 10:03:18 ET]
Table 'Hagar II' 9-max Seat #6 is the button
Seat 1: azzad2007 ($258.62 in chips) 
Seat 2: billynomates ($107.31 in chips) 
Seat 3: stan_09319 ($200 in chips) 
Seat 4: matiko09 ($244.15 in chips) 
Seat 6: Piniker85 ($851.47 in chips) 
Seat 7: Monsthand ($201 in chips) 
Seat 8: J0k3rF4c3_FD ($332.90 in chips) 
Seat 9: chaps1988 ($200 in chips) 
Monsthand: posts small blind $1
J0k3rF4c3_FD: posts big blind $2
*** HOLE CARDS ***
Dealt to matiko09 [7d 3s]
chaps1988: folds 
azzad2007: folds 
billynomates: folds 
PacPacBum joins the table at seat #5 
stan_09319: folds 
matiko09: folds 
Piniker85: calls $2
Monsthand: folds 
J0k3rF4c3_FD: checks 
*** FLOP *** [Th 2c 5s]
J0k3rF4c3_FD: checks 
Piniker85: bets $2
J0k3rF4c3_FD: folds 
Uncalled bet ($2) returned to Piniker85
Piniker85 collected $4.75 from pot
Piniker85: doesn't show hand 
*** SUMMARY ***
Total pot $5 | Rake $0.25 
Board [Th 2c 5s]
Seat 1: azzad2007 folded before Flop (didn't bet)
Seat 2: billynomates folded before Flop (didn't bet)
Seat 3: stan_09319 folded before Flop (didn't bet)
Seat 4: matiko09 folded before Flop (didn't bet)
Seat 6: Piniker85 (button) collected ($4.75)
Seat 7: Monsthand (small blind) folded before Flop
Seat 8: J0k3rF4c3_FD (big blind) folded on the Flop
Seat 9: chaps1988 folded before Flop (didn't bet)





PokerStars Hand #153066226704:  Hold'em No Limit ($0.50/$1.00 USD) - 2016/05/09 16:03:38 CET [2016/05/09 10:03:38 ET]
Table 'Alderamin' 9-max Seat #6 is the button
Seat 1: r4mz3s ($100 in chips) 
Seat 2: Filojoes ($123.43 in chips) 
Seat 3: NSL0808 ($77.68 in chips) 
Seat 4: matiko09 ($103.68 in chips) 
Seat 5: tanmayh ($110.03 in chips) 
Seat 6: Spid1 ($116.98 in chips) 
Seat 7: azzad2007 ($101.44 in chips) 
Seat 8: nubpoker ($102.25 in chips) 
Seat 9: ipashutapkom ($40 in chips) 
azzad2007: posts small blind $0.50
nubpoker: posts big blind $1
*** HOLE CARDS ***
Dealt to matiko09 [8s 7c]
ipashutapkom: folds 
r4mz3s: raises $2 to $3
Filojoes: folds 
NSL0808: folds 
matiko09: folds 
tanmayh: folds 
Spid1: folds 
azzad2007: folds 
nubpoker: folds 
Uncalled bet ($2) returned to r4mz3s
r4mz3s collected $2.50 from pot
r4mz3s: doesn't show hand 
*** SUMMARY ***
Total pot $2.50 | Rake $0 
Seat 1: r4mz3s collected ($2.50)
Seat 2: Filojoes folded before Flop (didn't bet)
Seat 3: NSL0808 folded before Flop (didn't bet)
Seat 4: matiko09 folded before Flop (didn't bet)
Seat 5: tanmayh folded before Flop (didn't bet)
Seat 6: Spid1 (button) folded before Flop (didn't bet)
Seat 7: azzad2007 (small blind) folded before Flop
Seat 8: nubpoker (big blind) folded before Flop
Seat 9: ipashutapkom folded before Flop (didn't bet)





PokerStars Hand #153066230317:  Hold'em No Limit ($0.50/$1.00 USD) - 2016/05/09 16:03:44 CET [2016/05/09 10:03:44 ET]
Table 'Merga II' 9-max Seat #3 is the button
Seat 1: luckyluke24 ($23.58 in chips) 
Seat 2: Filojoes ($100.18 in chips) 
Seat 3: xhinostrabli ($19.51 in chips) 
Seat 4: nubpoker ($103.62 in chips) 
Seat 5: LRVAV7 ($254.91 in chips) 
Seat 6: Spid1 ($288.98 in chips) 
Seat 7: matiko09 ($151.79 in chips) 
nubpoker: posts small blind $0.50
LRVAV7: posts big blind $1
GrandOldFart: sits out 
chaps1988: sits out 
*** HOLE CARDS ***
Dealt to matiko09 [4d Ts]
Spid1: folds 
matiko09: folds 
luckyluke24: folds 
Filojoes: folds 
xhinostrabli: folds 
nubpoker: folds 
Uncalled bet ($0.50) returned to LRVAV7
LRVAV7 collected $1 from pot
LRVAV7: doesn't show hand 
*** SUMMARY ***
Total pot $1 | Rake $0 
Seat 1: luckyluke24 folded before Flop (didn't bet)
Seat 2: Filojoes folded before Flop (didn't bet)
Seat 3: xhinostrabli (button) folded before Flop (didn't bet)
Seat 4: nubpoker (small blind) folded before Flop
Seat 5: LRVAV7 (big blind) collected ($1)
Seat 6: Spid1 folded before Flop (didn't bet)
Seat 7: matiko09 folded before Flop (didn't bet)





PokerStars Hand #153066232264:  Hold'em No Limit ($1/$2 USD) - 2016/05/09 16:03:47 CET [2016/05/09 10:03:47 ET]
Table 'Hagar II' 9-max Seat #7 is the button
Seat 1: azzad2007 ($258.62 in chips) 
Seat 2: billynomates ($107.31 in chips) 
Seat 3: stan_09319 ($200 in chips) 
Seat 4: matiko09 ($244.15 in chips) 
Seat 6: Piniker85 ($854.22 in chips) 
Seat 7: Monsthand ($200 in chips) 
Seat 8: J0k3rF4c3_FD ($330.90 in chips) 
Seat 9: chaps1988 ($200 in chips) 
J0k3rF4c3_FD: posts small blind $1
chaps1988: posts big blind $2
PacPacBum: sits out 
*** HOLE CARDS ***
Dealt to matiko09 [2c Qh]
azzad2007: folds 
billynomates: folds 
stan_09319: folds 
matiko09: folds 
Piniker85: raises $2 to $4
Monsthand: folds 
J0k3rF4c3_FD: raises $12 to $16
chaps1988: folds 
Piniker85: folds 
Uncalled bet ($12) returned to J0k3rF4c3_FD
J0k3rF4c3_FD collected $10 from pot
J0k3rF4c3_FD: doesn't show hand 
*** SUMMARY ***
Total pot $10 | Rake $0 
Seat 1: azzad2007 folded before Flop (didn't bet)
Seat 2: billynomates folded before Flop (didn't bet)
Seat 3: stan_09319 folded before Flop (didn't bet)
Seat 4: matiko09 folded before Flop (didn't bet)
Seat 6: Piniker85 folded before Flop
Seat 7: Monsthand (button) folded before Flop (didn't bet)
Seat 8: J0k3rF4c3_FD (small blind) collected ($10)
Seat 9: chaps1988 (big blind) folded before Flop





PokerStars Hand #153066233498:  Hold'em No Limit ($1/$2 USD) - 2016/05/09 16:03:50 CET [2016/05/09 10:03:50 ET]
Table 'Celaeno II' 9-max Seat #9 is the button
Seat 1: Li Shaobo ($272.75 in chips) 
Seat 2: J0k3rF4c3_FD ($234.98 in chips) 
Seat 3: Fredstar56 ($122.01 in chips) 
Seat 4: FTPbannedMe ($300.40 in chips) 
Seat 6: matiko09 ($311.15 in chips) 
Seat 7: Mister_b44 ($93.07 in chips) 
Seat 9: Spid1 ($202 in chips) 
Li Shaobo: posts small blind $1
J0k3rF4c3_FD: posts big blind $2
chaps1988: sits out 
*** HOLE CARDS ***
Dealt to matiko09 [5s 3c]
Fredstar56: folds 
FTPbannedMe: folds 
matiko09: folds 
Mister_b44: folds 
Spid1: folds 
Li Shaobo: folds 
Uncalled bet ($1) returned to J0k3rF4c3_FD
J0k3rF4c3_FD collected $2 from pot
J0k3rF4c3_FD: doesn't show hand 
*** SUMMARY ***
Total pot $2 | Rake $0 
Seat 1: Li Shaobo (small blind) folded before Flop
Seat 2: J0k3rF4c3_FD (big blind) collected ($2)
Seat 3: Fredstar56 folded before Flop (didn't bet)
Seat 4: FTPbannedMe folded before Flop (didn't bet)
Seat 6: matiko09 folded before Flop (didn't bet)
Seat 7: Mister_b44 folded before Flop (didn't bet)
Seat 9: Spid1 (button) folded before Flop (didn't bet)





PokerStars Hand #153066233979:  Hold'em No Limit ($1/$2 USD) - 2016/05/09 16:03:50 CET [2016/05/09 10:03:50 ET]
Table 'Luda' 9-max Seat #2 is the button
Seat 1: stan_09319 ($411.99 in chips) 
Seat 2: matiko09 ($234.80 in chips) 
Seat 3: Monsthand ($433.55 in chips) 
Seat 4: Igoriah ($261.80 in chips) 
Seat 5: J0k3rF4c3_FD ($203 in chips) 
Seat 6: Iggso ($200 in chips) 
Seat 8: ramseyg117 ($279.05 in chips) 
Seat 9: solano20000 ($134.24 in chips) 
Monsthand: posts small blind $1
Igoriah: posts big blind $2
chaps1988: sits out 
*** HOLE CARDS ***
Dealt to matiko09 [7c Ah]
J0k3rF4c3_FD: folds 
Iggso: folds 
ramseyg117: calls $2
solano20000: folds 
stan_09319: folds 
matiko09: raises $6 to $8
Monsthand: calls $7
Igoriah: raises $30 to $38
ramseyg117: calls $36
matiko09: folds 
Monsthand: folds 
*** FLOP *** [3s 4h 8s]
Igoriah: bets $71
ramseyg117: raises $170.05 to $241.05 and is all-in
Igoriah: calls $152.80 and is all-in
Uncalled bet ($17.25) returned to ramseyg117
*** TURN *** [3s 4h 8s] [9h]
*** RIVER *** [3s 4h 8s 9h] [Qs]
*** SHOW DOWN ***
Igoriah: shows [Jh Jc] (a pair of Jacks)
ramseyg117: shows [As Ac] (a pair of Aces)
ramseyg117 collected $536.85 from pot
*** SUMMARY ***
Total pot $539.60 | Rake $2.75 
Board [3s 4h 8s 9h Qs]
Seat 1: stan_09319 folded before Flop (didn't bet)
Seat 2: matiko09 (button) folded before Flop
Seat 3: Monsthand (small blind) folded before Flop
Seat 4: Igoriah (big blind) showed [Jh Jc] and lost with a pair of Jacks
Seat 5: J0k3rF4c3_FD folded before Flop (didn't bet)
Seat 6: Iggso folded before Flop (didn't bet)
Seat 8: ramseyg117 showed [As Ac] and won ($536.85) with a pair of Aces
Seat 9: solano20000 folded before Flop (didn't bet)





PokerStars Hand #153066234746:  Hold'em No Limit ($0.50/$1.00 USD) - 2016/05/09 16:03:52 CET [2016/05/09 10:03:52 ET]
Table 'Terpsichore' 9-max Seat #7 is the button
Seat 1: ipashutapkom ($52.36 in chips) 
Seat 2: J0k3rF4c3_FD ($182.66 in chips) 
Seat 3: matiko09 ($105.37 in chips) 
Seat 5: mycka86 ($110.74 in chips) 
Seat 7: xhinostrabli ($98.27 in chips) 
Seat 8: Kiosk230472 ($133.37 in chips) 
Seat 9: FTPbannedMe ($101.50 in chips) 
Kiosk230472: posts small blind $0.50
FTPbannedMe: posts big blind $1
nubpoker: sits out 
r4mz3s: sits out 
*** HOLE CARDS ***
Dealt to matiko09 [3d Qc]
ipashutapkom: folds 
J0k3rF4c3_FD: folds 
matiko09: folds 
mycka86: raises $1.10 to $2.10
xhinostrabli: calls $2.10
Kiosk230472: folds 
FTPbannedMe: folds 
*** FLOP *** [7c 9d Ad]
mycka86: bets $4.50
xhinostrabli: raises $6.50 to $11
mycka86: raises $26 to $37
xhinostrabli: calls $26
*** TURN *** [7c 9d Ad] [2c]
mycka86: bets $71.64 and is all-in
xhinostrabli: calls $59.17 and is all-in
Uncalled bet ($12.47) returned to mycka86
*** FIRST RIVER *** [7c 9d Ad 2c] [8s]
*** SECOND RIVER *** [7c 9d Ad 2c] [9c]
*** FIRST SHOW DOWN ***
mycka86: shows [Ah 9h] (two pair, Aces and Nines)
xhinostrabli: shows [Qh As] (a pair of Aces)
mycka86 collected $97.77 from pot
*** SECOND SHOW DOWN ***
mycka86: shows [Ah 9h] (a full house, Nines full of Aces)
xhinostrabli: shows [Qh As] (two pair, Aces and Nines)
mycka86 collected $97.77 from pot
*** SUMMARY ***
Total pot $198.04 | Rake $2.50 
Hand was run twice
FIRST Board [7c 9d Ad 2c 8s]
SECOND Board [7c 9d Ad 2c 9c]
Seat 1: ipashutapkom folded before Flop (didn't bet)
Seat 2: J0k3rF4c3_FD folded before Flop (didn't bet)
Seat 3: matiko09 folded before Flop (didn't bet)
Seat 5: mycka86 showed [Ah 9h] and won ($97.77) with two pair, Aces and Nines, and won ($97.77) with a full house, Nines full of Aces
Seat 7: xhinostrabli (button) showed [Qh As] and lost with a pair of Aces, and lost with two pair, Aces and Nines
Seat 8: Kiosk230472 (small blind) folded before Flop
Seat 9: FTPbannedMe (big blind) folded before Flop





PokerStars Hand #153066240399:  Hold'em No Limit ($0.50/$1.00 USD) - 2016/05/09 16:04:02 CET [2016/05/09 10:04:02 ET]
Table 'Reiss' 9-max Seat #9 is the button
Seat 1: Dickyxxx ($197.49 in chips) 
Seat 3: chaps1988 ($109.99 in chips) 
Seat 4: MichaLabam ($135.26 in chips) 
Seat 5: matiko09 ($100 in chips) 
Seat 6: Spid1 ($148.93 in chips) 
Seat 7: nubpoker ($100 in chips) 
Seat 8: Filojoes ($187.18 in chips) 
Seat 9: Aghmir77 ($103.96 in chips) 
Dickyxxx: posts small blind $0.50
chaps1988: posts big blind $1
*** HOLE CARDS ***
Dealt to matiko09 [5s 6d]
MichaLabam: folds 
matiko09: folds 
Spid1: folds 
nubpoker: folds 
Filojoes: folds 
Aghmir77: folds 
Dickyxxx: folds 
Uncalled bet ($0.50) returned to chaps1988
chaps1988 collected $1 from pot
chaps1988: doesn't show hand 
*** SUMMARY ***
Total pot $1 | Rake $0 
Seat 1: Dickyxxx (small blind) folded before Flop
Seat 3: chaps1988 (big blind) collected ($1)
Seat 4: MichaLabam folded before Flop (didn't bet)
Seat 5: matiko09 folded before Flop (didn't bet)
Seat 6: Spid1 folded before Flop (didn't bet)
Seat 7: nubpoker folded before Flop (didn't bet)
Seat 8: Filojoes folded before Flop (didn't bet)
Seat 9: Aghmir77 (button) folded before Flop (didn't bet)





PokerStars Hand #153066243625:  Hold'em No Limit ($0.50/$1.00 USD) - 2016/05/09 16:04:08 CET [2016/05/09 10:04:08 ET]
Table 'Hajek' 9-max Seat #3 is the button
Seat 1: Mukhin1 ($109.70 in chips) 
Seat 2: Spid1 ($100 in chips) 
Seat 3: mycka86 ($100 in chips) 
Seat 4: LRVAV7 ($85.43 in chips) 
Seat 5: ozone2003 ($100 in chips) 
Seat 6: Filojoes ($102.70 in chips) 
Seat 8: Kukuryzka ($99.60 in chips) 
Seat 9: matiko09 ($100 in chips) 
LRVAV7: posts small blind $0.50
ozone2003: posts big blind $1
DancerNN1: sits out 
Mukhin1: posts the ante $0.20
Spid1: posts the ante $0.20
mycka86: posts the ante $0.20
LRVAV7: posts the ante $0.20
ozone2003: posts the ante $0.20
Filojoes: posts the ante $0.20
Kukuryzka: posts the ante $0.20
matiko09: posts the ante $0.20
*** HOLE CARDS ***
Dealt to matiko09 [6s Kc]
Filojoes: folds 
Kukuryzka: folds 
matiko09: folds 
Mukhin1: folds 
Spid1: folds 
mycka86: raises $2 to $3
LRVAV7: folds 
ozone2003: folds 
Uncalled bet ($2) returned to mycka86
mycka86 collected $4.10 from pot
*** SUMMARY ***
Total pot $4.10 | Rake $0 
Seat 1: Mukhin1 folded before Flop (didn't bet)
Seat 2: Spid1 folded before Flop (didn't bet)
Seat 3: mycka86 (button) collected ($4.10)
Seat 4: LRVAV7 (small blind) folded before Flop
Seat 5: ozone2003 (big blind) folded before Flop
Seat 6: Filojoes folded before Flop (didn't bet)
Seat 8: Kukuryzka folded before Flop (didn't bet)
Seat 9: matiko09 folded before Flop (didn't bet)





PokerStars Hand #153066245229:  Hold'em No Limit ($1/$2 USD) - 2016/05/09 16:04:10 CET [2016/05/09 10:04:10 ET]
Table 'Celaeno II' 9-max Seat #1 is the button
Seat 1: Li Shaobo ($271.75 in chips) 
Seat 2: J0k3rF4c3_FD ($235.98 in chips) 
Seat 3: Fredstar56 ($122.01 in chips) 
Seat 4: FTPbannedMe ($300.40 in chips) 
Seat 6: matiko09 ($311.15 in chips) 
Seat 7: Mister_b44 ($93.07 in chips) 
Seat 9: Spid1 ($202 in chips) 
J0k3rF4c3_FD: posts small blind $1
Fredstar56: posts big blind $2
chaps1988: sits out 
*** HOLE CARDS ***
Dealt to matiko09 [9h Qd]
FTPbannedMe: folds 
matiko09: folds 
Mister_b44: folds 
Spid1: folds 
Li Shaobo: folds 
J0k3rF4c3_FD: raises $3 to $5
Fredstar56: calls $3
*** FLOP *** [3s 3h 8s]
J0k3rF4c3_FD: bets $4.75
Fredstar56: calls $4.75
*** TURN *** [3s 3h 8s] [Jc]
J0k3rF4c3_FD: bets $12.11
Fredstar56: calls $12.11
*** RIVER *** [3s 3h 8s Jc] [7h]
J0k3rF4c3_FD: bets $58.14
Fredstar56: folds 
Uncalled bet ($58.14) returned to J0k3rF4c3_FD
J0k3rF4c3_FD collected $41.53 from pot
J0k3rF4c3_FD: doesn't show hand 
*** SUMMARY ***
Total pot $43.72 | Rake $2.19 
Board [3s 3h 8s Jc 7h]
Seat 1: Li Shaobo (button) folded before Flop (didn't bet)
Seat 2: J0k3rF4c3_FD (small blind) collected ($41.53)
Seat 3: Fredstar56 (big blind) folded on the River
Seat 4: FTPbannedMe folded before Flop (didn't bet)
Seat 6: matiko09 folded before Flop (didn't bet)
Seat 7: Mister_b44 folded before Flop (didn't bet)
Seat 9: Spid1 folded before Flop (didn't bet)





PokerStars Hand #153066246340:  Hold'em No Limit ($0.50/$1.00 USD) - 2016/05/09 16:04:12 CET [2016/05/09 10:04:12 ET]
Table 'Merga II' 9-max Seat #4 is the button
Seat 1: luckyluke24 ($23.58 in chips) 
Seat 2: Filojoes ($100.18 in chips) 
Seat 3: xhinostrabli ($19.51 in chips) 
Seat 4: nubpoker ($103.12 in chips) 
Seat 5: LRVAV7 ($255.41 in chips) 
Seat 6: Spid1 ($288.98 in chips) 
Seat 7: matiko09 ($151.79 in chips) 
LRVAV7: posts small blind $0.50
Spid1: posts big blind $1
GrandOldFart: sits out 
chaps1988: sits out 
*** HOLE CARDS ***
Dealt to matiko09 [Qd Jd]
matiko09: raises $2 to $3
luckyluke24: folds 
Filojoes: folds 
xhinostrabli: folds 
nubpoker: folds 
LRVAV7: folds 
Spid1: folds 
Uncalled bet ($2) returned to matiko09
matiko09 collected $2.50 from pot
matiko09: doesn't show hand 
*** SUMMARY ***
Total pot $2.50 | Rake $0 
Seat 1: luckyluke24 folded before Flop (didn't bet)
Seat 2: Filojoes folded before Flop (didn't bet)
Seat 3: xhinostrabli folded before Flop (didn't bet)
Seat 4: nubpoker (button) folded before Flop (didn't bet)
Seat 5: LRVAV7 (small blind) folded before Flop
Seat 6: Spid1 (big blind) folded before Flop
Seat 7: matiko09 collected ($2.50)





PokerStars Hand #153066247838:  Hold'em No Limit ($0.50/$1.00 USD) - 2016/05/09 16:04:15 CET [2016/05/09 10:04:15 ET]
Table 'Alderamin' 9-max Seat #7 is the button
Seat 1: r4mz3s ($101.50 in chips) 
Seat 2: Filojoes ($123.43 in chips) 
Seat 3: NSL0808 ($77.68 in chips) 
Seat 4: matiko09 ($103.68 in chips) 
Seat 5: tanmayh ($110.03 in chips) 
Seat 6: Spid1 ($116.98 in chips) 
Seat 7: azzad2007 ($100.94 in chips) 
Seat 8: nubpoker ($101.25 in chips) 
Seat 9: ipashutapkom ($40 in chips) 
nubpoker: posts small blind $0.50
ipashutapkom: posts big blind $1
*** HOLE CARDS ***
Dealt to matiko09 [Tc 4s]
r4mz3s: folds 
Filojoes: folds 
NSL0808: calls $1
matiko09: folds 
tanmayh: calls $1
Spid1: folds 
azzad2007: raises $5 to $6
nubpoker: folds 
ipashutapkom: folds 
NSL0808: folds 
tanmayh: calls $5
*** FLOP *** [Js 4d 8h]
tanmayh: checks 
azzad2007: bets $3.85
tanmayh: calls $3.85
*** TURN *** [Js 4d 8h] [9d]
tanmayh: checks 
azzad2007: checks 
*** RIVER *** [Js 4d 8h 9d] [Kh]
tanmayh: checks 
azzad2007: bets $10.54
tanmayh: folds 
Uncalled bet ($10.54) returned to azzad2007
azzad2007 collected $21.09 from pot
azzad2007: doesn't show hand 
*** SUMMARY ***
Total pot $22.20 | Rake $1.11 
Board [Js 4d 8h 9d Kh]
Seat 1: r4mz3s folded before Flop (didn't bet)
Seat 2: Filojoes folded before Flop (didn't bet)
Seat 3: NSL0808 folded before Flop
Seat 4: matiko09 folded before Flop (didn't bet)
Seat 5: tanmayh folded on the River
Seat 6: Spid1 folded before Flop (didn't bet)
Seat 7: azzad2007 (button) collected ($21.09)
Seat 8: nubpoker (small blind) folded before Flop
Seat 9: ipashutapkom (big blind) folded before Flop





PokerStars Hand #153066261395:  Hold'em No Limit ($1/$2 USD) - 2016/05/09 16:04:39 CET [2016/05/09 10:04:39 ET]
Table 'Hagar II' 9-max Seat #8 is the button
Seat 1: azzad2007 ($258.62 in chips) 
Seat 2: billynomates ($107.31 in chips) 
Seat 3: stan_09319 ($200 in chips) 
Seat 4: matiko09 ($244.15 in chips) 
Seat 6: Piniker85 ($850.22 in chips) 
Seat 7: Monsthand ($200 in chips) 
Seat 8: J0k3rF4c3_FD ($336.90 in chips) 
Seat 9: chaps1988 ($200 in chips) 
chaps1988: posts small blind $1
azzad2007: posts big blind $2
PacPacBum: sits out 
*** HOLE CARDS ***
Dealt to matiko09 [7s 4s]
billynomates: folds 
stan_09319: folds 
matiko09: folds 
Piniker85: raises $2 to $4
Monsthand: folds 
J0k3rF4c3_FD: folds 
chaps1988: raises $12 to $16
azzad2007: folds 
Piniker85: calls $12
*** FLOP *** [5c 9c Jd]
chaps1988: checks 
Piniker85: bets $15
chaps1988: folds 
Uncalled bet ($15) returned to Piniker85
Piniker85 collected $32.30 from pot
Piniker85: doesn't show hand 
*** SUMMARY ***
Total pot $34 | Rake $1.70 
Board [5c 9c Jd]
Seat 1: azzad2007 (big blind) folded before Flop
Seat 2: billynomates folded before Flop (didn't bet)
Seat 3: stan_09319 folded before Flop (didn't bet)
Seat 4: matiko09 folded before Flop (didn't bet)
Seat 6: Piniker85 collected ($32.30)
Seat 7: Monsthand folded before Flop (didn't bet)
Seat 8: J0k3rF4c3_FD (button) folded before Flop (didn't bet)
Seat 9: chaps1988 (small blind) folded on the Flop





PokerStars Hand #153066265069:  Hold'em No Limit ($0.50/$1.00 USD) - 2016/05/09 16:04:45 CET [2016/05/09 10:04:45 ET]
Table 'Reiss' 9-max Seat #1 is the button
Seat 1: Dickyxxx ($196.99 in chips) 
Seat 3: chaps1988 ($110.49 in chips) 
Seat 4: MichaLabam ($135.26 in chips) 
Seat 5: matiko09 ($100 in chips) 
Seat 6: Spid1 ($148.93 in chips) 
Seat 7: nubpoker ($100 in chips) 
Seat 8: Filojoes ($187.18 in chips) 
Seat 9: Aghmir77 ($103.96 in chips) 
chaps1988: posts small blind $0.50
MichaLabam: posts big blind $1
*** HOLE CARDS ***
Dealt to matiko09 [2s Qh]
matiko09: folds 
Spid1: raises $2 to $3
nubpoker: folds 
Filojoes: folds 
Aghmir77: folds 
Dickyxxx: raises $6 to $9
chaps1988: folds 
MichaLabam: folds 
Spid1: calls $6
*** FLOP *** [4s 6c 9c]
Spid1: checks 
Dickyxxx: bets $12.34
Spid1: folds 
Uncalled bet ($12.34) returned to Dickyxxx
Dickyxxx collected $18.52 from pot
Dickyxxx: doesn't show hand 
*** SUMMARY ***
Total pot $19.50 | Rake $0.98 
Board [4s 6c 9c]
Seat 1: Dickyxxx (button) collected ($18.52)
Seat 3: chaps1988 (small blind) folded before Flop
Seat 4: MichaLabam (big blind) folded before Flop
Seat 5: matiko09 folded before Flop (didn't bet)
Seat 6: Spid1 folded on the Flop
Seat 7: nubpoker folded before Flop (didn't bet)
Seat 8: Filojoes folded before Flop (didn't bet)
Seat 9: Aghmir77 folded before Flop (didn't bet)





PokerStars Hand #153066266829:  Hold'em No Limit ($1/$2 USD) - 2016/05/09 16:04:48 CET [2016/05/09 10:04:48 ET]
Table 'Luda' 9-max Seat #3 is the button
Seat 1: stan_09319 ($411.99 in chips) 
Seat 2: matiko09 ($226.80 in chips) 
Seat 3: Monsthand ($425.55 in chips) 
Seat 4: Igoriah ($200 in chips) 
Seat 5: J0k3rF4c3_FD ($203 in chips) 
Seat 6: Iggso ($200 in chips) 
Seat 8: ramseyg117 ($554.10 in chips) 
Seat 9: solano20000 ($134.24 in chips) 
Igoriah: posts small blind $1
J0k3rF4c3_FD: posts big blind $2
chaps1988: sits out 
*** HOLE CARDS ***
Dealt to matiko09 [4c Ah]
Iggso: folds 
ramseyg117: calls $2
solano20000: folds 
stan_09319: folds 
matiko09: folds 
Monsthand: folds 
Igoriah: folds 
J0k3rF4c3_FD: checks 
*** FLOP *** [9s Ac 5s]
J0k3rF4c3_FD: checks 
ramseyg117: checks 
*** TURN *** [9s Ac 5s] [9c]
J0k3rF4c3_FD: checks 
ramseyg117: checks 
*** RIVER *** [9s Ac 5s 9c] [2h]
J0k3rF4c3_FD: checks 
ramseyg117: bets $2
J0k3rF4c3_FD: folds 
Uncalled bet ($2) returned to ramseyg117
ramseyg117 collected $4.75 from pot
ramseyg117: doesn't show hand 
*** SUMMARY ***
Total pot $5 | Rake $0.25 
Board [9s Ac 5s 9c 2h]
Seat 1: stan_09319 folded before Flop (didn't bet)
Seat 2: matiko09 folded before Flop (didn't bet)
Seat 3: Monsthand (button) folded before Flop (didn't bet)
Seat 4: Igoriah (small blind) folded before Flop
Seat 5: J0k3rF4c3_FD (big blind) folded on the River
Seat 6: Iggso folded before Flop (didn't bet)
Seat 8: ramseyg117 collected ($4.75)
Seat 9: solano20000 folded before Flop (didn't bet)





PokerStars Hand #153066272455:  Hold'em No Limit ($0.50/$1.00 USD) - 2016/05/09 16:04:58 CET [2016/05/09 10:04:58 ET]
Table 'Merga II' 9-max Seat #5 is the button
Seat 1: luckyluke24 ($23.58 in chips) 
Seat 2: Filojoes ($100.18 in chips) 
Seat 3: xhinostrabli ($19.51 in chips) 
Seat 4: nubpoker ($103.12 in chips) 
Seat 5: LRVAV7 ($254.91 in chips) 
Seat 6: Spid1 ($287.98 in chips) 
Seat 7: matiko09 ($153.29 in chips) 
Spid1: posts small blind $0.50
matiko09: posts big blind $1
GrandOldFart: sits out 
chaps1988: sits out 
*** HOLE CARDS ***
Dealt to matiko09 [8c Ks]
luckyluke24: folds 
Filojoes: folds 
xhinostrabli: folds 
nubpoker: folds 
LRVAV7: folds 
Spid1: folds 
Uncalled bet ($0.50) returned to matiko09
matiko09 collected $1 from pot
matiko09: doesn't show hand 
*** SUMMARY ***
Total pot $1 | Rake $0 
Seat 1: luckyluke24 folded before Flop (didn't bet)
Seat 2: Filojoes folded before Flop (didn't bet)
Seat 3: xhinostrabli folded before Flop (didn't bet)
Seat 4: nubpoker folded before Flop (didn't bet)
Seat 5: LRVAV7 (button) folded before Flop (didn't bet)
Seat 6: Spid1 (small blind) folded before Flop
Seat 7: matiko09 (big blind) collected ($1)





PokerStars Hand #153066280480:  Hold'em No Limit ($0.50/$1.00 USD) - 2016/05/09 16:05:12 CET [2016/05/09 10:05:12 ET]
Table 'Hajek' 9-max Seat #4 is the button
Seat 1: Mukhin1 ($109.50 in chips) 
Seat 2: Spid1 ($100 in chips) 
Seat 3: mycka86 ($102.90 in chips) 
Seat 4: LRVAV7 ($84.73 in chips) 
Seat 5: ozone2003 ($100 in chips) 
Seat 6: Filojoes ($102.50 in chips) 
Seat 8: Kukuryzka ($99.40 in chips) 
Seat 9: matiko09 ($100 in chips) 
ozone2003: posts small blind $0.50
Filojoes: posts big blind $1
DancerNN1: sits out 
Mukhin1: posts the ante $0.20
Spid1: posts the ante $0.20
mycka86: posts the ante $0.20
LRVAV7: posts the ante $0.20
ozone2003: posts the ante $0.20
Filojoes: posts the ante $0.20
Kukuryzka: posts the ante $0.20
matiko09: posts the ante $0.20
*** HOLE CARDS ***
Dealt to matiko09 [6h Qh]
Kukuryzka: folds 
matiko09: folds 
Mukhin1: folds 
Spid1: folds 
mycka86: folds 
LRVAV7: folds 
ozone2003: folds 
Uncalled bet ($0.50) returned to Filojoes
Filojoes collected $2.60 from pot
Filojoes: doesn't show hand 
*** SUMMARY ***
Total pot $2.60 | Rake $0 
Seat 1: Mukhin1 folded before Flop (didn't bet)
Seat 2: Spid1 folded before Flop (didn't bet)
Seat 3: mycka86 folded before Flop (didn't bet)
Seat 4: LRVAV7 (button) folded before Flop (didn't bet)
Seat 5: ozone2003 (small blind) folded before Flop
Seat 6: Filojoes (big blind) collected ($2.60)
Seat 8: Kukuryzka folded before Flop (didn't bet)
Seat 9: matiko09 folded before Flop (didn't bet)





PokerStars Hand #153066284308:  Hold'em No Limit ($0.50/$1.00 USD) - 2016/05/09 16:05:19 CET [2016/05/09 10:05:19 ET]
Table 'Merga II' 9-max Seat #6 is the button
Seat 1: luckyluke24 ($23.58 in chips) 
Seat 2: Filojoes ($100.18 in chips) 
Seat 3: xhinostrabli ($19.51 in chips) 
Seat 4: nubpoker ($103.12 in chips) 
Seat 5: LRVAV7 ($254.91 in chips) 
Seat 6: Spid1 ($287.48 in chips) 
Seat 7: matiko09 ($153.79 in chips) 
Seat 8: GrandOldFart ($100 in chips) 
matiko09: posts small blind $0.50
GrandOldFart: posts big blind $1
chaps1988: sits out 
*** HOLE CARDS ***
Dealt to matiko09 [7c 9h]
luckyluke24: folds 
Filojoes: folds 
xhinostrabli has timed out
xhinostrabli: folds 
nubpoker: folds 
LRVAV7: folds 
Spid1: folds 
matiko09: folds 
Uncalled bet ($0.50) returned to GrandOldFart
GrandOldFart collected $1 from pot
*** SUMMARY ***
Total pot $1 | Rake $0 
Seat 1: luckyluke24 folded before Flop (didn't bet)
Seat 2: Filojoes folded before Flop (didn't bet)
Seat 3: xhinostrabli folded before Flop (didn't bet)
Seat 4: nubpoker folded before Flop (didn't bet)
Seat 5: LRVAV7 folded before Flop (didn't bet)
Seat 6: Spid1 (button) folded before Flop (didn't bet)
Seat 7: matiko09 (small blind) folded before Flop
Seat 8: GrandOldFart (big blind) collected ($1)





PokerStars Hand #153066289968:  Hold'em No Limit ($1/$2 USD) - 2016/05/09 16:05:29 CET [2016/05/09 10:05:29 ET]
Table 'Celaeno II' 9-max Seat #2 is the button
Seat 1: Li Shaobo ($271.75 in chips) 
Seat 2: J0k3rF4c3_FD ($255.65 in chips) 
Seat 3: Fredstar56 ($100.15 in chips) 
Seat 4: FTPbannedMe ($300.40 in chips) 
Seat 6: matiko09 ($311.15 in chips) 
Seat 7: Mister_b44 ($93.07 in chips) 
Seat 9: Spid1 ($202 in chips) 
Fredstar56: posts small blind $1
FTPbannedMe: posts big blind $2
chaps1988: sits out 
*** HOLE CARDS ***
Dealt to matiko09 [Jd Tc]
matiko09: folds 
Mister_b44: raises $4 to $6
Spid1: folds 
Li Shaobo: raises $12 to $18
J0k3rF4c3_FD: folds 
Fredstar56: folds 
FTPbannedMe: folds 
Mister_b44: calls $12
*** FLOP *** [Th 6h Ac]
Mister_b44: checks 
Li Shaobo: bets $20
Mister_b44: calls $20
*** TURN *** [Th 6h Ac] [4d]
Mister_b44: checks 
Li Shaobo: checks 
*** RIVER *** [Th 6h Ac 4d] [5h]
Mister_b44: bets $55.07 and is all-in
Li Shaobo: folds 
Uncalled bet ($55.07) returned to Mister_b44
Mister_b44 collected $76.25 from pot
Mister_b44: doesn't show hand 
*** SUMMARY ***
Total pot $79 | Rake $2.75 
Board [Th 6h Ac 4d 5h]
Seat 1: Li Shaobo folded on the River
Seat 2: J0k3rF4c3_FD (button) folded before Flop (didn't bet)
Seat 3: Fredstar56 (small blind) folded before Flop
Seat 4: FTPbannedMe (big blind) folded before Flop
Seat 6: matiko09 folded before Flop (didn't bet)
Seat 7: Mister_b44 collected ($76.25)
Seat 9: Spid1 folded before Flop (didn't bet)





PokerStars Hand #153066294723:  Hold'em No Limit ($0.50/$1.00 USD) - 2016/05/09 16:05:37 CET [2016/05/09 10:05:37 ET]
Table 'Alderamin' 9-max Seat #8 is the button
Seat 1: r4mz3s ($101.50 in chips) 
Seat 2: Filojoes ($123.43 in chips) 
Seat 3: NSL0808 ($76.68 in chips) 
Seat 4: matiko09 ($103.68 in chips) 
Seat 5: tanmayh ($100.18 in chips) 
Seat 6: Spid1 ($116.98 in chips) 
Seat 7: azzad2007 ($112.18 in chips) 
Seat 8: nubpoker ($100.75 in chips) 
Seat 9: ipashutapkom ($40 in chips) 
ipashutapkom: posts small blind $0.50
r4mz3s: posts big blind $1
*** HOLE CARDS ***
Dealt to matiko09 [8s 9s]
Filojoes: folds 
NSL0808: calls $1
matiko09: raises $3 to $4
tanmayh: calls $4
Spid1: folds 
azzad2007: folds 
nubpoker: folds 
ipashutapkom: folds 
r4mz3s: calls $3
NSL0808: calls $3
*** FLOP *** [Ts Ac Jd]
r4mz3s: checks 
NSL0808: checks 
matiko09: checks 
tanmayh: checks 
*** TURN *** [Ts Ac Jd] [Ah]
r4mz3s: checks 
NSL0808: checks 
matiko09: checks 
tanmayh: bets $8
r4mz3s: folds 
NSL0808: folds 
matiko09: folds 
Uncalled bet ($8) returned to tanmayh
tanmayh collected $15.68 from pot
tanmayh: doesn't show hand 
*** SUMMARY ***
Total pot $16.50 | Rake $0.82 
Board [Ts Ac Jd Ah]
Seat 1: r4mz3s (big blind) folded on the Turn
Seat 2: Filojoes folded before Flop (didn't bet)
Seat 3: NSL0808 folded on the Turn
Seat 4: matiko09 folded on the Turn
Seat 5: tanmayh collected ($15.68)
Seat 6: Spid1 folded before Flop (didn't bet)
Seat 7: azzad2007 folded before Flop (didn't bet)
Seat 8: nubpoker (button) folded before Flop (didn't bet)
Seat 9: ipashutapkom (small blind) folded before Flop





PokerStars Hand #153066294849:  Hold'em No Limit ($0.50/$1.00 USD) - 2016/05/09 16:05:38 CET [2016/05/09 10:05:38 ET]
Table 'Terpsichore' 9-max Seat #8 is the button
Seat 1: ipashutapkom ($52.36 in chips) 
Seat 2: J0k3rF4c3_FD ($182.66 in chips) 
Seat 3: matiko09 ($105.37 in chips) 
Seat 5: mycka86 ($208.01 in chips) 
Seat 8: Kiosk230472 ($132.87 in chips) 
Seat 9: FTPbannedMe ($100.50 in chips) 
FTPbannedMe: posts small blind $0.50
ipashutapkom: posts big blind $1
nubpoker: sits out 
r4mz3s: sits out 
*** HOLE CARDS ***
Dealt to matiko09 [6s 5d]
J0k3rF4c3_FD: folds 
matiko09: folds 
mycka86: folds 
xhinostrabli leaves the table
Kukuryzka joins the table at seat #7 
Kukuryzka leaves the table
Kiosk230472: folds 
FTPbannedMe: raises $1.50 to $2.50
ipashutapkom: raises $5 to $7.50
FTPbannedMe: folds 
Uncalled bet ($5) returned to ipashutapkom
ipashutapkom collected $5 from pot
ipashutapkom: doesn't show hand 
*** SUMMARY ***
Total pot $5 | Rake $0 
Seat 1: ipashutapkom (big blind) collected ($5)
Seat 2: J0k3rF4c3_FD folded before Flop (didn't bet)
Seat 3: matiko09 folded before Flop (didn't bet)
Seat 5: mycka86 folded before Flop (didn't bet)
Seat 8: Kiosk230472 (button) folded before Flop (didn't bet)
Seat 9: FTPbannedMe (small blind) folded before Flop





PokerStars Hand #153066296629:  Hold'em No Limit ($1/$2 USD) - 2016/05/09 16:05:41 CET [2016/05/09 10:05:41 ET]
Table 'Luda' 9-max Seat #4 is the button
Seat 1: stan_09319 ($411.99 in chips) 
Seat 2: matiko09 ($226.80 in chips) 
Seat 3: Monsthand ($425.55 in chips) 
Seat 4: Igoriah ($200 in chips) 
Seat 5: J0k3rF4c3_FD ($201 in chips) 
Seat 6: Iggso ($200 in chips) 
Seat 8: ramseyg117 ($556.85 in chips) 
Seat 9: solano20000 ($134.24 in chips) 
J0k3rF4c3_FD: posts small blind $1
Iggso: posts big blind $2
chaps1988: sits out 
*** HOLE CARDS ***
Dealt to matiko09 [7c 6c]
ramseyg117: calls $2
solano20000: calls $2
stan_09319: folds 
matiko09: calls $2
Monsthand: folds 
Igoriah: folds 
J0k3rF4c3_FD: calls $1
Iggso: checks 
*** FLOP *** [3h Qh Qd]
J0k3rF4c3_FD: checks 
Iggso: checks 
ramseyg117: checks 
solano20000: bets $4.75
matiko09: folds 
J0k3rF4c3_FD: folds 
Iggso: folds 
ramseyg117: folds 
Uncalled bet ($4.75) returned to solano20000
solano20000 collected $9.50 from pot
*** SUMMARY ***
Total pot $10 | Rake $0.50 
Board [3h Qh Qd]
Seat 1: stan_09319 folded before Flop (didn't bet)
Seat 2: matiko09 folded on the Flop
Seat 3: Monsthand folded before Flop (didn't bet)
Seat 4: Igoriah (button) folded before Flop (didn't bet)
Seat 5: J0k3rF4c3_FD (small blind) folded on the Flop
Seat 6: Iggso (big blind) folded on the Flop
Seat 8: ramseyg117 folded on the Flop
Seat 9: solano20000 collected ($9.50)





PokerStars Hand #153066297529:  Hold'em No Limit ($1/$2 USD) - 2016/05/09 16:05:42 CET [2016/05/09 10:05:42 ET]
Table 'Hagar II' 9-max Seat #9 is the button
Seat 1: azzad2007 ($256.62 in chips) 
Seat 3: stan_09319 ($200 in chips) 
Seat 4: matiko09 ($244.15 in chips) 
Seat 6: Piniker85 ($866.52 in chips) 
Seat 7: Monsthand ($200 in chips) 
Seat 8: J0k3rF4c3_FD ($336.90 in chips) 
Seat 9: chaps1988 ($200 in chips) 
azzad2007: posts small blind $1
billynomates: is sitting out 
stan_09319: posts big blind $2
PacPacBum: sits out 
*** HOLE CARDS ***
Dealt to matiko09 [Ad 2h]
matiko09: folds 
Piniker85: folds 
billynomates leaves the table
Monsthand: folds 
J0k3rF4c3_FD: raises $3 to $5
chaps1988: folds 
azzad2007: folds 
stan_09319: folds 
Uncalled bet ($3) returned to J0k3rF4c3_FD
J0k3rF4c3_FD collected $5 from pot
J0k3rF4c3_FD: doesn't show hand 
*** SUMMARY ***
Total pot $5 | Rake $0 
Seat 1: azzad2007 (small blind) folded before Flop
Seat 3: stan_09319 (big blind) folded before Flop
Seat 4: matiko09 folded before Flop (didn't bet)
Seat 6: Piniker85 folded before Flop (didn't bet)
Seat 7: Monsthand folded before Flop (didn't bet)
Seat 8: J0k3rF4c3_FD collected ($5)
Seat 9: chaps1988 (button) folded before Flop (didn't bet)





PokerStars Hand #153066298986:  Hold'em No Limit ($0.50/$1.00 USD) - 2016/05/09 16:05:45 CET [2016/05/09 10:05:45 ET]
Table 'Hajek' 9-max Seat #5 is the button
Seat 1: Mukhin1 ($109.30 in chips) 
Seat 2: Spid1 ($100 in chips) 
Seat 3: mycka86 ($102.70 in chips) 
Seat 4: LRVAV7 ($84.53 in chips) 
Seat 5: ozone2003 ($100 in chips) 
Seat 6: Filojoes ($104.40 in chips) 
Seat 7: DancerNN1 ($100 in chips) 
Seat 8: Kukuryzka ($99.20 in chips) 
Seat 9: matiko09 ($100 in chips) 
Filojoes: posts small blind $0.50
DancerNN1: posts big blind $1
Mukhin1: posts the ante $0.20
Spid1: posts the ante $0.20
mycka86: posts the ante $0.20
LRVAV7: posts the ante $0.20
ozone2003: posts the ante $0.20
Filojoes: posts the ante $0.20
DancerNN1: posts the ante $0.20
Kukuryzka: posts the ante $0.20
matiko09: posts the ante $0.20
*** HOLE CARDS ***
Dealt to matiko09 [2d Tc]
Kukuryzka: folds 
matiko09: folds 
Mukhin1: folds 
Spid1: folds 
mycka86: folds 
LRVAV7: raises $2 to $3
ozone2003: folds 
Filojoes: folds 
DancerNN1: calls $2
*** FLOP *** [Qc 4s 6d]
DancerNN1: checks 
LRVAV7: bets $4
DancerNN1: calls $4
*** TURN *** [Qc 4s 6d] [2c]
DancerNN1: checks 
LRVAV7: bets $11.50
DancerNN1: calls $11.50
*** RIVER *** [Qc 4s 6d 2c] [Kd]
DancerNN1: checks 
LRVAV7: checks 
*** SHOW DOWN ***
DancerNN1: shows [7h Qh] (a pair of Queens)
LRVAV7: mucks hand 
DancerNN1 collected $37.34 from pot
*** SUMMARY ***
Total pot $39.30 | Rake $1.96 
Board [Qc 4s 6d 2c Kd]
Seat 1: Mukhin1 folded before Flop (didn't bet)
Seat 2: Spid1 folded before Flop (didn't bet)
Seat 3: mycka86 folded before Flop (didn't bet)
Seat 4: LRVAV7 mucked [Ad 3s]
Seat 5: ozone2003 (button) folded before Flop (didn't bet)
Seat 6: Filojoes (small blind) folded before Flop
Seat 7: DancerNN1 (big blind) showed [7h Qh] and won ($37.34) with a pair of Queens
Seat 8: Kukuryzka folded before Flop (didn't bet)
Seat 9: matiko09 folded before Flop (didn't bet)





PokerStars Hand #153066303971:  Hold'em No Limit ($0.50/$1.00 USD) - 2016/05/09 16:05:53 CET [2016/05/09 10:05:53 ET]
Table 'Silesia' 9-max Seat #1 is the button
Seat 1: MihaiCristea ($65.26 in chips) 
Seat 3: Dickyxxx ($106.30 in chips) 
Seat 5: matiko09 ($247.39 in chips) 
Seat 6: PacPacBum ($102 in chips) 
Seat 8: Aghmir77 ($84.50 in chips) 
Seat 9: J0k3rF4c3_FD ($216.45 in chips) 
Dickyxxx: posts small blind $0.50
matiko09: posts big blind $1
*** HOLE CARDS ***
Dealt to matiko09 [Jd 3s]
PacPacBum: folds 
Aghmir77: folds 
J0k3rF4c3_FD: folds 
MihaiCristea: folds 
Dickyxxx: folds 
Uncalled bet ($0.50) returned to matiko09
matiko09 collected $1 from pot
matiko09: doesn't show hand 
*** SUMMARY ***
Total pot $1 | Rake $0 
Seat 1: MihaiCristea (button) folded before Flop (didn't bet)
Seat 3: Dickyxxx (small blind) folded before Flop
Seat 5: matiko09 (big blind) collected ($1)
Seat 6: PacPacBum folded before Flop (didn't bet)
Seat 8: Aghmir77 folded before Flop (didn't bet)
Seat 9: J0k3rF4c3_FD folded before Flop (didn't bet)





PokerStars Hand #153066305900:  Hold'em No Limit ($0.50/$1.00 USD) - 2016/05/09 16:05:57 CET [2016/05/09 10:05:57 ET]
Table 'Reiss' 9-max Seat #3 is the button
Seat 1: Dickyxxx ($206.51 in chips) 
Seat 3: chaps1988 ($109.99 in chips) 
Seat 4: MichaLabam ($134.26 in chips) 
Seat 5: matiko09 ($100 in chips) 
Seat 6: Spid1 ($139.93 in chips) 
Seat 7: nubpoker ($100 in chips) 
Seat 8: Filojoes ($187.18 in chips) 
Seat 9: Aghmir77 ($103.96 in chips) 
MichaLabam: posts small blind $0.50
matiko09: posts big blind $1
*** HOLE CARDS ***
Dealt to matiko09 [9h 2d]
Spid1: folds 
nubpoker: folds 
Filojoes: folds 
Aghmir77: folds 
Dickyxxx: folds 
chaps1988: raises $1.25 to $2.25
MichaLabam: folds 
matiko09: folds 
Uncalled bet ($1.25) returned to chaps1988
chaps1988 collected $2.50 from pot
chaps1988: doesn't show hand 
*** SUMMARY ***
Total pot $2.50 | Rake $0 
Seat 1: Dickyxxx folded before Flop (didn't bet)
Seat 3: chaps1988 (button) collected ($2.50)
Seat 4: MichaLabam (small blind) folded before Flop
Seat 5: matiko09 (big blind) folded before Flop
Seat 6: Spid1 folded before Flop (didn't bet)
Seat 7: nubpoker folded before Flop (didn't bet)
Seat 8: Filojoes folded before Flop (didn't bet)
Seat 9: Aghmir77 folded before Flop (didn't bet)





PokerStars Hand #153066311848:  Hold'em No Limit ($0.50/$1.00 USD) - 2016/05/09 16:06:07 CET [2016/05/09 10:06:07 ET]
Table 'Silesia' 9-max Seat #3 is the button
Seat 1: MihaiCristea ($65.26 in chips) 
Seat 3: Dickyxxx ($105.80 in chips) 
Seat 5: matiko09 ($247.89 in chips) 
Seat 8: Aghmir77 ($84.50 in chips) 
Seat 9: J0k3rF4c3_FD ($216.45 in chips) 
matiko09: posts small blind $0.50
PacPacBum: is sitting out 
Aghmir77: posts big blind $1
*** HOLE CARDS ***
Dealt to matiko09 [3d 3s]
J0k3rF4c3_FD: folds 
J0k3rF4c3_FD leaves the table
MihaiCristea: raises $2.50 to $3.50
Dickyxxx: folds 
PacPacBum leaves the table
matiko09: folds 
Aghmir77: folds 
Uncalled bet ($2.50) returned to MihaiCristea
MihaiCristea collected $2.50 from pot
MihaiCristea: doesn't show hand 
*** SUMMARY ***
Total pot $2.50 | Rake $0 
Seat 1: MihaiCristea collected ($2.50)
Seat 3: Dickyxxx (button) folded before Flop (didn't bet)
Seat 5: matiko09 (small blind) folded before Flop
Seat 8: Aghmir77 (big blind) folded before Flop
Seat 9: J0k3rF4c3_FD folded before Flop (didn't bet)





PokerStars Hand #153066312233:  Hold'em No Limit ($1/$2 USD) - 2016/05/09 16:06:08 CET [2016/05/09 10:06:08 ET]
Table 'Hagar II' 9-max Seat #1 is the button
Seat 1: azzad2007 ($255.62 in chips) 
Seat 3: stan_09319 ($200 in chips) 
Seat 4: matiko09 ($244.15 in chips) 
Seat 6: Piniker85 ($866.52 in chips) 
Seat 7: Monsthand ($200 in chips) 
Seat 8: J0k3rF4c3_FD ($339.90 in chips) 
Seat 9: chaps1988 ($200 in chips) 
stan_09319: posts small blind $1
matiko09: posts big blind $2
PacPacBum: sits out 
*** HOLE CARDS ***
Dealt to matiko09 [7s 6s]
Piniker85: raises $2 to $4
Monsthand: folds 
J0k3rF4c3_FD: raises $8.45 to $12.45
chaps1988: folds 
azzad2007: folds 
stan_09319: folds 
matiko09: folds 
Piniker85: calls $8.45
*** FLOP *** [Qs Jh 8c]
Piniker85: checks 
J0k3rF4c3_FD: checks 
*** TURN *** [Qs Jh 8c] [4d]
Piniker85: bets $10
J0k3rF4c3_FD: calls $10
*** RIVER *** [Qs Jh 8c 4d] [9d]
Piniker85: bets $18
J0k3rF4c3_FD: raises $30.89 to $48.89
darren1031 joins the table at seat #2 
Piniker85: folds 
Uncalled bet ($30.89) returned to J0k3rF4c3_FD
J0k3rF4c3_FD collected $81.15 from pot
J0k3rF4c3_FD: doesn't show hand 
*** SUMMARY ***
Total pot $83.90 | Rake $2.75 
Board [Qs Jh 8c 4d 9d]
Seat 1: azzad2007 (button) folded before Flop (didn't bet)
Seat 3: stan_09319 (small blind) folded before Flop
Seat 4: matiko09 (big blind) folded before Flop
Seat 6: Piniker85 folded on the River
Seat 7: Monsthand folded before Flop (didn't bet)
Seat 8: J0k3rF4c3_FD collected ($81.15)
Seat 9: chaps1988 folded before Flop (didn't bet)





PokerStars Hand #153066314855:  Hold'em No Limit ($0.50/$1.00 USD) - 2016/05/09 16:06:13 CET [2016/05/09 10:06:13 ET]
Table 'Merga II' 9-max Seat #7 is the button
Seat 1: luckyluke24 ($23.58 in chips) 
Seat 2: Filojoes ($100.18 in chips) 
Seat 3: xhinostrabli ($19.51 in chips) 
Seat 4: nubpoker ($103.12 in chips) 
Seat 5: LRVAV7 ($254.91 in chips) 
Seat 6: Spid1 ($287.48 in chips) 
Seat 7: matiko09 ($153.29 in chips) 
Seat 8: GrandOldFart ($100.50 in chips) 
Seat 9: chaps1988 ($223.43 in chips) 
GrandOldFart: posts small blind $0.50
chaps1988: posts big blind $1
*** HOLE CARDS ***
Dealt to matiko09 [5s Ah]
luckyluke24: folds 
Filojoes: folds 
luckyluke24 leaves the table
xhinostrabli: raises $2 to $3
ipashutapkom joins the table at seat #1 
nubpoker: raises $6 to $9
LRVAV7: folds 
Spid1: folds 
matiko09: folds 
GrandOldFart: folds 
chaps1988: folds 
xhinostrabli: raises $10.51 to $19.51 and is all-in
nubpoker: calls $10.51
*** FLOP *** [5h 2d Kd]
*** TURN *** [5h 2d Kd] [7h]
*** RIVER *** [5h 2d Kd 7h] [5c]
*** SHOW DOWN ***
xhinostrabli: shows [Ks Qd] (two pair, Kings and Fives)
nubpoker: shows [Qh Ac] (a pair of Fives)
xhinostrabli collected $38.49 from pot
*** SUMMARY ***
Total pot $40.52 | Rake $2.03 
Board [5h 2d Kd 7h 5c]
Seat 1: luckyluke24 folded before Flop (didn't bet)
Seat 2: Filojoes folded before Flop (didn't bet)
Seat 3: xhinostrabli showed [Ks Qd] and won ($38.49) with two pair, Kings and Fives
Seat 4: nubpoker showed [Qh Ac] and lost with a pair of Fives
Seat 5: LRVAV7 folded before Flop (didn't bet)
Seat 6: Spid1 folded before Flop (didn't bet)
Seat 7: matiko09 (button) folded before Flop (didn't bet)
Seat 8: GrandOldFart (small blind) folded before Flop
Seat 9: chaps1988 (big blind) folded before Flop





PokerStars Hand #153066319597:  Hold'em No Limit ($0.50/$1.00 USD) - 2016/05/09 16:06:21 CET [2016/05/09 10:06:21 ET]
Table 'Reiss' 9-max Seat #4 is the button
Seat 1: Dickyxxx ($206.51 in chips) 
Seat 3: chaps1988 ($111.49 in chips) 
Seat 4: MichaLabam ($133.76 in chips) 
Seat 5: matiko09 ($100 in chips) 
Seat 6: Spid1 ($139.93 in chips) 
Seat 7: nubpoker ($100 in chips) 
Seat 8: Filojoes ($187.18 in chips) 
Seat 9: Aghmir77 ($103.96 in chips) 
matiko09: posts small blind $0.50
Spid1: posts big blind $1
*** HOLE CARDS ***
Dealt to matiko09 [4c Td]
nubpoker: folds 
Filojoes: folds 
Aghmir77: folds 
Dickyxxx: raises $2 to $3
chaps1988: folds 
MichaLabam: calls $3
matiko09: folds 
Spid1: folds 
*** FLOP *** [2s 6d 8s]
Dickyxxx: bets $4.74
MichaLabam: calls $4.74
*** TURN *** [2s 6d 8s] [Ac]
Dickyxxx: bets $10.75
MichaLabam: folds 
Uncalled bet ($10.75) returned to Dickyxxx
Dickyxxx collected $16.13 from pot
Dickyxxx: doesn't show hand 
*** SUMMARY ***
Total pot $16.98 | Rake $0.85 
Board [2s 6d 8s Ac]
Seat 1: Dickyxxx collected ($16.13)
Seat 3: chaps1988 folded before Flop (didn't bet)
Seat 4: MichaLabam (button) folded on the Turn
Seat 5: matiko09 (small blind) folded before Flop
Seat 6: Spid1 (big blind) folded before Flop
Seat 7: nubpoker folded before Flop (didn't bet)
Seat 8: Filojoes folded before Flop (didn't bet)
Seat 9: Aghmir77 folded before Flop (didn't bet)





PokerStars Hand #153066321486:  Hold'em No Limit ($0.50/$1.00 USD) - 2016/05/09 16:06:24 CET [2016/05/09 10:06:24 ET]
Table 'Silesia' 9-max Seat #5 is the button
Seat 1: MihaiCristea ($66.76 in chips) 
Seat 3: Dickyxxx ($105.80 in chips) 
Seat 5: matiko09 ($247.39 in chips) 
Seat 8: Aghmir77 ($83.50 in chips) 
Aghmir77: posts small blind $0.50
MihaiCristea: posts big blind $1
*** HOLE CARDS ***
Dealt to matiko09 [2d 7c]
Dickyxxx: folds 
matiko09: folds 
heroPaul1 joins the table at seat #6 
Aghmir77: folds 
Uncalled bet ($0.50) returned to MihaiCristea
MihaiCristea collected $1 from pot
MihaiCristea: doesn't show hand 
*** SUMMARY ***
Total pot $1 | Rake $0 
Seat 1: MihaiCristea (big blind) collected ($1)
Seat 3: Dickyxxx folded before Flop (didn't bet)
Seat 5: matiko09 (button) folded before Flop (didn't bet)
Seat 8: Aghmir77 (small blind) folded before Flop





PokerStars Hand #153066323779:  Hold'em No Limit ($0.50/$1.00 USD) - 2016/05/09 16:06:29 CET [2016/05/09 10:06:29 ET]
Table 'Terpsichore' 9-max Seat #9 is the button
Seat 1: ipashutapkom ($54.86 in chips) 
Seat 2: J0k3rF4c3_FD ($182.66 in chips) 
Seat 3: matiko09 ($105.37 in chips) 
Seat 8: Kiosk230472 ($132.87 in chips) 
Seat 9: FTPbannedMe ($100 in chips) 
ipashutapkom: posts small blind $0.50
J0k3rF4c3_FD: posts big blind $1
nubpoker: sits out 
r4mz3s: sits out 
*** HOLE CARDS ***
Dealt to matiko09 [Ac Ts]
ozone2003 joins the table at seat #7 
matiko09: raises $2 to $3
Kiosk230472: calls $3
FTPbannedMe: folds 
ipashutapkom: folds 
J0k3rF4c3_FD: calls $2
*** FLOP *** [7s 8c 7h]
J0k3rF4c3_FD: checks 
matiko09: checks 
Kiosk230472: checks 
*** TURN *** [7s 8c 7h] [6d]
J0k3rF4c3_FD: checks 
matiko09: checks 
Kiosk230472: bets $7
J0k3rF4c3_FD: folds 
matiko09: folds 
Uncalled bet ($7) returned to Kiosk230472
Kiosk230472 collected $9.02 from pot
Kiosk230472: doesn't show hand 
*** SUMMARY ***
Total pot $9.50 | Rake $0.48 
Board [7s 8c 7h 6d]
Seat 1: ipashutapkom (small blind) folded before Flop
Seat 2: J0k3rF4c3_FD (big blind) folded on the Turn
Seat 3: matiko09 folded on the Turn
Seat 8: Kiosk230472 collected ($9.02)
Seat 9: FTPbannedMe (button) folded before Flop (didn't bet)





PokerStars Hand #153066326112:  Hold'em No Limit ($1/$2 USD) - 2016/05/09 16:06:33 CET [2016/05/09 10:06:33 ET]
Table 'Luda' 9-max Seat #5 is the button
Seat 1: stan_09319 ($411.99 in chips) 
Seat 2: matiko09 ($224.80 in chips) 
Seat 3: Monsthand ($425.55 in chips) 
Seat 4: Igoriah ($200 in chips) 
Seat 5: J0k3rF4c3_FD ($200 in chips) 
Seat 6: Iggso ($200 in chips) 
Seat 7: chaps1988 ($222.25 in chips) 
Seat 8: ramseyg117 ($554.85 in chips) 
Seat 9: solano20000 ($141.74 in chips) 
Iggso: posts small blind $1
chaps1988: posts big blind $2
*** HOLE CARDS ***
Dealt to matiko09 [4d 2c]
ramseyg117: calls $2
solano20000: folds 
stan_09319: folds 
matiko09: folds 
Monsthand: folds 
Igoriah: folds 
J0k3rF4c3_FD: calls $2
Iggso: calls $1
chaps1988: checks 
*** FLOP *** [3s As 9d]
Iggso: checks 
chaps1988: checks 
ramseyg117: bets $2
J0k3rF4c3_FD: folds 
Iggso: folds 
chaps1988: folds 
Uncalled bet ($2) returned to ramseyg117
ramseyg117 collected $7.60 from pot
ramseyg117: doesn't show hand 
*** SUMMARY ***
Total pot $8 | Rake $0.40 
Board [3s As 9d]
Seat 1: stan_09319 folded before Flop (didn't bet)
Seat 2: matiko09 folded before Flop (didn't bet)
Seat 3: Monsthand folded before Flop (didn't bet)
Seat 4: Igoriah folded before Flop (didn't bet)
Seat 5: J0k3rF4c3_FD (button) folded on the Flop
Seat 6: Iggso (small blind) folded on the Flop
Seat 7: chaps1988 (big blind) folded on the Flop
Seat 8: ramseyg117 collected ($7.60)
Seat 9: solano20000 folded before Flop (didn't bet)





PokerStars Hand #153066344836:  Hold'em No Limit ($0.50/$1.00 USD) - 2016/05/09 16:07:06 CET [2016/05/09 10:07:06 ET]
Table 'Merga II' 9-max Seat #8 is the button
Seat 1: ipashutapkom ($40 in chips) 
Seat 2: Filojoes ($100.18 in chips) 
Seat 3: xhinostrabli ($38.49 in chips) 
Seat 4: nubpoker ($100 in chips) 
Seat 5: LRVAV7 ($254.91 in chips) 
Seat 6: Spid1 ($287.48 in chips) 
Seat 7: matiko09 ($153.29 in chips) 
Seat 8: GrandOldFart ($100 in chips) 
Seat 9: chaps1988 ($222.43 in chips) 
chaps1988: posts small blind $0.50
ipashutapkom: posts big blind $1
*** HOLE CARDS ***
Dealt to matiko09 [Ac Td]
Filojoes: raises $2 to $3
xhinostrabli: folds 
nubpoker: folds 
LRVAV7: folds 
Spid1: folds 
matiko09: folds 
GrandOldFart: folds 
chaps1988: folds 
ipashutapkom: folds 
Uncalled bet ($2) returned to Filojoes
Filojoes collected $2.50 from pot
Filojoes: doesn't show hand 
*** SUMMARY ***
Total pot $2.50 | Rake $0 
Seat 1: ipashutapkom (big blind) folded before Flop
Seat 2: Filojoes collected ($2.50)
Seat 3: xhinostrabli folded before Flop (didn't bet)
Seat 4: nubpoker folded before Flop (didn't bet)
Seat 5: LRVAV7 folded before Flop (didn't bet)
Seat 6: Spid1 folded before Flop (didn't bet)
Seat 7: matiko09 folded before Flop (didn't bet)
Seat 8: GrandOldFart (button) folded before Flop (didn't bet)
Seat 9: chaps1988 (small blind) folded before Flop





PokerStars Hand #153066345680:  Hold'em No Limit ($0.50/$1.00 USD) - 2016/05/09 16:07:07 CET [2016/05/09 10:07:07 ET]
Table 'Hajek' 9-max Seat #6 is the button
Seat 1: Mukhin1 ($109.10 in chips) 
Seat 2: Spid1 ($100 in chips) 
Seat 4: LRVAV7 ($65.83 in chips) 
Seat 5: ozone2003 ($100 in chips) 
Seat 6: Filojoes ($103.70 in chips) 
Seat 7: DancerNN1 ($118.64 in chips) 
Seat 8: Kukuryzka ($99 in chips) 
Seat 9: matiko09 ($100 in chips) 
DancerNN1: posts small blind $0.50
Kukuryzka: posts big blind $1
Mukhin1: posts the ante $0.20
Spid1: posts the ante $0.20
LRVAV7: posts the ante $0.20
ozone2003: posts the ante $0.20
Filojoes: posts the ante $0.20
DancerNN1: posts the ante $0.20
Kukuryzka: posts the ante $0.20
matiko09: posts the ante $0.20
*** HOLE CARDS ***
Dealt to matiko09 [4c Jh]
matiko09: folds 
Mukhin1: raises $2 to $3
Spid1: folds 
LRVAV7: folds 
ozone2003: folds 
Filojoes: folds 
DancerNN1: folds 
Kukuryzka: folds 
Uncalled bet ($2) returned to Mukhin1
Mukhin1 collected $4.10 from pot
Mukhin1: doesn't show hand 
*** SUMMARY ***
Total pot $4.10 | Rake $0 
Seat 1: Mukhin1 collected ($4.10)
Seat 2: Spid1 folded before Flop (didn't bet)
Seat 4: LRVAV7 folded before Flop (didn't bet)
Seat 5: ozone2003 folded before Flop (didn't bet)
Seat 6: Filojoes (button) folded before Flop (didn't bet)
Seat 7: DancerNN1 (small blind) folded before Flop
Seat 8: Kukuryzka (big blind) folded before Flop
Seat 9: matiko09 folded before Flop (didn't bet)





PokerStars Hand #153066347698:  Hold'em No Limit ($1/$2 USD) - 2016/05/09 16:07:11 CET [2016/05/09 10:07:11 ET]
Table 'Luda' 9-max Seat #6 is the button
Seat 1: stan_09319 ($411.99 in chips) 
Seat 2: matiko09 ($224.80 in chips) 
Seat 3: Monsthand ($425.55 in chips) 
Seat 4: Igoriah ($200 in chips) 
Seat 5: J0k3rF4c3_FD ($200 in chips) 
Seat 6: Iggso ($200 in chips) 
Seat 7: chaps1988 ($220.25 in chips) 
Seat 8: ramseyg117 ($560.45 in chips) 
Seat 9: solano20000 ($141.74 in chips) 
chaps1988: posts small blind $1
ramseyg117: posts big blind $2
*** HOLE CARDS ***
Dealt to matiko09 [Kc 7c]
solano20000: folds 
stan_09319: folds 
matiko09: folds 
Monsthand: folds 
Igoriah: folds 
J0k3rF4c3_FD: raises $3 to $5
Iggso: folds 
chaps1988: folds 
ramseyg117: calls $3
*** FLOP *** [4h Qs Td]
ramseyg117: bets $2
J0k3rF4c3_FD: folds 
Uncalled bet ($2) returned to ramseyg117
ramseyg117 collected $10.45 from pot
ramseyg117: doesn't show hand 
*** SUMMARY ***
Total pot $11 | Rake $0.55 
Board [4h Qs Td]
Seat 1: stan_09319 folded before Flop (didn't bet)
Seat 2: matiko09 folded before Flop (didn't bet)
Seat 3: Monsthand folded before Flop (didn't bet)
Seat 4: Igoriah folded before Flop (didn't bet)
Seat 5: J0k3rF4c3_FD folded on the Flop
Seat 6: Iggso (button) folded before Flop (didn't bet)
Seat 7: chaps1988 (small blind) folded before Flop
Seat 8: ramseyg117 (big blind) collected ($10.45)
Seat 9: solano20000 folded before Flop (didn't bet)





PokerStars Hand #153066352683:  Hold'em No Limit ($0.50/$1.00 USD) - 2016/05/09 16:07:19 CET [2016/05/09 10:07:19 ET]
Table 'Terpsichore' 9-max Seat #1 is the button
Seat 1: ipashutapkom ($54.36 in chips) 
Seat 2: J0k3rF4c3_FD ($179.66 in chips) 
Seat 3: matiko09 ($102.37 in chips) 
Seat 8: Kiosk230472 ($138.89 in chips) 
Seat 9: FTPbannedMe ($100 in chips) 
J0k3rF4c3_FD: posts small blind $0.50
matiko09: posts big blind $1
nubpoker: sits out 
r4mz3s: sits out 
ozone2003: sits out 
*** HOLE CARDS ***
Dealt to matiko09 [9c Ah]
Kiosk230472: folds 
FTPbannedMe: folds 
ipashutapkom: raises $1.26 to $2.26
J0k3rF4c3_FD: raises $6.24 to $8.50
matiko09: folds 
ipashutapkom: raises $45.36 to $53.86
J0k3rF4c3_FD: folds 
Uncalled bet ($45.36) returned to ipashutapkom
ipashutapkom collected $18 from pot
ipashutapkom: doesn't show hand 
*** SUMMARY ***
Total pot $18 | Rake $0 
Seat 1: ipashutapkom (button) collected ($18)
Seat 2: J0k3rF4c3_FD (small blind) folded before Flop
Seat 3: matiko09 (big blind) folded before Flop
Seat 8: Kiosk230472 folded before Flop (didn't bet)
Seat 9: FTPbannedMe folded before Flop (didn't bet)





PokerStars Hand #153066354911:  Hold'em No Limit ($0.50/$1.00 USD) - 2016/05/09 16:07:23 CET [2016/05/09 10:07:23 ET]
Table 'Alderamin' 9-max Seat #9 is the button
Seat 1: r4mz3s ($100 in chips) 
Seat 2: Filojoes ($123.43 in chips) 
Seat 3: NSL0808 ($72.68 in chips) 
Seat 4: matiko09 ($100 in chips) 
Seat 5: tanmayh ($111.86 in chips) 
Seat 6: Spid1 ($116.98 in chips) 
Seat 7: azzad2007 ($112.18 in chips) 
Seat 8: nubpoker ($100.75 in chips) 
Seat 9: ipashutapkom ($40 in chips) 
r4mz3s: posts small blind $0.50
Filojoes: posts big blind $1
*** HOLE CARDS ***
Dealt to matiko09 [Js 8h]
NSL0808: folds 
matiko09: folds 
tanmayh: folds 
Spid1: folds 
azzad2007: folds 
nubpoker: folds 
ipashutapkom: folds 
r4mz3s: raises $2 to $3
Filojoes: calls $2
*** FLOP *** [Th 6c 4s]
r4mz3s: checks 
Filojoes: bets $3.42
r4mz3s: folds 
Uncalled bet ($3.42) returned to Filojoes
Filojoes collected $5.70 from pot
Filojoes: doesn't show hand 
*** SUMMARY ***
Total pot $6 | Rake $0.30 
Board [Th 6c 4s]
Seat 1: r4mz3s (small blind) folded on the Flop
Seat 2: Filojoes (big blind) collected ($5.70)
Seat 3: NSL0808 folded before Flop (didn't bet)
Seat 4: matiko09 folded before Flop (didn't bet)
Seat 5: tanmayh folded before Flop (didn't bet)
Seat 6: Spid1 folded before Flop (didn't bet)
Seat 7: azzad2007 folded before Flop (didn't bet)
Seat 8: nubpoker folded before Flop (didn't bet)
Seat 9: ipashutapkom (button) folded before Flop (didn't bet)





PokerStars Hand #153066356910:  Hold'em No Limit ($0.50/$1.00 USD) - 2016/05/09 16:07:27 CET [2016/05/09 10:07:27 ET]
Table 'Reiss' 9-max Seat #5 is the button
Seat 1: Dickyxxx ($214.90 in chips) 
Seat 3: chaps1988 ($111.49 in chips) 
Seat 4: MichaLabam ($126.02 in chips) 
Seat 5: matiko09 ($100 in chips) 
Seat 6: Spid1 ($138.93 in chips) 
Seat 7: nubpoker ($100 in chips) 
Seat 8: Filojoes ($187.18 in chips) 
Seat 9: Aghmir77 ($103.96 in chips) 
Spid1: posts small blind $0.50
nubpoker: posts big blind $1
*** HOLE CARDS ***
Dealt to matiko09 [3c Jd]
Filojoes: folds 
Aghmir77: folds 
Dickyxxx: folds 
chaps1988: raises $1.50 to $2.50
MichaLabam: calls $2.50
matiko09: folds 
Spid1: folds 
nubpoker: folds 
*** FLOP *** [8c 6h 7s]
chaps1988: checks 
MichaLabam: bets $3
chaps1988: calls $3
*** TURN *** [8c 6h 7s] [2d]
chaps1988: checks 
MichaLabam: checks 
*** RIVER *** [8c 6h 7s 2d] [4d]
chaps1988: bets $7
MichaLabam: folds 
Uncalled bet ($7) returned to chaps1988
chaps1988 collected $11.88 from pot
chaps1988: doesn't show hand 
*** SUMMARY ***
Total pot $12.50 | Rake $0.62 
Board [8c 6h 7s 2d 4d]
Seat 1: Dickyxxx folded before Flop (didn't bet)
Seat 3: chaps1988 collected ($11.88)
Seat 4: MichaLabam folded on the River
Seat 5: matiko09 (button) folded before Flop (didn't bet)
Seat 6: Spid1 (small blind) folded before Flop
Seat 7: nubpoker (big blind) folded before Flop
Seat 8: Filojoes folded before Flop (didn't bet)
Seat 9: Aghmir77 folded before Flop (didn't bet)





PokerStars Hand #153066363713:  Hold'em No Limit ($0.50/$1.00 USD) - 2016/05/09 16:07:39 CET [2016/05/09 10:07:39 ET]
Table 'Merga II' 9-max Seat #9 is the button
Seat 1: ipashutapkom ($40 in chips) 
Seat 2: Filojoes ($101.68 in chips) 
Seat 3: xhinostrabli ($38.49 in chips) 
Seat 4: nubpoker ($100 in chips) 
Seat 5: LRVAV7 ($254.91 in chips) 
Seat 6: Spid1 ($287.48 in chips) 
Seat 7: matiko09 ($153.29 in chips) 
Seat 8: GrandOldFart ($100 in chips) 
Seat 9: chaps1988 ($221.93 in chips) 
ipashutapkom: posts small blind $0.50
Filojoes: posts big blind $1
*** HOLE CARDS ***
Dealt to matiko09 [8s Qd]
xhinostrabli: folds 
nubpoker: folds 
LRVAV7: folds 
Spid1: folds 
matiko09: folds 
GrandOldFart: folds 
chaps1988: raises $1.25 to $2.25
ipashutapkom: folds 
Filojoes: folds 
Uncalled bet ($1.25) returned to chaps1988
chaps1988 collected $2.50 from pot
chaps1988: doesn't show hand 
*** SUMMARY ***
Total pot $2.50 | Rake $0 
Seat 1: ipashutapkom (small blind) folded before Flop
Seat 2: Filojoes (big blind) folded before Flop
Seat 3: xhinostrabli folded before Flop (didn't bet)
Seat 4: nubpoker folded before Flop (didn't bet)
Seat 5: LRVAV7 folded before Flop (didn't bet)
Seat 6: Spid1 folded before Flop (didn't bet)
Seat 7: matiko09 folded before Flop (didn't bet)
Seat 8: GrandOldFart folded before Flop (didn't bet)
Seat 9: chaps1988 (button) collected ($2.50)





PokerStars Hand #153066367921:  Hold'em No Limit ($1/$2 USD) - 2016/05/09 16:07:46 CET [2016/05/09 10:07:46 ET]
Table 'Luda' 9-max Seat #7 is the button
Seat 1: stan_09319 ($411.99 in chips) 
Seat 2: matiko09 ($224.80 in chips) 
Seat 3: Monsthand ($425.55 in chips) 
Seat 4: Igoriah ($200 in chips) 
Seat 5: J0k3rF4c3_FD ($200 in chips) 
Seat 6: Iggso ($200 in chips) 
Seat 7: chaps1988 ($219.25 in chips) 
Seat 8: ramseyg117 ($565.90 in chips) 
Seat 9: solano20000 ($141.74 in chips) 
ramseyg117: posts small blind $1
solano20000: posts big blind $2
*** HOLE CARDS ***
Dealt to matiko09 [Qh Qc]
stan_09319: folds 
matiko09: raises $3 to $5
Monsthand: folds 
Igoriah: folds 
J0k3rF4c3_FD: folds 
Iggso: folds 
chaps1988: folds 
ramseyg117: calls $4
solano20000: raises $5 to $10
matiko09: raises $18 to $28
ramseyg117: calls $23
solano20000: raises $113.74 to $141.74 and is all-in
matiko09: raises $83.06 to $224.80 and is all-in
ramseyg117 is disconnected 
ramseyg117 is connected 
ramseyg117: folds 
Uncalled bet ($83.06) returned to matiko09
*** FLOP *** [8s 4d Jd]
*** TURN *** [8s 4d Jd] [6h]
*** RIVER *** [8s 4d Jd 6h] [Js]
*** SHOW DOWN ***
solano20000: shows [Ac Ad] (two pair, Aces and Jacks)
matiko09: mucks hand 
solano20000 collected $308.73 from pot
*** SUMMARY ***
Total pot $311.48 | Rake $2.75 
Board [8s 4d Jd 6h Js]
Seat 1: stan_09319 folded before Flop (didn't bet)
Seat 2: matiko09 mucked [Qh Qc]
Seat 3: Monsthand folded before Flop (didn't bet)
Seat 4: Igoriah folded before Flop (didn't bet)
Seat 5: J0k3rF4c3_FD folded before Flop (didn't bet)
Seat 6: Iggso folded before Flop (didn't bet)
Seat 7: chaps1988 (button) folded before Flop (didn't bet)
Seat 8: ramseyg117 (small blind) folded before Flop
Seat 9: solano20000 (big blind) showed [Ac Ad] and won ($308.73) with two pair, Aces and Jacks





PokerStars Hand #153066371215:  Hold'em No Limit ($0.50/$1.00 USD) - 2016/05/09 16:07:52 CET [2016/05/09 10:07:52 ET]
Table 'Hajek' 9-max Seat #7 is the button
Seat 1: Mukhin1 ($112 in chips) 
Seat 2: Spid1 ($100 in chips) 
Seat 4: LRVAV7 ($65.63 in chips) 
Seat 5: ozone2003 ($100 in chips) 
Seat 6: Filojoes ($103.50 in chips) 
Seat 7: DancerNN1 ($117.94 in chips) 
Seat 8: Kukuryzka ($100 in chips) 
Seat 9: matiko09 ($100 in chips) 
Kukuryzka: posts small blind $0.50
matiko09: posts big blind $1
Mukhin1: posts the ante $0.20
Spid1: posts the ante $0.20
LRVAV7: posts the ante $0.20
ozone2003: posts the ante $0.20
Filojoes: posts the ante $0.20
DancerNN1: posts the ante $0.20
Kukuryzka: posts the ante $0.20
matiko09: posts the ante $0.20
*** HOLE CARDS ***
Dealt to matiko09 [4d Kc]
Mukhin1: raises $2 to $3
Spid1: folds 
LRVAV7: calls $3
ozone2003: folds 
Filojoes: folds 
DancerNN1: folds 
Kukuryzka: folds 
matiko09: folds 
*** FLOP *** [3c 2c 2h]
Mukhin1: checks 
LRVAV7: bets $6
Mukhin1: calls $6
*** TURN *** [3c 2c 2h] [9h]
Mukhin1: checks 
LRVAV7: bets $15
Mukhin1: folds 
Uncalled bet ($15) returned to LRVAV7
LRVAV7 collected $20.04 from pot
LRVAV7: doesn't show hand 
*** SUMMARY ***
Total pot $21.10 | Rake $1.06 
Board [3c 2c 2h 9h]
Seat 1: Mukhin1 folded on the Turn
Seat 2: Spid1 folded before Flop (didn't bet)
Seat 4: LRVAV7 collected ($20.04)
Seat 5: ozone2003 folded before Flop (didn't bet)
Seat 6: Filojoes folded before Flop (didn't bet)
Seat 7: DancerNN1 (button) folded before Flop (didn't bet)
Seat 8: Kukuryzka (small blind) folded before Flop
Seat 9: matiko09 (big blind) folded before Flop





PokerStars Hand #153066373078:  Hold'em No Limit ($1/$2 USD) - 2016/05/09 16:07:55 CET [2016/05/09 10:07:55 ET]
Table 'Hagar II' 9-max Seat #3 is the button
Seat 1: azzad2007 ($255.62 in chips) 
Seat 3: stan_09319 ($200 in chips) 
Seat 4: matiko09 ($242.15 in chips) 
Seat 5: PacPacBum ($200 in chips) 
Seat 6: Piniker85 ($826.07 in chips) 
Seat 7: Monsthand ($200 in chips) 
Seat 8: J0k3rF4c3_FD ($380.60 in chips) 
Seat 9: chaps1988 ($200 in chips) 
matiko09: posts small blind $1
PacPacBum: posts big blind $2
darren1031: sits out 
*** HOLE CARDS ***
Dealt to matiko09 [Jd 7h]
Piniker85: folds 
Monsthand: folds 
J0k3rF4c3_FD: raises $3 to $5
chaps1988: folds 
azzad2007: folds 
stan_09319: folds 
matiko09: folds 
PacPacBum: folds 
Uncalled bet ($3) returned to J0k3rF4c3_FD
J0k3rF4c3_FD collected $5 from pot
J0k3rF4c3_FD: doesn't show hand 
*** SUMMARY ***
Total pot $5 | Rake $0 
Seat 1: azzad2007 folded before Flop (didn't bet)
Seat 3: stan_09319 (button) folded before Flop (didn't bet)
Seat 4: matiko09 (small blind) folded before Flop
Seat 5: PacPacBum (big blind) folded before Flop
Seat 6: Piniker85 folded before Flop (didn't bet)
Seat 7: Monsthand folded before Flop (didn't bet)
Seat 8: J0k3rF4c3_FD collected ($5)
Seat 9: chaps1988 folded before Flop (didn't bet)





PokerStars Hand #153066383285:  Hold'em No Limit ($0.50/$1.00 USD) - 2016/05/09 16:08:13 CET [2016/05/09 10:08:13 ET]
Table 'Isberga II' 9-max Seat #1 is the button
Seat 1: Kukuryzka ($100 in chips) 
Seat 2: Filojoes ($100 in chips) 
Seat 3: matiko09 ($100 in chips) 
Seat 4: mishanay111 ($55.46 in chips) 
Seat 9: tubelight00 ($100.85 in chips) 
Filojoes: posts small blind $0.50
matiko09: posts big blind $1
*** HOLE CARDS ***
Dealt to matiko09 [Kc 2d]
mishanay111: folds 
tubelight00: folds 
Kukuryzka: raises $1 to $2
Filojoes: calls $1.50
matiko09: folds 
*** FLOP *** [5c As 7d]
nubpoker joins the table at seat #5 
Filojoes: bets $3
Kukuryzka: calls $3
*** TURN *** [5c As 7d] [3d]
maxxmeister joins the table at seat #6 
azzad2007 joins the table at seat #7 
ozone2003 joins the table at seat #8 
Filojoes: bets $7
Kukuryzka: calls $7
*** RIVER *** [5c As 7d 3d] [6d]
Filojoes: checks 
Kukuryzka: checks 
*** SHOW DOWN ***
Filojoes: shows [5h 5d] (three of a kind, Fives)
Kukuryzka: mucks hand 
Filojoes collected $23.75 from pot
*** SUMMARY ***
Total pot $25 | Rake $1.25 
Board [5c As 7d 3d 6d]
Seat 1: Kukuryzka (button) mucked [Ad Ks]
Seat 2: Filojoes (small blind) showed [5h 5d] and won ($23.75) with three of a kind, Fives
Seat 3: matiko09 (big blind) folded before Flop
Seat 4: mishanay111 folded before Flop (didn't bet)
Seat 9: tubelight00 folded before Flop (didn't bet)





PokerStars Hand #153066386405:  Hold'em No Limit ($1/$2 USD) - 2016/05/09 16:08:18 CET [2016/05/09 10:08:18 ET]
Table 'Hagar II' 9-max Seat #4 is the button
Seat 1: azzad2007 ($255.62 in chips) 
Seat 3: stan_09319 ($200 in chips) 
Seat 4: matiko09 ($241.15 in chips) 
Seat 5: PacPacBum ($200 in chips) 
Seat 6: Piniker85 ($826.07 in chips) 
Seat 7: Monsthand ($200 in chips) 
Seat 8: J0k3rF4c3_FD ($383.60 in chips) 
Seat 9: chaps1988 ($200 in chips) 
PacPacBum: posts small blind $1
Piniker85: posts big blind $2
darren1031: sits out 
*** HOLE CARDS ***
Dealt to matiko09 [6s 7d]
Monsthand: folds 
J0k3rF4c3_FD: raises $3 to $5
chaps1988: folds 
azzad2007: folds 
stan_09319: folds 
matiko09: folds 
PacPacBum: folds 
Piniker85: folds 
Uncalled bet ($3) returned to J0k3rF4c3_FD
J0k3rF4c3_FD collected $5 from pot
J0k3rF4c3_FD: doesn't show hand 
*** SUMMARY ***
Total pot $5 | Rake $0 
Seat 1: azzad2007 folded before Flop (didn't bet)
Seat 3: stan_09319 folded before Flop (didn't bet)
Seat 4: matiko09 (button) folded before Flop (didn't bet)
Seat 5: PacPacBum (small blind) folded before Flop
Seat 6: Piniker85 (big blind) folded before Flop
Seat 7: Monsthand folded before Flop (didn't bet)
Seat 8: J0k3rF4c3_FD collected ($5)
Seat 9: chaps1988 folded before Flop (didn't bet)





PokerStars Hand #153066390558:  Hold'em No Limit ($0.50/$1.00 USD) - 2016/05/09 16:08:26 CET [2016/05/09 10:08:26 ET]
Table 'Terpsichore' 9-max Seat #2 is the button
Seat 1: ipashutapkom ($63.86 in chips) 
Seat 2: J0k3rF4c3_FD ($171.16 in chips) 
Seat 3: matiko09 ($101.37 in chips) 
Seat 4: nubpoker ($100 in chips) 
Seat 8: Kiosk230472 ($138.89 in chips) 
Seat 9: FTPbannedMe ($100 in chips) 
matiko09: posts small blind $0.50
nubpoker: posts big blind $1
r4mz3s: sits out 
ozone2003: sits out 
*** HOLE CARDS ***
Dealt to matiko09 [7c Jc]
Kiosk230472: folds 
FTPbannedMe: folds 
ipashutapkom: folds 
J0k3rF4c3_FD: folds 
matiko09: raises $1.50 to $2.50
nubpoker: calls $1.50
*** FLOP *** [9c 7h Kc]
matiko09: bets $3.09
nubpoker: raises $7.28 to $10.37
matiko09: raises $16.63 to $27
nubpoker: calls $16.63
*** TURN *** [9c 7h Kc] [3c]
matiko09: checks 
nubpoker: checks 
*** RIVER *** [9c 7h Kc 3c] [3d]
matiko09: checks 
nubpoker: checks 
*** SHOW DOWN ***
matiko09: shows [7c Jc] (a flush, King high)
nubpoker: mucks hand 
matiko09 collected $56.50 from pot
*** SUMMARY ***
Total pot $59 | Rake $2.50 
Board [9c 7h Kc 3c 3d]
Seat 1: ipashutapkom folded before Flop (didn't bet)
Seat 2: J0k3rF4c3_FD (button) folded before Flop (didn't bet)
Seat 3: matiko09 (small blind) showed [7c Jc] and won ($56.50) with a flush, King high
Seat 4: nubpoker (big blind) mucked [Ks Qh]
Seat 8: Kiosk230472 folded before Flop (didn't bet)
Seat 9: FTPbannedMe folded before Flop (didn't bet)





PokerStars Hand #153066391100:  Hold'em No Limit ($0.50/$1.00 USD) - 2016/05/09 16:08:27 CET [2016/05/09 10:08:27 ET]
Table 'Merga II' 9-max Seat #1 is the button
Seat 1: ipashutapkom ($40 in chips) 
Seat 2: Filojoes ($100.68 in chips) 
Seat 3: xhinostrabli ($38.49 in chips) 
Seat 4: nubpoker ($100 in chips) 
Seat 5: LRVAV7 ($254.91 in chips) 
Seat 6: Spid1 ($287.48 in chips) 
Seat 7: matiko09 ($153.29 in chips) 
Seat 8: GrandOldFart ($100 in chips) 
Seat 9: chaps1988 ($223.43 in chips) 
Filojoes: posts small blind $0.50
xhinostrabli: posts big blind $1
*** HOLE CARDS ***
Dealt to matiko09 [Qs 3s]
nubpoker: folds 
LRVAV7: raises $2 to $3
Spid1: folds 
matiko09: folds 
GrandOldFart: folds 
chaps1988: calls $3
ipashutapkom: folds 
Filojoes: folds 
xhinostrabli: calls $2
*** FLOP *** [8s 5h Ac]
xhinostrabli: checks 
LRVAV7: checks 
chaps1988: bets $5.50
xhinostrabli: raises $29.99 to $35.49 and is all-in
LRVAV7: folds 
chaps1988: folds 
Uncalled bet ($29.99) returned to xhinostrabli
xhinostrabli collected $19.48 from pot
*** SUMMARY ***
Total pot $20.50 | Rake $1.02 
Board [8s 5h Ac]
Seat 1: ipashutapkom (button) folded before Flop (didn't bet)
Seat 2: Filojoes (small blind) folded before Flop
Seat 3: xhinostrabli (big blind) collected ($19.48)
Seat 4: nubpoker folded before Flop (didn't bet)
Seat 5: LRVAV7 folded on the Flop
Seat 6: Spid1 folded before Flop (didn't bet)
Seat 7: matiko09 folded before Flop (didn't bet)
Seat 8: GrandOldFart folded before Flop (didn't bet)
Seat 9: chaps1988 folded on the Flop





PokerStars Hand #153066392341:  Hold'em No Limit ($0.50/$1.00 USD) - 2016/05/09 16:08:29 CET [2016/05/09 10:08:29 ET]
Table 'Reiss' 9-max Seat #6 is the button
Seat 1: Dickyxxx ($214.90 in chips) 
Seat 3: chaps1988 ($117.87 in chips) 
Seat 4: MichaLabam ($120.52 in chips) 
Seat 5: matiko09 ($100 in chips) 
Seat 6: Spid1 ($138.43 in chips) 
Seat 7: nubpoker ($100 in chips) 
Seat 8: Filojoes ($187.18 in chips) 
Seat 9: Aghmir77 ($103.96 in chips) 
nubpoker: posts small blind $0.50
Filojoes: posts big blind $1
*** HOLE CARDS ***
Dealt to matiko09 [Kc Jh]
Aghmir77: folds 
Dickyxxx: folds 
chaps1988: raises $2 to $3
MichaLabam: folds 
matiko09: folds 
Spid1: folds 
nubpoker: folds 
Filojoes: folds 
Uncalled bet ($2) returned to chaps1988
chaps1988 collected $2.50 from pot
chaps1988: doesn't show hand 
*** SUMMARY ***
Total pot $2.50 | Rake $0 
Seat 1: Dickyxxx folded before Flop (didn't bet)
Seat 3: chaps1988 collected ($2.50)
Seat 4: MichaLabam folded before Flop (didn't bet)
Seat 5: matiko09 folded before Flop (didn't bet)
Seat 6: Spid1 (button) folded before Flop (didn't bet)
Seat 7: nubpoker (small blind) folded before Flop
Seat 8: Filojoes (big blind) folded before Flop
Seat 9: Aghmir77 folded before Flop (didn't bet)





PokerStars Hand #153066393520:  Hold'em No Limit ($0.50/$1.00 USD) - 2016/05/09 16:08:31 CET [2016/05/09 10:08:31 ET]
Table 'Alderamin' 9-max Seat #1 is the button
Seat 1: r4mz3s ($100 in chips) 
Seat 2: Filojoes ($126.13 in chips) 
Seat 3: NSL0808 ($72.68 in chips) 
Seat 4: matiko09 ($100 in chips) 
Seat 5: tanmayh ($111.86 in chips) 
Seat 6: Spid1 ($116.98 in chips) 
Seat 7: azzad2007 ($112.18 in chips) 
Seat 8: nubpoker ($100.75 in chips) 
Seat 9: ipashutapkom ($40 in chips) 
Filojoes: posts small blind $0.50
NSL0808: posts big blind $1
*** HOLE CARDS ***
Dealt to matiko09 [8c Th]
matiko09: folds 
tanmayh: raises $2.50 to $3.50
Spid1: folds 
azzad2007: folds 
nubpoker: folds 
ipashutapkom: folds 
r4mz3s: folds 
Filojoes: folds 
NSL0808: calls $2.50
*** FLOP *** [5d As Jd]
NSL0808: checks 
tanmayh: bets $7
NSL0808: folds 
Uncalled bet ($7) returned to tanmayh
tanmayh collected $7.12 from pot
tanmayh: doesn't show hand 
*** SUMMARY ***
Total pot $7.50 | Rake $0.38 
Board [5d As Jd]
Seat 1: r4mz3s (button) folded before Flop (didn't bet)
Seat 2: Filojoes (small blind) folded before Flop
Seat 3: NSL0808 (big blind) folded on the Flop
Seat 4: matiko09 folded before Flop (didn't bet)
Seat 5: tanmayh collected ($7.12)
Seat 6: Spid1 folded before Flop (didn't bet)
Seat 7: azzad2007 folded before Flop (didn't bet)
Seat 8: nubpoker folded before Flop (didn't bet)
Seat 9: ipashutapkom folded before Flop (didn't bet)





PokerStars Hand #153066398096:  Hold'em No Limit ($1/$2 USD) - 2016/05/09 16:08:39 CET [2016/05/09 10:08:39 ET]
Table 'Hagar II' 9-max Seat #5 is the button
Seat 1: azzad2007 ($255.62 in chips) 
Seat 3: stan_09319 ($200 in chips) 
Seat 4: matiko09 ($241.15 in chips) 
Seat 5: PacPacBum ($200 in chips) 
Seat 6: Piniker85 ($824.07 in chips) 
Seat 7: Monsthand ($200 in chips) 
Seat 8: J0k3rF4c3_FD ($386.60 in chips) 
Seat 9: chaps1988 ($200 in chips) 
Piniker85: posts small blind $1
Monsthand: posts big blind $2
darren1031: sits out 
*** HOLE CARDS ***
Dealt to matiko09 [Th Qh]
J0k3rF4c3_FD: folds 
chaps1988: folds 
azzad2007: folds 
stan_09319: folds 
matiko09: raises $3 to $5
PacPacBum: folds 
Piniker85: folds 
Monsthand: folds 
Uncalled bet ($3) returned to matiko09
matiko09 collected $5 from pot
matiko09: doesn't show hand 
*** SUMMARY ***
Total pot $5 | Rake $0 
Seat 1: azzad2007 folded before Flop (didn't bet)
Seat 3: stan_09319 folded before Flop (didn't bet)
Seat 4: matiko09 collected ($5)
Seat 5: PacPacBum (button) folded before Flop (didn't bet)
Seat 6: Piniker85 (small blind) folded before Flop
Seat 7: Monsthand (big blind) folded before Flop
Seat 8: J0k3rF4c3_FD folded before Flop (didn't bet)
Seat 9: chaps1988 folded before Flop (didn't bet)





PokerStars Hand #153066415520:  Hold'em No Limit ($1/$2 USD) - 2016/05/09 16:09:10 CET [2016/05/09 10:09:10 ET]
Table 'Hagar II' 9-max Seat #6 is the button
Seat 1: azzad2007 ($255.62 in chips) 
Seat 3: stan_09319 ($200 in chips) 
Seat 4: matiko09 ($244.15 in chips) 
Seat 5: PacPacBum ($200 in chips) 
Seat 6: Piniker85 ($823.07 in chips) 
Seat 7: Monsthand ($200 in chips) 
Seat 8: J0k3rF4c3_FD ($386.60 in chips) 
Seat 9: chaps1988 ($200 in chips) 
Monsthand: posts small blind $1
J0k3rF4c3_FD: posts big blind $2
darren1031: sits out 
*** HOLE CARDS ***
Dealt to matiko09 [6s 4s]
chaps1988: folds 
azzad2007: folds 
stan_09319: raises $2.70 to $4.70
matiko09: folds 
PacPacBum: folds 
Piniker85: folds 
Monsthand: folds 
J0k3rF4c3_FD: folds 
Uncalled bet ($2.70) returned to stan_09319
stan_09319 collected $5 from pot
stan_09319: doesn't show hand 
*** SUMMARY ***
Total pot $5 | Rake $0 
Seat 1: azzad2007 folded before Flop (didn't bet)
Seat 3: stan_09319 collected ($5)
Seat 4: matiko09 folded before Flop (didn't bet)
Seat 5: PacPacBum folded before Flop (didn't bet)
Seat 6: Piniker85 (button) folded before Flop (didn't bet)
Seat 7: Monsthand (small blind) folded before Flop
Seat 8: J0k3rF4c3_FD (big blind) folded before Flop
Seat 9: chaps1988 folded before Flop (didn't bet)





PokerStars Hand #153066421678:  Hold'em No Limit ($0.50/$1.00 USD) - 2016/05/09 16:09:20 CET [2016/05/09 10:09:20 ET]
Table 'Reiss' 9-max Seat #7 is the button
Seat 1: Dickyxxx ($214.90 in chips) 
Seat 3: chaps1988 ($119.37 in chips) 
Seat 4: MichaLabam ($120.52 in chips) 
Seat 5: matiko09 ($100 in chips) 
Seat 6: Spid1 ($138.43 in chips) 
Seat 7: nubpoker ($100 in chips) 
Seat 8: Filojoes ($186.18 in chips) 
Seat 9: Aghmir77 ($103.96 in chips) 
Filojoes: posts small blind $0.50
Aghmir77: posts big blind $1
*** HOLE CARDS ***
Dealt to matiko09 [Qh 9s]
Dickyxxx: folds 
chaps1988: folds 
MichaLabam: folds 
matiko09: folds 
Spid1: folds 
nubpoker: raises $1.50 to $2.50
Filojoes: folds 
Aghmir77: folds 
Uncalled bet ($1.50) returned to nubpoker
nubpoker collected $2.50 from pot
nubpoker: doesn't show hand 
*** SUMMARY ***
Total pot $2.50 | Rake $0 
Seat 1: Dickyxxx folded before Flop (didn't bet)
Seat 3: chaps1988 folded before Flop (didn't bet)
Seat 4: MichaLabam folded before Flop (didn't bet)
Seat 5: matiko09 folded before Flop (didn't bet)
Seat 6: Spid1 folded before Flop (didn't bet)
Seat 7: nubpoker (button) collected ($2.50)
Seat 8: Filojoes (small blind) folded before Flop
Seat 9: Aghmir77 (big blind) folded before Flop





PokerStars Hand #153066424596:  Hold'em No Limit ($0.50/$1.00 USD) - 2016/05/09 16:09:25 CET [2016/05/09 10:09:25 ET]
Table 'Hajek' 9-max Seat #8 is the button
Seat 1: Mukhin1 ($102.80 in chips) 
Seat 2: Spid1 ($100 in chips) 
Seat 4: LRVAV7 ($76.47 in chips) 
Seat 5: ozone2003 ($100 in chips) 
Seat 6: Filojoes ($103.30 in chips) 
Seat 7: DancerNN1 ($117.74 in chips) 
Seat 8: Kukuryzka ($99.30 in chips) 
Seat 9: matiko09 ($100 in chips) 
matiko09: posts small blind $0.50
Mukhin1: posts big blind $1
Mukhin1: posts the ante $0.20
Spid1: posts the ante $0.20
LRVAV7: posts the ante $0.20
ozone2003: posts the ante $0.20
Filojoes: posts the ante $0.20
DancerNN1: posts the ante $0.20
Kukuryzka: posts the ante $0.20
matiko09: posts the ante $0.20
*** HOLE CARDS ***
Dealt to matiko09 [9h 6s]
Spid1: folds 
LRVAV7: folds 
ozone2003: folds 
Filojoes: raises $2 to $3
DancerNN1: folds 
Kukuryzka: folds 
matiko09: folds 
Mukhin1: folds 
Uncalled bet ($2) returned to Filojoes
Filojoes collected $4.10 from pot
Filojoes: doesn't show hand 
*** SUMMARY ***
Total pot $4.10 | Rake $0 
Seat 1: Mukhin1 (big blind) folded before Flop
Seat 2: Spid1 folded before Flop (didn't bet)
Seat 4: LRVAV7 folded before Flop (didn't bet)
Seat 5: ozone2003 folded before Flop (didn't bet)
Seat 6: Filojoes collected ($4.10)
Seat 7: DancerNN1 folded before Flop (didn't bet)
Seat 8: Kukuryzka (button) folded before Flop (didn't bet)
Seat 9: matiko09 (small blind) folded before Flop





PokerStars Hand #153066426090:  Hold'em No Limit ($0.50/$1.00 USD) - 2016/05/09 16:09:28 CET [2016/05/09 10:09:28 ET]
Table 'Isberga II' 9-max Seat #2 is the button
Seat 1: Kukuryzka ($100 in chips) 
Seat 2: Filojoes ($111.75 in chips) 
Seat 3: matiko09 ($100 in chips) 
Seat 4: mishanay111 ($55.46 in chips) 
Seat 9: tubelight00 ($100.85 in chips) 
matiko09: posts small blind $0.50
mishanay111: posts big blind $1
nubpoker: sits out 
maxxmeister: sits out 
azzad2007: sits out 
ozone2003: sits out 
*** HOLE CARDS ***
Dealt to matiko09 [9d Ac]
tubelight00: folds 
Kukuryzka: folds 
Filojoes: folds 
matiko09: raises $1.50 to $2.50
mishanay111: folds 
Uncalled bet ($1.50) returned to matiko09
matiko09 collected $2 from pot
matiko09: doesn't show hand 
*** SUMMARY ***
Total pot $2 | Rake $0 
Seat 1: Kukuryzka folded before Flop (didn't bet)
Seat 2: Filojoes (button) folded before Flop (didn't bet)
Seat 3: matiko09 (small blind) collected ($2)
Seat 4: mishanay111 (big blind) folded before Flop
Seat 9: tubelight00 folded before Flop (didn't bet)





PokerStars Hand #153066425858:  Hold'em No Limit ($0.50/$1.00 USD) - 2016/05/09 16:09:28 CET [2016/05/09 10:09:28 ET]
Table 'Alderamin' 9-max Seat #2 is the button
Seat 1: r4mz3s ($100 in chips) 
Seat 2: Filojoes ($125.63 in chips) 
Seat 3: NSL0808 ($69.18 in chips) 
Seat 4: matiko09 ($100 in chips) 
Seat 5: tanmayh ($115.48 in chips) 
Seat 6: Spid1 ($116.98 in chips) 
Seat 7: azzad2007 ($112.18 in chips) 
Seat 8: nubpoker ($100.75 in chips) 
Seat 9: ipashutapkom ($40 in chips) 
NSL0808: posts small blind $0.50
matiko09: posts big blind $1
*** HOLE CARDS ***
Dealt to matiko09 [Jh 5s]
tanmayh: raises $2 to $3
Spid1: folds 
azzad2007: folds 
nubpoker: folds 
ipashutapkom: folds 
r4mz3s: folds 
Filojoes: calls $3
NSL0808: raises $4 to $7
matiko09: folds 
tanmayh: calls $4
Filojoes: calls $4
*** FLOP *** [9s 3h As]
NSL0808: bets $10.45
tanmayh: raises $98.03 to $108.48 and is all-in
Filojoes: folds 
NSL0808: folds 
Uncalled bet ($98.03) returned to tanmayh
tanmayh collected $40.76 from pot
tanmayh: doesn't show hand 
*** SUMMARY ***
Total pot $42.90 | Rake $2.14 
Board [9s 3h As]
Seat 1: r4mz3s folded before Flop (didn't bet)
Seat 2: Filojoes (button) folded on the Flop
Seat 3: NSL0808 (small blind) folded on the Flop
Seat 4: matiko09 (big blind) folded before Flop
Seat 5: tanmayh collected ($40.76)
Seat 6: Spid1 folded before Flop (didn't bet)
Seat 7: azzad2007 folded before Flop (didn't bet)
Seat 8: nubpoker folded before Flop (didn't bet)
Seat 9: ipashutapkom folded before Flop (didn't bet)





PokerStars Hand #153066432301:  Hold'em No Limit ($1/$2 USD) - 2016/05/09 16:09:39 CET [2016/05/09 10:09:39 ET]
Table 'Luda' 9-max Seat #8 is the button
Seat 1: stan_09319 ($411.99 in chips) 
Seat 2: matiko09 ($200 in chips) 
Seat 3: Monsthand ($425.55 in chips) 
Seat 4: Igoriah ($200 in chips) 
Seat 5: J0k3rF4c3_FD ($200 in chips) 
Seat 6: Iggso ($200 in chips) 
Seat 7: chaps1988 ($219.25 in chips) 
Seat 8: ramseyg117 ($537.90 in chips) 
Seat 9: solano20000 ($308.73 in chips) 
solano20000: posts small blind $1
stan_09319: posts big blind $2
*** HOLE CARDS ***
Dealt to matiko09 [7s Ah]
matiko09: folds 
Monsthand: folds 
Igoriah: raises $4 to $6
J0k3rF4c3_FD: folds 
Iggso: folds 
chaps1988: folds 
ramseyg117 is disconnected 
ramseyg117 has timed out while disconnected
ramseyg117: folds 
solano20000: folds 
stan_09319: calls $4
*** FLOP *** [2h 2c Jc]
solano20000 leaves the table
stan_09319: checks 
Igoriah: bets $8.15
ramseyg117 leaves the table
stan_09319: calls $8.15
*** TURN *** [2h 2c Jc] [Tc]
stan_09319: checks 
Igoriah: bets $17
stan_09319: folds 
Uncalled bet ($17) returned to Igoriah
Igoriah collected $27.84 from pot
Igoriah: doesn't show hand 
*** SUMMARY ***
Total pot $29.30 | Rake $1.46 
Board [2h 2c Jc Tc]
Seat 1: stan_09319 (big blind) folded on the Turn
Seat 2: matiko09 folded before Flop (didn't bet)
Seat 3: Monsthand folded before Flop (didn't bet)
Seat 4: Igoriah collected ($27.84)
Seat 5: J0k3rF4c3_FD folded before Flop (didn't bet)
Seat 6: Iggso folded before Flop (didn't bet)
Seat 7: chaps1988 folded before Flop (didn't bet)
Seat 8: ramseyg117 (button) folded before Flop (didn't bet)
Seat 9: solano20000 (small blind) folded before Flop





PokerStars Hand #153066434725:  Hold'em No Limit ($1/$2 USD) - 2016/05/09 16:09:43 CET [2016/05/09 10:09:43 ET]
Table 'Hagar II' 9-max Seat #7 is the button
Seat 1: azzad2007 ($255.62 in chips) 
Seat 3: stan_09319 ($203 in chips) 
Seat 4: matiko09 ($244.15 in chips) 
Seat 5: PacPacBum ($200 in chips) 
Seat 6: Piniker85 ($823.07 in chips) 
Seat 7: Monsthand ($200 in chips) 
Seat 8: J0k3rF4c3_FD ($384.60 in chips) 
Seat 9: chaps1988 ($200 in chips) 
J0k3rF4c3_FD: posts small blind $1
chaps1988: posts big blind $2
darren1031: sits out 
*** HOLE CARDS ***
Dealt to matiko09 [4h 3d]
azzad2007: folds 
stan_09319: folds 
matiko09: folds 
PacPacBum: folds 
Piniker85: raises $2 to $4
Monsthand: raises $11 to $15
J0k3rF4c3_FD: folds 
chaps1988: folds 
Piniker85: calls $11
*** FLOP *** [8c 3c 4d]
Piniker85: checks 
Monsthand: bets $19
Piniker85: folds 
Uncalled bet ($19) returned to Monsthand
Monsthand collected $31.35 from pot
Monsthand: doesn't show hand 
*** SUMMARY ***
Total pot $33 | Rake $1.65 
Board [8c 3c 4d]
Seat 1: azzad2007 folded before Flop (didn't bet)
Seat 3: stan_09319 folded before Flop (didn't bet)
Seat 4: matiko09 folded before Flop (didn't bet)
Seat 5: PacPacBum folded before Flop (didn't bet)
Seat 6: Piniker85 folded on the Flop
Seat 7: Monsthand (button) collected ($31.35)
Seat 8: J0k3rF4c3_FD (small blind) folded before Flop
Seat 9: chaps1988 (big blind) folded before Flop





PokerStars Hand #153066439274:  Hold'em No Limit ($0.50/$1.00 USD) - 2016/05/09 16:09:51 CET [2016/05/09 10:09:51 ET]
Table 'Reiss' 9-max Seat #8 is the button
Seat 1: Dickyxxx ($214.90 in chips) 
Seat 3: chaps1988 ($119.37 in chips) 
Seat 4: MichaLabam ($120.52 in chips) 
Seat 5: matiko09 ($100 in chips) 
Seat 6: Spid1 ($138.43 in chips) 
Seat 7: nubpoker ($101.50 in chips) 
Seat 8: Filojoes ($185.68 in chips) 
Seat 9: Aghmir77 ($102.96 in chips) 
Aghmir77: posts small blind $0.50
Dickyxxx: posts big blind $1
*** HOLE CARDS ***
Dealt to matiko09 [6h 8c]
chaps1988: folds 
MichaLabam: raises $2 to $3
matiko09: folds 
Spid1: folds 
nubpoker: folds 
Filojoes: folds 
Aghmir77: folds 
Dickyxxx: calls $2
*** FLOP *** [Ac 5c 9s]
Dickyxxx: checks 
MichaLabam: bets $3
Dickyxxx: calls $3
*** TURN *** [Ac 5c 9s] [2h]
Dickyxxx: checks 
MichaLabam: bets $8
Dickyxxx: calls $8
*** RIVER *** [Ac 5c 9s 2h] [Tc]
Dickyxxx: checks 
MichaLabam: checks 
*** SHOW DOWN ***
Dickyxxx: shows [As 8s] (a pair of Aces)
MichaLabam: shows [9h 9c] (three of a kind, Nines)
MichaLabam collected $27.08 from pot
*** SUMMARY ***
Total pot $28.50 | Rake $1.42 
Board [Ac 5c 9s 2h Tc]
Seat 1: Dickyxxx (big blind) showed [As 8s] and lost with a pair of Aces
Seat 3: chaps1988 folded before Flop (didn't bet)
Seat 4: MichaLabam showed [9h 9c] and won ($27.08) with three of a kind, Nines
Seat 5: matiko09 folded before Flop (didn't bet)
Seat 6: Spid1 folded before Flop (didn't bet)
Seat 7: nubpoker folded before Flop (didn't bet)
Seat 8: Filojoes (button) folded before Flop (didn't bet)
Seat 9: Aghmir77 (small blind) folded before Flop





PokerStars Hand #153066440499:  Hold'em No Limit ($0.50/$1.00 USD) - 2016/05/09 16:09:54 CET [2016/05/09 10:09:54 ET]
Table 'Isberga II' 9-max Seat #3 is the button
Seat 1: Kukuryzka ($100 in chips) 
Seat 2: Filojoes ($111.75 in chips) 
Seat 3: matiko09 ($101 in chips) 
Seat 4: mishanay111 ($54.46 in chips) 
Seat 5: nubpoker ($100 in chips) 
Seat 9: tubelight00 ($100.85 in chips) 
mishanay111: posts small blind $0.50
nubpoker: posts big blind $1
maxxmeister: sits out 
azzad2007: sits out 
ozone2003: sits out 
*** HOLE CARDS ***
Dealt to matiko09 [2d 3d]
tubelight00: folds 
Kukuryzka: folds 
Filojoes: raises $1.50 to $2.50
matiko09: folds 
mishanay111: calls $2
nubpoker: folds 
*** FLOP *** [Kh Jc Js]
mishanay111: checks 
Filojoes: bets $3.42
mishanay111: folds 
Uncalled bet ($3.42) returned to Filojoes
Filojoes collected $5.70 from pot
Filojoes: doesn't show hand 
*** SUMMARY ***
Total pot $6 | Rake $0.30 
Board [Kh Jc Js]
Seat 1: Kukuryzka folded before Flop (didn't bet)
Seat 2: Filojoes collected ($5.70)
Seat 3: matiko09 (button) folded before Flop (didn't bet)
Seat 4: mishanay111 (small blind) folded on the Flop
Seat 5: nubpoker (big blind) folded before Flop
Seat 9: tubelight00 folded before Flop (didn't bet)





PokerStars Hand #153066452117:  Hold'em No Limit ($0.50/$1.00 USD) - 2016/05/09 16:10:14 CET [2016/05/09 10:10:14 ET]
Table 'Hajek' 9-max Seat #9 is the button
Seat 1: Mukhin1 ($101.60 in chips) 
Seat 2: Spid1 ($100 in chips) 
Seat 4: LRVAV7 ($76.27 in chips) 
Seat 5: ozone2003 ($100 in chips) 
Seat 6: Filojoes ($106.20 in chips) 
Seat 7: DancerNN1 ($117.54 in chips) 
Seat 8: Kukuryzka ($99.10 in chips) 
Seat 9: matiko09 ($100 in chips) 
Mukhin1: posts small blind $0.50
Spid1: posts big blind $1
Mukhin1: posts the ante $0.20
Spid1: posts the ante $0.20
LRVAV7: posts the ante $0.20
ozone2003: posts the ante $0.20
Filojoes: posts the ante $0.20
DancerNN1: posts the ante $0.20
Kukuryzka: posts the ante $0.20
matiko09: posts the ante $0.20
*** HOLE CARDS ***
Dealt to matiko09 [Ah 5c]
LRVAV7: folds 
ozone2003: folds 
Filojoes: folds 
DancerNN1: raises $2 to $3
Kukuryzka: folds 
matiko09: folds 
Mukhin1: folds 
Spid1: folds 
Uncalled bet ($2) returned to DancerNN1
DancerNN1 collected $4.10 from pot
DancerNN1: doesn't show hand 
*** SUMMARY ***
Total pot $4.10 | Rake $0 
Seat 1: Mukhin1 (small blind) folded before Flop
Seat 2: Spid1 (big blind) folded before Flop
Seat 4: LRVAV7 folded before Flop (didn't bet)
Seat 5: ozone2003 folded before Flop (didn't bet)
Seat 6: Filojoes folded before Flop (didn't bet)
Seat 7: DancerNN1 collected ($4.10)
Seat 8: Kukuryzka folded before Flop (didn't bet)
Seat 9: matiko09 (button) folded before Flop (didn't bet)





PokerStars Hand #153066453603:  Hold'em No Limit ($0.50/$1.00 USD) - 2016/05/09 16:10:16 CET [2016/05/09 10:10:16 ET]
Table 'Isberga II' 9-max Seat #4 is the button
Seat 1: Kukuryzka ($100 in chips) 
Seat 2: Filojoes ($114.95 in chips) 
Seat 3: matiko09 ($101 in chips) 
Seat 4: mishanay111 ($51.96 in chips) 
Seat 5: nubpoker ($100 in chips) 
Seat 6: maxxmeister ($100 in chips) 
Seat 9: tubelight00 ($100.85 in chips) 
nubpoker: posts small blind $0.50
maxxmeister: posts big blind $1
azzad2007: sits out 
ozone2003: sits out 
*** HOLE CARDS ***
Dealt to matiko09 [9c 3d]
tubelight00: raises $2 to $3
Kukuryzka: folds 
Filojoes: folds 
matiko09: folds 
mishanay111: calls $3
nubpoker: folds 
maxxmeister: folds 
*** FLOP *** [Qd 4h 9s]
tubelight00: bets $5
mishanay111: folds 
Uncalled bet ($5) returned to tubelight00
tubelight00 collected $7.12 from pot
tubelight00: doesn't show hand 
*** SUMMARY ***
Total pot $7.50 | Rake $0.38 
Board [Qd 4h 9s]
Seat 1: Kukuryzka folded before Flop (didn't bet)
Seat 2: Filojoes folded before Flop (didn't bet)
Seat 3: matiko09 folded before Flop (didn't bet)
Seat 4: mishanay111 (button) folded on the Flop
Seat 5: nubpoker (small blind) folded before Flop
Seat 6: maxxmeister (big blind) folded before Flop
Seat 9: tubelight00 collected ($7.12)





PokerStars Hand #153066458544:  Hold'em No Limit ($0.50/$1.00 USD) - 2016/05/09 16:10:25 CET [2016/05/09 10:10:25 ET]
Table 'Terpsichore' 9-max Seat #3 is the button
Seat 1: ipashutapkom ($63.86 in chips) 
Seat 2: J0k3rF4c3_FD ($171.16 in chips) 
Seat 3: matiko09 ($128.37 in chips) 
Seat 4: nubpoker ($100 in chips) 
Seat 6: r4mz3s ($100 in chips) 
Seat 8: Kiosk230472 ($138.89 in chips) 
Seat 9: FTPbannedMe ($100 in chips) 
nubpoker: posts small blind $0.50
r4mz3s: posts big blind $1
ozone2003: sits out 
*** HOLE CARDS ***
Dealt to matiko09 [2c Tc]
Kiosk230472: folds 
FTPbannedMe: folds 
ipashutapkom: folds 
J0k3rF4c3_FD: raises $1.50 to $2.50
matiko09: folds 
nubpoker: raises $6.50 to $9
r4mz3s: folds 
J0k3rF4c3_FD: folds 
Uncalled bet ($6.50) returned to nubpoker
nubpoker collected $6 from pot
nubpoker: doesn't show hand 
*** SUMMARY ***
Total pot $6 | Rake $0 
Seat 1: ipashutapkom folded before Flop (didn't bet)
Seat 2: J0k3rF4c3_FD folded before Flop
Seat 3: matiko09 (button) folded before Flop (didn't bet)
Seat 4: nubpoker (small blind) collected ($6)
Seat 6: r4mz3s (big blind) folded before Flop
Seat 8: Kiosk230472 folded before Flop (didn't bet)
Seat 9: FTPbannedMe folded before Flop (didn't bet)





PokerStars Hand #153066459844:  Hold'em No Limit ($0.50/$1.00 USD) - 2016/05/09 16:10:27 CET [2016/05/09 10:10:27 ET]
Table 'Merga II' 9-max Seat #2 is the button
Seat 1: ipashutapkom ($40 in chips) 
Seat 2: Filojoes ($100.18 in chips) 
Seat 3: xhinostrabli ($49.47 in chips) 
Seat 4: nubpoker ($100 in chips) 
Seat 5: LRVAV7 ($251.91 in chips) 
Seat 6: Spid1 ($287.48 in chips) 
Seat 7: matiko09 ($153.29 in chips) 
Seat 8: GrandOldFart ($100 in chips) 
Seat 9: chaps1988 ($214.93 in chips) 
xhinostrabli: posts small blind $0.50
nubpoker: posts big blind $1
*** HOLE CARDS ***
Dealt to matiko09 [8s Th]
LRVAV7: folds 
Spid1: folds 
matiko09: folds 
GrandOldFart: folds 
chaps1988: folds 
ipashutapkom: folds 
Filojoes: raises $1 to $2
xhinostrabli: folds 
nubpoker: raises $6 to $8
Filojoes: folds 
Uncalled bet ($6) returned to nubpoker
nubpoker collected $4.50 from pot
nubpoker: doesn't show hand 
*** SUMMARY ***
Total pot $4.50 | Rake $0 
Seat 1: ipashutapkom folded before Flop (didn't bet)
Seat 2: Filojoes (button) folded before Flop
Seat 3: xhinostrabli (small blind) folded before Flop
Seat 4: nubpoker (big blind) collected ($4.50)
Seat 5: LRVAV7 folded before Flop (didn't bet)
Seat 6: Spid1 folded before Flop (didn't bet)
Seat 7: matiko09 folded before Flop (didn't bet)
Seat 8: GrandOldFart folded before Flop (didn't bet)
Seat 9: chaps1988 folded before Flop (didn't bet)





PokerStars Hand #153066469836:  Hold'em No Limit ($0.50/$1.00 USD) - 2016/05/09 16:10:45 CET [2016/05/09 10:10:45 ET]
Table 'Alderamin' 9-max Seat #3 is the button
Seat 1: r4mz3s ($100 in chips) 
Seat 2: Filojoes ($118.63 in chips) 
Seat 3: NSL0808 ($51.73 in chips) 
Seat 4: matiko09 ($100 in chips) 
Seat 5: tanmayh ($138.79 in chips) 
Seat 6: Spid1 ($116.98 in chips) 
Seat 7: azzad2007 ($112.18 in chips) 
Seat 8: nubpoker ($100.75 in chips) 
Seat 9: ipashutapkom ($40 in chips) 
matiko09: posts small blind $0.50
tanmayh: posts big blind $1
*** HOLE CARDS ***
Dealt to matiko09 [5h 3h]
Spid1: folds 
azzad2007: folds 
nubpoker: folds 
ipashutapkom: folds 
r4mz3s: folds 
Filojoes: raises $1.50 to $2.50
NSL0808: calls $2.50
matiko09: folds 
tanmayh: calls $1.50
*** FLOP *** [Kc Ks 5d]
tanmayh: checks 
Filojoes: checks 
NSL0808: checks 
*** TURN *** [Kc Ks 5d] [Jc]
tanmayh: bets $4
Filojoes: calls $4
NSL0808: calls $4
*** RIVER *** [Kc Ks 5d Jc] [2c]
tanmayh: checks 
Filojoes: checks 
NSL0808: checks 
*** SHOW DOWN ***
tanmayh: shows [4c 8d] (a pair of Kings)
Filojoes: shows [3c 5c] (a flush, King high)
NSL0808: mucks hand 
Filojoes collected $19 from pot
*** SUMMARY ***
Total pot $20 | Rake $1 
Board [Kc Ks 5d Jc 2c]
Seat 1: r4mz3s folded before Flop (didn't bet)
Seat 2: Filojoes showed [3c 5c] and won ($19) with a flush, King high
Seat 3: NSL0808 (button) mucked [Ah Ts]
Seat 4: matiko09 (small blind) folded before Flop
Seat 5: tanmayh (big blind) showed [4c 8d] and lost with a pair of Kings
Seat 6: Spid1 folded before Flop (didn't bet)
Seat 7: azzad2007 folded before Flop (didn't bet)
Seat 8: nubpoker folded before Flop (didn't bet)
Seat 9: ipashutapkom folded before Flop (didn't bet)





PokerStars Hand #153066474437:  Hold'em No Limit ($0.50/$1.00 USD) - 2016/05/09 16:10:53 CET [2016/05/09 10:10:53 ET]
Table 'Reiss' 9-max Seat #9 is the button
Seat 1: Dickyxxx ($200.90 in chips) 
Seat 3: chaps1988 ($119.37 in chips) 
Seat 4: MichaLabam ($133.60 in chips) 
Seat 5: matiko09 ($100 in chips) 
Seat 6: Spid1 ($138.43 in chips) 
Seat 7: nubpoker ($101.50 in chips) 
Seat 8: Filojoes ($185.68 in chips) 
Seat 9: Aghmir77 ($102.46 in chips) 
Dickyxxx: posts small blind $0.50
chaps1988: posts big blind $1
*** HOLE CARDS ***
Dealt to matiko09 [2c 3h]
MichaLabam: folds 
matiko09: folds 
Spid1: folds 
nubpoker: folds 
Filojoes: folds 
Aghmir77: raises $1.25 to $2.25
Dickyxxx: folds 
chaps1988: folds 
Uncalled bet ($1.25) returned to Aghmir77
Aghmir77 collected $2.50 from pot
Aghmir77: doesn't show hand 
*** SUMMARY ***
Total pot $2.50 | Rake $0 
Seat 1: Dickyxxx (small blind) folded before Flop
Seat 3: chaps1988 (big blind) folded before Flop
Seat 4: MichaLabam folded before Flop (didn't bet)
Seat 5: matiko09 folded before Flop (didn't bet)
Seat 6: Spid1 folded before Flop (didn't bet)
Seat 7: nubpoker folded before Flop (didn't bet)
Seat 8: Filojoes folded before Flop (didn't bet)
Seat 9: Aghmir77 (button) collected ($2.50)





PokerStars Hand #153066476803:  Hold'em No Limit ($0.50/$1.00 USD) - 2016/05/09 16:10:57 CET [2016/05/09 10:10:57 ET]
Table 'Hajek' 9-max Seat #1 is the button
Seat 1: Mukhin1 ($100.90 in chips) 
Seat 2: Spid1 ($100 in chips) 
Seat 4: LRVAV7 ($76.07 in chips) 
Seat 5: ozone2003 ($100 in chips) 
Seat 6: Filojoes ($106 in chips) 
Seat 7: DancerNN1 ($120.44 in chips) 
Seat 8: Kukuryzka ($100 in chips) 
Seat 9: matiko09 ($100 in chips) 
Spid1: posts small blind $0.50
LRVAV7: posts big blind $1
Mukhin1: posts the ante $0.20
Spid1: posts the ante $0.20
LRVAV7: posts the ante $0.20
ozone2003: posts the ante $0.20
Filojoes: posts the ante $0.20
DancerNN1: posts the ante $0.20
Kukuryzka: posts the ante $0.20
matiko09: posts the ante $0.20
*** HOLE CARDS ***
Dealt to matiko09 [7c 8d]
ozone2003: raises $2 to $3
Filojoes: folds 
DancerNN1: folds 
Kukuryzka: folds 
matiko09: folds 
Mukhin1: folds 
Spid1: folds 
LRVAV7: folds 
Uncalled bet ($2) returned to ozone2003
ozone2003 collected $4.10 from pot
ozone2003: doesn't show hand 
*** SUMMARY ***
Total pot $4.10 | Rake $0 
Seat 1: Mukhin1 (button) folded before Flop (didn't bet)
Seat 2: Spid1 (small blind) folded before Flop
Seat 4: LRVAV7 (big blind) folded before Flop
Seat 5: ozone2003 collected ($4.10)
Seat 6: Filojoes folded before Flop (didn't bet)
Seat 7: DancerNN1 folded before Flop (didn't bet)
Seat 8: Kukuryzka folded before Flop (didn't bet)
Seat 9: matiko09 folded before Flop (didn't bet)





PokerStars Hand #153066476705:  Hold'em No Limit ($1/$2 USD) - 2016/05/09 16:10:57 CET [2016/05/09 10:10:57 ET]
Table 'Hagar II' 9-max Seat #8 is the button
Seat 1: azzad2007 ($255.62 in chips) 
Seat 3: stan_09319 ($203 in chips) 
Seat 4: matiko09 ($244.15 in chips) 
Seat 5: PacPacBum ($200 in chips) 
Seat 6: Piniker85 ($808.07 in chips) 
Seat 7: Monsthand ($216.35 in chips) 
Seat 8: J0k3rF4c3_FD ($383.60 in chips) 
Seat 9: chaps1988 ($200 in chips) 
chaps1988: posts small blind $1
azzad2007: posts big blind $2
darren1031: sits out 
*** HOLE CARDS ***
Dealt to matiko09 [Ks Js]
stan_09319: folds 
matiko09: raises $3 to $5
PacPacBum: folds 
Piniker85: folds 
Monsthand: folds 
J0k3rF4c3_FD: folds 
chaps1988: folds 
azzad2007: folds 
Uncalled bet ($3) returned to matiko09
matiko09 collected $5 from pot
matiko09: doesn't show hand 
*** SUMMARY ***
Total pot $5 | Rake $0 
Seat 1: azzad2007 (big blind) folded before Flop
Seat 3: stan_09319 folded before Flop (didn't bet)
Seat 4: matiko09 collected ($5)
Seat 5: PacPacBum folded before Flop (didn't bet)
Seat 6: Piniker85 folded before Flop (didn't bet)
Seat 7: Monsthand folded before Flop (didn't bet)
Seat 8: J0k3rF4c3_FD (button) folded before Flop (didn't bet)
Seat 9: chaps1988 (small blind) folded before Flop





PokerStars Hand #153066478822:  Hold'em No Limit ($1/$2 USD) - 2016/05/09 16:11:01 CET [2016/05/09 10:11:01 ET]
Table 'Luda' 9-max Seat #1 is the button
Seat 1: stan_09319 ($397.84 in chips) 
Seat 2: matiko09 ($200 in chips) 
Seat 3: Monsthand ($425.55 in chips) 
Seat 4: Igoriah ($213.69 in chips) 
Seat 5: J0k3rF4c3_FD ($200 in chips) 
Seat 6: Iggso ($200 in chips) 
Seat 7: chaps1988 ($219.25 in chips) 
matiko09: posts small blind $1
Monsthand: posts big blind $2
*** HOLE CARDS ***
Dealt to matiko09 [Kc 8h]
Igoriah: folds 
J0k3rF4c3_FD: folds 
Iggso: raises $3.15 to $5.15
Igoriah leaves the table
CI58 joins the table at seat #4 
chaps1988: raises $13.35 to $18.50
stan_09319: folds 
CI58 leaves the table
matiko09: folds 
Monsthand: folds 
Iggso: folds 
Uncalled bet ($13.35) returned to chaps1988
chaps1988 collected $13.30 from pot
chaps1988: doesn't show hand 
*** SUMMARY ***
Total pot $13.30 | Rake $0 
Seat 1: stan_09319 (button) folded before Flop (didn't bet)
Seat 2: matiko09 (small blind) folded before Flop
Seat 3: Monsthand (big blind) folded before Flop
Seat 4: Igoriah folded before Flop (didn't bet)
Seat 5: J0k3rF4c3_FD folded before Flop (didn't bet)
Seat 6: Iggso folded before Flop
Seat 7: chaps1988 collected ($13.30)





PokerStars Hand #153066480667:  Hold'em No Limit ($0.50/$1.00 USD) - 2016/05/09 16:11:04 CET [2016/05/09 10:11:04 ET]
Table 'Terpsichore' 9-max Seat #4 is the button
Seat 1: ipashutapkom ($63.86 in chips) 
Seat 2: J0k3rF4c3_FD ($168.66 in chips) 
Seat 3: matiko09 ($128.37 in chips) 
Seat 4: nubpoker ($103.50 in chips) 
Seat 6: r4mz3s ($100 in chips) 
Seat 7: ozone2003 ($100 in chips) 
Seat 8: Kiosk230472 ($138.89 in chips) 
Seat 9: FTPbannedMe ($100 in chips) 
r4mz3s: posts small blind $0.50
ozone2003: posts big blind $1
*** HOLE CARDS ***
Dealt to matiko09 [Ac 9s]
Kiosk230472: folds 
FTPbannedMe: folds 
ipashutapkom: folds 
J0k3rF4c3_FD: folds 
matiko09: raises $1.50 to $2.50
nubpoker: raises $5.50 to $8
r4mz3s: folds 
ozone2003: folds 
matiko09: folds 
Uncalled bet ($5.50) returned to nubpoker
nubpoker collected $6.50 from pot
nubpoker: doesn't show hand 
*** SUMMARY ***
Total pot $6.50 | Rake $0 
Seat 1: ipashutapkom folded before Flop (didn't bet)
Seat 2: J0k3rF4c3_FD folded before Flop (didn't bet)
Seat 3: matiko09 folded before Flop
Seat 4: nubpoker (button) collected ($6.50)
Seat 6: r4mz3s (small blind) folded before Flop
Seat 7: ozone2003 (big blind) folded before Flop
Seat 8: Kiosk230472 folded before Flop (didn't bet)
Seat 9: FTPbannedMe folded before Flop (didn't bet)





PokerStars Hand #153066485461:  Hold'em No Limit ($0.50/$1.00 USD) - 2016/05/09 16:11:12 CET [2016/05/09 10:11:12 ET]
Table 'Isberga II' 9-max Seat #5 is the button
Seat 1: Kukuryzka ($100 in chips) 
Seat 2: Filojoes ($114.95 in chips) 
Seat 3: matiko09 ($101 in chips) 
Seat 4: mishanay111 ($48.96 in chips) 
Seat 5: nubpoker ($100 in chips) 
Seat 6: maxxmeister ($100 in chips) 
Seat 7: azzad2007 ($100 in chips) 
Seat 9: tubelight00 ($104.97 in chips) 
maxxmeister: posts small blind $0.50
azzad2007: posts big blind $1
ozone2003: sits out 
*** HOLE CARDS ***
Dealt to matiko09 [2c 5h]
tubelight00: folds 
Kukuryzka: folds 
Filojoes: raises $2 to $3
matiko09: folds 
mishanay111: folds 
mishanay111 leaves the table
nubpoker: folds 
ipashutapkom joins the table at seat #4 
maxxmeister: folds 
azzad2007: folds 
Uncalled bet ($2) returned to Filojoes
Filojoes collected $2.50 from pot
Filojoes: doesn't show hand 
*** SUMMARY ***
Total pot $2.50 | Rake $0 
Seat 1: Kukuryzka folded before Flop (didn't bet)
Seat 2: Filojoes collected ($2.50)
Seat 3: matiko09 folded before Flop (didn't bet)
Seat 4: mishanay111 folded before Flop (didn't bet)
Seat 5: nubpoker (button) folded before Flop (didn't bet)
Seat 6: maxxmeister (small blind) folded before Flop
Seat 7: azzad2007 (big blind) folded before Flop
Seat 9: tubelight00 folded before Flop (didn't bet)





PokerStars Hand #153066487492:  Hold'em No Limit ($0.50/$1.00 USD) - 2016/05/09 16:11:16 CET [2016/05/09 10:11:16 ET]
Table 'Merga II' 9-max Seat #3 is the button
Seat 1: ipashutapkom ($40 in chips) 
Seat 2: Filojoes ($100 in chips) 
Seat 3: xhinostrabli ($48.97 in chips) 
Seat 4: nubpoker ($102.50 in chips) 
Seat 5: LRVAV7 ($251.91 in chips) 
Seat 6: Spid1 ($287.48 in chips) 
Seat 7: matiko09 ($153.29 in chips) 
Seat 8: GrandOldFart ($100 in chips) 
Seat 9: chaps1988 ($214.93 in chips) 
nubpoker: posts small blind $0.50
LRVAV7: posts big blind $1
*** HOLE CARDS ***
Dealt to matiko09 [4d 5c]
Spid1: folds 
matiko09: folds 
GrandOldFart: raises $2 to $3
chaps1988: folds 
ipashutapkom: folds 
Filojoes: folds 
xhinostrabli: folds 
nubpoker: folds 
LRVAV7: folds 
Uncalled bet ($2) returned to GrandOldFart
GrandOldFart collected $2.50 from pot
*** SUMMARY ***
Total pot $2.50 | Rake $0 
Seat 1: ipashutapkom folded before Flop (didn't bet)
Seat 2: Filojoes folded before Flop (didn't bet)
Seat 3: xhinostrabli (button) folded before Flop (didn't bet)
Seat 4: nubpoker (small blind) folded before Flop
Seat 5: LRVAV7 (big blind) folded before Flop
Seat 6: Spid1 folded before Flop (didn't bet)
Seat 7: matiko09 folded before Flop (didn't bet)
Seat 8: GrandOldFart collected ($2.50)
Seat 9: chaps1988 folded before Flop (didn't bet)





PokerStars Hand #153066490471:  Hold'em No Limit ($1/$2 USD) - 2016/05/09 16:11:21 CET [2016/05/09 10:11:21 ET]
Table 'Hagar II' 9-max Seat #9 is the button
Seat 1: azzad2007 ($253.62 in chips) 
Seat 2: darren1031 ($160 in chips) 
Seat 3: stan_09319 ($203 in chips) 
Seat 4: matiko09 ($247.15 in chips) 
Seat 5: PacPacBum ($200 in chips) 
Seat 6: Piniker85 ($808.07 in chips) 
Seat 7: Monsthand ($216.35 in chips) 
Seat 8: J0k3rF4c3_FD ($383.60 in chips) 
Seat 9: chaps1988 ($200 in chips) 
azzad2007: posts small blind $1
darren1031: posts big blind $2
*** HOLE CARDS ***
Dealt to matiko09 [3h 5s]
stan_09319: folds 
matiko09: folds 
PacPacBum: raises $3 to $5
Piniker85: folds 
Monsthand: folds 
J0k3rF4c3_FD: folds 
chaps1988: folds 
azzad2007: folds 
darren1031: calls $3
*** FLOP *** [4s 7c Th]
darren1031: checks 
PacPacBum: bets $3.65
darren1031: calls $3.65
*** TURN *** [4s 7c Th] [Jd]
darren1031: checks 
PacPacBum: checks 
*** RIVER *** [4s 7c Th Jd] [Jh]
darren1031: bets $8.69
PacPacBum: folds 
Uncalled bet ($8.69) returned to darren1031
darren1031 collected $17.38 from pot
*** SUMMARY ***
Total pot $18.30 | Rake $0.92 
Board [4s 7c Th Jd Jh]
Seat 1: azzad2007 (small blind) folded before Flop
Seat 2: darren1031 (big blind) collected ($17.38)
Seat 3: stan_09319 folded before Flop (didn't bet)
Seat 4: matiko09 folded before Flop (didn't bet)
Seat 5: PacPacBum folded on the River
Seat 6: Piniker85 folded before Flop (didn't bet)
Seat 7: Monsthand folded before Flop (didn't bet)
Seat 8: J0k3rF4c3_FD folded before Flop (didn't bet)
Seat 9: chaps1988 (button) folded before Flop (didn't bet)





PokerStars Hand #153066496018:  Hold'em No Limit ($0.50/$1.00 USD) - 2016/05/09 16:11:31 CET [2016/05/09 10:11:31 ET]
Table 'Reiss' 9-max Seat #1 is the button
Seat 1: Dickyxxx ($200.40 in chips) 
Seat 3: chaps1988 ($118.37 in chips) 
Seat 4: MichaLabam ($133.60 in chips) 
Seat 5: matiko09 ($100 in chips) 
Seat 6: Spid1 ($138.43 in chips) 
Seat 7: nubpoker ($101.50 in chips) 
Seat 8: Filojoes ($185.68 in chips) 
Seat 9: Aghmir77 ($103.96 in chips) 
chaps1988: posts small blind $0.50
MichaLabam: posts big blind $1
*** HOLE CARDS ***
Dealt to matiko09 [8d Ts]
matiko09: folds 
Spid1: folds 
nubpoker: folds 
Filojoes: folds 
Aghmir77: folds 
Dickyxxx: raises $2 to $3
chaps1988: folds 
MichaLabam: calls $2
*** FLOP *** [7h 9d Kc]
MichaLabam: checks 
Dickyxxx: checks 
*** TURN *** [7h 9d Kc] [4d]
MichaLabam: bets $3
Dickyxxx: folds 
Uncalled bet ($3) returned to MichaLabam
MichaLabam collected $6.18 from pot
MichaLabam: doesn't show hand 
*** SUMMARY ***
Total pot $6.50 | Rake $0.32 
Board [7h 9d Kc 4d]
Seat 1: Dickyxxx (button) folded on the Turn
Seat 3: chaps1988 (small blind) folded before Flop
Seat 4: MichaLabam (big blind) collected ($6.18)
Seat 5: matiko09 folded before Flop (didn't bet)
Seat 6: Spid1 folded before Flop (didn't bet)
Seat 7: nubpoker folded before Flop (didn't bet)
Seat 8: Filojoes folded before Flop (didn't bet)
Seat 9: Aghmir77 folded before Flop (didn't bet)





PokerStars Hand #153066495907:  Hold'em No Limit ($1/$2 USD) - 2016/05/09 16:11:31 CET [2016/05/09 10:11:31 ET]
Table 'Luda' 9-max Seat #2 is the button
Seat 1: stan_09319 ($397.84 in chips) 
Seat 2: matiko09 ($200 in chips) 
Seat 3: Monsthand ($423.55 in chips) 
Seat 5: J0k3rF4c3_FD ($200 in chips) 
Seat 6: Iggso ($200 in chips) 
Seat 7: chaps1988 ($227.40 in chips) 
Monsthand: posts small blind $1
J0k3rF4c3_FD: posts big blind $2
*** HOLE CARDS ***
Dealt to matiko09 [Js Kd]
Iggso: folds 
Iggso leaves the table
chaps1988: raises $3 to $5
stan_09319: folds 
matiko09: folds 
Monsthand: folds 
J0k3rF4c3_FD: folds 
Uncalled bet ($3) returned to chaps1988
chaps1988 collected $5 from pot
chaps1988: doesn't show hand 
*** SUMMARY ***
Total pot $5 | Rake $0 
Seat 1: stan_09319 folded before Flop (didn't bet)
Seat 2: matiko09 (button) folded before Flop (didn't bet)
Seat 3: Monsthand (small blind) folded before Flop
Seat 5: J0k3rF4c3_FD (big blind) folded before Flop
Seat 6: Iggso folded before Flop (didn't bet)
Seat 7: chaps1988 collected ($5)





PokerStars Hand #153066498370:  Hold'em No Limit ($0.50/$1.00 USD) - 2016/05/09 16:11:35 CET [2016/05/09 10:11:35 ET]
Table 'Hajek' 9-max Seat #2 is the button
Seat 1: Mukhin1 ($100.70 in chips) 
Seat 2: Spid1 ($100 in chips) 
Seat 4: LRVAV7 ($74.87 in chips) 
Seat 5: ozone2003 ($102.90 in chips) 
Seat 6: Filojoes ($105.80 in chips) 
Seat 7: DancerNN1 ($120.24 in chips) 
Seat 8: Kukuryzka ($99.80 in chips) 
Seat 9: matiko09 ($100 in chips) 
LRVAV7: posts small blind $0.50
ozone2003: posts big blind $1
Mukhin1: posts the ante $0.20
Spid1: posts the ante $0.20
LRVAV7: posts the ante $0.20
ozone2003: posts the ante $0.20
Filojoes: posts the ante $0.20
DancerNN1: posts the ante $0.20
Kukuryzka: posts the ante $0.20
matiko09: posts the ante $0.20
*** HOLE CARDS ***
Dealt to matiko09 [3c Jc]
Filojoes: raises $2 to $3
DancerNN1: folds 
Kukuryzka: folds 
matiko09: folds 
Mukhin1: folds 
Spid1: folds 
LRVAV7: folds 
ozone2003: folds 
Uncalled bet ($2) returned to Filojoes
Filojoes collected $4.10 from pot
Filojoes: doesn't show hand 
*** SUMMARY ***
Total pot $4.10 | Rake $0 
Seat 1: Mukhin1 folded before Flop (didn't bet)
Seat 2: Spid1 (button) folded before Flop (didn't bet)
Seat 4: LRVAV7 (small blind) folded before Flop
Seat 5: ozone2003 (big blind) folded before Flop
Seat 6: Filojoes collected ($4.10)
Seat 7: DancerNN1 folded before Flop (didn't bet)
Seat 8: Kukuryzka folded before Flop (didn't bet)
Seat 9: matiko09 folded before Flop (didn't bet)





PokerStars Hand #153066500035:  Hold'em No Limit ($0.50/$1.00 USD) - 2016/05/09 16:11:38 CET [2016/05/09 10:11:38 ET]
Table 'Isberga II' 9-max Seat #6 is the button
Seat 1: Kukuryzka ($100 in chips) 
Seat 2: Filojoes ($116.45 in chips) 
Seat 3: matiko09 ($101 in chips) 
Seat 5: nubpoker ($100 in chips) 
Seat 6: maxxmeister ($100 in chips) 
Seat 7: azzad2007 ($100 in chips) 
Seat 8: ozone2003 ($100 in chips) 
Seat 9: tubelight00 ($104.97 in chips) 
azzad2007: posts small blind $0.50
ozone2003: posts big blind $1
ipashutapkom: sits out 
*** HOLE CARDS ***
Dealt to matiko09 [3s 6c]
tubelight00: folds 
Kukuryzka: folds 
Filojoes: folds 
matiko09: folds 
nubpoker: raises $1.50 to $2.50
maxxmeister: folds 
azzad2007: folds 
ozone2003: raises $6.50 to $9
nubpoker: raises $11 to $20
ozone2003: calls $11
*** FLOP *** [Ac Kh Ah]
ozone2003: checks 
nubpoker: checks 
*** TURN *** [Ac Kh Ah] [5c]
ozone2003: checks 
nubpoker: bets $22
ozone2003: folds 
Uncalled bet ($22) returned to nubpoker
nubpoker collected $38.48 from pot
nubpoker: doesn't show hand 
*** SUMMARY ***
Total pot $40.50 | Rake $2.02 
Board [Ac Kh Ah 5c]
Seat 1: Kukuryzka folded before Flop (didn't bet)
Seat 2: Filojoes folded before Flop (didn't bet)
Seat 3: matiko09 folded before Flop (didn't bet)
Seat 5: nubpoker collected ($38.48)
Seat 6: maxxmeister (button) folded before Flop (didn't bet)
Seat 7: azzad2007 (small blind) folded before Flop
Seat 8: ozone2003 (big blind) folded on the Turn
Seat 9: tubelight00 folded before Flop (didn't bet)





PokerStars Hand #153066501814:  Hold'em No Limit ($0.50/$1.00 USD) - 2016/05/09 16:11:41 CET [2016/05/09 10:11:41 ET]
Table 'Terpsichore' 9-max Seat #6 is the button
Seat 1: ipashutapkom ($63.86 in chips) 
Seat 2: J0k3rF4c3_FD ($168.66 in chips) 
Seat 3: matiko09 ($125.87 in chips) 
Seat 4: nubpoker ($107.50 in chips) 
Seat 6: r4mz3s ($100 in chips) 
Seat 7: ozone2003 ($100 in chips) 
Seat 8: Kiosk230472 ($138.89 in chips) 
Seat 9: FTPbannedMe ($100 in chips) 
ozone2003: posts small blind $0.50
Kiosk230472: posts big blind $1
*** HOLE CARDS ***
Dealt to matiko09 [Ac Ks]
FTPbannedMe: folds 
ipashutapkom: folds 
J0k3rF4c3_FD: folds 
matiko09: raises $2 to $3
nubpoker: folds 
r4mz3s: folds 
ozone2003: folds 
Kiosk230472: calls $2
*** FLOP *** [6h 8h 3d]
Kiosk230472: bets $3
matiko09: calls $3
*** TURN *** [6h 8h 3d] [5c]
Kiosk230472: bets $4
matiko09: folds 
Uncalled bet ($4) returned to Kiosk230472
Kiosk230472 collected $11.88 from pot
Kiosk230472: doesn't show hand 
*** SUMMARY ***
Total pot $12.50 | Rake $0.62 
Board [6h 8h 3d 5c]
Seat 1: ipashutapkom folded before Flop (didn't bet)
Seat 2: J0k3rF4c3_FD folded before Flop (didn't bet)
Seat 3: matiko09 folded on the Turn
Seat 4: nubpoker folded before Flop (didn't bet)
Seat 6: r4mz3s (button) folded before Flop (didn't bet)
Seat 7: ozone2003 (small blind) folded before Flop
Seat 8: Kiosk230472 (big blind) collected ($11.88)
Seat 9: FTPbannedMe folded before Flop (didn't bet)





PokerStars Hand #153066511252:  Hold'em No Limit ($1/$2 USD) - 2016/05/09 16:11:57 CET [2016/05/09 10:11:57 ET]
Table 'Luda' 9-max Seat #3 is the button
Seat 1: stan_09319 ($397.84 in chips) 
Seat 2: matiko09 ($200 in chips) 
Seat 3: Monsthand ($422.55 in chips) 
Seat 5: J0k3rF4c3_FD ($200 in chips) 
Seat 7: chaps1988 ($230.40 in chips) 
J0k3rF4c3_FD: posts small blind $1
chaps1988: posts big blind $2
*** HOLE CARDS ***
Dealt to matiko09 [2h Ks]
stan_09319: folds 
matiko09: folds 
Monsthand: raises $3 to $5
J0k3rF4c3_FD: folds 
chaps1988: calls $3
*** FLOP *** [5d 4s 4c]
chaps1988: checks 
Monsthand: bets $6.47
chaps1988: calls $6.47
*** TURN *** [5d 4s 4c] [Ad]
chaps1988: checks 
Monsthand: bets $16
chaps1988: calls $16
*** RIVER *** [5d 4s 4c Ad] [2c]
chaps1988: checks 
Monsthand: bets $37.70
chaps1988: folds 
Uncalled bet ($37.70) returned to Monsthand
Monsthand collected $53.19 from pot
Monsthand: doesn't show hand 
*** SUMMARY ***
Total pot $55.94 | Rake $2.75 
Board [5d 4s 4c Ad 2c]
Seat 1: stan_09319 folded before Flop (didn't bet)
Seat 2: matiko09 folded before Flop (didn't bet)
Seat 3: Monsthand (button) collected ($53.19)
Seat 5: J0k3rF4c3_FD (small blind) folded before Flop
Seat 7: chaps1988 (big blind) folded on the River





PokerStars Hand #153066515737:  Hold'em No Limit ($0.50/$1.00 USD) - 2016/05/09 16:12:05 CET [2016/05/09 10:12:05 ET]
Table 'Merga II' 9-max Seat #4 is the button
Seat 1: ipashutapkom ($40 in chips) 
Seat 2: Filojoes ($100 in chips) 
Seat 3: xhinostrabli ($48.97 in chips) 
Seat 4: nubpoker ($102 in chips) 
Seat 5: LRVAV7 ($250.91 in chips) 
Seat 6: Spid1 ($287.48 in chips) 
Seat 7: matiko09 ($153.29 in chips) 
Seat 8: GrandOldFart ($101.50 in chips) 
Seat 9: chaps1988 ($214.93 in chips) 
LRVAV7: posts small blind $0.50
Spid1: posts big blind $1
*** HOLE CARDS ***
Dealt to matiko09 [6d 2s]
matiko09: folds 
GrandOldFart: folds 
chaps1988: folds 
ipashutapkom: folds 
Filojoes: raises $2 to $3
xhinostrabli: calls $3
nubpoker: folds 
LRVAV7: folds 
Spid1: folds 
*** FLOP *** [3h Qh 4s]
Filojoes: checks 
xhinostrabli: checks 
*** TURN *** [3h Qh 4s] [5s]
Filojoes: bets $4.27
xhinostrabli: folds 
Uncalled bet ($4.27) returned to Filojoes
Filojoes collected $7.12 from pot
Filojoes: doesn't show hand 
*** SUMMARY ***
Total pot $7.50 | Rake $0.38 
Board [3h Qh 4s 5s]
Seat 1: ipashutapkom folded before Flop (didn't bet)
Seat 2: Filojoes collected ($7.12)
Seat 3: xhinostrabli folded on the Turn
Seat 4: nubpoker (button) folded before Flop (didn't bet)
Seat 5: LRVAV7 (small blind) folded before Flop
Seat 6: Spid1 (big blind) folded before Flop
Seat 7: matiko09 folded before Flop (didn't bet)
Seat 8: GrandOldFart folded before Flop (didn't bet)
Seat 9: chaps1988 folded before Flop (didn't bet)





PokerStars Hand #153066521733:  Hold'em No Limit ($0.50/$1.00 USD) - 2016/05/09 16:12:16 CET [2016/05/09 10:12:16 ET]
Table 'Hajek' 9-max Seat #4 is the button
Seat 1: Mukhin1 ($100.50 in chips) 
Seat 2: Spid1 ($100 in chips) 
Seat 4: LRVAV7 ($74.17 in chips) 
Seat 5: ozone2003 ($101.70 in chips) 
Seat 6: Filojoes ($108.70 in chips) 
Seat 7: DancerNN1 ($120.04 in chips) 
Seat 8: Kukuryzka ($99.60 in chips) 
Seat 9: matiko09 ($100 in chips) 
ozone2003: posts small blind $0.50
Filojoes: posts big blind $1
Mukhin1: posts the ante $0.20
Spid1: posts the ante $0.20
LRVAV7: posts the ante $0.20
ozone2003: posts the ante $0.20
Filojoes: posts the ante $0.20
DancerNN1: posts the ante $0.20
Kukuryzka: posts the ante $0.20
matiko09: posts the ante $0.20
*** HOLE CARDS ***
Dealt to matiko09 [8c Js]
DancerNN1: folds 
Kukuryzka: folds 
matiko09: folds 
Mukhin1: folds 
Spid1: folds 
LRVAV7: raises $2 to $3
ozone2003: calls $2.50
Filojoes: folds 
*** FLOP *** [3h Kd Jc]
ozone2003: checks 
LRVAV7: bets $4.08
ozone2003: folds 
Uncalled bet ($4.08) returned to LRVAV7
LRVAV7 collected $8.17 from pot
LRVAV7: doesn't show hand 
*** SUMMARY ***
Total pot $8.60 | Rake $0.43 
Board [3h Kd Jc]
Seat 1: Mukhin1 folded before Flop (didn't bet)
Seat 2: Spid1 folded before Flop (didn't bet)
Seat 4: LRVAV7 (button) collected ($8.17)
Seat 5: ozone2003 (small blind) folded on the Flop
Seat 6: Filojoes (big blind) folded before Flop
Seat 7: DancerNN1 folded before Flop (didn't bet)
Seat 8: Kukuryzka folded before Flop (didn't bet)
Seat 9: matiko09 folded before Flop (didn't bet)





PokerStars Hand #153066522363:  Hold'em No Limit ($0.50/$1.00 USD) - 2016/05/09 16:12:17 CET [2016/05/09 10:12:17 ET]
Table 'Alderamin' 9-max Seat #4 is the button
Seat 1: r4mz3s ($100 in chips) 
Seat 2: Filojoes ($131.13 in chips) 
Seat 3: NSL0808 ($45.23 in chips) 
Seat 4: matiko09 ($100 in chips) 
Seat 5: tanmayh ($132.29 in chips) 
Seat 6: Spid1 ($116.98 in chips) 
Seat 7: azzad2007 ($112.18 in chips) 
Seat 8: nubpoker ($100.75 in chips) 
Seat 9: ipashutapkom ($40 in chips) 
tanmayh: posts small blind $0.50
Spid1: posts big blind $1
*** HOLE CARDS ***
Dealt to matiko09 [Kh 6d]
azzad2007: folds 
nubpoker: folds 
ipashutapkom: raises $1.26 to $2.26
r4mz3s: folds 
Filojoes: calls $2.26
NSL0808: folds 
matiko09: folds 
tanmayh: calls $1.76
Spid1: folds 
*** FLOP *** [Jd 8d Ah]
tanmayh: checks 
ipashutapkom: bets $2.36
Filojoes: calls $2.36
tanmayh: folds 
*** TURN *** [Jd 8d Ah] [As]
ipashutapkom: checks 
Filojoes: checks 
*** RIVER *** [Jd 8d Ah As] [2h]
ipashutapkom: bets $15.96
Filojoes: folds 
Uncalled bet ($15.96) returned to ipashutapkom
ipashutapkom collected $11.88 from pot
ipashutapkom: doesn't show hand 
*** SUMMARY ***
Total pot $12.50 | Rake $0.62 
Board [Jd 8d Ah As 2h]
Seat 1: r4mz3s folded before Flop (didn't bet)
Seat 2: Filojoes folded on the River
Seat 3: NSL0808 folded before Flop (didn't bet)
Seat 4: matiko09 (button) folded before Flop (didn't bet)
Seat 5: tanmayh (small blind) folded on the Flop
Seat 6: Spid1 (big blind) folded before Flop
Seat 7: azzad2007 folded before Flop (didn't bet)
Seat 8: nubpoker folded before Flop (didn't bet)
Seat 9: ipashutapkom collected ($11.88)





PokerStars Hand #153066525060:  Hold'em No Limit ($1/$2 USD) - 2016/05/09 16:12:21 CET [2016/05/09 10:12:21 ET]
Table 'Hagar II' 9-max Seat #1 is the button
Seat 1: azzad2007 ($252.62 in chips) 
Seat 2: darren1031 ($168.73 in chips) 
Seat 4: matiko09 ($247.15 in chips) 
Seat 5: PacPacBum ($200 in chips) 
Seat 6: Piniker85 ($808.07 in chips) 
Seat 7: Monsthand ($216.35 in chips) 
Seat 8: J0k3rF4c3_FD ($383.60 in chips) 
Seat 9: chaps1988 ($200 in chips) 
darren1031: posts small blind $1
matiko09: posts big blind $2
*** HOLE CARDS ***
Dealt to matiko09 [Qh 2h]
PacPacBum: folds 
Piniker85: calls $2
Monsthand: folds 
J0k3rF4c3_FD: folds 
chaps1988: folds 
azzad2007: folds 
darren1031: calls $1
matiko09: checks 
*** FLOP *** [Jd 6d Tc]
darren1031: checks 
matiko09: checks 
Piniker85: bets $2
darren1031: folds 
matiko09: folds 
Uncalled bet ($2) returned to Piniker85
Piniker85 collected $5.70 from pot
Piniker85: doesn't show hand 
*** SUMMARY ***
Total pot $6 | Rake $0.30 
Board [Jd 6d Tc]
Seat 1: azzad2007 (button) folded before Flop (didn't bet)
Seat 2: darren1031 (small blind) folded on the Flop
Seat 4: matiko09 (big blind) folded on the Flop
Seat 5: PacPacBum folded before Flop (didn't bet)
Seat 6: Piniker85 collected ($5.70)
Seat 7: Monsthand folded before Flop (didn't bet)
Seat 8: J0k3rF4c3_FD folded before Flop (didn't bet)
Seat 9: chaps1988 folded before Flop (didn't bet)





PokerStars Hand #153066528497:  Hold'em No Limit ($0.50/$1.00 USD) - 2016/05/09 16:12:27 CET [2016/05/09 10:12:27 ET]
Table 'Reiss' 9-max Seat #3 is the button
Seat 1: Dickyxxx ($197.40 in chips) 
Seat 3: chaps1988 ($117.87 in chips) 
Seat 4: MichaLabam ($136.78 in chips) 
Seat 5: matiko09 ($100 in chips) 
Seat 6: Spid1 ($138.43 in chips) 
Seat 7: nubpoker ($101.50 in chips) 
Seat 8: Filojoes ($185.68 in chips) 
Seat 9: Aghmir77 ($103.96 in chips) 
MichaLabam: posts small blind $0.50
matiko09: posts big blind $1
*** HOLE CARDS ***
Dealt to matiko09 [7h 8d]
Spid1: folds 
nubpoker: folds 
Filojoes: folds 
Aghmir77: folds 
Dickyxxx: folds 
chaps1988: folds 
MichaLabam: folds 
Uncalled bet ($0.50) returned to matiko09
matiko09 collected $1 from pot
matiko09: doesn't show hand 
*** SUMMARY ***
Total pot $1 | Rake $0 
Seat 1: Dickyxxx folded before Flop (didn't bet)
Seat 3: chaps1988 (button) folded before Flop (didn't bet)
Seat 4: MichaLabam (small blind) folded before Flop
Seat 5: matiko09 (big blind) collected ($1)
Seat 6: Spid1 folded before Flop (didn't bet)
Seat 7: nubpoker folded before Flop (didn't bet)
Seat 8: Filojoes folded before Flop (didn't bet)
Seat 9: Aghmir77 folded before Flop (didn't bet)





PokerStars Hand #153066536115:  Hold'em No Limit ($0.50/$1.00 USD) - 2016/05/09 16:12:41 CET [2016/05/09 10:12:41 ET]
Table 'Reiss' 9-max Seat #4 is the button
Seat 1: Dickyxxx ($197.40 in chips) 
Seat 3: chaps1988 ($117.87 in chips) 
Seat 4: MichaLabam ($136.28 in chips) 
Seat 5: matiko09 ($100.50 in chips) 
Seat 6: Spid1 ($138.43 in chips) 
Seat 7: nubpoker ($101.50 in chips) 
Seat 8: Filojoes ($185.68 in chips) 
Seat 9: Aghmir77 ($103.96 in chips) 
matiko09: posts small blind $0.50
Spid1: posts big blind $1
*** HOLE CARDS ***
Dealt to matiko09 [Qc Ts]
nubpoker: folds 
Filojoes: raises $2 to $3
Aghmir77: folds 
Dickyxxx: folds 
chaps1988: folds 
MichaLabam: calls $3
matiko09: folds 
Spid1: folds 
*** FLOP *** [3d 2h 3h]
Filojoes: checks 
MichaLabam: bets $3
Filojoes: folds 
Uncalled bet ($3) returned to MichaLabam
MichaLabam collected $7.12 from pot
MichaLabam: doesn't show hand 
*** SUMMARY ***
Total pot $7.50 | Rake $0.38 
Board [3d 2h 3h]
Seat 1: Dickyxxx folded before Flop (didn't bet)
Seat 3: chaps1988 folded before Flop (didn't bet)
Seat 4: MichaLabam (button) collected ($7.12)
Seat 5: matiko09 (small blind) folded before Flop
Seat 6: Spid1 (big blind) folded before Flop
Seat 7: nubpoker folded before Flop (didn't bet)
Seat 8: Filojoes folded on the Flop
Seat 9: Aghmir77 folded before Flop (didn't bet)





PokerStars Hand #153066536625:  Hold'em No Limit ($0.50/$1.00 USD) - 2016/05/09 16:12:42 CET [2016/05/09 10:12:42 ET]
Table 'Terpsichore' 9-max Seat #7 is the button
Seat 1: ipashutapkom ($63.86 in chips) 
Seat 2: J0k3rF4c3_FD ($168.66 in chips) 
Seat 3: matiko09 ($119.87 in chips) 
Seat 4: nubpoker ($107.50 in chips) 
Seat 6: r4mz3s ($100 in chips) 
Seat 7: ozone2003 ($100 in chips) 
Seat 8: Kiosk230472 ($144.77 in chips) 
Seat 9: FTPbannedMe ($100 in chips) 
Kiosk230472: posts small blind $0.50
FTPbannedMe: posts big blind $1
*** HOLE CARDS ***
Dealt to matiko09 [5s 9c]
ipashutapkom: folds 
J0k3rF4c3_FD: folds 
matiko09: folds 
nubpoker: folds 
r4mz3s: folds 
ozone2003: raises $1.20 to $2.20
Kiosk230472: folds 
FTPbannedMe: folds 
Uncalled bet ($1.20) returned to ozone2003
ozone2003 collected $2.50 from pot
ozone2003: doesn't show hand 
*** SUMMARY ***
Total pot $2.50 | Rake $0 
Seat 1: ipashutapkom folded before Flop (didn't bet)
Seat 2: J0k3rF4c3_FD folded before Flop (didn't bet)
Seat 3: matiko09 folded before Flop (didn't bet)
Seat 4: nubpoker folded before Flop (didn't bet)
Seat 6: r4mz3s folded before Flop (didn't bet)
Seat 7: ozone2003 (button) collected ($2.50)
Seat 8: Kiosk230472 (small blind) folded before Flop
Seat 9: FTPbannedMe (big blind) folded before Flop





PokerStars Hand #153066546469:  Hold'em No Limit ($0.50/$1.00 USD) - 2016/05/09 16:12:59 CET [2016/05/09 10:12:59 ET]
Table 'Merga II' 9-max Seat #5 is the button
Seat 1: ipashutapkom ($40 in chips) 
Seat 2: Filojoes ($104.12 in chips) 
Seat 3: xhinostrabli ($45.97 in chips) 
Seat 4: nubpoker ($102 in chips) 
Seat 5: LRVAV7 ($250.41 in chips) 
Seat 6: Spid1 ($286.48 in chips) 
Seat 7: matiko09 ($153.29 in chips) 
Seat 8: GrandOldFart ($101.50 in chips) 
Seat 9: chaps1988 ($214.93 in chips) 
Spid1: posts small blind $0.50
matiko09: posts big blind $1
*** HOLE CARDS ***
Dealt to matiko09 [5d 7s]
GrandOldFart has timed out
GrandOldFart: folds 
chaps1988: folds 
ipashutapkom: folds 
Filojoes: folds 
xhinostrabli: folds 
nubpoker: folds 
LRVAV7: folds 
Spid1: raises $1.50 to $2.50
matiko09: folds 
Uncalled bet ($1.50) returned to Spid1
Spid1 collected $2 from pot
Spid1: doesn't show hand 
*** SUMMARY ***
Total pot $2 | Rake $0 
Seat 1: ipashutapkom folded before Flop (didn't bet)
Seat 2: Filojoes folded before Flop (didn't bet)
Seat 3: xhinostrabli folded before Flop (didn't bet)
Seat 4: nubpoker folded before Flop (didn't bet)
Seat 5: LRVAV7 (button) folded before Flop (didn't bet)
Seat 6: Spid1 (small blind) collected ($2)
Seat 7: matiko09 (big blind) folded before Flop
Seat 8: GrandOldFart folded before Flop (didn't bet)
Seat 9: chaps1988 folded before Flop (didn't bet)





PokerStars Hand #153066547911:  Hold'em No Limit ($0.50/$1.00 USD) - 2016/05/09 16:13:01 CET [2016/05/09 10:13:01 ET]
Table 'Hajek' 9-max Seat #5 is the button
Seat 1: Mukhin1 ($100.30 in chips) 
Seat 2: Spid1 ($100 in chips) 
Seat 4: LRVAV7 ($79.14 in chips) 
Seat 5: ozone2003 ($100 in chips) 
Seat 6: Filojoes ($107.50 in chips) 
Seat 7: DancerNN1 ($119.84 in chips) 
Seat 8: Kukuryzka ($99.40 in chips) 
Seat 9: matiko09 ($100 in chips) 
Filojoes: posts small blind $0.50
DancerNN1: posts big blind $1
Mukhin1: posts the ante $0.20
Spid1: posts the ante $0.20
LRVAV7: posts the ante $0.20
ozone2003: posts the ante $0.20
Filojoes: posts the ante $0.20
DancerNN1: posts the ante $0.20
Kukuryzka: posts the ante $0.20
matiko09: posts the ante $0.20
*** HOLE CARDS ***
Dealt to matiko09 [6h Kc]
Kukuryzka: folds 
matiko09: folds 
Mukhin1: folds 
Spid1: folds 
LRVAV7: folds 
ozone2003: folds 
Filojoes: raises $1.50 to $2.50
DancerNN1: calls $1.50
*** FLOP *** [Qs 5d Tc]
Filojoes: checks 
DancerNN1: bets $3.13
Filojoes: folds 
Uncalled bet ($3.13) returned to DancerNN1
DancerNN1 collected $6.27 from pot
DancerNN1: doesn't show hand 
*** SUMMARY ***
Total pot $6.60 | Rake $0.33 
Board [Qs 5d Tc]
Seat 1: Mukhin1 folded before Flop (didn't bet)
Seat 2: Spid1 folded before Flop (didn't bet)
Seat 4: LRVAV7 folded before Flop (didn't bet)
Seat 5: ozone2003 (button) folded before Flop (didn't bet)
Seat 6: Filojoes (small blind) folded on the Flop
Seat 7: DancerNN1 (big blind) collected ($6.27)
Seat 8: Kukuryzka folded before Flop (didn't bet)
Seat 9: matiko09 folded before Flop (didn't bet)





PokerStars Hand #153066549192:  Hold'em No Limit ($1/$2 USD) - 2016/05/09 16:13:03 CET [2016/05/09 10:13:03 ET]
Table 'Hagar II' 9-max Seat #2 is the button
Seat 1: azzad2007 ($252.62 in chips) 
Seat 2: darren1031 ($166.73 in chips) 
Seat 4: matiko09 ($245.15 in chips) 
Seat 5: PacPacBum ($200 in chips) 
Seat 6: Piniker85 ($811.77 in chips) 
Seat 7: Monsthand ($216.35 in chips) 
Seat 8: J0k3rF4c3_FD ($383.60 in chips) 
Seat 9: chaps1988 ($200 in chips) 
matiko09: posts small blind $1
PacPacBum: posts big blind $2
*** HOLE CARDS ***
Dealt to matiko09 [Tc 4d]
Piniker85: folds 
Monsthand: folds 
J0k3rF4c3_FD: folds 
chaps1988: raises $3 to $5
azzad2007: folds 
darren1031: folds 
matiko09: folds 
PacPacBum: folds 
Uncalled bet ($3) returned to chaps1988
chaps1988 collected $5 from pot
chaps1988: doesn't show hand 
*** SUMMARY ***
Total pot $5 | Rake $0 
Seat 1: azzad2007 folded before Flop (didn't bet)
Seat 2: darren1031 (button) folded before Flop (didn't bet)
Seat 4: matiko09 (small blind) folded before Flop
Seat 5: PacPacBum (big blind) folded before Flop
Seat 6: Piniker85 folded before Flop (didn't bet)
Seat 7: Monsthand folded before Flop (didn't bet)
Seat 8: J0k3rF4c3_FD folded before Flop (didn't bet)
Seat 9: chaps1988 collected ($5)





PokerStars Hand #153066555017:  Hold'em No Limit ($0.50/$1.00 USD) - 2016/05/09 16:13:14 CET [2016/05/09 10:13:14 ET]
Table 'Terpsichore' 9-max Seat #8 is the button
Seat 1: ipashutapkom ($63.86 in chips) 
Seat 2: J0k3rF4c3_FD ($168.66 in chips) 
Seat 3: matiko09 ($119.87 in chips) 
Seat 4: nubpoker ($107.50 in chips) 
Seat 6: r4mz3s ($100 in chips) 
Seat 7: ozone2003 ($101.50 in chips) 
Seat 8: Kiosk230472 ($144.27 in chips) 
Seat 9: FTPbannedMe ($100 in chips) 
FTPbannedMe: posts small blind $0.50
ipashutapkom: posts big blind $1
*** HOLE CARDS ***
Dealt to matiko09 [8s Ac]
J0k3rF4c3_FD: folds 
matiko09: folds 
nubpoker: folds 
r4mz3s: folds 
ozone2003: folds 
Kiosk230472 has timed out
Kiosk230472: folds 
FTPbannedMe: folds 
Uncalled bet ($0.50) returned to ipashutapkom
ipashutapkom collected $1 from pot
ipashutapkom: doesn't show hand 
*** SUMMARY ***
Total pot $1 | Rake $0 
Seat 1: ipashutapkom (big blind) collected ($1)
Seat 2: J0k3rF4c3_FD folded before Flop (didn't bet)
Seat 3: matiko09 folded before Flop (didn't bet)
Seat 4: nubpoker folded before Flop (didn't bet)
Seat 6: r4mz3s folded before Flop (didn't bet)
Seat 7: ozone2003 folded before Flop (didn't bet)
Seat 8: Kiosk230472 (button) folded before Flop (didn't bet)
Seat 9: FTPbannedMe (small blind) folded before Flop





PokerStars Hand #153066557307:  Hold'em No Limit ($0.50/$1.00 USD) - 2016/05/09 16:13:18 CET [2016/05/09 10:13:18 ET]
Table 'Isberga II' 9-max Seat #7 is the button
Seat 1: Kukuryzka ($100 in chips) 
Seat 2: Filojoes ($116.45 in chips) 
Seat 3: matiko09 ($101 in chips) 
Seat 5: nubpoker ($118.48 in chips) 
Seat 6: maxxmeister ($100 in chips) 
Seat 7: azzad2007 ($100 in chips) 
Seat 8: ozone2003 ($100 in chips) 
Seat 9: tubelight00 ($104.97 in chips) 
ozone2003: posts small blind $0.50
tubelight00: posts big blind $1
ipashutapkom: sits out 
*** HOLE CARDS ***
Dealt to matiko09 [Kd Ah]
Kukuryzka: folds 
Filojoes: folds 
matiko09: raises $2 to $3
nubpoker: folds 
maxxmeister: folds 
azzad2007: folds 
ozone2003: folds 
tubelight00: calls $2
*** FLOP *** [2s Jh 4d]
tubelight00: checks 
matiko09: bets $4.02
tubelight00: calls $4.02
*** TURN *** [2s Jh 4d] [3h]
tubelight00: checks 
matiko09: checks 
*** RIVER *** [2s Jh 4d 3h] [8h]
tubelight00: checks 
matiko09: checks 
*** SHOW DOWN ***
tubelight00: shows [Qh Kc] (high card King)
matiko09: shows [Kd Ah] (high card Ace)
matiko09 collected $13.81 from pot
*** SUMMARY ***
Total pot $14.54 | Rake $0.73 
Board [2s Jh 4d 3h 8h]
Seat 1: Kukuryzka folded before Flop (didn't bet)
Seat 2: Filojoes folded before Flop (didn't bet)
Seat 3: matiko09 showed [Kd Ah] and won ($13.81) with high card Ace
Seat 5: nubpoker folded before Flop (didn't bet)
Seat 6: maxxmeister folded before Flop (didn't bet)
Seat 7: azzad2007 (button) folded before Flop (didn't bet)
Seat 8: ozone2003 (small blind) folded before Flop
Seat 9: tubelight00 (big blind) showed [Qh Kc] and lost with high card King





PokerStars Hand #153066564825:  Hold'em No Limit ($1/$2 USD) - 2016/05/09 16:13:30 CET [2016/05/09 10:13:30 ET]
Table 'Hagar II' 9-max Seat #4 is the button
Seat 1: azzad2007 ($252.62 in chips) 
Seat 2: darren1031 ($166.73 in chips) 
Seat 4: matiko09 ($244.15 in chips) 
Seat 5: PacPacBum ($200 in chips) 
Seat 6: Piniker85 ($811.77 in chips) 
Seat 7: Monsthand ($216.35 in chips) 
Seat 8: J0k3rF4c3_FD ($383.60 in chips) 
Seat 9: chaps1988 ($203 in chips) 
PacPacBum: posts small blind $1
Piniker85: posts big blind $2
*** HOLE CARDS ***
Dealt to matiko09 [Ts Qs]
Monsthand: folds 
J0k3rF4c3_FD: folds 
chaps1988: folds 
azzad2007: folds 
darren1031: folds 
matiko09: raises $2.54 to $4.54
PacPacBum: folds 
Piniker85: calls $2.54
*** FLOP *** [9s 3d 8h]
Piniker85: checks 
matiko09: bets $6.23
Piniker85: folds 
Uncalled bet ($6.23) returned to matiko09
matiko09 collected $9.58 from pot
matiko09: doesn't show hand 
*** SUMMARY ***
Total pot $10.08 | Rake $0.50 
Board [9s 3d 8h]
Seat 1: azzad2007 folded before Flop (didn't bet)
Seat 2: darren1031 folded before Flop (didn't bet)
Seat 4: matiko09 (button) collected ($9.58)
Seat 5: PacPacBum (small blind) folded before Flop
Seat 6: Piniker85 (big blind) folded on the Flop
Seat 7: Monsthand folded before Flop (didn't bet)
Seat 8: J0k3rF4c3_FD folded before Flop (didn't bet)
Seat 9: chaps1988 folded before Flop (didn't bet)





PokerStars Hand #153066570998:  Hold'em No Limit ($0.50/$1.00 USD) - 2016/05/09 16:13:41 CET [2016/05/09 10:13:41 ET]
Table 'Reiss' 9-max Seat #5 is the button
Seat 1: Dickyxxx ($197.40 in chips) 
Seat 3: chaps1988 ($117.87 in chips) 
Seat 4: MichaLabam ($140.40 in chips) 
Seat 5: matiko09 ($100 in chips) 
Seat 6: Spid1 ($137.43 in chips) 
Seat 7: nubpoker ($101.50 in chips) 
Seat 8: Filojoes ($182.68 in chips) 
Seat 9: Aghmir77 ($103.96 in chips) 
Spid1: posts small blind $0.50
nubpoker: posts big blind $1
*** HOLE CARDS ***
Dealt to matiko09 [3d 6h]
Filojoes: folds 
Aghmir77: folds 
Dickyxxx: folds 
chaps1988: folds 
MichaLabam: folds 
matiko09: folds 
Spid1: raises $1.50 to $2.50
nubpoker: folds 
Uncalled bet ($1.50) returned to Spid1
Spid1 collected $2 from pot
Spid1: doesn't show hand 
*** SUMMARY ***
Total pot $2 | Rake $0 
Seat 1: Dickyxxx folded before Flop (didn't bet)
Seat 3: chaps1988 folded before Flop (didn't bet)
Seat 4: MichaLabam folded before Flop (didn't bet)
Seat 5: matiko09 (button) folded before Flop (didn't bet)
Seat 6: Spid1 (small blind) collected ($2)
Seat 7: nubpoker (big blind) folded before Flop
Seat 8: Filojoes folded before Flop (didn't bet)
Seat 9: Aghmir77 folded before Flop (didn't bet)





PokerStars Hand #153066573016:  Hold'em No Limit ($0.50/$1.00 USD) - 2016/05/09 16:13:45 CET [2016/05/09 10:13:45 ET]
Table 'Terpsichore' 9-max Seat #9 is the button
Seat 1: ipashutapkom ($64.36 in chips) 
Seat 2: J0k3rF4c3_FD ($168.66 in chips) 
Seat 3: matiko09 ($119.87 in chips) 
Seat 4: nubpoker ($107.50 in chips) 
Seat 6: r4mz3s ($100 in chips) 
Seat 7: ozone2003 ($101.50 in chips) 
Seat 8: Kiosk230472 ($144.27 in chips) 
Seat 9: FTPbannedMe ($100 in chips) 
ipashutapkom: posts small blind $0.50
J0k3rF4c3_FD: posts big blind $1
*** HOLE CARDS ***
Dealt to matiko09 [Tc Qs]
matiko09: folds 
nubpoker: folds 
r4mz3s: folds 
ozone2003: folds 
Kiosk230472 has timed out
Kiosk230472: folds 
FTPbannedMe: folds 
ipashutapkom: folds 
Uncalled bet ($0.50) returned to J0k3rF4c3_FD
J0k3rF4c3_FD collected $1 from pot
J0k3rF4c3_FD: doesn't show hand 
*** SUMMARY ***
Total pot $1 | Rake $0 
Seat 1: ipashutapkom (small blind) folded before Flop
Seat 2: J0k3rF4c3_FD (big blind) collected ($1)
Seat 3: matiko09 folded before Flop (didn't bet)
Seat 4: nubpoker folded before Flop (didn't bet)
Seat 6: r4mz3s folded before Flop (didn't bet)
Seat 7: ozone2003 folded before Flop (didn't bet)
Seat 8: Kiosk230472 folded before Flop (didn't bet)
Seat 9: FTPbannedMe (button) folded before Flop (didn't bet)





PokerStars Hand #153066578064:  Hold'em No Limit ($0.50/$1.00 USD) - 2016/05/09 16:13:54 CET [2016/05/09 10:13:54 ET]
Table 'Alderamin' 9-max Seat #5 is the button
Seat 1: r4mz3s ($100 in chips) 
Seat 2: Filojoes ($126.51 in chips) 
Seat 3: NSL0808 ($45.23 in chips) 
Seat 4: matiko09 ($100 in chips) 
Seat 5: tanmayh ($130.03 in chips) 
Seat 6: Spid1 ($115.98 in chips) 
Seat 7: azzad2007 ($112.18 in chips) 
Seat 8: nubpoker ($100.75 in chips) 
Seat 9: ipashutapkom ($47.26 in chips) 
Spid1: posts small blind $0.50
azzad2007: posts big blind $1
*** HOLE CARDS ***
Dealt to matiko09 [Qs 6s]
nubpoker: folds 
ipashutapkom: folds 
r4mz3s: folds 
Filojoes: folds 
NSL0808: raises $2 to $3
matiko09: folds 
tanmayh: calls $3
Spid1: folds 
azzad2007: folds 
*** FLOP *** [7s Tc 7c]
NSL0808: checks 
tanmayh: checks 
*** TURN *** [7s Tc 7c] [4d]
NSL0808: bets $3.56
tanmayh: raises $3.56 to $7.12
NSL0808: calls $3.56
*** RIVER *** [7s Tc 7c 4d] [2d]
NSL0808: checks 
tanmayh: bets $10
NSL0808: calls $10
*** SHOW DOWN ***
tanmayh: shows [Jd 9d] (a pair of Sevens)
NSL0808: shows [Ad As] (two pair, Aces and Sevens)
NSL0808 collected $39.65 from pot
*** SUMMARY ***
Total pot $41.74 | Rake $2.09 
Board [7s Tc 7c 4d 2d]
Seat 1: r4mz3s folded before Flop (didn't bet)
Seat 2: Filojoes folded before Flop (didn't bet)
Seat 3: NSL0808 showed [Ad As] and won ($39.65) with two pair, Aces and Sevens
Seat 4: matiko09 folded before Flop (didn't bet)
Seat 5: tanmayh (button) showed [Jd 9d] and lost with a pair of Sevens
Seat 6: Spid1 (small blind) folded before Flop
Seat 7: azzad2007 (big blind) folded before Flop
Seat 8: nubpoker folded before Flop (didn't bet)
Seat 9: ipashutapkom folded before Flop (didn't bet)





PokerStars Hand #153066582480:  Hold'em No Limit ($0.50/$1.00 USD) - 2016/05/09 16:14:01 CET [2016/05/09 10:14:01 ET]
Table 'Hajek' 9-max Seat #6 is the button
Seat 1: Mukhin1 ($100.10 in chips) 
Seat 2: Spid1 ($100 in chips) 
Seat 4: LRVAV7 ($78.94 in chips) 
Seat 5: ozone2003 ($100 in chips) 
Seat 6: Filojoes ($104.80 in chips) 
Seat 7: DancerNN1 ($123.41 in chips) 
Seat 8: Kukuryzka ($99.20 in chips) 
Seat 9: matiko09 ($100 in chips) 
DancerNN1: posts small blind $0.50
Kukuryzka: posts big blind $1
Mukhin1: posts the ante $0.20
Spid1: posts the ante $0.20
LRVAV7: posts the ante $0.20
ozone2003: posts the ante $0.20
Filojoes: posts the ante $0.20
DancerNN1: posts the ante $0.20
Kukuryzka: posts the ante $0.20
matiko09: posts the ante $0.20
*** HOLE CARDS ***
Dealt to matiko09 [6d 2h]
matiko09: folds 
Mukhin1: folds 
Spid1: folds 
LRVAV7: folds 
ozone2003: folds 
Filojoes: folds 
DancerNN1: raises $2 to $3
Kukuryzka: raises $6 to $9
DancerNN1: raises $11 to $20
Kukuryzka: calls $11
*** FLOP *** [2d 8d 2s]
DancerNN1: bets $14
Kukuryzka: folds 
Uncalled bet ($14) returned to DancerNN1
DancerNN1 collected $39.52 from pot
DancerNN1: doesn't show hand 
*** SUMMARY ***
Total pot $41.60 | Rake $2.08 
Board [2d 8d 2s]
Seat 1: Mukhin1 folded before Flop (didn't bet)
Seat 2: Spid1 folded before Flop (didn't bet)
Seat 4: LRVAV7 folded before Flop (didn't bet)
Seat 5: ozone2003 folded before Flop (didn't bet)
Seat 6: Filojoes (button) folded before Flop (didn't bet)
Seat 7: DancerNN1 (small blind) collected ($39.52)
Seat 8: Kukuryzka (big blind) folded on the Flop
Seat 9: matiko09 folded before Flop (didn't bet)





PokerStars Hand #153066582387:  Hold'em No Limit ($0.50/$1.00 USD) - 2016/05/09 16:14:01 CET [2016/05/09 10:14:01 ET]
Table 'Merga II' 9-max Seat #6 is the button
Seat 1: ipashutapkom ($40 in chips) 
Seat 2: Filojoes ($104.12 in chips) 
Seat 3: xhinostrabli ($45.97 in chips) 
Seat 4: nubpoker ($102 in chips) 
Seat 5: LRVAV7 ($250.41 in chips) 
Seat 6: Spid1 ($287.48 in chips) 
Seat 7: matiko09 ($152.29 in chips) 
Seat 8: GrandOldFart ($101.50 in chips) 
Seat 9: chaps1988 ($214.93 in chips) 
matiko09: posts small blind $0.50
GrandOldFart: posts big blind $1
*** HOLE CARDS ***
Dealt to matiko09 [7h Qs]
chaps1988: folds 
ipashutapkom: folds 
Filojoes: folds 
xhinostrabli: folds 
nubpoker: folds 
LRVAV7: folds 
Spid1: raises $1.50 to $2.50
matiko09: folds 
GrandOldFart: folds 
Uncalled bet ($1.50) returned to Spid1
Spid1 collected $2.50 from pot
Spid1: doesn't show hand 
*** SUMMARY ***
Total pot $2.50 | Rake $0 
Seat 1: ipashutapkom folded before Flop (didn't bet)
Seat 2: Filojoes folded before Flop (didn't bet)
Seat 3: xhinostrabli folded before Flop (didn't bet)
Seat 4: nubpoker folded before Flop (didn't bet)
Seat 5: LRVAV7 folded before Flop (didn't bet)
Seat 6: Spid1 (button) collected ($2.50)
Seat 7: matiko09 (small blind) folded before Flop
Seat 8: GrandOldFart (big blind) folded before Flop
Seat 9: chaps1988 folded before Flop (didn't bet)





PokerStars Hand #153066582917:  Hold'em No Limit ($0.50/$1.00 USD) - 2016/05/09 16:14:02 CET [2016/05/09 10:14:02 ET]
Table 'Reiss' 9-max Seat #6 is the button
Seat 1: Dickyxxx ($197.40 in chips) 
Seat 3: chaps1988 ($117.87 in chips) 
Seat 4: MichaLabam ($140.40 in chips) 
Seat 5: matiko09 ($100 in chips) 
Seat 6: Spid1 ($138.43 in chips) 
Seat 7: nubpoker ($100.50 in chips) 
Seat 8: Filojoes ($182.68 in chips) 
Seat 9: Aghmir77 ($103.96 in chips) 
nubpoker: posts small blind $0.50
Filojoes: posts big blind $1
*** HOLE CARDS ***
Dealt to matiko09 [8d 7h]
Aghmir77: folds 
Dickyxxx: folds 
chaps1988: raises $2 to $3
MichaLabam: folds 
matiko09: folds 
Spid1: raises $6 to $9
nubpoker: folds 
Filojoes: folds 
chaps1988: calls $6
*** FLOP *** [2h Jh 6h]
chaps1988: bets $12
Spid1: calls $12
*** TURN *** [2h Jh 6h] [Tc]
chaps1988: bets $28.50
Spid1: calls $28.50
*** RIVER *** [2h Jh 6h Tc] [4h]
chaps1988: checks 
Spid1: bets $68.50
chaps1988: folds 
Uncalled bet ($68.50) returned to Spid1
Spid1 collected $98 from pot
Spid1: doesn't show hand 
*** SUMMARY ***
Total pot $100.50 | Rake $2.50 
Board [2h Jh 6h Tc 4h]
Seat 1: Dickyxxx folded before Flop (didn't bet)
Seat 3: chaps1988 folded on the River
Seat 4: MichaLabam folded before Flop (didn't bet)
Seat 5: matiko09 folded before Flop (didn't bet)
Seat 6: Spid1 (button) collected ($98)
Seat 7: nubpoker (small blind) folded before Flop
Seat 8: Filojoes (big blind) folded before Flop
Seat 9: Aghmir77 folded before Flop (didn't bet)





PokerStars Hand #153066588848:  Hold'em No Limit ($1/$2 USD) - 2016/05/09 16:14:12 CET [2016/05/09 10:14:12 ET]
Table 'Hagar II' 9-max Seat #5 is the button
Seat 1: azzad2007 ($252.62 in chips) 
Seat 2: darren1031 ($166.73 in chips) 
Seat 4: matiko09 ($249.19 in chips) 
Seat 5: PacPacBum ($200 in chips) 
Seat 6: Piniker85 ($807.23 in chips) 
Seat 7: Monsthand ($216.35 in chips) 
Seat 8: J0k3rF4c3_FD ($383.60 in chips) 
Seat 9: chaps1988 ($203 in chips) 
Piniker85: posts small blind $1
Monsthand: posts big blind $2
*** HOLE CARDS ***
Dealt to matiko09 [Ac 3s]
J0k3rF4c3_FD: folds 
chaps1988: folds 
azzad2007: folds 
darren1031: folds 
matiko09: folds 
PacPacBum: folds 
Piniker85: folds 
Uncalled bet ($1) returned to Monsthand
Monsthand collected $2 from pot
Monsthand: doesn't show hand 
*** SUMMARY ***
Total pot $2 | Rake $0 
Seat 1: azzad2007 folded before Flop (didn't bet)
Seat 2: darren1031 folded before Flop (didn't bet)
Seat 4: matiko09 folded before Flop (didn't bet)
Seat 5: PacPacBum (button) folded before Flop (didn't bet)
Seat 6: Piniker85 (small blind) folded before Flop
Seat 7: Monsthand (big blind) collected ($2)
Seat 8: J0k3rF4c3_FD folded before Flop (didn't bet)
Seat 9: chaps1988 folded before Flop (didn't bet)





PokerStars Hand #153066589947:  Hold'em No Limit ($0.50/$1.00 USD) - 2016/05/09 16:14:14 CET [2016/05/09 10:14:14 ET]
Table 'Terpsichore' 9-max Seat #1 is the button
Seat 1: ipashutapkom ($63.86 in chips) 
Seat 2: J0k3rF4c3_FD ($169.16 in chips) 
Seat 3: matiko09 ($119.87 in chips) 
Seat 4: nubpoker ($107.50 in chips) 
Seat 6: r4mz3s ($100 in chips) 
Seat 7: ozone2003 ($101.50 in chips) 
Seat 8: Kiosk230472 ($144.27 in chips) 
Seat 9: FTPbannedMe ($100 in chips) 
J0k3rF4c3_FD: posts small blind $0.50
matiko09: posts big blind $1
mycka86: sits out 
*** HOLE CARDS ***
Dealt to matiko09 [9d 7h]
nubpoker: folds 
r4mz3s: folds 
ozone2003: folds 
Kiosk230472 has timed out
Kiosk230472: folds 
FTPbannedMe: folds 
ipashutapkom: raises $1.26 to $2.26
J0k3rF4c3_FD: folds 
matiko09: folds 
Uncalled bet ($1.26) returned to ipashutapkom
ipashutapkom collected $2.50 from pot
ipashutapkom: doesn't show hand 
*** SUMMARY ***
Total pot $2.50 | Rake $0 
Seat 1: ipashutapkom (button) collected ($2.50)
Seat 2: J0k3rF4c3_FD (small blind) folded before Flop
Seat 3: matiko09 (big blind) folded before Flop
Seat 4: nubpoker folded before Flop (didn't bet)
Seat 6: r4mz3s folded before Flop (didn't bet)
Seat 7: ozone2003 folded before Flop (didn't bet)
Seat 8: Kiosk230472 folded before Flop (didn't bet)
Seat 9: FTPbannedMe folded before Flop (didn't bet)





PokerStars Hand #153066603780:  Hold'em No Limit ($0.50/$1.00 USD) - 2016/05/09 16:14:38 CET [2016/05/09 10:14:38 ET]
Table 'Merga II' 9-max Seat #7 is the button
Seat 1: ipashutapkom ($40 in chips) 
Seat 2: Filojoes ($104.12 in chips) 
Seat 3: xhinostrabli ($45.97 in chips) 
Seat 4: nubpoker ($102 in chips) 
Seat 5: LRVAV7 ($250.41 in chips) 
Seat 6: Spid1 ($288.98 in chips) 
Seat 7: matiko09 ($151.79 in chips) 
Seat 8: GrandOldFart ($100.50 in chips) 
Seat 9: chaps1988 ($214.93 in chips) 
GrandOldFart: posts small blind $0.50
chaps1988: posts big blind $1
*** HOLE CARDS ***
Dealt to matiko09 [5c Jd]
ipashutapkom: folds 
Filojoes: folds 
xhinostrabli: raises $1 to $2
nubpoker: folds 
LRVAV7: calls $2
Spid1: raises $10 to $12
matiko09: folds 
GrandOldFart: folds 
chaps1988: folds 
xhinostrabli: folds 
LRVAV7: folds 
Uncalled bet ($10) returned to Spid1
Spid1 collected $7.50 from pot
Spid1: doesn't show hand 
*** SUMMARY ***
Total pot $7.50 | Rake $0 
Seat 1: ipashutapkom folded before Flop (didn't bet)
Seat 2: Filojoes folded before Flop (didn't bet)
Seat 3: xhinostrabli folded before Flop
Seat 4: nubpoker folded before Flop (didn't bet)
Seat 5: LRVAV7 folded before Flop
Seat 6: Spid1 collected ($7.50)
Seat 7: matiko09 (button) folded before Flop (didn't bet)
Seat 8: GrandOldFart (small blind) folded before Flop
Seat 9: chaps1988 (big blind) folded before Flop





PokerStars Hand #153066608951:  Hold'em No Limit ($1/$2 USD) - 2016/05/09 16:14:47 CET [2016/05/09 10:14:47 ET]
Table 'Hagar II' 9-max Seat #6 is the button
Seat 1: azzad2007 ($252.62 in chips) 
Seat 2: darren1031 ($166.73 in chips) 
Seat 4: matiko09 ($249.19 in chips) 
Seat 5: PacPacBum ($200 in chips) 
Seat 6: Piniker85 ($806.23 in chips) 
Seat 7: Monsthand ($217.35 in chips) 
Seat 8: J0k3rF4c3_FD ($383.60 in chips) 
Seat 9: chaps1988 ($203 in chips) 
Monsthand: posts small blind $1
J0k3rF4c3_FD: posts big blind $2
*** HOLE CARDS ***
Dealt to matiko09 [Qs Jc]
chaps1988: folds 
azzad2007: folds 
darren1031: folds 
matiko09: raises $3 to $5
PacPacBum: folds 
Piniker85: folds 
Monsthand: folds 
J0k3rF4c3_FD: folds 
Uncalled bet ($3) returned to matiko09
matiko09 collected $5 from pot
matiko09: doesn't show hand 
*** SUMMARY ***
Total pot $5 | Rake $0 
Seat 1: azzad2007 folded before Flop (didn't bet)
Seat 2: darren1031 folded before Flop (didn't bet)
Seat 4: matiko09 collected ($5)
Seat 5: PacPacBum folded before Flop (didn't bet)
Seat 6: Piniker85 (button) folded before Flop (didn't bet)
Seat 7: Monsthand (small blind) folded before Flop
Seat 8: J0k3rF4c3_FD (big blind) folded before Flop
Seat 9: chaps1988 folded before Flop (didn't bet)





PokerStars Hand #153066610069:  Hold'em No Limit ($0.50/$1.00 USD) - 2016/05/09 16:14:49 CET [2016/05/09 10:14:49 ET]
Table 'Isberga II' 9-max Seat #8 is the button
Seat 1: Kukuryzka ($100 in chips) 
Seat 2: Filojoes ($116.45 in chips) 
Seat 3: matiko09 ($107.79 in chips) 
Seat 5: nubpoker ($118.48 in chips) 
Seat 6: maxxmeister ($100 in chips) 
Seat 7: azzad2007 ($100 in chips) 
Seat 8: ozone2003 ($100 in chips) 
Seat 9: tubelight00 ($97.95 in chips) 
tubelight00: posts small blind $0.50
Kukuryzka: posts big blind $1
ipashutapkom: sits out 
*** HOLE CARDS ***
Dealt to matiko09 [6h 2d]
Filojoes: folds 
matiko09: folds 
nubpoker: raises $1.50 to $2.50
maxxmeister: folds 
azzad2007: folds 
ozone2003: folds 
tubelight00: folds 
Kukuryzka: folds 
Uncalled bet ($1.50) returned to nubpoker
nubpoker collected $2.50 from pot
nubpoker: doesn't show hand 
*** SUMMARY ***
Total pot $2.50 | Rake $0 
Seat 1: Kukuryzka (big blind) folded before Flop
Seat 2: Filojoes folded before Flop (didn't bet)
Seat 3: matiko09 folded before Flop (didn't bet)
Seat 5: nubpoker collected ($2.50)
Seat 6: maxxmeister folded before Flop (didn't bet)
Seat 7: azzad2007 folded before Flop (didn't bet)
Seat 8: ozone2003 (button) folded before Flop (didn't bet)
Seat 9: tubelight00 (small blind) folded before Flop





PokerStars Hand #153066611425:  Hold'em No Limit ($0.50/$1.00 USD) - 2016/05/09 16:14:51 CET [2016/05/09 10:14:51 ET]
Table 'Terpsichore' 9-max Seat #2 is the button
Seat 1: ipashutapkom ($65.36 in chips) 
Seat 2: J0k3rF4c3_FD ($168.66 in chips) 
Seat 3: matiko09 ($118.87 in chips) 
Seat 4: nubpoker ($107.50 in chips) 
Seat 6: r4mz3s ($100 in chips) 
Seat 7: ozone2003 ($101.50 in chips) 
Seat 8: Kiosk230472 ($144.27 in chips) 
Seat 9: FTPbannedMe ($100 in chips) 
matiko09: posts small blind $0.50
nubpoker: posts big blind $1
mycka86: sits out 
*** HOLE CARDS ***
Dealt to matiko09 [Jd 9h]
r4mz3s: folds 
ozone2003: folds 
Kiosk230472: folds 
FTPbannedMe: folds 
ipashutapkom: folds 
J0k3rF4c3_FD: raises $1.50 to $2.50
matiko09: folds 
nubpoker: folds 
Uncalled bet ($1.50) returned to J0k3rF4c3_FD
J0k3rF4c3_FD collected $2.50 from pot
J0k3rF4c3_FD: doesn't show hand 
*** SUMMARY ***
Total pot $2.50 | Rake $0 
Seat 1: ipashutapkom folded before Flop (didn't bet)
Seat 2: J0k3rF4c3_FD (button) collected ($2.50)
Seat 3: matiko09 (small blind) folded before Flop
Seat 4: nubpoker (big blind) folded before Flop
Seat 6: r4mz3s folded before Flop (didn't bet)
Seat 7: ozone2003 folded before Flop (didn't bet)
Seat 8: Kiosk230472 folded before Flop (didn't bet)
Seat 9: FTPbannedMe folded before Flop (didn't bet)





PokerStars Hand #153066616243:  Hold'em No Limit ($0.50/$1.00 USD) - 2016/05/09 16:15:00 CET [2016/05/09 10:15:00 ET]
Table 'Alderamin' 9-max Seat #6 is the button
Seat 1: r4mz3s ($100 in chips) 
Seat 2: Filojoes ($126.51 in chips) 
Seat 3: NSL0808 ($64.76 in chips) 
Seat 4: matiko09 ($100 in chips) 
Seat 5: tanmayh ($109.91 in chips) 
Seat 6: Spid1 ($115.48 in chips) 
Seat 7: azzad2007 ($111.18 in chips) 
Seat 8: nubpoker ($100.75 in chips) 
Seat 9: ipashutapkom ($47.26 in chips) 
azzad2007: posts small blind $0.50
nubpoker: posts big blind $1
*** HOLE CARDS ***
Dealt to matiko09 [6s 9h]
ipashutapkom: folds 
r4mz3s: folds 
Filojoes: folds 
NSL0808: calls $1
matiko09: folds 
tanmayh: calls $1
Spid1: raises $3 to $4
azzad2007: folds 
nubpoker: folds 
NSL0808: calls $3
tanmayh: calls $3
*** FLOP *** [5d 9s Qc]
NSL0808: checks 
tanmayh: checks 
Spid1: checks 
*** TURN *** [5d 9s Qc] [Ad]
NSL0808: checks 
tanmayh: bets $13
Spid1: folds 
NSL0808: folds 
Uncalled bet ($13) returned to tanmayh
tanmayh collected $12.82 from pot
tanmayh: doesn't show hand 
*** SUMMARY ***
Total pot $13.50 | Rake $0.68 
Board [5d 9s Qc Ad]
Seat 1: r4mz3s folded before Flop (didn't bet)
Seat 2: Filojoes folded before Flop (didn't bet)
Seat 3: NSL0808 folded on the Turn
Seat 4: matiko09 folded before Flop (didn't bet)
Seat 5: tanmayh collected ($12.82)
Seat 6: Spid1 (button) folded on the Turn
Seat 7: azzad2007 (small blind) folded before Flop
Seat 8: nubpoker (big blind) folded before Flop
Seat 9: ipashutapkom folded before Flop (didn't bet)





PokerStars Hand #153066619789:  Hold'em No Limit ($0.50/$1.00 USD) - 2016/05/09 16:15:06 CET [2016/05/09 10:15:06 ET]
Table 'Orthos' 9-max Seat #2 is the button
Seat 1: Kelvin sai ($87.86 in chips) 
Seat 2: PacPacBum ($112.35 in chips) 
Seat 4: nubpoker ($118.87 in chips) 
Seat 5: matiko09 ($123.62 in chips) 
Seat 6: xhinostrabli ($118.15 in chips) 
Seat 7: azzad2007 ($106.47 in chips) 
Seat 8: Dickyxxx ($100 in chips) 
Seat 9: r4mz3s ($104.50 in chips) 
Filojoes will be allowed to play after the button
nubpoker: posts small blind $0.50
matiko09: posts big blind $1
*** HOLE CARDS ***
Dealt to matiko09 [4c Ac]
xhinostrabli: folds 
azzad2007: folds 
Dickyxxx: folds 
r4mz3s: folds 
Kelvin sai: folds 
PacPacBum: raises $1.50 to $2.50
nubpoker: folds 
matiko09: calls $1.50
*** FLOP *** [2s Ad 2d]
matiko09: checks 
PacPacBum: bets $3.60
matiko09: calls $3.60
*** TURN *** [2s Ad 2d] [Ks]
matiko09: checks 
PacPacBum: checks 
*** RIVER *** [2s Ad 2d Ks] [Jc]
matiko09: checks 
PacPacBum: checks 
*** SHOW DOWN ***
matiko09: shows [4c Ac] (two pair, Aces and Deuces)
PacPacBum: mucks hand 
matiko09 collected $12.06 from pot
*** SUMMARY ***
Total pot $12.70 | Rake $0.64 
Board [2s Ad 2d Ks Jc]
Seat 1: Kelvin sai folded before Flop (didn't bet)
Seat 2: PacPacBum (button) mucked [Jd Kd]
Seat 4: nubpoker (small blind) folded before Flop
Seat 5: matiko09 (big blind) showed [4c Ac] and won ($12.06) with two pair, Aces and Deuces
Seat 6: xhinostrabli folded before Flop (didn't bet)
Seat 7: azzad2007 folded before Flop (didn't bet)
Seat 8: Dickyxxx folded before Flop (didn't bet)
Seat 9: r4mz3s folded before Flop (didn't bet)





PokerStars Hand #153066623820:  Hold'em No Limit ($1/$2 USD) - 2016/05/09 16:15:13 CET [2016/05/09 10:15:13 ET]
Table 'Hagar II' 9-max Seat #7 is the button
Seat 1: azzad2007 ($252.62 in chips) 
Seat 2: darren1031 ($166.73 in chips) 
Seat 4: matiko09 ($252.19 in chips) 
Seat 5: PacPacBum ($200 in chips) 
Seat 6: Piniker85 ($806.23 in chips) 
Seat 7: Monsthand ($216.35 in chips) 
Seat 8: J0k3rF4c3_FD ($381.60 in chips) 
Seat 9: chaps1988 ($203 in chips) 
J0k3rF4c3_FD: posts small blind $1
chaps1988: posts big blind $2
*** HOLE CARDS ***
Dealt to matiko09 [As 2s]
azzad2007: folds 
darren1031: folds 
matiko09: folds 
PacPacBum: raises $3 to $5
Piniker85: folds 
Monsthand: folds 
J0k3rF4c3_FD: folds 
chaps1988: calls $3
*** FLOP *** [2c Kc 4s]
chaps1988: checks 
PacPacBum: bets $3.65
chaps1988: calls $3.65
*** TURN *** [2c Kc 4s] [3c]
chaps1988: checks 
PacPacBum: checks 
*** RIVER *** [2c Kc 4s 3c] [Qc]
chaps1988: checks 
PacPacBum: bets $9.38
chaps1988: raises $16.39 to $25.77
PacPacBum: folds 
Uncalled bet ($16.39) returned to chaps1988
chaps1988 collected $35.21 from pot
chaps1988: doesn't show hand 
*** SUMMARY ***
Total pot $37.06 | Rake $1.85 
Board [2c Kc 4s 3c Qc]
Seat 1: azzad2007 folded before Flop (didn't bet)
Seat 2: darren1031 folded before Flop (didn't bet)
Seat 4: matiko09 folded before Flop (didn't bet)
Seat 5: PacPacBum folded on the River
Seat 6: Piniker85 folded before Flop (didn't bet)
Seat 7: Monsthand (button) folded before Flop (didn't bet)
Seat 8: J0k3rF4c3_FD (small blind) folded before Flop
Seat 9: chaps1988 (big blind) collected ($35.21)





PokerStars Hand #153066624707:  Hold'em No Limit ($0.50/$1.00 USD) - 2016/05/09 16:15:14 CET [2016/05/09 10:15:14 ET]
Table 'Terpsichore' 9-max Seat #3 is the button
Seat 1: ipashutapkom ($65.36 in chips) 
Seat 2: J0k3rF4c3_FD ($170.16 in chips) 
Seat 3: matiko09 ($118.37 in chips) 
Seat 4: nubpoker ($106.50 in chips) 
Seat 5: mycka86 ($208.01 in chips) 
Seat 6: r4mz3s ($100 in chips) 
Seat 7: ozone2003 ($101.50 in chips) 
Seat 8: Kiosk230472 ($144.27 in chips) 
Seat 9: FTPbannedMe ($100 in chips) 
nubpoker: posts small blind $0.50
mycka86: posts big blind $1
*** HOLE CARDS ***
Dealt to matiko09 [9h Qd]
r4mz3s: folds 
ozone2003: folds 
Kiosk230472: calls $1
FTPbannedMe: folds 
ipashutapkom: folds 
J0k3rF4c3_FD: raises $3 to $4
matiko09: folds 
nubpoker: calls $3.50
mycka86: folds 
Kiosk230472: calls $3
*** FLOP *** [8s Kc 9s]
nubpoker: checks 
Kiosk230472: checks 
J0k3rF4c3_FD: bets $6.68
nubpoker: calls $6.68
Kiosk230472: calls $6.68
*** TURN *** [8s Kc 9s] [8d]
nubpoker: checks 
Kiosk230472: bets $7
J0k3rF4c3_FD: calls $7
nubpoker: calls $7
*** RIVER *** [8s Kc 9s 8d] [2s]
nubpoker: checks 
Kiosk230472: checks 
J0k3rF4c3_FD: checks 
*** SHOW DOWN ***
nubpoker: shows [Kh Jh] (two pair, Kings and Eights)
Kiosk230472: shows [Qs Kd] (two pair, Kings and Eights - Queen kicker)
J0k3rF4c3_FD: mucks hand 
Kiosk230472 collected $51.54 from pot
*** SUMMARY ***
Total pot $54.04 | Rake $2.50 
Board [8s Kc 9s 8d 2s]
Seat 1: ipashutapkom folded before Flop (didn't bet)
Seat 2: J0k3rF4c3_FD mucked [6d 7d]
Seat 3: matiko09 (button) folded before Flop (didn't bet)
Seat 4: nubpoker (small blind) showed [Kh Jh] and lost with two pair, Kings and Eights
Seat 5: mycka86 (big blind) folded before Flop
Seat 6: r4mz3s folded before Flop (didn't bet)
Seat 7: ozone2003 folded before Flop (didn't bet)
Seat 8: Kiosk230472 showed [Qs Kd] and won ($51.54) with two pair, Kings and Eights
Seat 9: FTPbannedMe folded before Flop (didn't bet)





PokerStars Hand #153066628072:  Hold'em No Limit ($0.50/$1.00 USD) - 2016/05/09 16:15:20 CET [2016/05/09 10:15:20 ET]
Table 'Hajek' 9-max Seat #7 is the button
Seat 1: Mukhin1 ($100 in chips) 
Seat 2: Spid1 ($100 in chips) 
Seat 4: LRVAV7 ($78.74 in chips) 
Seat 5: ozone2003 ($100 in chips) 
Seat 6: Filojoes ($104.60 in chips) 
Seat 7: DancerNN1 ($142.73 in chips) 
Seat 8: Kukuryzka ($100 in chips) 
Seat 9: matiko09 ($100 in chips) 
Kukuryzka: posts small blind $0.50
matiko09: posts big blind $1
mycka86: sits out 
Mukhin1: posts the ante $0.20
Spid1: posts the ante $0.20
LRVAV7: posts the ante $0.20
ozone2003: posts the ante $0.20
Filojoes: posts the ante $0.20
DancerNN1: posts the ante $0.20
Kukuryzka: posts the ante $0.20
matiko09: posts the ante $0.20
*** HOLE CARDS ***
Dealt to matiko09 [8s 4d]
Mukhin1: folds 
Spid1: folds 
LRVAV7: folds 
ozone2003: folds 
Filojoes: raises $1.50 to $2.50
DancerNN1: raises $6.50 to $9
Kukuryzka: folds 
matiko09: folds 
Filojoes: raises $95.40 to $104.40 and is all-in
DancerNN1: calls $95.40
*** FIRST FLOP *** [4s Jh 7d]
*** FIRST TURN *** [4s Jh 7d] [6s]
*** FIRST RIVER *** [4s Jh 7d 6s] [8d]
*** SECOND FLOP *** [Js 3c 9c]
*** SECOND TURN *** [Js 3c 9c] [Ac]
*** SECOND RIVER *** [Js 3c 9c Ac] [Tc]
*** FIRST SHOW DOWN ***
Filojoes: shows [Qd Qh] (a pair of Queens)
DancerNN1: shows [Kh Kd] (a pair of Kings)
DancerNN1 collected $104.70 from pot
*** SECOND SHOW DOWN ***
Filojoes: shows [Qd Qh] (a pair of Queens)
DancerNN1: shows [Kh Kd] (a pair of Kings)
DancerNN1 collected $104.70 from pot
*** SUMMARY ***
Total pot $211.90 | Rake $2.50 
Hand was run twice
FIRST Board [4s Jh 7d 6s 8d]
SECOND Board [Js 3c 9c Ac Tc]
Seat 1: Mukhin1 folded before Flop (didn't bet)
Seat 2: Spid1 folded before Flop (didn't bet)
Seat 4: LRVAV7 folded before Flop (didn't bet)
Seat 5: ozone2003 folded before Flop (didn't bet)
Seat 6: Filojoes showed [Qd Qh] and lost with a pair of Queens, and lost with a pair of Queens
Seat 7: DancerNN1 (button) showed [Kh Kd] and won ($104.70) with a pair of Kings, and won ($104.70) with a pair of Kings
Seat 8: Kukuryzka (small blind) folded before Flop
Seat 9: matiko09 (big blind) folded before Flop





PokerStars Hand #153066632556:  Hold'em No Limit ($0.50/$1.00 USD) - 2016/05/09 16:15:28 CET [2016/05/09 10:15:28 ET]
Table 'Isberga II' 9-max Seat #9 is the button
Seat 1: Kukuryzka ($99 in chips) 
Seat 2: Filojoes ($116.45 in chips) 
Seat 3: matiko09 ($107.79 in chips) 
Seat 5: nubpoker ($119.98 in chips) 
Seat 6: maxxmeister ($100 in chips) 
Seat 7: azzad2007 ($100 in chips) 
Seat 8: ozone2003 ($100 in chips) 
Seat 9: tubelight00 ($97.45 in chips) 
Kukuryzka: posts small blind $0.50
Filojoes: posts big blind $1
ipashutapkom: sits out 
*** HOLE CARDS ***
Dealt to matiko09 [7c 2s]
matiko09: folds 
nubpoker: raises $1.50 to $2.50
maxxmeister: folds 
azzad2007: folds 
ozone2003: folds 
tubelight00: folds 
Kukuryzka: folds 
Filojoes: folds 
Uncalled bet ($1.50) returned to nubpoker
nubpoker collected $2.50 from pot
nubpoker: doesn't show hand 
*** SUMMARY ***
Total pot $2.50 | Rake $0 
Seat 1: Kukuryzka (small blind) folded before Flop
Seat 2: Filojoes (big blind) folded before Flop
Seat 3: matiko09 folded before Flop (didn't bet)
Seat 5: nubpoker collected ($2.50)
Seat 6: maxxmeister folded before Flop (didn't bet)
Seat 7: azzad2007 folded before Flop (didn't bet)
Seat 8: ozone2003 folded before Flop (didn't bet)
Seat 9: tubelight00 (button) folded before Flop (didn't bet)





PokerStars Hand #153066639944:  Hold'em No Limit ($0.50/$1.00 USD) - 2016/05/09 16:15:41 CET [2016/05/09 10:15:41 ET]
Table 'Merga II' 9-max Seat #8 is the button
Seat 1: ipashutapkom ($40 in chips) 
Seat 2: Filojoes ($104.12 in chips) 
Seat 3: xhinostrabli ($43.97 in chips) 
Seat 4: nubpoker ($102 in chips) 
Seat 5: LRVAV7 ($248.41 in chips) 
Seat 6: Spid1 ($294.48 in chips) 
Seat 7: matiko09 ($151.79 in chips) 
Seat 8: GrandOldFart ($100 in chips) 
Seat 9: chaps1988 ($213.93 in chips) 
chaps1988: posts small blind $0.50
ipashutapkom: posts big blind $1
*** HOLE CARDS ***
Dealt to matiko09 [4h 3d]
Filojoes: folds 
xhinostrabli: folds 
nubpoker: folds 
LRVAV7: folds 
Spid1: folds 
matiko09: folds 
GrandOldFart: raises $2 to $3
chaps1988: folds 
ipashutapkom: folds 
Uncalled bet ($2) returned to GrandOldFart
GrandOldFart collected $2.50 from pot
*** SUMMARY ***
Total pot $2.50 | Rake $0 
Seat 1: ipashutapkom (big blind) folded before Flop
Seat 2: Filojoes folded before Flop (didn't bet)
Seat 3: xhinostrabli folded before Flop (didn't bet)
Seat 4: nubpoker folded before Flop (didn't bet)
Seat 5: LRVAV7 folded before Flop (didn't bet)
Seat 6: Spid1 folded before Flop (didn't bet)
Seat 7: matiko09 folded before Flop (didn't bet)
Seat 8: GrandOldFart (button) collected ($2.50)
Seat 9: chaps1988 (small blind) folded before Flop





PokerStars Hand #153066641414:  Hold'em No Limit ($0.50/$1.00 USD) - 2016/05/09 16:15:43 CET [2016/05/09 10:15:43 ET]
Table 'Orthos' 9-max Seat #4 is the button
Seat 1: Kelvin sai ($87.86 in chips) 
Seat 2: PacPacBum ($106.25 in chips) 
Seat 4: nubpoker ($118.37 in chips) 
Seat 5: matiko09 ($129.58 in chips) 
Seat 6: xhinostrabli ($118.15 in chips) 
Seat 7: azzad2007 ($106.47 in chips) 
Seat 8: Dickyxxx ($100 in chips) 
Seat 9: r4mz3s ($104.50 in chips) 
matiko09: posts small blind $0.50
xhinostrabli: posts big blind $1
Filojoes: sits out 
*** HOLE CARDS ***
Dealt to matiko09 [4d Th]
azzad2007: folds 
Dickyxxx: folds 
r4mz3s: raises $1.50 to $2.50
Kelvin sai: folds 
PacPacBum: folds 
nubpoker: folds 
matiko09: folds 
azzad2007 leaves the table
xhinostrabli: folds 
Uncalled bet ($1.50) returned to r4mz3s
r4mz3s collected $2.50 from pot
r4mz3s: doesn't show hand 
*** SUMMARY ***
Total pot $2.50 | Rake $0 
Seat 1: Kelvin sai folded before Flop (didn't bet)
Seat 2: PacPacBum folded before Flop (didn't bet)
Seat 4: nubpoker (button) folded before Flop (didn't bet)
Seat 5: matiko09 (small blind) folded before Flop
Seat 6: xhinostrabli (big blind) folded before Flop
Seat 7: azzad2007 folded before Flop (didn't bet)
Seat 8: Dickyxxx folded before Flop (didn't bet)
Seat 9: r4mz3s collected ($2.50)





PokerStars Hand #153066645130:  Hold'em No Limit ($0.50/$1.00 USD) - 2016/05/09 16:15:50 CET [2016/05/09 10:15:50 ET]
Table 'Reiss' 9-max Seat #7 is the button
Seat 1: Dickyxxx ($197.40 in chips) 
Seat 3: chaps1988 ($100 in chips) 
Seat 4: MichaLabam ($140.40 in chips) 
Seat 5: matiko09 ($100 in chips) 
Seat 6: Spid1 ($186.93 in chips) 
Seat 7: nubpoker ($100 in chips) 
Seat 8: Filojoes ($181.68 in chips) 
Seat 9: Aghmir77 ($103.96 in chips) 
Filojoes: posts small blind $0.50
Aghmir77: posts big blind $1
mycka86: sits out 
*** HOLE CARDS ***
Dealt to matiko09 [Ks Js]
Dickyxxx: folds 
chaps1988: folds 
MichaLabam: folds 
matiko09: raises $2 to $3
Spid1: folds 
nubpoker: folds 
Filojoes: folds 
Aghmir77: folds 
Uncalled bet ($2) returned to matiko09
matiko09 collected $2.50 from pot
matiko09: doesn't show hand 
*** SUMMARY ***
Total pot $2.50 | Rake $0 
Seat 1: Dickyxxx folded before Flop (didn't bet)
Seat 3: chaps1988 folded before Flop (didn't bet)
Seat 4: MichaLabam folded before Flop (didn't bet)
Seat 5: matiko09 collected ($2.50)
Seat 6: Spid1 folded before Flop (didn't bet)
Seat 7: nubpoker (button) folded before Flop (didn't bet)
Seat 8: Filojoes (small blind) folded before Flop
Seat 9: Aghmir77 (big blind) folded before Flop





PokerStars Hand #153066659417:  Hold'em No Limit ($0.50/$1.00 USD) - 2016/05/09 16:16:14 CET [2016/05/09 10:16:14 ET]
Table 'Orthos' 9-max Seat #5 is the button
Seat 1: Kelvin sai ($87.86 in chips) 
Seat 2: PacPacBum ($106.25 in chips) 
Seat 4: nubpoker ($118.37 in chips) 
Seat 5: matiko09 ($129.08 in chips) 
Seat 6: xhinostrabli ($117.15 in chips) 
Seat 8: Dickyxxx ($100 in chips) 
Seat 9: r4mz3s ($106 in chips) 
xhinostrabli: posts small blind $0.50
Dickyxxx: posts big blind $1
Filojoes: sits out 
*** HOLE CARDS ***
Dealt to matiko09 [7s 5s]
r4mz3s: folds 
Kelvin sai: folds 
PacPacBum: folds 
nubpoker: folds 
matiko09: raises $1.27 to $2.27
ozone2003 joins the table at seat #7 
ozone2003 leaves the table
xhinostrabli: folds 
Dickyxxx: folds 
Uncalled bet ($1.27) returned to matiko09
matiko09 collected $2.50 from pot
matiko09: doesn't show hand 
*** SUMMARY ***
Total pot $2.50 | Rake $0 
Seat 1: Kelvin sai folded before Flop (didn't bet)
Seat 2: PacPacBum folded before Flop (didn't bet)
Seat 4: nubpoker folded before Flop (didn't bet)
Seat 5: matiko09 (button) collected ($2.50)
Seat 6: xhinostrabli (small blind) folded before Flop
Seat 8: Dickyxxx (big blind) folded before Flop
Seat 9: r4mz3s folded before Flop (didn't bet)





PokerStars Hand #153066660102:  Hold'em No Limit ($0.50/$1.00 USD) - 2016/05/09 16:16:15 CET [2016/05/09 10:16:15 ET]
Table 'Isberga II' 9-max Seat #1 is the button
Seat 1: Kukuryzka ($100 in chips) 
Seat 2: Filojoes ($115.45 in chips) 
Seat 3: matiko09 ($107.79 in chips) 
Seat 5: nubpoker ($121.48 in chips) 
Seat 6: maxxmeister ($100 in chips) 
Seat 7: azzad2007 ($100 in chips) 
Seat 8: ozone2003 ($100 in chips) 
Seat 9: tubelight00 ($97.45 in chips) 
Filojoes: posts small blind $0.50
matiko09: posts big blind $1
ipashutapkom: sits out 
*** HOLE CARDS ***
Dealt to matiko09 [6s Ah]
nubpoker: folds 
maxxmeister: folds 
azzad2007: folds 
ozone2003: folds 
tubelight00: calls $1
Kukuryzka: folds 
Filojoes: raises $2.50 to $3.50
matiko09: folds 
tubelight00: calls $2.50
*** FLOP *** [4h Ad Jh]
Filojoes: bets $4.56
tubelight00: folds 
Uncalled bet ($4.56) returned to Filojoes
Filojoes collected $7.60 from pot
Filojoes: doesn't show hand 
*** SUMMARY ***
Total pot $8 | Rake $0.40 
Board [4h Ad Jh]
Seat 1: Kukuryzka (button) folded before Flop (didn't bet)
Seat 2: Filojoes (small blind) collected ($7.60)
Seat 3: matiko09 (big blind) folded before Flop
Seat 5: nubpoker folded before Flop (didn't bet)
Seat 6: maxxmeister folded before Flop (didn't bet)
Seat 7: azzad2007 folded before Flop (didn't bet)
Seat 8: ozone2003 folded before Flop (didn't bet)
Seat 9: tubelight00 folded on the Flop





PokerStars Hand #153066662021:  Hold'em No Limit ($0.50/$1.00 USD) - 2016/05/09 16:16:18 CET [2016/05/09 10:16:18 ET]
Table 'Merga II' 9-max Seat #9 is the button
Seat 1: ipashutapkom ($40 in chips) 
Seat 2: Filojoes ($104.12 in chips) 
Seat 3: xhinostrabli ($43.97 in chips) 
Seat 4: nubpoker ($102 in chips) 
Seat 5: LRVAV7 ($248.41 in chips) 
Seat 6: Spid1 ($294.48 in chips) 
Seat 7: matiko09 ($151.79 in chips) 
Seat 8: GrandOldFart ($101.50 in chips) 
Seat 9: chaps1988 ($213.43 in chips) 
ipashutapkom: posts small blind $0.50
Filojoes: posts big blind $1
*** HOLE CARDS ***
Dealt to matiko09 [9d 5c]
xhinostrabli: folds 
nubpoker: raises $1.50 to $2.50
LRVAV7: folds 
Spid1: folds 
matiko09: folds 
GrandOldFart: folds 
chaps1988: calls $2.50
ipashutapkom: calls $2
Filojoes: folds 
*** FLOP *** [Ts Js Kh]
ipashutapkom: checks 
nubpoker: checks 
chaps1988: checks 
*** TURN *** [Ts Js Kh] [2s]
ipashutapkom: checks 
nubpoker: bets $5.38
chaps1988: calls $5.38
ipashutapkom: folds 
*** RIVER *** [Ts Js Kh 2s] [Ac]
nubpoker: checks 
chaps1988: bets $12
nubpoker: calls $12
*** SHOW DOWN ***
chaps1988: shows [Qs Qc] (a straight, Ten to Ace)
nubpoker: mucks hand 
chaps1988 collected $41.10 from pot
*** SUMMARY ***
Total pot $43.26 | Rake $2.16 
Board [Ts Js Kh 2s Ac]
Seat 1: ipashutapkom (small blind) folded on the Turn
Seat 2: Filojoes (big blind) folded before Flop
Seat 3: xhinostrabli folded before Flop (didn't bet)
Seat 4: nubpoker mucked [Ad Ks]
Seat 5: LRVAV7 folded before Flop (didn't bet)
Seat 6: Spid1 folded before Flop (didn't bet)
Seat 7: matiko09 folded before Flop (didn't bet)
Seat 8: GrandOldFart folded before Flop (didn't bet)
Seat 9: chaps1988 (button) showed [Qs Qc] and won ($41.10) with a straight, Ten to Ace





PokerStars Hand #153066664108:  Hold'em No Limit ($0.50/$1.00 USD) - 2016/05/09 16:16:22 CET [2016/05/09 10:16:22 ET]
Table 'Reiss' 9-max Seat #8 is the button
Seat 1: Dickyxxx ($197.40 in chips) 
Seat 3: chaps1988 ($100 in chips) 
Seat 4: MichaLabam ($140.40 in chips) 
Seat 5: matiko09 ($101.50 in chips) 
Seat 6: Spid1 ($186.93 in chips) 
Seat 7: nubpoker ($100 in chips) 
Seat 8: Filojoes ($181.18 in chips) 
Seat 9: Aghmir77 ($102.96 in chips) 
Aghmir77: posts small blind $0.50
Dickyxxx: posts big blind $1
mycka86: sits out 
*** HOLE CARDS ***
Dealt to matiko09 [Js 2s]
chaps1988: folds 
MichaLabam: raises $2 to $3
matiko09: folds 
Spid1: folds 
nubpoker: folds 
Filojoes: calls $3
Aghmir77: folds 
Dickyxxx: folds 
*** FLOP *** [Qs 5d As]
MichaLabam: bets $3.56
Filojoes: folds 
Uncalled bet ($3.56) returned to MichaLabam
MichaLabam collected $7.12 from pot
MichaLabam: doesn't show hand 
*** SUMMARY ***
Total pot $7.50 | Rake $0.38 
Board [Qs 5d As]
Seat 1: Dickyxxx (big blind) folded before Flop
Seat 3: chaps1988 folded before Flop (didn't bet)
Seat 4: MichaLabam collected ($7.12)
Seat 5: matiko09 folded before Flop (didn't bet)
Seat 6: Spid1 folded before Flop (didn't bet)
Seat 7: nubpoker folded before Flop (didn't bet)
Seat 8: Filojoes (button) folded on the Flop
Seat 9: Aghmir77 (small blind) folded before Flop





PokerStars Hand #153066666525:  Hold'em No Limit ($0.50/$1.00 USD) - 2016/05/09 16:16:26 CET [2016/05/09 10:16:26 ET]
Table 'Hajek' 9-max Seat #8 is the button
Seat 2: Spid1 ($100 in chips) 
Seat 4: LRVAV7 ($78.54 in chips) 
Seat 5: ozone2003 ($100 in chips) 
Seat 6: Filojoes ($100 in chips) 
Seat 7: DancerNN1 ($247.53 in chips) 
Seat 8: Kukuryzka ($99.30 in chips) 
Seat 9: matiko09 ($100 in chips) 
matiko09: posts small blind $0.50
Mukhin1: is sitting out 
Spid1: posts big blind $1
mycka86: sits out 
Spid1: posts the ante $0.20
LRVAV7: posts the ante $0.20
ozone2003: posts the ante $0.20
Filojoes: posts the ante $0.20
DancerNN1: posts the ante $0.20
Kukuryzka: posts the ante $0.20
matiko09: posts the ante $0.20
*** HOLE CARDS ***
Dealt to matiko09 [7h Jc]
Mukhin1 leaves the table
LRVAV7: raises $2 to $3
vkartmann joins the table at seat #1 
ozone2003: folds 
Filojoes: folds 
DancerNN1: folds 
Kukuryzka: folds 
matiko09: folds 
Spid1: calls $2
*** FLOP *** [9c 4h 5c]
Spid1: checks 
LRVAV7: bets $5
Spid1: calls $5
*** TURN *** [9c 4h 5c] [Qh]
Spid1: checks 
LRVAV7: bets $17
Spid1: folds 
Uncalled bet ($17) returned to LRVAV7
LRVAV7 collected $17 from pot
LRVAV7: doesn't show hand 
*** SUMMARY ***
Total pot $17.90 | Rake $0.90 
Board [9c 4h 5c Qh]
Seat 2: Spid1 (big blind) folded on the Turn
Seat 4: LRVAV7 collected ($17)
Seat 5: ozone2003 folded before Flop (didn't bet)
Seat 6: Filojoes folded before Flop (didn't bet)
Seat 7: DancerNN1 folded before Flop (didn't bet)
Seat 8: Kukuryzka (button) folded before Flop (didn't bet)
Seat 9: matiko09 (small blind) folded before Flop





PokerStars Hand #153066674675:  Hold'em No Limit ($0.50/$1.00 USD) - 2016/05/09 16:16:40 CET [2016/05/09 10:16:40 ET]
Table 'Orthos' 9-max Seat #6 is the button
Seat 1: Kelvin sai ($87.86 in chips) 
Seat 2: PacPacBum ($106.25 in chips) 
Seat 4: nubpoker ($118.37 in chips) 
Seat 5: matiko09 ($130.58 in chips) 
Seat 6: xhinostrabli ($116.65 in chips) 
Seat 8: Dickyxxx ($100 in chips) 
Dickyxxx: posts small blind $0.50
r4mz3s: is sitting out 
Kelvin sai: posts big blind $1
Filojoes: sits out 
*** HOLE CARDS ***
Dealt to matiko09 [8s 3c]
PacPacBum: folds 
nubpoker: folds 
Kukuryzka joins the table at seat #7 
matiko09: folds 
xhinostrabli: folds 
Dickyxxx: folds 
Uncalled bet ($0.50) returned to Kelvin sai
Kelvin sai collected $1 from pot
r4mz3s leaves the table
Kelvin sai: doesn't show hand 
*** SUMMARY ***
Total pot $1 | Rake $0 
Seat 1: Kelvin sai (big blind) collected ($1)
Seat 2: PacPacBum folded before Flop (didn't bet)
Seat 4: nubpoker folded before Flop (didn't bet)
Seat 5: matiko09 folded before Flop (didn't bet)
Seat 6: xhinostrabli (button) folded before Flop (didn't bet)
Seat 8: Dickyxxx (small blind) folded before Flop





PokerStars Hand #153066676633:  Hold'em No Limit ($1/$2 USD) - 2016/05/09 16:16:43 CET [2016/05/09 10:16:43 ET]
Table 'Hagar II' 9-max Seat #8 is the button
Seat 1: azzad2007 ($252.62 in chips) 
Seat 2: darren1031 ($166.73 in chips) 
Seat 4: matiko09 ($252.19 in chips) 
Seat 5: PacPacBum ($200 in chips) 
Seat 6: Piniker85 ($806.23 in chips) 
Seat 7: Monsthand ($216.35 in chips) 
Seat 8: J0k3rF4c3_FD ($380.60 in chips) 
Seat 9: chaps1988 ($220.18 in chips) 
chaps1988: posts small blind $1
azzad2007: posts big blind $2
*** HOLE CARDS ***
Dealt to matiko09 [9h 6s]
darren1031: folds 
matiko09: folds 
PacPacBum: folds 
Piniker85: folds 
Monsthand: folds 
J0k3rF4c3_FD: raises $3 to $5
chaps1988: folds 
azzad2007: folds 
Uncalled bet ($3) returned to J0k3rF4c3_FD
J0k3rF4c3_FD collected $5 from pot
J0k3rF4c3_FD: doesn't show hand 
*** SUMMARY ***
Total pot $5 | Rake $0 
Seat 1: azzad2007 (big blind) folded before Flop
Seat 2: darren1031 folded before Flop (didn't bet)
Seat 4: matiko09 folded before Flop (didn't bet)
Seat 5: PacPacBum folded before Flop (didn't bet)
Seat 6: Piniker85 folded before Flop (didn't bet)
Seat 7: Monsthand folded before Flop (didn't bet)
Seat 8: J0k3rF4c3_FD (button) collected ($5)
Seat 9: chaps1988 (small blind) folded before Flop





PokerStars Hand #153066679146:  Hold'em No Limit ($0.50/$1.00 USD) - 2016/05/09 16:16:48 CET [2016/05/09 10:16:48 ET]
Table 'Orthos' 9-max Seat #8 is the button
Seat 1: Kelvin sai ($88.36 in chips) 
Seat 2: PacPacBum ($106.25 in chips) 
Seat 4: nubpoker ($118.37 in chips) 
Seat 5: matiko09 ($130.58 in chips) 
Seat 6: xhinostrabli ($116.65 in chips) 
Seat 8: Dickyxxx ($100 in chips) 
Kelvin sai: posts small blind $0.50
PacPacBum: posts big blind $1
Filojoes: sits out 
Kukuryzka: sits out 
*** HOLE CARDS ***
Dealt to matiko09 [3s Ks]
vkartmann joins the table at seat #9 
nubpoker: folds 
Kukuryzka leaves the table
matiko09: folds 
xhinostrabli: folds 
Dickyxxx: raises $2 to $3
Kelvin sai: calls $2.50
PacPacBum: calls $2
*** FLOP *** [3c Td 8h]
Kelvin sai: checks 
PacPacBum: checks 
Dickyxxx: checks 
*** TURN *** [3c Td 8h] [6h]
flk.Dasas joins the table at seat #7 
Kelvin sai: bets $3
PacPacBum: folds 
Dickyxxx: calls $3
*** RIVER *** [3c Td 8h 6h] [Kh]
Kelvin sai: checks 
Dickyxxx: bets $9.49
Kelvin sai: folds 
Uncalled bet ($9.49) returned to Dickyxxx
Dickyxxx collected $14.25 from pot
Dickyxxx: doesn't show hand 
*** SUMMARY ***
Total pot $15 | Rake $0.75 
Board [3c Td 8h 6h Kh]
Seat 1: Kelvin sai (small blind) folded on the River
Seat 2: PacPacBum (big blind) folded on the Turn
Seat 4: nubpoker folded before Flop (didn't bet)
Seat 5: matiko09 folded before Flop (didn't bet)
Seat 6: xhinostrabli folded before Flop (didn't bet)
Seat 8: Dickyxxx (button) collected ($14.25)





PokerStars Hand #153066685254:  Hold'em No Limit ($0.50/$1.00 USD) - 2016/05/09 16:16:58 CET [2016/05/09 10:16:58 ET]
Table 'Alderamin' 9-max Seat #7 is the button
Seat 1: r4mz3s ($100 in chips) 
Seat 2: Filojoes ($126.51 in chips) 
Seat 3: NSL0808 ($60.76 in chips) 
Seat 4: matiko09 ($100 in chips) 
Seat 5: tanmayh ($118.73 in chips) 
Seat 6: Spid1 ($111.48 in chips) 
Seat 7: azzad2007 ($110.68 in chips) 
Seat 8: nubpoker ($100 in chips) 
Seat 9: ipashutapkom ($47.26 in chips) 
nubpoker: posts small blind $0.50
ipashutapkom: posts big blind $1
*** HOLE CARDS ***
Dealt to matiko09 [5h Qs]
r4mz3s: folds 
Filojoes: folds 
NSL0808: folds 
matiko09: folds 
tanmayh: calls $1
Spid1: raises $3 to $4
azzad2007: folds 
nubpoker: folds 
r4mz3s leaves the table
ipashutapkom: folds 
tanmayh: calls $3
*** FLOP *** [4c Qc Tc]
tanmayh: checks 
Spid1: checks 
*** TURN *** [4c Qc Tc] [5s]
tanmayh: checks 
Spid1: checks 
*** RIVER *** [4c Qc Tc 5s] [5c]
XTLMZUWR joins the table at seat #1 
tanmayh: bets $5
Spid1: folds 
Uncalled bet ($5) returned to tanmayh
tanmayh collected $9.02 from pot
tanmayh: doesn't show hand 
*** SUMMARY ***
Total pot $9.50 | Rake $0.48 
Board [4c Qc Tc 5s 5c]
Seat 1: r4mz3s folded before Flop (didn't bet)
Seat 2: Filojoes folded before Flop (didn't bet)
Seat 3: NSL0808 folded before Flop (didn't bet)
Seat 4: matiko09 folded before Flop (didn't bet)
Seat 5: tanmayh collected ($9.02)
Seat 6: Spid1 folded on the River
Seat 7: azzad2007 (button) folded before Flop (didn't bet)
Seat 8: nubpoker (small blind) folded before Flop
Seat 9: ipashutapkom (big blind) folded before Flop





PokerStars Hand #153066688322:  Hold'em No Limit ($0.50/$1.00 USD) - 2016/05/09 16:17:03 CET [2016/05/09 10:17:03 ET]
Table 'Terpsichore' 9-max Seat #4 is the button
Seat 1: ipashutapkom ($65.36 in chips) 
Seat 2: J0k3rF4c3_FD ($152.48 in chips) 
Seat 3: matiko09 ($118.37 in chips) 
Seat 4: nubpoker ($100 in chips) 
Seat 5: mycka86 ($207.01 in chips) 
Seat 7: ozone2003 ($101.50 in chips) 
Seat 8: Kiosk230472 ($178.13 in chips) 
Seat 9: FTPbannedMe ($100 in chips) 
mycka86: posts small blind $0.50
r4mz3s: is sitting out 
ozone2003: posts big blind $1
*** HOLE CARDS ***
Dealt to matiko09 [2d 7c]
r4mz3s leaves the table
vkartmann joins the table at seat #6 
Kiosk230472: folds 
FTPbannedMe: folds 
ipashutapkom: folds 
J0k3rF4c3_FD: folds 
matiko09: folds 
nubpoker: folds 
mycka86: raises $1.75 to $2.75
vkartmann leaves the table
Filojoes joins the table at seat #6 
ozone2003: folds 
Uncalled bet ($1.75) returned to mycka86
mycka86 collected $2 from pot
*** SUMMARY ***
Total pot $2 | Rake $0 
Seat 1: ipashutapkom folded before Flop (didn't bet)
Seat 2: J0k3rF4c3_FD folded before Flop (didn't bet)
Seat 3: matiko09 folded before Flop (didn't bet)
Seat 4: nubpoker (button) folded before Flop (didn't bet)
Seat 5: mycka86 (small blind) collected ($2)
Seat 7: ozone2003 (big blind) folded before Flop
Seat 8: Kiosk230472 folded before Flop (didn't bet)
Seat 9: FTPbannedMe folded before Flop (didn't bet)





PokerStars Hand #153066688295:  Hold'em No Limit ($0.50/$1.00 USD) - 2016/05/09 16:17:03 CET [2016/05/09 10:17:03 ET]
Table 'Reiss' 9-max Seat #9 is the button
Seat 1: Dickyxxx ($196.40 in chips) 
Seat 2: mycka86 ($118.15 in chips) 
Seat 3: chaps1988 ($100 in chips) 
Seat 4: MichaLabam ($144.52 in chips) 
Seat 5: matiko09 ($101.50 in chips) 
Seat 6: Spid1 ($186.93 in chips) 
Seat 7: nubpoker ($100 in chips) 
Seat 8: Filojoes ($178.18 in chips) 
Seat 9: Aghmir77 ($102.46 in chips) 
Dickyxxx: posts small blind $0.50
mycka86: posts big blind $1
*** HOLE CARDS ***
Dealt to matiko09 [5c 9c]
chaps1988: folds 
MichaLabam: folds 
matiko09: folds 
Spid1: folds 
nubpoker: folds 
Filojoes: raises $1.50 to $2.50
Aghmir77: folds 
Dickyxxx: folds 
mycka86: folds 
Uncalled bet ($1.50) returned to Filojoes
Filojoes collected $2.50 from pot
Filojoes: doesn't show hand 
*** SUMMARY ***
Total pot $2.50 | Rake $0 
Seat 1: Dickyxxx (small blind) folded before Flop
Seat 2: mycka86 (big blind) folded before Flop
Seat 3: chaps1988 folded before Flop (didn't bet)
Seat 4: MichaLabam folded before Flop (didn't bet)
Seat 5: matiko09 folded before Flop (didn't bet)
Seat 6: Spid1 folded before Flop (didn't bet)
Seat 7: nubpoker folded before Flop (didn't bet)
Seat 8: Filojoes collected ($2.50)
Seat 9: Aghmir77 (button) folded before Flop (didn't bet)





PokerStars Hand #153066689887:  Hold'em No Limit ($1/$2 USD) - 2016/05/09 16:17:06 CET [2016/05/09 10:17:06 ET]
Table 'Hagar II' 9-max Seat #9 is the button
Seat 1: azzad2007 ($250.62 in chips) 
Seat 2: darren1031 ($166.73 in chips) 
Seat 4: matiko09 ($252.19 in chips) 
Seat 5: PacPacBum ($200 in chips) 
Seat 6: Piniker85 ($806.23 in chips) 
Seat 7: Monsthand ($216.35 in chips) 
Seat 8: J0k3rF4c3_FD ($383.60 in chips) 
Seat 9: chaps1988 ($219.18 in chips) 
azzad2007: posts small blind $1
darren1031: posts big blind $2
*** HOLE CARDS ***
Dealt to matiko09 [Js Kc]
matiko09: folds 
PacPacBum: folds 
Piniker85: folds 
Monsthand: folds 
J0k3rF4c3_FD: folds 
chaps1988: folds 
azzad2007: folds 
Uncalled bet ($1) returned to darren1031
darren1031 collected $2 from pot
darren1031: doesn't show hand 
*** SUMMARY ***
Total pot $2 | Rake $0 
Seat 1: azzad2007 (small blind) folded before Flop
Seat 2: darren1031 (big blind) collected ($2)
Seat 4: matiko09 folded before Flop (didn't bet)
Seat 5: PacPacBum folded before Flop (didn't bet)
Seat 6: Piniker85 folded before Flop (didn't bet)
Seat 7: Monsthand folded before Flop (didn't bet)
Seat 8: J0k3rF4c3_FD folded before Flop (didn't bet)
Seat 9: chaps1988 (button) folded before Flop (didn't bet)





PokerStars Hand #153066698519:  Hold'em No Limit ($0.50/$1.00 USD) - 2016/05/09 16:17:21 CET [2016/05/09 10:17:21 ET]
Table 'Isberga II' 9-max Seat #2 is the button
Seat 1: Kukuryzka ($100 in chips) 
Seat 2: Filojoes ($119.55 in chips) 
Seat 3: matiko09 ($106.79 in chips) 
Seat 4: ipashutapkom ($40 in chips) 
Seat 5: nubpoker ($121.48 in chips) 
Seat 6: maxxmeister ($100 in chips) 
Seat 7: azzad2007 ($100 in chips) 
Seat 8: ozone2003 ($100 in chips) 
Seat 9: tubelight00 ($93.95 in chips) 
matiko09: posts small blind $0.50
ipashutapkom: posts big blind $1
*** HOLE CARDS ***
Dealt to matiko09 [Kh 6d]
nubpoker: folds 
maxxmeister: raises $2.50 to $3.50
azzad2007: folds 
ozone2003: folds 
tubelight00: folds 
Kukuryzka: folds 
Filojoes: folds 
matiko09: folds 
ipashutapkom: folds 
Uncalled bet ($2.50) returned to maxxmeister
maxxmeister collected $2.50 from pot
maxxmeister: doesn't show hand 
*** SUMMARY ***
Total pot $2.50 | Rake $0 
Seat 1: Kukuryzka folded before Flop (didn't bet)
Seat 2: Filojoes (button) folded before Flop (didn't bet)
Seat 3: matiko09 (small blind) folded before Flop
Seat 4: ipashutapkom (big blind) folded before Flop
Seat 5: nubpoker folded before Flop (didn't bet)
Seat 6: maxxmeister collected ($2.50)
Seat 7: azzad2007 folded before Flop (didn't bet)
Seat 8: ozone2003 folded before Flop (didn't bet)
Seat 9: tubelight00 folded before Flop (didn't bet)





PokerStars Hand #153066703441:  Hold'em No Limit ($0.50/$1.00 USD) - 2016/05/09 16:17:29 CET [2016/05/09 10:17:29 ET]
Table 'Reiss' 9-max Seat #1 is the button
Seat 1: Dickyxxx ($195.90 in chips) 
Seat 2: mycka86 ($117.15 in chips) 
Seat 3: chaps1988 ($100 in chips) 
Seat 4: MichaLabam ($144.52 in chips) 
Seat 5: matiko09 ($101.50 in chips) 
Seat 6: Spid1 ($186.93 in chips) 
Seat 7: nubpoker ($100 in chips) 
Seat 8: Filojoes ($179.68 in chips) 
Seat 9: Aghmir77 ($102.46 in chips) 
mycka86: posts small blind $0.50
chaps1988: posts big blind $1
*** HOLE CARDS ***
Dealt to matiko09 [7s 5h]
MichaLabam: raises $1.50 to $2.50
matiko09: folds 
Spid1: folds 
nubpoker: folds 
Filojoes: folds 
Aghmir77: folds 
Dickyxxx: folds 
mycka86: folds 
chaps1988: folds 
Uncalled bet ($1.50) returned to MichaLabam
MichaLabam collected $2.50 from pot
MichaLabam: doesn't show hand 
*** SUMMARY ***
Total pot $2.50 | Rake $0 
Seat 1: Dickyxxx (button) folded before Flop (didn't bet)
Seat 2: mycka86 (small blind) folded before Flop
Seat 3: chaps1988 (big blind) folded before Flop
Seat 4: MichaLabam collected ($2.50)
Seat 5: matiko09 folded before Flop (didn't bet)
Seat 6: Spid1 folded before Flop (didn't bet)
Seat 7: nubpoker folded before Flop (didn't bet)
Seat 8: Filojoes folded before Flop (didn't bet)
Seat 9: Aghmir77 folded before Flop (didn't bet)





PokerStars Hand #153066703309:  Hold'em No Limit ($1/$2 USD) - 2016/05/09 16:17:29 CET [2016/05/09 10:17:29 ET]
Table 'Hagar II' 9-max Seat #1 is the button
Seat 1: azzad2007 ($249.62 in chips) 
Seat 2: darren1031 ($167.73 in chips) 
Seat 4: matiko09 ($252.19 in chips) 
Seat 5: PacPacBum ($200 in chips) 
Seat 6: Piniker85 ($806.23 in chips) 
Seat 7: Monsthand ($216.35 in chips) 
Seat 8: J0k3rF4c3_FD ($383.60 in chips) 
Seat 9: chaps1988 ($219.18 in chips) 
darren1031: posts small blind $1
matiko09: posts big blind $2
*** HOLE CARDS ***
Dealt to matiko09 [Ks 5d]
PacPacBum: folds 
Piniker85: calls $2
Monsthand: folds 
J0k3rF4c3_FD: folds 
chaps1988: folds 
azzad2007: folds 
darren1031: folds 
matiko09: checks 
*** FLOP *** [Jh Qc 4c]
matiko09: checks 
Piniker85: bets $2
matiko09: folds 
Uncalled bet ($2) returned to Piniker85
Piniker85 collected $4.75 from pot
Piniker85: doesn't show hand 
*** SUMMARY ***
Total pot $5 | Rake $0.25 
Board [Jh Qc 4c]
Seat 1: azzad2007 (button) folded before Flop (didn't bet)
Seat 2: darren1031 (small blind) folded before Flop
Seat 4: matiko09 (big blind) folded on the Flop
Seat 5: PacPacBum folded before Flop (didn't bet)
Seat 6: Piniker85 collected ($4.75)
Seat 7: Monsthand folded before Flop (didn't bet)
Seat 8: J0k3rF4c3_FD folded before Flop (didn't bet)
Seat 9: chaps1988 folded before Flop (didn't bet)





PokerStars Hand #153066704912:  Hold'em No Limit ($0.50/$1.00 USD) - 2016/05/09 16:17:32 CET [2016/05/09 10:17:32 ET]
Table 'Hajek' 9-max Seat #9 is the button
Seat 2: Spid1 ($100 in chips) 
Seat 3: mycka86 ($102.50 in chips) 
Seat 4: LRVAV7 ($87.34 in chips) 
Seat 5: ozone2003 ($100 in chips) 
Seat 6: Filojoes ($100 in chips) 
Seat 7: DancerNN1 ($247.33 in chips) 
Seat 8: Kukuryzka ($99.10 in chips) 
Seat 9: matiko09 ($100 in chips) 
vkartmann will be allowed to play after the button
Spid1: posts small blind $0.50
mycka86: posts big blind $1
Spid1: posts the ante $0.20
mycka86: posts the ante $0.20
LRVAV7: posts the ante $0.20
ozone2003: posts the ante $0.20
Filojoes: posts the ante $0.20
DancerNN1: posts the ante $0.20
Kukuryzka: posts the ante $0.20
matiko09: posts the ante $0.20
*** HOLE CARDS ***
Dealt to matiko09 [2s Ac]
LRVAV7: folds 
ozone2003: folds 
Filojoes: folds 
DancerNN1: folds 
Kukuryzka: folds 
matiko09: raises $1.50 to $2.50
Spid1: folds 
mycka86: calls $1.50
*** FLOP *** [5c Qs Jc]
mycka86: checks 
matiko09: checks 
*** TURN *** [5c Qs Jc] [Kc]
mycka86: checks 
matiko09: bets $4.38
mycka86: raises $11.62 to $16
matiko09: folds 
Uncalled bet ($11.62) returned to mycka86
mycka86 collected $15.07 from pot
*** SUMMARY ***
Total pot $15.86 | Rake $0.79 
Board [5c Qs Jc Kc]
Seat 2: Spid1 (small blind) folded before Flop
Seat 3: mycka86 (big blind) collected ($15.07)
Seat 4: LRVAV7 folded before Flop (didn't bet)
Seat 5: ozone2003 folded before Flop (didn't bet)
Seat 6: Filojoes folded before Flop (didn't bet)
Seat 7: DancerNN1 folded before Flop (didn't bet)
Seat 8: Kukuryzka folded before Flop (didn't bet)
Seat 9: matiko09 (button) folded on the Turn





PokerStars Hand #153066706810:  Hold'em No Limit ($0.50/$1.00 USD) - 2016/05/09 16:17:35 CET [2016/05/09 10:17:35 ET]
Table 'Terpsichore' 9-max Seat #5 is the button
Seat 1: ipashutapkom ($65.36 in chips) 
Seat 2: J0k3rF4c3_FD ($152.48 in chips) 
Seat 3: matiko09 ($118.37 in chips) 
Seat 4: nubpoker ($100 in chips) 
Seat 5: mycka86 ($208.01 in chips) 
Seat 7: ozone2003 ($100.50 in chips) 
Seat 8: Kiosk230472 ($178.13 in chips) 
Seat 9: FTPbannedMe ($100 in chips) 
Filojoes will be allowed to play after the button
ozone2003: posts small blind $0.50
Kiosk230472: posts big blind $1
*** HOLE CARDS ***
Dealt to matiko09 [Ah 8h]
FTPbannedMe: folds 
ipashutapkom: folds 
J0k3rF4c3_FD: folds 
matiko09: folds 
nubpoker: folds 
mycka86: folds 
ozone2003: raises $1.95 to $2.95
Kiosk230472: calls $1.95
*** FLOP *** [Ts 4s Qc]
ozone2003: checks 
Kiosk230472: checks 
*** TURN *** [Ts 4s Qc] [Jc]
ozone2003: checks 
Kiosk230472: bets $1
ozone2003: calls $1
*** RIVER *** [Ts 4s Qc Jc] [3h]
ozone2003: checks 
Kiosk230472: checks 
*** SHOW DOWN ***
ozone2003: shows [As Jh] (a pair of Jacks)
Kiosk230472: shows [8c Qs] (a pair of Queens)
Kiosk230472 collected $7.50 from pot
*** SUMMARY ***
Total pot $7.90 | Rake $0.40 
Board [Ts 4s Qc Jc 3h]
Seat 1: ipashutapkom folded before Flop (didn't bet)
Seat 2: J0k3rF4c3_FD folded before Flop (didn't bet)
Seat 3: matiko09 folded before Flop (didn't bet)
Seat 4: nubpoker folded before Flop (didn't bet)
Seat 5: mycka86 (button) folded before Flop (didn't bet)
Seat 7: ozone2003 (small blind) showed [As Jh] and lost with a pair of Jacks
Seat 8: Kiosk230472 (big blind) showed [8c Qs] and won ($7.50) with a pair of Queens
Seat 9: FTPbannedMe folded before Flop (didn't bet)





PokerStars Hand #153066712121:  Hold'em No Limit ($0.50/$1.00 USD) - 2016/05/09 16:17:45 CET [2016/05/09 10:17:45 ET]
Table 'Isberga II' 9-max Seat #3 is the button
Seat 1: Kukuryzka ($100 in chips) 
Seat 2: Filojoes ($119.55 in chips) 
Seat 3: matiko09 ($106.29 in chips) 
Seat 4: ipashutapkom ($40 in chips) 
Seat 5: nubpoker ($121.48 in chips) 
Seat 6: maxxmeister ($101.50 in chips) 
Seat 7: azzad2007 ($100 in chips) 
Seat 8: ozone2003 ($100 in chips) 
Seat 9: tubelight00 ($93.95 in chips) 
ipashutapkom: posts small blind $0.50
nubpoker: posts big blind $1
*** HOLE CARDS ***
Dealt to matiko09 [3d Ah]
maxxmeister: folds 
maxxmeister leaves the table
azzad2007: folds 
ozone2003: raises $2 to $3
tubelight00: calls $3
Kukuryzka: folds 
Filojoes: folds 
matiko09: folds 
ipashutapkom: folds 
nubpoker: raises $9.50 to $12.50
vkartmann joins the table at seat #6 
ozone2003: calls $9.50
tubelight00: calls $9.50
*** FLOP *** [3c 7s Js]
nubpoker: checks 
ozone2003: bets $19
tubelight00: folds 
nubpoker: folds 
Uncalled bet ($19) returned to ozone2003
ozone2003 collected $36.10 from pot
ozone2003: doesn't show hand 
*** SUMMARY ***
Total pot $38 | Rake $1.90 
Board [3c 7s Js]
Seat 1: Kukuryzka folded before Flop (didn't bet)
Seat 2: Filojoes folded before Flop (didn't bet)
Seat 3: matiko09 (button) folded before Flop (didn't bet)
Seat 4: ipashutapkom (small blind) folded before Flop
Seat 5: nubpoker (big blind) folded on the Flop
Seat 6: maxxmeister folded before Flop (didn't bet)
Seat 7: azzad2007 folded before Flop (didn't bet)
Seat 8: ozone2003 collected ($36.10)
Seat 9: tubelight00 folded on the Flop





PokerStars Hand #153066719968:  Hold'em No Limit ($1/$2 USD) - 2016/05/09 16:17:58 CET [2016/05/09 10:17:58 ET]
Table 'Hagar II' 9-max Seat #2 is the button
Seat 1: azzad2007 ($249.62 in chips) 
Seat 2: darren1031 ($166.73 in chips) 
Seat 4: matiko09 ($250.19 in chips) 
Seat 5: PacPacBum ($200 in chips) 
Seat 6: Piniker85 ($808.98 in chips) 
Seat 7: Monsthand ($216.35 in chips) 
Seat 8: J0k3rF4c3_FD ($383.60 in chips) 
Seat 9: chaps1988 ($219.18 in chips) 
matiko09: posts small blind $1
PacPacBum: posts big blind $2
*** HOLE CARDS ***
Dealt to matiko09 [Jc 6s]
Piniker85: calls $2
Monsthand: folds 
J0k3rF4c3_FD: folds 
chaps1988: folds 
azzad2007: calls $2
darren1031: folds 
matiko09: folds 
PacPacBum: checks 
*** FLOP *** [2h 9h Js]
PacPacBum: checks 
Piniker85: bets $3
azzad2007: calls $3
PacPacBum: folds 
*** TURN *** [2h 9h Js] [3d]
Piniker85: checks 
azzad2007: checks 
*** RIVER *** [2h 9h Js 3d] [4c]
Piniker85: bets $6
azzad2007: folds 
Uncalled bet ($6) returned to Piniker85
Piniker85 collected $12.35 from pot
Piniker85: doesn't show hand 
*** SUMMARY ***
Total pot $13 | Rake $0.65 
Board [2h 9h Js 3d 4c]
Seat 1: azzad2007 folded on the River
Seat 2: darren1031 (button) folded before Flop (didn't bet)
Seat 4: matiko09 (small blind) folded before Flop
Seat 5: PacPacBum (big blind) folded on the Flop
Seat 6: Piniker85 collected ($12.35)
Seat 7: Monsthand folded before Flop (didn't bet)
Seat 8: J0k3rF4c3_FD folded before Flop (didn't bet)
Seat 9: chaps1988 folded before Flop (didn't bet)





PokerStars Hand #153066720942:  Hold'em No Limit ($0.50/$1.00 USD) - 2016/05/09 16:18:00 CET [2016/05/09 10:18:00 ET]
Table 'Reiss' 9-max Seat #2 is the button
Seat 1: Dickyxxx ($195.90 in chips) 
Seat 2: mycka86 ($116.65 in chips) 
Seat 3: chaps1988 ($100 in chips) 
Seat 4: MichaLabam ($146.02 in chips) 
Seat 5: matiko09 ($101.50 in chips) 
Seat 6: Spid1 ($186.93 in chips) 
Seat 7: nubpoker ($100 in chips) 
Seat 8: Filojoes ($179.68 in chips) 
Seat 9: Aghmir77 ($102.46 in chips) 
chaps1988: posts small blind $0.50
MichaLabam: posts big blind $1
*** HOLE CARDS ***
Dealt to matiko09 [9c 8c]
matiko09: raises $2 to $3
Spid1: folds 
nubpoker: folds 
Filojoes: folds 
Aghmir77: folds 
Dickyxxx: folds 
mycka86: folds 
chaps1988: folds 
MichaLabam: folds 
Uncalled bet ($2) returned to matiko09
matiko09 collected $2.50 from pot
matiko09: doesn't show hand 
*** SUMMARY ***
Total pot $2.50 | Rake $0 
Seat 1: Dickyxxx folded before Flop (didn't bet)
Seat 2: mycka86 (button) folded before Flop (didn't bet)
Seat 3: chaps1988 (small blind) folded before Flop
Seat 4: MichaLabam (big blind) folded before Flop
Seat 5: matiko09 collected ($2.50)
Seat 6: Spid1 folded before Flop (didn't bet)
Seat 7: nubpoker folded before Flop (didn't bet)
Seat 8: Filojoes folded before Flop (didn't bet)
Seat 9: Aghmir77 folded before Flop (didn't bet)





PokerStars Hand #153066726123:  Hold'em No Limit ($0.50/$1.00 USD) - 2016/05/09 16:18:09 CET [2016/05/09 10:18:09 ET]
Table 'Alderamin' 9-max Seat #8 is the button
Seat 1: XTLMZUWR ($100 in chips) 
Seat 2: Filojoes ($126.51 in chips) 
Seat 3: NSL0808 ($60.76 in chips) 
Seat 4: matiko09 ($100 in chips) 
Seat 5: tanmayh ($123.75 in chips) 
Seat 6: Spid1 ($107.48 in chips) 
Seat 7: azzad2007 ($110.68 in chips) 
Seat 8: nubpoker ($100 in chips) 
Seat 9: ipashutapkom ($46.26 in chips) 
ipashutapkom: posts small blind $0.50
XTLMZUWR: posts big blind $1
*** HOLE CARDS ***
Dealt to matiko09 [Jh Qc]
Filojoes: folds 
NSL0808: folds 
matiko09: folds 
tanmayh: calls $1
Spid1: folds 
azzad2007: folds 
nubpoker: folds 
ipashutapkom: raises $3.76 to $4.76
XTLMZUWR: folds 
tanmayh: calls $3.76
*** FLOP *** [7d Tc Ah]
ipashutapkom: bets $7.19
tanmayh: folds 
Uncalled bet ($7.19) returned to ipashutapkom
ipashutapkom collected $9.99 from pot
ipashutapkom: doesn't show hand 
*** SUMMARY ***
Total pot $10.52 | Rake $0.53 
Board [7d Tc Ah]
Seat 1: XTLMZUWR (big blind) folded before Flop
Seat 2: Filojoes folded before Flop (didn't bet)
Seat 3: NSL0808 folded before Flop (didn't bet)
Seat 4: matiko09 folded before Flop (didn't bet)
Seat 5: tanmayh folded on the Flop
Seat 6: Spid1 folded before Flop (didn't bet)
Seat 7: azzad2007 folded before Flop (didn't bet)
Seat 8: nubpoker (button) folded before Flop (didn't bet)
Seat 9: ipashutapkom (small blind) collected ($9.99)





PokerStars Hand #153066730229:  Hold'em No Limit ($0.50/$1.00 USD) - 2016/05/09 16:18:16 CET [2016/05/09 10:18:16 ET]
Table 'Merga II' 9-max Seat #1 is the button
Seat 1: ipashutapkom ($40 in chips) 
Seat 2: Filojoes ($103.12 in chips) 
Seat 3: xhinostrabli ($43.97 in chips) 
Seat 4: nubpoker ($100 in chips) 
Seat 5: LRVAV7 ($248.41 in chips) 
Seat 6: Spid1 ($294.48 in chips) 
Seat 7: matiko09 ($151.79 in chips) 
Seat 8: GrandOldFart ($101.50 in chips) 
Seat 9: chaps1988 ($234.65 in chips) 
Filojoes: posts small blind $0.50
xhinostrabli: posts big blind $1
*** HOLE CARDS ***
Dealt to matiko09 [7c 6d]
nubpoker: folds 
LRVAV7: folds 
Spid1: folds 
matiko09: folds 
GrandOldFart: folds 
chaps1988: raises $1.25 to $2.25
ipashutapkom: raises $4.50 to $6.75
Filojoes: folds 
xhinostrabli: folds 
chaps1988: folds 
Uncalled bet ($4.50) returned to ipashutapkom
ipashutapkom collected $6 from pot
ipashutapkom: doesn't show hand 
*** SUMMARY ***
Total pot $6 | Rake $0 
Seat 1: ipashutapkom (button) collected ($6)
Seat 2: Filojoes (small blind) folded before Flop
Seat 3: xhinostrabli (big blind) folded before Flop
Seat 4: nubpoker folded before Flop (didn't bet)
Seat 5: LRVAV7 folded before Flop (didn't bet)
Seat 6: Spid1 folded before Flop (didn't bet)
Seat 7: matiko09 folded before Flop (didn't bet)
Seat 8: GrandOldFart folded before Flop (didn't bet)
Seat 9: chaps1988 folded before Flop





PokerStars Hand #153066732712:  Hold'em No Limit ($0.50/$1.00 USD) - 2016/05/09 16:18:20 CET [2016/05/09 10:18:20 ET]
Table 'Reiss' 9-max Seat #3 is the button
Seat 1: Dickyxxx ($195.90 in chips) 
Seat 2: mycka86 ($116.65 in chips) 
Seat 3: chaps1988 ($100 in chips) 
Seat 4: MichaLabam ($145.02 in chips) 
Seat 5: matiko09 ($103 in chips) 
Seat 6: Spid1 ($186.93 in chips) 
Seat 7: nubpoker ($100 in chips) 
Seat 8: Filojoes ($179.68 in chips) 
Seat 9: Aghmir77 ($102.46 in chips) 
MichaLabam: posts small blind $0.50
matiko09: posts big blind $1
*** HOLE CARDS ***
Dealt to matiko09 [Td 9d]
Spid1: folds 
nubpoker: folds 
Filojoes: raises $2 to $3
Aghmir77: folds 
Dickyxxx: folds 
mycka86: folds 
chaps1988: folds 
MichaLabam: calls $2.50
matiko09: calls $2
*** FLOP *** [4d Jd 2h]
MichaLabam: checks 
matiko09: checks 
Filojoes: checks 
*** TURN *** [4d Jd 2h] [3d]
MichaLabam: bets $5
matiko09: calls $5
Filojoes: folds 
*** RIVER *** [4d Jd 2h 3d] [8s]
MichaLabam: checks 
matiko09: bets $13
MichaLabam: calls $13
*** SHOW DOWN ***
matiko09: shows [Td 9d] (a flush, Jack high)
MichaLabam: mucks hand 
matiko09 collected $42.75 from pot
*** SUMMARY ***
Total pot $45 | Rake $2.25 
Board [4d Jd 2h 3d 8s]
Seat 1: Dickyxxx folded before Flop (didn't bet)
Seat 2: mycka86 folded before Flop (didn't bet)
Seat 3: chaps1988 (button) folded before Flop (didn't bet)
Seat 4: MichaLabam (small blind) mucked [Jh Th]
Seat 5: matiko09 (big blind) showed [Td 9d] and won ($42.75) with a flush, Jack high
Seat 6: Spid1 folded before Flop (didn't bet)
Seat 7: nubpoker folded before Flop (didn't bet)
Seat 8: Filojoes folded on the Turn
Seat 9: Aghmir77 folded before Flop (didn't bet)





PokerStars Hand #153066737863:  Hold'em No Limit ($0.50/$1.00 USD) - 2016/05/09 16:18:29 CET [2016/05/09 10:18:29 ET]
Table 'Hajek' 9-max Seat #2 is the button
Seat 2: Spid1 ($100 in chips) 
Seat 3: mycka86 ($110.49 in chips) 
Seat 4: LRVAV7 ($87.14 in chips) 
Seat 5: ozone2003 ($100 in chips) 
Seat 6: Filojoes ($100 in chips) 
Seat 7: DancerNN1 ($247.13 in chips) 
Seat 8: Kukuryzka ($100 in chips) 
Seat 9: matiko09 ($100 in chips) 
mycka86: posts small blind $0.50
LRVAV7: posts big blind $1
vkartmann: sits out 
Spid1: posts the ante $0.20
mycka86: posts the ante $0.20
LRVAV7: posts the ante $0.20
ozone2003: posts the ante $0.20
Filojoes: posts the ante $0.20
DancerNN1: posts the ante $0.20
Kukuryzka: posts the ante $0.20
matiko09: posts the ante $0.20
*** HOLE CARDS ***
Dealt to matiko09 [9s Jd]
ozone2003: raises $2 to $3
Filojoes: folds 
DancerNN1: folds 
Kukuryzka: folds 
matiko09: folds 
Spid1: folds 
mycka86: folds 
LRVAV7: calls $2
*** FLOP *** [4s 3d 6s]
LRVAV7: checks 
ozone2003: bets $6
LRVAV7: calls $6
*** TURN *** [4s 3d 6s] [3h]
LRVAV7: checks 
ozone2003: bets $16.03
LRVAV7: raises $16.03 to $32.06
ozone2003: folds 
Uncalled bet ($16.03) returned to LRVAV7
LRVAV7 collected $49.66 from pot
LRVAV7: doesn't show hand 
*** SUMMARY ***
Total pot $52.16 | Rake $2.50 
Board [4s 3d 6s 3h]
Seat 2: Spid1 (button) folded before Flop (didn't bet)
Seat 3: mycka86 (small blind) folded before Flop
Seat 4: LRVAV7 (big blind) collected ($49.66)
Seat 5: ozone2003 folded on the Turn
Seat 6: Filojoes folded before Flop (didn't bet)
Seat 7: DancerNN1 folded before Flop (didn't bet)
Seat 8: Kukuryzka folded before Flop (didn't bet)
Seat 9: matiko09 folded before Flop (didn't bet)





PokerStars Hand #153066749125:  Hold'em No Limit ($0.50/$1.00 USD) - 2016/05/09 16:18:48 CET [2016/05/09 10:18:48 ET]
Table 'Alderamin' 9-max Seat #9 is the button
Seat 2: Filojoes ($126.51 in chips) 
Seat 3: NSL0808 ($60.76 in chips) 
Seat 4: matiko09 ($100 in chips) 
Seat 5: tanmayh ($118.99 in chips) 
Seat 6: Spid1 ($107.48 in chips) 
Seat 7: azzad2007 ($110.68 in chips) 
Seat 8: nubpoker ($100 in chips) 
Seat 9: ipashutapkom ($51.49 in chips) 
XTLMZUWR has timed out
XTLMZUWR: is sitting out 
Filojoes: posts small blind $0.50
NSL0808: posts big blind $1
*** HOLE CARDS ***
Dealt to matiko09 [5s Jc]
matiko09: folds 
tanmayh: calls $1
Spid1: folds 
azzad2007: folds 
nubpoker: folds 
ipashutapkom: folds 
Filojoes: folds 
NSL0808: raises $3 to $4
tanmayh: calls $3
*** FLOP *** [2s Td 8h]
NSL0808: checks 
tanmayh: checks 
*** TURN *** [2s Td 8h] [4h]
NSL0808: bets $4.04
tanmayh: calls $4.04
*** RIVER *** [2s Td 8h 4h] [Ac]
NSL0808: bets $7.87
tanmayh: folds 
Uncalled bet ($7.87) returned to NSL0808
NSL0808 collected $15.75 from pot
*** SUMMARY ***
Total pot $16.58 | Rake $0.83 
Board [2s Td 8h 4h Ac]
Seat 2: Filojoes (small blind) folded before Flop
Seat 3: NSL0808 (big blind) collected ($15.75)
Seat 4: matiko09 folded before Flop (didn't bet)
Seat 5: tanmayh folded on the River
Seat 6: Spid1 folded before Flop (didn't bet)
Seat 7: azzad2007 folded before Flop (didn't bet)
Seat 8: nubpoker folded before Flop (didn't bet)
Seat 9: ipashutapkom (button) folded before Flop (didn't bet)





PokerStars Hand #153066750470:  Hold'em No Limit ($0.50/$1.00 USD) - 2016/05/09 16:18:51 CET [2016/05/09 10:18:51 ET]
Table 'Orthos' 9-max Seat #1 is the button
Seat 1: Kelvin sai ($82.36 in chips) 
Seat 2: PacPacBum ($103.25 in chips) 
Seat 3: Filojoes ($112.23 in chips) 
Seat 4: nubpoker ($118.37 in chips) 
Seat 5: matiko09 ($130.58 in chips) 
Seat 6: xhinostrabli ($116.65 in chips) 
Seat 8: Dickyxxx ($108.25 in chips) 
PacPacBum: posts small blind $0.50
Filojoes: posts big blind $1
flk.Dasas: sits out 
vkartmann: sits out 
*** HOLE CARDS ***
Dealt to matiko09 [Ah Jc]
nubpoker: folds 
matiko09: raises $2 to $3
xhinostrabli: folds 
Dickyxxx: calls $3
Kelvin sai: folds 
PacPacBum: folds 
Filojoes: calls $2
*** FLOP *** [8h 4c Th]
Filojoes: checks 
matiko09: bets $6
Dickyxxx: calls $6
Filojoes: folds 
*** TURN *** [8h 4c Th] [5h]
matiko09: bets $13
Dickyxxx: calls $13
*** RIVER *** [8h 4c Th 5h] [8d]
matiko09: checks 
Dickyxxx: bets $22.56
matiko09: folds 
Uncalled bet ($22.56) returned to Dickyxxx
Dickyxxx collected $45.12 from pot
Dickyxxx: doesn't show hand 
*** SUMMARY ***
Total pot $47.50 | Rake $2.38 
Board [8h 4c Th 5h 8d]
Seat 1: Kelvin sai (button) folded before Flop (didn't bet)
Seat 2: PacPacBum (small blind) folded before Flop
Seat 3: Filojoes (big blind) folded on the Flop
Seat 4: nubpoker folded before Flop (didn't bet)
Seat 5: matiko09 folded on the River
Seat 6: xhinostrabli folded before Flop (didn't bet)
Seat 8: Dickyxxx collected ($45.12)





PokerStars Hand #153066751798:  Hold'em No Limit ($0.50/$1.00 USD) - 2016/05/09 16:18:53 CET [2016/05/09 10:18:53 ET]
Table 'Terpsichore' 9-max Seat #7 is the button
Seat 1: ipashutapkom ($65.36 in chips) 
Seat 2: J0k3rF4c3_FD ($152.48 in chips) 
Seat 3: matiko09 ($118.37 in chips) 
Seat 4: nubpoker ($100 in chips) 
Seat 5: mycka86 ($208.01 in chips) 
Seat 7: ozone2003 ($100 in chips) 
Seat 8: Kiosk230472 ($181.68 in chips) 
Seat 9: FTPbannedMe ($100 in chips) 
Kiosk230472: posts small blind $0.50
FTPbannedMe: posts big blind $1
Filojoes: sits out 
*** HOLE CARDS ***
Dealt to matiko09 [7s 5h]
ipashutapkom: folds 
J0k3rF4c3_FD: raises $1.50 to $2.50
matiko09: folds 
nubpoker: folds 
mycka86: folds 
ozone2003: folds 
Kiosk230472: folds 
FTPbannedMe: calls $1.50
*** FLOP *** [Qh 9d 5d]
FTPbannedMe: checks 
J0k3rF4c3_FD: bets $3.11
FTPbannedMe: raises $8.58 to $11.69
J0k3rF4c3_FD: folds 
Uncalled bet ($8.58) returned to FTPbannedMe
FTPbannedMe collected $11.13 from pot
FTPbannedMe: doesn't show hand 
*** SUMMARY ***
Total pot $11.72 | Rake $0.59 
Board [Qh 9d 5d]
Seat 1: ipashutapkom folded before Flop (didn't bet)
Seat 2: J0k3rF4c3_FD folded on the Flop
Seat 3: matiko09 folded before Flop (didn't bet)
Seat 4: nubpoker folded before Flop (didn't bet)
Seat 5: mycka86 folded before Flop (didn't bet)
Seat 7: ozone2003 (button) folded before Flop (didn't bet)
Seat 8: Kiosk230472 (small blind) folded before Flop
Seat 9: FTPbannedMe (big blind) collected ($11.13)





PokerStars Hand #153066757432:  Hold'em No Limit ($0.50/$1.00 USD) - 2016/05/09 16:19:02 CET [2016/05/09 10:19:02 ET]
Table 'Merga II' 9-max Seat #2 is the button
Seat 1: ipashutapkom ($43.75 in chips) 
Seat 2: Filojoes ($102.62 in chips) 
Seat 3: xhinostrabli ($42.97 in chips) 
Seat 4: nubpoker ($100 in chips) 
Seat 5: LRVAV7 ($248.41 in chips) 
Seat 6: Spid1 ($294.48 in chips) 
Seat 7: matiko09 ($151.79 in chips) 
Seat 8: GrandOldFart ($101.50 in chips) 
Seat 9: chaps1988 ($232.40 in chips) 
xhinostrabli: posts small blind $0.50
nubpoker: posts big blind $1
*** HOLE CARDS ***
Dealt to matiko09 [Qh Jc]
LRVAV7: raises $1 to $2
Spid1: calls $2
matiko09: folds 
GrandOldFart: calls $2
chaps1988: raises $11 to $13
ipashutapkom: folds 
Filojoes: folds 
xhinostrabli: folds 
nubpoker: folds 
LRVAV7: folds 
Spid1: folds 
GrandOldFart: folds 
Uncalled bet ($11) returned to chaps1988
chaps1988 collected $9.50 from pot
chaps1988: doesn't show hand 
*** SUMMARY ***
Total pot $9.50 | Rake $0 
Seat 1: ipashutapkom folded before Flop (didn't bet)
Seat 2: Filojoes (button) folded before Flop (didn't bet)
Seat 3: xhinostrabli (small blind) folded before Flop
Seat 4: nubpoker (big blind) folded before Flop
Seat 5: LRVAV7 folded before Flop
Seat 6: Spid1 folded before Flop
Seat 7: matiko09 folded before Flop (didn't bet)
Seat 8: GrandOldFart folded before Flop
Seat 9: chaps1988 collected ($9.50)





PokerStars Hand #153066767000:  Hold'em No Limit ($0.50/$1.00 USD) - 2016/05/09 16:19:19 CET [2016/05/09 10:19:19 ET]
Table 'Isberga II' 9-max Seat #4 is the button
Seat 1: Kukuryzka ($100 in chips) 
Seat 2: Filojoes ($119.55 in chips) 
Seat 3: matiko09 ($106.29 in chips) 
Seat 4: ipashutapkom ($40 in chips) 
Seat 5: nubpoker ($108.98 in chips) 
Seat 6: vkartmann ($100 in chips) 
Seat 7: azzad2007 ($100 in chips) 
Seat 8: ozone2003 ($123.60 in chips) 
Seat 9: tubelight00 ($81.45 in chips) 
nubpoker: posts small blind $0.50
vkartmann: posts big blind $1
*** HOLE CARDS ***
Dealt to matiko09 [2c 7d]
azzad2007: folds 
ozone2003: folds 
tubelight00: raises $2 to $3
Kukuryzka: folds 
Filojoes: folds 
matiko09: folds 
ipashutapkom: folds 
nubpoker: folds 
vkartmann: folds 
Uncalled bet ($2) returned to tubelight00
tubelight00 collected $2.50 from pot
tubelight00: doesn't show hand 
*** SUMMARY ***
Total pot $2.50 | Rake $0 
Seat 1: Kukuryzka folded before Flop (didn't bet)
Seat 2: Filojoes folded before Flop (didn't bet)
Seat 3: matiko09 folded before Flop (didn't bet)
Seat 4: ipashutapkom (button) folded before Flop (didn't bet)
Seat 5: nubpoker (small blind) folded before Flop
Seat 6: vkartmann (big blind) folded before Flop
Seat 7: azzad2007 folded before Flop (didn't bet)
Seat 8: ozone2003 folded before Flop (didn't bet)
Seat 9: tubelight00 collected ($2.50)





PokerStars Hand #153066767257:  Hold'em No Limit ($1/$2 USD) - 2016/05/09 16:19:19 CET [2016/05/09 10:19:19 ET]
Table 'Hagar II' 9-max Seat #4 is the button
Seat 1: azzad2007 ($244.62 in chips) 
Seat 2: darren1031 ($166.73 in chips) 
Seat 4: matiko09 ($249.19 in chips) 
Seat 5: PacPacBum ($200 in chips) 
Seat 6: Piniker85 ($816.33 in chips) 
Seat 7: Monsthand ($216.35 in chips) 
Seat 8: J0k3rF4c3_FD ($383.60 in chips) 
Seat 9: chaps1988 ($219.18 in chips) 
PacPacBum: posts small blind $1
Piniker85: posts big blind $2
*** HOLE CARDS ***
Dealt to matiko09 [2c 9c]
Monsthand: folds 
J0k3rF4c3_FD: folds 
chaps1988: folds 
azzad2007: raises $4 to $6
darren1031: calls $6
matiko09: folds 
PacPacBum: folds 
Piniker85: folds 
*** FLOP *** [Qd 7c 8s]
Piniker85 leaves the table
azzad2007: checks 
darren1031: bets $7.12
azzad2007: calls $7.12
*** TURN *** [Qd 7c 8s] [6c]
azzad2007: checks 
darren1031: bets $13.89
azzad2007: calls $13.89
*** RIVER *** [Qd 7c 8s 6c] [6h]
azzad2007: checks 
darren1031: checks 
*** SHOW DOWN ***
azzad2007: shows [Jd Qh] (two pair, Queens and Sixes)
darren1031: shows [Ks Qc] (two pair, Queens and Sixes - King kicker)
darren1031 collected $54.27 from pot
*** SUMMARY ***
Total pot $57.02 | Rake $2.75 
Board [Qd 7c 8s 6c 6h]
Seat 1: azzad2007 showed [Jd Qh] and lost with two pair, Queens and Sixes
Seat 2: darren1031 showed [Ks Qc] and won ($54.27) with two pair, Queens and Sixes
Seat 4: matiko09 (button) folded before Flop (didn't bet)
Seat 5: PacPacBum (small blind) folded before Flop
Seat 6: Piniker85 (big blind) folded before Flop
Seat 7: Monsthand folded before Flop (didn't bet)
Seat 8: J0k3rF4c3_FD folded before Flop (didn't bet)
Seat 9: chaps1988 folded before Flop (didn't bet)





PokerStars Hand #153066769597:  Hold'em No Limit ($0.50/$1.00 USD) - 2016/05/09 16:19:23 CET [2016/05/09 10:19:23 ET]
Table 'Reiss' 9-max Seat #4 is the button
Seat 1: Dickyxxx ($195.90 in chips) 
Seat 2: mycka86 ($116.65 in chips) 
Seat 3: chaps1988 ($100 in chips) 
Seat 4: MichaLabam ($124.02 in chips) 
Seat 5: matiko09 ($124.75 in chips) 
Seat 6: Spid1 ($186.93 in chips) 
Seat 7: nubpoker ($100 in chips) 
Seat 8: Filojoes ($176.68 in chips) 
Seat 9: Aghmir77 ($102.46 in chips) 
matiko09: posts small blind $0.50
Spid1: posts big blind $1
*** HOLE CARDS ***
Dealt to matiko09 [Jc 2c]
nubpoker: folds 
Filojoes: folds 
Aghmir77: folds 
Dickyxxx: folds 
mycka86: folds 
chaps1988: folds 
MichaLabam: folds 
matiko09: folds 
Uncalled bet ($0.50) returned to Spid1
Spid1 collected $1 from pot
Spid1: doesn't show hand 
*** SUMMARY ***
Total pot $1 | Rake $0 
Seat 1: Dickyxxx folded before Flop (didn't bet)
Seat 2: mycka86 folded before Flop (didn't bet)
Seat 3: chaps1988 folded before Flop (didn't bet)
Seat 4: MichaLabam (button) folded before Flop (didn't bet)
Seat 5: matiko09 (small blind) folded before Flop
Seat 6: Spid1 (big blind) collected ($1)
Seat 7: nubpoker folded before Flop (didn't bet)
Seat 8: Filojoes folded before Flop (didn't bet)
Seat 9: Aghmir77 folded before Flop (didn't bet)





PokerStars Hand #153066783012:  Hold'em No Limit ($0.50/$1.00 USD) - 2016/05/09 16:19:46 CET [2016/05/09 10:19:46 ET]
Table 'Reiss' 9-max Seat #5 is the button
Seat 1: Dickyxxx ($195.90 in chips) 
Seat 2: mycka86 ($116.65 in chips) 
Seat 3: chaps1988 ($100 in chips) 
Seat 4: MichaLabam ($124.02 in chips) 
Seat 5: matiko09 ($124.25 in chips) 
Seat 6: Spid1 ($187.43 in chips) 
Seat 7: nubpoker ($100 in chips) 
Seat 8: Filojoes ($176.68 in chips) 
Seat 9: Aghmir77 ($102.46 in chips) 
Spid1: posts small blind $0.50
nubpoker: posts big blind $1
*** HOLE CARDS ***
Dealt to matiko09 [6c 6d]
Filojoes: raises $2 to $3
Aghmir77: folds 
Dickyxxx: folds 
mycka86: folds 
chaps1988: calls $3
MichaLabam: calls $3
matiko09: calls $3
Spid1: folds 
nubpoker: calls $2
*** FLOP *** [Kd Jc Ac]
nubpoker: checks 
Filojoes: checks 
chaps1988: checks 
MichaLabam: checks 
matiko09: checks 
*** TURN *** [Kd Jc Ac] [4h]
nubpoker: checks 
Filojoes: checks 
chaps1988: checks 
MichaLabam: bets $11
matiko09: folds 
nubpoker: folds 
Filojoes: folds 
chaps1988: folds 
Uncalled bet ($11) returned to MichaLabam
MichaLabam collected $14.72 from pot
MichaLabam: doesn't show hand 
*** SUMMARY ***
Total pot $15.50 | Rake $0.78 
Board [Kd Jc Ac 4h]
Seat 1: Dickyxxx folded before Flop (didn't bet)
Seat 2: mycka86 folded before Flop (didn't bet)
Seat 3: chaps1988 folded on the Turn
Seat 4: MichaLabam collected ($14.72)
Seat 5: matiko09 (button) folded on the Turn
Seat 6: Spid1 (small blind) folded before Flop
Seat 7: nubpoker (big blind) folded on the Turn
Seat 8: Filojoes folded on the Turn
Seat 9: Aghmir77 folded before Flop (didn't bet)





PokerStars Hand #153066783749:  Hold'em No Limit ($0.50/$1.00 USD) - 2016/05/09 16:19:48 CET [2016/05/09 10:19:48 ET]
Table 'Isberga II' 9-max Seat #5 is the button
Seat 1: Kukuryzka ($100 in chips) 
Seat 2: Filojoes ($119.55 in chips) 
Seat 3: matiko09 ($106.29 in chips) 
Seat 4: ipashutapkom ($40 in chips) 
Seat 5: nubpoker ($108.48 in chips) 
Seat 6: vkartmann ($100 in chips) 
Seat 8: ozone2003 ($123.60 in chips) 
Seat 9: tubelight00 ($82.95 in chips) 
vkartmann: posts small blind $0.50
azzad2007: is sitting out 
ozone2003: posts big blind $1
*** HOLE CARDS ***
Dealt to matiko09 [7d Ah]
azzad2007 leaves the table
tubelight00: raises $2 to $3
flk.Dasas joins the table at seat #7 
Kukuryzka: folds 
Filojoes: folds 
matiko09: folds 
ipashutapkom: folds 
nubpoker: folds 
vkartmann: folds 
ozone2003: folds 
Uncalled bet ($2) returned to tubelight00
tubelight00 collected $2.50 from pot
tubelight00: doesn't show hand 
*** SUMMARY ***
Total pot $2.50 | Rake $0 
Seat 1: Kukuryzka folded before Flop (didn't bet)
Seat 2: Filojoes folded before Flop (didn't bet)
Seat 3: matiko09 folded before Flop (didn't bet)
Seat 4: ipashutapkom folded before Flop (didn't bet)
Seat 5: nubpoker (button) folded before Flop (didn't bet)
Seat 6: vkartmann (small blind) folded before Flop
Seat 8: ozone2003 (big blind) folded before Flop
Seat 9: tubelight00 collected ($2.50)





PokerStars Hand #153066788491:  Hold'em No Limit ($0.50/$1.00 USD) - 2016/05/09 16:19:56 CET [2016/05/09 10:19:56 ET]
Table 'Merga II' 9-max Seat #3 is the button
Seat 1: ipashutapkom ($43.75 in chips) 
Seat 2: Filojoes ($102.62 in chips) 
Seat 3: xhinostrabli ($42.47 in chips) 
Seat 4: nubpoker ($100 in chips) 
Seat 5: LRVAV7 ($246.41 in chips) 
Seat 6: Spid1 ($292.48 in chips) 
Seat 7: matiko09 ($151.79 in chips) 
Seat 8: GrandOldFart ($99.50 in chips) 
Seat 9: chaps1988 ($239.90 in chips) 
nubpoker: posts small blind $0.50
LRVAV7: posts big blind $1
*** HOLE CARDS ***
Dealt to matiko09 [7c 4d]
Spid1: raises $2 to $3
matiko09: folds 
GrandOldFart: folds 
chaps1988: folds 
ipashutapkom: folds 
Filojoes: folds 
xhinostrabli: folds 
nubpoker: folds 
LRVAV7: folds 
Uncalled bet ($2) returned to Spid1
Spid1 collected $2.50 from pot
Spid1: doesn't show hand 
*** SUMMARY ***
Total pot $2.50 | Rake $0 
Seat 1: ipashutapkom folded before Flop (didn't bet)
Seat 2: Filojoes folded before Flop (didn't bet)
Seat 3: xhinostrabli (button) folded before Flop (didn't bet)
Seat 4: nubpoker (small blind) folded before Flop
Seat 5: LRVAV7 (big blind) folded before Flop
Seat 6: Spid1 collected ($2.50)
Seat 7: matiko09 folded before Flop (didn't bet)
Seat 8: GrandOldFart folded before Flop (didn't bet)
Seat 9: chaps1988 folded before Flop (didn't bet)





PokerStars Hand #153066799908:  Hold'em No Limit ($0.50/$1.00 USD) - 2016/05/09 16:20:16 CET [2016/05/09 10:20:16 ET]
Table 'Alderamin' 9-max Seat #2 is the button
Seat 2: Filojoes ($126.01 in chips) 
Seat 3: NSL0808 ($68.47 in chips) 
Seat 4: matiko09 ($100 in chips) 
Seat 5: tanmayh ($110.95 in chips) 
Seat 6: Spid1 ($107.48 in chips) 
Seat 7: azzad2007 ($110.68 in chips) 
Seat 8: nubpoker ($100 in chips) 
Seat 9: ipashutapkom ($51.49 in chips) 
NSL0808: posts small blind $0.50
matiko09: posts big blind $1
XTLMZUWR: sits out 
*** HOLE CARDS ***
Dealt to matiko09 [Js Jc]
tanmayh: raises $2.50 to $3.50
Spid1: folds 
azzad2007: folds 
nubpoker: calls $3.50
ipashutapkom: folds 
Filojoes: folds 
NSL0808: calls $3
matiko09: raises $10.50 to $14
tanmayh: folds 
nubpoker: folds 
NSL0808: folds 
Uncalled bet ($10.50) returned to matiko09
matiko09 collected $14 from pot
matiko09: doesn't show hand 
*** SUMMARY ***
Total pot $14 | Rake $0 
Seat 2: Filojoes (button) folded before Flop (didn't bet)
Seat 3: NSL0808 (small blind) folded before Flop
Seat 4: matiko09 (big blind) collected ($14)
Seat 5: tanmayh folded before Flop
Seat 6: Spid1 folded before Flop (didn't bet)
Seat 7: azzad2007 folded before Flop (didn't bet)
Seat 8: nubpoker folded before Flop
Seat 9: ipashutapkom folded before Flop (didn't bet)





PokerStars Hand #153066801759:  Hold'em No Limit ($0.50/$1.00 USD) - 2016/05/09 16:20:19 CET [2016/05/09 10:20:19 ET]
Table 'Terpsichore' 9-max Seat #8 is the button
Seat 1: ipashutapkom ($65.36 in chips) 
Seat 2: J0k3rF4c3_FD ($146.87 in chips) 
Seat 3: matiko09 ($118.37 in chips) 
Seat 4: nubpoker ($100 in chips) 
Seat 5: mycka86 ($208.01 in chips) 
Seat 7: ozone2003 ($100 in chips) 
Seat 8: Kiosk230472 ($181.18 in chips) 
Seat 9: FTPbannedMe ($105.52 in chips) 
FTPbannedMe: posts small blind $0.50
ipashutapkom: posts big blind $1
Filojoes: sits out 
*** HOLE CARDS ***
Dealt to matiko09 [5c Jd]
J0k3rF4c3_FD: folds 
matiko09: folds 
nubpoker: folds 
mycka86: folds 
ozone2003: raises $1.50 to $2.50
Kiosk230472: calls $2.50
FTPbannedMe: raises $8.50 to $11
ipashutapkom: folds 
ozone2003: calls $8.50
Kiosk230472: folds 
*** FLOP *** [Ad 8c 9c]
FTPbannedMe: checks 
ozone2003: bets $14
FTPbannedMe: calls $14
*** TURN *** [Ad 8c 9c] [Jh]
FTPbannedMe: checks 
ozone2003: bets $26
FTPbannedMe: calls $26
*** RIVER *** [Ad 8c 9c Jh] [8d]
FTPbannedMe: checks 
ozone2003: checks 
*** SHOW DOWN ***
FTPbannedMe: shows [Qc Qs] (two pair, Queens and Eights)
ozone2003: mucks hand 
FTPbannedMe collected $103 from pot
*** SUMMARY ***
Total pot $105.50 | Rake $2.50 
Board [Ad 8c 9c Jh 8d]
Seat 1: ipashutapkom (big blind) folded before Flop
Seat 2: J0k3rF4c3_FD folded before Flop (didn't bet)
Seat 3: matiko09 folded before Flop (didn't bet)
Seat 4: nubpoker folded before Flop (didn't bet)
Seat 5: mycka86 folded before Flop (didn't bet)
Seat 7: ozone2003 mucked [6d 7d]
Seat 8: Kiosk230472 (button) folded before Flop
Seat 9: FTPbannedMe (small blind) showed [Qc Qs] and won ($103) with two pair, Queens and Eights





PokerStars Hand #153066804124:  Hold'em No Limit ($0.50/$1.00 USD) - 2016/05/09 16:20:23 CET [2016/05/09 10:20:23 ET]
Table 'Merga II' 9-max Seat #4 is the button
Seat 1: ipashutapkom ($43.75 in chips) 
Seat 2: Filojoes ($102.62 in chips) 
Seat 3: xhinostrabli ($42.47 in chips) 
Seat 4: nubpoker ($100 in chips) 
Seat 5: LRVAV7 ($245.41 in chips) 
Seat 6: Spid1 ($293.98 in chips) 
Seat 7: matiko09 ($151.79 in chips) 
Seat 8: GrandOldFart ($99.50 in chips) 
Seat 9: chaps1988 ($239.90 in chips) 
LRVAV7: posts small blind $0.50
Spid1: posts big blind $1
*** HOLE CARDS ***
Dealt to matiko09 [7d 7c]
matiko09: raises $2 to $3
GrandOldFart: folds 
chaps1988: folds 
ipashutapkom: folds 
Filojoes: folds 
xhinostrabli: folds 
nubpoker: folds 
LRVAV7: calls $2.50
Spid1: folds 
*** FLOP *** [Kh 8c 6d]
LRVAV7: checks 
matiko09: checks 
*** TURN *** [Kh 8c 6d] [Td]
LRVAV7: checks 
matiko09: checks 
*** RIVER *** [Kh 8c 6d Td] [5h]
LRVAV7: checks 
matiko09: checks 
*** SHOW DOWN ***
LRVAV7: shows [Th Qh] (a pair of Tens)
matiko09: mucks hand 
LRVAV7 collected $6.65 from pot
*** SUMMARY ***
Total pot $7 | Rake $0.35 
Board [Kh 8c 6d Td 5h]
Seat 1: ipashutapkom folded before Flop (didn't bet)
Seat 2: Filojoes folded before Flop (didn't bet)
Seat 3: xhinostrabli folded before Flop (didn't bet)
Seat 4: nubpoker (button) folded before Flop (didn't bet)
Seat 5: LRVAV7 (small blind) showed [Th Qh] and won ($6.65) with a pair of Tens
Seat 6: Spid1 (big blind) folded before Flop
Seat 7: matiko09 mucked [7d 7c]
Seat 8: GrandOldFart folded before Flop (didn't bet)
Seat 9: chaps1988 folded before Flop (didn't bet)





PokerStars Hand #153066807076:  Hold'em No Limit ($0.50/$1.00 USD) - 2016/05/09 16:20:28 CET [2016/05/09 10:20:28 ET]
Table 'Hajek' 9-max Seat #3 is the button
Seat 2: Spid1 ($100 in chips) 
Seat 3: mycka86 ($109.79 in chips) 
Seat 4: LRVAV7 ($111.57 in chips) 
Seat 5: ozone2003 ($100 in chips) 
Seat 6: Filojoes ($100 in chips) 
Seat 7: DancerNN1 ($246.93 in chips) 
Seat 8: Kukuryzka ($99.80 in chips) 
Seat 9: matiko09 ($100 in chips) 
LRVAV7: posts small blind $0.50
ozone2003: posts big blind $1
vkartmann: sits out 
Spid1: posts the ante $0.20
mycka86: posts the ante $0.20
LRVAV7: posts the ante $0.20
ozone2003: posts the ante $0.20
Filojoes: posts the ante $0.20
DancerNN1: posts the ante $0.20
Kukuryzka: posts the ante $0.20
matiko09: posts the ante $0.20
*** HOLE CARDS ***
Dealt to matiko09 [Qc Ad]
Filojoes: folds 
DancerNN1: folds 
Kukuryzka: folds 
matiko09: raises $2 to $3
Spid1: folds 
mycka86: calls $3
LRVAV7: folds 
ozone2003: calls $2
*** FLOP *** [8c 7s 9d]
ozone2003: checks 
matiko09: checks 
mycka86: bets $7.50
ozone2003: folds 
matiko09: folds 
Uncalled bet ($7.50) returned to mycka86
mycka86 collected $10.54 from pot
*** SUMMARY ***
Total pot $11.10 | Rake $0.56 
Board [8c 7s 9d]
Seat 2: Spid1 folded before Flop (didn't bet)
Seat 3: mycka86 (button) collected ($10.54)
Seat 4: LRVAV7 (small blind) folded before Flop
Seat 5: ozone2003 (big blind) folded on the Flop
Seat 6: Filojoes folded before Flop (didn't bet)
Seat 7: DancerNN1 folded before Flop (didn't bet)
Seat 8: Kukuryzka folded before Flop (didn't bet)
Seat 9: matiko09 folded on the Flop





PokerStars Hand #153066807806:  Hold'em No Limit ($0.50/$1.00 USD) - 2016/05/09 16:20:29 CET [2016/05/09 10:20:29 ET]
Table 'Isberga II' 9-max Seat #6 is the button
Seat 1: Kukuryzka ($100 in chips) 
Seat 2: Filojoes ($119.55 in chips) 
Seat 3: matiko09 ($106.29 in chips) 
Seat 4: ipashutapkom ($40 in chips) 
Seat 5: nubpoker ($108.48 in chips) 
Seat 6: vkartmann ($100 in chips) 
Seat 8: ozone2003 ($122.60 in chips) 
Seat 9: tubelight00 ($84.45 in chips) 
flk.Dasas will be allowed to play after the button
ozone2003: posts small blind $0.50
tubelight00: posts big blind $1
*** HOLE CARDS ***
Dealt to matiko09 [Js 9h]
Kukuryzka: folds 
Filojoes: folds 
matiko09: folds 
ipashutapkom: folds 
nubpoker: folds 
vkartmann: raises $2 to $3
ozone2003: folds 
tubelight00: folds 
Uncalled bet ($2) returned to vkartmann
vkartmann collected $2.50 from pot
vkartmann: doesn't show hand 
*** SUMMARY ***
Total pot $2.50 | Rake $0 
Seat 1: Kukuryzka folded before Flop (didn't bet)
Seat 2: Filojoes folded before Flop (didn't bet)
Seat 3: matiko09 folded before Flop (didn't bet)
Seat 4: ipashutapkom folded before Flop (didn't bet)
Seat 5: nubpoker folded before Flop (didn't bet)
Seat 6: vkartmann (button) collected ($2.50)
Seat 8: ozone2003 (small blind) folded before Flop
Seat 9: tubelight00 (big blind) folded before Flop





PokerStars Hand #153066812845:  Hold'em No Limit ($1/$2 USD) - 2016/05/09 16:20:38 CET [2016/05/09 10:20:38 ET]
Table 'Hagar II' 9-max Seat #5 is the button
Seat 1: azzad2007 ($217.61 in chips) 
Seat 2: darren1031 ($193.99 in chips) 
Seat 4: matiko09 ($249.19 in chips) 
Seat 5: PacPacBum ($200 in chips) 
Seat 7: Monsthand ($216.35 in chips) 
Seat 8: J0k3rF4c3_FD ($383.60 in chips) 
Seat 9: chaps1988 ($219.18 in chips) 
Monsthand: posts small blind $1
J0k3rF4c3_FD: posts big blind $2
*** HOLE CARDS ***
Dealt to matiko09 [5d 9h]
chaps1988: raises $3 to $5
azzad2007: calls $5
darren1031: calls $5
matiko09: folds 
PacPacBum: folds 
Iggso joins the table at seat #6 
Monsthand: folds 
J0k3rF4c3_FD: folds 
*** FLOP *** [Kd Tc Ad]
chaps1988: checks 
azzad2007: checks 
darren1031: bets $8.55
chaps1988: folds 
azzad2007: folds 
Uncalled bet ($8.55) returned to darren1031
darren1031 collected $17.10 from pot
darren1031: doesn't show hand 
*** SUMMARY ***
Total pot $18 | Rake $0.90 
Board [Kd Tc Ad]
Seat 1: azzad2007 folded on the Flop
Seat 2: darren1031 collected ($17.10)
Seat 4: matiko09 folded before Flop (didn't bet)
Seat 5: PacPacBum (button) folded before Flop (didn't bet)
Seat 7: Monsthand (small blind) folded before Flop
Seat 8: J0k3rF4c3_FD (big blind) folded before Flop
Seat 9: chaps1988 folded on the Flop





PokerStars Hand #153066821708:  Hold'em No Limit ($0.50/$1.00 USD) - 2016/05/09 16:20:53 CET [2016/05/09 10:20:53 ET]
Table 'Orthos' 9-max Seat #2 is the button
Seat 1: Kelvin sai ($82.36 in chips) 
Seat 2: PacPacBum ($102.75 in chips) 
Seat 3: Filojoes ($109.23 in chips) 
Seat 4: nubpoker ($118.37 in chips) 
Seat 5: matiko09 ($108.58 in chips) 
Seat 6: xhinostrabli ($116.65 in chips) 
Seat 8: Dickyxxx ($131.37 in chips) 
Filojoes: posts small blind $0.50
nubpoker: posts big blind $1
flk.Dasas: sits out 
vkartmann: sits out 
*** HOLE CARDS ***
Dealt to matiko09 [5c 9s]
matiko09: folds 
xhinostrabli: folds 
Dickyxxx: folds 
Kelvin sai: raises $1 to $2
PacPacBum: folds 
Filojoes: folds 
nubpoker: raises $6 to $8
Kelvin sai: folds 
Uncalled bet ($6) returned to nubpoker
nubpoker collected $4.50 from pot
nubpoker: doesn't show hand 
*** SUMMARY ***
Total pot $4.50 | Rake $0 
Seat 1: Kelvin sai folded before Flop
Seat 2: PacPacBum (button) folded before Flop (didn't bet)
Seat 3: Filojoes (small blind) folded before Flop
Seat 4: nubpoker (big blind) collected ($4.50)
Seat 5: matiko09 folded before Flop (didn't bet)
Seat 6: xhinostrabli folded before Flop (didn't bet)
Seat 8: Dickyxxx folded before Flop (didn't bet)





PokerStars Hand #153066826889:  Hold'em No Limit ($0.50/$1.00 USD) - 2016/05/09 16:21:02 CET [2016/05/09 10:21:02 ET]
Table 'Alderamin' 9-max Seat #3 is the button
Seat 2: Filojoes ($126.01 in chips) 
Seat 3: NSL0808 ($64.97 in chips) 
Seat 4: matiko09 ($110.50 in chips) 
Seat 5: tanmayh ($107.45 in chips) 
Seat 6: Spid1 ($107.48 in chips) 
Seat 7: azzad2007 ($110.68 in chips) 
Seat 8: nubpoker ($100 in chips) 
Seat 9: ipashutapkom ($51.49 in chips) 
matiko09: posts small blind $0.50
tanmayh: posts big blind $1
XTLMZUWR: sits out 
*** HOLE CARDS ***
Dealt to matiko09 [8d 3s]
Spid1: folds 
azzad2007: folds 
nubpoker: folds 
ipashutapkom: raises $1.26 to $2.26
Filojoes: folds 
NSL0808: folds 
matiko09: folds 
tanmayh: calls $1.26
*** FLOP *** [8h Kh Js]
tanmayh: bets $2
ipashutapkom: calls $2
*** TURN *** [8h Kh Js] [4d]
tanmayh: bets $4
ipashutapkom: calls $4
*** RIVER *** [8h Kh Js 4d] [2d]
tanmayh: bets $8
ipashutapkom: calls $8
*** SHOW DOWN ***
tanmayh: shows [9s Jd] (a pair of Jacks)
ipashutapkom: shows [Td Kd] (a pair of Kings)
ipashutapkom collected $31.37 from pot
*** SUMMARY ***
Total pot $33.02 | Rake $1.65 
Board [8h Kh Js 4d 2d]
Seat 2: Filojoes folded before Flop (didn't bet)
Seat 3: NSL0808 (button) folded before Flop (didn't bet)
Seat 4: matiko09 (small blind) folded before Flop
Seat 5: tanmayh (big blind) showed [9s Jd] and lost with a pair of Jacks
Seat 6: Spid1 folded before Flop (didn't bet)
Seat 7: azzad2007 folded before Flop (didn't bet)
Seat 8: nubpoker folded before Flop (didn't bet)
Seat 9: ipashutapkom showed [Td Kd] and won ($31.37) with a pair of Kings





PokerStars Hand #153066831035:  Hold'em No Limit ($0.50/$1.00 USD) - 2016/05/09 16:21:10 CET [2016/05/09 10:21:10 ET]
Table 'Isberga II' 9-max Seat #8 is the button
Seat 1: Kukuryzka ($100 in chips) 
Seat 2: Filojoes ($119.55 in chips) 
Seat 3: matiko09 ($106.29 in chips) 
Seat 4: ipashutapkom ($40 in chips) 
Seat 5: nubpoker ($108.48 in chips) 
Seat 6: vkartmann ($101.50 in chips) 
Seat 8: ozone2003 ($122.10 in chips) 
Seat 9: tubelight00 ($83.45 in chips) 
tubelight00: posts small blind $0.50
Kukuryzka: posts big blind $1
flk.Dasas: sits out 
*** HOLE CARDS ***
Dealt to matiko09 [Ks Qd]
Filojoes: folds 
matiko09: raises $2 to $3
ipashutapkom: folds 
nubpoker: folds 
vkartmann: raises $2 to $5
ozone2003: calls $5
tubelight00: folds 
Kukuryzka: folds 
matiko09: calls $2
*** FLOP *** [Th Td As]
matiko09: checks 
vkartmann: checks 
ozone2003: checks 
*** TURN *** [Th Td As] [5c]
matiko09: checks 
vkartmann: bets $7
ozone2003: folds 
matiko09: folds 
Uncalled bet ($7) returned to vkartmann
vkartmann collected $15.68 from pot
vkartmann: doesn't show hand 
*** SUMMARY ***
Total pot $16.50 | Rake $0.82 
Board [Th Td As 5c]
Seat 1: Kukuryzka (big blind) folded before Flop
Seat 2: Filojoes folded before Flop (didn't bet)
Seat 3: matiko09 folded on the Turn
Seat 4: ipashutapkom folded before Flop (didn't bet)
Seat 5: nubpoker folded before Flop (didn't bet)
Seat 6: vkartmann collected ($15.68)
Seat 8: ozone2003 (button) folded on the Turn
Seat 9: tubelight00 (small blind) folded before Flop





PokerStars Hand #153066834322:  Hold'em No Limit ($0.50/$1.00 USD) - 2016/05/09 16:21:15 CET [2016/05/09 10:21:15 ET]
Table 'Reiss' 9-max Seat #6 is the button
Seat 1: Dickyxxx ($195.90 in chips) 
Seat 2: mycka86 ($116.65 in chips) 
Seat 3: chaps1988 ($100 in chips) 
Seat 4: MichaLabam ($135.74 in chips) 
Seat 5: matiko09 ($121.25 in chips) 
Seat 6: Spid1 ($186.93 in chips) 
Seat 7: nubpoker ($100 in chips) 
Seat 8: Filojoes ($173.68 in chips) 
Seat 9: Aghmir77 ($102.46 in chips) 
nubpoker: posts small blind $0.50
Filojoes: posts big blind $1
*** HOLE CARDS ***
Dealt to matiko09 [Jc Ts]
Aghmir77: folds 
Dickyxxx: folds 
mycka86: folds 
chaps1988: folds 
MichaLabam: calls $1
matiko09: raises $3 to $4
Spid1: calls $4
nubpoker: folds 
Filojoes: folds 
MichaLabam: calls $3
*** FLOP *** [3c 2c 6d]
MichaLabam: checks 
matiko09: checks 
Spid1: bets $9
MichaLabam: calls $9
matiko09: folds 
*** TURN *** [3c 2c 6d] [9h]
MichaLabam: checks 
Spid1: bets $19
MichaLabam: calls $19
*** RIVER *** [3c 2c 6d 9h] [3s]
MichaLabam: checks 
Spid1: checks 
*** SHOW DOWN ***
MichaLabam: shows [3h 3d] (four of a kind, Threes)
Spid1: mucks hand 
MichaLabam collected $67 from pot
*** SUMMARY ***
Total pot $69.50 | Rake $2.50 
Board [3c 2c 6d 9h 3s]
Seat 1: Dickyxxx folded before Flop (didn't bet)
Seat 2: mycka86 folded before Flop (didn't bet)
Seat 3: chaps1988 folded before Flop (didn't bet)
Seat 4: MichaLabam showed [3h 3d] and won ($67) with four of a kind, Threes
Seat 5: matiko09 folded on the Flop
Seat 6: Spid1 (button) mucked [8s 8d]
Seat 7: nubpoker (small blind) folded before Flop
Seat 8: Filojoes (big blind) folded before Flop
Seat 9: Aghmir77 folded before Flop (didn't bet)





PokerStars Hand #153066836051:  Hold'em No Limit ($0.50/$1.00 USD) - 2016/05/09 16:21:18 CET [2016/05/09 10:21:18 ET]
Table 'Merga II' 9-max Seat #5 is the button
Seat 1: ipashutapkom ($43.75 in chips) 
Seat 2: Filojoes ($102.62 in chips) 
Seat 3: xhinostrabli ($42.47 in chips) 
Seat 4: nubpoker ($100 in chips) 
Seat 5: LRVAV7 ($249.06 in chips) 
Seat 6: Spid1 ($292.98 in chips) 
Seat 7: matiko09 ($148.79 in chips) 
Seat 8: GrandOldFart ($99.50 in chips) 
Seat 9: chaps1988 ($239.90 in chips) 
Spid1: posts small blind $0.50
matiko09: posts big blind $1
*** HOLE CARDS ***
Dealt to matiko09 [Qd 6d]
GrandOldFart: folds 
chaps1988: folds 
ipashutapkom: folds 
Filojoes: folds 
xhinostrabli: folds 
nubpoker: folds 
LRVAV7: folds 
Spid1: folds 
Uncalled bet ($0.50) returned to matiko09
matiko09 collected $1 from pot
matiko09: doesn't show hand 
*** SUMMARY ***
Total pot $1 | Rake $0 
Seat 1: ipashutapkom folded before Flop (didn't bet)
Seat 2: Filojoes folded before Flop (didn't bet)
Seat 3: xhinostrabli folded before Flop (didn't bet)
Seat 4: nubpoker folded before Flop (didn't bet)
Seat 5: LRVAV7 (button) folded before Flop (didn't bet)
Seat 6: Spid1 (small blind) folded before Flop
Seat 7: matiko09 (big blind) collected ($1)
Seat 8: GrandOldFart folded before Flop (didn't bet)
Seat 9: chaps1988 folded before Flop (didn't bet)





PokerStars Hand #153066840733:  Hold'em No Limit ($1/$2 USD) - 2016/05/09 16:21:26 CET [2016/05/09 10:21:26 ET]
Table 'Hagar II' 9-max Seat #7 is the button
Seat 1: azzad2007 ($212.61 in chips) 
Seat 2: darren1031 ($206.09 in chips) 
Seat 4: matiko09 ($249.19 in chips) 
Seat 5: PacPacBum ($200 in chips) 
Seat 7: Monsthand ($215.35 in chips) 
Seat 8: J0k3rF4c3_FD ($381.60 in chips) 
Seat 9: chaps1988 ($214.18 in chips) 
J0k3rF4c3_FD: posts small blind $1
chaps1988: posts big blind $2
Iggso: sits out 
*** HOLE CARDS ***
Dealt to matiko09 [Qc 6d]
azzad2007: folds 
darren1031: calls $2
matiko09: folds 
PacPacBum: folds 
Monsthand: folds 
J0k3rF4c3_FD: folds 
chaps1988: checks 
*** FLOP *** [Jh Kd 8d]
chaps1988: checks 
darren1031: checks 
*** TURN *** [Jh Kd 8d] [9h]
chaps1988: bets $3
darren1031: calls $3
*** RIVER *** [Jh Kd 8d 9h] [7c]
chaps1988: checks 
darren1031: checks 
*** SHOW DOWN ***
chaps1988: shows [4d Js] (a pair of Jacks)
darren1031: mucks hand 
chaps1988 collected $10.45 from pot
*** SUMMARY ***
Total pot $11 | Rake $0.55 
Board [Jh Kd 8d 9h 7c]
Seat 1: azzad2007 folded before Flop (didn't bet)
Seat 2: darren1031 mucked [Ah Qs]
Seat 4: matiko09 folded before Flop (didn't bet)
Seat 5: PacPacBum folded before Flop (didn't bet)
Seat 7: Monsthand (button) folded before Flop (didn't bet)
Seat 8: J0k3rF4c3_FD (small blind) folded before Flop
Seat 9: chaps1988 (big blind) showed [4d Js] and won ($10.45) with a pair of Jacks





PokerStars Hand #153066849295:  Hold'em No Limit ($0.50/$1.00 USD) - 2016/05/09 16:21:40 CET [2016/05/09 10:21:40 ET]
Table 'Orthos' 9-max Seat #3 is the button
Seat 1: Kelvin sai ($80.36 in chips) 
Seat 2: PacPacBum ($102.75 in chips) 
Seat 3: Filojoes ($108.73 in chips) 
Seat 4: nubpoker ($120.87 in chips) 
Seat 5: matiko09 ($108.58 in chips) 
Seat 6: xhinostrabli ($116.65 in chips) 
Seat 8: Dickyxxx ($131.37 in chips) 
nubpoker: posts small blind $0.50
matiko09: posts big blind $1
flk.Dasas: sits out 
vkartmann: sits out 
*** HOLE CARDS ***
Dealt to matiko09 [9h 2h]
xhinostrabli: folds 
Dickyxxx: folds 
Kelvin sai: folds 
PacPacBum: folds 
Filojoes: folds 
nubpoker: raises $1.50 to $2.50
matiko09: folds 
Uncalled bet ($1.50) returned to nubpoker
nubpoker collected $2 from pot
nubpoker: doesn't show hand 
*** SUMMARY ***
Total pot $2 | Rake $0 
Seat 1: Kelvin sai folded before Flop (didn't bet)
Seat 2: PacPacBum folded before Flop (didn't bet)
Seat 3: Filojoes (button) folded before Flop (didn't bet)
Seat 4: nubpoker (small blind) collected ($2)
Seat 5: matiko09 (big blind) folded before Flop
Seat 6: xhinostrabli folded before Flop (didn't bet)
Seat 8: Dickyxxx folded before Flop (didn't bet)





PokerStars Hand #153066850538:  Hold'em No Limit ($0.50/$1.00 USD) - 2016/05/09 16:21:42 CET [2016/05/09 10:21:42 ET]
Table 'Merga II' 9-max Seat #6 is the button
Seat 1: ipashutapkom ($43.75 in chips) 
Seat 2: Filojoes ($102.62 in chips) 
Seat 3: xhinostrabli ($42.47 in chips) 
Seat 4: nubpoker ($100 in chips) 
Seat 5: LRVAV7 ($249.06 in chips) 
Seat 6: Spid1 ($292.48 in chips) 
Seat 7: matiko09 ($149.29 in chips) 
Seat 8: GrandOldFart ($99.50 in chips) 
Seat 9: chaps1988 ($239.90 in chips) 
matiko09: posts small blind $0.50
GrandOldFart: posts big blind $1
*** HOLE CARDS ***
Dealt to matiko09 [4s 3c]
chaps1988: folds 
ipashutapkom: raises $1.26 to $2.26
Filojoes: folds 
xhinostrabli: folds 
nubpoker: calls $2.26
LRVAV7: calls $2.26
Spid1: raises $9.74 to $12
matiko09: folds 
GrandOldFart: folds 
ipashutapkom: folds 
nubpoker: folds 
LRVAV7: folds 
Uncalled bet ($9.74) returned to Spid1
Spid1 collected $10.54 from pot
Spid1: doesn't show hand 
*** SUMMARY ***
Total pot $10.54 | Rake $0 
Seat 1: ipashutapkom folded before Flop
Seat 2: Filojoes folded before Flop (didn't bet)
Seat 3: xhinostrabli folded before Flop (didn't bet)
Seat 4: nubpoker folded before Flop
Seat 5: LRVAV7 folded before Flop
Seat 6: Spid1 (button) collected ($10.54)
Seat 7: matiko09 (small blind) folded before Flop
Seat 8: GrandOldFart (big blind) folded before Flop
Seat 9: chaps1988 folded before Flop (didn't bet)





PokerStars Hand #153066851468:  Hold'em No Limit ($0.50/$1.00 USD) - 2016/05/09 16:21:44 CET [2016/05/09 10:21:44 ET]
Table 'Hajek' 9-max Seat #4 is the button
Seat 2: Spid1 ($100 in chips) 
Seat 3: mycka86 ($117.13 in chips) 
Seat 4: LRVAV7 ($110.87 in chips) 
Seat 5: ozone2003 ($100 in chips) 
Seat 6: Filojoes ($100 in chips) 
Seat 7: DancerNN1 ($246.73 in chips) 
Seat 8: Kukuryzka ($99.60 in chips) 
Seat 9: matiko09 ($100 in chips) 
ozone2003: posts small blind $0.50
Filojoes: posts big blind $1
vkartmann: sits out 
Spid1: posts the ante $0.20
mycka86: posts the ante $0.20
LRVAV7: posts the ante $0.20
ozone2003: posts the ante $0.20
Filojoes: posts the ante $0.20
DancerNN1: posts the ante $0.20
Kukuryzka: posts the ante $0.20
matiko09: posts the ante $0.20
*** HOLE CARDS ***
Dealt to matiko09 [Ts 3d]
DancerNN1: folds 
Kukuryzka: folds 
matiko09: folds 
Spid1: folds 
mycka86: raises $2 to $3
LRVAV7: calls $3
ozone2003: folds 
Filojoes: folds 
*** FLOP *** [9d 2h Qd]
mycka86: bets $4.75
LRVAV7: folds 
Uncalled bet ($4.75) returned to mycka86
mycka86 collected $8.64 from pot
*** SUMMARY ***
Total pot $9.10 | Rake $0.46 
Board [9d 2h Qd]
Seat 2: Spid1 folded before Flop (didn't bet)
Seat 3: mycka86 collected ($8.64)
Seat 4: LRVAV7 (button) folded on the Flop
Seat 5: ozone2003 (small blind) folded before Flop
Seat 6: Filojoes (big blind) folded before Flop
Seat 7: DancerNN1 folded before Flop (didn't bet)
Seat 8: Kukuryzka folded before Flop (didn't bet)
Seat 9: matiko09 folded before Flop (didn't bet)





PokerStars Hand #153066856707:  Hold'em No Limit ($0.50/$1.00 USD) - 2016/05/09 16:21:53 CET [2016/05/09 10:21:53 ET]
Table 'Alderamin' 9-max Seat #4 is the button
Seat 2: Filojoes ($126.01 in chips) 
Seat 3: NSL0808 ($64.97 in chips) 
Seat 4: matiko09 ($110 in chips) 
Seat 5: tanmayh ($91.19 in chips) 
Seat 6: Spid1 ($107.48 in chips) 
Seat 7: azzad2007 ($110.68 in chips) 
Seat 8: nubpoker ($100 in chips) 
Seat 9: ipashutapkom ($66.60 in chips) 
tanmayh: posts small blind $0.50
Spid1: posts big blind $1
XTLMZUWR: sits out 
*** HOLE CARDS ***
Dealt to matiko09 [8s Ac]
azzad2007: folds 
nubpoker: folds 
ipashutapkom: folds 
Filojoes: folds 
NSL0808: calls $1
matiko09: raises $3 to $4
tanmayh: calls $3.50
Spid1: raises $12 to $16
NSL0808: folds 
matiko09: folds 
tanmayh: calls $12
*** FLOP *** [3h Ad 5s]
tanmayh: checks 
Spid1: checks 
*** TURN *** [3h Ad 5s] [8c]
tanmayh: bets $18
Spid1: calls $18
*** RIVER *** [3h Ad 5s 8c] [9c]
tanmayh: bets $9
Spid1: raises $58.50 to $67.50
tanmayh: folds 
Uncalled bet ($58.50) returned to Spid1
Spid1 collected $88.50 from pot
Spid1: doesn't show hand 
*** SUMMARY ***
Total pot $91 | Rake $2.50 
Board [3h Ad 5s 8c 9c]
Seat 2: Filojoes folded before Flop (didn't bet)
Seat 3: NSL0808 folded before Flop
Seat 4: matiko09 (button) folded before Flop
Seat 5: tanmayh (small blind) folded on the River
Seat 6: Spid1 (big blind) collected ($88.50)
Seat 7: azzad2007 folded before Flop (didn't bet)
Seat 8: nubpoker folded before Flop (didn't bet)
Seat 9: ipashutapkom folded before Flop (didn't bet)





PokerStars Hand #153066867846:  Hold'em No Limit ($0.50/$1.00 USD) - 2016/05/09 16:22:12 CET [2016/05/09 10:22:12 ET]
Table 'Orthos' 9-max Seat #4 is the button
Seat 1: Kelvin sai ($80.36 in chips) 
Seat 2: PacPacBum ($102.75 in chips) 
Seat 3: Filojoes ($108.73 in chips) 
Seat 4: nubpoker ($121.87 in chips) 
Seat 5: matiko09 ($107.58 in chips) 
Seat 6: xhinostrabli ($116.65 in chips) 
Seat 8: Dickyxxx ($131.37 in chips) 
matiko09: posts small blind $0.50
xhinostrabli: posts big blind $1
flk.Dasas: sits out 
vkartmann: sits out 
*** HOLE CARDS ***
Dealt to matiko09 [4d 8c]
Dickyxxx: folds 
Kelvin sai: raises $1 to $2
PacPacBum: folds 
Filojoes: folds 
nubpoker: folds 
matiko09: folds 
xhinostrabli: calls $1
*** FLOP *** [2d Th 9h]
xhinostrabli: checks 
Kelvin sai: bets $2
xhinostrabli: calls $2
*** TURN *** [2d Th 9h] [5c]
xhinostrabli: checks 
Kelvin sai: bets $4
xhinostrabli: calls $4
*** RIVER *** [2d Th 9h 5c] [Ts]
xhinostrabli: bets $8
Kelvin sai: folds 
Uncalled bet ($8) returned to xhinostrabli
xhinostrabli collected $15.68 from pot
*** SUMMARY ***
Total pot $16.50 | Rake $0.82 
Board [2d Th 9h 5c Ts]
Seat 1: Kelvin sai folded on the River
Seat 2: PacPacBum folded before Flop (didn't bet)
Seat 3: Filojoes folded before Flop (didn't bet)
Seat 4: nubpoker (button) folded before Flop (didn't bet)
Seat 5: matiko09 (small blind) folded before Flop
Seat 6: xhinostrabli (big blind) collected ($15.68)
Seat 8: Dickyxxx folded before Flop (didn't bet)





PokerStars Hand #153066874006:  Hold'em No Limit ($0.50/$1.00 USD) - 2016/05/09 16:22:23 CET [2016/05/09 10:22:23 ET]
Table 'Terpsichore' 9-max Seat #9 is the button
Seat 1: ipashutapkom ($64.36 in chips) 
Seat 2: J0k3rF4c3_FD ($146.87 in chips) 
Seat 3: matiko09 ($118.37 in chips) 
Seat 4: nubpoker ($100 in chips) 
Seat 5: mycka86 ($208.01 in chips) 
Seat 7: ozone2003 ($100 in chips) 
Seat 8: Kiosk230472 ($178.68 in chips) 
Seat 9: FTPbannedMe ($157.52 in chips) 
ipashutapkom: posts small blind $0.50
J0k3rF4c3_FD: posts big blind $1
Filojoes: sits out 
*** HOLE CARDS ***
Dealt to matiko09 [Td Ts]
matiko09: raises $2 to $3
nubpoker: folds 
mycka86: folds 
ozone2003: folds 
ozone2003 said, "(y)(y)"
Kiosk230472: calls $3
FTPbannedMe: folds 
ipashutapkom: folds 
J0k3rF4c3_FD: folds 
*** FLOP *** [Ks 5d 7s]
matiko09: checks 
Kiosk230472: checks 
*** TURN *** [Ks 5d 7s] [8h]
matiko09: bets $4.63
Kiosk230472: folds 
Uncalled bet ($4.63) returned to matiko09
matiko09 collected $7.12 from pot
matiko09: doesn't show hand 
*** SUMMARY ***
Total pot $7.50 | Rake $0.38 
Board [Ks 5d 7s 8h]
Seat 1: ipashutapkom (small blind) folded before Flop
Seat 2: J0k3rF4c3_FD (big blind) folded before Flop
Seat 3: matiko09 collected ($7.12)
Seat 4: nubpoker folded before Flop (didn't bet)
Seat 5: mycka86 folded before Flop (didn't bet)
Seat 7: ozone2003 folded before Flop (didn't bet)
Seat 8: Kiosk230472 folded on the Turn
Seat 9: FTPbannedMe (button) folded before Flop (didn't bet)





PokerStars Hand #153066881262:  Hold'em No Limit ($0.50/$1.00 USD) - 2016/05/09 16:22:35 CET [2016/05/09 10:22:35 ET]
Table 'Merga II' 9-max Seat #7 is the button
Seat 1: ipashutapkom ($41.49 in chips) 
Seat 2: Filojoes ($102.62 in chips) 
Seat 3: xhinostrabli ($42.47 in chips) 
Seat 4: nubpoker ($100 in chips) 
Seat 5: LRVAV7 ($246.80 in chips) 
Seat 6: Spid1 ($300.76 in chips) 
Seat 7: matiko09 ($148.79 in chips) 
Seat 8: GrandOldFart ($98.50 in chips) 
Seat 9: chaps1988 ($239.90 in chips) 
GrandOldFart: posts small blind $0.50
chaps1988: posts big blind $1
*** HOLE CARDS ***
Dealt to matiko09 [2s 4d]
ipashutapkom: folds 
Filojoes: raises $2 to $3
xhinostrabli: folds 
nubpoker: folds 
LRVAV7: folds 
Spid1: calls $3
matiko09: folds 
GrandOldFart: folds 
chaps1988: folds 
*** FLOP *** [Kc 6d 4s]
Filojoes: checks 
Spid1: checks 
*** TURN *** [Kc 6d 4s] [Jh]
Filojoes: checks 
Spid1: bets $5.50
Filojoes: folds 
Uncalled bet ($5.50) returned to Spid1
Spid1 collected $7.12 from pot
Spid1: doesn't show hand 
*** SUMMARY ***
Total pot $7.50 | Rake $0.38 
Board [Kc 6d 4s Jh]
Seat 1: ipashutapkom folded before Flop (didn't bet)
Seat 2: Filojoes folded on the Turn
Seat 3: xhinostrabli folded before Flop (didn't bet)
Seat 4: nubpoker folded before Flop (didn't bet)
Seat 5: LRVAV7 folded before Flop (didn't bet)
Seat 6: Spid1 collected ($7.12)
Seat 7: matiko09 (button) folded before Flop (didn't bet)
Seat 8: GrandOldFart (small blind) folded before Flop
Seat 9: chaps1988 (big blind) folded before Flop





PokerStars Hand #153066880950:  Hold'em No Limit ($1/$2 USD) - 2016/05/09 16:22:35 CET [2016/05/09 10:22:35 ET]
Table 'Hagar II' 9-max Seat #8 is the button
Seat 2: darren1031 ($201.09 in chips) 
Seat 4: matiko09 ($249.19 in chips) 
Seat 5: PacPacBum ($200 in chips) 
Seat 7: Monsthand ($215.35 in chips) 
Seat 8: J0k3rF4c3_FD ($380.60 in chips) 
Seat 9: chaps1988 ($219.63 in chips) 
chaps1988: posts small blind $1
azzad2007: is sitting out 
azzad2007 leaves the table
darren1031: posts big blind $2
Iggso: sits out 
*** HOLE CARDS ***
Dealt to matiko09 [Ad 2c]
matiko09: folds 
PacPacBum: raises $3 to $5
Monsthand: folds 
J0k3rF4c3_FD: folds 
chaps1988: folds 
darren1031: folds 
Uncalled bet ($3) returned to PacPacBum
PacPacBum collected $5 from pot
PacPacBum: doesn't show hand 
*** SUMMARY ***
Total pot $5 | Rake $0 
Seat 2: darren1031 (big blind) folded before Flop
Seat 4: matiko09 folded before Flop (didn't bet)
Seat 5: PacPacBum collected ($5)
Seat 7: Monsthand folded before Flop (didn't bet)
Seat 8: J0k3rF4c3_FD (button) folded before Flop (didn't bet)
Seat 9: chaps1988 (small blind) folded before Flop





PokerStars Hand #153066881979:  Hold'em No Limit ($0.50/$1.00 USD) - 2016/05/09 16:22:37 CET [2016/05/09 10:22:37 ET]
Table 'Reiss' 9-max Seat #7 is the button
Seat 1: Dickyxxx ($195.90 in chips) 
Seat 2: mycka86 ($116.65 in chips) 
Seat 3: chaps1988 ($100 in chips) 
Seat 4: MichaLabam ($170.74 in chips) 
Seat 5: matiko09 ($117.25 in chips) 
Seat 6: Spid1 ($154.93 in chips) 
Seat 7: nubpoker ($100 in chips) 
Seat 8: Filojoes ($172.68 in chips) 
Seat 9: Aghmir77 ($102.46 in chips) 
Filojoes: posts small blind $0.50
Aghmir77: posts big blind $1
*** HOLE CARDS ***
Dealt to matiko09 [3c Jh]
Dickyxxx: folds 
mycka86: folds 
chaps1988: folds 
MichaLabam: folds 
matiko09: folds 
Spid1: folds 
nubpoker: folds 
Filojoes: raises $1.50 to $2.50
Aghmir77: calls $1.50
*** FLOP *** [8c 3h Qd]
Filojoes: checks 
Aghmir77: checks 
*** TURN *** [8c 3h Qd] [3d]
Filojoes: checks 
Aghmir77: bets $2.37
Filojoes: folds 
Uncalled bet ($2.37) returned to Aghmir77
Aghmir77 collected $4.75 from pot
Aghmir77: doesn't show hand 
*** SUMMARY ***
Total pot $5 | Rake $0.25 
Board [8c 3h Qd 3d]
Seat 1: Dickyxxx folded before Flop (didn't bet)
Seat 2: mycka86 folded before Flop (didn't bet)
Seat 3: chaps1988 folded before Flop (didn't bet)
Seat 4: MichaLabam folded before Flop (didn't bet)
Seat 5: matiko09 folded before Flop (didn't bet)
Seat 6: Spid1 folded before Flop (didn't bet)
Seat 7: nubpoker (button) folded before Flop (didn't bet)
Seat 8: Filojoes (small blind) folded on the Turn
Seat 9: Aghmir77 (big blind) collected ($4.75)





PokerStars Hand #153066883206:  Hold'em No Limit ($0.50/$1.00 USD) - 2016/05/09 16:22:39 CET [2016/05/09 10:22:39 ET]
Table 'Hajek' 9-max Seat #5 is the button
Seat 2: Spid1 ($100 in chips) 
Seat 3: mycka86 ($122.57 in chips) 
Seat 4: LRVAV7 ($107.67 in chips) 
Seat 5: ozone2003 ($100 in chips) 
Seat 6: Filojoes ($100 in chips) 
Seat 7: DancerNN1 ($246.53 in chips) 
Seat 8: Kukuryzka ($99.40 in chips) 
Seat 9: matiko09 ($100 in chips) 
Filojoes: posts small blind $0.50
DancerNN1: posts big blind $1
vkartmann: sits out 
Spid1: posts the ante $0.20
mycka86: posts the ante $0.20
LRVAV7: posts the ante $0.20
ozone2003: posts the ante $0.20
Filojoes: posts the ante $0.20
DancerNN1: posts the ante $0.20
Kukuryzka: posts the ante $0.20
matiko09: posts the ante $0.20
*** HOLE CARDS ***
Dealt to matiko09 [9d 2d]
Kukuryzka: raises $2 to $3
matiko09: folds 
Spid1: folds 
mycka86: folds 
LRVAV7: calls $3
ozone2003: folds 
Filojoes: folds 
DancerNN1: folds 
*** FLOP *** [Jc 8d Ad]
Kukuryzka: checks 
LRVAV7: bets $6
Kukuryzka: folds 
Uncalled bet ($6) returned to LRVAV7
LRVAV7 collected $8.64 from pot
LRVAV7: doesn't show hand 
*** SUMMARY ***
Total pot $9.10 | Rake $0.46 
Board [Jc 8d Ad]
Seat 2: Spid1 folded before Flop (didn't bet)
Seat 3: mycka86 folded before Flop (didn't bet)
Seat 4: LRVAV7 collected ($8.64)
Seat 5: ozone2003 (button) folded before Flop (didn't bet)
Seat 6: Filojoes (small blind) folded before Flop
Seat 7: DancerNN1 (big blind) folded before Flop
Seat 8: Kukuryzka folded on the Flop
Seat 9: matiko09 folded before Flop (didn't bet)





PokerStars Hand #153066891853:  Hold'em No Limit ($1/$2 USD) - 2016/05/09 16:22:53 CET [2016/05/09 10:22:53 ET]
Table 'Hagar II' 9-max Seat #9 is the button
Seat 2: darren1031 ($199.09 in chips) 
Seat 4: matiko09 ($249.19 in chips) 
Seat 5: PacPacBum ($203 in chips) 
Seat 7: Monsthand ($215.35 in chips) 
Seat 8: J0k3rF4c3_FD ($380.60 in chips) 
Seat 9: chaps1988 ($218.63 in chips) 
darren1031: posts small blind $1
matiko09: posts big blind $2
Iggso: sits out 
*** HOLE CARDS ***
Dealt to matiko09 [2d Ks]
PacPacBum: raises $2.08 to $4.08
Monsthand: calls $4.08
J0k3rF4c3_FD: folds 
chaps1988: folds 
darren1031: folds 
matiko09: folds 
*** FLOP *** [4d 9s Th]
PacPacBum: bets $5.72
Monsthand: calls $5.72
*** TURN *** [4d 9s Th] [7s]
PacPacBum: checks 
Monsthand: bets $13
PacPacBum: calls $13
*** RIVER *** [4d 9s Th 7s] [Js]
PacPacBum: checks 
Monsthand: checks 
*** SHOW DOWN ***
PacPacBum: shows [Td 8d] (a straight, Seven to Jack)
Monsthand: mucks hand 
PacPacBum collected $46.17 from pot
*** SUMMARY ***
Total pot $48.60 | Rake $2.43 
Board [4d 9s Th 7s Js]
Seat 2: darren1031 (small blind) folded before Flop
Seat 4: matiko09 (big blind) folded before Flop
Seat 5: PacPacBum showed [Td 8d] and won ($46.17) with a straight, Seven to Jack
Seat 7: Monsthand mucked [7d 7h]
Seat 8: J0k3rF4c3_FD folded before Flop (didn't bet)
Seat 9: chaps1988 (button) folded before Flop (didn't bet)





PokerStars Hand #153066892367:  Hold'em No Limit ($0.50/$1.00 USD) - 2016/05/09 16:22:54 CET [2016/05/09 10:22:54 ET]
Table 'Isberga II' 9-max Seat #9 is the button
Seat 1: Kukuryzka ($99 in chips) 
Seat 2: Filojoes ($119.55 in chips) 
Seat 3: matiko09 ($101.29 in chips) 
Seat 4: ipashutapkom ($40 in chips) 
Seat 5: nubpoker ($108.48 in chips) 
Seat 6: vkartmann ($112.18 in chips) 
Seat 8: ozone2003 ($117.10 in chips) 
Seat 9: tubelight00 ($82.95 in chips) 
Kukuryzka: posts small blind $0.50
Filojoes: posts big blind $1
flk.Dasas: sits out 
*** HOLE CARDS ***
Dealt to matiko09 [7h Ks]
matiko09: folds 
ipashutapkom: folds 
nubpoker: folds 
vkartmann: raises $2 to $3
ozone2003: folds 
tubelight00: folds 
Kukuryzka: folds 
Filojoes: folds 
Uncalled bet ($2) returned to vkartmann
vkartmann collected $2.50 from pot
vkartmann: doesn't show hand 
*** SUMMARY ***
Total pot $2.50 | Rake $0 
Seat 1: Kukuryzka (small blind) folded before Flop
Seat 2: Filojoes (big blind) folded before Flop
Seat 3: matiko09 folded before Flop (didn't bet)
Seat 4: ipashutapkom folded before Flop (didn't bet)
Seat 5: nubpoker folded before Flop (didn't bet)
Seat 6: vkartmann collected ($2.50)
Seat 8: ozone2003 folded before Flop (didn't bet)
Seat 9: tubelight00 (button) folded before Flop (didn't bet)





PokerStars Hand #153066909965:  Hold'em No Limit ($0.50/$1.00 USD) - 2016/05/09 16:23:24 CET [2016/05/09 10:23:24 ET]
Table 'Isberga II' 9-max Seat #1 is the button
Seat 1: Kukuryzka ($100 in chips) 
Seat 2: Filojoes ($118.55 in chips) 
Seat 3: matiko09 ($101.29 in chips) 
Seat 4: ipashutapkom ($40 in chips) 
Seat 5: nubpoker ($108.48 in chips) 
Seat 6: vkartmann ($113.68 in chips) 
Seat 8: ozone2003 ($117.10 in chips) 
Seat 9: tubelight00 ($82.95 in chips) 
Filojoes: posts small blind $0.50
matiko09: posts big blind $1
flk.Dasas: sits out 
*** HOLE CARDS ***
Dealt to matiko09 [2h 5d]
ipashutapkom: folds 
nubpoker: folds 
vkartmann: folds 
ozone2003: folds 
tubelight00: folds 
Kukuryzka: raises $1 to $2
Filojoes: calls $1.50
matiko09: folds 
*** FLOP *** [6h 5c 2c]
Filojoes: checks 
Kukuryzka: checks 
*** TURN *** [6h 5c 2c] [Kd]
Filojoes: checks 
Kukuryzka: bets $3.32
Filojoes: folds 
Uncalled bet ($3.32) returned to Kukuryzka
Kukuryzka collected $4.75 from pot
Kukuryzka: doesn't show hand 
*** SUMMARY ***
Total pot $5 | Rake $0.25 
Board [6h 5c 2c Kd]
Seat 1: Kukuryzka (button) collected ($4.75)
Seat 2: Filojoes (small blind) folded on the Turn
Seat 3: matiko09 (big blind) folded before Flop
Seat 4: ipashutapkom folded before Flop (didn't bet)
Seat 5: nubpoker folded before Flop (didn't bet)
Seat 6: vkartmann folded before Flop (didn't bet)
Seat 8: ozone2003 folded before Flop (didn't bet)
Seat 9: tubelight00 folded before Flop (didn't bet)





PokerStars Hand #153066914941:  Hold'em No Limit ($0.50/$1.00 USD) - 2016/05/09 16:23:33 CET [2016/05/09 10:23:33 ET]
Table 'Merga II' 9-max Seat #8 is the button
Seat 1: ipashutapkom ($41.49 in chips) 
Seat 2: Filojoes ($100 in chips) 
Seat 3: xhinostrabli ($42.47 in chips) 
Seat 4: nubpoker ($100 in chips) 
Seat 5: LRVAV7 ($246.80 in chips) 
Seat 6: Spid1 ($304.88 in chips) 
Seat 7: matiko09 ($148.79 in chips) 
Seat 8: GrandOldFart ($98 in chips) 
Seat 9: chaps1988 ($238.90 in chips) 
chaps1988: posts small blind $0.50
ipashutapkom: posts big blind $1
*** HOLE CARDS ***
Dealt to matiko09 [4c Td]
Filojoes: folds 
xhinostrabli: folds 
nubpoker: folds 
LRVAV7: raises $2 to $3
Spid1: calls $3
matiko09: folds 
GrandOldFart: calls $3
chaps1988: folds 
ipashutapkom: folds 
*** FLOP *** [Kd Kh 7d]
LRVAV7: checks 
Spid1: checks 
GrandOldFart: checks 
*** TURN *** [Kd Kh 7d] [5c]
LRVAV7: bets $6
Spid1: folds 
GrandOldFart: folds 
Uncalled bet ($6) returned to LRVAV7
LRVAV7 collected $9.98 from pot
LRVAV7: doesn't show hand 
*** SUMMARY ***
Total pot $10.50 | Rake $0.52 
Board [Kd Kh 7d 5c]
Seat 1: ipashutapkom (big blind) folded before Flop
Seat 2: Filojoes folded before Flop (didn't bet)
Seat 3: xhinostrabli folded before Flop (didn't bet)
Seat 4: nubpoker folded before Flop (didn't bet)
Seat 5: LRVAV7 collected ($9.98)
Seat 6: Spid1 folded on the Turn
Seat 7: matiko09 folded before Flop (didn't bet)
Seat 8: GrandOldFart (button) folded on the Turn
Seat 9: chaps1988 (small blind) folded before Flop





PokerStars Hand #153066915378:  Hold'em No Limit ($0.50/$1.00 USD) - 2016/05/09 16:23:34 CET [2016/05/09 10:23:34 ET]
Table 'Hajek' 9-max Seat #6 is the button
Seat 2: Spid1 ($100 in chips) 
Seat 3: mycka86 ($122.37 in chips) 
Seat 4: LRVAV7 ($113.11 in chips) 
Seat 5: ozone2003 ($100 in chips) 
Seat 6: Filojoes ($100 in chips) 
Seat 7: DancerNN1 ($245.33 in chips) 
Seat 8: Kukuryzka ($100 in chips) 
Seat 9: matiko09 ($100 in chips) 
DancerNN1: posts small blind $0.50
Kukuryzka: posts big blind $1
vkartmann: sits out 
Spid1: posts the ante $0.20
mycka86: posts the ante $0.20
LRVAV7: posts the ante $0.20
ozone2003: posts the ante $0.20
Filojoes: posts the ante $0.20
DancerNN1: posts the ante $0.20
Kukuryzka: posts the ante $0.20
matiko09: posts the ante $0.20
*** HOLE CARDS ***
Dealt to matiko09 [As Kc]
matiko09: raises $2 to $3
Spid1: folds 
mycka86: folds 
LRVAV7: folds 
ozone2003: folds 
Filojoes: folds 
DancerNN1: folds 
Kukuryzka: folds 
Uncalled bet ($2) returned to matiko09
matiko09 collected $4.10 from pot
matiko09: doesn't show hand 
*** SUMMARY ***
Total pot $4.10 | Rake $0 
Seat 2: Spid1 folded before Flop (didn't bet)
Seat 3: mycka86 folded before Flop (didn't bet)
Seat 4: LRVAV7 folded before Flop (didn't bet)
Seat 5: ozone2003 folded before Flop (didn't bet)
Seat 6: Filojoes (button) folded before Flop (didn't bet)
Seat 7: DancerNN1 (small blind) folded before Flop
Seat 8: Kukuryzka (big blind) folded before Flop
Seat 9: matiko09 collected ($4.10)





PokerStars Hand #153066915526:  Hold'em No Limit ($0.50/$1.00 USD) - 2016/05/09 16:23:34 CET [2016/05/09 10:23:34 ET]
Table 'Alderamin' 9-max Seat #5 is the button
Seat 2: Filojoes ($126.01 in chips) 
Seat 3: NSL0808 ($63.97 in chips) 
Seat 4: matiko09 ($106 in chips) 
Seat 5: tanmayh ($48.19 in chips) 
Seat 6: Spid1 ($152.98 in chips) 
Seat 7: azzad2007 ($110.68 in chips) 
Seat 8: nubpoker ($100 in chips) 
Seat 9: ipashutapkom ($66.60 in chips) 
Spid1: posts small blind $0.50
azzad2007: posts big blind $1
XTLMZUWR: sits out 
*** HOLE CARDS ***
Dealt to matiko09 [4h 9c]
nubpoker: raises $1.50 to $2.50
ipashutapkom: folds 
Filojoes: folds 
NSL0808: folds 
matiko09: folds 
tanmayh: folds 
Spid1: folds 
azzad2007: folds 
Uncalled bet ($1.50) returned to nubpoker
nubpoker collected $2.50 from pot
nubpoker: doesn't show hand 
*** SUMMARY ***
Total pot $2.50 | Rake $0 
Seat 2: Filojoes folded before Flop (didn't bet)
Seat 3: NSL0808 folded before Flop (didn't bet)
Seat 4: matiko09 folded before Flop (didn't bet)
Seat 5: tanmayh (button) folded before Flop (didn't bet)
Seat 6: Spid1 (small blind) folded before Flop
Seat 7: azzad2007 (big blind) folded before Flop
Seat 8: nubpoker collected ($2.50)
Seat 9: ipashutapkom folded before Flop (didn't bet)





PokerStars Hand #153066916426:  Hold'em No Limit ($0.50/$1.00 USD) - 2016/05/09 16:23:35 CET [2016/05/09 10:23:35 ET]
Table 'Reiss' 9-max Seat #8 is the button
Seat 1: Dickyxxx ($195.90 in chips) 
Seat 2: mycka86 ($116.65 in chips) 
Seat 3: chaps1988 ($100 in chips) 
Seat 4: MichaLabam ($170.74 in chips) 
Seat 5: matiko09 ($117.25 in chips) 
Seat 6: Spid1 ($154.93 in chips) 
Seat 7: nubpoker ($100 in chips) 
Seat 8: Filojoes ($170.18 in chips) 
Seat 9: Aghmir77 ($104.71 in chips) 
Aghmir77: posts small blind $0.50
Dickyxxx: posts big blind $1
*** HOLE CARDS ***
Dealt to matiko09 [5d 3d]
mycka86: folds 
chaps1988: folds 
MichaLabam: folds 
matiko09: folds 
Spid1: folds 
nubpoker: folds 
Filojoes: raises $1 to $2
Aghmir77: folds 
Dickyxxx: calls $1
*** FLOP *** [4d Kd 3c]
Dickyxxx: checks 
Filojoes: checks 
*** TURN *** [4d Kd 3c] [Jc]
Dickyxxx: bets $2.85
Filojoes: folds 
Uncalled bet ($2.85) returned to Dickyxxx
Dickyxxx collected $4.28 from pot
Dickyxxx: doesn't show hand 
*** SUMMARY ***
Total pot $4.50 | Rake $0.22 
Board [4d Kd 3c Jc]
Seat 1: Dickyxxx (big blind) collected ($4.28)
Seat 2: mycka86 folded before Flop (didn't bet)
Seat 3: chaps1988 folded before Flop (didn't bet)
Seat 4: MichaLabam folded before Flop (didn't bet)
Seat 5: matiko09 folded before Flop (didn't bet)
Seat 6: Spid1 folded before Flop (didn't bet)
Seat 7: nubpoker folded before Flop (didn't bet)
Seat 8: Filojoes (button) folded on the Turn
Seat 9: Aghmir77 (small blind) folded before Flop





PokerStars Hand #153066919785:  Hold'em No Limit ($0.50/$1.00 USD) - 2016/05/09 16:23:41 CET [2016/05/09 10:23:41 ET]
Table 'Orthos' 9-max Seat #5 is the button
Seat 1: Kelvin sai ($72.36 in chips) 
Seat 2: PacPacBum ($102.75 in chips) 
Seat 3: Filojoes ($108.73 in chips) 
Seat 4: nubpoker ($121.87 in chips) 
Seat 5: matiko09 ($107.08 in chips) 
Seat 6: xhinostrabli ($124.33 in chips) 
Seat 7: flk.Dasas ($100 in chips) 
Seat 8: Dickyxxx ($131.37 in chips) 
xhinostrabli: posts small blind $0.50
flk.Dasas: posts big blind $1
vkartmann: sits out 
*** HOLE CARDS ***
Dealt to matiko09 [7c Kd]
Dickyxxx: folds 
Kelvin sai: raises $1 to $2
PacPacBum: folds 
Filojoes: folds 
nubpoker: folds 
matiko09: folds 
xhinostrabli: folds 
flk.Dasas: calls $1
*** FLOP *** [Jd Qc 9h]
flk.Dasas: checks 
Kelvin sai: bets $2
flk.Dasas: calls $2
*** TURN *** [Jd Qc 9h] [5d]
flk.Dasas: checks 
Kelvin sai: checks 
*** RIVER *** [Jd Qc 9h 5d] [2h]
flk.Dasas: checks 
Kelvin sai: checks 
*** SHOW DOWN ***
flk.Dasas: shows [Ah Js] (a pair of Jacks)
Kelvin sai: mucks hand 
flk.Dasas collected $8.08 from pot
*** SUMMARY ***
Total pot $8.50 | Rake $0.42 
Board [Jd Qc 9h 5d 2h]
Seat 1: Kelvin sai mucked [Ac Tc]
Seat 2: PacPacBum folded before Flop (didn't bet)
Seat 3: Filojoes folded before Flop (didn't bet)
Seat 4: nubpoker folded before Flop (didn't bet)
Seat 5: matiko09 (button) folded before Flop (didn't bet)
Seat 6: xhinostrabli (small blind) folded before Flop
Seat 7: flk.Dasas (big blind) showed [Ah Js] and won ($8.08) with a pair of Jacks
Seat 8: Dickyxxx folded before Flop (didn't bet)





PokerStars Hand #153066928605:  Hold'em No Limit ($1/$2 USD) - 2016/05/09 16:23:56 CET [2016/05/09 10:23:56 ET]
Table 'Hagar II' 9-max Seat #2 is the button
Seat 2: darren1031 ($198.09 in chips) 
Seat 4: matiko09 ($247.19 in chips) 
Seat 5: PacPacBum ($226.37 in chips) 
Seat 7: Monsthand ($200 in chips) 
Seat 8: J0k3rF4c3_FD ($380.60 in chips) 
Seat 9: chaps1988 ($218.63 in chips) 
matiko09: posts small blind $1
PacPacBum: posts big blind $2
Iggso: sits out 
*** HOLE CARDS ***
Dealt to matiko09 [Ts 9d]
Monsthand: folds 
J0k3rF4c3_FD: folds 
chaps1988: raises $2.50 to $4.50
darren1031: calls $4.50
matiko09: folds 
PacPacBum: folds 
*** FLOP *** [2d 7h 6c]
chaps1988: bets $5.50
darren1031: calls $5.50
*** TURN *** [2d 7h 6c] [6d]
chaps1988: checks 
darren1031: checks 
*** RIVER *** [2d 7h 6c 6d] [Kd]
chaps1988: checks 
darren1031: bets $16
chaps1988: folds 
Uncalled bet ($16) returned to darren1031
darren1031 collected $21.85 from pot
darren1031: doesn't show hand 
*** SUMMARY ***
Total pot $23 | Rake $1.15 
Board [2d 7h 6c 6d Kd]
Seat 2: darren1031 (button) collected ($21.85)
Seat 4: matiko09 (small blind) folded before Flop
Seat 5: PacPacBum (big blind) folded before Flop
Seat 7: Monsthand folded before Flop (didn't bet)
Seat 8: J0k3rF4c3_FD folded before Flop (didn't bet)
Seat 9: chaps1988 folded on the River





PokerStars Hand #153066929954:  Hold'em No Limit ($0.50/$1.00 USD) - 2016/05/09 16:23:58 CET [2016/05/09 10:23:58 ET]
Table 'Terpsichore' 9-max Seat #1 is the button
Seat 1: ipashutapkom ($63.86 in chips) 
Seat 2: J0k3rF4c3_FD ($145.87 in chips) 
Seat 3: matiko09 ($122.49 in chips) 
Seat 4: nubpoker ($100 in chips) 
Seat 5: mycka86 ($208.01 in chips) 
Seat 7: ozone2003 ($100 in chips) 
Seat 8: Kiosk230472 ($175.68 in chips) 
Seat 9: FTPbannedMe ($157.52 in chips) 
J0k3rF4c3_FD: posts small blind $0.50
matiko09: posts big blind $1
Filojoes: sits out 
*** HOLE CARDS ***
Dealt to matiko09 [7d Qs]
nubpoker: folds 
mycka86: folds 
ozone2003: folds 
Kiosk230472: folds 
FTPbannedMe: folds 
ipashutapkom: folds 
J0k3rF4c3_FD: raises $1.50 to $2.50
matiko09: folds 
Uncalled bet ($1.50) returned to J0k3rF4c3_FD
J0k3rF4c3_FD collected $2 from pot
J0k3rF4c3_FD: doesn't show hand 
*** SUMMARY ***
Total pot $2 | Rake $0 
Seat 1: ipashutapkom (button) folded before Flop (didn't bet)
Seat 2: J0k3rF4c3_FD (small blind) collected ($2)
Seat 3: matiko09 (big blind) folded before Flop
Seat 4: nubpoker folded before Flop (didn't bet)
Seat 5: mycka86 folded before Flop (didn't bet)
Seat 7: ozone2003 folded before Flop (didn't bet)
Seat 8: Kiosk230472 folded before Flop (didn't bet)
Seat 9: FTPbannedMe folded before Flop (didn't bet)





PokerStars Hand #153066933522:  Hold'em No Limit ($0.50/$1.00 USD) - 2016/05/09 16:24:05 CET [2016/05/09 10:24:05 ET]
Table 'Hajek' 9-max Seat #7 is the button
Seat 2: Spid1 ($100 in chips) 
Seat 3: mycka86 ($122.17 in chips) 
Seat 4: LRVAV7 ($112.91 in chips) 
Seat 5: ozone2003 ($100 in chips) 
Seat 6: Filojoes ($100 in chips) 
Seat 7: DancerNN1 ($244.63 in chips) 
Seat 8: Kukuryzka ($100 in chips) 
Seat 9: matiko09 ($102.90 in chips) 
Kukuryzka: posts small blind $0.50
matiko09: posts big blind $1
vkartmann: sits out 
Spid1: posts the ante $0.20
mycka86: posts the ante $0.20
LRVAV7: posts the ante $0.20
ozone2003: posts the ante $0.20
Filojoes: posts the ante $0.20
DancerNN1: posts the ante $0.20
Kukuryzka: posts the ante $0.20
matiko09: posts the ante $0.20
*** HOLE CARDS ***
Dealt to matiko09 [Kd 4h]
Spid1: folds 
mycka86: folds 
LRVAV7: folds 
ozone2003: folds 
Filojoes: folds 
DancerNN1: raises $1 to $2
Kukuryzka: folds 
matiko09: folds 
Uncalled bet ($1) returned to DancerNN1
DancerNN1 collected $4.10 from pot
DancerNN1: doesn't show hand 
*** SUMMARY ***
Total pot $4.10 | Rake $0 
Seat 2: Spid1 folded before Flop (didn't bet)
Seat 3: mycka86 folded before Flop (didn't bet)
Seat 4: LRVAV7 folded before Flop (didn't bet)
Seat 5: ozone2003 folded before Flop (didn't bet)
Seat 6: Filojoes folded before Flop (didn't bet)
Seat 7: DancerNN1 (button) collected ($4.10)
Seat 8: Kukuryzka (small blind) folded before Flop
Seat 9: matiko09 (big blind) folded before Flop





PokerStars Hand #153066935491:  Hold'em No Limit ($0.50/$1.00 USD) - 2016/05/09 16:24:08 CET [2016/05/09 10:24:08 ET]
Table 'Alderamin' 9-max Seat #6 is the button
Seat 2: Filojoes ($126.01 in chips) 
Seat 3: NSL0808 ($63.97 in chips) 
Seat 4: matiko09 ($106 in chips) 
Seat 5: tanmayh ($48.19 in chips) 
Seat 6: Spid1 ($152.48 in chips) 
Seat 7: azzad2007 ($109.68 in chips) 
Seat 8: nubpoker ($101.50 in chips) 
Seat 9: ipashutapkom ($66.60 in chips) 
azzad2007: posts small blind $0.50
nubpoker: posts big blind $1
XTLMZUWR: sits out 
*** HOLE CARDS ***
Dealt to matiko09 [2s Qc]
ipashutapkom: folds 
Filojoes: folds 
NSL0808: calls $1
matiko09: folds 
tanmayh: calls $1
Spid1: folds 
azzad2007: raises $4 to $5
nubpoker: folds 
NSL0808: calls $4
tanmayh: calls $4
*** FLOP *** [5c 8h 5s]
azzad2007: bets $7.60
NSL0808: calls $7.60
tanmayh: calls $7.60
*** TURN *** [5c 8h 5s] [4d]
azzad2007: checks 
NSL0808: checks 
tanmayh: checks 
*** RIVER *** [5c 8h 5s 4d] [Jc]
azzad2007: checks 
NSL0808: checks 
tanmayh: checks 
*** SHOW DOWN ***
azzad2007: shows [Th Ts] (two pair, Tens and Fives)
NSL0808: mucks hand 
tanmayh: mucks hand 
azzad2007 collected $36.86 from pot
*** SUMMARY ***
Total pot $38.80 | Rake $1.94 
Board [5c 8h 5s 4d Jc]
Seat 2: Filojoes folded before Flop (didn't bet)
Seat 3: NSL0808 mucked [2c 7c]
Seat 4: matiko09 folded before Flop (didn't bet)
Seat 5: tanmayh mucked [Ah 8d]
Seat 6: Spid1 (button) folded before Flop (didn't bet)
Seat 7: azzad2007 (small blind) showed [Th Ts] and won ($36.86) with two pair, Tens and Fives
Seat 8: nubpoker (big blind) folded before Flop
Seat 9: ipashutapkom folded before Flop (didn't bet)





PokerStars Hand #153066945927:  Hold'em No Limit ($0.50/$1.00 USD) - 2016/05/09 16:24:26 CET [2016/05/09 10:24:26 ET]
Table 'Merga II' 9-max Seat #9 is the button
Seat 1: ipashutapkom ($40.49 in chips) 
Seat 2: Filojoes ($100 in chips) 
Seat 3: xhinostrabli ($42.47 in chips) 
Seat 4: nubpoker ($100 in chips) 
Seat 5: LRVAV7 ($253.78 in chips) 
Seat 6: Spid1 ($301.88 in chips) 
Seat 7: matiko09 ($148.79 in chips) 
Seat 8: GrandOldFart ($95 in chips) 
Seat 9: chaps1988 ($238.40 in chips) 
ipashutapkom: posts small blind $0.50
Filojoes: posts big blind $1
*** HOLE CARDS ***
Dealt to matiko09 [7s 5s]
xhinostrabli: raises $1 to $2
nubpoker: folds 
LRVAV7: folds 
Spid1: folds 
matiko09: folds 
GrandOldFart: folds 
chaps1988: folds 
ipashutapkom: raises $4 to $6
Filojoes: folds 
xhinostrabli: calls $4
*** FLOP *** [Ks Th Kd]
ipashutapkom: bets $5.42
xhinostrabli: folds 
Uncalled bet ($5.42) returned to ipashutapkom
ipashutapkom collected $12.35 from pot
ipashutapkom: doesn't show hand 
*** SUMMARY ***
Total pot $13 | Rake $0.65 
Board [Ks Th Kd]
Seat 1: ipashutapkom (small blind) collected ($12.35)
Seat 2: Filojoes (big blind) folded before Flop
Seat 3: xhinostrabli folded on the Flop
Seat 4: nubpoker folded before Flop (didn't bet)
Seat 5: LRVAV7 folded before Flop (didn't bet)
Seat 6: Spid1 folded before Flop (didn't bet)
Seat 7: matiko09 folded before Flop (didn't bet)
Seat 8: GrandOldFart folded before Flop (didn't bet)
Seat 9: chaps1988 (button) folded before Flop (didn't bet)





PokerStars Hand #153066949306:  Hold'em No Limit ($0.50/$1.00 USD) - 2016/05/09 16:24:32 CET [2016/05/09 10:24:32 ET]
Table 'Isberga II' 9-max Seat #2 is the button
Seat 1: Kukuryzka ($102.75 in chips) 
Seat 2: Filojoes ($116.55 in chips) 
Seat 3: matiko09 ($100.29 in chips) 
Seat 4: ipashutapkom ($40 in chips) 
Seat 5: nubpoker ($108.48 in chips) 
Seat 6: vkartmann ($113.68 in chips) 
Seat 8: ozone2003 ($117.10 in chips) 
Seat 9: tubelight00 ($82.95 in chips) 
matiko09: posts small blind $0.50
ipashutapkom: posts big blind $1
flk.Dasas: sits out 
*** HOLE CARDS ***
Dealt to matiko09 [8h Jh]
nubpoker: raises $1.50 to $2.50
vkartmann: folds 
ozone2003: folds 
tubelight00: folds 
Kukuryzka: folds 
Filojoes: folds 
matiko09: folds 
ipashutapkom: folds 
Uncalled bet ($1.50) returned to nubpoker
nubpoker collected $2.50 from pot
nubpoker: doesn't show hand 
*** SUMMARY ***
Total pot $2.50 | Rake $0 
Seat 1: Kukuryzka folded before Flop (didn't bet)
Seat 2: Filojoes (button) folded before Flop (didn't bet)
Seat 3: matiko09 (small blind) folded before Flop
Seat 4: ipashutapkom (big blind) folded before Flop
Seat 5: nubpoker collected ($2.50)
Seat 6: vkartmann folded before Flop (didn't bet)
Seat 8: ozone2003 folded before Flop (didn't bet)
Seat 9: tubelight00 folded before Flop (didn't bet)





PokerStars Hand #153066951047:  Hold'em No Limit ($0.50/$1.00 USD) - 2016/05/09 16:24:35 CET [2016/05/09 10:24:35 ET]
Table 'Terpsichore' 9-max Seat #2 is the button
Seat 1: ipashutapkom ($63.86 in chips) 
Seat 2: J0k3rF4c3_FD ($146.87 in chips) 
Seat 3: matiko09 ($121.49 in chips) 
Seat 4: nubpoker ($100 in chips) 
Seat 5: mycka86 ($208.01 in chips) 
Seat 7: ozone2003 ($100 in chips) 
Seat 8: Kiosk230472 ($175.68 in chips) 
Seat 9: FTPbannedMe ($157.52 in chips) 
matiko09: posts small blind $0.50
nubpoker: posts big blind $1
Filojoes: sits out 
*** HOLE CARDS ***
Dealt to matiko09 [6d 5d]
mycka86: folds 
ozone2003: folds 
Kiosk230472: calls $1
FTPbannedMe: folds 
ipashutapkom: folds 
J0k3rF4c3_FD: folds 
matiko09: calls $0.50
nubpoker: checks 
*** FLOP *** [4d 7c 5c]
matiko09: bets $1.85
nubpoker: folds 
Kiosk230472: folds 
Uncalled bet ($1.85) returned to matiko09
matiko09 collected $2.85 from pot
matiko09: doesn't show hand 
*** SUMMARY ***
Total pot $3 | Rake $0.15 
Board [4d 7c 5c]
Seat 1: ipashutapkom folded before Flop (didn't bet)
Seat 2: J0k3rF4c3_FD (button) folded before Flop (didn't bet)
Seat 3: matiko09 (small blind) collected ($2.85)
Seat 4: nubpoker (big blind) folded on the Flop
Seat 5: mycka86 folded before Flop (didn't bet)
Seat 7: ozone2003 folded before Flop (didn't bet)
Seat 8: Kiosk230472 folded on the Flop
Seat 9: FTPbannedMe folded before Flop (didn't bet)





PokerStars Hand #153066956334:  Hold'em No Limit ($0.50/$1.00 USD) - 2016/05/09 16:24:44 CET [2016/05/09 10:24:44 ET]
Table 'Reiss' 9-max Seat #9 is the button
Seat 1: Dickyxxx ($198.18 in chips) 
Seat 2: mycka86 ($116.65 in chips) 
Seat 3: chaps1988 ($100 in chips) 
Seat 4: MichaLabam ($170.74 in chips) 
Seat 5: matiko09 ($117.25 in chips) 
Seat 6: Spid1 ($154.93 in chips) 
Seat 7: nubpoker ($100 in chips) 
Seat 8: Filojoes ($168.18 in chips) 
Seat 9: Aghmir77 ($104.21 in chips) 
Dickyxxx: posts small blind $0.50
mycka86: posts big blind $1
*** HOLE CARDS ***
Dealt to matiko09 [6d 7h]
chaps1988: folds 
MichaLabam: folds 
matiko09: folds 
Spid1: folds 
nubpoker: folds 
Filojoes: folds 
Aghmir77: folds 
Dickyxxx: raises $2 to $3
mycka86: folds 
Uncalled bet ($2) returned to Dickyxxx
Dickyxxx collected $2 from pot
Dickyxxx: doesn't show hand 
*** SUMMARY ***
Total pot $2 | Rake $0 
Seat 1: Dickyxxx (small blind) collected ($2)
Seat 2: mycka86 (big blind) folded before Flop
Seat 3: chaps1988 folded before Flop (didn't bet)
Seat 4: MichaLabam folded before Flop (didn't bet)
Seat 5: matiko09 folded before Flop (didn't bet)
Seat 6: Spid1 folded before Flop (didn't bet)
Seat 7: nubpoker folded before Flop (didn't bet)
Seat 8: Filojoes folded before Flop (didn't bet)
Seat 9: Aghmir77 (button) folded before Flop (didn't bet)





PokerStars Hand #153066959820:  Hold'em No Limit ($0.50/$1.00 USD) - 2016/05/09 16:24:50 CET [2016/05/09 10:24:50 ET]
Table 'Hajek' 9-max Seat #8 is the button
Seat 1: vkartmann ($100 in chips) 
Seat 2: Spid1 ($100 in chips) 
Seat 3: mycka86 ($121.97 in chips) 
Seat 4: LRVAV7 ($112.71 in chips) 
Seat 5: ozone2003 ($100 in chips) 
Seat 6: Filojoes ($100 in chips) 
Seat 7: DancerNN1 ($247.53 in chips) 
Seat 8: Kukuryzka ($99.30 in chips) 
Seat 9: matiko09 ($101.70 in chips) 
matiko09: posts small blind $0.50
vkartmann: posts big blind $1
vkartmann: posts the ante $0.20
Spid1: posts the ante $0.20
mycka86: posts the ante $0.20
LRVAV7: posts the ante $0.20
ozone2003: posts the ante $0.20
Filojoes: posts the ante $0.20
DancerNN1: posts the ante $0.20
Kukuryzka: posts the ante $0.20
matiko09: posts the ante $0.20
*** HOLE CARDS ***
Dealt to matiko09 [5h 5d]
Spid1: folds 
mycka86: folds 
LRVAV7: folds 
ozone2003: folds 
Filojoes: folds 
DancerNN1: folds 
Kukuryzka: raises $1 to $2
matiko09: calls $1.50
vkartmann: calls $1
*** FLOP *** [9h 6c 4h]
matiko09: checks 
vkartmann: bets $2.51
Kukuryzka: calls $2.51
matiko09: folds 
*** TURN *** [9h 6c 4h] [Ac]
vkartmann: checks 
Kukuryzka: checks 
*** RIVER *** [9h 6c 4h Ac] [Jc]
vkartmann: checks 
Kukuryzka: checks 
*** SHOW DOWN ***
vkartmann: shows [7s 7d] (a pair of Sevens)
Kukuryzka: shows [Ah 2h] (a pair of Aces)
Kukuryzka collected $12.18 from pot
*** SUMMARY ***
Total pot $12.82 | Rake $0.64 
Board [9h 6c 4h Ac Jc]
Seat 1: vkartmann (big blind) showed [7s 7d] and lost with a pair of Sevens
Seat 2: Spid1 folded before Flop (didn't bet)
Seat 3: mycka86 folded before Flop (didn't bet)
Seat 4: LRVAV7 folded before Flop (didn't bet)
Seat 5: ozone2003 folded before Flop (didn't bet)
Seat 6: Filojoes folded before Flop (didn't bet)
Seat 7: DancerNN1 folded before Flop (didn't bet)
Seat 8: Kukuryzka (button) showed [Ah 2h] and won ($12.18) with a pair of Aces
Seat 9: matiko09 (small blind) folded on the Flop





PokerStars Hand #153066961544:  Hold'em No Limit ($0.50/$1.00 USD) - 2016/05/09 16:24:52 CET [2016/05/09 10:24:52 ET]
Table 'Isberga II' 9-max Seat #3 is the button
Seat 1: Kukuryzka ($102.75 in chips) 
Seat 2: Filojoes ($116.55 in chips) 
Seat 3: matiko09 ($100 in chips) 
Seat 4: ipashutapkom ($40 in chips) 
Seat 5: nubpoker ($109.98 in chips) 
Seat 6: vkartmann ($113.68 in chips) 
Seat 8: ozone2003 ($117.10 in chips) 
Seat 9: tubelight00 ($82.95 in chips) 
ipashutapkom: posts small blind $0.50
nubpoker: posts big blind $1
flk.Dasas: sits out 
*** HOLE CARDS ***
Dealt to matiko09 [Jd 9h]
vkartmann: folds 
ozone2003: raises $2 to $3
tubelight00: raises $7.50 to $10.50
Kukuryzka: folds 
Filojoes: folds 
matiko09: folds 
ipashutapkom: folds 
nubpoker: folds 
ozone2003: raises $28.50 to $39
tubelight00: calls $28.50
*** FLOP *** [5c 8c 4c]
ozone2003: bets $78.10 and is all-in
ozone2003 said, "call"
tubelight00: calls $43.95 and is all-in
Uncalled bet ($34.15) returned to ozone2003
*** TURN *** [5c 8c 4c] [2h]
*** RIVER *** [5c 8c 4c 2h] [9s]
*** SHOW DOWN ***
ozone2003: shows [Qd Qc] (a pair of Queens)
tubelight00: shows [Kh Ad] (high card Ace)
ozone2003 collected $164.90 from pot
*** SUMMARY ***
Total pot $167.40 | Rake $2.50 
Board [5c 8c 4c 2h 9s]
Seat 1: Kukuryzka folded before Flop (didn't bet)
Seat 2: Filojoes folded before Flop (didn't bet)
Seat 3: matiko09 (button) folded before Flop (didn't bet)
Seat 4: ipashutapkom (small blind) folded before Flop
Seat 5: nubpoker (big blind) folded before Flop
Seat 6: vkartmann folded before Flop (didn't bet)
Seat 8: ozone2003 showed [Qd Qc] and won ($164.90) with a pair of Queens
Seat 9: tubelight00 showed [Kh Ad] and lost with high card Ace





PokerStars Hand #153066972997:  Hold'em No Limit ($0.50/$1.00 USD) - 2016/05/09 16:25:12 CET [2016/05/09 10:25:12 ET]
Table 'Reiss' 9-max Seat #1 is the button
Seat 1: Dickyxxx ($199.18 in chips) 
Seat 2: mycka86 ($115.65 in chips) 
Seat 3: chaps1988 ($100 in chips) 
Seat 4: MichaLabam ($170.74 in chips) 
Seat 5: matiko09 ($117.25 in chips) 
Seat 6: Spid1 ($154.93 in chips) 
Seat 7: nubpoker ($100 in chips) 
Seat 8: Filojoes ($168.18 in chips) 
Seat 9: Aghmir77 ($104.21 in chips) 
mycka86: posts small blind $0.50
chaps1988: posts big blind $1
*** HOLE CARDS ***
Dealt to matiko09 [Ks 5d]
MichaLabam: folds 
matiko09: folds 
Spid1: folds 
nubpoker: folds 
Filojoes: folds 
Aghmir77: folds 
Dickyxxx: folds 
mycka86: raises $1.75 to $2.75
chaps1988: raises $6.75 to $9.50
mycka86: folds 
Uncalled bet ($6.75) returned to chaps1988
chaps1988 collected $5.50 from pot
chaps1988: doesn't show hand 
*** SUMMARY ***
Total pot $5.50 | Rake $0 
Seat 1: Dickyxxx (button) folded before Flop (didn't bet)
Seat 2: mycka86 (small blind) folded before Flop
Seat 3: chaps1988 (big blind) collected ($5.50)
Seat 4: MichaLabam folded before Flop (didn't bet)
Seat 5: matiko09 folded before Flop (didn't bet)
Seat 6: Spid1 folded before Flop (didn't bet)
Seat 7: nubpoker folded before Flop (didn't bet)
Seat 8: Filojoes folded before Flop (didn't bet)
Seat 9: Aghmir77 folded before Flop (didn't bet)





PokerStars Hand #153066974443:  Hold'em No Limit ($0.50/$1.00 USD) - 2016/05/09 16:25:15 CET [2016/05/09 10:25:15 ET]
Table 'Orthos' 9-max Seat #6 is the button
Seat 1: Kelvin sai ($68.36 in chips) 
Seat 2: PacPacBum ($102.75 in chips) 
Seat 3: Filojoes ($108.73 in chips) 
Seat 4: nubpoker ($121.87 in chips) 
Seat 5: matiko09 ($107.08 in chips) 
Seat 6: xhinostrabli ($123.83 in chips) 
Seat 7: flk.Dasas ($104.08 in chips) 
Seat 8: Dickyxxx ($131.37 in chips) 
flk.Dasas: posts small blind $0.50
Dickyxxx: posts big blind $1
vkartmann: sits out 
*** HOLE CARDS ***
Dealt to matiko09 [5s Ac]
Kelvin sai: raises $1 to $2
PacPacBum: calls $2
Filojoes: folds 
nubpoker: folds 
matiko09: folds 
xhinostrabli: folds 
flk.Dasas: folds 
Dickyxxx: folds 
*** FLOP *** [Kd 3h 2d]
Kelvin sai: bets $3
PacPacBum: calls $3
*** TURN *** [Kd 3h 2d] [4c]
Kelvin sai: bets $5
PacPacBum: calls $5
*** RIVER *** [Kd 3h 2d 4c] [6s]
Kelvin sai: bets $12
PacPacBum: calls $12
*** SHOW DOWN ***
Kelvin sai: shows [4h 5h] (a straight, Deuce to Six)
PacPacBum: mucks hand 
Kelvin sai collected $43.22 from pot
*** SUMMARY ***
Total pot $45.50 | Rake $2.28 
Board [Kd 3h 2d 4c 6s]
Seat 1: Kelvin sai showed [4h 5h] and won ($43.22) with a straight, Deuce to Six
Seat 2: PacPacBum mucked [9c 9s]
Seat 3: Filojoes folded before Flop (didn't bet)
Seat 4: nubpoker folded before Flop (didn't bet)
Seat 5: matiko09 folded before Flop (didn't bet)
Seat 6: xhinostrabli (button) folded before Flop (didn't bet)
Seat 7: flk.Dasas (small blind) folded before Flop
Seat 8: Dickyxxx (big blind) folded before Flop





PokerStars Hand #153066975109:  Hold'em No Limit ($0.50/$1.00 USD) - 2016/05/09 16:25:16 CET [2016/05/09 10:25:16 ET]
Table 'Terpsichore' 9-max Seat #3 is the button
Seat 1: ipashutapkom ($63.86 in chips) 
Seat 2: J0k3rF4c3_FD ($146.87 in chips) 
Seat 3: matiko09 ($123.34 in chips) 
Seat 4: nubpoker ($100 in chips) 
Seat 5: mycka86 ($208.01 in chips) 
Seat 7: ozone2003 ($100 in chips) 
Seat 8: Kiosk230472 ($174.68 in chips) 
Seat 9: FTPbannedMe ($157.52 in chips) 
nubpoker: posts small blind $0.50
mycka86: posts big blind $1
Filojoes: sits out 
*** HOLE CARDS ***
Dealt to matiko09 [Jd 5s]
ozone2003: folds 
Kiosk230472: folds 
FTPbannedMe: folds 
ipashutapkom: folds 
J0k3rF4c3_FD: folds 
matiko09: folds 
nubpoker: folds 
Uncalled bet ($0.50) returned to mycka86
mycka86 collected $1 from pot
*** SUMMARY ***
Total pot $1 | Rake $0 
Seat 1: ipashutapkom folded before Flop (didn't bet)
Seat 2: J0k3rF4c3_FD folded before Flop (didn't bet)
Seat 3: matiko09 (button) folded before Flop (didn't bet)
Seat 4: nubpoker (small blind) folded before Flop
Seat 5: mycka86 (big blind) collected ($1)
Seat 7: ozone2003 folded before Flop (didn't bet)
Seat 8: Kiosk230472 folded before Flop (didn't bet)
Seat 9: FTPbannedMe folded before Flop (didn't bet)





PokerStars Hand #153066982558:  Hold'em No Limit ($1/$2 USD) - 2016/05/09 16:25:29 CET [2016/05/09 10:25:29 ET]
Table 'Hagar II' 9-max Seat #4 is the button
Seat 2: darren1031 ($209.94 in chips) 
Seat 4: matiko09 ($246.19 in chips) 
Seat 5: PacPacBum ($224.37 in chips) 
Seat 6: Iggso ($222.55 in chips) 
Seat 7: Monsthand ($200 in chips) 
Seat 8: J0k3rF4c3_FD ($380.60 in chips) 
Seat 9: chaps1988 ($208.63 in chips) 
PacPacBum: posts small blind $1
Iggso: posts big blind $2
*** HOLE CARDS ***
Dealt to matiko09 [Ks 9c]
Monsthand: folds 
J0k3rF4c3_FD: folds 
chaps1988: folds 
darren1031: calls $2
matiko09: raises $6 to $8
PacPacBum: folds 
Iggso: calls $6
darren1031: calls $6
*** FLOP *** [2s 3h Ad]
Iggso: checks 
darren1031: checks 
matiko09: bets $14
Iggso: folds 
darren1031: folds 
Uncalled bet ($14) returned to matiko09
matiko09 collected $23.75 from pot
matiko09: doesn't show hand 
*** SUMMARY ***
Total pot $25 | Rake $1.25 
Board [2s 3h Ad]
Seat 2: darren1031 folded on the Flop
Seat 4: matiko09 (button) collected ($23.75)
Seat 5: PacPacBum (small blind) folded before Flop
Seat 6: Iggso (big blind) folded on the Flop
Seat 7: Monsthand folded before Flop (didn't bet)
Seat 8: J0k3rF4c3_FD folded before Flop (didn't bet)
Seat 9: chaps1988 folded before Flop (didn't bet)





PokerStars Hand #153066990106:  Hold'em No Limit ($0.50/$1.00 USD) - 2016/05/09 16:25:41 CET [2016/05/09 10:25:41 ET]
Table 'Reiss' 9-max Seat #2 is the button
Seat 1: Dickyxxx ($199.18 in chips) 
Seat 2: mycka86 ($112.90 in chips) 
Seat 3: chaps1988 ($102.75 in chips) 
Seat 4: MichaLabam ($170.74 in chips) 
Seat 5: matiko09 ($117.25 in chips) 
Seat 6: Spid1 ($154.93 in chips) 
Seat 7: nubpoker ($100 in chips) 
Seat 8: Filojoes ($168.18 in chips) 
Seat 9: Aghmir77 ($104.21 in chips) 
chaps1988: posts small blind $0.50
MichaLabam: posts big blind $1
*** HOLE CARDS ***
Dealt to matiko09 [3s 2d]
matiko09: folds 
Spid1: folds 
nubpoker: folds 
Filojoes: folds 
Aghmir77: folds 
Dickyxxx: folds 
mycka86: raises $1.10 to $2.10
chaps1988: folds 
MichaLabam: calls $1.10
*** FLOP *** [Qh Ad 6h]
MichaLabam: checks 
mycka86: checks 
*** TURN *** [Qh Ad 6h] [Td]
MichaLabam: bets $2
mycka86: calls $2
*** RIVER *** [Qh Ad 6h Td] [4h]
MichaLabam: checks 
mycka86: bets $2.50
MichaLabam: folds 
Uncalled bet ($2.50) returned to mycka86
mycka86 collected $8.26 from pot
*** SUMMARY ***
Total pot $8.70 | Rake $0.44 
Board [Qh Ad 6h Td 4h]
Seat 1: Dickyxxx folded before Flop (didn't bet)
Seat 2: mycka86 (button) collected ($8.26)
Seat 3: chaps1988 (small blind) folded before Flop
Seat 4: MichaLabam (big blind) folded on the River
Seat 5: matiko09 folded before Flop (didn't bet)
Seat 6: Spid1 folded before Flop (didn't bet)
Seat 7: nubpoker folded before Flop (didn't bet)
Seat 8: Filojoes folded before Flop (didn't bet)
Seat 9: Aghmir77 folded before Flop (didn't bet)





PokerStars Hand #153066989620:  Hold'em No Limit ($0.50/$1.00 USD) - 2016/05/09 16:25:41 CET [2016/05/09 10:25:41 ET]
Table 'Merga II' 9-max Seat #1 is the button
Seat 1: ipashutapkom ($46.84 in chips) 
Seat 2: Filojoes ($100 in chips) 
Seat 3: xhinostrabli ($36.47 in chips) 
Seat 4: nubpoker ($100 in chips) 
Seat 5: LRVAV7 ($253.78 in chips) 
Seat 6: Spid1 ($301.88 in chips) 
Seat 7: matiko09 ($148.79 in chips) 
Seat 8: GrandOldFart ($100 in chips) 
Seat 9: chaps1988 ($238.40 in chips) 
Filojoes: posts small blind $0.50
xhinostrabli: posts big blind $1
*** HOLE CARDS ***
Dealt to matiko09 [8h Ac]
nubpoker: raises $1.50 to $2.50
LRVAV7: folds 
Spid1: folds 
matiko09: folds 
GrandOldFart: folds 
chaps1988: calls $2.50
ipashutapkom: folds 
Filojoes: calls $2
xhinostrabli: folds 
*** FLOP *** [3s 2c Jd]
Filojoes: checks 
nubpoker: bets $5.38
chaps1988: calls $5.38
Filojoes: folds 
*** TURN *** [3s 2c Jd] [3c]
nubpoker: bets $11.50
chaps1988: folds 
Uncalled bet ($11.50) returned to nubpoker
nubpoker collected $18.30 from pot
nubpoker: doesn't show hand 
*** SUMMARY ***
Total pot $19.26 | Rake $0.96 
Board [3s 2c Jd 3c]
Seat 1: ipashutapkom (button) folded before Flop (didn't bet)
Seat 2: Filojoes (small blind) folded on the Flop
Seat 3: xhinostrabli (big blind) folded before Flop
Seat 4: nubpoker collected ($18.30)
Seat 5: LRVAV7 folded before Flop (didn't bet)
Seat 6: Spid1 folded before Flop (didn't bet)
Seat 7: matiko09 folded before Flop (didn't bet)
Seat 8: GrandOldFart folded before Flop (didn't bet)
Seat 9: chaps1988 folded on the Turn





PokerStars Hand #153066992498:  Hold'em No Limit ($0.50/$1.00 USD) - 2016/05/09 16:25:46 CET [2016/05/09 10:25:46 ET]
Table 'Alderamin' 9-max Seat #7 is the button
Seat 2: Filojoes ($126.01 in chips) 
Seat 3: NSL0808 ($51.37 in chips) 
Seat 4: matiko09 ($106 in chips) 
Seat 5: tanmayh ($35.59 in chips) 
Seat 6: Spid1 ($152.48 in chips) 
Seat 7: azzad2007 ($133.94 in chips) 
Seat 8: nubpoker ($100.50 in chips) 
Seat 9: ipashutapkom ($66.60 in chips) 
nubpoker: posts small blind $0.50
ipashutapkom: posts big blind $1
XTLMZUWR: sits out 
*** HOLE CARDS ***
Dealt to matiko09 [Kd 5s]
Filojoes: folds 
NSL0808: folds 
matiko09: folds 
tanmayh: raises $2 to $3
Spid1: folds 
azzad2007: folds 
nubpoker: calls $2.50
ipashutapkom: calls $2
*** FLOP *** [Jh Ks 9h]
nubpoker: checks 
ipashutapkom: checks 
tanmayh: checks 
*** TURN *** [Jh Ks 9h] [4d]
nubpoker: bets $5.69
ipashutapkom: calls $5.69
tanmayh: folds 
*** RIVER *** [Jh Ks 9h 4d] [Ad]
nubpoker: checks 
ipashutapkom: checks 
*** SHOW DOWN ***
nubpoker: shows [Kc Qc] (a pair of Kings)
ipashutapkom: mucks hand 
nubpoker collected $19.36 from pot
*** SUMMARY ***
Total pot $20.38 | Rake $1.02 
Board [Jh Ks 9h 4d Ad]
Seat 2: Filojoes folded before Flop (didn't bet)
Seat 3: NSL0808 folded before Flop (didn't bet)
Seat 4: matiko09 folded before Flop (didn't bet)
Seat 5: tanmayh folded on the Turn
Seat 6: Spid1 folded before Flop (didn't bet)
Seat 7: azzad2007 (button) folded before Flop (didn't bet)
Seat 8: nubpoker (small blind) showed [Kc Qc] and won ($19.36) with a pair of Kings
Seat 9: ipashutapkom (big blind) mucked [Td Jc]





PokerStars Hand #153066999092:  Hold'em No Limit ($0.50/$1.00 USD) - 2016/05/09 16:25:57 CET [2016/05/09 10:25:57 ET]
Table 'Terpsichore' 9-max Seat #4 is the button
Seat 1: ipashutapkom ($63.86 in chips) 
Seat 2: J0k3rF4c3_FD ($146.87 in chips) 
Seat 3: matiko09 ($123.34 in chips) 
Seat 4: nubpoker ($100 in chips) 
Seat 5: mycka86 ($208.51 in chips) 
Seat 6: Filojoes ($110.09 in chips) 
Seat 7: ozone2003 ($100 in chips) 
Seat 8: Kiosk230472 ($174.68 in chips) 
Seat 9: FTPbannedMe ($157.52 in chips) 
mycka86: posts small blind $0.50
Filojoes: posts big blind $1
*** HOLE CARDS ***
Dealt to matiko09 [7h 4c]
ozone2003: folds 
Kiosk230472: calls $1
FTPbannedMe: folds 
ipashutapkom: raises $3.26 to $4.26
J0k3rF4c3_FD: folds 
matiko09: folds 
nubpoker: folds 
mycka86: folds 
Filojoes: folds 
Kiosk230472: folds 
Uncalled bet ($3.26) returned to ipashutapkom
ipashutapkom collected $3.50 from pot
ipashutapkom: doesn't show hand 
*** SUMMARY ***
Total pot $3.50 | Rake $0 
Seat 1: ipashutapkom collected ($3.50)
Seat 2: J0k3rF4c3_FD folded before Flop (didn't bet)
Seat 3: matiko09 folded before Flop (didn't bet)
Seat 4: nubpoker (button) folded before Flop (didn't bet)
Seat 5: mycka86 (small blind) folded before Flop
Seat 6: Filojoes (big blind) folded before Flop
Seat 7: ozone2003 folded before Flop (didn't bet)
Seat 8: Kiosk230472 folded before Flop
Seat 9: FTPbannedMe folded before Flop (didn't bet)





PokerStars Hand #153067005306:  Hold'em No Limit ($0.50/$1.00 USD) - 2016/05/09 16:26:08 CET [2016/05/09 10:26:08 ET]
Table 'Hajek' 9-max Seat #9 is the button
Seat 1: vkartmann ($100 in chips) 
Seat 2: Spid1 ($100 in chips) 
Seat 3: mycka86 ($121.77 in chips) 
Seat 4: LRVAV7 ($112.51 in chips) 
Seat 5: ozone2003 ($100 in chips) 
Seat 6: Filojoes ($100 in chips) 
Seat 7: DancerNN1 ($247.33 in chips) 
Seat 8: Kukuryzka ($106.77 in chips) 
Seat 9: matiko09 ($100 in chips) 
vkartmann: posts small blind $0.50
Spid1: posts big blind $1
vkartmann: posts the ante $0.20
Spid1: posts the ante $0.20
mycka86: posts the ante $0.20
LRVAV7: posts the ante $0.20
ozone2003: posts the ante $0.20
Filojoes: posts the ante $0.20
DancerNN1: posts the ante $0.20
Kukuryzka: posts the ante $0.20
matiko09: posts the ante $0.20
*** HOLE CARDS ***
Dealt to matiko09 [6s Ks]
mycka86: folds 
LRVAV7: folds 
ozone2003: folds 
Filojoes: raises $2 to $3
DancerNN1: folds 
Kukuryzka: folds 
matiko09: folds 
vkartmann: folds 
Spid1: folds 
Uncalled bet ($2) returned to Filojoes
Filojoes collected $4.30 from pot
Filojoes: doesn't show hand 
*** SUMMARY ***
Total pot $4.30 | Rake $0 
Seat 1: vkartmann (small blind) folded before Flop
Seat 2: Spid1 (big blind) folded before Flop
Seat 3: mycka86 folded before Flop (didn't bet)
Seat 4: LRVAV7 folded before Flop (didn't bet)
Seat 5: ozone2003 folded before Flop (didn't bet)
Seat 6: Filojoes collected ($4.30)
Seat 7: DancerNN1 folded before Flop (didn't bet)
Seat 8: Kukuryzka folded before Flop (didn't bet)
Seat 9: matiko09 (button) folded before Flop (didn't bet)





PokerStars Hand #153067009940:  Hold'em No Limit ($1/$2 USD) - 2016/05/09 16:26:15 CET [2016/05/09 10:26:15 ET]
Table 'Hagar II' 9-max Seat #5 is the button
Seat 2: darren1031 ($201.94 in chips) 
Seat 4: matiko09 ($261.94 in chips) 
Seat 5: PacPacBum ($223.37 in chips) 
Seat 6: Iggso ($214.55 in chips) 
Seat 7: Monsthand ($200 in chips) 
Seat 8: J0k3rF4c3_FD ($380.60 in chips) 
Seat 9: chaps1988 ($208.63 in chips) 
Iggso: posts small blind $1
Monsthand: posts big blind $2
*** HOLE CARDS ***
Dealt to matiko09 [2s 8d]
J0k3rF4c3_FD: folds 
chaps1988: raises $3 to $5
darren1031: folds 
matiko09: folds 
PacPacBum: folds 
Iggso: folds 
Monsthand: folds 
Uncalled bet ($3) returned to chaps1988
chaps1988 collected $5 from pot
chaps1988: doesn't show hand 
*** SUMMARY ***
Total pot $5 | Rake $0 
Seat 2: darren1031 folded before Flop (didn't bet)
Seat 4: matiko09 folded before Flop (didn't bet)
Seat 5: PacPacBum (button) folded before Flop (didn't bet)
Seat 6: Iggso (small blind) folded before Flop
Seat 7: Monsthand (big blind) folded before Flop
Seat 8: J0k3rF4c3_FD folded before Flop (didn't bet)
Seat 9: chaps1988 collected ($5)





PokerStars Hand #153067017997:  Hold'em No Limit ($0.50/$1.00 USD) - 2016/05/09 16:26:29 CET [2016/05/09 10:26:29 ET]
Table 'Isberga II' 9-max Seat #4 is the button
Seat 1: Kukuryzka ($102.75 in chips) 
Seat 2: Filojoes ($116.55 in chips) 
Seat 3: matiko09 ($100 in chips) 
Seat 4: ipashutapkom ($40 in chips) 
Seat 5: nubpoker ($108.98 in chips) 
Seat 6: vkartmann ($113.68 in chips) 
Seat 8: ozone2003 ($199.05 in chips) 
nubpoker: posts small blind $0.50
vkartmann: posts big blind $1
flk.Dasas: sits out 
*** HOLE CARDS ***
Dealt to matiko09 [Ad Ks]
tubelight00 leaves the table
ozone2003: folds 
Kukuryzka: folds 
Filojoes: folds 
matiko09: raises $1.50 to $2.50
ipashutapkom: folds 
nubpoker: folds 
vkartmann: folds 
Uncalled bet ($1.50) returned to matiko09
matiko09 collected $2.50 from pot
matiko09: doesn't show hand 
*** SUMMARY ***
Total pot $2.50 | Rake $0 
Seat 1: Kukuryzka folded before Flop (didn't bet)
Seat 2: Filojoes folded before Flop (didn't bet)
Seat 3: matiko09 collected ($2.50)
Seat 4: ipashutapkom (button) folded before Flop (didn't bet)
Seat 5: nubpoker (small blind) folded before Flop
Seat 6: vkartmann (big blind) folded before Flop
Seat 8: ozone2003 folded before Flop (didn't bet)





PokerStars Hand #153067022442:  Hold'em No Limit ($1/$2 USD) - 2016/05/09 16:26:37 CET [2016/05/09 10:26:37 ET]
Table 'Hagar II' 9-max Seat #6 is the button
Seat 2: darren1031 ($201.94 in chips) 
Seat 4: matiko09 ($261.94 in chips) 
Seat 5: PacPacBum ($223.37 in chips) 
Seat 6: Iggso ($213.55 in chips) 
Seat 7: Monsthand ($200 in chips) 
Seat 8: J0k3rF4c3_FD ($380.60 in chips) 
Seat 9: chaps1988 ($211.63 in chips) 
Monsthand: posts small blind $1
J0k3rF4c3_FD: posts big blind $2
*** HOLE CARDS ***
Dealt to matiko09 [Kh Jc]
chaps1988: raises $4 to $6
darren1031: calls $6
matiko09: folds 
PacPacBum: folds 
Iggso: folds 
Monsthand: folds 
J0k3rF4c3_FD: calls $4
*** FLOP *** [4s 9c 2d]
J0k3rF4c3_FD: checks 
chaps1988: bets $12
darren1031: raises $12 to $24
J0k3rF4c3_FD: calls $24
chaps1988: folds 
*** TURN *** [4s 9c 2d] [3h]
J0k3rF4c3_FD: checks 
darren1031: bets $38.12
J0k3rF4c3_FD: calls $38.12
*** RIVER *** [4s 9c 2d 3h] [Kc]
J0k3rF4c3_FD: checks 
darren1031: checks 
*** SHOW DOWN ***
J0k3rF4c3_FD: shows [9s Js] (a pair of Nines)
darren1031: mucks hand 
J0k3rF4c3_FD collected $152.49 from pot
*** SUMMARY ***
Total pot $155.24 | Rake $2.75 
Board [4s 9c 2d 3h Kc]
Seat 2: darren1031 mucked [5s 5h]
Seat 4: matiko09 folded before Flop (didn't bet)
Seat 5: PacPacBum folded before Flop (didn't bet)
Seat 6: Iggso (button) folded before Flop (didn't bet)
Seat 7: Monsthand (small blind) folded before Flop
Seat 8: J0k3rF4c3_FD (big blind) showed [9s Js] and won ($152.49) with a pair of Nines
Seat 9: chaps1988 folded on the Flop





PokerStars Hand #153067026507:  Hold'em No Limit ($0.50/$1.00 USD) - 2016/05/09 16:26:44 CET [2016/05/09 10:26:44 ET]
Table 'Hajek' 9-max Seat #1 is the button
Seat 1: vkartmann ($100 in chips) 
Seat 2: Spid1 ($100 in chips) 
Seat 3: mycka86 ($121.57 in chips) 
Seat 4: LRVAV7 ($112.31 in chips) 
Seat 5: ozone2003 ($100 in chips) 
Seat 6: Filojoes ($103.10 in chips) 
Seat 7: DancerNN1 ($247.13 in chips) 
Seat 8: Kukuryzka ($106.57 in chips) 
Seat 9: matiko09 ($100 in chips) 
Spid1: posts small blind $0.50
mycka86: posts big blind $1
vkartmann: posts the ante $0.20
Spid1: posts the ante $0.20
mycka86: posts the ante $0.20
LRVAV7: posts the ante $0.20
ozone2003: posts the ante $0.20
Filojoes: posts the ante $0.20
DancerNN1: posts the ante $0.20
Kukuryzka: posts the ante $0.20
matiko09: posts the ante $0.20
*** HOLE CARDS ***
Dealt to matiko09 [Td 6c]
LRVAV7: folds 
ozone2003: folds 
Filojoes: folds 
DancerNN1: folds 
Kukuryzka: folds 
matiko09: folds 
vkartmann: raises $2 to $3
Spid1: folds 
mycka86: calls $2
*** FLOP *** [Kd 2s 5c]
mycka86: checks 
vkartmann: checks 
*** TURN *** [Kd 2s 5c] [4c]
mycka86: bets $5.50
vkartmann: calls $5.50
*** RIVER *** [Kd 2s 5c 4c] [8c]
mycka86: bets $12.50
vkartmann: calls $12.50
*** SHOW DOWN ***
mycka86: shows [Ks 8d] (two pair, Kings and Eights)
vkartmann: mucks hand 
mycka86 collected $42.08 from pot
*** SUMMARY ***
Total pot $44.30 | Rake $2.22 
Board [Kd 2s 5c 4c 8c]
Seat 1: vkartmann (button) mucked [Ad Ac]
Seat 2: Spid1 (small blind) folded before Flop
Seat 3: mycka86 (big blind) showed [Ks 8d] and won ($42.08) with two pair, Kings and Eights
Seat 4: LRVAV7 folded before Flop (didn't bet)
Seat 5: ozone2003 folded before Flop (didn't bet)
Seat 6: Filojoes folded before Flop (didn't bet)
Seat 7: DancerNN1 folded before Flop (didn't bet)
Seat 8: Kukuryzka folded before Flop (didn't bet)
Seat 9: matiko09 folded before Flop (didn't bet)





PokerStars Hand #153067026600:  Hold'em No Limit ($0.50/$1.00 USD) - 2016/05/09 16:26:44 CET [2016/05/09 10:26:44 ET]
Table 'Reiss' 9-max Seat #3 is the button
Seat 1: Dickyxxx ($199.18 in chips) 
Seat 2: mycka86 ($117.06 in chips) 
Seat 3: chaps1988 ($102.25 in chips) 
Seat 4: MichaLabam ($166.64 in chips) 
Seat 5: matiko09 ($117.25 in chips) 
Seat 6: Spid1 ($154.93 in chips) 
Seat 7: nubpoker ($100 in chips) 
Seat 8: Filojoes ($168.18 in chips) 
Seat 9: Aghmir77 ($104.21 in chips) 
MichaLabam: posts small blind $0.50
matiko09: posts big blind $1
*** HOLE CARDS ***
Dealt to matiko09 [6h Td]
Spid1: folds 
nubpoker: raises $1.50 to $2.50
Filojoes: folds 
Aghmir77: folds 
Dickyxxx: folds 
mycka86: folds 
chaps1988: folds 
MichaLabam: folds 
matiko09: folds 
Uncalled bet ($1.50) returned to nubpoker
nubpoker collected $2.50 from pot
nubpoker: doesn't show hand 
*** SUMMARY ***
Total pot $2.50 | Rake $0 
Seat 1: Dickyxxx folded before Flop (didn't bet)
Seat 2: mycka86 folded before Flop (didn't bet)
Seat 3: chaps1988 (button) folded before Flop (didn't bet)
Seat 4: MichaLabam (small blind) folded before Flop
Seat 5: matiko09 (big blind) folded before Flop
Seat 6: Spid1 folded before Flop (didn't bet)
Seat 7: nubpoker collected ($2.50)
Seat 8: Filojoes folded before Flop (didn't bet)
Seat 9: Aghmir77 folded before Flop (didn't bet)





PokerStars Hand #153067032119:  Hold'em No Limit ($0.50/$1.00 USD) - 2016/05/09 16:26:53 CET [2016/05/09 10:26:53 ET]
Table 'Orthos' 9-max Seat #7 is the button
Seat 1: Kelvin sai ($89.58 in chips) 
Seat 2: PacPacBum ($100 in chips) 
Seat 3: Filojoes ($108.73 in chips) 
Seat 4: nubpoker ($121.87 in chips) 
Seat 5: matiko09 ($107.08 in chips) 
Seat 6: xhinostrabli ($123.83 in chips) 
Seat 7: flk.Dasas ($103.58 in chips) 
Seat 8: Dickyxxx ($130.37 in chips) 
Seat 9: vkartmann ($100 in chips) 
Dickyxxx: posts small blind $0.50
vkartmann: posts big blind $1
*** HOLE CARDS ***
Dealt to matiko09 [4c 8c]
Kelvin sai: raises $1 to $2
PacPacBum: folds 
Filojoes: raises $5.50 to $7.50
nubpoker: folds 
matiko09: folds 
xhinostrabli: folds 
flk.Dasas: folds 
Dickyxxx: folds 
vkartmann: folds 
Kelvin sai: folds 
Uncalled bet ($5.50) returned to Filojoes
Filojoes collected $5.50 from pot
Filojoes: doesn't show hand 
*** SUMMARY ***
Total pot $5.50 | Rake $0 
Seat 1: Kelvin sai folded before Flop
Seat 2: PacPacBum folded before Flop (didn't bet)
Seat 3: Filojoes collected ($5.50)
Seat 4: nubpoker folded before Flop (didn't bet)
Seat 5: matiko09 folded before Flop (didn't bet)
Seat 6: xhinostrabli folded before Flop (didn't bet)
Seat 7: flk.Dasas (button) folded before Flop (didn't bet)
Seat 8: Dickyxxx (small blind) folded before Flop
Seat 9: vkartmann (big blind) folded before Flop





PokerStars Hand #153067040789:  Hold'em No Limit ($0.50/$1.00 USD) - 2016/05/09 16:27:08 CET [2016/05/09 10:27:08 ET]
Table 'Merga II' 9-max Seat #2 is the button
Seat 1: ipashutapkom ($46.84 in chips) 
Seat 2: Filojoes ($100 in chips) 
Seat 3: xhinostrabli ($35.47 in chips) 
Seat 4: nubpoker ($110.42 in chips) 
Seat 5: LRVAV7 ($253.78 in chips) 
Seat 6: Spid1 ($301.88 in chips) 
Seat 7: matiko09 ($148.79 in chips) 
Seat 8: GrandOldFart ($100 in chips) 
Seat 9: chaps1988 ($230.52 in chips) 
xhinostrabli: posts small blind $0.50
nubpoker: posts big blind $1
*** HOLE CARDS ***
Dealt to matiko09 [3s 7c]
LRVAV7: folds 
Spid1: raises $2 to $3
matiko09: folds 
GrandOldFart: folds 
chaps1988: folds 
ipashutapkom: folds 
Filojoes: folds 
xhinostrabli: folds 
nubpoker: calls $2
*** FLOP *** [8c Td 4s]
nubpoker: checks 
Spid1: checks 
*** TURN *** [8c Td 4s] [6s]
nubpoker: checks 
Spid1: bets $4
nubpoker: raises $9.45 to $13.45
Spid1: folds 
Uncalled bet ($9.45) returned to nubpoker
nubpoker collected $13.78 from pot
nubpoker: doesn't show hand 
*** SUMMARY ***
Total pot $14.50 | Rake $0.72 
Board [8c Td 4s 6s]
Seat 1: ipashutapkom folded before Flop (didn't bet)
Seat 2: Filojoes (button) folded before Flop (didn't bet)
Seat 3: xhinostrabli (small blind) folded before Flop
Seat 4: nubpoker (big blind) collected ($13.78)
Seat 5: LRVAV7 folded before Flop (didn't bet)
Seat 6: Spid1 folded on the Turn
Seat 7: matiko09 folded before Flop (didn't bet)
Seat 8: GrandOldFart folded before Flop (didn't bet)
Seat 9: chaps1988 folded before Flop (didn't bet)





PokerStars Hand #153067041622:  Hold'em No Limit ($0.50/$1.00 USD) - 2016/05/09 16:27:10 CET [2016/05/09 10:27:10 ET]
Table 'Terpsichore' 9-max Seat #5 is the button
Seat 1: ipashutapkom ($66.36 in chips) 
Seat 2: J0k3rF4c3_FD ($146.87 in chips) 
Seat 3: matiko09 ($123.34 in chips) 
Seat 4: nubpoker ($100 in chips) 
Seat 5: mycka86 ($208.01 in chips) 
Seat 6: Filojoes ($109.09 in chips) 
Seat 7: ozone2003 ($100 in chips) 
Seat 8: Kiosk230472 ($173.68 in chips) 
Seat 9: FTPbannedMe ($157.52 in chips) 
Filojoes: posts small blind $0.50
ozone2003: posts big blind $1
*** HOLE CARDS ***
Dealt to matiko09 [4d 3s]
Kiosk230472 has timed out
Kiosk230472: folds 
FTPbannedMe: raises $1.50 to $2.50
ipashutapkom: folds 
J0k3rF4c3_FD: folds 
matiko09: folds 
nubpoker: calls $2.50
mycka86: calls $2.50
Filojoes: folds 
ozone2003: calls $1.50
*** FLOP *** [Tc Td 6d]
ozone2003: checks 
FTPbannedMe: checks 
nubpoker: checks 
mycka86: bets $6.80
ozone2003: folds 
FTPbannedMe: folds 
nubpoker: folds 
Uncalled bet ($6.80) returned to mycka86
mycka86 collected $9.98 from pot
*** SUMMARY ***
Total pot $10.50 | Rake $0.52 
Board [Tc Td 6d]
Seat 1: ipashutapkom folded before Flop (didn't bet)
Seat 2: J0k3rF4c3_FD folded before Flop (didn't bet)
Seat 3: matiko09 folded before Flop (didn't bet)
Seat 4: nubpoker folded on the Flop
Seat 5: mycka86 (button) collected ($9.98)
Seat 6: Filojoes (small blind) folded before Flop
Seat 7: ozone2003 (big blind) folded on the Flop
Seat 8: Kiosk230472 folded before Flop (didn't bet)
Seat 9: FTPbannedMe folded on the Flop





PokerStars Hand #153067042149:  Hold'em No Limit ($0.50/$1.00 USD) - 2016/05/09 16:27:10 CET [2016/05/09 10:27:10 ET]
Table 'Reiss' 9-max Seat #4 is the button
Seat 1: Dickyxxx ($199.18 in chips) 
Seat 2: mycka86 ($117.06 in chips) 
Seat 3: chaps1988 ($102.25 in chips) 
Seat 4: MichaLabam ($166.14 in chips) 
Seat 5: matiko09 ($116.25 in chips) 
Seat 6: Spid1 ($154.93 in chips) 
Seat 7: nubpoker ($101.50 in chips) 
Seat 8: Filojoes ($168.18 in chips) 
Seat 9: Aghmir77 ($104.21 in chips) 
matiko09: posts small blind $0.50
Spid1: posts big blind $1
*** HOLE CARDS ***
Dealt to matiko09 [7c 8h]
nubpoker: folds 
Filojoes: folds 
Aghmir77: folds 
Dickyxxx: raises $2 to $3
mycka86: folds 
chaps1988: folds 
MichaLabam: calls $3
matiko09: folds 
Spid1: calls $2
*** FLOP *** [5h 5s 6s]
Spid1: checks 
Dickyxxx: bets $6.01
MichaLabam: calls $6.01
Spid1: calls $6.01
*** TURN *** [5h 5s 6s] [3d]
Spid1: checks 
Dickyxxx: checks 
MichaLabam: checks 
*** RIVER *** [5h 5s 6s 3d] [8s]
Spid1: bets $18
Dickyxxx: folds 
MichaLabam: folds 
Uncalled bet ($18) returned to Spid1
Spid1 collected $26.15 from pot
Spid1: doesn't show hand 
*** SUMMARY ***
Total pot $27.53 | Rake $1.38 
Board [5h 5s 6s 3d 8s]
Seat 1: Dickyxxx folded on the River
Seat 2: mycka86 folded before Flop (didn't bet)
Seat 3: chaps1988 folded before Flop (didn't bet)
Seat 4: MichaLabam (button) folded on the River
Seat 5: matiko09 (small blind) folded before Flop
Seat 6: Spid1 (big blind) collected ($26.15)
Seat 7: nubpoker folded before Flop (didn't bet)
Seat 8: Filojoes folded before Flop (didn't bet)
Seat 9: Aghmir77 folded before Flop (didn't bet)





PokerStars Hand #153067042843:  Hold'em No Limit ($0.50/$1.00 USD) - 2016/05/09 16:27:12 CET [2016/05/09 10:27:12 ET]
Table 'Isberga II' 9-max Seat #5 is the button
Seat 1: Kukuryzka ($102.75 in chips) 
Seat 2: Filojoes ($116.55 in chips) 
Seat 3: matiko09 ($101.50 in chips) 
Seat 4: ipashutapkom ($40 in chips) 
Seat 5: nubpoker ($108.48 in chips) 
Seat 6: vkartmann ($112.68 in chips) 
Seat 7: flk.Dasas ($100 in chips) 
Seat 8: ozone2003 ($199.05 in chips) 
vkartmann: posts small blind $0.50
flk.Dasas: posts big blind $1
*** HOLE CARDS ***
Dealt to matiko09 [8c Ad]
ozone2003: folds 
ozone2003 leaves the table
Kukuryzka: folds 
PacPacBum joins the table at seat #8 
Filojoes: folds 
matiko09: folds 
ipashutapkom: folds 
nubpoker: raises $1.50 to $2.50
vkartmann: folds 
flk.Dasas: folds 
Uncalled bet ($1.50) returned to nubpoker
nubpoker collected $2.50 from pot
nubpoker: doesn't show hand 
*** SUMMARY ***
Total pot $2.50 | Rake $0 
Seat 1: Kukuryzka folded before Flop (didn't bet)
Seat 2: Filojoes folded before Flop (didn't bet)
Seat 3: matiko09 folded before Flop (didn't bet)
Seat 4: ipashutapkom folded before Flop (didn't bet)
Seat 5: nubpoker (button) collected ($2.50)
Seat 6: vkartmann (small blind) folded before Flop
Seat 7: flk.Dasas (big blind) folded before Flop
Seat 8: ozone2003 folded before Flop (didn't bet)





PokerStars Hand #153067045804:  Hold'em No Limit ($0.50/$1.00 USD) - 2016/05/09 16:27:17 CET [2016/05/09 10:27:17 ET]
Table 'Alderamin' 9-max Seat #8 is the button
Seat 1: XTLMZUWR ($100 in chips) 
Seat 2: Filojoes ($126.01 in chips) 
Seat 3: NSL0808 ($51.37 in chips) 
Seat 4: matiko09 ($106 in chips) 
Seat 5: tanmayh ($32.59 in chips) 
Seat 6: Spid1 ($152.48 in chips) 
Seat 7: azzad2007 ($133.94 in chips) 
Seat 8: nubpoker ($111.17 in chips) 
Seat 9: ipashutapkom ($57.91 in chips) 
ipashutapkom: posts small blind $0.50
XTLMZUWR: posts big blind $1
*** HOLE CARDS ***
Dealt to matiko09 [7h 3s]
Filojoes: folds 
NSL0808: folds 
matiko09: folds 
tanmayh: calls $1
Spid1: folds 
azzad2007: folds 
nubpoker: folds 
ipashutapkom: raises $3.26 to $4.26
XTLMZUWR: folds 
tanmayh: calls $3.26
*** FLOP *** [Ks Jc Kh]
ipashutapkom: bets $5.56
tanmayh: folds 
Uncalled bet ($5.56) returned to ipashutapkom
ipashutapkom collected $9.04 from pot
ipashutapkom: doesn't show hand 
*** SUMMARY ***
Total pot $9.52 | Rake $0.48 
Board [Ks Jc Kh]
Seat 1: XTLMZUWR (big blind) folded before Flop
Seat 2: Filojoes folded before Flop (didn't bet)
Seat 3: NSL0808 folded before Flop (didn't bet)
Seat 4: matiko09 folded before Flop (didn't bet)
Seat 5: tanmayh folded on the Flop
Seat 6: Spid1 folded before Flop (didn't bet)
Seat 7: azzad2007 folded before Flop (didn't bet)
Seat 8: nubpoker (button) folded before Flop (didn't bet)
Seat 9: ipashutapkom (small blind) collected ($9.04)





PokerStars Hand #153067058927:  Hold'em No Limit ($0.50/$1.00 USD) - 2016/05/09 16:27:39 CET [2016/05/09 10:27:39 ET]
Table 'Orthos' 9-max Seat #8 is the button
Seat 1: Kelvin sai ($87.58 in chips) 
Seat 2: PacPacBum ($100 in chips) 
Seat 3: Filojoes ($112.23 in chips) 
Seat 4: nubpoker ($121.87 in chips) 
Seat 5: matiko09 ($107.08 in chips) 
Seat 6: xhinostrabli ($123.83 in chips) 
Seat 7: flk.Dasas ($103.58 in chips) 
Seat 8: Dickyxxx ($129.87 in chips) 
Seat 9: vkartmann ($100 in chips) 
vkartmann: posts small blind $0.50
Kelvin sai: posts big blind $1
*** HOLE CARDS ***
Dealt to matiko09 [3c 2c]
PacPacBum: raises $1.50 to $2.50
Filojoes: folds 
nubpoker: folds 
matiko09: folds 
xhinostrabli: calls $2.50
flk.Dasas: folds 
Dickyxxx: folds 
vkartmann: folds 
Kelvin sai: folds 
*** FLOP *** [Jh 9c Kc]
PacPacBum: checks 
xhinostrabli: bets $4
PacPacBum: folds 
Uncalled bet ($4) returned to xhinostrabli
xhinostrabli collected $6.18 from pot
*** SUMMARY ***
Total pot $6.50 | Rake $0.32 
Board [Jh 9c Kc]
Seat 1: Kelvin sai (big blind) folded before Flop
Seat 2: PacPacBum folded on the Flop
Seat 3: Filojoes folded before Flop (didn't bet)
Seat 4: nubpoker folded before Flop (didn't bet)
Seat 5: matiko09 folded before Flop (didn't bet)
Seat 6: xhinostrabli collected ($6.18)
Seat 7: flk.Dasas folded before Flop (didn't bet)
Seat 8: Dickyxxx (button) folded before Flop (didn't bet)
Seat 9: vkartmann (small blind) folded before Flop





PokerStars Hand #153067067811:  Hold'em No Limit ($0.50/$1.00 USD) - 2016/05/09 16:27:55 CET [2016/05/09 10:27:55 ET]
Table 'Isberga II' 9-max Seat #6 is the button
Seat 1: Kukuryzka ($102.75 in chips) 
Seat 2: Filojoes ($116.55 in chips) 
Seat 3: matiko09 ($101.50 in chips) 
Seat 4: ipashutapkom ($40 in chips) 
Seat 5: nubpoker ($109.98 in chips) 
Seat 6: vkartmann ($112.18 in chips) 
Seat 7: flk.Dasas ($100 in chips) 
Seat 8: PacPacBum ($100 in chips) 
flk.Dasas: posts small blind $0.50
PacPacBum: posts big blind $1
*** HOLE CARDS ***
Dealt to matiko09 [2h 4d]
Kukuryzka: folds 
Filojoes: folds 
matiko09: folds 
ipashutapkom: folds 
nubpoker: raises $1.50 to $2.50
vkartmann: folds 
flk.Dasas: folds 
PacPacBum: raises $5.50 to $8
nubpoker: folds 
Uncalled bet ($5.50) returned to PacPacBum
PacPacBum collected $5.50 from pot
PacPacBum: doesn't show hand 
*** SUMMARY ***
Total pot $5.50 | Rake $0 
Seat 1: Kukuryzka folded before Flop (didn't bet)
Seat 2: Filojoes folded before Flop (didn't bet)
Seat 3: matiko09 folded before Flop (didn't bet)
Seat 4: ipashutapkom folded before Flop (didn't bet)
Seat 5: nubpoker folded before Flop
Seat 6: vkartmann (button) folded before Flop (didn't bet)
Seat 7: flk.Dasas (small blind) folded before Flop
Seat 8: PacPacBum (big blind) collected ($5.50)





PokerStars Hand #153067075263:  Hold'em No Limit ($0.50/$1.00 USD) - 2016/05/09 16:28:08 CET [2016/05/09 10:28:08 ET]
Table 'Alderamin' 9-max Seat #9 is the button
Seat 1: XTLMZUWR ($100 in chips) 
Seat 3: NSL0808 ($51.37 in chips) 
Seat 4: matiko09 ($106 in chips) 
Seat 5: tanmayh ($28.33 in chips) 
Seat 6: Spid1 ($152.48 in chips) 
Seat 7: azzad2007 ($133.94 in chips) 
Seat 8: nubpoker ($111.17 in chips) 
Seat 9: ipashutapkom ($62.69 in chips) 
XTLMZUWR: posts small blind $0.50
Filojoes: is sitting out 
NSL0808: posts big blind $1
*** HOLE CARDS ***
Dealt to matiko09 [3c 4d]
matiko09: folds 
tanmayh has timed out while being disconnected
tanmayh: folds 
Spid1: folds 
azzad2007: folds 
nubpoker: folds 
ipashutapkom: folds 
XTLMZUWR: folds 
Uncalled bet ($0.50) returned to NSL0808
NSL0808 collected $1 from pot
NSL0808: doesn't show hand 
*** SUMMARY ***
Total pot $1 | Rake $0 
Seat 1: XTLMZUWR (small blind) folded before Flop
Seat 3: NSL0808 (big blind) collected ($1)
Seat 4: matiko09 folded before Flop (didn't bet)
Seat 5: tanmayh folded before Flop (didn't bet)
Seat 6: Spid1 folded before Flop (didn't bet)
Seat 7: azzad2007 folded before Flop (didn't bet)
Seat 8: nubpoker folded before Flop (didn't bet)
Seat 9: ipashutapkom (button) folded before Flop (didn't bet)





PokerStars Hand #153067079597:  Hold'em No Limit ($0.50/$1.00 USD) - 2016/05/09 16:28:15 CET [2016/05/09 10:28:15 ET]
Table 'Hajek' 9-max Seat #2 is the button
Seat 1: vkartmann ($100 in chips) 
Seat 2: Spid1 ($100 in chips) 
Seat 3: mycka86 ($142.45 in chips) 
Seat 4: LRVAV7 ($112.11 in chips) 
Seat 5: ozone2003 ($100 in chips) 
Seat 6: Filojoes ($102.90 in chips) 
Seat 7: DancerNN1 ($246.93 in chips) 
Seat 8: Kukuryzka ($106.37 in chips) 
Seat 9: matiko09 ($100 in chips) 
mycka86: posts small blind $0.50
LRVAV7: posts big blind $1
vkartmann: posts the ante $0.20
Spid1: posts the ante $0.20
mycka86: posts the ante $0.20
LRVAV7: posts the ante $0.20
ozone2003: posts the ante $0.20
Filojoes: posts the ante $0.20
DancerNN1: posts the ante $0.20
Kukuryzka: posts the ante $0.20
matiko09: posts the ante $0.20
*** HOLE CARDS ***
Dealt to matiko09 [9c 5d]
ozone2003: folds 
Filojoes: folds 
DancerNN1: folds 
Kukuryzka: folds 
matiko09: folds 
vkartmann: raises $2 to $3
Spid1: folds 
mycka86: folds 
LRVAV7: calls $2
*** FLOP *** [As 2s 2d]
LRVAV7: checks 
vkartmann: bets $2.67
LRVAV7: folds 
Uncalled bet ($2.67) returned to vkartmann
vkartmann collected $7.88 from pot
vkartmann: doesn't show hand 
*** SUMMARY ***
Total pot $8.30 | Rake $0.42 
Board [As 2s 2d]
Seat 1: vkartmann collected ($7.88)
Seat 2: Spid1 (button) folded before Flop (didn't bet)
Seat 3: mycka86 (small blind) folded before Flop
Seat 4: LRVAV7 (big blind) folded on the Flop
Seat 5: ozone2003 folded before Flop (didn't bet)
Seat 6: Filojoes folded before Flop (didn't bet)
Seat 7: DancerNN1 folded before Flop (didn't bet)
Seat 8: Kukuryzka folded before Flop (didn't bet)
Seat 9: matiko09 folded before Flop (didn't bet)





PokerStars Hand #153067086456:  Hold'em No Limit ($0.50/$1.00 USD) - 2016/05/09 16:28:27 CET [2016/05/09 10:28:27 ET]
Table 'Merga II' 9-max Seat #3 is the button
Seat 1: ipashutapkom ($46.84 in chips) 
Seat 2: Filojoes ($100 in chips) 
Seat 3: xhinostrabli ($34.97 in chips) 
Seat 4: nubpoker ($117.20 in chips) 
Seat 5: LRVAV7 ($253.78 in chips) 
Seat 6: Spid1 ($294.88 in chips) 
Seat 7: matiko09 ($148.79 in chips) 
Seat 8: GrandOldFart ($100 in chips) 
Seat 9: chaps1988 ($230.52 in chips) 
nubpoker: posts small blind $0.50
LRVAV7: posts big blind $1
*** HOLE CARDS ***
Dealt to matiko09 [4h Kh]
Spid1: folds 
matiko09: folds 
GrandOldFart: folds 
chaps1988: folds 
ipashutapkom: folds 
Filojoes: raises $1.50 to $2.50
xhinostrabli: folds 
nubpoker: folds 
LRVAV7: folds 
Uncalled bet ($1.50) returned to Filojoes
Filojoes collected $2.50 from pot
Filojoes: doesn't show hand 
*** SUMMARY ***
Total pot $2.50 | Rake $0 
Seat 1: ipashutapkom folded before Flop (didn't bet)
Seat 2: Filojoes collected ($2.50)
Seat 3: xhinostrabli (button) folded before Flop (didn't bet)
Seat 4: nubpoker (small blind) folded before Flop
Seat 5: LRVAV7 (big blind) folded before Flop
Seat 6: Spid1 folded before Flop (didn't bet)
Seat 7: matiko09 folded before Flop (didn't bet)
Seat 8: GrandOldFart folded before Flop (didn't bet)
Seat 9: chaps1988 folded before Flop (didn't bet)





PokerStars Hand #153067091278:  Hold'em No Limit ($0.50/$1.00 USD) - 2016/05/09 16:28:35 CET [2016/05/09 10:28:35 ET]
Table 'Isberga II' 9-max Seat #7 is the button
Seat 3: matiko09 ($101.50 in chips) 
Seat 4: ipashutapkom ($40 in chips) 
Seat 5: nubpoker ($107.48 in chips) 
Seat 6: vkartmann ($112.18 in chips) 
Seat 7: flk.Dasas ($100 in chips) 
Seat 8: PacPacBum ($103 in chips) 
PacPacBum: posts small blind $0.50
Kukuryzka: is sitting out 
Filojoes: is sitting out 
matiko09: posts big blind $1
*** HOLE CARDS ***
Dealt to matiko09 [6c Kh]
Kukuryzka leaves the table
R1aki joins the table at seat #9 
ipashutapkom: folds 
leavingmacao joins the table at seat #1 
nubpoker: folds 
vkartmann: folds 
flk.Dasas: folds 
PacPacBum: raises $1.04 to $2.04
R1aki leaves the table
matiko09: folds 
Uncalled bet ($1.04) returned to PacPacBum
PacPacBum collected $2 from pot
PacPacBum: doesn't show hand 
*** SUMMARY ***
Total pot $2 | Rake $0 
Seat 3: matiko09 (big blind) folded before Flop
Seat 4: ipashutapkom folded before Flop (didn't bet)
Seat 5: nubpoker folded before Flop (didn't bet)
Seat 6: vkartmann folded before Flop (didn't bet)
Seat 7: flk.Dasas (button) folded before Flop (didn't bet)
Seat 8: PacPacBum (small blind) collected ($2)





PokerStars Hand #153067093164:  Hold'em No Limit ($0.50/$1.00 USD) - 2016/05/09 16:28:38 CET [2016/05/09 10:28:38 ET]
Table 'Orthos' 9-max Seat #9 is the button
Seat 1: Kelvin sai ($86.58 in chips) 
Seat 2: PacPacBum ($100 in chips) 
Seat 3: Filojoes ($112.23 in chips) 
Seat 4: nubpoker ($121.87 in chips) 
Seat 5: matiko09 ($107.08 in chips) 
Seat 6: xhinostrabli ($127.51 in chips) 
Seat 7: flk.Dasas ($103.58 in chips) 
Seat 8: Dickyxxx ($129.87 in chips) 
Seat 9: vkartmann ($100 in chips) 
Kelvin sai: posts small blind $0.50
PacPacBum: posts big blind $1
*** HOLE CARDS ***
Dealt to matiko09 [5c 8d]
Filojoes: folds 
nubpoker: folds 
matiko09: folds 
xhinostrabli: folds 
flk.Dasas: folds 
Dickyxxx: folds 
vkartmann: folds 
Kelvin sai: folds 
Uncalled bet ($0.50) returned to PacPacBum
PacPacBum collected $1 from pot
PacPacBum: doesn't show hand 
*** SUMMARY ***
Total pot $1 | Rake $0 
Seat 1: Kelvin sai (small blind) folded before Flop
Seat 2: PacPacBum (big blind) collected ($1)
Seat 3: Filojoes folded before Flop (didn't bet)
Seat 4: nubpoker folded before Flop (didn't bet)
Seat 5: matiko09 folded before Flop (didn't bet)
Seat 6: xhinostrabli folded before Flop (didn't bet)
Seat 7: flk.Dasas folded before Flop (didn't bet)
Seat 8: Dickyxxx folded before Flop (didn't bet)
Seat 9: vkartmann (button) folded before Flop (didn't bet)





PokerStars Hand #153067092772:  Hold'em No Limit ($1/$2 USD) - 2016/05/09 16:28:38 CET [2016/05/09 10:28:38 ET]
Table 'Hagar II' 9-max Seat #7 is the button
Seat 2: darren1031 ($160 in chips) 
Seat 4: matiko09 ($261.94 in chips) 
Seat 5: PacPacBum ($223.37 in chips) 
Seat 6: Iggso ($213.55 in chips) 
Seat 7: Monsthand ($200 in chips) 
Seat 8: J0k3rF4c3_FD ($464.97 in chips) 
Seat 9: chaps1988 ($200 in chips) 
J0k3rF4c3_FD: posts small blind $1
chaps1988: posts big blind $2
*** HOLE CARDS ***
Dealt to matiko09 [Ad 5d]
darren1031: calls $2
matiko09: raises $6 to $8
PacPacBum: folds 
Iggso: folds 
Monsthand: raises $14 to $22
J0k3rF4c3_FD: folds 
chaps1988: raises $24.50 to $46.50
darren1031: folds 
matiko09: folds 
Monsthand: folds 
Uncalled bet ($24.50) returned to chaps1988
chaps1988 collected $55 from pot
chaps1988: doesn't show hand 
*** SUMMARY ***
Total pot $55 | Rake $0 
Seat 2: darren1031 folded before Flop
Seat 4: matiko09 folded before Flop
Seat 5: PacPacBum folded before Flop (didn't bet)
Seat 6: Iggso folded before Flop (didn't bet)
Seat 7: Monsthand (button) folded before Flop
Seat 8: J0k3rF4c3_FD (small blind) folded before Flop
Seat 9: chaps1988 (big blind) collected ($55)





PokerStars Hand #153067421297:  Hold'em No Limit ($1/$2 USD) - 2016/05/09 16:38:01 CET [2016/05/09 10:38:01 ET]
Table 'Titan III' 9-max Seat #4 is the button
Seat 2: PacPacBum ($213.83 in chips) 
Seat 3: Spid1 ($218.75 in chips) 
Seat 4: MishaRychkov ($146.05 in chips) 
Seat 5: Monsthand ($284.25 in chips) 
Seat 6: matiko09 ($200 in chips) 
Seat 8: chaps1988 ($293.25 in chips) 
Monsthand: posts small blind $1
matiko09: posts big blind $2
*** HOLE CARDS ***
Dealt to matiko09 [8h 8c]
chaps1988: raises $4 to $6
PacPacBum: folds 
Sasuke777777 said, "lucky river...."
Spid1: folds 
MishaRychkov: folds 
Monsthand said, "yep"
Monsthand: folds 
matiko09: calls $4
*** FLOP *** [Ad 9s Qd]
matiko09: checks 
chaps1988: checks 
*** TURN *** [Ad 9s Qd] [2c]
matiko09: checks 
chaps1988: checks 
*** RIVER *** [Ad 9s Qd 2c] [4h]
matiko09: checks 
chaps1988: checks 
*** SHOW DOWN ***
matiko09: shows [8h 8c] (a pair of Eights)
chaps1988: mucks hand 
matiko09 collected $12.35 from pot
*** SUMMARY ***
Total pot $13 | Rake $0.65 
Board [Ad 9s Qd 2c 4h]
Seat 2: PacPacBum folded before Flop (didn't bet)
Seat 3: Spid1 folded before Flop (didn't bet)
Seat 4: MishaRychkov (button) folded before Flop (didn't bet)
Seat 5: Monsthand (small blind) folded before Flop
Seat 6: matiko09 (big blind) showed [8h 8c] and won ($12.35) with a pair of Eights
Seat 8: chaps1988 mucked [5s 5h]





PokerStars Hand #153067427462:  Hold'em No Limit ($1/$2 USD) - 2016/05/09 16:38:11 CET [2016/05/09 10:38:11 ET]
Table 'Hagar II' 9-max Seat #2 is the button
Seat 2: darren1031 ($144.05 in chips) 
Seat 3: Sasuke777777 ($81 in chips) 
Seat 4: matiko09 ($253.94 in chips) 
Seat 5: PacPacBum ($217.37 in chips) 
Seat 7: Monsthand ($205.40 in chips) 
Seat 9: chaps1988 ($251.75 in chips) 
Sasuke777777: posts small blind $1
matiko09: posts big blind $2
el Fatto: sits out 
AceSurgeon: sits out 
*** HOLE CARDS ***
Dealt to matiko09 [Tc Jc]
PacPacBum: folds 
Monsthand: folds 
chaps1988: raises $2.50 to $4.50
darren1031: folds 
Sasuke777777: raises $5.50 to $10
matiko09: folds 
chaps1988: calls $5.50
*** FLOP *** [Ad 4h Ah]
Sasuke777777: bets $10
chaps1988: folds 
Uncalled bet ($10) returned to Sasuke777777
Sasuke777777 collected $20.90 from pot
Sasuke777777: doesn't show hand 
*** SUMMARY ***
Total pot $22 | Rake $1.10 
Board [Ad 4h Ah]
Seat 2: darren1031 (button) folded before Flop (didn't bet)
Seat 3: Sasuke777777 (small blind) collected ($20.90)
Seat 4: matiko09 (big blind) folded before Flop
Seat 5: PacPacBum folded before Flop (didn't bet)
Seat 7: Monsthand folded before Flop (didn't bet)
Seat 9: chaps1988 folded on the Flop





PokerStars Hand #153067450420:  Hold'em No Limit ($1/$2 USD) - 2016/05/09 16:38:51 CET [2016/05/09 10:38:51 ET]
Table 'Titan III' 9-max Seat #5 is the button
Seat 2: PacPacBum ($213.83 in chips) 
Seat 3: Spid1 ($218.75 in chips) 
Seat 4: MishaRychkov ($146.05 in chips) 
Seat 5: Monsthand ($283.25 in chips) 
Seat 6: matiko09 ($206.35 in chips) 
Seat 8: chaps1988 ($287.25 in chips) 
Seat 9: Sasuke777777 ($80 in chips) 
matiko09: posts small blind $1
chaps1988: posts big blind $2
*** HOLE CARDS ***
Dealt to matiko09 [7c Ad]
Sasuke777777: folds 
PacPacBum: folds 
Spid1: folds 
MishaRychkov: folds 
Monsthand: folds 
matiko09: raises $3 to $5
chaps1988: folds 
Uncalled bet ($3) returned to matiko09
matiko09 collected $4 from pot
matiko09: doesn't show hand 
*** SUMMARY ***
Total pot $4 | Rake $0 
Seat 2: PacPacBum folded before Flop (didn't bet)
Seat 3: Spid1 folded before Flop (didn't bet)
Seat 4: MishaRychkov folded before Flop (didn't bet)
Seat 5: Monsthand (button) folded before Flop (didn't bet)
Seat 6: matiko09 (small blind) collected ($4)
Seat 8: chaps1988 (big blind) folded before Flop
Seat 9: Sasuke777777 folded before Flop (didn't bet)





PokerStars Hand #153067459974:  Hold'em No Limit ($1/$2 USD) - 2016/05/09 16:39:07 CET [2016/05/09 10:39:07 ET]
Table 'Hagar II' 9-max Seat #3 is the button
Seat 2: darren1031 ($144.05 in chips) 
Seat 3: Sasuke777777 ($91.90 in chips) 
Seat 4: matiko09 ($251.94 in chips) 
Seat 5: PacPacBum ($217.37 in chips) 
Seat 7: Monsthand ($205.40 in chips) 
Seat 9: chaps1988 ($241.75 in chips) 
matiko09: posts small blind $1
PacPacBum: posts big blind $2
el Fatto: sits out 
AceSurgeon: sits out 
*** HOLE CARDS ***
Dealt to matiko09 [Js Qh]
Monsthand: folds 
chaps1988: folds 
darren1031: folds 
Sasuke777777: raises $4 to $6
matiko09: folds 
PacPacBum: folds 
Uncalled bet ($4) returned to Sasuke777777
Sasuke777777 collected $5 from pot
Sasuke777777: doesn't show hand 
*** SUMMARY ***
Total pot $5 | Rake $0 
Seat 2: darren1031 folded before Flop (didn't bet)
Seat 3: Sasuke777777 (button) collected ($5)
Seat 4: matiko09 (small blind) folded before Flop
Seat 5: PacPacBum (big blind) folded before Flop
Seat 7: Monsthand folded before Flop (didn't bet)
Seat 9: chaps1988 folded before Flop (didn't bet)





PokerStars Hand #153067472969:  Hold'em No Limit ($1/$2 USD) - 2016/05/09 16:39:29 CET [2016/05/09 10:39:29 ET]
Table 'Titan III' 9-max Seat #6 is the button
Seat 2: PacPacBum ($213.83 in chips) 
Seat 3: Spid1 ($218.75 in chips) 
Seat 4: MishaRychkov ($146.05 in chips) 
Seat 5: Monsthand ($283.25 in chips) 
Seat 6: matiko09 ($208.35 in chips) 
Seat 8: chaps1988 ($285.25 in chips) 
Seat 9: Sasuke777777 ($80 in chips) 
chaps1988: posts small blind $1
Sasuke777777: posts big blind $2
*** HOLE CARDS ***
Dealt to matiko09 [Tc 6h]
PacPacBum: raises $4 to $6
Spid1: folds 
MishaRychkov: folds 
Monsthand: folds 
matiko09: folds 
chaps1988: folds 
Sasuke777777: folds 
Uncalled bet ($4) returned to PacPacBum
PacPacBum collected $5 from pot
PacPacBum: doesn't show hand 
*** SUMMARY ***
Total pot $5 | Rake $0 
Seat 2: PacPacBum collected ($5)
Seat 3: Spid1 folded before Flop (didn't bet)
Seat 4: MishaRychkov folded before Flop (didn't bet)
Seat 5: Monsthand folded before Flop (didn't bet)
Seat 6: matiko09 (button) folded before Flop (didn't bet)
Seat 8: chaps1988 (small blind) folded before Flop
Seat 9: Sasuke777777 (big blind) folded before Flop





PokerStars Hand #153067478071:  Hold'em No Limit ($1/$2 USD) - 2016/05/09 16:39:38 CET [2016/05/09 10:39:38 ET]
Table 'Hagar II' 9-max Seat #4 is the button
Seat 2: darren1031 ($144.05 in chips) 
Seat 3: Sasuke777777 ($94.90 in chips) 
Seat 4: matiko09 ($250.94 in chips) 
Seat 5: PacPacBum ($215.37 in chips) 
Seat 6: el Fatto ($200 in chips) 
Seat 7: Monsthand ($205.40 in chips) 
Seat 9: chaps1988 ($241.75 in chips) 
PacPacBum: posts small blind $1
el Fatto: posts big blind $2
AceSurgeon: sits out 
*** HOLE CARDS ***
Dealt to matiko09 [Ac Js]
Monsthand: folds 
chaps1988: folds 
darren1031: folds 
Sasuke777777: folds 
matiko09: raises $2.54 to $4.54
PacPacBum: folds 
el Fatto: calls $2.54
*** FLOP *** [9d 5s 3s]
el Fatto: checks 
matiko09: checks 
*** TURN *** [9d 5s 3s] [8s]
el Fatto: bets $6.38
matiko09: folds 
Uncalled bet ($6.38) returned to el Fatto
el Fatto collected $9.58 from pot
el Fatto: doesn't show hand 
*** SUMMARY ***
Total pot $10.08 | Rake $0.50 
Board [9d 5s 3s 8s]
Seat 2: darren1031 folded before Flop (didn't bet)
Seat 3: Sasuke777777 folded before Flop (didn't bet)
Seat 4: matiko09 (button) folded on the Turn
Seat 5: PacPacBum (small blind) folded before Flop
Seat 6: el Fatto (big blind) collected ($9.58)
Seat 7: Monsthand folded before Flop (didn't bet)
Seat 9: chaps1988 folded before Flop (didn't bet)





PokerStars Hand #153067483985:  Hold'em No Limit ($0.50/$1.00 USD) - 2016/05/09 16:39:48 CET [2016/05/09 10:39:48 ET]
Table 'Buryatia II' 9-max Seat #5 is the button
Seat 5: amisasi ($100 in chips) 
Seat 6: I The King I ($100 in chips) 
Seat 7: Spid1 ($100 in chips) 
Seat 8: matiko09 ($100 in chips) 
I The King I: posts small blind $0.50
Spid1: posts big blind $1
*** HOLE CARDS ***
Dealt to matiko09 [6c 8h]
matiko09: folds 
amisasi: folds 
I The King I: folds 
Uncalled bet ($0.50) returned to Spid1
Spid1 collected $1 from pot
Spid1: doesn't show hand 
*** SUMMARY ***
Total pot $1 | Rake $0 
Seat 5: amisasi (button) folded before Flop (didn't bet)
Seat 6: I The King I (small blind) folded before Flop
Seat 7: Spid1 (big blind) collected ($1)
Seat 8: matiko09 folded before Flop (didn't bet)





PokerStars Hand #153067485621:  Hold'em No Limit ($1/$2 USD) - 2016/05/09 16:39:51 CET [2016/05/09 10:39:51 ET]
Table 'Titan III' 9-max Seat #8 is the button
Seat 2: PacPacBum ($216.83 in chips) 
Seat 3: Spid1 ($218.75 in chips) 
Seat 4: MishaRychkov ($146.05 in chips) 
Seat 5: Monsthand ($283.25 in chips) 
Seat 6: matiko09 ($208.35 in chips) 
Seat 8: chaps1988 ($284.25 in chips) 
Seat 9: Sasuke777777 ($78 in chips) 
Sasuke777777: posts small blind $1
PacPacBum: posts big blind $2
*** HOLE CARDS ***
Dealt to matiko09 [9h Jc]
Spid1: folds 
MishaRychkov: folds 
Monsthand: folds 
matiko09: folds 
chaps1988: raises $3 to $5
Sasuke777777: calls $4
PacPacBum: folds 
*** FLOP *** [4h Th 2s]
Sasuke777777: checks 
chaps1988: checks 
*** TURN *** [4h Th 2s] [4d]
Sasuke777777: bets $6
chaps1988: calls $6
*** RIVER *** [4h Th 2s 4d] [Qs]
Sasuke777777: checks 
chaps1988: checks 
*** SHOW DOWN ***
Sasuke777777: shows [5d 5s] (two pair, Fives and Fours)
chaps1988: mucks hand 
Sasuke777777 collected $22.80 from pot
*** SUMMARY ***
Total pot $24 | Rake $1.20 
Board [4h Th 2s 4d Qs]
Seat 2: PacPacBum (big blind) folded before Flop
Seat 3: Spid1 folded before Flop (didn't bet)
Seat 4: MishaRychkov folded before Flop (didn't bet)
Seat 5: Monsthand folded before Flop (didn't bet)
Seat 6: matiko09 folded before Flop (didn't bet)
Seat 8: chaps1988 (button) mucked [Ad Kd]
Seat 9: Sasuke777777 (small blind) showed [5d 5s] and won ($22.80) with two pair, Fives and Fours





PokerStars Hand #153067488893:  Hold'em No Limit ($0.50/$1.00 USD) - 2016/05/09 16:39:56 CET [2016/05/09 10:39:56 ET]
Table 'Buryatia II' 9-max Seat #6 is the button
Seat 5: amisasi ($100 in chips) 
Seat 6: I The King I ($100 in chips) 
Seat 7: Spid1 ($100.50 in chips) 
Seat 8: matiko09 ($100 in chips) 
Spid1: posts small blind $0.50
matiko09: posts big blind $1
*** HOLE CARDS ***
Dealt to matiko09 [6h 3s]
amisasi: folds 
I The King I: raises $1 to $2
Spid1: folds 
matiko09: folds 
Uncalled bet ($1) returned to I The King I
I The King I collected $2.50 from pot
I The King I: doesn't show hand 
*** SUMMARY ***
Total pot $2.50 | Rake $0 
Seat 5: amisasi folded before Flop (didn't bet)
Seat 6: I The King I (button) collected ($2.50)
Seat 7: Spid1 (small blind) folded before Flop
Seat 8: matiko09 (big blind) folded before Flop





PokerStars Hand #153067493994:  Hold'em No Limit ($0.50/$1.00 USD) - 2016/05/09 16:40:05 CET [2016/05/09 10:40:05 ET]
Table 'Reiss' 9-max Seat #3 is the button
Seat 1: Dickyxxx ($187.92 in chips) 
Seat 2: mycka86 ($107.56 in chips) 
Seat 3: chaps1988 ($100 in chips) 
Seat 4: MichaLabam ($155.33 in chips) 
Seat 5: matiko09 ($115.75 in chips) 
Seat 6: Spid1 ($168.92 in chips) 
Seat 7: nubpoker ($135.79 in chips) 
Seat 8: Filojoes ($166.68 in chips) 
Seat 9: Aghmir77 ($102.98 in chips) 
MichaLabam: posts small blind $0.50
matiko09: posts big blind $1
*** HOLE CARDS ***
Dealt to matiko09 [4c 2s]
Spid1: folds 
nubpoker: folds 
Filojoes: folds 
Aghmir77: folds 
Dickyxxx: raises $2 to $3
mycka86: folds 
chaps1988: folds 
MichaLabam: calls $2.50
matiko09: folds 
*** FLOP *** [5d 3d Js]
MichaLabam: checks 
Dickyxxx: bets $4.43
MichaLabam: folds 
Uncalled bet ($4.43) returned to Dickyxxx
Dickyxxx collected $6.65 from pot
Dickyxxx: doesn't show hand 
*** SUMMARY ***
Total pot $7 | Rake $0.35 
Board [5d 3d Js]
Seat 1: Dickyxxx collected ($6.65)
Seat 2: mycka86 folded before Flop (didn't bet)
Seat 3: chaps1988 (button) folded before Flop (didn't bet)
Seat 4: MichaLabam (small blind) folded on the Flop
Seat 5: matiko09 (big blind) folded before Flop
Seat 6: Spid1 folded before Flop (didn't bet)
Seat 7: nubpoker folded before Flop (didn't bet)
Seat 8: Filojoes folded before Flop (didn't bet)
Seat 9: Aghmir77 folded before Flop (didn't bet)





PokerStars Hand #153067499038:  Hold'em No Limit ($0.50/$1.00 USD) - 2016/05/09 16:40:14 CET [2016/05/09 10:40:14 ET]
Table 'Buryatia II' 9-max Seat #7 is the button
Seat 5: amisasi ($100 in chips) 
Seat 6: I The King I ($101.50 in chips) 
Seat 7: Spid1 ($100 in chips) 
Seat 8: matiko09 ($100 in chips) 
matiko09: posts small blind $0.50
amisasi: posts big blind $1
*** HOLE CARDS ***
Dealt to matiko09 [Kc 6s]
I The King I: folds 
CI58 joins the table at seat #9 
Spid1: raises $1.50 to $2.50
matiko09: folds 
amisasi: folds 
Uncalled bet ($1.50) returned to Spid1
Spid1 collected $2.50 from pot
Spid1: doesn't show hand 
*** SUMMARY ***
Total pot $2.50 | Rake $0 
Seat 5: amisasi (big blind) folded before Flop
Seat 6: I The King I folded before Flop (didn't bet)
Seat 7: Spid1 (button) collected ($2.50)
Seat 8: matiko09 (small blind) folded before Flop





PokerStars Hand #153067504330:  Hold'em No Limit ($1/$2 USD) - 2016/05/09 16:40:23 CET [2016/05/09 10:40:23 ET]
Table 'Hagar II' 9-max Seat #5 is the button
Seat 2: darren1031 ($144.05 in chips) 
Seat 3: Sasuke777777 ($94.90 in chips) 
Seat 4: matiko09 ($246.40 in chips) 
Seat 5: PacPacBum ($214.37 in chips) 
Seat 6: el Fatto ($205.04 in chips) 
Seat 7: Monsthand ($205.40 in chips) 
Seat 9: chaps1988 ($241.75 in chips) 
el Fatto: posts small blind $1
Monsthand: posts big blind $2
AceSurgeon: sits out 
*** HOLE CARDS ***
Dealt to matiko09 [8d 4s]
mojitos86 joins the table at seat #1 
chaps1988: folds 
darren1031 has timed out
darren1031: folds 
Sasuke777777: folds 
matiko09: folds 
PacPacBum: raises $3 to $5
el Fatto: folds 
Monsthand: calls $3
*** FLOP *** [Kd 7d Ts]
Monsthand: checks 
PacPacBum: checks 
*** TURN *** [Kd 7d Ts] [Ad]
Monsthand: checks 
PacPacBum: bets $7.21
Monsthand: calls $7.21
*** RIVER *** [Kd 7d Ts Ad] [Jc]
Monsthand: checks 
PacPacBum: checks 
*** SHOW DOWN ***
Monsthand: shows [Kc 9c] (a pair of Kings)
PacPacBum: shows [As 7s] (two pair, Aces and Sevens)
PacPacBum collected $24.15 from pot
*** SUMMARY ***
Total pot $25.42 | Rake $1.27 
Board [Kd 7d Ts Ad Jc]
Seat 2: darren1031 folded before Flop (didn't bet)
Seat 3: Sasuke777777 folded before Flop (didn't bet)
Seat 4: matiko09 folded before Flop (didn't bet)
Seat 5: PacPacBum (button) showed [As 7s] and won ($24.15) with two pair, Aces and Sevens
Seat 6: el Fatto (small blind) folded before Flop
Seat 7: Monsthand (big blind) showed [Kc 9c] and lost with a pair of Kings
Seat 9: chaps1988 folded before Flop (didn't bet)





PokerStars Hand #153067506732:  Hold'em No Limit ($0.50/$1.00 USD) - 2016/05/09 16:40:27 CET [2016/05/09 10:40:27 ET]
Table 'Buryatia II' 9-max Seat #8 is the button
Seat 5: amisasi ($99 in chips) 
Seat 6: I The King I ($101.50 in chips) 
Seat 7: Spid1 ($101.50 in chips) 
Seat 8: matiko09 ($100 in chips) 
CI58 will be allowed to play after the button
amisasi: posts small blind $0.50
I The King I: posts big blind $1
*** HOLE CARDS ***
Dealt to matiko09 [4h 6h]
Spid1: folds 
matiko09: folds 
amisasi: folds 
Uncalled bet ($0.50) returned to I The King I
I The King I collected $1 from pot
I The King I: doesn't show hand 
*** SUMMARY ***
Total pot $1 | Rake $0 
Seat 5: amisasi (small blind) folded before Flop
Seat 6: I The King I (big blind) collected ($1)
Seat 7: Spid1 folded before Flop (didn't bet)
Seat 8: matiko09 (button) folded before Flop (didn't bet)





PokerStars Hand #153067508315:  Hold'em No Limit ($1/$2 USD) - 2016/05/09 16:40:29 CET [2016/05/09 10:40:29 ET]
Table 'Titan III' 9-max Seat #9 is the button
Seat 2: PacPacBum ($214.83 in chips) 
Seat 3: Spid1 ($218.75 in chips) 
Seat 4: MishaRychkov ($146.05 in chips) 
Seat 5: Monsthand ($283.25 in chips) 
Seat 6: matiko09 ($208.35 in chips) 
Seat 8: chaps1988 ($273.25 in chips) 
Seat 9: Sasuke777777 ($89.80 in chips) 
PacPacBum: posts small blind $1
Spid1: posts big blind $2
*** HOLE CARDS ***
Dealt to matiko09 [Ts 5h]
MishaRychkov: folds 
Monsthand: folds 
matiko09: folds 
chaps1988: raises $3 to $5
Sasuke777777: folds 
PacPacBum: folds 
lana111 was removed from the table for failing to post
Spid1: calls $3
*** FLOP *** [8c 4s 6h]
Spid1: checks 
chaps1988: checks 
*** TURN *** [8c 4s 6h] [7d]
Spid1: checks 
chaps1988: checks 
*** RIVER *** [8c 4s 6h 7d] [8s]
Spid1: checks 
chaps1988: checks 
*** SHOW DOWN ***
Spid1: shows [Td Tc] (two pair, Tens and Eights)
chaps1988: mucks hand 
Spid1 collected $10.45 from pot
*** SUMMARY ***
Total pot $11 | Rake $0.55 
Board [8c 4s 6h 7d 8s]
Seat 2: PacPacBum (small blind) folded before Flop
Seat 3: Spid1 (big blind) showed [Td Tc] and won ($10.45) with two pair, Tens and Eights
Seat 4: MishaRychkov folded before Flop (didn't bet)
Seat 5: Monsthand folded before Flop (didn't bet)
Seat 6: matiko09 folded before Flop (didn't bet)
Seat 8: chaps1988 mucked [Ks Ah]
Seat 9: Sasuke777777 (button) folded before Flop (didn't bet)





PokerStars Hand #153067511862:  Hold'em No Limit ($0.50/$1.00 USD) - 2016/05/09 16:40:35 CET [2016/05/09 10:40:35 ET]
Table 'Buryatia II' 9-max Seat #5 is the button
Seat 5: amisasi ($98.50 in chips) 
Seat 6: I The King I ($102 in chips) 
Seat 7: Spid1 ($101.50 in chips) 
Seat 8: matiko09 ($100 in chips) 
I The King I: posts small blind $0.50
Spid1: posts big blind $1
CI58: sits out 
*** HOLE CARDS ***
Dealt to matiko09 [5d Tc]
matiko09: folds 
amisasi: raises $1 to $2
Desperategam joins the table at seat #3 
I The King I: folds 
Spid1: folds 
Uncalled bet ($1) returned to amisasi
amisasi collected $2.50 from pot
*** SUMMARY ***
Total pot $2.50 | Rake $0 
Seat 5: amisasi (button) collected ($2.50)
Seat 6: I The King I (small blind) folded before Flop
Seat 7: Spid1 (big blind) folded before Flop
Seat 8: matiko09 folded before Flop (didn't bet)





PokerStars Hand #153067520733:  Hold'em No Limit ($0.50/$1.00 USD) - 2016/05/09 16:40:51 CET [2016/05/09 10:40:51 ET]
Table 'Reiss' 9-max Seat #4 is the button
Seat 1: Dickyxxx ($191.57 in chips) 
Seat 2: mycka86 ($107.56 in chips) 
Seat 3: chaps1988 ($100 in chips) 
Seat 4: MichaLabam ($152.33 in chips) 
Seat 5: matiko09 ($114.75 in chips) 
Seat 6: Spid1 ($168.92 in chips) 
Seat 7: nubpoker ($135.79 in chips) 
Seat 8: Filojoes ($166.68 in chips) 
Seat 9: Aghmir77 ($102.98 in chips) 
matiko09: posts small blind $0.50
Spid1: posts big blind $1
*** HOLE CARDS ***
Dealt to matiko09 [5d Ah]
nubpoker: folds 
Filojoes: folds 
Aghmir77: folds 
Dickyxxx: folds 
mycka86: raises $1.50 to $2.50
chaps1988: folds 
MichaLabam: folds 
matiko09: folds 
Spid1: folds 
Uncalled bet ($1.50) returned to mycka86
mycka86 collected $2.50 from pot
*** SUMMARY ***
Total pot $2.50 | Rake $0 
Seat 1: Dickyxxx folded before Flop (didn't bet)
Seat 2: mycka86 collected ($2.50)
Seat 3: chaps1988 folded before Flop (didn't bet)
Seat 4: MichaLabam (button) folded before Flop (didn't bet)
Seat 5: matiko09 (small blind) folded before Flop
Seat 6: Spid1 (big blind) folded before Flop
Seat 7: nubpoker folded before Flop (didn't bet)
Seat 8: Filojoes folded before Flop (didn't bet)
Seat 9: Aghmir77 folded before Flop (didn't bet)





PokerStars Hand #153067522422:  Hold'em No Limit ($0.50/$1.00 USD) - 2016/05/09 16:40:54 CET [2016/05/09 10:40:54 ET]
Table 'Buryatia II' 9-max Seat #6 is the button
Seat 5: amisasi ($100 in chips) 
Seat 6: I The King I ($101.50 in chips) 
Seat 7: Spid1 ($100.50 in chips) 
Seat 8: matiko09 ($100 in chips) 
AceSurgeon joins the table at seat #2 
Spid1: posts small blind $0.50
matiko09: posts big blind $1
CI58: sits out 
Desperategam: sits out 
*** HOLE CARDS ***
Dealt to matiko09 [Jh 4d]
amisasi: folds 
I The King I: raises $1 to $2
Spid1: folds 
matiko09: folds 
Uncalled bet ($1) returned to I The King I
I The King I collected $2.50 from pot
I The King I: doesn't show hand 
*** SUMMARY ***
Total pot $2.50 | Rake $0 
Seat 5: amisasi folded before Flop (didn't bet)
Seat 6: I The King I (button) collected ($2.50)
Seat 7: Spid1 (small blind) folded before Flop
Seat 8: matiko09 (big blind) folded before Flop





PokerStars Hand #153067528078:  Hold'em No Limit ($1/$2 USD) - 2016/05/09 16:41:03 CET [2016/05/09 10:41:03 ET]
Table 'Titan III' 9-max Seat #2 is the button
Seat 2: PacPacBum ($213.83 in chips) 
Seat 3: Spid1 ($224.20 in chips) 
Seat 4: MishaRychkov ($146.05 in chips) 
Seat 5: Monsthand ($283.25 in chips) 
Seat 6: matiko09 ($208.35 in chips) 
Seat 8: chaps1988 ($268.25 in chips) 
Seat 9: Sasuke777777 ($89.80 in chips) 
Spid1: posts small blind $1
MishaRychkov: posts big blind $2
*** HOLE CARDS ***
Dealt to matiko09 [8h 6c]
Monsthand: folds 
matiko09: folds 
chaps1988: folds 
Sasuke777777: folds 
PacPacBum: folds 
Spid1: raises $3 to $5
MishaRychkov: calls $3
*** FLOP *** [Js 5d 9c]
Spid1: bets $7
MishaRychkov: folds 
Uncalled bet ($7) returned to Spid1
Spid1 collected $9.50 from pot
Spid1: doesn't show hand 
*** SUMMARY ***
Total pot $10 | Rake $0.50 
Board [Js 5d 9c]
Seat 2: PacPacBum (button) folded before Flop (didn't bet)
Seat 3: Spid1 (small blind) collected ($9.50)
Seat 4: MishaRychkov (big blind) folded on the Flop
Seat 5: Monsthand folded before Flop (didn't bet)
Seat 6: matiko09 folded before Flop (didn't bet)
Seat 8: chaps1988 folded before Flop (didn't bet)
Seat 9: Sasuke777777 folded before Flop (didn't bet)





PokerStars Hand #153067530934:  Hold'em No Limit ($0.50/$1.00 USD) - 2016/05/09 16:41:08 CET [2016/05/09 10:41:08 ET]
Table 'Isberga II' 9-max Seat #1 is the button
Seat 1: CI58 ($100 in chips) 
Seat 2: Filojoes ($100 in chips) 
Seat 3: matiko09 ($100.50 in chips) 
Seat 4: Spid1 ($101.50 in chips) 
Seat 6: vkartmann ($162.68 in chips) 
Seat 7: flk.Dasas ($100 in chips) 
Seat 8: PacPacBum ($104.50 in chips) 
Seat 9: R1aki ($101.50 in chips) 
Filojoes: posts small blind $0.50
matiko09: posts big blind $1
*** HOLE CARDS ***
Dealt to matiko09 [Js 3h]
Spid1: folds 
vkartmann: raises $2 to $3
flk.Dasas: folds 
PacPacBum: folds 
R1aki: folds 
CI58: calls $3
Filojoes: folds 
matiko09: folds 
*** FLOP *** [Jd 9h 9c]
vkartmann: checks 
CI58: checks 
*** TURN *** [Jd 9h 9c] [2h]
vkartmann: checks 
CI58: checks 
*** RIVER *** [Jd 9h 9c 2h] [6h]
vkartmann: checks 
CI58: checks 
*** SHOW DOWN ***
vkartmann: shows [As Ts] (a pair of Nines)
CI58: mucks hand 
vkartmann collected $7.12 from pot
*** SUMMARY ***
Total pot $7.50 | Rake $0.38 
Board [Jd 9h 9c 2h 6h]
Seat 1: CI58 (button) mucked [Th Qd]
Seat 2: Filojoes (small blind) folded before Flop
Seat 3: matiko09 (big blind) folded before Flop
Seat 4: Spid1 folded before Flop (didn't bet)
Seat 6: vkartmann showed [As Ts] and won ($7.12) with a pair of Nines
Seat 7: flk.Dasas folded before Flop (didn't bet)
Seat 8: PacPacBum folded before Flop (didn't bet)
Seat 9: R1aki folded before Flop (didn't bet)





PokerStars Hand #153067534661:  Hold'em No Limit ($0.50/$1.00 USD) - 2016/05/09 16:41:15 CET [2016/05/09 10:41:15 ET]
Table 'Buryatia II' 9-max Seat #7 is the button
Seat 5: amisasi ($100 in chips) 
Seat 6: I The King I ($103 in chips) 
Seat 7: Spid1 ($100 in chips) 
Seat 8: matiko09 ($100 in chips) 
Seat 9: CI58 ($100 in chips) 
matiko09: posts small blind $0.50
CI58: posts big blind $1
AceSurgeon: sits out 
Desperategam: sits out 
*** HOLE CARDS ***
Dealt to matiko09 [6c 9d]
FunkyDonkey1 joins the table at seat #4 
amisasi: folds 
I The King I: raises $1.50 to $2.50
Spid1: folds 
matiko09: folds 
CI58: folds 
Uncalled bet ($1.50) returned to I The King I
I The King I collected $2.50 from pot
I The King I: doesn't show hand 
*** SUMMARY ***
Total pot $2.50 | Rake $0 
Seat 5: amisasi folded before Flop (didn't bet)
Seat 6: I The King I collected ($2.50)
Seat 7: Spid1 (button) folded before Flop (didn't bet)
Seat 8: matiko09 (small blind) folded before Flop
Seat 9: CI58 (big blind) folded before Flop





PokerStars Hand #153067539130:  Hold'em No Limit ($0.50/$1.00 USD) - 2016/05/09 16:41:22 CET [2016/05/09 10:41:22 ET]
Table 'Reiss' 9-max Seat #5 is the button
Seat 1: Dickyxxx ($191.57 in chips) 
Seat 2: mycka86 ($109.06 in chips) 
Seat 3: chaps1988 ($100 in chips) 
Seat 4: MichaLabam ($152.33 in chips) 
Seat 5: matiko09 ($114.25 in chips) 
Seat 6: Spid1 ($167.92 in chips) 
Seat 7: nubpoker ($135.79 in chips) 
Seat 8: Filojoes ($166.68 in chips) 
Seat 9: Aghmir77 ($102.98 in chips) 
Spid1: posts small blind $0.50
nubpoker: posts big blind $1
*** HOLE CARDS ***
Dealt to matiko09 [5d Td]
Filojoes: folds 
Aghmir77: folds 
Dickyxxx: folds 
mycka86: raises $2 to $3
chaps1988: folds 
MichaLabam: folds 
matiko09: folds 
Spid1: folds 
nubpoker: folds 
Uncalled bet ($2) returned to mycka86
mycka86 collected $2.50 from pot
*** SUMMARY ***
Total pot $2.50 | Rake $0 
Seat 1: Dickyxxx folded before Flop (didn't bet)
Seat 2: mycka86 collected ($2.50)
Seat 3: chaps1988 folded before Flop (didn't bet)
Seat 4: MichaLabam folded before Flop (didn't bet)
Seat 5: matiko09 (button) folded before Flop (didn't bet)
Seat 6: Spid1 (small blind) folded before Flop
Seat 7: nubpoker (big blind) folded before Flop
Seat 8: Filojoes folded before Flop (didn't bet)
Seat 9: Aghmir77 folded before Flop (didn't bet)





PokerStars Hand #153067547295:  Hold'em No Limit ($1/$2 USD) - 2016/05/09 16:41:36 CET [2016/05/09 10:41:36 ET]
Table 'Titan III' 9-max Seat #3 is the button
Seat 2: PacPacBum ($213.83 in chips) 
Seat 3: Spid1 ($228.70 in chips) 
Seat 4: MishaRychkov ($141.05 in chips) 
Seat 5: Monsthand ($283.25 in chips) 
Seat 6: matiko09 ($208.35 in chips) 
Seat 8: chaps1988 ($268.25 in chips) 
Seat 9: Sasuke777777 ($89.80 in chips) 
MishaRychkov: posts small blind $1
Monsthand: posts big blind $2
*** HOLE CARDS ***
Dealt to matiko09 [9h 8h]
matiko09: raises $3 to $5
I The King I joins the table at seat #1 
chaps1988: folds 
Sasuke777777: folds 
PacPacBum: folds 
Spid1: folds 
MishaRychkov: folds 
Monsthand: folds 
Uncalled bet ($3) returned to matiko09
matiko09 collected $5 from pot
matiko09: doesn't show hand 
*** SUMMARY ***
Total pot $5 | Rake $0 
Seat 2: PacPacBum folded before Flop (didn't bet)
Seat 3: Spid1 (button) folded before Flop (didn't bet)
Seat 4: MishaRychkov (small blind) folded before Flop
Seat 5: Monsthand (big blind) folded before Flop
Seat 6: matiko09 collected ($5)
Seat 8: chaps1988 folded before Flop (didn't bet)
Seat 9: Sasuke777777 folded before Flop (didn't bet)





PokerStars Hand #153067548654:  Hold'em No Limit ($0.50/$1.00 USD) - 2016/05/09 16:41:38 CET [2016/05/09 10:41:38 ET]
Table 'Reiss' 9-max Seat #6 is the button
Seat 1: Dickyxxx ($191.57 in chips) 
Seat 2: mycka86 ($110.56 in chips) 
Seat 3: chaps1988 ($100 in chips) 
Seat 4: MichaLabam ($152.33 in chips) 
Seat 5: matiko09 ($114.25 in chips) 
Seat 6: Spid1 ($167.42 in chips) 
Seat 7: nubpoker ($134.79 in chips) 
Seat 8: Filojoes ($166.68 in chips) 
Seat 9: Aghmir77 ($102.98 in chips) 
nubpoker: posts small blind $0.50
Filojoes: posts big blind $1
*** HOLE CARDS ***
Dealt to matiko09 [3d Ac]
Aghmir77: folds 
Dickyxxx: folds 
mycka86: folds 
chaps1988: folds 
MichaLabam: folds 
matiko09: folds 
Spid1: folds 
nubpoker: folds 
Uncalled bet ($0.50) returned to Filojoes
Filojoes collected $1 from pot
Filojoes: doesn't show hand 
*** SUMMARY ***
Total pot $1 | Rake $0 
Seat 1: Dickyxxx folded before Flop (didn't bet)
Seat 2: mycka86 folded before Flop (didn't bet)
Seat 3: chaps1988 folded before Flop (didn't bet)
Seat 4: MichaLabam folded before Flop (didn't bet)
Seat 5: matiko09 folded before Flop (didn't bet)
Seat 6: Spid1 (button) folded before Flop (didn't bet)
Seat 7: nubpoker (small blind) folded before Flop
Seat 8: Filojoes (big blind) collected ($1)
Seat 9: Aghmir77 folded before Flop (didn't bet)





PokerStars Hand #153067548919:  Hold'em No Limit ($0.50/$1.00 USD) - 2016/05/09 16:41:39 CET [2016/05/09 10:41:39 ET]
Table 'Buryatia II' 9-max Seat #8 is the button
Seat 1: flk.Dasas ($100 in chips) 
Seat 5: amisasi ($100 in chips) 
Seat 6: I The King I ($104.50 in chips) 
Seat 7: Spid1 ($100 in chips) 
Seat 8: matiko09 ($100 in chips) 
Seat 9: CI58 ($100 in chips) 
CI58: posts small blind $0.50
flk.Dasas: posts big blind $1
AceSurgeon: sits out 
Desperategam: sits out 
FunkyDonkey1: sits out 
*** HOLE CARDS ***
Dealt to matiko09 [Qs 5d]
amisasi: raises $2 to $3
I The King I: folds 
Spid1: folds 
matiko09: folds 
CI58: folds 
flk.Dasas: folds 
Uncalled bet ($2) returned to amisasi
amisasi collected $2.50 from pot
*** SUMMARY ***
Total pot $2.50 | Rake $0 
Seat 1: flk.Dasas (big blind) folded before Flop
Seat 5: amisasi collected ($2.50)
Seat 6: I The King I folded before Flop (didn't bet)
Seat 7: Spid1 folded before Flop (didn't bet)
Seat 8: matiko09 (button) folded before Flop (didn't bet)
Seat 9: CI58 (small blind) folded before Flop





PokerStars Hand #153067551876:  Hold'em No Limit ($1/$2 USD) - 2016/05/09 16:41:44 CET [2016/05/09 10:41:44 ET]
Table 'Hagar II' 9-max Seat #6 is the button
Seat 2: darren1031 ($144.05 in chips) 
Seat 3: Sasuke777777 ($94.90 in chips) 
Seat 4: matiko09 ($246.40 in chips) 
Seat 5: PacPacBum ($226.31 in chips) 
Seat 6: el Fatto ($204.04 in chips) 
Seat 7: Monsthand ($200 in chips) 
Seat 8: AceSurgeon ($200 in chips) 
Seat 9: chaps1988 ($241.75 in chips) 
Monsthand: posts small blind $1
AceSurgeon: posts big blind $2
mojitos86: sits out 
*** HOLE CARDS ***
Dealt to matiko09 [6d 3c]
chaps1988: folds 
darren1031: folds 
Sasuke777777: raises $4 to $6
matiko09: folds 
PacPacBum: folds 
el Fatto: folds 
Monsthand: folds 
AceSurgeon: folds 
Uncalled bet ($4) returned to Sasuke777777
Sasuke777777 collected $5 from pot
Sasuke777777: doesn't show hand 
*** SUMMARY ***
Total pot $5 | Rake $0 
Seat 2: darren1031 folded before Flop (didn't bet)
Seat 3: Sasuke777777 collected ($5)
Seat 4: matiko09 folded before Flop (didn't bet)
Seat 5: PacPacBum folded before Flop (didn't bet)
Seat 6: el Fatto (button) folded before Flop (didn't bet)
Seat 7: Monsthand (small blind) folded before Flop
Seat 8: AceSurgeon (big blind) folded before Flop
Seat 9: chaps1988 folded before Flop (didn't bet)





PokerStars Hand #153067559217:  Hold'em No Limit ($0.50/$1.00 USD) - 2016/05/09 16:41:56 CET [2016/05/09 10:41:56 ET]
Table 'Isberga II' 9-max Seat #2 is the button
Seat 1: CI58 ($100 in chips) 
Seat 2: Filojoes ($100 in chips) 
Seat 3: matiko09 ($100 in chips) 
Seat 4: Spid1 ($101.50 in chips) 
Seat 5: AliceIko2120 ($132.32 in chips) 
Seat 6: vkartmann ($166.80 in chips) 
Seat 7: flk.Dasas ($100 in chips) 
Seat 8: PacPacBum ($104.50 in chips) 
Seat 9: R1aki ($101.50 in chips) 
matiko09: posts small blind $0.50
Spid1: posts big blind $1
*** HOLE CARDS ***
Dealt to matiko09 [Qc 7s]
AliceIko2120: folds 
vkartmann: folds 
flk.Dasas: folds 
PacPacBum: raises $1.50 to $2.50
R1aki: folds 
CI58: folds 
Filojoes: folds 
matiko09: folds 
Spid1: folds 
Uncalled bet ($1.50) returned to PacPacBum
PacPacBum collected $2.50 from pot
PacPacBum: doesn't show hand 
*** SUMMARY ***
Total pot $2.50 | Rake $0 
Seat 1: CI58 folded before Flop (didn't bet)
Seat 2: Filojoes (button) folded before Flop (didn't bet)
Seat 3: matiko09 (small blind) folded before Flop
Seat 4: Spid1 (big blind) folded before Flop
Seat 5: AliceIko2120 folded before Flop (didn't bet)
Seat 6: vkartmann folded before Flop (didn't bet)
Seat 7: flk.Dasas folded before Flop (didn't bet)
Seat 8: PacPacBum collected ($2.50)
Seat 9: R1aki folded before Flop (didn't bet)





PokerStars Hand #153067560681:  Hold'em No Limit ($1/$2 USD) - 2016/05/09 16:41:58 CET [2016/05/09 10:41:58 ET]
Table 'Titan III' 9-max Seat #4 is the button
Seat 2: PacPacBum ($213.83 in chips) 
Seat 3: Spid1 ($228.70 in chips) 
Seat 4: MishaRychkov ($140.05 in chips) 
Seat 5: Monsthand ($281.25 in chips) 
Seat 6: matiko09 ($211.35 in chips) 
Seat 8: chaps1988 ($268.25 in chips) 
Seat 9: Sasuke777777 ($89.80 in chips) 
Monsthand: posts small blind $1
matiko09: posts big blind $2
seasar1: sits out 
I The King I: sits out 
*** HOLE CARDS ***
Dealt to matiko09 [3h 7h]
chaps1988: folds 
Sasuke777777: raises $4 to $6
PacPacBum: folds 
Spid1: folds 
MishaRychkov: folds 
Monsthand: folds 
matiko09: folds 
Uncalled bet ($4) returned to Sasuke777777
Sasuke777777 collected $5 from pot
Sasuke777777: doesn't show hand 
*** SUMMARY ***
Total pot $5 | Rake $0 
Seat 2: PacPacBum folded before Flop (didn't bet)
Seat 3: Spid1 folded before Flop (didn't bet)
Seat 4: MishaRychkov (button) folded before Flop (didn't bet)
Seat 5: Monsthand (small blind) folded before Flop
Seat 6: matiko09 (big blind) folded before Flop
Seat 8: chaps1988 folded before Flop (didn't bet)
Seat 9: Sasuke777777 collected ($5)





PokerStars Hand #153067563167:  Hold'em No Limit ($0.50/$1.00 USD) - 2016/05/09 16:42:03 CET [2016/05/09 10:42:03 ET]
Table 'Buryatia II' 9-max Seat #9 is the button
Seat 1: flk.Dasas ($100 in chips) 
Seat 2: AceSurgeon ($100 in chips) 
Seat 5: amisasi ($101.50 in chips) 
Seat 6: I The King I ($104.50 in chips) 
Seat 7: Spid1 ($100 in chips) 
Seat 8: matiko09 ($100 in chips) 
Seat 9: CI58 ($100 in chips) 
flk.Dasas: posts small blind $0.50
AceSurgeon: posts big blind $1
Desperategam: sits out 
FunkyDonkey1: sits out 
*** HOLE CARDS ***
Dealt to matiko09 [2h 8h]
amisasi: raises $1 to $2
I The King I: folds 
Spid1: folds 
matiko09: folds 
CI58: folds 
flk.Dasas: folds 
AceSurgeon: folds 
Uncalled bet ($1) returned to amisasi
amisasi collected $2.50 from pot
*** SUMMARY ***
Total pot $2.50 | Rake $0 
Seat 1: flk.Dasas (small blind) folded before Flop
Seat 2: AceSurgeon (big blind) folded before Flop
Seat 5: amisasi collected ($2.50)
Seat 6: I The King I folded before Flop (didn't bet)
Seat 7: Spid1 folded before Flop (didn't bet)
Seat 8: matiko09 folded before Flop (didn't bet)
Seat 9: CI58 (button) folded before Flop (didn't bet)





PokerStars Hand #153067564415:  Hold'em No Limit ($1/$2 USD) - 2016/05/09 16:42:05 CET [2016/05/09 10:42:05 ET]
Table 'Hagar II' 9-max Seat #7 is the button
Seat 2: darren1031 ($144.05 in chips) 
Seat 3: Sasuke777777 ($97.90 in chips) 
Seat 4: matiko09 ($246.40 in chips) 
Seat 5: PacPacBum ($226.31 in chips) 
Seat 6: el Fatto ($204.04 in chips) 
Seat 7: Monsthand ($200 in chips) 
Seat 8: AceSurgeon ($200 in chips) 
Seat 9: chaps1988 ($241.75 in chips) 
AceSurgeon: posts small blind $1
chaps1988: posts big blind $2
mojitos86: sits out 
*** HOLE CARDS ***
Dealt to matiko09 [3c 5c]
darren1031: raises $2 to $4
Sasuke777777: folds 
matiko09: folds 
PacPacBum: calls $4
el Fatto: folds 
Monsthand: folds 
AceSurgeon: raises $16 to $20
chaps1988: folds 
darren1031: raises $124.05 to $144.05 and is all-in
PacPacBum: folds 
AceSurgeon: calls $124.05
*** FLOP *** [8h 6s Th]
*** TURN *** [8h 6s Th] [8s]
*** RIVER *** [8h 6s Th 8s] [8d]
*** SHOW DOWN ***
AceSurgeon: shows [Kc Qc] (three of a kind, Eights)
darren1031: shows [Ah Td] (a full house, Eights full of Tens)
darren1031 collected $291.35 from pot
*** SUMMARY ***
Total pot $294.10 | Rake $2.75 
Board [8h 6s Th 8s 8d]
Seat 2: darren1031 showed [Ah Td] and won ($291.35) with a full house, Eights full of Tens
Seat 3: Sasuke777777 folded before Flop (didn't bet)
Seat 4: matiko09 folded before Flop (didn't bet)
Seat 5: PacPacBum folded before Flop
Seat 6: el Fatto folded before Flop (didn't bet)
Seat 7: Monsthand (button) folded before Flop (didn't bet)
Seat 8: AceSurgeon (small blind) showed [Kc Qc] and lost with three of a kind, Eights
Seat 9: chaps1988 (big blind) folded before Flop





PokerStars Hand #153067565214:  Hold'em No Limit ($0.50/$1.00 USD) - 2016/05/09 16:42:06 CET [2016/05/09 10:42:06 ET]
Table 'Reiss' 9-max Seat #7 is the button
Seat 1: Dickyxxx ($191.57 in chips) 
Seat 2: mycka86 ($110.56 in chips) 
Seat 3: chaps1988 ($100 in chips) 
Seat 4: MichaLabam ($152.33 in chips) 
Seat 5: matiko09 ($114.25 in chips) 
Seat 6: Spid1 ($167.42 in chips) 
Seat 7: nubpoker ($134.29 in chips) 
Seat 8: Filojoes ($167.18 in chips) 
Seat 9: Aghmir77 ($102.98 in chips) 
Filojoes: posts small blind $0.50
Aghmir77: posts big blind $1
*** HOLE CARDS ***
Dealt to matiko09 [8h 6h]
Dickyxxx: folds 
mycka86: raises $2 to $3
chaps1988: folds 
MichaLabam: calls $3
matiko09: folds 
Spid1: folds 
nubpoker: folds 
Filojoes: folds 
Aghmir77: folds 
*** FLOP *** [6s Jc 3h]
mycka86: bets $3.91
MichaLabam: calls $3.91
*** TURN *** [6s Jc 3h] [Kd]
mycka86: bets $10.60
MichaLabam: folds 
Uncalled bet ($10.60) returned to mycka86
mycka86 collected $14.55 from pot
*** SUMMARY ***
Total pot $15.32 | Rake $0.77 
Board [6s Jc 3h Kd]
Seat 1: Dickyxxx folded before Flop (didn't bet)
Seat 2: mycka86 collected ($14.55)
Seat 3: chaps1988 folded before Flop (didn't bet)
Seat 4: MichaLabam folded on the Turn
Seat 5: matiko09 folded before Flop (didn't bet)
Seat 6: Spid1 folded before Flop (didn't bet)
Seat 7: nubpoker (button) folded before Flop (didn't bet)
Seat 8: Filojoes (small blind) folded before Flop
Seat 9: Aghmir77 (big blind) folded before Flop





PokerStars Hand #153067568790:  Hold'em No Limit ($1/$2 USD) - 2016/05/09 16:42:12 CET [2016/05/09 10:42:12 ET]
Table 'Titan III' 9-max Seat #5 is the button
Seat 2: PacPacBum ($213.83 in chips) 
Seat 3: Spid1 ($228.70 in chips) 
Seat 4: MishaRychkov ($140.05 in chips) 
Seat 5: Monsthand ($280.25 in chips) 
Seat 6: matiko09 ($209.35 in chips) 
Seat 7: seasar1 ($200 in chips) 
Seat 8: chaps1988 ($268.25 in chips) 
Seat 9: Sasuke777777 ($92.80 in chips) 
matiko09: posts small blind $1
seasar1: posts big blind $2
I The King I: sits out 
*** HOLE CARDS ***
Dealt to matiko09 [7d 7s]
chaps1988: folds 
Sasuke777777: folds 
PacPacBum: folds 
Spid1: raises $4 to $6
MishaRychkov: calls $6
Monsthand: folds 
matiko09: calls $5
seasar1: calls $4
*** FLOP *** [Qd Qc 9d]
matiko09: checks 
seasar1: bets $10
Spid1: calls $10
MishaRychkov: calls $10
matiko09: folds 
*** TURN *** [Qd Qc 9d] [6h]
seasar1: bets $30
Spid1: calls $30
MishaRychkov: folds 
*** RIVER *** [Qd Qc 9d 6h] [Kh]
seasar1: bets $60
Spid1: raises $122.70 to $182.70 and is all-in
seasar1: calls $94 and is all-in
Uncalled bet ($28.70) returned to Spid1
*** SHOW DOWN ***
Spid1: shows [Kd Kc] (a full house, Kings full of Queens)
seasar1: shows [Js Qs] (three of a kind, Queens)
Spid1 collected $419.25 from pot
*** SUMMARY ***
Total pot $422 | Rake $2.75 
Board [Qd Qc 9d 6h Kh]
Seat 2: PacPacBum folded before Flop (didn't bet)
Seat 3: Spid1 showed [Kd Kc] and won ($419.25) with a full house, Kings full of Queens
Seat 4: MishaRychkov folded on the Turn
Seat 5: Monsthand (button) folded before Flop (didn't bet)
Seat 6: matiko09 (small blind) folded on the Flop
Seat 7: seasar1 (big blind) showed [Js Qs] and lost with three of a kind, Queens
Seat 8: chaps1988 folded before Flop (didn't bet)
Seat 9: Sasuke777777 folded before Flop (didn't bet)





PokerStars Hand #153067571958:  Hold'em No Limit ($0.50/$1.00 USD) - 2016/05/09 16:42:17 CET [2016/05/09 10:42:17 ET]
Table 'Hajek' 9-max Seat #7 is the button
Seat 1: vkartmann ($100.98 in chips) 
Seat 2: Spid1 ($156.40 in chips) 
Seat 3: mycka86 ($100 in chips) 
Seat 4: LRVAV7 ($158.62 in chips) 
Seat 5: ozone2003 ($110.33 in chips) 
Seat 6: Filojoes ($100 in chips) 
Seat 7: DancerNN1 ($245.21 in chips) 
Seat 8: Kukuryzka ($104.37 in chips) 
Seat 9: matiko09 ($100 in chips) 
Kukuryzka: posts small blind $0.50
matiko09: posts big blind $1
vkartmann: posts the ante $0.20
Spid1: posts the ante $0.20
mycka86: posts the ante $0.20
LRVAV7: posts the ante $0.20
ozone2003: posts the ante $0.20
Filojoes: posts the ante $0.20
DancerNN1: posts the ante $0.20
Kukuryzka: posts the ante $0.20
matiko09: posts the ante $0.20
*** HOLE CARDS ***
Dealt to matiko09 [8s Kh]
vkartmann: folds 
Spid1: folds 
mycka86: folds 
LRVAV7: raises $2 to $3
ozone2003: raises $8 to $11
Filojoes: folds 
DancerNN1: folds 
Kukuryzka: folds 
matiko09: folds 
LRVAV7: folds 
Uncalled bet ($8) returned to ozone2003
ozone2003 collected $9.30 from pot
*** SUMMARY ***
Total pot $9.30 | Rake $0 
Seat 1: vkartmann folded before Flop (didn't bet)
Seat 2: Spid1 folded before Flop (didn't bet)
Seat 3: mycka86 folded before Flop (didn't bet)
Seat 4: LRVAV7 folded before Flop
Seat 5: ozone2003 collected ($9.30)
Seat 6: Filojoes folded before Flop (didn't bet)
Seat 7: DancerNN1 (button) folded before Flop (didn't bet)
Seat 8: Kukuryzka (small blind) folded before Flop
Seat 9: matiko09 (big blind) folded before Flop





PokerStars Hand #153067579718:  Hold'em No Limit ($0.50/$1.00 USD) - 2016/05/09 16:42:30 CET [2016/05/09 10:42:30 ET]
Table 'Buryatia II' 9-max Seat #1 is the button
Seat 1: flk.Dasas ($100 in chips) 
Seat 2: AceSurgeon ($100 in chips) 
Seat 3: Desperategam ($100 in chips) 
Seat 5: amisasi ($103 in chips) 
Seat 6: I The King I ($104.50 in chips) 
Seat 7: Spid1 ($100 in chips) 
Seat 8: matiko09 ($100 in chips) 
Seat 9: CI58 ($100 in chips) 
AceSurgeon: posts small blind $0.50
Desperategam: posts big blind $1
FunkyDonkey1: sits out 
*** HOLE CARDS ***
Dealt to matiko09 [Jd 5h]
amisasi: calls $1
I The King I: folds 
Spid1: raises $3 to $4
matiko09: folds 
CI58: folds 
flk.Dasas: calls $4
AceSurgeon: folds 
Desperategam: folds 
amisasi: calls $3
*** FLOP *** [Ad 6s Tc]
amisasi: checks 
Spid1: checks 
flk.Dasas: bets $8.72
amisasi: calls $8.72
Spid1: folds 
*** TURN *** [Ad 6s Tc] [8c]
amisasi: checks 
flk.Dasas: bets $19.99
amisasi: folds 
Uncalled bet ($19.99) returned to flk.Dasas
flk.Dasas collected $29.39 from pot
flk.Dasas: doesn't show hand 
*** SUMMARY ***
Total pot $30.94 | Rake $1.55 
Board [Ad 6s Tc 8c]
Seat 1: flk.Dasas (button) collected ($29.39)
Seat 2: AceSurgeon (small blind) folded before Flop
Seat 3: Desperategam (big blind) folded before Flop
Seat 5: amisasi folded on the Turn
Seat 6: I The King I folded before Flop (didn't bet)
Seat 7: Spid1 folded on the Flop
Seat 8: matiko09 folded before Flop (didn't bet)
Seat 9: CI58 folded before Flop (didn't bet)





PokerStars Hand #153067587292:  Hold'em No Limit ($0.50/$1.00 USD) - 2016/05/09 16:42:43 CET [2016/05/09 10:42:43 ET]
Table 'Isberga II' 9-max Seat #3 is the button
Seat 1: CI58 ($100 in chips) 
Seat 2: Filojoes ($100 in chips) 
Seat 3: matiko09 ($100 in chips) 
Seat 4: Spid1 ($100.50 in chips) 
Seat 5: AliceIko2120 ($132.32 in chips) 
Seat 6: vkartmann ($166.80 in chips) 
Seat 7: flk.Dasas ($100 in chips) 
Seat 8: PacPacBum ($106 in chips) 
Seat 9: R1aki ($101.50 in chips) 
Spid1: posts small blind $0.50
AliceIko2120: posts big blind $1
*** HOLE CARDS ***
Dealt to matiko09 [7h 5c]
vkartmann: folds 
flk.Dasas: folds 
PacPacBum: folds 
R1aki: folds 
CI58: raises $2 to $3
Filojoes: folds 
matiko09: folds 
Spid1: folds 
AliceIko2120: folds 
Uncalled bet ($2) returned to CI58
CI58 collected $2.50 from pot
CI58: doesn't show hand 
*** SUMMARY ***
Total pot $2.50 | Rake $0 
Seat 1: CI58 collected ($2.50)
Seat 2: Filojoes folded before Flop (didn't bet)
Seat 3: matiko09 (button) folded before Flop (didn't bet)
Seat 4: Spid1 (small blind) folded before Flop
Seat 5: AliceIko2120 (big blind) folded before Flop
Seat 6: vkartmann folded before Flop (didn't bet)
Seat 7: flk.Dasas folded before Flop (didn't bet)
Seat 8: PacPacBum folded before Flop (didn't bet)
Seat 9: R1aki folded before Flop (didn't bet)





PokerStars Hand #153067594437:  Hold'em No Limit ($1/$2 USD) - 2016/05/09 16:42:55 CET [2016/05/09 10:42:55 ET]
Table 'Hagar II' 9-max Seat #8 is the button
Seat 1: mojitos86 ($200 in chips) 
Seat 2: darren1031 ($291.35 in chips) 
Seat 3: Sasuke777777 ($97.90 in chips) 
Seat 4: matiko09 ($246.40 in chips) 
Seat 5: PacPacBum ($222.31 in chips) 
Seat 6: el Fatto ($204.04 in chips) 
Seat 7: Monsthand ($200 in chips) 
Seat 8: AceSurgeon ($200 in chips) 
Seat 9: chaps1988 ($239.75 in chips) 
chaps1988: posts small blind $1
mojitos86: posts big blind $2
*** HOLE CARDS ***
Dealt to matiko09 [8c Ah]
darren1031: folds 
Sasuke777777: folds 
matiko09: folds 
PacPacBum: folds 
el Fatto: folds 
Monsthand: folds 
AceSurgeon: folds 
chaps1988: raises $4 to $6
mojitos86: folds 
Uncalled bet ($4) returned to chaps1988
chaps1988 collected $4 from pot
chaps1988: doesn't show hand 
*** SUMMARY ***
Total pot $4 | Rake $0 
Seat 1: mojitos86 (big blind) folded before Flop
Seat 2: darren1031 folded before Flop (didn't bet)
Seat 3: Sasuke777777 folded before Flop (didn't bet)
Seat 4: matiko09 folded before Flop (didn't bet)
Seat 5: PacPacBum folded before Flop (didn't bet)
Seat 6: el Fatto folded before Flop (didn't bet)
Seat 7: Monsthand folded before Flop (didn't bet)
Seat 8: AceSurgeon (button) folded before Flop (didn't bet)
Seat 9: chaps1988 (small blind) collected ($4)





PokerStars Hand #153067596347:  Hold'em No Limit ($0.50/$1.00 USD) - 2016/05/09 16:42:58 CET [2016/05/09 10:42:58 ET]
Table 'Merga II' 9-max Seat #5 is the button
Seat 1: ipashutapkom ($63.02 in chips) 
Seat 2: Filojoes ($100 in chips) 
Seat 3: xhinostrabli ($33.47 in chips) 
Seat 4: nubpoker ($100 in chips) 
Seat 5: LRVAV7 ($266.45 in chips) 
Seat 6: Spid1 ($293.88 in chips) 
Seat 7: matiko09 ($148.79 in chips) 
Seat 8: GrandOldFart ($97 in chips) 
Seat 9: chaps1988 ($227.72 in chips) 
Spid1: posts small blind $0.50
matiko09: posts big blind $1
*** HOLE CARDS ***
Dealt to matiko09 [Ks 5h]
GrandOldFart: folds 
chaps1988: raises $2 to $3
ipashutapkom: folds 
Filojoes: folds 
xhinostrabli: folds 
nubpoker: folds 
LRVAV7: calls $3
Spid1: folds 
matiko09: folds 
*** FLOP *** [5d 4h 2c]
chaps1988: bets $5
LRVAV7: calls $5
*** TURN *** [5d 4h 2c] [8d]
chaps1988: bets $12
LRVAV7: raises $12 to $24
chaps1988: calls $12
*** RIVER *** [5d 4h 2c 8d] [4s]
chaps1988: checks 
LRVAV7: bets $50
chaps1988: calls $50
*** SHOW DOWN ***
LRVAV7: shows [6h 3c] (a straight, Deuce to Six)
chaps1988: mucks hand 
LRVAV7 collected $163 from pot
*** SUMMARY ***
Total pot $165.50 | Rake $2.50 
Board [5d 4h 2c 8d 4s]
Seat 1: ipashutapkom folded before Flop (didn't bet)
Seat 2: Filojoes folded before Flop (didn't bet)
Seat 3: xhinostrabli folded before Flop (didn't bet)
Seat 4: nubpoker folded before Flop (didn't bet)
Seat 5: LRVAV7 (button) showed [6h 3c] and won ($163) with a straight, Deuce to Six
Seat 6: Spid1 (small blind) folded before Flop
Seat 7: matiko09 (big blind) folded before Flop
Seat 8: GrandOldFart folded before Flop (didn't bet)
Seat 9: chaps1988 mucked [Kd Kh]





PokerStars Hand #153067601494:  Hold'em No Limit ($0.50/$1.00 USD) - 2016/05/09 16:43:07 CET [2016/05/09 10:43:07 ET]
Table 'Orthos' 9-max Seat #3 is the button
Seat 2: PacPacBum ($111.91 in chips) 
Seat 3: Filojoes ($118.11 in chips) 
Seat 4: nubpoker ($152.15 in chips) 
Seat 5: matiko09 ($107.08 in chips) 
Seat 6: xhinostrabli ($135.85 in chips) 
Seat 7: flk.Dasas ($100.08 in chips) 
Seat 8: Dickyxxx ($103 in chips) 
Seat 9: mycka86 ($101 in chips) 
nubpoker: posts small blind $0.50
matiko09: posts big blind $1
*** HOLE CARDS ***
Dealt to matiko09 [9c As]
xhinostrabli: raises $1 to $2
flk.Dasas: raises $6 to $8
Dickyxxx: folds 
mycka86: folds 
PacPacBum: folds 
Filojoes: folds 
nubpoker: folds 
matiko09: folds 
xhinostrabli: calls $6
*** FLOP *** [3c 2s 9h]
xhinostrabli: checks 
flk.Dasas: bets $7.98
xhinostrabli: calls $7.98
*** TURN *** [3c 2s 9h] [4s]
xhinostrabli: checks 
flk.Dasas: checks 
*** RIVER *** [3c 2s 9h 4s] [Kh]
xhinostrabli: checks 
flk.Dasas: bets $13.26
xhinostrabli: calls $13.26
*** SHOW DOWN ***
flk.Dasas: shows [Ah Kc] (a pair of Kings)
xhinostrabli: mucks hand 
flk.Dasas collected $57.48 from pot
*** SUMMARY ***
Total pot $59.98 | Rake $2.50 
Board [3c 2s 9h 4s Kh]
Seat 2: PacPacBum folded before Flop (didn't bet)
Seat 3: Filojoes (button) folded before Flop (didn't bet)
Seat 4: nubpoker (small blind) folded before Flop
Seat 5: matiko09 (big blind) folded before Flop
Seat 6: xhinostrabli mucked [7d 9d]
Seat 7: flk.Dasas showed [Ah Kc] and won ($57.48) with a pair of Kings
Seat 8: Dickyxxx folded before Flop (didn't bet)
Seat 9: mycka86 folded before Flop (didn't bet)





PokerStars Hand #153067606429:  Hold'em No Limit ($0.50/$1.00 USD) - 2016/05/09 16:43:15 CET [2016/05/09 10:43:15 ET]
Table 'Hajek' 9-max Seat #8 is the button
Seat 2: Spid1 ($156.20 in chips) 
Seat 3: mycka86 ($100 in chips) 
Seat 4: LRVAV7 ($155.42 in chips) 
Seat 5: ozone2003 ($116.43 in chips) 
Seat 6: Filojoes ($100 in chips) 
Seat 7: DancerNN1 ($245.01 in chips) 
Seat 8: Kukuryzka ($103.67 in chips) 
Seat 9: matiko09 ($100 in chips) 
matiko09: posts small blind $0.50
vkartmann: is sitting out 
vkartmann leaves the table
Spid1: posts big blind $1
Spid1: posts the ante $0.20
mycka86: posts the ante $0.20
LRVAV7: posts the ante $0.20
ozone2003: posts the ante $0.20
Filojoes: posts the ante $0.20
DancerNN1: posts the ante $0.20
Kukuryzka: posts the ante $0.20
matiko09: posts the ante $0.20
*** HOLE CARDS ***
Dealt to matiko09 [Ah 3h]
mycka86: folds 
LRVAV7: folds 
CI58 joins the table at seat #1 
ozone2003: folds 
Filojoes: folds 
DancerNN1: raises $2 to $3
Kukuryzka: folds 
matiko09: folds 
Spid1: calls $2
*** FLOP *** [6c Kd 7h]
Spid1: checks 
DancerNN1: bets $4
Spid1: folds 
Uncalled bet ($4) returned to DancerNN1
DancerNN1 collected $7.70 from pot
DancerNN1: doesn't show hand 
*** SUMMARY ***
Total pot $8.10 | Rake $0.40 
Board [6c Kd 7h]
Seat 2: Spid1 (big blind) folded on the Flop
Seat 3: mycka86 folded before Flop (didn't bet)
Seat 4: LRVAV7 folded before Flop (didn't bet)
Seat 5: ozone2003 folded before Flop (didn't bet)
Seat 6: Filojoes folded before Flop (didn't bet)
Seat 7: DancerNN1 collected ($7.70)
Seat 8: Kukuryzka (button) folded before Flop (didn't bet)
Seat 9: matiko09 (small blind) folded before Flop





PokerStars Hand #153067610278:  Hold'em No Limit ($1/$2 USD) - 2016/05/09 16:43:22 CET [2016/05/09 10:43:22 ET]
Table 'Titan III' 9-max Seat #6 is the button
Seat 2: PacPacBum ($213.83 in chips) 
Seat 3: Spid1 ($447.95 in chips) 
Seat 4: MishaRychkov ($124.05 in chips) 
Seat 5: Monsthand ($280.25 in chips) 
Seat 6: matiko09 ($203.35 in chips) 
Seat 8: chaps1988 ($268.25 in chips) 
Seat 9: Sasuke777777 ($92.80 in chips) 
chaps1988: posts small blind $1
Sasuke777777: posts big blind $2
I The King I: sits out 
*** HOLE CARDS ***
Dealt to matiko09 [8d Ks]
PacPacBum: raises $2.08 to $4.08
Spid1: folds 
MishaRychkov: folds 
Monsthand: folds 
matiko09: folds 
chaps1988: folds 
Sasuke777777: raises $5.92 to $10
PacPacBum: calls $5.92
*** FLOP *** [As Kh 6c]
Sasuke777777: bets $19.95
PacPacBum: folds 
Uncalled bet ($19.95) returned to Sasuke777777
Sasuke777777 collected $19.95 from pot
Sasuke777777: doesn't show hand 
*** SUMMARY ***
Total pot $21 | Rake $1.05 
Board [As Kh 6c]
Seat 2: PacPacBum folded on the Flop
Seat 3: Spid1 folded before Flop (didn't bet)
Seat 4: MishaRychkov folded before Flop (didn't bet)
Seat 5: Monsthand folded before Flop (didn't bet)
Seat 6: matiko09 (button) folded before Flop (didn't bet)
Seat 8: chaps1988 (small blind) folded before Flop
Seat 9: Sasuke777777 (big blind) collected ($19.95)





PokerStars Hand #153067612937:  Hold'em No Limit ($1/$2 USD) - 2016/05/09 16:43:26 CET [2016/05/09 10:43:26 ET]
Table 'Hagar II' 9-max Seat #9 is the button
Seat 1: mojitos86 ($198 in chips) 
Seat 2: darren1031 ($291.35 in chips) 
Seat 3: Sasuke777777 ($97.90 in chips) 
Seat 4: matiko09 ($246.40 in chips) 
Seat 5: PacPacBum ($222.31 in chips) 
Seat 6: el Fatto ($204.04 in chips) 
Seat 7: Monsthand ($200 in chips) 
Seat 8: AceSurgeon ($200 in chips) 
Seat 9: chaps1988 ($241.75 in chips) 
mojitos86: posts small blind $1
darren1031: posts big blind $2
*** HOLE CARDS ***
Dealt to matiko09 [Js 8s]
Sasuke777777: folds 
matiko09: folds 
PacPacBum: folds 
el Fatto: folds 
Monsthand: folds 
AceSurgeon: folds 
chaps1988: folds 
mojitos86: raises $2 to $4
darren1031: calls $2
*** FLOP *** [5d As 3h]
mojitos86: bets $4
darren1031: calls $4
*** TURN *** [5d As 3h] [6c]
mojitos86: checks 
darren1031: bets $6
mojitos86: calls $6
*** RIVER *** [5d As 3h 6c] [2c]
mojitos86: checks 
darren1031: checks 
*** SHOW DOWN ***
mojitos86: shows [Kd Kc] (a pair of Kings)
darren1031: shows [8h Ac] (a pair of Aces)
darren1031 collected $26.60 from pot
*** SUMMARY ***
Total pot $28 | Rake $1.40 
Board [5d As 3h 6c 2c]
Seat 1: mojitos86 (small blind) showed [Kd Kc] and lost with a pair of Kings
Seat 2: darren1031 (big blind) showed [8h Ac] and won ($26.60) with a pair of Aces
Seat 3: Sasuke777777 folded before Flop (didn't bet)
Seat 4: matiko09 folded before Flop (didn't bet)
Seat 5: PacPacBum folded before Flop (didn't bet)
Seat 6: el Fatto folded before Flop (didn't bet)
Seat 7: Monsthand folded before Flop (didn't bet)
Seat 8: AceSurgeon folded before Flop (didn't bet)
Seat 9: chaps1988 (button) folded before Flop (didn't bet)





PokerStars Hand #153067613010:  Hold'em No Limit ($0.50/$1.00 USD) - 2016/05/09 16:43:27 CET [2016/05/09 10:43:27 ET]
Table 'Reiss' 9-max Seat #8 is the button
Seat 1: Dickyxxx ($191.57 in chips) 
Seat 2: mycka86 ($118.20 in chips) 
Seat 3: chaps1988 ($100 in chips) 
Seat 4: MichaLabam ($145.42 in chips) 
Seat 5: matiko09 ($114.25 in chips) 
Seat 6: Spid1 ($167.42 in chips) 
Seat 7: nubpoker ($134.29 in chips) 
Seat 8: Filojoes ($166.68 in chips) 
Seat 9: Aghmir77 ($101.98 in chips) 
Aghmir77: posts small blind $0.50
Dickyxxx: posts big blind $1
*** HOLE CARDS ***
Dealt to matiko09 [8d Ad]
mycka86: folds 
chaps1988: folds 
MichaLabam: folds 
matiko09: folds 
Spid1: folds 
nubpoker: folds 
Filojoes: folds 
Aghmir77: folds 
Uncalled bet ($0.50) returned to Dickyxxx
Dickyxxx collected $1 from pot
Dickyxxx: doesn't show hand 
*** SUMMARY ***
Total pot $1 | Rake $0 
Seat 1: Dickyxxx (big blind) collected ($1)
Seat 2: mycka86 folded before Flop (didn't bet)
Seat 3: chaps1988 folded before Flop (didn't bet)
Seat 4: MichaLabam folded before Flop (didn't bet)
Seat 5: matiko09 folded before Flop (didn't bet)
Seat 6: Spid1 folded before Flop (didn't bet)
Seat 7: nubpoker folded before Flop (didn't bet)
Seat 8: Filojoes (button) folded before Flop (didn't bet)
Seat 9: Aghmir77 (small blind) folded before Flop





PokerStars Hand #153067613733:  Hold'em No Limit ($0.50/$1.00 USD) - 2016/05/09 16:43:28 CET [2016/05/09 10:43:28 ET]
Table 'Isberga II' 9-max Seat #4 is the button
Seat 1: CI58 ($101.50 in chips) 
Seat 2: Filojoes ($100 in chips) 
Seat 3: matiko09 ($100 in chips) 
Seat 4: Spid1 ($100 in chips) 
Seat 5: AliceIko2120 ($131.32 in chips) 
Seat 6: vkartmann ($166.80 in chips) 
Seat 7: flk.Dasas ($100 in chips) 
Seat 8: PacPacBum ($106 in chips) 
Seat 9: R1aki ($101.50 in chips) 
AliceIko2120: posts small blind $0.50
vkartmann: posts big blind $1
*** HOLE CARDS ***
Dealt to matiko09 [Ah 3d]
flk.Dasas: folds 
PacPacBum: folds 
R1aki: folds 
CI58: folds 
Filojoes: raises $2 to $3
matiko09: folds 
Spid1: folds 
AliceIko2120: folds 
vkartmann: folds 
Uncalled bet ($2) returned to Filojoes
Filojoes collected $2.50 from pot
Filojoes: doesn't show hand 
*** SUMMARY ***
Total pot $2.50 | Rake $0 
Seat 1: CI58 folded before Flop (didn't bet)
Seat 2: Filojoes collected ($2.50)
Seat 3: matiko09 folded before Flop (didn't bet)
Seat 4: Spid1 (button) folded before Flop (didn't bet)
Seat 5: AliceIko2120 (small blind) folded before Flop
Seat 6: vkartmann (big blind) folded before Flop
Seat 7: flk.Dasas folded before Flop (didn't bet)
Seat 8: PacPacBum folded before Flop (didn't bet)
Seat 9: R1aki folded before Flop (didn't bet)





PokerStars Hand #153067629421:  Hold'em No Limit ($0.50/$1.00 USD) - 2016/05/09 16:43:54 CET [2016/05/09 10:43:54 ET]
Table 'Terpsichore' 9-max Seat #1 is the button
Seat 1: ipashutapkom ($158.72 in chips) 
Seat 2: CI58 ($118.62 in chips) 
Seat 3: matiko09 ($123.34 in chips) 
Seat 4: nubpoker ($100 in chips) 
Seat 5: mycka86 ($217.72 in chips) 
Seat 6: Filojoes ($100 in chips) 
Seat 7: ozone2003 ($106.75 in chips) 
Seat 8: Kiosk230472 ($125.13 in chips) 
Seat 9: FTPbannedMe ($171.44 in chips) 
CI58: posts small blind $0.50
matiko09: posts big blind $1
*** HOLE CARDS ***
Dealt to matiko09 [8h 8s]
nubpoker: raises $1.50 to $2.50
mycka86: folds 
Filojoes: folds 
ozone2003: folds 
Kiosk230472: calls $2.50
FTPbannedMe: folds 
ipashutapkom: folds 
CI58: folds 
matiko09: calls $1.50
*** FLOP *** [6s 6c Td]
matiko09: checks 
nubpoker: bets $5.06
Kiosk230472: calls $5.06
matiko09: folds 
*** TURN *** [6s 6c Td] [Ah]
nubpoker: checks 
Kiosk230472: checks 
*** RIVER *** [6s 6c Td Ah] [Kh]
nubpoker: checks 
Kiosk230472: checks 
*** SHOW DOWN ***
nubpoker: shows [Qc Qh] (two pair, Queens and Sixes)
Kiosk230472: mucks hand 
nubpoker collected $17.21 from pot
*** SUMMARY ***
Total pot $18.12 | Rake $0.91 
Board [6s 6c Td Ah Kh]
Seat 1: ipashutapkom (button) folded before Flop (didn't bet)
Seat 2: CI58 (small blind) folded before Flop
Seat 3: matiko09 (big blind) folded on the Flop
Seat 4: nubpoker showed [Qc Qh] and won ($17.21) with two pair, Queens and Sixes
Seat 5: mycka86 folded before Flop (didn't bet)
Seat 6: Filojoes folded before Flop (didn't bet)
Seat 7: ozone2003 folded before Flop (didn't bet)
Seat 8: Kiosk230472 mucked [9c 9d]
Seat 9: FTPbannedMe folded before Flop (didn't bet)





PokerStars Hand #153067631613:  Hold'em No Limit ($0.50/$1.00 USD) - 2016/05/09 16:43:58 CET [2016/05/09 10:43:58 ET]
Table 'Hajek' 9-max Seat #9 is the button
Seat 2: Spid1 ($153 in chips) 
Seat 3: mycka86 ($100 in chips) 
Seat 4: LRVAV7 ($155.22 in chips) 
Seat 5: ozone2003 ($116.23 in chips) 
Seat 6: Filojoes ($100 in chips) 
Seat 7: DancerNN1 ($249.51 in chips) 
Seat 8: Kukuryzka ($103.47 in chips) 
Seat 9: matiko09 ($100 in chips) 
CI58 will be allowed to play after the button
Spid1: posts small blind $0.50
mycka86: posts big blind $1
Spid1: posts the ante $0.20
mycka86: posts the ante $0.20
LRVAV7: posts the ante $0.20
ozone2003: posts the ante $0.20
Filojoes: posts the ante $0.20
DancerNN1: posts the ante $0.20
Kukuryzka: posts the ante $0.20
matiko09: posts the ante $0.20
*** HOLE CARDS ***
Dealt to matiko09 [9d 4c]
LRVAV7: folds 
ozone2003: folds 
Filojoes: folds 
DancerNN1: raises $2 to $3
Kukuryzka: folds 
matiko09: folds 
Spid1: folds 
mycka86: raises $7 to $10
DancerNN1: calls $7
*** FLOP *** [Td 6s Qd]
mycka86: bets $11.55
DancerNN1: raises $33.07 to $44.62
mycka86: raises $45.18 to $89.80 and is all-in
DancerNN1: calls $45.18
*** FIRST TURN *** [Td 6s Qd] [2d]
*** FIRST RIVER *** [Td 6s Qd 2d] [6d]
*** SECOND TURN *** [Td 6s Qd] [Ts]
*** SECOND RIVER *** [Td 6s Qd Ts] [9c]
*** FIRST SHOW DOWN ***
mycka86: shows [As Qs] (two pair, Queens and Sixes)
DancerNN1: shows [Ad Jd] (a flush, Ace high)
DancerNN1 collected $99.60 from pot
*** SECOND SHOW DOWN ***
mycka86: shows [As Qs] (two pair, Queens and Tens)
DancerNN1: shows [Ad Jd] (a pair of Tens)
mycka86 collected $99.60 from pot
*** SUMMARY ***
Total pot $201.70 | Rake $2.50 
Hand was run twice
FIRST Board [Td 6s Qd 2d 6d]
SECOND Board [Td 6s Qd Ts 9c]
Seat 2: Spid1 (small blind) folded before Flop
Seat 3: mycka86 (big blind) showed [As Qs] and lost with two pair, Queens and Sixes, and won ($99.60) with two pair, Queens and Tens
Seat 4: LRVAV7 folded before Flop (didn't bet)
Seat 5: ozone2003 folded before Flop (didn't bet)
Seat 6: Filojoes folded before Flop (didn't bet)
Seat 7: DancerNN1 showed [Ad Jd] and won ($99.60) with a flush, Ace high, and lost with a pair of Tens
Seat 8: Kukuryzka folded before Flop (didn't bet)
Seat 9: matiko09 (button) folded before Flop (didn't bet)





PokerStars Hand #153067633681:  Hold'em No Limit ($0.50/$1.00 USD) - 2016/05/09 16:44:01 CET [2016/05/09 10:44:01 ET]
Table 'Reiss' 9-max Seat #9 is the button
Seat 1: Dickyxxx ($192.07 in chips) 
Seat 2: mycka86 ($118.20 in chips) 
Seat 3: chaps1988 ($100 in chips) 
Seat 4: MichaLabam ($145.42 in chips) 
Seat 5: matiko09 ($114.25 in chips) 
Seat 6: Spid1 ($167.42 in chips) 
Seat 7: nubpoker ($134.29 in chips) 
Seat 8: Filojoes ($166.68 in chips) 
Seat 9: Aghmir77 ($101.48 in chips) 
Dickyxxx: posts small blind $0.50
mycka86: posts big blind $1
*** HOLE CARDS ***
Dealt to matiko09 [9c 2d]
chaps1988: folds 
MichaLabam: raises $2 to $3
matiko09: folds 
Spid1: folds 
nubpoker: folds 
Filojoes: folds 
Aghmir77: folds 
Dickyxxx: raises $9 to $12
mycka86: folds 
MichaLabam: folds 
Uncalled bet ($9) returned to Dickyxxx
Dickyxxx collected $7 from pot
Dickyxxx: doesn't show hand 
*** SUMMARY ***
Total pot $7 | Rake $0 
Seat 1: Dickyxxx (small blind) collected ($7)
Seat 2: mycka86 (big blind) folded before Flop
Seat 3: chaps1988 folded before Flop (didn't bet)
Seat 4: MichaLabam folded before Flop
Seat 5: matiko09 folded before Flop (didn't bet)
Seat 6: Spid1 folded before Flop (didn't bet)
Seat 7: nubpoker folded before Flop (didn't bet)
Seat 8: Filojoes folded before Flop (didn't bet)
Seat 9: Aghmir77 (button) folded before Flop (didn't bet)





PokerStars Hand #153067634131:  Hold'em No Limit ($1/$2 USD) - 2016/05/09 16:44:02 CET [2016/05/09 10:44:02 ET]
Table 'Titan III' 9-max Seat #8 is the button
Seat 1: I The King I ($200 in chips) 
Seat 2: PacPacBum ($203.83 in chips) 
Seat 3: Spid1 ($447.95 in chips) 
Seat 4: MishaRychkov ($124.05 in chips) 
Seat 5: Monsthand ($280.25 in chips) 
Seat 6: matiko09 ($203.35 in chips) 
Seat 8: chaps1988 ($267.25 in chips) 
Seat 9: Sasuke777777 ($102.75 in chips) 
Sasuke777777: posts small blind $1
I The King I: posts big blind $2
*** HOLE CARDS ***
Dealt to matiko09 [6d 9c]
PacPacBum: folds 
Spid1: folds 
MishaRychkov: folds 
Monsthand: folds 
matiko09: folds 
chaps1988: folds 
Sasuke777777: raises $2 to $4
I The King I: raises $10 to $14
Sasuke777777: folds 
Uncalled bet ($10) returned to I The King I
I The King I collected $8 from pot
I The King I: doesn't show hand 
*** SUMMARY ***
Total pot $8 | Rake $0 
Seat 1: I The King I (big blind) collected ($8)
Seat 2: PacPacBum folded before Flop (didn't bet)
Seat 3: Spid1 folded before Flop (didn't bet)
Seat 4: MishaRychkov folded before Flop (didn't bet)
Seat 5: Monsthand folded before Flop (didn't bet)
Seat 6: matiko09 folded before Flop (didn't bet)
Seat 8: chaps1988 (button) folded before Flop (didn't bet)
Seat 9: Sasuke777777 (small blind) folded before Flop





PokerStars Hand #153067640946:  Hold'em No Limit ($0.50/$1.00 USD) - 2016/05/09 16:44:13 CET [2016/05/09 10:44:13 ET]
Table 'Buryatia II' 9-max Seat #2 is the button
Seat 1: flk.Dasas ($116.67 in chips) 
Seat 2: AceSurgeon ($100 in chips) 
Seat 3: Desperategam ($99 in chips) 
Seat 4: FunkyDonkey1 ($100 in chips) 
Seat 5: amisasi ($90.28 in chips) 
Seat 6: I The King I ($104.50 in chips) 
Seat 7: Spid1 ($100 in chips) 
Seat 8: matiko09 ($100 in chips) 
Seat 9: CI58 ($100 in chips) 
Desperategam: posts small blind $0.50
FunkyDonkey1: posts big blind $1
*** HOLE CARDS ***
Dealt to matiko09 [8h Ad]
amisasi: folds 
I The King I: folds 
Spid1: folds 
matiko09: folds 
CI58: folds 
flk.Dasas: folds 
AceSurgeon: folds 
Desperategam: raises $2 to $3
FunkyDonkey1: raises $6.50 to $9.50
Desperategam: folds 
Uncalled bet ($6.50) returned to FunkyDonkey1
FunkyDonkey1 collected $6 from pot
FunkyDonkey1: doesn't show hand 
*** SUMMARY ***
Total pot $6 | Rake $0 
Seat 1: flk.Dasas folded before Flop (didn't bet)
Seat 2: AceSurgeon (button) folded before Flop (didn't bet)
Seat 3: Desperategam (small blind) folded before Flop
Seat 4: FunkyDonkey1 (big blind) collected ($6)
Seat 5: amisasi folded before Flop (didn't bet)
Seat 6: I The King I folded before Flop (didn't bet)
Seat 7: Spid1 folded before Flop (didn't bet)
Seat 8: matiko09 folded before Flop (didn't bet)
Seat 9: CI58 folded before Flop (didn't bet)





PokerStars Hand #153067640695:  Hold'em No Limit ($0.50/$1.00 USD) - 2016/05/09 16:44:13 CET [2016/05/09 10:44:13 ET]
Table 'Isberga II' 9-max Seat #5 is the button
Seat 1: CI58 ($101.50 in chips) 
Seat 2: Filojoes ($101.50 in chips) 
Seat 3: matiko09 ($100 in chips) 
Seat 4: Spid1 ($100 in chips) 
Seat 5: AliceIko2120 ($130.82 in chips) 
Seat 6: vkartmann ($165.80 in chips) 
Seat 7: flk.Dasas ($100 in chips) 
Seat 8: PacPacBum ($106 in chips) 
Seat 9: R1aki ($101.50 in chips) 
vkartmann: posts small blind $0.50
flk.Dasas: posts big blind $1
*** HOLE CARDS ***
Dealt to matiko09 [4h 8s]
PacPacBum: folds 
R1aki: folds 
CI58: folds 
Filojoes: folds 
matiko09: folds 
Spid1: raises $1.50 to $2.50
AliceIko2120: folds 
vkartmann: folds 
flk.Dasas: folds 
Uncalled bet ($1.50) returned to Spid1
Spid1 collected $2.50 from pot
Spid1: doesn't show hand 
*** SUMMARY ***
Total pot $2.50 | Rake $0 
Seat 1: CI58 folded before Flop (didn't bet)
Seat 2: Filojoes folded before Flop (didn't bet)
Seat 3: matiko09 folded before Flop (didn't bet)
Seat 4: Spid1 collected ($2.50)
Seat 5: AliceIko2120 (button) folded before Flop (didn't bet)
Seat 6: vkartmann (small blind) folded before Flop
Seat 7: flk.Dasas (big blind) folded before Flop
Seat 8: PacPacBum folded before Flop (didn't bet)
Seat 9: R1aki folded before Flop (didn't bet)





PokerStars Hand #153067642288:  Hold'em No Limit ($0.50/$1.00 USD) - 2016/05/09 16:44:16 CET [2016/05/09 10:44:16 ET]
Table 'Merga II' 9-max Seat #6 is the button
Seat 1: ipashutapkom ($63.02 in chips) 
Seat 2: Filojoes ($100 in chips) 
Seat 3: xhinostrabli ($33.47 in chips) 
Seat 4: nubpoker ($100 in chips) 
Seat 5: LRVAV7 ($347.45 in chips) 
Seat 6: Spid1 ($293.38 in chips) 
Seat 7: matiko09 ($147.79 in chips) 
Seat 8: GrandOldFart ($97 in chips) 
Seat 9: chaps1988 ($145.72 in chips) 
matiko09: posts small blind $0.50
GrandOldFart: posts big blind $1
*** HOLE CARDS ***
Dealt to matiko09 [8s As]
chaps1988: folds 
ipashutapkom: folds 
Filojoes: folds 
xhinostrabli: folds 
nubpoker: raises $1.50 to $2.50
LRVAV7: folds 
Spid1: folds 
matiko09: folds 
GrandOldFart: folds 
Uncalled bet ($1.50) returned to nubpoker
nubpoker collected $2.50 from pot
nubpoker: doesn't show hand 
*** SUMMARY ***
Total pot $2.50 | Rake $0 
Seat 1: ipashutapkom folded before Flop (didn't bet)
Seat 2: Filojoes folded before Flop (didn't bet)
Seat 3: xhinostrabli folded before Flop (didn't bet)
Seat 4: nubpoker collected ($2.50)
Seat 5: LRVAV7 folded before Flop (didn't bet)
Seat 6: Spid1 (button) folded before Flop (didn't bet)
Seat 7: matiko09 (small blind) folded before Flop
Seat 8: GrandOldFart (big blind) folded before Flop
Seat 9: chaps1988 folded before Flop (didn't bet)





PokerStars Hand #153067652081:  Hold'em No Limit ($1/$2 USD) - 2016/05/09 16:44:32 CET [2016/05/09 10:44:32 ET]
Table 'Hagar II' 9-max Seat #1 is the button
Seat 1: mojitos86 ($184 in chips) 
Seat 2: darren1031 ($303.95 in chips) 
Seat 3: Sasuke777777 ($97.90 in chips) 
Seat 4: matiko09 ($246.40 in chips) 
Seat 5: PacPacBum ($222.31 in chips) 
Seat 6: el Fatto ($204.04 in chips) 
Seat 7: Monsthand ($200 in chips) 
Seat 8: AceSurgeon ($200 in chips) 
Seat 9: chaps1988 ($241.75 in chips) 
darren1031: posts small blind $1
Sasuke777777: posts big blind $2
*** HOLE CARDS ***
Dealt to matiko09 [9d Ad]
matiko09: raises $3 to $5
PacPacBum: folds 
el Fatto: folds 
Monsthand: folds 
AceSurgeon: folds 
chaps1988: raises $13 to $18
mojitos86: folds 
darren1031: folds 
Sasuke777777: calls $16
matiko09: folds 
*** FLOP *** [6s 2h 4d]
Sasuke777777: checks 
chaps1988: checks 
*** TURN *** [6s 2h 4d] [8d]
Sasuke777777: bets $18
chaps1988: calls $18
*** RIVER *** [6s 2h 4d 8d] [Jc]
Sasuke777777: bets $22
chaps1988: calls $22
*** SHOW DOWN ***
Sasuke777777: shows [2c 2s] (three of a kind, Deuces)
chaps1988: mucks hand 
Sasuke777777 collected $119.25 from pot
*** SUMMARY ***
Total pot $122 | Rake $2.75 
Board [6s 2h 4d 8d Jc]
Seat 1: mojitos86 (button) folded before Flop (didn't bet)
Seat 2: darren1031 (small blind) folded before Flop
Seat 3: Sasuke777777 (big blind) showed [2c 2s] and won ($119.25) with three of a kind, Deuces
Seat 4: matiko09 folded before Flop
Seat 5: PacPacBum folded before Flop (didn't bet)
Seat 6: el Fatto folded before Flop (didn't bet)
Seat 7: Monsthand folded before Flop (didn't bet)
Seat 8: AceSurgeon folded before Flop (didn't bet)
Seat 9: chaps1988 mucked [Ah Kc]





PokerStars Hand #153067654067:  Hold'em No Limit ($1/$2 USD) - 2016/05/09 16:44:36 CET [2016/05/09 10:44:36 ET]
Table 'Titan III' 9-max Seat #9 is the button
Seat 1: I The King I ($204 in chips) 
Seat 2: PacPacBum ($203.83 in chips) 
Seat 3: Spid1 ($447.95 in chips) 
Seat 4: MishaRychkov ($124.05 in chips) 
Seat 5: Monsthand ($280.25 in chips) 
Seat 6: matiko09 ($203.35 in chips) 
Seat 8: chaps1988 ($267.25 in chips) 
Seat 9: Sasuke777777 ($98.75 in chips) 
I The King I: posts small blind $1
PacPacBum: posts big blind $2
*** HOLE CARDS ***
Dealt to matiko09 [6s 2d]
Spid1: folds 
MishaRychkov: folds 
MishaRychkov leaves the table
Monsthand: folds 
matiko09: folds 
AceSurgeon joins the table at seat #4 
chaps1988: folds 
Sasuke777777: folds 
I The King I: folds 
Uncalled bet ($1) returned to PacPacBum
PacPacBum collected $2 from pot
PacPacBum: doesn't show hand 
*** SUMMARY ***
Total pot $2 | Rake $0 
Seat 1: I The King I (small blind) folded before Flop
Seat 2: PacPacBum (big blind) collected ($2)
Seat 3: Spid1 folded before Flop (didn't bet)
Seat 4: MishaRychkov folded before Flop (didn't bet)
Seat 5: Monsthand folded before Flop (didn't bet)
Seat 6: matiko09 folded before Flop (didn't bet)
Seat 8: chaps1988 folded before Flop (didn't bet)
Seat 9: Sasuke777777 (button) folded before Flop (didn't bet)





PokerStars Hand #153067659068:  Hold'em No Limit ($0.50/$1.00 USD) - 2016/05/09 16:44:44 CET [2016/05/09 10:44:44 ET]
Table 'Reiss' 9-max Seat #1 is the button
Seat 1: Dickyxxx ($196.07 in chips) 
Seat 2: mycka86 ($117.20 in chips) 
Seat 3: chaps1988 ($100 in chips) 
Seat 4: MichaLabam ($142.42 in chips) 
Seat 5: matiko09 ($114.25 in chips) 
Seat 6: Spid1 ($167.42 in chips) 
Seat 7: nubpoker ($134.29 in chips) 
Seat 8: Filojoes ($166.68 in chips) 
Seat 9: Aghmir77 ($101.48 in chips) 
mycka86: posts small blind $0.50
chaps1988: posts big blind $1
*** HOLE CARDS ***
Dealt to matiko09 [9c 3h]
MichaLabam: folds 
matiko09: folds 
Spid1: folds 
nubpoker: folds 
Filojoes: folds 
Aghmir77: folds 
Dickyxxx: raises $2 to $3
mycka86: folds 
chaps1988: folds 
Uncalled bet ($2) returned to Dickyxxx
Dickyxxx collected $2.50 from pot
Dickyxxx: doesn't show hand 
*** SUMMARY ***
Total pot $2.50 | Rake $0 
Seat 1: Dickyxxx (button) collected ($2.50)
Seat 2: mycka86 (small blind) folded before Flop
Seat 3: chaps1988 (big blind) folded before Flop
Seat 4: MichaLabam folded before Flop (didn't bet)
Seat 5: matiko09 folded before Flop (didn't bet)
Seat 6: Spid1 folded before Flop (didn't bet)
Seat 7: nubpoker folded before Flop (didn't bet)
Seat 8: Filojoes folded before Flop (didn't bet)
Seat 9: Aghmir77 folded before Flop (didn't bet)





PokerStars Hand #153067660764:  Hold'em No Limit ($0.50/$1.00 USD) - 2016/05/09 16:44:47 CET [2016/05/09 10:44:47 ET]
Table 'Isberga II' 9-max Seat #6 is the button
Seat 1: CI58 ($101.50 in chips) 
Seat 2: Filojoes ($101.50 in chips) 
Seat 3: matiko09 ($100 in chips) 
Seat 4: Spid1 ($101.50 in chips) 
Seat 5: AliceIko2120 ($130.82 in chips) 
Seat 6: vkartmann ($165.30 in chips) 
Seat 7: flk.Dasas ($100 in chips) 
Seat 8: PacPacBum ($106 in chips) 
Seat 9: R1aki ($101.50 in chips) 
flk.Dasas: posts small blind $0.50
PacPacBum: posts big blind $1
*** HOLE CARDS ***
Dealt to matiko09 [4s Jc]
R1aki: folds 
R1aki leaves the table
CI58: folds 
maxxmeister joins the table at seat #9 
Filojoes: folds 
matiko09: folds 
Spid1: folds 
AliceIko2120: folds 
vkartmann: raises $2 to $3
flk.Dasas: folds 
PacPacBum: calls $2
*** FLOP *** [Qd Kh 5h]
PacPacBum: checks 
vkartmann: checks 
*** TURN *** [Qd Kh 5h] [4d]
PacPacBum: bets $4.26
vkartmann: folds 
Uncalled bet ($4.26) returned to PacPacBum
PacPacBum collected $6.18 from pot
PacPacBum: doesn't show hand 
*** SUMMARY ***
Total pot $6.50 | Rake $0.32 
Board [Qd Kh 5h 4d]
Seat 1: CI58 folded before Flop (didn't bet)
Seat 2: Filojoes folded before Flop (didn't bet)
Seat 3: matiko09 folded before Flop (didn't bet)
Seat 4: Spid1 folded before Flop (didn't bet)
Seat 5: AliceIko2120 folded before Flop (didn't bet)
Seat 6: vkartmann (button) folded on the Turn
Seat 7: flk.Dasas (small blind) folded before Flop
Seat 8: PacPacBum (big blind) collected ($6.18)
Seat 9: R1aki folded before Flop (didn't bet)





PokerStars Hand #153067662174:  Hold'em No Limit ($0.50/$1.00 USD) - 2016/05/09 16:44:49 CET [2016/05/09 10:44:49 ET]
Table 'Merga II' 9-max Seat #7 is the button
Seat 1: ipashutapkom ($63.02 in chips) 
Seat 2: Filojoes ($100 in chips) 
Seat 3: xhinostrabli ($33.47 in chips) 
Seat 4: nubpoker ($101.50 in chips) 
Seat 5: LRVAV7 ($347.45 in chips) 
Seat 6: Spid1 ($293.38 in chips) 
Seat 7: matiko09 ($147.29 in chips) 
Seat 8: GrandOldFart ($96 in chips) 
Seat 9: chaps1988 ($145.72 in chips) 
GrandOldFart: posts small blind $0.50
chaps1988: posts big blind $1
*** HOLE CARDS ***
Dealt to matiko09 [5s Ad]
ipashutapkom: folds 
Filojoes: folds 
xhinostrabli: folds 
nubpoker: folds 
LRVAV7: folds 
Spid1: folds 
matiko09: raises $1.27 to $2.27
GrandOldFart: folds 
chaps1988: folds 
Uncalled bet ($1.27) returned to matiko09
matiko09 collected $2.50 from pot
matiko09: doesn't show hand 
*** SUMMARY ***
Total pot $2.50 | Rake $0 
Seat 1: ipashutapkom folded before Flop (didn't bet)
Seat 2: Filojoes folded before Flop (didn't bet)
Seat 3: xhinostrabli folded before Flop (didn't bet)
Seat 4: nubpoker folded before Flop (didn't bet)
Seat 5: LRVAV7 folded before Flop (didn't bet)
Seat 6: Spid1 folded before Flop (didn't bet)
Seat 7: matiko09 (button) collected ($2.50)
Seat 8: GrandOldFart (small blind) folded before Flop
Seat 9: chaps1988 (big blind) folded before Flop





PokerStars Hand #153067664614:  Hold'em No Limit ($1/$2 USD) - 2016/05/09 16:44:53 CET [2016/05/09 10:44:53 ET]
Table 'Titan III' 9-max Seat #1 is the button
Seat 1: I The King I ($203 in chips) 
Seat 2: PacPacBum ($204.83 in chips) 
Seat 3: Spid1 ($447.95 in chips) 
Seat 5: Monsthand ($280.25 in chips) 
Seat 6: matiko09 ($203.35 in chips) 
Seat 8: chaps1988 ($267.25 in chips) 
Seat 9: Sasuke777777 ($98.75 in chips) 
PacPacBum: posts small blind $1
Spid1: posts big blind $2
AceSurgeon: sits out 
*** HOLE CARDS ***
Dealt to matiko09 [5c Qc]
Monsthand: folds 
matiko09: folds 
chaps1988: raises $3 to $5
Sasuke777777: folds 
I The King I: folds 
PacPacBum: calls $4
Spid1: folds 
*** FLOP *** [Kd 3s 2s]
PacPacBum: checks 
chaps1988: bets $5.70
PacPacBum: folds 
Uncalled bet ($5.70) returned to chaps1988
chaps1988 collected $11.40 from pot
chaps1988: doesn't show hand 
*** SUMMARY ***
Total pot $12 | Rake $0.60 
Board [Kd 3s 2s]
Seat 1: I The King I (button) folded before Flop (didn't bet)
Seat 2: PacPacBum (small blind) folded on the Flop
Seat 3: Spid1 (big blind) folded before Flop
Seat 5: Monsthand folded before Flop (didn't bet)
Seat 6: matiko09 folded before Flop (didn't bet)
Seat 8: chaps1988 collected ($11.40)
Seat 9: Sasuke777777 folded before Flop (didn't bet)





PokerStars Hand #153067668618:  Hold'em No Limit ($0.50/$1.00 USD) - 2016/05/09 16:45:00 CET [2016/05/09 10:45:00 ET]
Table 'Buryatia II' 9-max Seat #3 is the button
Seat 1: flk.Dasas ($116.67 in chips) 
Seat 2: AceSurgeon ($100 in chips) 
Seat 3: Desperategam ($100 in chips) 
Seat 4: FunkyDonkey1 ($103 in chips) 
Seat 5: amisasi ($90.28 in chips) 
Seat 6: I The King I ($104.50 in chips) 
Seat 7: Spid1 ($100 in chips) 
Seat 8: matiko09 ($100 in chips) 
Seat 9: CI58 ($100 in chips) 
FunkyDonkey1: posts small blind $0.50
amisasi: posts big blind $1
*** HOLE CARDS ***
Dealt to matiko09 [9h Ks]
I The King I: folds 
Spid1: folds 
matiko09: folds 
CI58: folds 
flk.Dasas: raises $2 to $3
AceSurgeon: folds 
Desperategam: raises $7.50 to $10.50
FunkyDonkey1: folds 
amisasi: folds 
flk.Dasas: calls $7.50
*** FLOP *** [As 2h 4d]
flk.Dasas: checks 
Desperategam: bets $11
flk.Dasas: folds 
Uncalled bet ($11) returned to Desperategam
Desperategam collected $21.38 from pot
Desperategam: doesn't show hand 
*** SUMMARY ***
Total pot $22.50 | Rake $1.12 
Board [As 2h 4d]
Seat 1: flk.Dasas folded on the Flop
Seat 2: AceSurgeon folded before Flop (didn't bet)
Seat 3: Desperategam (button) collected ($21.38)
Seat 4: FunkyDonkey1 (small blind) folded before Flop
Seat 5: amisasi (big blind) folded before Flop
Seat 6: I The King I folded before Flop (didn't bet)
Seat 7: Spid1 folded before Flop (didn't bet)
Seat 8: matiko09 folded before Flop (didn't bet)
Seat 9: CI58 folded before Flop (didn't bet)





PokerStars Hand #153067678235:  Hold'em No Limit ($0.50/$1.00 USD) - 2016/05/09 16:45:16 CET [2016/05/09 10:45:16 ET]
Table 'Orthos' 9-max Seat #4 is the button
Seat 2: PacPacBum ($111.91 in chips) 
Seat 3: Filojoes ($118.11 in chips) 
Seat 4: nubpoker ($151.65 in chips) 
Seat 5: matiko09 ($106.08 in chips) 
Seat 6: xhinostrabli ($106.61 in chips) 
Seat 7: flk.Dasas ($128.32 in chips) 
Seat 8: Dickyxxx ($103 in chips) 
Seat 9: mycka86 ($101 in chips) 
matiko09: posts small blind $0.50
xhinostrabli: posts big blind $1
Kelvin sai: sits out 
*** HOLE CARDS ***
Dealt to matiko09 [4h 8d]
flk.Dasas: folds 
Dickyxxx: folds 
mycka86: folds 
PacPacBum: raises $1.50 to $2.50
Filojoes: folds 
nubpoker: folds 
matiko09: folds 
xhinostrabli: calls $1.50
*** FLOP *** [Ah 3s Kh]
xhinostrabli: checks 
PacPacBum: checks 
*** TURN *** [Ah 3s Kh] [Qc]
xhinostrabli: checks 
PacPacBum: checks 
*** RIVER *** [Ah 3s Kh Qc] [Qd]
xhinostrabli: checks 
PacPacBum: checks 
*** SHOW DOWN ***
xhinostrabli: shows [Kc 5c] (two pair, Kings and Queens)
PacPacBum: mucks hand 
xhinostrabli collected $5.22 from pot
*** SUMMARY ***
Total pot $5.50 | Rake $0.28 
Board [Ah 3s Kh Qc Qd]
Seat 2: PacPacBum mucked [9s 9d]
Seat 3: Filojoes folded before Flop (didn't bet)
Seat 4: nubpoker (button) folded before Flop (didn't bet)
Seat 5: matiko09 (small blind) folded before Flop
Seat 6: xhinostrabli (big blind) showed [Kc 5c] and won ($5.22) with two pair, Kings and Queens
Seat 7: flk.Dasas folded before Flop (didn't bet)
Seat 8: Dickyxxx folded before Flop (didn't bet)
Seat 9: mycka86 folded before Flop (didn't bet)





PokerStars Hand #153067680294:  Hold'em No Limit ($0.50/$1.00 USD) - 2016/05/09 16:45:20 CET [2016/05/09 10:45:20 ET]
Table 'Reiss' 9-max Seat #2 is the button
Seat 1: Dickyxxx ($197.57 in chips) 
Seat 2: mycka86 ($116.70 in chips) 
Seat 3: chaps1988 ($100 in chips) 
Seat 4: MichaLabam ($142.42 in chips) 
Seat 5: matiko09 ($114.25 in chips) 
Seat 6: Spid1 ($167.42 in chips) 
Seat 7: nubpoker ($134.29 in chips) 
Seat 8: Filojoes ($166.68 in chips) 
Seat 9: Aghmir77 ($101.48 in chips) 
chaps1988: posts small blind $0.50
MichaLabam: posts big blind $1
*** HOLE CARDS ***
Dealt to matiko09 [Ad Js]
matiko09: raises $2 to $3
Spid1: folds 
nubpoker: folds 
Filojoes: raises $6 to $9
Aghmir77: folds 
Dickyxxx: folds 
mycka86: folds 
chaps1988: raises $12 to $21
MichaLabam: folds 
matiko09: folds 
Filojoes: folds 
Uncalled bet ($12) returned to chaps1988
chaps1988 collected $22 from pot
chaps1988: doesn't show hand 
*** SUMMARY ***
Total pot $22 | Rake $0 
Seat 1: Dickyxxx folded before Flop (didn't bet)
Seat 2: mycka86 (button) folded before Flop (didn't bet)
Seat 3: chaps1988 (small blind) collected ($22)
Seat 4: MichaLabam (big blind) folded before Flop
Seat 5: matiko09 folded before Flop
Seat 6: Spid1 folded before Flop (didn't bet)
Seat 7: nubpoker folded before Flop (didn't bet)
Seat 8: Filojoes folded before Flop
Seat 9: Aghmir77 folded before Flop (didn't bet)





PokerStars Hand #153067683588:  Hold'em No Limit ($0.50/$1.00 USD) - 2016/05/09 16:45:25 CET [2016/05/09 10:45:25 ET]
Table 'Terpsichore' 9-max Seat #2 is the button
Seat 1: ipashutapkom ($158.72 in chips) 
Seat 2: CI58 ($118.12 in chips) 
Seat 3: matiko09 ($120.84 in chips) 
Seat 4: nubpoker ($109.65 in chips) 
Seat 5: mycka86 ($217.72 in chips) 
Seat 6: Filojoes ($100 in chips) 
Seat 7: ozone2003 ($106.75 in chips) 
Seat 8: Kiosk230472 ($117.57 in chips) 
Seat 9: FTPbannedMe ($171.44 in chips) 
matiko09: posts small blind $0.50
nubpoker: posts big blind $1
*** HOLE CARDS ***
Dealt to matiko09 [5s 5d]
mycka86: folds 
Filojoes: folds 
ozone2003: folds 
Kiosk230472: raises $3 to $4
FTPbannedMe: raises $8 to $12
ipashutapkom: folds 
CI58: folds 
matiko09: folds 
nubpoker: folds 
Kiosk230472: calls $8
*** FLOP *** [8h 9h 9c]
Kiosk230472: checks 
FTPbannedMe: checks 
*** TURN *** [8h 9h 9c] [4d]
Kiosk230472: bets $11
FTPbannedMe: calls $11
*** RIVER *** [8h 9h 9c 4d] [6s]
Kiosk230472: bets $1
FTPbannedMe: calls $1
*** SHOW DOWN ***
Kiosk230472: shows [Jd 8s] (two pair, Nines and Eights)
FTPbannedMe: mucks hand 
Kiosk230472 collected $47.02 from pot
*** SUMMARY ***
Total pot $49.50 | Rake $2.48 
Board [8h 9h 9c 4d 6s]
Seat 1: ipashutapkom folded before Flop (didn't bet)
Seat 2: CI58 (button) folded before Flop (didn't bet)
Seat 3: matiko09 (small blind) folded before Flop
Seat 4: nubpoker (big blind) folded before Flop
Seat 5: mycka86 folded before Flop (didn't bet)
Seat 6: Filojoes folded before Flop (didn't bet)
Seat 7: ozone2003 folded before Flop (didn't bet)
Seat 8: Kiosk230472 showed [Jd 8s] and won ($47.02) with two pair, Nines and Eights
Seat 9: FTPbannedMe mucked [Ks Ac]





PokerStars Hand #153067687450:  Hold'em No Limit ($0.50/$1.00 USD) - 2016/05/09 16:45:32 CET [2016/05/09 10:45:32 ET]
Table 'Merga II' 9-max Seat #8 is the button
Seat 1: ipashutapkom ($63.02 in chips) 
Seat 2: Filojoes ($100 in chips) 
Seat 3: xhinostrabli ($33.47 in chips) 
Seat 4: nubpoker ($101.50 in chips) 
Seat 5: LRVAV7 ($347.45 in chips) 
Seat 6: Spid1 ($293.38 in chips) 
Seat 7: matiko09 ($148.79 in chips) 
Seat 8: GrandOldFart ($95.50 in chips) 
Seat 9: chaps1988 ($144.72 in chips) 
chaps1988: posts small blind $0.50
ipashutapkom: posts big blind $1
*** HOLE CARDS ***
Dealt to matiko09 [5h Qh]
Filojoes: folds 
xhinostrabli: folds 
nubpoker: folds 
LRVAV7: raises $2 to $3
Spid1: folds 
matiko09: folds 
GrandOldFart: folds 
chaps1988: raises $9 to $12
ipashutapkom: folds 
LRVAV7: calls $9
*** FLOP *** [8d Qs Js]
chaps1988: bets $11
LRVAV7: raises $11 to $22
chaps1988: calls $11
*** TURN *** [8d Qs Js] [3s]
chaps1988: checks 
LRVAV7: checks 
*** RIVER *** [8d Qs Js 3s] [9s]
chaps1988: checks 
LRVAV7: checks 
*** SHOW DOWN ***
chaps1988: shows [Qc Qd] (three of a kind, Queens)
LRVAV7: mucks hand 
chaps1988 collected $66.50 from pot
*** SUMMARY ***
Total pot $69 | Rake $2.50 
Board [8d Qs Js 3s 9s]
Seat 1: ipashutapkom (big blind) folded before Flop
Seat 2: Filojoes folded before Flop (didn't bet)
Seat 3: xhinostrabli folded before Flop (didn't bet)
Seat 4: nubpoker folded before Flop (didn't bet)
Seat 5: LRVAV7 mucked [Jh Ah]
Seat 6: Spid1 folded before Flop (didn't bet)
Seat 7: matiko09 folded before Flop (didn't bet)
Seat 8: GrandOldFart (button) folded before Flop (didn't bet)
Seat 9: chaps1988 (small blind) showed [Qc Qd] and won ($66.50) with three of a kind, Queens





PokerStars Hand #153067688713:  Hold'em No Limit ($1/$2 USD) - 2016/05/09 16:45:34 CET [2016/05/09 10:45:34 ET]
Table 'Titan III' 9-max Seat #2 is the button
Seat 1: I The King I ($203 in chips) 
Seat 2: PacPacBum ($200 in chips) 
Seat 3: Spid1 ($445.95 in chips) 
Seat 4: AceSurgeon ($200 in chips) 
Seat 5: Monsthand ($280.25 in chips) 
Seat 6: matiko09 ($203.35 in chips) 
Seat 8: chaps1988 ($273.65 in chips) 
Seat 9: Sasuke777777 ($98.75 in chips) 
Spid1: posts small blind $1
AceSurgeon: posts big blind $2
seasar1: sits out 
*** HOLE CARDS ***
Dealt to matiko09 [7s 3s]
Monsthand: folds 
matiko09: folds 
chaps1988: folds 
Sasuke777777: calls $2
I The King I: folds 
PacPacBum: raises $6 to $8
Spid1: folds 
AceSurgeon: folds 
Sasuke777777: folds 
Uncalled bet ($6) returned to PacPacBum
PacPacBum collected $7 from pot
PacPacBum: doesn't show hand 
*** SUMMARY ***
Total pot $7 | Rake $0 
Seat 1: I The King I folded before Flop (didn't bet)
Seat 2: PacPacBum (button) collected ($7)
Seat 3: Spid1 (small blind) folded before Flop
Seat 4: AceSurgeon (big blind) folded before Flop
Seat 5: Monsthand folded before Flop (didn't bet)
Seat 6: matiko09 folded before Flop (didn't bet)
Seat 8: chaps1988 folded before Flop (didn't bet)
Seat 9: Sasuke777777 folded before Flop





PokerStars Hand #153067691671:  Hold'em No Limit ($1/$2 USD) - 2016/05/09 16:45:39 CET [2016/05/09 10:45:39 ET]
Table 'Hagar II' 9-max Seat #2 is the button
Seat 1: mojitos86 ($184 in chips) 
Seat 2: darren1031 ($302.95 in chips) 
Seat 3: Sasuke777777 ($159.15 in chips) 
Seat 4: matiko09 ($241.40 in chips) 
Seat 5: PacPacBum ($222.31 in chips) 
Seat 6: el Fatto ($204.04 in chips) 
Seat 7: Monsthand ($200 in chips) 
Seat 8: AceSurgeon ($200 in chips) 
Seat 9: chaps1988 ($200 in chips) 
Sasuke777777: posts small blind $1
matiko09: posts big blind $2
*** HOLE CARDS ***
Dealt to matiko09 [5c 8d]
PacPacBum: folds 
el Fatto: folds 
Monsthand: folds 
AceSurgeon: folds 
chaps1988: folds 
mojitos86: raises $4 to $6
darren1031: folds 
Sasuke777777: folds 
matiko09: folds 
Uncalled bet ($4) returned to mojitos86
mojitos86 collected $5 from pot
*** SUMMARY ***
Total pot $5 | Rake $0 
Seat 1: mojitos86 collected ($5)
Seat 2: darren1031 (button) folded before Flop (didn't bet)
Seat 3: Sasuke777777 (small blind) folded before Flop
Seat 4: matiko09 (big blind) folded before Flop
Seat 5: PacPacBum folded before Flop (didn't bet)
Seat 6: el Fatto folded before Flop (didn't bet)
Seat 7: Monsthand folded before Flop (didn't bet)
Seat 8: AceSurgeon folded before Flop (didn't bet)
Seat 9: chaps1988 folded before Flop (didn't bet)





PokerStars Hand #153067701507:  Hold'em No Limit ($0.50/$1.00 USD) - 2016/05/09 16:45:55 CET [2016/05/09 10:45:55 ET]
Table 'Hajek' 9-max Seat #2 is the button
Seat 2: Spid1 ($152.30 in chips) 
Seat 3: mycka86 ($100 in chips) 
Seat 4: LRVAV7 ($155.02 in chips) 
Seat 5: ozone2003 ($116.03 in chips) 
Seat 6: Filojoes ($100 in chips) 
Seat 7: DancerNN1 ($249.11 in chips) 
Seat 8: Kukuryzka ($103.27 in chips) 
Seat 9: matiko09 ($100 in chips) 
mycka86: posts small blind $0.50
LRVAV7: posts big blind $1
CI58: sits out 
Spid1: posts the ante $0.20
mycka86: posts the ante $0.20
LRVAV7: posts the ante $0.20
ozone2003: posts the ante $0.20
Filojoes: posts the ante $0.20
DancerNN1: posts the ante $0.20
Kukuryzka: posts the ante $0.20
matiko09: posts the ante $0.20
*** HOLE CARDS ***
Dealt to matiko09 [3s Kc]
ozone2003: folds 
Filojoes: folds 
DancerNN1: folds 
Kukuryzka: folds 
matiko09: folds 
Spid1: folds 
mycka86: folds 
Uncalled bet ($0.50) returned to LRVAV7
LRVAV7 collected $2.60 from pot
LRVAV7: doesn't show hand 
*** SUMMARY ***
Total pot $2.60 | Rake $0 
Seat 2: Spid1 (button) folded before Flop (didn't bet)
Seat 3: mycka86 (small blind) folded before Flop
Seat 4: LRVAV7 (big blind) collected ($2.60)
Seat 5: ozone2003 folded before Flop (didn't bet)
Seat 6: Filojoes folded before Flop (didn't bet)
Seat 7: DancerNN1 folded before Flop (didn't bet)
Seat 8: Kukuryzka folded before Flop (didn't bet)
Seat 9: matiko09 folded before Flop (didn't bet)





PokerStars Hand #153067710790:  Hold'em No Limit ($0.50/$1.00 USD) - 2016/05/09 16:46:11 CET [2016/05/09 10:46:11 ET]
Table 'Reiss' 9-max Seat #3 is the button
Seat 1: Dickyxxx ($197.57 in chips) 
Seat 2: mycka86 ($116.70 in chips) 
Seat 3: chaps1988 ($113 in chips) 
Seat 4: MichaLabam ($141.42 in chips) 
Seat 5: matiko09 ($111.25 in chips) 
Seat 6: Spid1 ($167.42 in chips) 
Seat 7: nubpoker ($134.29 in chips) 
Seat 8: Filojoes ($157.68 in chips) 
Seat 9: Aghmir77 ($101.48 in chips) 
MichaLabam: posts small blind $0.50
matiko09: posts big blind $1
*** HOLE CARDS ***
Dealt to matiko09 [Qh Ac]
Spid1: folds 
nubpoker: folds 
Filojoes: folds 
Aghmir77: raises $2 to $3
Dickyxxx: folds 
mycka86: calls $3
chaps1988: folds 
MichaLabam: folds 
matiko09: calls $2
*** FLOP *** [Ks Qs As]
matiko09: checks 
Aghmir77: bets $6
mycka86: folds 
matiko09: calls $6
*** TURN *** [Ks Qs As] [Qc]
matiko09: checks 
Aghmir77: bets $15
matiko09: calls $15
*** RIVER *** [Ks Qs As Qc] [6c]
matiko09: checks 
Aghmir77: bets $77.48 and is all-in
matiko09: calls $77.48
*** SHOW DOWN ***
Aghmir77: shows [Kd Kh] (a full house, Kings full of Queens)
matiko09: mucks hand 
Aghmir77 collected $203.96 from pot
*** SUMMARY ***
Total pot $206.46 | Rake $2.50 
Board [Ks Qs As Qc 6c]
Seat 1: Dickyxxx folded before Flop (didn't bet)
Seat 2: mycka86 folded on the Flop
Seat 3: chaps1988 (button) folded before Flop (didn't bet)
Seat 4: MichaLabam (small blind) folded before Flop
Seat 5: matiko09 (big blind) mucked [Qh Ac]
Seat 6: Spid1 folded before Flop (didn't bet)
Seat 7: nubpoker folded before Flop (didn't bet)
Seat 8: Filojoes folded before Flop (didn't bet)
Seat 9: Aghmir77 showed [Kd Kh] and won ($203.96) with a full house, Kings full of Queens





PokerStars Hand #153067714018:  Hold'em No Limit ($0.50/$1.00 USD) - 2016/05/09 16:46:16 CET [2016/05/09 10:46:16 ET]
Table 'Isberga II' 9-max Seat #7 is the button
Seat 1: CI58 ($101.50 in chips) 
Seat 2: Filojoes ($101.50 in chips) 
Seat 3: matiko09 ($100 in chips) 
Seat 4: Spid1 ($101.50 in chips) 
Seat 5: AliceIko2120 ($130.82 in chips) 
Seat 6: vkartmann ($162.30 in chips) 
Seat 7: flk.Dasas ($100 in chips) 
Seat 8: PacPacBum ($109.18 in chips) 
PacPacBum: posts small blind $0.50
CI58: posts big blind $1
*** HOLE CARDS ***
Dealt to matiko09 [9c Td]
maxxmeister leaves the table
Filojoes: folds 
matiko09: folds 
Spid1: folds 
AliceIko2120: calls $1
vkartmann: folds 
Donetsk1y joins the table at seat #9 
flk.Dasas has timed out
flk.Dasas: folds 
PacPacBum: calls $0.50
CI58: checks 
*** FLOP *** [3h 8h 8c]
PacPacBum: checks 
CI58: checks 
AliceIko2120: checks 
*** TURN *** [3h 8h 8c] [7s]
PacPacBum: bets $1
CI58: folds 
AliceIko2120: raises $2 to $3
PacPacBum: raises $3 to $6
AliceIko2120: folds 
Uncalled bet ($3) returned to PacPacBum
PacPacBum collected $8.55 from pot
PacPacBum: doesn't show hand 
*** SUMMARY ***
Total pot $9 | Rake $0.45 
Board [3h 8h 8c 7s]
Seat 1: CI58 (big blind) folded on the Turn
Seat 2: Filojoes folded before Flop (didn't bet)
Seat 3: matiko09 folded before Flop (didn't bet)
Seat 4: Spid1 folded before Flop (didn't bet)
Seat 5: AliceIko2120 folded on the Turn
Seat 6: vkartmann folded before Flop (didn't bet)
Seat 7: flk.Dasas (button) folded before Flop (didn't bet)
Seat 8: PacPacBum (small blind) collected ($8.55)





PokerStars Hand #153067715362:  Hold'em No Limit ($1/$2 USD) - 2016/05/09 16:46:18 CET [2016/05/09 10:46:18 ET]
Table 'Titan III' 9-max Seat #3 is the button
Seat 1: I The King I ($203 in chips) 
Seat 2: PacPacBum ($205 in chips) 
Seat 3: Spid1 ($444.95 in chips) 
Seat 4: AceSurgeon ($200 in chips) 
Seat 5: Monsthand ($280.25 in chips) 
Seat 6: matiko09 ($203.35 in chips) 
Seat 8: chaps1988 ($273.65 in chips) 
Seat 9: Sasuke777777 ($96.75 in chips) 
AceSurgeon: posts small blind $1
Monsthand: posts big blind $2
seasar1: sits out 
*** HOLE CARDS ***
Dealt to matiko09 [9d Jd]
matiko09: folds 
chaps1988: folds 
Sasuke777777: raises $4 to $6
I The King I: raises $12 to $18
PacPacBum: folds 
Spid1: folds 
AceSurgeon: folds 
Monsthand: folds 
Sasuke777777: folds 
Uncalled bet ($12) returned to I The King I
I The King I collected $15 from pot
I The King I: doesn't show hand 
*** SUMMARY ***
Total pot $15 | Rake $0 
Seat 1: I The King I collected ($15)
Seat 2: PacPacBum folded before Flop (didn't bet)
Seat 3: Spid1 (button) folded before Flop (didn't bet)
Seat 4: AceSurgeon (small blind) folded before Flop
Seat 5: Monsthand (big blind) folded before Flop
Seat 6: matiko09 folded before Flop (didn't bet)
Seat 8: chaps1988 folded before Flop (didn't bet)
Seat 9: Sasuke777777 folded before Flop





PokerStars Hand #153067715544:  Hold'em No Limit ($1/$2 USD) - 2016/05/09 16:46:19 CET [2016/05/09 10:46:19 ET]
Table 'Hagar II' 9-max Seat #3 is the button
Seat 1: mojitos86 ($187 in chips) 
Seat 2: darren1031 ($302.95 in chips) 
Seat 3: Sasuke777777 ($158.15 in chips) 
Seat 4: matiko09 ($239.40 in chips) 
Seat 5: PacPacBum ($222.31 in chips) 
Seat 6: el Fatto ($204.04 in chips) 
Seat 7: Monsthand ($200 in chips) 
Seat 8: AceSurgeon ($200 in chips) 
Seat 9: chaps1988 ($200 in chips) 
matiko09: posts small blind $1
PacPacBum: posts big blind $2
*** HOLE CARDS ***
Dealt to matiko09 [7c Th]
el Fatto: raises $4 to $6
Monsthand: folds 
AceSurgeon: folds 
chaps1988: folds 
mojitos86: folds 
darren1031: calls $6
Sasuke777777: folds 
matiko09: folds 
PacPacBum: folds 
*** FLOP *** [3h Td Kh]
el Fatto: bets $9
darren1031: calls $9
*** TURN *** [3h Td Kh] [5h]
el Fatto: checks 
darren1031: bets $20
el Fatto: calls $20
*** RIVER *** [3h Td Kh 5h] [3s]
el Fatto: bets $46.83
darren1031: folds 
Uncalled bet ($46.83) returned to el Fatto
el Fatto collected $70.25 from pot
el Fatto: doesn't show hand 
*** SUMMARY ***
Total pot $73 | Rake $2.75 
Board [3h Td Kh 5h 3s]
Seat 1: mojitos86 folded before Flop (didn't bet)
Seat 2: darren1031 folded on the River
Seat 3: Sasuke777777 (button) folded before Flop (didn't bet)
Seat 4: matiko09 (small blind) folded before Flop
Seat 5: PacPacBum (big blind) folded before Flop
Seat 6: el Fatto collected ($70.25)
Seat 7: Monsthand folded before Flop (didn't bet)
Seat 8: AceSurgeon folded before Flop (didn't bet)
Seat 9: chaps1988 folded before Flop (didn't bet)





PokerStars Hand #153067727395:  Hold'em No Limit ($0.50/$1.00 USD) - 2016/05/09 16:46:39 CET [2016/05/09 10:46:39 ET]
Table 'Orthos' 9-max Seat #5 is the button
Seat 2: PacPacBum ($109.41 in chips) 
Seat 3: Filojoes ($118.11 in chips) 
Seat 4: nubpoker ($151.65 in chips) 
Seat 5: matiko09 ($105.58 in chips) 
Seat 6: xhinostrabli ($109.33 in chips) 
Seat 7: flk.Dasas ($128.32 in chips) 
Seat 8: Dickyxxx ($103 in chips) 
Seat 9: mycka86 ($101 in chips) 
xhinostrabli: posts small blind $0.50
flk.Dasas: posts big blind $1
Kelvin sai: sits out 
*** HOLE CARDS ***
Dealt to matiko09 [8h 7s]
Dickyxxx: folds 
mycka86: folds 
PacPacBum: folds 
Filojoes: folds 
nubpoker: raises $1.50 to $2.50
matiko09: folds 
xhinostrabli: folds 
flk.Dasas: folds 
Uncalled bet ($1.50) returned to nubpoker
nubpoker collected $2.50 from pot
nubpoker: doesn't show hand 
*** SUMMARY ***
Total pot $2.50 | Rake $0 
Seat 2: PacPacBum folded before Flop (didn't bet)
Seat 3: Filojoes folded before Flop (didn't bet)
Seat 4: nubpoker collected ($2.50)
Seat 5: matiko09 (button) folded before Flop (didn't bet)
Seat 6: xhinostrabli (small blind) folded before Flop
Seat 7: flk.Dasas (big blind) folded before Flop
Seat 8: Dickyxxx folded before Flop (didn't bet)
Seat 9: mycka86 folded before Flop (didn't bet)





PokerStars Hand #153067734556:  Hold'em No Limit ($1/$2 USD) - 2016/05/09 16:46:50 CET [2016/05/09 10:46:50 ET]
Table 'Titan III' 9-max Seat #4 is the button
Seat 1: I The King I ($212 in chips) 
Seat 2: PacPacBum ($205 in chips) 
Seat 3: Spid1 ($444.95 in chips) 
Seat 4: AceSurgeon ($200 in chips) 
Seat 5: Monsthand ($278.25 in chips) 
Seat 6: matiko09 ($203.35 in chips) 
Seat 8: chaps1988 ($273.65 in chips) 
Seat 9: Sasuke777777 ($90.75 in chips) 
Monsthand: posts small blind $1
matiko09: posts big blind $2
seasar1: sits out 
*** HOLE CARDS ***
Dealt to matiko09 [Ah Js]
chaps1988: folds 
Sasuke777777: folds 
I The King I: folds 
PacPacBum: folds 
Spid1: folds 
AceSurgeon: raises $4 to $6
Monsthand: folds 
matiko09: raises $14 to $20
AceSurgeon: calls $14
*** FLOP *** [Qh 9c 5s]
matiko09: checks 
AceSurgeon: checks 
*** TURN *** [Qh 9c 5s] [2s]
matiko09: checks 
AceSurgeon: bets $20
matiko09: folds 
Uncalled bet ($20) returned to AceSurgeon
AceSurgeon collected $38.95 from pot
*** SUMMARY ***
Total pot $41 | Rake $2.05 
Board [Qh 9c 5s 2s]
Seat 1: I The King I folded before Flop (didn't bet)
Seat 2: PacPacBum folded before Flop (didn't bet)
Seat 3: Spid1 folded before Flop (didn't bet)
Seat 4: AceSurgeon (button) collected ($38.95)
Seat 5: Monsthand (small blind) folded before Flop
Seat 6: matiko09 (big blind) folded on the Turn
Seat 8: chaps1988 folded before Flop (didn't bet)
Seat 9: Sasuke777777 folded before Flop (didn't bet)





PokerStars Hand #153067736679:  Hold'em No Limit ($0.50/$1.00 USD) - 2016/05/09 16:46:54 CET [2016/05/09 10:46:54 ET]
Table 'Hajek' 9-max Seat #3 is the button
Seat 2: Spid1 ($152.10 in chips) 
Seat 3: mycka86 ($100 in chips) 
Seat 4: LRVAV7 ($156.92 in chips) 
Seat 5: ozone2003 ($115.83 in chips) 
Seat 6: Filojoes ($100 in chips) 
Seat 7: DancerNN1 ($248.91 in chips) 
Seat 8: Kukuryzka ($103.07 in chips) 
Seat 9: matiko09 ($100 in chips) 
LRVAV7: posts small blind $0.50
ozone2003: posts big blind $1
CI58: sits out 
Spid1: posts the ante $0.20
mycka86: posts the ante $0.20
LRVAV7: posts the ante $0.20
ozone2003: posts the ante $0.20
Filojoes: posts the ante $0.20
DancerNN1: posts the ante $0.20
Kukuryzka: posts the ante $0.20
matiko09: posts the ante $0.20
*** HOLE CARDS ***
Dealt to matiko09 [4h 9h]
Filojoes: folds 
DancerNN1: folds 
Kukuryzka: folds 
matiko09: folds 
Spid1: folds 
mycka86: raises $2 to $3
LRVAV7: folds 
ozone2003: folds 
Uncalled bet ($2) returned to mycka86
mycka86 collected $4.10 from pot
*** SUMMARY ***
Total pot $4.10 | Rake $0 
Seat 2: Spid1 folded before Flop (didn't bet)
Seat 3: mycka86 (button) collected ($4.10)
Seat 4: LRVAV7 (small blind) folded before Flop
Seat 5: ozone2003 (big blind) folded before Flop
Seat 6: Filojoes folded before Flop (didn't bet)
Seat 7: DancerNN1 folded before Flop (didn't bet)
Seat 8: Kukuryzka folded before Flop (didn't bet)
Seat 9: matiko09 folded before Flop (didn't bet)





PokerStars Hand #153067739727:  Hold'em No Limit ($0.50/$1.00 USD) - 2016/05/09 16:46:59 CET [2016/05/09 10:46:59 ET]
Table 'Merga II' 9-max Seat #9 is the button
Seat 1: ipashutapkom ($62.02 in chips) 
Seat 2: Filojoes ($100 in chips) 
Seat 3: xhinostrabli ($33.47 in chips) 
Seat 4: nubpoker ($101.50 in chips) 
Seat 5: LRVAV7 ($313.45 in chips) 
Seat 6: Spid1 ($293.38 in chips) 
Seat 7: matiko09 ($148.79 in chips) 
Seat 8: GrandOldFart ($95.50 in chips) 
Seat 9: chaps1988 ($177.22 in chips) 
ipashutapkom: posts small blind $0.50
Filojoes: posts big blind $1
*** HOLE CARDS ***
Dealt to matiko09 [Ad 6d]
xhinostrabli: folds 
nubpoker: folds 
LRVAV7: folds 
LRVAV7 leaves the table
Spid1: folds 
matiko09: raises $2 to $3
GrandOldFart: folds 
chaps1988: folds 
ipashutapkom: folds 
Filojoes: folds 
Uncalled bet ($2) returned to matiko09
matiko09 collected $2.50 from pot
matiko09: doesn't show hand 
*** SUMMARY ***
Total pot $2.50 | Rake $0 
Seat 1: ipashutapkom (small blind) folded before Flop
Seat 2: Filojoes (big blind) folded before Flop
Seat 3: xhinostrabli folded before Flop (didn't bet)
Seat 4: nubpoker folded before Flop (didn't bet)
Seat 5: LRVAV7 folded before Flop (didn't bet)
Seat 6: Spid1 folded before Flop (didn't bet)
Seat 7: matiko09 collected ($2.50)
Seat 8: GrandOldFart folded before Flop (didn't bet)
Seat 9: chaps1988 (button) folded before Flop (didn't bet)





PokerStars Hand #153067744445:  Hold'em No Limit ($0.50/$1.00 USD) - 2016/05/09 16:47:07 CET [2016/05/09 10:47:07 ET]
Table 'Buryatia II' 9-max Seat #4 is the button
Seat 1: flk.Dasas ($106.17 in chips) 
Seat 2: AceSurgeon ($100 in chips) 
Seat 3: Desperategam ($110.88 in chips) 
Seat 4: FunkyDonkey1 ($102.50 in chips) 
Seat 5: amisasi ($89.28 in chips) 
Seat 6: I The King I ($104.50 in chips) 
Seat 7: Spid1 ($100 in chips) 
Seat 8: matiko09 ($100 in chips) 
Seat 9: CI58 ($100 in chips) 
amisasi: posts small blind $0.50
I The King I: posts big blind $1
*** HOLE CARDS ***
Dealt to matiko09 [Th As]
Spid1: folds 
matiko09: folds 
CI58: folds 
flk.Dasas: folds 
AceSurgeon: folds 
Desperategam: folds 
FunkyDonkey1: raises $1 to $2
amisasi: folds 
I The King I: folds 
Uncalled bet ($1) returned to FunkyDonkey1
FunkyDonkey1 collected $2.50 from pot
FunkyDonkey1: doesn't show hand 
*** SUMMARY ***
Total pot $2.50 | Rake $0 
Seat 1: flk.Dasas folded before Flop (didn't bet)
Seat 2: AceSurgeon folded before Flop (didn't bet)
Seat 3: Desperategam folded before Flop (didn't bet)
Seat 4: FunkyDonkey1 (button) collected ($2.50)
Seat 5: amisasi (small blind) folded before Flop
Seat 6: I The King I (big blind) folded before Flop
Seat 7: Spid1 folded before Flop (didn't bet)
Seat 8: matiko09 folded before Flop (didn't bet)
Seat 9: CI58 folded before Flop (didn't bet)





PokerStars Hand #153067745797:  Hold'em No Limit ($0.50/$1.00 USD) - 2016/05/09 16:47:09 CET [2016/05/09 10:47:09 ET]
Table 'Terpsichore' 9-max Seat #3 is the button
Seat 1: ipashutapkom ($158.72 in chips) 
Seat 2: CI58 ($118.12 in chips) 
Seat 3: matiko09 ($120.34 in chips) 
Seat 4: nubpoker ($108.65 in chips) 
Seat 5: mycka86 ($217.72 in chips) 
Seat 6: Filojoes ($100 in chips) 
Seat 7: ozone2003 ($106.75 in chips) 
Seat 8: Kiosk230472 ($140.59 in chips) 
Seat 9: FTPbannedMe ($147.44 in chips) 
nubpoker: posts small blind $0.50
mycka86: posts big blind $1
*** HOLE CARDS ***
Dealt to matiko09 [4h 7h]
Filojoes: folds 
ozone2003: folds 
Kiosk230472: calls $1
FTPbannedMe: folds 
ipashutapkom: folds 
CI58: raises $3 to $4
matiko09: folds 
nubpoker: folds 
mycka86: folds 
Kiosk230472: calls $3
*** FLOP *** [Ac 4s Jc]
Kiosk230472: checks 
CI58: bets $4.51
Kiosk230472: calls $4.51
*** TURN *** [Ac 4s Jc] [Qd]
Kiosk230472: checks 
CI58: checks 
*** RIVER *** [Ac 4s Jc Qd] [2s]
Kiosk230472: checks 
CI58: checks 
*** SHOW DOWN ***
Kiosk230472: shows [9h Js] (a pair of Jacks)
CI58: shows [Tc Jd] (a pair of Jacks - Ace+Queen+Ten kicker)
CI58 collected $17.59 from pot
*** SUMMARY ***
Total pot $18.52 | Rake $0.93 
Board [Ac 4s Jc Qd 2s]
Seat 1: ipashutapkom folded before Flop (didn't bet)
Seat 2: CI58 showed [Tc Jd] and won ($17.59) with a pair of Jacks
Seat 3: matiko09 (button) folded before Flop (didn't bet)
Seat 4: nubpoker (small blind) folded before Flop
Seat 5: mycka86 (big blind) folded before Flop
Seat 6: Filojoes folded before Flop (didn't bet)
Seat 7: ozone2003 folded before Flop (didn't bet)
Seat 8: Kiosk230472 showed [9h Js] and lost with a pair of Jacks
Seat 9: FTPbannedMe folded before Flop (didn't bet)





PokerStars Hand #153067746423:  Hold'em No Limit ($0.50/$1.00 USD) - 2016/05/09 16:47:10 CET [2016/05/09 10:47:10 ET]
Table 'Orthos' 9-max Seat #6 is the button
Seat 2: PacPacBum ($109.41 in chips) 
Seat 3: Filojoes ($118.11 in chips) 
Seat 4: nubpoker ($153.15 in chips) 
Seat 5: matiko09 ($105.58 in chips) 
Seat 6: xhinostrabli ($108.83 in chips) 
Seat 7: flk.Dasas ($127.32 in chips) 
Seat 8: Dickyxxx ($103 in chips) 
Seat 9: mycka86 ($101 in chips) 
flk.Dasas: posts small blind $0.50
Dickyxxx: posts big blind $1
Kelvin sai: sits out 
*** HOLE CARDS ***
Dealt to matiko09 [4c Jc]
mycka86: folds 
PacPacBum: folds 
Filojoes: folds 
nubpoker: raises $1.50 to $2.50
matiko09: folds 
xhinostrabli: folds 
flk.Dasas: folds 
Dickyxxx: folds 
Uncalled bet ($1.50) returned to nubpoker
nubpoker collected $2.50 from pot
nubpoker: doesn't show hand 
*** SUMMARY ***
Total pot $2.50 | Rake $0 
Seat 2: PacPacBum folded before Flop (didn't bet)
Seat 3: Filojoes folded before Flop (didn't bet)
Seat 4: nubpoker collected ($2.50)
Seat 5: matiko09 folded before Flop (didn't bet)
Seat 6: xhinostrabli (button) folded before Flop (didn't bet)
Seat 7: flk.Dasas (small blind) folded before Flop
Seat 8: Dickyxxx (big blind) folded before Flop
Seat 9: mycka86 folded before Flop (didn't bet)





PokerStars Hand #153067755342:  Hold'em No Limit ($0.50/$1.00 USD) - 2016/05/09 16:47:25 CET [2016/05/09 10:47:25 ET]
Table 'Merga II' 9-max Seat #1 is the button
Seat 1: ipashutapkom ($61.52 in chips) 
Seat 2: Filojoes ($100 in chips) 
Seat 3: xhinostrabli ($33.47 in chips) 
Seat 4: nubpoker ($101.50 in chips) 
Seat 6: Spid1 ($293.38 in chips) 
Seat 7: matiko09 ($150.29 in chips) 
Seat 8: GrandOldFart ($95.50 in chips) 
Seat 9: chaps1988 ($177.22 in chips) 
Filojoes: posts small blind $0.50
xhinostrabli: posts big blind $1
*** HOLE CARDS ***
Dealt to matiko09 [Kc 5s]
nubpoker: folds 
Spid1: raises $2 to $3
matiko09: folds 
GrandOldFart: folds 
chaps1988: calls $3
ipashutapkom: folds 
Filojoes: folds 
xhinostrabli: calls $2
*** FLOP *** [9d 8h 4d]
xhinostrabli: checks 
Spid1: checks 
chaps1988: bets $5.33
xhinostrabli: folds 
Spid1: calls $5.33
*** TURN *** [9d 8h 4d] [Js]
ozone2003 joins the table at seat #5 
Spid1: checks 
chaps1988: checks 
*** RIVER *** [9d 8h 4d Js] [Qh]
Spid1: bets $15.50
chaps1988: folds 
Uncalled bet ($15.50) returned to Spid1
Spid1 collected $19.15 from pot
Spid1: doesn't show hand 
*** SUMMARY ***
Total pot $20.16 | Rake $1.01 
Board [9d 8h 4d Js Qh]
Seat 1: ipashutapkom (button) folded before Flop (didn't bet)
Seat 2: Filojoes (small blind) folded before Flop
Seat 3: xhinostrabli (big blind) folded on the Flop
Seat 4: nubpoker folded before Flop (didn't bet)
Seat 6: Spid1 collected ($19.15)
Seat 7: matiko09 folded before Flop (didn't bet)
Seat 8: GrandOldFart folded before Flop (didn't bet)
Seat 9: chaps1988 folded on the River





PokerStars Hand #153067769067:  Hold'em No Limit ($0.50/$1.00 USD) - 2016/05/09 16:47:48 CET [2016/05/09 10:47:48 ET]
Table 'Isberga II' 9-max Seat #8 is the button
Seat 1: CI58 ($100.50 in chips) 
Seat 2: Filojoes ($101.50 in chips) 
Seat 3: matiko09 ($100 in chips) 
Seat 4: Spid1 ($101.50 in chips) 
Seat 5: AliceIko2120 ($126.82 in chips) 
Seat 6: vkartmann ($162.30 in chips) 
Seat 7: flk.Dasas ($100 in chips) 
Seat 8: PacPacBum ($113.73 in chips) 
Donetsk1y will be allowed to play after the button
CI58: posts small blind $0.50
Filojoes: posts big blind $1
*** HOLE CARDS ***
Dealt to matiko09 [As Td]
matiko09: folds 
Spid1: raises $2 to $3
AliceIko2120: folds 
vkartmann: folds 
flk.Dasas: folds 
PacPacBum: folds 
CI58: folds 
Filojoes: folds 
Uncalled bet ($2) returned to Spid1
Spid1 collected $2.50 from pot
*** SUMMARY ***
Total pot $2.50 | Rake $0 
Seat 1: CI58 (small blind) folded before Flop
Seat 2: Filojoes (big blind) folded before Flop
Seat 3: matiko09 folded before Flop (didn't bet)
Seat 4: Spid1 collected ($2.50)
Seat 5: AliceIko2120 folded before Flop (didn't bet)
Seat 6: vkartmann folded before Flop (didn't bet)
Seat 7: flk.Dasas folded before Flop (didn't bet)
Seat 8: PacPacBum (button) folded before Flop (didn't bet)





PokerStars Hand #153067772210:  Hold'em No Limit ($0.50/$1.00 USD) - 2016/05/09 16:47:53 CET [2016/05/09 10:47:53 ET]
Table 'Hajek' 9-max Seat #4 is the button
Seat 2: Spid1 ($151.90 in chips) 
Seat 3: mycka86 ($102.90 in chips) 
Seat 4: LRVAV7 ($156.22 in chips) 
Seat 5: ozone2003 ($114.63 in chips) 
Seat 6: Filojoes ($100 in chips) 
Seat 7: DancerNN1 ($248.71 in chips) 
Seat 8: Kukuryzka ($102.87 in chips) 
Seat 9: matiko09 ($100 in chips) 
ozone2003: posts small blind $0.50
Filojoes: posts big blind $1
CI58: sits out 
Spid1: posts the ante $0.20
mycka86: posts the ante $0.20
LRVAV7: posts the ante $0.20
ozone2003: posts the ante $0.20
Filojoes: posts the ante $0.20
DancerNN1: posts the ante $0.20
Kukuryzka: posts the ante $0.20
matiko09: posts the ante $0.20
*** HOLE CARDS ***
Dealt to matiko09 [3c 5h]
DancerNN1: folds 
Kukuryzka: folds 
matiko09: folds 
Spid1: folds 
mycka86: folds 
LRVAV7: raises $2 to $3
ozone2003: folds 
Filojoes: folds 
Uncalled bet ($2) returned to LRVAV7
LRVAV7 collected $4.10 from pot
LRVAV7: doesn't show hand 
*** SUMMARY ***
Total pot $4.10 | Rake $0 
Seat 2: Spid1 folded before Flop (didn't bet)
Seat 3: mycka86 folded before Flop (didn't bet)
Seat 4: LRVAV7 (button) collected ($4.10)
Seat 5: ozone2003 (small blind) folded before Flop
Seat 6: Filojoes (big blind) folded before Flop
Seat 7: DancerNN1 folded before Flop (didn't bet)
Seat 8: Kukuryzka folded before Flop (didn't bet)
Seat 9: matiko09 folded before Flop (didn't bet)





PokerStars Hand #153067773876:  Hold'em No Limit ($0.50/$1.00 USD) - 2016/05/09 16:47:56 CET [2016/05/09 10:47:56 ET]
Table 'Buryatia II' 9-max Seat #5 is the button
Seat 1: flk.Dasas ($106.17 in chips) 
Seat 2: AceSurgeon ($100 in chips) 
Seat 3: Desperategam ($110.88 in chips) 
Seat 4: FunkyDonkey1 ($104 in chips) 
Seat 5: amisasi ($88.78 in chips) 
Seat 6: I The King I ($103.50 in chips) 
Seat 8: matiko09 ($100 in chips) 
Seat 9: CI58 ($100 in chips) 
I The King I: posts small blind $0.50
Spid1: is sitting out 
matiko09: posts big blind $1
*** HOLE CARDS ***
Dealt to matiko09 [6d Qc]
Spid1 leaves the table
CI58: folds 
nubpoker joins the table at seat #7 
flk.Dasas: folds 
AceSurgeon: folds 
Desperategam: raises $2 to $3
FunkyDonkey1: folds 
amisasi: calls $3
I The King I: calls $2.50
matiko09: folds 
*** FLOP *** [Qh 9c Kc]
I The King I: checks 
Desperategam: bets $9
amisasi: folds 
I The King I: folds 
Uncalled bet ($9) returned to Desperategam
Desperategam collected $9.50 from pot
Desperategam: doesn't show hand 
*** SUMMARY ***
Total pot $10 | Rake $0.50 
Board [Qh 9c Kc]
Seat 1: flk.Dasas folded before Flop (didn't bet)
Seat 2: AceSurgeon folded before Flop (didn't bet)
Seat 3: Desperategam collected ($9.50)
Seat 4: FunkyDonkey1 folded before Flop (didn't bet)
Seat 5: amisasi (button) folded on the Flop
Seat 6: I The King I (small blind) folded on the Flop
Seat 8: matiko09 (big blind) folded before Flop
Seat 9: CI58 folded before Flop (didn't bet)





PokerStars Hand #153067786205:  Hold'em No Limit ($0.50/$1.00 USD) - 2016/05/09 16:48:16 CET [2016/05/09 10:48:16 ET]
Table 'Reiss' 9-max Seat #4 is the button
Seat 1: Dickyxxx ($197.57 in chips) 
Seat 2: mycka86 ($113.70 in chips) 
Seat 3: chaps1988 ($113 in chips) 
Seat 4: MichaLabam ($140.92 in chips) 
Seat 5: matiko09 ($100 in chips) 
Seat 6: Spid1 ($167.42 in chips) 
Seat 7: nubpoker ($134.29 in chips) 
Seat 8: Filojoes ($157.68 in chips) 
Seat 9: Aghmir77 ($203.96 in chips) 
matiko09: posts small blind $0.50
Spid1: posts big blind $1
*** HOLE CARDS ***
Dealt to matiko09 [9c 4c]
nubpoker: folds 
Filojoes: folds 
Aghmir77: folds 
Dickyxxx: folds 
mycka86: folds 
chaps1988: folds 
MichaLabam: raises $2 to $3
matiko09: folds 
Spid1: calls $2
*** FLOP *** [7s 4d Tc]
Spid1: checks 
MichaLabam: checks 
*** TURN *** [7s 4d Tc] [8c]
Spid1: bets $4.50
MichaLabam: calls $4.50
*** RIVER *** [7s 4d Tc 8c] [3d]
Spid1: bets $11.50
MichaLabam: folds 
Uncalled bet ($11.50) returned to Spid1
Spid1 collected $14.72 from pot
Spid1: doesn't show hand 
*** SUMMARY ***
Total pot $15.50 | Rake $0.78 
Board [7s 4d Tc 8c 3d]
Seat 1: Dickyxxx folded before Flop (didn't bet)
Seat 2: mycka86 folded before Flop (didn't bet)
Seat 3: chaps1988 folded before Flop (didn't bet)
Seat 4: MichaLabam (button) folded on the River
Seat 5: matiko09 (small blind) folded before Flop
Seat 6: Spid1 (big blind) collected ($14.72)
Seat 7: nubpoker folded before Flop (didn't bet)
Seat 8: Filojoes folded before Flop (didn't bet)
Seat 9: Aghmir77 folded before Flop (didn't bet)





PokerStars Hand #153067785856:  Hold'em No Limit ($0.50/$1.00 USD) - 2016/05/09 16:48:16 CET [2016/05/09 10:48:16 ET]
Table 'Orthos' 9-max Seat #7 is the button
Seat 2: PacPacBum ($109.41 in chips) 
Seat 3: Filojoes ($118.11 in chips) 
Seat 4: nubpoker ($154.65 in chips) 
Seat 5: matiko09 ($105.58 in chips) 
Seat 6: xhinostrabli ($108.83 in chips) 
Seat 7: flk.Dasas ($126.82 in chips) 
Seat 8: Dickyxxx ($102 in chips) 
Seat 9: mycka86 ($101 in chips) 
Dickyxxx: posts small blind $0.50
mycka86: posts big blind $1
Kelvin sai: sits out 
*** HOLE CARDS ***
Dealt to matiko09 [Ac 4d]
PacPacBum: folds 
Filojoes: folds 
nubpoker: folds 
matiko09: folds 
xhinostrabli: raises $2 to $3
flk.Dasas: folds 
Dickyxxx: folds 
mycka86: folds 
Uncalled bet ($2) returned to xhinostrabli
xhinostrabli collected $2.50 from pot
*** SUMMARY ***
Total pot $2.50 | Rake $0 
Seat 2: PacPacBum folded before Flop (didn't bet)
Seat 3: Filojoes folded before Flop (didn't bet)
Seat 4: nubpoker folded before Flop (didn't bet)
Seat 5: matiko09 folded before Flop (didn't bet)
Seat 6: xhinostrabli collected ($2.50)
Seat 7: flk.Dasas (button) folded before Flop (didn't bet)
Seat 8: Dickyxxx (small blind) folded before Flop
Seat 9: mycka86 (big blind) folded before Flop





PokerStars Hand #153067788715:  Hold'em No Limit ($1/$2 USD) - 2016/05/09 16:48:21 CET [2016/05/09 10:48:21 ET]
Table 'Hagar II' 9-max Seat #4 is the button
Seat 1: mojitos86 ($187 in chips) 
Seat 2: darren1031 ($267.95 in chips) 
Seat 3: Sasuke777777 ($158.15 in chips) 
Seat 4: matiko09 ($238.40 in chips) 
Seat 5: PacPacBum ($220.31 in chips) 
Seat 6: el Fatto ($239.29 in chips) 
Seat 7: Monsthand ($200 in chips) 
Seat 8: AceSurgeon ($200 in chips) 
Seat 9: chaps1988 ($200 in chips) 
PacPacBum: posts small blind $1
el Fatto: posts big blind $2
*** HOLE CARDS ***
Dealt to matiko09 [8s 9s]
Monsthand: folds 
AceSurgeon: folds 
chaps1988: folds 
mojitos86: folds 
darren1031: calls $2
Sasuke777777: raises $8 to $10
matiko09: folds 
PacPacBum: folds 
el Fatto: raises $18 to $28
darren1031: folds 
Sasuke777777: raises $130.15 to $158.15 and is all-in
el Fatto: folds 
Uncalled bet ($130.15) returned to Sasuke777777
Sasuke777777 collected $59 from pot
Sasuke777777: doesn't show hand 
*** SUMMARY ***
Total pot $59 | Rake $0 
Seat 1: mojitos86 folded before Flop (didn't bet)
Seat 2: darren1031 folded before Flop
Seat 3: Sasuke777777 collected ($59)
Seat 4: matiko09 (button) folded before Flop (didn't bet)
Seat 5: PacPacBum (small blind) folded before Flop
Seat 6: el Fatto (big blind) folded before Flop
Seat 7: Monsthand folded before Flop (didn't bet)
Seat 8: AceSurgeon folded before Flop (didn't bet)
Seat 9: chaps1988 folded before Flop (didn't bet)





PokerStars Hand #153067792224:  Hold'em No Limit ($1/$2 USD) - 2016/05/09 16:48:26 CET [2016/05/09 10:48:26 ET]
Table 'Titan III' 9-max Seat #5 is the button
Seat 1: I The King I ($212 in chips) 
Seat 2: PacPacBum ($205 in chips) 
Seat 3: Spid1 ($444.95 in chips) 
Seat 4: AceSurgeon ($218.95 in chips) 
Seat 5: Monsthand ($277.25 in chips) 
Seat 6: matiko09 ($200 in chips) 
Seat 7: seasar1 ($200 in chips) 
Seat 8: chaps1988 ($273.65 in chips) 
Seat 9: Sasuke777777 ($90.75 in chips) 
matiko09: posts small blind $1
seasar1: posts big blind $2
*** HOLE CARDS ***
Dealt to matiko09 [3s 3h]
chaps1988: folds 
Sasuke777777: folds 
I The King I: folds 
PacPacBum: folds 
Spid1: folds 
AceSurgeon: raises $4 to $6
Monsthand: folds 
matiko09: folds 
seasar1: calls $4
*** FLOP *** [4c 9c Tc]
seasar1: checks 
AceSurgeon: bets $8
seasar1: calls $8
*** TURN *** [4c 9c Tc] [7s]
seasar1: checks 
AceSurgeon: checks 
*** RIVER *** [4c 9c Tc 7s] [6h]
seasar1: checks 
AceSurgeon: bets $16
seasar1: calls $16
*** SHOW DOWN ***
AceSurgeon: shows [8h 8d] (a straight, Six to Ten)
seasar1: mucks hand 
AceSurgeon collected $58.25 from pot
*** SUMMARY ***
Total pot $61 | Rake $2.75 
Board [4c 9c Tc 7s 6h]
Seat 1: I The King I folded before Flop (didn't bet)
Seat 2: PacPacBum folded before Flop (didn't bet)
Seat 3: Spid1 folded before Flop (didn't bet)
Seat 4: AceSurgeon showed [8h 8d] and won ($58.25) with a straight, Six to Ten
Seat 5: Monsthand (button) folded before Flop (didn't bet)
Seat 6: matiko09 (small blind) folded before Flop
Seat 7: seasar1 (big blind) mucked [Ac 9h]
Seat 8: chaps1988 folded before Flop (didn't bet)
Seat 9: Sasuke777777 folded before Flop (didn't bet)





PokerStars Hand #153067792762:  Hold'em No Limit ($0.50/$1.00 USD) - 2016/05/09 16:48:27 CET [2016/05/09 10:48:27 ET]
Table 'Terpsichore' 9-max Seat #4 is the button
Seat 1: ipashutapkom ($158.72 in chips) 
Seat 2: CI58 ($127.20 in chips) 
Seat 3: matiko09 ($120.34 in chips) 
Seat 4: nubpoker ($108.15 in chips) 
Seat 5: mycka86 ($216.72 in chips) 
Seat 6: Filojoes ($100 in chips) 
Seat 7: ozone2003 ($106.75 in chips) 
Seat 8: Kiosk230472 ($132.08 in chips) 
Seat 9: FTPbannedMe ($147.44 in chips) 
mycka86: posts small blind $0.50
Filojoes: posts big blind $1
*** HOLE CARDS ***
Dealt to matiko09 [8h Th]
ozone2003: folds 
Kiosk230472: raises $6 to $7
FTPbannedMe: folds 
ipashutapkom: folds 
CI58: folds 
matiko09: folds 
nubpoker: folds 
mycka86: folds 
Filojoes: folds 
Uncalled bet ($6) returned to Kiosk230472
Kiosk230472 collected $2.50 from pot
Kiosk230472: doesn't show hand 
*** SUMMARY ***
Total pot $2.50 | Rake $0 
Seat 1: ipashutapkom folded before Flop (didn't bet)
Seat 2: CI58 folded before Flop (didn't bet)
Seat 3: matiko09 folded before Flop (didn't bet)
Seat 4: nubpoker (button) folded before Flop (didn't bet)
Seat 5: mycka86 (small blind) folded before Flop
Seat 6: Filojoes (big blind) folded before Flop
Seat 7: ozone2003 folded before Flop (didn't bet)
Seat 8: Kiosk230472 collected ($2.50)
Seat 9: FTPbannedMe folded before Flop (didn't bet)





PokerStars Hand #153067809923:  Hold'em No Limit ($0.50/$1.00 USD) - 2016/05/09 16:48:56 CET [2016/05/09 10:48:56 ET]
Table 'Merga II' 9-max Seat #2 is the button
Seat 1: ipashutapkom ($61.52 in chips) 
Seat 2: Filojoes ($100 in chips) 
Seat 3: xhinostrabli ($30.47 in chips) 
Seat 4: nubpoker ($101.50 in chips) 
Seat 6: Spid1 ($304.20 in chips) 
Seat 7: matiko09 ($150.29 in chips) 
Seat 8: GrandOldFart ($95.50 in chips) 
Seat 9: chaps1988 ($168.89 in chips) 
xhinostrabli: posts small blind $0.50
nubpoker: posts big blind $1
ozone2003: sits out 
*** HOLE CARDS ***
Dealt to matiko09 [Th 5c]
Spid1: folds 
matiko09: folds 
GrandOldFart: raises $2 to $3
chaps1988: folds 
ipashutapkom: folds 
Filojoes: folds 
ozone2003 leaves the table
xhinostrabli: folds 
flk.Dasas joins the table at seat #5 
nubpoker: folds 
Uncalled bet ($2) returned to GrandOldFart
GrandOldFart collected $2.50 from pot
*** SUMMARY ***
Total pot $2.50 | Rake $0 
Seat 1: ipashutapkom folded before Flop (didn't bet)
Seat 2: Filojoes (button) folded before Flop (didn't bet)
Seat 3: xhinostrabli (small blind) folded before Flop
Seat 4: nubpoker (big blind) folded before Flop
Seat 6: Spid1 folded before Flop (didn't bet)
Seat 7: matiko09 folded before Flop (didn't bet)
Seat 8: GrandOldFart collected ($2.50)
Seat 9: chaps1988 folded before Flop (didn't bet)





PokerStars Hand #153067812095:  Hold'em No Limit ($0.50/$1.00 USD) - 2016/05/09 16:48:59 CET [2016/05/09 10:48:59 ET]
Table 'Hajek' 9-max Seat #5 is the button
Seat 2: Spid1 ($151.70 in chips) 
Seat 3: mycka86 ($102.70 in chips) 
Seat 4: LRVAV7 ($159.12 in chips) 
Seat 5: ozone2003 ($113.93 in chips) 
Seat 6: Filojoes ($100 in chips) 
Seat 7: DancerNN1 ($248.51 in chips) 
Seat 8: Kukuryzka ($102.67 in chips) 
Seat 9: matiko09 ($100 in chips) 
Filojoes: posts small blind $0.50
DancerNN1: posts big blind $1
CI58: sits out 
Spid1: posts the ante $0.20
mycka86: posts the ante $0.20
LRVAV7: posts the ante $0.20
ozone2003: posts the ante $0.20
Filojoes: posts the ante $0.20
DancerNN1: posts the ante $0.20
Kukuryzka: posts the ante $0.20
matiko09: posts the ante $0.20
*** HOLE CARDS ***
Dealt to matiko09 [2h Jh]
Kukuryzka: folds 
matiko09: folds 
Spid1: folds 
mycka86: folds 
LRVAV7: folds 
ozone2003: raises $1.20 to $2.20
Filojoes: folds 
DancerNN1: calls $1.20
*** FLOP *** [8s Tc 6c]
DancerNN1: checks 
ozone2003 has timed out
ozone2003: checks 
*** TURN *** [8s Tc 6c] [7d]
DancerNN1: checks 
ozone2003: bets $4.06
DancerNN1: calls $4.06
*** RIVER *** [8s Tc 6c 7d] [6s]
DancerNN1: checks 
ozone2003: bets $8.75
DancerNN1: folds 
Uncalled bet ($8.75) returned to ozone2003
ozone2003 collected $13.89 from pot
ozone2003: doesn't show hand 
*** SUMMARY ***
Total pot $14.62 | Rake $0.73 
Board [8s Tc 6c 7d 6s]
Seat 2: Spid1 folded before Flop (didn't bet)
Seat 3: mycka86 folded before Flop (didn't bet)
Seat 4: LRVAV7 folded before Flop (didn't bet)
Seat 5: ozone2003 (button) collected ($13.89)
Seat 6: Filojoes (small blind) folded before Flop
Seat 7: DancerNN1 (big blind) folded on the River
Seat 8: Kukuryzka folded before Flop (didn't bet)
Seat 9: matiko09 folded before Flop (didn't bet)





PokerStars Hand #153067812612:  Hold'em No Limit ($0.50/$1.00 USD) - 2016/05/09 16:49:00 CET [2016/05/09 10:49:00 ET]
Table 'Orthos' 9-max Seat #8 is the button
Seat 1: Kelvin sai ($82.28 in chips) 
Seat 2: PacPacBum ($109.41 in chips) 
Seat 3: Filojoes ($118.11 in chips) 
Seat 4: nubpoker ($154.65 in chips) 
Seat 5: matiko09 ($105.58 in chips) 
Seat 6: xhinostrabli ($110.33 in chips) 
Seat 7: flk.Dasas ($126.82 in chips) 
Seat 8: Dickyxxx ($101.50 in chips) 
Seat 9: mycka86 ($100 in chips) 
mycka86: posts small blind $0.50
Kelvin sai: posts big blind $1
*** HOLE CARDS ***
Dealt to matiko09 [5c Qh]
PacPacBum: folds 
Filojoes: folds 
nubpoker: folds 
matiko09: folds 
xhinostrabli: folds 
flk.Dasas: folds 
Dickyxxx: raises $2 to $3
mycka86: folds 
Kelvin sai: calls $2
*** FLOP *** [Ac 9c 5h]
Kelvin sai: bets $3
Dickyxxx: folds 
Uncalled bet ($3) returned to Kelvin sai
Kelvin sai collected $6.18 from pot
Kelvin sai: doesn't show hand 
*** SUMMARY ***
Total pot $6.50 | Rake $0.32 
Board [Ac 9c 5h]
Seat 1: Kelvin sai (big blind) collected ($6.18)
Seat 2: PacPacBum folded before Flop (didn't bet)
Seat 3: Filojoes folded before Flop (didn't bet)
Seat 4: nubpoker folded before Flop (didn't bet)
Seat 5: matiko09 folded before Flop (didn't bet)
Seat 6: xhinostrabli folded before Flop (didn't bet)
Seat 7: flk.Dasas folded before Flop (didn't bet)
Seat 8: Dickyxxx (button) folded on the Flop
Seat 9: mycka86 (small blind) folded before Flop





PokerStars Hand #153067813749:  Hold'em No Limit ($1/$2 USD) - 2016/05/09 16:49:02 CET [2016/05/09 10:49:02 ET]
Table 'Hagar II' 9-max Seat #5 is the button
Seat 1: mojitos86 ($187 in chips) 
Seat 2: darren1031 ($265.95 in chips) 
Seat 3: Sasuke777777 ($189.15 in chips) 
Seat 4: matiko09 ($238.40 in chips) 
Seat 5: PacPacBum ($219.31 in chips) 
Seat 6: el Fatto ($211.29 in chips) 
Seat 7: Monsthand ($200 in chips) 
Seat 8: AceSurgeon ($200 in chips) 
Seat 9: chaps1988 ($200 in chips) 
el Fatto: posts small blind $1
Monsthand: posts big blind $2
*** HOLE CARDS ***
Dealt to matiko09 [Jc Js]
AceSurgeon: folds 
chaps1988: folds 
mojitos86: folds 
darren1031: folds 
Sasuke777777: folds 
matiko09: raises $3 to $5
PacPacBum: folds 
el Fatto: folds 
Monsthand: raises $13 to $18
matiko09: calls $13
*** FLOP *** [Ah 4h Kc]
Monsthand: bets $19.50
matiko09: folds 
Uncalled bet ($19.50) returned to Monsthand
Monsthand collected $35.15 from pot
Monsthand: doesn't show hand 
*** SUMMARY ***
Total pot $37 | Rake $1.85 
Board [Ah 4h Kc]
Seat 1: mojitos86 folded before Flop (didn't bet)
Seat 2: darren1031 folded before Flop (didn't bet)
Seat 3: Sasuke777777 folded before Flop (didn't bet)
Seat 4: matiko09 folded on the Flop
Seat 5: PacPacBum (button) folded before Flop (didn't bet)
Seat 6: el Fatto (small blind) folded before Flop
Seat 7: Monsthand (big blind) collected ($35.15)
Seat 8: AceSurgeon folded before Flop (didn't bet)
Seat 9: chaps1988 folded before Flop (didn't bet)





PokerStars Hand #153067814290:  Hold'em No Limit ($0.50/$1.00 USD) - 2016/05/09 16:49:03 CET [2016/05/09 10:49:03 ET]
Table 'Buryatia II' 9-max Seat #6 is the button
Seat 1: flk.Dasas ($106.17 in chips) 
Seat 2: AceSurgeon ($100 in chips) 
Seat 3: Desperategam ($117.38 in chips) 
Seat 4: FunkyDonkey1 ($104 in chips) 
Seat 5: amisasi ($85.78 in chips) 
Seat 6: I The King I ($100.50 in chips) 
Seat 8: matiko09 ($100 in chips) 
Seat 9: CI58 ($100 in chips) 
matiko09: posts small blind $0.50
CI58: posts big blind $1
*** HOLE CARDS ***
Dealt to matiko09 [2h 5c]
flk.Dasas: folds 
AceSurgeon: folds 
Desperategam: raises $2 to $3
FunkyDonkey1: folds 
amisasi: folds 
I The King I: folds 
matiko09: folds 
CI58: folds 
Uncalled bet ($2) returned to Desperategam
Desperategam collected $2.50 from pot
*** SUMMARY ***
Total pot $2.50 | Rake $0 
Seat 1: flk.Dasas folded before Flop (didn't bet)
Seat 2: AceSurgeon folded before Flop (didn't bet)
Seat 3: Desperategam collected ($2.50)
Seat 4: FunkyDonkey1 folded before Flop (didn't bet)
Seat 5: amisasi folded before Flop (didn't bet)
Seat 6: I The King I (button) folded before Flop (didn't bet)
Seat 8: matiko09 (small blind) folded before Flop
Seat 9: CI58 (big blind) folded before Flop





PokerStars Hand #153067819171:  Hold'em No Limit ($0.50/$1.00 USD) - 2016/05/09 16:49:11 CET [2016/05/09 10:49:11 ET]
Table 'Terpsichore' 9-max Seat #5 is the button
Seat 1: ipashutapkom ($158.72 in chips) 
Seat 2: CI58 ($127.20 in chips) 
Seat 3: matiko09 ($120.34 in chips) 
Seat 4: nubpoker ($108.15 in chips) 
Seat 5: mycka86 ($216.22 in chips) 
Seat 6: Filojoes ($100 in chips) 
Seat 7: ozone2003 ($106.75 in chips) 
Seat 8: Kiosk230472 ($133.58 in chips) 
Seat 9: FTPbannedMe ($147.44 in chips) 
Filojoes: posts small blind $0.50
ozone2003: posts big blind $1
*** HOLE CARDS ***
Dealt to matiko09 [4s Jd]
Kiosk230472: folds 
FTPbannedMe: raises $2 to $3
ipashutapkom: folds 
CI58: folds 
matiko09: folds 
nubpoker: folds 
mycka86: folds 
Filojoes: folds 
ozone2003: folds 
Uncalled bet ($2) returned to FTPbannedMe
FTPbannedMe collected $2.50 from pot
FTPbannedMe: doesn't show hand 
*** SUMMARY ***
Total pot $2.50 | Rake $0 
Seat 1: ipashutapkom folded before Flop (didn't bet)
Seat 2: CI58 folded before Flop (didn't bet)
Seat 3: matiko09 folded before Flop (didn't bet)
Seat 4: nubpoker folded before Flop (didn't bet)
Seat 5: mycka86 (button) folded before Flop (didn't bet)
Seat 6: Filojoes (small blind) folded before Flop
Seat 7: ozone2003 (big blind) folded before Flop
Seat 8: Kiosk230472 folded before Flop (didn't bet)
Seat 9: FTPbannedMe collected ($2.50)





PokerStars Hand #153067824576:  Hold'em No Limit ($0.50/$1.00 USD) - 2016/05/09 16:49:20 CET [2016/05/09 10:49:20 ET]
Table 'Reiss' 9-max Seat #5 is the button
Seat 1: Dickyxxx ($197.57 in chips) 
Seat 2: mycka86 ($113.70 in chips) 
Seat 3: chaps1988 ($113 in chips) 
Seat 4: MichaLabam ($133.42 in chips) 
Seat 5: matiko09 ($100 in chips) 
Seat 6: Spid1 ($174.64 in chips) 
Seat 8: Filojoes ($157.68 in chips) 
Seat 9: Aghmir77 ($203.96 in chips) 
Spid1: posts small blind $0.50
Filojoes: posts big blind $1
*** HOLE CARDS ***
Dealt to matiko09 [7h Qc]
Aghmir77: folds 
Dickyxxx: folds 
mycka86: folds 
chaps1988: folds 
MichaLabam: folds 
MichaLabam leaves the table
matiko09: folds 
Aghmir77 leaves the table
Spid1: folds 
Uncalled bet ($0.50) returned to Filojoes
Filojoes collected $1 from pot
Filojoes: doesn't show hand 
*** SUMMARY ***
Total pot $1 | Rake $0 
Seat 1: Dickyxxx folded before Flop (didn't bet)
Seat 2: mycka86 folded before Flop (didn't bet)
Seat 3: chaps1988 folded before Flop (didn't bet)
Seat 4: MichaLabam folded before Flop (didn't bet)
Seat 5: matiko09 (button) folded before Flop (didn't bet)
Seat 6: Spid1 (small blind) folded before Flop
Seat 8: Filojoes (big blind) collected ($1)
Seat 9: Aghmir77 folded before Flop (didn't bet)





PokerStars Hand #153067827521:  Hold'em No Limit ($1/$2 USD) - 2016/05/09 16:49:25 CET [2016/05/09 10:49:25 ET]
Table 'Titan III' 9-max Seat #6 is the button
Seat 1: I The King I ($212 in chips) 
Seat 2: PacPacBum ($205 in chips) 
Seat 3: Spid1 ($444.95 in chips) 
Seat 5: Monsthand ($277.25 in chips) 
Seat 6: matiko09 ($200 in chips) 
Seat 7: seasar1 ($170 in chips) 
Seat 8: chaps1988 ($273.65 in chips) 
Seat 9: Sasuke777777 ($90.75 in chips) 
seasar1: posts small blind $1
chaps1988: posts big blind $2
*** HOLE CARDS ***
Dealt to matiko09 [Kh 6d]
Sasuke777777: folds 
I The King I: raises $4 to $6
PacPacBum: folds 
Spid1: folds 
Monsthand: folds 
matiko09: folds 
seasar1: calls $5
chaps1988: folds 
*** FLOP *** [3d Js Ac]
seasar1: checks 
I The King I: checks 
*** TURN *** [3d Js Ac] [6h]
seasar1: checks 
I The King I: checks 
*** RIVER *** [3d Js Ac 6h] [2h]
seasar1: checks 
I The King I: checks 
*** SHOW DOWN ***
seasar1: shows [5c 5s] (a pair of Fives)
I The King I: shows [9d 9h] (a pair of Nines)
I The King I collected $13.30 from pot
*** SUMMARY ***
Total pot $14 | Rake $0.70 
Board [3d Js Ac 6h 2h]
Seat 1: I The King I showed [9d 9h] and won ($13.30) with a pair of Nines
Seat 2: PacPacBum folded before Flop (didn't bet)
Seat 3: Spid1 folded before Flop (didn't bet)
Seat 5: Monsthand folded before Flop (didn't bet)
Seat 6: matiko09 (button) folded before Flop (didn't bet)
Seat 7: seasar1 (small blind) showed [5c 5s] and lost with a pair of Fives
Seat 8: chaps1988 (big blind) folded before Flop
Seat 9: Sasuke777777 folded before Flop (didn't bet)





PokerStars Hand #153067839266:  Hold'em No Limit ($0.50/$1.00 USD) - 2016/05/09 16:49:45 CET [2016/05/09 10:49:45 ET]
Table 'Orthos' 9-max Seat #9 is the button
Seat 1: Kelvin sai ($85.46 in chips) 
Seat 2: PacPacBum ($109.41 in chips) 
Seat 3: Filojoes ($118.11 in chips) 
Seat 4: nubpoker ($154.65 in chips) 
Seat 5: matiko09 ($105.58 in chips) 
Seat 6: xhinostrabli ($110.33 in chips) 
Seat 7: flk.Dasas ($126.82 in chips) 
Seat 8: Dickyxxx ($100 in chips) 
Seat 9: mycka86 ($100 in chips) 
Kelvin sai: posts small blind $0.50
PacPacBum: posts big blind $1
*** HOLE CARDS ***
Dealt to matiko09 [9d 3c]
Filojoes: folds 
nubpoker: folds 
matiko09: folds 
xhinostrabli: folds 
flk.Dasas: folds 
Dickyxxx: raises $2 to $3
mycka86: raises $6.50 to $9.50
Kelvin sai: folds 
PacPacBum: folds 
Dickyxxx: folds 
Uncalled bet ($6.50) returned to mycka86
mycka86 collected $7.50 from pot
*** SUMMARY ***
Total pot $7.50 | Rake $0 
Seat 1: Kelvin sai (small blind) folded before Flop
Seat 2: PacPacBum (big blind) folded before Flop
Seat 3: Filojoes folded before Flop (didn't bet)
Seat 4: nubpoker folded before Flop (didn't bet)
Seat 5: matiko09 folded before Flop (didn't bet)
Seat 6: xhinostrabli folded before Flop (didn't bet)
Seat 7: flk.Dasas folded before Flop (didn't bet)
Seat 8: Dickyxxx folded before Flop
Seat 9: mycka86 (button) collected ($7.50)





PokerStars Hand #153067842438:  Hold'em No Limit ($0.50/$1.00 USD) - 2016/05/09 16:49:50 CET [2016/05/09 10:49:50 ET]
Table 'Reiss' 9-max Seat #6 is the button
Seat 1: Dickyxxx ($197.57 in chips) 
Seat 2: mycka86 ($113.70 in chips) 
Seat 3: chaps1988 ($113 in chips) 
Seat 5: matiko09 ($100 in chips) 
Seat 6: Spid1 ($174.14 in chips) 
Seat 8: Filojoes ($158.18 in chips) 
Filojoes: posts small blind $0.50
Dickyxxx: posts big blind $1
*** HOLE CARDS ***
Dealt to matiko09 [3c Kc]
mycka86: folds 
chaps1988: raises $1.50 to $2.50
matiko09: folds 
Spid1: folds 
Filojoes: folds 
Dickyxxx: folds 
Uncalled bet ($1.50) returned to chaps1988
chaps1988 collected $2.50 from pot
chaps1988: doesn't show hand 
*** SUMMARY ***
Total pot $2.50 | Rake $0 
Seat 1: Dickyxxx (big blind) folded before Flop
Seat 2: mycka86 folded before Flop (didn't bet)
Seat 3: chaps1988 collected ($2.50)
Seat 5: matiko09 folded before Flop (didn't bet)
Seat 6: Spid1 (button) folded before Flop (didn't bet)
Seat 8: Filojoes (small blind) folded before Flop





PokerStars Hand #153067843377:  Hold'em No Limit ($0.50/$1.00 USD) - 2016/05/09 16:49:51 CET [2016/05/09 10:49:51 ET]
Table 'Buryatia II' 9-max Seat #8 is the button
Seat 1: flk.Dasas ($106.17 in chips) 
Seat 3: Desperategam ($118.88 in chips) 
Seat 4: FunkyDonkey1 ($104 in chips) 
Seat 5: amisasi ($85.78 in chips) 
Seat 6: I The King I ($100.50 in chips) 
Seat 8: matiko09 ($100 in chips) 
Seat 9: CI58 ($100 in chips) 
CI58: posts small blind $0.50
flk.Dasas: posts big blind $1
*** HOLE CARDS ***
Dealt to matiko09 [Qh 9h]
Desperategam: folds 
FunkyDonkey1: folds 
amisasi: folds 
I The King I: folds 
matiko09: raises $1.27 to $2.27
CI58: folds 
flk.Dasas: calls $1.27
*** FLOP *** [Td 6s 3d]
flk.Dasas: checks 
matiko09: bets $3.11
flk.Dasas: folds 
Uncalled bet ($3.11) returned to matiko09
matiko09 collected $4.79 from pot
matiko09: doesn't show hand 
*** SUMMARY ***
Total pot $5.04 | Rake $0.25 
Board [Td 6s 3d]
Seat 1: flk.Dasas (big blind) folded on the Flop
Seat 3: Desperategam folded before Flop (didn't bet)
Seat 4: FunkyDonkey1 folded before Flop (didn't bet)
Seat 5: amisasi folded before Flop (didn't bet)
Seat 6: I The King I folded before Flop (didn't bet)
Seat 8: matiko09 (button) collected ($4.79)
Seat 9: CI58 (small blind) folded before Flop





PokerStars Hand #153067850984:  Hold'em No Limit ($1/$2 USD) - 2016/05/09 16:50:04 CET [2016/05/09 10:50:04 ET]
Table 'Hagar II' 9-max Seat #6 is the button
Seat 1: mojitos86 ($187 in chips) 
Seat 2: darren1031 ($265.95 in chips) 
Seat 3: Sasuke777777 ($189.15 in chips) 
Seat 4: matiko09 ($220.40 in chips) 
Seat 5: PacPacBum ($219.31 in chips) 
Seat 6: el Fatto ($210.29 in chips) 
Seat 7: Monsthand ($217.15 in chips) 
Seat 9: chaps1988 ($200 in chips) 
Monsthand: posts small blind $1
chaps1988: posts big blind $2
*** HOLE CARDS ***
Dealt to matiko09 [6h 8s]
mojitos86: folds 
darren1031: folds 
Sasuke777777: folds 
matiko09: folds 
PacPacBum: folds 
el Fatto: folds 
Monsthand: folds 
Uncalled bet ($1) returned to chaps1988
chaps1988 collected $2 from pot
chaps1988: doesn't show hand 
*** SUMMARY ***
Total pot $2 | Rake $0 
Seat 1: mojitos86 folded before Flop (didn't bet)
Seat 2: darren1031 folded before Flop (didn't bet)
Seat 3: Sasuke777777 folded before Flop (didn't bet)
Seat 4: matiko09 folded before Flop (didn't bet)
Seat 5: PacPacBum folded before Flop (didn't bet)
Seat 6: el Fatto (button) folded before Flop (didn't bet)
Seat 7: Monsthand (small blind) folded before Flop
Seat 9: chaps1988 (big blind) collected ($2)





PokerStars Hand #153067852888:  Hold'em No Limit ($1/$2 USD) - 2016/05/09 16:50:07 CET [2016/05/09 10:50:07 ET]
Table 'Titan III' 9-max Seat #7 is the button
Seat 1: I The King I ($219.30 in chips) 
Seat 2: PacPacBum ($205 in chips) 
Seat 3: Spid1 ($444.95 in chips) 
Seat 5: Monsthand ($277.25 in chips) 
Seat 6: matiko09 ($200 in chips) 
Seat 7: seasar1 ($195 in chips) 
Seat 8: chaps1988 ($271.65 in chips) 
Seat 9: Sasuke777777 ($90.75 in chips) 
chaps1988: posts small blind $1
Sasuke777777: posts big blind $2
*** HOLE CARDS ***
Dealt to matiko09 [5c 3s]
I The King I: folds 
PacPacBum: folds 
Spid1: folds 
Monsthand: folds 
matiko09: folds 
seasar1: folds 
chaps1988: raises $4 to $6
Sasuke777777: raises $8 to $14
chaps1988: calls $8
*** FLOP *** [Js 2c 6c]
chaps1988: checks 
Sasuke777777: bets $26.60
chaps1988: folds 
Uncalled bet ($26.60) returned to Sasuke777777
Sasuke777777 collected $26.60 from pot
Sasuke777777: doesn't show hand 
*** SUMMARY ***
Total pot $28 | Rake $1.40 
Board [Js 2c 6c]
Seat 1: I The King I folded before Flop (didn't bet)
Seat 2: PacPacBum folded before Flop (didn't bet)
Seat 3: Spid1 folded before Flop (didn't bet)
Seat 5: Monsthand folded before Flop (didn't bet)
Seat 6: matiko09 folded before Flop (didn't bet)
Seat 7: seasar1 (button) folded before Flop (didn't bet)
Seat 8: chaps1988 (small blind) folded on the Flop
Seat 9: Sasuke777777 (big blind) collected ($26.60)





PokerStars Hand #153067856709:  Hold'em No Limit ($0.50/$1.00 USD) - 2016/05/09 16:50:14 CET [2016/05/09 10:50:14 ET]
Table 'Reiss' 9-max Seat #8 is the button
Seat 1: Dickyxxx ($196.57 in chips) 
Seat 2: mycka86 ($113.70 in chips) 
Seat 3: chaps1988 ($114.50 in chips) 
Seat 5: matiko09 ($100 in chips) 
Seat 6: Spid1 ($174.14 in chips) 
Seat 8: Filojoes ($157.68 in chips) 
Dickyxxx: posts small blind $0.50
mycka86: posts big blind $1
*** HOLE CARDS ***
Dealt to matiko09 [3c As]
I The King I joins the table at seat #4 
I The King I leaves the table
chaps1988: folds 
matiko09: folds 
Spid1: folds 
Filojoes: raises $1 to $2
Dickyxxx: raises $9 to $11
mycka86: folds 
flyer9898 joins the table at seat #9 
pokerrewa joins the table at seat #4 
Filojoes: calls $9
*** FLOP *** [3h 9d 4s]
Dickyxxx: bets $14.56
Filojoes: raises $19.44 to $34
Dickyxxx: folds 
Uncalled bet ($19.44) returned to Filojoes
Filojoes collected $49.62 from pot
Filojoes: doesn't show hand 
*** SUMMARY ***
Total pot $52.12 | Rake $2.50 
Board [3h 9d 4s]
Seat 1: Dickyxxx (small blind) folded on the Flop
Seat 2: mycka86 (big blind) folded before Flop
Seat 3: chaps1988 folded before Flop (didn't bet)
Seat 5: matiko09 folded before Flop (didn't bet)
Seat 6: Spid1 folded before Flop (didn't bet)
Seat 8: Filojoes (button) collected ($49.62)





PokerStars Hand #153067861328:  Hold'em No Limit ($0.50/$1.00 USD) - 2016/05/09 16:50:21 CET [2016/05/09 10:50:21 ET]
Table 'Terpsichore' 9-max Seat #6 is the button
Seat 1: ipashutapkom ($158.72 in chips) 
Seat 2: CI58 ($127.20 in chips) 
Seat 3: matiko09 ($120.34 in chips) 
Seat 4: nubpoker ($108.15 in chips) 
Seat 5: mycka86 ($216.22 in chips) 
Seat 6: Filojoes ($100 in chips) 
Seat 7: ozone2003 ($105.75 in chips) 
Seat 8: Kiosk230472 ($133.58 in chips) 
Seat 9: FTPbannedMe ($148.94 in chips) 
ozone2003: posts small blind $0.50
Kiosk230472: posts big blind $1
*** HOLE CARDS ***
Dealt to matiko09 [6h 2h]
FTPbannedMe: raises $2 to $3
ipashutapkom: folds 
CI58: folds 
matiko09: folds 
nubpoker: calls $3
mycka86: folds 
Filojoes: folds 
ozone2003: folds 
Kiosk230472: calls $2
*** FLOP *** [5c Jd 7d]
Kiosk230472: checks 
FTPbannedMe: bets $6.76
nubpoker: calls $6.76
Kiosk230472: folds 
*** TURN *** [5c Jd 7d] [Ks]
FTPbannedMe: checks 
nubpoker: checks 
*** RIVER *** [5c Jd 7d Ks] [5h]
FTPbannedMe: checks 
nubpoker: bets $14.57
FTPbannedMe: calls $14.57
*** SHOW DOWN ***
nubpoker: shows [Kd Qd] (two pair, Kings and Fives)
FTPbannedMe: mucks hand 
nubpoker collected $49.66 from pot
*** SUMMARY ***
Total pot $52.16 | Rake $2.50 
Board [5c Jd 7d Ks 5h]
Seat 1: ipashutapkom folded before Flop (didn't bet)
Seat 2: CI58 folded before Flop (didn't bet)
Seat 3: matiko09 folded before Flop (didn't bet)
Seat 4: nubpoker showed [Kd Qd] and won ($49.66) with two pair, Kings and Fives
Seat 5: mycka86 folded before Flop (didn't bet)
Seat 6: Filojoes (button) folded before Flop (didn't bet)
Seat 7: ozone2003 (small blind) folded before Flop
Seat 8: Kiosk230472 (big blind) folded on the Flop
Seat 9: FTPbannedMe mucked [Qs Qc]





PokerStars Hand #153067863763:  Hold'em No Limit ($0.50/$1.00 USD) - 2016/05/09 16:50:25 CET [2016/05/09 10:50:25 ET]
Table 'Orthos' 9-max Seat #1 is the button
Seat 1: Kelvin sai ($84.96 in chips) 
Seat 2: PacPacBum ($108.41 in chips) 
Seat 3: Filojoes ($118.11 in chips) 
Seat 4: nubpoker ($154.65 in chips) 
Seat 5: matiko09 ($105.58 in chips) 
Seat 6: xhinostrabli ($110.33 in chips) 
Seat 7: flk.Dasas ($126.82 in chips) 
Seat 8: Dickyxxx ($100 in chips) 
Seat 9: mycka86 ($104.50 in chips) 
PacPacBum: posts small blind $0.50
Filojoes: posts big blind $1
*** HOLE CARDS ***
Dealt to matiko09 [Ad 4h]
nubpoker: folds 
matiko09: folds 
xhinostrabli has timed out
xhinostrabli: folds 
flk.Dasas: folds 
Dickyxxx: folds 
mycka86: folds 
Kelvin sai: raises $1 to $2
PacPacBum: raises $5 to $7
Filojoes: folds 
Kelvin sai: folds 
Uncalled bet ($5) returned to PacPacBum
PacPacBum collected $5 from pot
PacPacBum: doesn't show hand 
*** SUMMARY ***
Total pot $5 | Rake $0 
Seat 1: Kelvin sai (button) folded before Flop
Seat 2: PacPacBum (small blind) collected ($5)
Seat 3: Filojoes (big blind) folded before Flop
Seat 4: nubpoker folded before Flop (didn't bet)
Seat 5: matiko09 folded before Flop (didn't bet)
Seat 6: xhinostrabli folded before Flop (didn't bet)
Seat 7: flk.Dasas folded before Flop (didn't bet)
Seat 8: Dickyxxx folded before Flop (didn't bet)
Seat 9: mycka86 folded before Flop (didn't bet)





PokerStars Hand #153067867123:  Hold'em No Limit ($1/$2 USD) - 2016/05/09 16:50:31 CET [2016/05/09 10:50:31 ET]
Table 'Hagar II' 9-max Seat #7 is the button
Seat 1: mojitos86 ($187 in chips) 
Seat 2: darren1031 ($265.95 in chips) 
Seat 3: Sasuke777777 ($189.15 in chips) 
Seat 4: matiko09 ($220.40 in chips) 
Seat 5: PacPacBum ($219.31 in chips) 
Seat 6: el Fatto ($210.29 in chips) 
Seat 7: Monsthand ($216.15 in chips) 
Seat 9: chaps1988 ($201 in chips) 
chaps1988: posts small blind $1
mojitos86: posts big blind $2
*** HOLE CARDS ***
Dealt to matiko09 [4s 9h]
darren1031: folds 
Sasuke777777: folds 
matiko09: folds 
PacPacBum: raises $2.08 to $4.08
el Fatto: folds 
Monsthand: folds 
chaps1988: folds 
mojitos86: calls $2.08
*** FLOP *** [Kc Ad 2s]
mojitos86: checks 
PacPacBum: bets $3.04
mojitos86: calls $3.04
*** TURN *** [Kc Ad 2s] [3c]
mojitos86: checks 
PacPacBum: checks 
*** RIVER *** [Kc Ad 2s 3c] [Ac]
mojitos86: bets $8
PacPacBum: folds 
Uncalled bet ($8) returned to mojitos86
mojitos86 collected $14.48 from pot
*** SUMMARY ***
Total pot $15.24 | Rake $0.76 
Board [Kc Ad 2s 3c Ac]
Seat 1: mojitos86 (big blind) collected ($14.48)
Seat 2: darren1031 folded before Flop (didn't bet)
Seat 3: Sasuke777777 folded before Flop (didn't bet)
Seat 4: matiko09 folded before Flop (didn't bet)
Seat 5: PacPacBum folded on the River
Seat 6: el Fatto folded before Flop (didn't bet)
Seat 7: Monsthand (button) folded before Flop (didn't bet)
Seat 9: chaps1988 (small blind) folded before Flop





PokerStars Hand #153067873485:  Hold'em No Limit ($0.50/$1.00 USD) - 2016/05/09 16:50:41 CET [2016/05/09 10:50:41 ET]
Table 'Eucharis' 9-max Seat #6 is the button
Seat 1: Spid1 ($100 in chips) 
Seat 2: Chef-Zizou ($80 in chips) 
Seat 3: kiyo94 ($70 in chips) 
Seat 4: matiko09 ($100 in chips) 
Seat 5: mycka86 ($100 in chips) 
Seat 6: Mukhin1 ($100 in chips) 
Seat 7: ThorSun ($40 in chips) 
Seat 8: Kukuryzka ($100 in chips) 
Seat 9: nubpoker ($100 in chips) 
ThorSun: posts small blind $0.50
Kukuryzka: posts big blind $1
*** HOLE CARDS ***
Dealt to matiko09 [9h 4d]
nubpoker: folds 
Spid1: raises $1 to $2
Chef-Zizou: folds 
kiyo94: folds 
matiko09: folds 
mycka86: folds 
Mukhin1: folds 
ThorSun: folds 
Kukuryzka: folds 
Uncalled bet ($1) returned to Spid1
Spid1 collected $2.50 from pot
Spid1: doesn't show hand 
*** SUMMARY ***
Total pot $2.50 | Rake $0 
Seat 1: Spid1 collected ($2.50)
Seat 2: Chef-Zizou folded before Flop (didn't bet)
Seat 3: kiyo94 folded before Flop (didn't bet)
Seat 4: matiko09 folded before Flop (didn't bet)
Seat 5: mycka86 folded before Flop (didn't bet)
Seat 6: Mukhin1 (button) folded before Flop (didn't bet)
Seat 7: ThorSun (small blind) folded before Flop
Seat 8: Kukuryzka (big blind) folded before Flop
Seat 9: nubpoker folded before Flop (didn't bet)





PokerStars Hand #153067882405:  Hold'em No Limit ($1/$2 USD) - 2016/05/09 16:50:56 CET [2016/05/09 10:50:56 ET]
Table 'Titan III' 9-max Seat #8 is the button
Seat 1: I The King I ($219.30 in chips) 
Seat 2: PacPacBum ($205 in chips) 
Seat 3: Spid1 ($444.95 in chips) 
Seat 5: Monsthand ($277.25 in chips) 
Seat 6: matiko09 ($200 in chips) 
Seat 7: seasar1 ($200 in chips) 
Seat 8: chaps1988 ($257.65 in chips) 
Seat 9: Sasuke777777 ($103.35 in chips) 
Sasuke777777: posts small blind $1
I The King I: posts big blind $2
*** HOLE CARDS ***
Dealt to matiko09 [9h Ts]
PacPacBum: folds 
Spid1: folds 
Monsthand: folds 
matiko09: folds 
seasar1: raises $2 to $4
chaps1988: folds 
Sasuke777777: calls $3
I The King I: calls $2
*** FLOP *** [Td Ks 7h]
Sasuke777777: checks 
I The King I: bets $8
seasar1: calls $8
Sasuke777777: calls $8
*** TURN *** [Td Ks 7h] [4h]
Sasuke777777: checks 
I The King I: bets $24
seasar1: folds 
Sasuke777777: calls $24
*** RIVER *** [Td Ks 7h 4h] [4c]
Sasuke777777: checks 
I The King I: bets $72
Sasuke777777: folds 
Uncalled bet ($72) returned to I The King I
I The King I collected $81.25 from pot
I The King I: doesn't show hand 
*** SUMMARY ***
Total pot $84 | Rake $2.75 
Board [Td Ks 7h 4h 4c]
Seat 1: I The King I (big blind) collected ($81.25)
Seat 2: PacPacBum folded before Flop (didn't bet)
Seat 3: Spid1 folded before Flop (didn't bet)
Seat 5: Monsthand folded before Flop (didn't bet)
Seat 6: matiko09 folded before Flop (didn't bet)
Seat 7: seasar1 folded on the Turn
Seat 8: chaps1988 (button) folded before Flop (didn't bet)
Seat 9: Sasuke777777 (small blind) folded on the River





PokerStars Hand #153067889179:  Hold'em No Limit ($0.50/$1.00 USD) - 2016/05/09 16:51:07 CET [2016/05/09 10:51:07 ET]
Table 'Buryatia II' 9-max Seat #9 is the button
Seat 1: flk.Dasas ($103.90 in chips) 
Seat 3: Desperategam ($118.88 in chips) 
Seat 4: FunkyDonkey1 ($104 in chips) 
Seat 5: amisasi ($85.78 in chips) 
Seat 6: I The King I ($100.50 in chips) 
Seat 8: matiko09 ($102.52 in chips) 
Seat 9: CI58 ($100 in chips) 
flk.Dasas: posts small blind $0.50
Desperategam: posts big blind $1
*** HOLE CARDS ***
Dealt to matiko09 [9d 2c]
FunkyDonkey1: raises $1.50 to $2.50
amisasi: folds 
I The King I: folds 
matiko09: folds 
CI58: calls $2.50
flk.Dasas: folds 
Desperategam: calls $1.50
*** FLOP *** [3h 8h Js]
Desperategam: checks 
FunkyDonkey1: bets $5
CI58: calls $5
Desperategam: folds 
*** TURN *** [3h 8h Js] [Jc]
FunkyDonkey1: checks 
CI58: checks 
*** RIVER *** [3h 8h Js Jc] [5h]
FunkyDonkey1: checks 
CI58: bets $8.55
FunkyDonkey1: calls $8.55
*** SHOW DOWN ***
CI58: shows [2h Ah] (a flush, Ace high)
FunkyDonkey1: mucks hand 
CI58 collected $33.34 from pot
*** SUMMARY ***
Total pot $35.10 | Rake $1.76 
Board [3h 8h Js Jc 5h]
Seat 1: flk.Dasas (small blind) folded before Flop
Seat 3: Desperategam (big blind) folded on the Flop
Seat 4: FunkyDonkey1 mucked [Kh Kc]
Seat 5: amisasi folded before Flop (didn't bet)
Seat 6: I The King I folded before Flop (didn't bet)
Seat 8: matiko09 folded before Flop (didn't bet)
Seat 9: CI58 (button) showed [2h Ah] and won ($33.34) with a flush, Ace high





PokerStars Hand #153067889477:  Hold'em No Limit ($0.50/$1.00 USD) - 2016/05/09 16:51:08 CET [2016/05/09 10:51:08 ET]
Table 'Hajek' 9-max Seat #6 is the button
Seat 2: Spid1 ($151.50 in chips) 
Seat 3: mycka86 ($102.50 in chips) 
Seat 4: LRVAV7 ($158.92 in chips) 
Seat 5: ozone2003 ($121.36 in chips) 
Seat 6: Filojoes ($100 in chips) 
Seat 7: DancerNN1 ($242.05 in chips) 
Seat 8: Kukuryzka ($102.47 in chips) 
Seat 9: matiko09 ($100 in chips) 
DancerNN1: posts small blind $0.50
Kukuryzka: posts big blind $1
CI58: sits out 
Spid1: posts the ante $0.20
mycka86: posts the ante $0.20
LRVAV7: posts the ante $0.20
ozone2003: posts the ante $0.20
Filojoes: posts the ante $0.20
DancerNN1: posts the ante $0.20
Kukuryzka: posts the ante $0.20
matiko09: posts the ante $0.20
*** HOLE CARDS ***
Dealt to matiko09 [Ad 5c]
matiko09: folds 
Spid1: folds 
mycka86: folds 
LRVAV7: raises $2 to $3
ozone2003: folds 
Filojoes: folds 
DancerNN1: calls $2.50
Kukuryzka: calls $2
*** FLOP *** [Tc 8c 4s]
DancerNN1: checks 
Kukuryzka: checks 
LRVAV7: bets $7
DancerNN1: calls $7
Kukuryzka: raises $22 to $29
LRVAV7: folds 
DancerNN1: folds 
Uncalled bet ($22) returned to Kukuryzka
Kukuryzka collected $30.02 from pot
Kukuryzka: doesn't show hand 
*** SUMMARY ***
Total pot $31.60 | Rake $1.58 
Board [Tc 8c 4s]
Seat 2: Spid1 folded before Flop (didn't bet)
Seat 3: mycka86 folded before Flop (didn't bet)
Seat 4: LRVAV7 folded on the Flop
Seat 5: ozone2003 folded before Flop (didn't bet)
Seat 6: Filojoes (button) folded before Flop (didn't bet)
Seat 7: DancerNN1 (small blind) folded on the Flop
Seat 8: Kukuryzka (big blind) collected ($30.02)
Seat 9: matiko09 folded before Flop (didn't bet)





PokerStars Hand #153067896574:  Hold'em No Limit ($0.50/$1.00 USD) - 2016/05/09 16:51:20 CET [2016/05/09 10:51:20 ET]
Table 'Orthos' 9-max Seat #2 is the button
Seat 1: Kelvin sai ($82.96 in chips) 
Seat 2: PacPacBum ($111.41 in chips) 
Seat 3: Filojoes ($117.11 in chips) 
Seat 5: matiko09 ($105.58 in chips) 
Seat 6: xhinostrabli ($110.33 in chips) 
Seat 7: flk.Dasas ($126.82 in chips) 
Seat 8: Dickyxxx ($100 in chips) 
Seat 9: mycka86 ($104.50 in chips) 
Filojoes: posts small blind $0.50
matiko09: posts big blind $1
*** HOLE CARDS ***
Dealt to matiko09 [Qc Kd]
xhinostrabli: folds 
flk.Dasas: folds 
Dickyxxx: folds 
mycka86: folds 
Kelvin sai: folds 
PacPacBum: folds 
Filojoes: folds 
Uncalled bet ($0.50) returned to matiko09
matiko09 collected $1 from pot
matiko09: doesn't show hand 
*** SUMMARY ***
Total pot $1 | Rake $0 
Seat 1: Kelvin sai folded before Flop (didn't bet)
Seat 2: PacPacBum (button) folded before Flop (didn't bet)
Seat 3: Filojoes (small blind) folded before Flop
Seat 5: matiko09 (big blind) collected ($1)
Seat 6: xhinostrabli folded before Flop (didn't bet)
Seat 7: flk.Dasas folded before Flop (didn't bet)
Seat 8: Dickyxxx folded before Flop (didn't bet)
Seat 9: mycka86 folded before Flop (didn't bet)





PokerStars Hand #153067901742:  Hold'em No Limit ($1/$2 USD) - 2016/05/09 16:51:28 CET [2016/05/09 10:51:28 ET]
Table 'Hagar II' 9-max Seat #9 is the button
Seat 1: mojitos86 ($194.36 in chips) 
Seat 2: darren1031 ($265.95 in chips) 
Seat 3: Sasuke777777 ($189.15 in chips) 
Seat 4: matiko09 ($220.40 in chips) 
Seat 5: PacPacBum ($212.19 in chips) 
Seat 6: el Fatto ($210.29 in chips) 
Seat 7: Monsthand ($216.15 in chips) 
Seat 9: chaps1988 ($200 in chips) 
mojitos86: posts small blind $1
darren1031: posts big blind $2
*** HOLE CARDS ***
Dealt to matiko09 [3d Ah]
Sasuke777777: folds 
matiko09: folds 
PacPacBum: folds 
el Fatto: folds 
Monsthand: folds 
chaps1988: folds 
mojitos86: folds 
Uncalled bet ($1) returned to darren1031
darren1031 collected $2 from pot
darren1031: doesn't show hand 
*** SUMMARY ***
Total pot $2 | Rake $0 
Seat 1: mojitos86 (small blind) folded before Flop
Seat 2: darren1031 (big blind) collected ($2)
Seat 3: Sasuke777777 folded before Flop (didn't bet)
Seat 4: matiko09 folded before Flop (didn't bet)
Seat 5: PacPacBum folded before Flop (didn't bet)
Seat 6: el Fatto folded before Flop (didn't bet)
Seat 7: Monsthand folded before Flop (didn't bet)
Seat 9: chaps1988 (button) folded before Flop (didn't bet)





PokerStars Hand #153067917016:  Hold'em No Limit ($1/$2 USD) - 2016/05/09 16:51:54 CET [2016/05/09 10:51:54 ET]
Table 'Hagar II' 9-max Seat #1 is the button
Seat 1: mojitos86 ($193.36 in chips) 
Seat 2: darren1031 ($266.95 in chips) 
Seat 3: Sasuke777777 ($189.15 in chips) 
Seat 4: matiko09 ($220.40 in chips) 
Seat 5: PacPacBum ($212.19 in chips) 
Seat 6: el Fatto ($210.29 in chips) 
Seat 7: Monsthand ($216.15 in chips) 
Seat 9: chaps1988 ($200 in chips) 
darren1031: posts small blind $1
Sasuke777777: posts big blind $2
*** HOLE CARDS ***
Dealt to matiko09 [8s 2h]
matiko09: folds 
PacPacBum: folds 
el Fatto: folds 
Monsthand: folds 
chaps1988: raises $2.50 to $4.50
mojitos86: folds 
darren1031: folds 
Sasuke777777: calls $2.50
*** FLOP *** [6h 4c Ah]
Sasuke777777: checks 
chaps1988: bets $5
Sasuke777777: folds 
Uncalled bet ($5) returned to chaps1988
chaps1988 collected $9.50 from pot
chaps1988: doesn't show hand 
*** SUMMARY ***
Total pot $10 | Rake $0.50 
Board [6h 4c Ah]
Seat 1: mojitos86 (button) folded before Flop (didn't bet)
Seat 2: darren1031 (small blind) folded before Flop
Seat 3: Sasuke777777 (big blind) folded on the Flop
Seat 4: matiko09 folded before Flop (didn't bet)
Seat 5: PacPacBum folded before Flop (didn't bet)
Seat 6: el Fatto folded before Flop (didn't bet)
Seat 7: Monsthand folded before Flop (didn't bet)
Seat 9: chaps1988 collected ($9.50)





PokerStars Hand #153067920589:  Hold'em No Limit ($0.50/$1.00 USD) - 2016/05/09 16:52:00 CET [2016/05/09 10:52:00 ET]
Table 'Eucharis' 9-max Seat #7 is the button
Seat 1: Spid1 ($101.50 in chips) 
Seat 2: Chef-Zizou ($80 in chips) 
Seat 3: kiyo94 ($70 in chips) 
Seat 4: matiko09 ($100 in chips) 
Seat 5: mycka86 ($100 in chips) 
Seat 6: Mukhin1 ($100 in chips) 
Seat 7: ThorSun ($39.50 in chips) 
Seat 8: Kukuryzka ($99 in chips) 
Kukuryzka: posts small blind $0.50
Spid1: posts big blind $1
*** HOLE CARDS ***
Dealt to matiko09 [7c 2h]
Chef-Zizou: folds 
kiyo94: folds 
matiko09: folds 
mycka86: raises $1.50 to $2.50
Mukhin1: folds 
ThorSun: calls $2.50
Kukuryzka: folds 
Spid1: folds 
*** FLOP *** [8c 6d 7s]
mycka86: checks 
ThorSun: bets $4
mycka86: folds 
Uncalled bet ($4) returned to ThorSun
ThorSun collected $6.18 from pot
ThorSun: doesn't show hand 
*** SUMMARY ***
Total pot $6.50 | Rake $0.32 
Board [8c 6d 7s]
Seat 1: Spid1 (big blind) folded before Flop
Seat 2: Chef-Zizou folded before Flop (didn't bet)
Seat 3: kiyo94 folded before Flop (didn't bet)
Seat 4: matiko09 folded before Flop (didn't bet)
Seat 5: mycka86 folded on the Flop
Seat 6: Mukhin1 folded before Flop (didn't bet)
Seat 7: ThorSun (button) collected ($6.18)
Seat 8: Kukuryzka (small blind) folded before Flop





PokerStars Hand #153067922152:  Hold'em No Limit ($0.50/$1.00 USD) - 2016/05/09 16:52:02 CET [2016/05/09 10:52:02 ET]
Table 'Orthos' 9-max Seat #3 is the button
Seat 1: Kelvin sai ($82.96 in chips) 
Seat 2: PacPacBum ($111.41 in chips) 
Seat 3: Filojoes ($116.61 in chips) 
Seat 5: matiko09 ($106.08 in chips) 
Seat 6: xhinostrabli ($110.33 in chips) 
Seat 7: flk.Dasas ($126.82 in chips) 
Seat 8: Dickyxxx ($100 in chips) 
Seat 9: mycka86 ($104.50 in chips) 
matiko09: posts small blind $0.50
xhinostrabli: posts big blind $1
*** HOLE CARDS ***
Dealt to matiko09 [6c Kh]
flk.Dasas: folds 
Dickyxxx: folds 
mycka86: folds 
Kelvin sai: raises $1 to $2
PacPacBum: folds 
Filojoes: calls $2
matiko09: folds 
xhinostrabli: calls $1
*** FLOP *** [6h Ts 3c]
xhinostrabli: checks 
Kelvin sai: checks 
Filojoes: checks 
*** TURN *** [6h Ts 3c] [9d]
xhinostrabli: checks 
Kelvin sai: bets $4
Filojoes: folds 
xhinostrabli: folds 
Uncalled bet ($4) returned to Kelvin sai
Kelvin sai collected $6.18 from pot
Kelvin sai: doesn't show hand 
*** SUMMARY ***
Total pot $6.50 | Rake $0.32 
Board [6h Ts 3c 9d]
Seat 1: Kelvin sai collected ($6.18)
Seat 2: PacPacBum folded before Flop (didn't bet)
Seat 3: Filojoes (button) folded on the Turn
Seat 5: matiko09 (small blind) folded before Flop
Seat 6: xhinostrabli (big blind) folded on the Turn
Seat 7: flk.Dasas folded before Flop (didn't bet)
Seat 8: Dickyxxx folded before Flop (didn't bet)
Seat 9: mycka86 folded before Flop (didn't bet)





PokerStars Hand #153067926367:  Hold'em No Limit ($0.50/$1.00 USD) - 2016/05/09 16:52:09 CET [2016/05/09 10:52:09 ET]
Table 'Terpsichore' 9-max Seat #7 is the button
Seat 1: ipashutapkom ($158.72 in chips) 
Seat 2: CI58 ($127.20 in chips) 
Seat 3: matiko09 ($120.34 in chips) 
Seat 4: nubpoker ($133.48 in chips) 
Seat 5: mycka86 ($216.22 in chips) 
Seat 6: Filojoes ($100 in chips) 
Seat 7: ozone2003 ($105.25 in chips) 
Seat 8: Kiosk230472 ($130.58 in chips) 
Seat 9: FTPbannedMe ($124.61 in chips) 
Kiosk230472: posts small blind $0.50
FTPbannedMe: posts big blind $1
*** HOLE CARDS ***
Dealt to matiko09 [8d Td]
ipashutapkom: folds 
CI58: folds 
matiko09: folds 
nubpoker: folds 
mycka86: raises $1.50 to $2.50
Filojoes: folds 
ozone2003: folds 
Kiosk230472: calls $2
FTPbannedMe: folds 
*** FLOP *** [Jh 9c 7c]
Kiosk230472: checks 
mycka86: checks 
*** TURN *** [Jh 9c 7c] [8h]
Kiosk230472: bets $6
mycka86: folds 
Uncalled bet ($6) returned to Kiosk230472
Kiosk230472 collected $5.70 from pot
Kiosk230472: doesn't show hand 
*** SUMMARY ***
Total pot $6 | Rake $0.30 
Board [Jh 9c 7c 8h]
Seat 1: ipashutapkom folded before Flop (didn't bet)
Seat 2: CI58 folded before Flop (didn't bet)
Seat 3: matiko09 folded before Flop (didn't bet)
Seat 4: nubpoker folded before Flop (didn't bet)
Seat 5: mycka86 folded on the Turn
Seat 6: Filojoes folded before Flop (didn't bet)
Seat 7: ozone2003 (button) folded before Flop (didn't bet)
Seat 8: Kiosk230472 (small blind) collected ($5.70)
Seat 9: FTPbannedMe (big blind) folded before Flop





PokerStars Hand #153067930343:  Hold'em No Limit ($0.50/$1.00 USD) - 2016/05/09 16:52:16 CET [2016/05/09 10:52:16 ET]
Table 'Reiss' 9-max Seat #1 is the button
Seat 1: Dickyxxx ($171.01 in chips) 
Seat 2: mycka86 ($112.70 in chips) 
Seat 3: chaps1988 ($114.50 in chips) 
Seat 5: matiko09 ($100 in chips) 
Seat 6: Spid1 ($174.14 in chips) 
Seat 8: Filojoes ($181.74 in chips) 
mycka86: posts small blind $0.50
chaps1988: posts big blind $1
pokerrewa: sits out 
flyer9898: sits out 
*** HOLE CARDS ***
Dealt to matiko09 [2c Jc]
matiko09: folds 
Spid1: folds 
Filojoes: folds 
Dickyxxx: folds 
mycka86: folds 
Uncalled bet ($0.50) returned to chaps1988
chaps1988 collected $1 from pot
chaps1988: doesn't show hand 
*** SUMMARY ***
Total pot $1 | Rake $0 
Seat 1: Dickyxxx (button) folded before Flop (didn't bet)
Seat 2: mycka86 (small blind) folded before Flop
Seat 3: chaps1988 (big blind) collected ($1)
Seat 5: matiko09 folded before Flop (didn't bet)
Seat 6: Spid1 folded before Flop (didn't bet)
Seat 8: Filojoes folded before Flop (didn't bet)





PokerStars Hand #153067932534:  Hold'em No Limit ($1/$2 USD) - 2016/05/09 16:52:20 CET [2016/05/09 10:52:20 ET]
Table 'Titan III' 9-max Seat #9 is the button
Seat 1: I The King I ($264.55 in chips) 
Seat 2: PacPacBum ($205 in chips) 
Seat 3: Spid1 ($444.95 in chips) 
Seat 5: Monsthand ($277.25 in chips) 
Seat 6: matiko09 ($200 in chips) 
Seat 7: seasar1 ($200 in chips) 
Seat 8: chaps1988 ($257.65 in chips) 
Seat 9: Sasuke777777 ($67.35 in chips) 
I The King I: posts small blind $1
PacPacBum: posts big blind $2
*** HOLE CARDS ***
Dealt to matiko09 [Js Kc]
Spid1: folds 
Monsthand: folds 
matiko09: raises $3 to $5
seasar1: calls $5
chaps1988: folds 
Sasuke777777: raises $9 to $14
I The King I: folds 
PacPacBum: folds 
matiko09: folds 
seasar1: calls $9
*** FLOP *** [8s Jh 6d]
seasar1: checks 
Sasuke777777: bets $16
seasar1: calls $16
*** TURN *** [8s Jh 6d] [Th]
seasar1: checks 
Sasuke777777: bets $37.35 and is all-in
seasar1: folds 
Uncalled bet ($37.35) returned to Sasuke777777
Sasuke777777 collected $65.25 from pot
Sasuke777777: doesn't show hand 
*** SUMMARY ***
Total pot $68 | Rake $2.75 
Board [8s Jh 6d Th]
Seat 1: I The King I (small blind) folded before Flop
Seat 2: PacPacBum (big blind) folded before Flop
Seat 3: Spid1 folded before Flop (didn't bet)
Seat 5: Monsthand folded before Flop (didn't bet)
Seat 6: matiko09 folded before Flop
Seat 7: seasar1 folded on the Turn
Seat 8: chaps1988 folded before Flop (didn't bet)
Seat 9: Sasuke777777 (button) collected ($65.25)





PokerStars Hand #153067938621:  Hold'em No Limit ($0.50/$1.00 USD) - 2016/05/09 16:52:30 CET [2016/05/09 10:52:30 ET]
Table 'Hajek' 9-max Seat #7 is the button
Seat 2: Spid1 ($151.30 in chips) 
Seat 3: mycka86 ($102.30 in chips) 
Seat 4: LRVAV7 ($148.72 in chips) 
Seat 5: ozone2003 ($121.16 in chips) 
Seat 6: Filojoes ($100 in chips) 
Seat 7: DancerNN1 ($231.85 in chips) 
Seat 8: Kukuryzka ($122.29 in chips) 
Seat 9: matiko09 ($100 in chips) 
Kukuryzka: posts small blind $0.50
matiko09: posts big blind $1
CI58: sits out 
Spid1: posts the ante $0.20
mycka86: posts the ante $0.20
LRVAV7: posts the ante $0.20
ozone2003: posts the ante $0.20
Filojoes: posts the ante $0.20
DancerNN1: posts the ante $0.20
Kukuryzka: posts the ante $0.20
matiko09: posts the ante $0.20
*** HOLE CARDS ***
Dealt to matiko09 [8c Kh]
Spid1: folds 
mycka86: folds 
LRVAV7: folds 
ozone2003: folds 
Filojoes: folds 
DancerNN1: raises $1 to $2
Kukuryzka: folds 
matiko09: calls $1
*** FLOP *** [Ad 4c 6d]
matiko09: checks 
DancerNN1: bets $2.32
matiko09: folds 
Uncalled bet ($2.32) returned to DancerNN1
DancerNN1 collected $5.80 from pot
DancerNN1: doesn't show hand 
*** SUMMARY ***
Total pot $6.10 | Rake $0.30 
Board [Ad 4c 6d]
Seat 2: Spid1 folded before Flop (didn't bet)
Seat 3: mycka86 folded before Flop (didn't bet)
Seat 4: LRVAV7 folded before Flop (didn't bet)
Seat 5: ozone2003 folded before Flop (didn't bet)
Seat 6: Filojoes folded before Flop (didn't bet)
Seat 7: DancerNN1 (button) collected ($5.80)
Seat 8: Kukuryzka (small blind) folded before Flop
Seat 9: matiko09 (big blind) folded on the Flop





PokerStars Hand #153067939581:  Hold'em No Limit ($1/$2 USD) - 2016/05/09 16:52:31 CET [2016/05/09 10:52:31 ET]
Table 'Hagar II' 9-max Seat #2 is the button
Seat 1: mojitos86 ($193.36 in chips) 
Seat 2: darren1031 ($265.95 in chips) 
Seat 3: Sasuke777777 ($184.65 in chips) 
Seat 4: matiko09 ($220.40 in chips) 
Seat 5: PacPacBum ($212.19 in chips) 
Seat 6: el Fatto ($210.29 in chips) 
Seat 7: Monsthand ($216.15 in chips) 
Seat 9: chaps1988 ($205 in chips) 
Sasuke777777: posts small blind $1
matiko09: posts big blind $2
*** HOLE CARDS ***
Dealt to matiko09 [5h 6d]
PacPacBum: folds 
el Fatto: folds 
Monsthand: raises $4 to $6
chaps1988: folds 
mojitos86: folds 
darren1031: folds 
Sasuke777777: folds 
matiko09: folds 
Uncalled bet ($4) returned to Monsthand
Monsthand collected $5 from pot
Monsthand: doesn't show hand 
*** SUMMARY ***
Total pot $5 | Rake $0 
Seat 1: mojitos86 folded before Flop (didn't bet)
Seat 2: darren1031 (button) folded before Flop (didn't bet)
Seat 3: Sasuke777777 (small blind) folded before Flop
Seat 4: matiko09 (big blind) folded before Flop
Seat 5: PacPacBum folded before Flop (didn't bet)
Seat 6: el Fatto folded before Flop (didn't bet)
Seat 7: Monsthand collected ($5)
Seat 9: chaps1988 folded before Flop (didn't bet)





PokerStars Hand #153067944715:  Hold'em No Limit ($0.50/$1.00 USD) - 2016/05/09 16:52:40 CET [2016/05/09 10:52:40 ET]
Table 'Eucharis' 9-max Seat #8 is the button
Seat 1: Spid1 ($100.50 in chips) 
Seat 2: Chef-Zizou ($80 in chips) 
Seat 3: kiyo94 ($70 in chips) 
Seat 4: matiko09 ($100 in chips) 
Seat 5: mycka86 ($100 in chips) 
Seat 6: Mukhin1 ($100 in chips) 
Seat 7: ThorSun ($43.18 in chips) 
Seat 8: Kukuryzka ($100 in chips) 
Spid1: posts small blind $0.50
Chef-Zizou: posts big blind $1
*** HOLE CARDS ***
Dealt to matiko09 [Ah 7d]
kiyo94: calls $1
matiko09: folds 
mycka86: folds 
Mukhin1: folds 
ThorSun: calls $1
Kukuryzka: folds 
Spid1: folds 
Chef-Zizou: checks 
*** FLOP *** [8s 5h 7h]
Chef-Zizou: checks 
kiyo94: checks 
ThorSun: checks 
*** TURN *** [8s 5h 7h] [Ts]
Chef-Zizou: bets $3.32
kiyo94: folds 
ThorSun: folds 
Uncalled bet ($3.32) returned to Chef-Zizou
Chef-Zizou collected $3.32 from pot
*** SUMMARY ***
Total pot $3.50 | Rake $0.18 
Board [8s 5h 7h Ts]
Seat 1: Spid1 (small blind) folded before Flop
Seat 2: Chef-Zizou (big blind) collected ($3.32)
Seat 3: kiyo94 folded on the Turn
Seat 4: matiko09 folded before Flop (didn't bet)
Seat 5: mycka86 folded before Flop (didn't bet)
Seat 6: Mukhin1 folded before Flop (didn't bet)
Seat 7: ThorSun folded on the Turn
Seat 8: Kukuryzka (button) folded before Flop (didn't bet)





PokerStars Hand #153067947065:  Hold'em No Limit ($0.50/$1.00 USD) - 2016/05/09 16:52:44 CET [2016/05/09 10:52:44 ET]
Table 'Reiss' 9-max Seat #2 is the button
Seat 1: Dickyxxx ($171.01 in chips) 
Seat 2: mycka86 ($112.20 in chips) 
Seat 3: chaps1988 ($115 in chips) 
Seat 5: matiko09 ($100 in chips) 
Seat 6: Spid1 ($174.14 in chips) 
Seat 8: Filojoes ($181.74 in chips) 
chaps1988: posts small blind $0.50
pokerrewa has timed out
pokerrewa: is sitting out 
matiko09: posts big blind $1
flyer9898: sits out 
*** HOLE CARDS ***
Dealt to matiko09 [Tc Ts]
Spid1: folds 
Filojoes: folds 
Dickyxxx: raises $2 to $3
mycka86: folds 
chaps1988: folds 
matiko09: calls $2
*** FLOP *** [8d 9s As]
matiko09: checks 
Dickyxxx: checks 
*** TURN *** [8d 9s As] [Kd]
matiko09: checks 
Dickyxxx: checks 
*** RIVER *** [8d 9s As Kd] [2s]
matiko09: checks 
Dickyxxx: checks 
*** SHOW DOWN ***
matiko09: shows [Tc Ts] (a pair of Tens)
Dickyxxx: mucks hand 
matiko09 collected $6.18 from pot
*** SUMMARY ***
Total pot $6.50 | Rake $0.32 
Board [8d 9s As Kd 2s]
Seat 1: Dickyxxx mucked [6h 8h]
Seat 2: mycka86 (button) folded before Flop (didn't bet)
Seat 3: chaps1988 (small blind) folded before Flop
Seat 5: matiko09 (big blind) showed [Tc Ts] and won ($6.18) with a pair of Tens
Seat 6: Spid1 folded before Flop (didn't bet)
Seat 8: Filojoes folded before Flop (didn't bet)





PokerStars Hand #153067948314:  Hold'em No Limit ($0.50/$1.00 USD) - 2016/05/09 16:52:46 CET [2016/05/09 10:52:46 ET]
Table 'Buryatia II' 9-max Seat #1 is the button
Seat 1: flk.Dasas ($103.40 in chips) 
Seat 3: Desperategam ($116.38 in chips) 
Seat 4: FunkyDonkey1 ($87.95 in chips) 
Seat 5: amisasi ($85.78 in chips) 
Seat 6: I The King I ($100.50 in chips) 
Seat 8: matiko09 ($102.52 in chips) 
Seat 9: CI58 ($117.29 in chips) 
Desperategam: posts small blind $0.50
FunkyDonkey1: posts big blind $1
*** HOLE CARDS ***
Dealt to matiko09 [3c 5h]
amisasi: folds 
I The King I: folds 
matiko09: folds 
CI58: folds 
flk.Dasas: folds 
Desperategam: folds 
Uncalled bet ($0.50) returned to FunkyDonkey1
FunkyDonkey1 collected $1 from pot
FunkyDonkey1: doesn't show hand 
*** SUMMARY ***
Total pot $1 | Rake $0 
Seat 1: flk.Dasas (button) folded before Flop (didn't bet)
Seat 3: Desperategam (small blind) folded before Flop
Seat 4: FunkyDonkey1 (big blind) collected ($1)
Seat 5: amisasi folded before Flop (didn't bet)
Seat 6: I The King I folded before Flop (didn't bet)
Seat 8: matiko09 folded before Flop (didn't bet)
Seat 9: CI58 folded before Flop (didn't bet)





PokerStars Hand #153067958479:  Hold'em No Limit ($1/$2 USD) - 2016/05/09 16:53:03 CET [2016/05/09 10:53:03 ET]
Table 'Hagar II' 9-max Seat #3 is the button
Seat 1: mojitos86 ($193.36 in chips) 
Seat 2: darren1031 ($265.95 in chips) 
Seat 3: Sasuke777777 ($183.65 in chips) 
Seat 4: matiko09 ($218.40 in chips) 
Seat 5: PacPacBum ($212.19 in chips) 
Seat 6: el Fatto ($210.29 in chips) 
Seat 7: Monsthand ($219.15 in chips) 
Seat 9: chaps1988 ($205 in chips) 
matiko09: posts small blind $1
PacPacBum: posts big blind $2
*** HOLE CARDS ***
Dealt to matiko09 [5c 5d]
el Fatto: folds 
Monsthand: folds 
chaps1988: folds 
mojitos86: folds 
darren1031: folds 
Sasuke777777: folds 
matiko09: raises $3 to $5
PacPacBum: calls $3
*** FLOP *** [5h 4s 8c]
matiko09: bets $6.18
PacPacBum: calls $6.18
*** TURN *** [5h 4s 8c] [Kh]
matiko09: bets $14
PacPacBum: raises $26.58 to $40.58
matiko09: calls $26.58
*** RIVER *** [5h 4s 8c Kh] [3d]
matiko09: checks 
PacPacBum: bets $160.43 and is all-in
matiko09: calls $160.43
*** SHOW DOWN ***
PacPacBum: shows [7d Ts] (high card King)
matiko09: shows [5c 5d] (three of a kind, Fives)
matiko09 collected $421.63 from pot
*** SUMMARY ***
Total pot $424.38 | Rake $2.75 
Board [5h 4s 8c Kh 3d]
Seat 1: mojitos86 folded before Flop (didn't bet)
Seat 2: darren1031 folded before Flop (didn't bet)
Seat 3: Sasuke777777 (button) folded before Flop (didn't bet)
Seat 4: matiko09 (small blind) showed [5c 5d] and won ($421.63) with three of a kind, Fives
Seat 5: PacPacBum (big blind) showed [7d Ts] and lost with high card King
Seat 6: el Fatto folded before Flop (didn't bet)
Seat 7: Monsthand folded before Flop (didn't bet)
Seat 9: chaps1988 folded before Flop (didn't bet)





PokerStars Hand #153067963901:  Hold'em No Limit ($0.50/$1.00 USD) - 2016/05/09 16:53:12 CET [2016/05/09 10:53:12 ET]
Table 'Buryatia II' 9-max Seat #3 is the button
Seat 1: flk.Dasas ($103.40 in chips) 
Seat 3: Desperategam ($115.88 in chips) 
Seat 4: FunkyDonkey1 ($88.45 in chips) 
Seat 5: amisasi ($85.78 in chips) 
Seat 6: I The King I ($100.50 in chips) 
Seat 8: matiko09 ($102.52 in chips) 
Seat 9: CI58 ($117.29 in chips) 
FunkyDonkey1: posts small blind $0.50
amisasi: posts big blind $1
*** HOLE CARDS ***
Dealt to matiko09 [6h 4c]
I The King I: folds 
matiko09: folds 
CI58: folds 
flk.Dasas: folds 
Desperategam: raises $2 to $3
FunkyDonkey1: folds 
amisasi: folds 
Uncalled bet ($2) returned to Desperategam
Desperategam collected $2.50 from pot
Desperategam: doesn't show hand 
*** SUMMARY ***
Total pot $2.50 | Rake $0 
Seat 1: flk.Dasas folded before Flop (didn't bet)
Seat 3: Desperategam (button) collected ($2.50)
Seat 4: FunkyDonkey1 (small blind) folded before Flop
Seat 5: amisasi (big blind) folded before Flop
Seat 6: I The King I folded before Flop (didn't bet)
Seat 8: matiko09 folded before Flop (didn't bet)
Seat 9: CI58 folded before Flop (didn't bet)





PokerStars Hand #153067966453:  Hold'em No Limit ($0.50/$1.00 USD) - 2016/05/09 16:53:16 CET [2016/05/09 10:53:16 ET]
Table 'Terpsichore' 9-max Seat #8 is the button
Seat 1: ipashutapkom ($158.72 in chips) 
Seat 2: CI58 ($127.20 in chips) 
Seat 3: matiko09 ($120.34 in chips) 
Seat 4: nubpoker ($133.48 in chips) 
Seat 5: mycka86 ($213.72 in chips) 
Seat 6: Filojoes ($100 in chips) 
Seat 7: ozone2003 ($105.25 in chips) 
Seat 8: Kiosk230472 ($133.78 in chips) 
Seat 9: FTPbannedMe ($123.61 in chips) 
FTPbannedMe: posts small blind $0.50
ipashutapkom: posts big blind $1
*** HOLE CARDS ***
Dealt to matiko09 [Ks 8d]
CI58: calls $1
matiko09: folds 
nubpoker: folds 
mycka86: folds 
Filojoes: folds 
ozone2003: folds 
Kiosk230472: calls $1
FTPbannedMe: folds 
ipashutapkom: checks 
*** FLOP *** [Jc Kd 6d]
ipashutapkom: checks 
CI58: checks 
Kiosk230472: bets $4
ipashutapkom: folds 
CI58: folds 
Uncalled bet ($4) returned to Kiosk230472
Kiosk230472 collected $3.32 from pot
Kiosk230472: doesn't show hand 
*** SUMMARY ***
Total pot $3.50 | Rake $0.18 
Board [Jc Kd 6d]
Seat 1: ipashutapkom (big blind) folded on the Flop
Seat 2: CI58 folded on the Flop
Seat 3: matiko09 folded before Flop (didn't bet)
Seat 4: nubpoker folded before Flop (didn't bet)
Seat 5: mycka86 folded before Flop (didn't bet)
Seat 6: Filojoes folded before Flop (didn't bet)
Seat 7: ozone2003 folded before Flop (didn't bet)
Seat 8: Kiosk230472 (button) collected ($3.32)
Seat 9: FTPbannedMe (small blind) folded before Flop





PokerStars Hand #153067966921:  Hold'em No Limit ($0.50/$1.00 USD) - 2016/05/09 16:53:17 CET [2016/05/09 10:53:17 ET]
Table 'Hajek' 9-max Seat #8 is the button
Seat 1: CI58 ($100 in chips) 
Seat 2: Spid1 ($151.10 in chips) 
Seat 3: mycka86 ($102.10 in chips) 
Seat 4: LRVAV7 ($148.52 in chips) 
Seat 5: ozone2003 ($120.96 in chips) 
Seat 6: Filojoes ($100 in chips) 
Seat 7: DancerNN1 ($235.45 in chips) 
Seat 8: Kukuryzka ($121.59 in chips) 
Seat 9: matiko09 ($100 in chips) 
matiko09: posts small blind $0.50
CI58: posts big blind $1
CI58: posts the ante $0.20
Spid1: posts the ante $0.20
mycka86: posts the ante $0.20
LRVAV7: posts the ante $0.20
ozone2003: posts the ante $0.20
Filojoes: posts the ante $0.20
DancerNN1: posts the ante $0.20
Kukuryzka: posts the ante $0.20
matiko09: posts the ante $0.20
*** HOLE CARDS ***
Dealt to matiko09 [5c 5h]
Spid1: folds 
mycka86: folds 
LRVAV7: folds 
ozone2003: folds 
Filojoes: folds 
DancerNN1: folds 
Kukuryzka: raises $1 to $2
matiko09: calls $1.50
CI58: calls $1
*** FLOP *** [Js 4h As]
matiko09: checks 
CI58: checks 
Kukuryzka: checks 
*** TURN *** [Js 4h As] [Qc]
matiko09: checks 
CI58: checks 
Kukuryzka: bets $3.50
matiko09: folds 
CI58: folds 
Uncalled bet ($3.50) returned to Kukuryzka
Kukuryzka collected $7.41 from pot
Kukuryzka: doesn't show hand 
*** SUMMARY ***
Total pot $7.80 | Rake $0.39 
Board [Js 4h As Qc]
Seat 1: CI58 (big blind) folded on the Turn
Seat 2: Spid1 folded before Flop (didn't bet)
Seat 3: mycka86 folded before Flop (didn't bet)
Seat 4: LRVAV7 folded before Flop (didn't bet)
Seat 5: ozone2003 folded before Flop (didn't bet)
Seat 6: Filojoes folded before Flop (didn't bet)
Seat 7: DancerNN1 folded before Flop (didn't bet)
Seat 8: Kukuryzka (button) collected ($7.41)
Seat 9: matiko09 (small blind) folded on the Turn





PokerStars Hand #153067967315:  Hold'em No Limit ($1/$2 USD) - 2016/05/09 16:53:17 CET [2016/05/09 10:53:17 ET]
Table 'Titan III' 9-max Seat #1 is the button
Seat 1: I The King I ($263.55 in chips) 
Seat 2: PacPacBum ($203 in chips) 
Seat 3: Spid1 ($444.95 in chips) 
Seat 5: Monsthand ($277.25 in chips) 
Seat 6: matiko09 ($200 in chips) 
Seat 7: seasar1 ($170 in chips) 
Seat 8: chaps1988 ($257.65 in chips) 
Seat 9: Sasuke777777 ($102.60 in chips) 
PacPacBum: posts small blind $1
Spid1: posts big blind $2
*** HOLE CARDS ***
Dealt to matiko09 [2h Jc]
Monsthand: folds 
Sasuke777777 said, "QQ"
matiko09: folds 
seasar1: folds 
chaps1988: folds 
Sasuke777777: folds 
I The King I: folds 
PacPacBum: folds 
Uncalled bet ($1) returned to Spid1
Spid1 collected $2 from pot
Spid1: doesn't show hand 
*** SUMMARY ***
Total pot $2 | Rake $0 
Seat 1: I The King I (button) folded before Flop (didn't bet)
Seat 2: PacPacBum (small blind) folded before Flop
Seat 3: Spid1 (big blind) collected ($2)
Seat 5: Monsthand folded before Flop (didn't bet)
Seat 6: matiko09 folded before Flop (didn't bet)
Seat 7: seasar1 folded before Flop (didn't bet)
Seat 8: chaps1988 folded before Flop (didn't bet)
Seat 9: Sasuke777777 folded before Flop (didn't bet)





PokerStars Hand #153067975077:  Hold'em No Limit ($0.50/$1.00 USD) - 2016/05/09 16:53:31 CET [2016/05/09 10:53:31 ET]
Table 'Orthos' 9-max Seat #5 is the button
Seat 1: Kelvin sai ($87.14 in chips) 
Seat 2: PacPacBum ($111.41 in chips) 
Seat 3: Filojoes ($114.61 in chips) 
Seat 5: matiko09 ($105.58 in chips) 
Seat 6: xhinostrabli ($108.33 in chips) 
Seat 7: flk.Dasas ($126.82 in chips) 
Seat 8: Dickyxxx ($100 in chips) 
Seat 9: mycka86 ($104.50 in chips) 
xhinostrabli: posts small blind $0.50
flk.Dasas: posts big blind $1
*** HOLE CARDS ***
Dealt to matiko09 [5h Jd]
Dickyxxx: folds 
mycka86: folds 
Kelvin sai: raises $1 to $2
PacPacBum: folds 
Filojoes: folds 
matiko09: folds 
xhinostrabli: folds 
flk.Dasas: folds 
Uncalled bet ($1) returned to Kelvin sai
Kelvin sai collected $2.50 from pot
Kelvin sai: doesn't show hand 
*** SUMMARY ***
Total pot $2.50 | Rake $0 
Seat 1: Kelvin sai collected ($2.50)
Seat 2: PacPacBum folded before Flop (didn't bet)
Seat 3: Filojoes folded before Flop (didn't bet)
Seat 5: matiko09 (button) folded before Flop (didn't bet)
Seat 6: xhinostrabli (small blind) folded before Flop
Seat 7: flk.Dasas (big blind) folded before Flop
Seat 8: Dickyxxx folded before Flop (didn't bet)
Seat 9: mycka86 folded before Flop (didn't bet)





PokerStars Hand #153067976339:  Hold'em No Limit ($0.50/$1.00 USD) - 2016/05/09 16:53:33 CET [2016/05/09 10:53:33 ET]
Table 'Eucharis' 9-max Seat #1 is the button
Seat 1: Spid1 ($100 in chips) 
Seat 2: Chef-Zizou ($82.32 in chips) 
Seat 3: kiyo94 ($69 in chips) 
Seat 4: matiko09 ($100 in chips) 
Seat 5: mycka86 ($100 in chips) 
Seat 6: Mukhin1 ($100 in chips) 
Seat 7: ThorSun ($42.18 in chips) 
Seat 8: Kukuryzka ($100 in chips) 
Chef-Zizou: posts small blind $0.50
kiyo94: posts big blind $1
*** HOLE CARDS ***
Dealt to matiko09 [8s Jc]
matiko09: folds 
mycka86: folds 
Mukhin1: raises $2.02 to $3.02
ThorSun: calls $3.02
Kukuryzka: folds 
Spid1: folds 
Chef-Zizou: folds 
kiyo94: raises $6.98 to $10
Mukhin1: raises $12.50 to $22.50
ThorSun: raises $19.68 to $42.18 and is all-in
kiyo94: folds 
Mukhin1: calls $19.68
*** FLOP *** [As Js 6d]
*** TURN *** [As Js 6d] [6s]
*** RIVER *** [As Js 6d 6s] [5s]
*** SHOW DOWN ***
Mukhin1: shows [Kc Kh] (two pair, Kings and Sixes)
ThorSun: shows [Kd Ks] (a flush, Ace high)
ThorSun collected $92.36 from pot
*** SUMMARY ***
Total pot $94.86 | Rake $2.50 
Board [As Js 6d 6s 5s]
Seat 1: Spid1 (button) folded before Flop (didn't bet)
Seat 2: Chef-Zizou (small blind) folded before Flop
Seat 3: kiyo94 (big blind) folded before Flop
Seat 4: matiko09 folded before Flop (didn't bet)
Seat 5: mycka86 folded before Flop (didn't bet)
Seat 6: Mukhin1 showed [Kc Kh] and lost with two pair, Kings and Sixes
Seat 7: ThorSun showed [Kd Ks] and won ($92.36) with a flush, Ace high
Seat 8: Kukuryzka folded before Flop (didn't bet)





PokerStars Hand #153067977662:  Hold'em No Limit ($1/$2 USD) - 2016/05/09 16:53:35 CET [2016/05/09 10:53:35 ET]
Table 'Titan III' 9-max Seat #2 is the button
Seat 1: I The King I ($263.55 in chips) 
Seat 2: PacPacBum ($202 in chips) 
Seat 3: Spid1 ($445.95 in chips) 
Seat 5: Monsthand ($277.25 in chips) 
Seat 6: matiko09 ($200 in chips) 
Seat 7: seasar1 ($175.48 in chips) 
Seat 8: chaps1988 ($257.65 in chips) 
Seat 9: Sasuke777777 ($102.60 in chips) 
Spid1: posts small blind $1
Monsthand: posts big blind $2
*** HOLE CARDS ***
Dealt to matiko09 [9d Jd]
matiko09: folds 
seasar1: folds 
chaps1988: raises $3 to $5
Sasuke777777: raises $9 to $14
I The King I: folds 
PacPacBum: folds 
Spid1: folds 
Monsthand: folds 
chaps1988: folds 
Uncalled bet ($9) returned to Sasuke777777
Sasuke777777 collected $13 from pot
Sasuke777777: doesn't show hand 
*** SUMMARY ***
Total pot $13 | Rake $0 
Seat 1: I The King I folded before Flop (didn't bet)
Seat 2: PacPacBum (button) folded before Flop (didn't bet)
Seat 3: Spid1 (small blind) folded before Flop
Seat 5: Monsthand (big blind) folded before Flop
Seat 6: matiko09 folded before Flop (didn't bet)
Seat 7: seasar1 folded before Flop (didn't bet)
Seat 8: chaps1988 folded before Flop
Seat 9: Sasuke777777 collected ($13)





PokerStars Hand #153067982481:  Hold'em No Limit ($0.50/$1.00 USD) - 2016/05/09 16:53:43 CET [2016/05/09 10:53:43 ET]
Table 'Buryatia II' 9-max Seat #4 is the button
Seat 1: flk.Dasas ($103.40 in chips) 
Seat 3: Desperategam ($117.38 in chips) 
Seat 4: FunkyDonkey1 ($87.95 in chips) 
Seat 5: amisasi ($84.78 in chips) 
Seat 6: I The King I ($100.50 in chips) 
Seat 8: matiko09 ($102.52 in chips) 
Seat 9: CI58 ($117.29 in chips) 
amisasi: posts small blind $0.50
I The King I: posts big blind $1
*** HOLE CARDS ***
Dealt to matiko09 [4d 5h]
matiko09: folds 
CI58: folds 
flk.Dasas: folds 
Desperategam: folds 
FunkyDonkey1: folds 
amisasi: raises $1 to $2
I The King I: calls $1
*** FLOP *** [7h 6s 9c]
amisasi: bets $2
I The King I: calls $2
*** TURN *** [7h 6s 9c] [5d]
amisasi: bets $3
I The King I: calls $3
*** RIVER *** [7h 6s 9c 5d] [As]
amisasi: bets $6.65
I The King I: folds 
Uncalled bet ($6.65) returned to amisasi
amisasi collected $13.30 from pot
*** SUMMARY ***
Total pot $14 | Rake $0.70 
Board [7h 6s 9c 5d As]
Seat 1: flk.Dasas folded before Flop (didn't bet)
Seat 3: Desperategam folded before Flop (didn't bet)
Seat 4: FunkyDonkey1 (button) folded before Flop (didn't bet)
Seat 5: amisasi (small blind) collected ($13.30)
Seat 6: I The King I (big blind) folded on the River
Seat 8: matiko09 folded before Flop (didn't bet)
Seat 9: CI58 folded before Flop (didn't bet)





PokerStars Hand #153067982465:  Hold'em No Limit ($0.50/$1.00 USD) - 2016/05/09 16:53:43 CET [2016/05/09 10:53:43 ET]
Table 'Reiss' 9-max Seat #3 is the button
Seat 1: Dickyxxx ($168.01 in chips) 
Seat 2: mycka86 ($112.20 in chips) 
Seat 3: chaps1988 ($114.50 in chips) 
Seat 5: matiko09 ($103.18 in chips) 
Seat 9: flyer9898 ($80 in chips) 
pokerrewa will be allowed to play after the button
matiko09: posts small blind $0.50
Spid1: is sitting out 
Filojoes: is sitting out 
Filojoes leaves the table
flyer9898: posts big blind $1
*** HOLE CARDS ***
Dealt to matiko09 [As 9s]
Spid1 leaves the table
Dickyxxx: raises $2 to $3
ozone2003 joins the table at seat #6 
R1aki joins the table at seat #8 
mycka86: raises $7 to $10
chaps1988: folds 
matiko09: folds 
flyer9898: folds 
Dickyxxx: folds 
Uncalled bet ($7) returned to mycka86
mycka86 collected $7.50 from pot
*** SUMMARY ***
Total pot $7.50 | Rake $0 
Seat 1: Dickyxxx folded before Flop
Seat 2: mycka86 collected ($7.50)
Seat 3: chaps1988 (button) folded before Flop (didn't bet)
Seat 5: matiko09 (small blind) folded before Flop
Seat 9: flyer9898 (big blind) folded before Flop





PokerStars Hand #153067997864:  Hold'em No Limit ($0.50/$1.00 USD) - 2016/05/09 16:54:09 CET [2016/05/09 10:54:09 ET]
Table 'Orthos' 9-max Seat #6 is the button
Seat 1: Kelvin sai ($88.64 in chips) 
Seat 2: PacPacBum ($111.41 in chips) 
Seat 3: Filojoes ($114.61 in chips) 
Seat 5: matiko09 ($105.58 in chips) 
Seat 6: xhinostrabli ($107.83 in chips) 
Seat 7: flk.Dasas ($125.82 in chips) 
Seat 8: Dickyxxx ($100 in chips) 
Seat 9: mycka86 ($104.50 in chips) 
flk.Dasas: posts small blind $0.50
Dickyxxx: posts big blind $1
*** HOLE CARDS ***
Dealt to matiko09 [Qc Ts]
mycka86: folds 
Kelvin sai: raises $1 to $2
PacPacBum: folds 
Filojoes: raises $5 to $7
matiko09: folds 
xhinostrabli: folds 
flk.Dasas: folds 
Dickyxxx: folds 
Kelvin sai: folds 
Uncalled bet ($5) returned to Filojoes
Filojoes collected $5.50 from pot
Filojoes: doesn't show hand 
*** SUMMARY ***
Total pot $5.50 | Rake $0 
Seat 1: Kelvin sai folded before Flop
Seat 2: PacPacBum folded before Flop (didn't bet)
Seat 3: Filojoes collected ($5.50)
Seat 5: matiko09 folded before Flop (didn't bet)
Seat 6: xhinostrabli (button) folded before Flop (didn't bet)
Seat 7: flk.Dasas (small blind) folded before Flop
Seat 8: Dickyxxx (big blind) folded before Flop
Seat 9: mycka86 folded before Flop (didn't bet)





PokerStars Hand #153068000639:  Hold'em No Limit ($1/$2 USD) - 2016/05/09 16:54:13 CET [2016/05/09 10:54:13 ET]
Table 'Titan III' 9-max Seat #3 is the button
Seat 1: I The King I ($263.55 in chips) 
Seat 2: PacPacBum ($202 in chips) 
Seat 3: Spid1 ($444.95 in chips) 
Seat 5: Monsthand ($275.25 in chips) 
Seat 6: matiko09 ($200 in chips) 
Seat 7: seasar1 ($175.48 in chips) 
Seat 8: chaps1988 ($252.65 in chips) 
Seat 9: Sasuke777777 ($110.60 in chips) 
Monsthand: posts small blind $1
matiko09: posts big blind $2
*** HOLE CARDS ***
Dealt to matiko09 [Jh 3h]
seasar1: folds 
chaps1988: folds 
Sasuke777777 said, "again"
Sasuke777777: folds 
I The King I: folds 
PacPacBum: folds 
Spid1: folds 
Monsthand: raises $4 to $6
matiko09: folds 
Uncalled bet ($4) returned to Monsthand
Monsthand collected $4 from pot
Monsthand: doesn't show hand 
*** SUMMARY ***
Total pot $4 | Rake $0 
Seat 1: I The King I folded before Flop (didn't bet)
Seat 2: PacPacBum folded before Flop (didn't bet)
Seat 3: Spid1 (button) folded before Flop (didn't bet)
Seat 5: Monsthand (small blind) collected ($4)
Seat 6: matiko09 (big blind) folded before Flop
Seat 7: seasar1 folded before Flop (didn't bet)
Seat 8: chaps1988 folded before Flop (didn't bet)
Seat 9: Sasuke777777 folded before Flop (didn't bet)





PokerStars Hand #153068002760:  Hold'em No Limit ($0.50/$1.00 USD) - 2016/05/09 16:54:17 CET [2016/05/09 10:54:17 ET]
Table 'Terpsichore' 9-max Seat #9 is the button
Seat 1: ipashutapkom ($157.72 in chips) 
Seat 2: CI58 ($126.20 in chips) 
Seat 3: matiko09 ($120.34 in chips) 
Seat 4: nubpoker ($133.48 in chips) 
Seat 5: mycka86 ($213.72 in chips) 
Seat 6: Filojoes ($100 in chips) 
Seat 7: ozone2003 ($105.25 in chips) 
Seat 8: Kiosk230472 ($136.10 in chips) 
Seat 9: FTPbannedMe ($123.11 in chips) 
ipashutapkom: posts small blind $0.50
CI58: posts big blind $1
*** HOLE CARDS ***
Dealt to matiko09 [4s Qh]
matiko09: folds 
nubpoker: folds 
mycka86: folds 
Filojoes: folds 
ozone2003: folds 
Kiosk230472: calls $1
FTPbannedMe: folds 
ipashutapkom: raises $3.26 to $4.26
CI58: folds 
Kiosk230472: folds 
Uncalled bet ($3.26) returned to ipashutapkom
ipashutapkom collected $3 from pot
ipashutapkom: doesn't show hand 
*** SUMMARY ***
Total pot $3 | Rake $0 
Seat 1: ipashutapkom (small blind) collected ($3)
Seat 2: CI58 (big blind) folded before Flop
Seat 3: matiko09 folded before Flop (didn't bet)
Seat 4: nubpoker folded before Flop (didn't bet)
Seat 5: mycka86 folded before Flop (didn't bet)
Seat 6: Filojoes folded before Flop (didn't bet)
Seat 7: ozone2003 folded before Flop (didn't bet)
Seat 8: Kiosk230472 folded before Flop
Seat 9: FTPbannedMe (button) folded before Flop (didn't bet)





PokerStars Hand #153068005041:  Hold'em No Limit ($0.50/$1.00 USD) - 2016/05/09 16:54:21 CET [2016/05/09 10:54:21 ET]
Table 'Eucharis' 9-max Seat #2 is the button
Seat 1: Spid1 ($100 in chips) 
Seat 2: Chef-Zizou ($81.82 in chips) 
Seat 3: kiyo94 ($59 in chips) 
Seat 4: matiko09 ($100 in chips) 
Seat 5: mycka86 ($100 in chips) 
Seat 6: Mukhin1 ($100 in chips) 
Seat 7: ThorSun ($92.36 in chips) 
Seat 8: Kukuryzka ($100 in chips) 
kiyo94: posts small blind $0.50
matiko09: posts big blind $1
*** HOLE CARDS ***
Dealt to matiko09 [7s 7h]
mycka86: raises $2 to $3
Mukhin1: folds 
ThorSun: folds 
Kukuryzka: folds 
Spid1: folds 
Chef-Zizou: folds 
kiyo94: calls $2.50
matiko09: calls $2
*** FLOP *** [Jc Jh 9h]
kiyo94: checks 
matiko09: checks 
mycka86: bets $6
kiyo94: calls $6
matiko09: folds 
*** TURN *** [Jc Jh 9h] [As]
kiyo94: bets $50 and is all-in
mycka86: folds 
Uncalled bet ($50) returned to kiyo94
kiyo94 collected $19.95 from pot
kiyo94: doesn't show hand 
*** SUMMARY ***
Total pot $21 | Rake $1.05 
Board [Jc Jh 9h As]
Seat 1: Spid1 folded before Flop (didn't bet)
Seat 2: Chef-Zizou (button) folded before Flop (didn't bet)
Seat 3: kiyo94 (small blind) collected ($19.95)
Seat 4: matiko09 (big blind) folded on the Flop
Seat 5: mycka86 folded on the Turn
Seat 6: Mukhin1 folded before Flop (didn't bet)
Seat 7: ThorSun folded before Flop (didn't bet)
Seat 8: Kukuryzka folded before Flop (didn't bet)





PokerStars Hand #153068012067:  Hold'em No Limit ($0.50/$1.00 USD) - 2016/05/09 16:54:32 CET [2016/05/09 10:54:32 ET]
Table 'Reiss' 9-max Seat #5 is the button
Seat 1: Dickyxxx ($165.01 in chips) 
Seat 2: mycka86 ($116.70 in chips) 
Seat 3: chaps1988 ($114.50 in chips) 
Seat 4: pokerrewa ($80 in chips) 
Seat 5: matiko09 ($102.68 in chips) 
Seat 9: flyer9898 ($79 in chips) 
ozone2003 will be allowed to play after the button
R1aki will be allowed to play after the button
flyer9898: posts small blind $0.50
Dickyxxx: posts big blind $1
pokerrewa: posts big blind $1
*** HOLE CARDS ***
Dealt to matiko09 [4d Jc]
mycka86: folds 
chaps1988: folds 
pokerrewa: raises $2 to $3
matiko09: folds 
flyer9898: folds 
Dickyxxx: folds 
Uncalled bet ($2) returned to pokerrewa
pokerrewa collected $2.50 from pot
pokerrewa: doesn't show hand 
*** SUMMARY ***
Total pot $2.50 | Rake $0 
Seat 1: Dickyxxx (big blind) folded before Flop
Seat 2: mycka86 folded before Flop (didn't bet)
Seat 3: chaps1988 folded before Flop (didn't bet)
Seat 4: pokerrewa collected ($2.50)
Seat 5: matiko09 (button) folded before Flop (didn't bet)
Seat 9: flyer9898 (small blind) folded before Flop





PokerStars Hand #153068013868:  Hold'em No Limit ($0.50/$1.00 USD) - 2016/05/09 16:54:35 CET [2016/05/09 10:54:35 ET]
Table 'Buryatia II' 9-max Seat #5 is the button
Seat 1: flk.Dasas ($103.40 in chips) 
Seat 3: Desperategam ($117.38 in chips) 
Seat 4: FunkyDonkey1 ($87.95 in chips) 
Seat 5: amisasi ($91.08 in chips) 
Seat 6: I The King I ($100 in chips) 
Seat 8: matiko09 ($102.52 in chips) 
Seat 9: CI58 ($117.29 in chips) 
I The King I: posts small blind $0.50
matiko09: posts big blind $1
*** HOLE CARDS ***
Dealt to matiko09 [Ts Ah]
CI58: folds 
flk.Dasas: folds 
Desperategam: folds 
FunkyDonkey1: folds 
amisasi: folds 
I The King I: folds 
Uncalled bet ($0.50) returned to matiko09
matiko09 collected $1 from pot
matiko09: doesn't show hand 
*** SUMMARY ***
Total pot $1 | Rake $0 
Seat 1: flk.Dasas folded before Flop (didn't bet)
Seat 3: Desperategam folded before Flop (didn't bet)
Seat 4: FunkyDonkey1 folded before Flop (didn't bet)
Seat 5: amisasi (button) folded before Flop (didn't bet)
Seat 6: I The King I (small blind) folded before Flop
Seat 8: matiko09 (big blind) collected ($1)
Seat 9: CI58 folded before Flop (didn't bet)





PokerStars Hand #153068017979:  Hold'em No Limit ($0.50/$1.00 USD) - 2016/05/09 16:54:42 CET [2016/05/09 10:54:42 ET]
Table 'Hajek' 9-max Seat #9 is the button
Seat 1: CI58 ($100 in chips) 
Seat 2: Spid1 ($150.90 in chips) 
Seat 3: mycka86 ($101.90 in chips) 
Seat 4: LRVAV7 ($148.32 in chips) 
Seat 5: ozone2003 ($120.76 in chips) 
Seat 6: Filojoes ($100 in chips) 
Seat 7: DancerNN1 ($235.25 in chips) 
Seat 8: Kukuryzka ($126.80 in chips) 
Seat 9: matiko09 ($100 in chips) 
CI58: posts small blind $0.50
Spid1: posts big blind $1
CI58: posts the ante $0.20
Spid1: posts the ante $0.20
mycka86: posts the ante $0.20
LRVAV7: posts the ante $0.20
ozone2003: posts the ante $0.20
Filojoes: posts the ante $0.20
DancerNN1: posts the ante $0.20
Kukuryzka: posts the ante $0.20
matiko09: posts the ante $0.20
*** HOLE CARDS ***
Dealt to matiko09 [6s 2s]
mycka86: folds 
LRVAV7: folds 
ozone2003 has timed out
ozone2003: folds 
Filojoes: folds 
DancerNN1: folds 
Kukuryzka: raises $2 to $3
matiko09: folds 
CI58: folds 
Spid1: folds 
Uncalled bet ($2) returned to Kukuryzka
Kukuryzka collected $4.30 from pot
Kukuryzka: doesn't show hand 
*** SUMMARY ***
Total pot $4.30 | Rake $0 
Seat 1: CI58 (small blind) folded before Flop
Seat 2: Spid1 (big blind) folded before Flop
Seat 3: mycka86 folded before Flop (didn't bet)
Seat 4: LRVAV7 folded before Flop (didn't bet)
Seat 5: ozone2003 folded before Flop (didn't bet)
Seat 6: Filojoes folded before Flop (didn't bet)
Seat 7: DancerNN1 folded before Flop (didn't bet)
Seat 8: Kukuryzka collected ($4.30)
Seat 9: matiko09 (button) folded before Flop (didn't bet)





PokerStars Hand #153068021899:  Hold'em No Limit ($1/$2 USD) - 2016/05/09 16:54:48 CET [2016/05/09 10:54:48 ET]
Table 'Titan III' 9-max Seat #5 is the button
Seat 1: I The King I ($263.55 in chips) 
Seat 2: PacPacBum ($202 in chips) 
Seat 3: Spid1 ($444.95 in chips) 
Seat 5: Monsthand ($277.25 in chips) 
Seat 6: matiko09 ($200 in chips) 
Seat 7: seasar1 ($175.48 in chips) 
Seat 8: chaps1988 ($252.65 in chips) 
Seat 9: Sasuke777777 ($110.60 in chips) 
matiko09: posts small blind $1
seasar1: posts big blind $2
*** HOLE CARDS ***
Dealt to matiko09 [8h 2h]
chaps1988: folds 
Sasuke777777: folds 
I The King I: folds 
PacPacBum: folds 
Spid1: raises $3 to $5
Monsthand: raises $11.50 to $16.50
matiko09: folds 
seasar1: folds 
Spid1: folds 
Uncalled bet ($11.50) returned to Monsthand
Monsthand collected $13 from pot
Monsthand: doesn't show hand 
*** SUMMARY ***
Total pot $13 | Rake $0 
Seat 1: I The King I folded before Flop (didn't bet)
Seat 2: PacPacBum folded before Flop (didn't bet)
Seat 3: Spid1 folded before Flop
Seat 5: Monsthand (button) collected ($13)
Seat 6: matiko09 (small blind) folded before Flop
Seat 7: seasar1 (big blind) folded before Flop
Seat 8: chaps1988 folded before Flop (didn't bet)
Seat 9: Sasuke777777 folded before Flop (didn't bet)





PokerStars Hand #153068021704:  Hold'em No Limit ($0.50/$1.00 USD) - 2016/05/09 16:54:48 CET [2016/05/09 10:54:48 ET]
Table 'Orthos' 9-max Seat #7 is the button
Seat 1: Kelvin sai ($86.64 in chips) 
Seat 2: PacPacBum ($111.41 in chips) 
Seat 3: Filojoes ($118.11 in chips) 
Seat 5: matiko09 ($105.58 in chips) 
Seat 6: xhinostrabli ($107.83 in chips) 
Seat 7: flk.Dasas ($125.32 in chips) 
Seat 8: Dickyxxx ($100 in chips) 
Seat 9: mycka86 ($104.50 in chips) 
Dickyxxx: posts small blind $0.50
mycka86: posts big blind $1
*** HOLE CARDS ***
Dealt to matiko09 [2c Kh]
Kelvin sai: folds 
PacPacBum: folds 
Filojoes: folds 
matiko09: folds 
xhinostrabli: folds 
flk.Dasas: raises $1.50 to $2.50
Dickyxxx: folds 
mycka86: raises $6.50 to $9
flk.Dasas: calls $6.50
*** FLOP *** [7c Ah 6c]
mycka86: checks 
flk.Dasas: bets $10.37
mycka86: folds 
Uncalled bet ($10.37) returned to flk.Dasas
flk.Dasas collected $17.58 from pot
flk.Dasas: doesn't show hand 
*** SUMMARY ***
Total pot $18.50 | Rake $0.92 
Board [7c Ah 6c]
Seat 1: Kelvin sai folded before Flop (didn't bet)
Seat 2: PacPacBum folded before Flop (didn't bet)
Seat 3: Filojoes folded before Flop (didn't bet)
Seat 5: matiko09 folded before Flop (didn't bet)
Seat 6: xhinostrabli folded before Flop (didn't bet)
Seat 7: flk.Dasas (button) collected ($17.58)
Seat 8: Dickyxxx (small blind) folded before Flop
Seat 9: mycka86 (big blind) folded on the Flop





PokerStars Hand #153068026241:  Hold'em No Limit ($0.50/$1.00 USD) - 2016/05/09 16:54:56 CET [2016/05/09 10:54:56 ET]
Table 'Buryatia II' 9-max Seat #6 is the button
Seat 1: flk.Dasas ($103.40 in chips) 
Seat 3: Desperategam ($117.38 in chips) 
Seat 4: FunkyDonkey1 ($87.95 in chips) 
Seat 5: amisasi ($91.08 in chips) 
Seat 6: I The King I ($100 in chips) 
Seat 8: matiko09 ($103.02 in chips) 
Seat 9: CI58 ($117.29 in chips) 
matiko09: posts small blind $0.50
CI58: posts big blind $1
*** HOLE CARDS ***
Dealt to matiko09 [Qd Qh]
flk.Dasas: folds 
Desperategam: folds 
FunkyDonkey1: folds 
amisasi: folds 
I The King I: folds 
matiko09: raises $1.50 to $2.50
CI58: folds 
Uncalled bet ($1.50) returned to matiko09
matiko09 collected $2 from pot
matiko09: doesn't show hand 
*** SUMMARY ***
Total pot $2 | Rake $0 
Seat 1: flk.Dasas folded before Flop (didn't bet)
Seat 3: Desperategam folded before Flop (didn't bet)
Seat 4: FunkyDonkey1 folded before Flop (didn't bet)
Seat 5: amisasi folded before Flop (didn't bet)
Seat 6: I The King I (button) folded before Flop (didn't bet)
Seat 8: matiko09 (small blind) collected ($2)
Seat 9: CI58 (big blind) folded before Flop





PokerStars Hand #153068032591:  Hold'em No Limit ($0.50/$1.00 USD) - 2016/05/09 16:55:07 CET [2016/05/09 10:55:07 ET]
Table 'Reiss' 9-max Seat #9 is the button
Seat 1: Dickyxxx ($164.01 in chips) 
Seat 2: mycka86 ($116.70 in chips) 
Seat 3: chaps1988 ($114.50 in chips) 
Seat 4: pokerrewa ($81.50 in chips) 
Seat 5: matiko09 ($102.68 in chips) 
Seat 9: flyer9898 ($78.50 in chips) 
Dickyxxx: posts small blind $0.50
mycka86: posts big blind $1
ozone2003: sits out 
R1aki: sits out 
*** HOLE CARDS ***
Dealt to matiko09 [Kc 3s]
chaps1988: raises $1.50 to $2.50
pokerrewa: folds 
matiko09: folds 
flyer9898: folds 
Dickyxxx: calls $2
mycka86: folds 
*** FLOP *** [2c Kh 6d]
Dickyxxx: checks 
chaps1988: checks 
*** TURN *** [2c Kh 6d] [9d]
Dickyxxx: bets $2.85
chaps1988: calls $2.85
*** RIVER *** [2c Kh 6d 9d] [7d]
Dickyxxx: checks 
chaps1988: bets $9.50
Dickyxxx: folds 
Uncalled bet ($9.50) returned to chaps1988
chaps1988 collected $11.12 from pot
chaps1988: doesn't show hand 
*** SUMMARY ***
Total pot $11.70 | Rake $0.58 
Board [2c Kh 6d 9d 7d]
Seat 1: Dickyxxx (small blind) folded on the River
Seat 2: mycka86 (big blind) folded before Flop
Seat 3: chaps1988 collected ($11.12)
Seat 4: pokerrewa folded before Flop (didn't bet)
Seat 5: matiko09 folded before Flop (didn't bet)
Seat 9: flyer9898 (button) folded before Flop (didn't bet)





PokerStars Hand #153068033397:  Hold'em No Limit ($0.50/$1.00 USD) - 2016/05/09 16:55:08 CET [2016/05/09 10:55:08 ET]
Table 'Terpsichore' 9-max Seat #1 is the button
Seat 1: ipashutapkom ($159.72 in chips) 
Seat 2: CI58 ($125.20 in chips) 
Seat 3: matiko09 ($120.34 in chips) 
Seat 4: nubpoker ($133.48 in chips) 
Seat 5: mycka86 ($213.72 in chips) 
Seat 6: Filojoes ($100 in chips) 
Seat 7: ozone2003 ($105.25 in chips) 
Seat 8: Kiosk230472 ($135.10 in chips) 
Seat 9: FTPbannedMe ($123.11 in chips) 
CI58: posts small blind $0.50
matiko09: posts big blind $1
*** HOLE CARDS ***
Dealt to matiko09 [6s Kd]
nubpoker: folds 
mycka86: folds 
Filojoes: folds 
ozone2003: folds 
Kiosk230472: raises $3 to $4
FTPbannedMe: folds 
ipashutapkom: folds 
CI58: folds 
matiko09: folds 
Uncalled bet ($3) returned to Kiosk230472
Kiosk230472 collected $2.50 from pot
Kiosk230472: doesn't show hand 
*** SUMMARY ***
Total pot $2.50 | Rake $0 
Seat 1: ipashutapkom (button) folded before Flop (didn't bet)
Seat 2: CI58 (small blind) folded before Flop
Seat 3: matiko09 (big blind) folded before Flop
Seat 4: nubpoker folded before Flop (didn't bet)
Seat 5: mycka86 folded before Flop (didn't bet)
Seat 6: Filojoes folded before Flop (didn't bet)
Seat 7: ozone2003 folded before Flop (didn't bet)
Seat 8: Kiosk230472 collected ($2.50)
Seat 9: FTPbannedMe folded before Flop (didn't bet)





PokerStars Hand #153068037602:  Hold'em No Limit ($1/$2 USD) - 2016/05/09 16:55:17 CET [2016/05/09 10:55:17 ET]
Table 'Hagar II' 9-max Seat #4 is the button
Seat 1: mojitos86 ($193.36 in chips) 
Seat 2: darren1031 ($265.95 in chips) 
Seat 3: Sasuke777777 ($183.65 in chips) 
Seat 4: matiko09 ($427.84 in chips) 
Seat 5: PacPacBum ($200 in chips) 
Seat 6: el Fatto ($210.29 in chips) 
Seat 7: Monsthand ($219.15 in chips) 
Seat 9: chaps1988 ($205 in chips) 
PacPacBum: posts small blind $1
el Fatto: posts big blind $2
*** HOLE CARDS ***
Dealt to matiko09 [Ah 9s]
Monsthand: raises $4 to $6
chaps1988: folds 
mojitos86: folds 
darren1031: calls $6
Sasuke777777: calls $6
matiko09: folds 
PacPacBum: folds 
el Fatto: calls $4
*** FLOP *** [Ac 4h 2d]
el Fatto: checks 
Monsthand: bets $14
darren1031: folds 
Sasuke777777: folds 
el Fatto: folds 
Uncalled bet ($14) returned to Monsthand
Monsthand collected $23.75 from pot
Monsthand: doesn't show hand 
*** SUMMARY ***
Total pot $25 | Rake $1.25 
Board [Ac 4h 2d]
Seat 1: mojitos86 folded before Flop (didn't bet)
Seat 2: darren1031 folded on the Flop
Seat 3: Sasuke777777 folded on the Flop
Seat 4: matiko09 (button) folded before Flop (didn't bet)
Seat 5: PacPacBum (small blind) folded before Flop
Seat 6: el Fatto (big blind) folded on the Flop
Seat 7: Monsthand collected ($23.75)
Seat 9: chaps1988 folded before Flop (didn't bet)





PokerStars Hand #153068038152:  Hold'em No Limit ($0.50/$1.00 USD) - 2016/05/09 16:55:18 CET [2016/05/09 10:55:18 ET]
Table 'Buryatia II' 9-max Seat #8 is the button
Seat 1: flk.Dasas ($103.40 in chips) 
Seat 3: Desperategam ($117.38 in chips) 
Seat 4: FunkyDonkey1 ($87.95 in chips) 
Seat 5: amisasi ($91.08 in chips) 
Seat 6: I The King I ($100 in chips) 
Seat 8: matiko09 ($104.02 in chips) 
Seat 9: CI58 ($116.29 in chips) 
CI58: posts small blind $0.50
flk.Dasas: posts big blind $1
*** HOLE CARDS ***
Dealt to matiko09 [6h Ks]
Desperategam: folds 
FunkyDonkey1: folds 
amisasi: folds 
I The King I: folds 
matiko09: folds 
CI58: folds 
Uncalled bet ($0.50) returned to flk.Dasas
flk.Dasas collected $1 from pot
flk.Dasas: doesn't show hand 
*** SUMMARY ***
Total pot $1 | Rake $0 
Seat 1: flk.Dasas (big blind) collected ($1)
Seat 3: Desperategam folded before Flop (didn't bet)
Seat 4: FunkyDonkey1 folded before Flop (didn't bet)
Seat 5: amisasi folded before Flop (didn't bet)
Seat 6: I The King I folded before Flop (didn't bet)
Seat 8: matiko09 (button) folded before Flop (didn't bet)
Seat 9: CI58 (small blind) folded before Flop





PokerStars Hand #153068044514:  Hold'em No Limit ($0.50/$1.00 USD) - 2016/05/09 16:55:30 CET [2016/05/09 10:55:30 ET]
Table 'Hajek' 9-max Seat #1 is the button
Seat 1: CI58 ($100 in chips) 
Seat 2: Spid1 ($149.70 in chips) 
Seat 3: mycka86 ($101.70 in chips) 
Seat 4: LRVAV7 ($148.12 in chips) 
Seat 5: ozone2003 ($120.56 in chips) 
Seat 6: Filojoes ($100 in chips) 
Seat 7: DancerNN1 ($235.05 in chips) 
Seat 8: Kukuryzka ($129.90 in chips) 
Seat 9: matiko09 ($100 in chips) 
Spid1: posts small blind $0.50
mycka86: posts big blind $1
CI58: posts the ante $0.20
Spid1: posts the ante $0.20
mycka86: posts the ante $0.20
LRVAV7: posts the ante $0.20
ozone2003: posts the ante $0.20
Filojoes: posts the ante $0.20
DancerNN1: posts the ante $0.20
Kukuryzka: posts the ante $0.20
matiko09: posts the ante $0.20
*** HOLE CARDS ***
Dealt to matiko09 [9c 9h]
LRVAV7: folds 
ozone2003 has timed out
ozone2003: folds 
Filojoes: folds 
LRVAV7 leaves the table
DancerNN1: raises $2 to $3
Kukuryzka: folds 
matiko09: calls $3
CI58: folds 
Spid1: folds 
el Fatto joins the table at seat #4 
mycka86: folds 
*** FLOP *** [Jh Ts 8d]
el Fatto leaves the table
DancerNN1: checks 
matiko09: checks 
*** TURN *** [Jh Ts 8d] [Tc]
DancerNN1: bets $4.42
Donetsk1y joins the table at seat #4 
matiko09: calls $4.42
*** RIVER *** [Jh Ts 8d Tc] [5h]
Donetsk1y leaves the table
DancerNN1: checks 
matiko09: checks 
*** SHOW DOWN ***
DancerNN1: shows [Kc Qh] (a pair of Tens)
matiko09: shows [9c 9h] (two pair, Tens and Nines)
matiko09 collected $17.23 from pot
*** SUMMARY ***
Total pot $18.14 | Rake $0.91 
Board [Jh Ts 8d Tc 5h]
Seat 1: CI58 (button) folded before Flop (didn't bet)
Seat 2: Spid1 (small blind) folded before Flop
Seat 3: mycka86 (big blind) folded before Flop
Seat 4: LRVAV7 folded before Flop (didn't bet)
Seat 5: ozone2003 folded before Flop (didn't bet)
Seat 6: Filojoes folded before Flop (didn't bet)
Seat 7: DancerNN1 showed [Kc Qh] and lost with a pair of Tens
Seat 8: Kukuryzka folded before Flop (didn't bet)
Seat 9: matiko09 showed [9c 9h] and won ($17.23) with two pair, Tens and Nines





PokerStars Hand #153068044966:  Hold'em No Limit ($0.50/$1.00 USD) - 2016/05/09 16:55:31 CET [2016/05/09 10:55:31 ET]
Table 'Buryatia II' 9-max Seat #9 is the button
Seat 1: flk.Dasas ($103.90 in chips) 
Seat 3: Desperategam ($117.38 in chips) 
Seat 4: FunkyDonkey1 ($87.95 in chips) 
Seat 5: amisasi ($91.08 in chips) 
Seat 6: I The King I ($100 in chips) 
Seat 8: matiko09 ($104.02 in chips) 
Seat 9: CI58 ($115.79 in chips) 
flk.Dasas: posts small blind $0.50
Desperategam: posts big blind $1
*** HOLE CARDS ***
Dealt to matiko09 [7h 3h]
FunkyDonkey1: folds 
amisasi: calls $1
I The King I: folds 
matiko09: folds 
CI58: folds 
flk.Dasas: folds 
Desperategam: raises $4.50 to $5.50
amisasi: folds 
Uncalled bet ($4.50) returned to Desperategam
Desperategam collected $2.50 from pot
Desperategam: doesn't show hand 
*** SUMMARY ***
Total pot $2.50 | Rake $0 
Seat 1: flk.Dasas (small blind) folded before Flop
Seat 3: Desperategam (big blind) collected ($2.50)
Seat 4: FunkyDonkey1 folded before Flop (didn't bet)
Seat 5: amisasi folded before Flop
Seat 6: I The King I folded before Flop (didn't bet)
Seat 8: matiko09 folded before Flop (didn't bet)
Seat 9: CI58 (button) folded before Flop (didn't bet)





PokerStars Hand #153068045364:  Hold'em No Limit ($0.50/$1.00 USD) - 2016/05/09 16:55:32 CET [2016/05/09 10:55:32 ET]
Table 'Eucharis' 9-max Seat #3 is the button
Seat 1: Spid1 ($100 in chips) 
Seat 2: Chef-Zizou ($81.82 in chips) 
Seat 3: kiyo94 ($69.95 in chips) 
Seat 4: matiko09 ($100 in chips) 
Seat 5: mycka86 ($100 in chips) 
Seat 6: Mukhin1 ($100 in chips) 
Seat 7: ThorSun ($92.36 in chips) 
Seat 8: Kukuryzka ($100 in chips) 
matiko09: posts small blind $0.50
mycka86: posts big blind $1
*** HOLE CARDS ***
Dealt to matiko09 [Kd 9c]
Mukhin1: folds 
ThorSun: raises $2 to $3
Kukuryzka: raises $6 to $9
Spid1: folds 
Chef-Zizou: folds 
kiyo94: folds 
matiko09: folds 
mycka86: folds 
ThorSun: calls $6
*** FLOP *** [Qd 6h 5d]
ThorSun: checks 
Kukuryzka: bets $13.89
ThorSun: calls $13.89
*** TURN *** [Qd 6h 5d] [Js]
ThorSun: checks 
Kukuryzka: bets $77.11 and is all-in
ThorSun: folds 
Uncalled bet ($77.11) returned to Kukuryzka
Kukuryzka collected $44.92 from pot
Kukuryzka: doesn't show hand 
*** SUMMARY ***
Total pot $47.28 | Rake $2.36 
Board [Qd 6h 5d Js]
Seat 1: Spid1 folded before Flop (didn't bet)
Seat 2: Chef-Zizou folded before Flop (didn't bet)
Seat 3: kiyo94 (button) folded before Flop (didn't bet)
Seat 4: matiko09 (small blind) folded before Flop
Seat 5: mycka86 (big blind) folded before Flop
Seat 6: Mukhin1 folded before Flop (didn't bet)
Seat 7: ThorSun folded on the Turn
Seat 8: Kukuryzka collected ($44.92)





PokerStars Hand #153068045797:  Hold'em No Limit ($1/$2 USD) - 2016/05/09 16:55:33 CET [2016/05/09 10:55:33 ET]
Table 'Titan III' 9-max Seat #6 is the button
Seat 1: I The King I ($263.55 in chips) 
Seat 2: PacPacBum ($202 in chips) 
Seat 3: Spid1 ($439.95 in chips) 
Seat 5: Monsthand ($285.25 in chips) 
Seat 6: matiko09 ($200 in chips) 
Seat 7: seasar1 ($173.48 in chips) 
Seat 8: chaps1988 ($252.65 in chips) 
Seat 9: Sasuke777777 ($110.60 in chips) 
seasar1: posts small blind $1
chaps1988: posts big blind $2
*** HOLE CARDS ***
Dealt to matiko09 [4s Js]
Sasuke777777: folds 
I The King I: folds 
PacPacBum: folds 
Spid1: folds 
Monsthand: folds 
matiko09: folds 
seasar1: folds 
Uncalled bet ($1) returned to chaps1988
chaps1988 collected $2 from pot
chaps1988: doesn't show hand 
*** SUMMARY ***
Total pot $2 | Rake $0 
Seat 1: I The King I folded before Flop (didn't bet)
Seat 2: PacPacBum folded before Flop (didn't bet)
Seat 3: Spid1 folded before Flop (didn't bet)
Seat 5: Monsthand folded before Flop (didn't bet)
Seat 6: matiko09 (button) folded before Flop (didn't bet)
Seat 7: seasar1 (small blind) folded before Flop
Seat 8: chaps1988 (big blind) collected ($2)
Seat 9: Sasuke777777 folded before Flop (didn't bet)





PokerStars Hand #153068050122:  Hold'em No Limit ($0.50/$1.00 USD) - 2016/05/09 16:55:41 CET [2016/05/09 10:55:41 ET]
Table 'Terpsichore' 9-max Seat #2 is the button
Seat 1: ipashutapkom ($159.72 in chips) 
Seat 2: CI58 ($124.70 in chips) 
Seat 3: matiko09 ($119.34 in chips) 
Seat 4: nubpoker ($133.48 in chips) 
Seat 5: mycka86 ($213.72 in chips) 
Seat 6: Filojoes ($100 in chips) 
Seat 7: ozone2003 ($105.25 in chips) 
Seat 8: Kiosk230472 ($136.60 in chips) 
Seat 9: FTPbannedMe ($123.11 in chips) 
matiko09: posts small blind $0.50
nubpoker: posts big blind $1
*** HOLE CARDS ***
Dealt to matiko09 [Jh Tc]
mycka86: folds 
Filojoes: folds 
ozone2003: folds 
Kiosk230472: calls $1
FTPbannedMe: folds 
ipashutapkom: folds 
CI58: calls $1
matiko09: calls $0.50
nubpoker: checks 
*** FLOP *** [Js 3c 9s]
matiko09: bets $2.47
nubpoker: folds 
Kiosk230472: raises $4.53 to $7
CI58: folds 
matiko09: folds 
Uncalled bet ($4.53) returned to Kiosk230472
Kiosk230472 collected $8.49 from pot
Kiosk230472: doesn't show hand 
*** SUMMARY ***
Total pot $8.94 | Rake $0.45 
Board [Js 3c 9s]
Seat 1: ipashutapkom folded before Flop (didn't bet)
Seat 2: CI58 (button) folded on the Flop
Seat 3: matiko09 (small blind) folded on the Flop
Seat 4: nubpoker (big blind) folded on the Flop
Seat 5: mycka86 folded before Flop (didn't bet)
Seat 6: Filojoes folded before Flop (didn't bet)
Seat 7: ozone2003 folded before Flop (didn't bet)
Seat 8: Kiosk230472 collected ($8.49)
Seat 9: FTPbannedMe folded before Flop (didn't bet)





PokerStars Hand #153068056274:  Hold'em No Limit ($1/$2 USD) - 2016/05/09 16:55:54 CET [2016/05/09 10:55:54 ET]
Table 'Titan III' 9-max Seat #7 is the button
Seat 1: I The King I ($263.55 in chips) 
Seat 2: PacPacBum ($202 in chips) 
Seat 3: Spid1 ($439.95 in chips) 
Seat 5: Monsthand ($285.25 in chips) 
Seat 6: matiko09 ($200 in chips) 
Seat 7: seasar1 ($172.48 in chips) 
Seat 8: chaps1988 ($253.65 in chips) 
Seat 9: Sasuke777777 ($110.60 in chips) 
chaps1988: posts small blind $1
Sasuke777777: posts big blind $2
*** HOLE CARDS ***
Dealt to matiko09 [4d 8s]
I The King I: folds 
PacPacBum: folds 
Spid1: folds 
Monsthand: folds 
matiko09: folds 
seasar1: folds 
chaps1988: raises $4 to $6
Sasuke777777: folds 
Uncalled bet ($4) returned to chaps1988
chaps1988 collected $4 from pot
chaps1988: doesn't show hand 
*** SUMMARY ***
Total pot $4 | Rake $0 
Seat 1: I The King I folded before Flop (didn't bet)
Seat 2: PacPacBum folded before Flop (didn't bet)
Seat 3: Spid1 folded before Flop (didn't bet)
Seat 5: Monsthand folded before Flop (didn't bet)
Seat 6: matiko09 folded before Flop (didn't bet)
Seat 7: seasar1 (button) folded before Flop (didn't bet)
Seat 8: chaps1988 (small blind) collected ($4)
Seat 9: Sasuke777777 (big blind) folded before Flop





PokerStars Hand #153068060564:  Hold'em No Limit ($0.50/$1.00 USD) - 2016/05/09 16:56:02 CET [2016/05/09 10:56:02 ET]
Table 'Buryatia II' 9-max Seat #1 is the button
Seat 1: flk.Dasas ($103.40 in chips) 
Seat 3: Desperategam ($118.88 in chips) 
Seat 5: amisasi ($90.08 in chips) 
Seat 6: I The King I ($100 in chips) 
Seat 8: matiko09 ($104.02 in chips) 
Seat 9: CI58 ($115.79 in chips) 
Desperategam: posts small blind $0.50
FunkyDonkey1: is sitting out 
amisasi: posts big blind $1
*** HOLE CARDS ***
Dealt to matiko09 [Qh 6d]
FunkyDonkey1 leaves the table
I The King I: folds 
maxxmeister joins the table at seat #4 
matiko09: folds 
CI58: folds 
flk.Dasas: folds 
Desperategam: folds 
Uncalled bet ($0.50) returned to amisasi
amisasi collected $1 from pot
*** SUMMARY ***
Total pot $1 | Rake $0 
Seat 1: flk.Dasas (button) folded before Flop (didn't bet)
Seat 3: Desperategam (small blind) folded before Flop
Seat 5: amisasi (big blind) collected ($1)
Seat 6: I The King I folded before Flop (didn't bet)
Seat 8: matiko09 folded before Flop (didn't bet)
Seat 9: CI58 folded before Flop (didn't bet)





PokerStars Hand #153068060813:  Hold'em No Limit ($1/$2 USD) - 2016/05/09 16:56:03 CET [2016/05/09 10:56:03 ET]
Table 'Hagar II' 9-max Seat #5 is the button
Seat 1: mojitos86 ($193.36 in chips) 
Seat 2: darren1031 ($259.95 in chips) 
Seat 3: Sasuke777777 ($177.65 in chips) 
Seat 4: matiko09 ($427.84 in chips) 
Seat 5: PacPacBum ($200 in chips) 
Seat 6: el Fatto ($204.29 in chips) 
Seat 7: Monsthand ($236.90 in chips) 
Seat 9: chaps1988 ($205 in chips) 
el Fatto: posts small blind $1
Monsthand: posts big blind $2
*** HOLE CARDS ***
Dealt to matiko09 [9c Ad]
chaps1988: folds 
mojitos86: folds 
darren1031: calls $2
Sasuke777777: raises $4 to $6
matiko09: folds 
PacPacBum: folds 
el Fatto: folds 
Monsthand: calls $4
darren1031: calls $4
*** FLOP *** [Qd Jc 8c]
Monsthand: checks 
darren1031: checks 
Sasuke777777: bets $6
Monsthand: calls $6
darren1031: calls $6
*** TURN *** [Qd Jc 8c] [7s]
Monsthand: checks 
darren1031: checks 
Sasuke777777: bets $26
Monsthand: folds 
darren1031: folds 
Uncalled bet ($26) returned to Sasuke777777
Sasuke777777 collected $35.15 from pot
Sasuke777777: doesn't show hand 
*** SUMMARY ***
Total pot $37 | Rake $1.85 
Board [Qd Jc 8c 7s]
Seat 1: mojitos86 folded before Flop (didn't bet)
Seat 2: darren1031 folded on the Turn
Seat 3: Sasuke777777 collected ($35.15)
Seat 4: matiko09 folded before Flop (didn't bet)
Seat 5: PacPacBum (button) folded before Flop (didn't bet)
Seat 6: el Fatto (small blind) folded before Flop
Seat 7: Monsthand (big blind) folded on the Turn
Seat 9: chaps1988 folded before Flop (didn't bet)





PokerStars Hand #153068062230:  Hold'em No Limit ($0.50/$1.00 USD) - 2016/05/09 16:56:06 CET [2016/05/09 10:56:06 ET]
Table 'Reiss' 9-max Seat #1 is the button
Seat 1: Dickyxxx ($158.66 in chips) 
Seat 2: mycka86 ($115.70 in chips) 
Seat 3: chaps1988 ($120.27 in chips) 
Seat 4: pokerrewa ($81.50 in chips) 
Seat 5: matiko09 ($102.68 in chips) 
Seat 9: flyer9898 ($78.50 in chips) 
mycka86: posts small blind $0.50
chaps1988: posts big blind $1
ozone2003: sits out 
R1aki: sits out 
*** HOLE CARDS ***
Dealt to matiko09 [As 2d]
pokerrewa: raises $2 to $3
matiko09: folds 
flyer9898: folds 
Dickyxxx: folds 
mycka86: raises $6.30 to $9.30
chaps1988: folds 
pokerrewa: calls $6.30
*** FLOP *** [6c 8d 7h]
mycka86: checks 
pokerrewa: bets $9.31
mycka86: calls $9.31
*** TURN *** [6c 8d 7h] [Qd]
mycka86: checks 
pokerrewa: checks 
*** RIVER *** [6c 8d 7h Qd] [Th]
mycka86: checks 
pokerrewa: checks 
*** SHOW DOWN ***
mycka86: shows [Js Jd] (a pair of Jacks)
pokerrewa: mucks hand 
mycka86 collected $36.31 from pot
*** SUMMARY ***
Total pot $38.22 | Rake $1.91 
Board [6c 8d 7h Qd Th]
Seat 1: Dickyxxx (button) folded before Flop (didn't bet)
Seat 2: mycka86 (small blind) showed [Js Jd] and won ($36.31) with a pair of Jacks
Seat 3: chaps1988 (big blind) folded before Flop
Seat 4: pokerrewa mucked [Kc 2c]
Seat 5: matiko09 folded before Flop (didn't bet)
Seat 9: flyer9898 folded before Flop (didn't bet)





PokerStars Hand #153068067610:  Hold'em No Limit ($0.50/$1.00 USD) - 2016/05/09 16:56:16 CET [2016/05/09 10:56:16 ET]
Table 'Orthos' 9-max Seat #8 is the button
Seat 1: Kelvin sai ($86.64 in chips) 
Seat 2: PacPacBum ($111.41 in chips) 
Seat 3: Filojoes ($118.11 in chips) 
Seat 5: matiko09 ($105.58 in chips) 
Seat 6: xhinostrabli ($107.83 in chips) 
Seat 7: flk.Dasas ($133.90 in chips) 
Seat 8: Dickyxxx ($100 in chips) 
Seat 9: mycka86 ($100 in chips) 
mycka86: posts small blind $0.50
Kelvin sai: posts big blind $1
*** HOLE CARDS ***
Dealt to matiko09 [Qd 8c]
PacPacBum: calls $1
Filojoes: folds 
matiko09: folds 
xhinostrabli: folds 
flk.Dasas: folds 
Dickyxxx: folds 
mycka86: folds 
Kelvin sai: checks 
*** FLOP *** [Tc Kc Qc]
Kelvin sai: bets $1
PacPacBum: calls $1
*** TURN *** [Tc Kc Qc] [2s]
Kelvin sai: checks 
PacPacBum: bets $2.95
Kelvin sai: folds 
Uncalled bet ($2.95) returned to PacPacBum
PacPacBum collected $4.28 from pot
PacPacBum: doesn't show hand 
*** SUMMARY ***
Total pot $4.50 | Rake $0.22 
Board [Tc Kc Qc 2s]
Seat 1: Kelvin sai (big blind) folded on the Turn
Seat 2: PacPacBum collected ($4.28)
Seat 3: Filojoes folded before Flop (didn't bet)
Seat 5: matiko09 folded before Flop (didn't bet)
Seat 6: xhinostrabli folded before Flop (didn't bet)
Seat 7: flk.Dasas folded before Flop (didn't bet)
Seat 8: Dickyxxx (button) folded before Flop (didn't bet)
Seat 9: mycka86 (small blind) folded before Flop





PokerStars Hand #153068068954:  Hold'em No Limit ($1/$2 USD) - 2016/05/09 16:56:19 CET [2016/05/09 10:56:19 ET]
Table 'Titan III' 9-max Seat #8 is the button
Seat 1: I The King I ($263.55 in chips) 
Seat 2: PacPacBum ($202 in chips) 
Seat 3: Spid1 ($439.95 in chips) 
Seat 5: Monsthand ($285.25 in chips) 
Seat 6: matiko09 ($200 in chips) 
Seat 7: seasar1 ($172.48 in chips) 
Seat 8: chaps1988 ($255.65 in chips) 
Seat 9: Sasuke777777 ($108.60 in chips) 
Sasuke777777: posts small blind $1
I The King I: posts big blind $2
*** HOLE CARDS ***
Dealt to matiko09 [6h Ad]
PacPacBum: folds 
Spid1: folds 
Monsthand: folds 
matiko09: folds 
seasar1: folds 
chaps1988: folds 
Sasuke777777: raises $4 to $6
I The King I: folds 
Uncalled bet ($4) returned to Sasuke777777
Sasuke777777 collected $4 from pot
Sasuke777777: doesn't show hand 
*** SUMMARY ***
Total pot $4 | Rake $0 
Seat 1: I The King I (big blind) folded before Flop
Seat 2: PacPacBum folded before Flop (didn't bet)
Seat 3: Spid1 folded before Flop (didn't bet)
Seat 5: Monsthand folded before Flop (didn't bet)
Seat 6: matiko09 folded before Flop (didn't bet)
Seat 7: seasar1 folded before Flop (didn't bet)
Seat 8: chaps1988 (button) folded before Flop (didn't bet)
Seat 9: Sasuke777777 (small blind) collected ($4)





PokerStars Hand #153068072522:  Hold'em No Limit ($0.50/$1.00 USD) - 2016/05/09 16:56:26 CET [2016/05/09 10:56:26 ET]
Table 'Terpsichore' 9-max Seat #3 is the button
Seat 1: ipashutapkom ($159.72 in chips) 
Seat 2: CI58 ($123.70 in chips) 
Seat 3: matiko09 ($115.87 in chips) 
Seat 4: nubpoker ($132.48 in chips) 
Seat 5: mycka86 ($213.72 in chips) 
Seat 6: Filojoes ($100 in chips) 
Seat 7: ozone2003 ($105.25 in chips) 
Seat 8: Kiosk230472 ($141.62 in chips) 
Seat 9: FTPbannedMe ($123.11 in chips) 
nubpoker: posts small blind $0.50
mycka86: posts big blind $1
*** HOLE CARDS ***
Dealt to matiko09 [9h 5c]
Filojoes: folds 
ozone2003: folds 
Kiosk230472: calls $1
FTPbannedMe: folds 
ipashutapkom: folds 
CI58: raises $3 to $4
matiko09: folds 
nubpoker: folds 
mycka86: calls $3
Kiosk230472: calls $3
*** FLOP *** [3d 3h Ts]
mycka86: checks 
Kiosk230472: bets $6
CI58: calls $6
mycka86: calls $6
*** TURN *** [3d 3h Ts] [8d]
mycka86: checks 
Kiosk230472: checks 
CI58: checks 
*** RIVER *** [3d 3h Ts 8d] [7h]
mycka86: bets $10.14
Kiosk230472: folds 
CI58: calls $10.14
*** SHOW DOWN ***
mycka86: shows [Qd Td] (two pair, Tens and Threes)
CI58: mucks hand 
mycka86 collected $48.28 from pot
*** SUMMARY ***
Total pot $50.78 | Rake $2.50 
Board [3d 3h Ts 8d 7h]
Seat 1: ipashutapkom folded before Flop (didn't bet)
Seat 2: CI58 mucked [Tc Jh]
Seat 3: matiko09 (button) folded before Flop (didn't bet)
Seat 4: nubpoker (small blind) folded before Flop
Seat 5: mycka86 (big blind) showed [Qd Td] and won ($48.28) with two pair, Tens and Threes
Seat 6: Filojoes folded before Flop (didn't bet)
Seat 7: ozone2003 folded before Flop (didn't bet)
Seat 8: Kiosk230472 folded on the River
Seat 9: FTPbannedMe folded before Flop (didn't bet)





PokerStars Hand #153068075048:  Hold'em No Limit ($0.50/$1.00 USD) - 2016/05/09 16:56:31 CET [2016/05/09 10:56:31 ET]
Table 'Eucharis' 9-max Seat #4 is the button
Seat 1: Spid1 ($100 in chips) 
Seat 2: Chef-Zizou ($81.82 in chips) 
Seat 3: kiyo94 ($69.95 in chips) 
Seat 4: matiko09 ($100 in chips) 
Seat 5: mycka86 ($100 in chips) 
Seat 6: Mukhin1 ($100 in chips) 
Seat 7: ThorSun ($69.47 in chips) 
Seat 8: Kukuryzka ($122.03 in chips) 
mycka86: posts small blind $0.50
Mukhin1: posts big blind $1
*** HOLE CARDS ***
Dealt to matiko09 [Th Ah]
ThorSun: folds 
Kukuryzka: folds 
Spid1: folds 
Chef-Zizou: folds 
kiyo94: folds 
matiko09: raises $1.27 to $2.27
mycka86: folds 
Mukhin1: calls $1.27
*** FLOP *** [7d 9s 2d]
Mukhin1: checks 
matiko09: checks 
*** TURN *** [7d 9s 2d] [9h]
Mukhin1: checks 
matiko09: checks 
*** RIVER *** [7d 9s 2d 9h] [2c]
Mukhin1: checks 
matiko09: checks 
*** SHOW DOWN ***
Mukhin1: shows [Ac Jh] (two pair, Nines and Deuces)
matiko09: shows [Th Ah] (two pair, Nines and Deuces)
Mukhin1 collected $2.40 from pot
matiko09 collected $2.39 from pot
*** SUMMARY ***
Total pot $5.04 | Rake $0.25 
Board [7d 9s 2d 9h 2c]
Seat 1: Spid1 folded before Flop (didn't bet)
Seat 2: Chef-Zizou folded before Flop (didn't bet)
Seat 3: kiyo94 folded before Flop (didn't bet)
Seat 4: matiko09 (button) showed [Th Ah] and won ($2.39) with two pair, Nines and Deuces
Seat 5: mycka86 (small blind) folded before Flop
Seat 6: Mukhin1 (big blind) showed [Ac Jh] and won ($2.40) with two pair, Nines and Deuces
Seat 7: ThorSun folded before Flop (didn't bet)
Seat 8: Kukuryzka folded before Flop (didn't bet)





PokerStars Hand #153068078696:  Hold'em No Limit ($0.50/$1.00 USD) - 2016/05/09 16:56:38 CET [2016/05/09 10:56:38 ET]
Table 'Buryatia II' 9-max Seat #3 is the button
Seat 1: flk.Dasas ($103.40 in chips) 
Seat 3: Desperategam ($118.38 in chips) 
Seat 5: amisasi ($90.58 in chips) 
Seat 6: I The King I ($100 in chips) 
Seat 8: matiko09 ($104.02 in chips) 
Seat 9: CI58 ($115.79 in chips) 
maxxmeister will be allowed to play after the button
amisasi: posts small blind $0.50
I The King I: posts big blind $1
*** HOLE CARDS ***
Dealt to matiko09 [2h 4d]
matiko09: folds 
CI58: raises $2 to $3
flk.Dasas: folds 
Desperategam: calls $3
amisasi: folds 
I The King I: folds 
*** FLOP *** [5s Qh 9c]
CI58: checks 
Desperategam: checks 
*** TURN *** [5s Qh 9c] [Ad]
CI58: checks 
Desperategam: checks 
*** RIVER *** [5s Qh 9c Ad] [Ah]
CI58: checks 
Desperategam: checks 
*** SHOW DOWN ***
CI58: shows [Td Th] (two pair, Aces and Tens)
Desperategam: mucks hand 
CI58 collected $7.12 from pot
*** SUMMARY ***
Total pot $7.50 | Rake $0.38 
Board [5s Qh 9c Ad Ah]
Seat 1: flk.Dasas folded before Flop (didn't bet)
Seat 3: Desperategam (button) mucked [Kd Js]
Seat 5: amisasi (small blind) folded before Flop
Seat 6: I The King I (big blind) folded before Flop
Seat 8: matiko09 folded before Flop (didn't bet)
Seat 9: CI58 showed [Td Th] and won ($7.12) with two pair, Aces and Tens





PokerStars Hand #153068081444:  Hold'em No Limit ($1/$2 USD) - 2016/05/09 16:56:44 CET [2016/05/09 10:56:44 ET]
Table 'Titan III' 9-max Seat #9 is the button
Seat 1: I The King I ($261.55 in chips) 
Seat 2: PacPacBum ($202 in chips) 
Seat 3: Spid1 ($439.95 in chips) 
Seat 5: Monsthand ($285.25 in chips) 
Seat 6: matiko09 ($200 in chips) 
Seat 7: seasar1 ($172.48 in chips) 
Seat 8: chaps1988 ($255.65 in chips) 
Seat 9: Sasuke777777 ($110.60 in chips) 
I The King I: posts small blind $1
PacPacBum: posts big blind $2
*** HOLE CARDS ***
Dealt to matiko09 [Ts Qh]
Spid1: folds 
Monsthand: folds 
matiko09: folds 
seasar1: folds 
chaps1988: folds 
Sasuke777777: folds 
I The King I: folds 
Uncalled bet ($1) returned to PacPacBum
PacPacBum collected $2 from pot
PacPacBum: doesn't show hand 
*** SUMMARY ***
Total pot $2 | Rake $0 
Seat 1: I The King I (small blind) folded before Flop
Seat 2: PacPacBum (big blind) collected ($2)
Seat 3: Spid1 folded before Flop (didn't bet)
Seat 5: Monsthand folded before Flop (didn't bet)
Seat 6: matiko09 folded before Flop (didn't bet)
Seat 7: seasar1 folded before Flop (didn't bet)
Seat 8: chaps1988 folded before Flop (didn't bet)
Seat 9: Sasuke777777 (button) folded before Flop (didn't bet)





PokerStars Hand #153068090238:  Hold'em No Limit ($1/$2 USD) - 2016/05/09 16:57:01 CET [2016/05/09 10:57:01 ET]
Table 'Hagar II' 9-max Seat #6 is the button
Seat 1: mojitos86 ($193.36 in chips) 
Seat 2: darren1031 ($247.95 in chips) 
Seat 3: Sasuke777777 ($200.80 in chips) 
Seat 4: matiko09 ($427.84 in chips) 
Seat 5: PacPacBum ($200 in chips) 
Seat 6: el Fatto ($203.29 in chips) 
Seat 7: Monsthand ($224.90 in chips) 
Seat 9: chaps1988 ($205 in chips) 
Monsthand: posts small blind $1
chaps1988: posts big blind $2
*** HOLE CARDS ***
Dealt to matiko09 [Qh 9s]
mojitos86: folds 
darren1031: folds 
Sasuke777777: folds 
matiko09: folds 
PacPacBum: folds 
el Fatto: folds 
Monsthand: folds 
Uncalled bet ($1) returned to chaps1988
chaps1988 collected $2 from pot
chaps1988: doesn't show hand 
*** SUMMARY ***
Total pot $2 | Rake $0 
Seat 1: mojitos86 folded before Flop (didn't bet)
Seat 2: darren1031 folded before Flop (didn't bet)
Seat 3: Sasuke777777 folded before Flop (didn't bet)
Seat 4: matiko09 folded before Flop (didn't bet)
Seat 5: PacPacBum folded before Flop (didn't bet)
Seat 6: el Fatto (button) folded before Flop (didn't bet)
Seat 7: Monsthand (small blind) folded before Flop
Seat 9: chaps1988 (big blind) collected ($2)





PokerStars Hand #153068092799:  Hold'em No Limit ($1/$2 USD) - 2016/05/09 16:57:06 CET [2016/05/09 10:57:06 ET]
Table 'Titan III' 9-max Seat #1 is the button
Seat 1: I The King I ($260.55 in chips) 
Seat 2: PacPacBum ($203 in chips) 
Seat 3: Spid1 ($439.95 in chips) 
Seat 5: Monsthand ($285.25 in chips) 
Seat 6: matiko09 ($200 in chips) 
Seat 7: seasar1 ($172.48 in chips) 
Seat 8: chaps1988 ($255.65 in chips) 
Seat 9: Sasuke777777 ($110.60 in chips) 
PacPacBum: posts small blind $1
Spid1: posts big blind $2
*** HOLE CARDS ***
Dealt to matiko09 [5s 9s]
Monsthand: folds 
matiko09: folds 
seasar1: folds 
chaps1988: raises $3 to $5
Sasuke777777: folds 
I The King I: folds 
PacPacBum: folds 
Spid1: folds 
Uncalled bet ($3) returned to chaps1988
chaps1988 collected $5 from pot
chaps1988: doesn't show hand 
*** SUMMARY ***
Total pot $5 | Rake $0 
Seat 1: I The King I (button) folded before Flop (didn't bet)
Seat 2: PacPacBum (small blind) folded before Flop
Seat 3: Spid1 (big blind) folded before Flop
Seat 5: Monsthand folded before Flop (didn't bet)
Seat 6: matiko09 folded before Flop (didn't bet)
Seat 7: seasar1 folded before Flop (didn't bet)
Seat 8: chaps1988 collected ($5)
Seat 9: Sasuke777777 folded before Flop (didn't bet)





PokerStars Hand #153068095265:  Hold'em No Limit ($0.50/$1.00 USD) - 2016/05/09 16:57:11 CET [2016/05/09 10:57:11 ET]
Table 'Orthos' 9-max Seat #9 is the button
Seat 1: Kelvin sai ($84.64 in chips) 
Seat 2: PacPacBum ($113.69 in chips) 
Seat 3: Filojoes ($118.11 in chips) 
Seat 5: matiko09 ($105.58 in chips) 
Seat 6: xhinostrabli ($107.83 in chips) 
Seat 7: flk.Dasas ($133.90 in chips) 
Seat 8: Dickyxxx ($100 in chips) 
Seat 9: mycka86 ($100 in chips) 
Kelvin sai: posts small blind $0.50
PacPacBum: posts big blind $1
*** HOLE CARDS ***
Dealt to matiko09 [Th 5d]
Filojoes: raises $2 to $3
matiko09: folds 
xhinostrabli: calls $3
flk.Dasas: raises $9 to $12
Dickyxxx: folds 
mycka86: folds 
Kelvin sai: folds 
PacPacBum: folds 
Filojoes: raises $14 to $26
xhinostrabli: folds 
flk.Dasas: raises $107.90 to $133.90 and is all-in
Filojoes: folds 
Uncalled bet ($107.90) returned to flk.Dasas
flk.Dasas collected $56.50 from pot
flk.Dasas: doesn't show hand 
*** SUMMARY ***
Total pot $56.50 | Rake $0 
Seat 1: Kelvin sai (small blind) folded before Flop
Seat 2: PacPacBum (big blind) folded before Flop
Seat 3: Filojoes folded before Flop
Seat 5: matiko09 folded before Flop (didn't bet)
Seat 6: xhinostrabli folded before Flop
Seat 7: flk.Dasas collected ($56.50)
Seat 8: Dickyxxx folded before Flop (didn't bet)
Seat 9: mycka86 (button) folded before Flop (didn't bet)





PokerStars Hand #153068098922:  Hold'em No Limit ($0.50/$1.00 USD) - 2016/05/09 16:57:18 CET [2016/05/09 10:57:18 ET]
Table 'Hajek' 9-max Seat #2 is the button
Seat 1: CI58 ($100 in chips) 
Seat 2: Spid1 ($149 in chips) 
Seat 3: mycka86 ($100.50 in chips) 
Seat 5: ozone2003 ($120.36 in chips) 
Seat 6: Filojoes ($100 in chips) 
Seat 7: DancerNN1 ($227.43 in chips) 
Seat 8: Kukuryzka ($129.70 in chips) 
Seat 9: matiko09 ($109.61 in chips) 
mycka86: posts small blind $0.50
ozone2003: posts big blind $1
CI58: posts the ante $0.20
Spid1: posts the ante $0.20
mycka86: posts the ante $0.20
ozone2003: posts the ante $0.20
Filojoes: posts the ante $0.20
DancerNN1: posts the ante $0.20
Kukuryzka: posts the ante $0.20
matiko09: posts the ante $0.20
*** HOLE CARDS ***
Dealt to matiko09 [3h 5s]
Filojoes: folds 
DancerNN1: folds 
Kukuryzka: folds 
matiko09: folds 
CI58: folds 
Spid1: raises $1.50 to $2.50
mycka86: folds 
MoonJimmy joins the table at seat #4 
ozone2003: calls $1.50
*** FLOP *** [7d Qs 4d]
ozone2003: checks 
Spid1: bets $4.50
ozone2003: folds 
Uncalled bet ($4.50) returned to Spid1
Spid1 collected $6.74 from pot
Spid1: doesn't show hand 
*** SUMMARY ***
Total pot $7.10 | Rake $0.36 
Board [7d Qs 4d]
Seat 1: CI58 folded before Flop (didn't bet)
Seat 2: Spid1 (button) collected ($6.74)
Seat 3: mycka86 (small blind) folded before Flop
Seat 5: ozone2003 (big blind) folded on the Flop
Seat 6: Filojoes folded before Flop (didn't bet)
Seat 7: DancerNN1 folded before Flop (didn't bet)
Seat 8: Kukuryzka folded before Flop (didn't bet)
Seat 9: matiko09 folded before Flop (didn't bet)





PokerStars Hand #153068103178:  Hold'em No Limit ($1/$2 USD) - 2016/05/09 16:57:26 CET [2016/05/09 10:57:26 ET]
Table 'Titan III' 9-max Seat #2 is the button
Seat 1: I The King I ($260.55 in chips) 
Seat 2: PacPacBum ($202 in chips) 
Seat 3: Spid1 ($437.95 in chips) 
Seat 5: Monsthand ($285.25 in chips) 
Seat 6: matiko09 ($200 in chips) 
Seat 7: seasar1 ($172.48 in chips) 
Seat 8: chaps1988 ($258.65 in chips) 
Seat 9: Sasuke777777 ($110.60 in chips) 
Spid1: posts small blind $1
Monsthand: posts big blind $2
*** HOLE CARDS ***
Dealt to matiko09 [7d 4c]
matiko09: folds 
seasar1: raises $2 to $4
chaps1988: folds 
Sasuke777777: raises $8 to $12
I The King I: folds 
PacPacBum: folds 
Spid1: folds 
Monsthand: folds 
seasar1: calls $8
*** FLOP *** [3c 3d 4s]
seasar1: checks 
Sasuke777777: bets $16
seasar1: folds 
Uncalled bet ($16) returned to Sasuke777777
Sasuke777777 collected $25.65 from pot
Sasuke777777: doesn't show hand 
*** SUMMARY ***
Total pot $27 | Rake $1.35 
Board [3c 3d 4s]
Seat 1: I The King I folded before Flop (didn't bet)
Seat 2: PacPacBum (button) folded before Flop (didn't bet)
Seat 3: Spid1 (small blind) folded before Flop
Seat 5: Monsthand (big blind) folded before Flop
Seat 6: matiko09 folded before Flop (didn't bet)
Seat 7: seasar1 folded on the Flop
Seat 8: chaps1988 folded before Flop (didn't bet)
Seat 9: Sasuke777777 collected ($25.65)





PokerStars Hand #153068104177:  Hold'em No Limit ($1/$2 USD) - 2016/05/09 16:57:28 CET [2016/05/09 10:57:28 ET]
Table 'Hagar II' 9-max Seat #7 is the button
Seat 1: mojitos86 ($193.36 in chips) 
Seat 2: darren1031 ($247.95 in chips) 
Seat 3: Sasuke777777 ($200.80 in chips) 
Seat 4: matiko09 ($427.84 in chips) 
Seat 5: PacPacBum ($200 in chips) 
Seat 6: el Fatto ($203.29 in chips) 
Seat 7: Monsthand ($223.90 in chips) 
Seat 9: chaps1988 ($206 in chips) 
chaps1988: posts small blind $1
mojitos86: posts big blind $2
*** HOLE CARDS ***
Dealt to matiko09 [Js Th]
darren1031: folds 
Sasuke777777: folds 
matiko09: folds 
PacPacBum: folds 
el Fatto: folds 
Monsthand: raises $3 to $5
chaps1988: folds 
mojitos86: calls $3
*** FLOP *** [8s 8c 9d]
mojitos86: checks 
Monsthand: checks 
*** TURN *** [8s 8c 9d] [As]
mojitos86: checks 
Monsthand: bets $6.47
mojitos86: calls $6.47
*** RIVER *** [8s 8c 9d As] [3d]
mojitos86: checks 
Monsthand: checks 
*** SHOW DOWN ***
mojitos86: shows [Ac 3c] (two pair, Aces and Eights)
Monsthand: mucks hand 
mojitos86 collected $22.74 from pot
*** SUMMARY ***
Total pot $23.94 | Rake $1.20 
Board [8s 8c 9d As 3d]
Seat 1: mojitos86 (big blind) showed [Ac 3c] and won ($22.74) with two pair, Aces and Eights
Seat 2: darren1031 folded before Flop (didn't bet)
Seat 3: Sasuke777777 folded before Flop (didn't bet)
Seat 4: matiko09 folded before Flop (didn't bet)
Seat 5: PacPacBum folded before Flop (didn't bet)
Seat 6: el Fatto folded before Flop (didn't bet)
Seat 7: Monsthand (button) mucked [4h Kh]
Seat 9: chaps1988 (small blind) folded before Flop





PokerStars Hand #153068109357:  Hold'em No Limit ($0.50/$1.00 USD) - 2016/05/09 16:57:38 CET [2016/05/09 10:57:38 ET]
Table 'Buryatia II' 9-max Seat #5 is the button
Seat 1: flk.Dasas ($103.40 in chips) 
Seat 3: Desperategam ($115.38 in chips) 
Seat 5: amisasi ($90.08 in chips) 
Seat 6: I The King I ($100 in chips) 
Seat 8: matiko09 ($104.02 in chips) 
Seat 9: CI58 ($119.91 in chips) 
I The King I: posts small blind $0.50
matiko09: posts big blind $1
maxxmeister: sits out 
*** HOLE CARDS ***
Dealt to matiko09 [Td Ts]
CI58: folds 
flk.Dasas: raises $2 to $3
Desperategam: folds 
amisasi: folds 
I The King I: folds 
matiko09: calls $2
*** FLOP *** [Jd 8s 6c]
matiko09: checks 
flk.Dasas: checks 
*** TURN *** [Jd 8s 6c] [Ah]
matiko09: checks 
Desperategam is disconnected 
flk.Dasas: bets $4.20
matiko09: folds 
Uncalled bet ($4.20) returned to flk.Dasas
flk.Dasas collected $6.18 from pot
flk.Dasas: doesn't show hand 
*** SUMMARY ***
Total pot $6.50 | Rake $0.32 
Board [Jd 8s 6c Ah]
Seat 1: flk.Dasas collected ($6.18)
Seat 3: Desperategam folded before Flop (didn't bet)
Seat 5: amisasi (button) folded before Flop (didn't bet)
Seat 6: I The King I (small blind) folded before Flop
Seat 8: matiko09 (big blind) folded on the Turn
Seat 9: CI58 folded before Flop (didn't bet)





PokerStars Hand #153068117218:  Hold'em No Limit ($0.50/$1.00 USD) - 2016/05/09 16:57:53 CET [2016/05/09 10:57:53 ET]
Table 'Reiss' 9-max Seat #2 is the button
Seat 1: Dickyxxx ($158.66 in chips) 
Seat 2: mycka86 ($133.40 in chips) 
Seat 3: chaps1988 ($119.27 in chips) 
Seat 4: pokerrewa ($62.89 in chips) 
Seat 5: matiko09 ($102.68 in chips) 
Seat 9: flyer9898 ($78.50 in chips) 
chaps1988: posts small blind $0.50
pokerrewa: posts big blind $1
ozone2003: sits out 
R1aki: sits out 
*** HOLE CARDS ***
Dealt to matiko09 [As Qh]
matiko09: raises $2 to $3
flyer9898: folds 
Dickyxxx: folds 
mycka86: folds 
chaps1988: folds 
pokerrewa: calls $2
*** FLOP *** [4h 5d 9h]
pokerrewa: checks 
matiko09: checks 
*** TURN *** [4h 5d 9h] [Qc]
pokerrewa: checks 
matiko09: bets $4.02
pokerrewa: folds 
Uncalled bet ($4.02) returned to matiko09
matiko09 collected $6.18 from pot
matiko09: doesn't show hand 
*** SUMMARY ***
Total pot $6.50 | Rake $0.32 
Board [4h 5d 9h Qc]
Seat 1: Dickyxxx folded before Flop (didn't bet)
Seat 2: mycka86 (button) folded before Flop (didn't bet)
Seat 3: chaps1988 (small blind) folded before Flop
Seat 4: pokerrewa (big blind) folded on the Turn
Seat 5: matiko09 collected ($6.18)
Seat 9: flyer9898 folded before Flop (didn't bet)





PokerStars Hand #153068119300:  Hold'em No Limit ($0.50/$1.00 USD) - 2016/05/09 16:57:57 CET [2016/05/09 10:57:57 ET]
Table 'Eucharis' 9-max Seat #5 is the button
Seat 1: Spid1 ($100 in chips) 
Seat 2: Chef-Zizou ($81.82 in chips) 
Seat 3: kiyo94 ($69.95 in chips) 
Seat 4: matiko09 ($100.12 in chips) 
Seat 5: mycka86 ($100 in chips) 
Seat 6: Mukhin1 ($100.13 in chips) 
Seat 7: ThorSun ($69.47 in chips) 
Seat 8: Kukuryzka ($122.03 in chips) 
Mukhin1: posts small blind $0.50
ThorSun: posts big blind $1
*** HOLE CARDS ***
Dealt to matiko09 [2d 2c]
Kukuryzka: folds 
Spid1: folds 
Chef-Zizou: raises $1 to $2
kiyo94: calls $2
matiko09: calls $2
mycka86: calls $2
Mukhin1: folds 
ThorSun: calls $1
*** FLOP *** [8h 3d Kd]
ThorSun: checks 
Chef-Zizou: checks 
kiyo94: bets $4.99
matiko09: folds 
mycka86: folds 
ThorSun: folds 
Chef-Zizou: folds 
Uncalled bet ($4.99) returned to kiyo94
kiyo94 collected $9.98 from pot
kiyo94: doesn't show hand 
*** SUMMARY ***
Total pot $10.50 | Rake $0.52 
Board [8h 3d Kd]
Seat 1: Spid1 folded before Flop (didn't bet)
Seat 2: Chef-Zizou folded on the Flop
Seat 3: kiyo94 collected ($9.98)
Seat 4: matiko09 folded on the Flop
Seat 5: mycka86 (button) folded on the Flop
Seat 6: Mukhin1 (small blind) folded before Flop
Seat 7: ThorSun (big blind) folded on the Flop
Seat 8: Kukuryzka folded before Flop (didn't bet)





PokerStars Hand #153068130912:  Hold'em No Limit ($1/$2 USD) - 2016/05/09 16:58:20 CET [2016/05/09 10:58:20 ET]
Table 'Titan III' 9-max Seat #3 is the button
Seat 1: I The King I ($260.55 in chips) 
Seat 2: PacPacBum ($202 in chips) 
Seat 3: Spid1 ($436.95 in chips) 
Seat 5: Monsthand ($283.25 in chips) 
Seat 6: matiko09 ($200 in chips) 
Seat 7: seasar1 ($160.48 in chips) 
Seat 8: chaps1988 ($258.65 in chips) 
Seat 9: Sasuke777777 ($124.25 in chips) 
Monsthand: posts small blind $1
matiko09: posts big blind $2
*** HOLE CARDS ***
Dealt to matiko09 [5s Js]
seasar1: folds 
chaps1988: folds 
Sasuke777777: folds 
I The King I: raises $4 to $6
PacPacBum: folds 
Spid1: folds 
Monsthand: folds 
matiko09: folds 
Uncalled bet ($4) returned to I The King I
I The King I collected $5 from pot
I The King I: doesn't show hand 
*** SUMMARY ***
Total pot $5 | Rake $0 
Seat 1: I The King I collected ($5)
Seat 2: PacPacBum folded before Flop (didn't bet)
Seat 3: Spid1 (button) folded before Flop (didn't bet)
Seat 5: Monsthand (small blind) folded before Flop
Seat 6: matiko09 (big blind) folded before Flop
Seat 7: seasar1 folded before Flop (didn't bet)
Seat 8: chaps1988 folded before Flop (didn't bet)
Seat 9: Sasuke777777 folded before Flop (didn't bet)





PokerStars Hand #153068136663:  Hold'em No Limit ($0.50/$1.00 USD) - 2016/05/09 16:58:31 CET [2016/05/09 10:58:31 ET]
Table 'Reiss' 9-max Seat #3 is the button
Seat 1: Dickyxxx ($158.66 in chips) 
Seat 2: mycka86 ($133.40 in chips) 
Seat 3: chaps1988 ($118.77 in chips) 
Seat 4: pokerrewa ($59.89 in chips) 
Seat 5: matiko09 ($105.86 in chips) 
Seat 9: flyer9898 ($78.50 in chips) 
pokerrewa: posts small blind $0.50
matiko09: posts big blind $1
ozone2003: sits out 
R1aki: sits out 
*** HOLE CARDS ***
Dealt to matiko09 [8d Tc]
flyer9898: folds 
Dickyxxx: raises $2 to $3
mycka86: folds 
chaps1988: folds 
pokerrewa: folds 
matiko09: folds 
Uncalled bet ($2) returned to Dickyxxx
Dickyxxx collected $2.50 from pot
Dickyxxx: doesn't show hand 
*** SUMMARY ***
Total pot $2.50 | Rake $0 
Seat 1: Dickyxxx collected ($2.50)
Seat 2: mycka86 folded before Flop (didn't bet)
Seat 3: chaps1988 (button) folded before Flop (didn't bet)
Seat 4: pokerrewa (small blind) folded before Flop
Seat 5: matiko09 (big blind) folded before Flop
Seat 9: flyer9898 folded before Flop (didn't bet)





PokerStars Hand #153068137128:  Hold'em No Limit ($0.50/$1.00 USD) - 2016/05/09 16:58:32 CET [2016/05/09 10:58:32 ET]
Table 'Hajek' 9-max Seat #3 is the button
Seat 1: CI58 ($100 in chips) 
Seat 2: Spid1 ($153.04 in chips) 
Seat 3: mycka86 ($100 in chips) 
Seat 5: ozone2003 ($117.66 in chips) 
Seat 6: Filojoes ($100 in chips) 
Seat 7: DancerNN1 ($227.23 in chips) 
Seat 8: Kukuryzka ($129.50 in chips) 
Seat 9: matiko09 ($109.41 in chips) 
MoonJimmy will be allowed to play after the button
ozone2003: posts small blind $0.50
Filojoes: posts big blind $1
CI58: posts the ante $0.20
Spid1: posts the ante $0.20
mycka86: posts the ante $0.20
ozone2003: posts the ante $0.20
Filojoes: posts the ante $0.20
DancerNN1: posts the ante $0.20
Kukuryzka: posts the ante $0.20
matiko09: posts the ante $0.20
*** HOLE CARDS ***
Dealt to matiko09 [Jc 4c]
DancerNN1: folds 
Kukuryzka: folds 
DancerNN1 leaves the table
matiko09: folds 
CI58: raises $2 to $3
Spid1: folds 
mycka86: folds 
ozone2003: folds 
Filojoes: folds 
Uncalled bet ($2) returned to CI58
CI58 collected $4.10 from pot
CI58: doesn't show hand 
*** SUMMARY ***
Total pot $4.10 | Rake $0 
Seat 1: CI58 collected ($4.10)
Seat 2: Spid1 folded before Flop (didn't bet)
Seat 3: mycka86 (button) folded before Flop (didn't bet)
Seat 5: ozone2003 (small blind) folded before Flop
Seat 6: Filojoes (big blind) folded before Flop
Seat 7: DancerNN1 folded before Flop (didn't bet)
Seat 8: Kukuryzka folded before Flop (didn't bet)
Seat 9: matiko09 folded before Flop (didn't bet)





PokerStars Hand #153068137904:  Hold'em No Limit ($1/$2 USD) - 2016/05/09 16:58:33 CET [2016/05/09 10:58:33 ET]
Table 'Hagar II' 9-max Seat #9 is the button
Seat 1: mojitos86 ($204.63 in chips) 
Seat 2: darren1031 ($247.95 in chips) 
Seat 3: Sasuke777777 ($200.80 in chips) 
Seat 4: matiko09 ($427.84 in chips) 
Seat 5: PacPacBum ($200 in chips) 
Seat 6: el Fatto ($203.29 in chips) 
Seat 7: Monsthand ($212.43 in chips) 
Seat 9: chaps1988 ($205 in chips) 
mojitos86: posts small blind $1
darren1031: posts big blind $2
*** HOLE CARDS ***
Dealt to matiko09 [Ks Ts]
Sasuke777777: folds 
matiko09: raises $3 to $5
PacPacBum: folds 
el Fatto: folds 
Monsthand: folds 
chaps1988: folds 
mojitos86: folds 
darren1031: calls $3
*** FLOP *** [7h Th 3d]
darren1031: bets $8
matiko09: raises $14 to $22
darren1031: folds 
Uncalled bet ($14) returned to matiko09
matiko09 collected $25.65 from pot
matiko09: doesn't show hand 
*** SUMMARY ***
Total pot $27 | Rake $1.35 
Board [7h Th 3d]
Seat 1: mojitos86 (small blind) folded before Flop
Seat 2: darren1031 (big blind) folded on the Flop
Seat 3: Sasuke777777 folded before Flop (didn't bet)
Seat 4: matiko09 collected ($25.65)
Seat 5: PacPacBum folded before Flop (didn't bet)
Seat 6: el Fatto folded before Flop (didn't bet)
Seat 7: Monsthand folded before Flop (didn't bet)
Seat 9: chaps1988 (button) folded before Flop (didn't bet)





PokerStars Hand #153068138515:  Hold'em No Limit ($0.50/$1.00 USD) - 2016/05/09 16:58:35 CET [2016/05/09 10:58:35 ET]
Table 'Orthos' 9-max Seat #1 is the button
Seat 1: Kelvin sai ($84.14 in chips) 
Seat 2: PacPacBum ($112.69 in chips) 
Seat 3: Filojoes ($100 in chips) 
Seat 5: matiko09 ($105.58 in chips) 
Seat 6: xhinostrabli ($104.83 in chips) 
Seat 7: flk.Dasas ($164.40 in chips) 
Seat 8: Dickyxxx ($100 in chips) 
Seat 9: mycka86 ($100 in chips) 
PacPacBum: posts small blind $0.50
Filojoes: posts big blind $1
*** HOLE CARDS ***
Dealt to matiko09 [Ks 5c]
matiko09: folds 
xhinostrabli: raises $2 to $3
flk.Dasas: folds 
Dickyxxx: folds 
mycka86: folds 
Kelvin sai: calls $3
PacPacBum: folds 
Filojoes: calls $2
*** FLOP *** [Ah Js 4h]
Filojoes: checks 
xhinostrabli: checks 
Kelvin sai: bets $3
Filojoes: raises $5 to $8
xhinostrabli: folds 
Kelvin sai: calls $5
*** TURN *** [Ah Js 4h] [Kd]
Filojoes: checks 
Kelvin sai: checks 
*** RIVER *** [Ah Js 4h Kd] [Jc]
Filojoes: checks 
Kelvin sai: checks 
*** SHOW DOWN ***
Filojoes: shows [Ac Qh] (two pair, Aces and Jacks)
Kelvin sai: shows [8d Ad] (two pair, Aces and Jacks)
Filojoes collected $12.11 from pot
Kelvin sai collected $12.11 from pot
*** SUMMARY ***
Total pot $25.50 | Rake $1.28 
Board [Ah Js 4h Kd Jc]
Seat 1: Kelvin sai (button) showed [8d Ad] and won ($12.11) with two pair, Aces and Jacks
Seat 2: PacPacBum (small blind) folded before Flop
Seat 3: Filojoes (big blind) showed [Ac Qh] and won ($12.11) with two pair, Aces and Jacks
Seat 5: matiko09 folded before Flop (didn't bet)
Seat 6: xhinostrabli folded on the Flop
Seat 7: flk.Dasas folded before Flop (didn't bet)
Seat 8: Dickyxxx folded before Flop (didn't bet)
Seat 9: mycka86 folded before Flop (didn't bet)





PokerStars Hand #153068143265:  Hold'em No Limit ($0.50/$1.00 USD) - 2016/05/09 16:58:44 CET [2016/05/09 10:58:44 ET]
Table 'Eucharis' 9-max Seat #6 is the button
Seat 1: Spid1 ($100 in chips) 
Seat 2: Chef-Zizou ($79.82 in chips) 
Seat 3: kiyo94 ($77.93 in chips) 
Seat 4: matiko09 ($100 in chips) 
Seat 5: mycka86 ($100 in chips) 
Seat 6: Mukhin1 ($100 in chips) 
Seat 7: ThorSun ($67.47 in chips) 
Seat 8: Kukuryzka ($122.03 in chips) 
ThorSun: posts small blind $0.50
Kukuryzka: posts big blind $1
*** HOLE CARDS ***
Dealt to matiko09 [Td Ac]
Spid1: raises $2 to $3
Chef-Zizou: calls $3
kiyo94: calls $3
matiko09: folds 
mycka86: calls $3
Mukhin1: folds 
ThorSun: folds 
Kukuryzka: folds 
*** FLOP *** [4d 2c 2s]
Spid1: bets $10.50
Chef-Zizou: folds 
kiyo94: folds 
mycka86: folds 
Uncalled bet ($10.50) returned to Spid1
Spid1 collected $12.82 from pot
Spid1: doesn't show hand 
*** SUMMARY ***
Total pot $13.50 | Rake $0.68 
Board [4d 2c 2s]
Seat 1: Spid1 collected ($12.82)
Seat 2: Chef-Zizou folded on the Flop
Seat 3: kiyo94 folded on the Flop
Seat 4: matiko09 folded before Flop (didn't bet)
Seat 5: mycka86 folded on the Flop
Seat 6: Mukhin1 (button) folded before Flop (didn't bet)
Seat 7: ThorSun (small blind) folded before Flop
Seat 8: Kukuryzka (big blind) folded before Flop





PokerStars Hand #153068144227:  Hold'em No Limit ($1/$2 USD) - 2016/05/09 16:58:46 CET [2016/05/09 10:58:46 ET]
Table 'Titan III' 9-max Seat #5 is the button
Seat 1: I The King I ($263.55 in chips) 
Seat 2: PacPacBum ($202 in chips) 
Seat 3: Spid1 ($436.95 in chips) 
Seat 5: Monsthand ($282.25 in chips) 
Seat 6: matiko09 ($200 in chips) 
Seat 7: seasar1 ($160.48 in chips) 
Seat 8: chaps1988 ($258.65 in chips) 
Seat 9: Sasuke777777 ($124.25 in chips) 
matiko09: posts small blind $1
seasar1: posts big blind $2
*** HOLE CARDS ***
Dealt to matiko09 [Qh Tc]
chaps1988: folds 
Sasuke777777: folds 
I The King I: folds 
PacPacBum: folds 
Spid1: folds 
Monsthand: raises $3 to $5
matiko09: folds 
seasar1: folds 
Uncalled bet ($3) returned to Monsthand
Monsthand collected $5 from pot
Monsthand: doesn't show hand 
*** SUMMARY ***
Total pot $5 | Rake $0 
Seat 1: I The King I folded before Flop (didn't bet)
Seat 2: PacPacBum folded before Flop (didn't bet)
Seat 3: Spid1 folded before Flop (didn't bet)
Seat 5: Monsthand (button) collected ($5)
Seat 6: matiko09 (small blind) folded before Flop
Seat 7: seasar1 (big blind) folded before Flop
Seat 8: chaps1988 folded before Flop (didn't bet)
Seat 9: Sasuke777777 folded before Flop (didn't bet)





PokerStars Hand #153068145193:  Hold'em No Limit ($0.50/$1.00 USD) - 2016/05/09 16:58:47 CET [2016/05/09 10:58:47 ET]
Table 'Buryatia II' 9-max Seat #6 is the button
Seat 1: flk.Dasas ($106.58 in chips) 
Seat 3: Desperategam ($115.38 in chips) 
Seat 5: amisasi ($90.08 in chips) 
Seat 6: I The King I ($100 in chips) 
Seat 8: matiko09 ($101.02 in chips) 
Seat 9: CI58 ($119.91 in chips) 
matiko09: posts small blind $0.50
CI58: posts big blind $1
maxxmeister: sits out 
*** HOLE CARDS ***
Dealt to matiko09 [3s Jd]
flk.Dasas: folds 
Desperategam has timed out while disconnected
Desperategam: folds 
amisasi: calls $1
I The King I: raises $3 to $4
matiko09: folds 
CI58: folds 
amisasi: calls $3
*** FLOP *** [Ac Qs 6c]
amisasi: checks 
I The King I: checks 
*** TURN *** [Ac Qs 6c] [2d]
amisasi: bets $4
I The King I: folds 
Uncalled bet ($4) returned to amisasi
amisasi collected $9.02 from pot
*** SUMMARY ***
Total pot $9.50 | Rake $0.48 
Board [Ac Qs 6c 2d]
Seat 1: flk.Dasas folded before Flop (didn't bet)
Seat 3: Desperategam folded before Flop (didn't bet)
Seat 5: amisasi collected ($9.02)
Seat 6: I The King I (button) folded on the Turn
Seat 8: matiko09 (small blind) folded before Flop
Seat 9: CI58 (big blind) folded before Flop





PokerStars Hand #153068148218:  Hold'em No Limit ($0.50/$1.00 USD) - 2016/05/09 16:58:53 CET [2016/05/09 10:58:53 ET]
Table 'Reiss' 9-max Seat #4 is the button
Seat 1: Dickyxxx ($160.16 in chips) 
Seat 2: mycka86 ($133.40 in chips) 
Seat 3: chaps1988 ($118.77 in chips) 
Seat 4: pokerrewa ($59.39 in chips) 
Seat 5: matiko09 ($104.86 in chips) 
Seat 6: ozone2003 ($100 in chips) 
Seat 9: flyer9898 ($78.50 in chips) 
matiko09: posts small blind $0.50
ozone2003: posts big blind $1
R1aki: sits out 
*** HOLE CARDS ***
Dealt to matiko09 [Td 3c]
flyer9898: folds 
Dickyxxx: folds 
mycka86: raises $1.50 to $2.50
chaps1988: calls $2.50
pokerrewa: raises $8.50 to $11
matiko09: folds 
ozone2003: folds 
mycka86: raises $11 to $22
chaps1988: folds 
pokerrewa: raises $37.39 to $59.39 and is all-in
mycka86: calls $37.39
*** FLOP *** [5s 3s 4c]
*** TURN *** [5s 3s 4c] [6c]
*** RIVER *** [5s 3s 4c 6c] [Jh]
*** SHOW DOWN ***
mycka86: shows [Ac Ad] (a pair of Aces)
pokerrewa: shows [Qd Ah] (high card Ace)
mycka86 collected $120.28 from pot
*** SUMMARY ***
Total pot $122.78 | Rake $2.50 
Board [5s 3s 4c 6c Jh]
Seat 1: Dickyxxx folded before Flop (didn't bet)
Seat 2: mycka86 showed [Ac Ad] and won ($120.28) with a pair of Aces
Seat 3: chaps1988 folded before Flop
Seat 4: pokerrewa (button) showed [Qd Ah] and lost with high card Ace
Seat 5: matiko09 (small blind) folded before Flop
Seat 6: ozone2003 (big blind) folded before Flop
Seat 9: flyer9898 folded before Flop (didn't bet)





PokerStars Hand #153068150947:  Hold'em No Limit ($0.50/$1.00 USD) - 2016/05/09 16:58:58 CET [2016/05/09 10:58:58 ET]
Table 'Terpsichore' 9-max Seat #5 is the button
Seat 1: ipashutapkom ($159.72 in chips) 
Seat 2: CI58 ($103.56 in chips) 
Seat 3: matiko09 ($115.87 in chips) 
Seat 5: mycka86 ($241.86 in chips) 
Seat 6: Filojoes ($100 in chips) 
Seat 7: ozone2003 ($105.25 in chips) 
Seat 8: Kiosk230472 ($131.62 in chips) 
Seat 9: FTPbannedMe ($123.11 in chips) 
Filojoes: posts small blind $0.50
ozone2003: posts big blind $1
*** HOLE CARDS ***
Dealt to matiko09 [Tc 9c]
Kiosk230472: calls $1
FTPbannedMe: folds 
ipashutapkom: folds 
CI58: folds 
matiko09: raises $3 to $4
mycka86: folds 
Filojoes: folds 
ozone2003: folds 
Kiosk230472: calls $3
*** FLOP *** [4d 8s Kc]
Kiosk230472: checks 
matiko09: bets $5
Kiosk230472: folds 
Uncalled bet ($5) returned to matiko09
matiko09 collected $9.02 from pot
matiko09: doesn't show hand 
*** SUMMARY ***
Total pot $9.50 | Rake $0.48 
Board [4d 8s Kc]
Seat 1: ipashutapkom folded before Flop (didn't bet)
Seat 2: CI58 folded before Flop (didn't bet)
Seat 3: matiko09 collected ($9.02)
Seat 5: mycka86 (button) folded before Flop (didn't bet)
Seat 6: Filojoes (small blind) folded before Flop
Seat 7: ozone2003 (big blind) folded before Flop
Seat 8: Kiosk230472 folded on the Flop
Seat 9: FTPbannedMe folded before Flop (didn't bet)





PokerStars Hand #153068162815:  Hold'em No Limit ($1/$2 USD) - 2016/05/09 16:59:21 CET [2016/05/09 10:59:21 ET]
Table 'Titan III' 9-max Seat #6 is the button
Seat 1: I The King I ($263.55 in chips) 
Seat 2: PacPacBum ($202 in chips) 
Seat 3: Spid1 ($436.95 in chips) 
Seat 5: Monsthand ($285.25 in chips) 
Seat 6: matiko09 ($200 in chips) 
Seat 7: seasar1 ($158.48 in chips) 
Seat 8: chaps1988 ($258.65 in chips) 
Seat 9: Sasuke777777 ($124.25 in chips) 
seasar1: posts small blind $1
chaps1988: posts big blind $2
*** HOLE CARDS ***
Dealt to matiko09 [5c 9d]
Sasuke777777: folds 
I The King I: folds 
PacPacBum: raises $2.08 to $4.08
Spid1: folds 
Monsthand: folds 
matiko09: folds 
seasar1: folds 
chaps1988: calls $2.08
*** FLOP *** [4d 8d Kc]
chaps1988: checks 
PacPacBum: checks 
*** TURN *** [4d 8d Kc] [9h]
chaps1988: bets $7.50
PacPacBum: folds 
Uncalled bet ($7.50) returned to chaps1988
chaps1988 collected $8.70 from pot
chaps1988: doesn't show hand 
*** SUMMARY ***
Total pot $9.16 | Rake $0.46 
Board [4d 8d Kc 9h]
Seat 1: I The King I folded before Flop (didn't bet)
Seat 2: PacPacBum folded on the Turn
Seat 3: Spid1 folded before Flop (didn't bet)
Seat 5: Monsthand folded before Flop (didn't bet)
Seat 6: matiko09 (button) folded before Flop (didn't bet)
Seat 7: seasar1 (small blind) folded before Flop
Seat 8: chaps1988 (big blind) collected ($8.70)
Seat 9: Sasuke777777 folded before Flop (didn't bet)





PokerStars Hand #153068166426:  Hold'em No Limit ($1/$2 USD) - 2016/05/09 16:59:28 CET [2016/05/09 10:59:28 ET]
Table 'Hagar II' 9-max Seat #1 is the button
Seat 1: mojitos86 ($203.63 in chips) 
Seat 2: darren1031 ($234.95 in chips) 
Seat 3: Sasuke777777 ($200.80 in chips) 
Seat 4: matiko09 ($440.49 in chips) 
Seat 5: PacPacBum ($200 in chips) 
Seat 6: el Fatto ($203.29 in chips) 
Seat 7: Monsthand ($212.43 in chips) 
Seat 9: chaps1988 ($205 in chips) 
darren1031: posts small blind $1
Sasuke777777: posts big blind $2
*** HOLE CARDS ***
Dealt to matiko09 [Ks 8d]
matiko09: folds 
PacPacBum: folds 
el Fatto: folds 
Monsthand: raises $3.40 to $5.40
chaps1988: calls $5.40
mojitos86: calls $5.40
darren1031: folds 
Sasuke777777: folds 
*** FLOP *** [3h Qh Kd]
Monsthand: checks 
chaps1988: bets $12
mojitos86: calls $12
Monsthand: folds 
*** TURN *** [3h Qh Kd] [Ts]
chaps1988: checks 
mojitos86: checks 
*** RIVER *** [3h Qh Kd Ts] [5c]
chaps1988: checks 
mojitos86: checks 
*** SHOW DOWN ***
chaps1988: shows [As Qd] (a pair of Queens)
mojitos86: mucks hand 
chaps1988 collected $41.04 from pot
*** SUMMARY ***
Total pot $43.20 | Rake $2.16 
Board [3h Qh Kd Ts 5c]
Seat 1: mojitos86 (button) mucked [Td Ah]
Seat 2: darren1031 (small blind) folded before Flop
Seat 3: Sasuke777777 (big blind) folded before Flop
Seat 4: matiko09 folded before Flop (didn't bet)
Seat 5: PacPacBum folded before Flop (didn't bet)
Seat 6: el Fatto folded before Flop (didn't bet)
Seat 7: Monsthand folded on the Flop
Seat 9: chaps1988 showed [As Qd] and won ($41.04) with a pair of Queens





PokerStars Hand #153068172032:  Hold'em No Limit ($0.50/$1.00 USD) - 2016/05/09 16:59:39 CET [2016/05/09 10:59:39 ET]
Table 'Orthos' 9-max Seat #2 is the button
Seat 1: Kelvin sai ($85.25 in chips) 
Seat 2: PacPacBum ($112.19 in chips) 
Seat 3: Filojoes ($101.11 in chips) 
Seat 5: matiko09 ($105.58 in chips) 
Seat 6: xhinostrabli ($101.83 in chips) 
Seat 7: flk.Dasas ($164.40 in chips) 
Seat 8: Dickyxxx ($100 in chips) 
Seat 9: mycka86 ($100 in chips) 
Filojoes: posts small blind $0.50
matiko09: posts big blind $1
*** HOLE CARDS ***
Dealt to matiko09 [2d 8c]
xhinostrabli: folds 
flk.Dasas: folds 
Dickyxxx: folds 
mycka86: folds 
Kelvin sai: raises $1 to $2
PacPacBum: folds 
Filojoes: folds 
matiko09: folds 
Uncalled bet ($1) returned to Kelvin sai
Kelvin sai collected $2.50 from pot
Kelvin sai: doesn't show hand 
*** SUMMARY ***
Total pot $2.50 | Rake $0 
Seat 1: Kelvin sai collected ($2.50)
Seat 2: PacPacBum (button) folded before Flop (didn't bet)
Seat 3: Filojoes (small blind) folded before Flop
Seat 5: matiko09 (big blind) folded before Flop
Seat 6: xhinostrabli folded before Flop (didn't bet)
Seat 7: flk.Dasas folded before Flop (didn't bet)
Seat 8: Dickyxxx folded before Flop (didn't bet)
Seat 9: mycka86 folded before Flop (didn't bet)





PokerStars Hand #153068173021:  Hold'em No Limit ($0.50/$1.00 USD) - 2016/05/09 16:59:41 CET [2016/05/09 10:59:41 ET]
Table 'Eucharis' 9-max Seat #7 is the button
Seat 1: Spid1 ($109.82 in chips) 
Seat 2: Chef-Zizou ($76.82 in chips) 
Seat 3: kiyo94 ($74.93 in chips) 
Seat 4: matiko09 ($100 in chips) 
Seat 5: mycka86 ($100 in chips) 
Seat 6: Mukhin1 ($100 in chips) 
Seat 7: ThorSun ($66.97 in chips) 
Seat 8: Kukuryzka ($121.03 in chips) 
Kukuryzka: posts small blind $0.50
Spid1: posts big blind $1
*** HOLE CARDS ***
Dealt to matiko09 [2d 4c]
Chef-Zizou: folds 
kiyo94: folds 
matiko09: folds 
mycka86: folds 
Mukhin1: raises $1.55 to $2.55
ThorSun: calls $2.55
Kukuryzka: folds 
Spid1: folds 
*** FLOP *** [4h 9h 9s]
Mukhin1: bets $3.26
ThorSun: calls $3.26
*** TURN *** [4h 9h 9s] [7h]
Mukhin1: checks 
ThorSun: checks 
*** RIVER *** [4h 9h 9s 7h] [Ad]
Mukhin1: checks 
ThorSun: checks 
*** SHOW DOWN ***
Mukhin1: shows [Jd 8d] (a pair of Nines)
ThorSun: shows [Ks 7s] (two pair, Nines and Sevens)
ThorSun collected $12.46 from pot
*** SUMMARY ***
Total pot $13.12 | Rake $0.66 
Board [4h 9h 9s 7h Ad]
Seat 1: Spid1 (big blind) folded before Flop
Seat 2: Chef-Zizou folded before Flop (didn't bet)
Seat 3: kiyo94 folded before Flop (didn't bet)
Seat 4: matiko09 folded before Flop (didn't bet)
Seat 5: mycka86 folded before Flop (didn't bet)
Seat 6: Mukhin1 showed [Jd 8d] and lost with a pair of Nines
Seat 7: ThorSun (button) showed [Ks 7s] and won ($12.46) with two pair, Nines and Sevens
Seat 8: Kukuryzka (small blind) folded before Flop





PokerStars Hand #153068176597:  Hold'em No Limit ($0.50/$1.00 USD) - 2016/05/09 16:59:48 CET [2016/05/09 10:59:48 ET]
Table 'Buryatia II' 9-max Seat #8 is the button
Seat 1: flk.Dasas ($106.58 in chips) 
Seat 3: Desperategam ($115.38 in chips) 
Seat 5: amisasi ($95.10 in chips) 
Seat 6: I The King I ($100 in chips) 
Seat 8: matiko09 ($100.52 in chips) 
Seat 9: CI58 ($118.91 in chips) 
CI58: posts small blind $0.50
flk.Dasas: posts big blind $1
maxxmeister: sits out 
*** HOLE CARDS ***
Dealt to matiko09 [Ah 2h]
Desperategam: folds 
amisasi: raises $1 to $2
I The King I: folds 
matiko09: folds 
CI58: folds 
flk.Dasas: calls $1
*** FLOP *** [9s Tc Ks]
flk.Dasas: checks 
amisasi: checks 
*** TURN *** [9s Tc Ks] [6c]
flk.Dasas: bets $2.91
amisasi: folds 
Uncalled bet ($2.91) returned to flk.Dasas
flk.Dasas collected $4.28 from pot
flk.Dasas: doesn't show hand 
*** SUMMARY ***
Total pot $4.50 | Rake $0.22 
Board [9s Tc Ks 6c]
Seat 1: flk.Dasas (big blind) collected ($4.28)
Seat 3: Desperategam folded before Flop (didn't bet)
Seat 5: amisasi folded on the Turn
Seat 6: I The King I folded before Flop (didn't bet)
Seat 8: matiko09 (button) folded before Flop (didn't bet)
Seat 9: CI58 (small blind) folded before Flop





PokerStars Hand #153068186258:  Hold'em No Limit ($0.50/$1.00 USD) - 2016/05/09 17:00:06 CET [2016/05/09 11:00:06 ET]
Table 'Reiss' 9-max Seat #5 is the button
Seat 1: Dickyxxx ($160.16 in chips) 
Seat 2: mycka86 ($194.29 in chips) 
Seat 3: chaps1988 ($116.27 in chips) 
Seat 5: matiko09 ($104.36 in chips) 
Seat 6: ozone2003 ($100 in chips) 
Seat 8: R1aki ($100 in chips) 
Seat 9: flyer9898 ($78.50 in chips) 
ozone2003: posts small blind $0.50
R1aki: posts big blind $1
*** HOLE CARDS ***
Dealt to matiko09 [Ad 6c]
pokerrewa leaves the table
flyer9898: folds 
CI58 joins the table at seat #4 
Dickyxxx: folds 
mycka86: raises $1.50 to $2.50
chaps1988: calls $2.50
matiko09: folds 
ozone2003: folds 
R1aki: calls $1.50
*** FLOP *** [9c 3s Qh]
R1aki: checks 
mycka86: checks 
chaps1988: bets $5
R1aki: folds 
mycka86: folds 
Uncalled bet ($5) returned to chaps1988
chaps1988 collected $7.60 from pot
chaps1988: doesn't show hand 
*** SUMMARY ***
Total pot $8 | Rake $0.40 
Board [9c 3s Qh]
Seat 1: Dickyxxx folded before Flop (didn't bet)
Seat 2: mycka86 folded on the Flop
Seat 3: chaps1988 collected ($7.60)
Seat 5: matiko09 (button) folded before Flop (didn't bet)
Seat 6: ozone2003 (small blind) folded before Flop
Seat 8: R1aki (big blind) folded on the Flop
Seat 9: flyer9898 folded before Flop (didn't bet)





PokerStars Hand #153068194101:  Hold'em No Limit ($0.50/$1.00 USD) - 2016/05/09 17:00:21 CET [2016/05/09 11:00:21 ET]
Table 'Terpsichore' 9-max Seat #6 is the button
Seat 1: ipashutapkom ($159.72 in chips) 
Seat 2: CI58 ($103.56 in chips) 
Seat 3: matiko09 ($120.89 in chips) 
Seat 5: mycka86 ($241.86 in chips) 
Seat 6: Filojoes ($100 in chips) 
Seat 7: ozone2003 ($104.25 in chips) 
Seat 8: Kiosk230472 ($127.62 in chips) 
Seat 9: FTPbannedMe ($123.11 in chips) 
ozone2003: posts small blind $0.50
Kiosk230472: posts big blind $1
*** HOLE CARDS ***
Dealt to matiko09 [7d Jc]
FTPbannedMe: folds 
ipashutapkom: folds 
CI58: folds 
matiko09: folds 
mycka86: folds 
Filojoes: raises $1 to $2
ozone2003: folds 
Kiosk230472: calls $1
*** FLOP *** [7c 3d Kh]
Kiosk230472: checks 
Filojoes: checks 
*** TURN *** [7c 3d Kh] [4h]
Kiosk230472: bets $2
Filojoes: calls $2
*** RIVER *** [7c 3d Kh 4h] [Qd]
Kiosk230472: bets $2
Filojoes: folds 
Uncalled bet ($2) returned to Kiosk230472
Kiosk230472 collected $8.08 from pot
Kiosk230472: doesn't show hand 
*** SUMMARY ***
Total pot $8.50 | Rake $0.42 
Board [7c 3d Kh 4h Qd]
Seat 1: ipashutapkom folded before Flop (didn't bet)
Seat 2: CI58 folded before Flop (didn't bet)
Seat 3: matiko09 folded before Flop (didn't bet)
Seat 5: mycka86 folded before Flop (didn't bet)
Seat 6: Filojoes (button) folded on the River
Seat 7: ozone2003 (small blind) folded before Flop
Seat 8: Kiosk230472 (big blind) collected ($8.08)
Seat 9: FTPbannedMe folded before Flop (didn't bet)





PokerStars Hand #153068194890:  Hold'em No Limit ($0.50/$1.00 USD) - 2016/05/09 17:00:23 CET [2016/05/09 11:00:23 ET]
Table 'Orthos' 9-max Seat #3 is the button
Seat 1: Kelvin sai ($86.75 in chips) 
Seat 2: PacPacBum ($112.19 in chips) 
Seat 3: Filojoes ($100.61 in chips) 
Seat 5: matiko09 ($104.58 in chips) 
Seat 6: xhinostrabli ($101.83 in chips) 
Seat 7: flk.Dasas ($164.40 in chips) 
Seat 8: Dickyxxx ($100 in chips) 
Seat 9: mycka86 ($100 in chips) 
matiko09: posts small blind $0.50
xhinostrabli: posts big blind $1
*** HOLE CARDS ***
Dealt to matiko09 [Ah Js]
flk.Dasas: folds 
Dickyxxx: folds 
mycka86: folds 
Kelvin sai: folds 
PacPacBum: folds 
Filojoes: folds 
matiko09: raises $1.50 to $2.50
xhinostrabli: folds 
Uncalled bet ($1.50) returned to matiko09
matiko09 collected $2 from pot
matiko09: doesn't show hand 
*** SUMMARY ***
Total pot $2 | Rake $0 
Seat 1: Kelvin sai folded before Flop (didn't bet)
Seat 2: PacPacBum folded before Flop (didn't bet)
Seat 3: Filojoes (button) folded before Flop (didn't bet)
Seat 5: matiko09 (small blind) collected ($2)
Seat 6: xhinostrabli (big blind) folded before Flop
Seat 7: flk.Dasas folded before Flop (didn't bet)
Seat 8: Dickyxxx folded before Flop (didn't bet)
Seat 9: mycka86 folded before Flop (didn't bet)





PokerStars Hand #153068201450:  Hold'em No Limit ($0.50/$1.00 USD) - 2016/05/09 17:00:35 CET [2016/05/09 11:00:35 ET]
Table 'Eucharis' 9-max Seat #8 is the button
Seat 1: Spid1 ($108.82 in chips) 
Seat 2: Chef-Zizou ($76.82 in chips) 
Seat 3: kiyo94 ($74.93 in chips) 
Seat 4: matiko09 ($100 in chips) 
Seat 5: mycka86 ($100 in chips) 
Seat 6: Mukhin1 ($100 in chips) 
Seat 7: ThorSun ($73.62 in chips) 
Seat 8: Kukuryzka ($120.53 in chips) 
Spid1: posts small blind $0.50
Chef-Zizou: posts big blind $1
*** HOLE CARDS ***
Dealt to matiko09 [Th Ks]
kiyo94: folds 
matiko09: folds 
mycka86: folds 
Mukhin1: raises $2.02 to $3.02
ThorSun: calls $3.02
Kukuryzka: folds 
Spid1: folds 
Chef-Zizou: folds 
*** FLOP *** [8d Ah 4s]
Mukhin1: bets $2.43
ThorSun: calls $2.43
*** TURN *** [8d Ah 4s] [7d]
Mukhin1: checks 
ThorSun: checks 
*** RIVER *** [8d Ah 4s 7d] [As]
Mukhin1: bets $8.71
ThorSun: folds 
Uncalled bet ($8.71) returned to Mukhin1
Mukhin1 collected $11.78 from pot
Mukhin1: doesn't show hand 
*** SUMMARY ***
Total pot $12.40 | Rake $0.62 
Board [8d Ah 4s 7d As]
Seat 1: Spid1 (small blind) folded before Flop
Seat 2: Chef-Zizou (big blind) folded before Flop
Seat 3: kiyo94 folded before Flop (didn't bet)
Seat 4: matiko09 folded before Flop (didn't bet)
Seat 5: mycka86 folded before Flop (didn't bet)
Seat 6: Mukhin1 collected ($11.78)
Seat 7: ThorSun folded on the River
Seat 8: Kukuryzka (button) folded before Flop (didn't bet)





PokerStars Hand #153068202950:  Hold'em No Limit ($1/$2 USD) - 2016/05/09 17:00:38 CET [2016/05/09 11:00:38 ET]
Table 'Titan III' 9-max Seat #7 is the button
Seat 1: I The King I ($263.55 in chips) 
Seat 2: PacPacBum ($200 in chips) 
Seat 3: Spid1 ($436.95 in chips) 
Seat 5: Monsthand ($285.25 in chips) 
Seat 6: matiko09 ($200 in chips) 
Seat 7: seasar1 ($157.48 in chips) 
Seat 8: chaps1988 ($263.27 in chips) 
Seat 9: Sasuke777777 ($124.25 in chips) 
chaps1988: posts small blind $1
Sasuke777777: posts big blind $2
*** HOLE CARDS ***
Dealt to matiko09 [9d 9c]
I The King I: folds 
PacPacBum: folds 
Spid1: folds 
Monsthand: folds 
matiko09: raises $3 to $5
seasar1: folds 
chaps1988: folds 
Sasuke777777: folds 
Uncalled bet ($3) returned to matiko09
matiko09 collected $5 from pot
matiko09: doesn't show hand 
*** SUMMARY ***
Total pot $5 | Rake $0 
Seat 1: I The King I folded before Flop (didn't bet)
Seat 2: PacPacBum folded before Flop (didn't bet)
Seat 3: Spid1 folded before Flop (didn't bet)
Seat 5: Monsthand folded before Flop (didn't bet)
Seat 6: matiko09 collected ($5)
Seat 7: seasar1 (button) folded before Flop (didn't bet)
Seat 8: chaps1988 (small blind) folded before Flop
Seat 9: Sasuke777777 (big blind) folded before Flop





PokerStars Hand #153068203538:  Hold'em No Limit ($0.50/$1.00 USD) - 2016/05/09 17:00:39 CET [2016/05/09 11:00:39 ET]
Table 'Buryatia II' 9-max Seat #9 is the button
Seat 1: flk.Dasas ($108.86 in chips) 
Seat 3: Desperategam ($115.38 in chips) 
Seat 5: amisasi ($93.10 in chips) 
Seat 6: I The King I ($100 in chips) 
Seat 8: matiko09 ($100.52 in chips) 
Seat 9: CI58 ($118.41 in chips) 
flk.Dasas: posts small blind $0.50
Desperategam: posts big blind $1
maxxmeister: sits out 
*** HOLE CARDS ***
Dealt to matiko09 [6d Ad]
amisasi: folds 
I The King I: folds 
matiko09: raises $1.50 to $2.50
CI58: folds 
flk.Dasas: raises $6.50 to $9
Desperategam: calls $8
matiko09: folds 
*** FLOP *** [3c Td Kh]
flk.Dasas: bets $11.49
Desperategam: calls $11.49
*** TURN *** [3c Td Kh] [6c]
flk.Dasas: bets $28.09
Desperategam: calls $28.09
*** RIVER *** [3c Td Kh 6c] [9d]
flk.Dasas: bets $60.28 and is all-in
Desperategam: folds 
Uncalled bet ($60.28) returned to flk.Dasas
flk.Dasas collected $97.16 from pot
flk.Dasas: doesn't show hand 
*** SUMMARY ***
Total pot $99.66 | Rake $2.50 
Board [3c Td Kh 6c 9d]
Seat 1: flk.Dasas (small blind) collected ($97.16)
Seat 3: Desperategam (big blind) folded on the River
Seat 5: amisasi folded before Flop (didn't bet)
Seat 6: I The King I folded before Flop (didn't bet)
Seat 8: matiko09 folded before Flop
Seat 9: CI58 (button) folded before Flop (didn't bet)





PokerStars Hand #153068207895:  Hold'em No Limit ($0.50/$1.00 USD) - 2016/05/09 17:00:47 CET [2016/05/09 11:00:47 ET]
Table 'Orthos' 9-max Seat #5 is the button
Seat 1: Kelvin sai ($86.75 in chips) 
Seat 2: PacPacBum ($112.19 in chips) 
Seat 3: Filojoes ($100.61 in chips) 
Seat 5: matiko09 ($105.58 in chips) 
Seat 6: xhinostrabli ($100.83 in chips) 
Seat 7: flk.Dasas ($164.40 in chips) 
Seat 8: Dickyxxx ($100 in chips) 
Seat 9: mycka86 ($100 in chips) 
xhinostrabli: posts small blind $0.50
flk.Dasas: posts big blind $1
*** HOLE CARDS ***
Dealt to matiko09 [7h 2s]
Dickyxxx: folds 
mycka86: folds 
Kelvin sai: raises $1 to $2
PacPacBum: folds 
Filojoes: folds 
matiko09: folds 
xhinostrabli: folds 
flk.Dasas: folds 
Uncalled bet ($1) returned to Kelvin sai
Kelvin sai collected $2.50 from pot
Kelvin sai: doesn't show hand 
*** SUMMARY ***
Total pot $2.50 | Rake $0 
Seat 1: Kelvin sai collected ($2.50)
Seat 2: PacPacBum folded before Flop (didn't bet)
Seat 3: Filojoes folded before Flop (didn't bet)
Seat 5: matiko09 (button) folded before Flop (didn't bet)
Seat 6: xhinostrabli (small blind) folded before Flop
Seat 7: flk.Dasas (big blind) folded before Flop
Seat 8: Dickyxxx folded before Flop (didn't bet)
Seat 9: mycka86 folded before Flop (didn't bet)





PokerStars Hand #153068210417:  Hold'em No Limit ($1/$2 USD) - 2016/05/09 17:00:51 CET [2016/05/09 11:00:51 ET]
Table 'Hagar II' 9-max Seat #2 is the button
Seat 1: mojitos86 ($186.23 in chips) 
Seat 2: darren1031 ($233.95 in chips) 
Seat 3: Sasuke777777 ($198.80 in chips) 
Seat 4: matiko09 ($440.49 in chips) 
Seat 5: PacPacBum ($200 in chips) 
Seat 6: el Fatto ($203.29 in chips) 
Seat 7: Monsthand ($207.03 in chips) 
Seat 9: chaps1988 ($228.64 in chips) 
Sasuke777777: posts small blind $1
matiko09: posts big blind $2
*** HOLE CARDS ***
Dealt to matiko09 [Kd 4c]
PacPacBum: folds 
el Fatto: raises $4 to $6
Monsthand: folds 
chaps1988: folds 
mojitos86: folds 
darren1031: calls $6
Sasuke777777: raises $18 to $24
matiko09: folds 
el Fatto: calls $18
darren1031: calls $18
*** FLOP *** [7c 7h 5s]
Sasuke777777: bets $71.25
el Fatto: folds 
darren1031: folds 
Uncalled bet ($71.25) returned to Sasuke777777
Sasuke777777 collected $71.25 from pot
Sasuke777777: doesn't show hand 
*** SUMMARY ***
Total pot $74 | Rake $2.75 
Board [7c 7h 5s]
Seat 1: mojitos86 folded before Flop (didn't bet)
Seat 2: darren1031 (button) folded on the Flop
Seat 3: Sasuke777777 (small blind) collected ($71.25)
Seat 4: matiko09 (big blind) folded before Flop
Seat 5: PacPacBum folded before Flop (didn't bet)
Seat 6: el Fatto folded on the Flop
Seat 7: Monsthand folded before Flop (didn't bet)
Seat 9: chaps1988 folded before Flop (didn't bet)





PokerStars Hand #153068218106:  Hold'em No Limit ($1/$2 USD) - 2016/05/09 17:01:05 CET [2016/05/09 11:01:05 ET]
Table 'Titan III' 9-max Seat #8 is the button
Seat 1: I The King I ($263.55 in chips) 
Seat 2: PacPacBum ($200 in chips) 
Seat 3: Spid1 ($436.95 in chips) 
Seat 5: Monsthand ($285.25 in chips) 
Seat 6: matiko09 ($203 in chips) 
Seat 7: seasar1 ($157.48 in chips) 
Seat 8: chaps1988 ($262.27 in chips) 
Seat 9: Sasuke777777 ($122.25 in chips) 
Sasuke777777: posts small blind $1
I The King I: posts big blind $2
*** HOLE CARDS ***
Dealt to matiko09 [5h 6h]
PacPacBum: raises $4 to $6
Spid1: folds 
Monsthand: folds 
matiko09: folds 
seasar1: folds 
chaps1988: folds 
Sasuke777777: folds 
I The King I: folds 
Uncalled bet ($4) returned to PacPacBum
PacPacBum collected $5 from pot
PacPacBum: doesn't show hand 
*** SUMMARY ***
Total pot $5 | Rake $0 
Seat 1: I The King I (big blind) folded before Flop
Seat 2: PacPacBum collected ($5)
Seat 3: Spid1 folded before Flop (didn't bet)
Seat 5: Monsthand folded before Flop (didn't bet)
Seat 6: matiko09 folded before Flop (didn't bet)
Seat 7: seasar1 folded before Flop (didn't bet)
Seat 8: chaps1988 (button) folded before Flop (didn't bet)
Seat 9: Sasuke777777 (small blind) folded before Flop





PokerStars Hand #153068223876:  Hold'em No Limit ($0.50/$1.00 USD) - 2016/05/09 17:01:15 CET [2016/05/09 11:01:15 ET]
Table 'Reiss' 9-max Seat #6 is the button
Seat 1: Dickyxxx ($160.16 in chips) 
Seat 2: mycka86 ($191.79 in chips) 
Seat 3: chaps1988 ($121.37 in chips) 
Seat 5: matiko09 ($104.36 in chips) 
Seat 6: ozone2003 ($100 in chips) 
Seat 8: R1aki ($100 in chips) 
Seat 9: flyer9898 ($78.50 in chips) 
R1aki: posts small blind $0.50
flyer9898: posts big blind $1
CI58: sits out 
*** HOLE CARDS ***
Dealt to matiko09 [8h 5d]
Dickyxxx: folds 
mycka86: raises $2 to $3
chaps1988: folds 
matiko09: folds 
ozone2003: calls $3
R1aki: folds 
flyer9898: folds 
*** FLOP *** [3s Ts 3h]
mycka86: checks 
ozone2003: checks 
*** TURN *** [3s Ts 3h] [Td]
mycka86: checks 
ozone2003: checks 
*** RIVER *** [3s Ts 3h Td] [Jh]
mycka86: checks 
ozone2003: checks 
*** SHOW DOWN ***
mycka86: shows [Kh Ad] (two pair, Tens and Threes)
ozone2003: shows [Ac Kd] (two pair, Tens and Threes)
mycka86 collected $3.56 from pot
ozone2003 collected $3.56 from pot
*** SUMMARY ***
Total pot $7.50 | Rake $0.38 
Board [3s Ts 3h Td Jh]
Seat 1: Dickyxxx folded before Flop (didn't bet)
Seat 2: mycka86 showed [Kh Ad] and won ($3.56) with two pair, Tens and Threes
Seat 3: chaps1988 folded before Flop (didn't bet)
Seat 5: matiko09 folded before Flop (didn't bet)
Seat 6: ozone2003 (button) showed [Ac Kd] and won ($3.56) with two pair, Tens and Threes
Seat 8: R1aki (small blind) folded before Flop
Seat 9: flyer9898 (big blind) folded before Flop





PokerStars Hand #153068227505:  Hold'em No Limit ($0.50/$1.00 USD) - 2016/05/09 17:01:21 CET [2016/05/09 11:01:21 ET]
Table 'Eucharis' 9-max Seat #1 is the button
Seat 1: Spid1 ($108.32 in chips) 
Seat 2: Chef-Zizou ($75.82 in chips) 
Seat 3: kiyo94 ($74.93 in chips) 
Seat 4: matiko09 ($100 in chips) 
Seat 5: mycka86 ($100 in chips) 
Seat 6: Mukhin1 ($106.33 in chips) 
Seat 7: ThorSun ($68.17 in chips) 
Seat 8: Kukuryzka ($120.53 in chips) 
Chef-Zizou: posts small blind $0.50
kiyo94: posts big blind $1
*** HOLE CARDS ***
Dealt to matiko09 [4d 9s]
matiko09: folds 
mycka86: folds 
Mukhin1: folds 
ThorSun: raises $1 to $2
Kukuryzka: folds 
Spid1: folds 
Chef-Zizou: folds 
kiyo94: calls $1
*** FLOP *** [Qs Qh 8h]
kiyo94: checks 
ThorSun: bets $3
kiyo94: folds 
Uncalled bet ($3) returned to ThorSun
ThorSun collected $4.28 from pot
ThorSun: doesn't show hand 
*** SUMMARY ***
Total pot $4.50 | Rake $0.22 
Board [Qs Qh 8h]
Seat 1: Spid1 (button) folded before Flop (didn't bet)
Seat 2: Chef-Zizou (small blind) folded before Flop
Seat 3: kiyo94 (big blind) folded on the Flop
Seat 4: matiko09 folded before Flop (didn't bet)
Seat 5: mycka86 folded before Flop (didn't bet)
Seat 6: Mukhin1 folded before Flop (didn't bet)
Seat 7: ThorSun collected ($4.28)
Seat 8: Kukuryzka folded before Flop (didn't bet)





PokerStars Hand #153068230506:  Hold'em No Limit ($1/$2 USD) - 2016/05/09 17:01:26 CET [2016/05/09 11:01:26 ET]
Table 'Titan III' 9-max Seat #9 is the button
Seat 1: I The King I ($261.55 in chips) 
Seat 2: PacPacBum ($203 in chips) 
Seat 3: Spid1 ($436.95 in chips) 
Seat 5: Monsthand ($285.25 in chips) 
Seat 6: matiko09 ($203 in chips) 
Seat 7: seasar1 ($157.48 in chips) 
Seat 8: chaps1988 ($262.27 in chips) 
Seat 9: Sasuke777777 ($121.25 in chips) 
I The King I: posts small blind $1
PacPacBum: posts big blind $2
*** HOLE CARDS ***
Dealt to matiko09 [6h 2c]
Spid1: folds 
Monsthand: folds 
matiko09: folds 
seasar1: folds 
chaps1988: folds 
Sasuke777777 has timed out
Sasuke777777: folds 
I The King I: folds 
Uncalled bet ($1) returned to PacPacBum
PacPacBum collected $2 from pot
PacPacBum: doesn't show hand 
*** SUMMARY ***
Total pot $2 | Rake $0 
Seat 1: I The King I (small blind) folded before Flop
Seat 2: PacPacBum (big blind) collected ($2)
Seat 3: Spid1 folded before Flop (didn't bet)
Seat 5: Monsthand folded before Flop (didn't bet)
Seat 6: matiko09 folded before Flop (didn't bet)
Seat 7: seasar1 folded before Flop (didn't bet)
Seat 8: chaps1988 folded before Flop (didn't bet)
Seat 9: Sasuke777777 (button) folded before Flop (didn't bet)





PokerStars Hand #153068236200:  Hold'em No Limit ($0.50/$1.00 USD) - 2016/05/09 17:01:36 CET [2016/05/09 11:01:36 ET]
Table 'Orthos' 9-max Seat #6 is the button
Seat 1: Kelvin sai ($88.25 in chips) 
Seat 2: PacPacBum ($112.19 in chips) 
Seat 3: Filojoes ($100.61 in chips) 
Seat 5: matiko09 ($105.58 in chips) 
Seat 6: xhinostrabli ($100.33 in chips) 
Seat 7: flk.Dasas ($163.40 in chips) 
Seat 8: Dickyxxx ($100 in chips) 
Seat 9: mycka86 ($100 in chips) 
flk.Dasas: posts small blind $0.50
Dickyxxx: posts big blind $1
*** HOLE CARDS ***
Dealt to matiko09 [2h 4d]
mycka86: folds 
Kelvin sai: folds 
PacPacBum: folds 
Filojoes: folds 
matiko09: folds 
xhinostrabli: folds 
flk.Dasas: folds 
Uncalled bet ($0.50) returned to Dickyxxx
Dickyxxx collected $1 from pot
Dickyxxx: doesn't show hand 
*** SUMMARY ***
Total pot $1 | Rake $0 
Seat 1: Kelvin sai folded before Flop (didn't bet)
Seat 2: PacPacBum folded before Flop (didn't bet)
Seat 3: Filojoes folded before Flop (didn't bet)
Seat 5: matiko09 folded before Flop (didn't bet)
Seat 6: xhinostrabli (button) folded before Flop (didn't bet)
Seat 7: flk.Dasas (small blind) folded before Flop
Seat 8: Dickyxxx (big blind) collected ($1)
Seat 9: mycka86 folded before Flop (didn't bet)





PokerStars Hand #153068238473:  Hold'em No Limit ($0.50/$1.00 USD) - 2016/05/09 17:01:40 CET [2016/05/09 11:01:40 ET]
Table 'Terpsichore' 9-max Seat #7 is the button
Seat 1: ipashutapkom ($159.72 in chips) 
Seat 2: CI58 ($103.56 in chips) 
Seat 3: matiko09 ($120.89 in chips) 
Seat 5: mycka86 ($241.86 in chips) 
Seat 6: Filojoes ($100 in chips) 
Seat 7: ozone2003 ($103.75 in chips) 
Seat 8: Kiosk230472 ($131.70 in chips) 
Seat 9: FTPbannedMe ($123.11 in chips) 
Kiosk230472: posts small blind $0.50
FTPbannedMe: posts big blind $1
*** HOLE CARDS ***
Dealt to matiko09 [5c 2c]
ipashutapkom: raises $1.26 to $2.26
CI58: folds 
matiko09: folds 
mycka86: folds 
Filojoes: folds 
ozone2003: folds 
Kiosk230472: raises $2.74 to $5
FTPbannedMe: calls $4
ipashutapkom: calls $2.74
*** FLOP *** [5s Th Qs]
Kiosk230472: checks 
FTPbannedMe: bets $9.68
ipashutapkom: calls $9.68
Kiosk230472: folds 
*** TURN *** [5s Th Qs] [Jc]
FTPbannedMe: checks 
ipashutapkom: bets $16.97
FTPbannedMe: calls $16.97
*** RIVER *** [5s Th Qs Jc] [2d]
FTPbannedMe: checks 
ipashutapkom: bets $58.47
FTPbannedMe: folds 
Uncalled bet ($58.47) returned to ipashutapkom
ipashutapkom collected $65.80 from pot
ipashutapkom: doesn't show hand 
*** SUMMARY ***
Total pot $68.30 | Rake $2.50 
Board [5s Th Qs Jc 2d]
Seat 1: ipashutapkom collected ($65.80)
Seat 2: CI58 folded before Flop (didn't bet)
Seat 3: matiko09 folded before Flop (didn't bet)
Seat 5: mycka86 folded before Flop (didn't bet)
Seat 6: Filojoes folded before Flop (didn't bet)
Seat 7: ozone2003 (button) folded before Flop (didn't bet)
Seat 8: Kiosk230472 (small blind) folded on the Flop
Seat 9: FTPbannedMe (big blind) folded on the River





PokerStars Hand #153068241311:  Hold'em No Limit ($1/$2 USD) - 2016/05/09 17:01:44 CET [2016/05/09 11:01:44 ET]
Table 'Hagar II' 9-max Seat #3 is the button
Seat 1: mojitos86 ($186.23 in chips) 
Seat 2: darren1031 ($209.95 in chips) 
Seat 3: Sasuke777777 ($246.05 in chips) 
Seat 4: matiko09 ($438.49 in chips) 
Seat 5: PacPacBum ($200 in chips) 
Seat 6: el Fatto ($200 in chips) 
Seat 7: Monsthand ($207.03 in chips) 
Seat 9: chaps1988 ($228.64 in chips) 
matiko09: posts small blind $1
PacPacBum: posts big blind $2
*** HOLE CARDS ***
Dealt to matiko09 [5s Qs]
el Fatto: raises $4 to $6
Monsthand: folds 
chaps1988: folds 
mojitos86: folds 
darren1031: raises $203.95 to $209.95 and is all-in
Sasuke777777: folds 
matiko09: folds 
PacPacBum: folds 
el Fatto: folds 
Uncalled bet ($203.95) returned to darren1031
darren1031 collected $15 from pot
darren1031: doesn't show hand 
*** SUMMARY ***
Total pot $15 | Rake $0 
Seat 1: mojitos86 folded before Flop (didn't bet)
Seat 2: darren1031 collected ($15)
Seat 3: Sasuke777777 (button) folded before Flop (didn't bet)
Seat 4: matiko09 (small blind) folded before Flop
Seat 5: PacPacBum (big blind) folded before Flop
Seat 6: el Fatto folded before Flop
Seat 7: Monsthand folded before Flop (didn't bet)
Seat 9: chaps1988 folded before Flop (didn't bet)





PokerStars Hand #153068247086:  Hold'em No Limit ($0.50/$1.00 USD) - 2016/05/09 17:01:53 CET [2016/05/09 11:01:53 ET]
Table 'Orthos' 9-max Seat #7 is the button
Seat 1: Kelvin sai ($88.25 in chips) 
Seat 2: PacPacBum ($112.19 in chips) 
Seat 3: Filojoes ($100.61 in chips) 
Seat 5: matiko09 ($105.58 in chips) 
Seat 6: xhinostrabli ($100.33 in chips) 
Seat 7: flk.Dasas ($162.90 in chips) 
Seat 8: Dickyxxx ($100.50 in chips) 
Seat 9: mycka86 ($100 in chips) 
Dickyxxx: posts small blind $0.50
mycka86: posts big blind $1
*** HOLE CARDS ***
Dealt to matiko09 [5d 3s]
Kelvin sai: raises $1 to $2
PacPacBum: calls $2
Filojoes: folds 
matiko09: folds 
xhinostrabli: folds 
flk.Dasas: folds 
Dickyxxx: folds 
mycka86: calls $1
*** FLOP *** [8h Jd Qs]
mycka86: checks 
Kelvin sai: checks 
PacPacBum: checks 
*** TURN *** [8h Jd Qs] [2s]
mycka86: checks 
Kelvin sai: checks 
PacPacBum: checks 
*** RIVER *** [8h Jd Qs 2s] [4d]
mycka86: checks 
Kelvin sai: checks 
PacPacBum: bets $2
mycka86: folds 
Kelvin sai: calls $2
*** SHOW DOWN ***
PacPacBum: shows [Js Ad] (a pair of Jacks)
Kelvin sai: mucks hand 
PacPacBum collected $9.98 from pot
*** SUMMARY ***
Total pot $10.50 | Rake $0.52 
Board [8h Jd Qs 2s 4d]
Seat 1: Kelvin sai mucked [8d 9d]
Seat 2: PacPacBum showed [Js Ad] and won ($9.98) with a pair of Jacks
Seat 3: Filojoes folded before Flop (didn't bet)
Seat 5: matiko09 folded before Flop (didn't bet)
Seat 6: xhinostrabli folded before Flop (didn't bet)
Seat 7: flk.Dasas (button) folded before Flop (didn't bet)
Seat 8: Dickyxxx (small blind) folded before Flop
Seat 9: mycka86 (big blind) folded on the River





PokerStars Hand #153068250794:  Hold'em No Limit ($1/$2 USD) - 2016/05/09 17:01:59 CET [2016/05/09 11:01:59 ET]
Table 'Titan III' 9-max Seat #1 is the button
Seat 1: I The King I ($260.55 in chips) 
Seat 2: PacPacBum ($204 in chips) 
Seat 3: Spid1 ($436.95 in chips) 
Seat 5: Monsthand ($285.25 in chips) 
Seat 6: matiko09 ($203 in chips) 
Seat 7: seasar1 ($157.48 in chips) 
Seat 8: chaps1988 ($262.27 in chips) 
Seat 9: Sasuke777777 ($121.25 in chips) 
PacPacBum: posts small blind $1
Spid1: posts big blind $2
*** HOLE CARDS ***
Dealt to matiko09 [8d 5d]
Monsthand: folds 
matiko09: folds 
seasar1: raises $2 to $4
chaps1988: folds 
Sasuke777777: folds 
I The King I: folds 
PacPacBum: folds 
Spid1: folds 
Uncalled bet ($2) returned to seasar1
seasar1 collected $5 from pot
*** SUMMARY ***
Total pot $5 | Rake $0 
Seat 1: I The King I (button) folded before Flop (didn't bet)
Seat 2: PacPacBum (small blind) folded before Flop
Seat 3: Spid1 (big blind) folded before Flop
Seat 5: Monsthand folded before Flop (didn't bet)
Seat 6: matiko09 folded before Flop (didn't bet)
Seat 7: seasar1 collected ($5)
Seat 8: chaps1988 folded before Flop (didn't bet)
Seat 9: Sasuke777777 folded before Flop (didn't bet)





PokerStars Hand #153068253355:  Hold'em No Limit ($0.50/$1.00 USD) - 2016/05/09 17:02:04 CET [2016/05/09 11:02:04 ET]
Table 'Reiss' 9-max Seat #8 is the button
Seat 1: Dickyxxx ($160.16 in chips) 
Seat 2: mycka86 ($192.35 in chips) 
Seat 3: chaps1988 ($121.37 in chips) 
Seat 5: matiko09 ($104.36 in chips) 
Seat 6: ozone2003 ($100.56 in chips) 
Seat 8: R1aki ($100 in chips) 
Seat 9: flyer9898 ($77.50 in chips) 
flyer9898: posts small blind $0.50
Dickyxxx: posts big blind $1
CI58: sits out 
*** HOLE CARDS ***
Dealt to matiko09 [3d 6c]
mycka86: folds 
chaps1988: folds 
matiko09: folds 
ozone2003: folds 
R1aki: raises $1.50 to $2.50
flyer9898: folds 
Dickyxxx: raises $6.50 to $9
R1aki: folds 
Uncalled bet ($6.50) returned to Dickyxxx
Dickyxxx collected $5.50 from pot
Dickyxxx: doesn't show hand 
*** SUMMARY ***
Total pot $5.50 | Rake $0 
Seat 1: Dickyxxx (big blind) collected ($5.50)
Seat 2: mycka86 folded before Flop (didn't bet)
Seat 3: chaps1988 folded before Flop (didn't bet)
Seat 5: matiko09 folded before Flop (didn't bet)
Seat 6: ozone2003 folded before Flop (didn't bet)
Seat 8: R1aki (button) folded before Flop
Seat 9: flyer9898 (small blind) folded before Flop





PokerStars Hand #153068256218:  Hold'em No Limit ($0.50/$1.00 USD) - 2016/05/09 17:02:09 CET [2016/05/09 11:02:09 ET]
Table 'Eucharis' 9-max Seat #2 is the button
Seat 1: Spid1 ($108.32 in chips) 
Seat 2: Chef-Zizou ($75.32 in chips) 
Seat 3: kiyo94 ($72.93 in chips) 
Seat 4: matiko09 ($100 in chips) 
Seat 5: mycka86 ($100 in chips) 
Seat 6: Mukhin1 ($106.33 in chips) 
Seat 7: ThorSun ($70.45 in chips) 
Seat 8: Kukuryzka ($120.53 in chips) 
kiyo94: posts small blind $0.50
matiko09: posts big blind $1
*** HOLE CARDS ***
Dealt to matiko09 [Jd Kh]
mycka86: folds 
Mukhin1: raises $2.02 to $3.02
ThorSun: folds 
Kukuryzka: folds 
Spid1: folds 
Chef-Zizou: folds 
kiyo94: folds 
matiko09: folds 
Uncalled bet ($2.02) returned to Mukhin1
Mukhin1 collected $2.50 from pot
Mukhin1: doesn't show hand 
*** SUMMARY ***
Total pot $2.50 | Rake $0 
Seat 1: Spid1 folded before Flop (didn't bet)
Seat 2: Chef-Zizou (button) folded before Flop (didn't bet)
Seat 3: kiyo94 (small blind) folded before Flop
Seat 4: matiko09 (big blind) folded before Flop
Seat 5: mycka86 folded before Flop (didn't bet)
Seat 6: Mukhin1 collected ($2.50)
Seat 7: ThorSun folded before Flop (didn't bet)
Seat 8: Kukuryzka folded before Flop (didn't bet)





PokerStars Hand #153068258811:  Hold'em No Limit ($1/$2 USD) - 2016/05/09 17:02:12 CET [2016/05/09 11:02:12 ET]
Table 'Celaeno II' 9-max Seat #2 is the button
Seat 1: LRVAV7 ($208.25 in chips) 
Seat 2: PacPacBum ($422.59 in chips) 
Seat 3: CI58 ($200 in chips) 
Seat 4: matiko09 ($311.15 in chips) 
Seat 5: Monsthand ($221.16 in chips) 
Seat 6: Igoriah ($200 in chips) 
Seat 7: Mister_b44 ($125.94 in chips) 
Seat 8: chaps1988 ($231.31 in chips) 
Seat 9: Spid1 ($200 in chips) 
CI58: posts small blind $1
matiko09: posts big blind $2
*** HOLE CARDS ***
Dealt to matiko09 [Ks 2d]
Monsthand: folds 
Igoriah: raises $3 to $5
Mister_b44: folds 
chaps1988: folds 
Spid1: folds 
LRVAV7: folds 
PacPacBum: folds 
CI58: folds 
matiko09: folds 
Uncalled bet ($3) returned to Igoriah
Igoriah collected $5 from pot
Igoriah: doesn't show hand 
*** SUMMARY ***
Total pot $5 | Rake $0 
Seat 1: LRVAV7 folded before Flop (didn't bet)
Seat 2: PacPacBum (button) folded before Flop (didn't bet)
Seat 3: CI58 (small blind) folded before Flop
Seat 4: matiko09 (big blind) folded before Flop
Seat 5: Monsthand folded before Flop (didn't bet)
Seat 6: Igoriah collected ($5)
Seat 7: Mister_b44 folded before Flop (didn't bet)
Seat 8: chaps1988 folded before Flop (didn't bet)
Seat 9: Spid1 folded before Flop (didn't bet)





PokerStars Hand #153068261105:  Hold'em No Limit ($1/$2 USD) - 2016/05/09 17:02:17 CET [2016/05/09 11:02:17 ET]
Table 'Titan III' 9-max Seat #2 is the button
Seat 1: I The King I ($260.55 in chips) 
Seat 2: PacPacBum ($203 in chips) 
Seat 3: Spid1 ($434.95 in chips) 
Seat 5: Monsthand ($285.25 in chips) 
Seat 6: matiko09 ($203 in chips) 
Seat 7: seasar1 ($160.48 in chips) 
Seat 8: chaps1988 ($262.27 in chips) 
Seat 9: Sasuke777777 ($121.25 in chips) 
Spid1: posts small blind $1
Monsthand: posts big blind $2
*** HOLE CARDS ***
Dealt to matiko09 [Kh 7h]
matiko09: folds 
seasar1: folds 
chaps1988: raises $3 to $5
Sasuke777777: raises $5 to $10
I The King I: folds 
PacPacBum: folds 
Spid1: folds 
Monsthand: folds 
chaps1988: raises $15 to $25
Sasuke777777: calls $15
*** FLOP *** [6d Qh Qd]
chaps1988: bets $17.50
Sasuke777777: raises $18.50 to $36
chaps1988: folds 
Uncalled bet ($18.50) returned to Sasuke777777
Sasuke777777 collected $85.25 from pot
Sasuke777777: doesn't show hand 
*** SUMMARY ***
Total pot $88 | Rake $2.75 
Board [6d Qh Qd]
Seat 1: I The King I folded before Flop (didn't bet)
Seat 2: PacPacBum (button) folded before Flop (didn't bet)
Seat 3: Spid1 (small blind) folded before Flop
Seat 5: Monsthand (big blind) folded before Flop
Seat 6: matiko09 folded before Flop (didn't bet)
Seat 7: seasar1 folded before Flop (didn't bet)
Seat 8: chaps1988 folded on the Flop
Seat 9: Sasuke777777 collected ($85.25)





PokerStars Hand #153068264117:  Hold'em No Limit ($1/$2 USD) - 2016/05/09 17:02:22 CET [2016/05/09 11:02:22 ET]
Table 'Hagar II' 9-max Seat #4 is the button
Seat 1: mojitos86 ($186.23 in chips) 
Seat 2: darren1031 ($218.95 in chips) 
Seat 3: Sasuke777777 ($246.05 in chips) 
Seat 4: matiko09 ($437.49 in chips) 
Seat 5: PacPacBum ($200 in chips) 
Seat 6: el Fatto ($200 in chips) 
Seat 7: Monsthand ($207.03 in chips) 
Seat 9: chaps1988 ($228.64 in chips) 
PacPacBum: posts small blind $1
el Fatto: posts big blind $2
*** HOLE CARDS ***
Dealt to matiko09 [8d Ks]
Monsthand: folds 
chaps1988: folds 
mojitos86: folds 
darren1031: calls $2
Sasuke777777: raises $4 to $6
matiko09: folds 
PacPacBum: raises $14 to $20
el Fatto: folds 
darren1031: folds 
Sasuke777777: calls $14
*** FLOP *** [Jc 9c 7h]
PacPacBum: bets $22.57
Sasuke777777: calls $22.57
*** TURN *** [Jc 9c 7h] [4h]
PacPacBum: bets $46.65
Sasuke777777: calls $46.65
*** RIVER *** [Jc 9c 7h 4h] [2d]
PacPacBum: checks 
Sasuke777777: checks 
*** SHOW DOWN ***
PacPacBum: shows [Ad Jh] (a pair of Jacks)
Sasuke777777: mucks hand 
PacPacBum collected $179.69 from pot
*** SUMMARY ***
Total pot $182.44 | Rake $2.75 
Board [Jc 9c 7h 4h 2d]
Seat 1: mojitos86 folded before Flop (didn't bet)
Seat 2: darren1031 folded before Flop
Seat 3: Sasuke777777 mucked [Js Ts]
Seat 4: matiko09 (button) folded before Flop (didn't bet)
Seat 5: PacPacBum (small blind) showed [Ad Jh] and won ($179.69) with a pair of Jacks
Seat 6: el Fatto (big blind) folded before Flop
Seat 7: Monsthand folded before Flop (didn't bet)
Seat 9: chaps1988 folded before Flop (didn't bet)





PokerStars Hand #153068272592:  Hold'em No Limit ($0.50/$1.00 USD) - 2016/05/09 17:02:36 CET [2016/05/09 11:02:36 ET]
Table 'Buryatia II' 9-max Seat #1 is the button
Seat 1: flk.Dasas ($157.44 in chips) 
Seat 3: Desperategam ($100 in chips) 
Seat 4: maxxmeister ($100 in chips) 
Seat 5: amisasi ($93.10 in chips) 
Seat 6: I The King I ($100 in chips) 
Seat 8: matiko09 ($100 in chips) 
Seat 9: CI58 ($118.41 in chips) 
Desperategam: posts small blind $0.50
maxxmeister: posts big blind $1
*** HOLE CARDS ***
Dealt to matiko09 [9h 3s]
amisasi: folds 
I The King I: folds 
matiko09: folds 
CI58: folds 
flk.Dasas: raises $1.50 to $2.50
Desperategam: raises $6 to $8.50
maxxmeister: folds 
flk.Dasas: calls $6
*** FLOP *** [Qs 2h Qh]
Desperategam: bets $9
flk.Dasas: folds 
Uncalled bet ($9) returned to Desperategam
Desperategam collected $17.10 from pot
Desperategam: doesn't show hand 
*** SUMMARY ***
Total pot $18 | Rake $0.90 
Board [Qs 2h Qh]
Seat 1: flk.Dasas (button) folded on the Flop
Seat 3: Desperategam (small blind) collected ($17.10)
Seat 4: maxxmeister (big blind) folded before Flop
Seat 5: amisasi folded before Flop (didn't bet)
Seat 6: I The King I folded before Flop (didn't bet)
Seat 8: matiko09 folded before Flop (didn't bet)
Seat 9: CI58 folded before Flop (didn't bet)





PokerStars Hand #153068279331:  Hold'em No Limit ($0.50/$1.00 USD) - 2016/05/09 17:02:47 CET [2016/05/09 11:02:47 ET]
Table 'Reiss' 9-max Seat #9 is the button
Seat 1: Dickyxxx ($163.16 in chips) 
Seat 2: mycka86 ($192.35 in chips) 
Seat 3: chaps1988 ($121.37 in chips) 
Seat 5: matiko09 ($104.36 in chips) 
Seat 6: ozone2003 ($100.56 in chips) 
Seat 8: R1aki ($100 in chips) 
Seat 9: flyer9898 ($77 in chips) 
Dickyxxx: posts small blind $0.50
mycka86: posts big blind $1
CI58: sits out 
*** HOLE CARDS ***
Dealt to matiko09 [8h Jd]
chaps1988: folds 
matiko09: folds 
ozone2003: folds 
R1aki: raises $1.50 to $2.50
flyer9898: raises $2.50 to $5
Dickyxxx: folds 
mycka86: folds 
R1aki: calls $2.50
*** FLOP *** [Jc 4h 3d]
R1aki: checks 
flyer9898: bets $11
R1aki: folds 
Uncalled bet ($11) returned to flyer9898
flyer9898 collected $10.92 from pot
flyer9898: doesn't show hand 
*** SUMMARY ***
Total pot $11.50 | Rake $0.58 
Board [Jc 4h 3d]
Seat 1: Dickyxxx (small blind) folded before Flop
Seat 2: mycka86 (big blind) folded before Flop
Seat 3: chaps1988 folded before Flop (didn't bet)
Seat 5: matiko09 folded before Flop (didn't bet)
Seat 6: ozone2003 folded before Flop (didn't bet)
Seat 8: R1aki folded on the Flop
Seat 9: flyer9898 (button) collected ($10.92)





PokerStars Hand #153068282830:  Hold'em No Limit ($1/$2 USD) - 2016/05/09 17:02:53 CET [2016/05/09 11:02:53 ET]
Table 'Celaeno II' 9-max Seat #3 is the button
Seat 1: LRVAV7 ($208.25 in chips) 
Seat 2: PacPacBum ($422.59 in chips) 
Seat 3: CI58 ($200 in chips) 
Seat 4: matiko09 ($309.15 in chips) 
Seat 5: Monsthand ($221.16 in chips) 
Seat 6: Igoriah ($203 in chips) 
Seat 7: Mister_b44 ($125.94 in chips) 
Seat 8: chaps1988 ($231.31 in chips) 
Seat 9: Spid1 ($200 in chips) 
matiko09: posts small blind $1
Monsthand: posts big blind $2
*** HOLE CARDS ***
Dealt to matiko09 [9d 2h]
Igoriah: folds 
Mister_b44: raises $4 to $6
chaps1988: folds 
Spid1: folds 
LRVAV7: folds 
PacPacBum: folds 
CI58: folds 
matiko09: folds 
Monsthand: folds 
Uncalled bet ($4) returned to Mister_b44
Mister_b44 collected $5 from pot
Mister_b44: doesn't show hand 
*** SUMMARY ***
Total pot $5 | Rake $0 
Seat 1: LRVAV7 folded before Flop (didn't bet)
Seat 2: PacPacBum folded before Flop (didn't bet)
Seat 3: CI58 (button) folded before Flop (didn't bet)
Seat 4: matiko09 (small blind) folded before Flop
Seat 5: Monsthand (big blind) folded before Flop
Seat 6: Igoriah folded before Flop (didn't bet)
Seat 7: Mister_b44 collected ($5)
Seat 8: chaps1988 folded before Flop (didn't bet)
Seat 9: Spid1 folded before Flop (didn't bet)





PokerStars Hand #153068295561:  Hold'em No Limit ($0.50/$1.00 USD) - 2016/05/09 17:03:14 CET [2016/05/09 11:03:14 ET]
Table 'Orthos' 9-max Seat #8 is the button
Seat 1: Kelvin sai ($84.25 in chips) 
Seat 2: PacPacBum ($118.17 in chips) 
Seat 3: Filojoes ($100.61 in chips) 
Seat 5: matiko09 ($105.58 in chips) 
Seat 6: xhinostrabli ($100.33 in chips) 
Seat 7: flk.Dasas ($162.90 in chips) 
Seat 8: Dickyxxx ($100 in chips) 
Seat 9: mycka86 ($100 in chips) 
mycka86: posts small blind $0.50
Kelvin sai: posts big blind $1
*** HOLE CARDS ***
Dealt to matiko09 [3s Th]
PacPacBum: folds 
Filojoes: raises $2 to $3
matiko09: folds 
xhinostrabli: folds 
flk.Dasas: folds 
Dickyxxx: calls $3
mycka86: folds 
Kelvin sai: folds 
*** FLOP *** [4h 6h Kc]
Filojoes: checks 
Dickyxxx: bets $4.74
Filojoes: folds 
Uncalled bet ($4.74) returned to Dickyxxx
Dickyxxx collected $7.12 from pot
Dickyxxx: doesn't show hand 
*** SUMMARY ***
Total pot $7.50 | Rake $0.38 
Board [4h 6h Kc]
Seat 1: Kelvin sai (big blind) folded before Flop
Seat 2: PacPacBum folded before Flop (didn't bet)
Seat 3: Filojoes folded on the Flop
Seat 5: matiko09 folded before Flop (didn't bet)
Seat 6: xhinostrabli folded before Flop (didn't bet)
Seat 7: flk.Dasas folded before Flop (didn't bet)
Seat 8: Dickyxxx (button) collected ($7.12)
Seat 9: mycka86 (small blind) folded before Flop





PokerStars Hand #153068298893:  Hold'em No Limit ($1/$2 USD) - 2016/05/09 17:03:19 CET [2016/05/09 11:03:19 ET]
Table 'Celaeno II' 9-max Seat #4 is the button
Seat 1: LRVAV7 ($208.25 in chips) 
Seat 2: PacPacBum ($422.59 in chips) 
Seat 3: CI58 ($200 in chips) 
Seat 4: matiko09 ($308.15 in chips) 
Seat 5: Monsthand ($219.16 in chips) 
Seat 6: Igoriah ($203 in chips) 
Seat 7: Mister_b44 ($128.94 in chips) 
Seat 8: chaps1988 ($231.31 in chips) 
Seat 9: Spid1 ($200 in chips) 
Monsthand: posts small blind $1
Igoriah: posts big blind $2
*** HOLE CARDS ***
Dealt to matiko09 [Qh Ah]
Mister_b44: folds 
chaps1988: folds 
Spid1: folds 
LRVAV7: folds 
PacPacBum: folds 
CI58: folds 
matiko09: raises $2.54 to $4.54
Monsthand: folds 
Igoriah: calls $2.54
*** FLOP *** [2h 5d 9c]
Igoriah: checks 
matiko09: bets $4.98
Igoriah: raises $10.02 to $15
matiko09: folds 
Uncalled bet ($10.02) returned to Igoriah
Igoriah collected $19.04 from pot
Igoriah: doesn't show hand 
*** SUMMARY ***
Total pot $20.04 | Rake $1 
Board [2h 5d 9c]
Seat 1: LRVAV7 folded before Flop (didn't bet)
Seat 2: PacPacBum folded before Flop (didn't bet)
Seat 3: CI58 folded before Flop (didn't bet)
Seat 4: matiko09 (button) folded on the Flop
Seat 5: Monsthand (small blind) folded before Flop
Seat 6: Igoriah (big blind) collected ($19.04)
Seat 7: Mister_b44 folded before Flop (didn't bet)
Seat 8: chaps1988 folded before Flop (didn't bet)
Seat 9: Spid1 folded before Flop (didn't bet)





PokerStars Hand #153068303708:  Hold'em No Limit ($0.50/$1.00 USD) - 2016/05/09 17:03:27 CET [2016/05/09 11:03:27 ET]
Table 'Reiss' 9-max Seat #1 is the button
Seat 1: Dickyxxx ($162.66 in chips) 
Seat 2: mycka86 ($191.35 in chips) 
Seat 3: chaps1988 ($121.37 in chips) 
Seat 5: matiko09 ($104.36 in chips) 
Seat 6: ozone2003 ($100.56 in chips) 
Seat 8: R1aki ($100 in chips) 
Seat 9: flyer9898 ($82.92 in chips) 
mycka86: posts small blind $0.50
chaps1988: posts big blind $1
CI58: sits out 
*** HOLE CARDS ***
Dealt to matiko09 [6d 4d]
matiko09: folds 
ozone2003: folds 
R1aki: folds 
flyer9898: raises $2 to $3
Dickyxxx: folds 
mycka86: folds 
chaps1988: folds 
Uncalled bet ($2) returned to flyer9898
flyer9898 collected $2.50 from pot
flyer9898: doesn't show hand 
*** SUMMARY ***
Total pot $2.50 | Rake $0 
Seat 1: Dickyxxx (button) folded before Flop (didn't bet)
Seat 2: mycka86 (small blind) folded before Flop
Seat 3: chaps1988 (big blind) folded before Flop
Seat 5: matiko09 folded before Flop (didn't bet)
Seat 6: ozone2003 folded before Flop (didn't bet)
Seat 8: R1aki folded before Flop (didn't bet)
Seat 9: flyer9898 collected ($2.50)





PokerStars Hand #153068304021:  Hold'em No Limit ($1/$2 USD) - 2016/05/09 17:03:28 CET [2016/05/09 11:03:28 ET]
Table 'Titan III' 9-max Seat #3 is the button
Seat 1: I The King I ($260.55 in chips) 
Seat 2: PacPacBum ($203 in chips) 
Seat 3: Spid1 ($433.95 in chips) 
Seat 5: Monsthand ($283.25 in chips) 
Seat 6: matiko09 ($203 in chips) 
Seat 7: seasar1 ($160.48 in chips) 
Seat 8: chaps1988 ($219.77 in chips) 
Seat 9: Sasuke777777 ($164 in chips) 
Monsthand: posts small blind $1
matiko09: posts big blind $2
*** HOLE CARDS ***
Dealt to matiko09 [6s Tc]
seasar1: folds 
chaps1988: folds 
Sasuke777777: folds 
I The King I: raises $4 to $6
PacPacBum: calls $6
Spid1: calls $6
Monsthand: folds 
matiko09: folds 
*** FLOP *** [Qh 3d 5s]
I The King I: bets $10
PacPacBum: folds 
Spid1: calls $10
*** TURN *** [Qh 3d 5s] [Ts]
I The King I: checks 
Spid1: checks 
*** RIVER *** [Qh 3d 5s Ts] [Kc]
I The King I: checks 
Spid1: checks 
*** SHOW DOWN ***
I The King I: shows [As Ad] (a pair of Aces)
Spid1: mucks hand 
I The King I collected $38.95 from pot
*** SUMMARY ***
Total pot $41 | Rake $2.05 
Board [Qh 3d 5s Ts Kc]
Seat 1: I The King I showed [As Ad] and won ($38.95) with a pair of Aces
Seat 2: PacPacBum folded on the Flop
Seat 3: Spid1 (button) mucked [Jc Js]
Seat 5: Monsthand (small blind) folded before Flop
Seat 6: matiko09 (big blind) folded before Flop
Seat 7: seasar1 folded before Flop (didn't bet)
Seat 8: chaps1988 folded before Flop (didn't bet)
Seat 9: Sasuke777777 folded before Flop (didn't bet)





PokerStars Hand #153068311568:  Hold'em No Limit ($0.50/$1.00 USD) - 2016/05/09 17:03:40 CET [2016/05/09 11:03:40 ET]
Table 'Eucharis' 9-max Seat #3 is the button
Seat 1: Spid1 ($108.32 in chips) 
Seat 2: Chef-Zizou ($75.32 in chips) 
Seat 3: kiyo94 ($72.43 in chips) 
Seat 4: matiko09 ($100 in chips) 
Seat 5: mycka86 ($100 in chips) 
Seat 6: Mukhin1 ($107.83 in chips) 
Seat 7: ThorSun ($70.45 in chips) 
Seat 8: Kukuryzka ($120.53 in chips) 
matiko09: posts small blind $0.50
mycka86: posts big blind $1
*** HOLE CARDS ***
Dealt to matiko09 [2c Js]
Mukhin1: folds 
ThorSun: folds 
Kukuryzka: folds 
Spid1: folds 
Chef-Zizou: raises $1 to $2
kiyo94 has timed out
kiyo94: folds 
matiko09: folds 
mycka86: calls $1
*** FLOP *** [8s 8d Jh]
mycka86: checks 
Chef-Zizou: checks 
*** TURN *** [8s 8d Jh] [Qs]
mycka86: checks 
Chef-Zizou: bets $3
mycka86: folds 
Uncalled bet ($3) returned to Chef-Zizou
Chef-Zizou collected $4.28 from pot
*** SUMMARY ***
Total pot $4.50 | Rake $0.22 
Board [8s 8d Jh Qs]
Seat 1: Spid1 folded before Flop (didn't bet)
Seat 2: Chef-Zizou collected ($4.28)
Seat 3: kiyo94 (button) folded before Flop (didn't bet)
Seat 4: matiko09 (small blind) folded before Flop
Seat 5: mycka86 (big blind) folded on the Turn
Seat 6: Mukhin1 folded before Flop (didn't bet)
Seat 7: ThorSun folded before Flop (didn't bet)
Seat 8: Kukuryzka folded before Flop (didn't bet)





PokerStars Hand #153068317167:  Hold'em No Limit ($0.50/$1.00 USD) - 2016/05/09 17:03:49 CET [2016/05/09 11:03:49 ET]
Table 'Buryatia II' 9-max Seat #3 is the button
Seat 1: flk.Dasas ($148.94 in chips) 
Seat 3: Desperategam ($108.60 in chips) 
Seat 4: maxxmeister ($100 in chips) 
Seat 5: amisasi ($93.10 in chips) 
Seat 6: I The King I ($100 in chips) 
Seat 8: matiko09 ($100 in chips) 
Seat 9: CI58 ($118.41 in chips) 
maxxmeister: posts small blind $0.50
amisasi: posts big blind $1
*** HOLE CARDS ***
Dealt to matiko09 [6h 3d]
I The King I: folds 
matiko09: folds 
CI58: folds 
flk.Dasas: folds 
Desperategam: raises $2 to $3
maxxmeister: folds 
amisasi: folds 
Uncalled bet ($2) returned to Desperategam
Desperategam collected $2.50 from pot
*** SUMMARY ***
Total pot $2.50 | Rake $0 
Seat 1: flk.Dasas folded before Flop (didn't bet)
Seat 3: Desperategam (button) collected ($2.50)
Seat 4: maxxmeister (small blind) folded before Flop
Seat 5: amisasi (big blind) folded before Flop
Seat 6: I The King I folded before Flop (didn't bet)
Seat 8: matiko09 folded before Flop (didn't bet)
Seat 9: CI58 folded before Flop (didn't bet)





PokerStars Hand #153068323874:  Hold'em No Limit ($0.50/$1.00 USD) - 2016/05/09 17:04:00 CET [2016/05/09 11:04:00 ET]
Table 'Reiss' 9-max Seat #2 is the button
Seat 1: Dickyxxx ($162.66 in chips) 
Seat 2: mycka86 ($190.85 in chips) 
Seat 3: chaps1988 ($120.37 in chips) 
Seat 4: CI58 ($100 in chips) 
Seat 5: matiko09 ($104.36 in chips) 
Seat 6: ozone2003 ($100.56 in chips) 
Seat 8: R1aki ($100 in chips) 
Seat 9: flyer9898 ($84.42 in chips) 
chaps1988: posts small blind $0.50
CI58: posts big blind $1
*** HOLE CARDS ***
Dealt to matiko09 [3h Ad]
matiko09: folds 
ozone2003: folds 
R1aki: raises $1.50 to $2.50
flyer9898: folds 
Dickyxxx: folds 
mycka86: folds 
chaps1988: calls $2
CI58: folds 
*** FLOP *** [8h 3d Tc]
chaps1988: checks 
R1aki: bets $3.50
chaps1988: folds 
Uncalled bet ($3.50) returned to R1aki
R1aki collected $5.70 from pot
R1aki: doesn't show hand 
*** SUMMARY ***
Total pot $6 | Rake $0.30 
Board [8h 3d Tc]
Seat 1: Dickyxxx folded before Flop (didn't bet)
Seat 2: mycka86 (button) folded before Flop (didn't bet)
Seat 3: chaps1988 (small blind) folded on the Flop
Seat 4: CI58 (big blind) folded before Flop
Seat 5: matiko09 folded before Flop (didn't bet)
Seat 6: ozone2003 folded before Flop (didn't bet)
Seat 8: R1aki collected ($5.70)
Seat 9: flyer9898 folded before Flop (didn't bet)





PokerStars Hand #153068328823:  Hold'em No Limit ($0.50/$1.00 USD) - 2016/05/09 17:04:08 CET [2016/05/09 11:04:08 ET]
Table 'Orthos' 9-max Seat #9 is the button
Seat 1: Kelvin sai ($83.25 in chips) 
Seat 2: PacPacBum ($118.17 in chips) 
Seat 3: Filojoes ($100 in chips) 
Seat 5: matiko09 ($105.58 in chips) 
Seat 6: xhinostrabli ($100.33 in chips) 
Seat 7: flk.Dasas ($162.90 in chips) 
Seat 8: Dickyxxx ($104.12 in chips) 
Seat 9: mycka86 ($100 in chips) 
Kelvin sai: posts small blind $0.50
PacPacBum: posts big blind $1
*** HOLE CARDS ***
Dealt to matiko09 [Qd 8d]
Filojoes: folds 
matiko09: folds 
xhinostrabli: folds 
flk.Dasas: folds 
Dickyxxx: raises $2 to $3
mycka86: folds 
Kelvin sai: calls $2.50
PacPacBum: calls $2
*** FLOP *** [7s 2s 8c]
Kelvin sai: checks 
PacPacBum: checks 
Dickyxxx: bets $5.69
Kelvin sai: folds 
PacPacBum: folds 
Uncalled bet ($5.69) returned to Dickyxxx
Dickyxxx collected $8.55 from pot
Dickyxxx: doesn't show hand 
*** SUMMARY ***
Total pot $9 | Rake $0.45 
Board [7s 2s 8c]
Seat 1: Kelvin sai (small blind) folded on the Flop
Seat 2: PacPacBum (big blind) folded on the Flop
Seat 3: Filojoes folded before Flop (didn't bet)
Seat 5: matiko09 folded before Flop (didn't bet)
Seat 6: xhinostrabli folded before Flop (didn't bet)
Seat 7: flk.Dasas folded before Flop (didn't bet)
Seat 8: Dickyxxx collected ($8.55)
Seat 9: mycka86 (button) folded before Flop (didn't bet)





PokerStars Hand #153068331349:  Hold'em No Limit ($0.50/$1.00 USD) - 2016/05/09 17:04:12 CET [2016/05/09 11:04:12 ET]
Table 'Terpsichore' 9-max Seat #8 is the button
Seat 1: ipashutapkom ($193.87 in chips) 
Seat 2: CI58 ($103.56 in chips) 
Seat 3: matiko09 ($120.89 in chips) 
Seat 5: mycka86 ($241.86 in chips) 
Seat 6: Filojoes ($100 in chips) 
Seat 7: ozone2003 ($103.75 in chips) 
Seat 8: Kiosk230472 ($126.70 in chips) 
Seat 9: FTPbannedMe ($100 in chips) 
FTPbannedMe: posts small blind $0.50
ipashutapkom: posts big blind $1
*** HOLE CARDS ***
Dealt to matiko09 [8h 6s]
CI58: raises $2 to $3
matiko09: folds 
mycka86: folds 
Filojoes: calls $3
ozone2003: calls $3
Kiosk230472: folds 
FTPbannedMe: folds 
ipashutapkom: folds 
*** FLOP *** [Jd 9h Qd]
CI58: bets $5.98
Filojoes: folds 
ozone2003: calls $5.98
*** TURN *** [Jd 9h Qd] [2h]
CI58: bets $12.80
ozone2003: calls $12.80
*** RIVER *** [Jd 9h Qd 2h] [Qc]
CI58: checks 
ozone2003: checks 
*** SHOW DOWN ***
CI58: shows [Kc Kh] (two pair, Kings and Queens)
ozone2003: shows [Qh Ah] (three of a kind, Queens)
ozone2003 collected $45.66 from pot
*** SUMMARY ***
Total pot $48.06 | Rake $2.40 
Board [Jd 9h Qd 2h Qc]
Seat 1: ipashutapkom (big blind) folded before Flop
Seat 2: CI58 showed [Kc Kh] and lost with two pair, Kings and Queens
Seat 3: matiko09 folded before Flop (didn't bet)
Seat 5: mycka86 folded before Flop (didn't bet)
Seat 6: Filojoes folded on the Flop
Seat 7: ozone2003 showed [Qh Ah] and won ($45.66) with three of a kind, Queens
Seat 8: Kiosk230472 (button) folded before Flop (didn't bet)
Seat 9: FTPbannedMe (small blind) folded before Flop





PokerStars Hand #153068335544:  Hold'em No Limit ($0.50/$1.00 USD) - 2016/05/09 17:04:19 CET [2016/05/09 11:04:19 ET]
Table 'Buryatia II' 9-max Seat #4 is the button
Seat 1: flk.Dasas ($148.94 in chips) 
Seat 3: Desperategam ($110.10 in chips) 
Seat 4: maxxmeister ($100 in chips) 
Seat 5: amisasi ($92.10 in chips) 
Seat 6: I The King I ($100 in chips) 
Seat 8: matiko09 ($100 in chips) 
Seat 9: CI58 ($118.41 in chips) 
amisasi: posts small blind $0.50
I The King I: posts big blind $1
*** HOLE CARDS ***
Dealt to matiko09 [Kc 2d]
matiko09: folds 
CI58: folds 
flk.Dasas: folds 
Desperategam: raises $2 to $3
maxxmeister: folds 
amisasi: folds 
I The King I: folds 
Uncalled bet ($2) returned to Desperategam
Desperategam collected $2.50 from pot
Desperategam: doesn't show hand 
*** SUMMARY ***
Total pot $2.50 | Rake $0 
Seat 1: flk.Dasas folded before Flop (didn't bet)
Seat 3: Desperategam collected ($2.50)
Seat 4: maxxmeister (button) folded before Flop (didn't bet)
Seat 5: amisasi (small blind) folded before Flop
Seat 6: I The King I (big blind) folded before Flop
Seat 8: matiko09 folded before Flop (didn't bet)
Seat 9: CI58 folded before Flop (didn't bet)





PokerStars Hand #153068337047:  Hold'em No Limit ($1/$2 USD) - 2016/05/09 17:04:22 CET [2016/05/09 11:04:22 ET]
Table 'Hagar II' 9-max Seat #5 is the button
Seat 1: mojitos86 ($186.23 in chips) 
Seat 2: darren1031 ($216.95 in chips) 
Seat 3: Sasuke777777 ($156.83 in chips) 
Seat 4: matiko09 ($437.49 in chips) 
Seat 5: PacPacBum ($290.47 in chips) 
Seat 6: el Fatto ($200 in chips) 
Seat 7: Monsthand ($207.03 in chips) 
Seat 9: chaps1988 ($228.64 in chips) 
el Fatto: posts small blind $1
Monsthand: posts big blind $2
*** HOLE CARDS ***
Dealt to matiko09 [4c Ts]
chaps1988: folds 
mojitos86: folds 
darren1031: folds 
Sasuke777777: folds 
Sasuke777777 said, "nh"
matiko09: folds 
PacPacBum: folds 
PacPacBum said, "thx"
el Fatto: calls $1
Monsthand: raises $5 to $7
el Fatto: raises $14 to $21
Monsthand: folds 
Uncalled bet ($14) returned to el Fatto
el Fatto collected $14 from pot
el Fatto: doesn't show hand 
*** SUMMARY ***
Total pot $14 | Rake $0 
Seat 1: mojitos86 folded before Flop (didn't bet)
Seat 2: darren1031 folded before Flop (didn't bet)
Seat 3: Sasuke777777 folded before Flop (didn't bet)
Seat 4: matiko09 folded before Flop (didn't bet)
Seat 5: PacPacBum (button) folded before Flop (didn't bet)
Seat 6: el Fatto (small blind) collected ($14)
Seat 7: Monsthand (big blind) folded before Flop
Seat 9: chaps1988 folded before Flop (didn't bet)





PokerStars Hand #153068342883:  Hold'em No Limit ($1/$2 USD) - 2016/05/09 17:04:31 CET [2016/05/09 11:04:31 ET]
Table 'Celaeno II' 9-max Seat #5 is the button
Seat 1: LRVAV7 ($208.25 in chips) 
Seat 2: PacPacBum ($422.59 in chips) 
Seat 3: CI58 ($200 in chips) 
Seat 4: matiko09 ($298.63 in chips) 
Seat 5: Monsthand ($218.16 in chips) 
Seat 6: Igoriah ($212.52 in chips) 
Seat 7: Mister_b44 ($128.94 in chips) 
Seat 8: chaps1988 ($231.31 in chips) 
Seat 9: Spid1 ($200 in chips) 
Igoriah: posts small blind $1
Mister_b44: posts big blind $2
*** HOLE CARDS ***
Dealt to matiko09 [2c Ah]
chaps1988: folds 
Spid1: folds 
LRVAV7: folds 
PacPacBum: folds 
CI58: folds 
matiko09: folds 
Monsthand: raises $3 to $5
Igoriah: folds 
Mister_b44: calls $3
*** FLOP *** [Th 6h Jd]
Mister_b44: checks 
Monsthand: checks 
*** TURN *** [Th 6h Jd] [Kh]
Mister_b44: checks 
Monsthand: bets $6.79
Mister_b44: folds 
Uncalled bet ($6.79) returned to Monsthand
Monsthand collected $10.45 from pot
Monsthand: doesn't show hand 
*** SUMMARY ***
Total pot $11 | Rake $0.55 
Board [Th 6h Jd Kh]
Seat 1: LRVAV7 folded before Flop (didn't bet)
Seat 2: PacPacBum folded before Flop (didn't bet)
Seat 3: CI58 folded before Flop (didn't bet)
Seat 4: matiko09 folded before Flop (didn't bet)
Seat 5: Monsthand (button) collected ($10.45)
Seat 6: Igoriah (small blind) folded before Flop
Seat 7: Mister_b44 (big blind) folded on the Turn
Seat 8: chaps1988 folded before Flop (didn't bet)
Seat 9: Spid1 folded before Flop (didn't bet)





PokerStars Hand #153068344887:  Hold'em No Limit ($1/$2 USD) - 2016/05/09 17:04:35 CET [2016/05/09 11:04:35 ET]
Table 'Titan III' 9-max Seat #5 is the button
Seat 1: I The King I ($283.50 in chips) 
Seat 2: PacPacBum ($200 in chips) 
Seat 3: Spid1 ($417.95 in chips) 
Seat 5: Monsthand ($282.25 in chips) 
Seat 6: matiko09 ($201 in chips) 
Seat 7: seasar1 ($160.48 in chips) 
Seat 8: chaps1988 ($219.77 in chips) 
Seat 9: Sasuke777777 ($164 in chips) 
matiko09: posts small blind $1
seasar1: posts big blind $2
*** HOLE CARDS ***
Dealt to matiko09 [6s Js]
chaps1988: folds 
Sasuke777777: raises $4 to $6
I The King I: folds 
PacPacBum: calls $6
Spid1: folds 
Monsthand: folds 
matiko09: folds 
seasar1: calls $4
*** FLOP *** [4c Ad Jc]
seasar1: checks 
Sasuke777777: checks 
PacPacBum: checks 
*** TURN *** [4c Ad Jc] [3s]
seasar1: checks 
Sasuke777777: checks 
PacPacBum: checks 
*** RIVER *** [4c Ad Jc 3s] [7s]
seasar1: checks 
Sasuke777777: bets $18.05
PacPacBum: folds 
seasar1: folds 
Uncalled bet ($18.05) returned to Sasuke777777
Sasuke777777 collected $18.05 from pot
Sasuke777777: doesn't show hand 
*** SUMMARY ***
Total pot $19 | Rake $0.95 
Board [4c Ad Jc 3s 7s]
Seat 1: I The King I folded before Flop (didn't bet)
Seat 2: PacPacBum folded on the River
Seat 3: Spid1 folded before Flop (didn't bet)
Seat 5: Monsthand (button) folded before Flop (didn't bet)
Seat 6: matiko09 (small blind) folded before Flop
Seat 7: seasar1 (big blind) folded on the River
Seat 8: chaps1988 folded before Flop (didn't bet)
Seat 9: Sasuke777777 collected ($18.05)





PokerStars Hand #153068353521:  Hold'em No Limit ($0.50/$1.00 USD) - 2016/05/09 17:04:49 CET [2016/05/09 11:04:49 ET]
Table 'Buryatia II' 9-max Seat #5 is the button
Seat 1: flk.Dasas ($148.94 in chips) 
Seat 3: Desperategam ($111.60 in chips) 
Seat 4: maxxmeister ($100 in chips) 
Seat 5: amisasi ($91.60 in chips) 
Seat 6: I The King I ($100 in chips) 
Seat 8: matiko09 ($100 in chips) 
Seat 9: CI58 ($118.41 in chips) 
I The King I: posts small blind $0.50
matiko09: posts big blind $1
*** HOLE CARDS ***
Dealt to matiko09 [Qs Qd]
CI58: folds 
flk.Dasas: folds 
Desperategam: raises $2 to $3
maxxmeister: folds 
amisasi: folds 
I The King I: folds 
matiko09: raises $7 to $10
Desperategam: calls $7
*** FLOP *** [7s Qh 8c]
matiko09: checks 
Desperategam: checks 
*** TURN *** [7s Qh 8c] [Ts]
matiko09: checks 
Desperategam: bets $19
matiko09: calls $19
*** RIVER *** [7s Qh 8c Ts] [9h]
matiko09: checks 
Desperategam: checks 
*** SHOW DOWN ***
matiko09: shows [Qs Qd] (three of a kind, Queens)
Desperategam: mucks hand 
matiko09 collected $56 from pot
*** SUMMARY ***
Total pot $58.50 | Rake $2.50 
Board [7s Qh 8c Ts 9h]
Seat 1: flk.Dasas folded before Flop (didn't bet)
Seat 3: Desperategam mucked [7h 3h]
Seat 4: maxxmeister folded before Flop (didn't bet)
Seat 5: amisasi (button) folded before Flop (didn't bet)
Seat 6: I The King I (small blind) folded before Flop
Seat 8: matiko09 (big blind) showed [Qs Qd] and won ($56) with three of a kind, Queens
Seat 9: CI58 folded before Flop (didn't bet)





PokerStars Hand #153068356188:  Hold'em No Limit ($0.50/$1.00 USD) - 2016/05/09 17:04:53 CET [2016/05/09 11:04:53 ET]
Table 'Reiss' 9-max Seat #3 is the button
Seat 1: Dickyxxx ($162.66 in chips) 
Seat 2: mycka86 ($190.85 in chips) 
Seat 3: chaps1988 ($117.87 in chips) 
Seat 4: CI58 ($100 in chips) 
Seat 5: matiko09 ($104.36 in chips) 
Seat 6: ozone2003 ($100.56 in chips) 
Seat 8: R1aki ($103.20 in chips) 
Seat 9: flyer9898 ($84.42 in chips) 
CI58: posts small blind $0.50
matiko09: posts big blind $1
*** HOLE CARDS ***
Dealt to matiko09 [Kh 4h]
ozone2003: folds 
ozone2003 leaves the table
Donetsk1y joins the table at seat #6 
Donetsk1y leaves the table
R1aki: folds 
flyer9898: folds 
Dickyxxx: folds 
mycka86: raises $1.10 to $2.10
chaps1988: folds 
HITYESCA joins the table at seat #6 
CI58: raises $5.90 to $8
matiko09: folds 
mycka86: folds 
Uncalled bet ($5.90) returned to CI58
CI58 collected $5.20 from pot
CI58: doesn't show hand 
*** SUMMARY ***
Total pot $5.20 | Rake $0 
Seat 1: Dickyxxx folded before Flop (didn't bet)
Seat 2: mycka86 folded before Flop
Seat 3: chaps1988 (button) folded before Flop (didn't bet)
Seat 4: CI58 (small blind) collected ($5.20)
Seat 5: matiko09 (big blind) folded before Flop
Seat 6: ozone2003 folded before Flop (didn't bet)
Seat 8: R1aki folded before Flop (didn't bet)
Seat 9: flyer9898 folded before Flop (didn't bet)





PokerStars Hand #153068364523:  Hold'em No Limit ($0.50/$1.00 USD) - 2016/05/09 17:05:07 CET [2016/05/09 11:05:07 ET]
Table 'Eucharis' 9-max Seat #4 is the button
Seat 1: Spid1 ($108.32 in chips) 
Seat 2: Chef-Zizou ($77.60 in chips) 
Seat 3: kiyo94 ($72.43 in chips) 
Seat 4: matiko09 ($100 in chips) 
Seat 5: mycka86 ($100 in chips) 
Seat 6: Mukhin1 ($107.83 in chips) 
Seat 7: ThorSun ($70.45 in chips) 
Seat 8: Kukuryzka ($120.53 in chips) 
mycka86: posts small blind $0.50
Mukhin1: posts big blind $1
*** HOLE CARDS ***
Dealt to matiko09 [As Qc]
ThorSun: folds 
Kukuryzka: folds 
Spid1: folds 
Chef-Zizou: folds 
kiyo94: calls $1
matiko09: raises $2 to $3
mycka86: folds 
Mukhin1: raises $7 to $10
kiyo94: folds 
matiko09: calls $7
*** FLOP *** [5d 7d 4h]
Mukhin1: bets $9.94
matiko09: folds 
Uncalled bet ($9.94) returned to Mukhin1
Mukhin1 collected $20.42 from pot
Mukhin1: doesn't show hand 
*** SUMMARY ***
Total pot $21.50 | Rake $1.08 
Board [5d 7d 4h]
Seat 1: Spid1 folded before Flop (didn't bet)
Seat 2: Chef-Zizou folded before Flop (didn't bet)
Seat 3: kiyo94 folded before Flop
Seat 4: matiko09 (button) folded on the Flop
Seat 5: mycka86 (small blind) folded before Flop
Seat 6: Mukhin1 (big blind) collected ($20.42)
Seat 7: ThorSun folded before Flop (didn't bet)
Seat 8: Kukuryzka folded before Flop (didn't bet)





PokerStars Hand #153068368131:  Hold'em No Limit ($0.50/$1.00 USD) - 2016/05/09 17:05:13 CET [2016/05/09 11:05:13 ET]
Table 'Orthos' 9-max Seat #1 is the button
Seat 1: Kelvin sai ($80.25 in chips) 
Seat 2: PacPacBum ($115.17 in chips) 
Seat 3: Filojoes ($100 in chips) 
Seat 5: matiko09 ($105.58 in chips) 
Seat 6: xhinostrabli ($100.33 in chips) 
Seat 7: flk.Dasas ($162.90 in chips) 
Seat 8: Dickyxxx ($109.67 in chips) 
Seat 9: mycka86 ($100 in chips) 
PacPacBum: posts small blind $0.50
Filojoes: posts big blind $1
*** HOLE CARDS ***
Dealt to matiko09 [Jd 2s]
matiko09: folds 
xhinostrabli: raises $1 to $2
flk.Dasas: folds 
Dickyxxx: folds 
mycka86: raises $7 to $9
Kelvin sai: folds 
PacPacBum: folds 
Filojoes: folds 
xhinostrabli: folds 
Uncalled bet ($7) returned to mycka86
mycka86 collected $5.50 from pot
*** SUMMARY ***
Total pot $5.50 | Rake $0 
Seat 1: Kelvin sai (button) folded before Flop (didn't bet)
Seat 2: PacPacBum (small blind) folded before Flop
Seat 3: Filojoes (big blind) folded before Flop
Seat 5: matiko09 folded before Flop (didn't bet)
Seat 6: xhinostrabli folded before Flop
Seat 7: flk.Dasas folded before Flop (didn't bet)
Seat 8: Dickyxxx folded before Flop (didn't bet)
Seat 9: mycka86 collected ($5.50)





PokerStars Hand #153068374552:  Hold'em No Limit ($1/$2 USD) - 2016/05/09 17:05:23 CET [2016/05/09 11:05:23 ET]
Table 'Hagar II' 9-max Seat #6 is the button
Seat 1: mojitos86 ($186.23 in chips) 
Seat 2: darren1031 ($216.95 in chips) 
Seat 3: Sasuke777777 ($156.83 in chips) 
Seat 4: matiko09 ($437.49 in chips) 
Seat 5: PacPacBum ($290.47 in chips) 
Seat 6: el Fatto ($207 in chips) 
Seat 7: Monsthand ($200.03 in chips) 
Seat 9: chaps1988 ($228.64 in chips) 
Monsthand: posts small blind $1
chaps1988: posts big blind $2
*** HOLE CARDS ***
Dealt to matiko09 [6c 5s]
mojitos86: folds 
darren1031: folds 
Sasuke777777 has timed out
Sasuke777777: folds 
matiko09: folds 
PacPacBum: folds 
el Fatto: folds 
Monsthand: raises $4 to $6
chaps1988: calls $4
*** FLOP *** [3c Qh 3h]
Monsthand: checks 
chaps1988: checks 
*** TURN *** [3c Qh 3h] [7h]
Monsthand: bets $7.06
chaps1988: calls $7.06
*** RIVER *** [3c Qh 3h 7h] [3s]
Monsthand: checks 
chaps1988: checks 
*** SHOW DOWN ***
Monsthand: shows [8c Ad] (three of a kind, Threes)
chaps1988: shows [7s 8h] (a full house, Threes full of Sevens)
chaps1988 collected $24.81 from pot
*** SUMMARY ***
Total pot $26.12 | Rake $1.31 
Board [3c Qh 3h 7h 3s]
Seat 1: mojitos86 folded before Flop (didn't bet)
Seat 2: darren1031 folded before Flop (didn't bet)
Seat 3: Sasuke777777 folded before Flop (didn't bet)
Seat 4: matiko09 folded before Flop (didn't bet)
Seat 5: PacPacBum folded before Flop (didn't bet)
Seat 6: el Fatto (button) folded before Flop (didn't bet)
Seat 7: Monsthand (small blind) showed [8c Ad] and lost with three of a kind, Threes
Seat 9: chaps1988 (big blind) showed [7s 8h] and won ($24.81) with a full house, Threes full of Sevens





PokerStars Hand #153068384990:  Hold'em No Limit ($0.50/$1.00 USD) - 2016/05/09 17:05:40 CET [2016/05/09 11:05:40 ET]
Table 'Terpsichore' 9-max Seat #9 is the button
Seat 1: ipashutapkom ($192.87 in chips) 
Seat 2: CI58 ($100 in chips) 
Seat 3: matiko09 ($120.89 in chips) 
Seat 5: mycka86 ($241.86 in chips) 
Seat 6: Filojoes ($100 in chips) 
Seat 7: ozone2003 ($127.63 in chips) 
Seat 8: Kiosk230472 ($126.70 in chips) 
Seat 9: FTPbannedMe ($100 in chips) 
ipashutapkom: posts small blind $0.50
CI58: posts big blind $1
*** HOLE CARDS ***
Dealt to matiko09 [2s Kd]
matiko09: folds 
mycka86: folds 
Filojoes: folds 
ozone2003: folds 
Kiosk230472: raises $5 to $6
FTPbannedMe: raises $12 to $18
ipashutapkom: folds 
CI58: folds 
Kiosk230472: folds 
Uncalled bet ($12) returned to FTPbannedMe
FTPbannedMe collected $13.50 from pot
FTPbannedMe: doesn't show hand 
*** SUMMARY ***
Total pot $13.50 | Rake $0 
Seat 1: ipashutapkom (small blind) folded before Flop
Seat 2: CI58 (big blind) folded before Flop
Seat 3: matiko09 folded before Flop (didn't bet)
Seat 5: mycka86 folded before Flop (didn't bet)
Seat 6: Filojoes folded before Flop (didn't bet)
Seat 7: ozone2003 folded before Flop (didn't bet)
Seat 8: Kiosk230472 folded before Flop
Seat 9: FTPbannedMe (button) collected ($13.50)





PokerStars Hand #153068388313:  Hold'em No Limit ($0.50/$1.00 USD) - 2016/05/09 17:05:46 CET [2016/05/09 11:05:46 ET]
Table 'Reiss' 9-max Seat #4 is the button
Seat 1: Dickyxxx ($162.66 in chips) 
Seat 2: mycka86 ($188.75 in chips) 
Seat 3: chaps1988 ($117.87 in chips) 
Seat 4: CI58 ($103.10 in chips) 
Seat 5: matiko09 ($103.36 in chips) 
Seat 6: HITYESCA ($100 in chips) 
Seat 8: R1aki ($103.20 in chips) 
Seat 9: flyer9898 ($84.42 in chips) 
matiko09: posts small blind $0.50
HITYESCA: posts big blind $1
*** HOLE CARDS ***
Dealt to matiko09 [As Jh]
R1aki: folds 
R1aki leaves the table
flyer9898: folds 
Dickyxxx: folds 
mycka86: folds 
chaps1988: folds 
CI58: folds 
matiko09: raises $1.50 to $2.50
HITYESCA: calls $1.50
*** FLOP *** [3d 7c 2d]
matiko09: bets $3.09
rusher_NiNja joins the table at seat #8 
HITYESCA: calls $3.09
*** TURN *** [3d 7c 2d] [6s]
matiko09: checks 
HITYESCA: checks 
*** RIVER *** [3d 7c 2d 6s] [Ac]
matiko09: bets $6
HITYESCA: calls $6
*** SHOW DOWN ***
matiko09: shows [As Jh] (a pair of Aces)
HITYESCA: mucks hand 
matiko09 collected $22.02 from pot
*** SUMMARY ***
Total pot $23.18 | Rake $1.16 
Board [3d 7c 2d 6s Ac]
Seat 1: Dickyxxx folded before Flop (didn't bet)
Seat 2: mycka86 folded before Flop (didn't bet)
Seat 3: chaps1988 folded before Flop (didn't bet)
Seat 4: CI58 (button) folded before Flop (didn't bet)
Seat 5: matiko09 (small blind) showed [As Jh] and won ($22.02) with a pair of Aces
Seat 6: HITYESCA (big blind) mucked [4h 7d]
Seat 8: R1aki folded before Flop (didn't bet)
Seat 9: flyer9898 folded before Flop (didn't bet)





PokerStars Hand #153068389017:  Hold'em No Limit ($1/$2 USD) - 2016/05/09 17:05:47 CET [2016/05/09 11:05:47 ET]
Table 'Celaeno II' 9-max Seat #6 is the button
Seat 1: LRVAV7 ($208.25 in chips) 
Seat 2: PacPacBum ($422.59 in chips) 
Seat 3: CI58 ($200 in chips) 
Seat 4: matiko09 ($298.63 in chips) 
Seat 5: Monsthand ($223.61 in chips) 
Seat 6: Igoriah ($211.52 in chips) 
Seat 7: Mister_b44 ($123.94 in chips) 
Seat 8: chaps1988 ($231.31 in chips) 
Seat 9: Spid1 ($200 in chips) 
Mister_b44: posts small blind $1
chaps1988: posts big blind $2
*** HOLE CARDS ***
Dealt to matiko09 [2d 5s]
Spid1: folds 
LRVAV7: raises $3 to $5
PacPacBum: folds 
CI58: folds 
matiko09: folds 
Monsthand: folds 
Igoriah: folds 
Mister_b44: calls $4
chaps1988: folds 
*** FLOP *** [Qc Qd 2s]
Mister_b44: checks 
LRVAV7: checks 
*** TURN *** [Qc Qd 2s] [Ts]
Mister_b44: checks 
LRVAV7: bets $11.40
Mister_b44: folds 
Uncalled bet ($11.40) returned to LRVAV7
LRVAV7 collected $11.40 from pot
LRVAV7: doesn't show hand 
*** SUMMARY ***
Total pot $12 | Rake $0.60 
Board [Qc Qd 2s Ts]
Seat 1: LRVAV7 collected ($11.40)
Seat 2: PacPacBum folded before Flop (didn't bet)
Seat 3: CI58 folded before Flop (didn't bet)
Seat 4: matiko09 folded before Flop (didn't bet)
Seat 5: Monsthand folded before Flop (didn't bet)
Seat 6: Igoriah (button) folded before Flop (didn't bet)
Seat 7: Mister_b44 (small blind) folded on the Turn
Seat 8: chaps1988 (big blind) folded before Flop
Seat 9: Spid1 folded before Flop (didn't bet)





PokerStars Hand #153068391256:  Hold'em No Limit ($1/$2 USD) - 2016/05/09 17:05:50 CET [2016/05/09 11:05:50 ET]
Table 'Titan III' 9-max Seat #6 is the button
Seat 1: I The King I ($283.50 in chips) 
Seat 2: PacPacBum ($200 in chips) 
Seat 3: Spid1 ($417.95 in chips) 
Seat 5: Monsthand ($282.25 in chips) 
Seat 6: matiko09 ($200 in chips) 
Seat 7: seasar1 ($154.48 in chips) 
Seat 8: chaps1988 ($219.77 in chips) 
Seat 9: Sasuke777777 ($176.05 in chips) 
seasar1: posts small blind $1
chaps1988: posts big blind $2
*** HOLE CARDS ***
Dealt to matiko09 [Td 2h]
Sasuke777777: folds 
I The King I: folds 
PacPacBum: folds 
Spid1: folds 
Monsthand: raises $3 to $5
matiko09: folds 
seasar1: folds 
chaps1988: folds 
Uncalled bet ($3) returned to Monsthand
Monsthand collected $5 from pot
Monsthand: doesn't show hand 
*** SUMMARY ***
Total pot $5 | Rake $0 
Seat 1: I The King I folded before Flop (didn't bet)
Seat 2: PacPacBum folded before Flop (didn't bet)
Seat 3: Spid1 folded before Flop (didn't bet)
Seat 5: Monsthand collected ($5)
Seat 6: matiko09 (button) folded before Flop (didn't bet)
Seat 7: seasar1 (small blind) folded before Flop
Seat 8: chaps1988 (big blind) folded before Flop
Seat 9: Sasuke777777 folded before Flop (didn't bet)





PokerStars Hand #153068396414:  Hold'em No Limit ($0.50/$1.00 USD) - 2016/05/09 17:05:59 CET [2016/05/09 11:05:59 ET]
Table 'Eucharis' 9-max Seat #5 is the button
Seat 1: Spid1 ($108.32 in chips) 
Seat 2: Chef-Zizou ($77.60 in chips) 
Seat 3: kiyo94 ($71.43 in chips) 
Seat 4: matiko09 ($100 in chips) 
Seat 5: mycka86 ($100 in chips) 
Seat 6: Mukhin1 ($118.25 in chips) 
Seat 7: ThorSun ($70.45 in chips) 
Seat 8: Kukuryzka ($120.53 in chips) 
Mukhin1: posts small blind $0.50
ThorSun: posts big blind $1
*** HOLE CARDS ***
Dealt to matiko09 [Ts 7h]
Kukuryzka: folds 
Spid1: folds 
Chef-Zizou: folds 
kiyo94: calls $1
matiko09: folds 
mycka86: raises $3.50 to $4.50
Mukhin1: folds 
ThorSun: folds 
kiyo94: calls $3.50
*** FLOP *** [Kd 4d Js]
kiyo94: checks 
mycka86: bets $7.50
kiyo94: calls $7.50
*** TURN *** [Kd 4d Js] [7s]
kiyo94: checks 
mycka86: bets $16.50
kiyo94: raises $42.93 to $59.43 and is all-in
mycka86: calls $42.93
*** RIVER *** [Kd 4d Js 7s] [2c]
*** SHOW DOWN ***
kiyo94: shows [Jh Qd] (a pair of Jacks)
mycka86: shows [9d Ks] (a pair of Kings)
mycka86 collected $141.86 from pot
*** SUMMARY ***
Total pot $144.36 | Rake $2.50 
Board [Kd 4d Js 7s 2c]
Seat 1: Spid1 folded before Flop (didn't bet)
Seat 2: Chef-Zizou folded before Flop (didn't bet)
Seat 3: kiyo94 showed [Jh Qd] and lost with a pair of Jacks
Seat 4: matiko09 folded before Flop (didn't bet)
Seat 5: mycka86 (button) showed [9d Ks] and won ($141.86) with a pair of Kings
Seat 6: Mukhin1 (small blind) folded before Flop
Seat 7: ThorSun (big blind) folded before Flop
Seat 8: Kukuryzka folded before Flop (didn't bet)





PokerStars Hand #153068399278:  Hold'em No Limit ($0.50/$1.00 USD) - 2016/05/09 17:06:03 CET [2016/05/09 11:06:03 ET]
Table 'Orthos' 9-max Seat #2 is the button
Seat 1: Kelvin sai ($80.25 in chips) 
Seat 2: PacPacBum ($114.67 in chips) 
Seat 3: Filojoes ($100 in chips) 
Seat 5: matiko09 ($105.58 in chips) 
Seat 6: xhinostrabli ($98.33 in chips) 
Seat 7: flk.Dasas ($162.90 in chips) 
Seat 8: Dickyxxx ($109.67 in chips) 
Seat 9: mycka86 ($103.50 in chips) 
Filojoes: posts small blind $0.50
matiko09: posts big blind $1
*** HOLE CARDS ***
Dealt to matiko09 [6h 2c]
xhinostrabli: folds 
flk.Dasas: folds 
Dickyxxx: folds 
mycka86: folds 
Kelvin sai: raises $1 to $2
PacPacBum: folds 
Filojoes: calls $1.50
matiko09: folds 
*** FLOP *** [8s 5s Qh]
Filojoes: bets $2.85
Kelvin sai: calls $2.85
*** TURN *** [8s 5s Qh] [Ah]
Filojoes: checks 
Kelvin sai: bets $4
Filojoes: folds 
Uncalled bet ($4) returned to Kelvin sai
Kelvin sai collected $10.16 from pot
Kelvin sai: doesn't show hand 
*** SUMMARY ***
Total pot $10.70 | Rake $0.54 
Board [8s 5s Qh Ah]
Seat 1: Kelvin sai collected ($10.16)
Seat 2: PacPacBum (button) folded before Flop (didn't bet)
Seat 3: Filojoes (small blind) folded on the Turn
Seat 5: matiko09 (big blind) folded before Flop
Seat 6: xhinostrabli folded before Flop (didn't bet)
Seat 7: flk.Dasas folded before Flop (didn't bet)
Seat 8: Dickyxxx folded before Flop (didn't bet)
Seat 9: mycka86 folded before Flop (didn't bet)





PokerStars Hand #153068408249:  Hold'em No Limit ($1/$2 USD) - 2016/05/09 17:06:18 CET [2016/05/09 11:06:18 ET]
Table 'Titan III' 9-max Seat #7 is the button
Seat 1: I The King I ($283.50 in chips) 
Seat 2: PacPacBum ($200 in chips) 
Seat 3: Spid1 ($417.95 in chips) 
Seat 5: Monsthand ($285.25 in chips) 
Seat 6: matiko09 ($200 in chips) 
Seat 7: seasar1 ($153.48 in chips) 
Seat 8: chaps1988 ($217.77 in chips) 
Seat 9: Sasuke777777 ($176.05 in chips) 
chaps1988: posts small blind $1
Sasuke777777: posts big blind $2
*** HOLE CARDS ***
Dealt to matiko09 [4d 4c]
I The King I: folds 
PacPacBum: folds 
Spid1: folds 
Monsthand: folds 
matiko09: raises $3 to $5
seasar1: folds 
chaps1988: folds 
Sasuke777777: raises $3 to $8
matiko09: calls $3
*** FLOP *** [Th 7h 5h]
Sasuke777777: bets $8
matiko09: folds 
Uncalled bet ($8) returned to Sasuke777777
Sasuke777777 collected $16.15 from pot
Sasuke777777: doesn't show hand 
*** SUMMARY ***
Total pot $17 | Rake $0.85 
Board [Th 7h 5h]
Seat 1: I The King I folded before Flop (didn't bet)
Seat 2: PacPacBum folded before Flop (didn't bet)
Seat 3: Spid1 folded before Flop (didn't bet)
Seat 5: Monsthand folded before Flop (didn't bet)
Seat 6: matiko09 folded on the Flop
Seat 7: seasar1 (button) folded before Flop (didn't bet)
Seat 8: chaps1988 (small blind) folded before Flop
Seat 9: Sasuke777777 (big blind) collected ($16.15)





PokerStars Hand #153068411536:  Hold'em No Limit ($0.50/$1.00 USD) - 2016/05/09 17:06:23 CET [2016/05/09 11:06:23 ET]
Table 'Buryatia II' 9-max Seat #6 is the button
Seat 1: flk.Dasas ($148.94 in chips) 
Seat 3: Desperategam ($82.60 in chips) 
Seat 4: maxxmeister ($100 in chips) 
Seat 5: amisasi ($91.60 in chips) 
Seat 6: I The King I ($100 in chips) 
Seat 8: matiko09 ($127 in chips) 
Seat 9: CI58 ($118.41 in chips) 
matiko09: posts small blind $0.50
CI58: posts big blind $1
*** HOLE CARDS ***
Dealt to matiko09 [8h Ac]
flk.Dasas: folds 
Desperategam: folds 
maxxmeister: folds 
amisasi: raises $1 to $2
I The King I: raises $5 to $7
matiko09: folds 
CI58: folds 
amisasi: folds 
Uncalled bet ($5) returned to I The King I
I The King I collected $5.50 from pot
I The King I: doesn't show hand 
*** SUMMARY ***
Total pot $5.50 | Rake $0 
Seat 1: flk.Dasas folded before Flop (didn't bet)
Seat 3: Desperategam folded before Flop (didn't bet)
Seat 4: maxxmeister folded before Flop (didn't bet)
Seat 5: amisasi folded before Flop
Seat 6: I The King I (button) collected ($5.50)
Seat 8: matiko09 (small blind) folded before Flop
Seat 9: CI58 (big blind) folded before Flop





PokerStars Hand #153068417891:  Hold'em No Limit ($0.50/$1.00 USD) - 2016/05/09 17:06:34 CET [2016/05/09 11:06:34 ET]
Table 'Terpsichore' 9-max Seat #1 is the button
Seat 1: ipashutapkom ($192.37 in chips) 
Seat 2: CI58 ($100 in chips) 
Seat 3: matiko09 ($120.89 in chips) 
Seat 5: mycka86 ($241.86 in chips) 
Seat 6: Filojoes ($100 in chips) 
Seat 7: ozone2003 ($127.63 in chips) 
Seat 8: Kiosk230472 ($120.70 in chips) 
Seat 9: FTPbannedMe ($107.50 in chips) 
CI58: posts small blind $0.50
matiko09: posts big blind $1
*** HOLE CARDS ***
Dealt to matiko09 [Ah Kd]
mycka86: folds 
Filojoes: folds 
ozone2003: folds 
Kiosk230472: folds 
FTPbannedMe: raises $1.50 to $2.50
ipashutapkom: raises $5 to $7.50
CI58: folds 
matiko09: raises $9.50 to $17
FTPbannedMe: folds 
ipashutapkom: calls $9.50
*** FLOP *** [Qc 3s 3c]
matiko09: bets $18
ipashutapkom: calls $18
*** TURN *** [Qc 3s 3c] [Ks]
matiko09: checks 
ipashutapkom: checks 
*** RIVER *** [Qc 3s 3c Ks] [9c]
matiko09: checks 
ipashutapkom: checks 
*** SHOW DOWN ***
matiko09: shows [Ah Kd] (two pair, Kings and Threes)
ipashutapkom: mucks hand 
matiko09 collected $70.50 from pot
*** SUMMARY ***
Total pot $73 | Rake $2.50 
Board [Qc 3s 3c Ks 9c]
Seat 1: ipashutapkom (button) mucked [2d 2s]
Seat 2: CI58 (small blind) folded before Flop
Seat 3: matiko09 (big blind) showed [Ah Kd] and won ($70.50) with two pair, Kings and Threes
Seat 5: mycka86 folded before Flop (didn't bet)
Seat 6: Filojoes folded before Flop (didn't bet)
Seat 7: ozone2003 folded before Flop (didn't bet)
Seat 8: Kiosk230472 folded before Flop (didn't bet)
Seat 9: FTPbannedMe folded before Flop





PokerStars Hand #153068419017:  Hold'em No Limit ($1/$2 USD) - 2016/05/09 17:06:36 CET [2016/05/09 11:06:36 ET]
Table 'Celaeno II' 9-max Seat #7 is the button
Seat 1: LRVAV7 ($214.65 in chips) 
Seat 2: PacPacBum ($422.59 in chips) 
Seat 3: CI58 ($200 in chips) 
Seat 4: matiko09 ($298.63 in chips) 
Seat 5: Monsthand ($223.61 in chips) 
Seat 6: Igoriah ($211.52 in chips) 
Seat 7: Mister_b44 ($118.94 in chips) 
Seat 8: chaps1988 ($229.31 in chips) 
Seat 9: Spid1 ($200 in chips) 
chaps1988: posts small blind $1
Spid1: posts big blind $2
*** HOLE CARDS ***
Dealt to matiko09 [8c 8s]
LRVAV7: folds 
PacPacBum: folds 
CI58: folds 
matiko09: raises $3 to $5
Monsthand: folds 
Igoriah: calls $5
Mister_b44: calls $5
chaps1988: calls $4
Spid1: folds 
*** FLOP *** [8d Ad 4c]
chaps1988: checks 
matiko09: bets $14
Igoriah: folds 
Mister_b44: calls $14
chaps1988: folds 
*** TURN *** [8d Ad 4c] [Ts]
matiko09: bets $32
Mister_b44: raises $32 to $64
matiko09: raises $108.48 to $172.48
Mister_b44: calls $35.94 and is all-in
Uncalled bet ($72.54) returned to matiko09
*** RIVER *** [8d Ad 4c Ts] [Kd]
*** SHOW DOWN ***
matiko09: shows [8c 8s] (three of a kind, Eights)
Mister_b44: mucks hand 
matiko09 collected $247.13 from pot
*** SUMMARY ***
Total pot $249.88 | Rake $2.75 
Board [8d Ad 4c Ts Kd]
Seat 1: LRVAV7 folded before Flop (didn't bet)
Seat 2: PacPacBum folded before Flop (didn't bet)
Seat 3: CI58 folded before Flop (didn't bet)
Seat 4: matiko09 showed [8c 8s] and won ($247.13) with three of a kind, Eights
Seat 5: Monsthand folded before Flop (didn't bet)
Seat 6: Igoriah folded on the Flop
Seat 7: Mister_b44 (button) mucked [4h 4d]
Seat 8: chaps1988 (small blind) folded on the Flop
Seat 9: Spid1 (big blind) folded before Flop





PokerStars Hand #153068419677:  Hold'em No Limit ($1/$2 USD) - 2016/05/09 17:06:37 CET [2016/05/09 11:06:37 ET]
Table 'Hagar II' 9-max Seat #7 is the button
Seat 1: mojitos86 ($186.23 in chips) 
Seat 2: darren1031 ($216.95 in chips) 
Seat 3: Sasuke777777 ($156.83 in chips) 
Seat 4: matiko09 ($437.49 in chips) 
Seat 5: PacPacBum ($290.47 in chips) 
Seat 6: el Fatto ($207 in chips) 
Seat 7: Monsthand ($200 in chips) 
Seat 9: chaps1988 ($240.39 in chips) 
chaps1988: posts small blind $1
mojitos86: posts big blind $2
*** HOLE CARDS ***
Dealt to matiko09 [6c 8c]
darren1031: folds 
Sasuke777777: raises $4 to $6
matiko09: folds 
PacPacBum: folds 
el Fatto: folds 
Monsthand: folds 
chaps1988: raises $14 to $20
mojitos86: folds 
Sasuke777777: calls $14
*** FLOP *** [Qc 2h 9d]
chaps1988: bets $21
Sasuke777777: raises $115.83 to $136.83 and is all-in
chaps1988: calls $115.83
*** TURN *** [Qc 2h 9d] [4c]
*** RIVER *** [Qc 2h 9d 4c] [9c]
*** SHOW DOWN ***
chaps1988: shows [Qs Ah] (two pair, Queens and Nines)
Sasuke777777: shows [Ts Qd] (two pair, Queens and Nines - lower kicker)
chaps1988 collected $312.91 from pot
*** SUMMARY ***
Total pot $315.66 | Rake $2.75 
Board [Qc 2h 9d 4c 9c]
Seat 1: mojitos86 (big blind) folded before Flop
Seat 2: darren1031 folded before Flop (didn't bet)
Seat 3: Sasuke777777 showed [Ts Qd] and lost with two pair, Queens and Nines
Seat 4: matiko09 folded before Flop (didn't bet)
Seat 5: PacPacBum folded before Flop (didn't bet)
Seat 6: el Fatto folded before Flop (didn't bet)
Seat 7: Monsthand (button) folded before Flop (didn't bet)
Seat 9: chaps1988 (small blind) showed [Qs Ah] and won ($312.91) with two pair, Queens and Nines





PokerStars Hand #153068428343:  Hold'em No Limit ($1/$2 USD) - 2016/05/09 17:06:51 CET [2016/05/09 11:06:51 ET]
Table 'Titan III' 9-max Seat #8 is the button
Seat 1: I The King I ($283.50 in chips) 
Seat 2: PacPacBum ($200 in chips) 
Seat 3: Spid1 ($417.95 in chips) 
Seat 5: Monsthand ($285.25 in chips) 
Seat 6: matiko09 ($200 in chips) 
Seat 7: seasar1 ($153.48 in chips) 
Seat 8: chaps1988 ($216.77 in chips) 
Seat 9: Sasuke777777 ($184.20 in chips) 
Sasuke777777: posts small blind $1
I The King I: posts big blind $2
*** HOLE CARDS ***
Dealt to matiko09 [6s 3c]
PacPacBum: folds 
Spid1: raises $4 to $6
Monsthand: folds 
matiko09: folds 
seasar1: folds 
chaps1988: folds 
Sasuke777777: folds 
I The King I: calls $4
*** FLOP *** [6d Td 2c]
I The King I: checks 
Spid1: bets $8
I The King I: folds 
Uncalled bet ($8) returned to Spid1
Spid1 collected $12.35 from pot
Spid1: doesn't show hand 
*** SUMMARY ***
Total pot $13 | Rake $0.65 
Board [6d Td 2c]
Seat 1: I The King I (big blind) folded on the Flop
Seat 2: PacPacBum folded before Flop (didn't bet)
Seat 3: Spid1 collected ($12.35)
Seat 5: Monsthand folded before Flop (didn't bet)
Seat 6: matiko09 folded before Flop (didn't bet)
Seat 7: seasar1 folded before Flop (didn't bet)
Seat 8: chaps1988 (button) folded before Flop (didn't bet)
Seat 9: Sasuke777777 (small blind) folded before Flop





PokerStars Hand #153068434783:  Hold'em No Limit ($0.50/$1.00 USD) - 2016/05/09 17:07:01 CET [2016/05/09 11:07:01 ET]
Table 'Buryatia II' 9-max Seat #8 is the button
Seat 1: flk.Dasas ($148.94 in chips) 
Seat 3: Desperategam ($82.60 in chips) 
Seat 4: maxxmeister ($100 in chips) 
Seat 5: amisasi ($89.60 in chips) 
Seat 6: I The King I ($103.50 in chips) 
Seat 8: matiko09 ($126.50 in chips) 
Seat 9: CI58 ($117.41 in chips) 
CI58: posts small blind $0.50
flk.Dasas: posts big blind $1
*** HOLE CARDS ***
Dealt to matiko09 [9d 5h]
Desperategam: calls $1
maxxmeister: calls $1
amisasi: folds 
I The King I: folds 
matiko09: folds 
CI58: raises $5 to $6
flk.Dasas: folds 
Desperategam: calls $5
maxxmeister: folds 
*** FLOP *** [4c Ah 3h]
CI58: bets $7.98
Desperategam: folds 
Uncalled bet ($7.98) returned to CI58
CI58 collected $13.30 from pot
CI58: doesn't show hand 
*** SUMMARY ***
Total pot $14 | Rake $0.70 
Board [4c Ah 3h]
Seat 1: flk.Dasas (big blind) folded before Flop
Seat 3: Desperategam folded on the Flop
Seat 4: maxxmeister folded before Flop
Seat 5: amisasi folded before Flop (didn't bet)
Seat 6: I The King I folded before Flop (didn't bet)
Seat 8: matiko09 (button) folded before Flop (didn't bet)
Seat 9: CI58 (small blind) collected ($13.30)





PokerStars Hand #153068436222:  Hold'em No Limit ($0.50/$1.00 USD) - 2016/05/09 17:07:03 CET [2016/05/09 11:07:03 ET]
Table 'Reiss' 9-max Seat #5 is the button
Seat 1: Dickyxxx ($162.66 in chips) 
Seat 2: mycka86 ($188.75 in chips) 
Seat 3: chaps1988 ($117.87 in chips) 
Seat 4: CI58 ($103.10 in chips) 
Seat 5: matiko09 ($113.79 in chips) 
Seat 6: HITYESCA ($100 in chips) 
Seat 8: rusher_NiNja ($100 in chips) 
Seat 9: flyer9898 ($84.42 in chips) 
HITYESCA: posts small blind $0.50
rusher_NiNja: posts big blind $1
*** HOLE CARDS ***
Dealt to matiko09 [Kh Jc]
flyer9898: folds 
Dickyxxx: folds 
mycka86: folds 
chaps1988: raises $1.50 to $2.50
CI58: raises $5.50 to $8
matiko09: folds 
HITYESCA: folds 
rusher_NiNja: folds 
chaps1988: folds 
Uncalled bet ($5.50) returned to CI58
CI58 collected $6.50 from pot
CI58: doesn't show hand 
*** SUMMARY ***
Total pot $6.50 | Rake $0 
Seat 1: Dickyxxx folded before Flop (didn't bet)
Seat 2: mycka86 folded before Flop (didn't bet)
Seat 3: chaps1988 folded before Flop
Seat 4: CI58 collected ($6.50)
Seat 5: matiko09 (button) folded before Flop (didn't bet)
Seat 6: HITYESCA (small blind) folded before Flop
Seat 8: rusher_NiNja (big blind) folded before Flop
Seat 9: flyer9898 folded before Flop (didn't bet)





PokerStars Hand #153068449859:  Hold'em No Limit ($0.50/$1.00 USD) - 2016/05/09 17:07:21 CET [2016/05/09 11:07:21 ET]
Table 'Orthos' 9-max Seat #3 is the button
Seat 1: Kelvin sai ($85.56 in chips) 
Seat 2: PacPacBum ($114.67 in chips) 
Seat 3: Filojoes ($100 in chips) 
Seat 5: matiko09 ($104.58 in chips) 
Seat 6: xhinostrabli ($98.33 in chips) 
Seat 7: flk.Dasas ($162.90 in chips) 
Seat 8: Dickyxxx ($109.67 in chips) 
Seat 9: mycka86 ($103.50 in chips) 
matiko09: posts small blind $0.50
xhinostrabli: posts big blind $1
*** HOLE CARDS ***
Dealt to matiko09 [Js Tc]
flk.Dasas: folds 
Dickyxxx: folds 
mycka86: folds 
Kelvin sai: raises $1 to $2
PacPacBum: folds 
Filojoes: calls $2
matiko09: folds 
xhinostrabli: folds 
*** FLOP *** [3h Ah Qs]
Kelvin sai: bets $3
Filojoes: calls $3
*** TURN *** [3h Ah Qs] [9h]
Kelvin sai: bets $5
Filojoes: calls $5
*** RIVER *** [3h Ah Qs 9h] [5c]
Kelvin sai: checks 
Filojoes: checks 
*** SHOW DOWN ***
Kelvin sai: shows [Qc Kh] (a pair of Queens)
Filojoes: shows [As Kd] (a pair of Aces)
Filojoes collected $20.42 from pot
*** SUMMARY ***
Total pot $21.50 | Rake $1.08 
Board [3h Ah Qs 9h 5c]
Seat 1: Kelvin sai showed [Qc Kh] and lost with a pair of Queens
Seat 2: PacPacBum folded before Flop (didn't bet)
Seat 3: Filojoes (button) showed [As Kd] and won ($20.42) with a pair of Aces
Seat 5: matiko09 (small blind) folded before Flop
Seat 6: xhinostrabli (big blind) folded before Flop
Seat 7: flk.Dasas folded before Flop (didn't bet)
Seat 8: Dickyxxx folded before Flop (didn't bet)
Seat 9: mycka86 folded before Flop (didn't bet)





PokerStars Hand #153068449741:  Hold'em No Limit ($1/$2 USD) - 2016/05/09 17:07:21 CET [2016/05/09 11:07:21 ET]
Table 'Hagar II' 9-max Seat #9 is the button
Seat 1: mojitos86 ($184.23 in chips) 
Seat 2: darren1031 ($216.95 in chips) 
Seat 4: matiko09 ($437.49 in chips) 
Seat 5: PacPacBum ($290.47 in chips) 
Seat 6: el Fatto ($207 in chips) 
Seat 7: Monsthand ($200 in chips) 
Seat 9: chaps1988 ($396.47 in chips) 
mojitos86: posts small blind $1
darren1031: posts big blind $2
*** HOLE CARDS ***
Dealt to matiko09 [Qc 6h]
matiko09: folds 
PacPacBum: folds 
el Fatto: folds 
Monsthand: raises $3.40 to $5.40
chaps1988: folds 
mojitos86: folds 
darren1031: calls $3.40
*** FLOP *** [7d Qs 9c]
darren1031: checks 
Monsthand: bets $7.28
darren1031: calls $7.28
*** TURN *** [7d Qs 9c] [Jc]
darren1031: checks 
Monsthand: checks 
*** RIVER *** [7d Qs 9c Jc] [Js]
darren1031: bets $25.04
Monsthand: calls $25.04
*** SHOW DOWN ***
darren1031: shows [8s 5s] (a pair of Jacks)
Monsthand: shows [Jd Kh] (three of a kind, Jacks)
Monsthand collected $73.69 from pot
*** SUMMARY ***
Total pot $76.44 | Rake $2.75 
Board [7d Qs 9c Jc Js]
Seat 1: mojitos86 (small blind) folded before Flop
Seat 2: darren1031 (big blind) showed [8s 5s] and lost with a pair of Jacks
Seat 4: matiko09 folded before Flop (didn't bet)
Seat 5: PacPacBum folded before Flop (didn't bet)
Seat 6: el Fatto folded before Flop (didn't bet)
Seat 7: Monsthand showed [Jd Kh] and won ($73.69) with three of a kind, Jacks
Seat 9: chaps1988 (button) folded before Flop (didn't bet)





PokerStars Hand #153068451180:  Hold'em No Limit ($1/$2 USD) - 2016/05/09 17:07:23 CET [2016/05/09 11:07:23 ET]
Table 'Titan III' 9-max Seat #9 is the button
Seat 1: I The King I ($277.50 in chips) 
Seat 2: PacPacBum ($200 in chips) 
Seat 3: Spid1 ($424.30 in chips) 
Seat 5: Monsthand ($285.25 in chips) 
Seat 6: matiko09 ($200 in chips) 
Seat 7: seasar1 ($153.48 in chips) 
Seat 8: chaps1988 ($216.77 in chips) 
Seat 9: Sasuke777777 ($183.20 in chips) 
I The King I: posts small blind $1
PacPacBum: posts big blind $2
*** HOLE CARDS ***
Dealt to matiko09 [Ah 3d]
Spid1: folds 
Monsthand: folds 
matiko09: folds 
seasar1: folds 
chaps1988: folds 
Sasuke777777: raises $4 to $6
I The King I: folds 
PacPacBum: folds 
Uncalled bet ($4) returned to Sasuke777777
Sasuke777777 collected $5 from pot
Sasuke777777: doesn't show hand 
*** SUMMARY ***
Total pot $5 | Rake $0 
Seat 1: I The King I (small blind) folded before Flop
Seat 2: PacPacBum (big blind) folded before Flop
Seat 3: Spid1 folded before Flop (didn't bet)
Seat 5: Monsthand folded before Flop (didn't bet)
Seat 6: matiko09 folded before Flop (didn't bet)
Seat 7: seasar1 folded before Flop (didn't bet)
Seat 8: chaps1988 folded before Flop (didn't bet)
Seat 9: Sasuke777777 (button) collected ($5)





PokerStars Hand #153068455937:  Hold'em No Limit ($0.50/$1.00 USD) - 2016/05/09 17:07:31 CET [2016/05/09 11:07:31 ET]
Table 'Eucharis' 9-max Seat #6 is the button
Seat 1: Spid1 ($108.32 in chips) 
Seat 2: Chef-Zizou ($77.60 in chips) 
Seat 4: matiko09 ($100 in chips) 
Seat 5: mycka86 ($170.43 in chips) 
Seat 6: Mukhin1 ($117.75 in chips) 
Seat 7: ThorSun ($69.45 in chips) 
Seat 8: Kukuryzka ($120.53 in chips) 
ThorSun: posts small blind $0.50
Kukuryzka: posts big blind $1
*** HOLE CARDS ***
Dealt to matiko09 [As Jd]
Spid1: folds 
Chef-Zizou: folds 
matiko09: raises $2 to $3
mycka86: folds 
kiyo94 leaves the table
flk.Dasas joins the table at seat #3 
Mukhin1: raises $6.07 to $9.07
ThorSun: folds 
Kukuryzka: folds 
matiko09: raises $9.93 to $19
Mukhin1: folds 
Uncalled bet ($9.93) returned to matiko09
matiko09 collected $19.64 from pot
matiko09: doesn't show hand 
*** SUMMARY ***
Total pot $19.64 | Rake $0 
Seat 1: Spid1 folded before Flop (didn't bet)
Seat 2: Chef-Zizou folded before Flop (didn't bet)
Seat 4: matiko09 collected ($19.64)
Seat 5: mycka86 folded before Flop (didn't bet)
Seat 6: Mukhin1 (button) folded before Flop
Seat 7: ThorSun (small blind) folded before Flop
Seat 8: Kukuryzka (big blind) folded before Flop





PokerStars Hand #153068462115:  Hold'em No Limit ($0.50/$1.00 USD) - 2016/05/09 17:07:41 CET [2016/05/09 11:07:41 ET]
Table 'Reiss' 9-max Seat #6 is the button
Seat 1: Dickyxxx ($162.66 in chips) 
Seat 2: mycka86 ($188.75 in chips) 
Seat 3: chaps1988 ($115.37 in chips) 
Seat 4: CI58 ($107.10 in chips) 
Seat 5: matiko09 ($113.79 in chips) 
Seat 6: HITYESCA ($100 in chips) 
Seat 8: rusher_NiNja ($100 in chips) 
Seat 9: flyer9898 ($84.42 in chips) 
rusher_NiNja: posts small blind $0.50
flyer9898: posts big blind $1
*** HOLE CARDS ***
Dealt to matiko09 [4h As]
Dickyxxx: folds 
mycka86: folds 
chaps1988: folds 
CI58: folds 
matiko09: folds 
HITYESCA: folds 
rusher_NiNja: folds 
Uncalled bet ($0.50) returned to flyer9898
flyer9898 collected $1 from pot
flyer9898: doesn't show hand 
*** SUMMARY ***
Total pot $1 | Rake $0 
Seat 1: Dickyxxx folded before Flop (didn't bet)
Seat 2: mycka86 folded before Flop (didn't bet)
Seat 3: chaps1988 folded before Flop (didn't bet)
Seat 4: CI58 folded before Flop (didn't bet)
Seat 5: matiko09 folded before Flop (didn't bet)
Seat 6: HITYESCA (button) folded before Flop (didn't bet)
Seat 8: rusher_NiNja (small blind) folded before Flop
Seat 9: flyer9898 (big blind) collected ($1)





PokerStars Hand #153068464971:  Hold'em No Limit ($1/$2 USD) - 2016/05/09 17:07:46 CET [2016/05/09 11:07:46 ET]
Table 'Titan III' 9-max Seat #1 is the button
Seat 1: I The King I ($276.50 in chips) 
Seat 2: PacPacBum ($200 in chips) 
Seat 3: Spid1 ($424.30 in chips) 
Seat 5: Monsthand ($285.25 in chips) 
Seat 6: matiko09 ($200 in chips) 
Seat 7: seasar1 ($153.48 in chips) 
Seat 8: chaps1988 ($216.77 in chips) 
Seat 9: Sasuke777777 ($186.20 in chips) 
PacPacBum: posts small blind $1
Spid1: posts big blind $2
*** HOLE CARDS ***
Dealt to matiko09 [Ts 7d]
Monsthand: folds 
matiko09: folds 
seasar1: folds 
chaps1988: folds 
Sasuke777777: raises $4 to $6
I The King I: folds 
PacPacBum: folds 
Spid1: raises $14 to $20
Sasuke777777: calls $14
*** FLOP *** [Kd 7h 2d]
Spid1: bets $31
Sasuke777777: folds 
Uncalled bet ($31) returned to Spid1
Spid1 collected $38.95 from pot
Spid1: doesn't show hand 
*** SUMMARY ***
Total pot $41 | Rake $2.05 
Board [Kd 7h 2d]
Seat 1: I The King I (button) folded before Flop (didn't bet)
Seat 2: PacPacBum (small blind) folded before Flop
Seat 3: Spid1 (big blind) collected ($38.95)
Seat 5: Monsthand folded before Flop (didn't bet)
Seat 6: matiko09 folded before Flop (didn't bet)
Seat 7: seasar1 folded before Flop (didn't bet)
Seat 8: chaps1988 folded before Flop (didn't bet)
Seat 9: Sasuke777777 folded on the Flop





PokerStars Hand #153068480139:  Hold'em No Limit ($0.50/$1.00 USD) - 2016/05/09 17:08:11 CET [2016/05/09 11:08:11 ET]
Table 'Buryatia II' 9-max Seat #9 is the button
Seat 1: flk.Dasas ($147.94 in chips) 
Seat 4: maxxmeister ($100 in chips) 
Seat 5: amisasi ($89.60 in chips) 
Seat 6: I The King I ($103.50 in chips) 
Seat 8: matiko09 ($126.50 in chips) 
Seat 9: CI58 ($124.71 in chips) 
flk.Dasas: posts small blind $0.50
Desperategam: is sitting out 
maxxmeister: posts big blind $1
*** HOLE CARDS ***
Dealt to matiko09 [6h Ac]
amisasi: calls $1
I The King I: folds 
matiko09: folds 
CI58: raises $3 to $4
flk.Dasas: folds 
maxxmeister: folds 
amisasi: calls $3
*** FLOP *** [Kc Td Ts]
amisasi: checks 
CI58: checks 
*** TURN *** [Kc Td Ts] [9h]
amisasi: bets $4.51
CI58: folds 
Uncalled bet ($4.51) returned to amisasi
amisasi collected $9.02 from pot
*** SUMMARY ***
Total pot $9.50 | Rake $0.48 
Board [Kc Td Ts 9h]
Seat 1: flk.Dasas (small blind) folded before Flop
Seat 4: maxxmeister (big blind) folded before Flop
Seat 5: amisasi collected ($9.02)
Seat 6: I The King I folded before Flop (didn't bet)
Seat 8: matiko09 folded before Flop (didn't bet)
Seat 9: CI58 (button) folded on the Turn





PokerStars Hand #153068485961:  Hold'em No Limit ($0.50/$1.00 USD) - 2016/05/09 17:08:20 CET [2016/05/09 11:08:20 ET]
Table 'Reiss' 9-max Seat #8 is the button
Seat 1: Dickyxxx ($162.66 in chips) 
Seat 2: mycka86 ($188.75 in chips) 
Seat 3: chaps1988 ($115.37 in chips) 
Seat 4: CI58 ($107.10 in chips) 
Seat 5: matiko09 ($113.79 in chips) 
Seat 6: HITYESCA ($100 in chips) 
Seat 8: rusher_NiNja ($100 in chips) 
Seat 9: flyer9898 ($84.92 in chips) 
flyer9898: posts small blind $0.50
Dickyxxx: posts big blind $1
*** HOLE CARDS ***
Dealt to matiko09 [9d 6s]
mycka86: folds 
chaps1988: folds 
CI58: folds 
matiko09: folds 
HITYESCA: folds 
rusher_NiNja: folds 
flyer9898: raises $2 to $3
Dickyxxx: folds 
Uncalled bet ($2) returned to flyer9898
flyer9898 collected $2 from pot
flyer9898: doesn't show hand 
*** SUMMARY ***
Total pot $2 | Rake $0 
Seat 1: Dickyxxx (big blind) folded before Flop
Seat 2: mycka86 folded before Flop (didn't bet)
Seat 3: chaps1988 folded before Flop (didn't bet)
Seat 4: CI58 folded before Flop (didn't bet)
Seat 5: matiko09 folded before Flop (didn't bet)
Seat 6: HITYESCA folded before Flop (didn't bet)
Seat 8: rusher_NiNja (button) folded before Flop (didn't bet)
Seat 9: flyer9898 (small blind) collected ($2)





PokerStars Hand #153068489006:  Hold'em No Limit ($0.50/$1.00 USD) - 2016/05/09 17:08:25 CET [2016/05/09 11:08:25 ET]
Table 'Eucharis' 9-max Seat #7 is the button
Seat 1: Spid1 ($108.32 in chips) 
Seat 2: Chef-Zizou ($77.60 in chips) 
Seat 4: matiko09 ($110.57 in chips) 
Seat 5: mycka86 ($170.43 in chips) 
Seat 6: Mukhin1 ($108.68 in chips) 
Seat 7: ThorSun ($68.95 in chips) 
Seat 8: Kukuryzka ($119.53 in chips) 
Kukuryzka: posts small blind $0.50
Spid1: posts big blind $1
*** HOLE CARDS ***
Dealt to matiko09 [Kc 8h]
Chef-Zizou: folds 
matiko09: folds 
mycka86: folds 
Mukhin1: folds 
ThorSun: folds 
Kukuryzka: folds 
Uncalled bet ($0.50) returned to Spid1
Spid1 collected $1 from pot
Spid1: doesn't show hand 
*** SUMMARY ***
Total pot $1 | Rake $0 
Seat 1: Spid1 (big blind) collected ($1)
Seat 2: Chef-Zizou folded before Flop (didn't bet)
Seat 4: matiko09 folded before Flop (didn't bet)
Seat 5: mycka86 folded before Flop (didn't bet)
Seat 6: Mukhin1 folded before Flop (didn't bet)
Seat 7: ThorSun (button) folded before Flop (didn't bet)
Seat 8: Kukuryzka (small blind) folded before Flop





PokerStars Hand #153068491474:  Hold'em No Limit ($1/$2 USD) - 2016/05/09 17:08:29 CET [2016/05/09 11:08:29 ET]
Table 'Celaeno II' 9-max Seat #8 is the button
Seat 1: LRVAV7 ($214.65 in chips) 
Seat 2: PacPacBum ($422.59 in chips) 
Seat 3: CI58 ($200 in chips) 
Seat 4: matiko09 ($426.82 in chips) 
Seat 5: Monsthand ($223.61 in chips) 
Seat 6: Igoriah ($206.52 in chips) 
Seat 8: chaps1988 ($224.31 in chips) 
Seat 9: Spid1 ($200 in chips) 
Spid1: posts small blind $1
LRVAV7: posts big blind $2
*** HOLE CARDS ***
Dealt to matiko09 [4d Jc]
PacPacBum: folds 
CI58: folds 
matiko09: folds 
Monsthand: raises $3.40 to $5.40
Igoriah: folds 
chaps1988: folds 
Spid1: folds 
LRVAV7: folds 
Uncalled bet ($3.40) returned to Monsthand
Monsthand collected $5 from pot
Monsthand: doesn't show hand 
*** SUMMARY ***
Total pot $5 | Rake $0 
Seat 1: LRVAV7 (big blind) folded before Flop
Seat 2: PacPacBum folded before Flop (didn't bet)
Seat 3: CI58 folded before Flop (didn't bet)
Seat 4: matiko09 folded before Flop (didn't bet)
Seat 5: Monsthand collected ($5)
Seat 6: Igoriah folded before Flop (didn't bet)
Seat 8: chaps1988 (button) folded before Flop (didn't bet)
Seat 9: Spid1 (small blind) folded before Flop





PokerStars Hand #153068493103:  Hold'em No Limit ($1/$2 USD) - 2016/05/09 17:08:32 CET [2016/05/09 11:08:32 ET]
Table 'Titan III' 9-max Seat #2 is the button
Seat 1: I The King I ($276.50 in chips) 
Seat 2: PacPacBum ($200 in chips) 
Seat 3: Spid1 ($443.25 in chips) 
Seat 5: Monsthand ($285.25 in chips) 
Seat 6: matiko09 ($200 in chips) 
Seat 7: seasar1 ($153.48 in chips) 
Seat 8: chaps1988 ($216.77 in chips) 
Seat 9: Sasuke777777 ($166.20 in chips) 
Spid1: posts small blind $1
Monsthand: posts big blind $2
*** HOLE CARDS ***
Dealt to matiko09 [7h 6s]
matiko09: folds 
seasar1: raises $2 to $4
chaps1988: folds 
Sasuke777777: folds 
I The King I: folds 
PacPacBum: folds 
Spid1: folds 
Monsthand: folds 
Uncalled bet ($2) returned to seasar1
seasar1 collected $5 from pot
*** SUMMARY ***
Total pot $5 | Rake $0 
Seat 1: I The King I folded before Flop (didn't bet)
Seat 2: PacPacBum (button) folded before Flop (didn't bet)
Seat 3: Spid1 (small blind) folded before Flop
Seat 5: Monsthand (big blind) folded before Flop
Seat 6: matiko09 folded before Flop (didn't bet)
Seat 7: seasar1 collected ($5)
Seat 8: chaps1988 folded before Flop (didn't bet)
Seat 9: Sasuke777777 folded before Flop (didn't bet)





PokerStars Hand #153068499852:  Hold'em No Limit ($0.50/$1.00 USD) - 2016/05/09 17:08:43 CET [2016/05/09 11:08:43 ET]
Table 'Reiss' 9-max Seat #9 is the button
Seat 1: Dickyxxx ($161.66 in chips) 
Seat 2: mycka86 ($188.75 in chips) 
Seat 3: chaps1988 ($115.37 in chips) 
Seat 4: CI58 ($107.10 in chips) 
Seat 5: matiko09 ($113.79 in chips) 
Seat 6: HITYESCA ($100 in chips) 
Seat 8: rusher_NiNja ($100 in chips) 
Seat 9: flyer9898 ($85.92 in chips) 
Dickyxxx: posts small blind $0.50
mycka86: posts big blind $1
*** HOLE CARDS ***
Dealt to matiko09 [2s Ad]
chaps1988: folds 
CI58: folds 
matiko09: folds 
HITYESCA: folds 
rusher_NiNja: folds 
flyer9898: raises $1 to $2
Dickyxxx: raises $7 to $9
mycka86: folds 
flyer9898: folds 
Uncalled bet ($7) returned to Dickyxxx
Dickyxxx collected $5 from pot
Dickyxxx: doesn't show hand 
*** SUMMARY ***
Total pot $5 | Rake $0 
Seat 1: Dickyxxx (small blind) collected ($5)
Seat 2: mycka86 (big blind) folded before Flop
Seat 3: chaps1988 folded before Flop (didn't bet)
Seat 4: CI58 folded before Flop (didn't bet)
Seat 5: matiko09 folded before Flop (didn't bet)
Seat 6: HITYESCA folded before Flop (didn't bet)
Seat 8: rusher_NiNja folded before Flop (didn't bet)
Seat 9: flyer9898 (button) folded before Flop





PokerStars Hand #153068502475:  Hold'em No Limit ($0.50/$1.00 USD) - 2016/05/09 17:08:47 CET [2016/05/09 11:08:47 ET]
Table 'Terpsichore' 9-max Seat #2 is the button
Seat 1: ipashutapkom ($157.37 in chips) 
Seat 2: CI58 ($100 in chips) 
Seat 3: matiko09 ($156.39 in chips) 
Seat 5: mycka86 ($241.86 in chips) 
Seat 6: Filojoes ($100 in chips) 
Seat 7: ozone2003 ($127.63 in chips) 
Seat 8: Kiosk230472 ($120.70 in chips) 
Seat 9: FTPbannedMe ($105 in chips) 
matiko09: posts small blind $0.50
mycka86: posts big blind $1
*** HOLE CARDS ***
Dealt to matiko09 [4s Tc]
Filojoes: folds 
ozone2003: raises $2 to $3
Kiosk230472: folds 
FTPbannedMe: folds 
ipashutapkom: folds 
CI58: folds 
matiko09: folds 
mycka86: folds 
Uncalled bet ($2) returned to ozone2003
ozone2003 collected $2.50 from pot
ozone2003: doesn't show hand 
*** SUMMARY ***
Total pot $2.50 | Rake $0 
Seat 1: ipashutapkom folded before Flop (didn't bet)
Seat 2: CI58 (button) folded before Flop (didn't bet)
Seat 3: matiko09 (small blind) folded before Flop
Seat 5: mycka86 (big blind) folded before Flop
Seat 6: Filojoes folded before Flop (didn't bet)
Seat 7: ozone2003 collected ($2.50)
Seat 8: Kiosk230472 folded before Flop (didn't bet)
Seat 9: FTPbannedMe folded before Flop (didn't bet)





PokerStars Hand #153068504560:  Hold'em No Limit ($0.50/$1.00 USD) - 2016/05/09 17:08:50 CET [2016/05/09 11:08:50 ET]
Table 'Orthos' 9-max Seat #5 is the button
Seat 1: Kelvin sai ($75.56 in chips) 
Seat 2: PacPacBum ($114.67 in chips) 
Seat 3: Filojoes ($110.42 in chips) 
Seat 5: matiko09 ($104.08 in chips) 
Seat 6: xhinostrabli ($97.33 in chips) 
Seat 7: flk.Dasas ($162.90 in chips) 
Seat 8: Dickyxxx ($109.67 in chips) 
Seat 9: mycka86 ($103.50 in chips) 
xhinostrabli: posts small blind $0.50
flk.Dasas: posts big blind $1
*** HOLE CARDS ***
Dealt to matiko09 [Qc Js]
Dickyxxx: raises $2 to $3
mycka86: folds 
Kelvin sai: folds 
PacPacBum: folds 
Filojoes: calls $3
matiko09: folds 
xhinostrabli: folds 
flk.Dasas: folds 
*** FLOP *** [5h 9h Th]
Dickyxxx: checks 
Filojoes: bets $4.27
Dickyxxx: folds 
Uncalled bet ($4.27) returned to Filojoes
Filojoes collected $7.12 from pot
Filojoes: doesn't show hand 
*** SUMMARY ***
Total pot $7.50 | Rake $0.38 
Board [5h 9h Th]
Seat 1: Kelvin sai folded before Flop (didn't bet)
Seat 2: PacPacBum folded before Flop (didn't bet)
Seat 3: Filojoes collected ($7.12)
Seat 5: matiko09 (button) folded before Flop (didn't bet)
Seat 6: xhinostrabli (small blind) folded before Flop
Seat 7: flk.Dasas (big blind) folded before Flop
Seat 8: Dickyxxx folded on the Flop
Seat 9: mycka86 folded before Flop (didn't bet)





PokerStars Hand #153068505226:  Hold'em No Limit ($0.50/$1.00 USD) - 2016/05/09 17:08:52 CET [2016/05/09 11:08:52 ET]
Table 'Buryatia II' 9-max Seat #1 is the button
Seat 1: flk.Dasas ($147.44 in chips) 
Seat 4: maxxmeister ($100 in chips) 
Seat 5: amisasi ($94.62 in chips) 
Seat 6: I The King I ($103.50 in chips) 
Seat 8: matiko09 ($126.50 in chips) 
Seat 9: CI58 ($120.71 in chips) 
maxxmeister: posts small blind $0.50
amisasi: posts big blind $1
*** HOLE CARDS ***
Dealt to matiko09 [4h 2c]
I The King I: folds 
matiko09: folds 
CI58: raises $1.25 to $2.25
flk.Dasas: folds 
maxxmeister: folds 
amisasi: folds 
Uncalled bet ($1.25) returned to CI58
CI58 collected $2.50 from pot
CI58: doesn't show hand 
*** SUMMARY ***
Total pot $2.50 | Rake $0 
Seat 1: flk.Dasas (button) folded before Flop (didn't bet)
Seat 4: maxxmeister (small blind) folded before Flop
Seat 5: amisasi (big blind) folded before Flop
Seat 6: I The King I folded before Flop (didn't bet)
Seat 8: matiko09 folded before Flop (didn't bet)
Seat 9: CI58 collected ($2.50)





PokerStars Hand #153068505724:  Hold'em No Limit ($1/$2 USD) - 2016/05/09 17:08:52 CET [2016/05/09 11:08:52 ET]
Table 'Hagar II' 9-max Seat #1 is the button
Seat 1: mojitos86 ($183.23 in chips) 
Seat 2: darren1031 ($179.23 in chips) 
Seat 3: Sasuke777777 ($80 in chips) 
Seat 4: matiko09 ($437.49 in chips) 
Seat 5: PacPacBum ($290.47 in chips) 
Seat 6: el Fatto ($207 in chips) 
Seat 7: Monsthand ($235.97 in chips) 
Seat 9: chaps1988 ($396.47 in chips) 
darren1031: posts small blind $1
Sasuke777777: posts big blind $2
*** HOLE CARDS ***
Dealt to matiko09 [4s 7h]
matiko09: folds 
PacPacBum: folds 
el Fatto: folds 
Monsthand: folds 
chaps1988: folds 
mojitos86: folds 
darren1031: folds 
Uncalled bet ($1) returned to Sasuke777777
Sasuke777777 collected $2 from pot
Sasuke777777: doesn't show hand 
*** SUMMARY ***
Total pot $2 | Rake $0 
Seat 1: mojitos86 (button) folded before Flop (didn't bet)
Seat 2: darren1031 (small blind) folded before Flop
Seat 3: Sasuke777777 (big blind) collected ($2)
Seat 4: matiko09 folded before Flop (didn't bet)
Seat 5: PacPacBum folded before Flop (didn't bet)
Seat 6: el Fatto folded before Flop (didn't bet)
Seat 7: Monsthand folded before Flop (didn't bet)
Seat 9: chaps1988 folded before Flop (didn't bet)





PokerStars Hand #153068507487:  Hold'em No Limit ($0.50/$1.00 USD) - 2016/05/09 17:08:55 CET [2016/05/09 11:08:55 ET]
Table 'Eucharis' 9-max Seat #8 is the button
Seat 1: Spid1 ($108.82 in chips) 
Seat 2: Chef-Zizou ($77.60 in chips) 
Seat 4: matiko09 ($110.57 in chips) 
Seat 5: mycka86 ($170.43 in chips) 
Seat 6: Mukhin1 ($108.68 in chips) 
Seat 7: ThorSun ($68.95 in chips) 
Seat 8: Kukuryzka ($119.03 in chips) 
Spid1: posts small blind $0.50
Chef-Zizou: posts big blind $1
*** HOLE CARDS ***
Dealt to matiko09 [2s 7h]
matiko09: folds 
mycka86: raises $2 to $3
Mukhin1: folds 
ThorSun: folds 
Kukuryzka: folds 
Spid1: folds 
Chef-Zizou: folds 
Uncalled bet ($2) returned to mycka86
mycka86 collected $2.50 from pot
*** SUMMARY ***
Total pot $2.50 | Rake $0 
Seat 1: Spid1 (small blind) folded before Flop
Seat 2: Chef-Zizou (big blind) folded before Flop
Seat 4: matiko09 folded before Flop (didn't bet)
Seat 5: mycka86 collected ($2.50)
Seat 6: Mukhin1 folded before Flop (didn't bet)
Seat 7: ThorSun folded before Flop (didn't bet)
Seat 8: Kukuryzka (button) folded before Flop (didn't bet)





PokerStars Hand #153068509884:  Hold'em No Limit ($1/$2 USD) - 2016/05/09 17:08:59 CET [2016/05/09 11:08:59 ET]
Table 'Titan III' 9-max Seat #3 is the button
Seat 1: I The King I ($276.50 in chips) 
Seat 2: PacPacBum ($200 in chips) 
Seat 3: Spid1 ($442.25 in chips) 
Seat 5: Monsthand ($283.25 in chips) 
Seat 6: matiko09 ($200 in chips) 
Seat 7: seasar1 ($156.48 in chips) 
Seat 8: chaps1988 ($216.77 in chips) 
Seat 9: Sasuke777777 ($166.20 in chips) 
Monsthand: posts small blind $1
matiko09: posts big blind $2
*** HOLE CARDS ***
Dealt to matiko09 [4c 9d]
seasar1: folds 
chaps1988: folds 
Sasuke777777: raises $4 to $6
I The King I: raises $12 to $18
PacPacBum: folds 
Spid1: folds 
Monsthand: folds 
matiko09: folds 
Sasuke777777: raises $39 to $57
I The King I: folds 
Uncalled bet ($39) returned to Sasuke777777
Sasuke777777 collected $39 from pot
Sasuke777777: doesn't show hand 
*** SUMMARY ***
Total pot $39 | Rake $0 
Seat 1: I The King I folded before Flop
Seat 2: PacPacBum folded before Flop (didn't bet)
Seat 3: Spid1 (button) folded before Flop (didn't bet)
Seat 5: Monsthand (small blind) folded before Flop
Seat 6: matiko09 (big blind) folded before Flop
Seat 7: seasar1 folded before Flop (didn't bet)
Seat 8: chaps1988 folded before Flop (didn't bet)
Seat 9: Sasuke777777 collected ($39)





PokerStars Hand #153068509946:  Hold'em No Limit ($1/$2 USD) - 2016/05/09 17:08:59 CET [2016/05/09 11:08:59 ET]
Table 'Celaeno II' 9-max Seat #9 is the button
Seat 1: LRVAV7 ($212.65 in chips) 
Seat 2: PacPacBum ($422.59 in chips) 
Seat 3: CI58 ($200 in chips) 
Seat 4: matiko09 ($426.82 in chips) 
Seat 5: Monsthand ($226.61 in chips) 
Seat 6: Igoriah ($206.52 in chips) 
Seat 7: Mister_b44 ($100 in chips) 
Seat 8: chaps1988 ($224.31 in chips) 
Seat 9: Spid1 ($200 in chips) 
LRVAV7: posts small blind $1
PacPacBum: posts big blind $2
*** HOLE CARDS ***
Dealt to matiko09 [Kc 9d]
CI58: raises $4 to $6
matiko09: folds 
Monsthand: folds 
Igoriah: calls $6
Mister_b44: calls $6
chaps1988: folds 
Spid1: folds 
LRVAV7: folds 
PacPacBum: folds 
*** FLOP *** [As Qd 6c]
CI58: checks 
Igoriah: checks 
Mister_b44: checks 
*** TURN *** [As Qd 6c] [4s]
CI58: checks 
Igoriah: checks 
Mister_b44: checks 
*** RIVER *** [As Qd 6c 4s] [4d]
CI58: checks 
Igoriah: checks 
Mister_b44: checks 
*** SHOW DOWN ***
CI58: shows [8d 8s] (two pair, Eights and Fours)
Igoriah: shows [Ts Tc] (two pair, Tens and Fours)
Mister_b44: mucks hand 
Igoriah collected $19.95 from pot
*** SUMMARY ***
Total pot $21 | Rake $1.05 
Board [As Qd 6c 4s 4d]
Seat 1: LRVAV7 (small blind) folded before Flop
Seat 2: PacPacBum (big blind) folded before Flop
Seat 3: CI58 showed [8d 8s] and lost with two pair, Eights and Fours
Seat 4: matiko09 folded before Flop (didn't bet)
Seat 5: Monsthand folded before Flop (didn't bet)
Seat 6: Igoriah showed [Ts Tc] and won ($19.95) with two pair, Tens and Fours
Seat 7: Mister_b44 mucked [Jh Th]
Seat 8: chaps1988 folded before Flop (didn't bet)
Seat 9: Spid1 (button) folded before Flop (didn't bet)





PokerStars Hand #153068518124:  Hold'em No Limit ($0.50/$1.00 USD) - 2016/05/09 17:09:12 CET [2016/05/09 11:09:12 ET]
Table 'Buryatia II' 9-max Seat #4 is the button
Seat 1: flk.Dasas ($147.44 in chips) 
Seat 4: maxxmeister ($100 in chips) 
Seat 5: amisasi ($93.62 in chips) 
Seat 6: I The King I ($103.50 in chips) 
Seat 8: matiko09 ($126.50 in chips) 
Seat 9: CI58 ($122.21 in chips) 
amisasi: posts small blind $0.50
I The King I: posts big blind $1
*** HOLE CARDS ***
Dealt to matiko09 [Jh 4d]
matiko09: folds 
CI58: folds 
flk.Dasas: folds 
Desperategam leaves the table
Filojoes joins the table at seat #3 
maxxmeister: raises $2 to $3
amisasi: raises $4 to $7
I The King I: calls $6
maxxmeister: calls $4
*** FLOP *** [Ks Qh 7c]
amisasi: bets $9
I The King I: calls $9
maxxmeister: folds 
*** TURN *** [Ks Qh 7c] [Qc]
amisasi: checks 
I The King I: bets $20
amisasi: folds 
Uncalled bet ($20) returned to I The King I
I The King I collected $37.05 from pot
I The King I: doesn't show hand 
*** SUMMARY ***
Total pot $39 | Rake $1.95 
Board [Ks Qh 7c Qc]
Seat 1: flk.Dasas folded before Flop (didn't bet)
Seat 4: maxxmeister (button) folded on the Flop
Seat 5: amisasi (small blind) folded on the Turn
Seat 6: I The King I (big blind) collected ($37.05)
Seat 8: matiko09 folded before Flop (didn't bet)
Seat 9: CI58 folded before Flop (didn't bet)





PokerStars Hand #153068519849:  Hold'em No Limit ($0.50/$1.00 USD) - 2016/05/09 17:09:15 CET [2016/05/09 11:09:15 ET]
Table 'Terpsichore' 9-max Seat #3 is the button
Seat 1: ipashutapkom ($157.37 in chips) 
Seat 2: CI58 ($100 in chips) 
Seat 3: matiko09 ($155.89 in chips) 
Seat 5: mycka86 ($240.86 in chips) 
Seat 6: Filojoes ($100 in chips) 
Seat 7: ozone2003 ($129.13 in chips) 
Seat 8: Kiosk230472 ($120.70 in chips) 
Seat 9: FTPbannedMe ($105 in chips) 
mycka86: posts small blind $0.50
Filojoes: posts big blind $1
*** HOLE CARDS ***
Dealt to matiko09 [7h Td]
ozone2003: raises $2 to $3
Kiosk230472: folds 
FTPbannedMe: calls $3
ipashutapkom: folds 
CI58: folds 
matiko09: folds 
mycka86: folds 
Filojoes: calls $2
*** FLOP *** [6c 6h 7s]
Filojoes: checks 
ozone2003: bets $7
FTPbannedMe: folds 
Filojoes: folds 
Uncalled bet ($7) returned to ozone2003
ozone2003 collected $9.02 from pot
ozone2003: doesn't show hand 
*** SUMMARY ***
Total pot $9.50 | Rake $0.48 
Board [6c 6h 7s]
Seat 1: ipashutapkom folded before Flop (didn't bet)
Seat 2: CI58 folded before Flop (didn't bet)
Seat 3: matiko09 (button) folded before Flop (didn't bet)
Seat 5: mycka86 (small blind) folded before Flop
Seat 6: Filojoes (big blind) folded on the Flop
Seat 7: ozone2003 collected ($9.02)
Seat 8: Kiosk230472 folded before Flop (didn't bet)
Seat 9: FTPbannedMe folded on the Flop





PokerStars Hand #153068521446:  Hold'em No Limit ($0.50/$1.00 USD) - 2016/05/09 17:09:18 CET [2016/05/09 11:09:18 ET]
Table 'Reiss' 9-max Seat #1 is the button
Seat 1: Dickyxxx ($164.66 in chips) 
Seat 2: mycka86 ($187.75 in chips) 
Seat 3: chaps1988 ($115.37 in chips) 
Seat 4: CI58 ($107.10 in chips) 
Seat 5: matiko09 ($113.79 in chips) 
Seat 6: HITYESCA ($100 in chips) 
Seat 8: rusher_NiNja ($100 in chips) 
Seat 9: flyer9898 ($83.92 in chips) 
mycka86: posts small blind $0.50
chaps1988: posts big blind $1
*** HOLE CARDS ***
Dealt to matiko09 [8h Ac]
CI58: folds 
matiko09: folds 
HITYESCA: folds 
rusher_NiNja: folds 
flyer9898: folds 
Dickyxxx: folds 
mycka86: folds 
Uncalled bet ($0.50) returned to chaps1988
chaps1988 collected $1 from pot
chaps1988: doesn't show hand 
*** SUMMARY ***
Total pot $1 | Rake $0 
Seat 1: Dickyxxx (button) folded before Flop (didn't bet)
Seat 2: mycka86 (small blind) folded before Flop
Seat 3: chaps1988 (big blind) collected ($1)
Seat 4: CI58 folded before Flop (didn't bet)
Seat 5: matiko09 folded before Flop (didn't bet)
Seat 6: HITYESCA folded before Flop (didn't bet)
Seat 8: rusher_NiNja folded before Flop (didn't bet)
Seat 9: flyer9898 folded before Flop (didn't bet)





PokerStars Hand #153068522328:  Hold'em No Limit ($1/$2 USD) - 2016/05/09 17:09:19 CET [2016/05/09 11:09:19 ET]
Table 'Hagar II' 9-max Seat #2 is the button
Seat 1: mojitos86 ($183.23 in chips) 
Seat 2: darren1031 ($178.23 in chips) 
Seat 3: Sasuke777777 ($81 in chips) 
Seat 4: matiko09 ($437.49 in chips) 
Seat 5: PacPacBum ($290.47 in chips) 
Seat 6: el Fatto ($207 in chips) 
Seat 7: Monsthand ($235.97 in chips) 
Seat 9: chaps1988 ($396.47 in chips) 
Sasuke777777: posts small blind $1
matiko09: posts big blind $2
*** HOLE CARDS ***
Dealt to matiko09 [5s 6c]
PacPacBum: folds 
el Fatto: folds 
Monsthand: raises $3.40 to $5.40
chaps1988: folds 
mojitos86: calls $5.40
darren1031: folds 
Sasuke777777: raises $12.60 to $18
matiko09: folds 
Monsthand: raises $18 to $36
mojitos86: folds 
Sasuke777777: folds 
Uncalled bet ($18) returned to Monsthand
Monsthand collected $43.40 from pot
Monsthand: doesn't show hand 
*** SUMMARY ***
Total pot $43.40 | Rake $0 
Seat 1: mojitos86 folded before Flop
Seat 2: darren1031 (button) folded before Flop (didn't bet)
Seat 3: Sasuke777777 (small blind) folded before Flop
Seat 4: matiko09 (big blind) folded before Flop
Seat 5: PacPacBum folded before Flop (didn't bet)
Seat 6: el Fatto folded before Flop (didn't bet)
Seat 7: Monsthand collected ($43.40)
Seat 9: chaps1988 folded before Flop (didn't bet)





PokerStars Hand #153068525663:  Hold'em No Limit ($0.50/$1.00 USD) - 2016/05/09 17:09:25 CET [2016/05/09 11:09:25 ET]
Table 'Orthos' 9-max Seat #6 is the button
Seat 1: Kelvin sai ($75.56 in chips) 
Seat 2: PacPacBum ($114.67 in chips) 
Seat 3: Filojoes ($114.54 in chips) 
Seat 5: matiko09 ($104.08 in chips) 
Seat 6: xhinostrabli ($96.83 in chips) 
Seat 7: flk.Dasas ($161.90 in chips) 
Seat 8: Dickyxxx ($106.67 in chips) 
Seat 9: mycka86 ($103.50 in chips) 
flk.Dasas: posts small blind $0.50
Dickyxxx: posts big blind $1
*** HOLE CARDS ***
Dealt to matiko09 [Ad Ks]
mycka86: folds 
Kelvin sai: folds 
PacPacBum: folds 
Filojoes: folds 
matiko09: raises $1.50 to $2.50
xhinostrabli: folds 
flk.Dasas: folds 
Dickyxxx: calls $1.50
*** FLOP *** [Ah 7c 8h]
Dickyxxx: checks 
matiko09: bets $3.39
Dickyxxx: folds 
Uncalled bet ($3.39) returned to matiko09
matiko09 collected $5.22 from pot
matiko09: doesn't show hand 
*** SUMMARY ***
Total pot $5.50 | Rake $0.28 
Board [Ah 7c 8h]
Seat 1: Kelvin sai folded before Flop (didn't bet)
Seat 2: PacPacBum folded before Flop (didn't bet)
Seat 3: Filojoes folded before Flop (didn't bet)
Seat 5: matiko09 collected ($5.22)
Seat 6: xhinostrabli (button) folded before Flop (didn't bet)
Seat 7: flk.Dasas (small blind) folded before Flop
Seat 8: Dickyxxx (big blind) folded on the Flop
Seat 9: mycka86 folded before Flop (didn't bet)





PokerStars Hand #153068534528:  Hold'em No Limit ($1/$2 USD) - 2016/05/09 17:09:39 CET [2016/05/09 11:09:39 ET]
Table 'Titan III' 9-max Seat #5 is the button
Seat 1: I The King I ($258.50 in chips) 
Seat 2: PacPacBum ($200 in chips) 
Seat 3: Spid1 ($442.25 in chips) 
Seat 5: Monsthand ($282.25 in chips) 
Seat 6: matiko09 ($200 in chips) 
Seat 7: seasar1 ($156.48 in chips) 
Seat 8: chaps1988 ($216.77 in chips) 
Seat 9: Sasuke777777 ($187.20 in chips) 
matiko09: posts small blind $1
seasar1: posts big blind $2
*** HOLE CARDS ***
Dealt to matiko09 [7s Kd]
chaps1988: folds 
Sasuke777777: raises $6 to $8
I The King I: folds 
PacPacBum: folds 
Spid1: folds 
Monsthand: folds 
matiko09: folds 
seasar1: folds 
Uncalled bet ($6) returned to Sasuke777777
Sasuke777777 collected $5 from pot
Sasuke777777: doesn't show hand 
*** SUMMARY ***
Total pot $5 | Rake $0 
Seat 1: I The King I folded before Flop (didn't bet)
Seat 2: PacPacBum folded before Flop (didn't bet)
Seat 3: Spid1 folded before Flop (didn't bet)
Seat 5: Monsthand (button) folded before Flop (didn't bet)
Seat 6: matiko09 (small blind) folded before Flop
Seat 7: seasar1 (big blind) folded before Flop
Seat 8: chaps1988 folded before Flop (didn't bet)
Seat 9: Sasuke777777 collected ($5)





PokerStars Hand #153068536065:  Hold'em No Limit ($0.50/$1.00 USD) - 2016/05/09 17:09:42 CET [2016/05/09 11:09:42 ET]
Table 'Eucharis' 9-max Seat #1 is the button
Seat 1: Spid1 ($108.32 in chips) 
Seat 2: Chef-Zizou ($76.60 in chips) 
Seat 4: matiko09 ($110.57 in chips) 
Seat 5: mycka86 ($171.93 in chips) 
Seat 6: Mukhin1 ($108.68 in chips) 
Seat 7: ThorSun ($68.95 in chips) 
Seat 8: Kukuryzka ($119.03 in chips) 
Chef-Zizou: posts small blind $0.50
matiko09: posts big blind $1
*** HOLE CARDS ***
Dealt to matiko09 [Qs Jd]
mycka86: folds 
Mukhin1: folds 
ThorSun: raises $1 to $2
Kukuryzka: folds 
Spid1: folds 
Chef-Zizou: folds 
matiko09: calls $1
*** FLOP *** [Ac 3h 8h]
matiko09: checks 
ThorSun: bets $4
matiko09: folds 
Uncalled bet ($4) returned to ThorSun
ThorSun collected $4.28 from pot
ThorSun: doesn't show hand 
*** SUMMARY ***
Total pot $4.50 | Rake $0.22 
Board [Ac 3h 8h]
Seat 1: Spid1 (button) folded before Flop (didn't bet)
Seat 2: Chef-Zizou (small blind) folded before Flop
Seat 4: matiko09 (big blind) folded on the Flop
Seat 5: mycka86 folded before Flop (didn't bet)
Seat 6: Mukhin1 folded before Flop (didn't bet)
Seat 7: ThorSun collected ($4.28)
Seat 8: Kukuryzka folded before Flop (didn't bet)





PokerStars Hand #153068536967:  Hold'em No Limit ($0.50/$1.00 USD) - 2016/05/09 17:09:43 CET [2016/05/09 11:09:43 ET]
Table 'Reiss' 9-max Seat #2 is the button
Seat 1: Dickyxxx ($164.66 in chips) 
Seat 2: mycka86 ($187.25 in chips) 
Seat 3: chaps1988 ($115.87 in chips) 
Seat 4: CI58 ($107.10 in chips) 
Seat 5: matiko09 ($113.79 in chips) 
Seat 6: HITYESCA ($100 in chips) 
Seat 8: rusher_NiNja ($100 in chips) 
Seat 9: flyer9898 ($83.92 in chips) 
chaps1988: posts small blind $0.50
CI58: posts big blind $1
*** HOLE CARDS ***
Dealt to matiko09 [6c Qc]
matiko09: folds 
HITYESCA: folds 
rusher_NiNja: folds 
flyer9898: raises $1 to $2
Dickyxxx: folds 
mycka86: folds 
chaps1988: folds 
CI58: calls $1
*** FLOP *** [9s 2c As]
CI58: checks 
flyer9898: checks 
*** TURN *** [9s 2c As] [8h]
CI58: bets $2.56
flyer9898: calls $2.56
*** RIVER *** [9s 2c As 8h] [8c]
CI58: checks 
flyer9898: checks 
*** SHOW DOWN ***
CI58: shows [7h 6s] (a pair of Eights)
flyer9898: shows [Qd Jd] (a pair of Eights - Ace+Queen kicker)
flyer9898 collected $9.14 from pot
*** SUMMARY ***
Total pot $9.62 | Rake $0.48 
Board [9s 2c As 8h 8c]
Seat 1: Dickyxxx folded before Flop (didn't bet)
Seat 2: mycka86 (button) folded before Flop (didn't bet)
Seat 3: chaps1988 (small blind) folded before Flop
Seat 4: CI58 (big blind) showed [7h 6s] and lost with a pair of Eights
Seat 5: matiko09 folded before Flop (didn't bet)
Seat 6: HITYESCA folded before Flop (didn't bet)
Seat 8: rusher_NiNja folded before Flop (didn't bet)
Seat 9: flyer9898 showed [Qd Jd] and won ($9.14) with a pair of Eights





PokerStars Hand #153068541746:  Hold'em No Limit ($1/$2 USD) - 2016/05/09 17:09:51 CET [2016/05/09 11:09:51 ET]
Table 'Celaeno II' 9-max Seat #1 is the button
Seat 1: LRVAV7 ($211.65 in chips) 
Seat 2: PacPacBum ($420.59 in chips) 
Seat 3: CI58 ($200 in chips) 
Seat 4: matiko09 ($426.82 in chips) 
Seat 5: Monsthand ($226.61 in chips) 
Seat 6: Igoriah ($220.47 in chips) 
Seat 7: Mister_b44 ($94 in chips) 
Seat 8: chaps1988 ($224.31 in chips) 
Seat 9: Spid1 ($200 in chips) 
PacPacBum: posts small blind $1
CI58: posts big blind $2
*** HOLE CARDS ***
Dealt to matiko09 [9s Td]
matiko09: folds 
Monsthand: folds 
Igoriah: folds 
Mister_b44: raises $4 to $6
chaps1988: folds 
Spid1: folds 
LRVAV7: folds 
PacPacBum: folds 
CI58: folds 
Uncalled bet ($4) returned to Mister_b44
Mister_b44 collected $5 from pot
Mister_b44: doesn't show hand 
*** SUMMARY ***
Total pot $5 | Rake $0 
Seat 1: LRVAV7 (button) folded before Flop (didn't bet)
Seat 2: PacPacBum (small blind) folded before Flop
Seat 3: CI58 (big blind) folded before Flop
Seat 4: matiko09 folded before Flop (didn't bet)
Seat 5: Monsthand folded before Flop (didn't bet)
Seat 6: Igoriah folded before Flop (didn't bet)
Seat 7: Mister_b44 collected ($5)
Seat 8: chaps1988 folded before Flop (didn't bet)
Seat 9: Spid1 folded before Flop (didn't bet)





PokerStars Hand #153068549104:  Hold'em No Limit ($0.50/$1.00 USD) - 2016/05/09 17:10:03 CET [2016/05/09 11:10:03 ET]
Table 'Eucharis' 9-max Seat #2 is the button
Seat 1: Spid1 ($108.32 in chips) 
Seat 2: Chef-Zizou ($76.10 in chips) 
Seat 4: matiko09 ($108.57 in chips) 
Seat 5: mycka86 ($171.93 in chips) 
Seat 6: Mukhin1 ($108.68 in chips) 
Seat 7: ThorSun ($71.23 in chips) 
Seat 8: Kukuryzka ($119.03 in chips) 
matiko09: posts small blind $0.50
mycka86: posts big blind $1
*** HOLE CARDS ***
Dealt to matiko09 [4c 9c]
Mukhin1: folds 
ThorSun: raises $1 to $2
Kukuryzka: folds 
Spid1: folds 
Chef-Zizou has timed out
Chef-Zizou: folds 
matiko09: folds 
mycka86: calls $1
*** FLOP *** [3c Ac Qs]
mycka86: checks 
ThorSun: bets $3
mycka86: raises $3.59 to $6.59
ThorSun: calls $3.59
*** TURN *** [3c Ac Qs] [Ah]
mycka86: checks 
ThorSun: checks 
*** RIVER *** [3c Ac Qs Ah] [6h]
mycka86: checks 
ThorSun: checks 
*** SHOW DOWN ***
mycka86: shows [Kd Tc] (a pair of Aces)
ThorSun: shows [2h 2c] (two pair, Aces and Deuces)
ThorSun collected $16.80 from pot
*** SUMMARY ***
Total pot $17.68 | Rake $0.88 
Board [3c Ac Qs Ah 6h]
Seat 1: Spid1 folded before Flop (didn't bet)
Seat 2: Chef-Zizou (button) folded before Flop (didn't bet)
Seat 4: matiko09 (small blind) folded before Flop
Seat 5: mycka86 (big blind) showed [Kd Tc] and lost with a pair of Aces
Seat 6: Mukhin1 folded before Flop (didn't bet)
Seat 7: ThorSun showed [2h 2c] and won ($16.80) with two pair, Aces and Deuces
Seat 8: Kukuryzka folded before Flop (didn't bet)





PokerStars Hand #153068550779:  Hold'em No Limit ($1/$2 USD) - 2016/05/09 17:10:05 CET [2016/05/09 11:10:05 ET]
Table 'Titan III' 9-max Seat #6 is the button
Seat 1: I The King I ($258.50 in chips) 
Seat 2: PacPacBum ($200 in chips) 
Seat 3: Spid1 ($442.25 in chips) 
Seat 5: Monsthand ($282.25 in chips) 
Seat 6: matiko09 ($200 in chips) 
Seat 7: seasar1 ($154.48 in chips) 
Seat 8: chaps1988 ($216.77 in chips) 
Seat 9: Sasuke777777 ($190.20 in chips) 
seasar1: posts small blind $1
chaps1988: posts big blind $2
*** HOLE CARDS ***
Dealt to matiko09 [9c Th]
Sasuke777777: raises $4 to $6
I The King I: folds 
PacPacBum: folds 
Spid1: folds 
Monsthand: calls $6
matiko09: folds 
seasar1: folds 
chaps1988: folds 
*** FLOP *** [Jh 2c 4c]
Sasuke777777: bets $12
Monsthand: folds 
Uncalled bet ($12) returned to Sasuke777777
Sasuke777777 collected $14.25 from pot
Sasuke777777: doesn't show hand 
*** SUMMARY ***
Total pot $15 | Rake $0.75 
Board [Jh 2c 4c]
Seat 1: I The King I folded before Flop (didn't bet)
Seat 2: PacPacBum folded before Flop (didn't bet)
Seat 3: Spid1 folded before Flop (didn't bet)
Seat 5: Monsthand folded on the Flop
Seat 6: matiko09 (button) folded before Flop (didn't bet)
Seat 7: seasar1 (small blind) folded before Flop
Seat 8: chaps1988 (big blind) folded before Flop
Seat 9: Sasuke777777 collected ($14.25)





PokerStars Hand #153068553122:  Hold'em No Limit ($0.50/$1.00 USD) - 2016/05/09 17:10:09 CET [2016/05/09 11:10:09 ET]
Table 'Orthos' 9-max Seat #7 is the button
Seat 1: Kelvin sai ($75.56 in chips) 
Seat 2: PacPacBum ($114.67 in chips) 
Seat 3: Filojoes ($114.54 in chips) 
Seat 5: matiko09 ($106.80 in chips) 
Seat 6: xhinostrabli ($96.83 in chips) 
Seat 7: flk.Dasas ($161.40 in chips) 
Seat 8: Dickyxxx ($104.17 in chips) 
Seat 9: mycka86 ($103.50 in chips) 
Dickyxxx: posts small blind $0.50
mycka86: posts big blind $1
*** HOLE CARDS ***
Dealt to matiko09 [8h 8s]
Kelvin sai: folds 
PacPacBum: folds 
Filojoes: folds 
matiko09: raises $2 to $3
xhinostrabli: folds 
flk.Dasas: folds 
Dickyxxx: folds 
mycka86: calls $2
*** FLOP *** [Qc 3d 7h]
mycka86: checks 
matiko09: checks 
*** TURN *** [Qc 3d 7h] [Tc]
mycka86: bets $4.50
matiko09: folds 
Uncalled bet ($4.50) returned to mycka86
mycka86 collected $6.18 from pot
*** SUMMARY ***
Total pot $6.50 | Rake $0.32 
Board [Qc 3d 7h Tc]
Seat 1: Kelvin sai folded before Flop (didn't bet)
Seat 2: PacPacBum folded before Flop (didn't bet)
Seat 3: Filojoes folded before Flop (didn't bet)
Seat 5: matiko09 folded on the Turn
Seat 6: xhinostrabli folded before Flop (didn't bet)
Seat 7: flk.Dasas (button) folded before Flop (didn't bet)
Seat 8: Dickyxxx (small blind) folded before Flop
Seat 9: mycka86 (big blind) collected ($6.18)





PokerStars Hand #153068555291:  Hold'em No Limit ($0.50/$1.00 USD) - 2016/05/09 17:10:12 CET [2016/05/09 11:10:12 ET]
Table 'Terpsichore' 9-max Seat #5 is the button
Seat 1: ipashutapkom ($157.37 in chips) 
Seat 2: CI58 ($100 in chips) 
Seat 3: matiko09 ($155.89 in chips) 
Seat 5: mycka86 ($240.36 in chips) 
Seat 6: Filojoes ($100 in chips) 
Seat 8: Kiosk230472 ($120.70 in chips) 
Seat 9: FTPbannedMe ($102 in chips) 
Filojoes: posts small blind $0.50
ozone2003: is sitting out 
Kiosk230472: posts big blind $1
*** HOLE CARDS ***
Dealt to matiko09 [6h 3h]
ozone2003 leaves the table
Kukuryzka joins the table at seat #7 
FTPbannedMe: folds 
FTPbannedMe leaves the table
ipashutapkom: folds 
CI58: folds 
matiko09: folds 
mycka86: folds 
flk.Dasas joins the table at seat #9 
Filojoes: raises $1.50 to $2.50
Kiosk230472: calls $1.50
*** FLOP *** [7h 9c 7s]
Filojoes: checks 
Kiosk230472: checks 
*** TURN *** [7h 9c 7s] [5d]
Filojoes: checks 
Kiosk230472: checks 
*** RIVER *** [7h 9c 7s 5d] [Qh]
Filojoes: checks 
Kiosk230472: checks 
*** SHOW DOWN ***
Filojoes: shows [Ah 4d] (a pair of Sevens)
Kiosk230472: shows [Qc 8c] (two pair, Queens and Sevens)
Kiosk230472 collected $4.75 from pot
*** SUMMARY ***
Total pot $5 | Rake $0.25 
Board [7h 9c 7s 5d Qh]
Seat 1: ipashutapkom folded before Flop (didn't bet)
Seat 2: CI58 folded before Flop (didn't bet)
Seat 3: matiko09 folded before Flop (didn't bet)
Seat 5: mycka86 (button) folded before Flop (didn't bet)
Seat 6: Filojoes (small blind) showed [Ah 4d] and lost with a pair of Sevens
Seat 8: Kiosk230472 (big blind) showed [Qc 8c] and won ($4.75) with two pair, Queens and Sevens
Seat 9: FTPbannedMe folded before Flop (didn't bet)





PokerStars Hand #153068559319:  Hold'em No Limit ($1/$2 USD) - 2016/05/09 17:10:19 CET [2016/05/09 11:10:19 ET]
Table 'Hagar II' 9-max Seat #3 is the button
Seat 1: mojitos86 ($177.83 in chips) 
Seat 2: darren1031 ($178.23 in chips) 
Seat 3: Sasuke777777 ($63 in chips) 
Seat 4: matiko09 ($435.49 in chips) 
Seat 5: PacPacBum ($290.47 in chips) 
Seat 6: el Fatto ($207 in chips) 
Seat 7: Monsthand ($261.37 in chips) 
Seat 9: chaps1988 ($396.47 in chips) 
matiko09: posts small blind $1
PacPacBum: posts big blind $2
*** HOLE CARDS ***
Dealt to matiko09 [4h Ad]
el Fatto: folds 
Monsthand: folds 
chaps1988: folds 
mojitos86: raises $4 to $6
darren1031: folds 
Sasuke777777: calls $6
matiko09: folds 
PacPacBum: calls $4
*** FLOP *** [Ks 8d Js]
PacPacBum: checks 
mojitos86: checks 
Sasuke777777: bets $10
PacPacBum: folds 
mojitos86: folds 
Uncalled bet ($10) returned to Sasuke777777
Sasuke777777 collected $18.05 from pot
Sasuke777777: doesn't show hand 
*** SUMMARY ***
Total pot $19 | Rake $0.95 
Board [Ks 8d Js]
Seat 1: mojitos86 folded on the Flop
Seat 2: darren1031 folded before Flop (didn't bet)
Seat 3: Sasuke777777 (button) collected ($18.05)
Seat 4: matiko09 (small blind) folded before Flop
Seat 5: PacPacBum (big blind) folded on the Flop
Seat 6: el Fatto folded before Flop (didn't bet)
Seat 7: Monsthand folded before Flop (didn't bet)
Seat 9: chaps1988 folded before Flop (didn't bet)





PokerStars Hand #153068567290:  Hold'em No Limit ($1/$2 USD) - 2016/05/09 17:10:32 CET [2016/05/09 11:10:32 ET]
Table 'Celaeno II' 9-max Seat #2 is the button
Seat 1: LRVAV7 ($211.65 in chips) 
Seat 2: PacPacBum ($419.59 in chips) 
Seat 3: CI58 ($200 in chips) 
Seat 4: matiko09 ($426.82 in chips) 
Seat 5: Monsthand ($226.61 in chips) 
Seat 6: Igoriah ($220.47 in chips) 
Seat 7: Mister_b44 ($97 in chips) 
Seat 8: chaps1988 ($224.31 in chips) 
Seat 9: Spid1 ($200 in chips) 
CI58: posts small blind $1
matiko09: posts big blind $2
*** HOLE CARDS ***
Dealt to matiko09 [5d 4h]
Monsthand: folds 
Igoriah: folds 
Mister_b44: raises $4 to $6
chaps1988: folds 
Spid1: calls $6
LRVAV7: folds 
PacPacBum: folds 
CI58: folds 
matiko09: folds 
*** FLOP *** [8d Th 3h]
Mister_b44: bets $12
Spid1: calls $12
*** TURN *** [8d Th 3h] [3c]
Mister_b44: bets $37.05
Spid1: raises $60.95 to $98
Mister_b44: calls $41.95 and is all-in
Uncalled bet ($19) returned to Spid1
*** FIRST RIVER *** [8d Th 3h 3c] [4c]
*** SECOND RIVER *** [8d Th 3h 3c] [8h]
*** FIRST SHOW DOWN ***
Mister_b44: shows [Ac Td] (two pair, Tens and Threes)
Spid1: shows [Js Jd] (two pair, Jacks and Threes)
Spid1 collected $97.13 from pot
*** SECOND SHOW DOWN ***
Mister_b44: shows [Ac Td] (two pair, Tens and Eights)
Spid1: shows [Js Jd] (two pair, Jacks and Eights)
Spid1 collected $97.12 from pot
*** SUMMARY ***
Total pot $197 | Rake $2.75 
Hand was run twice
FIRST Board [8d Th 3h 3c 4c]
SECOND Board [8d Th 3h 3c 8h]
Seat 1: LRVAV7 folded before Flop (didn't bet)
Seat 2: PacPacBum (button) folded before Flop (didn't bet)
Seat 3: CI58 (small blind) folded before Flop
Seat 4: matiko09 (big blind) folded before Flop
Seat 5: Monsthand folded before Flop (didn't bet)
Seat 6: Igoriah folded before Flop (didn't bet)
Seat 7: Mister_b44 showed [Ac Td] and lost with two pair, Tens and Threes, and lost with two pair, Tens and Eights
Seat 8: chaps1988 folded before Flop (didn't bet)
Seat 9: Spid1 showed [Js Jd] and won ($97.13) with two pair, Jacks and Threes, and won ($97.12) with two pair, Jacks and Eights





PokerStars Hand #153068573914:  Hold'em No Limit ($1/$2 USD) - 2016/05/09 17:10:42 CET [2016/05/09 11:10:42 ET]
Table 'Titan III' 9-max Seat #7 is the button
Seat 1: I The King I ($258.50 in chips) 
Seat 2: PacPacBum ($200 in chips) 
Seat 3: Spid1 ($442.25 in chips) 
Seat 5: Monsthand ($276.25 in chips) 
Seat 6: matiko09 ($200 in chips) 
Seat 7: seasar1 ($153.48 in chips) 
Seat 8: chaps1988 ($214.77 in chips) 
Seat 9: Sasuke777777 ($198.45 in chips) 
chaps1988: posts small blind $1
Sasuke777777: posts big blind $2
*** HOLE CARDS ***
Dealt to matiko09 [Ac Ts]
I The King I: folds 
PacPacBum: folds 
Spid1: raises $4 to $6
Monsthand: folds 
matiko09: calls $6
seasar1: calls $6
chaps1988: folds 
Sasuke777777: folds 
*** FLOP *** [2s 6d Ah]
Spid1: bets $14
matiko09: calls $14
seasar1: folds 
*** TURN *** [2s 6d Ah] [5c]
Spid1: checks 
matiko09: checks 
*** RIVER *** [2s 6d Ah 5c] [4h]
Spid1: bets $29
matiko09: folds 
Uncalled bet ($29) returned to Spid1
Spid1 collected $46.55 from pot
Spid1: doesn't show hand 
*** SUMMARY ***
Total pot $49 | Rake $2.45 
Board [2s 6d Ah 5c 4h]
Seat 1: I The King I folded before Flop (didn't bet)
Seat 2: PacPacBum folded before Flop (didn't bet)
Seat 3: Spid1 collected ($46.55)
Seat 5: Monsthand folded before Flop (didn't bet)
Seat 6: matiko09 folded on the River
Seat 7: seasar1 (button) folded on the Flop
Seat 8: chaps1988 (small blind) folded before Flop
Seat 9: Sasuke777777 (big blind) folded before Flop





PokerStars Hand #153068586540:  Hold'em No Limit ($0.50/$1.00 USD) - 2016/05/09 17:11:03 CET [2016/05/09 11:11:03 ET]
Table 'Reiss' 9-max Seat #3 is the button
Seat 1: Dickyxxx ($164.66 in chips) 
Seat 2: mycka86 ($187.25 in chips) 
Seat 3: chaps1988 ($115.37 in chips) 
Seat 4: CI58 ($102.54 in chips) 
Seat 5: matiko09 ($113.79 in chips) 
Seat 6: HITYESCA ($100 in chips) 
Seat 8: rusher_NiNja ($100 in chips) 
Seat 9: flyer9898 ($88.50 in chips) 
CI58: posts small blind $0.50
matiko09: posts big blind $1
*** HOLE CARDS ***
Dealt to matiko09 [Ks Qc]
HITYESCA: folds 
rusher_NiNja: folds 
flyer9898: folds 
Dickyxxx: folds 
mycka86: folds 
chaps1988: raises $1 to $2
CI58: folds 
matiko09: raises $6 to $8
chaps1988: folds 
Uncalled bet ($6) returned to matiko09
matiko09 collected $4.50 from pot
matiko09: doesn't show hand 
*** SUMMARY ***
Total pot $4.50 | Rake $0 
Seat 1: Dickyxxx folded before Flop (didn't bet)
Seat 2: mycka86 folded before Flop (didn't bet)
Seat 3: chaps1988 (button) folded before Flop
Seat 4: CI58 (small blind) folded before Flop
Seat 5: matiko09 (big blind) collected ($4.50)
Seat 6: HITYESCA folded before Flop (didn't bet)
Seat 8: rusher_NiNja folded before Flop (didn't bet)
Seat 9: flyer9898 folded before Flop (didn't bet)





PokerStars Hand #153068588699:  Hold'em No Limit ($0.50/$1.00 USD) - 2016/05/09 17:11:06 CET [2016/05/09 11:11:06 ET]
Table 'Buryatia II' 9-max Seat #5 is the button
Seat 1: flk.Dasas ($147.44 in chips) 
Seat 4: maxxmeister ($100 in chips) 
Seat 5: amisasi ($77.62 in chips) 
Seat 6: I The King I ($124.55 in chips) 
Seat 8: matiko09 ($126.50 in chips) 
Seat 9: CI58 ($122.21 in chips) 
I The King I: posts small blind $0.50
nubpoker was removed from the table for failing to post
matiko09: posts big blind $1
Filojoes: sits out 
*** HOLE CARDS ***
Dealt to matiko09 [Jd Th]
CI58: folds 
flk.Dasas: folds 
HITYESCA joins the table at seat #7 
maxxmeister: raises $2.50 to $3.50
amisasi: folds 
I The King I: folds 
matiko09: folds 
Uncalled bet ($2.50) returned to maxxmeister
maxxmeister collected $2.50 from pot
maxxmeister: doesn't show hand 
*** SUMMARY ***
Total pot $2.50 | Rake $0 
Seat 1: flk.Dasas folded before Flop (didn't bet)
Seat 4: maxxmeister collected ($2.50)
Seat 5: amisasi (button) folded before Flop (didn't bet)
Seat 6: I The King I (small blind) folded before Flop
Seat 8: matiko09 (big blind) folded before Flop
Seat 9: CI58 folded before Flop (didn't bet)





PokerStars Hand #153068590997:  Hold'em No Limit ($0.50/$1.00 USD) - 2016/05/09 17:11:10 CET [2016/05/09 11:11:10 ET]
Table 'Terpsichore' 9-max Seat #6 is the button
Seat 1: ipashutapkom ($157.37 in chips) 
Seat 2: CI58 ($100 in chips) 
Seat 3: matiko09 ($155.89 in chips) 
Seat 5: mycka86 ($240.36 in chips) 
Seat 6: Filojoes ($100 in chips) 
Seat 8: Kiosk230472 ($122.95 in chips) 
Kukuryzka will be allowed to play after the button
Kiosk230472: posts small blind $0.50
ipashutapkom: posts big blind $1
*** HOLE CARDS ***
Dealt to matiko09 [9c Ts]
CI58: folds 
matiko09: folds 
mycka86: raises $1.10 to $2.10
Filojoes: folds 
Kiosk230472: folds 
ipashutapkom: folds 
Uncalled bet ($1.10) returned to mycka86
mycka86 collected $2.50 from pot
*** SUMMARY ***
Total pot $2.50 | Rake $0 
Seat 1: ipashutapkom (big blind) folded before Flop
Seat 2: CI58 folded before Flop (didn't bet)
Seat 3: matiko09 folded before Flop (didn't bet)
Seat 5: mycka86 collected ($2.50)
Seat 6: Filojoes (button) folded before Flop (didn't bet)
Seat 8: Kiosk230472 (small blind) folded before Flop





PokerStars Hand #153068592735:  Hold'em No Limit ($0.50/$1.00 USD) - 2016/05/09 17:11:13 CET [2016/05/09 11:11:13 ET]
Table 'Orthos' 9-max Seat #8 is the button
Seat 1: Kelvin sai ($75.56 in chips) 
Seat 2: PacPacBum ($114.67 in chips) 
Seat 3: Filojoes ($114.54 in chips) 
Seat 5: matiko09 ($103.80 in chips) 
Seat 6: xhinostrabli ($96.83 in chips) 
Seat 7: flk.Dasas ($161.40 in chips) 
Seat 8: Dickyxxx ($103.67 in chips) 
Seat 9: mycka86 ($106.68 in chips) 
mycka86: posts small blind $0.50
Kelvin sai: posts big blind $1
*** HOLE CARDS ***
Dealt to matiko09 [Qc Tc]
PacPacBum: folds 
Filojoes: raises $2 to $3
matiko09: folds 
xhinostrabli: folds 
flk.Dasas: folds 
Dickyxxx: folds 
mycka86: folds 
Kelvin sai: folds 
Uncalled bet ($2) returned to Filojoes
Filojoes collected $2.50 from pot
Filojoes: doesn't show hand 
*** SUMMARY ***
Total pot $2.50 | Rake $0 
Seat 1: Kelvin sai (big blind) folded before Flop
Seat 2: PacPacBum folded before Flop (didn't bet)
Seat 3: Filojoes collected ($2.50)
Seat 5: matiko09 folded before Flop (didn't bet)
Seat 6: xhinostrabli folded before Flop (didn't bet)
Seat 7: flk.Dasas folded before Flop (didn't bet)
Seat 8: Dickyxxx (button) folded before Flop (didn't bet)
Seat 9: mycka86 (small blind) folded before Flop





PokerStars Hand #153068594338:  Hold'em No Limit ($1/$2 USD) - 2016/05/09 17:11:15 CET [2016/05/09 11:11:15 ET]
Table 'Hagar II' 9-max Seat #4 is the button
Seat 1: mojitos86 ($171.83 in chips) 
Seat 2: darren1031 ($178.23 in chips) 
Seat 3: Sasuke777777 ($75.05 in chips) 
Seat 4: matiko09 ($434.49 in chips) 
Seat 5: PacPacBum ($284.47 in chips) 
Seat 6: el Fatto ($207 in chips) 
Seat 7: Monsthand ($261.37 in chips) 
Seat 9: chaps1988 ($396.47 in chips) 
PacPacBum: posts small blind $1
el Fatto: posts big blind $2
*** HOLE CARDS ***
Dealt to matiko09 [Ts 8d]
Monsthand: folds 
chaps1988: folds 
mojitos86: folds 
darren1031: raises $4 to $6
Sasuke777777: calls $6
matiko09: folds 
PacPacBum: folds 
el Fatto: folds 
*** FLOP *** [9d 3c Kh]
darren1031: bets $14.25
Sasuke777777: raises $54.80 to $69.05 and is all-in
darren1031: folds 
Uncalled bet ($54.80) returned to Sasuke777777
Sasuke777777 collected $41.32 from pot
Sasuke777777: doesn't show hand 
*** SUMMARY ***
Total pot $43.50 | Rake $2.18 
Board [9d 3c Kh]
Seat 1: mojitos86 folded before Flop (didn't bet)
Seat 2: darren1031 folded on the Flop
Seat 3: Sasuke777777 collected ($41.32)
Seat 4: matiko09 (button) folded before Flop (didn't bet)
Seat 5: PacPacBum (small blind) folded before Flop
Seat 6: el Fatto (big blind) folded before Flop
Seat 7: Monsthand folded before Flop (didn't bet)
Seat 9: chaps1988 folded before Flop (didn't bet)





PokerStars Hand #153068600782:  Hold'em No Limit ($1/$2 USD) - 2016/05/09 17:11:26 CET [2016/05/09 11:11:26 ET]
Table 'Titan III' 9-max Seat #8 is the button
Seat 1: I The King I ($258.50 in chips) 
Seat 2: PacPacBum ($200 in chips) 
Seat 3: Spid1 ($468.80 in chips) 
Seat 5: Monsthand ($276.25 in chips) 
Seat 6: matiko09 ($200 in chips) 
Seat 7: seasar1 ($147.48 in chips) 
Seat 8: chaps1988 ($213.77 in chips) 
Seat 9: Sasuke777777 ($196.45 in chips) 
Sasuke777777: posts small blind $1
I The King I: posts big blind $2
*** HOLE CARDS ***
Dealt to matiko09 [4d 9c]
PacPacBum: folds 
Spid1: folds 
Monsthand: folds 
matiko09: folds 
seasar1: folds 
chaps1988: folds 
Sasuke777777: folds 
Uncalled bet ($1) returned to I The King I
I The King I collected $2 from pot
I The King I: doesn't show hand 
*** SUMMARY ***
Total pot $2 | Rake $0 
Seat 1: I The King I (big blind) collected ($2)
Seat 2: PacPacBum folded before Flop (didn't bet)
Seat 3: Spid1 folded before Flop (didn't bet)
Seat 5: Monsthand folded before Flop (didn't bet)
Seat 6: matiko09 folded before Flop (didn't bet)
Seat 7: seasar1 folded before Flop (didn't bet)
Seat 8: chaps1988 (button) folded before Flop (didn't bet)
Seat 9: Sasuke777777 (small blind) folded before Flop





PokerStars Hand #153068605099:  Hold'em No Limit ($0.50/$1.00 USD) - 2016/05/09 17:11:33 CET [2016/05/09 11:11:33 ET]
Table 'Buryatia II' 9-max Seat #6 is the button
Seat 1: flk.Dasas ($147.44 in chips) 
Seat 4: maxxmeister ($101.50 in chips) 
Seat 5: amisasi ($77.62 in chips) 
Seat 6: I The King I ($124.05 in chips) 
Seat 8: matiko09 ($125.50 in chips) 
Seat 9: CI58 ($122.21 in chips) 
HITYESCA will be allowed to play after the button
matiko09: posts small blind $0.50
CI58: posts big blind $1
Filojoes: sits out 
*** HOLE CARDS ***
Dealt to matiko09 [Qs Kc]
flk.Dasas: raises $2 to $3
maxxmeister: raises $7.50 to $10.50
amisasi: calls $10.50
I The King I: folds 
matiko09: folds 
CI58: folds 
flk.Dasas: calls $7.50
*** FLOP *** [Ts 3d Ks]
flk.Dasas: checks 
maxxmeister: checks 
amisasi: bets $15.67
flk.Dasas: folds 
maxxmeister: calls $15.67
*** TURN *** [Ts 3d Ks] [Tc]
maxxmeister: checks 
amisasi: bets $30.92
maxxmeister: calls $30.92
*** RIVER *** [Ts 3d Ks Tc] [2h]
maxxmeister: checks 
amisasi: bets $20.53 and is all-in
maxxmeister: calls $20.53
*** SHOW DOWN ***
amisasi: shows [Kd As] (two pair, Kings and Tens)
maxxmeister: mucks hand 
amisasi collected $164.74 from pot
*** SUMMARY ***
Total pot $167.24 | Rake $2.50 
Board [Ts 3d Ks Tc 2h]
Seat 1: flk.Dasas folded on the Flop
Seat 4: maxxmeister mucked [Kh Jh]
Seat 5: amisasi showed [Kd As] and won ($164.74) with two pair, Kings and Tens
Seat 6: I The King I (button) folded before Flop (didn't bet)
Seat 8: matiko09 (small blind) folded before Flop
Seat 9: CI58 (big blind) folded before Flop





PokerStars Hand #153068607848:  Hold'em No Limit ($0.50/$1.00 USD) - 2016/05/09 17:11:37 CET [2016/05/09 11:11:37 ET]
Table 'Terpsichore' 9-max Seat #8 is the button
Seat 1: ipashutapkom ($156.37 in chips) 
Seat 2: CI58 ($100 in chips) 
Seat 3: matiko09 ($155.89 in chips) 
Seat 5: mycka86 ($241.86 in chips) 
Seat 6: Filojoes ($100 in chips) 
Seat 8: Kiosk230472 ($122.45 in chips) 
ipashutapkom: posts small blind $0.50
CI58: posts big blind $1
nubpoker: sits out 
Kukuryzka: sits out 
*** HOLE CARDS ***
Dealt to matiko09 [4h Kd]
matiko09: folds 
mycka86: folds 
Filojoes: raises $1.50 to $2.50
Kiosk230472: calls $2.50
ipashutapkom: calls $2
CI58: folds 
*** FLOP *** [Qh 4d Js]
ipashutapkom: checks 
Filojoes: checks 
Kiosk230472: bets $4
ipashutapkom: folds 
Filojoes: folds 
Uncalled bet ($4) returned to Kiosk230472
Kiosk230472 collected $8.08 from pot
Kiosk230472: doesn't show hand 
*** SUMMARY ***
Total pot $8.50 | Rake $0.42 
Board [Qh 4d Js]
Seat 1: ipashutapkom (small blind) folded on the Flop
Seat 2: CI58 (big blind) folded before Flop
Seat 3: matiko09 folded before Flop (didn't bet)
Seat 5: mycka86 folded before Flop (didn't bet)
Seat 6: Filojoes folded on the Flop
Seat 8: Kiosk230472 (button) collected ($8.08)





PokerStars Hand #153068611637:  Hold'em No Limit ($0.50/$1.00 USD) - 2016/05/09 17:11:43 CET [2016/05/09 11:11:43 ET]
Table 'Eucharis' 9-max Seat #4 is the button
Seat 1: Spid1 ($108.32 in chips) 
Seat 2: Chef-Zizou ($76.10 in chips) 
Seat 4: matiko09 ($108.07 in chips) 
Seat 5: mycka86 ($163.34 in chips) 
Seat 6: Mukhin1 ($108.68 in chips) 
Seat 7: ThorSun ($79.44 in chips) 
Seat 8: Kukuryzka ($119.03 in chips) 
mycka86: posts small blind $0.50
Mukhin1: posts big blind $1
nubpoker: sits out 
flk.Dasas: sits out 
*** HOLE CARDS ***
Dealt to matiko09 [Tc 5c]
ThorSun: folds 
Kukuryzka: raises $2 to $3
Spid1: folds 
Chef-Zizou: folds 
matiko09: folds 
mycka86: folds 
Mukhin1: folds 
Uncalled bet ($2) returned to Kukuryzka
Kukuryzka collected $2.50 from pot
Kukuryzka: doesn't show hand 
*** SUMMARY ***
Total pot $2.50 | Rake $0 
Seat 1: Spid1 folded before Flop (didn't bet)
Seat 2: Chef-Zizou folded before Flop (didn't bet)
Seat 4: matiko09 (button) folded before Flop (didn't bet)
Seat 5: mycka86 (small blind) folded before Flop
Seat 6: Mukhin1 (big blind) folded before Flop
Seat 7: ThorSun folded before Flop (didn't bet)
Seat 8: Kukuryzka collected ($2.50)





PokerStars Hand #153068613273:  Hold'em No Limit ($1/$2 USD) - 2016/05/09 17:11:46 CET [2016/05/09 11:11:46 ET]
Table 'Titan III' 9-max Seat #9 is the button
Seat 1: I The King I ($259.50 in chips) 
Seat 2: PacPacBum ($200 in chips) 
Seat 3: Spid1 ($468.80 in chips) 
Seat 5: Monsthand ($276.25 in chips) 
Seat 6: matiko09 ($200 in chips) 
Seat 7: seasar1 ($147.48 in chips) 
Seat 8: chaps1988 ($213.77 in chips) 
Seat 9: Sasuke777777 ($195.45 in chips) 
I The King I: posts small blind $1
PacPacBum: posts big blind $2
*** HOLE CARDS ***
Dealt to matiko09 [Jc Ts]
Spid1: folds 
Monsthand: folds 
matiko09: folds 
seasar1: folds 
chaps1988 has timed out
chaps1988: folds 
Sasuke777777: folds 
I The King I: raises $4 to $6
PacPacBum: folds 
Uncalled bet ($4) returned to I The King I
I The King I collected $4 from pot
I The King I: doesn't show hand 
*** SUMMARY ***
Total pot $4 | Rake $0 
Seat 1: I The King I (small blind) collected ($4)
Seat 2: PacPacBum (big blind) folded before Flop
Seat 3: Spid1 folded before Flop (didn't bet)
Seat 5: Monsthand folded before Flop (didn't bet)
Seat 6: matiko09 folded before Flop (didn't bet)
Seat 7: seasar1 folded before Flop (didn't bet)
Seat 8: chaps1988 folded before Flop (didn't bet)
Seat 9: Sasuke777777 (button) folded before Flop (didn't bet)





PokerStars Hand #153068613739:  Hold'em No Limit ($0.50/$1.00 USD) - 2016/05/09 17:11:47 CET [2016/05/09 11:11:47 ET]
Table 'Orthos' 9-max Seat #9 is the button
Seat 1: Kelvin sai ($74.56 in chips) 
Seat 2: PacPacBum ($114.67 in chips) 
Seat 3: Filojoes ($116.04 in chips) 
Seat 5: matiko09 ($103.80 in chips) 
Seat 6: xhinostrabli ($96.83 in chips) 
Seat 7: flk.Dasas ($161.40 in chips) 
Seat 8: Dickyxxx ($103.67 in chips) 
Seat 9: mycka86 ($106.18 in chips) 
Kelvin sai: posts small blind $0.50
PacPacBum: posts big blind $1
nubpoker: sits out 
*** HOLE CARDS ***
Dealt to matiko09 [Qd 5s]
Filojoes: folds 
matiko09: folds 
xhinostrabli: folds 
flk.Dasas: folds 
Dickyxxx: folds 
mycka86: folds 
Kelvin sai: folds 
Uncalled bet ($0.50) returned to PacPacBum
PacPacBum collected $1 from pot
PacPacBum: doesn't show hand 
*** SUMMARY ***
Total pot $1 | Rake $0 
Seat 1: Kelvin sai (small blind) folded before Flop
Seat 2: PacPacBum (big blind) collected ($1)
Seat 3: Filojoes folded before Flop (didn't bet)
Seat 5: matiko09 folded before Flop (didn't bet)
Seat 6: xhinostrabli folded before Flop (didn't bet)
Seat 7: flk.Dasas folded before Flop (didn't bet)
Seat 8: Dickyxxx folded before Flop (didn't bet)
Seat 9: mycka86 (button) folded before Flop (didn't bet)





PokerStars Hand #153068614426:  Hold'em No Limit ($1/$2 USD) - 2016/05/09 17:11:48 CET [2016/05/09 11:11:48 ET]
Table 'Celaeno II' 9-max Seat #3 is the button
Seat 1: LRVAV7 ($211.65 in chips) 
Seat 2: PacPacBum ($419.59 in chips) 
Seat 3: CI58 ($200 in chips) 
Seat 4: matiko09 ($424.82 in chips) 
Seat 5: Monsthand ($226.61 in chips) 
Seat 6: Igoriah ($220.47 in chips) 
Seat 8: chaps1988 ($224.31 in chips) 
Seat 9: Spid1 ($297.25 in chips) 
matiko09: posts small blind $1
Monsthand: posts big blind $2
*** HOLE CARDS ***
Dealt to matiko09 [3c Jh]
Igoriah: folds 
chaps1988: folds 
Spid1: folds 
Mister_b44 leaves the table
LRVAV7: raises $3 to $5
PacPacBum: folds 
CI58: calls $5
matiko09: folds 
Monsthand: folds 
*** FLOP *** [2d 2c 4h]
LRVAV7: checks 
CI58: bets $6.17
LRVAV7: folds 
Uncalled bet ($6.17) returned to CI58
CI58 collected $12.35 from pot
CI58: doesn't show hand 
*** SUMMARY ***
Total pot $13 | Rake $0.65 
Board [2d 2c 4h]
Seat 1: LRVAV7 folded on the Flop
Seat 2: PacPacBum folded before Flop (didn't bet)
Seat 3: CI58 (button) collected ($12.35)
Seat 4: matiko09 (small blind) folded before Flop
Seat 5: Monsthand (big blind) folded before Flop
Seat 6: Igoriah folded before Flop (didn't bet)
Seat 8: chaps1988 folded before Flop (didn't bet)
Seat 9: Spid1 folded before Flop (didn't bet)





PokerStars Hand #153068616148:  Hold'em No Limit ($0.50/$1.00 USD) - 2016/05/09 17:11:50 CET [2016/05/09 11:11:50 ET]
Table 'Reiss' 9-max Seat #4 is the button
Seat 1: Dickyxxx ($164.66 in chips) 
Seat 2: mycka86 ($187.25 in chips) 
Seat 3: chaps1988 ($113.37 in chips) 
Seat 4: CI58 ($102.04 in chips) 
Seat 5: matiko09 ($116.29 in chips) 
Seat 6: HITYESCA ($100 in chips) 
Seat 8: rusher_NiNja ($100 in chips) 
Seat 9: flyer9898 ($88.50 in chips) 
matiko09: posts small blind $0.50
HITYESCA: posts big blind $1
nubpoker: sits out 
*** HOLE CARDS ***
Dealt to matiko09 [7d 4s]
rusher_NiNja: folds 
flyer9898: folds 
Dickyxxx: folds 
mycka86: folds 
chaps1988: folds 
CI58: folds 
matiko09: folds 
Uncalled bet ($0.50) returned to HITYESCA
HITYESCA collected $1 from pot
HITYESCA: doesn't show hand 
*** SUMMARY ***
Total pot $1 | Rake $0 
Seat 1: Dickyxxx folded before Flop (didn't bet)
Seat 2: mycka86 folded before Flop (didn't bet)
Seat 3: chaps1988 folded before Flop (didn't bet)
Seat 4: CI58 (button) folded before Flop (didn't bet)
Seat 5: matiko09 (small blind) folded before Flop
Seat 6: HITYESCA (big blind) collected ($1)
Seat 8: rusher_NiNja folded before Flop (didn't bet)
Seat 9: flyer9898 folded before Flop (didn't bet)





PokerStars Hand #153068630222:  Hold'em No Limit ($1/$2 USD) - 2016/05/09 17:12:13 CET [2016/05/09 11:12:13 ET]
Table 'Hagar II' 9-max Seat #5 is the button
Seat 1: mojitos86 ($171.83 in chips) 
Seat 2: darren1031 ($157.98 in chips) 
Seat 3: Sasuke777777 ($96.12 in chips) 
Seat 4: matiko09 ($434.49 in chips) 
Seat 5: PacPacBum ($283.47 in chips) 
Seat 6: el Fatto ($205 in chips) 
Seat 7: Monsthand ($261.37 in chips) 
Seat 9: chaps1988 ($396.47 in chips) 
el Fatto: posts small blind $1
Monsthand: posts big blind $2
*** HOLE CARDS ***
Dealt to matiko09 [8h 9h]
chaps1988: folds 
mojitos86: folds 
darren1031: folds 
Sasuke777777: raises $8 to $10
matiko09: folds 
PacPacBum: folds 
el Fatto: folds 
Monsthand: folds 
Uncalled bet ($8) returned to Sasuke777777
Sasuke777777 collected $5 from pot
Sasuke777777: doesn't show hand 
*** SUMMARY ***
Total pot $5 | Rake $0 
Seat 1: mojitos86 folded before Flop (didn't bet)
Seat 2: darren1031 folded before Flop (didn't bet)
Seat 3: Sasuke777777 collected ($5)
Seat 4: matiko09 folded before Flop (didn't bet)
Seat 5: PacPacBum (button) folded before Flop (didn't bet)
Seat 6: el Fatto (small blind) folded before Flop
Seat 7: Monsthand (big blind) folded before Flop
Seat 9: chaps1988 folded before Flop (didn't bet)





PokerStars Hand #153068630472:  Hold'em No Limit ($0.50/$1.00 USD) - 2016/05/09 17:12:14 CET [2016/05/09 11:12:14 ET]
Table 'Orthos' 9-max Seat #1 is the button
Seat 1: Kelvin sai ($74.06 in chips) 
Seat 2: PacPacBum ($115.17 in chips) 
Seat 3: Filojoes ($116.04 in chips) 
Seat 5: matiko09 ($103.80 in chips) 
Seat 6: xhinostrabli ($96.83 in chips) 
Seat 7: flk.Dasas ($161.40 in chips) 
Seat 8: Dickyxxx ($103.67 in chips) 
Seat 9: mycka86 ($106.18 in chips) 
PacPacBum: posts small blind $0.50
Filojoes: posts big blind $1
nubpoker: sits out 
*** HOLE CARDS ***
Dealt to matiko09 [Kh 2d]
matiko09: folds 
xhinostrabli: raises $1 to $2
flk.Dasas: folds 
Dickyxxx: folds 
mycka86: folds 
Kelvin sai: folds 
PacPacBum: folds 
Filojoes: calls $1
*** FLOP *** [8c Kc Jc]
Filojoes: checks 
xhinostrabli: checks 
*** TURN *** [8c Kc Jc] [Qh]
Filojoes: checks 
xhinostrabli: checks 
*** RIVER *** [8c Kc Jc Qh] [Kd]
Filojoes: checks 
xhinostrabli: checks 
*** SHOW DOWN ***
Filojoes: shows [3s As] (a pair of Kings)
xhinostrabli: shows [Qs Js] (two pair, Kings and Queens)
xhinostrabli collected $4.28 from pot
*** SUMMARY ***
Total pot $4.50 | Rake $0.22 
Board [8c Kc Jc Qh Kd]
Seat 1: Kelvin sai (button) folded before Flop (didn't bet)
Seat 2: PacPacBum (small blind) folded before Flop
Seat 3: Filojoes (big blind) showed [3s As] and lost with a pair of Kings
Seat 5: matiko09 folded before Flop (didn't bet)
Seat 6: xhinostrabli showed [Qs Js] and won ($4.28) with two pair, Kings and Queens
Seat 7: flk.Dasas folded before Flop (didn't bet)
Seat 8: Dickyxxx folded before Flop (didn't bet)
Seat 9: mycka86 folded before Flop (didn't bet)





PokerStars Hand #153068631407:  Hold'em No Limit ($0.50/$1.00 USD) - 2016/05/09 17:12:15 CET [2016/05/09 11:12:15 ET]
Table 'Eucharis' 9-max Seat #5 is the button
Seat 1: Spid1 ($108.32 in chips) 
Seat 2: Chef-Zizou ($76.10 in chips) 
Seat 4: matiko09 ($108.07 in chips) 
Seat 5: mycka86 ($162.84 in chips) 
Seat 6: Mukhin1 ($107.68 in chips) 
Seat 7: ThorSun ($79.44 in chips) 
Seat 8: Kukuryzka ($120.53 in chips) 
Mukhin1: posts small blind $0.50
ThorSun: posts big blind $1
nubpoker: sits out 
flk.Dasas: sits out 
*** HOLE CARDS ***
Dealt to matiko09 [Kh 7d]
Kukuryzka: folds 
Spid1: raises $2 to $3
Chef-Zizou: folds 
matiko09: folds 
mycka86: folds 
Mukhin1: folds 
ThorSun: folds 
Uncalled bet ($2) returned to Spid1
Spid1 collected $2.50 from pot
Spid1: doesn't show hand 
*** SUMMARY ***
Total pot $2.50 | Rake $0 
Seat 1: Spid1 collected ($2.50)
Seat 2: Chef-Zizou folded before Flop (didn't bet)
Seat 4: matiko09 folded before Flop (didn't bet)
Seat 5: mycka86 (button) folded before Flop (didn't bet)
Seat 6: Mukhin1 (small blind) folded before Flop
Seat 7: ThorSun (big blind) folded before Flop
Seat 8: Kukuryzka folded before Flop (didn't bet)





PokerStars Hand #153068635917:  Hold'em No Limit ($0.50/$1.00 USD) - 2016/05/09 17:12:22 CET [2016/05/09 11:12:22 ET]
Table 'Reiss' 9-max Seat #5 is the button
Seat 1: Dickyxxx ($164.66 in chips) 
Seat 2: mycka86 ($187.25 in chips) 
Seat 3: chaps1988 ($113.37 in chips) 
Seat 4: CI58 ($102.04 in chips) 
Seat 5: matiko09 ($115.79 in chips) 
Seat 6: HITYESCA ($100.50 in chips) 
Seat 7: nubpoker ($134.29 in chips) 
Seat 8: rusher_NiNja ($100 in chips) 
Seat 9: flyer9898 ($88.50 in chips) 
HITYESCA: posts small blind $0.50
nubpoker: posts big blind $1
*** HOLE CARDS ***
Dealt to matiko09 [Qh Qs]
rusher_NiNja: folds 
flyer9898: raises $2 to $3
Dickyxxx: folds 
mycka86: folds 
chaps1988: folds 
CI58: folds 
matiko09: raises $7 to $10
HITYESCA: folds 
nubpoker: folds 
flyer9898: calls $7
*** FLOP *** [3c Tc Jd]
flyer9898: bets $10
matiko09: raises $20 to $30
flyer9898: folds 
Uncalled bet ($20) returned to matiko09
matiko09 collected $39.42 from pot
matiko09: doesn't show hand 
*** SUMMARY ***
Total pot $41.50 | Rake $2.08 
Board [3c Tc Jd]
Seat 1: Dickyxxx folded before Flop (didn't bet)
Seat 2: mycka86 folded before Flop (didn't bet)
Seat 3: chaps1988 folded before Flop (didn't bet)
Seat 4: CI58 folded before Flop (didn't bet)
Seat 5: matiko09 (button) collected ($39.42)
Seat 6: HITYESCA (small blind) folded before Flop
Seat 7: nubpoker (big blind) folded before Flop
Seat 8: rusher_NiNja folded before Flop (didn't bet)
Seat 9: flyer9898 folded on the Flop





PokerStars Hand #153068637949:  Hold'em No Limit ($1/$2 USD) - 2016/05/09 17:12:26 CET [2016/05/09 11:12:26 ET]
Table 'Titan III' 9-max Seat #1 is the button
Seat 1: I The King I ($261.50 in chips) 
Seat 2: PacPacBum ($200 in chips) 
Seat 3: Spid1 ($468.80 in chips) 
Seat 5: Monsthand ($276.25 in chips) 
Seat 6: matiko09 ($200 in chips) 
Seat 7: seasar1 ($147.48 in chips) 
Seat 8: chaps1988 ($213.77 in chips) 
Seat 9: Sasuke777777 ($195.45 in chips) 
PacPacBum: posts small blind $1
Spid1: posts big blind $2
*** HOLE CARDS ***
Dealt to matiko09 [6d Ks]
Monsthand: folds 
matiko09: folds 
seasar1: raises $2 to $4
chaps1988: folds 
Sasuke777777: calls $4
I The King I: folds 
PacPacBum: folds 
Spid1: folds 
*** FLOP *** [9d Ac 4d]
seasar1: bets $4
Sasuke777777: folds 
Uncalled bet ($4) returned to seasar1
seasar1 collected $10.45 from pot
*** SUMMARY ***
Total pot $11 | Rake $0.55 
Board [9d Ac 4d]
Seat 1: I The King I (button) folded before Flop (didn't bet)
Seat 2: PacPacBum (small blind) folded before Flop
Seat 3: Spid1 (big blind) folded before Flop
Seat 5: Monsthand folded before Flop (didn't bet)
Seat 6: matiko09 folded before Flop (didn't bet)
Seat 7: seasar1 collected ($10.45)
Seat 8: chaps1988 folded before Flop (didn't bet)
Seat 9: Sasuke777777 folded on the Flop





PokerStars Hand #153068643468:  Hold'em No Limit ($0.50/$1.00 USD) - 2016/05/09 17:12:35 CET [2016/05/09 11:12:35 ET]
Table 'Eucharis' 9-max Seat #6 is the button
Seat 1: Spid1 ($109.82 in chips) 
Seat 2: Chef-Zizou ($76.10 in chips) 
Seat 4: matiko09 ($108.07 in chips) 
Seat 5: mycka86 ($162.84 in chips) 
Seat 6: Mukhin1 ($107.18 in chips) 
Seat 7: ThorSun ($78.44 in chips) 
Seat 8: Kukuryzka ($120.53 in chips) 
ThorSun: posts small blind $0.50
Kukuryzka: posts big blind $1
nubpoker: sits out 
flk.Dasas: sits out 
*** HOLE CARDS ***
Dealt to matiko09 [7d Tc]
Spid1: raises $2 to $3
Chef-Zizou: folds 
matiko09: folds 
mycka86: folds 
Mukhin1: folds 
ThorSun: calls $2.50
Kukuryzka: folds 
*** FLOP *** [Td Qd 3s]
ThorSun: checks 
Spid1: bets $5
ThorSun: calls $5
*** TURN *** [Td Qd 3s] [3c]
ThorSun: checks 
Spid1: bets $12
ThorSun: calls $12
*** RIVER *** [Td Qd 3s 3c] [5c]
ThorSun: checks 
Spid1: bets $38
ThorSun: folds 
Uncalled bet ($38) returned to Spid1
Spid1 collected $38.95 from pot
Spid1: doesn't show hand 
*** SUMMARY ***
Total pot $41 | Rake $2.05 
Board [Td Qd 3s 3c 5c]
Seat 1: Spid1 collected ($38.95)
Seat 2: Chef-Zizou folded before Flop (didn't bet)
Seat 4: matiko09 folded before Flop (didn't bet)
Seat 5: mycka86 folded before Flop (didn't bet)
Seat 6: Mukhin1 (button) folded before Flop (didn't bet)
Seat 7: ThorSun (small blind) folded on the River
Seat 8: Kukuryzka (big blind) folded before Flop





PokerStars Hand #153068647099:  Hold'em No Limit ($1/$2 USD) - 2016/05/09 17:12:40 CET [2016/05/09 11:12:40 ET]
Table 'Hagar II' 9-max Seat #6 is the button
Seat 1: mojitos86 ($171.83 in chips) 
Seat 2: darren1031 ($157.98 in chips) 
Seat 3: Sasuke777777 ($99.12 in chips) 
Seat 4: matiko09 ($434.49 in chips) 
Seat 5: PacPacBum ($283.47 in chips) 
Seat 6: el Fatto ($204 in chips) 
Seat 7: Monsthand ($259.37 in chips) 
Seat 9: chaps1988 ($396.47 in chips) 
Monsthand: posts small blind $1
chaps1988: posts big blind $2
*** HOLE CARDS ***
Dealt to matiko09 [8s 5c]
mojitos86: folds 
darren1031: folds 
Sasuke777777: folds 
matiko09: folds 
PacPacBum: raises $3 to $5
mojitos86 leaves the table
I The King I joins the table at seat #1 
el Fatto: calls $5
I The King I leaves the table
Monsthand: folds 
chaps1988: folds 
*** FLOP *** [4d 8h Qs]
PacPacBum: checks 
el Fatto: checks 
*** TURN *** [4d 8h Qs] [3s]
PacPacBum: checks 
el Fatto: bets $7
PacPacBum: folds 
Uncalled bet ($7) returned to el Fatto
el Fatto collected $12.35 from pot
el Fatto: doesn't show hand 
*** SUMMARY ***
Total pot $13 | Rake $0.65 
Board [4d 8h Qs 3s]
Seat 1: mojitos86 folded before Flop (didn't bet)
Seat 2: darren1031 folded before Flop (didn't bet)
Seat 3: Sasuke777777 folded before Flop (didn't bet)
Seat 4: matiko09 folded before Flop (didn't bet)
Seat 5: PacPacBum folded on the Turn
Seat 6: el Fatto (button) collected ($12.35)
Seat 7: Monsthand (small blind) folded before Flop
Seat 9: chaps1988 (big blind) folded before Flop





PokerStars Hand #153068652870:  Hold'em No Limit ($1/$2 USD) - 2016/05/09 17:12:50 CET [2016/05/09 11:12:50 ET]
Table 'Titan III' 9-max Seat #2 is the button
Seat 1: I The King I ($261.50 in chips) 
Seat 2: PacPacBum ($200 in chips) 
Seat 3: Spid1 ($466.80 in chips) 
Seat 5: Monsthand ($276.25 in chips) 
Seat 6: matiko09 ($200 in chips) 
Seat 7: seasar1 ($153.93 in chips) 
Seat 8: chaps1988 ($213.77 in chips) 
Seat 9: Sasuke777777 ($191.45 in chips) 
Spid1: posts small blind $1
AceSurgeon was removed from the table for failing to post
Monsthand: posts big blind $2
*** HOLE CARDS ***
Dealt to matiko09 [3s Kh]
matiko09: folds 
seasar1: folds 
chaps1988: folds 
Sasuke777777: folds 
I The King I: raises $3 to $5
PacPacBum: folds 
Spid1: folds 
Monsthand: folds 
Uncalled bet ($3) returned to I The King I
I The King I collected $5 from pot
I The King I: doesn't show hand 
*** SUMMARY ***
Total pot $5 | Rake $0 
Seat 1: I The King I collected ($5)
Seat 2: PacPacBum (button) folded before Flop (didn't bet)
Seat 3: Spid1 (small blind) folded before Flop
Seat 5: Monsthand (big blind) folded before Flop
Seat 6: matiko09 folded before Flop (didn't bet)
Seat 7: seasar1 folded before Flop (didn't bet)
Seat 8: chaps1988 folded before Flop (didn't bet)
Seat 9: Sasuke777777 folded before Flop (didn't bet)





PokerStars Hand #153068654670:  Hold'em No Limit ($0.50/$1.00 USD) - 2016/05/09 17:12:53 CET [2016/05/09 11:12:53 ET]
Table 'Terpsichore' 9-max Seat #1 is the button
Seat 1: ipashutapkom ($153.87 in chips) 
Seat 2: CI58 ($100 in chips) 
Seat 3: matiko09 ($155.89 in chips) 
Seat 5: mycka86 ($241.86 in chips) 
Seat 6: Filojoes ($100 in chips) 
Seat 8: Kiosk230472 ($128.03 in chips) 
CI58: posts small blind $0.50
matiko09: posts big blind $1
nubpoker: sits out 
Kukuryzka: sits out 
*** HOLE CARDS ***
Dealt to matiko09 [Qh 7d]
mycka86: raises $2 to $3
Filojoes: calls $3
Kiosk230472: folds 
ipashutapkom: folds 
CI58: folds 
matiko09: folds 
*** FLOP *** [7s Jh 4d]
mycka86: bets $4.50
Filojoes: folds 
Uncalled bet ($4.50) returned to mycka86
mycka86 collected $7.12 from pot
*** SUMMARY ***
Total pot $7.50 | Rake $0.38 
Board [7s Jh 4d]
Seat 1: ipashutapkom (button) folded before Flop (didn't bet)
Seat 2: CI58 (small blind) folded before Flop
Seat 3: matiko09 (big blind) folded before Flop
Seat 5: mycka86 collected ($7.12)
Seat 6: Filojoes folded on the Flop
Seat 8: Kiosk230472 folded before Flop (didn't bet)





PokerStars Hand #153068661157:  Hold'em No Limit ($0.50/$1.00 USD) - 2016/05/09 17:13:03 CET [2016/05/09 11:13:03 ET]
Table 'Buryatia II' 9-max Seat #8 is the button
Seat 1: flk.Dasas ($136.94 in chips) 
Seat 4: maxxmeister ($100 in chips) 
Seat 5: amisasi ($164.74 in chips) 
Seat 6: I The King I ($124.05 in chips) 
Seat 8: matiko09 ($125 in chips) 
Seat 9: CI58 ($121.21 in chips) 
CI58: posts small blind $0.50
flk.Dasas: posts big blind $1
Filojoes: sits out 
HITYESCA: sits out 
*** HOLE CARDS ***
Dealt to matiko09 [Ac Kh]
maxxmeister: folds 
amisasi: folds 
I The King I: folds 
matiko09: raises $1.27 to $2.27
CI58: folds 
flk.Dasas: folds 
Uncalled bet ($1.27) returned to matiko09
matiko09 collected $2.50 from pot
matiko09: doesn't show hand 
*** SUMMARY ***
Total pot $2.50 | Rake $0 
Seat 1: flk.Dasas (big blind) folded before Flop
Seat 4: maxxmeister folded before Flop (didn't bet)
Seat 5: amisasi folded before Flop (didn't bet)
Seat 6: I The King I folded before Flop (didn't bet)
Seat 8: matiko09 (button) collected ($2.50)
Seat 9: CI58 (small blind) folded before Flop





PokerStars Hand #153068665636:  Hold'em No Limit ($0.50/$1.00 USD) - 2016/05/09 17:13:10 CET [2016/05/09 11:13:10 ET]
Table 'Orthos' 9-max Seat #2 is the button
Seat 1: Kelvin sai ($74.06 in chips) 
Seat 2: PacPacBum ($114.67 in chips) 
Seat 3: Filojoes ($114.04 in chips) 
Seat 4: nubpoker ($154.65 in chips) 
Seat 5: matiko09 ($103.80 in chips) 
Seat 6: xhinostrabli ($99.11 in chips) 
Seat 7: flk.Dasas ($161.40 in chips) 
Seat 8: Dickyxxx ($103.67 in chips) 
Seat 9: mycka86 ($106.18 in chips) 
Filojoes: posts small blind $0.50
nubpoker: posts big blind $1
*** HOLE CARDS ***
Dealt to matiko09 [Ac Qc]
matiko09: raises $2 to $3
xhinostrabli: folds 
flk.Dasas: calls $3
Dickyxxx: folds 
mycka86: folds 
Kelvin sai: folds 
PacPacBum: folds 
Filojoes: calls $2.50
nubpoker: folds 
*** FLOP *** [Ah Js Jc]
Filojoes: checks 
matiko09: checks 
flk.Dasas: checks 
*** TURN *** [Ah Js Jc] [4h]
Filojoes: checks 
matiko09: bets $6
flk.Dasas: folds 
Filojoes: calls $6
*** RIVER *** [Ah Js Jc 4h] [Qd]
Filojoes: checks 
matiko09: checks 
*** SHOW DOWN ***
Filojoes: shows [6s As] (two pair, Aces and Jacks)
matiko09: shows [Ac Qc] (two pair, Aces and Queens)
matiko09 collected $20.90 from pot
*** SUMMARY ***
Total pot $22 | Rake $1.10 
Board [Ah Js Jc 4h Qd]
Seat 1: Kelvin sai folded before Flop (didn't bet)
Seat 2: PacPacBum (button) folded before Flop (didn't bet)
Seat 3: Filojoes (small blind) showed [6s As] and lost with two pair, Aces and Jacks
Seat 4: nubpoker (big blind) folded before Flop
Seat 5: matiko09 showed [Ac Qc] and won ($20.90) with two pair, Aces and Queens
Seat 6: xhinostrabli folded before Flop (didn't bet)
Seat 7: flk.Dasas folded on the Turn
Seat 8: Dickyxxx folded before Flop (didn't bet)
Seat 9: mycka86 folded before Flop (didn't bet)





PokerStars Hand #153068666339:  Hold'em No Limit ($1/$2 USD) - 2016/05/09 17:13:12 CET [2016/05/09 11:13:12 ET]
Table 'Titan III' 9-max Seat #3 is the button
Seat 1: I The King I ($264.50 in chips) 
Seat 2: PacPacBum ($200 in chips) 
Seat 3: Spid1 ($465.80 in chips) 
Seat 5: Monsthand ($274.25 in chips) 
Seat 6: matiko09 ($200 in chips) 
Seat 7: seasar1 ($153.93 in chips) 
Seat 8: chaps1988 ($213.77 in chips) 
Seat 9: Sasuke777777 ($191.45 in chips) 
Monsthand: posts small blind $1
matiko09: posts big blind $2
*** HOLE CARDS ***
Dealt to matiko09 [6s 7h]
seasar1: folds 
chaps1988: folds 
Sasuke777777: raises $4 to $6
I The King I: folds 
PacPacBum: calls $6
Spid1: folds 
Monsthand: folds 
matiko09: folds 
*** FLOP *** [4c 5h Jd]
Sasuke777777: bets $6
PacPacBum: folds 
Uncalled bet ($6) returned to Sasuke777777
Sasuke777777 collected $14.25 from pot
Sasuke777777: doesn't show hand 
HuanHuan joins the table at seat #4 
*** SUMMARY ***
Total pot $15 | Rake $0.75 
Board [4c 5h Jd]
Seat 1: I The King I folded before Flop (didn't bet)
Seat 2: PacPacBum folded on the Flop
Seat 3: Spid1 (button) folded before Flop (didn't bet)
Seat 5: Monsthand (small blind) folded before Flop
Seat 6: matiko09 (big blind) folded before Flop
Seat 7: seasar1 folded before Flop (didn't bet)
Seat 8: chaps1988 folded before Flop (didn't bet)
Seat 9: Sasuke777777 collected ($14.25)





PokerStars Hand #153068667249:  Hold'em No Limit ($1/$2 USD) - 2016/05/09 17:13:13 CET [2016/05/09 11:13:13 ET]
Table 'Celaeno II' 9-max Seat #4 is the button
Seat 1: LRVAV7 ($206.65 in chips) 
Seat 2: PacPacBum ($419.59 in chips) 
Seat 3: CI58 ($207.35 in chips) 
Seat 4: matiko09 ($423.82 in chips) 
Seat 5: Monsthand ($224.61 in chips) 
Seat 8: chaps1988 ($224.31 in chips) 
Seat 9: Spid1 ($297.25 in chips) 
Monsthand: posts small blind $1
Igoriah: is sitting out 
chaps1988: posts big blind $2
*** HOLE CARDS ***
Dealt to matiko09 [As 9h]
Spid1: raises $4 to $6
LRVAV7: folds 
DancerNN1 joins the table at seat #7 
PacPacBum: folds 
CI58: folds 
matiko09: folds 
Monsthand: folds 
DancerNN1 leaves the table
chaps1988: folds 
Uncalled bet ($4) returned to Spid1
Spid1 collected $5 from pot
Spid1: doesn't show hand 
*** SUMMARY ***
Total pot $5 | Rake $0 
Seat 1: LRVAV7 folded before Flop (didn't bet)
Seat 2: PacPacBum folded before Flop (didn't bet)
Seat 3: CI58 folded before Flop (didn't bet)
Seat 4: matiko09 (button) folded before Flop (didn't bet)
Seat 5: Monsthand (small blind) folded before Flop
Seat 8: chaps1988 (big blind) folded before Flop
Seat 9: Spid1 collected ($5)





PokerStars Hand #153068670352:  Hold'em No Limit ($0.50/$1.00 USD) - 2016/05/09 17:13:18 CET [2016/05/09 11:13:18 ET]
Table 'Buryatia II' 9-max Seat #9 is the button
Seat 1: flk.Dasas ($135.94 in chips) 
Seat 3: Filojoes ($100 in chips) 
Seat 4: maxxmeister ($100 in chips) 
Seat 5: amisasi ($164.74 in chips) 
Seat 6: I The King I ($124.05 in chips) 
Seat 8: matiko09 ($126.50 in chips) 
Seat 9: CI58 ($120.71 in chips) 
flk.Dasas: posts small blind $0.50
AceSurgeon was removed from the table for failing to post
Filojoes: posts big blind $1
HITYESCA: sits out 
*** HOLE CARDS ***
Dealt to matiko09 [7s 9h]
maxxmeister: folds 
rusher_NiNja joins the table at seat #2 
amisasi: folds 
I The King I: folds 
matiko09: folds 
CI58: raises $1.25 to $2.25
flk.Dasas: folds 
Filojoes: calls $1.25
*** FLOP *** [7c Qc 2d]
Filojoes: checks 
CI58: checks 
*** TURN *** [7c Qc 2d] [6s]
Filojoes: checks 
CI58: checks 
*** RIVER *** [7c Qc 2d 6s] [3h]
Filojoes: checks 
CI58: checks 
*** SHOW DOWN ***
Filojoes: shows [Kh Jd] (high card King)
CI58: mucks hand 
Filojoes collected $4.75 from pot
*** SUMMARY ***
Total pot $5 | Rake $0.25 
Board [7c Qc 2d 6s 3h]
Seat 1: flk.Dasas (small blind) folded before Flop
Seat 3: Filojoes (big blind) showed [Kh Jd] and won ($4.75) with high card King
Seat 4: maxxmeister folded before Flop (didn't bet)
Seat 5: amisasi folded before Flop (didn't bet)
Seat 6: I The King I folded before Flop (didn't bet)
Seat 8: matiko09 folded before Flop (didn't bet)
Seat 9: CI58 (button) mucked [Ks Td]





PokerStars Hand #153068676104:  Hold'em No Limit ($0.50/$1.00 USD) - 2016/05/09 17:13:27 CET [2016/05/09 11:13:27 ET]
Table 'Terpsichore' 9-max Seat #2 is the button
Seat 1: ipashutapkom ($153.87 in chips) 
Seat 2: CI58 ($100 in chips) 
Seat 3: matiko09 ($154.89 in chips) 
Seat 4: nubpoker ($131.98 in chips) 
Seat 5: mycka86 ($245.98 in chips) 
Seat 6: Filojoes ($100 in chips) 
Seat 8: Kiosk230472 ($128.03 in chips) 
matiko09: posts small blind $0.50
nubpoker: posts big blind $1
Kukuryzka: sits out 
*** HOLE CARDS ***
Dealt to matiko09 [Ac 6h]
mycka86: folds 
Filojoes: folds 
Kiosk230472 has timed out
Kiosk230472: folds 
ipashutapkom: folds 
CI58: raises $1.25 to $2.25
matiko09: folds 
nubpoker: folds 
Uncalled bet ($1.25) returned to CI58
CI58 collected $2.50 from pot
CI58: doesn't show hand 
*** SUMMARY ***
Total pot $2.50 | Rake $0 
Seat 1: ipashutapkom folded before Flop (didn't bet)
Seat 2: CI58 (button) collected ($2.50)
Seat 3: matiko09 (small blind) folded before Flop
Seat 4: nubpoker (big blind) folded before Flop
Seat 5: mycka86 folded before Flop (didn't bet)
Seat 6: Filojoes folded before Flop (didn't bet)
Seat 8: Kiosk230472 folded before Flop (didn't bet)





PokerStars Hand #153068681580:  Hold'em No Limit ($1/$2 USD) - 2016/05/09 17:13:36 CET [2016/05/09 11:13:36 ET]
Table 'Celaeno II' 9-max Seat #5 is the button
Seat 1: LRVAV7 ($206.65 in chips) 
Seat 2: PacPacBum ($419.59 in chips) 
Seat 3: CI58 ($207.35 in chips) 
Seat 4: matiko09 ($423.82 in chips) 
Seat 5: Monsthand ($223.61 in chips) 
Seat 8: chaps1988 ($222.31 in chips) 
Seat 9: Spid1 ($300.25 in chips) 
chaps1988: posts small blind $1
Spid1: posts big blind $2
*** HOLE CARDS ***
Dealt to matiko09 [Jh 9s]
LRVAV7: folds 
PacPacBum: raises $2.08 to $4.08
CI58: folds 
matiko09: folds 
Monsthand: folds 
chaps1988: folds 
Spid1: calls $2.08
*** FLOP *** [6c Js 5s]
HuanHuan joins the table at seat #7 
Spid1: checks 
PacPacBum: checks 
*** TURN *** [6c Js 5s] [6d]
Spid1: bets $7
PacPacBum: folds 
Uncalled bet ($7) returned to Spid1
Spid1 collected $8.70 from pot
Spid1: doesn't show hand 
*** SUMMARY ***
Total pot $9.16 | Rake $0.46 
Board [6c Js 5s 6d]
Seat 1: LRVAV7 folded before Flop (didn't bet)
Seat 2: PacPacBum folded on the Turn
Seat 3: CI58 folded before Flop (didn't bet)
Seat 4: matiko09 folded before Flop (didn't bet)
Seat 5: Monsthand (button) folded before Flop (didn't bet)
Seat 8: chaps1988 (small blind) folded before Flop
Seat 9: Spid1 (big blind) collected ($8.70)





PokerStars Hand #153068681320:  Hold'em No Limit ($1/$2 USD) - 2016/05/09 17:13:36 CET [2016/05/09 11:13:36 ET]
Table 'Hagar II' 9-max Seat #7 is the button
Seat 2: darren1031 ($157.98 in chips) 
Seat 3: Sasuke777777 ($99.12 in chips) 
Seat 4: matiko09 ($434.49 in chips) 
Seat 5: PacPacBum ($278.47 in chips) 
Seat 6: el Fatto ($211.35 in chips) 
Seat 7: Monsthand ($258.37 in chips) 
Seat 9: chaps1988 ($394.47 in chips) 
chaps1988: posts small blind $1
darren1031: posts big blind $2
*** HOLE CARDS ***
Dealt to matiko09 [9s Qc]
Sasuke777777: raises $4 to $6
matiko09: folds 
PacPacBum: folds 
el Fatto: folds 
Monsthand: calls $6
chaps1988: folds 
darren1031: folds 
*** FLOP *** [Tc 9d 8d]
Sasuke777777: bets $6
CI58 joins the table at seat #1 
Monsthand: calls $6
*** TURN *** [Tc 9d 8d] [7d]
Sasuke777777: checks 
Monsthand: bets $15
Sasuke777777: calls $15
*** RIVER *** [Tc 9d 8d 7d] [5s]
Sasuke777777: checks 
Monsthand: bets $29.50
Sasuke777777: calls $29.50
*** SHOW DOWN ***
Monsthand: shows [4d 5d] (a flush, Nine high)
Sasuke777777: mucks hand 
Monsthand collected $113.25 from pot
*** SUMMARY ***
Total pot $116 | Rake $2.75 
Board [Tc 9d 8d 7d 5s]
Seat 2: darren1031 (big blind) folded before Flop
Seat 3: Sasuke777777 mucked [Jh 8c]
Seat 4: matiko09 folded before Flop (didn't bet)
Seat 5: PacPacBum folded before Flop (didn't bet)
Seat 6: el Fatto folded before Flop (didn't bet)
Seat 7: Monsthand (button) showed [4d 5d] and won ($113.25) with a flush, Nine high
Seat 9: chaps1988 (small blind) folded before Flop





PokerStars Hand #153068683472:  Hold'em No Limit ($0.50/$1.00 USD) - 2016/05/09 17:13:39 CET [2016/05/09 11:13:39 ET]
Table 'Eucharis' 9-max Seat #7 is the button
Seat 1: Spid1 ($128.77 in chips) 
Seat 2: Chef-Zizou ($76.10 in chips) 
Seat 4: matiko09 ($108.07 in chips) 
Seat 5: mycka86 ($162.84 in chips) 
Seat 6: Mukhin1 ($107.18 in chips) 
Seat 7: ThorSun ($58.44 in chips) 
Seat 8: Kukuryzka ($119.53 in chips) 
Seat 9: nubpoker ($100 in chips) 
Kukuryzka: posts small blind $0.50
nubpoker: posts big blind $1
flk.Dasas: sits out 
*** HOLE CARDS ***
Dealt to matiko09 [Jh Tc]
Spid1: raises $2 to $3
Chef-Zizou: folds 
matiko09: folds 
mycka86: folds 
Mukhin1: folds 
ThorSun: calls $3
Kukuryzka: folds 
nubpoker: folds 
*** FLOP *** [2s As 9c]
Spid1: checks 
ThorSun: bets $5
Spid1: folds 
Uncalled bet ($5) returned to ThorSun
ThorSun collected $7.12 from pot
ThorSun: doesn't show hand 
*** SUMMARY ***
Total pot $7.50 | Rake $0.38 
Board [2s As 9c]
Seat 1: Spid1 folded on the Flop
Seat 2: Chef-Zizou folded before Flop (didn't bet)
Seat 4: matiko09 folded before Flop (didn't bet)
Seat 5: mycka86 folded before Flop (didn't bet)
Seat 6: Mukhin1 folded before Flop (didn't bet)
Seat 7: ThorSun (button) collected ($7.12)
Seat 8: Kukuryzka (small blind) folded before Flop
Seat 9: nubpoker (big blind) folded before Flop





PokerStars Hand #153068691932:  Hold'em No Limit ($0.50/$1.00 USD) - 2016/05/09 17:13:53 CET [2016/05/09 11:13:53 ET]
Table 'Reiss' 9-max Seat #6 is the button
Seat 1: Dickyxxx ($164.66 in chips) 
Seat 2: mycka86 ($187.25 in chips) 
Seat 3: chaps1988 ($113.37 in chips) 
Seat 4: CI58 ($102.04 in chips) 
Seat 5: matiko09 ($135.21 in chips) 
Seat 6: HITYESCA ($100 in chips) 
Seat 7: nubpoker ($133.29 in chips) 
Seat 9: flyer9898 ($68.50 in chips) 
nubpoker: posts small blind $0.50
rusher_NiNja: is sitting out 
flyer9898: posts big blind $1
*** HOLE CARDS ***
Dealt to matiko09 [Ts 2c]
Dickyxxx: folds 
mycka86: folds 
chaps1988: raises $1.50 to $2.50
rusher_NiNja leaves the table
I The King I joins the table at seat #8 
CI58: folds 
I The King I leaves the table
matiko09: folds 
HITYESCA: folds 
nubpoker: folds 
flyer9898: calls $1.50
*** FLOP *** [5s 8d Tc]
flyer9898: checks 
JimineyCrik joins the table at seat #8 
chaps1988: checks 
*** TURN *** [5s 8d Tc] [Qs]
flyer9898: checks 
chaps1988: bets $4
flyer9898: folds 
Uncalled bet ($4) returned to chaps1988
chaps1988 collected $5.22 from pot
chaps1988: doesn't show hand 
*** SUMMARY ***
Total pot $5.50 | Rake $0.28 
Board [5s 8d Tc Qs]
Seat 1: Dickyxxx folded before Flop (didn't bet)
Seat 2: mycka86 folded before Flop (didn't bet)
Seat 3: chaps1988 collected ($5.22)
Seat 4: CI58 folded before Flop (didn't bet)
Seat 5: matiko09 folded before Flop (didn't bet)
Seat 6: HITYESCA (button) folded before Flop (didn't bet)
Seat 7: nubpoker (small blind) folded before Flop
Seat 9: flyer9898 (big blind) folded on the Turn





PokerStars Hand #153068696524:  Hold'em No Limit ($1/$2 USD) - 2016/05/09 17:14:00 CET [2016/05/09 11:14:00 ET]
Table 'Bella' 9-max Seat #6 is the button
Seat 1: matiko09 ($200 in chips) 
Seat 2: AlKatrone ($226.94 in chips) 
Seat 3: PacPacBum ($214 in chips) 
Seat 4: Spid1 ($200 in chips) 
Seat 5: Monsthand ($202 in chips) 
Seat 6: CI58 ($228.95 in chips) 
Seat 7: stan_09319 ($424.09 in chips) 
stan_09319: posts small blind $1
matiko09: posts big blind $2
*** HOLE CARDS ***
Dealt to matiko09 [3d 4d]
AlKatrone: folds 
PacPacBum: raises $2.08 to $4.08
Spid1: folds 
Monsthand: folds 
CI58: folds 
stan_09319: calls $3.08
matiko09: folds 
*** FLOP *** [Jd 5c 5d]
stan_09319: checks 
PacPacBum: bets $5.21
stan_09319: folds 
Uncalled bet ($5.21) returned to PacPacBum
PacPacBum collected $9.65 from pot
PacPacBum: doesn't show hand 
*** SUMMARY ***
Total pot $10.16 | Rake $0.51 
Board [Jd 5c 5d]
Seat 1: matiko09 (big blind) folded before Flop
Seat 2: AlKatrone folded before Flop (didn't bet)
Seat 3: PacPacBum collected ($9.65)
Seat 4: Spid1 folded before Flop (didn't bet)
Seat 5: Monsthand folded before Flop (didn't bet)
Seat 6: CI58 (button) folded before Flop (didn't bet)
Seat 7: stan_09319 (small blind) folded on the Flop





PokerStars Hand #153068700931:  Hold'em No Limit ($1/$2 USD) - 2016/05/09 17:14:07 CET [2016/05/09 11:14:07 ET]
Table 'Celaeno II' 9-max Seat #8 is the button
Seat 1: LRVAV7 ($206.65 in chips) 
Seat 2: PacPacBum ($415.51 in chips) 
Seat 3: CI58 ($207.35 in chips) 
Seat 4: matiko09 ($423.82 in chips) 
Seat 5: Monsthand ($223.61 in chips) 
Seat 8: chaps1988 ($221.31 in chips) 
Seat 9: Spid1 ($304.87 in chips) 
Spid1: posts small blind $1
LRVAV7: posts big blind $2
HuanHuan: sits out 
*** HOLE CARDS ***
Dealt to matiko09 [7c 6s]
PacPacBum: folds 
CI58: folds 
matiko09: folds 
Monsthand: raises $3 to $5
chaps1988: folds 
Spid1: folds 
LRVAV7: calls $3
*** FLOP *** [4d Ah 8s]
LRVAV7: checks 
Monsthand: bets $6.47
LRVAV7: folds 
Uncalled bet ($6.47) returned to Monsthand
Monsthand collected $10.45 from pot
Monsthand: doesn't show hand 
*** SUMMARY ***
Total pot $11 | Rake $0.55 
Board [4d Ah 8s]
Seat 1: LRVAV7 (big blind) folded on the Flop
Seat 2: PacPacBum folded before Flop (didn't bet)
Seat 3: CI58 folded before Flop (didn't bet)
Seat 4: matiko09 folded before Flop (didn't bet)
Seat 5: Monsthand collected ($10.45)
Seat 8: chaps1988 (button) folded before Flop (didn't bet)
Seat 9: Spid1 (small blind) folded before Flop





PokerStars Hand #153068701765:  Hold'em No Limit ($1/$2 USD) - 2016/05/09 17:14:09 CET [2016/05/09 11:14:09 ET]
Table 'Titan III' 9-max Seat #5 is the button
Seat 1: I The King I ($264.50 in chips) 
Seat 2: PacPacBum ($200 in chips) 
Seat 3: Spid1 ($465.80 in chips) 
Seat 5: Monsthand ($273.25 in chips) 
Seat 6: matiko09 ($200 in chips) 
Seat 7: seasar1 ($153.93 in chips) 
Seat 8: chaps1988 ($213.77 in chips) 
Seat 9: Sasuke777777 ($199.70 in chips) 
matiko09: posts small blind $1
seasar1: posts big blind $2
HuanHuan: sits out 
*** HOLE CARDS ***
Dealt to matiko09 [9h 3d]
chaps1988: folds 
Sasuke777777: folds 
I The King I: folds 
PacPacBum: folds 
Spid1: folds 
Monsthand: folds 
matiko09: folds 
Uncalled bet ($1) returned to seasar1
seasar1 collected $2 from pot
*** SUMMARY ***
Total pot $2 | Rake $0 
Seat 1: I The King I folded before Flop (didn't bet)
Seat 2: PacPacBum folded before Flop (didn't bet)
Seat 3: Spid1 folded before Flop (didn't bet)
Seat 5: Monsthand (button) folded before Flop (didn't bet)
Seat 6: matiko09 (small blind) folded before Flop
Seat 7: seasar1 (big blind) collected ($2)
Seat 8: chaps1988 folded before Flop (didn't bet)
Seat 9: Sasuke777777 folded before Flop (didn't bet)





PokerStars Hand #153068704060:  Hold'em No Limit ($0.50/$1.00 USD) - 2016/05/09 17:14:12 CET [2016/05/09 11:14:12 ET]
Table 'Eucharis' 9-max Seat #8 is the button
Seat 2: Chef-Zizou ($76.10 in chips) 
Seat 4: matiko09 ($108.07 in chips) 
Seat 5: mycka86 ($162.84 in chips) 
Seat 6: Mukhin1 ($107.18 in chips) 
Seat 7: ThorSun ($62.56 in chips) 
Seat 8: Kukuryzka ($119.03 in chips) 
Seat 9: nubpoker ($100 in chips) 
nubpoker: posts small blind $0.50
Spid1: is sitting out 
Chef-Zizou: posts big blind $1
flk.Dasas: sits out 
*** HOLE CARDS ***
Dealt to matiko09 [Kh 2h]
Spid1 leaves the table
matiko09: folds 
CI58 joins the table at seat #1 
mycka86: folds 
Mukhin1: raises $2.02 to $3.02
ThorSun: calls $3.02
Kukuryzka: folds 
nubpoker: folds 
Chef-Zizou: folds 
*** FLOP *** [Ac 8h 8c]
Mukhin1: checks 
ThorSun: checks 
*** TURN *** [Ac 8h 8c] [5d]
Mukhin1: checks 
ThorSun: checks 
*** RIVER *** [Ac 8h 8c 5d] [8s]
Mukhin1: bets $4.43
ThorSun: calls $4.43
*** SHOW DOWN ***
Mukhin1: shows [4s As] (a full house, Eights full of Aces)
ThorSun: mucks hand 
Mukhin1 collected $15.58 from pot
*** SUMMARY ***
Total pot $16.40 | Rake $0.82 
Board [Ac 8h 8c 5d 8s]
Seat 2: Chef-Zizou (big blind) folded before Flop
Seat 4: matiko09 folded before Flop (didn't bet)
Seat 5: mycka86 folded before Flop (didn't bet)
Seat 6: Mukhin1 showed [4s As] and won ($15.58) with a full house, Eights full of Aces
Seat 7: ThorSun mucked [Kd Tc]
Seat 8: Kukuryzka (button) folded before Flop (didn't bet)
Seat 9: nubpoker (small blind) folded before Flop





PokerStars Hand #153068703731:  Hold'em No Limit ($0.50/$1.00 USD) - 2016/05/09 17:14:12 CET [2016/05/09 11:14:12 ET]
Table 'Terpsichore' 9-max Seat #3 is the button
Seat 1: ipashutapkom ($153.87 in chips) 
Seat 2: CI58 ($101.50 in chips) 
Seat 3: matiko09 ($154.39 in chips) 
Seat 4: nubpoker ($130.98 in chips) 
Seat 5: mycka86 ($245.98 in chips) 
Seat 6: Filojoes ($100 in chips) 
Seat 8: Kiosk230472 ($128.03 in chips) 
nubpoker: posts small blind $0.50
mycka86: posts big blind $1
Kukuryzka: sits out 
*** HOLE CARDS ***
Dealt to matiko09 [8d 9d]
Filojoes: folds 
Kiosk230472: calls $1
ipashutapkom: folds 
CI58: raises $3 to $4
matiko09: calls $4
nubpoker: folds 
mycka86: raises $14.50 to $18.50
Kiosk230472: folds 
CI58: folds 
matiko09: folds 
Uncalled bet ($14.50) returned to mycka86
mycka86 collected $13.50 from pot
*** SUMMARY ***
Total pot $13.50 | Rake $0 
Seat 1: ipashutapkom folded before Flop (didn't bet)
Seat 2: CI58 folded before Flop
Seat 3: matiko09 (button) folded before Flop
Seat 4: nubpoker (small blind) folded before Flop
Seat 5: mycka86 (big blind) collected ($13.50)
Seat 6: Filojoes folded before Flop (didn't bet)
Seat 8: Kiosk230472 folded before Flop





PokerStars Hand #153068708453:  Hold'em No Limit ($1/$2 USD) - 2016/05/09 17:14:19 CET [2016/05/09 11:14:19 ET]
Table 'Demeter II' 9-max Seat #9 is the button
Seat 1: Sasuke777777 ($330.32 in chips) 
Seat 2: matiko09 ($216 in chips) 
Seat 3: chaps1988 ($206.90 in chips) 
Seat 5: PacPacBum ($211.17 in chips) 
Seat 7: Siwyosb ($216.64 in chips) 
Seat 8: CI58 ($229.25 in chips) 
Seat 9: Monsthand ($639.13 in chips) 
Sasuke777777: posts small blind $1
matiko09: posts big blind $2
*** HOLE CARDS ***
Dealt to matiko09 [7c 5s]
chaps1988: folds 
HuanHuan joins the table at seat #6 
PacPacBum: folds 
Siwyosb: raises $2 to $4
CI58: raises $8 to $12
Monsthand: folds 
Sasuke777777: folds 
matiko09: folds 
Siwyosb: folds 
Uncalled bet ($8) returned to CI58
CI58 collected $11 from pot
*** SUMMARY ***
Total pot $11 | Rake $0 
Seat 1: Sasuke777777 (small blind) folded before Flop
Seat 2: matiko09 (big blind) folded before Flop
Seat 3: chaps1988 folded before Flop (didn't bet)
Seat 5: PacPacBum folded before Flop (didn't bet)
Seat 7: Siwyosb folded before Flop
Seat 8: CI58 collected ($11)
Seat 9: Monsthand (button) folded before Flop (didn't bet)





PokerStars Hand #153068713257:  Hold'em No Limit ($1/$2 USD) - 2016/05/09 17:14:27 CET [2016/05/09 11:14:27 ET]
Table 'Titan III' 9-max Seat #6 is the button
Seat 1: I The King I ($264.50 in chips) 
Seat 2: PacPacBum ($200 in chips) 
Seat 3: Spid1 ($465.80 in chips) 
Seat 5: Monsthand ($273.25 in chips) 
Seat 6: matiko09 ($200 in chips) 
Seat 7: seasar1 ($154.93 in chips) 
Seat 8: chaps1988 ($213.77 in chips) 
Seat 9: Sasuke777777 ($199.70 in chips) 
seasar1: posts small blind $1
chaps1988: posts big blind $2
HuanHuan: sits out 
*** HOLE CARDS ***
Dealt to matiko09 [Js Kh]
Sasuke777777: calls $2
I The King I: folds 
PacPacBum: folds 
Spid1: folds 
Monsthand: folds 
matiko09: raises $6 to $8
seasar1: folds 
chaps1988: folds 
Sasuke777777: calls $6
*** FLOP *** [8s 3d 5h]
Sasuke777777: checks 
matiko09: bets $9.38
Sasuke777777: raises $16.62 to $26
matiko09: folds 
Uncalled bet ($16.62) returned to Sasuke777777
Sasuke777777 collected $35.87 from pot
Sasuke777777: doesn't show hand 
*** SUMMARY ***
Total pot $37.76 | Rake $1.89 
Board [8s 3d 5h]
Seat 1: I The King I folded before Flop (didn't bet)
Seat 2: PacPacBum folded before Flop (didn't bet)
Seat 3: Spid1 folded before Flop (didn't bet)
Seat 5: Monsthand folded before Flop (didn't bet)
Seat 6: matiko09 (button) folded on the Flop
Seat 7: seasar1 (small blind) folded before Flop
Seat 8: chaps1988 (big blind) folded before Flop
Seat 9: Sasuke777777 collected ($35.87)





PokerStars Hand #153068713048:  Hold'em No Limit ($0.50/$1.00 USD) - 2016/05/09 17:14:27 CET [2016/05/09 11:14:27 ET]
Table 'Buryatia II' 9-max Seat #1 is the button
Seat 1: flk.Dasas ($135.44 in chips) 
Seat 3: Filojoes ($102.50 in chips) 
Seat 5: amisasi ($164.74 in chips) 
Seat 6: I The King I ($124.05 in chips) 
Seat 8: matiko09 ($126.50 in chips) 
Seat 9: CI58 ($118.46 in chips) 
rusher_NiNja will be allowed to play after the button
Filojoes: posts small blind $0.50
maxxmeister: is sitting out 
amisasi: posts big blind $1
HITYESCA: sits out 
*** HOLE CARDS ***
Dealt to matiko09 [Ac Td]
I The King I: folds 
matiko09: raises $2 to $3
CI58: folds 
flk.Dasas: folds 
maxxmeister leaves the table
Dickyxxx joins the table at seat #4 
Filojoes: folds 
amisasi: folds 
Uncalled bet ($2) returned to matiko09
matiko09 collected $2.50 from pot
matiko09: doesn't show hand 
*** SUMMARY ***
Total pot $2.50 | Rake $0 
Seat 1: flk.Dasas (button) folded before Flop (didn't bet)
Seat 3: Filojoes (small blind) folded before Flop
Seat 5: amisasi (big blind) folded before Flop
Seat 6: I The King I folded before Flop (didn't bet)
Seat 8: matiko09 collected ($2.50)
Seat 9: CI58 folded before Flop (didn't bet)





PokerStars Hand #153068724488:  Hold'em No Limit ($1/$2 USD) - 2016/05/09 17:14:45 CET [2016/05/09 11:14:45 ET]
Table 'Bella' 9-max Seat #7 is the button
Seat 1: matiko09 ($200 in chips) 
Seat 2: AlKatrone ($226.94 in chips) 
Seat 3: PacPacBum ($219.57 in chips) 
Seat 4: Spid1 ($200 in chips) 
Seat 5: Monsthand ($202 in chips) 
Seat 6: CI58 ($228.95 in chips) 
Seat 7: stan_09319 ($420.01 in chips) 
matiko09: posts small blind $1
AlKatrone: posts big blind $2
*** HOLE CARDS ***
Dealt to matiko09 [4c Ac]
PacPacBum: raises $2.08 to $4.08
Spid1: folds 
Monsthand: folds 
CI58: folds 
stan_09319: folds 
matiko09: folds 
AlKatrone: calls $2.08
*** FLOP *** [6h Ah 2h]
AlKatrone: checks 
PacPacBum: bets $4.69
AlKatrone: calls $4.69
*** TURN *** [6h Ah 2h] [7c]
AlKatrone: checks 
PacPacBum: bets $9.50
AlKatrone: calls $9.50
*** RIVER *** [6h Ah 2h 7c] [Ks]
AlKatrone: checks 
PacPacBum: checks 
*** SHOW DOWN ***
AlKatrone: shows [Th Td] (a pair of Tens)
PacPacBum: shows [9c As] (a pair of Aces)
PacPacBum collected $35.66 from pot
*** SUMMARY ***
Total pot $37.54 | Rake $1.88 
Board [6h Ah 2h 7c Ks]
Seat 1: matiko09 (small blind) folded before Flop
Seat 2: AlKatrone (big blind) showed [Th Td] and lost with a pair of Tens
Seat 3: PacPacBum showed [9c As] and won ($35.66) with a pair of Aces
Seat 4: Spid1 folded before Flop (didn't bet)
Seat 5: Monsthand folded before Flop (didn't bet)
Seat 6: CI58 folded before Flop (didn't bet)
Seat 7: stan_09319 (button) folded before Flop (didn't bet)





PokerStars Hand #153068724546:  Hold'em No Limit ($0.50/$1.00 USD) - 2016/05/09 17:14:46 CET [2016/05/09 11:14:46 ET]
Table 'Reiss' 9-max Seat #7 is the button
Seat 1: Dickyxxx ($164.66 in chips) 
Seat 2: mycka86 ($187.25 in chips) 
Seat 3: chaps1988 ($116.09 in chips) 
Seat 4: CI58 ($102.04 in chips) 
Seat 5: matiko09 ($135.21 in chips) 
Seat 6: HITYESCA ($100 in chips) 
Seat 7: nubpoker ($132.79 in chips) 
Seat 9: flyer9898 ($66 in chips) 
JimineyCrik will be allowed to play after the button
flyer9898: posts small blind $0.50
Dickyxxx: posts big blind $1
*** HOLE CARDS ***
Dealt to matiko09 [Jd 4s]
mycka86: folds 
chaps1988: raises $2 to $3
CI58: calls $3
matiko09: folds 
HITYESCA: folds 
nubpoker: folds 
flyer9898: folds 
Dickyxxx: folds 
*** FLOP *** [2s 5h Kh]
chaps1988: checks 
CI58: bets $3.56
chaps1988: folds 
Uncalled bet ($3.56) returned to CI58
CI58 collected $7.12 from pot
CI58: doesn't show hand 
*** SUMMARY ***
Total pot $7.50 | Rake $0.38 
Board [2s 5h Kh]
Seat 1: Dickyxxx (big blind) folded before Flop
Seat 2: mycka86 folded before Flop (didn't bet)
Seat 3: chaps1988 folded on the Flop
Seat 4: CI58 collected ($7.12)
Seat 5: matiko09 folded before Flop (didn't bet)
Seat 6: HITYESCA folded before Flop (didn't bet)
Seat 7: nubpoker (button) folded before Flop (didn't bet)
Seat 9: flyer9898 (small blind) folded before Flop





PokerStars Hand #153068728320:  Hold'em No Limit ($1/$2 USD) - 2016/05/09 17:14:52 CET [2016/05/09 11:14:52 ET]
Table 'Demeter II' 9-max Seat #1 is the button
Seat 1: Sasuke777777 ($329.32 in chips) 
Seat 2: matiko09 ($214 in chips) 
Seat 3: chaps1988 ($206.90 in chips) 
Seat 5: PacPacBum ($211.17 in chips) 
Seat 7: Siwyosb ($212.64 in chips) 
Seat 8: CI58 ($236.25 in chips) 
Seat 9: Monsthand ($639.13 in chips) 
matiko09: posts small blind $1
chaps1988: posts big blind $2
HuanHuan: sits out 
*** HOLE CARDS ***
Dealt to matiko09 [6s Qs]
PacPacBum: raises $2.08 to $4.08
Siwyosb: folds 
CI58: folds 
Monsthand: folds 
Sasuke777777: folds 
matiko09: folds 
chaps1988: folds 
Uncalled bet ($2.08) returned to PacPacBum
PacPacBum collected $5 from pot
PacPacBum: doesn't show hand 
*** SUMMARY ***
Total pot $5 | Rake $0 
Seat 1: Sasuke777777 (button) folded before Flop (didn't bet)
Seat 2: matiko09 (small blind) folded before Flop
Seat 3: chaps1988 (big blind) folded before Flop
Seat 5: PacPacBum collected ($5)
Seat 7: Siwyosb folded before Flop (didn't bet)
Seat 8: CI58 folded before Flop (didn't bet)
Seat 9: Monsthand folded before Flop (didn't bet)





PokerStars Hand #153068734899:  Hold'em No Limit ($1/$2 USD) - 2016/05/09 17:15:02 CET [2016/05/09 11:15:02 ET]
Table 'Celaeno II' 9-max Seat #9 is the button
Seat 1: LRVAV7 ($201.65 in chips) 
Seat 2: PacPacBum ($415.51 in chips) 
Seat 3: CI58 ($207.35 in chips) 
Seat 4: matiko09 ($423.82 in chips) 
Seat 5: Monsthand ($229.06 in chips) 
Seat 8: chaps1988 ($221.31 in chips) 
Seat 9: Spid1 ($303.87 in chips) 
LRVAV7: posts small blind $1
PacPacBum: posts big blind $2
HuanHuan: sits out 
*** HOLE CARDS ***
Dealt to matiko09 [6d Qd]
CI58: raises $4 to $6
matiko09: folds 
Monsthand: folds 
chaps1988: folds 
Spid1: folds 
LRVAV7: calls $5
PacPacBum: folds 
*** FLOP *** [7d Jc Kc]
LRVAV7: checks 
CI58: bets $8
LRVAV7: calls $8
*** TURN *** [7d Jc Kc] [3d]
LRVAV7: checks 
CI58: bets $16
LRVAV7: calls $16
*** RIVER *** [7d Jc Kc 3d] [Qh]
LRVAV7: checks 
CI58: checks 
*** SHOW DOWN ***
LRVAV7: shows [Ks Ts] (a pair of Kings)
CI58: shows [Ad Kd] (a pair of Kings - Ace kicker)
CI58 collected $59.25 from pot
*** SUMMARY ***
Total pot $62 | Rake $2.75 
Board [7d Jc Kc 3d Qh]
Seat 1: LRVAV7 (small blind) showed [Ks Ts] and lost with a pair of Kings
Seat 2: PacPacBum (big blind) folded before Flop
Seat 3: CI58 showed [Ad Kd] and won ($59.25) with a pair of Kings
Seat 4: matiko09 folded before Flop (didn't bet)
Seat 5: Monsthand folded before Flop (didn't bet)
Seat 8: chaps1988 folded before Flop (didn't bet)
Seat 9: Spid1 (button) folded before Flop (didn't bet)





PokerStars Hand #153068734841:  Hold'em No Limit ($1/$2 USD) - 2016/05/09 17:15:02 CET [2016/05/09 11:15:02 ET]
Table 'Hagar II' 9-max Seat #9 is the button
Seat 2: darren1031 ($155.98 in chips) 
Seat 3: Sasuke777777 ($42.62 in chips) 
Seat 4: matiko09 ($434.49 in chips) 
Seat 5: PacPacBum ($278.47 in chips) 
Seat 6: el Fatto ($211.35 in chips) 
Seat 7: Monsthand ($315.12 in chips) 
Seat 9: chaps1988 ($393.47 in chips) 
CI58 will be allowed to play after the button
darren1031: posts small blind $1
Sasuke777777: posts big blind $2
*** HOLE CARDS ***
Dealt to matiko09 [Qd 4c]
matiko09: folds 
PacPacBum: raises $3 to $5
el Fatto: folds 
Monsthand: folds 
chaps1988: folds 
darren1031: folds 
Sasuke777777: raises $7 to $12
PacPacBum: calls $7
*** FLOP *** [9c Jd 9d]
Sasuke777777: bets $30.62 and is all-in
PacPacBum: folds 
Uncalled bet ($30.62) returned to Sasuke777777
Sasuke777777 collected $23.75 from pot
Sasuke777777: doesn't show hand 
*** SUMMARY ***
Total pot $25 | Rake $1.25 
Board [9c Jd 9d]
Seat 2: darren1031 (small blind) folded before Flop
Seat 3: Sasuke777777 (big blind) collected ($23.75)
Seat 4: matiko09 folded before Flop (didn't bet)
Seat 5: PacPacBum folded on the Flop
Seat 6: el Fatto folded before Flop (didn't bet)
Seat 7: Monsthand folded before Flop (didn't bet)
Seat 9: chaps1988 (button) folded before Flop (didn't bet)





PokerStars Hand #153068735146:  Hold'em No Limit ($0.50/$1.00 USD) - 2016/05/09 17:15:03 CET [2016/05/09 11:15:03 ET]
Table 'Eucharis' 9-max Seat #9 is the button
Seat 2: Chef-Zizou ($75.10 in chips) 
Seat 3: flk.Dasas ($100 in chips) 
Seat 4: matiko09 ($108.07 in chips) 
Seat 5: mycka86 ($162.84 in chips) 
Seat 6: Mukhin1 ($115.31 in chips) 
Seat 7: ThorSun ($55.11 in chips) 
Seat 8: Kukuryzka ($119.03 in chips) 
Seat 9: nubpoker ($100 in chips) 
CI58 will be allowed to play after the button
Chef-Zizou: posts small blind $0.50
flk.Dasas: posts big blind $1
*** HOLE CARDS ***
Dealt to matiko09 [4d Kh]
matiko09: folds 
mycka86: folds 
Mukhin1: folds 
ThorSun: raises $2 to $3
Kukuryzka: folds 
nubpoker: folds 
Chef-Zizou: calls $2.50
flk.Dasas: folds 
*** FLOP *** [Jh 8c Kc]
Chef-Zizou: checks 
ThorSun: bets $6
Chef-Zizou: folds 
Uncalled bet ($6) returned to ThorSun
ThorSun collected $6.65 from pot
ThorSun: doesn't show hand 
*** SUMMARY ***
Total pot $7 | Rake $0.35 
Board [Jh 8c Kc]
Seat 2: Chef-Zizou (small blind) folded on the Flop
Seat 3: flk.Dasas (big blind) folded before Flop
Seat 4: matiko09 folded before Flop (didn't bet)
Seat 5: mycka86 folded before Flop (didn't bet)
Seat 6: Mukhin1 folded before Flop (didn't bet)
Seat 7: ThorSun collected ($6.65)
Seat 8: Kukuryzka folded before Flop (didn't bet)
Seat 9: nubpoker (button) folded before Flop (didn't bet)





PokerStars Hand #153068741137:  Hold'em No Limit ($0.50/$1.00 USD) - 2016/05/09 17:15:12 CET [2016/05/09 11:15:12 ET]
Table 'Terpsichore' 9-max Seat #4 is the button
Seat 1: ipashutapkom ($153.87 in chips) 
Seat 2: CI58 ($100 in chips) 
Seat 3: matiko09 ($150.39 in chips) 
Seat 4: nubpoker ($130.48 in chips) 
Seat 5: mycka86 ($255.48 in chips) 
Seat 6: Filojoes ($100 in chips) 
Seat 8: Kiosk230472 ($127.03 in chips) 
mycka86: posts small blind $0.50
Filojoes: posts big blind $1
Kukuryzka: sits out 
*** HOLE CARDS ***
Dealt to matiko09 [3h 8h]
Kiosk230472: calls $1
ipashutapkom: raises $3.26 to $4.26
CI58: folds 
matiko09: folds 
nubpoker: folds 
mycka86: folds 
Filojoes: folds 
Kiosk230472: calls $3.26
*** FLOP *** [2d 4c As]
Kiosk230472: checks 
ipashutapkom: bets $7.88
Kiosk230472: folds 
Uncalled bet ($7.88) returned to ipashutapkom
ipashutapkom collected $9.52 from pot
ipashutapkom: doesn't show hand 
*** SUMMARY ***
Total pot $10.02 | Rake $0.50 
Board [2d 4c As]
Seat 1: ipashutapkom collected ($9.52)
Seat 2: CI58 folded before Flop (didn't bet)
Seat 3: matiko09 folded before Flop (didn't bet)
Seat 4: nubpoker (button) folded before Flop (didn't bet)
Seat 5: mycka86 (small blind) folded before Flop
Seat 6: Filojoes (big blind) folded before Flop
Seat 8: Kiosk230472 folded on the Flop





PokerStars Hand #153068740903:  Hold'em No Limit ($1/$2 USD) - 2016/05/09 17:15:12 CET [2016/05/09 11:15:12 ET]
Table 'Demeter II' 9-max Seat #2 is the button
Seat 1: Sasuke777777 ($329.32 in chips) 
Seat 2: matiko09 ($213 in chips) 
Seat 3: chaps1988 ($204.90 in chips) 
Seat 5: PacPacBum ($214.17 in chips) 
Seat 7: Siwyosb ($212.64 in chips) 
Seat 8: CI58 ($236.25 in chips) 
Seat 9: Monsthand ($639.13 in chips) 
chaps1988: posts small blind $1
PacPacBum: posts big blind $2
HuanHuan: sits out 
*** HOLE CARDS ***
Dealt to matiko09 [Js Qh]
Siwyosb: folds 
CI58: folds 
Monsthand: folds 
Sasuke777777: folds 
matiko09: raises $2.54 to $4.54
chaps1988: raises $12.96 to $17.50
PacPacBum: raises $22.50 to $40
matiko09: folds 
chaps1988: folds 
Uncalled bet ($22.50) returned to PacPacBum
PacPacBum collected $39.54 from pot
PacPacBum: doesn't show hand 
*** SUMMARY ***
Total pot $39.54 | Rake $0 
Seat 1: Sasuke777777 folded before Flop (didn't bet)
Seat 2: matiko09 (button) folded before Flop
Seat 3: chaps1988 (small blind) folded before Flop
Seat 5: PacPacBum (big blind) collected ($39.54)
Seat 7: Siwyosb folded before Flop (didn't bet)
Seat 8: CI58 folded before Flop (didn't bet)
Seat 9: Monsthand folded before Flop (didn't bet)





PokerStars Hand #153068746917:  Hold'em No Limit ($0.50/$1.00 USD) - 2016/05/09 17:15:21 CET [2016/05/09 11:15:21 ET]
Table 'Buryatia II' 9-max Seat #3 is the button
Seat 1: flk.Dasas ($135.44 in chips) 
Seat 3: Filojoes ($102 in chips) 
Seat 5: amisasi ($163.74 in chips) 
Seat 6: I The King I ($124.05 in chips) 
Seat 8: matiko09 ($128 in chips) 
Seat 9: CI58 ($118.46 in chips) 
Dickyxxx will be allowed to play after the button
amisasi: posts small blind $0.50
I The King I: posts big blind $1
HITYESCA: sits out 
rusher_NiNja: sits out 
*** HOLE CARDS ***
Dealt to matiko09 [3d 2c]
matiko09: folds 
CI58: folds 
flk.Dasas: folds 
Filojoes: raises $1 to $2
amisasi: calls $1.50
I The King I: folds 
*** FLOP *** [9c 2s Ad]
amisasi: checks 
Filojoes: checks 
*** TURN *** [9c 2s Ad] [Jc]
amisasi: bets $2.37
Filojoes: folds 
Uncalled bet ($2.37) returned to amisasi
amisasi collected $4.75 from pot
*** SUMMARY ***
Total pot $5 | Rake $0.25 
Board [9c 2s Ad Jc]
Seat 1: flk.Dasas folded before Flop (didn't bet)
Seat 3: Filojoes (button) folded on the Turn
Seat 5: amisasi (small blind) collected ($4.75)
Seat 6: I The King I (big blind) folded before Flop
Seat 8: matiko09 folded before Flop (didn't bet)
Seat 9: CI58 folded before Flop (didn't bet)





PokerStars Hand #153068747844:  Hold'em No Limit ($0.50/$1.00 USD) - 2016/05/09 17:15:23 CET [2016/05/09 11:15:23 ET]
Table 'Reiss' 9-max Seat #9 is the button
Seat 1: Dickyxxx ($163.66 in chips) 
Seat 2: mycka86 ($187.25 in chips) 
Seat 3: chaps1988 ($113.09 in chips) 
Seat 4: CI58 ($106.16 in chips) 
Seat 5: matiko09 ($135.21 in chips) 
Seat 6: HITYESCA ($100 in chips) 
Seat 7: nubpoker ($132.79 in chips) 
Seat 9: flyer9898 ($65.50 in chips) 
Dickyxxx: posts small blind $0.50
mycka86: posts big blind $1
JimineyCrik: sits out 
*** HOLE CARDS ***
Dealt to matiko09 [7s Qc]
chaps1988: raises $1 to $2
CI58: folds 
matiko09: folds 
HITYESCA: calls $2
Dickyxxx said, "chaps where u from bro"
nubpoker: folds 
flyer9898: folds 
Dickyxxx: folds 
mycka86: folds 
*** FLOP *** [4d 4s Tc]
chaps1988: bets $2.61
HITYESCA: calls $2.61
*** TURN *** [4d 4s Tc] [Kc]
chaps1988: checks 
HITYESCA: bets $7
chaps1988: calls $7
*** RIVER *** [4d 4s Tc Kc] [6s]
chaps1988: checks 
HITYESCA: checks 
*** SHOW DOWN ***
chaps1988: shows [Ts As] (two pair, Tens and Fours)
HITYESCA: mucks hand 
chaps1988 collected $23.48 from pot
*** SUMMARY ***
Total pot $24.72 | Rake $1.24 
Board [4d 4s Tc Kc 6s]
Seat 1: Dickyxxx (small blind) folded before Flop
Seat 2: mycka86 (big blind) folded before Flop
Seat 3: chaps1988 showed [Ts As] and won ($23.48) with two pair, Tens and Fours
Seat 4: CI58 folded before Flop (didn't bet)
Seat 5: matiko09 folded before Flop (didn't bet)
Seat 6: HITYESCA mucked [Qh Ah]
Seat 7: nubpoker folded before Flop (didn't bet)
Seat 9: flyer9898 (button) folded before Flop (didn't bet)





PokerStars Hand #153068749541:  Hold'em No Limit ($1/$2 USD) - 2016/05/09 17:15:26 CET [2016/05/09 11:15:26 ET]
Table 'Titan III' 9-max Seat #7 is the button
Seat 1: I The King I ($264.50 in chips) 
Seat 2: PacPacBum ($200 in chips) 
Seat 3: Spid1 ($465.80 in chips) 
Seat 5: Monsthand ($273.25 in chips) 
Seat 6: matiko09 ($200 in chips) 
Seat 7: seasar1 ($153.93 in chips) 
Seat 8: chaps1988 ($211.77 in chips) 
Seat 9: Sasuke777777 ($218.19 in chips) 
chaps1988: posts small blind $1
Sasuke777777: posts big blind $2
HuanHuan: sits out 
*** HOLE CARDS ***
Dealt to matiko09 [3d Td]
I The King I: folds 
PacPacBum: folds 
Spid1: folds 
Monsthand: folds 
matiko09: folds 
seasar1: folds 
chaps1988: raises $4 to $6
Sasuke777777: calls $4
*** FLOP *** [As 8c 8h]
chaps1988: bets $3.50
Sasuke777777: raises $3.50 to $7
chaps1988: calls $3.50
*** TURN *** [As 8c 8h] [Ah]
chaps1988: checks 
Sasuke777777: checks 
*** RIVER *** [As 8c 8h Ah] [Kh]
chaps1988: bets $14
Sasuke777777: calls $14
*** SHOW DOWN ***
chaps1988: shows [6h 6c] (two pair, Aces and Eights)
Sasuke777777: shows [Kc Qd] (two pair, Aces and Kings)
Sasuke777777 collected $51.30 from pot
*** SUMMARY ***
Total pot $54 | Rake $2.70 
Board [As 8c 8h Ah Kh]
Seat 1: I The King I folded before Flop (didn't bet)
Seat 2: PacPacBum folded before Flop (didn't bet)
Seat 3: Spid1 folded before Flop (didn't bet)
Seat 5: Monsthand folded before Flop (didn't bet)
Seat 6: matiko09 folded before Flop (didn't bet)
Seat 7: seasar1 (button) folded before Flop (didn't bet)
Seat 8: chaps1988 (small blind) showed [6h 6c] and lost with two pair, Aces and Eights
Seat 9: Sasuke777777 (big blind) showed [Kc Qd] and won ($51.30) with two pair, Aces and Kings





PokerStars Hand #153068750575:  Hold'em No Limit ($0.50/$1.00 USD) - 2016/05/09 17:15:27 CET [2016/05/09 11:15:27 ET]
Table 'Orthos' 9-max Seat #3 is the button
Seat 1: Kelvin sai ($74.06 in chips) 
Seat 2: PacPacBum ($114.67 in chips) 
Seat 3: Filojoes ($105.04 in chips) 
Seat 4: nubpoker ($153.65 in chips) 
Seat 5: matiko09 ($115.70 in chips) 
Seat 6: xhinostrabli ($99.11 in chips) 
Seat 7: flk.Dasas ($158.40 in chips) 
Seat 8: Dickyxxx ($103.67 in chips) 
Seat 9: mycka86 ($106.18 in chips) 
nubpoker: posts small blind $0.50
matiko09: posts big blind $1
*** HOLE CARDS ***
Dealt to matiko09 [Qs 3c]
xhinostrabli: folds 
flk.Dasas: folds 
Dickyxxx: folds 
mycka86: folds 
Kelvin sai: raises $1 to $2
PacPacBum: raises $4 to $6
Filojoes: folds 
nubpoker: folds 
matiko09: folds 
Kelvin sai: calls $4
*** FLOP *** [Ks Tc 4d]
Kelvin sai: checks 
PacPacBum: bets $4.48
Kelvin sai: folds 
Uncalled bet ($4.48) returned to PacPacBum
PacPacBum collected $12.82 from pot
PacPacBum: doesn't show hand 
*** SUMMARY ***
Total pot $13.50 | Rake $0.68 
Board [Ks Tc 4d]
Seat 1: Kelvin sai folded on the Flop
Seat 2: PacPacBum collected ($12.82)
Seat 3: Filojoes (button) folded before Flop (didn't bet)
Seat 4: nubpoker (small blind) folded before Flop
Seat 5: matiko09 (big blind) folded before Flop
Seat 6: xhinostrabli folded before Flop (didn't bet)
Seat 7: flk.Dasas folded before Flop (didn't bet)
Seat 8: Dickyxxx folded before Flop (didn't bet)
Seat 9: mycka86 folded before Flop (didn't bet)





PokerStars Hand #153068761869:  Hold'em No Limit ($0.50/$1.00 USD) - 2016/05/09 17:15:46 CET [2016/05/09 11:15:46 ET]
Table 'Merga II' 9-max Seat #3 is the button
Seat 1: R1aki ($102 in chips) 
Seat 2: Spid1 ($100 in chips) 
Seat 3: 43605511 ($100 in chips) 
Seat 4: erick222 ($100 in chips) 
Seat 5: matiko09 ($100 in chips) 
Seat 6: AlKatrone ($100 in chips) 
Seat 7: rusher_NiNja ($219.70 in chips) 
Seat 8: serbianhaze ($100 in chips) 
Seat 9: maxxmeister ($100 in chips) 
erick222: posts small blind $0.50
matiko09: posts big blind $1
*** HOLE CARDS ***
Dealt to matiko09 [3h 4h]
AlKatrone: folds 
rusher_NiNja: raises $1.50 to $2.50
serbianhaze: folds 
maxxmeister: folds 
R1aki: folds 
Spid1: folds 
43605511: folds 
erick222: folds 
matiko09: folds 
Uncalled bet ($1.50) returned to rusher_NiNja
rusher_NiNja collected $2.50 from pot
rusher_NiNja: doesn't show hand 
*** SUMMARY ***
Total pot $2.50 | Rake $0 
Seat 1: R1aki folded before Flop (didn't bet)
Seat 2: Spid1 folded before Flop (didn't bet)
Seat 3: 43605511 (button) folded before Flop (didn't bet)
Seat 4: erick222 (small blind) folded before Flop
Seat 5: matiko09 (big blind) folded before Flop
Seat 6: AlKatrone folded before Flop (didn't bet)
Seat 7: rusher_NiNja collected ($2.50)
Seat 8: serbianhaze folded before Flop (didn't bet)
Seat 9: maxxmeister folded before Flop (didn't bet)





PokerStars Hand #153068771461:  Hold'em No Limit ($0.50/$1.00 USD) - 2016/05/09 17:16:01 CET [2016/05/09 11:16:01 ET]
Table 'Terpsichore' 9-max Seat #5 is the button
Seat 1: ipashutapkom ($159.13 in chips) 
Seat 2: CI58 ($100 in chips) 
Seat 3: matiko09 ($150.39 in chips) 
Seat 4: nubpoker ($130.48 in chips) 
Seat 5: mycka86 ($254.98 in chips) 
Seat 6: Filojoes ($100 in chips) 
Seat 7: Kukuryzka ($100 in chips) 
Seat 8: Kiosk230472 ($122.77 in chips) 
Filojoes: posts small blind $0.50
Kukuryzka: posts big blind $1
*** HOLE CARDS ***
Dealt to matiko09 [8s Tc]
Kiosk230472: calls $1
ipashutapkom: folds 
CI58: folds 
matiko09: folds 
nubpoker: folds 
mycka86: folds 
Filojoes: raises $3 to $4
Kukuryzka: folds 
Kiosk230472: calls $3
*** FLOP *** [Qd Th 7d]
Filojoes: bets $4.88
Kiosk230472: calls $4.88
*** TURN *** [Qd Th 7d] [5h]
Filojoes: bets $10.69
Kiosk230472: folds 
Uncalled bet ($10.69) returned to Filojoes
Filojoes collected $17.82 from pot
Filojoes: doesn't show hand 
*** SUMMARY ***
Total pot $18.76 | Rake $0.94 
Board [Qd Th 7d 5h]
Seat 1: ipashutapkom folded before Flop (didn't bet)
Seat 2: CI58 folded before Flop (didn't bet)
Seat 3: matiko09 folded before Flop (didn't bet)
Seat 4: nubpoker folded before Flop (didn't bet)
Seat 5: mycka86 (button) folded before Flop (didn't bet)
Seat 6: Filojoes (small blind) collected ($17.82)
Seat 7: Kukuryzka (big blind) folded before Flop
Seat 8: Kiosk230472 folded on the Turn





PokerStars Hand #153068774658:  Hold'em No Limit ($1/$2 USD) - 2016/05/09 17:16:06 CET [2016/05/09 11:16:06 ET]
Table 'Hagar II' 9-max Seat #2 is the button
Seat 2: darren1031 ($154.98 in chips) 
Seat 3: Sasuke777777 ($54.37 in chips) 
Seat 4: matiko09 ($434.49 in chips) 
Seat 5: PacPacBum ($266.47 in chips) 
Seat 6: el Fatto ($211.35 in chips) 
Seat 7: Monsthand ($315.12 in chips) 
Seat 9: chaps1988 ($393.47 in chips) 
Sasuke777777: posts small blind $1
matiko09: posts big blind $2
CI58: sits out 
*** HOLE CARDS ***
Dealt to matiko09 [3h Kh]
PacPacBum: folds 
el Fatto: folds 
Monsthand: folds 
chaps1988: folds 
darren1031: calls $2
Sasuke777777: raises $4 to $6
matiko09: folds 
darren1031: raises $50 to $56
Sasuke777777: folds [9d Kd]
Uncalled bet ($50) returned to darren1031
darren1031 collected $14 from pot
darren1031: doesn't show hand 
*** SUMMARY ***
Total pot $14 | Rake $0 
Seat 2: darren1031 (button) collected ($14)
Seat 3: Sasuke777777 (small blind) folded before Flop
Seat 4: matiko09 (big blind) folded before Flop
Seat 5: PacPacBum folded before Flop (didn't bet)
Seat 6: el Fatto folded before Flop (didn't bet)
Seat 7: Monsthand folded before Flop (didn't bet)
Seat 9: chaps1988 folded before Flop (didn't bet)





PokerStars Hand #153068775489:  Hold'em No Limit ($0.50/$1.00 USD) - 2016/05/09 17:16:07 CET [2016/05/09 11:16:07 ET]
Table 'Buryatia II' 9-max Seat #5 is the button
Seat 1: flk.Dasas ($135.44 in chips) 
Seat 3: Filojoes ($100 in chips) 
Seat 5: amisasi ($166.49 in chips) 
Seat 6: I The King I ($123.05 in chips) 
Seat 7: HITYESCA ($100 in chips) 
Seat 8: matiko09 ($128 in chips) 
Seat 9: CI58 ($118.46 in chips) 
I The King I: posts small blind $0.50
HITYESCA: posts big blind $1
rusher_NiNja: sits out 
Dickyxxx: sits out 
*** HOLE CARDS ***
Dealt to matiko09 [7d 8s]
matiko09: folds 
CI58: raises $2 to $3
flk.Dasas: folds 
Filojoes: folds 
amisasi: folds 
I The King I: folds 
HITYESCA: folds 
Uncalled bet ($2) returned to CI58
CI58 collected $2.50 from pot
CI58: doesn't show hand 
*** SUMMARY ***
Total pot $2.50 | Rake $0 
Seat 1: flk.Dasas folded before Flop (didn't bet)
Seat 3: Filojoes folded before Flop (didn't bet)
Seat 5: amisasi (button) folded before Flop (didn't bet)
Seat 6: I The King I (small blind) folded before Flop
Seat 7: HITYESCA (big blind) folded before Flop
Seat 8: matiko09 folded before Flop (didn't bet)
Seat 9: CI58 collected ($2.50)





PokerStars Hand #153068776337:  Hold'em No Limit ($1/$2 USD) - 2016/05/09 17:16:09 CET [2016/05/09 11:16:09 ET]
Table 'Bella' 9-max Seat #1 is the button
Seat 1: matiko09 ($200 in chips) 
Seat 2: AlKatrone ($208.67 in chips) 
Seat 3: PacPacBum ($236.96 in chips) 
Seat 4: Spid1 ($200 in chips) 
Seat 5: Monsthand ($202 in chips) 
Seat 6: CI58 ($228.95 in chips) 
Seat 7: stan_09319 ($420.01 in chips) 
AlKatrone: posts small blind $1
PacPacBum: posts big blind $2
*** HOLE CARDS ***
Dealt to matiko09 [Tc 3d]
Spid1: folds 
Monsthand: folds 
CI58: raises $4 to $6
stan_09319: folds 
matiko09: folds 
AlKatrone: folds 
PacPacBum: calls $4
*** FLOP *** [Ks Jd 9s]
PacPacBum: checks 
CI58: bets $6.17
PacPacBum: folds 
Uncalled bet ($6.17) returned to CI58
CI58 collected $12.35 from pot
CI58: doesn't show hand 
*** SUMMARY ***
Total pot $13 | Rake $0.65 
Board [Ks Jd 9s]
Seat 1: matiko09 (button) folded before Flop (didn't bet)
Seat 2: AlKatrone (small blind) folded before Flop
Seat 3: PacPacBum (big blind) folded on the Flop
Seat 4: Spid1 folded before Flop (didn't bet)
Seat 5: Monsthand folded before Flop (didn't bet)
Seat 6: CI58 collected ($12.35)
Seat 7: stan_09319 folded before Flop (didn't bet)





PokerStars Hand #153068778085:  Hold'em No Limit ($0.50/$1.00 USD) - 2016/05/09 17:16:12 CET [2016/05/09 11:16:12 ET]
Table 'Merga II' 9-max Seat #4 is the button
Seat 1: R1aki ($102 in chips) 
Seat 2: Spid1 ($100 in chips) 
Seat 3: 43605511 ($100 in chips) 
Seat 4: erick222 ($100 in chips) 
Seat 5: matiko09 ($100 in chips) 
Seat 6: AlKatrone ($100 in chips) 
Seat 7: rusher_NiNja ($221.20 in chips) 
Seat 8: serbianhaze ($100 in chips) 
Seat 9: maxxmeister ($100 in chips) 
matiko09: posts small blind $0.50
AlKatrone: posts big blind $1
*** HOLE CARDS ***
Dealt to matiko09 [2h 2c]
rusher_NiNja: folds 
serbianhaze: folds 
maxxmeister: folds 
R1aki: folds 
Spid1: folds 
43605511: folds 
erick222: raises $2.50 to $3.50
matiko09: folds 
AlKatrone: folds 
Uncalled bet ($2.50) returned to erick222
erick222 collected $2.50 from pot
erick222: doesn't show hand 
*** SUMMARY ***
Total pot $2.50 | Rake $0 
Seat 1: R1aki folded before Flop (didn't bet)
Seat 2: Spid1 folded before Flop (didn't bet)
Seat 3: 43605511 folded before Flop (didn't bet)
Seat 4: erick222 (button) collected ($2.50)
Seat 5: matiko09 (small blind) folded before Flop
Seat 6: AlKatrone (big blind) folded before Flop
Seat 7: rusher_NiNja folded before Flop (didn't bet)
Seat 8: serbianhaze folded before Flop (didn't bet)
Seat 9: maxxmeister folded before Flop (didn't bet)





PokerStars Hand #153068781371:  Hold'em No Limit ($1/$2 USD) - 2016/05/09 17:16:17 CET [2016/05/09 11:16:17 ET]
Table 'Celaeno II' 9-max Seat #1 is the button
Seat 1: LRVAV7 ($200 in chips) 
Seat 2: PacPacBum ($413.51 in chips) 
Seat 3: CI58 ($236.60 in chips) 
Seat 4: matiko09 ($423.82 in chips) 
Seat 5: Monsthand ($229.06 in chips) 
Seat 8: chaps1988 ($221.31 in chips) 
Seat 9: Spid1 ($303.87 in chips) 
PacPacBum: posts small blind $1
CI58: posts big blind $2
HuanHuan: sits out 
*** HOLE CARDS ***
Dealt to matiko09 [Qh Qc]
matiko09: raises $3 to $5
Monsthand: folds 
chaps1988: folds 
Spid1: folds 
LRVAV7: folds 
PacPacBum: folds 
CI58: folds 
Uncalled bet ($3) returned to matiko09
matiko09 collected $5 from pot
matiko09: doesn't show hand 
*** SUMMARY ***
Total pot $5 | Rake $0 
Seat 1: LRVAV7 (button) folded before Flop (didn't bet)
Seat 2: PacPacBum (small blind) folded before Flop
Seat 3: CI58 (big blind) folded before Flop
Seat 4: matiko09 collected ($5)
Seat 5: Monsthand folded before Flop (didn't bet)
Seat 8: chaps1988 folded before Flop (didn't bet)
Seat 9: Spid1 folded before Flop (didn't bet)





PokerStars Hand #153068783518:  Hold'em No Limit ($1/$2 USD) - 2016/05/09 17:16:20 CET [2016/05/09 11:16:20 ET]
Table 'Titan III' 9-max Seat #8 is the button
Seat 1: I The King I ($264.50 in chips) 
Seat 2: PacPacBum ($200 in chips) 
Seat 3: Spid1 ($465.80 in chips) 
Seat 5: Monsthand ($273.25 in chips) 
Seat 6: matiko09 ($200 in chips) 
Seat 7: seasar1 ($153.93 in chips) 
Seat 8: chaps1988 ($200 in chips) 
Seat 9: Sasuke777777 ($242.49 in chips) 
Sasuke777777: posts small blind $1
I The King I: posts big blind $2
HuanHuan: sits out 
*** HOLE CARDS ***
Dealt to matiko09 [6h 8h]
PacPacBum: folds 
Spid1: folds 
Monsthand: folds 
matiko09: raises $3 to $5
seasar1: folds 
chaps1988: folds 
Sasuke777777: folds 
I The King I: folds 
Uncalled bet ($3) returned to matiko09
matiko09 collected $5 from pot
matiko09: doesn't show hand 
*** SUMMARY ***
Total pot $5 | Rake $0 
Seat 1: I The King I (big blind) folded before Flop
Seat 2: PacPacBum folded before Flop (didn't bet)
Seat 3: Spid1 folded before Flop (didn't bet)
Seat 5: Monsthand folded before Flop (didn't bet)
Seat 6: matiko09 collected ($5)
Seat 7: seasar1 folded before Flop (didn't bet)
Seat 8: chaps1988 (button) folded before Flop (didn't bet)
Seat 9: Sasuke777777 (small blind) folded before Flop





PokerStars Hand #153068787100:  Hold'em No Limit ($1/$2 USD) - 2016/05/09 17:16:26 CET [2016/05/09 11:16:26 ET]
Table 'Demeter II' 9-max Seat #3 is the button
Seat 1: Sasuke777777 ($329.32 in chips) 
Seat 2: matiko09 ($208.46 in chips) 
Seat 3: chaps1988 ($200 in chips) 
Seat 5: PacPacBum ($236.21 in chips) 
Seat 6: HuanHuan ($200 in chips) 
Seat 7: Siwyosb ($212.64 in chips) 
Seat 8: CI58 ($236.25 in chips) 
Seat 9: Monsthand ($639.13 in chips) 
PacPacBum: posts small blind $1
HuanHuan: posts big blind $2
*** HOLE CARDS ***
Dealt to matiko09 [8s Qc]
Siwyosb: folds 
CI58: raises $4 to $6
Monsthand: folds 
Sasuke777777: folds 
matiko09: folds 
chaps1988: folds 
PacPacBum: folds 
HuanHuan: calls $4
*** FLOP *** [Qs 5h 6s]
HuanHuan: checks 
CI58: bets $7.41
HuanHuan: raises $18.59 to $26
CI58: folds 
Uncalled bet ($18.59) returned to HuanHuan
HuanHuan collected $26.43 from pot
HuanHuan: doesn't show hand 
*** SUMMARY ***
Total pot $27.82 | Rake $1.39 
Board [Qs 5h 6s]
Seat 1: Sasuke777777 folded before Flop (didn't bet)
Seat 2: matiko09 folded before Flop (didn't bet)
Seat 3: chaps1988 (button) folded before Flop (didn't bet)
Seat 5: PacPacBum (small blind) folded before Flop
Seat 6: HuanHuan (big blind) collected ($26.43)
Seat 7: Siwyosb folded before Flop (didn't bet)
Seat 8: CI58 folded on the Flop
Seat 9: Monsthand folded before Flop (didn't bet)





PokerStars Hand #153068792299:  Hold'em No Limit ($0.50/$1.00 USD) - 2016/05/09 17:16:34 CET [2016/05/09 11:16:34 ET]
Table 'Orthos' 9-max Seat #4 is the button
Seat 1: Kelvin sai ($68.06 in chips) 
Seat 2: PacPacBum ($121.49 in chips) 
Seat 3: Filojoes ($105.04 in chips) 
Seat 4: nubpoker ($153.15 in chips) 
Seat 5: matiko09 ($114.70 in chips) 
Seat 6: xhinostrabli ($99.11 in chips) 
Seat 7: flk.Dasas ($158.40 in chips) 
Seat 8: Dickyxxx ($103.67 in chips) 
Seat 9: mycka86 ($106.18 in chips) 
matiko09: posts small blind $0.50
xhinostrabli: posts big blind $1
*** HOLE CARDS ***
Dealt to matiko09 [5d Tc]
flk.Dasas: folds 
Dickyxxx: folds 
mycka86: raises $2 to $3
Kelvin sai: folds 
PacPacBum: folds 
Filojoes: calls $3
nubpoker: folds 
matiko09: folds 
xhinostrabli: folds 
*** FLOP *** [Jd Th 2h]
mycka86: checks 
Filojoes: bets $4.27
mycka86: calls $4.27
*** TURN *** [Jd Th 2h] [4s]
mycka86: checks 
Filojoes: checks 
*** RIVER *** [Jd Th 2h 4s] [6c]
mycka86: bets $11.50
Filojoes: folds 
Uncalled bet ($11.50) returned to mycka86
mycka86 collected $15.24 from pot
*** SUMMARY ***
Total pot $16.04 | Rake $0.80 
Board [Jd Th 2h 4s 6c]
Seat 1: Kelvin sai folded before Flop (didn't bet)
Seat 2: PacPacBum folded before Flop (didn't bet)
Seat 3: Filojoes folded on the River
Seat 4: nubpoker (button) folded before Flop (didn't bet)
Seat 5: matiko09 (small blind) folded before Flop
Seat 6: xhinostrabli (big blind) folded before Flop
Seat 7: flk.Dasas folded before Flop (didn't bet)
Seat 8: Dickyxxx folded before Flop (didn't bet)
Seat 9: mycka86 collected ($15.24)





PokerStars Hand #153068793694:  Hold'em No Limit ($1/$2 USD) - 2016/05/09 17:16:37 CET [2016/05/09 11:16:37 ET]
Table 'Celaeno II' 9-max Seat #2 is the button
Seat 1: LRVAV7 ($200 in chips) 
Seat 2: PacPacBum ($412.51 in chips) 
Seat 3: CI58 ($234.60 in chips) 
Seat 4: matiko09 ($426.82 in chips) 
Seat 5: Monsthand ($229.06 in chips) 
Seat 8: chaps1988 ($221.31 in chips) 
Seat 9: Spid1 ($303.87 in chips) 
CI58: posts small blind $1
matiko09: posts big blind $2
HuanHuan: sits out 
*** HOLE CARDS ***
Dealt to matiko09 [3d 7d]
Monsthand: folds 
chaps1988: folds 
Spid1: folds 
LRVAV7: folds 
PacPacBum: raises $3 to $5
CI58: folds 
matiko09: folds 
Uncalled bet ($3) returned to PacPacBum
PacPacBum collected $5 from pot
PacPacBum: doesn't show hand 
*** SUMMARY ***
Total pot $5 | Rake $0 
Seat 1: LRVAV7 folded before Flop (didn't bet)
Seat 2: PacPacBum (button) collected ($5)
Seat 3: CI58 (small blind) folded before Flop
Seat 4: matiko09 (big blind) folded before Flop
Seat 5: Monsthand folded before Flop (didn't bet)
Seat 8: chaps1988 folded before Flop (didn't bet)
Seat 9: Spid1 folded before Flop (didn't bet)





PokerStars Hand #153068794322:  Hold'em No Limit ($0.50/$1.00 USD) - 2016/05/09 17:16:38 CET [2016/05/09 11:16:38 ET]
Table 'Reiss' 9-max Seat #1 is the button
Seat 1: Dickyxxx ($163.16 in chips) 
Seat 2: mycka86 ($186.25 in chips) 
Seat 3: chaps1988 ($124.96 in chips) 
Seat 4: CI58 ($106.16 in chips) 
Seat 5: matiko09 ($135.21 in chips) 
Seat 6: HITYESCA ($100 in chips) 
Seat 7: nubpoker ($132.79 in chips) 
Seat 9: flyer9898 ($65.50 in chips) 
mycka86: posts small blind $0.50
chaps1988: posts big blind $1
JimineyCrik: sits out 
*** HOLE CARDS ***
Dealt to matiko09 [8h 7c]
CI58: raises $2 to $3
matiko09: folds 
HITYESCA: folds 
nubpoker: folds 
flyer9898: folds 
Dickyxxx: folds 
mycka86: folds 
chaps1988: folds 
Uncalled bet ($2) returned to CI58
CI58 collected $2.50 from pot
CI58: doesn't show hand 
*** SUMMARY ***
Total pot $2.50 | Rake $0 
Seat 1: Dickyxxx (button) folded before Flop (didn't bet)
Seat 2: mycka86 (small blind) folded before Flop
Seat 3: chaps1988 (big blind) folded before Flop
Seat 4: CI58 collected ($2.50)
Seat 5: matiko09 folded before Flop (didn't bet)
Seat 6: HITYESCA folded before Flop (didn't bet)
Seat 7: nubpoker folded before Flop (didn't bet)
Seat 9: flyer9898 folded before Flop (didn't bet)





PokerStars Hand #153068796422:  Hold'em No Limit ($1/$2 USD) - 2016/05/09 17:16:41 CET [2016/05/09 11:16:41 ET]
Table 'Titan III' 9-max Seat #9 is the button
Seat 1: I The King I ($262.50 in chips) 
Seat 2: PacPacBum ($200 in chips) 
Seat 3: Spid1 ($465.80 in chips) 
Seat 5: Monsthand ($273.25 in chips) 
Seat 6: matiko09 ($203 in chips) 
Seat 7: seasar1 ($153.93 in chips) 
Seat 8: chaps1988 ($200 in chips) 
Seat 9: Sasuke777777 ($241.49 in chips) 
I The King I: posts small blind $1
PacPacBum: posts big blind $2
HuanHuan: sits out 
*** HOLE CARDS ***
Dealt to matiko09 [As 3h]
Spid1: folds 
Monsthand: folds 
matiko09: folds 
seasar1: folds 
chaps1988: folds 
Sasuke777777: folds 
I The King I: raises $4 to $6
PacPacBum: raises $12 to $18
I The King I: calls $12
*** FLOP *** [Kd Ts Qs]
I The King I: checks 
PacPacBum: bets $18.46
I The King I: folds 
Uncalled bet ($18.46) returned to PacPacBum
PacPacBum collected $34.20 from pot
PacPacBum: doesn't show hand 
*** SUMMARY ***
Total pot $36 | Rake $1.80 
Board [Kd Ts Qs]
Seat 1: I The King I (small blind) folded on the Flop
Seat 2: PacPacBum (big blind) collected ($34.20)
Seat 3: Spid1 folded before Flop (didn't bet)
Seat 5: Monsthand folded before Flop (didn't bet)
Seat 6: matiko09 folded before Flop (didn't bet)
Seat 7: seasar1 folded before Flop (didn't bet)
Seat 8: chaps1988 folded before Flop (didn't bet)
Seat 9: Sasuke777777 (button) folded before Flop (didn't bet)





PokerStars Hand #153068796017:  Hold'em No Limit ($0.50/$1.00 USD) - 2016/05/09 17:16:41 CET [2016/05/09 11:16:41 ET]
Table 'Buryatia II' 9-max Seat #6 is the button
Seat 1: flk.Dasas ($135.44 in chips) 
Seat 3: Filojoes ($100 in chips) 
Seat 5: amisasi ($166.49 in chips) 
Seat 6: I The King I ($122.55 in chips) 
Seat 7: HITYESCA ($100 in chips) 
Seat 8: matiko09 ($128 in chips) 
Seat 9: CI58 ($119.96 in chips) 
HITYESCA: posts small blind $0.50
matiko09: posts big blind $1
rusher_NiNja: sits out 
Dickyxxx: sits out 
*** HOLE CARDS ***
Dealt to matiko09 [8h Js]
CI58: folds 
flk.Dasas: raises $2 to $3
Filojoes: folds 
amisasi: calls $3
I The King I: folds 
HITYESCA: folds 
matiko09: folds 
*** FLOP *** [2s 3c 4c]
flk.Dasas: bets $4.84
amisasi: calls $4.84
*** TURN *** [2s 3c 4c] [5c]
flk.Dasas: checks 
amisasi: checks 
*** RIVER *** [2s 3c 4c 5c] [Th]
HITYESCA leaves the table
nubpoker joins the table at seat #7 
flk.Dasas: bets $5.22
amisasi: raises $5.22 to $10.44
flk.Dasas: folds 
Uncalled bet ($5.22) returned to amisasi
amisasi collected $26.24 from pot
*** SUMMARY ***
Total pot $27.62 | Rake $1.38 
Board [2s 3c 4c 5c Th]
Seat 1: flk.Dasas folded on the River
Seat 3: Filojoes folded before Flop (didn't bet)
Seat 5: amisasi collected ($26.24)
Seat 6: I The King I (button) folded before Flop (didn't bet)
Seat 7: HITYESCA (small blind) folded before Flop
Seat 8: matiko09 (big blind) folded before Flop
Seat 9: CI58 folded before Flop (didn't bet)





PokerStars Hand #153068797069:  Hold'em No Limit ($0.50/$1.00 USD) - 2016/05/09 17:16:42 CET [2016/05/09 11:16:42 ET]
Table 'Merga II' 9-max Seat #5 is the button
Seat 1: R1aki ($102 in chips) 
Seat 2: Spid1 ($100 in chips) 
Seat 3: 43605511 ($100 in chips) 
Seat 4: erick222 ($101.50 in chips) 
Seat 5: matiko09 ($100 in chips) 
Seat 6: AlKatrone ($100 in chips) 
Seat 7: rusher_NiNja ($221.20 in chips) 
Seat 8: serbianhaze ($100 in chips) 
Seat 9: maxxmeister ($100 in chips) 
AlKatrone: posts small blind $0.50
rusher_NiNja: posts big blind $1
*** HOLE CARDS ***
Dealt to matiko09 [5c Ad]
serbianhaze: folds 
maxxmeister: folds 
R1aki: raises $1.50 to $2.50
Spid1: folds 
43605511: folds 
erick222: folds 
matiko09: folds 
AlKatrone: folds 
rusher_NiNja: folds 
Uncalled bet ($1.50) returned to R1aki
R1aki collected $2.50 from pot
R1aki: doesn't show hand 
*** SUMMARY ***
Total pot $2.50 | Rake $0 
Seat 1: R1aki collected ($2.50)
Seat 2: Spid1 folded before Flop (didn't bet)
Seat 3: 43605511 folded before Flop (didn't bet)
Seat 4: erick222 folded before Flop (didn't bet)
Seat 5: matiko09 (button) folded before Flop (didn't bet)
Seat 6: AlKatrone (small blind) folded before Flop
Seat 7: rusher_NiNja (big blind) folded before Flop
Seat 8: serbianhaze folded before Flop (didn't bet)
Seat 9: maxxmeister folded before Flop (didn't bet)





PokerStars Hand #153068805336:  Hold'em No Limit ($1/$2 USD) - 2016/05/09 17:16:55 CET [2016/05/09 11:16:55 ET]
Table 'Hagar II' 9-max Seat #3 is the button
Seat 2: darren1031 ($162.98 in chips) 
Seat 3: Sasuke777777 ($48.37 in chips) 
Seat 4: matiko09 ($432.49 in chips) 
Seat 5: PacPacBum ($266.47 in chips) 
Seat 6: el Fatto ($211.35 in chips) 
Seat 7: Monsthand ($315.12 in chips) 
Seat 9: chaps1988 ($393.47 in chips) 
matiko09: posts small blind $1
PacPacBum: posts big blind $2
CI58: sits out 
*** HOLE CARDS ***
Dealt to matiko09 [7c Ad]
el Fatto: folds 
Monsthand: folds 
chaps1988: folds 
darren1031: calls $2
Sasuke777777: calls $2
matiko09: calls $1
PacPacBum: checks 
*** FLOP *** [2h 8s 9h]
matiko09: checks 
PacPacBum: checks 
darren1031: checks 
Sasuke777777: bets $10
matiko09: folds 
PacPacBum: folds 
darren1031: folds 
Uncalled bet ($10) returned to Sasuke777777
Sasuke777777 collected $7.60 from pot
Sasuke777777: doesn't show hand 
*** SUMMARY ***
Total pot $8 | Rake $0.40 
Board [2h 8s 9h]
Seat 2: darren1031 folded on the Flop
Seat 3: Sasuke777777 (button) collected ($7.60)
Seat 4: matiko09 (small blind) folded on the Flop
Seat 5: PacPacBum (big blind) folded on the Flop
Seat 6: el Fatto folded before Flop (didn't bet)
Seat 7: Monsthand folded before Flop (didn't bet)
Seat 9: chaps1988 folded before Flop (didn't bet)





PokerStars Hand #153068808720:  Hold'em No Limit ($1/$2 USD) - 2016/05/09 17:17:01 CET [2016/05/09 11:17:01 ET]
Table 'Bella' 9-max Seat #2 is the button
Seat 1: matiko09 ($200 in chips) 
Seat 2: AlKatrone ($207.67 in chips) 
Seat 3: PacPacBum ($230.96 in chips) 
Seat 5: Monsthand ($202 in chips) 
Seat 6: CI58 ($235.30 in chips) 
Seat 7: stan_09319 ($420.01 in chips) 
PacPacBum: posts small blind $1
Spid1: is sitting out 
Monsthand: posts big blind $2
*** HOLE CARDS ***
Dealt to matiko09 [Js 8h]
Spid1 leaves the table
CI58: folds 
stan_09319: folds 
matiko09: folds 
AlKatrone: folds 
PacPacBum: folds 
Uncalled bet ($1) returned to Monsthand
Monsthand collected $2 from pot
Monsthand: doesn't show hand 
*** SUMMARY ***
Total pot $2 | Rake $0 
Seat 1: matiko09 folded before Flop (didn't bet)
Seat 2: AlKatrone (button) folded before Flop (didn't bet)
Seat 3: PacPacBum (small blind) folded before Flop
Seat 5: Monsthand (big blind) collected ($2)
Seat 6: CI58 folded before Flop (didn't bet)
Seat 7: stan_09319 folded before Flop (didn't bet)





PokerStars Hand #153068810473:  Hold'em No Limit ($0.50/$1.00 USD) - 2016/05/09 17:17:04 CET [2016/05/09 11:17:04 ET]
Table 'Reiss' 9-max Seat #2 is the button
Seat 1: Dickyxxx ($163.16 in chips) 
Seat 2: mycka86 ($185.75 in chips) 
Seat 3: chaps1988 ($123.96 in chips) 
Seat 4: CI58 ($107.66 in chips) 
Seat 5: matiko09 ($135.21 in chips) 
Seat 6: HITYESCA ($100 in chips) 
Seat 7: nubpoker ($132.79 in chips) 
Seat 9: flyer9898 ($65.50 in chips) 
chaps1988: posts small blind $0.50
CI58: posts big blind $1
JimineyCrik: sits out 
*** HOLE CARDS ***
Dealt to matiko09 [8c Kh]
matiko09: folds 
HITYESCA: raises $2 to $3
nubpoker: calls $3
flyer9898: folds 
Dickyxxx: folds 
mycka86: folds 
chaps1988: folds 
CI58: folds 
*** FLOP *** [4h 9d Jc]
HITYESCA: checks 
nubpoker: checks 
*** TURN *** [4h 9d Jc] [Kc]
HITYESCA: bets $5
nubpoker: folds 
Uncalled bet ($5) returned to HITYESCA
Dickyxxx said, "chaps?"
HITYESCA collected $7.12 from pot
*** SUMMARY ***
Total pot $7.50 | Rake $0.38 
Board [4h 9d Jc Kc]
Seat 1: Dickyxxx folded before Flop (didn't bet)
Seat 2: mycka86 (button) folded before Flop (didn't bet)
Seat 3: chaps1988 (small blind) folded before Flop
Seat 4: CI58 (big blind) folded before Flop
Seat 5: matiko09 folded before Flop (didn't bet)
Seat 6: HITYESCA collected ($7.12)
Seat 7: nubpoker folded on the Turn
Seat 9: flyer9898 folded before Flop (didn't bet)





PokerStars Hand #153068811424:  Hold'em No Limit ($1/$2 USD) - 2016/05/09 17:17:05 CET [2016/05/09 11:17:05 ET]
Table 'Celaeno II' 9-max Seat #3 is the button
Seat 1: LRVAV7 ($200 in chips) 
Seat 2: PacPacBum ($415.51 in chips) 
Seat 3: CI58 ($233.60 in chips) 
Seat 4: matiko09 ($424.82 in chips) 
Seat 5: Monsthand ($229.06 in chips) 
Seat 8: chaps1988 ($221.31 in chips) 
Seat 9: Spid1 ($303.87 in chips) 
matiko09: posts small blind $1
Monsthand: posts big blind $2
HuanHuan: sits out 
*** HOLE CARDS ***
Dealt to matiko09 [As 3c]
chaps1988: folds 
Spid1: folds 
LRVAV7: folds 
PacPacBum: folds 
CI58: folds 
matiko09: raises $3 to $5
Monsthand: calls $3
*** FLOP *** [6c 2c 7d]
matiko09: checks 
Monsthand: bets $5.89
matiko09: folds 
Uncalled bet ($5.89) returned to Monsthand
Monsthand collected $9.50 from pot
Monsthand: doesn't show hand 
*** SUMMARY ***
Total pot $10 | Rake $0.50 
Board [6c 2c 7d]
Seat 1: LRVAV7 folded before Flop (didn't bet)
Seat 2: PacPacBum folded before Flop (didn't bet)
Seat 3: CI58 (button) folded before Flop (didn't bet)
Seat 4: matiko09 (small blind) folded on the Flop
Seat 5: Monsthand (big blind) collected ($9.50)
Seat 8: chaps1988 folded before Flop (didn't bet)
Seat 9: Spid1 folded before Flop (didn't bet)





PokerStars Hand #153068812562:  Hold'em No Limit ($0.50/$1.00 USD) - 2016/05/09 17:17:07 CET [2016/05/09 11:17:07 ET]
Table 'Merga II' 9-max Seat #6 is the button
Seat 1: R1aki ($103.50 in chips) 
Seat 2: Spid1 ($100 in chips) 
Seat 3: 43605511 ($100 in chips) 
Seat 4: erick222 ($101.50 in chips) 
Seat 5: matiko09 ($100 in chips) 
Seat 6: AlKatrone ($100 in chips) 
Seat 7: rusher_NiNja ($220.20 in chips) 
Seat 8: serbianhaze ($100 in chips) 
Seat 9: maxxmeister ($100 in chips) 
rusher_NiNja: posts small blind $0.50
serbianhaze: posts big blind $1
*** HOLE CARDS ***
Dealt to matiko09 [4c 6d]
maxxmeister: folds 
R1aki: folds 
Spid1: folds 
43605511: folds 
erick222: raises $2.50 to $3.50
matiko09: folds 
AlKatrone: folds 
rusher_NiNja: folds 
serbianhaze: folds 
Uncalled bet ($2.50) returned to erick222
erick222 collected $2.50 from pot
erick222: doesn't show hand 
*** SUMMARY ***
Total pot $2.50 | Rake $0 
Seat 1: R1aki folded before Flop (didn't bet)
Seat 2: Spid1 folded before Flop (didn't bet)
Seat 3: 43605511 folded before Flop (didn't bet)
Seat 4: erick222 collected ($2.50)
Seat 5: matiko09 folded before Flop (didn't bet)
Seat 6: AlKatrone (button) folded before Flop (didn't bet)
Seat 7: rusher_NiNja (small blind) folded before Flop
Seat 8: serbianhaze (big blind) folded before Flop
Seat 9: maxxmeister folded before Flop (didn't bet)





PokerStars Hand #153068823416:  Hold'em No Limit ($1/$2 USD) - 2016/05/09 17:17:25 CET [2016/05/09 11:17:25 ET]
Table 'Bella' 9-max Seat #3 is the button
Seat 1: matiko09 ($200 in chips) 
Seat 2: AlKatrone ($207.67 in chips) 
Seat 3: PacPacBum ($229.96 in chips) 
Seat 5: Monsthand ($203 in chips) 
Seat 6: CI58 ($235.30 in chips) 
Seat 7: stan_09319 ($420.01 in chips) 
Monsthand: posts small blind $1
CI58: posts big blind $2
*** HOLE CARDS ***
Dealt to matiko09 [Kd Js]
stan_09319: raises $2.70 to $4.70
matiko09: folds 
AlKatrone: folds 
PacPacBum: folds 
Monsthand: folds 
CI58: folds 
Uncalled bet ($2.70) returned to stan_09319
stan_09319 collected $5 from pot
stan_09319: doesn't show hand 
*** SUMMARY ***
Total pot $5 | Rake $0 
Seat 1: matiko09 folded before Flop (didn't bet)
Seat 2: AlKatrone folded before Flop (didn't bet)
Seat 3: PacPacBum (button) folded before Flop (didn't bet)
Seat 5: Monsthand (small blind) folded before Flop
Seat 6: CI58 (big blind) folded before Flop
Seat 7: stan_09319 collected ($5)





PokerStars Hand #153068824102:  Hold'em No Limit ($1/$2 USD) - 2016/05/09 17:17:26 CET [2016/05/09 11:17:26 ET]
Table 'Demeter II' 9-max Seat #5 is the button
Seat 1: Sasuke777777 ($329.32 in chips) 
Seat 2: matiko09 ($208.46 in chips) 
Seat 3: chaps1988 ($200 in chips) 
Seat 5: PacPacBum ($235.21 in chips) 
Seat 6: HuanHuan ($213.02 in chips) 
Seat 7: Siwyosb ($212.64 in chips) 
Seat 8: CI58 ($222.84 in chips) 
Seat 9: Monsthand ($639.13 in chips) 
HuanHuan: posts small blind $1
Siwyosb: posts big blind $2
*** HOLE CARDS ***
Dealt to matiko09 [Kh 8d]
CI58: calls $2
Monsthand: folds 
Sasuke777777: raises $2 to $4
matiko09: folds 
chaps1988: folds 
PacPacBum: folds 
HuanHuan: folds 
Siwyosb: folds 
CI58: calls $2
*** FLOP *** [4h 5d 6c]
CI58: checks 
Sasuke777777: checks 
*** TURN *** [4h 5d 6c] [Tc]
CI58: bets $6.27
Sasuke777777: folds 
Uncalled bet ($6.27) returned to CI58
CI58 collected $10.45 from pot
CI58: doesn't show hand 
*** SUMMARY ***
Total pot $11 | Rake $0.55 
Board [4h 5d 6c Tc]
Seat 1: Sasuke777777 folded on the Turn
Seat 2: matiko09 folded before Flop (didn't bet)
Seat 3: chaps1988 folded before Flop (didn't bet)
Seat 5: PacPacBum (button) folded before Flop (didn't bet)
Seat 6: HuanHuan (small blind) folded before Flop
Seat 7: Siwyosb (big blind) folded before Flop
Seat 8: CI58 collected ($10.45)
Seat 9: Monsthand folded before Flop (didn't bet)





PokerStars Hand #153068824452:  Hold'em No Limit ($1/$2 USD) - 2016/05/09 17:17:26 CET [2016/05/09 11:17:26 ET]
Table 'Titan III' 9-max Seat #1 is the button
Seat 1: I The King I ($244.50 in chips) 
Seat 2: PacPacBum ($216.20 in chips) 
Seat 4: HuanHuan ($200 in chips) 
Seat 5: Monsthand ($273.25 in chips) 
Seat 6: matiko09 ($203 in chips) 
Seat 7: seasar1 ($153.93 in chips) 
Seat 8: chaps1988 ($200 in chips) 
Seat 9: Sasuke777777 ($241.49 in chips) 
PacPacBum: posts small blind $1
Spid1: is sitting out 
HuanHuan: posts big blind $2
*** HOLE CARDS ***
Dealt to matiko09 [Td 2h]
Spid1 leaves the table
Monsthand: folds 
CI58 joins the table at seat #3 
matiko09: folds 
seasar1: raises $2 to $4
chaps1988: folds 
Sasuke777777: folds 
I The King I: folds 
PacPacBum: folds 
HuanHuan: calls $2
*** FLOP *** [6d 4c Jc]
HuanHuan: checks 
seasar1: bets $4
HuanHuan: folds 
Uncalled bet ($4) returned to seasar1
seasar1 collected $8.55 from pot
*** SUMMARY ***
Total pot $9 | Rake $0.45 
Board [6d 4c Jc]
Seat 1: I The King I (button) folded before Flop (didn't bet)
Seat 2: PacPacBum (small blind) folded before Flop
Seat 4: HuanHuan (big blind) folded on the Flop
Seat 5: Monsthand folded before Flop (didn't bet)
Seat 6: matiko09 folded before Flop (didn't bet)
Seat 7: seasar1 collected ($8.55)
Seat 8: chaps1988 folded before Flop (didn't bet)
Seat 9: Sasuke777777 folded before Flop (didn't bet)





PokerStars Hand #153068832202:  Hold'em No Limit ($0.50/$1.00 USD) - 2016/05/09 17:17:39 CET [2016/05/09 11:17:39 ET]
Table 'Terpsichore' 9-max Seat #6 is the button
Seat 1: ipashutapkom ($159.13 in chips) 
Seat 2: CI58 ($100 in chips) 
Seat 3: matiko09 ($150.39 in chips) 
Seat 4: nubpoker ($130.48 in chips) 
Seat 5: mycka86 ($254.98 in chips) 
Seat 6: Filojoes ($108.94 in chips) 
Seat 7: Kukuryzka ($99 in chips) 
Seat 8: Kiosk230472 ($113.89 in chips) 
Kukuryzka: posts small blind $0.50
Kiosk230472: posts big blind $1
*** HOLE CARDS ***
Dealt to matiko09 [6s Th]
ipashutapkom: folds 
CI58: raises $2 to $3
matiko09: folds 
nubpoker: folds 
mycka86: folds 
Filojoes: calls $3
Kukuryzka: folds 
Kiosk230472: raises $6 to $9
CI58: calls $6
Filojoes: calls $6
*** FLOP *** [4c Qs Qd]
Kiosk230472: checks 
CI58: checks 
Filojoes: bets $14
Kiosk230472: folds 
CI58: folds 
Uncalled bet ($14) returned to Filojoes
Filojoes collected $26.12 from pot
Filojoes: doesn't show hand 
*** SUMMARY ***
Total pot $27.50 | Rake $1.38 
Board [4c Qs Qd]
Seat 1: ipashutapkom folded before Flop (didn't bet)
Seat 2: CI58 folded on the Flop
Seat 3: matiko09 folded before Flop (didn't bet)
Seat 4: nubpoker folded before Flop (didn't bet)
Seat 5: mycka86 folded before Flop (didn't bet)
Seat 6: Filojoes (button) collected ($26.12)
Seat 7: Kukuryzka (small blind) folded before Flop
Seat 8: Kiosk230472 (big blind) folded on the Flop





PokerStars Hand #153068832741:  Hold'em No Limit ($0.50/$1.00 USD) - 2016/05/09 17:17:40 CET [2016/05/09 11:17:40 ET]
Table 'Buryatia II' 9-max Seat #8 is the button
Seat 2: rusher_NiNja ($100 in chips) 
Seat 3: Filojoes ($100 in chips) 
Seat 5: amisasi ($179.67 in chips) 
Seat 6: I The King I ($122.55 in chips) 
Seat 8: matiko09 ($127 in chips) 
Seat 9: CI58 ($119.96 in chips) 
CI58: posts small blind $0.50
flk.Dasas: is sitting out 
rusher_NiNja: posts big blind $1
Dickyxxx: sits out 
nubpoker: sits out 
*** HOLE CARDS ***
Dealt to matiko09 [Kc Qs]
flk.Dasas leaves the table
Filojoes: raises $2 to $3
amisasi: folds 
I The King I: calls $3
matiko09: folds 
CI58: folds 
rusher_NiNja: folds 
*** FLOP *** [8d 6c 2d]
Filojoes: checks 
I The King I: bets $4
Filojoes: folds 
Uncalled bet ($4) returned to I The King I
I The King I collected $7.12 from pot
I The King I: doesn't show hand 
*** SUMMARY ***
Total pot $7.50 | Rake $0.38 
Board [8d 6c 2d]
Seat 2: rusher_NiNja (big blind) folded before Flop
Seat 3: Filojoes folded on the Flop
Seat 5: amisasi folded before Flop (didn't bet)
Seat 6: I The King I collected ($7.12)
Seat 8: matiko09 (button) folded before Flop (didn't bet)
Seat 9: CI58 (small blind) folded before Flop





PokerStars Hand #153068833897:  Hold'em No Limit ($0.50/$1.00 USD) - 2016/05/09 17:17:41 CET [2016/05/09 11:17:41 ET]
Table 'Merga II' 9-max Seat #7 is the button
Seat 1: R1aki ($103.50 in chips) 
Seat 2: Spid1 ($100 in chips) 
Seat 3: 43605511 ($100 in chips) 
Seat 4: erick222 ($103 in chips) 
Seat 5: matiko09 ($100 in chips) 
Seat 6: AlKatrone ($100 in chips) 
Seat 7: rusher_NiNja ($219.70 in chips) 
Seat 8: serbianhaze ($99 in chips) 
Seat 9: maxxmeister ($100 in chips) 
serbianhaze: posts small blind $0.50
maxxmeister: posts big blind $1
*** HOLE CARDS ***
Dealt to matiko09 [6h Ts]
R1aki: folds 
Spid1: folds 
43605511: calls $1
erick222: calls $1
matiko09: folds 
AlKatrone: raises $5 to $6
rusher_NiNja: folds 
serbianhaze: calls $5.50
maxxmeister: folds 
43605511: folds 
erick222: calls $5
*** FLOP *** [2s 3d As]
serbianhaze: checks 
erick222: checks 
AlKatrone: checks 
*** TURN *** [2s 3d As] [Qc]
serbianhaze: bets $6
erick222: calls $6
AlKatrone: folds 
*** RIVER *** [2s 3d As Qc] [8c]
serbianhaze: bets $17
erick222: folds 
Uncalled bet ($17) returned to serbianhaze
serbianhaze collected $30.40 from pot
*** SUMMARY ***
Total pot $32 | Rake $1.60 
Board [2s 3d As Qc 8c]
Seat 1: R1aki folded before Flop (didn't bet)
Seat 2: Spid1 folded before Flop (didn't bet)
Seat 3: 43605511 folded before Flop
Seat 4: erick222 folded on the River
Seat 5: matiko09 folded before Flop (didn't bet)
Seat 6: AlKatrone folded on the Turn
Seat 7: rusher_NiNja (button) folded before Flop (didn't bet)
Seat 8: serbianhaze (small blind) collected ($30.40)
Seat 9: maxxmeister (big blind) folded before Flop





PokerStars Hand #153068834704:  Hold'em No Limit ($1/$2 USD) - 2016/05/09 17:17:43 CET [2016/05/09 11:17:43 ET]
Table 'Hagar II' 9-max Seat #4 is the button
Seat 2: darren1031 ($160.98 in chips) 
Seat 3: Sasuke777777 ($53.97 in chips) 
Seat 4: matiko09 ($430.49 in chips) 
Seat 5: PacPacBum ($264.47 in chips) 
Seat 6: el Fatto ($211.35 in chips) 
Seat 7: Monsthand ($315.12 in chips) 
Seat 9: chaps1988 ($393.47 in chips) 
PacPacBum: posts small blind $1
el Fatto: posts big blind $2
CI58: sits out 
*** HOLE CARDS ***
Dealt to matiko09 [4s 6s]
Monsthand: folds 
chaps1988: folds 
darren1031: calls $2
Sasuke777777: folds 
matiko09: folds 
PacPacBum: calls $1
el Fatto: checks 
*** FLOP *** [Qd 2d 7s]
PacPacBum: checks 
el Fatto: checks 
darren1031: bets $6
PacPacBum: folds 
el Fatto: calls $6
*** TURN *** [Qd 2d 7s] [2h]
el Fatto: checks 
darren1031: bets $24
el Fatto: calls $24
*** RIVER *** [Qd 2d 7s 2h] [8s]
el Fatto: checks 
darren1031: bets $128.98 and is all-in
el Fatto: calls $128.98
*** SHOW DOWN ***
darren1031: shows [Kc Ks] (two pair, Kings and Deuces)
el Fatto: mucks hand 
darren1031 collected $321.21 from pot
*** SUMMARY ***
Total pot $323.96 | Rake $2.75 
Board [Qd 2d 7s 2h 8s]
Seat 2: darren1031 showed [Kc Ks] and won ($321.21) with two pair, Kings and Deuces
Seat 3: Sasuke777777 folded before Flop (didn't bet)
Seat 4: matiko09 (button) folded before Flop (didn't bet)
Seat 5: PacPacBum (small blind) folded on the Flop
Seat 6: el Fatto (big blind) mucked [Qs 3d]
Seat 7: Monsthand folded before Flop (didn't bet)
Seat 9: chaps1988 folded before Flop (didn't bet)





PokerStars Hand #153068836240:  Hold'em No Limit ($1/$2 USD) - 2016/05/09 17:17:45 CET [2016/05/09 11:17:45 ET]
Table 'Celaeno II' 9-max Seat #4 is the button
Seat 1: LRVAV7 ($200 in chips) 
Seat 2: PacPacBum ($415.51 in chips) 
Seat 3: CI58 ($233.60 in chips) 
Seat 4: matiko09 ($419.82 in chips) 
Seat 5: Monsthand ($233.56 in chips) 
Seat 6: Igoriah ($220.47 in chips) 
Seat 8: chaps1988 ($221.31 in chips) 
Seat 9: Spid1 ($303.87 in chips) 
Monsthand: posts small blind $1
Igoriah: posts big blind $2
HuanHuan: sits out 
*** HOLE CARDS ***
Dealt to matiko09 [Qs 5d]
chaps1988: folds 
Spid1: folds 
LRVAV7: folds 
PacPacBum: raises $4 to $6
CI58: folds 
matiko09: folds 
Monsthand: calls $5
Igoriah: folds 
*** FLOP *** [Td Kd 7h]
Monsthand: checks 
PacPacBum: bets $7.18
Monsthand: calls $7.18
*** TURN *** [Td Kd 7h] [8h]
Monsthand: checks 
PacPacBum: bets $14.54
Monsthand: folds 
Uncalled bet ($14.54) returned to PacPacBum
PacPacBum collected $26.94 from pot
PacPacBum: doesn't show hand 
*** SUMMARY ***
Total pot $28.36 | Rake $1.42 
Board [Td Kd 7h 8h]
Seat 1: LRVAV7 folded before Flop (didn't bet)
Seat 2: PacPacBum collected ($26.94)
Seat 3: CI58 folded before Flop (didn't bet)
Seat 4: matiko09 (button) folded before Flop (didn't bet)
Seat 5: Monsthand (small blind) folded on the Turn
Seat 6: Igoriah (big blind) folded before Flop
Seat 8: chaps1988 folded before Flop (didn't bet)
Seat 9: Spid1 folded before Flop (didn't bet)





PokerStars Hand #153068839497:  Hold'em No Limit ($1/$2 USD) - 2016/05/09 17:17:50 CET [2016/05/09 11:17:50 ET]
Table 'Bella' 9-max Seat #5 is the button
Seat 1: matiko09 ($200 in chips) 
Seat 2: AlKatrone ($207.67 in chips) 
Seat 3: PacPacBum ($229.96 in chips) 
Seat 5: Monsthand ($202 in chips) 
Seat 6: CI58 ($233.30 in chips) 
Seat 7: stan_09319 ($423.01 in chips) 
CI58: posts small blind $1
stan_09319: posts big blind $2
Igoriah: sits out 
*** HOLE CARDS ***
Dealt to matiko09 [Jd 8d]
matiko09: folds 
AlKatrone: folds 
PacPacBum: folds 
HuanHuan joins the table at seat #4 
Monsthand: raises $3 to $5
CI58: raises $13 to $18
stan_09319: folds 
Monsthand: folds 
Uncalled bet ($13) returned to CI58
CI58 collected $12 from pot
CI58: doesn't show hand 
*** SUMMARY ***
Total pot $12 | Rake $0 
Seat 1: matiko09 folded before Flop (didn't bet)
Seat 2: AlKatrone folded before Flop (didn't bet)
Seat 3: PacPacBum folded before Flop (didn't bet)
Seat 5: Monsthand (button) folded before Flop
Seat 6: CI58 (small blind) collected ($12)
Seat 7: stan_09319 (big blind) folded before Flop





PokerStars Hand #153068847375:  Hold'em No Limit ($1/$2 USD) - 2016/05/09 17:18:03 CET [2016/05/09 11:18:03 ET]
Table 'Demeter II' 9-max Seat #6 is the button
Seat 1: Sasuke777777 ($325.32 in chips) 
Seat 2: matiko09 ($208.46 in chips) 
Seat 3: chaps1988 ($200 in chips) 
Seat 5: PacPacBum ($235.21 in chips) 
Seat 6: HuanHuan ($212.02 in chips) 
Seat 7: Siwyosb ($210.64 in chips) 
Seat 8: CI58 ($229.29 in chips) 
Seat 9: Monsthand ($639.13 in chips) 
Siwyosb: posts small blind $1
CI58: posts big blind $2
Igoriah: sits out 
*** HOLE CARDS ***
Dealt to matiko09 [7d Ts]
Monsthand: raises $4 to $6
Sasuke777777: folds 
matiko09: folds 
chaps1988: folds 
PacPacBum: folds 
HuanHuan: calls $6
Siwyosb: folds 
CI58: folds 
*** FLOP *** [5s Kc Th]
Monsthand: bets $9
HuanHuan: folds 
Uncalled bet ($9) returned to Monsthand
Monsthand collected $14.25 from pot
Monsthand: doesn't show hand 
*** SUMMARY ***
Total pot $15 | Rake $0.75 
Board [5s Kc Th]
Seat 1: Sasuke777777 folded before Flop (didn't bet)
Seat 2: matiko09 folded before Flop (didn't bet)
Seat 3: chaps1988 folded before Flop (didn't bet)
Seat 5: PacPacBum folded before Flop (didn't bet)
Seat 6: HuanHuan (button) folded on the Flop
Seat 7: Siwyosb (small blind) folded before Flop
Seat 8: CI58 (big blind) folded before Flop
Seat 9: Monsthand collected ($14.25)





PokerStars Hand #153068848158:  Hold'em No Limit ($1/$2 USD) - 2016/05/09 17:18:04 CET [2016/05/09 11:18:04 ET]
Table 'Titan III' 9-max Seat #2 is the button
Seat 1: I The King I ($244.50 in chips) 
Seat 2: PacPacBum ($215.20 in chips) 
Seat 4: HuanHuan ($200 in chips) 
Seat 5: Monsthand ($273.25 in chips) 
Seat 6: matiko09 ($203 in chips) 
Seat 7: seasar1 ($158.48 in chips) 
Seat 8: chaps1988 ($200 in chips) 
Seat 9: Sasuke777777 ($241.49 in chips) 
CI58 will be allowed to play after the button
HuanHuan: posts small blind $1
Monsthand: posts big blind $2
*** HOLE CARDS ***
Dealt to matiko09 [Ks Ts]
matiko09: raises $3 to $5
seasar1: folds 
chaps1988: folds 
Sasuke777777: folds 
I The King I: folds 
PacPacBum: folds 
HuanHuan: folds 
Monsthand: folds 
Uncalled bet ($3) returned to matiko09
matiko09 collected $5 from pot
matiko09: doesn't show hand 
*** SUMMARY ***
Total pot $5 | Rake $0 
Seat 1: I The King I folded before Flop (didn't bet)
Seat 2: PacPacBum (button) folded before Flop (didn't bet)
Seat 4: HuanHuan (small blind) folded before Flop
Seat 5: Monsthand (big blind) folded before Flop
Seat 6: matiko09 collected ($5)
Seat 7: seasar1 folded before Flop (didn't bet)
Seat 8: chaps1988 folded before Flop (didn't bet)
Seat 9: Sasuke777777 folded before Flop (didn't bet)





PokerStars Hand #153068854867:  Hold'em No Limit ($0.50/$1.00 USD) - 2016/05/09 17:18:15 CET [2016/05/09 11:18:15 ET]
Table 'Reiss' 9-max Seat #3 is the button
Seat 1: Dickyxxx ($163.16 in chips) 
Seat 2: mycka86 ($185.75 in chips) 
Seat 3: chaps1988 ($123.46 in chips) 
Seat 4: CI58 ($106.66 in chips) 
Seat 5: matiko09 ($135.21 in chips) 
Seat 6: HITYESCA ($104.12 in chips) 
Seat 7: nubpoker ($129.79 in chips) 
Seat 9: flyer9898 ($65.50 in chips) 
CI58: posts small blind $0.50
matiko09: posts big blind $1
JimineyCrik: sits out 
*** HOLE CARDS ***
Dealt to matiko09 [Qs Th]
HITYESCA: folds 
nubpoker: folds 
flyer9898: folds 
Dickyxxx: folds 
mycka86: folds 
chaps1988: folds 
CI58: raises $2 to $3
matiko09: calls $2
*** FLOP *** [3h 7c 6s]
CI58: bets $2.85
matiko09: folds 
Uncalled bet ($2.85) returned to CI58
CI58 collected $5.70 from pot
CI58: doesn't show hand 
*** SUMMARY ***
Total pot $6 | Rake $0.30 
Board [3h 7c 6s]
Seat 1: Dickyxxx folded before Flop (didn't bet)
Seat 2: mycka86 folded before Flop (didn't bet)
Seat 3: chaps1988 (button) folded before Flop (didn't bet)
Seat 4: CI58 (small blind) collected ($5.70)
Seat 5: matiko09 (big blind) folded on the Flop
Seat 6: HITYESCA folded before Flop (didn't bet)
Seat 7: nubpoker folded before Flop (didn't bet)
Seat 9: flyer9898 folded before Flop (didn't bet)





PokerStars Hand #153068859205:  Hold'em No Limit ($0.50/$1.00 USD) - 2016/05/09 17:18:22 CET [2016/05/09 11:18:22 ET]
Table 'Buryatia II' 9-max Seat #9 is the button
Seat 2: rusher_NiNja ($100 in chips) 
Seat 3: Filojoes ($100 in chips) 
Seat 5: amisasi ($179.67 in chips) 
Seat 6: I The King I ($126.67 in chips) 
Seat 8: matiko09 ($127 in chips) 
Seat 9: CI58 ($119.46 in chips) 
rusher_NiNja: posts small blind $0.50
Filojoes: posts big blind $1
Dickyxxx: sits out 
nubpoker: sits out 
*** HOLE CARDS ***
Dealt to matiko09 [6s 2c]
amisasi: folds 
I The King I: folds 
matiko09: folds 
CI58: folds 
rusher_NiNja: folds 
Uncalled bet ($0.50) returned to Filojoes
Filojoes collected $1 from pot
Filojoes: doesn't show hand 
*** SUMMARY ***
Total pot $1 | Rake $0 
Seat 2: rusher_NiNja (small blind) folded before Flop
Seat 3: Filojoes (big blind) collected ($1)
Seat 5: amisasi folded before Flop (didn't bet)
Seat 6: I The King I folded before Flop (didn't bet)
Seat 8: matiko09 folded before Flop (didn't bet)
Seat 9: CI58 (button) folded before Flop (didn't bet)





PokerStars Hand #153068864122:  Hold'em No Limit ($0.50/$1.00 USD) - 2016/05/09 17:18:30 CET [2016/05/09 11:18:30 ET]
Table 'Orthos' 9-max Seat #5 is the button
Seat 1: Kelvin sai ($98.32 in chips) 
Seat 2: PacPacBum ($121.49 in chips) 
Seat 3: Filojoes ($100 in chips) 
Seat 4: nubpoker ($153.15 in chips) 
Seat 5: matiko09 ($114.20 in chips) 
Seat 6: xhinostrabli ($98.11 in chips) 
Seat 7: flk.Dasas ($158.40 in chips) 
Seat 8: Dickyxxx ($103.67 in chips) 
Seat 9: mycka86 ($114.15 in chips) 
xhinostrabli: posts small blind $0.50
flk.Dasas: posts big blind $1
*** HOLE CARDS ***
Dealt to matiko09 [2h Ac]
Dickyxxx: raises $2 to $3
mycka86: folds 
Kelvin sai: folds 
PacPacBum: folds 
Filojoes: folds 
nubpoker: folds 
matiko09: folds 
xhinostrabli: folds 
flk.Dasas: folds 
Uncalled bet ($2) returned to Dickyxxx
Dickyxxx collected $2.50 from pot
Dickyxxx: doesn't show hand 
*** SUMMARY ***
Total pot $2.50 | Rake $0 
Seat 1: Kelvin sai folded before Flop (didn't bet)
Seat 2: PacPacBum folded before Flop (didn't bet)
Seat 3: Filojoes folded before Flop (didn't bet)
Seat 4: nubpoker folded before Flop (didn't bet)
Seat 5: matiko09 (button) folded before Flop (didn't bet)
Seat 6: xhinostrabli (small blind) folded before Flop
Seat 7: flk.Dasas (big blind) folded before Flop
Seat 8: Dickyxxx collected ($2.50)
Seat 9: mycka86 folded before Flop (didn't bet)





PokerStars Hand #153068865945:  Hold'em No Limit ($1/$2 USD) - 2016/05/09 17:18:33 CET [2016/05/09 11:18:33 ET]
Table 'Titan III' 9-max Seat #4 is the button
Seat 1: I The King I ($244.50 in chips) 
Seat 2: PacPacBum ($215.20 in chips) 
Seat 4: HuanHuan ($200 in chips) 
Seat 5: Monsthand ($271.25 in chips) 
Seat 6: matiko09 ($206 in chips) 
Seat 7: seasar1 ($158.48 in chips) 
Seat 8: chaps1988 ($200 in chips) 
Seat 9: Sasuke777777 ($241.49 in chips) 
Monsthand: posts small blind $1
matiko09: posts big blind $2
CI58: sits out 
*** HOLE CARDS ***
Dealt to matiko09 [Js Jd]
seasar1: folds 
chaps1988: folds 
seasar1 leaves the table
Sasuke777777: raises $4 to $6
Igoriah joins the table at seat #7 
I The King I: folds 
PacPacBum: folds 
HuanHuan: folds 
Monsthand: folds 
matiko09: raises $18 to $24
Sasuke777777: folds 
Uncalled bet ($18) returned to matiko09
matiko09 collected $13 from pot
matiko09: doesn't show hand 
*** SUMMARY ***
Total pot $13 | Rake $0 
Seat 1: I The King I folded before Flop (didn't bet)
Seat 2: PacPacBum folded before Flop (didn't bet)
Seat 4: HuanHuan (button) folded before Flop (didn't bet)
Seat 5: Monsthand (small blind) folded before Flop
Seat 6: matiko09 (big blind) collected ($13)
Seat 7: seasar1 folded before Flop (didn't bet)
Seat 8: chaps1988 folded before Flop (didn't bet)
Seat 9: Sasuke777777 folded before Flop





PokerStars Hand #153068868444:  Hold'em No Limit ($0.50/$1.00 USD) - 2016/05/09 17:18:37 CET [2016/05/09 11:18:37 ET]
Table 'Buryatia II' 9-max Seat #2 is the button
Seat 2: rusher_NiNja ($100 in chips) 
Seat 3: Filojoes ($100.50 in chips) 
Seat 4: Dickyxxx ($100 in chips) 
Seat 5: amisasi ($179.67 in chips) 
Seat 6: I The King I ($126.67 in chips) 
Seat 8: matiko09 ($127 in chips) 
Seat 9: CI58 ($119.46 in chips) 
Filojoes: posts small blind $0.50
Dickyxxx: posts big blind $1
nubpoker: sits out 
*** HOLE CARDS ***
Dealt to matiko09 [Jc 4s]
amisasi: folds 
I The King I: folds 
matiko09: folds 
CI58: folds 
rusher_NiNja: folds 
Filojoes: raises $1.50 to $2.50
Dickyxxx: calls $1.50
*** FLOP *** [Qd 6d Js]
Filojoes: checks 
Dickyxxx: checks 
*** TURN *** [Qd 6d Js] [5c]
Filojoes: checks 
Dickyxxx: bets $3.16
Filojoes: folds 
Uncalled bet ($3.16) returned to Dickyxxx
Dickyxxx collected $4.75 from pot
Dickyxxx: doesn't show hand 
*** SUMMARY ***
Total pot $5 | Rake $0.25 
Board [Qd 6d Js 5c]
Seat 2: rusher_NiNja (button) folded before Flop (didn't bet)
Seat 3: Filojoes (small blind) folded on the Turn
Seat 4: Dickyxxx (big blind) collected ($4.75)
Seat 5: amisasi folded before Flop (didn't bet)
Seat 6: I The King I folded before Flop (didn't bet)
Seat 8: matiko09 folded before Flop (didn't bet)
Seat 9: CI58 folded before Flop (didn't bet)





PokerStars Hand #153068875629:  Hold'em No Limit ($1/$2 USD) - 2016/05/09 17:18:48 CET [2016/05/09 11:18:48 ET]
Table 'Celaeno II' 9-max Seat #5 is the button
Seat 1: LRVAV7 ($200 in chips) 
Seat 2: PacPacBum ($429.27 in chips) 
Seat 3: CI58 ($233.60 in chips) 
Seat 4: matiko09 ($419.82 in chips) 
Seat 5: Monsthand ($220.38 in chips) 
Seat 6: Igoriah ($218.47 in chips) 
Seat 7: HuanHuan ($200 in chips) 
Seat 8: chaps1988 ($221.31 in chips) 
Seat 9: Spid1 ($303.87 in chips) 
Igoriah: posts small blind $1
HuanHuan: posts big blind $2
*** HOLE CARDS ***
Dealt to matiko09 [Jh 4c]
chaps1988: folds 
Spid1: folds 
LRVAV7: folds 
PacPacBum: raises $4 to $6
CI58: calls $6
matiko09: folds 
Monsthand: raises $18 to $24
Igoriah: folds 
HuanHuan: folds 
PacPacBum: calls $18
CI58: folds 
*** FLOP *** [6h 3d 9s]
PacPacBum: checks 
Monsthand: bets $25.50
PacPacBum: raises $56.83 to $82.33
Monsthand: calls $56.83
*** TURN *** [6h 3d 9s] [4h]
PacPacBum: bets $322.94 and is all-in
Monsthand: calls $114.05 and is all-in
Uncalled bet ($208.89) returned to PacPacBum
*** RIVER *** [6h 3d 9s 4h] [7d]
*** SHOW DOWN ***
PacPacBum: shows [7h 8h] (a pair of Sevens)
Monsthand: shows [5s 4s] (a straight, Three to Seven)
Monsthand collected $447.01 from pot
*** SUMMARY ***
Total pot $449.76 | Rake $2.75 
Board [6h 3d 9s 4h 7d]
Seat 1: LRVAV7 folded before Flop (didn't bet)
Seat 2: PacPacBum showed [7h 8h] and lost with a pair of Sevens
Seat 3: CI58 folded before Flop
Seat 4: matiko09 folded before Flop (didn't bet)
Seat 5: Monsthand (button) showed [5s 4s] and won ($447.01) with a straight, Three to Seven
Seat 6: Igoriah (small blind) folded before Flop
Seat 7: HuanHuan (big blind) folded before Flop
Seat 8: chaps1988 folded before Flop (didn't bet)
Seat 9: Spid1 folded before Flop (didn't bet)





PokerStars Hand #153068876253:  Hold'em No Limit ($1/$2 USD) - 2016/05/09 17:18:49 CET [2016/05/09 11:18:49 ET]
Table 'Bella' 9-max Seat #6 is the button
Seat 1: matiko09 ($200 in chips) 
Seat 2: AlKatrone ($207.67 in chips) 
Seat 3: PacPacBum ($229.96 in chips) 
Seat 5: Monsthand ($200 in chips) 
Seat 6: CI58 ($240.30 in chips) 
Seat 7: stan_09319 ($421.01 in chips) 
Seat 8: Igoriah ($200.68 in chips) 
stan_09319: posts small blind $1
Igoriah: posts big blind $2
HuanHuan: sits out 
*** HOLE CARDS ***
Dealt to matiko09 [7d 9s]
matiko09: folds 
AlKatrone has timed out
AlKatrone: folds 
PacPacBum: folds 
Monsthand: folds 
CI58: folds 
stan_09319: folds 
Uncalled bet ($1) returned to Igoriah
Igoriah collected $2 from pot
Igoriah: doesn't show hand 
*** SUMMARY ***
Total pot $2 | Rake $0 
Seat 1: matiko09 folded before Flop (didn't bet)
Seat 2: AlKatrone folded before Flop (didn't bet)
Seat 3: PacPacBum folded before Flop (didn't bet)
Seat 5: Monsthand folded before Flop (didn't bet)
Seat 6: CI58 (button) folded before Flop (didn't bet)
Seat 7: stan_09319 (small blind) folded before Flop
Seat 8: Igoriah (big blind) collected ($2)





PokerStars Hand #153068883261:  Hold'em No Limit ($0.50/$1.00 USD) - 2016/05/09 17:19:00 CET [2016/05/09 11:19:00 ET]
Table 'Reiss' 9-max Seat #4 is the button
Seat 1: Dickyxxx ($163.16 in chips) 
Seat 2: mycka86 ($185.75 in chips) 
Seat 3: chaps1988 ($123.46 in chips) 
Seat 4: CI58 ($109.36 in chips) 
Seat 5: matiko09 ($132.21 in chips) 
Seat 6: HITYESCA ($104.12 in chips) 
Seat 7: nubpoker ($129.79 in chips) 
Seat 9: flyer9898 ($65.50 in chips) 
matiko09: posts small blind $0.50
HITYESCA: posts big blind $1
JimineyCrik: sits out 
*** HOLE CARDS ***
Dealt to matiko09 [9c 6s]
nubpoker: folds 
flyer9898: raises $1 to $2
Dickyxxx: folds 
mycka86: folds 
chaps1988: folds 
CI58: folds 
matiko09: folds 
HITYESCA: folds 
Uncalled bet ($1) returned to flyer9898
flyer9898 collected $2.50 from pot
flyer9898: doesn't show hand 
*** SUMMARY ***
Total pot $2.50 | Rake $0 
Seat 1: Dickyxxx folded before Flop (didn't bet)
Seat 2: mycka86 folded before Flop (didn't bet)
Seat 3: chaps1988 folded before Flop (didn't bet)
Seat 4: CI58 (button) folded before Flop (didn't bet)
Seat 5: matiko09 (small blind) folded before Flop
Seat 6: HITYESCA (big blind) folded before Flop
Seat 7: nubpoker folded before Flop (didn't bet)
Seat 9: flyer9898 collected ($2.50)





PokerStars Hand #153068883117:  Hold'em No Limit ($0.50/$1.00 USD) - 2016/05/09 17:19:00 CET [2016/05/09 11:19:00 ET]
Table 'Orthos' 9-max Seat #6 is the button
Seat 1: Kelvin sai ($98.32 in chips) 
Seat 2: PacPacBum ($121.49 in chips) 
Seat 3: Filojoes ($100 in chips) 
Seat 4: nubpoker ($153.15 in chips) 
Seat 5: matiko09 ($114.20 in chips) 
Seat 6: xhinostrabli ($97.61 in chips) 
Seat 7: flk.Dasas ($157.40 in chips) 
Seat 8: Dickyxxx ($105.17 in chips) 
Seat 9: mycka86 ($114.15 in chips) 
flk.Dasas: posts small blind $0.50
Dickyxxx: posts big blind $1
*** HOLE CARDS ***
Dealt to matiko09 [Kc 3h]
mycka86: folds 
Kelvin sai: folds 
PacPacBum: folds 
Filojoes: folds 
nubpoker: raises $1.50 to $2.50
matiko09: folds 
xhinostrabli: folds 
flk.Dasas: folds 
Dickyxxx: folds 
Uncalled bet ($1.50) returned to nubpoker
nubpoker collected $2.50 from pot
nubpoker: doesn't show hand 
*** SUMMARY ***
Total pot $2.50 | Rake $0 
Seat 1: Kelvin sai folded before Flop (didn't bet)
Seat 2: PacPacBum folded before Flop (didn't bet)
Seat 3: Filojoes folded before Flop (didn't bet)
Seat 4: nubpoker collected ($2.50)
Seat 5: matiko09 folded before Flop (didn't bet)
Seat 6: xhinostrabli (button) folded before Flop (didn't bet)
Seat 7: flk.Dasas (small blind) folded before Flop
Seat 8: Dickyxxx (big blind) folded before Flop
Seat 9: mycka86 folded before Flop (didn't bet)





PokerStars Hand #153068886686:  Hold'em No Limit ($1/$2 USD) - 2016/05/09 17:19:06 CET [2016/05/09 11:19:06 ET]
Table 'Titan III' 9-max Seat #5 is the button
Seat 1: I The King I ($244.50 in chips) 
Seat 2: PacPacBum ($215.20 in chips) 
Seat 4: HuanHuan ($200 in chips) 
Seat 5: Monsthand ($270.25 in chips) 
Seat 6: matiko09 ($213 in chips) 
Seat 7: Igoriah ($345.64 in chips) 
Seat 8: chaps1988 ($200 in chips) 
Seat 9: Sasuke777777 ($235.49 in chips) 
matiko09: posts small blind $1
Igoriah: posts big blind $2
CI58: sits out 
*** HOLE CARDS ***
Dealt to matiko09 [9h Jc]
chaps1988: folds 
Sasuke777777: folds 
I The King I: folds 
PacPacBum: folds 
HuanHuan: folds 
Monsthand: folds 
Sasuke777777 leaves the table
matiko09: raises $3 to $5
Igoriah: calls $3
*** FLOP *** [Jd Kh 4s]
matiko09: checks 
Igoriah: checks 
*** TURN *** [Jd Kh 4s] [3h]
matiko09: checks 
Igoriah: checks 
*** RIVER *** [Jd Kh 4s 3h] [Qd]
matiko09: checks 
Igoriah: bets $8
matiko09: folds 
Uncalled bet ($8) returned to Igoriah
Igoriah collected $9.50 from pot
Igoriah: doesn't show hand 
*** SUMMARY ***
Total pot $10 | Rake $0.50 
Board [Jd Kh 4s 3h Qd]
Seat 1: I The King I folded before Flop (didn't bet)
Seat 2: PacPacBum folded before Flop (didn't bet)
Seat 4: HuanHuan folded before Flop (didn't bet)
Seat 5: Monsthand (button) folded before Flop (didn't bet)
Seat 6: matiko09 (small blind) folded on the River
Seat 7: Igoriah (big blind) collected ($9.50)
Seat 8: chaps1988 folded before Flop (didn't bet)
Seat 9: Sasuke777777 folded before Flop (didn't bet)





PokerStars Hand #153068887184:  Hold'em No Limit ($0.50/$1.00 USD) - 2016/05/09 17:19:07 CET [2016/05/09 11:19:07 ET]
Table 'Terpsichore' 9-max Seat #7 is the button
Seat 2: CI58 ($100 in chips) 
Seat 3: matiko09 ($150.39 in chips) 
Seat 4: nubpoker ($130.48 in chips) 
Seat 5: mycka86 ($254.98 in chips) 
Seat 6: Filojoes ($126.06 in chips) 
Seat 7: Kukuryzka ($100 in chips) 
Seat 8: Kiosk230472 ($104.89 in chips) 
Kiosk230472: posts small blind $0.50
ipashutapkom: is sitting out 
ipashutapkom leaves the table
CI58: posts big blind $1
*** HOLE CARDS ***
Dealt to matiko09 [Ts 9d]
Donetsk1y joins the table at seat #1 
matiko09: folds 
nubpoker: folds 
mycka86: folds 
Filojoes: folds 
Kukuryzka: folds 
Kiosk230472: calls $0.50
CI58: raises $2 to $3
Kiosk230472: calls $2
*** FLOP *** [4d Th 4h]
Kiosk230472: checks 
CI58: bets $2.85
Kiosk230472: calls $2.85
*** TURN *** [4d Th 4h] [Kh]
Kiosk230472: checks 
CI58: checks 
*** RIVER *** [4d Th 4h Kh] [5c]
Kiosk230472: bets $5
CI58: folds 
Uncalled bet ($5) returned to Kiosk230472
Kiosk230472 collected $11.12 from pot
Kiosk230472: doesn't show hand 
*** SUMMARY ***
Total pot $11.70 | Rake $0.58 
Board [4d Th 4h Kh 5c]
Seat 2: CI58 (big blind) folded on the River
Seat 3: matiko09 folded before Flop (didn't bet)
Seat 4: nubpoker folded before Flop (didn't bet)
Seat 5: mycka86 folded before Flop (didn't bet)
Seat 6: Filojoes folded before Flop (didn't bet)
Seat 7: Kukuryzka (button) folded before Flop (didn't bet)
Seat 8: Kiosk230472 (small blind) collected ($11.12)





PokerStars Hand #153068887959:  Hold'em No Limit ($1/$2 USD) - 2016/05/09 17:19:08 CET [2016/05/09 11:19:08 ET]
Table 'Demeter II' 9-max Seat #7 is the button
Seat 1: Sasuke777777 ($325.32 in chips) 
Seat 2: matiko09 ($208.46 in chips) 
Seat 3: chaps1988 ($200 in chips) 
Seat 5: PacPacBum ($235.21 in chips) 
Seat 6: HuanHuan ($206.02 in chips) 
Seat 7: Siwyosb ($209.64 in chips) 
Seat 8: CI58 ($227.29 in chips) 
Seat 9: Monsthand ($647.38 in chips) 
CI58: posts small blind $1
Monsthand: posts big blind $2
Igoriah: sits out 
*** HOLE CARDS ***
Dealt to matiko09 [6d Kd]
Sasuke777777: folds 
matiko09: folds 
chaps1988: raises $3 to $5
PacPacBum: folds 
HuanHuan: folds 
Siwyosb: folds 
CI58: folds 
Monsthand: folds 
Uncalled bet ($3) returned to chaps1988
chaps1988 collected $5 from pot
chaps1988: doesn't show hand 
*** SUMMARY ***
Total pot $5 | Rake $0 
Seat 1: Sasuke777777 folded before Flop (didn't bet)
Seat 2: matiko09 folded before Flop (didn't bet)
Seat 3: chaps1988 collected ($5)
Seat 5: PacPacBum folded before Flop (didn't bet)
Seat 6: HuanHuan folded before Flop (didn't bet)
Seat 7: Siwyosb (button) folded before Flop (didn't bet)
Seat 8: CI58 (small blind) folded before Flop
Seat 9: Monsthand (big blind) folded before Flop





PokerStars Hand #153068896805:  Hold'em No Limit ($0.50/$1.00 USD) - 2016/05/09 17:19:22 CET [2016/05/09 11:19:22 ET]
Table 'Merga II' 9-max Seat #8 is the button
Seat 1: R1aki ($103.50 in chips) 
Seat 2: Spid1 ($100 in chips) 
Seat 3: 43605511 ($99 in chips) 
Seat 4: erick222 ($100 in chips) 
Seat 5: matiko09 ($100 in chips) 
Seat 6: AlKatrone ($100 in chips) 
Seat 7: rusher_NiNja ($219.70 in chips) 
Seat 8: serbianhaze ($117.40 in chips) 
Seat 9: maxxmeister ($100 in chips) 
maxxmeister: posts small blind $0.50
R1aki: posts big blind $1
*** HOLE CARDS ***
Dealt to matiko09 [Qs Kc]
Spid1: folds 
43605511: folds 
erick222: folds 
matiko09: raises $2 to $3
AlKatrone: raises $6 to $9
rusher_NiNja: folds 
serbianhaze: calls $9
maxxmeister: raises $19 to $28
R1aki: folds 
matiko09: folds 
AlKatrone: folds 
serbianhaze: folds 
Uncalled bet ($19) returned to maxxmeister
maxxmeister collected $31 from pot
maxxmeister: doesn't show hand 
*** SUMMARY ***
Total pot $31 | Rake $0 
Seat 1: R1aki (big blind) folded before Flop
Seat 2: Spid1 folded before Flop (didn't bet)
Seat 3: 43605511 folded before Flop (didn't bet)
Seat 4: erick222 folded before Flop (didn't bet)
Seat 5: matiko09 folded before Flop
Seat 6: AlKatrone folded before Flop
Seat 7: rusher_NiNja folded before Flop (didn't bet)
Seat 8: serbianhaze (button) folded before Flop
Seat 9: maxxmeister (small blind) collected ($31)





PokerStars Hand #153068900903:  Hold'em No Limit ($1/$2 USD) - 2016/05/09 17:19:28 CET [2016/05/09 11:19:28 ET]
Table 'Bella' 9-max Seat #7 is the button
Seat 1: matiko09 ($200 in chips) 
Seat 2: AlKatrone ($207.67 in chips) 
Seat 3: PacPacBum ($229.96 in chips) 
Seat 5: Monsthand ($200 in chips) 
Seat 6: CI58 ($240.30 in chips) 
Seat 7: stan_09319 ($420.01 in chips) 
Seat 8: Igoriah ($201.68 in chips) 
Igoriah: posts small blind $1
matiko09: posts big blind $2
HuanHuan: sits out 
*** HOLE CARDS ***
Dealt to matiko09 [Th 7h]
AlKatrone: folds 
PacPacBum: folds 
Monsthand: folds 
CI58: raises $2.50 to $4.50
stan_09319: raises $12 to $16.50
Igoriah: folds 
matiko09: folds 
CI58: calls $12
*** FLOP *** [2h Td 2c]
CI58: checks 
stan_09319: bets $12
CI58: folds 
Uncalled bet ($12) returned to stan_09319
stan_09319 collected $34.20 from pot
stan_09319: doesn't show hand 
*** SUMMARY ***
Total pot $36 | Rake $1.80 
Board [2h Td 2c]
Seat 1: matiko09 (big blind) folded before Flop
Seat 2: AlKatrone folded before Flop (didn't bet)
Seat 3: PacPacBum folded before Flop (didn't bet)
Seat 5: Monsthand folded before Flop (didn't bet)
Seat 6: CI58 folded on the Flop
Seat 7: stan_09319 (button) collected ($34.20)
Seat 8: Igoriah (small blind) folded before Flop





PokerStars Hand #153068903484:  Hold'em No Limit ($1/$2 USD) - 2016/05/09 17:19:32 CET [2016/05/09 11:19:32 ET]
Table 'Demeter II' 9-max Seat #8 is the button
Seat 1: Sasuke777777 ($325.32 in chips) 
Seat 2: matiko09 ($208.46 in chips) 
Seat 3: chaps1988 ($203 in chips) 
Seat 5: PacPacBum ($235.21 in chips) 
Seat 6: HuanHuan ($206.02 in chips) 
Seat 7: Siwyosb ($209.64 in chips) 
Seat 8: CI58 ($226.29 in chips) 
Seat 9: Monsthand ($645.38 in chips) 
Monsthand: posts small blind $1
Sasuke777777: posts big blind $2
Igoriah: sits out 
*** HOLE CARDS ***
Dealt to matiko09 [7h Ts]
matiko09: folds 
chaps1988: folds 
PacPacBum: folds 
HuanHuan: folds 
Siwyosb: raises $2 to $4
CI58: folds 
Monsthand: folds 
Sasuke777777: calls $2
*** FLOP *** [Kh 4h 4d]
Sasuke777777: checks 
Siwyosb: bets $2
Sasuke777777: calls $2
*** TURN *** [Kh 4h 4d] [Qc]
Sasuke777777: checks 
Siwyosb: bets $2
Sasuke777777: calls $2
*** RIVER *** [Kh 4h 4d Qc] [8s]
Sasuke777777: checks 
Siwyosb: bets $8.07
Sasuke777777: calls $8.07
*** SHOW DOWN ***
Siwyosb: shows [7c Kc] (two pair, Kings and Fours)
Sasuke777777: shows [Ks 2s] (two pair, Kings and Fours)
Sasuke777777 collected $15.74 from pot
Siwyosb collected $15.74 from pot
*** SUMMARY ***
Total pot $33.14 | Rake $1.66 
Board [Kh 4h 4d Qc 8s]
Seat 1: Sasuke777777 (big blind) showed [Ks 2s] and won ($15.74) with two pair, Kings and Fours
Seat 2: matiko09 folded before Flop (didn't bet)
Seat 3: chaps1988 folded before Flop (didn't bet)
Seat 5: PacPacBum folded before Flop (didn't bet)
Seat 6: HuanHuan folded before Flop (didn't bet)
Seat 7: Siwyosb showed [7c Kc] and won ($15.74) with two pair, Kings and Fours
Seat 8: CI58 (button) folded before Flop (didn't bet)
Seat 9: Monsthand (small blind) folded before Flop





PokerStars Hand #153068903838:  Hold'em No Limit ($0.50/$1.00 USD) - 2016/05/09 17:19:33 CET [2016/05/09 11:19:33 ET]
Table 'Orthos' 9-max Seat #7 is the button
Seat 1: Kelvin sai ($98.32 in chips) 
Seat 2: PacPacBum ($121.49 in chips) 
Seat 3: Filojoes ($100 in chips) 
Seat 4: nubpoker ($154.65 in chips) 
Seat 5: matiko09 ($114.20 in chips) 
Seat 6: xhinostrabli ($97.61 in chips) 
Seat 7: flk.Dasas ($156.90 in chips) 
Seat 8: Dickyxxx ($104.17 in chips) 
Seat 9: mycka86 ($114.15 in chips) 
Dickyxxx: posts small blind $0.50
mycka86: posts big blind $1
*** HOLE CARDS ***
Dealt to matiko09 [Ts 6c]
Kelvin sai: folds 
PacPacBum: folds 
Filojoes: folds 
nubpoker: raises $1.50 to $2.50
matiko09: folds 
xhinostrabli: folds 
flk.Dasas: folds 
Dickyxxx: folds 
mycka86: calls $1.50
*** FLOP *** [7c 8d 4h]
mycka86: checks 
nubpoker: checks 
*** TURN *** [7c 8d 4h] [As]
mycka86: checks 
nubpoker: checks 
*** RIVER *** [7c 8d 4h As] [8h]
mycka86: checks 
nubpoker: bets $3.47
mycka86: folds 
Uncalled bet ($3.47) returned to nubpoker
nubpoker collected $5.22 from pot
nubpoker: doesn't show hand 
*** SUMMARY ***
Total pot $5.50 | Rake $0.28 
Board [7c 8d 4h As 8h]
Seat 1: Kelvin sai folded before Flop (didn't bet)
Seat 2: PacPacBum folded before Flop (didn't bet)
Seat 3: Filojoes folded before Flop (didn't bet)
Seat 4: nubpoker collected ($5.22)
Seat 5: matiko09 folded before Flop (didn't bet)
Seat 6: xhinostrabli folded before Flop (didn't bet)
Seat 7: flk.Dasas (button) folded before Flop (didn't bet)
Seat 8: Dickyxxx (small blind) folded before Flop
Seat 9: mycka86 (big blind) folded on the River





PokerStars Hand #153068906264:  Hold'em No Limit ($1/$2 USD) - 2016/05/09 17:19:37 CET [2016/05/09 11:19:37 ET]
Table 'Hagar II' 9-max Seat #5 is the button
Seat 2: darren1031 ($321.21 in chips) 
Seat 3: Sasuke777777 ($53.97 in chips) 
Seat 4: matiko09 ($430.49 in chips) 
Seat 5: PacPacBum ($262.47 in chips) 
Seat 6: el Fatto ($200 in chips) 
Seat 7: Monsthand ($315.12 in chips) 
Seat 9: chaps1988 ($393.47 in chips) 
el Fatto: posts small blind $1
Monsthand: posts big blind $2
CI58: sits out 
*** HOLE CARDS ***
Dealt to matiko09 [3c 8s]
chaps1988: raises $4 to $6
darren1031: folds 
Sasuke777777: folds 
matiko09: folds 
PacPacBum: folds 
el Fatto: folds 
Monsthand: folds 
Uncalled bet ($4) returned to chaps1988
chaps1988 collected $5 from pot
chaps1988: doesn't show hand 
*** SUMMARY ***
Total pot $5 | Rake $0 
Seat 2: darren1031 folded before Flop (didn't bet)
Seat 3: Sasuke777777 folded before Flop (didn't bet)
Seat 4: matiko09 folded before Flop (didn't bet)
Seat 5: PacPacBum (button) folded before Flop (didn't bet)
Seat 6: el Fatto (small blind) folded before Flop
Seat 7: Monsthand (big blind) folded before Flop
Seat 9: chaps1988 collected ($5)





PokerStars Hand #153068912880:  Hold'em No Limit ($0.50/$1.00 USD) - 2016/05/09 17:19:47 CET [2016/05/09 11:19:47 ET]
Table 'Buryatia II' 9-max Seat #3 is the button
Seat 2: rusher_NiNja ($100 in chips) 
Seat 3: Filojoes ($100 in chips) 
Seat 4: Dickyxxx ($102.25 in chips) 
Seat 5: amisasi ($179.67 in chips) 
Seat 6: I The King I ($126.67 in chips) 
Seat 8: matiko09 ($127 in chips) 
Seat 9: CI58 ($119.46 in chips) 
Dickyxxx: posts small blind $0.50
amisasi: posts big blind $1
nubpoker: sits out 
*** HOLE CARDS ***
Dealt to matiko09 [As 7h]
I The King I: raises $2 to $3
matiko09: folds 
CI58: folds 
rusher_NiNja: folds 
Filojoes: folds 
Dickyxxx: folds 
amisasi: folds 
Uncalled bet ($2) returned to I The King I
I The King I collected $2.50 from pot
I The King I: doesn't show hand 
*** SUMMARY ***
Total pot $2.50 | Rake $0 
Seat 2: rusher_NiNja folded before Flop (didn't bet)
Seat 3: Filojoes (button) folded before Flop (didn't bet)
Seat 4: Dickyxxx (small blind) folded before Flop
Seat 5: amisasi (big blind) folded before Flop
Seat 6: I The King I collected ($2.50)
Seat 8: matiko09 folded before Flop (didn't bet)
Seat 9: CI58 folded before Flop (didn't bet)





PokerStars Hand #153068916407:  Hold'em No Limit ($1/$2 USD) - 2016/05/09 17:19:53 CET [2016/05/09 11:19:53 ET]
Table 'Titan III' 9-max Seat #6 is the button
Seat 1: I The King I ($244.50 in chips) 
Seat 2: PacPacBum ($215.20 in chips) 
Seat 4: HuanHuan ($200 in chips) 
Seat 5: Monsthand ($270.25 in chips) 
Seat 6: matiko09 ($208 in chips) 
Seat 7: Igoriah ($350.14 in chips) 
Seat 8: chaps1988 ($200 in chips) 
Igoriah: posts small blind $1
chaps1988: posts big blind $2
CI58: sits out 
*** HOLE CARDS ***
Dealt to matiko09 [8d 4s]
I The King I: folds 
PacPacBum: folds 
HuanHuan: folds 
Monsthand: folds 
matiko09: folds 
Igoriah: folds 
Uncalled bet ($1) returned to chaps1988
chaps1988 collected $2 from pot
chaps1988: doesn't show hand 
*** SUMMARY ***
Total pot $2 | Rake $0 
Seat 1: I The King I folded before Flop (didn't bet)
Seat 2: PacPacBum folded before Flop (didn't bet)
Seat 4: HuanHuan folded before Flop (didn't bet)
Seat 5: Monsthand folded before Flop (didn't bet)
Seat 6: matiko09 (button) folded before Flop (didn't bet)
Seat 7: Igoriah (small blind) folded before Flop
Seat 8: chaps1988 (big blind) collected ($2)





PokerStars Hand #153068921571:  Hold'em No Limit ($0.50/$1.00 USD) - 2016/05/09 17:20:01 CET [2016/05/09 11:20:01 ET]
Table 'Terpsichore' 9-max Seat #8 is the button
Seat 2: CI58 ($100 in chips) 
Seat 3: matiko09 ($150.39 in chips) 
Seat 4: nubpoker ($130.48 in chips) 
Seat 5: mycka86 ($254.98 in chips) 
Seat 6: Filojoes ($126.06 in chips) 
Seat 7: Kukuryzka ($100 in chips) 
Seat 8: Kiosk230472 ($110.16 in chips) 
Donetsk1y will be allowed to play after the button
CI58: posts small blind $0.50
matiko09: posts big blind $1
*** HOLE CARDS ***
Dealt to matiko09 [7h 2h]
nubpoker: folds 
mycka86: folds 
Filojoes: folds 
Kukuryzka: folds 
Kiosk230472: folds 
CI58: folds 
Uncalled bet ($0.50) returned to matiko09
matiko09 collected $1 from pot
matiko09: doesn't show hand 
*** SUMMARY ***
Total pot $1 | Rake $0 
Seat 2: CI58 (small blind) folded before Flop
Seat 3: matiko09 (big blind) collected ($1)
Seat 4: nubpoker folded before Flop (didn't bet)
Seat 5: mycka86 folded before Flop (didn't bet)
Seat 6: Filojoes folded before Flop (didn't bet)
Seat 7: Kukuryzka folded before Flop (didn't bet)
Seat 8: Kiosk230472 (button) folded before Flop (didn't bet)





PokerStars Hand #153068924086:  Hold'em No Limit ($1/$2 USD) - 2016/05/09 17:20:05 CET [2016/05/09 11:20:05 ET]
Table 'Hagar II' 9-max Seat #6 is the button
Seat 2: darren1031 ($321.21 in chips) 
Seat 3: Sasuke777777 ($53.97 in chips) 
Seat 4: matiko09 ($430.49 in chips) 
Seat 5: PacPacBum ($262.47 in chips) 
Seat 6: el Fatto ($200 in chips) 
Seat 7: Monsthand ($313.12 in chips) 
Seat 9: chaps1988 ($396.47 in chips) 
Monsthand: posts small blind $1
AceSurgeon was removed from the table for failing to post
chaps1988: posts big blind $2
CI58: sits out 
*** HOLE CARDS ***
Dealt to matiko09 [Qs Td]
darren1031: folds 
Sasuke777777: folds 
matiko09: folds 
PacPacBum: folds 
el Fatto: folds 
Monsthand: folds 
Uncalled bet ($1) returned to chaps1988
chaps1988 collected $2 from pot
chaps1988: doesn't show hand 
*** SUMMARY ***
Total pot $2 | Rake $0 
Seat 2: darren1031 folded before Flop (didn't bet)
Seat 3: Sasuke777777 folded before Flop (didn't bet)
Seat 4: matiko09 folded before Flop (didn't bet)
Seat 5: PacPacBum folded before Flop (didn't bet)
Seat 6: el Fatto (button) folded before Flop (didn't bet)
Seat 7: Monsthand (small blind) folded before Flop
Seat 9: chaps1988 (big blind) collected ($2)





PokerStars Hand #153068927885:  Hold'em No Limit ($0.50/$1.00 USD) - 2016/05/09 17:20:11 CET [2016/05/09 11:20:11 ET]
Table 'Reiss' 9-max Seat #5 is the button
Seat 1: Dickyxxx ($163.16 in chips) 
Seat 2: mycka86 ($185.75 in chips) 
Seat 3: chaps1988 ($123.46 in chips) 
Seat 4: CI58 ($109.36 in chips) 
Seat 5: matiko09 ($131.71 in chips) 
Seat 6: HITYESCA ($103.12 in chips) 
Seat 7: nubpoker ($129.79 in chips) 
Seat 9: flyer9898 ($67 in chips) 
HITYESCA: posts small blind $0.50
nubpoker: posts big blind $1
JimineyCrik: sits out 
*** HOLE CARDS ***
Dealt to matiko09 [5s 8d]
flyer9898: folds 
Dickyxxx: folds 
mycka86: folds 
chaps1988: folds 
CI58: raises $1.25 to $2.25
matiko09: folds 
HITYESCA: raises $6.75 to $9
nubpoker: folds 
CI58: calls $6.75
*** FLOP *** [4c 5c 7h]
HITYESCA: checks 
CI58: bets $10.83
HITYESCA: raises $34.17 to $45
CI58: raises $55.36 to $100.36 and is all-in
HITYESCA: calls $49.12 and is all-in
Uncalled bet ($6.24) returned to CI58
*** TURN *** [4c 5c 7h] [8h]
*** RIVER *** [4c 5c 7h 8h] [4s]
*** SHOW DOWN ***
HITYESCA: shows [6h 6s] (a straight, Four to Eight)
CI58: mucks hand 
HITYESCA collected $204.74 from pot
*** SUMMARY ***
Total pot $207.24 | Rake $2.50 
Board [4c 5c 7h 8h 4s]
Seat 1: Dickyxxx folded before Flop (didn't bet)
Seat 2: mycka86 folded before Flop (didn't bet)
Seat 3: chaps1988 folded before Flop (didn't bet)
Seat 4: CI58 mucked [Qh Qc]
Seat 5: matiko09 (button) folded before Flop (didn't bet)
Seat 6: HITYESCA (small blind) showed [6h 6s] and won ($204.74) with a straight, Four to Eight
Seat 7: nubpoker (big blind) folded before Flop
Seat 9: flyer9898 folded before Flop (didn't bet)





PokerStars Hand #153068928656:  Hold'em No Limit ($1/$2 USD) - 2016/05/09 17:20:12 CET [2016/05/09 11:20:12 ET]
Table 'Titan III' 9-max Seat #7 is the button
Seat 1: I The King I ($244.50 in chips) 
Seat 2: PacPacBum ($215.20 in chips) 
Seat 4: HuanHuan ($200 in chips) 
Seat 5: Monsthand ($270.25 in chips) 
Seat 6: matiko09 ($208 in chips) 
Seat 7: Igoriah ($349.14 in chips) 
Seat 8: chaps1988 ($201 in chips) 
chaps1988: posts small blind $1
I The King I: posts big blind $2
CI58: sits out 
*** HOLE CARDS ***
Dealt to matiko09 [Qs Tc]
PacPacBum: raises $2.08 to $4.08
HuanHuan: folds 
Monsthand: folds 
matiko09: folds 
Igoriah: folds 
chaps1988: folds 
I The King I: folds 
Uncalled bet ($2.08) returned to PacPacBum
PacPacBum collected $5 from pot
PacPacBum: doesn't show hand 
*** SUMMARY ***
Total pot $5 | Rake $0 
Seat 1: I The King I (big blind) folded before Flop
Seat 2: PacPacBum collected ($5)
Seat 4: HuanHuan folded before Flop (didn't bet)
Seat 5: Monsthand folded before Flop (didn't bet)
Seat 6: matiko09 folded before Flop (didn't bet)
Seat 7: Igoriah (button) folded before Flop (didn't bet)
Seat 8: chaps1988 (small blind) folded before Flop





PokerStars Hand #153068933855:  Hold'em No Limit ($1/$2 USD) - 2016/05/09 17:20:20 CET [2016/05/09 11:20:20 ET]
Table 'Hagar II' 9-max Seat #7 is the button
Seat 1: CI58 ($200 in chips) 
Seat 2: darren1031 ($321.21 in chips) 
Seat 3: Sasuke777777 ($53.97 in chips) 
Seat 4: matiko09 ($430.49 in chips) 
Seat 5: PacPacBum ($262.47 in chips) 
Seat 6: el Fatto ($200 in chips) 
Seat 7: Monsthand ($312.12 in chips) 
Seat 9: chaps1988 ($397.47 in chips) 
chaps1988: posts small blind $1
Igoriah joins the table at seat #8 
CI58: posts big blind $2
*** HOLE CARDS ***
Dealt to matiko09 [Ks Kh]
darren1031: folds 
Sasuke777777: folds 
matiko09: raises $3 to $5
PacPacBum: folds 
el Fatto: folds 
Monsthand: folds 
chaps1988: folds 
CI58: folds 
Uncalled bet ($3) returned to matiko09
matiko09 collected $5 from pot
matiko09: doesn't show hand 
*** SUMMARY ***
Total pot $5 | Rake $0 
Seat 1: CI58 (big blind) folded before Flop
Seat 2: darren1031 folded before Flop (didn't bet)
Seat 3: Sasuke777777 folded before Flop (didn't bet)
Seat 4: matiko09 collected ($5)
Seat 5: PacPacBum folded before Flop (didn't bet)
Seat 6: el Fatto folded before Flop (didn't bet)
Seat 7: Monsthand (button) folded before Flop (didn't bet)
Seat 9: chaps1988 (small blind) folded before Flop





PokerStars Hand #153068934594:  Hold'em No Limit ($1/$2 USD) - 2016/05/09 17:20:22 CET [2016/05/09 11:20:22 ET]
Table 'Demeter II' 9-max Seat #9 is the button
Seat 1: Sasuke777777 ($324.99 in chips) 
Seat 2: matiko09 ($208.46 in chips) 
Seat 3: chaps1988 ($203 in chips) 
Seat 5: PacPacBum ($235.21 in chips) 
Seat 6: HuanHuan ($206.02 in chips) 
Seat 7: Siwyosb ($209.31 in chips) 
Seat 8: CI58 ($226.29 in chips) 
Seat 9: Monsthand ($644.38 in chips) 
Sasuke777777: posts small blind $1
matiko09: posts big blind $2
Igoriah: sits out 
*** HOLE CARDS ***
Dealt to matiko09 [Ac 6s]
chaps1988: folds 
PacPacBum: folds 
HuanHuan: folds 
Siwyosb: folds 
CI58: folds 
Monsthand: raises $3 to $5
Sasuke777777: folds 
matiko09: folds 
Uncalled bet ($3) returned to Monsthand
Monsthand collected $5 from pot
Monsthand: doesn't show hand 
*** SUMMARY ***
Total pot $5 | Rake $0 
Seat 1: Sasuke777777 (small blind) folded before Flop
Seat 2: matiko09 (big blind) folded before Flop
Seat 3: chaps1988 folded before Flop (didn't bet)
Seat 5: PacPacBum folded before Flop (didn't bet)
Seat 6: HuanHuan folded before Flop (didn't bet)
Seat 7: Siwyosb folded before Flop (didn't bet)
Seat 8: CI58 folded before Flop (didn't bet)
Seat 9: Monsthand (button) collected ($5)





PokerStars Hand #153068942078:  Hold'em No Limit ($0.50/$1.00 USD) - 2016/05/09 17:20:34 CET [2016/05/09 11:20:34 ET]
Table 'Buryatia II' 9-max Seat #4 is the button
Seat 2: rusher_NiNja ($100 in chips) 
Seat 3: Filojoes ($100 in chips) 
Seat 4: Dickyxxx ($101.75 in chips) 
Seat 5: amisasi ($178.67 in chips) 
Seat 6: I The King I ($128.17 in chips) 
Seat 8: matiko09 ($127 in chips) 
Seat 9: CI58 ($119.46 in chips) 
amisasi: posts small blind $0.50
I The King I: posts big blind $1
nubpoker: sits out 
*** HOLE CARDS ***
Dealt to matiko09 [3c Ks]
matiko09: folds 
CI58: folds 
rusher_NiNja: folds 
Filojoes: raises $1.50 to $2.50
Dickyxxx: folds 
amisasi: folds 
I The King I: calls $1.50
*** FLOP *** [8s 8c 6d]
I The King I: checks 
Filojoes: checks 
*** TURN *** [8s 8c 6d] [Ts]
I The King I: checks 
Filojoes: checks 
*** RIVER *** [8s 8c 6d Ts] [Js]
I The King I: checks 
Filojoes: bets $3.13
I The King I: folds 
Uncalled bet ($3.13) returned to Filojoes
Filojoes collected $5.22 from pot
Filojoes: doesn't show hand 
*** SUMMARY ***
Total pot $5.50 | Rake $0.28 
Board [8s 8c 6d Ts Js]
Seat 2: rusher_NiNja folded before Flop (didn't bet)
Seat 3: Filojoes collected ($5.22)
Seat 4: Dickyxxx (button) folded before Flop (didn't bet)
Seat 5: amisasi (small blind) folded before Flop
Seat 6: I The King I (big blind) folded on the River
Seat 8: matiko09 folded before Flop (didn't bet)
Seat 9: CI58 folded before Flop (didn't bet)





PokerStars Hand #153068945108:  Hold'em No Limit ($0.50/$1.00 USD) - 2016/05/09 17:20:38 CET [2016/05/09 11:20:38 ET]
Table 'Terpsichore' 9-max Seat #2 is the button
Seat 2: CI58 ($100 in chips) 
Seat 3: matiko09 ($150.89 in chips) 
Seat 4: nubpoker ($130.48 in chips) 
Seat 5: mycka86 ($254.98 in chips) 
Seat 6: Filojoes ($126.06 in chips) 
Seat 7: Kukuryzka ($100 in chips) 
Seat 8: Kiosk230472 ($110.16 in chips) 
matiko09: posts small blind $0.50
nubpoker: posts big blind $1
Donetsk1y: sits out 
*** HOLE CARDS ***
Dealt to matiko09 [Qs Jd]
mycka86: raises $2 to $3
Filojoes: calls $3
Kukuryzka: folds 
Kiosk230472: folds 
CI58: calls $3
matiko09: folds 
nubpoker: folds 
*** FLOP *** [Jc Js Qc]
mycka86: checks 
Filojoes: checks 
CI58: checks 
*** TURN *** [Jc Js Qc] [As]
mycka86: checks 
Filojoes: bets $6.98
CI58: folds 
mycka86: calls $6.98
*** RIVER *** [Jc Js Qc As] [7d]
mycka86: checks 
Filojoes: checks 
*** SHOW DOWN ***
mycka86: shows [2c Ac] (two pair, Aces and Jacks)
Filojoes: mucks hand 
mycka86 collected $23.24 from pot
*** SUMMARY ***
Total pot $24.46 | Rake $1.22 
Board [Jc Js Qc As 7d]
Seat 2: CI58 (button) folded on the Turn
Seat 3: matiko09 (small blind) folded before Flop
Seat 4: nubpoker (big blind) folded before Flop
Seat 5: mycka86 showed [2c Ac] and won ($23.24) with two pair, Aces and Jacks
Seat 6: Filojoes mucked [8d Td]
Seat 7: Kukuryzka folded before Flop (didn't bet)
Seat 8: Kiosk230472 folded before Flop (didn't bet)





PokerStars Hand #153068947006:  Hold'em No Limit ($0.50/$1.00 USD) - 2016/05/09 17:20:41 CET [2016/05/09 11:20:41 ET]
Table 'Merga II' 9-max Seat #9 is the button
Seat 1: R1aki ($102.50 in chips) 
Seat 3: 43605511 ($99 in chips) 
Seat 4: erick222 ($100 in chips) 
Seat 5: matiko09 ($100 in chips) 
Seat 6: AlKatrone ($100 in chips) 
Seat 7: rusher_NiNja ($219.70 in chips) 
Seat 8: serbianhaze ($108.40 in chips) 
Seat 9: maxxmeister ($122 in chips) 
R1aki: posts small blind $0.50
Spid1: is sitting out 
Spid1 leaves the table
43605511: posts big blind $1
*** HOLE CARDS ***
Dealt to matiko09 [9d Qd]
erick222: folds 
matiko09: folds 
AlKatrone: folds 
rusher_NiNja: folds 
serbianhaze: folds 
I The King I joins the table at seat #2 
I The King I leaves the table
maxxmeister: folds 
R1aki: raises $2 to $3
flk.Dasas joins the table at seat #2 
43605511: folds 
Uncalled bet ($2) returned to R1aki
R1aki collected $2 from pot
R1aki: doesn't show hand 
*** SUMMARY ***
Total pot $2 | Rake $0 
Seat 1: R1aki (small blind) collected ($2)
Seat 3: 43605511 (big blind) folded before Flop
Seat 4: erick222 folded before Flop (didn't bet)
Seat 5: matiko09 folded before Flop (didn't bet)
Seat 6: AlKatrone folded before Flop (didn't bet)
Seat 7: rusher_NiNja folded before Flop (didn't bet)
Seat 8: serbianhaze folded before Flop (didn't bet)
Seat 9: maxxmeister (button) folded before Flop (didn't bet)





PokerStars Hand #153068946672:  Hold'em No Limit ($1/$2 USD) - 2016/05/09 17:20:41 CET [2016/05/09 11:20:41 ET]
Table 'Bella' 9-max Seat #8 is the button
Seat 1: matiko09 ($200 in chips) 
Seat 2: AlKatrone ($207.67 in chips) 
Seat 3: PacPacBum ($229.96 in chips) 
Seat 5: Monsthand ($200 in chips) 
Seat 6: CI58 ($223.80 in chips) 
Seat 7: stan_09319 ($437.71 in chips) 
Seat 8: Igoriah ($200.68 in chips) 
matiko09: posts small blind $1
AlKatrone: posts big blind $2
HuanHuan: sits out 
*** HOLE CARDS ***
Dealt to matiko09 [7s 6s]
PacPacBum: folds 
Monsthand: folds 
CI58: folds 
stan_09319: folds 
Igoriah: raises $3 to $5
matiko09: folds 
AlKatrone: folds 
Uncalled bet ($3) returned to Igoriah
Igoriah collected $5 from pot
Igoriah: doesn't show hand 
*** SUMMARY ***
Total pot $5 | Rake $0 
Seat 1: matiko09 (small blind) folded before Flop
Seat 2: AlKatrone (big blind) folded before Flop
Seat 3: PacPacBum folded before Flop (didn't bet)
Seat 5: Monsthand folded before Flop (didn't bet)
Seat 6: CI58 folded before Flop (didn't bet)
Seat 7: stan_09319 folded before Flop (didn't bet)
Seat 8: Igoriah (button) collected ($5)





PokerStars Hand #153068955285:  Hold'em No Limit ($1/$2 USD) - 2016/05/09 17:20:54 CET [2016/05/09 11:20:54 ET]
Table 'Demeter II' 9-max Seat #1 is the button
Seat 1: Sasuke777777 ($323.99 in chips) 
Seat 2: matiko09 ($206.46 in chips) 
Seat 3: chaps1988 ($203 in chips) 
Seat 5: PacPacBum ($235.21 in chips) 
Seat 6: HuanHuan ($206.02 in chips) 
Seat 7: Siwyosb ($209.31 in chips) 
Seat 8: CI58 ($226.29 in chips) 
Seat 9: Monsthand ($647.38 in chips) 
matiko09: posts small blind $1
chaps1988: posts big blind $2
Igoriah: sits out 
*** HOLE CARDS ***
Dealt to matiko09 [2c 9s]
PacPacBum: folds 
HuanHuan: folds 
Siwyosb: raises $2 to $4
CI58: folds 
Monsthand: folds 
Sasuke777777: folds 
matiko09: folds 
chaps1988: folds 
Uncalled bet ($2) returned to Siwyosb
Siwyosb collected $5 from pot
*** SUMMARY ***
Total pot $5 | Rake $0 
Seat 1: Sasuke777777 (button) folded before Flop (didn't bet)
Seat 2: matiko09 (small blind) folded before Flop
Seat 3: chaps1988 (big blind) folded before Flop
Seat 5: PacPacBum folded before Flop (didn't bet)
Seat 6: HuanHuan folded before Flop (didn't bet)
Seat 7: Siwyosb collected ($5)
Seat 8: CI58 folded before Flop (didn't bet)
Seat 9: Monsthand folded before Flop (didn't bet)





PokerStars Hand #153068956021:  Hold'em No Limit ($1/$2 USD) - 2016/05/09 17:20:56 CET [2016/05/09 11:20:56 ET]
Table 'Titan III' 9-max Seat #8 is the button
Seat 1: I The King I ($242.50 in chips) 
Seat 2: PacPacBum ($218.20 in chips) 
Seat 4: HuanHuan ($200 in chips) 
Seat 5: Monsthand ($270.25 in chips) 
Seat 6: matiko09 ($208 in chips) 
Seat 7: Igoriah ($349.14 in chips) 
Seat 8: chaps1988 ($200 in chips) 
I The King I: posts small blind $1
PacPacBum: posts big blind $2
CI58: sits out 
*** HOLE CARDS ***
Dealt to matiko09 [2h 3h]
scop79 joins the table at seat #9 
HuanHuan: folds 
Monsthand: folds 
matiko09: folds 
Igoriah: folds 
chaps1988: raises $2 to $4
I The King I: folds 
PacPacBum: folds 
Uncalled bet ($2) returned to chaps1988
chaps1988 collected $5 from pot
chaps1988: doesn't show hand 
*** SUMMARY ***
Total pot $5 | Rake $0 
Seat 1: I The King I (small blind) folded before Flop
Seat 2: PacPacBum (big blind) folded before Flop
Seat 4: HuanHuan folded before Flop (didn't bet)
Seat 5: Monsthand folded before Flop (didn't bet)
Seat 6: matiko09 folded before Flop (didn't bet)
Seat 7: Igoriah folded before Flop (didn't bet)
Seat 8: chaps1988 (button) collected ($5)





PokerStars Hand #153068957640:  Hold'em No Limit ($1/$2 USD) - 2016/05/09 17:20:58 CET [2016/05/09 11:20:58 ET]
Table 'Hagar II' 9-max Seat #9 is the button
Seat 1: CI58 ($200 in chips) 
Seat 2: darren1031 ($321.21 in chips) 
Seat 3: Sasuke777777 ($53.97 in chips) 
Seat 4: matiko09 ($433.49 in chips) 
Seat 5: PacPacBum ($262.47 in chips) 
Seat 6: el Fatto ($200 in chips) 
Seat 7: Monsthand ($312.12 in chips) 
Seat 9: chaps1988 ($396.47 in chips) 
CI58: posts small blind $1
darren1031: posts big blind $2
Igoriah: sits out 
*** HOLE CARDS ***
Dealt to matiko09 [9c Js]
Sasuke777777: folds 
matiko09: folds 
PacPacBum: raises $2.08 to $4.08
el Fatto: raises $12.92 to $17
Monsthand: folds 
chaps1988: calls $17
CI58: folds 
darren1031: folds 
PacPacBum: folds 
*** FLOP *** [9s 5h Ks]
el Fatto: checks 
chaps1988: checks 
*** TURN *** [9s 5h Ks] [4c]
el Fatto: bets $31
chaps1988: folds 
Uncalled bet ($31) returned to el Fatto
el Fatto collected $39.03 from pot
el Fatto: doesn't show hand 
*** SUMMARY ***
Total pot $41.08 | Rake $2.05 
Board [9s 5h Ks 4c]
Seat 1: CI58 (small blind) folded before Flop
Seat 2: darren1031 (big blind) folded before Flop
Seat 3: Sasuke777777 folded before Flop (didn't bet)
Seat 4: matiko09 folded before Flop (didn't bet)
Seat 5: PacPacBum folded before Flop
Seat 6: el Fatto collected ($39.03)
Seat 7: Monsthand folded before Flop (didn't bet)
Seat 9: chaps1988 (button) folded on the Turn





PokerStars Hand #153068961117:  Hold'em No Limit ($0.50/$1.00 USD) - 2016/05/09 17:21:04 CET [2016/05/09 11:21:04 ET]
Table 'Merga II' 9-max Seat #1 is the button
Seat 1: R1aki ($103.50 in chips) 
Seat 3: 43605511 ($98 in chips) 
Seat 4: erick222 ($100 in chips) 
Seat 5: matiko09 ($100 in chips) 
Seat 6: AlKatrone ($100 in chips) 
Seat 7: rusher_NiNja ($219.70 in chips) 
Seat 8: serbianhaze ($108.40 in chips) 
Seat 9: maxxmeister ($122 in chips) 
43605511: posts small blind $0.50
erick222: posts big blind $1
*** HOLE CARDS ***
Dealt to matiko09 [Td 2h]
matiko09: folds 
AlKatrone: folds 
rusher_NiNja: folds 
serbianhaze: folds 
maxxmeister: raises $2 to $3
R1aki: folds 
43605511: folds 
erick222: calls $2
*** FLOP *** [3c Jc 6h]
erick222: checks 
maxxmeister: checks 
*** TURN *** [3c Jc 6h] [5d]
erick222: bets $4.11
maxxmeister: folds 
Uncalled bet ($4.11) returned to erick222
erick222 collected $6.18 from pot
erick222: doesn't show hand 
*** SUMMARY ***
Total pot $6.50 | Rake $0.32 
Board [3c Jc 6h 5d]
Seat 1: R1aki (button) folded before Flop (didn't bet)
Seat 3: 43605511 (small blind) folded before Flop
Seat 4: erick222 (big blind) collected ($6.18)
Seat 5: matiko09 folded before Flop (didn't bet)
Seat 6: AlKatrone folded before Flop (didn't bet)
Seat 7: rusher_NiNja folded before Flop (didn't bet)
Seat 8: serbianhaze folded before Flop (didn't bet)
Seat 9: maxxmeister folded on the Turn





PokerStars Hand #153068964934:  Hold'em No Limit ($1/$2 USD) - 2016/05/09 17:21:10 CET [2016/05/09 11:21:10 ET]
Table 'Bella' 9-max Seat #1 is the button
Seat 1: matiko09 ($200 in chips) 
Seat 2: AlKatrone ($205.67 in chips) 
Seat 3: PacPacBum ($229.96 in chips) 
Seat 5: Monsthand ($200 in chips) 
Seat 6: CI58 ($223.80 in chips) 
Seat 7: stan_09319 ($437.71 in chips) 
Seat 8: Igoriah ($203.68 in chips) 
AlKatrone: posts small blind $1
PacPacBum: posts big blind $2
HuanHuan: sits out 
*** HOLE CARDS ***
Dealt to matiko09 [9d 2s]
Monsthand: folds 
CI58: folds 
stan_09319: folds 
Igoriah: folds 
matiko09: folds 
AlKatrone: raises $3 to $5
PacPacBum: folds 
Uncalled bet ($3) returned to AlKatrone
AlKatrone collected $4 from pot
*** SUMMARY ***
Total pot $4 | Rake $0 
Seat 1: matiko09 (button) folded before Flop (didn't bet)
Seat 2: AlKatrone (small blind) collected ($4)
Seat 3: PacPacBum (big blind) folded before Flop
Seat 5: Monsthand folded before Flop (didn't bet)
Seat 6: CI58 folded before Flop (didn't bet)
Seat 7: stan_09319 folded before Flop (didn't bet)
Seat 8: Igoriah folded before Flop (didn't bet)





PokerStars Hand #153068965324:  Hold'em No Limit ($0.50/$1.00 USD) - 2016/05/09 17:21:10 CET [2016/05/09 11:21:10 ET]
Table 'Orthos' 9-max Seat #8 is the button
Seat 1: Kelvin sai ($98.32 in chips) 
Seat 2: PacPacBum ($121.49 in chips) 
Seat 3: Filojoes ($100 in chips) 
Seat 4: nubpoker ($157.37 in chips) 
Seat 5: matiko09 ($114.20 in chips) 
Seat 6: xhinostrabli ($97.61 in chips) 
Seat 7: flk.Dasas ($156.90 in chips) 
Seat 8: Dickyxxx ($103.67 in chips) 
Seat 9: mycka86 ($111.65 in chips) 
mycka86: posts small blind $0.50
Kelvin sai: posts big blind $1
*** HOLE CARDS ***
Dealt to matiko09 [Tc 8h]
PacPacBum: folds 
Filojoes: folds 
nubpoker: folds 
matiko09: folds 
xhinostrabli: raises $2 to $3
flk.Dasas: raises $6 to $9
Dickyxxx: folds 
mycka86: folds 
Kelvin sai: folds 
xhinostrabli: calls $6
*** FLOP *** [6c Jc 3h]
xhinostrabli: checks 
flk.Dasas: bets $10.93
xhinostrabli: folds 
Uncalled bet ($10.93) returned to flk.Dasas
flk.Dasas collected $18.52 from pot
flk.Dasas: doesn't show hand 
*** SUMMARY ***
Total pot $19.50 | Rake $0.98 
Board [6c Jc 3h]
Seat 1: Kelvin sai (big blind) folded before Flop
Seat 2: PacPacBum folded before Flop (didn't bet)
Seat 3: Filojoes folded before Flop (didn't bet)
Seat 4: nubpoker folded before Flop (didn't bet)
Seat 5: matiko09 folded before Flop (didn't bet)
Seat 6: xhinostrabli folded on the Flop
Seat 7: flk.Dasas collected ($18.52)
Seat 8: Dickyxxx (button) folded before Flop (didn't bet)
Seat 9: mycka86 (small blind) folded before Flop





PokerStars Hand #153068967934:  Hold'em No Limit ($1/$2 USD) - 2016/05/09 17:21:15 CET [2016/05/09 11:21:15 ET]
Table 'Celaeno II' 9-max Seat #6 is the button
Seat 1: LRVAV7 ($200 in chips) 
Seat 2: PacPacBum ($208.89 in chips) 
Seat 3: CI58 ($227.60 in chips) 
Seat 4: matiko09 ($419.82 in chips) 
Seat 5: Monsthand ($447.01 in chips) 
Seat 6: Igoriah ($217.47 in chips) 
Seat 7: HuanHuan ($200 in chips) 
Seat 8: chaps1988 ($221.31 in chips) 
Seat 9: Spid1 ($303.87 in chips) 
HuanHuan: posts small blind $1
chaps1988: posts big blind $2
*** HOLE CARDS ***
Dealt to matiko09 [Qc 2c]
Spid1: folds 
LRVAV7: folds 
PacPacBum: raises $4 to $6
CI58: folds 
matiko09: folds 
Monsthand: folds 
Igoriah: calls $6
HuanHuan: calls $5
chaps1988: folds 
*** FLOP *** [7d 3d 5d]
HuanHuan: checks 
PacPacBum: bets $10.26
Igoriah: folds 
HuanHuan: folds 
Uncalled bet ($10.26) returned to PacPacBum
PacPacBum collected $19 from pot
PacPacBum: doesn't show hand 
*** SUMMARY ***
Total pot $20 | Rake $1 
Board [7d 3d 5d]
Seat 1: LRVAV7 folded before Flop (didn't bet)
Seat 2: PacPacBum collected ($19)
Seat 3: CI58 folded before Flop (didn't bet)
Seat 4: matiko09 folded before Flop (didn't bet)
Seat 5: Monsthand folded before Flop (didn't bet)
Seat 6: Igoriah (button) folded on the Flop
Seat 7: HuanHuan (small blind) folded on the Flop
Seat 8: chaps1988 (big blind) folded before Flop
Seat 9: Spid1 folded before Flop (didn't bet)





PokerStars Hand #153068968199:  Hold'em No Limit ($1/$2 USD) - 2016/05/09 17:21:15 CET [2016/05/09 11:21:15 ET]
Table 'Titan III' 9-max Seat #1 is the button
Seat 1: I The King I ($241.50 in chips) 
Seat 2: PacPacBum ($216.20 in chips) 
Seat 3: CI58 ($200 in chips) 
Seat 4: HuanHuan ($200 in chips) 
Seat 5: Monsthand ($270.25 in chips) 
Seat 6: matiko09 ($208 in chips) 
Seat 7: Igoriah ($349.14 in chips) 
Seat 8: chaps1988 ($203 in chips) 
PacPacBum: posts small blind $1
CI58: posts big blind $2
scop79: sits out 
*** HOLE CARDS ***
Dealt to matiko09 [Th 2d]
HuanHuan: folds 
Monsthand: folds 
matiko09: folds 
Igoriah: folds 
chaps1988: folds 
I The King I: raises $2 to $4
PacPacBum: calls $3
CI58: folds 
*** FLOP *** [3d 6s Ad]
PacPacBum: checks 
I The King I: checks 
*** TURN *** [3d 6s Ad] [9d]
PacPacBum: checks 
I The King I: checks 
*** RIVER *** [3d 6s Ad 9d] [6c]
PacPacBum: checks 
I The King I: checks 
*** SHOW DOWN ***
PacPacBum: shows [Ts Qs] (a pair of Sixes)
I The King I: mucks hand 
PacPacBum collected $9.50 from pot
*** SUMMARY ***
Total pot $10 | Rake $0.50 
Board [3d 6s Ad 9d 6c]
Seat 1: I The King I (button) mucked [Tc Jc]
Seat 2: PacPacBum (small blind) showed [Ts Qs] and won ($9.50) with a pair of Sixes
Seat 3: CI58 (big blind) folded before Flop
Seat 4: HuanHuan folded before Flop (didn't bet)
Seat 5: Monsthand folded before Flop (didn't bet)
Seat 6: matiko09 folded before Flop (didn't bet)
Seat 7: Igoriah folded before Flop (didn't bet)
Seat 8: chaps1988 folded before Flop (didn't bet)





PokerStars Hand #153068973290:  Hold'em No Limit ($1/$2 USD) - 2016/05/09 17:21:23 CET [2016/05/09 11:21:23 ET]
Table 'Demeter II' 9-max Seat #2 is the button
Seat 1: Sasuke777777 ($323.99 in chips) 
Seat 2: matiko09 ($205.46 in chips) 
Seat 3: chaps1988 ($201 in chips) 
Seat 4: Igoriah ($200 in chips) 
Seat 5: PacPacBum ($235.21 in chips) 
Seat 6: HuanHuan ($206.02 in chips) 
Seat 7: Siwyosb ($212.31 in chips) 
Seat 8: CI58 ($226.29 in chips) 
Seat 9: Monsthand ($647.38 in chips) 
chaps1988: posts small blind $1
Igoriah: posts big blind $2
*** HOLE CARDS ***
Dealt to matiko09 [Th 9h]
PacPacBum: folds 
HuanHuan: folds 
Siwyosb has timed out
Siwyosb: folds 
CI58: folds 
Monsthand: folds 
Sasuke777777: raises $4 to $6
matiko09: raises $10 to $16
chaps1988: folds 
Igoriah: folds 
Sasuke777777: calls $10
*** FLOP *** [5h 5c 8c]
Sasuke777777: checks 
matiko09: checks 
*** TURN *** [5h 5c 8c] [Qd]
Sasuke777777: checks 
matiko09: bets $17
Sasuke777777: calls $17
*** RIVER *** [5h 5c 8c Qd] [Ks]
Sasuke777777: checks 
matiko09: checks 
*** SHOW DOWN ***
Sasuke777777: shows [Td Ts] (two pair, Tens and Fives)
matiko09: mucks hand 
Sasuke777777 collected $66.25 from pot
*** SUMMARY ***
Total pot $69 | Rake $2.75 
Board [5h 5c 8c Qd Ks]
Seat 1: Sasuke777777 showed [Td Ts] and won ($66.25) with two pair, Tens and Fives
Seat 2: matiko09 (button) mucked [Th 9h]
Seat 3: chaps1988 (small blind) folded before Flop
Seat 4: Igoriah (big blind) folded before Flop
Seat 5: PacPacBum folded before Flop (didn't bet)
Seat 6: HuanHuan folded before Flop (didn't bet)
Seat 7: Siwyosb folded before Flop (didn't bet)
Seat 8: CI58 folded before Flop (didn't bet)
Seat 9: Monsthand folded before Flop (didn't bet)





PokerStars Hand #153068977334:  Hold'em No Limit ($0.50/$1.00 USD) - 2016/05/09 17:21:29 CET [2016/05/09 11:21:29 ET]
Table 'Odyssey' 9-max Seat #8 is the button
Seat 1: matiko09 ($100 in chips) 
Seat 2: flk.Dasas ($100 in chips) 
Seat 3: chaps1988 ($151.50 in chips) 
Seat 4: mycka86 ($168.15 in chips) 
Seat 6: Kukuryzka ($99.50 in chips) 
Seat 7: DancerNN1 ($112.64 in chips) 
Seat 8: nubpoker ($106.16 in chips) 
Seat 9: hellig777 ($124.98 in chips) 
hellig777: posts small blind $0.50
matiko09: posts big blind $1
Donetsk1y: sits out 
*** HOLE CARDS ***
Dealt to matiko09 [5d 6d]
flk.Dasas: folds 
chaps1988: folds 
mycka86: folds 
Kukuryzka: raises $2 to $3
DancerNN1: calls $3
nubpoker: folds 
hellig777: calls $2.50
matiko09: calls $2
*** FLOP *** [4h Qh Ah]
hellig777: checks 
matiko09: checks 
Kukuryzka: bets $8.55
DancerNN1: calls $8.55
hellig777: calls $8.55
matiko09: folds 
*** TURN *** [4h Qh Ah] [Ts]
hellig777: bets $17.88
Kukuryzka: folds 
DancerNN1: folds 
Uncalled bet ($17.88) returned to hellig777
hellig777 collected $35.77 from pot
*** SUMMARY ***
Total pot $37.65 | Rake $1.88 
Board [4h Qh Ah Ts]
Seat 1: matiko09 (big blind) folded on the Flop
Seat 2: flk.Dasas folded before Flop (didn't bet)
Seat 3: chaps1988 folded before Flop (didn't bet)
Seat 4: mycka86 folded before Flop (didn't bet)
Seat 6: Kukuryzka folded on the Turn
Seat 7: DancerNN1 folded on the Turn
Seat 8: nubpoker (button) folded before Flop (didn't bet)
Seat 9: hellig777 (small blind) collected ($35.77)





PokerStars Hand #153068981901:  Hold'em No Limit ($1/$2 USD) - 2016/05/09 17:21:37 CET [2016/05/09 11:21:37 ET]
Table 'Bella' 9-max Seat #2 is the button
Seat 1: matiko09 ($200 in chips) 
Seat 2: AlKatrone ($207.67 in chips) 
Seat 3: PacPacBum ($227.96 in chips) 
Seat 4: HuanHuan ($200 in chips) 
Seat 6: CI58 ($223.80 in chips) 
Seat 7: stan_09319 ($437.71 in chips) 
Seat 8: Igoriah ($203.68 in chips) 
PacPacBum: posts small blind $1
HuanHuan: posts big blind $2
*** HOLE CARDS ***
Dealt to matiko09 [9s 9c]
CI58: raises $4 to $6
stan_09319: folds 
Igoriah: folds 
matiko09: calls $6
AlKatrone: folds 
PacPacBum: folds 
HuanHuan: folds 
*** FLOP *** [Th 8s 2h]
CI58: checks 
matiko09: bets $7.41
CI58: folds 
Uncalled bet ($7.41) returned to matiko09
matiko09 collected $14.25 from pot
matiko09: doesn't show hand 
*** SUMMARY ***
Total pot $15 | Rake $0.75 
Board [Th 8s 2h]
Seat 1: matiko09 collected ($14.25)
Seat 2: AlKatrone (button) folded before Flop (didn't bet)
Seat 3: PacPacBum (small blind) folded before Flop
Seat 4: HuanHuan (big blind) folded before Flop
Seat 6: CI58 folded on the Flop
Seat 7: stan_09319 folded before Flop (didn't bet)
Seat 8: Igoriah folded before Flop (didn't bet)





PokerStars Hand #153068992363:  Hold'em No Limit ($0.50/$1.00 USD) - 2016/05/09 17:21:54 CET [2016/05/09 11:21:54 ET]
Table 'Reiss' 9-max Seat #6 is the button
Seat 1: Dickyxxx ($163.16 in chips) 
Seat 2: mycka86 ($185.75 in chips) 
Seat 3: chaps1988 ($123.46 in chips) 
Seat 4: CI58 ($100 in chips) 
Seat 5: matiko09 ($131.71 in chips) 
Seat 6: HITYESCA ($204.74 in chips) 
Seat 7: nubpoker ($128.79 in chips) 
Seat 8: JimineyCrik ($100 in chips) 
Seat 9: flyer9898 ($67 in chips) 
nubpoker: posts small blind $0.50
JimineyCrik: posts big blind $1
*** HOLE CARDS ***
Dealt to matiko09 [9s 7h]
flyer9898: folds 
Dickyxxx: raises $2 to $3
mycka86: folds 
flyer9898 leaves the table
chaps1988: folds 
CI58: folds 
matiko09: folds 
HITYESCA: folds 
nubpoker: folds 
JimineyCrik: folds 
Uncalled bet ($2) returned to Dickyxxx
Dickyxxx collected $2.50 from pot
Dickyxxx: doesn't show hand 
*** SUMMARY ***
Total pot $2.50 | Rake $0 
Seat 1: Dickyxxx collected ($2.50)
Seat 2: mycka86 folded before Flop (didn't bet)
Seat 3: chaps1988 folded before Flop (didn't bet)
Seat 4: CI58 folded before Flop (didn't bet)
Seat 5: matiko09 folded before Flop (didn't bet)
Seat 6: HITYESCA (button) folded before Flop (didn't bet)
Seat 7: nubpoker (small blind) folded before Flop
Seat 8: JimineyCrik (big blind) folded before Flop
Seat 9: flyer9898 folded before Flop (didn't bet)





PokerStars Hand #153068995375:  Hold'em No Limit ($1/$2 USD) - 2016/05/09 17:21:58 CET [2016/05/09 11:21:58 ET]
Table 'Celaeno II' 9-max Seat #7 is the button
Seat 1: LRVAV7 ($200 in chips) 
Seat 2: PacPacBum ($221.89 in chips) 
Seat 3: CI58 ($227.60 in chips) 
Seat 4: matiko09 ($419.82 in chips) 
Seat 6: Igoriah ($211.47 in chips) 
Seat 7: HuanHuan ($200 in chips) 
Seat 8: chaps1988 ($219.31 in chips) 
chaps1988: posts small blind $1
Spid1: is sitting out 
Spid1 leaves the table
LRVAV7: posts big blind $2
*** HOLE CARDS ***
Dealt to matiko09 [Qd Td]
I The King I joins the table at seat #9 
I The King I leaves the table
PacPacBum: folds 
KovIFish89 joins the table at seat #9 
KovIFish89 leaves the table
CI58: raises $4 to $6
matiko09: folds 
Igoriah: raises $12 to $18
HuanHuan: folds 
chaps1988: folds 
LRVAV7: folds 
CI58: calls $12
*** FLOP *** [9c Th Ts]
CI58: checks 
Igoriah: bets $19
CI58: folds 
Uncalled bet ($19) returned to Igoriah
Igoriah collected $37.05 from pot
Igoriah: doesn't show hand 
*** SUMMARY ***
Total pot $39 | Rake $1.95 
Board [9c Th Ts]
Seat 1: LRVAV7 (big blind) folded before Flop
Seat 2: PacPacBum folded before Flop (didn't bet)
Seat 3: CI58 folded on the Flop
Seat 4: matiko09 folded before Flop (didn't bet)
Seat 6: Igoriah collected ($37.05)
Seat 7: HuanHuan (button) folded before Flop (didn't bet)
Seat 8: chaps1988 (small blind) folded before Flop





PokerStars Hand #153068996519:  Hold'em No Limit ($0.50/$1.00 USD) - 2016/05/09 17:22:00 CET [2016/05/09 11:22:00 ET]
Table 'Merga II' 9-max Seat #3 is the button
Seat 1: R1aki ($103.50 in chips) 
Seat 3: 43605511 ($97.50 in chips) 
Seat 4: erick222 ($103.18 in chips) 
Seat 5: matiko09 ($100 in chips) 
Seat 6: AlKatrone ($100 in chips) 
Seat 7: rusher_NiNja ($219.70 in chips) 
Seat 8: serbianhaze ($108.40 in chips) 
Seat 9: maxxmeister ($119 in chips) 
erick222: posts small blind $0.50
matiko09: posts big blind $1
*** HOLE CARDS ***
Dealt to matiko09 [2s 6h]
AlKatrone: folds 
rusher_NiNja: folds 
serbianhaze: raises $1 to $2
maxxmeister: folds 
R1aki: folds 
43605511: folds 
erick222: folds 
matiko09: folds 
Uncalled bet ($1) returned to serbianhaze
serbianhaze collected $2.50 from pot
*** SUMMARY ***
Total pot $2.50 | Rake $0 
Seat 1: R1aki folded before Flop (didn't bet)
Seat 3: 43605511 (button) folded before Flop (didn't bet)
Seat 4: erick222 (small blind) folded before Flop
Seat 5: matiko09 (big blind) folded before Flop
Seat 6: AlKatrone folded before Flop (didn't bet)
Seat 7: rusher_NiNja folded before Flop (didn't bet)
Seat 8: serbianhaze collected ($2.50)
Seat 9: maxxmeister folded before Flop (didn't bet)





PokerStars Hand #153069002294:  Hold'em No Limit ($1/$2 USD) - 2016/05/09 17:22:09 CET [2016/05/09 11:22:09 ET]
Table 'Bella' 9-max Seat #3 is the button
Seat 1: matiko09 ($208.25 in chips) 
Seat 2: AlKatrone ($207.67 in chips) 
Seat 3: PacPacBum ($226.96 in chips) 
Seat 4: HuanHuan ($200 in chips) 
Seat 6: CI58 ($217.80 in chips) 
Seat 7: stan_09319 ($437.71 in chips) 
Seat 8: Igoriah ($203.68 in chips) 
HuanHuan: posts small blind $1
CI58: posts big blind $2
*** HOLE CARDS ***
Dealt to matiko09 [2c Qc]
stan_09319: folds 
scout326 leaves the table
Igoriah: folds 
chaps1988 joins the table at seat #9 
matiko09: folds 
AlKatrone: folds 
PacPacBum: raises $2.08 to $4.08
HuanHuan: folds 
CI58: folds 
Uncalled bet ($2.08) returned to PacPacBum
PacPacBum collected $5 from pot
PacPacBum: doesn't show hand 
*** SUMMARY ***
Total pot $5 | Rake $0 
Seat 1: matiko09 folded before Flop (didn't bet)
Seat 2: AlKatrone folded before Flop (didn't bet)
Seat 3: PacPacBum (button) collected ($5)
Seat 4: HuanHuan (small blind) folded before Flop
Seat 6: CI58 (big blind) folded before Flop
Seat 7: stan_09319 folded before Flop (didn't bet)
Seat 8: Igoriah folded before Flop (didn't bet)





PokerStars Hand #153069013877:  Hold'em No Limit ($0.50/$1.00 USD) - 2016/05/09 17:22:28 CET [2016/05/09 11:22:28 ET]
Table 'Merga II' 9-max Seat #4 is the button
Seat 1: R1aki ($103.50 in chips) 
Seat 3: 43605511 ($97.50 in chips) 
Seat 4: erick222 ($102.68 in chips) 
Seat 5: matiko09 ($100 in chips) 
Seat 6: AlKatrone ($100 in chips) 
Seat 7: rusher_NiNja ($219.70 in chips) 
Seat 8: serbianhaze ($109.90 in chips) 
Seat 9: maxxmeister ($119 in chips) 
matiko09: posts small blind $0.50
AlKatrone: posts big blind $1
*** HOLE CARDS ***
Dealt to matiko09 [6h Jd]
rusher_NiNja: folds 
serbianhaze: folds 
maxxmeister: folds 
R1aki: folds 
43605511: raises $2 to $3
erick222: folds 
matiko09: folds 
AlKatrone: calls $2
*** FLOP *** [As 5d 9s]
AlKatrone: checks 
43605511: checks 
*** TURN *** [As 5d 9s] [9h]
AlKatrone: checks 
43605511: checks 
*** RIVER *** [As 5d 9s 9h] [Tc]
AlKatrone: bets $4.63
43605511: folds 
Uncalled bet ($4.63) returned to AlKatrone
AlKatrone collected $6.18 from pot
*** SUMMARY ***
Total pot $6.50 | Rake $0.32 
Board [As 5d 9s 9h Tc]
Seat 1: R1aki folded before Flop (didn't bet)
Seat 3: 43605511 folded on the River
Seat 4: erick222 (button) folded before Flop (didn't bet)
Seat 5: matiko09 (small blind) folded before Flop
Seat 6: AlKatrone (big blind) collected ($6.18)
Seat 7: rusher_NiNja folded before Flop (didn't bet)
Seat 8: serbianhaze folded before Flop (didn't bet)
Seat 9: maxxmeister folded before Flop (didn't bet)





PokerStars Hand #153069017946:  Hold'em No Limit ($0.50/$1.00 USD) - 2016/05/09 17:22:34 CET [2016/05/09 11:22:34 ET]
Table 'Odyssey' 9-max Seat #9 is the button
Seat 1: matiko09 ($100 in chips) 
Seat 2: flk.Dasas ($100 in chips) 
Seat 3: chaps1988 ($151.50 in chips) 
Seat 4: mycka86 ($168.15 in chips) 
Seat 6: Kukuryzka ($100 in chips) 
Seat 7: DancerNN1 ($101.09 in chips) 
Seat 8: nubpoker ($106.16 in chips) 
Seat 9: hellig777 ($149.20 in chips) 
matiko09: posts small blind $0.50
flk.Dasas: posts big blind $1
Donetsk1y: sits out 
*** HOLE CARDS ***
Dealt to matiko09 [3d Qd]
chaps1988: folds 
mycka86: folds 
Kukuryzka: folds 
DancerNN1: folds 
nubpoker: folds 
hellig777: raises $1 to $2
matiko09: folds 
flk.Dasas: folds 
Uncalled bet ($1) returned to hellig777
hellig777 collected $2.50 from pot
*** SUMMARY ***
Total pot $2.50 | Rake $0 
Seat 1: matiko09 (small blind) folded before Flop
Seat 2: flk.Dasas (big blind) folded before Flop
Seat 3: chaps1988 folded before Flop (didn't bet)
Seat 4: mycka86 folded before Flop (didn't bet)
Seat 6: Kukuryzka folded before Flop (didn't bet)
Seat 7: DancerNN1 folded before Flop (didn't bet)
Seat 8: nubpoker folded before Flop (didn't bet)
Seat 9: hellig777 (button) collected ($2.50)





PokerStars Hand #153069019370:  Hold'em No Limit ($1/$2 USD) - 2016/05/09 17:22:36 CET [2016/05/09 11:22:36 ET]
Table 'Bella' 9-max Seat #4 is the button
Seat 1: matiko09 ($208.25 in chips) 
Seat 2: AlKatrone ($207.67 in chips) 
Seat 3: PacPacBum ($229.96 in chips) 
Seat 4: HuanHuan ($200 in chips) 
Seat 6: CI58 ($215.80 in chips) 
Seat 7: stan_09319 ($437.71 in chips) 
Seat 8: Igoriah ($203.68 in chips) 
CI58: posts small blind $1
stan_09319: posts big blind $2
chaps1988: sits out 
*** HOLE CARDS ***
Dealt to matiko09 [Jc 7s]
Igoriah: raises $3 to $5
matiko09: folds 
AlKatrone: folds 
PacPacBum: folds 
HuanHuan: folds 
CI58: folds 
stan_09319: folds 
Uncalled bet ($3) returned to Igoriah
Igoriah collected $5 from pot
Igoriah: doesn't show hand 
*** SUMMARY ***
Total pot $5 | Rake $0 
Seat 1: matiko09 folded before Flop (didn't bet)
Seat 2: AlKatrone folded before Flop (didn't bet)
Seat 3: PacPacBum folded before Flop (didn't bet)
Seat 4: HuanHuan (button) folded before Flop (didn't bet)
Seat 6: CI58 (small blind) folded before Flop
Seat 7: stan_09319 (big blind) folded before Flop
Seat 8: Igoriah collected ($5)





PokerStars Hand #153069020227:  Hold'em No Limit ($1/$2 USD) - 2016/05/09 17:22:38 CET [2016/05/09 11:22:38 ET]
Table 'Hagar II' 9-max Seat #1 is the button
Seat 1: CI58 ($200 in chips) 
Seat 3: Sasuke777777 ($53.97 in chips) 
Seat 4: matiko09 ($433.49 in chips) 
Seat 5: PacPacBum ($258.39 in chips) 
Seat 6: el Fatto ($222.03 in chips) 
Seat 9: chaps1988 ($379.47 in chips) 
darren1031 is disconnected 
darren1031 has timed out while disconnected
darren1031: is sitting out 
Sasuke777777: posts small blind $1
matiko09: posts big blind $2
Igoriah: sits out 
*** HOLE CARDS ***
Dealt to matiko09 [Td 5c]
PacPacBum: folds 
el Fatto: folds 
chaps1988: raises $2.50 to $4.50
CI58: folds 
Sasuke777777: raises $7.50 to $12
matiko09: folds 
chaps1988: folds 
Uncalled bet ($7.50) returned to Sasuke777777
Sasuke777777 collected $11 from pot
Sasuke777777: doesn't show hand 
*** SUMMARY ***
Total pot $11 | Rake $0 
Seat 1: CI58 (button) folded before Flop (didn't bet)
Seat 3: Sasuke777777 (small blind) collected ($11)
Seat 4: matiko09 (big blind) folded before Flop
Seat 5: PacPacBum folded before Flop (didn't bet)
Seat 6: el Fatto folded before Flop (didn't bet)
Seat 9: chaps1988 folded before Flop





PokerStars Hand #153069023736:  Hold'em No Limit ($1/$2 USD) - 2016/05/09 17:22:44 CET [2016/05/09 11:22:44 ET]
Table 'Demeter II' 9-max Seat #3 is the button
Seat 1: Sasuke777777 ($357.24 in chips) 
Seat 2: matiko09 ($200 in chips) 
Seat 3: chaps1988 ($200 in chips) 
Seat 4: Igoriah ($200 in chips) 
Seat 5: PacPacBum ($235.21 in chips) 
Seat 6: HuanHuan ($206.02 in chips) 
Seat 7: Siwyosb ($212.31 in chips) 
Seat 8: CI58 ($226.29 in chips) 
Igoriah: posts small blind $1
PacPacBum: posts big blind $2
*** HOLE CARDS ***
Dealt to matiko09 [Jh 9s]
HuanHuan: folds 
Siwyosb: folds 
CI58: raises $4 to $6
Sasuke777777: folds 
matiko09: folds 
chaps1988: calls $6
Igoriah: folds 
PacPacBum: folds 
*** FLOP *** [Kh Td 2h]
CI58: bets $8.55
chaps1988: folds 
Uncalled bet ($8.55) returned to CI58
CI58 collected $14.25 from pot
CI58: doesn't show hand 
*** SUMMARY ***
Total pot $15 | Rake $0.75 
Board [Kh Td 2h]
Seat 1: Sasuke777777 folded before Flop (didn't bet)
Seat 2: matiko09 folded before Flop (didn't bet)
Seat 3: chaps1988 (button) folded on the Flop
Seat 4: Igoriah (small blind) folded before Flop
Seat 5: PacPacBum (big blind) folded before Flop
Seat 6: HuanHuan folded before Flop (didn't bet)
Seat 7: Siwyosb folded before Flop (didn't bet)
Seat 8: CI58 collected ($14.25)





PokerStars Hand #153069024243:  Hold'em No Limit ($0.50/$1.00 USD) - 2016/05/09 17:22:44 CET [2016/05/09 11:22:44 ET]
Table 'Reiss' 9-max Seat #7 is the button
Seat 1: Dickyxxx ($164.66 in chips) 
Seat 2: mycka86 ($185.75 in chips) 
Seat 3: chaps1988 ($123.46 in chips) 
Seat 4: CI58 ($100 in chips) 
Seat 5: matiko09 ($131.71 in chips) 
Seat 6: HITYESCA ($204.74 in chips) 
Seat 7: nubpoker ($128.29 in chips) 
Seat 8: JimineyCrik ($100 in chips) 
JimineyCrik: posts small blind $0.50
Dickyxxx: posts big blind $1
*** HOLE CARDS ***
Dealt to matiko09 [As 2h]
mycka86: folds 
chaps1988: folds 
CI58: folds 
matiko09: folds 
HITYESCA: folds 
nubpoker: folds 
JimineyCrik: raises $1 to $2
Dickyxxx: calls $1
*** FLOP *** [9d 6c Tc]
JimineyCrik: bets $1.93
Dickyxxx: folds 
Uncalled bet ($1.93) returned to JimineyCrik
JimineyCrik collected $3.80 from pot
JimineyCrik: doesn't show hand 
*** SUMMARY ***
Total pot $4 | Rake $0.20 
Board [9d 6c Tc]
Seat 1: Dickyxxx (big blind) folded on the Flop
Seat 2: mycka86 folded before Flop (didn't bet)
Seat 3: chaps1988 folded before Flop (didn't bet)
Seat 4: CI58 folded before Flop (didn't bet)
Seat 5: matiko09 folded before Flop (didn't bet)
Seat 6: HITYESCA folded before Flop (didn't bet)
Seat 7: nubpoker (button) folded before Flop (didn't bet)
Seat 8: JimineyCrik (small blind) collected ($3.80)





PokerStars Hand #153069025945:  Hold'em No Limit ($1/$2 USD) - 2016/05/09 17:22:47 CET [2016/05/09 11:22:47 ET]
Table 'Philagoria II' 9-max Seat #9 is the button
Seat 1: stan_09319 ($200 in chips) 
Seat 2: matiko09 ($200 in chips) 
Seat 4: mishanay111 ($85.40 in chips) 
Seat 5: AlKatrone ($205.60 in chips) 
Seat 6: I The King I ($237.21 in chips) 
Seat 8: scop79 ($160 in chips) 
Seat 9: PacPacBum ($200 in chips) 
stan_09319: posts small blind $1
matiko09: posts big blind $2
*** HOLE CARDS ***
Dealt to matiko09 [5s 6c]
mishanay111: raises $2 to $4
AlKatrone: folds 
I The King I: calls $4
scop79: raises $12 to $16
PacPacBum: folds 
stan_09319: folds 
matiko09: folds 
mishanay111: folds 
I The King I: calls $12
*** FLOP *** [Jd 8s 6d]
mishanay111 leaves the table
I The King I: checks 
scop79: bets $14
I The King I: calls $14
*** TURN *** [Jd 8s 6d] [Ks]
I The King I: checks 
scop79: checks 
*** RIVER *** [Jd 8s 6d Ks] [Td]
I The King I: bets $38
HuanHuan joins the table at seat #3 
scop79: folds 
Uncalled bet ($38) returned to I The King I
I The King I collected $64.25 from pot
I The King I: doesn't show hand 
*** SUMMARY ***
Total pot $67 | Rake $2.75 
Board [Jd 8s 6d Ks Td]
Seat 1: stan_09319 (small blind) folded before Flop
Seat 2: matiko09 (big blind) folded before Flop
Seat 4: mishanay111 folded before Flop
Seat 5: AlKatrone folded before Flop (didn't bet)
Seat 6: I The King I collected ($64.25)
Seat 8: scop79 folded on the River
Seat 9: PacPacBum (button) folded before Flop (didn't bet)





PokerStars Hand #153069027815:  Hold'em No Limit ($0.50/$1.00 USD) - 2016/05/09 17:22:50 CET [2016/05/09 11:22:50 ET]
Table 'Terpsichore' 9-max Seat #3 is the button
Seat 2: CI58 ($100 in chips) 
Seat 3: matiko09 ($150.39 in chips) 
Seat 4: nubpoker ($129.48 in chips) 
Seat 5: mycka86 ($268.24 in chips) 
Seat 6: Filojoes ($116.08 in chips) 
Seat 7: Kukuryzka ($100 in chips) 
Seat 8: Kiosk230472 ($110.16 in chips) 
nubpoker: posts small blind $0.50
mycka86: posts big blind $1
flk.Dasas: sits out 
Donetsk1y: sits out 
*** HOLE CARDS ***
Dealt to matiko09 [8c Qh]
Filojoes: folds 
Kukuryzka: folds 
Kiosk230472: calls $1
CI58: raises $4 to $5
matiko09: folds 
nubpoker: folds 
mycka86: folds 
Kiosk230472: calls $4
*** FLOP *** [8s 9h Ad]
Kiosk230472: checks 
CI58: bets $5.46
Kiosk230472: folds 
Uncalled bet ($5.46) returned to CI58
CI58 collected $10.92 from pot
CI58: doesn't show hand 
*** SUMMARY ***
Total pot $11.50 | Rake $0.58 
Board [8s 9h Ad]
Seat 2: CI58 collected ($10.92)
Seat 3: matiko09 (button) folded before Flop (didn't bet)
Seat 4: nubpoker (small blind) folded before Flop
Seat 5: mycka86 (big blind) folded before Flop
Seat 6: Filojoes folded before Flop (didn't bet)
Seat 7: Kukuryzka folded before Flop (didn't bet)
Seat 8: Kiosk230472 folded on the Flop





PokerStars Hand #153069029564:  Hold'em No Limit ($0.50/$1.00 USD) - 2016/05/09 17:22:53 CET [2016/05/09 11:22:53 ET]
Table 'Odyssey' 9-max Seat #1 is the button
Seat 1: matiko09 ($100 in chips) 
Seat 2: flk.Dasas ($100 in chips) 
Seat 3: chaps1988 ($151.50 in chips) 
Seat 4: mycka86 ($168.15 in chips) 
Seat 6: Kukuryzka ($100 in chips) 
Seat 7: DancerNN1 ($101.09 in chips) 
Seat 8: nubpoker ($106.16 in chips) 
Seat 9: hellig777 ($150.70 in chips) 
flk.Dasas: posts small blind $0.50
chaps1988: posts big blind $1
Donetsk1y: sits out 
*** HOLE CARDS ***
Dealt to matiko09 [4d 5h]
mycka86: folds 
Kukuryzka: raises $2 to $3
DancerNN1: folds 
nubpoker: folds 
hellig777: folds 
matiko09: folds 
flk.Dasas: folds 
chaps1988: folds 
Uncalled bet ($2) returned to Kukuryzka
Kukuryzka collected $2.50 from pot
Kukuryzka: doesn't show hand 
*** SUMMARY ***
Total pot $2.50 | Rake $0 
Seat 1: matiko09 (button) folded before Flop (didn't bet)
Seat 2: flk.Dasas (small blind) folded before Flop
Seat 3: chaps1988 (big blind) folded before Flop
Seat 4: mycka86 folded before Flop (didn't bet)
Seat 6: Kukuryzka collected ($2.50)
Seat 7: DancerNN1 folded before Flop (didn't bet)
Seat 8: nubpoker folded before Flop (didn't bet)
Seat 9: hellig777 folded before Flop (didn't bet)





PokerStars Hand #153069036550:  Hold'em No Limit ($0.50/$1.00 USD) - 2016/05/09 17:23:04 CET [2016/05/09 11:23:04 ET]
Table 'Orthos' 9-max Seat #9 is the button
Seat 1: Kelvin sai ($97.32 in chips) 
Seat 2: PacPacBum ($121.49 in chips) 
Seat 3: Filojoes ($100 in chips) 
Seat 4: nubpoker ($157.37 in chips) 
Seat 5: matiko09 ($114.20 in chips) 
Seat 6: xhinostrabli ($88.61 in chips) 
Seat 7: flk.Dasas ($166.42 in chips) 
Seat 8: Dickyxxx ($103.67 in chips) 
Seat 9: mycka86 ($111.15 in chips) 
Kelvin sai: posts small blind $0.50
PacPacBum: posts big blind $1
*** HOLE CARDS ***
Dealt to matiko09 [Jd Jc]
Filojoes: folds 
nubpoker: folds 
matiko09: raises $2 to $3
xhinostrabli: calls $3
flk.Dasas: folds 
Dickyxxx: folds 
mycka86: folds 
Kelvin sai: folds 
PacPacBum: raises $9 to $12
matiko09: calls $9
xhinostrabli: folds 
*** FLOP *** [4h 3s 2h]
PacPacBum: checks 
matiko09: checks 
*** TURN *** [4h 3s 2h] [3c]
PacPacBum: bets $14.10
matiko09: calls $14.10
*** RIVER *** [4h 3s 2h 3c] [2d]
PacPacBum: checks 
matiko09: checks 
*** SHOW DOWN ***
PacPacBum: shows [Ah Qs] (two pair, Threes and Deuces)
matiko09: shows [Jd Jc] (two pair, Jacks and Threes)
matiko09 collected $53.20 from pot
*** SUMMARY ***
Total pot $55.70 | Rake $2.50 
Board [4h 3s 2h 3c 2d]
Seat 1: Kelvin sai (small blind) folded before Flop
Seat 2: PacPacBum (big blind) showed [Ah Qs] and lost with two pair, Threes and Deuces
Seat 3: Filojoes folded before Flop (didn't bet)
Seat 4: nubpoker folded before Flop (didn't bet)
Seat 5: matiko09 showed [Jd Jc] and won ($53.20) with two pair, Jacks and Threes
Seat 6: xhinostrabli folded before Flop
Seat 7: flk.Dasas folded before Flop (didn't bet)
Seat 8: Dickyxxx folded before Flop (didn't bet)
Seat 9: mycka86 (button) folded before Flop (didn't bet)





PokerStars Hand #153069046803:  Hold'em No Limit ($1/$2 USD) - 2016/05/09 17:23:20 CET [2016/05/09 11:23:20 ET]
Table 'Celaeno II' 9-max Seat #8 is the button
Seat 1: LRVAV7 ($200 in chips) 
Seat 2: PacPacBum ($221.89 in chips) 
Seat 3: CI58 ($209.60 in chips) 
Seat 4: matiko09 ($419.82 in chips) 
Seat 6: Igoriah ($230.52 in chips) 
Seat 7: HuanHuan ($200 in chips) 
Seat 8: chaps1988 ($218.31 in chips) 
LRVAV7: posts small blind $1
PacPacBum: posts big blind $2
*** HOLE CARDS ***
Dealt to matiko09 [8c Kh]
CI58: folds 
matiko09: folds 
RamiroAgujis joins the table at seat #9 
Igoriah: raises $3 to $5
HuanHuan: folds 
chaps1988: calls $5
LRVAV7: raises $17 to $22
PacPacBum: folds 
Igoriah: raises $81 to $103
chaps1988: folds 
LRVAV7: folds 
Uncalled bet ($81) returned to Igoriah
Igoriah collected $51 from pot
Igoriah: doesn't show hand 
*** SUMMARY ***
Total pot $51 | Rake $0 
Seat 1: LRVAV7 (small blind) folded before Flop
Seat 2: PacPacBum (big blind) folded before Flop
Seat 3: CI58 folded before Flop (didn't bet)
Seat 4: matiko09 folded before Flop (didn't bet)
Seat 6: Igoriah collected ($51)
Seat 7: HuanHuan folded before Flop (didn't bet)
Seat 8: chaps1988 (button) folded before Flop





PokerStars Hand #153069055458:  Hold'em No Limit ($0.50/$1.00 USD) - 2016/05/09 17:23:34 CET [2016/05/09 11:23:34 ET]
Table 'Terpsichore' 9-max Seat #4 is the button
Seat 2: CI58 ($105.92 in chips) 
Seat 3: matiko09 ($150.39 in chips) 
Seat 4: nubpoker ($128.98 in chips) 
Seat 5: mycka86 ($267.24 in chips) 
Seat 6: Filojoes ($116.08 in chips) 
Seat 7: Kukuryzka ($100 in chips) 
Seat 8: Kiosk230472 ($105.16 in chips) 
mycka86: posts small blind $0.50
Filojoes: posts big blind $1
flk.Dasas: sits out 
Donetsk1y: sits out 
*** HOLE CARDS ***
Dealt to matiko09 [Th Qd]
Kukuryzka: folds 
Kiosk230472: folds 
CI58: folds 
matiko09: raises $1.50 to $2.50
nubpoker: raises $6.50 to $9
mycka86: folds 
Filojoes: folds 
matiko09: folds 
Uncalled bet ($6.50) returned to nubpoker
nubpoker collected $6.50 from pot
nubpoker: doesn't show hand 
*** SUMMARY ***
Total pot $6.50 | Rake $0 
Seat 2: CI58 folded before Flop (didn't bet)
Seat 3: matiko09 folded before Flop
Seat 4: nubpoker (button) collected ($6.50)
Seat 5: mycka86 (small blind) folded before Flop
Seat 6: Filojoes (big blind) folded before Flop
Seat 7: Kukuryzka folded before Flop (didn't bet)
Seat 8: Kiosk230472 folded before Flop (didn't bet)





PokerStars Hand #153069061689:  Hold'em No Limit ($1/$2 USD) - 2016/05/09 17:23:44 CET [2016/05/09 11:23:44 ET]
Table 'Demeter II' 9-max Seat #4 is the button
Seat 1: Sasuke777777 ($357.24 in chips) 
Seat 2: matiko09 ($200 in chips) 
Seat 3: chaps1988 ($200 in chips) 
Seat 4: Igoriah ($200 in chips) 
Seat 5: PacPacBum ($233.21 in chips) 
Seat 6: HuanHuan ($206.02 in chips) 
Seat 7: Siwyosb ($212.31 in chips) 
Seat 8: CI58 ($234.54 in chips) 
PacPacBum: posts small blind $1
HuanHuan: posts big blind $2
*** HOLE CARDS ***
Dealt to matiko09 [Ad 5d]
Siwyosb: calls $2
CI58: folds 
Sasuke777777: calls $2
matiko09: calls $2
chaps1988: calls $2
Igoriah: folds 
PacPacBum: folds 
HuanHuan: checks 
*** FLOP *** [6s 3h Qh]
HuanHuan: checks 
Siwyosb: checks 
Sasuke777777: checks 
matiko09: checks 
chaps1988: bets $7
HuanHuan: folds 
Siwyosb: folds 
Sasuke777777: folds 
matiko09: folds 
Uncalled bet ($7) returned to chaps1988
chaps1988 collected $10.45 from pot
chaps1988: doesn't show hand 
*** SUMMARY ***
Total pot $11 | Rake $0.55 
Board [6s 3h Qh]
Seat 1: Sasuke777777 folded on the Flop
Seat 2: matiko09 folded on the Flop
Seat 3: chaps1988 collected ($10.45)
Seat 4: Igoriah (button) folded before Flop (didn't bet)
Seat 5: PacPacBum (small blind) folded before Flop
Seat 6: HuanHuan (big blind) folded on the Flop
Seat 7: Siwyosb folded on the Flop
Seat 8: CI58 folded before Flop (didn't bet)





PokerStars Hand #153069062607:  Hold'em No Limit ($0.50/$1.00 USD) - 2016/05/09 17:23:45 CET [2016/05/09 11:23:45 ET]
Table 'Merga II' 9-max Seat #5 is the button
Seat 1: R1aki ($103.50 in chips) 
Seat 3: 43605511 ($94.50 in chips) 
Seat 4: erick222 ($102.68 in chips) 
Seat 5: matiko09 ($100 in chips) 
Seat 6: AlKatrone ($103.18 in chips) 
Seat 7: rusher_NiNja ($219.70 in chips) 
Seat 8: serbianhaze ($109.90 in chips) 
Seat 9: maxxmeister ($119 in chips) 
AlKatrone: posts small blind $0.50
rusher_NiNja: posts big blind $1
*** HOLE CARDS ***
Dealt to matiko09 [Qd 2h]
serbianhaze: raises $2 to $3
maxxmeister: folds 
R1aki: folds 
43605511: folds 
erick222: raises $6 to $9
matiko09: folds 
AlKatrone: folds 
rusher_NiNja: folds 
serbianhaze: calls $6
*** FLOP *** [Ah Ts 3s]
serbianhaze: checks 
erick222: bets $10
serbianhaze: calls $10
*** TURN *** [Ah Ts 3s] [Tc]
serbianhaze: checks 
erick222: checks 
*** RIVER *** [Ah Ts 3s Tc] [As]
serbianhaze: bets $15
erick222: folds 
Uncalled bet ($15) returned to serbianhaze
serbianhaze collected $37.52 from pot
*** SUMMARY ***
Total pot $39.50 | Rake $1.98 
Board [Ah Ts 3s Tc As]
Seat 1: R1aki folded before Flop (didn't bet)
Seat 3: 43605511 folded before Flop (didn't bet)
Seat 4: erick222 folded on the River
Seat 5: matiko09 (button) folded before Flop (didn't bet)
Seat 6: AlKatrone (small blind) folded before Flop
Seat 7: rusher_NiNja (big blind) folded before Flop
Seat 8: serbianhaze collected ($37.52)
Seat 9: maxxmeister folded before Flop (didn't bet)





PokerStars Hand #153069062292:  Hold'em No Limit ($0.50/$1.00 USD) - 2016/05/09 17:23:45 CET [2016/05/09 11:23:45 ET]
Table 'Odyssey' 9-max Seat #2 is the button
Seat 1: matiko09 ($100 in chips) 
Seat 2: flk.Dasas ($100 in chips) 
Seat 3: chaps1988 ($150.50 in chips) 
Seat 4: mycka86 ($168.15 in chips) 
Seat 6: Kukuryzka ($101.50 in chips) 
Seat 7: DancerNN1 ($101.09 in chips) 
Seat 8: nubpoker ($106.16 in chips) 
Seat 9: hellig777 ($150.70 in chips) 
chaps1988: posts small blind $0.50
mycka86: posts big blind $1
Donetsk1y: sits out 
*** HOLE CARDS ***
Dealt to matiko09 [7h Ks]
Kukuryzka: folds 
DancerNN1: raises $2 to $3
nubpoker: folds 
hellig777: folds 
matiko09: folds 
flk.Dasas: folds 
chaps1988: folds 
mycka86: folds 
Uncalled bet ($2) returned to DancerNN1
DancerNN1 collected $2.50 from pot
DancerNN1: doesn't show hand 
*** SUMMARY ***
Total pot $2.50 | Rake $0 
Seat 1: matiko09 folded before Flop (didn't bet)
Seat 2: flk.Dasas (button) folded before Flop (didn't bet)
Seat 3: chaps1988 (small blind) folded before Flop
Seat 4: mycka86 (big blind) folded before Flop
Seat 6: Kukuryzka folded before Flop (didn't bet)
Seat 7: DancerNN1 collected ($2.50)
Seat 8: nubpoker folded before Flop (didn't bet)
Seat 9: hellig777 folded before Flop (didn't bet)





PokerStars Hand #153069066704:  Hold'em No Limit ($0.50/$1.00 USD) - 2016/05/09 17:23:51 CET [2016/05/09 11:23:51 ET]
Table 'Reiss' 9-max Seat #8 is the button
Seat 1: Dickyxxx ($162.66 in chips) 
Seat 2: mycka86 ($185.75 in chips) 
Seat 3: chaps1988 ($123.46 in chips) 
Seat 4: CI58 ($100 in chips) 
Seat 5: matiko09 ($131.71 in chips) 
Seat 6: HITYESCA ($204.74 in chips) 
Seat 7: nubpoker ($128.29 in chips) 
Seat 8: JimineyCrik ($101.80 in chips) 
Dickyxxx: posts small blind $0.50
mycka86: posts big blind $1
*** HOLE CARDS ***
Dealt to matiko09 [6c 5c]
chaps1988: folds 
CI58: folds 
matiko09: folds 
HITYESCA: folds 
nubpoker: raises $1.50 to $2.50
JimineyCrik: folds 
Dickyxxx: raises $9.50 to $12
mycka86: folds 
nubpoker: calls $9.50
*** FLOP *** [Kd As Th]
Dickyxxx: checks 
nubpoker: bets $14
Dickyxxx: calls $14
*** TURN *** [Kd As Th] [2s]
Dickyxxx: checks 
taxi1313 joins the table at seat #9 
nubpoker: bets $25.25
Dickyxxx: calls $25.25
*** RIVER *** [Kd As Th 2s] [Js]
Dickyxxx: bets $25
taxi1313 is disconnected 
nubpoker: folds 
Uncalled bet ($25) returned to Dickyxxx
Dickyxxx collected $101 from pot
Dickyxxx: doesn't show hand 
*** SUMMARY ***
Total pot $103.50 | Rake $2.50 
Board [Kd As Th 2s Js]
Seat 1: Dickyxxx (small blind) collected ($101)
Seat 2: mycka86 (big blind) folded before Flop
Seat 3: chaps1988 folded before Flop (didn't bet)
Seat 4: CI58 folded before Flop (didn't bet)
Seat 5: matiko09 folded before Flop (didn't bet)
Seat 6: HITYESCA folded before Flop (didn't bet)
Seat 7: nubpoker folded on the River
Seat 8: JimineyCrik (button) folded before Flop (didn't bet)





PokerStars Hand #153069068781:  Hold'em No Limit ($1/$2 USD) - 2016/05/09 17:23:55 CET [2016/05/09 11:23:55 ET]
Table 'Hagar II' 9-max Seat #3 is the button
Seat 1: CI58 ($200 in chips) 
Seat 2: darren1031 ($319.21 in chips) 
Seat 3: Sasuke777777 ($60.47 in chips) 
Seat 4: matiko09 ($431.49 in chips) 
Seat 5: PacPacBum ($258.39 in chips) 
Seat 6: el Fatto ($222.03 in chips) 
Seat 9: chaps1988 ($374.97 in chips) 
matiko09: posts small blind $1
PacPacBum: posts big blind $2
Igoriah: sits out 
darren1031: posts small blind $1
*** HOLE CARDS ***
Dealt to matiko09 [Ks 9c]
el Fatto: folds 
chaps1988: folds 
CI58: folds 
darren1031: raises $4 to $6
Sasuke777777: folds 
matiko09: folds 
PacPacBum: folds 
Uncalled bet ($4) returned to darren1031
darren1031 collected $6 from pot
*** SUMMARY ***
Total pot $6 | Rake $0 
Seat 1: CI58 folded before Flop (didn't bet)
Seat 2: darren1031 collected ($6)
Seat 3: Sasuke777777 (button) folded before Flop (didn't bet)
Seat 4: matiko09 (small blind) folded before Flop
Seat 5: PacPacBum (big blind) folded before Flop
Seat 6: el Fatto folded before Flop (didn't bet)
Seat 9: chaps1988 folded before Flop (didn't bet)





PokerStars Hand #153069078348:  Hold'em No Limit ($0.50/$1.00 USD) - 2016/05/09 17:24:10 CET [2016/05/09 11:24:10 ET]
Table 'Terpsichore' 9-max Seat #5 is the button
Seat 2: CI58 ($105.92 in chips) 
Seat 3: matiko09 ($147.89 in chips) 
Seat 4: nubpoker ($132.98 in chips) 
Seat 5: mycka86 ($266.74 in chips) 
Seat 6: Filojoes ($115.08 in chips) 
Seat 7: Kukuryzka ($100 in chips) 
Seat 8: Kiosk230472 ($105.16 in chips) 
Filojoes: posts small blind $0.50
Kukuryzka: posts big blind $1
flk.Dasas: sits out 
Donetsk1y: sits out 
*** HOLE CARDS ***
Dealt to matiko09 [4d 7h]
Kiosk230472: folds 
CI58: folds 
matiko09: folds 
nubpoker: raises $1.50 to $2.50
mycka86: folds 
Filojoes: folds 
Kukuryzka: folds 
Uncalled bet ($1.50) returned to nubpoker
nubpoker collected $2.50 from pot
nubpoker: doesn't show hand 
*** SUMMARY ***
Total pot $2.50 | Rake $0 
Seat 2: CI58 folded before Flop (didn't bet)
Seat 3: matiko09 folded before Flop (didn't bet)
Seat 4: nubpoker collected ($2.50)
Seat 5: mycka86 (button) folded before Flop (didn't bet)
Seat 6: Filojoes (small blind) folded before Flop
Seat 7: Kukuryzka (big blind) folded before Flop
Seat 8: Kiosk230472 folded before Flop (didn't bet)





PokerStars Hand #153069079287:  Hold'em No Limit ($0.50/$1.00 USD) - 2016/05/09 17:24:12 CET [2016/05/09 11:24:12 ET]
Table 'Odyssey' 9-max Seat #3 is the button
Seat 1: matiko09 ($100 in chips) 
Seat 2: flk.Dasas ($100 in chips) 
Seat 3: chaps1988 ($150 in chips) 
Seat 4: mycka86 ($167.15 in chips) 
Seat 5: Donetsk1y ($100 in chips) 
Seat 6: Kukuryzka ($101.50 in chips) 
Seat 7: DancerNN1 ($102.59 in chips) 
Seat 8: nubpoker ($106.16 in chips) 
Seat 9: hellig777 ($150.70 in chips) 
mycka86: posts small blind $0.50
Donetsk1y: posts big blind $1
*** HOLE CARDS ***
Dealt to matiko09 [Qh 6d]
Kukuryzka: folds 
DancerNN1: folds 
nubpoker: folds 
hellig777: raises $2 to $3
matiko09: folds 
flk.Dasas: folds 
chaps1988: calls $3
mycka86: folds 
Donetsk1y: folds 
*** FLOP *** [8h Qd Kh]
hellig777: checks 
chaps1988: checks 
*** TURN *** [8h Qd Kh] [Kc]
hellig777: bets $3.56
chaps1988: calls $3.56
*** RIVER *** [8h Qd Kh Kc] [7d]
hellig777: checks 
chaps1988: bets $5.50
hellig777: folds 
Uncalled bet ($5.50) returned to chaps1988
chaps1988 collected $13.89 from pot
chaps1988: doesn't show hand 
*** SUMMARY ***
Total pot $14.62 | Rake $0.73 
Board [8h Qd Kh Kc 7d]
Seat 1: matiko09 folded before Flop (didn't bet)
Seat 2: flk.Dasas folded before Flop (didn't bet)
Seat 3: chaps1988 (button) collected ($13.89)
Seat 4: mycka86 (small blind) folded before Flop
Seat 5: Donetsk1y (big blind) folded before Flop
Seat 6: Kukuryzka folded before Flop (didn't bet)
Seat 7: DancerNN1 folded before Flop (didn't bet)
Seat 8: nubpoker folded before Flop (didn't bet)
Seat 9: hellig777 folded on the River





PokerStars Hand #153069087277:  Hold'em No Limit ($1/$2 USD) - 2016/05/09 17:24:24 CET [2016/05/09 11:24:24 ET]
Table 'Hagar II' 9-max Seat #4 is the button
Seat 1: CI58 ($200 in chips) 
Seat 2: darren1031 ($322.21 in chips) 
Seat 3: Sasuke777777 ($60.47 in chips) 
Seat 4: matiko09 ($430.49 in chips) 
Seat 5: PacPacBum ($256.39 in chips) 
Seat 6: el Fatto ($222.03 in chips) 
Seat 9: chaps1988 ($374.97 in chips) 
PacPacBum: posts small blind $1
el Fatto: posts big blind $2
Igoriah: sits out 
*** HOLE CARDS ***
Dealt to matiko09 [4d Kc]
chaps1988: folds 
CI58: folds 
darren1031: folds 
Sasuke777777: folds 
matiko09: folds 
PacPacBum: folds 
Uncalled bet ($1) returned to el Fatto
el Fatto collected $2 from pot
el Fatto: doesn't show hand 
*** SUMMARY ***
Total pot $2 | Rake $0 
Seat 1: CI58 folded before Flop (didn't bet)
Seat 2: darren1031 folded before Flop (didn't bet)
Seat 3: Sasuke777777 folded before Flop (didn't bet)
Seat 4: matiko09 (button) folded before Flop (didn't bet)
Seat 5: PacPacBum (small blind) folded before Flop
Seat 6: el Fatto (big blind) collected ($2)
Seat 9: chaps1988 folded before Flop (didn't bet)





PokerStars Hand #153069089249:  Hold'em No Limit ($1/$2 USD) - 2016/05/09 17:24:27 CET [2016/05/09 11:24:27 ET]
Table 'Celaeno II' 9-max Seat #1 is the button
Seat 1: LRVAV7 ($200 in chips) 
Seat 2: PacPacBum ($219.89 in chips) 
Seat 3: CI58 ($209.60 in chips) 
Seat 4: matiko09 ($419.82 in chips) 
Seat 6: Igoriah ($259.52 in chips) 
Seat 7: HuanHuan ($200 in chips) 
Seat 8: chaps1988 ($213.31 in chips) 
PacPacBum: posts small blind $1
CI58: posts big blind $2
RamiroAgujis: sits out 
*** HOLE CARDS ***
Dealt to matiko09 [Ah 7d]
matiko09: folds 
Igoriah: folds 
HuanHuan: folds 
chaps1988: folds 
LRVAV7: folds 
PacPacBum: folds 
Uncalled bet ($1) returned to CI58
CI58 collected $2 from pot
CI58: doesn't show hand 
*** SUMMARY ***
Total pot $2 | Rake $0 
Seat 1: LRVAV7 (button) folded before Flop (didn't bet)
Seat 2: PacPacBum (small blind) folded before Flop
Seat 3: CI58 (big blind) collected ($2)
Seat 4: matiko09 folded before Flop (didn't bet)
Seat 6: Igoriah folded before Flop (didn't bet)
Seat 7: HuanHuan folded before Flop (didn't bet)
Seat 8: chaps1988 folded before Flop (didn't bet)





PokerStars Hand #153069092040:  Hold'em No Limit ($1/$2 USD) - 2016/05/09 17:24:32 CET [2016/05/09 11:24:32 ET]
Table 'Philagoria II' 9-max Seat #1 is the button
Seat 1: stan_09319 ($200 in chips) 
Seat 2: matiko09 ($200 in chips) 
Seat 3: HuanHuan ($200 in chips) 
Seat 5: AlKatrone ($205.60 in chips) 
Seat 6: I The King I ($271.46 in chips) 
Seat 8: scop79 ($130 in chips) 
Seat 9: PacPacBum ($200 in chips) 
matiko09: posts small blind $1
HuanHuan: posts big blind $2
*** HOLE CARDS ***
Dealt to matiko09 [9h Js]
AlKatrone: folds 
I The King I: folds 
scop79: raises $3 to $5
PacPacBum: folds 
stan_09319: folds 
matiko09: folds 
HuanHuan: folds 
Uncalled bet ($3) returned to scop79
scop79 collected $5 from pot
scop79: doesn't show hand 
*** SUMMARY ***
Total pot $5 | Rake $0 
Seat 1: stan_09319 (button) folded before Flop (didn't bet)
Seat 2: matiko09 (small blind) folded before Flop
Seat 3: HuanHuan (big blind) folded before Flop
Seat 5: AlKatrone folded before Flop (didn't bet)
Seat 6: I The King I folded before Flop (didn't bet)
Seat 8: scop79 collected ($5)
Seat 9: PacPacBum folded before Flop (didn't bet)





PokerStars Hand #153069095033:  Hold'em No Limit ($1/$2 USD) - 2016/05/09 17:24:36 CET [2016/05/09 11:24:36 ET]
Table 'Demeter II' 9-max Seat #5 is the button
Seat 1: Sasuke777777 ($355.24 in chips) 
Seat 2: matiko09 ($200 in chips) 
Seat 3: chaps1988 ($208.45 in chips) 
Seat 4: Igoriah ($200 in chips) 
Seat 5: PacPacBum ($232.21 in chips) 
Seat 6: HuanHuan ($204.02 in chips) 
Seat 7: Siwyosb ($210.31 in chips) 
Seat 8: CI58 ($234.54 in chips) 
HuanHuan: posts small blind $1
Siwyosb: posts big blind $2
*** HOLE CARDS ***
Dealt to matiko09 [Kd 6d]
CI58: folds 
Sasuke777777: folds 
matiko09: folds 
chaps1988: raises $3 to $5
Igoriah: folds 
PacPacBum: calls $5
HuanHuan: folds 
Siwyosb: calls $3
*** FLOP *** [8c 4c 8h]
Siwyosb: checks 
chaps1988: bets $8.50
PacPacBum: folds 
Siwyosb: folds 
Uncalled bet ($8.50) returned to chaps1988
chaps1988 collected $15.20 from pot
chaps1988: doesn't show hand 
*** SUMMARY ***
Total pot $16 | Rake $0.80 
Board [8c 4c 8h]
Seat 1: Sasuke777777 folded before Flop (didn't bet)
Seat 2: matiko09 folded before Flop (didn't bet)
Seat 3: chaps1988 collected ($15.20)
Seat 4: Igoriah folded before Flop (didn't bet)
Seat 5: PacPacBum (button) folded on the Flop
Seat 6: HuanHuan (small blind) folded before Flop
Seat 7: Siwyosb (big blind) folded on the Flop
Seat 8: CI58 folded before Flop (didn't bet)





PokerStars Hand #153069096235:  Hold'em No Limit ($0.50/$1.00 USD) - 2016/05/09 17:24:38 CET [2016/05/09 11:24:38 ET]
Table 'Terpsichore' 9-max Seat #6 is the button
Seat 2: CI58 ($105.92 in chips) 
Seat 3: matiko09 ($147.89 in chips) 
Seat 4: nubpoker ($134.48 in chips) 
Seat 5: mycka86 ($266.74 in chips) 
Seat 6: Filojoes ($114.58 in chips) 
Seat 7: Kukuryzka ($99 in chips) 
Seat 8: Kiosk230472 ($105.16 in chips) 
Kukuryzka: posts small blind $0.50
Kiosk230472: posts big blind $1
flk.Dasas: sits out 
Donetsk1y: sits out 
*** HOLE CARDS ***
Dealt to matiko09 [5c 2h]
CI58: folds 
matiko09: folds 
nubpoker: folds 
mycka86: folds 
Filojoes: folds 
Kukuryzka: folds 
Uncalled bet ($0.50) returned to Kiosk230472
Kiosk230472 collected $1 from pot
Kiosk230472: doesn't show hand 
*** SUMMARY ***
Total pot $1 | Rake $0 
Seat 2: CI58 folded before Flop (didn't bet)
Seat 3: matiko09 folded before Flop (didn't bet)
Seat 4: nubpoker folded before Flop (didn't bet)
Seat 5: mycka86 folded before Flop (didn't bet)
Seat 6: Filojoes (button) folded before Flop (didn't bet)
Seat 7: Kukuryzka (small blind) folded before Flop
Seat 8: Kiosk230472 (big blind) collected ($1)





PokerStars Hand #153069099334:  Hold'em No Limit ($1/$2 USD) - 2016/05/09 17:24:43 CET [2016/05/09 11:24:43 ET]
Table 'Celaeno II' 9-max Seat #2 is the button
Seat 1: LRVAV7 ($200 in chips) 
Seat 2: PacPacBum ($218.89 in chips) 
Seat 3: CI58 ($210.60 in chips) 
Seat 4: matiko09 ($419.82 in chips) 
Seat 6: Igoriah ($259.52 in chips) 
Seat 7: HuanHuan ($200 in chips) 
Seat 8: chaps1988 ($213.31 in chips) 
CI58: posts small blind $1
matiko09: posts big blind $2
RamiroAgujis: sits out 
*** HOLE CARDS ***
Dealt to matiko09 [Ad 5h]
Igoriah: folds 
HuanHuan: folds 
chaps1988: folds 
LRVAV7: folds 
PacPacBum has timed out
PacPacBum: folds 
CI58: folds 
Uncalled bet ($1) returned to matiko09
matiko09 collected $2 from pot
matiko09: doesn't show hand 
*** SUMMARY ***
Total pot $2 | Rake $0 
Seat 1: LRVAV7 folded before Flop (didn't bet)
Seat 2: PacPacBum (button) folded before Flop (didn't bet)
Seat 3: CI58 (small blind) folded before Flop
Seat 4: matiko09 (big blind) collected ($2)
Seat 6: Igoriah folded before Flop (didn't bet)
Seat 7: HuanHuan folded before Flop (didn't bet)
Seat 8: chaps1988 folded before Flop (didn't bet)





PokerStars Hand #153069105026:  Hold'em No Limit ($1/$2 USD) - 2016/05/09 17:24:52 CET [2016/05/09 11:24:52 ET]
Table 'Hagar II' 9-max Seat #5 is the button
Seat 1: CI58 ($200 in chips) 
Seat 2: darren1031 ($322.21 in chips) 
Seat 3: Sasuke777777 ($60.47 in chips) 
Seat 4: matiko09 ($430.49 in chips) 
Seat 5: PacPacBum ($255.39 in chips) 
Seat 6: el Fatto ($223.03 in chips) 
Seat 7: Monsthand ($312.12 in chips) 
Seat 9: chaps1988 ($374.97 in chips) 
el Fatto: posts small blind $1
Monsthand: posts big blind $2
Igoriah: sits out 
*** HOLE CARDS ***
Dealt to matiko09 [7h 8s]
chaps1988: folds 
CI58: folds 
darren1031: folds 
Sasuke777777: folds 
matiko09: folds 
PacPacBum: folds 
el Fatto: calls $1
Monsthand: raises $5 to $7
el Fatto: folds 
Uncalled bet ($5) returned to Monsthand
Monsthand collected $4 from pot
Monsthand: doesn't show hand 
*** SUMMARY ***
Total pot $4 | Rake $0 
Seat 1: CI58 folded before Flop (didn't bet)
Seat 2: darren1031 folded before Flop (didn't bet)
Seat 3: Sasuke777777 folded before Flop (didn't bet)
Seat 4: matiko09 folded before Flop (didn't bet)
Seat 5: PacPacBum (button) folded before Flop (didn't bet)
Seat 6: el Fatto (small blind) folded before Flop
Seat 7: Monsthand (big blind) collected ($4)
Seat 9: chaps1988 folded before Flop (didn't bet)





PokerStars Hand #153069108115:  Hold'em No Limit ($0.50/$1.00 USD) - 2016/05/09 17:24:57 CET [2016/05/09 11:24:57 ET]
Table 'Odyssey' 9-max Seat #4 is the button
Seat 1: matiko09 ($100 in chips) 
Seat 2: flk.Dasas ($100 in chips) 
Seat 3: chaps1988 ($157.33 in chips) 
Seat 4: mycka86 ($166.65 in chips) 
Seat 5: Donetsk1y ($100 in chips) 
Seat 6: Kukuryzka ($101.50 in chips) 
Seat 7: DancerNN1 ($102.59 in chips) 
Seat 8: nubpoker ($106.16 in chips) 
Seat 9: hellig777 ($144.14 in chips) 
Donetsk1y: posts small blind $0.50
Kukuryzka: posts big blind $1
*** HOLE CARDS ***
Dealt to matiko09 [6h 4d]
DancerNN1: folds 
nubpoker: folds 
hellig777: folds 
matiko09: folds 
flk.Dasas: folds 
chaps1988: raises $1.25 to $2.25
mycka86: folds 
Donetsk1y: folds 
Kukuryzka: folds 
Uncalled bet ($1.25) returned to chaps1988
chaps1988 collected $2.50 from pot
chaps1988: doesn't show hand 
*** SUMMARY ***
Total pot $2.50 | Rake $0 
Seat 1: matiko09 folded before Flop (didn't bet)
Seat 2: flk.Dasas folded before Flop (didn't bet)
Seat 3: chaps1988 collected ($2.50)
Seat 4: mycka86 (button) folded before Flop (didn't bet)
Seat 5: Donetsk1y (small blind) folded before Flop
Seat 6: Kukuryzka (big blind) folded before Flop
Seat 7: DancerNN1 folded before Flop (didn't bet)
Seat 8: nubpoker folded before Flop (didn't bet)
Seat 9: hellig777 folded before Flop (didn't bet)





PokerStars Hand #153069113067:  Hold'em No Limit ($1/$2 USD) - 2016/05/09 17:25:05 CET [2016/05/09 11:25:05 ET]
Table 'Philagoria II' 9-max Seat #2 is the button
Seat 1: stan_09319 ($200 in chips) 
Seat 2: matiko09 ($200 in chips) 
Seat 3: HuanHuan ($200 in chips) 
Seat 6: I The King I ($271.46 in chips) 
Seat 8: scop79 ($133 in chips) 
Seat 9: PacPacBum ($200 in chips) 
HuanHuan: posts small blind $1
AlKatrone: is sitting out 
I The King I: posts big blind $2
Monsthand: sits out 
*** HOLE CARDS ***
Dealt to matiko09 [Ah 7s]
Monsthand leaves the table
AlKatrone leaves the table
scop79: folds 
PacPacBum: raises $2.08 to $4.08
stan_09319: folds 
matiko09: folds 
HuanHuan: folds 
chaps1988 joins the table at seat #7 
I The King I: calls $2.08
*** FLOP *** [Qs 5c 2c]
I The King I: checks 
PacPacBum: bets $6
I The King I: calls $6
*** TURN *** [Qs 5c 2c] [2h]
I The King I: checks 
PacPacBum: bets $13.86
I The King I: calls $13.86
*** RIVER *** [Qs 5c 2c 2h] [Th]
I The King I: checks 
el Fatto joins the table at seat #4 
PacPacBum: checks 
*** SHOW DOWN ***
I The King I: shows [Kc Qc] (two pair, Queens and Deuces)
PacPacBum: mucks hand 
I The King I collected $46.44 from pot
*** SUMMARY ***
Total pot $48.88 | Rake $2.44 
Board [Qs 5c 2c 2h Th]
Seat 1: stan_09319 folded before Flop (didn't bet)
Seat 2: matiko09 (button) folded before Flop (didn't bet)
Seat 3: HuanHuan (small blind) folded before Flop
Seat 6: I The King I (big blind) showed [Kc Qc] and won ($46.44) with two pair, Queens and Deuces
Seat 8: scop79 folded before Flop (didn't bet)
Seat 9: PacPacBum mucked [6c Ac]





PokerStars Hand #153069114939:  Hold'em No Limit ($0.50/$1.00 USD) - 2016/05/09 17:25:08 CET [2016/05/09 11:25:08 ET]
Table 'Terpsichore' 9-max Seat #7 is the button
Seat 2: CI58 ($105.92 in chips) 
Seat 3: matiko09 ($147.89 in chips) 
Seat 4: nubpoker ($134.48 in chips) 
Seat 5: mycka86 ($266.74 in chips) 
Seat 6: Filojoes ($114.58 in chips) 
Seat 7: Kukuryzka ($100 in chips) 
Seat 8: Kiosk230472 ($105.66 in chips) 
Seat 9: flk.Dasas ($100 in chips) 
Kiosk230472: posts small blind $0.50
flk.Dasas: posts big blind $1
Donetsk1y: sits out 
*** HOLE CARDS ***
Dealt to matiko09 [9h 2c]
CI58: folds 
matiko09: folds 
nubpoker: raises $1.50 to $2.50
mycka86: folds 
Filojoes: raises $6.50 to $9
Kukuryzka: folds 
Kiosk230472: folds 
flk.Dasas: folds 
nubpoker: calls $6.50
*** FLOP *** [8s 8c 9c]
nubpoker: checks 
Filojoes: checks 
*** TURN *** [8s 8c 9c] [8d]
nubpoker: checks 
Filojoes: bets $12
nubpoker: calls $12
*** RIVER *** [8s 8c 9c 8d] [6d]
nubpoker: checks 
Filojoes: bets $28
nubpoker has timed out
nubpoker: folds 
Uncalled bet ($28) returned to Filojoes
Filojoes collected $41.32 from pot
Filojoes: doesn't show hand 
*** SUMMARY ***
Total pot $43.50 | Rake $2.18 
Board [8s 8c 9c 8d 6d]
Seat 2: CI58 folded before Flop (didn't bet)
Seat 3: matiko09 folded before Flop (didn't bet)
Seat 4: nubpoker folded on the River
Seat 5: mycka86 folded before Flop (didn't bet)
Seat 6: Filojoes collected ($41.32)
Seat 7: Kukuryzka (button) folded before Flop (didn't bet)
Seat 8: Kiosk230472 (small blind) folded before Flop
Seat 9: flk.Dasas (big blind) folded before Flop





PokerStars Hand #153069117668:  Hold'em No Limit ($1/$2 USD) - 2016/05/09 17:25:12 CET [2016/05/09 11:25:12 ET]
Table 'Celaeno II' 9-max Seat #3 is the button
Seat 1: LRVAV7 ($200 in chips) 
Seat 2: PacPacBum ($218.89 in chips) 
Seat 3: CI58 ($209.60 in chips) 
Seat 4: matiko09 ($420.82 in chips) 
Seat 6: Igoriah ($259.52 in chips) 
Seat 7: HuanHuan ($200 in chips) 
Seat 8: chaps1988 ($213.31 in chips) 
matiko09: posts small blind $1
Monsthand: is sitting out 
Igoriah: posts big blind $2
Monsthand leaves the table
RamiroAgujis: sits out 
*** HOLE CARDS ***
Dealt to matiko09 [Ac Th]
HuanHuan: folds 
chaps1988: folds 
LRVAV7: folds 
PacPacBum: folds 
scop79 joins the table at seat #5 
CI58: raises $2.50 to $4.50
matiko09: folds 
Igoriah: folds 
Uncalled bet ($2.50) returned to CI58
CI58 collected $5 from pot
CI58: doesn't show hand 
*** SUMMARY ***
Total pot $5 | Rake $0 
Seat 1: LRVAV7 folded before Flop (didn't bet)
Seat 2: PacPacBum folded before Flop (didn't bet)
Seat 3: CI58 (button) collected ($5)
Seat 4: matiko09 (small blind) folded before Flop
Seat 6: Igoriah (big blind) folded before Flop
Seat 7: HuanHuan folded before Flop (didn't bet)
Seat 8: chaps1988 folded before Flop (didn't bet)





PokerStars Hand #153069123860:  Hold'em No Limit ($0.50/$1.00 USD) - 2016/05/09 17:25:22 CET [2016/05/09 11:25:22 ET]
Table 'Merga II' 9-max Seat #6 is the button
Seat 1: R1aki ($103.50 in chips) 
Seat 3: 43605511 ($100 in chips) 
Seat 4: erick222 ($100 in chips) 
Seat 5: matiko09 ($100 in chips) 
Seat 6: AlKatrone ($102.68 in chips) 
Seat 7: rusher_NiNja ($218.70 in chips) 
Seat 8: serbianhaze ($128.42 in chips) 
Seat 9: maxxmeister ($119 in chips) 
rusher_NiNja: posts small blind $0.50
serbianhaze: posts big blind $1
flk.Dasas: sits out 
*** HOLE CARDS ***
Dealt to matiko09 [4s Qh]
maxxmeister: folds 
R1aki: folds 
43605511: folds 
erick222: folds 
matiko09: folds 
AlKatrone: folds 
rusher_NiNja: raises $1.50 to $2.50
serbianhaze: calls $1.50
*** FLOP *** [4d 6h 7h]
rusher_NiNja: checks 
serbianhaze: checks 
*** TURN *** [4d 6h 7h] [2h]
rusher_NiNja: checks 
serbianhaze: bets $3
rusher_NiNja: folds 
Uncalled bet ($3) returned to serbianhaze
serbianhaze collected $4.75 from pot
*** SUMMARY ***
Total pot $5 | Rake $0.25 
Board [4d 6h 7h 2h]
Seat 1: R1aki folded before Flop (didn't bet)
Seat 3: 43605511 folded before Flop (didn't bet)
Seat 4: erick222 folded before Flop (didn't bet)
Seat 5: matiko09 folded before Flop (didn't bet)
Seat 6: AlKatrone (button) folded before Flop (didn't bet)
Seat 7: rusher_NiNja (small blind) folded on the Turn
Seat 8: serbianhaze (big blind) collected ($4.75)
Seat 9: maxxmeister folded before Flop (didn't bet)





PokerStars Hand #153069125219:  Hold'em No Limit ($0.50/$1.00 USD) - 2016/05/09 17:25:24 CET [2016/05/09 11:25:24 ET]
Table 'Orthos' 9-max Seat #1 is the button
Seat 1: Kelvin sai ($96.82 in chips) 
Seat 2: PacPacBum ($100 in chips) 
Seat 3: Filojoes ($100 in chips) 
Seat 4: nubpoker ($157.37 in chips) 
Seat 5: matiko09 ($141.30 in chips) 
Seat 6: xhinostrabli ($85.61 in chips) 
Seat 7: flk.Dasas ($166.42 in chips) 
Seat 8: Dickyxxx ($103.67 in chips) 
Seat 9: mycka86 ($111.15 in chips) 
PacPacBum: posts small blind $0.50
Filojoes: posts big blind $1
*** HOLE CARDS ***
Dealt to matiko09 [6c 2h]
nubpoker: folds 
matiko09: folds 
xhinostrabli: folds 
flk.Dasas: raises $2 to $3
Dickyxxx: folds 
mycka86: folds 
Kelvin sai: folds 
PacPacBum: folds 
Filojoes: folds 
Uncalled bet ($2) returned to flk.Dasas
flk.Dasas collected $2.50 from pot
flk.Dasas: doesn't show hand 
*** SUMMARY ***
Total pot $2.50 | Rake $0 
Seat 1: Kelvin sai (button) folded before Flop (didn't bet)
Seat 2: PacPacBum (small blind) folded before Flop
Seat 3: Filojoes (big blind) folded before Flop
Seat 4: nubpoker folded before Flop (didn't bet)
Seat 5: matiko09 folded before Flop (didn't bet)
Seat 6: xhinostrabli folded before Flop (didn't bet)
Seat 7: flk.Dasas collected ($2.50)
Seat 8: Dickyxxx folded before Flop (didn't bet)
Seat 9: mycka86 folded before Flop (didn't bet)





PokerStars Hand #153069125298:  Hold'em No Limit ($1/$2 USD) - 2016/05/09 17:25:24 CET [2016/05/09 11:25:24 ET]
Table 'Demeter II' 9-max Seat #6 is the button
Seat 1: Sasuke777777 ($355.24 in chips) 
Seat 2: matiko09 ($200 in chips) 
Seat 3: chaps1988 ($218.65 in chips) 
Seat 4: Igoriah ($200 in chips) 
Seat 5: PacPacBum ($227.21 in chips) 
Seat 6: HuanHuan ($203.02 in chips) 
Seat 7: Siwyosb ($205.31 in chips) 
Seat 8: CI58 ($234.54 in chips) 
Seat 9: Monsthand ($647.38 in chips) 
Siwyosb: posts small blind $1
CI58: posts big blind $2
*** HOLE CARDS ***
Dealt to matiko09 [7c 8d]
Monsthand: folds 
Sasuke777777: raises $4 to $6
matiko09: folds 
chaps1988: folds 
Igoriah: folds 
PacPacBum: folds 
HuanHuan: folds 
Siwyosb: folds 
CI58: folds 
Uncalled bet ($4) returned to Sasuke777777
Sasuke777777 collected $5 from pot
Sasuke777777: doesn't show hand 
*** SUMMARY ***
Total pot $5 | Rake $0 
Seat 1: Sasuke777777 collected ($5)
Seat 2: matiko09 folded before Flop (didn't bet)
Seat 3: chaps1988 folded before Flop (didn't bet)
Seat 4: Igoriah folded before Flop (didn't bet)
Seat 5: PacPacBum folded before Flop (didn't bet)
Seat 6: HuanHuan (button) folded before Flop (didn't bet)
Seat 7: Siwyosb (small blind) folded before Flop
Seat 8: CI58 (big blind) folded before Flop
Seat 9: Monsthand folded before Flop (didn't bet)





PokerStars Hand #153069125879:  Hold'em No Limit ($1/$2 USD) - 2016/05/09 17:25:25 CET [2016/05/09 11:25:25 ET]
Table 'Hagar II' 9-max Seat #6 is the button
Seat 1: CI58 ($200 in chips) 
Seat 2: darren1031 ($322.21 in chips) 
Seat 3: Sasuke777777 ($60.47 in chips) 
Seat 4: matiko09 ($430.49 in chips) 
Seat 5: PacPacBum ($255.39 in chips) 
Seat 6: el Fatto ($221.03 in chips) 
Seat 7: Monsthand ($314.12 in chips) 
Seat 8: Igoriah ($200 in chips) 
Seat 9: chaps1988 ($374.97 in chips) 
Monsthand: posts small blind $1
Igoriah: posts big blind $2
*** HOLE CARDS ***
Dealt to matiko09 [6h 8s]
chaps1988: folds 
CI58: folds 
darren1031: folds 
Sasuke777777: raises $4 to $6
matiko09: folds 
PacPacBum: folds 
el Fatto: folds 
Monsthand: folds 
Igoriah: folds 
Uncalled bet ($4) returned to Sasuke777777
Sasuke777777 collected $5 from pot
Sasuke777777: doesn't show hand 
*** SUMMARY ***
Total pot $5 | Rake $0 
Seat 1: CI58 folded before Flop (didn't bet)
Seat 2: darren1031 folded before Flop (didn't bet)
Seat 3: Sasuke777777 collected ($5)
Seat 4: matiko09 folded before Flop (didn't bet)
Seat 5: PacPacBum folded before Flop (didn't bet)
Seat 6: el Fatto (button) folded before Flop (didn't bet)
Seat 7: Monsthand (small blind) folded before Flop
Seat 8: Igoriah (big blind) folded before Flop
Seat 9: chaps1988 folded before Flop (didn't bet)





PokerStars Hand #153069128487:  Hold'em No Limit ($0.50/$1.00 USD) - 2016/05/09 17:25:29 CET [2016/05/09 11:25:29 ET]
Table 'Odyssey' 9-max Seat #5 is the button
Seat 1: matiko09 ($100 in chips) 
Seat 2: flk.Dasas ($100 in chips) 
Seat 3: chaps1988 ($158.83 in chips) 
Seat 4: mycka86 ($166.65 in chips) 
Seat 5: Donetsk1y ($100 in chips) 
Seat 6: Kukuryzka ($100.50 in chips) 
Seat 8: nubpoker ($106.16 in chips) 
Seat 9: hellig777 ($144.14 in chips) 
Kukuryzka: posts small blind $0.50
DancerNN1: is sitting out 
nubpoker: posts big blind $1
*** HOLE CARDS ***
Dealt to matiko09 [Qs 8c]
hellig777: raises $2 to $3
matiko09: folds 
flk.Dasas: folds 
chaps1988: folds 
mycka86: folds 
Donetsk1y: folds 
Kukuryzka: folds 
nubpoker: calls $2
*** FLOP *** [Ts 2d 8d]
DancerNN1 leaves the table
I The King I joins the table at seat #7 
I The King I leaves the table
nubpoker: checks 
hellig777: bets $3.09
CI58 joins the table at seat #7 
nubpoker: calls $3.09
*** TURN *** [Ts 2d 8d] [9d]
nubpoker: checks 
hellig777: bets $6.02
nubpoker: raises $16.05 to $22.07
hellig777: calls $16.05
*** RIVER *** [Ts 2d 8d 9d] [9c]
nubpoker: bets $36.21
hellig777: raises $63.37 to $99.58
nubpoker: calls $41.79 and is all-in
Uncalled bet ($21.58) returned to hellig777
*** SHOW DOWN ***
hellig777: shows [Tc Td] (a full house, Tens full of Nines)
nubpoker: shows [Ad Qd] (a flush, Ace high)
hellig777 collected $210.32 from pot
*** SUMMARY ***
Total pot $212.82 | Rake $2.50 
Board [Ts 2d 8d 9d 9c]
Seat 1: matiko09 folded before Flop (didn't bet)
Seat 2: flk.Dasas folded before Flop (didn't bet)
Seat 3: chaps1988 folded before Flop (didn't bet)
Seat 4: mycka86 folded before Flop (didn't bet)
Seat 5: Donetsk1y (button) folded before Flop (didn't bet)
Seat 6: Kukuryzka (small blind) folded before Flop
Seat 8: nubpoker (big blind) showed [Ad Qd] and lost with a flush, Ace high
Seat 9: hellig777 showed [Tc Td] and won ($210.32) with a full house, Tens full of Nines





PokerStars Hand #153069132724:  Hold'em No Limit ($1/$2 USD) - 2016/05/09 17:25:36 CET [2016/05/09 11:25:36 ET]
Table 'Celaeno II' 9-max Seat #4 is the button
Seat 1: LRVAV7 ($200 in chips) 
Seat 2: PacPacBum ($218.89 in chips) 
Seat 3: CI58 ($212.60 in chips) 
Seat 4: matiko09 ($419.82 in chips) 
Seat 6: Igoriah ($257.52 in chips) 
Seat 7: HuanHuan ($200 in chips) 
Seat 8: chaps1988 ($213.31 in chips) 
scop79 will be allowed to play after the button
Igoriah: posts small blind $1
HuanHuan: posts big blind $2
RamiroAgujis: sits out 
*** HOLE CARDS ***
Dealt to matiko09 [5d Ac]
chaps1988: folds 
LRVAV7: folds 
PacPacBum: folds 
CI58: folds 
matiko09: raises $2.54 to $4.54
Igoriah: raises $9.46 to $14
HuanHuan: raises $23 to $37
matiko09: folds 
Igoriah: folds 
Uncalled bet ($23) returned to HuanHuan
HuanHuan collected $32.54 from pot
HuanHuan: doesn't show hand 
*** SUMMARY ***
Total pot $32.54 | Rake $0 
Seat 1: LRVAV7 folded before Flop (didn't bet)
Seat 2: PacPacBum folded before Flop (didn't bet)
Seat 3: CI58 folded before Flop (didn't bet)
Seat 4: matiko09 (button) folded before Flop
Seat 6: Igoriah (small blind) folded before Flop
Seat 7: HuanHuan (big blind) collected ($32.54)
Seat 8: chaps1988 folded before Flop (didn't bet)





PokerStars Hand #153069139122:  Hold'em No Limit ($1/$2 USD) - 2016/05/09 17:25:46 CET [2016/05/09 11:25:46 ET]
Table 'Demeter II' 9-max Seat #7 is the button
Seat 1: Sasuke777777 ($358.24 in chips) 
Seat 2: matiko09 ($200 in chips) 
Seat 3: chaps1988 ($218.65 in chips) 
Seat 4: Igoriah ($200 in chips) 
Seat 5: PacPacBum ($227.21 in chips) 
Seat 6: HuanHuan ($203.02 in chips) 
Seat 7: Siwyosb ($204.31 in chips) 
Seat 8: CI58 ($232.54 in chips) 
CI58: posts small blind $1
Monsthand: is sitting out 
Sasuke777777: posts big blind $2
*** HOLE CARDS ***
Dealt to matiko09 [Th 4h]
Monsthand leaves the table
matiko09: folds 
chaps1988: folds 
Igoriah: folds 
PacPacBum: folds 
HuanHuan: raises $3 to $5
Siwyosb: folds 
CI58: calls $4
Sasuke777777: raises $11 to $16
HuanHuan: calls $11
CI58: calls $11
*** FLOP *** [8d 3h Td]
CI58: checks 
Sasuke777777: bets $24
HuanHuan: folds 
CI58: calls $24
*** TURN *** [8d 3h Td] [4c]
RamiroAgujis joins the table at seat #9 
CI58: checks 
Sasuke777777: bets $93.25
CI58: calls $93.25
*** RIVER *** [8d 3h Td 4c] [7c]
CI58: checks 
Sasuke777777: bets $40
CI58: calls $40
*** SHOW DOWN ***
Sasuke777777: shows [Ks 8h] (a pair of Eights)
CI58: shows [Jc Jd] (a pair of Jacks)
CI58 collected $359.75 from pot
*** SUMMARY ***
Total pot $362.50 | Rake $2.75 
Board [8d 3h Td 4c 7c]
Seat 1: Sasuke777777 (big blind) showed [Ks 8h] and lost with a pair of Eights
Seat 2: matiko09 folded before Flop (didn't bet)
Seat 3: chaps1988 folded before Flop (didn't bet)
Seat 4: Igoriah folded before Flop (didn't bet)
Seat 5: PacPacBum folded before Flop (didn't bet)
Seat 6: HuanHuan folded on the Flop
Seat 7: Siwyosb (button) folded before Flop (didn't bet)
Seat 8: CI58 (small blind) showed [Jc Jd] and won ($359.75) with a pair of Jacks





PokerStars Hand #153069141463:  Hold'em No Limit ($1/$2 USD) - 2016/05/09 17:25:50 CET [2016/05/09 11:25:50 ET]
Table 'Hagar II' 9-max Seat #7 is the button
Seat 1: CI58 ($200 in chips) 
Seat 2: darren1031 ($322.21 in chips) 
Seat 3: Sasuke777777 ($63.47 in chips) 
Seat 4: matiko09 ($430.49 in chips) 
Seat 5: PacPacBum ($255.39 in chips) 
Seat 6: el Fatto ($221.03 in chips) 
Seat 7: Monsthand ($313.12 in chips) 
Seat 8: Igoriah ($200 in chips) 
Seat 9: chaps1988 ($374.97 in chips) 
Igoriah: posts small blind $1
chaps1988: posts big blind $2
*** HOLE CARDS ***
Dealt to matiko09 [Ks 6d]
CI58: raises $4 to $6
darren1031: folds 
Sasuke777777: calls $6
matiko09: folds 
PacPacBum: raises $18 to $24
el Fatto: folds 
Monsthand: folds 
Igoriah: folds 
chaps1988: folds 
CI58: raises $38 to $62
Sasuke777777: raises $1.47 to $63.47 and is all-in
PacPacBum: folds 
CI58: calls $1.47
*** FLOP *** [Ad 6s 8h]
*** TURN *** [Ad 6s 8h] [9s]
*** RIVER *** [Ad 6s 8h 9s] [7c]
*** SHOW DOWN ***
CI58: shows [Kd Kh] (a pair of Kings)
Sasuke777777: shows [Th Jh] (a straight, Seven to Jack)
Sasuke777777 collected $151.19 from pot
*** SUMMARY ***
Total pot $153.94 | Rake $2.75 
Board [Ad 6s 8h 9s 7c]
Seat 1: CI58 showed [Kd Kh] and lost with a pair of Kings
Seat 2: darren1031 folded before Flop (didn't bet)
Seat 3: Sasuke777777 showed [Th Jh] and won ($151.19) with a straight, Seven to Jack
Seat 4: matiko09 folded before Flop (didn't bet)
Seat 5: PacPacBum folded before Flop
Seat 6: el Fatto folded before Flop (didn't bet)
Seat 7: Monsthand (button) folded before Flop (didn't bet)
Seat 8: Igoriah (small blind) folded before Flop
Seat 9: chaps1988 (big blind) folded before Flop





PokerStars Hand #153069148205:  Hold'em No Limit ($0.50/$1.00 USD) - 2016/05/09 17:26:00 CET [2016/05/09 11:26:00 ET]
Table 'Orthos' 9-max Seat #2 is the button
Seat 1: Kelvin sai ($96.82 in chips) 
Seat 2: PacPacBum ($100 in chips) 
Seat 3: Filojoes ($100 in chips) 
Seat 4: nubpoker ($157.37 in chips) 
Seat 5: matiko09 ($141.30 in chips) 
Seat 6: xhinostrabli ($85.61 in chips) 
Seat 7: flk.Dasas ($167.92 in chips) 
Seat 8: Dickyxxx ($103.67 in chips) 
Seat 9: mycka86 ($111.15 in chips) 
Filojoes: posts small blind $0.50
nubpoker: posts big blind $1
*** HOLE CARDS ***
Dealt to matiko09 [Jd 3c]
matiko09: folds 
xhinostrabli: folds 
flk.Dasas: folds 
Dickyxxx: folds 
mycka86: folds 
Kelvin sai: folds 
PacPacBum: folds 
Filojoes: folds 
Uncalled bet ($0.50) returned to nubpoker
nubpoker collected $1 from pot
nubpoker: doesn't show hand 
*** SUMMARY ***
Total pot $1 | Rake $0 
Seat 1: Kelvin sai folded before Flop (didn't bet)
Seat 2: PacPacBum (button) folded before Flop (didn't bet)
Seat 3: Filojoes (small blind) folded before Flop
Seat 4: nubpoker (big blind) collected ($1)
Seat 5: matiko09 folded before Flop (didn't bet)
Seat 6: xhinostrabli folded before Flop (didn't bet)
Seat 7: flk.Dasas folded before Flop (didn't bet)
Seat 8: Dickyxxx folded before Flop (didn't bet)
Seat 9: mycka86 folded before Flop (didn't bet)





PokerStars Hand #153069164599:  Hold'em No Limit ($0.50/$1.00 USD) - 2016/05/09 17:26:27 CET [2016/05/09 11:26:27 ET]
Table 'Merga II' 9-max Seat #7 is the button
Seat 1: R1aki ($103.50 in chips) 
Seat 3: 43605511 ($100 in chips) 
Seat 4: erick222 ($100 in chips) 
Seat 5: matiko09 ($100 in chips) 
Seat 6: AlKatrone ($102.68 in chips) 
Seat 7: rusher_NiNja ($216.20 in chips) 
Seat 8: serbianhaze ($130.67 in chips) 
Seat 9: maxxmeister ($119 in chips) 
serbianhaze: posts small blind $0.50
maxxmeister: posts big blind $1
flk.Dasas: sits out 
*** HOLE CARDS ***
Dealt to matiko09 [2c Kd]
R1aki: folds 
43605511: folds 
erick222: folds 
matiko09: folds 
AlKatrone: folds 
rusher_NiNja: raises $1.50 to $2.50
serbianhaze: calls $2
maxxmeister: raises $9.50 to $12
rusher_NiNja: folds 
serbianhaze: folds 
Uncalled bet ($9.50) returned to maxxmeister
maxxmeister collected $7.50 from pot
maxxmeister: doesn't show hand 
*** SUMMARY ***
Total pot $7.50 | Rake $0 
Seat 1: R1aki folded before Flop (didn't bet)
Seat 3: 43605511 folded before Flop (didn't bet)
Seat 4: erick222 folded before Flop (didn't bet)
Seat 5: matiko09 folded before Flop (didn't bet)
Seat 6: AlKatrone folded before Flop (didn't bet)
Seat 7: rusher_NiNja (button) folded before Flop
Seat 8: serbianhaze (small blind) folded before Flop
Seat 9: maxxmeister (big blind) collected ($7.50)





PokerStars Hand #153069165898:  Hold'em No Limit ($0.50/$1.00 USD) - 2016/05/09 17:26:29 CET [2016/05/09 11:26:29 ET]
Table 'Orthos' 9-max Seat #3 is the button
Seat 1: Kelvin sai ($96.82 in chips) 
Seat 2: PacPacBum ($100 in chips) 
Seat 3: Filojoes ($100 in chips) 
Seat 4: nubpoker ($157.87 in chips) 
Seat 5: matiko09 ($141.30 in chips) 
Seat 6: xhinostrabli ($85.61 in chips) 
Seat 7: flk.Dasas ($167.92 in chips) 
Seat 8: Dickyxxx ($103.67 in chips) 
Seat 9: mycka86 ($111.15 in chips) 
nubpoker: posts small blind $0.50
matiko09: posts big blind $1
*** HOLE CARDS ***
Dealt to matiko09 [3d 5h]
xhinostrabli: folds 
flk.Dasas: folds 
Dickyxxx: folds 
mycka86: folds 
Kelvin sai: folds 
PacPacBum: raises $1.50 to $2.50
Filojoes: folds 
nubpoker: folds 
matiko09: folds 
Uncalled bet ($1.50) returned to PacPacBum
PacPacBum collected $2.50 from pot
PacPacBum: doesn't show hand 
*** SUMMARY ***
Total pot $2.50 | Rake $0 
Seat 1: Kelvin sai folded before Flop (didn't bet)
Seat 2: PacPacBum collected ($2.50)
Seat 3: Filojoes (button) folded before Flop (didn't bet)
Seat 4: nubpoker (small blind) folded before Flop
Seat 5: matiko09 (big blind) folded before Flop
Seat 6: xhinostrabli folded before Flop (didn't bet)
Seat 7: flk.Dasas folded before Flop (didn't bet)
Seat 8: Dickyxxx folded before Flop (didn't bet)
Seat 9: mycka86 folded before Flop (didn't bet)





PokerStars Hand #153069172809:  Hold'em No Limit ($1/$2 USD) - 2016/05/09 17:26:40 CET [2016/05/09 11:26:40 ET]
Table 'Celaeno II' 9-max Seat #6 is the button
Seat 1: LRVAV7 ($200 in chips) 
Seat 2: PacPacBum ($218.89 in chips) 
Seat 3: CI58 ($212.60 in chips) 
Seat 4: matiko09 ($415.28 in chips) 
Seat 6: Igoriah ($243.52 in chips) 
Seat 7: HuanHuan ($218.54 in chips) 
Seat 8: chaps1988 ($213.31 in chips) 
HuanHuan: posts small blind $1
chaps1988: posts big blind $2
RamiroAgujis: sits out 
scop79: sits out 
*** HOLE CARDS ***
Dealt to matiko09 [4h 9d]
LRVAV7: folds 
PacPacBum: raises $2.08 to $4.08
CI58: folds 
matiko09: folds 
Igoriah: folds 
HuanHuan: folds 
chaps1988: folds 
Uncalled bet ($2.08) returned to PacPacBum
PacPacBum collected $5 from pot
PacPacBum: doesn't show hand 
*** SUMMARY ***
Total pot $5 | Rake $0 
Seat 1: LRVAV7 folded before Flop (didn't bet)
Seat 2: PacPacBum collected ($5)
Seat 3: CI58 folded before Flop (didn't bet)
Seat 4: matiko09 folded before Flop (didn't bet)
Seat 6: Igoriah (button) folded before Flop (didn't bet)
Seat 7: HuanHuan (small blind) folded before Flop
Seat 8: chaps1988 (big blind) folded before Flop





PokerStars Hand #153069182370:  Hold'em No Limit ($0.50/$1.00 USD) - 2016/05/09 17:26:55 CET [2016/05/09 11:26:55 ET]
Table 'Orthos' 9-max Seat #4 is the button
Seat 1: Kelvin sai ($96.82 in chips) 
Seat 2: PacPacBum ($101.50 in chips) 
Seat 3: Filojoes ($100 in chips) 
Seat 4: nubpoker ($157.37 in chips) 
Seat 5: matiko09 ($140.30 in chips) 
Seat 6: xhinostrabli ($85.61 in chips) 
Seat 7: flk.Dasas ($167.92 in chips) 
Seat 8: Dickyxxx ($103.67 in chips) 
Seat 9: mycka86 ($111.15 in chips) 
matiko09: posts small blind $0.50
xhinostrabli: posts big blind $1
*** HOLE CARDS ***
Dealt to matiko09 [Qh Tc]
flk.Dasas: folds 
Dickyxxx: folds 
mycka86: folds 
Kelvin sai: raises $1 to $2
PacPacBum: folds 
Filojoes: raises $5 to $7
nubpoker: folds 
matiko09: folds 
xhinostrabli: raises $5 to $12
Kelvin sai: folds 
Filojoes: raises $10 to $22
xhinostrabli: folds 
Uncalled bet ($10) returned to Filojoes
Filojoes collected $26.50 from pot
Filojoes: doesn't show hand 
*** SUMMARY ***
Total pot $26.50 | Rake $0 
Seat 1: Kelvin sai folded before Flop
Seat 2: PacPacBum folded before Flop (didn't bet)
Seat 3: Filojoes collected ($26.50)
Seat 4: nubpoker (button) folded before Flop (didn't bet)
Seat 5: matiko09 (small blind) folded before Flop
Seat 6: xhinostrabli (big blind) folded before Flop
Seat 7: flk.Dasas folded before Flop (didn't bet)
Seat 8: Dickyxxx folded before Flop (didn't bet)
Seat 9: mycka86 folded before Flop (didn't bet)





PokerStars Hand #153069189366:  Hold'em No Limit ($1/$2 USD) - 2016/05/09 17:27:06 CET [2016/05/09 11:27:06 ET]
Table 'Philagoria II' 9-max Seat #3 is the button
Seat 1: stan_09319 ($200 in chips) 
Seat 2: matiko09 ($200 in chips) 
Seat 3: HuanHuan ($200 in chips) 
Seat 6: I The King I ($293.96 in chips) 
Seat 7: chaps1988 ($200 in chips) 
Seat 8: scop79 ($133 in chips) 
Seat 9: PacPacBum ($200 in chips) 
I The King I: posts small blind $1
chaps1988: posts big blind $2
*** HOLE CARDS ***
Dealt to matiko09 [2s 5s]
scop79: folds 
PacPacBum: folds 
stan_09319: raises $2.70 to $4.70
matiko09: folds 
HuanHuan: folds 
I The King I: calls $3.70
el Fatto leaves the table
chaps1988: folds 
*** FLOP *** [Kh 6c 6d]
I The King I: checks 
stan_09319: checks 
*** TURN *** [Kh 6c 6d] [Qc]
I The King I: checks 
stan_09319: checks 
*** RIVER *** [Kh 6c 6d Qc] [9s]
I The King I: bets $8
stan_09319: folds 
Uncalled bet ($8) returned to I The King I
I The King I collected $10.83 from pot
I The King I: doesn't show hand 
*** SUMMARY ***
Total pot $11.40 | Rake $0.57 
Board [Kh 6c 6d Qc 9s]
Seat 1: stan_09319 folded on the River
Seat 2: matiko09 folded before Flop (didn't bet)
Seat 3: HuanHuan (button) folded before Flop (didn't bet)
Seat 6: I The King I (small blind) collected ($10.83)
Seat 7: chaps1988 (big blind) folded before Flop
Seat 8: scop79 folded before Flop (didn't bet)
Seat 9: PacPacBum folded before Flop (didn't bet)





PokerStars Hand #153069190922:  Hold'em No Limit ($1/$2 USD) - 2016/05/09 17:27:09 CET [2016/05/09 11:27:09 ET]
Table 'Celaeno II' 9-max Seat #7 is the button
Seat 1: LRVAV7 ($200 in chips) 
Seat 2: PacPacBum ($221.89 in chips) 
Seat 3: CI58 ($212.60 in chips) 
Seat 4: matiko09 ($415.28 in chips) 
Seat 6: Igoriah ($243.52 in chips) 
Seat 7: HuanHuan ($217.54 in chips) 
Seat 8: chaps1988 ($211.31 in chips) 
Seat 9: RamiroAgujis ($200 in chips) 
chaps1988: posts small blind $1
RamiroAgujis: posts big blind $2
scop79: sits out 
*** HOLE CARDS ***
Dealt to matiko09 [Ts Ad]
LRVAV7: folds 
scop79 leaves the table
PacPacBum: raises $2.08 to $4.08
CI58: folds 
matiko09: folds 
Igoriah: folds 
HuanHuan: folds 
chaps1988: folds 
RamiroAgujis: calls $2.08
*** FLOP *** [Ks Th 6c]
RamiroAgujis: checks 
PacPacBum: checks 
*** TURN *** [Ks Th 6c] [9c]
RamiroAgujis: bets $6.26
PacPacBum: folds 
Uncalled bet ($6.26) returned to RamiroAgujis
RamiroAgujis collected $8.70 from pot
RamiroAgujis: doesn't show hand 
*** SUMMARY ***
Total pot $9.16 | Rake $0.46 
Board [Ks Th 6c 9c]
Seat 1: LRVAV7 folded before Flop (didn't bet)
Seat 2: PacPacBum folded on the Turn
Seat 3: CI58 folded before Flop (didn't bet)
Seat 4: matiko09 folded before Flop (didn't bet)
Seat 6: Igoriah folded before Flop (didn't bet)
Seat 7: HuanHuan (button) folded before Flop (didn't bet)
Seat 8: chaps1988 (small blind) folded before Flop
Seat 9: RamiroAgujis (big blind) collected ($8.70)





PokerStars Hand #153069191498:  Hold'em No Limit ($1/$2 USD) - 2016/05/09 17:27:10 CET [2016/05/09 11:27:10 ET]
Table 'Hagar II' 9-max Seat #8 is the button
Seat 1: CI58 ($200 in chips) 
Seat 2: darren1031 ($322.21 in chips) 
Seat 3: Sasuke777777 ($151.19 in chips) 
Seat 4: matiko09 ($430.49 in chips) 
Seat 5: PacPacBum ($231.39 in chips) 
Seat 6: el Fatto ($221.03 in chips) 
Seat 7: Monsthand ($313.12 in chips) 
Seat 8: Igoriah ($200 in chips) 
Seat 9: chaps1988 ($372.97 in chips) 
chaps1988: posts small blind $1
CI58: posts big blind $2
*** HOLE CARDS ***
Dealt to matiko09 [9s 7s]
darren1031: folds 
Sasuke777777: folds 
matiko09: folds 
PacPacBum: folds 
el Fatto: folds 
Monsthand: folds 
Igoriah: raises $3 to $5
chaps1988: calls $4
CI58: folds 
*** FLOP *** [Qs 6h 4h]
chaps1988: checks 
Igoriah: checks 
*** TURN *** [Qs 6h 4h] [2h]
chaps1988: checks 
Igoriah: checks 
*** RIVER *** [Qs 6h 4h 2h] [Ah]
chaps1988: checks 
Igoriah: bets $7.52
chaps1988: folds 
Uncalled bet ($7.52) returned to Igoriah
Igoriah collected $11.40 from pot
Igoriah: doesn't show hand 
*** SUMMARY ***
Total pot $12 | Rake $0.60 
Board [Qs 6h 4h 2h Ah]
Seat 1: CI58 (big blind) folded before Flop
Seat 2: darren1031 folded before Flop (didn't bet)
Seat 3: Sasuke777777 folded before Flop (didn't bet)
Seat 4: matiko09 folded before Flop (didn't bet)
Seat 5: PacPacBum folded before Flop (didn't bet)
Seat 6: el Fatto folded before Flop (didn't bet)
Seat 7: Monsthand folded before Flop (didn't bet)
Seat 8: Igoriah (button) collected ($11.40)
Seat 9: chaps1988 (small blind) folded on the River





PokerStars Hand #153069193499:  Hold'em No Limit ($0.50/$1.00 USD) - 2016/05/09 17:27:13 CET [2016/05/09 11:27:13 ET]
Table 'Reiss' 9-max Seat #1 is the button
Seat 1: Dickyxxx ($212.41 in chips) 
Seat 2: mycka86 ($184.75 in chips) 
Seat 3: chaps1988 ($123.46 in chips) 
Seat 4: CI58 ($100 in chips) 
Seat 5: matiko09 ($131.71 in chips) 
Seat 6: HITYESCA ($204.74 in chips) 
Seat 7: nubpoker ($100 in chips) 
Seat 8: JimineyCrik ($101.80 in chips) 
mycka86: posts small blind $0.50
chaps1988: posts big blind $1
taxi1313 is connected 
taxi1313: sits out 
*** HOLE CARDS ***
Dealt to matiko09 [Kc Kd]
CI58: folds 
matiko09: raises $2 to $3
HITYESCA: folds 
nubpoker: folds 
JimineyCrik: folds 
Dickyxxx: calls $3
mycka86: folds 
chaps1988: folds 
*** FLOP *** [3s 2c 6h]
matiko09: bets $4.63
Dickyxxx: folds 
Uncalled bet ($4.63) returned to matiko09
matiko09 collected $7.12 from pot
matiko09: doesn't show hand 
*** SUMMARY ***
Total pot $7.50 | Rake $0.38 
Board [3s 2c 6h]
Seat 1: Dickyxxx (button) folded on the Flop
Seat 2: mycka86 (small blind) folded before Flop
Seat 3: chaps1988 (big blind) folded before Flop
Seat 4: CI58 folded before Flop (didn't bet)
Seat 5: matiko09 collected ($7.12)
Seat 6: HITYESCA folded before Flop (didn't bet)
Seat 7: nubpoker folded before Flop (didn't bet)
Seat 8: JimineyCrik folded before Flop (didn't bet)





PokerStars Hand #153069194227:  Hold'em No Limit ($0.50/$1.00 USD) - 2016/05/09 17:27:14 CET [2016/05/09 11:27:14 ET]
Table 'Merga II' 9-max Seat #8 is the button
Seat 1: R1aki ($103.50 in chips) 
Seat 3: 43605511 ($100 in chips) 
Seat 4: erick222 ($100 in chips) 
Seat 5: matiko09 ($100 in chips) 
Seat 6: AlKatrone ($102.68 in chips) 
Seat 7: rusher_NiNja ($213.70 in chips) 
Seat 8: serbianhaze ($128.17 in chips) 
Seat 9: maxxmeister ($124 in chips) 
maxxmeister: posts small blind $0.50
R1aki: posts big blind $1
flk.Dasas: sits out 
*** HOLE CARDS ***
Dealt to matiko09 [6c Js]
43605511: folds 
erick222: folds 
matiko09: folds 
AlKatrone: folds 
rusher_NiNja: raises $1.50 to $2.50
serbianhaze: folds 
maxxmeister: folds 
R1aki: folds 
Uncalled bet ($1.50) returned to rusher_NiNja
rusher_NiNja collected $2.50 from pot
rusher_NiNja: doesn't show hand 
*** SUMMARY ***
Total pot $2.50 | Rake $0 
Seat 1: R1aki (big blind) folded before Flop
Seat 3: 43605511 folded before Flop (didn't bet)
Seat 4: erick222 folded before Flop (didn't bet)
Seat 5: matiko09 folded before Flop (didn't bet)
Seat 6: AlKatrone folded before Flop (didn't bet)
Seat 7: rusher_NiNja collected ($2.50)
Seat 8: serbianhaze (button) folded before Flop (didn't bet)
Seat 9: maxxmeister (small blind) folded before Flop





PokerStars Hand #153069209640:  Hold'em No Limit ($0.50/$1.00 USD) - 2016/05/09 17:27:38 CET [2016/05/09 11:27:38 ET]
Table 'Odyssey' 9-max Seat #6 is the button
Seat 1: matiko09 ($100 in chips) 
Seat 2: flk.Dasas ($100 in chips) 
Seat 3: chaps1988 ($158.83 in chips) 
Seat 4: mycka86 ($166.65 in chips) 
Seat 5: Donetsk1y ($100 in chips) 
Seat 6: Kukuryzka ($100 in chips) 
Seat 8: nubpoker ($100 in chips) 
Seat 9: hellig777 ($248.30 in chips) 
CI58 will be allowed to play after the button
nubpoker: posts small blind $0.50
hellig777: posts big blind $1
*** HOLE CARDS ***
Dealt to matiko09 [As Jc]
matiko09: raises $2 to $3
flk.Dasas: folds 
chaps1988: folds 
mycka86: folds 
Donetsk1y: folds 
Kukuryzka: calls $3
nubpoker: folds 
hellig777: calls $2
*** FLOP *** [9c 6d Jh]
hellig777: checks 
matiko09: bets $6
Kukuryzka: calls $6
hellig777: folds 
*** TURN *** [9c 6d Jh] [8s]
matiko09: checks 
Kukuryzka: bets $14.29
matiko09: calls $14.29
*** RIVER *** [9c 6d Jh 8s] [Kd]
matiko09: checks 
Kukuryzka: checks 
*** SHOW DOWN ***
matiko09: shows [As Jc] (a pair of Jacks)
Kukuryzka: shows [6h 6s] (three of a kind, Sixes)
Kukuryzka collected $47.58 from pot
*** SUMMARY ***
Total pot $50.08 | Rake $2.50 
Board [9c 6d Jh 8s Kd]
Seat 1: matiko09 showed [As Jc] and lost with a pair of Jacks
Seat 2: flk.Dasas folded before Flop (didn't bet)
Seat 3: chaps1988 folded before Flop (didn't bet)
Seat 4: mycka86 folded before Flop (didn't bet)
Seat 5: Donetsk1y folded before Flop (didn't bet)
Seat 6: Kukuryzka (button) showed [6h 6s] and won ($47.58) with three of a kind, Sixes
Seat 8: nubpoker (small blind) folded before Flop
Seat 9: hellig777 (big blind) folded on the Flop





PokerStars Hand #153069211459:  Hold'em No Limit ($0.50/$1.00 USD) - 2016/05/09 17:27:41 CET [2016/05/09 11:27:41 ET]
Table 'Merga II' 9-max Seat #9 is the button
Seat 1: R1aki ($102.50 in chips) 
Seat 2: flk.Dasas ($100 in chips) 
Seat 3: 43605511 ($100 in chips) 
Seat 4: erick222 ($100 in chips) 
Seat 5: matiko09 ($100 in chips) 
Seat 6: AlKatrone ($102.68 in chips) 
Seat 7: rusher_NiNja ($215.20 in chips) 
Seat 8: serbianhaze ($128.17 in chips) 
Seat 9: maxxmeister ($123.50 in chips) 
R1aki: posts small blind $0.50
flk.Dasas: posts big blind $1
*** HOLE CARDS ***
Dealt to matiko09 [Jh 7h]
43605511: folds 
erick222: folds 
matiko09: folds 
AlKatrone: folds 
rusher_NiNja: folds 
serbianhaze: raises $2 to $3
maxxmeister: folds 
R1aki: folds 
flk.Dasas: calls $2
*** FLOP *** [Th 7s 5d]
flk.Dasas: checks 
serbianhaze: bets $3
flk.Dasas: folds 
Uncalled bet ($3) returned to serbianhaze
serbianhaze collected $6.18 from pot
*** SUMMARY ***
Total pot $6.50 | Rake $0.32 
Board [Th 7s 5d]
Seat 1: R1aki (small blind) folded before Flop
Seat 2: flk.Dasas (big blind) folded on the Flop
Seat 3: 43605511 folded before Flop (didn't bet)
Seat 4: erick222 folded before Flop (didn't bet)
Seat 5: matiko09 folded before Flop (didn't bet)
Seat 6: AlKatrone folded before Flop (didn't bet)
Seat 7: rusher_NiNja folded before Flop (didn't bet)
Seat 8: serbianhaze collected ($6.18)
Seat 9: maxxmeister (button) folded before Flop (didn't bet)





PokerStars Hand #153069213462:  Hold'em No Limit ($1/$2 USD) - 2016/05/09 17:27:45 CET [2016/05/09 11:27:45 ET]
Table 'Demeter II' 9-max Seat #8 is the button
Seat 1: Sasuke777777 ($184.99 in chips) 
Seat 2: matiko09 ($200 in chips) 
Seat 3: chaps1988 ($218.65 in chips) 
Seat 4: Igoriah ($200 in chips) 
Seat 5: PacPacBum ($227.21 in chips) 
Seat 6: HuanHuan ($200 in chips) 
Seat 7: Siwyosb ($204.31 in chips) 
Seat 8: CI58 ($419.04 in chips) 
RamiroAgujis will be allowed to play after the button
Sasuke777777: posts small blind $1
matiko09: posts big blind $2
*** HOLE CARDS ***
Dealt to matiko09 [Jc Kd]
chaps1988: folds 
Igoriah: folds 
PacPacBum: folds 
HuanHuan: folds 
Siwyosb: folds 
CI58: raises $2.50 to $4.50
Sasuke777777: calls $3.50
matiko09: raises $15.50 to $20
CI58: folds 
Sasuke777777: raises $164.99 to $184.99 and is all-in
matiko09: folds 
Uncalled bet ($164.99) returned to Sasuke777777
Sasuke777777 collected $44.50 from pot
Sasuke777777: doesn't show hand 
*** SUMMARY ***
Total pot $44.50 | Rake $0 
Seat 1: Sasuke777777 (small blind) collected ($44.50)
Seat 2: matiko09 (big blind) folded before Flop
Seat 3: chaps1988 folded before Flop (didn't bet)
Seat 4: Igoriah folded before Flop (didn't bet)
Seat 5: PacPacBum folded before Flop (didn't bet)
Seat 6: HuanHuan folded before Flop (didn't bet)
Seat 7: Siwyosb folded before Flop (didn't bet)
Seat 8: CI58 (button) folded before Flop





PokerStars Hand #153069215111:  Hold'em No Limit ($0.50/$1.00 USD) - 2016/05/09 17:27:47 CET [2016/05/09 11:27:47 ET]
Table 'Orthos' 9-max Seat #5 is the button
Seat 1: Kelvin sai ($94.82 in chips) 
Seat 2: PacPacBum ($101.50 in chips) 
Seat 3: Filojoes ($114.50 in chips) 
Seat 4: nubpoker ($157.37 in chips) 
Seat 5: matiko09 ($139.80 in chips) 
Seat 6: xhinostrabli ($73.61 in chips) 
Seat 7: flk.Dasas ($167.92 in chips) 
Seat 8: Dickyxxx ($103.67 in chips) 
Seat 9: mycka86 ($111.15 in chips) 
xhinostrabli: posts small blind $0.50
flk.Dasas: posts big blind $1
*** HOLE CARDS ***
Dealt to matiko09 [3s 9s]
Dickyxxx: folds 
mycka86: folds 
Kelvin sai: raises $1 to $2
PacPacBum: folds 
Filojoes: folds 
nubpoker: folds 
matiko09: folds 
xhinostrabli: folds 
flk.Dasas: calls $1
*** FLOP *** [6d Td 5s]
flk.Dasas: checks 
Kelvin sai: bets $4.28
flk.Dasas: calls $4.28
*** TURN *** [6d Td 5s] [3c]
flk.Dasas: checks 
Kelvin sai: bets $5
flk.Dasas: calls $5
*** RIVER *** [6d Td 5s 3c] [9c]
flk.Dasas: bets $10.52
Kelvin sai: folds 
Uncalled bet ($10.52) returned to flk.Dasas
flk.Dasas collected $21.91 from pot
flk.Dasas: doesn't show hand 
*** SUMMARY ***
Total pot $23.06 | Rake $1.15 
Board [6d Td 5s 3c 9c]
Seat 1: Kelvin sai folded on the River
Seat 2: PacPacBum folded before Flop (didn't bet)
Seat 3: Filojoes folded before Flop (didn't bet)
Seat 4: nubpoker folded before Flop (didn't bet)
Seat 5: matiko09 (button) folded before Flop (didn't bet)
Seat 6: xhinostrabli (small blind) folded before Flop
Seat 7: flk.Dasas (big blind) collected ($21.91)
Seat 8: Dickyxxx folded before Flop (didn't bet)
Seat 9: mycka86 folded before Flop (didn't bet)





PokerStars Hand #153069222047:  Hold'em No Limit ($0.50/$1.00 USD) - 2016/05/09 17:27:58 CET [2016/05/09 11:27:58 ET]
Table 'Reiss' 9-max Seat #2 is the button
Seat 1: Dickyxxx ($209.41 in chips) 
Seat 2: mycka86 ($184.25 in chips) 
Seat 3: chaps1988 ($122.46 in chips) 
Seat 5: matiko09 ($135.83 in chips) 
Seat 6: HITYESCA ($204.74 in chips) 
Seat 7: nubpoker ($100 in chips) 
Seat 8: JimineyCrik ($101.80 in chips) 
Seat 9: taxi1313 ($80 in chips) 
chaps1988: posts small blind $0.50
CI58: is sitting out 
matiko09: posts big blind $1
taxi1313: posts big blind $1
*** HOLE CARDS ***
Dealt to matiko09 [Ah Jd]
HITYESCA: folds 
nubpoker: folds 
CI58 leaves the table
JimineyCrik: raises $2 to $3
Donetsk1y joins the table at seat #4 
taxi1313: raises $7.50 to $10.50
Dickyxxx: folds 
mycka86: folds 
chaps1988: folds 
matiko09: folds 
JimineyCrik: folds 
Uncalled bet ($7.50) returned to taxi1313
taxi1313 collected $7.50 from pot
taxi1313: doesn't show hand 
*** SUMMARY ***
Total pot $7.50 | Rake $0 
Seat 1: Dickyxxx folded before Flop (didn't bet)
Seat 2: mycka86 (button) folded before Flop (didn't bet)
Seat 3: chaps1988 (small blind) folded before Flop
Seat 5: matiko09 (big blind) folded before Flop
Seat 6: HITYESCA folded before Flop (didn't bet)
Seat 7: nubpoker folded before Flop (didn't bet)
Seat 8: JimineyCrik folded before Flop
Seat 9: taxi1313 collected ($7.50)





PokerStars Hand #153069222656:  Hold'em No Limit ($1/$2 USD) - 2016/05/09 17:27:59 CET [2016/05/09 11:27:59 ET]
Table 'Philagoria II' 9-max Seat #6 is the button
Seat 1: stan_09319 ($200 in chips) 
Seat 2: matiko09 ($200 in chips) 
Seat 3: HuanHuan ($200 in chips) 
Seat 6: I The King I ($300.09 in chips) 
Seat 7: chaps1988 ($200 in chips) 
Seat 9: PacPacBum ($200 in chips) 
chaps1988: posts small blind $1
scop79: is sitting out 
PacPacBum: posts big blind $2
*** HOLE CARDS ***
Dealt to matiko09 [Ah Ac]
stan_09319: folds 
matiko09: raises $3 to $5
scop79 leaves the table
HuanHuan: calls $5
I The King I: folds 
chaps1988: folds 
PacPacBum: folds 
*** FLOP *** [3h 8d Jc]
matiko09: bets $8.03
HuanHuan: folds 
Uncalled bet ($8.03) returned to matiko09
matiko09 collected $12.35 from pot
matiko09: doesn't show hand 
*** SUMMARY ***
Total pot $13 | Rake $0.65 
Board [3h 8d Jc]
Seat 1: stan_09319 folded before Flop (didn't bet)
Seat 2: matiko09 collected ($12.35)
Seat 3: HuanHuan folded on the Flop
Seat 6: I The King I (button) folded before Flop (didn't bet)
Seat 7: chaps1988 (small blind) folded before Flop
Seat 9: PacPacBum (big blind) folded before Flop





PokerStars Hand #153069232691:  Hold'em No Limit ($0.50/$1.00 USD) - 2016/05/09 17:28:15 CET [2016/05/09 11:28:15 ET]
Table 'Merga II' 9-max Seat #1 is the button
Seat 1: R1aki ($102 in chips) 
Seat 2: flk.Dasas ($100 in chips) 
Seat 3: 43605511 ($100 in chips) 
Seat 4: erick222 ($100 in chips) 
Seat 5: matiko09 ($100 in chips) 
Seat 6: AlKatrone ($102.68 in chips) 
Seat 7: rusher_NiNja ($215.20 in chips) 
Seat 8: serbianhaze ($131.35 in chips) 
Seat 9: maxxmeister ($123.50 in chips) 
flk.Dasas: posts small blind $0.50
43605511: posts big blind $1
*** HOLE CARDS ***
Dealt to matiko09 [Kd Ac]
erick222: folds 
matiko09: raises $2 to $3
AlKatrone: calls $3
rusher_NiNja: folds 
serbianhaze: folds 
maxxmeister: folds 
R1aki: folds 
flk.Dasas: folds 
43605511: folds 
*** FLOP *** [2c 7h 8s]
matiko09: checks 
AlKatrone: bets $4.69
matiko09: folds 
Uncalled bet ($4.69) returned to AlKatrone
AlKatrone collected $7.12 from pot
*** SUMMARY ***
Total pot $7.50 | Rake $0.38 
Board [2c 7h 8s]
Seat 1: R1aki (button) folded before Flop (didn't bet)
Seat 2: flk.Dasas (small blind) folded before Flop
Seat 3: 43605511 (big blind) folded before Flop
Seat 4: erick222 folded before Flop (didn't bet)
Seat 5: matiko09 folded on the Flop
Seat 6: AlKatrone collected ($7.12)
Seat 7: rusher_NiNja folded before Flop (didn't bet)
Seat 8: serbianhaze folded before Flop (didn't bet)
Seat 9: maxxmeister folded before Flop (didn't bet)





PokerStars Hand #153069238521:  Hold'em No Limit ($1/$2 USD) - 2016/05/09 17:28:25 CET [2016/05/09 11:28:25 ET]
Table 'Celaeno II' 9-max Seat #8 is the button
Seat 1: LRVAV7 ($200 in chips) 
Seat 2: PacPacBum ($217.81 in chips) 
Seat 3: CI58 ($212.60 in chips) 
Seat 4: matiko09 ($415.28 in chips) 
Seat 6: Igoriah ($243.52 in chips) 
Seat 7: HuanHuan ($217.54 in chips) 
Seat 8: chaps1988 ($210.31 in chips) 
Seat 9: RamiroAgujis ($204.62 in chips) 
RamiroAgujis: posts small blind $1
LRVAV7: posts big blind $2
*** HOLE CARDS ***
Dealt to matiko09 [8c 8h]
PacPacBum: folds 
CI58: folds 
matiko09: raises $3 to $5
Igoriah: folds 
HuanHuan: folds 
chaps1988: folds 
RamiroAgujis: folds 
LRVAV7: folds 
Uncalled bet ($3) returned to matiko09
matiko09 collected $5 from pot
matiko09: doesn't show hand 
*** SUMMARY ***
Total pot $5 | Rake $0 
Seat 1: LRVAV7 (big blind) folded before Flop
Seat 2: PacPacBum folded before Flop (didn't bet)
Seat 3: CI58 folded before Flop (didn't bet)
Seat 4: matiko09 collected ($5)
Seat 6: Igoriah folded before Flop (didn't bet)
Seat 7: HuanHuan folded before Flop (didn't bet)
Seat 8: chaps1988 (button) folded before Flop (didn't bet)
Seat 9: RamiroAgujis (small blind) folded before Flop





PokerStars Hand #153069243128:  Hold'em No Limit ($1/$2 USD) - 2016/05/09 17:28:32 CET [2016/05/09 11:28:32 ET]
Table 'Demeter II' 9-max Seat #1 is the button
Seat 1: Sasuke777777 ($209.49 in chips) 
Seat 2: matiko09 ($200 in chips) 
Seat 3: chaps1988 ($218.65 in chips) 
Seat 4: Igoriah ($200 in chips) 
Seat 5: PacPacBum ($227.21 in chips) 
Seat 6: HuanHuan ($200 in chips) 
Seat 7: Siwyosb ($204.31 in chips) 
Seat 8: CI58 ($414.54 in chips) 
matiko09: posts small blind $1
chaps1988: posts big blind $2
RamiroAgujis: sits out 
*** HOLE CARDS ***
Dealt to matiko09 [6s As]
Igoriah: folds 
PacPacBum: folds 
HuanHuan: folds 
Siwyosb: raises $2 to $4
CI58: folds 
Sasuke777777: folds 
Sasuke777777 leaves the table
matiko09: folds 
chaps1988: folds 
Uncalled bet ($2) returned to Siwyosb
Siwyosb collected $5 from pot
*** SUMMARY ***
Total pot $5 | Rake $0 
Seat 1: Sasuke777777 (button) folded before Flop (didn't bet)
Seat 2: matiko09 (small blind) folded before Flop
Seat 3: chaps1988 (big blind) folded before Flop
Seat 4: Igoriah folded before Flop (didn't bet)
Seat 5: PacPacBum folded before Flop (didn't bet)
Seat 6: HuanHuan folded before Flop (didn't bet)
Seat 7: Siwyosb collected ($5)
Seat 8: CI58 folded before Flop (didn't bet)





PokerStars Hand #153069245577:  Hold'em No Limit ($0.50/$1.00 USD) - 2016/05/09 17:28:36 CET [2016/05/09 11:28:36 ET]
Table 'Reiss' 9-max Seat #3 is the button
Seat 1: Dickyxxx ($209.41 in chips) 
Seat 2: mycka86 ($184.25 in chips) 
Seat 3: chaps1988 ($121.96 in chips) 
Seat 5: matiko09 ($134.83 in chips) 
Seat 6: HITYESCA ($204.74 in chips) 
Seat 7: nubpoker ($100 in chips) 
Seat 8: JimineyCrik ($100 in chips) 
Seat 9: taxi1313 ($84.50 in chips) 
Donetsk1y will be allowed to play after the button
matiko09: posts small blind $0.50
HITYESCA: posts big blind $1
*** HOLE CARDS ***
Dealt to matiko09 [Ks 2d]
nubpoker: folds 
JimineyCrik: folds 
taxi1313: folds 
Dickyxxx: folds 
mycka86: folds 
chaps1988: folds 
matiko09: folds 
Uncalled bet ($0.50) returned to HITYESCA
HITYESCA collected $1 from pot
HITYESCA: doesn't show hand 
*** SUMMARY ***
Total pot $1 | Rake $0 
Seat 1: Dickyxxx folded before Flop (didn't bet)
Seat 2: mycka86 folded before Flop (didn't bet)
Seat 3: chaps1988 (button) folded before Flop (didn't bet)
Seat 5: matiko09 (small blind) folded before Flop
Seat 6: HITYESCA (big blind) collected ($1)
Seat 7: nubpoker folded before Flop (didn't bet)
Seat 8: JimineyCrik folded before Flop (didn't bet)
Seat 9: taxi1313 folded before Flop (didn't bet)





PokerStars Hand #153069251162:  Hold'em No Limit ($1/$2 USD) - 2016/05/09 17:28:45 CET [2016/05/09 11:28:45 ET]
Table 'Hagar II' 9-max Seat #9 is the button
Seat 1: CI58 ($200 in chips) 
Seat 2: darren1031 ($322.21 in chips) 
Seat 3: Sasuke777777 ($151.19 in chips) 
Seat 4: matiko09 ($430.49 in chips) 
Seat 5: PacPacBum ($231.39 in chips) 
Seat 6: el Fatto ($221.03 in chips) 
Seat 7: Monsthand ($313.12 in chips) 
Seat 8: Igoriah ($206.40 in chips) 
Seat 9: chaps1988 ($367.97 in chips) 
CI58: posts small blind $1
darren1031: posts big blind $2
*** HOLE CARDS ***
Dealt to matiko09 [Ad 3s]
Sasuke777777: folds 
matiko09: folds 
PacPacBum: folds 
el Fatto: folds 
Monsthand: folds 
Igoriah: folds 
chaps1988: folds 
CI58: folds 
Uncalled bet ($1) returned to darren1031
darren1031 collected $2 from pot
darren1031: doesn't show hand 
*** SUMMARY ***
Total pot $2 | Rake $0 
Seat 1: CI58 (small blind) folded before Flop
Seat 2: darren1031 (big blind) collected ($2)
Seat 3: Sasuke777777 folded before Flop (didn't bet)
Seat 4: matiko09 folded before Flop (didn't bet)
Seat 5: PacPacBum folded before Flop (didn't bet)
Seat 6: el Fatto folded before Flop (didn't bet)
Seat 7: Monsthand folded before Flop (didn't bet)
Seat 8: Igoriah folded before Flop (didn't bet)
Seat 9: chaps1988 (button) folded before Flop (didn't bet)





PokerStars Hand #153069254355:  Hold'em No Limit ($0.50/$1.00 USD) - 2016/05/09 17:28:50 CET [2016/05/09 11:28:50 ET]
Table 'Reiss' 9-max Seat #5 is the button
Seat 1: Dickyxxx ($209.41 in chips) 
Seat 2: mycka86 ($184.25 in chips) 
Seat 3: chaps1988 ($121.96 in chips) 
Seat 5: matiko09 ($134.33 in chips) 
Seat 6: HITYESCA ($205.24 in chips) 
Seat 7: nubpoker ($100 in chips) 
Seat 8: JimineyCrik ($100 in chips) 
Seat 9: taxi1313 ($84.50 in chips) 
HITYESCA: posts small blind $0.50
nubpoker: posts big blind $1
Donetsk1y: sits out 
*** HOLE CARDS ***
Dealt to matiko09 [Qh Qs]
JimineyCrik: folds 
taxi1313: folds 
Dickyxxx: folds 
mycka86: folds 
chaps1988: folds 
matiko09: raises $1.27 to $2.27
HITYESCA: folds 
nubpoker: calls $1.27
*** FLOP *** [3c As 7h]
nubpoker: checks 
matiko09: checks 
*** TURN *** [3c As 7h] [6c]
nubpoker: checks 
matiko09: bets $2.49
nubpoker: folds 
Uncalled bet ($2.49) returned to matiko09
matiko09 collected $4.79 from pot
matiko09: doesn't show hand 
*** SUMMARY ***
Total pot $5.04 | Rake $0.25 
Board [3c As 7h 6c]
Seat 1: Dickyxxx folded before Flop (didn't bet)
Seat 2: mycka86 folded before Flop (didn't bet)
Seat 3: chaps1988 folded before Flop (didn't bet)
Seat 5: matiko09 (button) collected ($4.79)
Seat 6: HITYESCA (small blind) folded before Flop
Seat 7: nubpoker (big blind) folded on the Turn
Seat 8: JimineyCrik folded before Flop (didn't bet)
Seat 9: taxi1313 folded before Flop (didn't bet)





PokerStars Hand #153069256884:  Hold'em No Limit ($0.50/$1.00 USD) - 2016/05/09 17:28:54 CET [2016/05/09 11:28:54 ET]
Table 'Odyssey' 9-max Seat #8 is the button
Seat 1: matiko09 ($100 in chips) 
Seat 2: flk.Dasas ($100 in chips) 
Seat 3: chaps1988 ($158.83 in chips) 
Seat 4: mycka86 ($166.65 in chips) 
Seat 5: Donetsk1y ($100 in chips) 
Seat 6: Kukuryzka ($124.29 in chips) 
Seat 8: nubpoker ($100 in chips) 
Seat 9: hellig777 ($245.30 in chips) 
hellig777: posts small blind $0.50
matiko09: posts big blind $1
CI58: sits out 
*** HOLE CARDS ***
Dealt to matiko09 [7c 7s]
flk.Dasas: raises $2 to $3
chaps1988: folds 
mycka86: folds 
Donetsk1y: calls $3
Kukuryzka: folds 
nubpoker: folds 
hellig777: folds 
matiko09: calls $2
*** FLOP *** [Kd Jc 7d]
matiko09: bets $6
flk.Dasas: calls $6
Donetsk1y: folds 
*** TURN *** [Kd Jc 7d] [4d]
matiko09: bets $14
flk.Dasas: folds 
Uncalled bet ($14) returned to matiko09
matiko09 collected $20.42 from pot
matiko09: doesn't show hand 
*** SUMMARY ***
Total pot $21.50 | Rake $1.08 
Board [Kd Jc 7d 4d]
Seat 1: matiko09 (big blind) collected ($20.42)
Seat 2: flk.Dasas folded on the Turn
Seat 3: chaps1988 folded before Flop (didn't bet)
Seat 4: mycka86 folded before Flop (didn't bet)
Seat 5: Donetsk1y folded on the Flop
Seat 6: Kukuryzka folded before Flop (didn't bet)
Seat 8: nubpoker (button) folded before Flop (didn't bet)
Seat 9: hellig777 (small blind) folded before Flop





PokerStars Hand #153069260763:  Hold'em No Limit ($1/$2 USD) - 2016/05/09 17:29:00 CET [2016/05/09 11:29:00 ET]
Table 'Demeter II' 9-max Seat #2 is the button
Seat 2: matiko09 ($200 in chips) 
Seat 3: chaps1988 ($216.65 in chips) 
Seat 4: Igoriah ($200 in chips) 
Seat 5: PacPacBum ($227.21 in chips) 
Seat 6: HuanHuan ($200 in chips) 
Seat 7: Siwyosb ($207.31 in chips) 
Seat 8: CI58 ($414.54 in chips) 
chaps1988: posts small blind $1
Igoriah: posts big blind $2
RamiroAgujis: sits out 
*** HOLE CARDS ***
Dealt to matiko09 [6s 4s]
scop79 joins the table at seat #1 
PacPacBum: folds 
HuanHuan: folds 
scop79 leaves the table
Siwyosb: folds 
CI58: folds 
matiko09: folds 
chaps1988: raises $4 to $6
Igoriah: calls $4
*** FLOP *** [3h Th 8s]
chaps1988: bets $6.50
Igoriah: calls $6.50
*** TURN *** [3h Th 8s] [3s]
chaps1988: bets $17.50
Igoriah: raises $26.50 to $44
chaps1988: calls $26.50
*** RIVER *** [3h Th 8s 3s] [3d]
chaps1988: checks 
Igoriah: checks 
*** SHOW DOWN ***
chaps1988: shows [Qc Qh] (a full house, Threes full of Queens)
Igoriah: mucks hand 
chaps1988 collected $110.25 from pot
*** SUMMARY ***
Total pot $113 | Rake $2.75 
Board [3h Th 8s 3s 3d]
Seat 2: matiko09 (button) folded before Flop (didn't bet)
Seat 3: chaps1988 (small blind) showed [Qc Qh] and won ($110.25) with a full house, Threes full of Queens
Seat 4: Igoriah (big blind) mucked [Ac 8d]
Seat 5: PacPacBum folded before Flop (didn't bet)
Seat 6: HuanHuan folded before Flop (didn't bet)
Seat 7: Siwyosb folded before Flop (didn't bet)
Seat 8: CI58 folded before Flop (didn't bet)





PokerStars Hand #153069262200:  Hold'em No Limit ($0.50/$1.00 USD) - 2016/05/09 17:29:02 CET [2016/05/09 11:29:02 ET]
Table 'Terpsichore' 9-max Seat #8 is the button
Seat 1: Donetsk1y ($100 in chips) 
Seat 2: CI58 ($105.92 in chips) 
Seat 3: matiko09 ($147.89 in chips) 
Seat 4: nubpoker ($113.48 in chips) 
Seat 5: mycka86 ($266.74 in chips) 
Seat 6: Filojoes ($134.90 in chips) 
Seat 7: Kukuryzka ($100 in chips) 
Seat 8: Kiosk230472 ($105.16 in chips) 
Seat 9: flk.Dasas ($100 in chips) 
flk.Dasas: posts small blind $0.50
Donetsk1y: posts big blind $1
*** HOLE CARDS ***
Dealt to matiko09 [Kh Kd]
CI58: folds 
matiko09: raises $2 to $3
nubpoker: folds 
mycka86: folds 
Filojoes: folds 
Kukuryzka: folds 
Kiosk230472: folds 
flk.Dasas: folds 
Donetsk1y: folds 
Uncalled bet ($2) returned to matiko09
matiko09 collected $2.50 from pot
matiko09: doesn't show hand 
*** SUMMARY ***
Total pot $2.50 | Rake $0 
Seat 1: Donetsk1y (big blind) folded before Flop
Seat 2: CI58 folded before Flop (didn't bet)
Seat 3: matiko09 collected ($2.50)
Seat 4: nubpoker folded before Flop (didn't bet)
Seat 5: mycka86 folded before Flop (didn't bet)
Seat 6: Filojoes folded before Flop (didn't bet)
Seat 7: Kukuryzka folded before Flop (didn't bet)
Seat 8: Kiosk230472 (button) folded before Flop (didn't bet)
Seat 9: flk.Dasas (small blind) folded before Flop





PokerStars Hand #153069264160:  Hold'em No Limit ($1/$2 USD) - 2016/05/09 17:29:05 CET [2016/05/09 11:29:05 ET]
Table 'Celaeno II' 9-max Seat #9 is the button
Seat 1: LRVAV7 ($200 in chips) 
Seat 2: PacPacBum ($217.81 in chips) 
Seat 3: CI58 ($212.60 in chips) 
Seat 4: matiko09 ($418.28 in chips) 
Seat 6: Igoriah ($243.52 in chips) 
Seat 7: HuanHuan ($217.54 in chips) 
Seat 8: chaps1988 ($210.31 in chips) 
Seat 9: RamiroAgujis ($203.62 in chips) 
LRVAV7: posts small blind $1
PacPacBum: posts big blind $2
*** HOLE CARDS ***
Dealt to matiko09 [5d Qd]
CI58: folds 
matiko09: folds 
Igoriah: raises $3 to $5
HuanHuan: folds 
chaps1988: folds 
RamiroAgujis: folds 
LRVAV7: folds 
PacPacBum: folds 
Uncalled bet ($3) returned to Igoriah
Igoriah collected $5 from pot
Igoriah: doesn't show hand 
*** SUMMARY ***
Total pot $5 | Rake $0 
Seat 1: LRVAV7 (small blind) folded before Flop
Seat 2: PacPacBum (big blind) folded before Flop
Seat 3: CI58 folded before Flop (didn't bet)
Seat 4: matiko09 folded before Flop (didn't bet)
Seat 6: Igoriah collected ($5)
Seat 7: HuanHuan folded before Flop (didn't bet)
Seat 8: chaps1988 folded before Flop (didn't bet)
Seat 9: RamiroAgujis (button) folded before Flop (didn't bet)





PokerStars Hand #153069265648:  Hold'em No Limit ($1/$2 USD) - 2016/05/09 17:29:08 CET [2016/05/09 11:29:08 ET]
Table 'Hagar II' 9-max Seat #1 is the button
Seat 1: CI58 ($200 in chips) 
Seat 2: darren1031 ($323.21 in chips) 
Seat 3: Sasuke777777 ($151.19 in chips) 
Seat 4: matiko09 ($430.49 in chips) 
Seat 5: PacPacBum ($231.39 in chips) 
Seat 6: el Fatto ($221.03 in chips) 
Seat 7: Monsthand ($313.12 in chips) 
Seat 8: Igoriah ($206.40 in chips) 
Seat 9: chaps1988 ($367.97 in chips) 
darren1031: posts small blind $1
Sasuke777777: posts big blind $2
*** HOLE CARDS ***
Dealt to matiko09 [Jc 8c]
matiko09: folds 
PacPacBum: folds 
el Fatto: folds 
Monsthand: folds 
Igoriah: folds 
chaps1988: folds 
CI58: folds 
darren1031: folds 
Uncalled bet ($1) returned to Sasuke777777
Sasuke777777 collected $2 from pot
Sasuke777777: doesn't show hand 
*** SUMMARY ***
Total pot $2 | Rake $0 
Seat 1: CI58 (button) folded before Flop (didn't bet)
Seat 2: darren1031 (small blind) folded before Flop
Seat 3: Sasuke777777 (big blind) collected ($2)
Seat 4: matiko09 folded before Flop (didn't bet)
Seat 5: PacPacBum folded before Flop (didn't bet)
Seat 6: el Fatto folded before Flop (didn't bet)
Seat 7: Monsthand folded before Flop (didn't bet)
Seat 8: Igoriah folded before Flop (didn't bet)
Seat 9: chaps1988 folded before Flop (didn't bet)





PokerStars Hand #153069280808:  Hold'em No Limit ($1/$2 USD) - 2016/05/09 17:29:32 CET [2016/05/09 11:29:32 ET]
Table 'Hagar II' 9-max Seat #2 is the button
Seat 1: CI58 ($200 in chips) 
Seat 2: darren1031 ($322.21 in chips) 
Seat 3: Sasuke777777 ($152.19 in chips) 
Seat 4: matiko09 ($430.49 in chips) 
Seat 5: PacPacBum ($231.39 in chips) 
Seat 6: el Fatto ($221.03 in chips) 
Seat 7: Monsthand ($313.12 in chips) 
Seat 8: Igoriah ($206.40 in chips) 
Seat 9: chaps1988 ($367.97 in chips) 
Sasuke777777: posts small blind $1
matiko09: posts big blind $2
*** HOLE CARDS ***
Dealt to matiko09 [7h 6h]
PacPacBum: folds 
el Fatto: folds 
Monsthand: raises $3.40 to $5.40
Igoriah: folds 
chaps1988: calls $5.40
CI58: folds 
darren1031: folds 
Sasuke777777: calls $4.40
matiko09: calls $3.40
*** FLOP *** [7s 3s Qh]
Sasuke777777: checks 
matiko09: checks 
Monsthand: checks 
chaps1988: bets $5
Sasuke777777: folds 
matiko09: calls $5
Sasuke777777 leaves the table
Monsthand: folds 
*** TURN *** [7s 3s Qh] [2c]
matiko09: checks 
chaps1988: checks 
*** RIVER *** [7s 3s Qh 2c] [Qd]
matiko09: checks 
chaps1988: checks 
*** SHOW DOWN ***
matiko09: shows [7h 6h] (two pair, Queens and Sevens)
chaps1988: shows [8h 8c] (two pair, Queens and Eights)
chaps1988 collected $30.02 from pot
*** SUMMARY ***
Total pot $31.60 | Rake $1.58 
Board [7s 3s Qh 2c Qd]
Seat 1: CI58 folded before Flop (didn't bet)
Seat 2: darren1031 (button) folded before Flop (didn't bet)
Seat 3: Sasuke777777 (small blind) folded on the Flop
Seat 4: matiko09 (big blind) showed [7h 6h] and lost with two pair, Queens and Sevens
Seat 5: PacPacBum folded before Flop (didn't bet)
Seat 6: el Fatto folded before Flop (didn't bet)
Seat 7: Monsthand folded on the Flop
Seat 8: Igoriah folded before Flop (didn't bet)
Seat 9: chaps1988 showed [8h 8c] and won ($30.02) with two pair, Queens and Eights





PokerStars Hand #153069280782:  Hold'em No Limit ($1/$2 USD) - 2016/05/09 17:29:32 CET [2016/05/09 11:29:32 ET]
Table 'Celaeno II' 9-max Seat #1 is the button
Seat 1: LRVAV7 ($200 in chips) 
Seat 2: PacPacBum ($215.81 in chips) 
Seat 3: CI58 ($212.60 in chips) 
Seat 4: matiko09 ($418.28 in chips) 
Seat 6: Igoriah ($246.52 in chips) 
Seat 7: HuanHuan ($217.54 in chips) 
Seat 8: chaps1988 ($210.31 in chips) 
Seat 9: RamiroAgujis ($203.62 in chips) 
PacPacBum: posts small blind $1
CI58: posts big blind $2
*** HOLE CARDS ***
Dealt to matiko09 [2h Js]
matiko09: folds 
Igoriah: folds 
HuanHuan: raises $3 to $5
chaps1988: folds 
RamiroAgujis: folds 
LRVAV7: calls $5
PacPacBum: folds 
CI58: folds 
*** FLOP *** [9h 3s 5h]
HuanHuan: bets $7.42
LRVAV7: calls $7.42
*** TURN *** [9h 3s 5h] [4c]
HuanHuan: bets $19
LRVAV7: raises $19 to $38
HuanHuan: calls $19
*** RIVER *** [9h 3s 5h 4c] [Qs]
HuanHuan: checks 
KovIFish89 joins the table at seat #5 
LRVAV7: bets $68
HuanHuan: folds 
Uncalled bet ($68) returned to LRVAV7
LRVAV7 collected $101.09 from pot
LRVAV7: doesn't show hand 
*** SUMMARY ***
Total pot $103.84 | Rake $2.75 
Board [9h 3s 5h 4c Qs]
Seat 1: LRVAV7 (button) collected ($101.09)
Seat 2: PacPacBum (small blind) folded before Flop
Seat 3: CI58 (big blind) folded before Flop
Seat 4: matiko09 folded before Flop (didn't bet)
Seat 6: Igoriah folded before Flop (didn't bet)
Seat 7: HuanHuan folded on the River
Seat 8: chaps1988 folded before Flop (didn't bet)
Seat 9: RamiroAgujis folded before Flop (didn't bet)





PokerStars Hand #153069285627:  Hold'em No Limit ($0.50/$1.00 USD) - 2016/05/09 17:29:40 CET [2016/05/09 11:29:40 ET]
Table 'Terpsichore' 9-max Seat #9 is the button
Seat 1: Donetsk1y ($100 in chips) 
Seat 2: CI58 ($105.92 in chips) 
Seat 3: matiko09 ($149.39 in chips) 
Seat 4: nubpoker ($113.48 in chips) 
Seat 5: mycka86 ($266.74 in chips) 
Seat 6: Filojoes ($134.90 in chips) 
Seat 7: Kukuryzka ($100 in chips) 
Seat 8: Kiosk230472 ($105.16 in chips) 
Seat 9: flk.Dasas ($100 in chips) 
Donetsk1y: posts small blind $0.50
CI58: posts big blind $1
*** HOLE CARDS ***
Dealt to matiko09 [2d 6c]
matiko09: folds 
nubpoker: folds 
mycka86: folds 
Filojoes: folds 
Kukuryzka: raises $2 to $3
Kiosk230472: folds 
flk.Dasas: folds 
Donetsk1y: folds 
CI58: folds 
Uncalled bet ($2) returned to Kukuryzka
Kukuryzka collected $2.50 from pot
Kukuryzka: doesn't show hand 
*** SUMMARY ***
Total pot $2.50 | Rake $0 
Seat 1: Donetsk1y (small blind) folded before Flop
Seat 2: CI58 (big blind) folded before Flop
Seat 3: matiko09 folded before Flop (didn't bet)
Seat 4: nubpoker folded before Flop (didn't bet)
Seat 5: mycka86 folded before Flop (didn't bet)
Seat 6: Filojoes folded before Flop (didn't bet)
Seat 7: Kukuryzka collected ($2.50)
Seat 8: Kiosk230472 folded before Flop (didn't bet)
Seat 9: flk.Dasas (button) folded before Flop (didn't bet)





PokerStars Hand #153069293441:  Hold'em No Limit ($0.50/$1.00 USD) - 2016/05/09 17:29:52 CET [2016/05/09 11:29:52 ET]
Table 'Reiss' 9-max Seat #6 is the button
Seat 1: Dickyxxx ($209.41 in chips) 
Seat 2: mycka86 ($184.25 in chips) 
Seat 3: chaps1988 ($121.96 in chips) 
Seat 5: matiko09 ($136.85 in chips) 
Seat 6: HITYESCA ($204.74 in chips) 
Seat 7: nubpoker ($100 in chips) 
Seat 8: JimineyCrik ($100 in chips) 
Seat 9: taxi1313 ($84.50 in chips) 
nubpoker: posts small blind $0.50
JimineyCrik: posts big blind $1
Donetsk1y: sits out 
*** HOLE CARDS ***
Dealt to matiko09 [Tc 3d]
taxi1313: calls $1
Dickyxxx: folds 
mycka86: raises $3.50 to $4.50
chaps1988: folds 
matiko09: folds 
HITYESCA: folds 
nubpoker: folds 
JimineyCrik: folds 
taxi1313: calls $3.50
*** FLOP *** [2h Qs 7c]
taxi1313: checks 
mycka86: bets $5.48
taxi1313: calls $5.48
*** TURN *** [2h Qs 7c] [4d]
taxi1313: checks 
mycka86: checks 
*** RIVER *** [2h Qs 7c 4d] [2c]
taxi1313: bets $20
mycka86: folds 
Uncalled bet ($20) returned to taxi1313
taxi1313 collected $20.39 from pot
taxi1313: doesn't show hand 
*** SUMMARY ***
Total pot $21.46 | Rake $1.07 
Board [2h Qs 7c 4d 2c]
Seat 1: Dickyxxx folded before Flop (didn't bet)
Seat 2: mycka86 folded on the River
Seat 3: chaps1988 folded before Flop (didn't bet)
Seat 5: matiko09 folded before Flop (didn't bet)
Seat 6: HITYESCA (button) folded before Flop (didn't bet)
Seat 7: nubpoker (small blind) folded before Flop
Seat 8: JimineyCrik (big blind) folded before Flop
Seat 9: taxi1313 collected ($20.39)





PokerStars Hand #153069309288:  Hold'em No Limit ($0.50/$1.00 USD) - 2016/05/09 17:30:16 CET [2016/05/09 11:30:16 ET]
Table 'Terpsichore' 9-max Seat #1 is the button
Seat 1: Donetsk1y ($100 in chips) 
Seat 2: CI58 ($104.92 in chips) 
Seat 3: matiko09 ($149.39 in chips) 
Seat 4: nubpoker ($113.48 in chips) 
Seat 5: mycka86 ($266.74 in chips) 
Seat 6: Filojoes ($134.90 in chips) 
Seat 7: Kukuryzka ($101.50 in chips) 
Seat 8: Kiosk230472 ($105.16 in chips) 
Seat 9: flk.Dasas ($100 in chips) 
CI58: posts small blind $0.50
matiko09: posts big blind $1
*** HOLE CARDS ***
Dealt to matiko09 [Kh 4c]
nubpoker: folds 
mycka86: folds 
Filojoes: folds 
Kukuryzka: folds 
Kiosk230472: calls $1
flk.Dasas: folds 
Donetsk1y: folds 
CI58: folds 
matiko09: checks 
*** FLOP *** [3d 2s 6h]
matiko09: checks 
Kiosk230472: checks 
*** TURN *** [3d 2s 6h] [Qd]
matiko09: checks 
Kiosk230472: checks 
*** RIVER *** [3d 2s 6h Qd] [5c]
matiko09: checks 
Kiosk230472: checks 
*** SHOW DOWN ***
matiko09: shows [Kh 4c] (a straight, Deuce to Six)
Kiosk230472: mucks hand 
matiko09 collected $2.38 from pot
*** SUMMARY ***
Total pot $2.50 | Rake $0.12 
Board [3d 2s 6h Qd 5c]
Seat 1: Donetsk1y (button) folded before Flop (didn't bet)
Seat 2: CI58 (small blind) folded before Flop
Seat 3: matiko09 (big blind) showed [Kh 4c] and won ($2.38) with a straight, Deuce to Six
Seat 4: nubpoker folded before Flop (didn't bet)
Seat 5: mycka86 folded before Flop (didn't bet)
Seat 6: Filojoes folded before Flop (didn't bet)
Seat 7: Kukuryzka folded before Flop (didn't bet)
Seat 8: Kiosk230472 mucked [8h Ad]
Seat 9: flk.Dasas folded before Flop (didn't bet)





PokerStars Hand #153069314995:  Hold'em No Limit ($0.50/$1.00 USD) - 2016/05/09 17:30:25 CET [2016/05/09 11:30:25 ET]
Table 'Odyssey' 9-max Seat #9 is the button
Seat 1: matiko09 ($111.42 in chips) 
Seat 2: flk.Dasas ($100 in chips) 
Seat 3: chaps1988 ($158.83 in chips) 
Seat 4: mycka86 ($166.65 in chips) 
Seat 5: Donetsk1y ($100 in chips) 
Seat 6: Kukuryzka ($124.29 in chips) 
Seat 8: nubpoker ($100 in chips) 
Seat 9: hellig777 ($244.80 in chips) 
matiko09: posts small blind $0.50
flk.Dasas: posts big blind $1
CI58: sits out 
*** HOLE CARDS ***
Dealt to matiko09 [Jc Ts]
chaps1988: folds 
mycka86: folds 
Donetsk1y: folds 
Kukuryzka: folds 
nubpoker: folds 
hellig777: raises $1 to $2
matiko09: folds 
flk.Dasas: calls $1
*** FLOP *** [Jh Ac Qc]
flk.Dasas: checks 
hellig777: bets $2.14
flk.Dasas: calls $2.14
*** TURN *** [Jh Ac Qc] [6c]
flk.Dasas: checks 
hellig777: checks 
*** RIVER *** [Jh Ac Qc 6c] [6h]
flk.Dasas: bets $5
hellig777: calls $5
*** SHOW DOWN ***
flk.Dasas: shows [As 5h] (two pair, Aces and Sixes)
hellig777: shows [Ad 2s] (two pair, Aces and Sixes)
flk.Dasas collected $8.92 from pot
hellig777 collected $8.92 from pot
*** SUMMARY ***
Total pot $18.78 | Rake $0.94 
Board [Jh Ac Qc 6c 6h]
Seat 1: matiko09 (small blind) folded before Flop
Seat 2: flk.Dasas (big blind) showed [As 5h] and won ($8.92) with two pair, Aces and Sixes
Seat 3: chaps1988 folded before Flop (didn't bet)
Seat 4: mycka86 folded before Flop (didn't bet)
Seat 5: Donetsk1y folded before Flop (didn't bet)
Seat 6: Kukuryzka folded before Flop (didn't bet)
Seat 8: nubpoker folded before Flop (didn't bet)
Seat 9: hellig777 (button) showed [Ad 2s] and won ($8.92) with two pair, Aces and Sixes





PokerStars Hand #153069317944:  Hold'em No Limit ($0.50/$1.00 USD) - 2016/05/09 17:30:30 CET [2016/05/09 11:30:30 ET]
Table 'Orthos' 9-max Seat #6 is the button
Seat 1: Kelvin sai ($83.54 in chips) 
Seat 2: PacPacBum ($101.50 in chips) 
Seat 3: Filojoes ($114.50 in chips) 
Seat 4: nubpoker ($157.37 in chips) 
Seat 5: matiko09 ($139.80 in chips) 
Seat 6: xhinostrabli ($73.11 in chips) 
Seat 7: flk.Dasas ($178.55 in chips) 
Seat 8: Dickyxxx ($103.67 in chips) 
Seat 9: mycka86 ($111.15 in chips) 
flk.Dasas: posts small blind $0.50
Dickyxxx: posts big blind $1
*** HOLE CARDS ***
Dealt to matiko09 [9h Th]
mycka86: folds 
Kelvin sai: folds 
PacPacBum: raises $1.04 to $2.04
Filojoes: folds 
nubpoker: folds 
matiko09: calls $2.04
xhinostrabli: folds 
flk.Dasas: folds 
Dickyxxx: folds 
*** FLOP *** [6h 6c 2h]
PacPacBum: checks 
matiko09: bets $3.45
PacPacBum: folds 
Uncalled bet ($3.45) returned to matiko09
matiko09 collected $5.30 from pot
matiko09: doesn't show hand 
*** SUMMARY ***
Total pot $5.58 | Rake $0.28 
Board [6h 6c 2h]
Seat 1: Kelvin sai folded before Flop (didn't bet)
Seat 2: PacPacBum folded on the Flop
Seat 3: Filojoes folded before Flop (didn't bet)
Seat 4: nubpoker folded before Flop (didn't bet)
Seat 5: matiko09 collected ($5.30)
Seat 6: xhinostrabli (button) folded before Flop (didn't bet)
Seat 7: flk.Dasas (small blind) folded before Flop
Seat 8: Dickyxxx (big blind) folded before Flop
Seat 9: mycka86 folded before Flop (didn't bet)





PokerStars Hand #153069322866:  Hold'em No Limit ($1/$2 USD) - 2016/05/09 17:30:38 CET [2016/05/09 11:30:38 ET]
Table 'Demeter II' 9-max Seat #3 is the button
Seat 2: matiko09 ($200 in chips) 
Seat 3: chaps1988 ($270.40 in chips) 
Seat 4: Igoriah ($200 in chips) 
Seat 5: PacPacBum ($227.21 in chips) 
Seat 6: HuanHuan ($200 in chips) 
Seat 7: Siwyosb ($207.31 in chips) 
Seat 8: CI58 ($414.54 in chips) 
Igoriah: posts small blind $1
PacPacBum: posts big blind $2
RamiroAgujis: sits out 
*** HOLE CARDS ***
Dealt to matiko09 [Qh Ac]
HuanHuan: folds 
Siwyosb: folds 
CI58: raises $4 to $6
matiko09: calls $6
chaps1988: folds 
KovIFish89 joins the table at seat #1 
Igoriah: calls $5
PacPacBum: folds 
*** FLOP *** [8c 7c 2d]
Igoriah: checks 
CI58: bets $10
matiko09: raises $20 to $30
Igoriah: folds 
CI58: calls $20
*** TURN *** [8c 7c 2d] [4d]
CI58: checks 
matiko09: checks 
*** RIVER *** [8c 7c 2d 4d] [8h]
CI58: bets $30.90
matiko09: folds 
Uncalled bet ($30.90) returned to CI58
CI58 collected $77.25 from pot
CI58: doesn't show hand 
*** SUMMARY ***
Total pot $80 | Rake $2.75 
Board [8c 7c 2d 4d 8h]
Seat 2: matiko09 folded on the River
Seat 3: chaps1988 (button) folded before Flop (didn't bet)
Seat 4: Igoriah (small blind) folded on the Flop
Seat 5: PacPacBum (big blind) folded before Flop
Seat 6: HuanHuan folded before Flop (didn't bet)
Seat 7: Siwyosb folded before Flop (didn't bet)
Seat 8: CI58 collected ($77.25)





PokerStars Hand #153069336275:  Hold'em No Limit ($1/$2 USD) - 2016/05/09 17:30:59 CET [2016/05/09 11:30:59 ET]
Table 'Celaeno II' 9-max Seat #2 is the button
Seat 1: LRVAV7 ($250.67 in chips) 
Seat 2: PacPacBum ($214.81 in chips) 
Seat 3: CI58 ($210.60 in chips) 
Seat 4: matiko09 ($418.28 in chips) 
Seat 6: Igoriah ($246.52 in chips) 
Seat 7: HuanHuan ($200 in chips) 
Seat 8: chaps1988 ($210.31 in chips) 
Seat 9: RamiroAgujis ($203.62 in chips) 
CI58: posts small blind $1
matiko09: posts big blind $2
KovIFish89: sits out 
*** HOLE CARDS ***
Dealt to matiko09 [3c 2s]
Igoriah: folds 
HuanHuan: raises $4 to $6
chaps1988: folds 
RamiroAgujis: folds 
LRVAV7: folds 
PacPacBum: folds 
CI58: folds 
matiko09: folds 
Uncalled bet ($4) returned to HuanHuan
HuanHuan collected $5 from pot
HuanHuan: doesn't show hand 
*** SUMMARY ***
Total pot $5 | Rake $0 
Seat 1: LRVAV7 folded before Flop (didn't bet)
Seat 2: PacPacBum (button) folded before Flop (didn't bet)
Seat 3: CI58 (small blind) folded before Flop
Seat 4: matiko09 (big blind) folded before Flop
Seat 6: Igoriah folded before Flop (didn't bet)
Seat 7: HuanHuan collected ($5)
Seat 8: chaps1988 folded before Flop (didn't bet)
Seat 9: RamiroAgujis folded before Flop (didn't bet)





PokerStars Hand #153069341387:  Hold'em No Limit ($0.50/$1.00 USD) - 2016/05/09 17:31:06 CET [2016/05/09 11:31:06 ET]
Table 'Reiss' 9-max Seat #7 is the button
Seat 1: Dickyxxx ($209.41 in chips) 
Seat 2: mycka86 ($174.27 in chips) 
Seat 3: chaps1988 ($121.96 in chips) 
Seat 5: matiko09 ($136.85 in chips) 
Seat 6: HITYESCA ($204.74 in chips) 
Seat 7: nubpoker ($100 in chips) 
Seat 8: JimineyCrik ($100 in chips) 
Seat 9: taxi1313 ($94.91 in chips) 
JimineyCrik: posts small blind $0.50
taxi1313: posts big blind $1
Donetsk1y: sits out 
*** HOLE CARDS ***
Dealt to matiko09 [8d 6s]
Dickyxxx: folds 
mycka86: raises $2 to $3
chaps1988: folds 
matiko09: folds 
HITYESCA: folds 
nubpoker: folds 
JimineyCrik: folds 
taxi1313: calls $2
*** FLOP *** [Th Td 3h]
taxi1313: checks 
mycka86: bets $4.50
taxi1313: calls $4.50
*** TURN *** [Th Td 3h] [Qd]
taxi1313: checks 
mycka86: bets $12.50
taxi1313: calls $12.50
*** RIVER *** [Th Td 3h Qd] [Js]
taxi1313: checks 
mycka86: bets $34
taxi1313: folds 
Uncalled bet ($34) returned to mycka86
mycka86 collected $38.48 from pot
*** SUMMARY ***
Total pot $40.50 | Rake $2.02 
Board [Th Td 3h Qd Js]
Seat 1: Dickyxxx folded before Flop (didn't bet)
Seat 2: mycka86 collected ($38.48)
Seat 3: chaps1988 folded before Flop (didn't bet)
Seat 5: matiko09 folded before Flop (didn't bet)
Seat 6: HITYESCA folded before Flop (didn't bet)
Seat 7: nubpoker (button) folded before Flop (didn't bet)
Seat 8: JimineyCrik (small blind) folded before Flop
Seat 9: taxi1313 (big blind) folded on the River





PokerStars Hand #153069347667:  Hold'em No Limit ($1/$2 USD) - 2016/05/09 17:31:16 CET [2016/05/09 11:31:16 ET]
Table 'Hagar II' 9-max Seat #4 is the button
Seat 1: CI58 ($200 in chips) 
Seat 2: darren1031 ($322.21 in chips) 
Seat 4: matiko09 ($420.09 in chips) 
Seat 5: PacPacBum ($231.39 in chips) 
Seat 6: el Fatto ($221.03 in chips) 
Seat 7: Monsthand ($307.72 in chips) 
Seat 8: Igoriah ($206.40 in chips) 
Seat 9: chaps1988 ($387.59 in chips) 
PacPacBum: posts small blind $1
el Fatto: posts big blind $2
*** HOLE CARDS ***
Dealt to matiko09 [4h Td]
Monsthand: folds 
Monsthand leaves the table
Igoriah: raises $3 to $5
chaps1988: folds 
CI58: folds 
darren1031: folds 
HuanHuan joins the table at seat #7 
matiko09: folds 
PacPacBum: folds 
el Fatto: folds 
Uncalled bet ($3) returned to Igoriah
Igoriah collected $5 from pot
Igoriah: doesn't show hand 
*** SUMMARY ***
Total pot $5 | Rake $0 
Seat 1: CI58 folded before Flop (didn't bet)
Seat 2: darren1031 folded before Flop (didn't bet)
Seat 4: matiko09 (button) folded before Flop (didn't bet)
Seat 5: PacPacBum (small blind) folded before Flop
Seat 6: el Fatto (big blind) folded before Flop
Seat 7: Monsthand folded before Flop (didn't bet)
Seat 8: Igoriah collected ($5)
Seat 9: chaps1988 folded before Flop (didn't bet)





PokerStars Hand #153069351927:  Hold'em No Limit ($1/$2 USD) - 2016/05/09 17:31:23 CET [2016/05/09 11:31:23 ET]
Table 'Celaeno II' 9-max Seat #3 is the button
Seat 1: LRVAV7 ($250.67 in chips) 
Seat 2: PacPacBum ($214.81 in chips) 
Seat 3: CI58 ($209.60 in chips) 
Seat 4: matiko09 ($416.28 in chips) 
Seat 5: KovIFish89 ($200 in chips) 
Seat 6: Igoriah ($246.52 in chips) 
Seat 7: HuanHuan ($203 in chips) 
Seat 8: chaps1988 ($210.31 in chips) 
Seat 9: RamiroAgujis ($203.62 in chips) 
matiko09: posts small blind $1
KovIFish89: posts big blind $2
*** HOLE CARDS ***
Dealt to matiko09 [2c 9h]
Igoriah: folds 
HuanHuan: folds 
chaps1988: folds 
RamiroAgujis: folds 
LRVAV7: folds 
PacPacBum: folds 
CI58: folds 
matiko09: folds 
Uncalled bet ($1) returned to KovIFish89
KovIFish89 collected $2 from pot
KovIFish89: doesn't show hand 
*** SUMMARY ***
Total pot $2 | Rake $0 
Seat 1: LRVAV7 folded before Flop (didn't bet)
Seat 2: PacPacBum folded before Flop (didn't bet)
Seat 3: CI58 (button) folded before Flop (didn't bet)
Seat 4: matiko09 (small blind) folded before Flop
Seat 5: KovIFish89 (big blind) collected ($2)
Seat 6: Igoriah folded before Flop (didn't bet)
Seat 7: HuanHuan folded before Flop (didn't bet)
Seat 8: chaps1988 folded before Flop (didn't bet)
Seat 9: RamiroAgujis folded before Flop (didn't bet)





PokerStars Hand #153069352414:  Hold'em No Limit ($0.50/$1.00 USD) - 2016/05/09 17:31:24 CET [2016/05/09 11:31:24 ET]
Table 'Terpsichore' 9-max Seat #2 is the button
Seat 1: Donetsk1y ($100 in chips) 
Seat 2: CI58 ($104.42 in chips) 
Seat 3: matiko09 ($150.77 in chips) 
Seat 4: nubpoker ($113.48 in chips) 
Seat 5: mycka86 ($266.74 in chips) 
Seat 6: Filojoes ($134.90 in chips) 
Seat 7: Kukuryzka ($101.50 in chips) 
Seat 8: Kiosk230472 ($104.16 in chips) 
Seat 9: flk.Dasas ($100 in chips) 
matiko09: posts small blind $0.50
nubpoker: posts big blind $1
*** HOLE CARDS ***
Dealt to matiko09 [Ah Ac]
mycka86: folds 
Filojoes: folds 
Kukuryzka: folds 
Kiosk230472 has timed out
Kiosk230472: folds 
flk.Dasas: folds 
Donetsk1y: folds 
CI58: folds 
matiko09: raises $1.50 to $2.50
nubpoker: folds 
Uncalled bet ($1.50) returned to matiko09
matiko09 collected $2 from pot
matiko09: doesn't show hand 
*** SUMMARY ***
Total pot $2 | Rake $0 
Seat 1: Donetsk1y folded before Flop (didn't bet)
Seat 2: CI58 (button) folded before Flop (didn't bet)
Seat 3: matiko09 (small blind) collected ($2)
Seat 4: nubpoker (big blind) folded before Flop
Seat 5: mycka86 folded before Flop (didn't bet)
Seat 6: Filojoes folded before Flop (didn't bet)
Seat 7: Kukuryzka folded before Flop (didn't bet)
Seat 8: Kiosk230472 folded before Flop (didn't bet)
Seat 9: flk.Dasas folded before Flop (didn't bet)





PokerStars Hand #153069353242:  Hold'em No Limit ($0.50/$1.00 USD) - 2016/05/09 17:31:25 CET [2016/05/09 11:31:25 ET]
Table 'Orthos' 9-max Seat #7 is the button
Seat 1: Kelvin sai ($83.54 in chips) 
Seat 2: PacPacBum ($100 in chips) 
Seat 3: Filojoes ($114.50 in chips) 
Seat 4: nubpoker ($157.37 in chips) 
Seat 5: matiko09 ($143.06 in chips) 
Seat 6: xhinostrabli ($73.11 in chips) 
Seat 7: flk.Dasas ($178.05 in chips) 
Seat 8: Dickyxxx ($102.67 in chips) 
Dickyxxx: posts small blind $0.50
mycka86: is sitting out 
mycka86 leaves the table
Kelvin sai: posts big blind $1
*** HOLE CARDS ***
Dealt to matiko09 [8d 3s]
PacPacBum: folds 
Filojoes: raises $2 to $3
nubpoker: folds 
matiko09: folds 
xhinostrabli: folds 
flk.Dasas: folds 
Dickyxxx: folds 
Kelvin sai: folds 
Uncalled bet ($2) returned to Filojoes
Filojoes collected $2.50 from pot
Filojoes: doesn't show hand 
*** SUMMARY ***
Total pot $2.50 | Rake $0 
Seat 1: Kelvin sai (big blind) folded before Flop
Seat 2: PacPacBum folded before Flop (didn't bet)
Seat 3: Filojoes collected ($2.50)
Seat 4: nubpoker folded before Flop (didn't bet)
Seat 5: matiko09 folded before Flop (didn't bet)
Seat 6: xhinostrabli folded before Flop (didn't bet)
Seat 7: flk.Dasas (button) folded before Flop (didn't bet)
Seat 8: Dickyxxx (small blind) folded before Flop





PokerStars Hand #153069360047:  Hold'em No Limit ($0.50/$1.00 USD) - 2016/05/09 17:31:36 CET [2016/05/09 11:31:36 ET]
Table 'Odyssey' 9-max Seat #1 is the button
Seat 1: matiko09 ($110.92 in chips) 
Seat 2: flk.Dasas ($100 in chips) 
Seat 3: chaps1988 ($158.83 in chips) 
Seat 4: mycka86 ($166.65 in chips) 
Seat 5: Donetsk1y ($100 in chips) 
Seat 6: Kukuryzka ($124.29 in chips) 
Seat 8: nubpoker ($100 in chips) 
Seat 9: hellig777 ($244.58 in chips) 
flk.Dasas: posts small blind $0.50
chaps1988: posts big blind $1
CI58: sits out 
*** HOLE CARDS ***
Dealt to matiko09 [8d Kc]
mycka86: folds 
Donetsk1y: folds 
Kukuryzka: folds 
nubpoker: folds 
hellig777: calls $1
matiko09: raises $3 to $4
flk.Dasas: folds 
chaps1988: folds 
hellig777: calls $3
*** FLOP *** [Jh 6c Jc]
hellig777: checks 
matiko09: bets $5
hellig777: calls $5
*** TURN *** [Jh 6c Jc] [4h]
hellig777: checks 
matiko09: checks 
*** RIVER *** [Jh 6c Jc 4h] [2d]
hellig777: bets $9.26
matiko09: folds 
Uncalled bet ($9.26) returned to hellig777
hellig777 collected $18.52 from pot
*** SUMMARY ***
Total pot $19.50 | Rake $0.98 
Board [Jh 6c Jc 4h 2d]
Seat 1: matiko09 (button) folded on the River
Seat 2: flk.Dasas (small blind) folded before Flop
Seat 3: chaps1988 (big blind) folded before Flop
Seat 4: mycka86 folded before Flop (didn't bet)
Seat 5: Donetsk1y folded before Flop (didn't bet)
Seat 6: Kukuryzka folded before Flop (didn't bet)
Seat 8: nubpoker folded before Flop (didn't bet)
Seat 9: hellig777 collected ($18.52)





PokerStars Hand #153069363506:  Hold'em No Limit ($1/$2 USD) - 2016/05/09 17:31:41 CET [2016/05/09 11:31:41 ET]
Table 'Celaeno II' 9-max Seat #4 is the button
Seat 1: LRVAV7 ($250.67 in chips) 
Seat 2: PacPacBum ($214.81 in chips) 
Seat 3: CI58 ($209.60 in chips) 
Seat 4: matiko09 ($415.28 in chips) 
Seat 5: KovIFish89 ($201 in chips) 
Seat 6: Igoriah ($246.52 in chips) 
Seat 7: HuanHuan ($203 in chips) 
Seat 8: chaps1988 ($210.31 in chips) 
Seat 9: RamiroAgujis ($203.62 in chips) 
KovIFish89: posts small blind $1
Igoriah: posts big blind $2
*** HOLE CARDS ***
Dealt to matiko09 [2s 7s]
HuanHuan: folds 
chaps1988: folds 
RamiroAgujis: folds 
LRVAV7: raises $3 to $5
PacPacBum: folds 
CI58: folds 
matiko09: folds 
KovIFish89: folds 
Igoriah: folds 
Uncalled bet ($3) returned to LRVAV7
LRVAV7 collected $5 from pot
*** SUMMARY ***
Total pot $5 | Rake $0 
Seat 1: LRVAV7 collected ($5)
Seat 2: PacPacBum folded before Flop (didn't bet)
Seat 3: CI58 folded before Flop (didn't bet)
Seat 4: matiko09 (button) folded before Flop (didn't bet)
Seat 5: KovIFish89 (small blind) folded before Flop
Seat 6: Igoriah (big blind) folded before Flop
Seat 7: HuanHuan folded before Flop (didn't bet)
Seat 8: chaps1988 folded before Flop (didn't bet)
Seat 9: RamiroAgujis folded before Flop (didn't bet)





PokerStars Hand #153069365259:  Hold'em No Limit ($1/$2 USD) - 2016/05/09 17:31:44 CET [2016/05/09 11:31:44 ET]
Table 'Hagar II' 9-max Seat #5 is the button
Seat 1: CI58 ($200 in chips) 
Seat 2: darren1031 ($322.21 in chips) 
Seat 4: matiko09 ($420.09 in chips) 
Seat 5: PacPacBum ($230.39 in chips) 
Seat 6: el Fatto ($219.03 in chips) 
Seat 7: HuanHuan ($200 in chips) 
Seat 8: Igoriah ($209.40 in chips) 
Seat 9: chaps1988 ($387.59 in chips) 
el Fatto: posts small blind $1
HuanHuan: posts big blind $2
*** HOLE CARDS ***
Dealt to matiko09 [Jh 2h]
Igoriah: folds 
chaps1988: folds 
CI58: folds 
darren1031: calls $2
matiko09: folds 
PacPacBum: folds 
el Fatto: calls $1
HuanHuan: raises $8 to $10
darren1031: folds 
el Fatto: folds 
Uncalled bet ($8) returned to HuanHuan
HuanHuan collected $6 from pot
HuanHuan: doesn't show hand 
*** SUMMARY ***
Total pot $6 | Rake $0 
Seat 1: CI58 folded before Flop (didn't bet)
Seat 2: darren1031 folded before Flop
Seat 4: matiko09 folded before Flop (didn't bet)
Seat 5: PacPacBum (button) folded before Flop (didn't bet)
Seat 6: el Fatto (small blind) folded before Flop
Seat 7: HuanHuan (big blind) collected ($6)
Seat 8: Igoriah folded before Flop (didn't bet)
Seat 9: chaps1988 folded before Flop (didn't bet)





PokerStars Hand #153069368539:  Hold'em No Limit ($0.50/$1.00 USD) - 2016/05/09 17:31:49 CET [2016/05/09 11:31:49 ET]
Table 'Orthos' 9-max Seat #8 is the button
Seat 1: Kelvin sai ($82.54 in chips) 
Seat 2: PacPacBum ($100 in chips) 
Seat 3: Filojoes ($116 in chips) 
Seat 4: nubpoker ($157.37 in chips) 
Seat 5: matiko09 ($143.06 in chips) 
Seat 6: xhinostrabli ($73.11 in chips) 
Seat 7: flk.Dasas ($178.05 in chips) 
Seat 8: Dickyxxx ($102.17 in chips) 
Kelvin sai: posts small blind $0.50
PacPacBum: posts big blind $1
*** HOLE CARDS ***
Dealt to matiko09 [5d 3s]
Filojoes: raises $2 to $3
nubpoker: folds 
matiko09: folds 
xhinostrabli: folds 
flk.Dasas: folds 
Donetsk1y joins the table at seat #9 
Dickyxxx: folds 
Kelvin sai: folds 
PacPacBum: folds 
Uncalled bet ($2) returned to Filojoes
Filojoes collected $2.50 from pot
Filojoes: doesn't show hand 
*** SUMMARY ***
Total pot $2.50 | Rake $0 
Seat 1: Kelvin sai (small blind) folded before Flop
Seat 2: PacPacBum (big blind) folded before Flop
Seat 3: Filojoes collected ($2.50)
Seat 4: nubpoker folded before Flop (didn't bet)
Seat 5: matiko09 folded before Flop (didn't bet)
Seat 6: xhinostrabli folded before Flop (didn't bet)
Seat 7: flk.Dasas folded before Flop (didn't bet)
Seat 8: Dickyxxx (button) folded before Flop (didn't bet)





PokerStars Hand #153069374403:  Hold'em No Limit ($1/$2 USD) - 2016/05/09 17:31:58 CET [2016/05/09 11:31:58 ET]
Table 'Demeter II' 9-max Seat #4 is the button
Seat 2: matiko09 ($200 in chips) 
Seat 3: chaps1988 ($270.40 in chips) 
Seat 4: Igoriah ($200 in chips) 
Seat 5: PacPacBum ($225.21 in chips) 
Seat 6: HuanHuan ($200 in chips) 
Seat 7: Siwyosb ($207.31 in chips) 
Seat 8: CI58 ($455.79 in chips) 
PacPacBum: posts small blind $1
HuanHuan: posts big blind $2
RamiroAgujis: sits out 
KovIFish89: sits out 
*** HOLE CARDS ***
Dealt to matiko09 [6s Kc]
Siwyosb: folds 
CI58: calls $2
matiko09: folds 
chaps1988: folds 
Igoriah: raises $7 to $9
PacPacBum: folds 
HuanHuan: folds 
CI58: calls $7
*** FLOP *** [7c 2h Qc]
CI58: checks 
Igoriah: bets $12
CI58: raises $18 to $30
Igoriah: folds 
Uncalled bet ($18) returned to CI58
CI58 collected $42.75 from pot
CI58: doesn't show hand 
*** SUMMARY ***
Total pot $45 | Rake $2.25 
Board [7c 2h Qc]
Seat 2: matiko09 folded before Flop (didn't bet)
Seat 3: chaps1988 folded before Flop (didn't bet)
Seat 4: Igoriah (button) folded on the Flop
Seat 5: PacPacBum (small blind) folded before Flop
Seat 6: HuanHuan (big blind) folded before Flop
Seat 7: Siwyosb folded before Flop (didn't bet)
Seat 8: CI58 collected ($42.75)





PokerStars Hand #153069378167:  Hold'em No Limit ($1/$2 USD) - 2016/05/09 17:32:04 CET [2016/05/09 11:32:04 ET]
Table 'Celaeno II' 9-max Seat #5 is the button
Seat 1: LRVAV7 ($253.67 in chips) 
Seat 2: PacPacBum ($214.81 in chips) 
Seat 3: CI58 ($209.60 in chips) 
Seat 4: matiko09 ($415.28 in chips) 
Seat 5: KovIFish89 ($200 in chips) 
Seat 6: Igoriah ($244.52 in chips) 
Seat 7: HuanHuan ($203 in chips) 
Seat 8: chaps1988 ($210.31 in chips) 
Seat 9: RamiroAgujis ($203.62 in chips) 
Igoriah: posts small blind $1
HuanHuan: posts big blind $2
*** HOLE CARDS ***
Dealt to matiko09 [Tc Qc]
chaps1988: folds 
RamiroAgujis: folds 
LRVAV7: folds 
PacPacBum: folds 
CI58: folds 
matiko09: raises $3 to $5
KovIFish89: folds 
Igoriah: folds 
HuanHuan: calls $3
*** FLOP *** [5c As 9s]
HuanHuan: checks 
matiko09: bets $6.79
HuanHuan: calls $6.79
*** TURN *** [5c As 9s] [5d]
HuanHuan: checks 
matiko09: checks 
*** RIVER *** [5c As 9s 5d] [Js]
HuanHuan: bets $16.34
matiko09: folds 
Uncalled bet ($16.34) returned to HuanHuan
HuanHuan collected $23.35 from pot
HuanHuan: doesn't show hand 
*** SUMMARY ***
Total pot $24.58 | Rake $1.23 
Board [5c As 9s 5d Js]
Seat 1: LRVAV7 folded before Flop (didn't bet)
Seat 2: PacPacBum folded before Flop (didn't bet)
Seat 3: CI58 folded before Flop (didn't bet)
Seat 4: matiko09 folded on the River
Seat 5: KovIFish89 (button) folded before Flop (didn't bet)
Seat 6: Igoriah (small blind) folded before Flop
Seat 7: HuanHuan (big blind) collected ($23.35)
Seat 8: chaps1988 folded before Flop (didn't bet)
Seat 9: RamiroAgujis folded before Flop (didn't bet)





PokerStars Hand #153069380402:  Hold'em No Limit ($0.50/$1.00 USD) - 2016/05/09 17:32:08 CET [2016/05/09 11:32:08 ET]
Table 'Terpsichore' 9-max Seat #3 is the button
Seat 1: Donetsk1y ($100 in chips) 
Seat 2: CI58 ($104.42 in chips) 
Seat 3: matiko09 ($151.77 in chips) 
Seat 4: nubpoker ($112.48 in chips) 
Seat 7: Kukuryzka ($101.50 in chips) 
Seat 9: flk.Dasas ($100 in chips) 
nubpoker: posts small blind $0.50
mycka86: is sitting out 
Filojoes: is sitting out 
mycka86 leaves the table
Kukuryzka: posts big blind $1
*** HOLE CARDS ***
Dealt to matiko09 [7c 7d]
Filojoes leaves the table
I The King I joins the table at seat #5 
flk.Dasas: folds 
I The King I leaves the table
Donetsk1y: folds 
CI58: folds 
matiko09: raises $1.27 to $2.27
nubpoker: folds 
Kukuryzka: folds 
Uncalled bet ($1.27) returned to matiko09
matiko09 collected $2.50 from pot
matiko09: doesn't show hand 
*** SUMMARY ***
Total pot $2.50 | Rake $0 
Seat 1: Donetsk1y folded before Flop (didn't bet)
Seat 2: CI58 folded before Flop (didn't bet)
Seat 3: matiko09 (button) collected ($2.50)
Seat 4: nubpoker (small blind) folded before Flop
Seat 7: Kukuryzka (big blind) folded before Flop
Seat 9: flk.Dasas folded before Flop (didn't bet)





PokerStars Hand #153069382747:  Hold'em No Limit ($0.50/$1.00 USD) - 2016/05/09 17:32:11 CET [2016/05/09 11:32:11 ET]
Table 'Orthos' 9-max Seat #1 is the button
Seat 1: Kelvin sai ($82.04 in chips) 
Seat 2: PacPacBum ($100 in chips) 
Seat 4: nubpoker ($157.37 in chips) 
Seat 5: matiko09 ($143.06 in chips) 
Seat 6: xhinostrabli ($73.11 in chips) 
Seat 7: flk.Dasas ($178.05 in chips) 
Seat 8: Dickyxxx ($102.17 in chips) 
PacPacBum: posts small blind $0.50
Filojoes: is sitting out 
Filojoes leaves the table
nubpoker: posts big blind $1
Donetsk1y: sits out 
*** HOLE CARDS ***
Dealt to matiko09 [As 4s]
I The King I joins the table at seat #3 
matiko09: folds 
xhinostrabli: folds 
flk.Dasas: folds 
Dickyxxx: folds 
Kelvin sai: folds 
PacPacBum: folds 
Uncalled bet ($0.50) returned to nubpoker
nubpoker collected $1 from pot
nubpoker: doesn't show hand 
*** SUMMARY ***
Total pot $1 | Rake $0 
Seat 1: Kelvin sai (button) folded before Flop (didn't bet)
Seat 2: PacPacBum (small blind) folded before Flop
Seat 4: nubpoker (big blind) collected ($1)
Seat 5: matiko09 folded before Flop (didn't bet)
Seat 6: xhinostrabli folded before Flop (didn't bet)
Seat 7: flk.Dasas folded before Flop (didn't bet)
Seat 8: Dickyxxx folded before Flop (didn't bet)





PokerStars Hand #153069389431:  Hold'em No Limit ($0.50/$1.00 USD) - 2016/05/09 17:32:22 CET [2016/05/09 11:32:22 ET]
Table 'Odyssey' 9-max Seat #2 is the button
Seat 1: matiko09 ($101.92 in chips) 
Seat 2: flk.Dasas ($100 in chips) 
Seat 3: chaps1988 ($157.83 in chips) 
Seat 5: Donetsk1y ($100 in chips) 
Seat 6: Kukuryzka ($124.29 in chips) 
Seat 8: nubpoker ($100 in chips) 
Seat 9: hellig777 ($254.10 in chips) 
chaps1988: posts small blind $0.50
mycka86: is sitting out 
mycka86 leaves the table
Donetsk1y: posts big blind $1
CI58: sits out 
*** HOLE CARDS ***
Dealt to matiko09 [Jd Qd]
Kukuryzka: folds 
nubpoker: folds 
hellig777: calls $1
matiko09: raises $3 to $4
flk.Dasas: folds 
chaps1988: folds 
Donetsk1y: folds 
hellig777: calls $3
*** FLOP *** [Kc 9d 6c]
hellig777: checks 
matiko09: bets $6
hellig777: calls $6
*** TURN *** [Kc 9d 6c] [5h]
hellig777: checks 
matiko09: checks 
*** RIVER *** [Kc 9d 6c 5h] [Ah]
hellig777: checks 
matiko09: checks 
*** SHOW DOWN ***
hellig777: shows [Jc Tc] (high card Ace)
matiko09: shows [Jd Qd] (high card Ace - King+Queen kicker)
matiko09 collected $20.42 from pot
*** SUMMARY ***
Total pot $21.50 | Rake $1.08 
Board [Kc 9d 6c 5h Ah]
Seat 1: matiko09 showed [Jd Qd] and won ($20.42) with high card Ace
Seat 2: flk.Dasas (button) folded before Flop (didn't bet)
Seat 3: chaps1988 (small blind) folded before Flop
Seat 5: Donetsk1y (big blind) folded before Flop
Seat 6: Kukuryzka folded before Flop (didn't bet)
Seat 8: nubpoker folded before Flop (didn't bet)
Seat 9: hellig777 showed [Jc Tc] and lost with high card Ace





PokerStars Hand #153069399756:  Hold'em No Limit ($0.50/$1.00 USD) - 2016/05/09 17:32:38 CET [2016/05/09 11:32:38 ET]
Table 'Orthos' 9-max Seat #2 is the button
Seat 1: Kelvin sai ($82.04 in chips) 
Seat 2: PacPacBum ($100 in chips) 
Seat 4: nubpoker ($157.87 in chips) 
Seat 5: matiko09 ($143.06 in chips) 
Seat 6: xhinostrabli ($73.11 in chips) 
Seat 7: flk.Dasas ($178.05 in chips) 
Seat 8: Dickyxxx ($102.17 in chips) 
I The King I will be allowed to play after the button
nubpoker: posts small blind $0.50
matiko09: posts big blind $1
Donetsk1y: sits out 
*** HOLE CARDS ***
Dealt to matiko09 [As 6c]
xhinostrabli: folds 
flk.Dasas: folds 
Dickyxxx: folds 
Kelvin sai: folds 
PacPacBum: folds 
nubpoker: raises $1.50 to $2.50
matiko09: calls $1.50
*** FLOP *** [3c 9c 8s]
nubpoker: checks 
matiko09: checks 
*** TURN *** [3c 9c 8s] [6h]
nubpoker: checks 
matiko09: checks 
*** RIVER *** [3c 9c 8s 6h] [Jh]
nubpoker: checks 
matiko09: checks 
*** SHOW DOWN ***
nubpoker: shows [2h 2d] (a pair of Deuces)
matiko09: shows [As 6c] (a pair of Sixes)
matiko09 collected $4.75 from pot
*** SUMMARY ***
Total pot $5 | Rake $0.25 
Board [3c 9c 8s 6h Jh]
Seat 1: Kelvin sai folded before Flop (didn't bet)
Seat 2: PacPacBum (button) folded before Flop (didn't bet)
Seat 4: nubpoker (small blind) showed [2h 2d] and lost with a pair of Deuces
Seat 5: matiko09 (big blind) showed [As 6c] and won ($4.75) with a pair of Sixes
Seat 6: xhinostrabli folded before Flop (didn't bet)
Seat 7: flk.Dasas folded before Flop (didn't bet)
Seat 8: Dickyxxx folded before Flop (didn't bet)





PokerStars Hand #153069406085:  Hold'em No Limit ($1/$2 USD) - 2016/05/09 17:32:48 CET [2016/05/09 11:32:48 ET]
Table 'Demeter II' 9-max Seat #5 is the button
Seat 2: matiko09 ($200 in chips) 
Seat 3: chaps1988 ($270.40 in chips) 
Seat 4: Igoriah ($200 in chips) 
Seat 5: PacPacBum ($224.21 in chips) 
Seat 6: HuanHuan ($200 in chips) 
Seat 7: Siwyosb ($207.31 in chips) 
Seat 8: CI58 ($477.54 in chips) 
HuanHuan: posts small blind $1
Siwyosb: posts big blind $2
RamiroAgujis: sits out 
KovIFish89: sits out 
*** HOLE CARDS ***
Dealt to matiko09 [Ks Ah]
CI58: folds 
matiko09: raises $3 to $5
chaps1988: folds 
Igoriah: folds 
PacPacBum: folds 
HuanHuan: folds 
Siwyosb: folds 
Uncalled bet ($3) returned to matiko09
matiko09 collected $5 from pot
matiko09: doesn't show hand 
*** SUMMARY ***
Total pot $5 | Rake $0 
Seat 2: matiko09 collected ($5)
Seat 3: chaps1988 folded before Flop (didn't bet)
Seat 4: Igoriah folded before Flop (didn't bet)
Seat 5: PacPacBum (button) folded before Flop (didn't bet)
Seat 6: HuanHuan (small blind) folded before Flop
Seat 7: Siwyosb (big blind) folded before Flop
Seat 8: CI58 folded before Flop (didn't bet)





PokerStars Hand #153069407174:  Hold'em No Limit ($0.50/$1.00 USD) - 2016/05/09 17:32:49 CET [2016/05/09 11:32:49 ET]
Table 'Reiss' 9-max Seat #8 is the button
Seat 1: Dickyxxx ($209.41 in chips) 
Seat 2: mycka86 ($192.75 in chips) 
Seat 5: matiko09 ($136.85 in chips) 
Seat 6: HITYESCA ($204.74 in chips) 
Seat 7: nubpoker ($100 in chips) 
Seat 8: JimineyCrik ($100 in chips) 
Seat 9: taxi1313 ($74.91 in chips) 
taxi1313: posts small blind $0.50
Dickyxxx: posts big blind $1
Donetsk1y: sits out 
*** HOLE CARDS ***
Dealt to matiko09 [8h Qs]
mycka86: folds 
matiko09: folds 
HITYESCA: folds 
nubpoker: raises $1.50 to $2.50
JimineyCrik: calls $2.50
taxi1313: calls $2
Dickyxxx: raises $11.50 to $14
nubpoker: folds 
JimineyCrik: folds 
taxi1313: calls $11.50
*** FLOP *** [7d 3d 6d]
taxi1313: bets $31
Dickyxxx: folds 
Uncalled bet ($31) returned to taxi1313
taxi1313 collected $31.35 from pot
taxi1313: doesn't show hand 
*** SUMMARY ***
Total pot $33 | Rake $1.65 
Board [7d 3d 6d]
Seat 1: Dickyxxx (big blind) folded on the Flop
Seat 2: mycka86 folded before Flop (didn't bet)
Seat 5: matiko09 folded before Flop (didn't bet)
Seat 6: HITYESCA folded before Flop (didn't bet)
Seat 7: nubpoker folded before Flop
Seat 8: JimineyCrik (button) folded before Flop
Seat 9: taxi1313 (small blind) collected ($31.35)





PokerStars Hand #153069407634:  Hold'em No Limit ($1/$2 USD) - 2016/05/09 17:32:50 CET [2016/05/09 11:32:50 ET]
Table 'Hagar II' 9-max Seat #6 is the button
Seat 1: CI58 ($200 in chips) 
Seat 2: darren1031 ($320.21 in chips) 
Seat 4: matiko09 ($420.09 in chips) 
Seat 5: PacPacBum ($230.39 in chips) 
Seat 6: el Fatto ($217.03 in chips) 
Seat 7: HuanHuan ($204 in chips) 
Seat 8: Igoriah ($209.40 in chips) 
HuanHuan: posts small blind $1
Igoriah: posts big blind $2
*** HOLE CARDS ***
Dealt to matiko09 [Qs 7c]
AlKatrone joins the table at seat #3 
CI58: calls $2
darren1031: calls $2
matiko09: folds 
PacPacBum: folds 
el Fatto: folds 
HuanHuan: raises $7 to $9
Igoriah: folds 
CI58: calls $7
darren1031: calls $7
*** FLOP *** [Kd 7d 4h]
HuanHuan: checks 
CI58: checks 
darren1031: bets $26
HuanHuan: folds 
CI58: folds 
Uncalled bet ($26) returned to darren1031
darren1031 collected $27.55 from pot
darren1031: doesn't show hand 
*** SUMMARY ***
Total pot $29 | Rake $1.45 
Board [Kd 7d 4h]
Seat 1: CI58 folded on the Flop
Seat 2: darren1031 collected ($27.55)
Seat 4: matiko09 folded before Flop (didn't bet)
Seat 5: PacPacBum folded before Flop (didn't bet)
Seat 6: el Fatto (button) folded before Flop (didn't bet)
Seat 7: HuanHuan (small blind) folded on the Flop
Seat 8: Igoriah (big blind) folded before Flop





PokerStars Hand #153069411382:  Hold'em No Limit ($0.50/$1.00 USD) - 2016/05/09 17:32:56 CET [2016/05/09 11:32:56 ET]
Table 'Terpsichore' 9-max Seat #4 is the button
Seat 1: Donetsk1y ($100 in chips) 
Seat 2: CI58 ($104.42 in chips) 
Seat 3: matiko09 ($153.27 in chips) 
Seat 4: nubpoker ($111.98 in chips) 
Seat 7: Kukuryzka ($100.50 in chips) 
Seat 8: Kiosk230472 ($104.16 in chips) 
Seat 9: flk.Dasas ($100 in chips) 
Kukuryzka: posts small blind $0.50
Kiosk230472: posts big blind $1
*** HOLE CARDS ***
Dealt to matiko09 [Ad 8h]
flk.Dasas: folds 
R1aki joins the table at seat #5 
Donetsk1y: folds 
CI58: folds 
matiko09: raises $1.50 to $2.50
nubpoker: folds 
Kukuryzka: raises $6.50 to $9
Kiosk230472: folds 
matiko09: folds 
Uncalled bet ($6.50) returned to Kukuryzka
Kukuryzka collected $6 from pot
Kukuryzka: doesn't show hand 
*** SUMMARY ***
Total pot $6 | Rake $0 
Seat 1: Donetsk1y folded before Flop (didn't bet)
Seat 2: CI58 folded before Flop (didn't bet)
Seat 3: matiko09 folded before Flop
Seat 4: nubpoker (button) folded before Flop (didn't bet)
Seat 7: Kukuryzka (small blind) collected ($6)
Seat 8: Kiosk230472 (big blind) folded before Flop
Seat 9: flk.Dasas folded before Flop (didn't bet)





PokerStars Hand #153069425292:  Hold'em No Limit ($0.50/$1.00 USD) - 2016/05/09 17:33:17 CET [2016/05/09 11:33:17 ET]
Table 'Odyssey' 9-max Seat #5 is the button
Seat 1: matiko09 ($112.34 in chips) 
Seat 2: flk.Dasas ($100 in chips) 
Seat 5: Donetsk1y ($100 in chips) 
Seat 6: Kukuryzka ($124.29 in chips) 
Seat 7: CI58 ($100 in chips) 
Seat 8: nubpoker ($100 in chips) 
Seat 9: hellig777 ($244.10 in chips) 
Kukuryzka: posts small blind $0.50
CI58: posts big blind $1
*** HOLE CARDS ***
Dealt to matiko09 [Kh 9c]
nubpoker: folds 
hellig777: folds 
matiko09: folds 
flk.Dasas: folds 
Donetsk1y: raises $1.20 to $2.20
Kukuryzka: folds 
CI58: folds 
Uncalled bet ($1.20) returned to Donetsk1y
Donetsk1y collected $2.50 from pot
Donetsk1y: doesn't show hand 
*** SUMMARY ***
Total pot $2.50 | Rake $0 
Seat 1: matiko09 folded before Flop (didn't bet)
Seat 2: flk.Dasas folded before Flop (didn't bet)
Seat 5: Donetsk1y (button) collected ($2.50)
Seat 6: Kukuryzka (small blind) folded before Flop
Seat 7: CI58 (big blind) folded before Flop
Seat 8: nubpoker folded before Flop (didn't bet)
Seat 9: hellig777 folded before Flop (didn't bet)





PokerStars Hand #153069425993:  Hold'em No Limit ($1/$2 USD) - 2016/05/09 17:33:18 CET [2016/05/09 11:33:18 ET]
Table 'Demeter II' 9-max Seat #6 is the button
Seat 2: matiko09 ($203 in chips) 
Seat 4: Igoriah ($200 in chips) 
Seat 5: PacPacBum ($224.21 in chips) 
Seat 6: HuanHuan ($200 in chips) 
Seat 7: Siwyosb ($205.31 in chips) 
Seat 9: RamiroAgujis ($200 in chips) 
Siwyosb: posts small blind $1
CI58: is sitting out 
RamiroAgujis: posts big blind $2
KovIFish89: sits out 
*** HOLE CARDS ***
Dealt to matiko09 [Td 9c]
matiko09: folds 
CI58 leaves the table
Igoriah: folds 
PacPacBum: raises $2.08 to $4.08
HuanHuan: raises $9.92 to $14
Siwyosb: folds 
RamiroAgujis: folds 
PacPacBum: folds 
Uncalled bet ($9.92) returned to HuanHuan
HuanHuan collected $11.16 from pot
HuanHuan: doesn't show hand 
*** SUMMARY ***
Total pot $11.16 | Rake $0 
Seat 2: matiko09 folded before Flop (didn't bet)
Seat 4: Igoriah folded before Flop (didn't bet)
Seat 5: PacPacBum folded before Flop
Seat 6: HuanHuan (button) collected ($11.16)
Seat 7: Siwyosb (small blind) folded before Flop
Seat 9: RamiroAgujis (big blind) folded before Flop





PokerStars Hand #153069427214:  Hold'em No Limit ($0.50/$1.00 USD) - 2016/05/09 17:33:20 CET [2016/05/09 11:33:20 ET]
Table 'Orthos' 9-max Seat #4 is the button
Seat 1: Kelvin sai ($82.04 in chips) 
Seat 2: PacPacBum ($100 in chips) 
Seat 4: nubpoker ($155.37 in chips) 
Seat 5: matiko09 ($145.31 in chips) 
Seat 6: xhinostrabli ($73.11 in chips) 
Seat 7: flk.Dasas ($178.05 in chips) 
Seat 8: Dickyxxx ($102.17 in chips) 
matiko09: posts small blind $0.50
xhinostrabli: posts big blind $1
Donetsk1y: sits out 
I The King I: sits out 
*** HOLE CARDS ***
Dealt to matiko09 [3c 8h]
flk.Dasas: folds 
Dickyxxx: folds 
Kelvin sai: raises $2 to $3
PacPacBum: folds 
nubpoker: folds 
matiko09: folds 
xhinostrabli: folds 
Uncalled bet ($2) returned to Kelvin sai
Kelvin sai collected $2.50 from pot
Kelvin sai: doesn't show hand 
*** SUMMARY ***
Total pot $2.50 | Rake $0 
Seat 1: Kelvin sai collected ($2.50)
Seat 2: PacPacBum folded before Flop (didn't bet)
Seat 4: nubpoker (button) folded before Flop (didn't bet)
Seat 5: matiko09 (small blind) folded before Flop
Seat 6: xhinostrabli (big blind) folded before Flop
Seat 7: flk.Dasas folded before Flop (didn't bet)
Seat 8: Dickyxxx folded before Flop (didn't bet)





PokerStars Hand #153069430006:  Hold'em No Limit ($1/$2 USD) - 2016/05/09 17:33:25 CET [2016/05/09 11:33:25 ET]
Table 'Celaeno II' 9-max Seat #6 is the button
Seat 1: LRVAV7 ($253.67 in chips) 
Seat 2: PacPacBum ($214.81 in chips) 
Seat 3: CI58 ($209.60 in chips) 
Seat 4: matiko09 ($403.49 in chips) 
Seat 5: KovIFish89 ($200 in chips) 
Seat 6: Igoriah ($243.52 in chips) 
Seat 7: HuanHuan ($214.56 in chips) 
Seat 9: RamiroAgujis ($203.62 in chips) 
HuanHuan: posts small blind $1
RamiroAgujis: posts big blind $2
*** HOLE CARDS ***
Dealt to matiko09 [7h 4s]
LRVAV7: folds 
PacPacBum: folds 
CI58: raises $4 to $6
matiko09: folds 
KovIFish89: folds 
Igoriah: calls $6
HuanHuan: folds 
RamiroAgujis: calls $4
*** FLOP *** [Ac 8d 8h]
RamiroAgujis: checks 
CI58: checks 
Igoriah: checks 
*** TURN *** [Ac 8d 8h] [6c]
RamiroAgujis: bets $13
CI58: calls $13
Igoriah: folds 
*** RIVER *** [Ac 8d 8h 6c] [2s]
RamiroAgujis: bets $36
CI58: folds 
Uncalled bet ($36) returned to RamiroAgujis
RamiroAgujis collected $42.75 from pot
RamiroAgujis: doesn't show hand 
*** SUMMARY ***
Total pot $45 | Rake $2.25 
Board [Ac 8d 8h 6c 2s]
Seat 1: LRVAV7 folded before Flop (didn't bet)
Seat 2: PacPacBum folded before Flop (didn't bet)
Seat 3: CI58 folded on the River
Seat 4: matiko09 folded before Flop (didn't bet)
Seat 5: KovIFish89 folded before Flop (didn't bet)
Seat 6: Igoriah (button) folded on the Turn
Seat 7: HuanHuan (small blind) folded before Flop
Seat 9: RamiroAgujis (big blind) collected ($42.75)





PokerStars Hand #153069441850:  Hold'em No Limit ($0.50/$1.00 USD) - 2016/05/09 17:33:43 CET [2016/05/09 11:33:43 ET]
Table 'Reiss' 9-max Seat #9 is the button
Seat 1: Dickyxxx ($195.41 in chips) 
Seat 4: Donetsk1y ($100 in chips) 
Seat 5: matiko09 ($136.85 in chips) 
Seat 6: HITYESCA ($204.74 in chips) 
Seat 7: nubpoker ($100 in chips) 
Seat 8: JimineyCrik ($100 in chips) 
Seat 9: taxi1313 ($92.26 in chips) 
Dickyxxx: posts small blind $0.50
mycka86: is sitting out 
Donetsk1y: posts big blind $1
*** HOLE CARDS ***
Dealt to matiko09 [Td 3h]
mycka86 leaves the table
matiko09: folds 
flk.Dasas joins the table at seat #2 
HITYESCA: folds 
nubpoker: raises $1.50 to $2.50
JimineyCrik: folds 
taxi1313: folds 
Dickyxxx: folds 
Donetsk1y: folds 
Uncalled bet ($1.50) returned to nubpoker
nubpoker collected $2.50 from pot
nubpoker: doesn't show hand 
*** SUMMARY ***
Total pot $2.50 | Rake $0 
Seat 1: Dickyxxx (small blind) folded before Flop
Seat 4: Donetsk1y (big blind) folded before Flop
Seat 5: matiko09 folded before Flop (didn't bet)
Seat 6: HITYESCA folded before Flop (didn't bet)
Seat 7: nubpoker collected ($2.50)
Seat 8: JimineyCrik folded before Flop (didn't bet)
Seat 9: taxi1313 (button) folded before Flop (didn't bet)





PokerStars Hand #153069444549:  Hold'em No Limit ($0.50/$1.00 USD) - 2016/05/09 17:33:47 CET [2016/05/09 11:33:47 ET]
Table 'Orthos' 9-max Seat #5 is the button
Seat 1: Kelvin sai ($83.54 in chips) 
Seat 2: PacPacBum ($100 in chips) 
Seat 4: nubpoker ($155.37 in chips) 
Seat 5: matiko09 ($144.81 in chips) 
Seat 6: xhinostrabli ($72.11 in chips) 
Seat 7: flk.Dasas ($178.05 in chips) 
Seat 8: Dickyxxx ($102.17 in chips) 
xhinostrabli: posts small blind $0.50
flk.Dasas: posts big blind $1
Donetsk1y: sits out 
I The King I: sits out 
*** HOLE CARDS ***
Dealt to matiko09 [2s 5d]
Dickyxxx: folds 
Kelvin sai: folds 
PacPacBum: raises $1.04 to $2.04
nubpoker: folds 
matiko09: folds 
xhinostrabli: folds 
flk.Dasas: folds 
Uncalled bet ($1.04) returned to PacPacBum
PacPacBum collected $2.50 from pot
PacPacBum: doesn't show hand 
*** SUMMARY ***
Total pot $2.50 | Rake $0 
Seat 1: Kelvin sai folded before Flop (didn't bet)
Seat 2: PacPacBum collected ($2.50)
Seat 4: nubpoker folded before Flop (didn't bet)
Seat 5: matiko09 (button) folded before Flop (didn't bet)
Seat 6: xhinostrabli (small blind) folded before Flop
Seat 7: flk.Dasas (big blind) folded before Flop
Seat 8: Dickyxxx folded before Flop (didn't bet)





PokerStars Hand #153069448591:  Hold'em No Limit ($0.50/$1.00 USD) - 2016/05/09 17:33:54 CET [2016/05/09 11:33:54 ET]
Table 'Terpsichore' 9-max Seat #7 is the button
Seat 1: Donetsk1y ($100 in chips) 
Seat 2: CI58 ($104.42 in chips) 
Seat 3: matiko09 ($150.77 in chips) 
Seat 4: nubpoker ($111.98 in chips) 
Seat 7: Kukuryzka ($104 in chips) 
Seat 8: Kiosk230472 ($103.16 in chips) 
Seat 9: flk.Dasas ($100 in chips) 
Kiosk230472: posts small blind $0.50
flk.Dasas: posts big blind $1
R1aki: sits out 
*** HOLE CARDS ***
Dealt to matiko09 [6h Th]
Donetsk1y: raises $2 to $3
CI58: folds 
matiko09: folds 
nubpoker: calls $3
Kukuryzka: folds 
Kiosk230472: calls $2.50
flk.Dasas: folds 
*** FLOP *** [6s 7c 4s]
Kiosk230472: checks 
Donetsk1y: bets $7.12
nubpoker: calls $7.12
Kiosk230472: folds 
*** TURN *** [6s 7c 4s] [Ts]
Donetsk1y: checks 
nubpoker: bets $12
Donetsk1y: raises $30.57 to $42.57
nubpoker: folds 
Uncalled bet ($30.57) returned to Donetsk1y
Donetsk1y collected $45.83 from pot
Donetsk1y: doesn't show hand 
*** SUMMARY ***
Total pot $48.24 | Rake $2.41 
Board [6s 7c 4s Ts]
Seat 1: Donetsk1y collected ($45.83)
Seat 2: CI58 folded before Flop (didn't bet)
Seat 3: matiko09 folded before Flop (didn't bet)
Seat 4: nubpoker folded on the Turn
Seat 7: Kukuryzka (button) folded before Flop (didn't bet)
Seat 8: Kiosk230472 (small blind) folded on the Flop
Seat 9: flk.Dasas (big blind) folded before Flop





PokerStars Hand #153069452881:  Hold'em No Limit ($0.50/$1.00 USD) - 2016/05/09 17:34:00 CET [2016/05/09 11:34:00 ET]
Table 'Reiss' 9-max Seat #1 is the button
Seat 1: Dickyxxx ($194.91 in chips) 
Seat 4: Donetsk1y ($100 in chips) 
Seat 5: matiko09 ($136.85 in chips) 
Seat 6: HITYESCA ($204.74 in chips) 
Seat 7: nubpoker ($101.50 in chips) 
Seat 8: JimineyCrik ($100 in chips) 
Seat 9: taxi1313 ($92.26 in chips) 
Donetsk1y: posts small blind $0.50
matiko09: posts big blind $1
*** HOLE CARDS ***
Dealt to matiko09 [5c 6h]
HITYESCA: raises $2 to $3
nubpoker: folds 
JimineyCrik: folds 
taxi1313: folds 
Dickyxxx: folds 
Donetsk1y: folds 
matiko09: folds 
Uncalled bet ($2) returned to HITYESCA
HITYESCA collected $2.50 from pot
HITYESCA: doesn't show hand 
*** SUMMARY ***
Total pot $2.50 | Rake $0 
Seat 1: Dickyxxx (button) folded before Flop (didn't bet)
Seat 4: Donetsk1y (small blind) folded before Flop
Seat 5: matiko09 (big blind) folded before Flop
Seat 6: HITYESCA collected ($2.50)
Seat 7: nubpoker folded before Flop (didn't bet)
Seat 8: JimineyCrik folded before Flop (didn't bet)
Seat 9: taxi1313 folded before Flop (didn't bet)





PokerStars Hand #153069455911:  Hold'em No Limit ($0.50/$1.00 USD) - 2016/05/09 17:34:05 CET [2016/05/09 11:34:05 ET]
Table 'Odyssey' 9-max Seat #6 is the button
Seat 1: matiko09 ($112.34 in chips) 
Seat 2: flk.Dasas ($100 in chips) 
Seat 5: Donetsk1y ($101.50 in chips) 
Seat 6: Kukuryzka ($123.79 in chips) 
Seat 7: CI58 ($100 in chips) 
Seat 9: hellig777 ($244.10 in chips) 
CI58: posts small blind $0.50
nubpoker: is sitting out 
hellig777: posts big blind $1
*** HOLE CARDS ***
Dealt to matiko09 [3d 2c]
nubpoker leaves the table
R1aki joins the table at seat #4 
matiko09: folds 
flk.Dasas: folds 
Donetsk1y: folds 
Kukuryzka: folds 
CI58: folds 
Uncalled bet ($0.50) returned to hellig777
hellig777 collected $1 from pot
*** SUMMARY ***
Total pot $1 | Rake $0 
Seat 1: matiko09 folded before Flop (didn't bet)
Seat 2: flk.Dasas folded before Flop (didn't bet)
Seat 5: Donetsk1y folded before Flop (didn't bet)
Seat 6: Kukuryzka (button) folded before Flop (didn't bet)
Seat 7: CI58 (small blind) folded before Flop
Seat 9: hellig777 (big blind) collected ($1)





PokerStars Hand #153069465241:  Hold'em No Limit ($0.50/$1.00 USD) - 2016/05/09 17:34:20 CET [2016/05/09 11:34:20 ET]
Table 'Orthos' 9-max Seat #6 is the button
Seat 1: Kelvin sai ($83.54 in chips) 
Seat 2: PacPacBum ($101.50 in chips) 
Seat 4: nubpoker ($155.37 in chips) 
Seat 5: matiko09 ($144.81 in chips) 
Seat 6: xhinostrabli ($71.61 in chips) 
Seat 7: flk.Dasas ($177.05 in chips) 
Seat 8: Dickyxxx ($102.17 in chips) 
flk.Dasas: posts small blind $0.50
Dickyxxx: posts big blind $1
Donetsk1y: sits out 
I The King I: sits out 
*** HOLE CARDS ***
Dealt to matiko09 [2d Ts]
Kelvin sai: raises $2 to $3
PacPacBum: raises $6 to $9
nubpoker: folds 
matiko09: folds 
xhinostrabli: folds 
flk.Dasas: folds 
Dickyxxx: folds 
Kelvin sai: calls $6
*** FLOP *** [3c Kd Ks]
Kelvin sai: checks 
PacPacBum: checks 
*** TURN *** [3c Kd Ks] [6d]
Kelvin sai: checks 
PacPacBum: checks 
*** RIVER *** [3c Kd Ks 6d] [3d]
Kelvin sai: checks 
PacPacBum: bets $6.48
Kelvin sai: calls $6.48
*** SHOW DOWN ***
PacPacBum: shows [Kc Kh] (four of a kind, Kings)
Kelvin sai: mucks hand 
PacPacBum collected $30.84 from pot
*** SUMMARY ***
Total pot $32.46 | Rake $1.62 
Board [3c Kd Ks 6d 3d]
Seat 1: Kelvin sai mucked [4c 4h]
Seat 2: PacPacBum showed [Kc Kh] and won ($30.84) with four of a kind, Kings
Seat 4: nubpoker folded before Flop (didn't bet)
Seat 5: matiko09 folded before Flop (didn't bet)
Seat 6: xhinostrabli (button) folded before Flop (didn't bet)
Seat 7: flk.Dasas (small blind) folded before Flop
Seat 8: Dickyxxx (big blind) folded before Flop





PokerStars Hand #153069474132:  Hold'em No Limit ($0.50/$1.00 USD) - 2016/05/09 17:34:34 CET [2016/05/09 11:34:34 ET]
Table 'Reiss' 9-max Seat #4 is the button
Seat 1: Dickyxxx ($194.91 in chips) 
Seat 4: Donetsk1y ($100 in chips) 
Seat 5: matiko09 ($135.85 in chips) 
Seat 6: HITYESCA ($206.24 in chips) 
Seat 7: nubpoker ($101.50 in chips) 
Seat 8: JimineyCrik ($100 in chips) 
Seat 9: taxi1313 ($92.26 in chips) 
matiko09: posts small blind $0.50
HITYESCA: posts big blind $1
*** HOLE CARDS ***
Dealt to matiko09 [6s 4h]
nubpoker: folds 
JimineyCrik: folds 
taxi1313: folds 
Dickyxxx: folds 
Donetsk1y: folds 
matiko09: folds 
Uncalled bet ($0.50) returned to HITYESCA
HITYESCA collected $1 from pot
HITYESCA: doesn't show hand 
*** SUMMARY ***
Total pot $1 | Rake $0 
Seat 1: Dickyxxx folded before Flop (didn't bet)
Seat 4: Donetsk1y (button) folded before Flop (didn't bet)
Seat 5: matiko09 (small blind) folded before Flop
Seat 6: HITYESCA (big blind) collected ($1)
Seat 7: nubpoker folded before Flop (didn't bet)
Seat 8: JimineyCrik folded before Flop (didn't bet)
Seat 9: taxi1313 folded before Flop (didn't bet)





PokerStars Hand #153069475414:  Hold'em No Limit ($0.50/$1.00 USD) - 2016/05/09 17:34:36 CET [2016/05/09 11:34:36 ET]
Table 'Unuk' 9-max Seat #4 is the button
Seat 1: I The King I ($100 in chips) 
Seat 2: nubpoker ($100 in chips) 
Seat 3: CI58 ($103.40 in chips) 
Seat 4: HITYESCA ($132.19 in chips) 
Seat 5: 76198 ($104.98 in chips) 
Seat 6: matiko09 ($100 in chips) 
Seat 7: Donetsk1y ($121.73 in chips) 
Seat 8: Lesley2002 ($99.45 in chips) 
Seat 9: flk.Dasas ($100 in chips) 
76198: posts small blind $0.50
matiko09: posts big blind $1
*** HOLE CARDS ***
Dealt to matiko09 [7c 9h]
Donetsk1y: folds 
Lesley2002: folds 
flk.Dasas: folds 
I The King I: raises $2 to $3
nubpoker: folds 
CI58: folds 
HITYESCA: folds 
76198: folds 
matiko09: folds 
Uncalled bet ($2) returned to I The King I
I The King I collected $2.50 from pot
I The King I: doesn't show hand 
*** SUMMARY ***
Total pot $2.50 | Rake $0 
Seat 1: I The King I collected ($2.50)
Seat 2: nubpoker folded before Flop (didn't bet)
Seat 3: CI58 folded before Flop (didn't bet)
Seat 4: HITYESCA (button) folded before Flop (didn't bet)
Seat 5: 76198 (small blind) folded before Flop
Seat 6: matiko09 (big blind) folded before Flop
Seat 7: Donetsk1y folded before Flop (didn't bet)
Seat 8: Lesley2002 folded before Flop (didn't bet)
Seat 9: flk.Dasas folded before Flop (didn't bet)





PokerStars Hand #153069476445:  Hold'em No Limit ($0.50/$1.00 USD) - 2016/05/09 17:34:37 CET [2016/05/09 11:34:37 ET]
Table 'Odyssey' 9-max Seat #7 is the button
Seat 1: matiko09 ($112.34 in chips) 
Seat 2: flk.Dasas ($100 in chips) 
Seat 5: Donetsk1y ($101.50 in chips) 
Seat 6: Kukuryzka ($123.79 in chips) 
Seat 7: CI58 ($100 in chips) 
Seat 9: hellig777 ($244.60 in chips) 
hellig777: posts small blind $0.50
matiko09: posts big blind $1
R1aki: sits out 
*** HOLE CARDS ***
Dealt to matiko09 [2s Ac]
flk.Dasas: folds 
Donetsk1y: folds 
Kukuryzka: folds 
CI58: raises $1.25 to $2.25
hellig777: calls $1.75
matiko09: calls $1.25
*** FLOP *** [3c 9s Ah]
hellig777: checks 
matiko09: checks 
CI58: checks 
*** TURN *** [3c 9s Ah] [9h]
hellig777: bets $3.20
matiko09: calls $3.20
CI58: folds 
*** RIVER *** [3c 9s Ah 9h] [5s]
hellig777: checks 
matiko09: checks 
*** SHOW DOWN ***
hellig777: shows [Kh 3h] (two pair, Nines and Threes)
matiko09: shows [2s Ac] (two pair, Aces and Nines)
matiko09 collected $12.49 from pot
*** SUMMARY ***
Total pot $13.15 | Rake $0.66 
Board [3c 9s Ah 9h 5s]
Seat 1: matiko09 (big blind) showed [2s Ac] and won ($12.49) with two pair, Aces and Nines
Seat 2: flk.Dasas folded before Flop (didn't bet)
Seat 5: Donetsk1y folded before Flop (didn't bet)
Seat 6: Kukuryzka folded before Flop (didn't bet)
Seat 7: CI58 (button) folded on the Turn
Seat 9: hellig777 (small blind) showed [Kh 3h] and lost with two pair, Nines and Threes





PokerStars Hand #153069484849:  Hold'em No Limit ($0.50/$1.00 USD) - 2016/05/09 17:34:51 CET [2016/05/09 11:34:51 ET]
Table 'Reiss' 9-max Seat #5 is the button
Seat 1: Dickyxxx ($194.91 in chips) 
Seat 4: Donetsk1y ($100 in chips) 
Seat 5: matiko09 ($135.35 in chips) 
Seat 6: HITYESCA ($206.74 in chips) 
Seat 8: JimineyCrik ($100 in chips) 
Seat 9: taxi1313 ($92.26 in chips) 
HITYESCA: posts small blind $0.50
nubpoker: is sitting out 
JimineyCrik: posts big blind $1
*** HOLE CARDS ***
Dealt to matiko09 [9h 8c]
nubpoker leaves the table
taxi1313: folds 
Dickyxxx: folds 
CI58 joins the table at seat #7 
Donetsk1y: raises $1.50 to $2.50
matiko09: folds 
HITYESCA: folds 
JimineyCrik: calls $1.50
*** FLOP *** [Ad Td 3d]
JimineyCrik: checks 
Donetsk1y: checks 
*** TURN *** [Ad Td 3d] [6c]
JimineyCrik: bets $2.66
Donetsk1y: folds 
Uncalled bet ($2.66) returned to JimineyCrik
JimineyCrik collected $5.22 from pot
JimineyCrik: doesn't show hand 
*** SUMMARY ***
Total pot $5.50 | Rake $0.28 
Board [Ad Td 3d 6c]
Seat 1: Dickyxxx folded before Flop (didn't bet)
Seat 4: Donetsk1y folded on the Turn
Seat 5: matiko09 (button) folded before Flop (didn't bet)
Seat 6: HITYESCA (small blind) folded before Flop
Seat 8: JimineyCrik (big blind) collected ($5.22)
Seat 9: taxi1313 folded before Flop (didn't bet)





PokerStars Hand #153069500159:  Hold'em No Limit ($0.50/$1.00 USD) - 2016/05/09 17:35:15 CET [2016/05/09 11:35:15 ET]
Table 'Unuk' 9-max Seat #5 is the button
Seat 1: I The King I ($101.50 in chips) 
Seat 2: nubpoker ($100 in chips) 
Seat 3: CI58 ($103.40 in chips) 
Seat 4: HITYESCA ($132.19 in chips) 
Seat 5: 76198 ($104.48 in chips) 
Seat 6: matiko09 ($100 in chips) 
Seat 7: Donetsk1y ($121.73 in chips) 
Seat 8: Lesley2002 ($99.45 in chips) 
Seat 9: flk.Dasas ($100 in chips) 
matiko09: posts small blind $0.50
Donetsk1y: posts big blind $1
*** HOLE CARDS ***
Dealt to matiko09 [Tc Qh]
Lesley2002: folds 
flk.Dasas: folds 
I The King I: raises $2 to $3
nubpoker: folds 
CI58: folds 
HITYESCA: folds 
76198: folds 
matiko09: folds 
Donetsk1y: folds 
Uncalled bet ($2) returned to I The King I
I The King I collected $2.50 from pot
I The King I: doesn't show hand 
*** SUMMARY ***
Total pot $2.50 | Rake $0 
Seat 1: I The King I collected ($2.50)
Seat 2: nubpoker folded before Flop (didn't bet)
Seat 3: CI58 folded before Flop (didn't bet)
Seat 4: HITYESCA folded before Flop (didn't bet)
Seat 5: 76198 (button) folded before Flop (didn't bet)
Seat 6: matiko09 (small blind) folded before Flop
Seat 7: Donetsk1y (big blind) folded before Flop
Seat 8: Lesley2002 folded before Flop (didn't bet)
Seat 9: flk.Dasas folded before Flop (didn't bet)





PokerStars Hand #153069508063:  Hold'em No Limit ($1/$2 USD) - 2016/05/09 17:35:27 CET [2016/05/09 11:35:27 ET]
Table 'Celaeno II' 9-max Seat #7 is the button
Seat 1: LRVAV7 ($253.67 in chips) 
Seat 2: PacPacBum ($214.81 in chips) 
Seat 3: CI58 ($200 in chips) 
Seat 4: matiko09 ($403.49 in chips) 
Seat 5: KovIFish89 ($200 in chips) 
Seat 6: Igoriah ($237.52 in chips) 
Seat 7: HuanHuan ($213.56 in chips) 
Seat 9: RamiroAgujis ($227.37 in chips) 
RamiroAgujis: posts small blind $1
LRVAV7: posts big blind $2
*** HOLE CARDS ***
Dealt to matiko09 [Qs 7h]
PacPacBum: folds 
CI58: folds 
matiko09: folds 
KovIFish89: raises $4 to $6
Igoriah: folds 
HuanHuan: raises $12 to $18
RamiroAgujis: folds 
LRVAV7: folds 
KovIFish89: folds 
Uncalled bet ($12) returned to HuanHuan
HuanHuan collected $15 from pot
HuanHuan: doesn't show hand 
*** SUMMARY ***
Total pot $15 | Rake $0 
Seat 1: LRVAV7 (big blind) folded before Flop
Seat 2: PacPacBum folded before Flop (didn't bet)
Seat 3: CI58 folded before Flop (didn't bet)
Seat 4: matiko09 folded before Flop (didn't bet)
Seat 5: KovIFish89 folded before Flop
Seat 6: Igoriah folded before Flop (didn't bet)
Seat 7: HuanHuan (button) collected ($15)
Seat 9: RamiroAgujis (small blind) folded before Flop





PokerStars Hand #153069512881:  Hold'em No Limit ($0.50/$1.00 USD) - 2016/05/09 17:35:33 CET [2016/05/09 11:35:33 ET]
Table 'Odyssey' 9-max Seat #9 is the button
Seat 1: matiko09 ($119.38 in chips) 
Seat 2: flk.Dasas ($100 in chips) 
Seat 5: Donetsk1y ($101.50 in chips) 
Seat 6: Kukuryzka ($123.79 in chips) 
Seat 7: CI58 ($100 in chips) 
Seat 9: hellig777 ($239.15 in chips) 
matiko09: posts small blind $0.50
flk.Dasas: posts big blind $1
R1aki: sits out 
*** HOLE CARDS ***
Dealt to matiko09 [7d 8c]
Donetsk1y: raises $2 to $3
Kukuryzka: folds 
CI58: folds 
hellig777: calls $3
matiko09: folds 
flk.Dasas: calls $2
*** FLOP *** [Td 3c 7c]
flk.Dasas: checks 
Donetsk1y: bets $9.02
hellig777: calls $9.02
flk.Dasas: folds 
*** TURN *** [Td 3c 7c] [5h]
Donetsk1y: bets $26.16
hellig777: calls $26.16
*** RIVER *** [Td 3c 7c 5h] [Ac]
Donetsk1y: bets $5
hellig777: calls $5
*** SHOW DOWN ***
Donetsk1y: shows [Ah As] (three of a kind, Aces)
hellig777: mucks hand 
Donetsk1y collected $87.36 from pot
*** SUMMARY ***
Total pot $89.86 | Rake $2.50 
Board [Td 3c 7c 5h Ac]
Seat 1: matiko09 (small blind) folded before Flop
Seat 2: flk.Dasas (big blind) folded on the Flop
Seat 5: Donetsk1y showed [Ah As] and won ($87.36) with three of a kind, Aces
Seat 6: Kukuryzka folded before Flop (didn't bet)
Seat 7: CI58 folded before Flop (didn't bet)
Seat 9: hellig777 (button) mucked [8h 8d]





PokerStars Hand #153069516902:  Hold'em No Limit ($0.50/$1.00 USD) - 2016/05/09 17:35:40 CET [2016/05/09 11:35:40 ET]
Table 'Reiss' 9-max Seat #6 is the button
Seat 1: Dickyxxx ($194.91 in chips) 
Seat 4: Donetsk1y ($100 in chips) 
Seat 5: matiko09 ($135.35 in chips) 
Seat 6: HITYESCA ($206.24 in chips) 
Seat 8: JimineyCrik ($102.72 in chips) 
Seat 9: taxi1313 ($92.26 in chips) 
CI58 will be allowed to play after the button
JimineyCrik: posts small blind $0.50
taxi1313: posts big blind $1
flk.Dasas: sits out 
*** HOLE CARDS ***
Dealt to matiko09 [Qh 4h]
Dickyxxx: folds 
Donetsk1y: raises $2 to $3
matiko09: folds 
HITYESCA: calls $3
JimineyCrik: folds 
taxi1313: calls $2
*** FLOP *** [7h 9c Jc]
taxi1313: checks 
Donetsk1y: checks 
HITYESCA: bets $6.83
taxi1313: folds 
Donetsk1y: calls $6.83
*** TURN *** [7h 9c Jc] [8c]
Donetsk1y: checks 
HITYESCA: checks 
*** RIVER *** [7h 9c Jc 8c] [8s]
Donetsk1y: bets $14
HITYESCA: folds 
Uncalled bet ($14) returned to Donetsk1y
Donetsk1y collected $22 from pot
Donetsk1y: doesn't show hand 
*** SUMMARY ***
Total pot $23.16 | Rake $1.16 
Board [7h 9c Jc 8c 8s]
Seat 1: Dickyxxx folded before Flop (didn't bet)
Seat 4: Donetsk1y collected ($22)
Seat 5: matiko09 folded before Flop (didn't bet)
Seat 6: HITYESCA (button) folded on the River
Seat 8: JimineyCrik (small blind) folded before Flop
Seat 9: taxi1313 (big blind) folded on the Flop





PokerStars Hand #153069521427:  Hold'em No Limit ($0.50/$1.00 USD) - 2016/05/09 17:35:47 CET [2016/05/09 11:35:47 ET]
Table 'Terpsichore' 9-max Seat #8 is the button
Seat 1: Donetsk1y ($123.71 in chips) 
Seat 2: CI58 ($104.42 in chips) 
Seat 3: matiko09 ($150.77 in chips) 
Seat 4: nubpoker ($100 in chips) 
Seat 7: Kukuryzka ($104 in chips) 
Seat 8: Kiosk230472 ($100.16 in chips) 
Seat 9: flk.Dasas ($100 in chips) 
flk.Dasas: posts small blind $0.50
Donetsk1y: posts big blind $1
R1aki: sits out 
*** HOLE CARDS ***
Dealt to matiko09 [9d 4d]
CI58: folds 
matiko09: folds 
nubpoker: folds 
Kukuryzka: raises $1.50 to $2.50
Kiosk230472: calls $2.50
flk.Dasas: folds 
Donetsk1y: folds 
*** FLOP *** [6s 2d 9s]
Kukuryzka: checks 
Kiosk230472: bets $7
Kukuryzka: folds 
Uncalled bet ($7) returned to Kiosk230472
Kiosk230472 collected $6.18 from pot
Kiosk230472: doesn't show hand 
*** SUMMARY ***
Total pot $6.50 | Rake $0.32 
Board [6s 2d 9s]
Seat 1: Donetsk1y (big blind) folded before Flop
Seat 2: CI58 folded before Flop (didn't bet)
Seat 3: matiko09 folded before Flop (didn't bet)
Seat 4: nubpoker folded before Flop (didn't bet)
Seat 7: Kukuryzka folded on the Flop
Seat 8: Kiosk230472 (button) collected ($6.18)
Seat 9: flk.Dasas (small blind) folded before Flop





PokerStars Hand #153069521802:  Hold'em No Limit ($0.50/$1.00 USD) - 2016/05/09 17:35:47 CET [2016/05/09 11:35:47 ET]
Table 'Unuk' 9-max Seat #6 is the button
Seat 1: I The King I ($103 in chips) 
Seat 2: nubpoker ($100 in chips) 
Seat 3: CI58 ($103.40 in chips) 
Seat 4: HITYESCA ($132.19 in chips) 
Seat 5: 76198 ($104.48 in chips) 
Seat 6: matiko09 ($100 in chips) 
Seat 7: Donetsk1y ($120.73 in chips) 
Seat 8: Lesley2002 ($99.45 in chips) 
Seat 9: flk.Dasas ($100 in chips) 
Donetsk1y: posts small blind $0.50
Lesley2002: posts big blind $1
*** HOLE CARDS ***
Dealt to matiko09 [7s Td]
flk.Dasas: folds 
flk.Dasas leaves the table
I The King I: folds 
nubpoker: folds 
CI58: folds 
HITYESCA: folds 
76198: raises $1 to $2
matiko09: folds 
Donetsk1y: folds 
Lesley2002: folds 
Uncalled bet ($1) returned to 76198
76198 collected $2.50 from pot
76198: doesn't show hand 
*** SUMMARY ***
Total pot $2.50 | Rake $0 
Seat 1: I The King I folded before Flop (didn't bet)
Seat 2: nubpoker folded before Flop (didn't bet)
Seat 3: CI58 folded before Flop (didn't bet)
Seat 4: HITYESCA folded before Flop (didn't bet)
Seat 5: 76198 collected ($2.50)
Seat 6: matiko09 (button) folded before Flop (didn't bet)
Seat 7: Donetsk1y (small blind) folded before Flop
Seat 8: Lesley2002 (big blind) folded before Flop
Seat 9: flk.Dasas folded before Flop (didn't bet)





PokerStars Hand #153069530408:  Hold'em No Limit ($0.50/$1.00 USD) - 2016/05/09 17:36:01 CET [2016/05/09 11:36:01 ET]
Table 'Orthos' 9-max Seat #7 is the button
Seat 1: Kelvin sai ($68.06 in chips) 
Seat 2: PacPacBum ($116.86 in chips) 
Seat 4: nubpoker ($155.37 in chips) 
Seat 5: matiko09 ($144.81 in chips) 
Seat 6: xhinostrabli ($71.61 in chips) 
Seat 7: flk.Dasas ($176.55 in chips) 
Seat 8: Dickyxxx ($101.17 in chips) 
Seat 9: Donetsk1y ($100 in chips) 
Dickyxxx: posts small blind $0.50
Donetsk1y: posts big blind $1
I The King I: sits out 
*** HOLE CARDS ***
Dealt to matiko09 [Th Ac]
Kelvin sai: folds 
PacPacBum: folds 
nubpoker: folds 
matiko09: raises $2 to $3
xhinostrabli: folds 
flk.Dasas: folds 
Dickyxxx: folds 
Donetsk1y: folds 
Uncalled bet ($2) returned to matiko09
matiko09 collected $2.50 from pot
matiko09: doesn't show hand 
*** SUMMARY ***
Total pot $2.50 | Rake $0 
Seat 1: Kelvin sai folded before Flop (didn't bet)
Seat 2: PacPacBum folded before Flop (didn't bet)
Seat 4: nubpoker folded before Flop (didn't bet)
Seat 5: matiko09 collected ($2.50)
Seat 6: xhinostrabli folded before Flop (didn't bet)
Seat 7: flk.Dasas (button) folded before Flop (didn't bet)
Seat 8: Dickyxxx (small blind) folded before Flop
Seat 9: Donetsk1y (big blind) folded before Flop





PokerStars Hand #153069542563:  Hold'em No Limit ($1/$2 USD) - 2016/05/09 17:36:20 CET [2016/05/09 11:36:20 ET]
Table 'Celaeno II' 9-max Seat #9 is the button
Seat 1: LRVAV7 ($251.67 in chips) 
Seat 2: PacPacBum ($214.81 in chips) 
Seat 3: CI58 ($200 in chips) 
Seat 4: matiko09 ($403.49 in chips) 
Seat 5: KovIFish89 ($200 in chips) 
Seat 6: Igoriah ($237.52 in chips) 
Seat 7: HuanHuan ($222.56 in chips) 
Seat 9: RamiroAgujis ($226.37 in chips) 
LRVAV7: posts small blind $1
PacPacBum: posts big blind $2
*** HOLE CARDS ***
Dealt to matiko09 [Qs 3c]
CI58: folds 
matiko09: folds 
KovIFish89: folds 
Igoriah: folds 
HuanHuan: raises $3 to $5
RamiroAgujis: folds 
LRVAV7: folds 
PacPacBum: folds 
Uncalled bet ($3) returned to HuanHuan
HuanHuan collected $5 from pot
HuanHuan: doesn't show hand 
*** SUMMARY ***
Total pot $5 | Rake $0 
Seat 1: LRVAV7 (small blind) folded before Flop
Seat 2: PacPacBum (big blind) folded before Flop
Seat 3: CI58 folded before Flop (didn't bet)
Seat 4: matiko09 folded before Flop (didn't bet)
Seat 5: KovIFish89 folded before Flop (didn't bet)
Seat 6: Igoriah folded before Flop (didn't bet)
Seat 7: HuanHuan collected ($5)
Seat 9: RamiroAgujis (button) folded before Flop (didn't bet)





PokerStars Hand #153069557474:  Hold'em No Limit ($1/$2 USD) - 2016/05/09 17:36:43 CET [2016/05/09 11:36:43 ET]
Table 'Celaeno II' 9-max Seat #1 is the button
Seat 1: LRVAV7 ($250.67 in chips) 
Seat 2: PacPacBum ($212.81 in chips) 
Seat 3: CI58 ($200 in chips) 
Seat 4: matiko09 ($403.49 in chips) 
Seat 5: KovIFish89 ($200 in chips) 
Seat 6: Igoriah ($237.52 in chips) 
Seat 7: HuanHuan ($225.56 in chips) 
Seat 9: RamiroAgujis ($226.37 in chips) 
PacPacBum: posts small blind $1
CI58: posts big blind $2
*** HOLE CARDS ***
Dealt to matiko09 [6c 6d]
matiko09: raises $3 to $5
KovIFish89: folds 
Igoriah: folds 
HuanHuan: folds 
RamiroAgujis: calls $5
LRVAV7: folds 
PacPacBum: folds 
CI58: folds 
*** FLOP *** [Th Ad Kc]
matiko09: checks 
RamiroAgujis: bets $6.79
matiko09: folds 
Uncalled bet ($6.79) returned to RamiroAgujis
RamiroAgujis collected $12.35 from pot
RamiroAgujis: doesn't show hand 
*** SUMMARY ***
Total pot $13 | Rake $0.65 
Board [Th Ad Kc]
Seat 1: LRVAV7 (button) folded before Flop (didn't bet)
Seat 2: PacPacBum (small blind) folded before Flop
Seat 3: CI58 (big blind) folded before Flop
Seat 4: matiko09 folded on the Flop
Seat 5: KovIFish89 folded before Flop (didn't bet)
Seat 6: Igoriah folded before Flop (didn't bet)
Seat 7: HuanHuan folded before Flop (didn't bet)
Seat 9: RamiroAgujis collected ($12.35)





PokerStars Hand #153069557845:  Hold'em No Limit ($0.50/$1.00 USD) - 2016/05/09 17:36:43 CET [2016/05/09 11:36:43 ET]
Table 'Orthos' 9-max Seat #8 is the button
Seat 1: Kelvin sai ($68.06 in chips) 
Seat 2: PacPacBum ($116.86 in chips) 
Seat 4: nubpoker ($155.37 in chips) 
Seat 5: matiko09 ($146.31 in chips) 
Seat 6: xhinostrabli ($71.61 in chips) 
Seat 7: flk.Dasas ($176.55 in chips) 
Seat 8: Dickyxxx ($100.67 in chips) 
Seat 9: Donetsk1y ($100 in chips) 
Donetsk1y: posts small blind $0.50
Kelvin sai: posts big blind $1
I The King I: sits out 
*** HOLE CARDS ***
Dealt to matiko09 [5d Ad]
PacPacBum: folds 
nubpoker: folds 
matiko09: raises $2 to $3
xhinostrabli: calls $3
flk.Dasas: folds 
Dickyxxx: folds 
Donetsk1y: folds 
Kelvin sai: folds 
*** FLOP *** [9d Ac Kd]
matiko09: checks 
xhinostrabli: checks 
*** TURN *** [9d Ac Kd] [Jh]
matiko09: bets $4.63
xhinostrabli: calls $4.63
*** RIVER *** [9d Ac Kd Jh] [6c]
matiko09: checks 
xhinostrabli: checks 
*** SHOW DOWN ***
matiko09: shows [5d Ad] (a pair of Aces)
xhinostrabli: mucks hand 
matiko09 collected $15.92 from pot
*** SUMMARY ***
Total pot $16.76 | Rake $0.84 
Board [9d Ac Kd Jh 6c]
Seat 1: Kelvin sai (big blind) folded before Flop
Seat 2: PacPacBum folded before Flop (didn't bet)
Seat 4: nubpoker folded before Flop (didn't bet)
Seat 5: matiko09 showed [5d Ad] and won ($15.92) with a pair of Aces
Seat 6: xhinostrabli mucked [Qs Ks]
Seat 7: flk.Dasas folded before Flop (didn't bet)
Seat 8: Dickyxxx (button) folded before Flop (didn't bet)
Seat 9: Donetsk1y (small blind) folded before Flop





PokerStars Hand #153069559693:  Hold'em No Limit ($0.50/$1.00 USD) - 2016/05/09 17:36:46 CET [2016/05/09 11:36:46 ET]
Table 'Unuk' 9-max Seat #7 is the button
Seat 1: I The King I ($103 in chips) 
Seat 2: nubpoker ($100 in chips) 
Seat 3: CI58 ($103.40 in chips) 
Seat 4: HITYESCA ($132.19 in chips) 
Seat 5: 76198 ($105.98 in chips) 
Seat 6: matiko09 ($100 in chips) 
Seat 7: Donetsk1y ($120.23 in chips) 
Seat 8: Lesley2002 ($98.45 in chips) 
Lesley2002: posts small blind $0.50
I The King I: posts big blind $1
*** HOLE CARDS ***
Dealt to matiko09 [Jc Ks]
nubpoker: folds 
CI58: folds 
HITYESCA: folds 
76198: folds 
matiko09: raises $1.50 to $2.50
Donetsk1y: folds 
Lesley2002: calls $2
I The King I: folds 
*** FLOP *** [3h Qc 2d]
Lesley2002: checks 
matiko09: bets $3.71
Lesley2002: calls $3.71
*** TURN *** [3h Qc 2d] [9c]
Lesley2002: checks 
matiko09: checks 
*** RIVER *** [3h Qc 2d 9c] [8d]
Lesley2002: bets $6
matiko09: folds 
Uncalled bet ($6) returned to Lesley2002
Lesley2002 collected $12.75 from pot
*** SUMMARY ***
Total pot $13.42 | Rake $0.67 
Board [3h Qc 2d 9c 8d]
Seat 1: I The King I (big blind) folded before Flop
Seat 2: nubpoker folded before Flop (didn't bet)
Seat 3: CI58 folded before Flop (didn't bet)
Seat 4: HITYESCA folded before Flop (didn't bet)
Seat 5: 76198 folded before Flop (didn't bet)
Seat 6: matiko09 folded on the River
Seat 7: Donetsk1y (button) folded before Flop (didn't bet)
Seat 8: Lesley2002 (small blind) collected ($12.75)





PokerStars Hand #153069562490:  Hold'em No Limit ($0.50/$1.00 USD) - 2016/05/09 17:36:51 CET [2016/05/09 11:36:51 ET]
Table 'Terpsichore' 9-max Seat #9 is the button
Seat 1: Donetsk1y ($122.71 in chips) 
Seat 2: CI58 ($104.42 in chips) 
Seat 3: matiko09 ($150.77 in chips) 
Seat 4: nubpoker ($100 in chips) 
Seat 7: Kukuryzka ($101.50 in chips) 
Seat 8: Kiosk230472 ($103.84 in chips) 
Seat 9: flk.Dasas ($100 in chips) 
Donetsk1y: posts small blind $0.50
CI58: posts big blind $1
R1aki: sits out 
*** HOLE CARDS ***
Dealt to matiko09 [7s 6h]
matiko09: folds 
nubpoker: folds 
Kukuryzka: raises $2 to $3
Kiosk230472: folds 
flk.Dasas: folds 
Donetsk1y: folds 
CI58: folds 
Uncalled bet ($2) returned to Kukuryzka
Kukuryzka collected $2.50 from pot
Kukuryzka: doesn't show hand 
*** SUMMARY ***
Total pot $2.50 | Rake $0 
Seat 1: Donetsk1y (small blind) folded before Flop
Seat 2: CI58 (big blind) folded before Flop
Seat 3: matiko09 folded before Flop (didn't bet)
Seat 4: nubpoker folded before Flop (didn't bet)
Seat 7: Kukuryzka collected ($2.50)
Seat 8: Kiosk230472 folded before Flop (didn't bet)
Seat 9: flk.Dasas (button) folded before Flop (didn't bet)





PokerStars Hand #153069572625:  Hold'em No Limit ($0.50/$1.00 USD) - 2016/05/09 17:37:06 CET [2016/05/09 11:37:06 ET]
Table 'Odyssey' 9-max Seat #1 is the button
Seat 1: matiko09 ($118.88 in chips) 
Seat 2: flk.Dasas ($100 in chips) 
Seat 4: R1aki ($100 in chips) 
Seat 5: Donetsk1y ($145.68 in chips) 
Seat 6: Kukuryzka ($123.79 in chips) 
Seat 7: CI58 ($100 in chips) 
Seat 9: hellig777 ($195.97 in chips) 
flk.Dasas: posts small blind $0.50
R1aki: posts big blind $1
*** HOLE CARDS ***
Dealt to matiko09 [Kc 2d]
Donetsk1y: folds 
Kukuryzka: folds 
CI58: folds 
hellig777: raises $2 to $3
matiko09: folds 
flk.Dasas: folds 
R1aki: folds 
Uncalled bet ($2) returned to hellig777
hellig777 collected $2.50 from pot
*** SUMMARY ***
Total pot $2.50 | Rake $0 
Seat 1: matiko09 (button) folded before Flop (didn't bet)
Seat 2: flk.Dasas (small blind) folded before Flop
Seat 4: R1aki (big blind) folded before Flop
Seat 5: Donetsk1y folded before Flop (didn't bet)
Seat 6: Kukuryzka folded before Flop (didn't bet)
Seat 7: CI58 folded before Flop (didn't bet)
Seat 9: hellig777 collected ($2.50)





PokerStars Hand #153069582590:  Hold'em No Limit ($0.50/$1.00 USD) - 2016/05/09 17:37:22 CET [2016/05/09 11:37:22 ET]
Table 'Reiss' 9-max Seat #8 is the button
Seat 1: Dickyxxx ($194.91 in chips) 
Seat 4: Donetsk1y ($112.17 in chips) 
Seat 5: matiko09 ($135.35 in chips) 
Seat 6: HITYESCA ($196.41 in chips) 
Seat 8: JimineyCrik ($102.22 in chips) 
Seat 9: taxi1313 ($89.26 in chips) 
taxi1313: posts small blind $0.50
Dickyxxx: posts big blind $1
flk.Dasas: sits out 
CI58: sits out 
*** HOLE CARDS ***
Dealt to matiko09 [Jc Tc]
Donetsk1y: folds 
matiko09: raises $2 to $3
HITYESCA: folds 
JimineyCrik: folds 
taxi1313: folds 
Dickyxxx: folds 
Uncalled bet ($2) returned to matiko09
matiko09 collected $2.50 from pot
matiko09: doesn't show hand 
*** SUMMARY ***
Total pot $2.50 | Rake $0 
Seat 1: Dickyxxx (big blind) folded before Flop
Seat 4: Donetsk1y folded before Flop (didn't bet)
Seat 5: matiko09 collected ($2.50)
Seat 6: HITYESCA folded before Flop (didn't bet)
Seat 8: JimineyCrik (button) folded before Flop (didn't bet)
Seat 9: taxi1313 (small blind) folded before Flop





PokerStars Hand #153069586923:  Hold'em No Limit ($0.50/$1.00 USD) - 2016/05/09 17:37:29 CET [2016/05/09 11:37:29 ET]
Table 'Odyssey' 9-max Seat #2 is the button
Seat 1: matiko09 ($118.88 in chips) 
Seat 2: flk.Dasas ($100 in chips) 
Seat 4: R1aki ($100 in chips) 
Seat 5: Donetsk1y ($145.68 in chips) 
Seat 6: Kukuryzka ($123.79 in chips) 
Seat 7: CI58 ($100 in chips) 
Seat 9: hellig777 ($197.47 in chips) 
R1aki: posts small blind $0.50
Donetsk1y: posts big blind $1
*** HOLE CARDS ***
Dealt to matiko09 [9h 8d]
Kukuryzka: folds 
CI58: folds 
hellig777: raises $1 to $2
matiko09: folds 
flk.Dasas: folds 
R1aki: folds 
Donetsk1y: folds 
Uncalled bet ($1) returned to hellig777
hellig777 collected $2.50 from pot
*** SUMMARY ***
Total pot $2.50 | Rake $0 
Seat 1: matiko09 folded before Flop (didn't bet)
Seat 2: flk.Dasas (button) folded before Flop (didn't bet)
Seat 4: R1aki (small blind) folded before Flop
Seat 5: Donetsk1y (big blind) folded before Flop
Seat 6: Kukuryzka folded before Flop (didn't bet)
Seat 7: CI58 folded before Flop (didn't bet)
Seat 9: hellig777 collected ($2.50)





PokerStars Hand #153069590471:  Hold'em No Limit ($0.50/$1.00 USD) - 2016/05/09 17:37:34 CET [2016/05/09 11:37:34 ET]
Table 'Orthos' 9-max Seat #9 is the button
Seat 1: Kelvin sai ($67.06 in chips) 
Seat 2: PacPacBum ($116.86 in chips) 
Seat 4: nubpoker ($155.37 in chips) 
Seat 5: matiko09 ($154.60 in chips) 
Seat 6: xhinostrabli ($63.98 in chips) 
Seat 7: flk.Dasas ($176.55 in chips) 
Seat 8: Dickyxxx ($100.67 in chips) 
Seat 9: Donetsk1y ($100 in chips) 
Kelvin sai: posts small blind $0.50
PacPacBum: posts big blind $1
I The King I: sits out 
*** HOLE CARDS ***
Dealt to matiko09 [5h 9d]
nubpoker: folds 
matiko09: folds 
xhinostrabli: folds 
flk.Dasas: folds 
Dickyxxx: folds 
Donetsk1y: folds 
Kelvin sai: folds 
Uncalled bet ($0.50) returned to PacPacBum
PacPacBum collected $1 from pot
PacPacBum: doesn't show hand 
*** SUMMARY ***
Total pot $1 | Rake $0 
Seat 1: Kelvin sai (small blind) folded before Flop
Seat 2: PacPacBum (big blind) collected ($1)
Seat 4: nubpoker folded before Flop (didn't bet)
Seat 5: matiko09 folded before Flop (didn't bet)
Seat 6: xhinostrabli folded before Flop (didn't bet)
Seat 7: flk.Dasas folded before Flop (didn't bet)
Seat 8: Dickyxxx folded before Flop (didn't bet)
Seat 9: Donetsk1y (button) folded before Flop (didn't bet)





PokerStars Hand #153069597397:  Hold'em No Limit ($0.50/$1.00 USD) - 2016/05/09 17:37:45 CET [2016/05/09 11:37:45 ET]
Table 'Unuk' 9-max Seat #8 is the button
Seat 1: I The King I ($102 in chips) 
Seat 3: CI58 ($103.40 in chips) 
Seat 4: HITYESCA ($132.19 in chips) 
Seat 5: 76198 ($105.98 in chips) 
Seat 6: matiko09 ($100 in chips) 
Seat 7: Donetsk1y ($120.23 in chips) 
Seat 8: Lesley2002 ($104.99 in chips) 
I The King I: posts small blind $0.50
nubpoker: is sitting out 
nubpoker leaves the table
CI58: posts big blind $1
*** HOLE CARDS ***
Dealt to matiko09 [2c Ts]
R1aki joins the table at seat #9 
HITYESCA: folds 
76198: folds 
matiko09: folds 
Donetsk1y: raises $1.50 to $2.50
Lesley2002: calls $2.50
I The King I: folds 
CI58: folds 
*** FLOP *** [8h 8s 7h]
WDW3 joins the table at seat #2 
Donetsk1y: checks 
Lesley2002: bets $3
Donetsk1y: calls $3
*** TURN *** [8h 8s 7h] [Qc]
Donetsk1y: checks 
Lesley2002: checks 
*** RIVER *** [8h 8s 7h Qc] [4h]
Donetsk1y: checks 
Lesley2002: bets $8
Donetsk1y: folds 
Uncalled bet ($8) returned to Lesley2002
Lesley2002 collected $11.88 from pot
*** SUMMARY ***
Total pot $12.50 | Rake $0.62 
Board [8h 8s 7h Qc 4h]
Seat 1: I The King I (small blind) folded before Flop
Seat 3: CI58 (big blind) folded before Flop
Seat 4: HITYESCA folded before Flop (didn't bet)
Seat 5: 76198 folded before Flop (didn't bet)
Seat 6: matiko09 folded before Flop (didn't bet)
Seat 7: Donetsk1y folded on the River
Seat 8: Lesley2002 (button) collected ($11.88)





PokerStars Hand #153069601909:  Hold'em No Limit ($0.50/$1.00 USD) - 2016/05/09 17:37:52 CET [2016/05/09 11:37:52 ET]
Table 'Odyssey' 9-max Seat #4 is the button
Seat 1: matiko09 ($118.88 in chips) 
Seat 2: flk.Dasas ($100 in chips) 
Seat 4: R1aki ($100 in chips) 
Seat 5: Donetsk1y ($144.68 in chips) 
Seat 6: Kukuryzka ($123.79 in chips) 
Seat 7: CI58 ($100 in chips) 
Seat 9: hellig777 ($198.97 in chips) 
Donetsk1y: posts small blind $0.50
Kukuryzka: posts big blind $1
chaps1988: sits out 
*** HOLE CARDS ***
Dealt to matiko09 [Qh 5s]
CI58: folds 
hellig777: folds 
matiko09: folds 
flk.Dasas: folds 
R1aki: folds 
Donetsk1y: folds 
Uncalled bet ($0.50) returned to Kukuryzka
Kukuryzka collected $1 from pot
Kukuryzka: doesn't show hand 
*** SUMMARY ***
Total pot $1 | Rake $0 
Seat 1: matiko09 folded before Flop (didn't bet)
Seat 2: flk.Dasas folded before Flop (didn't bet)
Seat 4: R1aki (button) folded before Flop (didn't bet)
Seat 5: Donetsk1y (small blind) folded before Flop
Seat 6: Kukuryzka (big blind) collected ($1)
Seat 7: CI58 folded before Flop (didn't bet)
Seat 9: hellig777 folded before Flop (didn't bet)





PokerStars Hand #153069604145:  Hold'em No Limit ($0.50/$1.00 USD) - 2016/05/09 17:37:56 CET [2016/05/09 11:37:56 ET]
Table 'Orthos' 9-max Seat #1 is the button
Seat 1: Kelvin sai ($66.56 in chips) 
Seat 2: PacPacBum ($117.36 in chips) 
Seat 3: I The King I ($100 in chips) 
Seat 4: nubpoker ($155.37 in chips) 
Seat 5: matiko09 ($154.60 in chips) 
Seat 6: xhinostrabli ($63.98 in chips) 
Seat 7: flk.Dasas ($176.55 in chips) 
Seat 8: Dickyxxx ($100.67 in chips) 
Seat 9: Donetsk1y ($100 in chips) 
PacPacBum: posts small blind $0.50
I The King I: posts big blind $1
*** HOLE CARDS ***
Dealt to matiko09 [6c As]
nubpoker: raises $1.50 to $2.50
matiko09: folds 
xhinostrabli: folds 
flk.Dasas: folds 
Dickyxxx: calls $2.50
Donetsk1y: folds 
Kelvin sai: folds 
PacPacBum: folds 
Kelvin sai leaves the table
I The King I: folds 
*** FLOP *** [3h Kd 5c]
nubpoker: bets $4.11
Dickyxxx: folds 
Uncalled bet ($4.11) returned to nubpoker
nubpoker collected $6.18 from pot
nubpoker: doesn't show hand 
*** SUMMARY ***
Total pot $6.50 | Rake $0.32 
Board [3h Kd 5c]
Seat 1: Kelvin sai (button) folded before Flop (didn't bet)
Seat 2: PacPacBum (small blind) folded before Flop
Seat 3: I The King I (big blind) folded before Flop
Seat 4: nubpoker collected ($6.18)
Seat 5: matiko09 folded before Flop (didn't bet)
Seat 6: xhinostrabli folded before Flop (didn't bet)
Seat 7: flk.Dasas folded before Flop (didn't bet)
Seat 8: Dickyxxx folded on the Flop
Seat 9: Donetsk1y folded before Flop (didn't bet)





PokerStars Hand #153069604795:  Hold'em No Limit ($0.50/$1.00 USD) - 2016/05/09 17:37:57 CET [2016/05/09 11:37:57 ET]
Table 'Reiss' 9-max Seat #9 is the button
Seat 1: Dickyxxx ($193.91 in chips) 
Seat 2: flk.Dasas ($100 in chips) 
Seat 4: Donetsk1y ($112.17 in chips) 
Seat 5: matiko09 ($136.85 in chips) 
Seat 6: HITYESCA ($196.41 in chips) 
Seat 8: JimineyCrik ($102.22 in chips) 
Seat 9: taxi1313 ($88.76 in chips) 
Dickyxxx: posts small blind $0.50
flk.Dasas: posts big blind $1
chaps1988: sits out 
CI58: sits out 
*** HOLE CARDS ***
Dealt to matiko09 [Jc 5h]
Donetsk1y: folds 
matiko09: folds 
HITYESCA: folds 
JimineyCrik: raises $4 to $5
taxi1313: folds 
Dickyxxx: folds 
flk.Dasas: folds 
Uncalled bet ($4) returned to JimineyCrik
JimineyCrik collected $2.50 from pot
JimineyCrik: doesn't show hand 
*** SUMMARY ***
Total pot $2.50 | Rake $0 
Seat 1: Dickyxxx (small blind) folded before Flop
Seat 2: flk.Dasas (big blind) folded before Flop
Seat 4: Donetsk1y folded before Flop (didn't bet)
Seat 5: matiko09 folded before Flop (didn't bet)
Seat 6: HITYESCA folded before Flop (didn't bet)
Seat 8: JimineyCrik collected ($2.50)
Seat 9: taxi1313 (button) folded before Flop (didn't bet)





PokerStars Hand #153069617039:  Hold'em No Limit ($0.50/$1.00 USD) - 2016/05/09 17:38:15 CET [2016/05/09 11:38:15 ET]
Table 'Odyssey' 9-max Seat #5 is the button
Seat 1: matiko09 ($118.88 in chips) 
Seat 2: flk.Dasas ($100 in chips) 
Seat 4: R1aki ($100 in chips) 
Seat 5: Donetsk1y ($144.18 in chips) 
Seat 6: Kukuryzka ($124.29 in chips) 
Seat 7: CI58 ($100 in chips) 
Seat 9: hellig777 ($198.97 in chips) 
Kukuryzka: posts small blind $0.50
CI58: posts big blind $1
chaps1988: sits out 
*** HOLE CARDS ***
Dealt to matiko09 [5h 8d]
hellig777: folds 
matiko09: folds 
flk.Dasas: folds 
R1aki: folds 
Donetsk1y: folds 
Kukuryzka: raises $2 to $3
CI58: folds 
Uncalled bet ($2) returned to Kukuryzka
Kukuryzka collected $2 from pot
Kukuryzka: doesn't show hand 
*** SUMMARY ***
Total pot $2 | Rake $0 
Seat 1: matiko09 folded before Flop (didn't bet)
Seat 2: flk.Dasas folded before Flop (didn't bet)
Seat 4: R1aki folded before Flop (didn't bet)
Seat 5: Donetsk1y (button) folded before Flop (didn't bet)
Seat 6: Kukuryzka (small blind) collected ($2)
Seat 7: CI58 (big blind) folded before Flop
Seat 9: hellig777 folded before Flop (didn't bet)





PokerStars Hand #153069618467:  Hold'em No Limit ($0.50/$1.00 USD) - 2016/05/09 17:38:18 CET [2016/05/09 11:38:18 ET]
Table 'Reiss' 9-max Seat #1 is the button
Seat 1: Dickyxxx ($193.41 in chips) 
Seat 2: flk.Dasas ($100 in chips) 
Seat 3: chaps1988 ($121.96 in chips) 
Seat 4: Donetsk1y ($112.17 in chips) 
Seat 5: matiko09 ($136.85 in chips) 
Seat 6: HITYESCA ($196.41 in chips) 
Seat 8: JimineyCrik ($103.72 in chips) 
Seat 9: taxi1313 ($88.76 in chips) 
flk.Dasas: posts small blind $0.50
chaps1988: posts big blind $1
CI58: sits out 
*** HOLE CARDS ***
Dealt to matiko09 [8d 7d]
Donetsk1y: folds 
matiko09: folds 
HITYESCA: folds 
JimineyCrik: folds 
taxi1313: folds 
Dickyxxx: folds 
flk.Dasas: folds 
Uncalled bet ($0.50) returned to chaps1988
chaps1988 collected $1 from pot
chaps1988: doesn't show hand 
*** SUMMARY ***
Total pot $1 | Rake $0 
Seat 1: Dickyxxx (button) folded before Flop (didn't bet)
Seat 2: flk.Dasas (small blind) folded before Flop
Seat 3: chaps1988 (big blind) collected ($1)
Seat 4: Donetsk1y folded before Flop (didn't bet)
Seat 5: matiko09 folded before Flop (didn't bet)
Seat 6: HITYESCA folded before Flop (didn't bet)
Seat 8: JimineyCrik folded before Flop (didn't bet)
Seat 9: taxi1313 folded before Flop (didn't bet)





PokerStars Hand #153069635281:  Hold'em No Limit ($0.50/$1.00 USD) - 2016/05/09 17:38:44 CET [2016/05/09 11:38:44 ET]
Table 'Reiss' 9-max Seat #2 is the button
Seat 1: Dickyxxx ($193.41 in chips) 
Seat 2: flk.Dasas ($100 in chips) 
Seat 3: chaps1988 ($122.46 in chips) 
Seat 4: Donetsk1y ($112.17 in chips) 
Seat 5: matiko09 ($136.85 in chips) 
Seat 6: HITYESCA ($196.41 in chips) 
Seat 8: JimineyCrik ($103.72 in chips) 
Seat 9: taxi1313 ($88.76 in chips) 
chaps1988: posts small blind $0.50
Donetsk1y: posts big blind $1
CI58: sits out 
*** HOLE CARDS ***
Dealt to matiko09 [7s Qc]
matiko09: folds 
HITYESCA: folds 
JimineyCrik: folds 
taxi1313: folds 
Dickyxxx: raises $2 to $3
flk.Dasas: folds 
chaps1988: folds 
Donetsk1y: folds 
Uncalled bet ($2) returned to Dickyxxx
Dickyxxx collected $2.50 from pot
Dickyxxx: doesn't show hand 
*** SUMMARY ***
Total pot $2.50 | Rake $0 
Seat 1: Dickyxxx collected ($2.50)
Seat 2: flk.Dasas (button) folded before Flop (didn't bet)
Seat 3: chaps1988 (small blind) folded before Flop
Seat 4: Donetsk1y (big blind) folded before Flop
Seat 5: matiko09 folded before Flop (didn't bet)
Seat 6: HITYESCA folded before Flop (didn't bet)
Seat 8: JimineyCrik folded before Flop (didn't bet)
Seat 9: taxi1313 folded before Flop (didn't bet)





PokerStars Hand #153069650520:  Hold'em No Limit ($0.50/$1.00 USD) - 2016/05/09 17:39:08 CET [2016/05/09 11:39:08 ET]
Table 'Odyssey' 9-max Seat #6 is the button
Seat 1: matiko09 ($118.88 in chips) 
Seat 2: flk.Dasas ($100 in chips) 
Seat 4: R1aki ($100 in chips) 
Seat 5: Donetsk1y ($144.18 in chips) 
Seat 6: Kukuryzka ($125.29 in chips) 
Seat 7: CI58 ($100 in chips) 
Seat 9: hellig777 ($198.97 in chips) 
CI58: posts small blind $0.50
hellig777: posts big blind $1
chaps1988: sits out 
*** HOLE CARDS ***
Dealt to matiko09 [Js 3s]
matiko09: folds 
flk.Dasas: folds 
R1aki: folds 
pepek60271 joins the table at seat #8 
Donetsk1y: raises $1.50 to $2.50
Kukuryzka: folds 
CI58: folds 
hellig777: folds 
Uncalled bet ($1.50) returned to Donetsk1y
Donetsk1y collected $2.50 from pot
Donetsk1y: doesn't show hand 
*** SUMMARY ***
Total pot $2.50 | Rake $0 
Seat 1: matiko09 folded before Flop (didn't bet)
Seat 2: flk.Dasas folded before Flop (didn't bet)
Seat 4: R1aki folded before Flop (didn't bet)
Seat 5: Donetsk1y collected ($2.50)
Seat 6: Kukuryzka (button) folded before Flop (didn't bet)
Seat 7: CI58 (small blind) folded before Flop
Seat 9: hellig777 (big blind) folded before Flop





PokerStars Hand #153069656960:  Hold'em No Limit ($0.50/$1.00 USD) - 2016/05/09 17:39:18 CET [2016/05/09 11:39:18 ET]
Table 'Unuk' 9-max Seat #1 is the button
Seat 1: I The King I ($101.50 in chips) 
Seat 3: CI58 ($102.40 in chips) 
Seat 4: HITYESCA ($132.19 in chips) 
Seat 5: 76198 ($105.98 in chips) 
Seat 6: matiko09 ($100 in chips) 
Seat 7: Donetsk1y ($114.73 in chips) 
Seat 8: Lesley2002 ($111.37 in chips) 
WDW3 will be allowed to play after the button
CI58: posts small blind $0.50
HITYESCA: posts big blind $1
R1aki: sits out 
*** HOLE CARDS ***
Dealt to matiko09 [7h 2c]
76198: folds 
matiko09: folds 
Donetsk1y: folds 
Lesley2002: raises $1 to $2
I The King I: folds 
CI58: folds 
HITYESCA: folds 
Uncalled bet ($1) returned to Lesley2002
Lesley2002 collected $2.50 from pot
*** SUMMARY ***
Total pot $2.50 | Rake $0 
Seat 1: I The King I (button) folded before Flop (didn't bet)
Seat 3: CI58 (small blind) folded before Flop
Seat 4: HITYESCA (big blind) folded before Flop
Seat 5: 76198 folded before Flop (didn't bet)
Seat 6: matiko09 folded before Flop (didn't bet)
Seat 7: Donetsk1y folded before Flop (didn't bet)
Seat 8: Lesley2002 collected ($2.50)





PokerStars Zoom Hand #153148808870:  Hold'em No Limit ($0.01/$0.02) - 2016/05/11 9:40:54 CET [2016/05/11 3:40:54 ET]
Table 'Halley' 6-max Seat #1 is the button
Seat 1: pashOk1956 ($2.68 in chips) 
Seat 2: juvastik ($1.84 in chips) 
Seat 3: matiko09 ($2 in chips) 
Seat 4: AAvsxD ($5.57 in chips) 
Seat 5: methsky ($5.68 in chips) 
Seat 6: Me1bas ($2.78 in chips) 
juvastik: posts small blind $0.01
matiko09: posts big blind $0.02
*** HOLE CARDS ***
Dealt to matiko09 [3s 4s]
AAvsxD: folds 
methsky: folds 
Me1bas: folds 
pashOk1956: folds 
juvastik: folds 
Uncalled bet ($0.01) returned to matiko09
matiko09 collected $0.02 from pot
matiko09: doesn't show hand 
*** SUMMARY ***
Total pot $0.02 | Rake $0 
Seat 1: pashOk1956 (button) folded before Flop (didn't bet)
Seat 2: juvastik (small blind) folded before Flop
Seat 3: matiko09 (big blind) collected ($0.02)
Seat 4: AAvsxD folded before Flop (didn't bet)
Seat 5: methsky folded before Flop (didn't bet)
Seat 6: Me1bas folded before Flop (didn't bet)





PokerStars Zoom Hand #153148810868:  Hold'em No Limit ($0.01/$0.02) - 2016/05/11 9:41:01 CET [2016/05/11 3:41:01 ET]
Table 'Halley' 6-max Seat #1 is the button
Seat 1: Murzakof ($3.12 in chips) 
Seat 2: loveWanidy ($2.13 in chips) 
Seat 3: Adalizka ($2.69 in chips) 
Seat 4: danirom770 ($1.28 in chips) 
Seat 5: chira00 ($3.02 in chips) 
Seat 6: matiko09 ($2.01 in chips) 
loveWanidy: posts small blind $0.01
Adalizka: posts big blind $0.02
*** HOLE CARDS ***
Dealt to matiko09 [7c 3d]
danirom770: folds 
chira00: folds 
matiko09: folds 
Murzakof: folds 
loveWanidy: folds 
Uncalled bet ($0.01) returned to Adalizka
Adalizka collected $0.02 from pot
Adalizka: doesn't show hand 
*** SUMMARY ***
Total pot $0.02 | Rake $0 
Seat 1: Murzakof (button) folded before Flop (didn't bet)
Seat 2: loveWanidy (small blind) folded before Flop
Seat 3: Adalizka (big blind) collected ($0.02)
Seat 4: danirom770 folded before Flop (didn't bet)
Seat 5: chira00 folded before Flop (didn't bet)
Seat 6: matiko09 folded before Flop (didn't bet)





PokerStars Zoom Hand #153148815515:  Hold'em No Limit ($0.01/$0.02) - 2016/05/11 9:41:17 CET [2016/05/11 3:41:17 ET]
Table 'Halley' 6-max Seat #1 is the button
Seat 1: LocoAlfa ($2.90 in chips) 
Seat 2: matiko09 ($2.01 in chips) 
Seat 3: Hope^F1y ($4.06 in chips) 
Seat 4: Falkkon ($2.74 in chips) 
Seat 5: kantatimo ($1.51 in chips) 
Seat 6: tukhty ($1.53 in chips) 
matiko09: posts small blind $0.01
Hope^F1y: posts big blind $0.02
*** HOLE CARDS ***
Dealt to matiko09 [7s 8c]
Falkkon: folds 
kantatimo: folds 
tukhty: folds 
LocoAlfa: folds 
matiko09: folds 
Uncalled bet ($0.01) returned to Hope^F1y
Hope^F1y collected $0.02 from pot
Hope^F1y: doesn't show hand 
*** SUMMARY ***
Total pot $0.02 | Rake $0 
Seat 1: LocoAlfa (button) folded before Flop (didn't bet)
Seat 2: matiko09 (small blind) folded before Flop
Seat 3: Hope^F1y (big blind) collected ($0.02)
Seat 4: Falkkon folded before Flop (didn't bet)
Seat 5: kantatimo folded before Flop (didn't bet)
Seat 6: tukhty folded before Flop (didn't bet)





PokerStars Zoom Hand #153148818695:  Hold'em No Limit ($0.01/$0.02) - 2016/05/11 9:41:28 CET [2016/05/11 3:41:28 ET]
Table 'Halley' 6-max Seat #1 is the button
Seat 1: matiko09 ($2 in chips) 
Seat 2: bigdanny117 ($9.66 in chips) 
Seat 3: Blackdonn3 ($1.63 in chips) 
Seat 4: kingcarlo317 ($2.34 in chips) 
Seat 5: shinygrl ($2.44 in chips) 
Seat 6: rnwbl ($2.02 in chips) 
bigdanny117: posts small blind $0.01
Blackdonn3: posts big blind $0.02
*** HOLE CARDS ***
Dealt to matiko09 [2h Js]
kingcarlo317: folds 
shinygrl: folds 
rnwbl: folds 
matiko09: folds 
bigdanny117: folds 
Uncalled bet ($0.01) returned to Blackdonn3
Blackdonn3 collected $0.02 from pot
Blackdonn3: doesn't show hand 
*** SUMMARY ***
Total pot $0.02 | Rake $0 
Seat 1: matiko09 (button) folded before Flop (didn't bet)
Seat 2: bigdanny117 (small blind) folded before Flop
Seat 3: Blackdonn3 (big blind) collected ($0.02)
Seat 4: kingcarlo317 folded before Flop (didn't bet)
Seat 5: shinygrl folded before Flop (didn't bet)
Seat 6: rnwbl folded before Flop (didn't bet)





PokerStars Zoom Hand #153148821025:  Hold'em No Limit ($0.01/$0.02) - 2016/05/11 9:41:36 CET [2016/05/11 3:41:36 ET]
Table 'Halley' 6-max Seat #1 is the button
Seat 1: 1987141 ($2.57 in chips) 
Seat 2: sewczu ($1.07 in chips) 
Seat 3: AllstarCon ($3 in chips) 
Seat 4: matiko09 ($2 in chips) 
Seat 5: marcin21414 ($2.06 in chips) 
Seat 6: dragonborno ($4.94 in chips) 
sewczu: posts small blind $0.01
AllstarCon: posts big blind $0.02
*** HOLE CARDS ***
Dealt to matiko09 [Qs Js]
matiko09: raises $0.04 to $0.06
marcin21414: calls $0.06
dragonborno: folds 
1987141: folds 
sewczu: calls $0.05
AllstarCon: folds 
*** FLOP *** [7h 6s 8s]
sewczu: checks 
matiko09: checks 
marcin21414: checks 
*** TURN *** [7h 6s 8s] [5s]
sewczu: checks 
matiko09: bets $0.12
marcin21414: folds 
sewczu: folds 
Uncalled bet ($0.12) returned to matiko09
matiko09 collected $0.19 from pot
matiko09: doesn't show hand 
*** SUMMARY ***
Total pot $0.20 | Rake $0.01 
Board [7h 6s 8s 5s]
Seat 1: 1987141 (button) folded before Flop (didn't bet)
Seat 2: sewczu (small blind) folded on the Turn
Seat 3: AllstarCon (big blind) folded before Flop
Seat 4: matiko09 collected ($0.19)
Seat 5: marcin21414 folded on the Turn
Seat 6: dragonborno folded before Flop (didn't bet)





PokerStars Zoom Hand #153148833688:  Hold'em No Limit ($0.01/$0.02) - 2016/05/11 9:42:20 CET [2016/05/11 3:42:20 ET]
Table 'Halley' 6-max Seat #1 is the button
Seat 1: GDGDGDGDGDG ($3.14 in chips) 
Seat 2: coolzzz013 ($2.06 in chips) 
Seat 3: arsenal 71T ($2.17 in chips) 
Seat 4: Alexandr0503 ($2.75 in chips) 
Seat 5: matiko09 ($2.13 in chips) 
Seat 6: Pliotrema ($2.93 in chips) 
coolzzz013: posts small blind $0.01
arsenal 71T: posts big blind $0.02
*** HOLE CARDS ***
Dealt to matiko09 [3c 8s]
Alexandr0503: folds 
matiko09: folds 
Pliotrema: folds 
GDGDGDGDGDG: folds 
coolzzz013: folds 
Uncalled bet ($0.01) returned to arsenal 71T
arsenal 71T collected $0.02 from pot
arsenal 71T: doesn't show hand 
*** SUMMARY ***
Total pot $0.02 | Rake $0 
Seat 1: GDGDGDGDGDG (button) folded before Flop (didn't bet)
Seat 2: coolzzz013 (small blind) folded before Flop
Seat 3: arsenal 71T (big blind) collected ($0.02)
Seat 4: Alexandr0503 folded before Flop (didn't bet)
Seat 5: matiko09 folded before Flop (didn't bet)
Seat 6: Pliotrema folded before Flop (didn't bet)





PokerStars Hand #153148887985:  Hold'em No Limit ($1/$2 USD) - 2016/05/11 9:45:26 CET [2016/05/11 3:45:26 ET]
Table 'Almach' 9-max Seat #1 is the button
Seat 1: fulsh81 ($111.10 in chips) 
Seat 3: bIondie ($200 in chips) 
Seat 4: matiko09 ($200 in chips) 
Seat 5: toprmaw ($200 in chips) 
Seat 6: ilaviiitech ($200 in chips) 
Seat 7: HerrJanks ($200 in chips) 
Seat 8: nickreason17 ($200 in chips) 
Seat 9: IseeUcards ($200 in chips) 
bIondie: posts small blind $1
matiko09: posts big blind $2
*** HOLE CARDS ***
Dealt to matiko09 [2d 3s]
toprmaw: folds 
ilaviiitech: folds 
HerrJanks: folds 
HerrJanks leaves the table
nickreason17: folds 
IseeUcards: folds 
fulsh81: folds 
bIondie: folds 
Uncalled bet ($1) returned to matiko09
matiko09 collected $2 from pot
matiko09: doesn't show hand 
*** SUMMARY ***
Total pot $2 | Rake $0 
Seat 1: fulsh81 (button) folded before Flop (didn't bet)
Seat 3: bIondie (small blind) folded before Flop
Seat 4: matiko09 (big blind) collected ($2)
Seat 5: toprmaw folded before Flop (didn't bet)
Seat 6: ilaviiitech folded before Flop (didn't bet)
Seat 7: HerrJanks folded before Flop (didn't bet)
Seat 8: nickreason17 folded before Flop (didn't bet)
Seat 9: IseeUcards folded before Flop (didn't bet)





PokerStars Hand #153148891483:  Hold'em No Limit ($1/$2 USD) - 2016/05/11 9:45:38 CET [2016/05/11 3:45:38 ET]
Table 'Almach' 9-max Seat #3 is the button
Seat 1: fulsh81 ($111.10 in chips) 
Seat 3: bIondie ($200 in chips) 
Seat 4: matiko09 ($201 in chips) 
Seat 5: toprmaw ($200 in chips) 
Seat 6: ilaviiitech ($200 in chips) 
Seat 8: nickreason17 ($200 in chips) 
Seat 9: IseeUcards ($200 in chips) 
matiko09: posts small blind $1
toprmaw: posts big blind $2
*** HOLE CARDS ***
Dealt to matiko09 [Kc 2d]
ilaviiitech: folds 
nickreason17: folds 
IseeUcards: folds 
fulsh81: raises $2 to $4
bIondie: raises $10 to $14
matiko09: folds 
toprmaw: folds 
fulsh81: folds 
Uncalled bet ($10) returned to bIondie
bIondie collected $11 from pot
bIondie: doesn't show hand 
*** SUMMARY ***
Total pot $11 | Rake $0 
Seat 1: fulsh81 folded before Flop
Seat 3: bIondie (button) collected ($11)
Seat 4: matiko09 (small blind) folded before Flop
Seat 5: toprmaw (big blind) folded before Flop
Seat 6: ilaviiitech folded before Flop (didn't bet)
Seat 8: nickreason17 folded before Flop (didn't bet)
Seat 9: IseeUcards folded before Flop (didn't bet)





PokerStars Hand #153148898987:  Hold'em No Limit ($1/$2 USD) - 2016/05/11 9:46:03 CET [2016/05/11 3:46:03 ET]
Table 'Almach' 9-max Seat #4 is the button
Seat 1: fulsh81 ($107.10 in chips) 
Seat 3: bIondie ($207 in chips) 
Seat 4: matiko09 ($200 in chips) 
Seat 5: toprmaw ($200 in chips) 
Seat 6: ilaviiitech ($200 in chips) 
Seat 8: nickreason17 ($200 in chips) 
Seat 9: IseeUcards ($200 in chips) 
toprmaw: posts small blind $1
ilaviiitech: posts big blind $2
*** HOLE CARDS ***
Dealt to matiko09 [Kh 9h]
suddend3ath joins the table at seat #7 
nickreason17: folds 
IseeUcards: folds 
fulsh81: folds 
bIondie: folds 
matiko09: raises $2.54 to $4.54
toprmaw: folds 
ilaviiitech: raises $19.46 to $24
matiko09: folds 
Uncalled bet ($19.46) returned to ilaviiitech
ilaviiitech collected $10.08 from pot
ilaviiitech: doesn't show hand 
*** SUMMARY ***
Total pot $10.08 | Rake $0 
Seat 1: fulsh81 folded before Flop (didn't bet)
Seat 3: bIondie folded before Flop (didn't bet)
Seat 4: matiko09 (button) folded before Flop
Seat 5: toprmaw (small blind) folded before Flop
Seat 6: ilaviiitech (big blind) collected ($10.08)
Seat 8: nickreason17 folded before Flop (didn't bet)
Seat 9: IseeUcards folded before Flop (didn't bet)





PokerStars Hand #153148909348:  Hold'em No Limit ($1/$2 USD) - 2016/05/11 9:46:38 CET [2016/05/11 3:46:38 ET]
Table 'Almach' 9-max Seat #5 is the button
Seat 1: fulsh81 ($107.10 in chips) 
Seat 3: bIondie ($207 in chips) 
Seat 4: matiko09 ($200 in chips) 
Seat 5: toprmaw ($200 in chips) 
Seat 6: ilaviiitech ($205.54 in chips) 
Seat 7: suddend3ath ($200 in chips) 
Seat 8: nickreason17 ($200 in chips) 
Seat 9: IseeUcards ($200 in chips) 
ilaviiitech: posts small blind $1
suddend3ath: posts big blind $2
*** HOLE CARDS ***
Dealt to matiko09 [7c 4h]
nickreason17: folds 
IseeUcards: folds 
fulsh81: calls $2
bIondie: folds 
matiko09: folds 
toprmaw: raises $5 to $7
ilaviiitech: folds 
suddend3ath: raises $13 to $20
fulsh81: folds 
toprmaw: folds 
Uncalled bet ($13) returned to suddend3ath
suddend3ath collected $17 from pot
suddend3ath: doesn't show hand 
*** SUMMARY ***
Total pot $17 | Rake $0 
Seat 1: fulsh81 folded before Flop
Seat 3: bIondie folded before Flop (didn't bet)
Seat 4: matiko09 folded before Flop (didn't bet)
Seat 5: toprmaw (button) folded before Flop
Seat 6: ilaviiitech (small blind) folded before Flop
Seat 7: suddend3ath (big blind) collected ($17)
Seat 8: nickreason17 folded before Flop (didn't bet)
Seat 9: IseeUcards folded before Flop (didn't bet)





PokerStars Hand #153148921562:  Hold'em No Limit ($1/$2 USD) - 2016/05/11 9:47:20 CET [2016/05/11 3:47:20 ET]
Table 'Almach' 9-max Seat #6 is the button
Seat 1: fulsh81 ($105.10 in chips) 
Seat 3: bIondie ($207 in chips) 
Seat 4: matiko09 ($200 in chips) 
Seat 5: toprmaw ($200 in chips) 
Seat 6: ilaviiitech ($204.54 in chips) 
Seat 7: suddend3ath ($210 in chips) 
Seat 8: nickreason17 ($200 in chips) 
Seat 9: IseeUcards ($200 in chips) 
suddend3ath: posts small blind $1
nickreason17: posts big blind $2
*** HOLE CARDS ***
Dealt to matiko09 [Ks 8c]
IseeUcards: folds 
fulsh81: calls $2
bIondie: folds 
matiko09: folds 
toprmaw: raises $6 to $8
ilaviiitech: folds 
suddend3ath: folds 
nickreason17: calls $6
fulsh81: calls $6
*** FLOP *** [8h 3d Jh]
nickreason17: checks 
fulsh81: bets $12
toprmaw: folds 
nickreason17: folds 
Uncalled bet ($12) returned to fulsh81
fulsh81 collected $23.75 from pot
*** SUMMARY ***
Total pot $25 | Rake $1.25 
Board [8h 3d Jh]
Seat 1: fulsh81 collected ($23.75)
Seat 3: bIondie folded before Flop (didn't bet)
Seat 4: matiko09 folded before Flop (didn't bet)
Seat 5: toprmaw folded on the Flop
Seat 6: ilaviiitech (button) folded before Flop (didn't bet)
Seat 7: suddend3ath (small blind) folded before Flop
Seat 8: nickreason17 (big blind) folded on the Flop
Seat 9: IseeUcards folded before Flop (didn't bet)





PokerStars Hand #153148923389:  Hold'em No Limit ($1/$2 USD) - 2016/05/11 9:47:26 CET [2016/05/11 3:47:26 ET]
Table 'Pyrrha' 9-max Seat #8 is the button
Seat 1: matiko09 ($200 in chips) 
Seat 2: AlKatrone ($252.77 in chips) 
Seat 3: HerrJanks ($200 in chips) 
Seat 4: toprmaw ($227.30 in chips) 
Seat 5: suddend3ath ($200 in chips) 
Seat 6: bIondie ($386.55 in chips) 
Seat 7: BigNickyy ($134.18 in chips) 
Seat 8: Yeomine ($78.55 in chips) 
Seat 9: Piniker85 ($268.03 in chips) 
Piniker85: posts small blind $1
matiko09: posts big blind $2
*** HOLE CARDS ***
Dealt to matiko09 [Qs Qc]
AlKatrone: folds 
HerrJanks: folds 
toprmaw: folds 
suddend3ath: raises $3 to $5
bIondie: folds 
BigNickyy: folds 
Yeomine: folds 
Piniker85: raises $5 to $10
matiko09: raises $16 to $26
suddend3ath: folds 
Piniker85: calls $16
*** FLOP *** [2s 4c 3c]
Piniker85: bets $20
matiko09: raises $36 to $56
Piniker85: folds 
Uncalled bet ($36) returned to matiko09
matiko09 collected $94.25 from pot
matiko09: doesn't show hand 
*** SUMMARY ***
Total pot $97 | Rake $2.75 
Board [2s 4c 3c]
Seat 1: matiko09 (big blind) collected ($94.25)
Seat 2: AlKatrone folded before Flop (didn't bet)
Seat 3: HerrJanks folded before Flop (didn't bet)
Seat 4: toprmaw folded before Flop (didn't bet)
Seat 5: suddend3ath folded before Flop
Seat 6: bIondie folded before Flop (didn't bet)
Seat 7: BigNickyy folded before Flop (didn't bet)
Seat 8: Yeomine (button) folded before Flop (didn't bet)
Seat 9: Piniker85 (small blind) folded on the Flop





PokerStars Hand #153148930543:  Hold'em No Limit ($1/$2 USD) - 2016/05/11 9:47:50 CET [2016/05/11 3:47:50 ET]
Table 'Almach' 9-max Seat #7 is the button
Seat 1: fulsh81 ($120.85 in chips) 
Seat 3: bIondie ($207 in chips) 
Seat 4: matiko09 ($200 in chips) 
Seat 5: toprmaw ($200 in chips) 
Seat 6: ilaviiitech ($204.54 in chips) 
Seat 7: suddend3ath ($209 in chips) 
Seat 8: nickreason17 ($200 in chips) 
Seat 9: IseeUcards ($200 in chips) 
nickreason17: posts small blind $1
IseeUcards: posts big blind $2
AlKatrone: sits out 
*** HOLE CARDS ***
Dealt to matiko09 [Qd Ah]
fulsh81: folds 
bIondie: folds 
matiko09: raises $3 to $5
toprmaw: folds 
ilaviiitech: folds 
suddend3ath: folds 
nickreason17: folds 
IseeUcards: folds 
Uncalled bet ($3) returned to matiko09
matiko09 collected $5 from pot
matiko09: doesn't show hand 
*** SUMMARY ***
Total pot $5 | Rake $0 
Seat 1: fulsh81 folded before Flop (didn't bet)
Seat 3: bIondie folded before Flop (didn't bet)
Seat 4: matiko09 collected ($5)
Seat 5: toprmaw folded before Flop (didn't bet)
Seat 6: ilaviiitech folded before Flop (didn't bet)
Seat 7: suddend3ath (button) folded before Flop (didn't bet)
Seat 8: nickreason17 (small blind) folded before Flop
Seat 9: IseeUcards (big blind) folded before Flop





PokerStars Hand #153148936265:  Hold'em No Limit ($1/$2 USD) - 2016/05/11 9:48:09 CET [2016/05/11 3:48:09 ET]
Table 'Almach' 9-max Seat #8 is the button
Seat 1: fulsh81 ($120.85 in chips) 
Seat 3: bIondie ($207 in chips) 
Seat 4: matiko09 ($203 in chips) 
Seat 5: toprmaw ($200 in chips) 
Seat 6: ilaviiitech ($204.54 in chips) 
Seat 7: suddend3ath ($209 in chips) 
Seat 8: nickreason17 ($200 in chips) 
Seat 9: IseeUcards ($200 in chips) 
IseeUcards: posts small blind $1
fulsh81: posts big blind $2
AlKatrone: sits out 
*** HOLE CARDS ***
Dealt to matiko09 [9d 5s]
bIondie: folds 
matiko09: folds 
toprmaw: folds 
ilaviiitech: folds 
suddend3ath: raises $3 to $5
nickreason17: raises $12 to $17
IseeUcards: folds 
fulsh81: folds 
suddend3ath: folds 
Uncalled bet ($12) returned to nickreason17
nickreason17 collected $13 from pot
*** SUMMARY ***
Total pot $13 | Rake $0 
Seat 1: fulsh81 (big blind) folded before Flop
Seat 3: bIondie folded before Flop (didn't bet)
Seat 4: matiko09 folded before Flop (didn't bet)
Seat 5: toprmaw folded before Flop (didn't bet)
Seat 6: ilaviiitech folded before Flop (didn't bet)
Seat 7: suddend3ath folded before Flop
Seat 8: nickreason17 (button) collected ($13)
Seat 9: IseeUcards (small blind) folded before Flop





PokerStars Hand #153148946138:  Hold'em No Limit ($1/$2 USD) - 2016/05/11 9:48:43 CET [2016/05/11 3:48:43 ET]
Table 'Almach' 9-max Seat #9 is the button
Seat 1: fulsh81 ($118.85 in chips) 
Seat 2: AlKatrone ($200 in chips) 
Seat 3: bIondie ($207 in chips) 
Seat 4: matiko09 ($203 in chips) 
Seat 5: toprmaw ($200 in chips) 
Seat 6: ilaviiitech ($204.54 in chips) 
Seat 7: suddend3ath ($204 in chips) 
Seat 8: nickreason17 ($208 in chips) 
Seat 9: IseeUcards ($200 in chips) 
fulsh81: posts small blind $1
AlKatrone: posts big blind $2
*** HOLE CARDS ***
Dealt to matiko09 [2d 8h]
bIondie: folds 
matiko09: folds 
toprmaw: folds 
ilaviiitech: folds 
suddend3ath: folds 
nickreason17: raises $3 to $5
IseeUcards: folds 
fulsh81: folds 
AlKatrone: folds 
Uncalled bet ($3) returned to nickreason17
nickreason17 collected $5 from pot
*** SUMMARY ***
Total pot $5 | Rake $0 
Seat 1: fulsh81 (small blind) folded before Flop
Seat 2: AlKatrone (big blind) folded before Flop
Seat 3: bIondie folded before Flop (didn't bet)
Seat 4: matiko09 folded before Flop (didn't bet)
Seat 5: toprmaw folded before Flop (didn't bet)
Seat 6: ilaviiitech folded before Flop (didn't bet)
Seat 7: suddend3ath folded before Flop (didn't bet)
Seat 8: nickreason17 collected ($5)
Seat 9: IseeUcards (button) folded before Flop (didn't bet)





PokerStars Hand #153148949201:  Hold'em No Limit ($1/$2 USD) - 2016/05/11 9:48:53 CET [2016/05/11 3:48:53 ET]
Table 'Pyrrha' 9-max Seat #9 is the button
Seat 1: matiko09 ($248.25 in chips) 
Seat 2: AlKatrone ($252.77 in chips) 
Seat 3: HerrJanks ($200 in chips) 
Seat 4: toprmaw ($227.30 in chips) 
Seat 5: suddend3ath ($200 in chips) 
Seat 6: bIondie ($386.55 in chips) 
Seat 7: BigNickyy ($134.18 in chips) 
Seat 8: Yeomine ($78.55 in chips) 
Seat 9: Piniker85 ($222.03 in chips) 
matiko09: posts small blind $1
AlKatrone: posts big blind $2
*** HOLE CARDS ***
Dealt to matiko09 [Ac Qh]
HerrJanks: folds 
toprmaw: folds 
suddend3ath: folds 
bIondie: folds 
BigNickyy: folds 
Yeomine: folds 
Piniker85: folds 
matiko09: raises $3 to $5
AlKatrone: folds 
Uncalled bet ($3) returned to matiko09
matiko09 collected $4 from pot
matiko09: doesn't show hand 
*** SUMMARY ***
Total pot $4 | Rake $0 
Seat 1: matiko09 (small blind) collected ($4)
Seat 2: AlKatrone (big blind) folded before Flop
Seat 3: HerrJanks folded before Flop (didn't bet)
Seat 4: toprmaw folded before Flop (didn't bet)
Seat 5: suddend3ath folded before Flop (didn't bet)
Seat 6: bIondie folded before Flop (didn't bet)
Seat 7: BigNickyy folded before Flop (didn't bet)
Seat 8: Yeomine folded before Flop (didn't bet)
Seat 9: Piniker85 (button) folded before Flop (didn't bet)





PokerStars Hand #153148951541:  Hold'em No Limit ($0.50/$1.00 USD) - 2016/05/11 9:49:01 CET [2016/05/11 3:49:01 ET]
Table 'Hebei II' 9-max Seat #7 is the button
Seat 1: suddend3ath ($138.13 in chips) 
Seat 2: jojohny0211 ($101.80 in chips) 
Seat 3: WrongButton ($101.50 in chips) 
Seat 4: toprmaw ($123.53 in chips) 
Seat 5: gnnr84 ($94.74 in chips) 
Seat 7: picka4u ($38.32 in chips) 
Seat 8: arctur17 ($90.91 in chips) 
Seat 9: matiko09 ($100 in chips) 
arctur17: posts small blind $0.50
matiko09: posts big blind $1
*** HOLE CARDS ***
Dealt to matiko09 [5h Td]
suddend3ath: raises $1.50 to $2.50
jojohny0211: raises $7.50 to $10
WrongButton: folds 
toprmaw: folds 
gnnr84: folds 
picka4u: folds 
arctur17: folds 
matiko09: folds 
suddend3ath: folds 
Uncalled bet ($7.50) returned to jojohny0211
jojohny0211 collected $6.50 from pot
jojohny0211: doesn't show hand 
*** SUMMARY ***
Total pot $6.50 | Rake $0 
Seat 1: suddend3ath folded before Flop
Seat 2: jojohny0211 collected ($6.50)
Seat 3: WrongButton folded before Flop (didn't bet)
Seat 4: toprmaw folded before Flop (didn't bet)
Seat 5: gnnr84 folded before Flop (didn't bet)
Seat 7: picka4u (button) folded before Flop (didn't bet)
Seat 8: arctur17 (small blind) folded before Flop
Seat 9: matiko09 (big blind) folded before Flop





PokerStars Hand #153148955368:  Hold'em No Limit ($1/$2 USD) - 2016/05/11 9:49:14 CET [2016/05/11 3:49:14 ET]
Table 'Pyrrha' 9-max Seat #1 is the button
Seat 1: matiko09 ($250.25 in chips) 
Seat 2: AlKatrone ($250.77 in chips) 
Seat 3: HerrJanks ($200 in chips) 
Seat 4: toprmaw ($227.30 in chips) 
Seat 5: suddend3ath ($200 in chips) 
Seat 6: bIondie ($386.55 in chips) 
Seat 7: BigNickyy ($134.18 in chips) 
Seat 8: Yeomine ($78.55 in chips) 
Seat 9: Piniker85 ($222.03 in chips) 
AlKatrone: posts small blind $1
HerrJanks: posts big blind $2
*** HOLE CARDS ***
Dealt to matiko09 [Js 7d]
toprmaw: folds 
suddend3ath: raises $3 to $5
bIondie: folds 
BigNickyy: folds 
Yeomine: folds 
Piniker85: raises $5 to $10
matiko09: folds 
AlKatrone: folds 
HerrJanks: folds 
suddend3ath: raises $190 to $200 and is all-in
Piniker85: folds 
Uncalled bet ($190) returned to suddend3ath
suddend3ath collected $23 from pot
suddend3ath: doesn't show hand 
*** SUMMARY ***
Total pot $23 | Rake $0 
Seat 1: matiko09 (button) folded before Flop (didn't bet)
Seat 2: AlKatrone (small blind) folded before Flop
Seat 3: HerrJanks (big blind) folded before Flop
Seat 4: toprmaw folded before Flop (didn't bet)
Seat 5: suddend3ath collected ($23)
Seat 6: bIondie folded before Flop (didn't bet)
Seat 7: BigNickyy folded before Flop (didn't bet)
Seat 8: Yeomine folded before Flop (didn't bet)
Seat 9: Piniker85 folded before Flop





PokerStars Hand #153148958060:  Hold'em No Limit ($1/$2 USD) - 2016/05/11 9:49:23 CET [2016/05/11 3:49:23 ET]
Table 'Almach' 9-max Seat #1 is the button
Seat 1: fulsh81 ($117.85 in chips) 
Seat 2: AlKatrone ($200 in chips) 
Seat 3: bIondie ($207 in chips) 
Seat 4: matiko09 ($203 in chips) 
Seat 5: toprmaw ($200 in chips) 
Seat 6: ilaviiitech ($204.54 in chips) 
Seat 7: suddend3ath ($204 in chips) 
Seat 8: nickreason17 ($211 in chips) 
Seat 9: IseeUcards ($200 in chips) 
AlKatrone: posts small blind $1
bIondie: posts big blind $2
*** HOLE CARDS ***
Dealt to matiko09 [Ks 9h]
matiko09: folds 
toprmaw: folds 
ilaviiitech: folds 
suddend3ath: folds 
nickreason17: folds 
IseeUcards: raises $3 to $5
fulsh81: calls $5
AlKatrone: folds 
bIondie: calls $3
*** FLOP *** [8d 6d 5s]
bIondie: checks 
IseeUcards: checks 
fulsh81: bets $8
bIondie: folds 
IseeUcards: folds 
Uncalled bet ($8) returned to fulsh81
fulsh81 collected $15.20 from pot
fulsh81: doesn't show hand 
*** SUMMARY ***
Total pot $16 | Rake $0.80 
Board [8d 6d 5s]
Seat 1: fulsh81 (button) collected ($15.20)
Seat 2: AlKatrone (small blind) folded before Flop
Seat 3: bIondie (big blind) folded on the Flop
Seat 4: matiko09 folded before Flop (didn't bet)
Seat 5: toprmaw folded before Flop (didn't bet)
Seat 6: ilaviiitech folded before Flop (didn't bet)
Seat 7: suddend3ath folded before Flop (didn't bet)
Seat 8: nickreason17 folded before Flop (didn't bet)
Seat 9: IseeUcards folded on the Flop





PokerStars Hand #153148962565:  Hold'em No Limit ($0.50/$1.00 USD) - 2016/05/11 9:49:38 CET [2016/05/11 3:49:38 ET]
Table 'Frisia' 9-max Seat #1 is the button
Seat 1: matiko09 ($100 in chips) 
Seat 3: flk.Dasas ($100 in chips) 
Seat 4: ilaviiitech ($100 in chips) 
Seat 5: toprmaw ($100 in chips) 
Seat 6: nickreason17 ($100 in chips) 
Seat 9: ninomorper ($100 in chips) 
Glushchenko joins the table at seat #7 
flk.Dasas: posts small blind $0.50
ilaviiitech: posts big blind $1
*** HOLE CARDS ***
Dealt to matiko09 [5h Ah]
toprmaw: folds 
nickreason17: raises $1.50 to $2.50
ninomorper: folds 
matiko09: raises $6.50 to $9
flk.Dasas: folds 
ilaviiitech: folds 
vanilica joins the table at seat #8 
nickreason17: folds 
Uncalled bet ($6.50) returned to matiko09
matiko09 collected $6.50 from pot
matiko09: doesn't show hand 
*** SUMMARY ***
Total pot $6.50 | Rake $0 
Seat 1: matiko09 (button) collected ($6.50)
Seat 3: flk.Dasas (small blind) folded before Flop
Seat 4: ilaviiitech (big blind) folded before Flop
Seat 5: toprmaw folded before Flop (didn't bet)
Seat 6: nickreason17 folded before Flop
Seat 9: ninomorper folded before Flop (didn't bet)





PokerStars Hand #153148964952:  Hold'em No Limit ($0.50/$1.00 USD) - 2016/05/11 9:49:47 CET [2016/05/11 3:49:47 ET]
Table 'Hebei II' 9-max Seat #8 is the button
Seat 1: suddend3ath ($135.63 in chips) 
Seat 2: jojohny0211 ($105.80 in chips) 
Seat 3: WrongButton ($101.50 in chips) 
Seat 4: toprmaw ($123.53 in chips) 
Seat 5: gnnr84 ($94.74 in chips) 
Seat 7: picka4u ($38.32 in chips) 
Seat 8: arctur17 ($100 in chips) 
Seat 9: matiko09 ($100 in chips) 
matiko09: posts small blind $0.50
suddend3ath: posts big blind $1
*** HOLE CARDS ***
Dealt to matiko09 [As 7h]
jojohny0211: folds 
WrongButton: folds 
toprmaw: folds 
gnnr84: raises $1 to $2
picka4u: folds 
arctur17: folds 
matiko09: folds 
suddend3ath: calls $1
*** FLOP *** [5h Ac Ah]
suddend3ath: checks 
gnnr84: bets $4
suddend3ath: folds 
Uncalled bet ($4) returned to gnnr84
gnnr84 collected $4.28 from pot
gnnr84: doesn't show hand 
*** SUMMARY ***
Total pot $4.50 | Rake $0.22 
Board [5h Ac Ah]
Seat 1: suddend3ath (big blind) folded on the Flop
Seat 2: jojohny0211 folded before Flop (didn't bet)
Seat 3: WrongButton folded before Flop (didn't bet)
Seat 4: toprmaw folded before Flop (didn't bet)
Seat 5: gnnr84 collected ($4.28)
Seat 7: picka4u folded before Flop (didn't bet)
Seat 8: arctur17 (button) folded before Flop (didn't bet)
Seat 9: matiko09 (small blind) folded before Flop





PokerStars Hand #153148965703:  Hold'em No Limit ($1/$2 USD) - 2016/05/11 9:49:49 CET [2016/05/11 3:49:49 ET]
Table 'Pyrrha' 9-max Seat #2 is the button
Seat 1: matiko09 ($250.25 in chips) 
Seat 2: AlKatrone ($249.77 in chips) 
Seat 3: HerrJanks ($200 in chips) 
Seat 4: toprmaw ($227.30 in chips) 
Seat 5: suddend3ath ($213 in chips) 
Seat 6: bIondie ($386.55 in chips) 
Seat 7: BigNickyy ($134.18 in chips) 
Seat 8: Yeomine ($78.55 in chips) 
Seat 9: Piniker85 ($212.03 in chips) 
HerrJanks: posts small blind $1
toprmaw: posts big blind $2
*** HOLE CARDS ***
Dealt to matiko09 [Kc 3d]
suddend3ath: folds 
bIondie: folds 
BigNickyy: folds 
Yeomine: folds 
Piniker85: folds 
matiko09: folds 
AlKatrone: folds 
HerrJanks: folds 
Uncalled bet ($1) returned to toprmaw
toprmaw collected $2 from pot
toprmaw: doesn't show hand 
*** SUMMARY ***
Total pot $2 | Rake $0 
Seat 1: matiko09 folded before Flop (didn't bet)
Seat 2: AlKatrone (button) folded before Flop (didn't bet)
Seat 3: HerrJanks (small blind) folded before Flop
Seat 4: toprmaw (big blind) collected ($2)
Seat 5: suddend3ath folded before Flop (didn't bet)
Seat 6: bIondie folded before Flop (didn't bet)
Seat 7: BigNickyy folded before Flop (didn't bet)
Seat 8: Yeomine folded before Flop (didn't bet)
Seat 9: Piniker85 folded before Flop (didn't bet)





PokerStars Hand #153148972138:  Hold'em No Limit ($1/$2 USD) - 2016/05/11 9:50:11 CET [2016/05/11 3:50:11 ET]
Table 'Pyrrha' 9-max Seat #3 is the button
Seat 1: matiko09 ($250.25 in chips) 
Seat 2: AlKatrone ($249.77 in chips) 
Seat 3: HerrJanks ($200 in chips) 
Seat 4: toprmaw ($228.30 in chips) 
Seat 5: suddend3ath ($213 in chips) 
Seat 6: bIondie ($386.55 in chips) 
Seat 7: BigNickyy ($134.18 in chips) 
Seat 8: Yeomine ($78.55 in chips) 
Seat 9: Piniker85 ($212.03 in chips) 
toprmaw: posts small blind $1
suddend3ath: posts big blind $2
*** HOLE CARDS ***
Dealt to matiko09 [2h 3h]
bIondie: folds 
BigNickyy: folds 
Yeomine: raises $4 to $6
Piniker85: folds 
matiko09: folds 
AlKatrone: folds 
HerrJanks: folds 
toprmaw: folds 
suddend3ath: folds 
Uncalled bet ($4) returned to Yeomine
Yeomine collected $5 from pot
Yeomine: doesn't show hand 
*** SUMMARY ***
Total pot $5 | Rake $0 
Seat 1: matiko09 folded before Flop (didn't bet)
Seat 2: AlKatrone folded before Flop (didn't bet)
Seat 3: HerrJanks (button) folded before Flop (didn't bet)
Seat 4: toprmaw (small blind) folded before Flop
Seat 5: suddend3ath (big blind) folded before Flop
Seat 6: bIondie folded before Flop (didn't bet)
Seat 7: BigNickyy folded before Flop (didn't bet)
Seat 8: Yeomine collected ($5)
Seat 9: Piniker85 folded before Flop (didn't bet)





PokerStars Hand #153148972458:  Hold'em No Limit ($1/$2 USD) - 2016/05/11 9:50:12 CET [2016/05/11 3:50:12 ET]
Table 'Almach' 9-max Seat #2 is the button
Seat 1: fulsh81 ($128.05 in chips) 
Seat 2: AlKatrone ($200 in chips) 
Seat 3: bIondie ($202 in chips) 
Seat 4: matiko09 ($203 in chips) 
Seat 5: toprmaw ($200 in chips) 
Seat 6: ilaviiitech ($204.54 in chips) 
Seat 7: suddend3ath ($204 in chips) 
Seat 8: nickreason17 ($211 in chips) 
Seat 9: IseeUcards ($200 in chips) 
bIondie: posts small blind $1
matiko09: posts big blind $2
*** HOLE CARDS ***
Dealt to matiko09 [7h 4d]
toprmaw: folds 
ilaviiitech: raises $4 to $6
suddend3ath: folds 
nickreason17: raises $12 to $18
IseeUcards: folds 
fulsh81: folds 
AlKatrone: folds 
bIondie: folds 
matiko09: folds 
ilaviiitech: folds 
Uncalled bet ($12) returned to nickreason17
nickreason17 collected $15 from pot
*** SUMMARY ***
Total pot $15 | Rake $0 
Seat 1: fulsh81 folded before Flop (didn't bet)
Seat 2: AlKatrone (button) folded before Flop (didn't bet)
Seat 3: bIondie (small blind) folded before Flop
Seat 4: matiko09 (big blind) folded before Flop
Seat 5: toprmaw folded before Flop (didn't bet)
Seat 6: ilaviiitech folded before Flop
Seat 7: suddend3ath folded before Flop (didn't bet)
Seat 8: nickreason17 collected ($15)
Seat 9: IseeUcards folded before Flop (didn't bet)





PokerStars Hand #153148974243:  Hold'em No Limit ($0.50/$1.00 USD) - 2016/05/11 9:50:18 CET [2016/05/11 3:50:18 ET]
Table 'Frisia' 9-max Seat #3 is the button
Seat 1: matiko09 ($104 in chips) 
Seat 3: flk.Dasas ($100 in chips) 
Seat 4: ilaviiitech ($100 in chips) 
Seat 5: toprmaw ($100 in chips) 
Seat 6: nickreason17 ($100 in chips) 
Seat 9: ninomorper ($100 in chips) 
ilaviiitech: posts small blind $0.50
toprmaw: posts big blind $1
vanilica: sits out 
AlKatrone: sits out 
*** HOLE CARDS ***
Dealt to matiko09 [3s 5s]
nickreason17: raises $1.50 to $2.50
ninomorper: folds 
matiko09: folds 
flk.Dasas: calls $2.50
ilaviiitech: folds 
toprmaw: folds 
*** FLOP *** [9h 6h 9s]
nickreason17: bets $3.25
flk.Dasas: folds 
Uncalled bet ($3.25) returned to nickreason17
nickreason17 collected $6.18 from pot
*** SUMMARY ***
Total pot $6.50 | Rake $0.32 
Board [9h 6h 9s]
Seat 1: matiko09 folded before Flop (didn't bet)
Seat 3: flk.Dasas (button) folded on the Flop
Seat 4: ilaviiitech (small blind) folded before Flop
Seat 5: toprmaw (big blind) folded before Flop
Seat 6: nickreason17 collected ($6.18)
Seat 9: ninomorper folded before Flop (didn't bet)





PokerStars Hand #153148976179:  Hold'em No Limit ($0.50/$1.00 USD) - 2016/05/11 9:50:25 CET [2016/05/11 3:50:25 ET]
Table 'Hebei II' 9-max Seat #9 is the button
Seat 1: suddend3ath ($133.63 in chips) 
Seat 2: jojohny0211 ($105.80 in chips) 
Seat 3: WrongButton ($101.50 in chips) 
Seat 4: toprmaw ($123.53 in chips) 
Seat 5: gnnr84 ($97.02 in chips) 
Seat 7: picka4u ($38.32 in chips) 
Seat 8: arctur17 ($100 in chips) 
Seat 9: matiko09 ($100 in chips) 
suddend3ath: posts small blind $0.50
jojohny0211: posts big blind $1
*** HOLE CARDS ***
Dealt to matiko09 [Kd 8s]
WrongButton: folds 
toprmaw: folds 
gnnr84: folds 
picka4u: folds 
arctur17: folds 
matiko09: raises $1.27 to $2.27
suddend3ath: folds 
jojohny0211: folds 
Uncalled bet ($1.27) returned to matiko09
matiko09 collected $2.50 from pot
matiko09: doesn't show hand 
*** SUMMARY ***
Total pot $2.50 | Rake $0 
Seat 1: suddend3ath (small blind) folded before Flop
Seat 2: jojohny0211 (big blind) folded before Flop
Seat 3: WrongButton folded before Flop (didn't bet)
Seat 4: toprmaw folded before Flop (didn't bet)
Seat 5: gnnr84 folded before Flop (didn't bet)
Seat 7: picka4u folded before Flop (didn't bet)
Seat 8: arctur17 folded before Flop (didn't bet)
Seat 9: matiko09 (button) collected ($2.50)





PokerStars Hand #153148981473:  Hold'em No Limit ($1/$2 USD) - 2016/05/11 9:50:42 CET [2016/05/11 3:50:42 ET]
Table 'Pyrrha' 9-max Seat #4 is the button
Seat 1: matiko09 ($250.25 in chips) 
Seat 2: AlKatrone ($249.77 in chips) 
Seat 3: HerrJanks ($200 in chips) 
Seat 4: toprmaw ($227.30 in chips) 
Seat 5: suddend3ath ($211 in chips) 
Seat 6: bIondie ($386.55 in chips) 
Seat 7: BigNickyy ($134.18 in chips) 
Seat 8: Yeomine ($81.55 in chips) 
Seat 9: Piniker85 ($212.03 in chips) 
suddend3ath: posts small blind $1
bIondie: posts big blind $2
*** HOLE CARDS ***
Dealt to matiko09 [5s Th]
BigNickyy: folds 
Yeomine: folds 
Piniker85: folds 
matiko09: folds 
AlKatrone: folds 
HerrJanks: folds 
toprmaw: folds 
suddend3ath: folds 
Uncalled bet ($1) returned to bIondie
bIondie collected $2 from pot
bIondie: doesn't show hand 
*** SUMMARY ***
Total pot $2 | Rake $0 
Seat 1: matiko09 folded before Flop (didn't bet)
Seat 2: AlKatrone folded before Flop (didn't bet)
Seat 3: HerrJanks folded before Flop (didn't bet)
Seat 4: toprmaw (button) folded before Flop (didn't bet)
Seat 5: suddend3ath (small blind) folded before Flop
Seat 6: bIondie (big blind) collected ($2)
Seat 7: BigNickyy folded before Flop (didn't bet)
Seat 8: Yeomine folded before Flop (didn't bet)
Seat 9: Piniker85 folded before Flop (didn't bet)





PokerStars Hand #153148983078:  Hold'em No Limit ($0.50/$1.00 USD) - 2016/05/11 9:50:48 CET [2016/05/11 3:50:48 ET]
Table 'Hebei II' 9-max Seat #1 is the button
Seat 1: suddend3ath ($133.13 in chips) 
Seat 2: jojohny0211 ($104.80 in chips) 
Seat 4: toprmaw ($123.53 in chips) 
Seat 5: gnnr84 ($97.02 in chips) 
Seat 7: picka4u ($38.32 in chips) 
Seat 8: arctur17 ($100 in chips) 
Seat 9: matiko09 ($101.50 in chips) 
jojohny0211: posts small blind $0.50
WrongButton: is sitting out 
WrongButton leaves the table
toprmaw: posts big blind $1
*** HOLE CARDS ***
Dealt to matiko09 [7d 8c]
gnnr84: folds 
picka4u: folds 
arctur17: folds 
matiko09: folds 
suddend3ath: folds 
jojohny0211: raises $2 to $3
toprmaw: calls $2
*** FLOP *** [6s Kh Td]
BKA12 joins the table at seat #3 
BKA12 leaves the table
flk.Dasas joins the table at seat #3 
jojohny0211: bets $2.90
toprmaw: calls $2.90
*** TURN *** [6s Kh Td] [Ts]
jojohny0211: checks 
toprmaw: bets $8
jojohny0211: folds 
Uncalled bet ($8) returned to toprmaw
toprmaw collected $11.21 from pot
toprmaw: doesn't show hand 
*** SUMMARY ***
Total pot $11.80 | Rake $0.59 
Board [6s Kh Td Ts]
Seat 1: suddend3ath (button) folded before Flop (didn't bet)
Seat 2: jojohny0211 (small blind) folded on the Turn
Seat 4: toprmaw (big blind) collected ($11.21)
Seat 5: gnnr84 folded before Flop (didn't bet)
Seat 7: picka4u folded before Flop (didn't bet)
Seat 8: arctur17 folded before Flop (didn't bet)
Seat 9: matiko09 folded before Flop (didn't bet)





PokerStars Hand #153148985979:  Hold'em No Limit ($0.50/$1.00 USD) - 2016/05/11 9:50:58 CET [2016/05/11 3:50:58 ET]
Table 'Sun' 9-max Seat #4 is the button
Seat 3: braindamage8 ($103.68 in chips) 
Seat 4: jd20102007 ($29.83 in chips) 
Seat 5: AlKatrone ($100 in chips) 
Seat 6: matiko09 ($100 in chips) 
Seat 7: ilaviiitech ($109.55 in chips) 
Seat 9: toprmaw ($100 in chips) 
AlKatrone: posts small blind $0.50
matiko09: posts big blind $1
myatiy 96: sits out 
jojohny0211: sits out 
*** HOLE CARDS ***
Dealt to matiko09 [Td Qc]
ilaviiitech: folds 
toprmaw: folds 
braindamage8: folds 
jd20102007: raises $1 to $2
AlKatrone: folds 
matiko09: calls $1
*** FLOP *** [5d 7d 3s]
matiko09: checks 
jd20102007: bets $4
matiko09: folds 
Uncalled bet ($4) returned to jd20102007
jd20102007 collected $4.28 from pot
jd20102007: doesn't show hand 
*** SUMMARY ***
Total pot $4.50 | Rake $0.22 
Board [5d 7d 3s]
Seat 3: braindamage8 folded before Flop (didn't bet)
Seat 4: jd20102007 (button) collected ($4.28)
Seat 5: AlKatrone (small blind) folded before Flop
Seat 6: matiko09 (big blind) folded on the Flop
Seat 7: ilaviiitech folded before Flop (didn't bet)
Seat 9: toprmaw folded before Flop (didn't bet)





PokerStars Hand #153148986984:  Hold'em No Limit ($1/$2 USD) - 2016/05/11 9:51:01 CET [2016/05/11 3:51:01 ET]
Table 'Almach' 9-max Seat #3 is the button
Seat 1: fulsh81 ($128.05 in chips) 
Seat 2: AlKatrone ($200 in chips) 
Seat 3: bIondie ($201 in chips) 
Seat 4: matiko09 ($201 in chips) 
Seat 5: toprmaw ($200 in chips) 
Seat 6: ilaviiitech ($200 in chips) 
Seat 7: suddend3ath ($204 in chips) 
Seat 8: nickreason17 ($220 in chips) 
Seat 9: IseeUcards ($200 in chips) 
matiko09: posts small blind $1
toprmaw: posts big blind $2
*** HOLE CARDS ***
Dealt to matiko09 [6h Ah]
ilaviiitech: folds 
suddend3ath: folds 
nickreason17: folds 
IseeUcards: folds 
fulsh81: calls $2
AlKatrone: folds 
bIondie: folds 
matiko09: raises $6 to $8
toprmaw: folds 
fulsh81: calls $6
*** FLOP *** [4s Ac 6d]
matiko09: bets $11.50
fulsh81: folds 
Uncalled bet ($11.50) returned to matiko09
matiko09 collected $17.10 from pot
matiko09: doesn't show hand 
*** SUMMARY ***
Total pot $18 | Rake $0.90 
Board [4s Ac 6d]
Seat 1: fulsh81 folded on the Flop
Seat 2: AlKatrone folded before Flop (didn't bet)
Seat 3: bIondie (button) folded before Flop (didn't bet)
Seat 4: matiko09 (small blind) collected ($17.10)
Seat 5: toprmaw (big blind) folded before Flop
Seat 6: ilaviiitech folded before Flop (didn't bet)
Seat 7: suddend3ath folded before Flop (didn't bet)
Seat 8: nickreason17 folded before Flop (didn't bet)
Seat 9: IseeUcards folded before Flop (didn't bet)





PokerStars Hand #153148989723:  Hold'em No Limit ($1/$2 USD) - 2016/05/11 9:51:10 CET [2016/05/11 3:51:10 ET]
Table 'Pyrrha' 9-max Seat #5 is the button
Seat 1: matiko09 ($250.25 in chips) 
Seat 2: AlKatrone ($249.77 in chips) 
Seat 3: HerrJanks ($200 in chips) 
Seat 4: toprmaw ($227.30 in chips) 
Seat 5: suddend3ath ($210 in chips) 
Seat 6: bIondie ($387.55 in chips) 
Seat 7: BigNickyy ($134.18 in chips) 
Seat 8: Yeomine ($81.55 in chips) 
Seat 9: Piniker85 ($212.03 in chips) 
bIondie: posts small blind $1
BigNickyy: posts big blind $2
*** HOLE CARDS ***
Dealt to matiko09 [8c Kh]
Yeomine: folds 
Piniker85: folds 
matiko09: folds 
AlKatrone: folds 
HerrJanks: folds 
toprmaw: raises $3 to $5
suddend3ath: folds 
bIondie: folds 
BigNickyy: folds 
Uncalled bet ($3) returned to toprmaw
toprmaw collected $5 from pot
toprmaw: doesn't show hand 
*** SUMMARY ***
Total pot $5 | Rake $0 
Seat 1: matiko09 folded before Flop (didn't bet)
Seat 2: AlKatrone folded before Flop (didn't bet)
Seat 3: HerrJanks folded before Flop (didn't bet)
Seat 4: toprmaw collected ($5)
Seat 5: suddend3ath (button) folded before Flop (didn't bet)
Seat 6: bIondie (small blind) folded before Flop
Seat 7: BigNickyy (big blind) folded before Flop
Seat 8: Yeomine folded before Flop (didn't bet)
Seat 9: Piniker85 folded before Flop (didn't bet)





PokerStars Hand #153148992144:  Hold'em No Limit ($0.50/$1.00 USD) - 2016/05/11 9:51:19 CET [2016/05/11 3:51:19 ET]
Table 'Frisia' 9-max Seat #4 is the button
Seat 1: matiko09 ($104 in chips) 
Seat 3: flk.Dasas ($100 in chips) 
Seat 4: ilaviiitech ($100 in chips) 
Seat 5: toprmaw ($100 in chips) 
Seat 6: nickreason17 ($103.68 in chips) 
Seat 9: ninomorper ($100 in chips) 
toprmaw: posts small blind $0.50
nickreason17: posts big blind $1
vanilica: sits out 
AlKatrone: sits out 
*** HOLE CARDS ***
Dealt to matiko09 [Qc Tc]
ninomorper: folds 
matiko09: raises $2 to $3
flk.Dasas: folds 
ilaviiitech: folds 
toprmaw: folds 
nickreason17: folds 
Uncalled bet ($2) returned to matiko09
matiko09 collected $2.50 from pot
matiko09: doesn't show hand 
*** SUMMARY ***
Total pot $2.50 | Rake $0 
Seat 1: matiko09 collected ($2.50)
Seat 3: flk.Dasas folded before Flop (didn't bet)
Seat 4: ilaviiitech (button) folded before Flop (didn't bet)
Seat 5: toprmaw (small blind) folded before Flop
Seat 6: nickreason17 (big blind) folded before Flop
Seat 9: ninomorper folded before Flop (didn't bet)





PokerStars Hand #153148997611:  Hold'em No Limit ($0.50/$1.00 USD) - 2016/05/11 9:51:37 CET [2016/05/11 3:51:37 ET]
Table 'Frisia' 9-max Seat #5 is the button
Seat 1: matiko09 ($105.50 in chips) 
Seat 3: flk.Dasas ($100 in chips) 
Seat 4: ilaviiitech ($100 in chips) 
Seat 5: toprmaw ($100 in chips) 
Seat 6: nickreason17 ($102.68 in chips) 
Seat 8: vanilica ($100 in chips) 
Seat 9: ninomorper ($100 in chips) 
nickreason17: posts small blind $0.50
vanilica: posts big blind $1
AlKatrone: sits out 
*** HOLE CARDS ***
Dealt to matiko09 [Ah 7c]
ninomorper: folds 
matiko09: folds 
flk.Dasas: folds 
ilaviiitech: folds 
toprmaw: folds 
nickreason17: folds 
Uncalled bet ($0.50) returned to vanilica
vanilica collected $1 from pot
vanilica: doesn't show hand 
*** SUMMARY ***
Total pot $1 | Rake $0 
Seat 1: matiko09 folded before Flop (didn't bet)
Seat 3: flk.Dasas folded before Flop (didn't bet)
Seat 4: ilaviiitech folded before Flop (didn't bet)
Seat 5: toprmaw (button) folded before Flop (didn't bet)
Seat 6: nickreason17 (small blind) folded before Flop
Seat 8: vanilica (big blind) collected ($1)
Seat 9: ninomorper folded before Flop (didn't bet)





PokerStars Hand #153148999356:  Hold'em No Limit ($1/$2 USD) - 2016/05/11 9:51:43 CET [2016/05/11 3:51:43 ET]
Table 'Almach' 9-max Seat #4 is the button
Seat 1: fulsh81 ($120.05 in chips) 
Seat 2: AlKatrone ($200 in chips) 
Seat 3: bIondie ($201 in chips) 
Seat 4: matiko09 ($210.10 in chips) 
Seat 5: toprmaw ($200 in chips) 
Seat 6: ilaviiitech ($200 in chips) 
Seat 7: suddend3ath ($204 in chips) 
Seat 8: nickreason17 ($220 in chips) 
Seat 9: IseeUcards ($200 in chips) 
toprmaw: posts small blind $1
ilaviiitech: posts big blind $2
*** HOLE CARDS ***
Dealt to matiko09 [5h Th]
suddend3ath: folds 
nickreason17: folds 
IseeUcards: folds 
fulsh81: folds 
AlKatrone: folds 
bIondie: folds 
matiko09: folds 
toprmaw: folds 
Uncalled bet ($1) returned to ilaviiitech
ilaviiitech collected $2 from pot
ilaviiitech: doesn't show hand 
*** SUMMARY ***
Total pot $2 | Rake $0 
Seat 1: fulsh81 folded before Flop (didn't bet)
Seat 2: AlKatrone folded before Flop (didn't bet)
Seat 3: bIondie folded before Flop (didn't bet)
Seat 4: matiko09 (button) folded before Flop (didn't bet)
Seat 5: toprmaw (small blind) folded before Flop
Seat 6: ilaviiitech (big blind) collected ($2)
Seat 7: suddend3ath folded before Flop (didn't bet)
Seat 8: nickreason17 folded before Flop (didn't bet)
Seat 9: IseeUcards folded before Flop (didn't bet)





PokerStars Hand #153149000595:  Hold'em No Limit ($1/$2 USD) - 2016/05/11 9:51:47 CET [2016/05/11 3:51:47 ET]
Table 'Pyrrha' 9-max Seat #6 is the button
Seat 1: matiko09 ($250.25 in chips) 
Seat 2: AlKatrone ($249.77 in chips) 
Seat 3: HerrJanks ($200 in chips) 
Seat 4: toprmaw ($230.30 in chips) 
Seat 5: suddend3ath ($210 in chips) 
Seat 6: bIondie ($386.55 in chips) 
Seat 7: BigNickyy ($132.18 in chips) 
Seat 8: Yeomine ($81.55 in chips) 
Seat 9: Piniker85 ($212.03 in chips) 
BigNickyy: posts small blind $1
Yeomine: posts big blind $2
*** HOLE CARDS ***
Dealt to matiko09 [Tc Jc]
Piniker85: folds 
matiko09: raises $3 to $5
AlKatrone: folds 
HerrJanks: folds 
toprmaw: folds 
suddend3ath: folds 
bIondie: folds 
BigNickyy: folds 
Yeomine: folds 
Uncalled bet ($3) returned to matiko09
matiko09 collected $5 from pot
matiko09: doesn't show hand 
*** SUMMARY ***
Total pot $5 | Rake $0 
Seat 1: matiko09 collected ($5)
Seat 2: AlKatrone folded before Flop (didn't bet)
Seat 3: HerrJanks folded before Flop (didn't bet)
Seat 4: toprmaw folded before Flop (didn't bet)
Seat 5: suddend3ath folded before Flop (didn't bet)
Seat 6: bIondie (button) folded before Flop (didn't bet)
Seat 7: BigNickyy (small blind) folded before Flop
Seat 8: Yeomine (big blind) folded before Flop
Seat 9: Piniker85 folded before Flop (didn't bet)





PokerStars Hand #153149001268:  Hold'em No Limit ($0.50/$1.00 USD) - 2016/05/11 9:51:49 CET [2016/05/11 3:51:49 ET]
Table 'Sun' 9-max Seat #5 is the button
Seat 3: braindamage8 ($103.68 in chips) 
Seat 4: jd20102007 ($32.11 in chips) 
Seat 5: AlKatrone ($100 in chips) 
Seat 6: matiko09 ($100 in chips) 
Seat 7: ilaviiitech ($109.55 in chips) 
Seat 9: toprmaw ($100 in chips) 
matiko09: posts small blind $0.50
ilaviiitech: posts big blind $1
myatiy 96: sits out 
jojohny0211: sits out 
*** HOLE CARDS ***
Dealt to matiko09 [As 9s]
toprmaw: folds 
braindamage8: folds 
jd20102007: raises $1 to $2
AlKatrone: folds 
matiko09: folds 
ilaviiitech: folds 
Uncalled bet ($1) returned to jd20102007
jd20102007 collected $2.50 from pot
jd20102007: doesn't show hand 
*** SUMMARY ***
Total pot $2.50 | Rake $0 
Seat 3: braindamage8 folded before Flop (didn't bet)
Seat 4: jd20102007 collected ($2.50)
Seat 5: AlKatrone (button) folded before Flop (didn't bet)
Seat 6: matiko09 (small blind) folded before Flop
Seat 7: ilaviiitech (big blind) folded before Flop
Seat 9: toprmaw folded before Flop (didn't bet)





PokerStars Hand #153149003010:  Hold'em No Limit ($0.50/$1.00 USD) - 2016/05/11 9:51:55 CET [2016/05/11 3:51:55 ET]
Table 'Hebei II' 9-max Seat #2 is the button
Seat 1: suddend3ath ($133.13 in chips) 
Seat 2: jojohny0211 ($100 in chips) 
Seat 4: toprmaw ($128.84 in chips) 
Seat 5: gnnr84 ($97.02 in chips) 
Seat 7: picka4u ($38.32 in chips) 
Seat 8: arctur17 ($100 in chips) 
Seat 9: matiko09 ($101.50 in chips) 
flk.Dasas will be allowed to play after the button
toprmaw: posts small blind $0.50
gnnr84: posts big blind $1
*** HOLE CARDS ***
Dealt to matiko09 [Qh 5s]
picka4u: folds 
arctur17: folds 
matiko09: folds 
suddend3ath: raises $1.50 to $2.50
jojohny0211: folds 
toprmaw: folds 
gnnr84: folds 
Uncalled bet ($1.50) returned to suddend3ath
suddend3ath collected $2.50 from pot
suddend3ath: doesn't show hand 
*** SUMMARY ***
Total pot $2.50 | Rake $0 
Seat 1: suddend3ath collected ($2.50)
Seat 2: jojohny0211 (button) folded before Flop (didn't bet)
Seat 4: toprmaw (small blind) folded before Flop
Seat 5: gnnr84 (big blind) folded before Flop
Seat 7: picka4u folded before Flop (didn't bet)
Seat 8: arctur17 folded before Flop (didn't bet)
Seat 9: matiko09 folded before Flop (didn't bet)





PokerStars Hand #153149003706:  Hold'em No Limit ($1/$2 USD) - 2016/05/11 9:51:57 CET [2016/05/11 3:51:57 ET]
Table 'Almach' 9-max Seat #5 is the button
Seat 1: fulsh81 ($120.05 in chips) 
Seat 2: AlKatrone ($200 in chips) 
Seat 3: bIondie ($201 in chips) 
Seat 4: matiko09 ($210.10 in chips) 
Seat 5: toprmaw ($200 in chips) 
Seat 6: ilaviiitech ($201 in chips) 
Seat 7: suddend3ath ($204 in chips) 
Seat 8: nickreason17 ($220 in chips) 
Seat 9: IseeUcards ($200 in chips) 
ilaviiitech: posts small blind $1
suddend3ath: posts big blind $2
*** HOLE CARDS ***
Dealt to matiko09 [As Jc]
nickreason17: folds 
IseeUcards: folds 
fulsh81: calls $2
AlKatrone: folds 
bIondie: folds 
matiko09: raises $6 to $8
toprmaw: folds 
ilaviiitech: folds 
suddend3ath: folds 
fulsh81: calls $6
*** FLOP *** [4c 3h 2h]
fulsh81: checks 
matiko09: checks 
*** TURN *** [4c 3h 2h] [9h]
fulsh81: checks 
matiko09: checks 
*** RIVER *** [4c 3h 2h 9h] [8s]
fulsh81: bets $8
matiko09: folds 
Uncalled bet ($8) returned to fulsh81
fulsh81 collected $18.05 from pot
fulsh81: doesn't show hand 
*** SUMMARY ***
Total pot $19 | Rake $0.95 
Board [4c 3h 2h 9h 8s]
Seat 1: fulsh81 collected ($18.05)
Seat 2: AlKatrone folded before Flop (didn't bet)
Seat 3: bIondie folded before Flop (didn't bet)
Seat 4: matiko09 folded on the River
Seat 5: toprmaw (button) folded before Flop (didn't bet)
Seat 6: ilaviiitech (small blind) folded before Flop
Seat 7: suddend3ath (big blind) folded before Flop
Seat 8: nickreason17 folded before Flop (didn't bet)
Seat 9: IseeUcards folded before Flop (didn't bet)





PokerStars Hand #153149004931:  Hold'em No Limit ($0.50/$1.00 USD) - 2016/05/11 9:52:01 CET [2016/05/11 3:52:01 ET]
Table 'Frisia' 9-max Seat #6 is the button
Seat 1: matiko09 ($105.50 in chips) 
Seat 3: flk.Dasas ($100 in chips) 
Seat 4: ilaviiitech ($100 in chips) 
Seat 5: toprmaw ($100 in chips) 
Seat 6: nickreason17 ($102.18 in chips) 
Seat 8: vanilica ($100.50 in chips) 
Seat 9: ninomorper ($100 in chips) 
vanilica: posts small blind $0.50
ninomorper: posts big blind $1
AlKatrone: sits out 
*** HOLE CARDS ***
Dealt to matiko09 [Ad Qd]
matiko09: raises $2 to $3
flk.Dasas: calls $3
ilaviiitech: folds 
toprmaw: folds 
nickreason17: folds 
vanilica: folds 
ninomorper: folds 
*** FLOP *** [Ac 3s 5c]
matiko09: bets $4.63
flk.Dasas: calls $4.63
*** TURN *** [Ac 3s 5c] [7c]
matiko09: checks 
flk.Dasas: checks 
*** RIVER *** [Ac 3s 5c 7c] [Kc]
matiko09: checks 
flk.Dasas: checks 
*** SHOW DOWN ***
matiko09: shows [Ad Qd] (a pair of Aces)
flk.Dasas: shows [Ah Kd] (two pair, Aces and Kings)
flk.Dasas collected $15.92 from pot
*** SUMMARY ***
Total pot $16.76 | Rake $0.84 
Board [Ac 3s 5c 7c Kc]
Seat 1: matiko09 showed [Ad Qd] and lost with a pair of Aces
Seat 3: flk.Dasas showed [Ah Kd] and won ($15.92) with two pair, Aces and Kings
Seat 4: ilaviiitech folded before Flop (didn't bet)
Seat 5: toprmaw folded before Flop (didn't bet)
Seat 6: nickreason17 (button) folded before Flop (didn't bet)
Seat 8: vanilica (small blind) folded before Flop
Seat 9: ninomorper (big blind) folded before Flop





PokerStars Hand #153149010584:  Hold'em No Limit ($0.50/$1.00 USD) - 2016/05/11 9:52:20 CET [2016/05/11 3:52:20 ET]
Table 'Sun' 9-max Seat #6 is the button
Seat 3: braindamage8 ($103.68 in chips) 
Seat 4: jd20102007 ($33.61 in chips) 
Seat 5: AlKatrone ($100 in chips) 
Seat 6: matiko09 ($100 in chips) 
Seat 7: ilaviiitech ($108.55 in chips) 
Seat 9: toprmaw ($100 in chips) 
ilaviiitech: posts small blind $0.50
toprmaw: posts big blind $1
myatiy 96: sits out 
jojohny0211: sits out 
*** HOLE CARDS ***
Dealt to matiko09 [4s Kh]
braindamage8: folds 
jd20102007: folds 
AlKatrone: folds 
matiko09: folds 
ilaviiitech: raises $2 to $3
toprmaw: folds 
Uncalled bet ($2) returned to ilaviiitech
ilaviiitech collected $2 from pot
ilaviiitech: doesn't show hand 
*** SUMMARY ***
Total pot $2 | Rake $0 
Seat 3: braindamage8 folded before Flop (didn't bet)
Seat 4: jd20102007 folded before Flop (didn't bet)
Seat 5: AlKatrone folded before Flop (didn't bet)
Seat 6: matiko09 (button) folded before Flop (didn't bet)
Seat 7: ilaviiitech (small blind) collected ($2)
Seat 9: toprmaw (big blind) folded before Flop





PokerStars Hand #153149011030:  Hold'em No Limit ($1/$2 USD) - 2016/05/11 9:52:22 CET [2016/05/11 3:52:22 ET]
Table 'Pyrrha' 9-max Seat #7 is the button
Seat 1: matiko09 ($253.25 in chips) 
Seat 2: AlKatrone ($249.77 in chips) 
Seat 3: HerrJanks ($200 in chips) 
Seat 4: toprmaw ($230.30 in chips) 
Seat 5: suddend3ath ($210 in chips) 
Seat 6: bIondie ($386.55 in chips) 
Seat 7: BigNickyy ($131.18 in chips) 
Seat 8: Yeomine ($79.55 in chips) 
Seat 9: Piniker85 ($212.03 in chips) 
Yeomine: posts small blind $1
Piniker85: posts big blind $2
*** HOLE CARDS ***
Dealt to matiko09 [Ts Ad]
matiko09: folds 
AlKatrone: folds 
HerrJanks: raises $3 to $5
toprmaw: folds 
suddend3ath: calls $5
bIondie: folds 
BigNickyy: folds 
Yeomine: folds 
Piniker85: folds 
*** FLOP *** [3d 2c 4d]
HerrJanks: bets $6.17
suddend3ath: calls $6.17
*** TURN *** [3d 2c 4d] [9h]
HerrJanks: bets $18.05
suddend3ath: calls $18.05
*** RIVER *** [3d 2c 4d 9h] [3s]
HerrJanks: bets $40.15
suddend3ath: calls $40.15
*** SHOW DOWN ***
HerrJanks: shows [Ac 6c] (a pair of Threes)
suddend3ath: shows [Kc Ks] (two pair, Kings and Threes)
suddend3ath collected $138.99 from pot
*** SUMMARY ***
Total pot $141.74 | Rake $2.75 
Board [3d 2c 4d 9h 3s]
Seat 1: matiko09 folded before Flop (didn't bet)
Seat 2: AlKatrone folded before Flop (didn't bet)
Seat 3: HerrJanks showed [Ac 6c] and lost with a pair of Threes
Seat 4: toprmaw folded before Flop (didn't bet)
Seat 5: suddend3ath showed [Kc Ks] and won ($138.99) with two pair, Kings and Threes
Seat 6: bIondie folded before Flop (didn't bet)
Seat 7: BigNickyy (button) folded before Flop (didn't bet)
Seat 8: Yeomine (small blind) folded before Flop
Seat 9: Piniker85 (big blind) folded before Flop





PokerStars Hand #153149011535:  Hold'em No Limit ($0.50/$1.00 USD) - 2016/05/11 9:52:24 CET [2016/05/11 3:52:24 ET]
Table 'Hebei II' 9-max Seat #4 is the button
Seat 1: suddend3ath ($134.63 in chips) 
Seat 2: jojohny0211 ($100 in chips) 
Seat 4: toprmaw ($128.34 in chips) 
Seat 5: gnnr84 ($96.02 in chips) 
Seat 7: picka4u ($38.32 in chips) 
Seat 8: arctur17 ($100 in chips) 
Seat 9: matiko09 ($101.50 in chips) 
gnnr84: posts small blind $0.50
picka4u: posts big blind $1
flk.Dasas: sits out 
*** HOLE CARDS ***
Dealt to matiko09 [2s 6d]
arctur17: folds 
matiko09: folds 
suddend3ath: raises $1.50 to $2.50
jojohny0211: calls $2.50
toprmaw: folds 
gnnr84: folds 
picka4u: folds 
*** FLOP *** [9d 5d 7c]
suddend3ath: checks 
jojohny0211: bets $3.70
suddend3ath: calls $3.70
*** TURN *** [9d 5d 7c] [7h]
suddend3ath: checks 
jojohny0211: checks 
*** RIVER *** [9d 5d 7c 7h] [Qc]
suddend3ath: bets $10
jojohny0211: folds 
Uncalled bet ($10) returned to suddend3ath
suddend3ath collected $13.20 from pot
suddend3ath: doesn't show hand 
*** SUMMARY ***
Total pot $13.90 | Rake $0.70 
Board [9d 5d 7c 7h Qc]
Seat 1: suddend3ath collected ($13.20)
Seat 2: jojohny0211 folded on the River
Seat 4: toprmaw (button) folded before Flop (didn't bet)
Seat 5: gnnr84 (small blind) folded before Flop
Seat 7: picka4u (big blind) folded before Flop
Seat 8: arctur17 folded before Flop (didn't bet)
Seat 9: matiko09 folded before Flop (didn't bet)





PokerStars Hand #153149018739:  Hold'em No Limit ($1/$2 USD) - 2016/05/11 9:52:48 CET [2016/05/11 3:52:48 ET]
Table 'Almach' 9-max Seat #6 is the button
Seat 1: fulsh81 ($130.10 in chips) 
Seat 2: AlKatrone ($200 in chips) 
Seat 3: bIondie ($201 in chips) 
Seat 4: matiko09 ($202.10 in chips) 
Seat 5: toprmaw ($200 in chips) 
Seat 6: ilaviiitech ($200 in chips) 
Seat 7: suddend3ath ($202 in chips) 
Seat 8: nickreason17 ($220 in chips) 
Seat 9: IseeUcards ($200 in chips) 
suddend3ath: posts small blind $1
nickreason17: posts big blind $2
*** HOLE CARDS ***
Dealt to matiko09 [As 5h]
IseeUcards: folds 
fulsh81: calls $2
AlKatrone: raises $6 to $8
bIondie: folds 
matiko09: folds 
toprmaw: folds 
ilaviiitech: folds 
suddend3ath: folds 
nickreason17: folds 
fulsh81: calls $6
*** FLOP *** [8h 6d Js]
fulsh81: checks 
AlKatrone: bets $10
fulsh81: folds 
Uncalled bet ($10) returned to AlKatrone
AlKatrone collected $18.05 from pot
*** SUMMARY ***
Total pot $19 | Rake $0.95 
Board [8h 6d Js]
Seat 1: fulsh81 folded on the Flop
Seat 2: AlKatrone collected ($18.05)
Seat 3: bIondie folded before Flop (didn't bet)
Seat 4: matiko09 folded before Flop (didn't bet)
Seat 5: toprmaw folded before Flop (didn't bet)
Seat 6: ilaviiitech (button) folded before Flop (didn't bet)
Seat 7: suddend3ath (small blind) folded before Flop
Seat 8: nickreason17 (big blind) folded before Flop
Seat 9: IseeUcards folded before Flop (didn't bet)





PokerStars Hand #153149019665:  Hold'em No Limit ($0.50/$1.00 USD) - 2016/05/11 9:52:51 CET [2016/05/11 3:52:51 ET]
Table 'Sun' 9-max Seat #7 is the button
Seat 1: myatiy 96 ($100 in chips) 
Seat 3: braindamage8 ($103.68 in chips) 
Seat 4: jd20102007 ($33.61 in chips) 
Seat 5: AlKatrone ($100 in chips) 
Seat 6: matiko09 ($100 in chips) 
Seat 7: ilaviiitech ($109.55 in chips) 
Seat 9: toprmaw ($100 in chips) 
toprmaw: posts small blind $0.50
myatiy 96: posts big blind $1
jojohny0211: sits out 
*** HOLE CARDS ***
Dealt to matiko09 [6c 5s]
braindamage8: raises $2 to $3
jd20102007: folds 
AlKatrone: folds 
matiko09: folds 
ilaviiitech: folds 
toprmaw: folds 
myatiy 96: folds 
Uncalled bet ($2) returned to braindamage8
braindamage8 collected $2.50 from pot
braindamage8: doesn't show hand 
*** SUMMARY ***
Total pot $2.50 | Rake $0 
Seat 1: myatiy 96 (big blind) folded before Flop
Seat 3: braindamage8 collected ($2.50)
Seat 4: jd20102007 folded before Flop (didn't bet)
Seat 5: AlKatrone folded before Flop (didn't bet)
Seat 6: matiko09 folded before Flop (didn't bet)
Seat 7: ilaviiitech (button) folded before Flop (didn't bet)
Seat 9: toprmaw (small blind) folded before Flop





PokerStars Hand #153149029470:  Hold'em No Limit ($1/$2 USD) - 2016/05/11 9:53:25 CET [2016/05/11 3:53:25 ET]
Table 'Almach' 9-max Seat #7 is the button
Seat 1: fulsh81 ($122.10 in chips) 
Seat 2: AlKatrone ($210.05 in chips) 
Seat 3: bIondie ($201 in chips) 
Seat 4: matiko09 ($202.10 in chips) 
Seat 5: toprmaw ($200 in chips) 
Seat 6: ilaviiitech ($200 in chips) 
Seat 7: suddend3ath ($201 in chips) 
Seat 8: nickreason17 ($218 in chips) 
Seat 9: IseeUcards ($200 in chips) 
nickreason17: posts small blind $1
IseeUcards: posts big blind $2
*** HOLE CARDS ***
Dealt to matiko09 [3s 9s]
fulsh81: folds 
AlKatrone: folds 
bIondie: raises $3 to $5
matiko09: folds 
toprmaw: folds 
ilaviiitech: folds 
suddend3ath: folds 
nickreason17: folds 
IseeUcards: folds 
Uncalled bet ($3) returned to bIondie
bIondie collected $5 from pot
bIondie: doesn't show hand 
*** SUMMARY ***
Total pot $5 | Rake $0 
Seat 1: fulsh81 folded before Flop (didn't bet)
Seat 2: AlKatrone folded before Flop (didn't bet)
Seat 3: bIondie collected ($5)
Seat 4: matiko09 folded before Flop (didn't bet)
Seat 5: toprmaw folded before Flop (didn't bet)
Seat 6: ilaviiitech folded before Flop (didn't bet)
Seat 7: suddend3ath (button) folded before Flop (didn't bet)
Seat 8: nickreason17 (small blind) folded before Flop
Seat 9: IseeUcards (big blind) folded before Flop





PokerStars Hand #153149030864:  Hold'em No Limit ($0.50/$1.00 USD) - 2016/05/11 9:53:30 CET [2016/05/11 3:53:30 ET]
Table 'Sun' 9-max Seat #9 is the button
Seat 1: myatiy 96 ($100 in chips) 
Seat 2: jojohny0211 ($100 in chips) 
Seat 3: braindamage8 ($105.18 in chips) 
Seat 4: jd20102007 ($33.61 in chips) 
Seat 5: AlKatrone ($100 in chips) 
Seat 6: matiko09 ($100 in chips) 
Seat 7: ilaviiitech ($109.55 in chips) 
Seat 9: toprmaw ($100 in chips) 
myatiy 96: posts small blind $0.50
jojohny0211: posts big blind $1
*** HOLE CARDS ***
Dealt to matiko09 [Tc 9s]
braindamage8: folds 
jd20102007: raises $1 to $2
AlKatrone: folds 
matiko09: folds 
ilaviiitech: folds 
toprmaw: folds 
myatiy 96: folds 
jojohny0211: folds 
Uncalled bet ($1) returned to jd20102007
jd20102007 collected $2.50 from pot
jd20102007: doesn't show hand 
*** SUMMARY ***
Total pot $2.50 | Rake $0 
Seat 1: myatiy 96 (small blind) folded before Flop
Seat 2: jojohny0211 (big blind) folded before Flop
Seat 3: braindamage8 folded before Flop (didn't bet)
Seat 4: jd20102007 collected ($2.50)
Seat 5: AlKatrone folded before Flop (didn't bet)
Seat 6: matiko09 folded before Flop (didn't bet)
Seat 7: ilaviiitech folded before Flop (didn't bet)
Seat 9: toprmaw (button) folded before Flop (didn't bet)





PokerStars Hand #153149033111:  Hold'em No Limit ($0.50/$1.00 USD) - 2016/05/11 9:53:37 CET [2016/05/11 3:53:37 ET]
Table 'Frisia' 9-max Seat #8 is the button
Seat 1: matiko09 ($100 in chips) 
Seat 3: flk.Dasas ($108.29 in chips) 
Seat 4: ilaviiitech ($100 in chips) 
Seat 5: toprmaw ($100 in chips) 
Seat 6: nickreason17 ($102.18 in chips) 
Seat 8: vanilica ($100 in chips) 
Seat 9: ninomorper ($99 in chips) 
ninomorper: posts small blind $0.50
matiko09: posts big blind $1
AlKatrone: sits out 
*** HOLE CARDS ***
Dealt to matiko09 [5s Kc]
flk.Dasas: raises $2 to $3
ilaviiitech: folds 
toprmaw: calls $3
nickreason17: folds 
vanilica: folds 
ninomorper: folds 
matiko09: folds 
*** FLOP *** [Kh Th Ts]
flk.Dasas: bets $4.84
toprmaw: folds 
Uncalled bet ($4.84) returned to flk.Dasas
flk.Dasas collected $7.12 from pot
flk.Dasas: doesn't show hand 
*** SUMMARY ***
Total pot $7.50 | Rake $0.38 
Board [Kh Th Ts]
Seat 1: matiko09 (big blind) folded before Flop
Seat 3: flk.Dasas collected ($7.12)
Seat 4: ilaviiitech folded before Flop (didn't bet)
Seat 5: toprmaw folded on the Flop
Seat 6: nickreason17 folded before Flop (didn't bet)
Seat 8: vanilica (button) folded before Flop (didn't bet)
Seat 9: ninomorper (small blind) folded before Flop





PokerStars Hand #153149035664:  Hold'em No Limit ($1/$2 USD) - 2016/05/11 9:53:46 CET [2016/05/11 3:53:46 ET]
Table 'Pyrrha' 9-max Seat #8 is the button
Seat 1: matiko09 ($253.25 in chips) 
Seat 2: AlKatrone ($249.77 in chips) 
Seat 3: HerrJanks ($200 in chips) 
Seat 4: toprmaw ($230.30 in chips) 
Seat 5: suddend3ath ($279.62 in chips) 
Seat 6: bIondie ($386.55 in chips) 
Seat 7: BigNickyy ($131.18 in chips) 
Seat 8: Yeomine ($78.55 in chips) 
Seat 9: Piniker85 ($210.03 in chips) 
Piniker85: posts small blind $1
matiko09: posts big blind $2
*** HOLE CARDS ***
Dealt to matiko09 [2s 5d]
AlKatrone: folds 
HerrJanks: folds 
toprmaw: folds 
suddend3ath: folds 
bIondie: folds 
BigNickyy: raises $4 to $6
Yeomine: raises $6 to $12
Piniker85: folds 
matiko09: folds 
BigNickyy: calls $6
*** FLOP *** [3h 2h 4h]
BigNickyy: checks 
Yeomine: bets $14
BigNickyy: raises $24 to $38
Yeomine: raises $24 to $62
BigNickyy: raises $24 to $86
Yeomine: calls $4.55 and is all-in
Uncalled bet ($19.45) returned to BigNickyy
*** TURN *** [3h 2h 4h] [8s]
*** RIVER *** [3h 2h 4h 8s] [2c]
*** SHOW DOWN ***
BigNickyy: shows [3s 3c] (a full house, Threes full of Deuces)
Yeomine: shows [Ad Ac] (two pair, Aces and Deuces)
BigNickyy collected $157.35 from pot
*** SUMMARY ***
Total pot $160.10 | Rake $2.75 
Board [3h 2h 4h 8s 2c]
Seat 1: matiko09 (big blind) folded before Flop
Seat 2: AlKatrone folded before Flop (didn't bet)
Seat 3: HerrJanks folded before Flop (didn't bet)
Seat 4: toprmaw folded before Flop (didn't bet)
Seat 5: suddend3ath folded before Flop (didn't bet)
Seat 6: bIondie folded before Flop (didn't bet)
Seat 7: BigNickyy showed [3s 3c] and won ($157.35) with a full house, Threes full of Deuces
Seat 8: Yeomine (button) showed [Ad Ac] and lost with two pair, Aces and Deuces
Seat 9: Piniker85 (small blind) folded before Flop





PokerStars Hand #153149035795:  Hold'em No Limit ($1/$2 USD) - 2016/05/11 9:53:47 CET [2016/05/11 3:53:47 ET]
Table 'Almach' 9-max Seat #8 is the button
Seat 1: fulsh81 ($122.10 in chips) 
Seat 2: AlKatrone ($210.05 in chips) 
Seat 3: bIondie ($204 in chips) 
Seat 4: matiko09 ($202.10 in chips) 
Seat 5: toprmaw ($200 in chips) 
Seat 6: ilaviiitech ($200 in chips) 
Seat 7: suddend3ath ($201 in chips) 
Seat 8: nickreason17 ($217 in chips) 
Seat 9: IseeUcards ($200 in chips) 
IseeUcards: posts small blind $1
fulsh81: posts big blind $2
*** HOLE CARDS ***
Dealt to matiko09 [Jc Ac]
AlKatrone: folds 
bIondie: folds 
matiko09: raises $3 to $5
toprmaw: folds 
ilaviiitech: folds 
suddend3ath: folds 
nickreason17: folds 
IseeUcards: calls $4
fulsh81: calls $3
*** FLOP *** [6d 3d 7c]
IseeUcards: checks 
fulsh81: bets $6
matiko09: calls $6
IseeUcards: folds 
*** TURN *** [6d 3d 7c] [Jd]
fulsh81: checks 
matiko09: bets $15
fulsh81: folds 
Uncalled bet ($15) returned to matiko09
matiko09 collected $25.65 from pot
matiko09: doesn't show hand 
*** SUMMARY ***
Total pot $27 | Rake $1.35 
Board [6d 3d 7c Jd]
Seat 1: fulsh81 (big blind) folded on the Turn
Seat 2: AlKatrone folded before Flop (didn't bet)
Seat 3: bIondie folded before Flop (didn't bet)
Seat 4: matiko09 collected ($25.65)
Seat 5: toprmaw folded before Flop (didn't bet)
Seat 6: ilaviiitech folded before Flop (didn't bet)
Seat 7: suddend3ath folded before Flop (didn't bet)
Seat 8: nickreason17 (button) folded before Flop (didn't bet)
Seat 9: IseeUcards (small blind) folded on the Flop





PokerStars Hand #153149041765:  Hold'em No Limit ($0.50/$1.00 USD) - 2016/05/11 9:54:07 CET [2016/05/11 3:54:07 ET]
Table 'Hebei II' 9-max Seat #5 is the button
Seat 1: suddend3ath ($141.63 in chips) 
Seat 2: jojohny0211 ($100 in chips) 
Seat 4: toprmaw ($128.34 in chips) 
Seat 5: gnnr84 ($95.52 in chips) 
Seat 7: picka4u ($37.32 in chips) 
Seat 8: arctur17 ($100 in chips) 
Seat 9: matiko09 ($101.50 in chips) 
picka4u: posts small blind $0.50
arctur17: posts big blind $1
flk.Dasas: sits out 
*** HOLE CARDS ***
Dealt to matiko09 [Th 4c]
matiko09: folds 
suddend3ath: folds 
jojohny0211: folds 
toprmaw: folds 
gnnr84: folds 
picka4u: raises $1.25 to $2.25
arctur17: folds 
Uncalled bet ($1.25) returned to picka4u
picka4u collected $2 from pot
picka4u: doesn't show hand 
*** SUMMARY ***
Total pot $2 | Rake $0 
Seat 1: suddend3ath folded before Flop (didn't bet)
Seat 2: jojohny0211 folded before Flop (didn't bet)
Seat 4: toprmaw folded before Flop (didn't bet)
Seat 5: gnnr84 (button) folded before Flop (didn't bet)
Seat 7: picka4u (small blind) collected ($2)
Seat 8: arctur17 (big blind) folded before Flop
Seat 9: matiko09 folded before Flop (didn't bet)





PokerStars Hand #153149042373:  Hold'em No Limit ($0.50/$1.00 USD) - 2016/05/11 9:54:09 CET [2016/05/11 3:54:09 ET]
Table 'Sun' 9-max Seat #1 is the button
Seat 1: myatiy 96 ($100 in chips) 
Seat 2: jojohny0211 ($100 in chips) 
Seat 4: jd20102007 ($35.11 in chips) 
Seat 5: AlKatrone ($100 in chips) 
Seat 6: matiko09 ($100 in chips) 
Seat 7: ilaviiitech ($109.55 in chips) 
Seat 9: toprmaw ($100 in chips) 
jojohny0211: posts small blind $0.50
braindamage8: is sitting out 
jd20102007: posts big blind $1
*** HOLE CARDS ***
Dealt to matiko09 [9c Ah]
AlKatrone: raises $2 to $3
matiko09: folds 
ilaviiitech: folds 
toprmaw: folds 
myatiy 96: calls $3
jojohny0211: folds 
jd20102007: folds 
*** FLOP *** [Tc Jc 6s]
AlKatrone: checks 
braindamage8 leaves the table
myatiy 96: checks 
*** TURN *** [Tc Jc 6s] [Ac]
AlKatrone: checks 
myatiy 96: checks 
*** RIVER *** [Tc Jc 6s Ac] [4d]
AlKatrone: checks 
myatiy 96: checks 
*** SHOW DOWN ***
AlKatrone: shows [Th 9h] (a pair of Tens)
myatiy 96: shows [Qs Js] (a pair of Jacks)
myatiy 96 collected $7.12 from pot
*** SUMMARY ***
Total pot $7.50 | Rake $0.38 
Board [Tc Jc 6s Ac 4d]
Seat 1: myatiy 96 (button) showed [Qs Js] and won ($7.12) with a pair of Jacks
Seat 2: jojohny0211 (small blind) folded before Flop
Seat 4: jd20102007 (big blind) folded before Flop
Seat 5: AlKatrone showed [Th 9h] and lost with a pair of Tens
Seat 6: matiko09 folded before Flop (didn't bet)
Seat 7: ilaviiitech folded before Flop (didn't bet)
Seat 9: toprmaw folded before Flop (didn't bet)





PokerStars Hand #153149047801:  Hold'em No Limit ($0.50/$1.00 USD) - 2016/05/11 9:54:27 CET [2016/05/11 3:54:27 ET]
Table 'Frisia' 9-max Seat #9 is the button
Seat 1: matiko09 ($100 in chips) 
Seat 2: AlKatrone ($100 in chips) 
Seat 3: flk.Dasas ($112.41 in chips) 
Seat 4: ilaviiitech ($100 in chips) 
Seat 5: toprmaw ($100 in chips) 
Seat 6: nickreason17 ($102.18 in chips) 
Seat 8: vanilica ($100 in chips) 
Seat 9: ninomorper ($98.50 in chips) 
matiko09: posts small blind $0.50
AlKatrone: posts big blind $1
*** HOLE CARDS ***
Dealt to matiko09 [Ts 9c]
flk.Dasas: folds 
ilaviiitech: folds 
toprmaw: folds 
nickreason17: folds 
vanilica: folds 
ninomorper: raises $1 to $2
matiko09: folds 
AlKatrone: calls $1
*** FLOP *** [3d 5c 9s]
AlKatrone: checks 
ninomorper: bets $4
AlKatrone: folds 
Uncalled bet ($4) returned to ninomorper
ninomorper collected $4.28 from pot
*** SUMMARY ***
Total pot $4.50 | Rake $0.22 
Board [3d 5c 9s]
Seat 1: matiko09 (small blind) folded before Flop
Seat 2: AlKatrone (big blind) folded on the Flop
Seat 3: flk.Dasas folded before Flop (didn't bet)
Seat 4: ilaviiitech folded before Flop (didn't bet)
Seat 5: toprmaw folded before Flop (didn't bet)
Seat 6: nickreason17 folded before Flop (didn't bet)
Seat 8: vanilica folded before Flop (didn't bet)
Seat 9: ninomorper (button) collected ($4.28)





PokerStars Hand #153149053809:  Hold'em No Limit ($1/$2 USD) - 2016/05/11 9:54:47 CET [2016/05/11 3:54:47 ET]
Table 'Pyrrha' 9-max Seat #9 is the button
Seat 1: matiko09 ($251.25 in chips) 
Seat 2: AlKatrone ($249.77 in chips) 
Seat 3: HerrJanks ($200 in chips) 
Seat 4: toprmaw ($230.30 in chips) 
Seat 5: suddend3ath ($279.62 in chips) 
Seat 6: bIondie ($386.55 in chips) 
Seat 7: BigNickyy ($209.98 in chips) 
Seat 9: Piniker85 ($209.03 in chips) 
matiko09: posts small blind $1
AlKatrone: posts big blind $2
*** HOLE CARDS ***
Dealt to matiko09 [Ah Kc]
HerrJanks: folds 
Yeomine leaves the table
toprmaw: folds 
nickreason17 joins the table at seat #8 
suddend3ath: raises $3 to $5
bIondie: folds 
BigNickyy: folds 
nickreason17 leaves the table
IseeUcards joins the table at seat #8 
Piniker85: folds 
matiko09: calls $4
AlKatrone: folds 
*** FLOP *** [4s 8c 6s]
matiko09: checks 
suddend3ath: checks 
*** TURN *** [4s 8c 6s] [Tc]
matiko09: bets $7.41
suddend3ath: folds 
Uncalled bet ($7.41) returned to matiko09
matiko09 collected $11.40 from pot
matiko09: doesn't show hand 
*** SUMMARY ***
Total pot $12 | Rake $0.60 
Board [4s 8c 6s Tc]
Seat 1: matiko09 (small blind) collected ($11.40)
Seat 2: AlKatrone (big blind) folded before Flop
Seat 3: HerrJanks folded before Flop (didn't bet)
Seat 4: toprmaw folded before Flop (didn't bet)
Seat 5: suddend3ath folded on the Turn
Seat 6: bIondie folded before Flop (didn't bet)
Seat 7: BigNickyy folded before Flop (didn't bet)
Seat 9: Piniker85 (button) folded before Flop (didn't bet)





PokerStars Hand #153149055055:  Hold'em No Limit ($1/$2 USD) - 2016/05/11 9:54:51 CET [2016/05/11 3:54:51 ET]
Table 'Almach' 9-max Seat #9 is the button
Seat 1: fulsh81 ($111.10 in chips) 
Seat 2: AlKatrone ($210.05 in chips) 
Seat 3: bIondie ($204 in chips) 
Seat 4: matiko09 ($216.75 in chips) 
Seat 5: toprmaw ($200 in chips) 
Seat 6: ilaviiitech ($200 in chips) 
Seat 7: suddend3ath ($201 in chips) 
Seat 8: nickreason17 ($217 in chips) 
Seat 9: IseeUcards ($200 in chips) 
fulsh81: posts small blind $1
AlKatrone: posts big blind $2
*** HOLE CARDS ***
Dealt to matiko09 [8c Kd]
bIondie: folds 
bIondie leaves the table
matiko09: folds 
toprmaw: folds 
ilaviiitech: folds 
suddend3ath: folds 
nickreason17: folds 
IseeUcards: folds 
fulsh81: calls $1
HerrJanks joins the table at seat #3 
AlKatrone: checks 
*** FLOP *** [Th 3h Js]
fulsh81: bets $4
AlKatrone: folds 
Uncalled bet ($4) returned to fulsh81
fulsh81 collected $3.80 from pot
*** SUMMARY ***
Total pot $4 | Rake $0.20 
Board [Th 3h Js]
Seat 1: fulsh81 (small blind) collected ($3.80)
Seat 2: AlKatrone (big blind) folded on the Flop
Seat 3: bIondie folded before Flop (didn't bet)
Seat 4: matiko09 folded before Flop (didn't bet)
Seat 5: toprmaw folded before Flop (didn't bet)
Seat 6: ilaviiitech folded before Flop (didn't bet)
Seat 7: suddend3ath folded before Flop (didn't bet)
Seat 8: nickreason17 folded before Flop (didn't bet)
Seat 9: IseeUcards (button) folded before Flop (didn't bet)





PokerStars Hand #153149059754:  Hold'em No Limit ($0.50/$1.00 USD) - 2016/05/11 9:55:07 CET [2016/05/11 3:55:07 ET]
Table 'Frisia' 9-max Seat #1 is the button
Seat 1: matiko09 ($100 in chips) 
Seat 2: AlKatrone ($100 in chips) 
Seat 3: flk.Dasas ($112.41 in chips) 
Seat 4: ilaviiitech ($100 in chips) 
Seat 5: toprmaw ($100 in chips) 
Seat 6: nickreason17 ($102.18 in chips) 
Seat 8: vanilica ($100 in chips) 
Seat 9: ninomorper ($100.78 in chips) 
AlKatrone: posts small blind $0.50
flk.Dasas: posts big blind $1
*** HOLE CARDS ***
Dealt to matiko09 [As Ah]
ilaviiitech: folds 
toprmaw: folds 
nickreason17: folds 
vanilica: folds 
ninomorper: folds 
matiko09: raises $1.27 to $2.27
AlKatrone: folds 
flk.Dasas: folds 
Uncalled bet ($1.27) returned to matiko09
matiko09 collected $2.50 from pot
matiko09: doesn't show hand 
*** SUMMARY ***
Total pot $2.50 | Rake $0 
Seat 1: matiko09 (button) collected ($2.50)
Seat 2: AlKatrone (small blind) folded before Flop
Seat 3: flk.Dasas (big blind) folded before Flop
Seat 4: ilaviiitech folded before Flop (didn't bet)
Seat 5: toprmaw folded before Flop (didn't bet)
Seat 6: nickreason17 folded before Flop (didn't bet)
Seat 8: vanilica folded before Flop (didn't bet)
Seat 9: ninomorper folded before Flop (didn't bet)





PokerStars Hand #153149064432:  Hold'em No Limit ($0.50/$1.00 USD) - 2016/05/11 9:55:24 CET [2016/05/11 3:55:24 ET]
Table 'Frisia' 9-max Seat #2 is the button
Seat 1: matiko09 ($101.50 in chips) 
Seat 2: AlKatrone ($100 in chips) 
Seat 3: flk.Dasas ($111.41 in chips) 
Seat 4: ilaviiitech ($100 in chips) 
Seat 5: toprmaw ($100 in chips) 
Seat 6: nickreason17 ($102.18 in chips) 
Seat 8: vanilica ($100 in chips) 
Seat 9: ninomorper ($100.78 in chips) 
flk.Dasas: posts small blind $0.50
ilaviiitech: posts big blind $1
*** HOLE CARDS ***
Dealt to matiko09 [Kh 7h]
toprmaw: folds 
nickreason17: folds 
vanilica: folds 
ninomorper: folds 
matiko09: folds 
AlKatrone: raises $2 to $3
flk.Dasas: folds 
ilaviiitech: folds 
Uncalled bet ($2) returned to AlKatrone
AlKatrone collected $2.50 from pot
*** SUMMARY ***
Total pot $2.50 | Rake $0 
Seat 1: matiko09 folded before Flop (didn't bet)
Seat 2: AlKatrone (button) collected ($2.50)
Seat 3: flk.Dasas (small blind) folded before Flop
Seat 4: ilaviiitech (big blind) folded before Flop
Seat 5: toprmaw folded before Flop (didn't bet)
Seat 6: nickreason17 folded before Flop (didn't bet)
Seat 8: vanilica folded before Flop (didn't bet)
Seat 9: ninomorper folded before Flop (didn't bet)





PokerStars Hand #153149064733:  Hold'em No Limit ($1/$2 USD) - 2016/05/11 9:55:25 CET [2016/05/11 3:55:25 ET]
Table 'Almach' 9-max Seat #1 is the button
Seat 1: fulsh81 ($112.90 in chips) 
Seat 2: AlKatrone ($208.05 in chips) 
Seat 3: HerrJanks ($200 in chips) 
Seat 4: matiko09 ($216.75 in chips) 
Seat 5: toprmaw ($200 in chips) 
Seat 6: ilaviiitech ($200 in chips) 
Seat 7: suddend3ath ($201 in chips) 
Seat 8: nickreason17 ($217 in chips) 
Seat 9: IseeUcards ($200 in chips) 
AlKatrone: posts small blind $1
HerrJanks: posts big blind $2
*** HOLE CARDS ***
Dealt to matiko09 [3h 4c]
matiko09: folds 
toprmaw: folds 
ilaviiitech: folds 
suddend3ath: folds 
nickreason17: raises $3 to $5
IseeUcards: folds 
fulsh81: folds 
AlKatrone: folds 
HerrJanks: calls $3
*** FLOP *** [Qs 5d 5c]
HerrJanks: checks 
nickreason17: bets $5.50
HerrJanks: calls $5.50
*** TURN *** [Qs 5d 5c] [6h]
HerrJanks: checks 
nickreason17: checks 
*** RIVER *** [Qs 5d 5c 6h] [Ks]
HerrJanks: checks 
nickreason17: bets $12.54
HerrJanks: folds 
Uncalled bet ($12.54) returned to nickreason17
nickreason17 collected $20.90 from pot
*** SUMMARY ***
Total pot $22 | Rake $1.10 
Board [Qs 5d 5c 6h Ks]
Seat 1: fulsh81 (button) folded before Flop (didn't bet)
Seat 2: AlKatrone (small blind) folded before Flop
Seat 3: HerrJanks (big blind) folded on the River
Seat 4: matiko09 folded before Flop (didn't bet)
Seat 5: toprmaw folded before Flop (didn't bet)
Seat 6: ilaviiitech folded before Flop (didn't bet)
Seat 7: suddend3ath folded before Flop (didn't bet)
Seat 8: nickreason17 collected ($20.90)
Seat 9: IseeUcards folded before Flop (didn't bet)





PokerStars Hand #153149069688:  Hold'em No Limit ($1/$2 USD) - 2016/05/11 9:55:44 CET [2016/05/11 3:55:44 ET]
Table 'Pyrrha' 9-max Seat #1 is the button
Seat 1: matiko09 ($257.65 in chips) 
Seat 2: AlKatrone ($247.77 in chips) 
Seat 3: HerrJanks ($200 in chips) 
Seat 4: toprmaw ($230.30 in chips) 
Seat 5: suddend3ath ($274.62 in chips) 
Seat 6: bIondie ($386.55 in chips) 
Seat 7: BigNickyy ($209.98 in chips) 
Seat 9: Piniker85 ($209.03 in chips) 
AlKatrone: posts small blind $1
HerrJanks: posts big blind $2
IseeUcards: sits out 
*** HOLE CARDS ***
Dealt to matiko09 [Jh 8h]
toprmaw: folds 
suddend3ath: folds 
bIondie: folds 
BigNickyy: raises $4 to $6
Piniker85: folds 
matiko09: folds 
AlKatrone: folds 
HerrJanks: folds 
Uncalled bet ($4) returned to BigNickyy
BigNickyy collected $5 from pot
BigNickyy: doesn't show hand 
*** SUMMARY ***
Total pot $5 | Rake $0 
Seat 1: matiko09 (button) folded before Flop (didn't bet)
Seat 2: AlKatrone (small blind) folded before Flop
Seat 3: HerrJanks (big blind) folded before Flop
Seat 4: toprmaw folded before Flop (didn't bet)
Seat 5: suddend3ath folded before Flop (didn't bet)
Seat 6: bIondie folded before Flop (didn't bet)
Seat 7: BigNickyy collected ($5)
Seat 9: Piniker85 folded before Flop (didn't bet)





PokerStars Hand #153149073027:  Hold'em No Limit ($0.50/$1.00 USD) - 2016/05/11 9:55:57 CET [2016/05/11 3:55:57 ET]
Table 'Sun' 9-max Seat #2 is the button
Seat 1: myatiy 96 ($104.12 in chips) 
Seat 2: jojohny0211 ($100 in chips) 
Seat 4: jd20102007 ($34.11 in chips) 
Seat 5: AlKatrone ($100 in chips) 
Seat 6: matiko09 ($100 in chips) 
Seat 7: ilaviiitech ($109.55 in chips) 
Seat 9: toprmaw ($100 in chips) 
jd20102007: posts small blind $0.50
vanilica joins the table at seat #3 
AlKatrone: posts big blind $1
*** HOLE CARDS ***
Dealt to matiko09 [Js As]
vanilica leaves the table
matiko09: raises $2 to $3
ilaviiitech: folds 
toprmaw: folds 
myatiy 96: folds 
jojohny0211: folds 
jd20102007: folds 
mycka86 joins the table at seat #3 
AlKatrone: folds 
Uncalled bet ($2) returned to matiko09
matiko09 collected $2.50 from pot
matiko09: doesn't show hand 
*** SUMMARY ***
Total pot $2.50 | Rake $0 
Seat 1: myatiy 96 folded before Flop (didn't bet)
Seat 2: jojohny0211 (button) folded before Flop (didn't bet)
Seat 4: jd20102007 (small blind) folded before Flop
Seat 5: AlKatrone (big blind) folded before Flop
Seat 6: matiko09 collected ($2.50)
Seat 7: ilaviiitech folded before Flop (didn't bet)
Seat 9: toprmaw folded before Flop (didn't bet)





PokerStars Hand #153149075126:  Hold'em No Limit ($0.50/$1.00 USD) - 2016/05/11 9:56:05 CET [2016/05/11 3:56:05 ET]
Table 'Frisia' 9-max Seat #3 is the button
Seat 1: matiko09 ($101.50 in chips) 
Seat 2: AlKatrone ($101.50 in chips) 
Seat 3: flk.Dasas ($110.91 in chips) 
Seat 4: ilaviiitech ($100 in chips) 
Seat 5: toprmaw ($100 in chips) 
Seat 6: nickreason17 ($102.18 in chips) 
Seat 8: vanilica ($100 in chips) 
Seat 9: ninomorper ($100.78 in chips) 
ilaviiitech: posts small blind $0.50
toprmaw: posts big blind $1
*** HOLE CARDS ***
Dealt to matiko09 [4c 7c]
nickreason17: folds 
nickreason17 leaves the table
vanilica: folds 
myatiy 96 joins the table at seat #6 
myatiy 96 leaves the table
ninomorper: raises $2 to $3
matiko09: folds 
teerajaja joins the table at seat #6 
AlKatrone: raises $6 to $9
flk.Dasas: folds 
ilaviiitech: folds 
toprmaw: folds 
ninomorper: folds 
Uncalled bet ($6) returned to AlKatrone
AlKatrone collected $7.50 from pot
*** SUMMARY ***
Total pot $7.50 | Rake $0 
Seat 1: matiko09 folded before Flop (didn't bet)
Seat 2: AlKatrone collected ($7.50)
Seat 3: flk.Dasas (button) folded before Flop (didn't bet)
Seat 4: ilaviiitech (small blind) folded before Flop
Seat 5: toprmaw (big blind) folded before Flop
Seat 6: nickreason17 folded before Flop (didn't bet)
Seat 8: vanilica folded before Flop (didn't bet)
Seat 9: ninomorper folded before Flop





PokerStars Hand #153149075751:  Hold'em No Limit ($1/$2 USD) - 2016/05/11 9:56:07 CET [2016/05/11 3:56:07 ET]
Table 'Pyrrha' 9-max Seat #2 is the button
Seat 1: matiko09 ($257.65 in chips) 
Seat 2: AlKatrone ($246.77 in chips) 
Seat 3: HerrJanks ($200 in chips) 
Seat 4: toprmaw ($230.30 in chips) 
Seat 5: suddend3ath ($274.62 in chips) 
Seat 6: bIondie ($386.55 in chips) 
Seat 7: BigNickyy ($212.98 in chips) 
Seat 9: Piniker85 ($209.03 in chips) 
HerrJanks: posts small blind $1
toprmaw: posts big blind $2
IseeUcards: sits out 
*** HOLE CARDS ***
Dealt to matiko09 [9s Ah]
suddend3ath: folds 
bIondie: folds 
BigNickyy: raises $4 to $6
Piniker85: folds 
matiko09: folds 
AlKatrone: raises $12 to $18
HerrJanks: folds 
toprmaw: folds 
BigNickyy: folds 
Uncalled bet ($12) returned to AlKatrone
AlKatrone collected $15 from pot
*** SUMMARY ***
Total pot $15 | Rake $0 
Seat 1: matiko09 folded before Flop (didn't bet)
Seat 2: AlKatrone (button) collected ($15)
Seat 3: HerrJanks (small blind) folded before Flop
Seat 4: toprmaw (big blind) folded before Flop
Seat 5: suddend3ath folded before Flop (didn't bet)
Seat 6: bIondie folded before Flop (didn't bet)
Seat 7: BigNickyy folded before Flop
Seat 9: Piniker85 folded before Flop (didn't bet)





PokerStars Hand #153149083189:  Hold'em No Limit ($1/$2 USD) - 2016/05/11 9:56:35 CET [2016/05/11 3:56:35 ET]
Table 'Pyrrha' 9-max Seat #3 is the button
Seat 1: matiko09 ($257.65 in chips) 
Seat 2: AlKatrone ($255.77 in chips) 
Seat 3: HerrJanks ($200 in chips) 
Seat 4: toprmaw ($228.30 in chips) 
Seat 5: suddend3ath ($274.62 in chips) 
Seat 6: bIondie ($386.55 in chips) 
Seat 7: BigNickyy ($206.98 in chips) 
Seat 9: Piniker85 ($209.03 in chips) 
toprmaw: posts small blind $1
suddend3ath: posts big blind $2
IseeUcards: sits out 
*** HOLE CARDS ***
Dealt to matiko09 [9c 9d]
bIondie: folds 
bIondie leaves the table
BigNickyy: folds 
myatiy 96 joins the table at seat #6 
myatiy 96 leaves the table
Piniker85: folds 
matiko09: raises $3 to $5
AlKatrone: folds 
HerrJanks: folds 
toprmaw: folds 
semaantarek joins the table at seat #6 
suddend3ath: folds 
Uncalled bet ($3) returned to matiko09
matiko09 collected $5 from pot
matiko09: doesn't show hand 
*** SUMMARY ***
Total pot $5 | Rake $0 
Seat 1: matiko09 collected ($5)
Seat 2: AlKatrone folded before Flop (didn't bet)
Seat 3: HerrJanks (button) folded before Flop (didn't bet)
Seat 4: toprmaw (small blind) folded before Flop
Seat 5: suddend3ath (big blind) folded before Flop
Seat 6: bIondie folded before Flop (didn't bet)
Seat 7: BigNickyy folded before Flop (didn't bet)
Seat 9: Piniker85 folded before Flop (didn't bet)





PokerStars Hand #153149083305:  Hold'em No Limit ($0.50/$1.00 USD) - 2016/05/11 9:56:36 CET [2016/05/11 3:56:36 ET]
Table 'Sun' 9-max Seat #4 is the button
Seat 1: myatiy 96 ($104.12 in chips) 
Seat 2: jojohny0211 ($100 in chips) 
Seat 4: jd20102007 ($33.61 in chips) 
Seat 5: AlKatrone ($100 in chips) 
Seat 6: matiko09 ($101.50 in chips) 
Seat 7: ilaviiitech ($109.55 in chips) 
Seat 9: toprmaw ($100 in chips) 
AlKatrone: posts small blind $0.50
matiko09: posts big blind $1
mycka86: sits out 
*** HOLE CARDS ***
Dealt to matiko09 [4h 2c]
ilaviiitech: folds 
toprmaw: folds 
myatiy 96: raises $2 to $3
jojohny0211: calls $3
jd20102007: folds 
AlKatrone: folds 
matiko09: folds 
*** FLOP *** [2h 4s 3d]
myatiy 96: checks 
jojohny0211: bets $3.70
myatiy 96: folds 
Uncalled bet ($3.70) returned to jojohny0211
jojohny0211 collected $7.12 from pot
jojohny0211: doesn't show hand 
*** SUMMARY ***
Total pot $7.50 | Rake $0.38 
Board [2h 4s 3d]
Seat 1: myatiy 96 folded on the Flop
Seat 2: jojohny0211 collected ($7.12)
Seat 4: jd20102007 (button) folded before Flop (didn't bet)
Seat 5: AlKatrone (small blind) folded before Flop
Seat 6: matiko09 (big blind) folded before Flop
Seat 7: ilaviiitech folded before Flop (didn't bet)
Seat 9: toprmaw folded before Flop (didn't bet)





PokerStars Hand #153149084851:  Hold'em No Limit ($1/$2 USD) - 2016/05/11 9:56:41 CET [2016/05/11 3:56:41 ET]
Table 'Almach' 9-max Seat #2 is the button
Seat 1: fulsh81 ($112.90 in chips) 
Seat 2: AlKatrone ($207.05 in chips) 
Seat 3: HerrJanks ($200 in chips) 
Seat 4: matiko09 ($216.75 in chips) 
Seat 5: toprmaw ($200 in chips) 
Seat 6: ilaviiitech ($200 in chips) 
Seat 7: suddend3ath ($201 in chips) 
Seat 8: nickreason17 ($227.40 in chips) 
Seat 9: IseeUcards ($200 in chips) 
HerrJanks: posts small blind $1
matiko09: posts big blind $2
*** HOLE CARDS ***
Dealt to matiko09 [5c 5s]
toprmaw: folds 
ilaviiitech: folds 
suddend3ath: folds 
nickreason17: raises $3 to $5
IseeUcards: folds 
fulsh81: raises $5 to $10
AlKatrone: folds 
HerrJanks: folds 
matiko09: folds 
nickreason17: calls $5
*** FLOP *** [6s 2s Ks]
nickreason17: checks 
fulsh81: bets $10
nickreason17: folds 
Uncalled bet ($10) returned to fulsh81
fulsh81 collected $21.85 from pot
*** SUMMARY ***
Total pot $23 | Rake $1.15 
Board [6s 2s Ks]
Seat 1: fulsh81 collected ($21.85)
Seat 2: AlKatrone (button) folded before Flop (didn't bet)
Seat 3: HerrJanks (small blind) folded before Flop
Seat 4: matiko09 (big blind) folded before Flop
Seat 5: toprmaw folded before Flop (didn't bet)
Seat 6: ilaviiitech folded before Flop (didn't bet)
Seat 7: suddend3ath folded before Flop (didn't bet)
Seat 8: nickreason17 folded on the Flop
Seat 9: IseeUcards folded before Flop (didn't bet)





PokerStars Hand #153149084981:  Hold'em No Limit ($0.50/$1.00 USD) - 2016/05/11 9:56:42 CET [2016/05/11 3:56:42 ET]
Table 'Frisia' 9-max Seat #4 is the button
Seat 1: matiko09 ($101.50 in chips) 
Seat 2: AlKatrone ($106 in chips) 
Seat 3: flk.Dasas ($110.91 in chips) 
Seat 4: ilaviiitech ($100 in chips) 
Seat 5: toprmaw ($100 in chips) 
Seat 6: teerajaja ($100 in chips) 
Seat 8: vanilica ($100 in chips) 
Seat 9: ninomorper ($97.78 in chips) 
toprmaw: posts small blind $0.50
teerajaja: posts big blind $1
*** HOLE CARDS ***
Dealt to matiko09 [2s 3h]
vanilica: folds 
ninomorper: folds 
matiko09: folds 
AlKatrone: folds 
flk.Dasas: raises $1.50 to $2.50
ilaviiitech: folds 
toprmaw: folds 
teerajaja: calls $1.50
*** FLOP *** [8c Qh Js]
teerajaja: checks 
flk.Dasas: checks 
*** TURN *** [8c Qh Js] [9d]
teerajaja: checks 
flk.Dasas: bets $2.51
teerajaja: calls $2.51
*** RIVER *** [8c Qh Js 9d] [2d]
teerajaja: checks 
flk.Dasas: bets $5.89
teerajaja: calls $5.89
*** SHOW DOWN ***
flk.Dasas: shows [Th Jc] (a straight, Eight to Queen)
teerajaja: shows [Ts Qs] (a straight, Eight to Queen)
teerajaja collected $10.59 from pot
flk.Dasas collected $10.59 from pot
*** SUMMARY ***
Total pot $22.30 | Rake $1.12 
Board [8c Qh Js 9d 2d]
Seat 1: matiko09 folded before Flop (didn't bet)
Seat 2: AlKatrone folded before Flop (didn't bet)
Seat 3: flk.Dasas showed [Th Jc] and won ($10.59) with a straight, Eight to Queen
Seat 4: ilaviiitech (button) folded before Flop (didn't bet)
Seat 5: toprmaw (small blind) folded before Flop
Seat 6: teerajaja (big blind) showed [Ts Qs] and won ($10.59) with a straight, Eight to Queen
Seat 8: vanilica folded before Flop (didn't bet)
Seat 9: ninomorper folded before Flop (didn't bet)





PokerStars Hand #153149087259:  Hold'em No Limit ($0.50/$1.00 USD) - 2016/05/11 9:56:50 CET [2016/05/11 3:56:50 ET]
Table 'Eukrate II' 9-max Seat #1 is the button
Seat 1: rolik374 ($40 in chips) 
Seat 2: matiko09 ($100 in chips) 
Seat 3: ilaviiitech ($100 in chips) 
Seat 4: nickreason17 ($100 in chips) 
Seat 5: flk.Dasas ($100 in chips) 
matiko09: posts small blind $0.50
ilaviiitech: posts big blind $1
*** HOLE CARDS ***
Dealt to matiko09 [Jc 4h]
Dantist1122 joins the table at seat #6 
IseeUcards joins the table at seat #9 
nickreason17: folds 
flk.Dasas: raises $1.50 to $2.50
Yeomine joins the table at seat #7 
rolik374: calls $2.50
matiko09: folds 
ilaviiitech: raises $10.50 to $13
ebashupoker joins the table at seat #8 
flk.Dasas: folds 
rolik374: folds 
Uncalled bet ($10.50) returned to ilaviiitech
ilaviiitech collected $8 from pot
ilaviiitech: doesn't show hand 
*** SUMMARY ***
Total pot $8 | Rake $0 
Seat 1: rolik374 (button) folded before Flop
Seat 2: matiko09 (small blind) folded before Flop
Seat 3: ilaviiitech (big blind) collected ($8)
Seat 4: nickreason17 folded before Flop (didn't bet)
Seat 5: flk.Dasas folded before Flop





PokerStars Hand #153149088983:  Hold'em No Limit ($1/$2 USD) - 2016/05/11 9:56:57 CET [2016/05/11 3:56:57 ET]
Table 'Pyrrha' 9-max Seat #4 is the button
Seat 1: matiko09 ($260.65 in chips) 
Seat 2: AlKatrone ($255.77 in chips) 
Seat 3: HerrJanks ($200 in chips) 
Seat 4: toprmaw ($227.30 in chips) 
Seat 5: suddend3ath ($272.62 in chips) 
Seat 6: semaantarek ($200 in chips) 
Seat 7: BigNickyy ($206.98 in chips) 
Seat 9: Piniker85 ($209.03 in chips) 
suddend3ath: posts small blind $1
semaantarek: posts big blind $2
IseeUcards: sits out 
*** HOLE CARDS ***
Dealt to matiko09 [As 7c]
BigNickyy: folds 
Piniker85: folds 
matiko09: folds 
AlKatrone: folds 
HerrJanks: folds 
toprmaw: raises $4 to $6
suddend3ath: folds 
semaantarek: folds 
Uncalled bet ($4) returned to toprmaw
toprmaw collected $5 from pot
toprmaw: doesn't show hand 
*** SUMMARY ***
Total pot $5 | Rake $0 
Seat 1: matiko09 folded before Flop (didn't bet)
Seat 2: AlKatrone folded before Flop (didn't bet)
Seat 3: HerrJanks folded before Flop (didn't bet)
Seat 4: toprmaw (button) collected ($5)
Seat 5: suddend3ath (small blind) folded before Flop
Seat 6: semaantarek (big blind) folded before Flop
Seat 7: BigNickyy folded before Flop (didn't bet)
Seat 9: Piniker85 folded before Flop (didn't bet)





PokerStars Hand #153149095768:  Hold'em No Limit ($1/$2 USD) - 2016/05/11 9:57:23 CET [2016/05/11 3:57:23 ET]
Table 'Almach' 9-max Seat #3 is the button
Seat 1: fulsh81 ($124.75 in chips) 
Seat 2: AlKatrone ($207.05 in chips) 
Seat 3: HerrJanks ($200 in chips) 
Seat 4: matiko09 ($214.75 in chips) 
Seat 5: toprmaw ($200 in chips) 
Seat 6: ilaviiitech ($200 in chips) 
Seat 7: suddend3ath ($201 in chips) 
Seat 8: nickreason17 ($217.40 in chips) 
Seat 9: IseeUcards ($200 in chips) 
matiko09: posts small blind $1
toprmaw: posts big blind $2
*** HOLE CARDS ***
Dealt to matiko09 [9c Qh]
ilaviiitech: folds 
suddend3ath: folds 
nickreason17: folds 
IseeUcards: folds 
fulsh81: calls $2
AlKatrone: raises $6 to $8
HerrJanks: folds 
matiko09: folds 
toprmaw: folds 
fulsh81: calls $6
*** FLOP *** [Td 4c Kh]
fulsh81: bets $8
AlKatrone: calls $8
*** TURN *** [Td 4c Kh] [8s]
fulsh81: bets $8
AlKatrone: raises $26 to $34
fulsh81: folds 
Uncalled bet ($26) returned to AlKatrone
AlKatrone collected $48.45 from pot
*** SUMMARY ***
Total pot $51 | Rake $2.55 
Board [Td 4c Kh 8s]
Seat 1: fulsh81 folded on the Turn
Seat 2: AlKatrone collected ($48.45)
Seat 3: HerrJanks (button) folded before Flop (didn't bet)
Seat 4: matiko09 (small blind) folded before Flop
Seat 5: toprmaw (big blind) folded before Flop
Seat 6: ilaviiitech folded before Flop (didn't bet)
Seat 7: suddend3ath folded before Flop (didn't bet)
Seat 8: nickreason17 folded before Flop (didn't bet)
Seat 9: IseeUcards folded before Flop (didn't bet)





PokerStars Hand #153149096946:  Hold'em No Limit ($1/$2 USD) - 2016/05/11 9:57:27 CET [2016/05/11 3:57:27 ET]
Table 'Pyrrha' 9-max Seat #5 is the button
Seat 1: matiko09 ($260.65 in chips) 
Seat 2: AlKatrone ($255.77 in chips) 
Seat 3: HerrJanks ($200 in chips) 
Seat 4: toprmaw ($230.30 in chips) 
Seat 5: suddend3ath ($271.62 in chips) 
Seat 6: semaantarek ($200 in chips) 
Seat 7: BigNickyy ($206.98 in chips) 
Seat 9: Piniker85 ($209.03 in chips) 
semaantarek: posts small blind $1
BigNickyy: posts big blind $2
IseeUcards: sits out 
*** HOLE CARDS ***
Dealt to matiko09 [6c 5d]
Piniker85: folds 
matiko09: folds 
AlKatrone: raises $4 to $6
HerrJanks: folds 
toprmaw: folds 
suddend3ath: calls $6
semaantarek: calls $5
BigNickyy: folds 
*** FLOP *** [6h Th 3s]
semaantarek: checks 
AlKatrone: bets $12
suddend3ath: calls $12
semaantarek: folds 
*** TURN *** [6h Th 3s] [Js]
AlKatrone: checks 
suddend3ath: bets $28
AlKatrone: calls $28
*** RIVER *** [6h Th 3s Js] [Ac]
AlKatrone: checks 
suddend3ath: checks 
*** SHOW DOWN ***
AlKatrone: shows [Jh Qh] (a pair of Jacks)
suddend3ath: shows [Kc Kd] (a pair of Kings)
suddend3ath collected $97.25 from pot
*** SUMMARY ***
Total pot $100 | Rake $2.75 
Board [6h Th 3s Js Ac]
Seat 1: matiko09 folded before Flop (didn't bet)
Seat 2: AlKatrone showed [Jh Qh] and lost with a pair of Jacks
Seat 3: HerrJanks folded before Flop (didn't bet)
Seat 4: toprmaw folded before Flop (didn't bet)
Seat 5: suddend3ath (button) showed [Kc Kd] and won ($97.25) with a pair of Kings
Seat 6: semaantarek (small blind) folded on the Flop
Seat 7: BigNickyy (big blind) folded before Flop
Seat 9: Piniker85 folded before Flop (didn't bet)





PokerStars Hand #153149098101:  Hold'em No Limit ($0.50/$1.00 USD) - 2016/05/11 9:57:32 CET [2016/05/11 3:57:32 ET]
Table 'Eukrate II' 9-max Seat #2 is the button
Seat 1: rolik374 ($37.50 in chips) 
Seat 2: matiko09 ($100 in chips) 
Seat 3: ilaviiitech ($105.50 in chips) 
Seat 4: nickreason17 ($100 in chips) 
Seat 5: flk.Dasas ($100 in chips) 
ilaviiitech: posts small blind $0.50
nickreason17: posts big blind $1
Dantist1122: sits out 
Yeomine: sits out 
ebashupoker: sits out 
IseeUcards: sits out 
*** HOLE CARDS ***
Dealt to matiko09 [5s Qh]
flk.Dasas: folds 
rolik374: folds 
matiko09: folds 
ilaviiitech: folds 
Uncalled bet ($0.50) returned to nickreason17
nickreason17 collected $1 from pot
*** SUMMARY ***
Total pot $1 | Rake $0 
Seat 1: rolik374 folded before Flop (didn't bet)
Seat 2: matiko09 (button) folded before Flop (didn't bet)
Seat 3: ilaviiitech (small blind) folded before Flop
Seat 4: nickreason17 (big blind) collected ($1)
Seat 5: flk.Dasas folded before Flop (didn't bet)





PokerStars Hand #153149098630:  Hold'em No Limit ($0.50/$1.00 USD) - 2016/05/11 9:57:34 CET [2016/05/11 3:57:34 ET]
Table 'Sun' 9-max Seat #5 is the button
Seat 1: myatiy 96 ($101.12 in chips) 
Seat 2: jojohny0211 ($104.12 in chips) 
Seat 4: jd20102007 ($33.61 in chips) 
Seat 5: AlKatrone ($100 in chips) 
Seat 6: matiko09 ($100.50 in chips) 
Seat 7: ilaviiitech ($109.55 in chips) 
Seat 9: toprmaw ($100 in chips) 
matiko09: posts small blind $0.50
ilaviiitech: posts big blind $1
mycka86: sits out 
*** HOLE CARDS ***
Dealt to matiko09 [3c 9c]
toprmaw: folds 
myatiy 96: folds 
jojohny0211: folds 
jd20102007: folds 
AlKatrone: folds 
matiko09: raises $2 to $3
ilaviiitech: folds 
Uncalled bet ($2) returned to matiko09
matiko09 collected $2 from pot
matiko09: doesn't show hand 
*** SUMMARY ***
Total pot $2 | Rake $0 
Seat 1: myatiy 96 folded before Flop (didn't bet)
Seat 2: jojohny0211 folded before Flop (didn't bet)
Seat 4: jd20102007 folded before Flop (didn't bet)
Seat 5: AlKatrone (button) folded before Flop (didn't bet)
Seat 6: matiko09 (small blind) collected ($2)
Seat 7: ilaviiitech (big blind) folded before Flop
Seat 9: toprmaw folded before Flop (didn't bet)





PokerStars Hand #153149101960:  Hold'em No Limit ($0.50/$1.00 USD) - 2016/05/11 9:57:46 CET [2016/05/11 3:57:46 ET]
Table 'Eukrate II' 9-max Seat #3 is the button
Seat 1: rolik374 ($37.50 in chips) 
Seat 2: matiko09 ($100 in chips) 
Seat 3: ilaviiitech ($105 in chips) 
Seat 4: nickreason17 ($100.50 in chips) 
Seat 5: flk.Dasas ($100 in chips) 
nickreason17: posts small blind $0.50
flk.Dasas: posts big blind $1
Dantist1122: sits out 
Yeomine: sits out 
ebashupoker: sits out 
IseeUcards: sits out 
*** HOLE CARDS ***
Dealt to matiko09 [8c 7c]
rolik374: folds 
matiko09: raises $1.50 to $2.50
ilaviiitech: folds 
nickreason17: folds 
flk.Dasas: folds 
Uncalled bet ($1.50) returned to matiko09
matiko09 collected $2.50 from pot
matiko09: doesn't show hand 
*** SUMMARY ***
Total pot $2.50 | Rake $0 
Seat 1: rolik374 folded before Flop (didn't bet)
Seat 2: matiko09 collected ($2.50)
Seat 3: ilaviiitech (button) folded before Flop (didn't bet)
Seat 4: nickreason17 (small blind) folded before Flop
Seat 5: flk.Dasas (big blind) folded before Flop





PokerStars Hand #153149108149:  Hold'em No Limit ($0.50/$1.00 USD) - 2016/05/11 9:58:09 CET [2016/05/11 3:58:09 ET]
Table 'Eukrate II' 9-max Seat #4 is the button
Seat 1: rolik374 ($37.50 in chips) 
Seat 2: matiko09 ($101.50 in chips) 
Seat 3: ilaviiitech ($105 in chips) 
Seat 4: nickreason17 ($100 in chips) 
Seat 5: flk.Dasas ($100 in chips) 
Seat 6: Dantist1122 ($100 in chips) 
flk.Dasas: posts small blind $0.50
Dantist1122: posts big blind $1
Yeomine: sits out 
ebashupoker: sits out 
IseeUcards: sits out 
*** HOLE CARDS ***
Dealt to matiko09 [Qs 6h]
rolik374: folds 
matiko09: folds 
ilaviiitech: folds 
nickreason17: raises $1 to $2
flk.Dasas: folds 
Dantist1122: calls $1
*** FLOP *** [5c Ts Jc]
Dantist1122: checks 
nickreason17: bets $3.21
Dantist1122: calls $3.21
*** TURN *** [5c Ts Jc] [6c]
Dantist1122: checks 
nickreason17: checks 
*** RIVER *** [5c Ts Jc 6c] [5d]
Dantist1122: bets $6.74
nickreason17: calls $6.74
*** SHOW DOWN ***
Dantist1122: shows [Qc Jd] (two pair, Jacks and Fives)
nickreason17: shows [Ks Kh] (two pair, Kings and Fives)
nickreason17 collected $23.18 from pot
*** SUMMARY ***
Total pot $24.40 | Rake $1.22 
Board [5c Ts Jc 6c 5d]
Seat 1: rolik374 folded before Flop (didn't bet)
Seat 2: matiko09 folded before Flop (didn't bet)
Seat 3: ilaviiitech folded before Flop (didn't bet)
Seat 4: nickreason17 (button) showed [Ks Kh] and won ($23.18) with two pair, Kings and Fives
Seat 5: flk.Dasas (small blind) folded before Flop
Seat 6: Dantist1122 (big blind) showed [Qc Jd] and lost with two pair, Jacks and Fives





PokerStars Hand #153149108528:  Hold'em No Limit ($0.50/$1.00 USD) - 2016/05/11 9:58:11 CET [2016/05/11 3:58:11 ET]
Table 'Sun' 9-max Seat #6 is the button
Seat 1: myatiy 96 ($101.12 in chips) 
Seat 2: jojohny0211 ($104.12 in chips) 
Seat 4: jd20102007 ($33.61 in chips) 
Seat 5: AlKatrone ($100 in chips) 
Seat 6: matiko09 ($101.50 in chips) 
Seat 7: ilaviiitech ($108.55 in chips) 
Seat 9: toprmaw ($100 in chips) 
ilaviiitech: posts small blind $0.50
toprmaw: posts big blind $1
mycka86: sits out 
*** HOLE CARDS ***
Dealt to matiko09 [9s Th]
myatiy 96: folds 
jojohny0211: folds 
jd20102007: folds 
AlKatrone: raises $1 to $2
matiko09: folds 
ilaviiitech: calls $1.50
toprmaw: folds 
*** FLOP *** [Ad 6h 9c]
ilaviiitech: checks 
AlKatrone: checks 
*** TURN *** [Ad 6h 9c] [Kc]
ilaviiitech: bets $3.08
AlKatrone: folds 
Uncalled bet ($3.08) returned to ilaviiitech
ilaviiitech collected $4.75 from pot
ilaviiitech: doesn't show hand 
*** SUMMARY ***
Total pot $5 | Rake $0.25 
Board [Ad 6h 9c Kc]
Seat 1: myatiy 96 folded before Flop (didn't bet)
Seat 2: jojohny0211 folded before Flop (didn't bet)
Seat 4: jd20102007 folded before Flop (didn't bet)
Seat 5: AlKatrone folded on the Turn
Seat 6: matiko09 (button) folded before Flop (didn't bet)
Seat 7: ilaviiitech (small blind) collected ($4.75)
Seat 9: toprmaw (big blind) folded before Flop





PokerStars Hand #153149115498:  Hold'em No Limit ($1/$2 USD) - 2016/05/11 9:58:37 CET [2016/05/11 3:58:37 ET]
Table 'Almach' 9-max Seat #4 is the button
Seat 1: fulsh81 ($100.75 in chips) 
Seat 2: AlKatrone ($231.50 in chips) 
Seat 3: HerrJanks ($200 in chips) 
Seat 4: matiko09 ($213.75 in chips) 
Seat 5: toprmaw ($200 in chips) 
Seat 6: ilaviiitech ($200 in chips) 
Seat 7: suddend3ath ($201 in chips) 
Seat 8: nickreason17 ($217.40 in chips) 
Seat 9: IseeUcards ($200 in chips) 
toprmaw: posts small blind $1
ilaviiitech: posts big blind $2
*** HOLE CARDS ***
Dealt to matiko09 [Kd 5s]
suddend3ath: folds 
nickreason17: folds 
IseeUcards: folds 
fulsh81: folds 
AlKatrone: folds 
HerrJanks: raises $3 to $5
matiko09: folds 
toprmaw: raises $12 to $17
ilaviiitech: folds 
HerrJanks: calls $12
*** FLOP *** [Ks 5h 7s]
toprmaw: checks 
HerrJanks: checks 
*** TURN *** [Ks 5h 7s] [Jc]
toprmaw: checks 
HerrJanks: checks 
*** RIVER *** [Ks 5h 7s Jc] [Ad]
toprmaw: checks 
HerrJanks: checks 
*** SHOW DOWN ***
toprmaw: shows [9c 9d] (a pair of Nines)
HerrJanks: shows [Qh Jh] (a pair of Jacks)
HerrJanks collected $34.20 from pot
*** SUMMARY ***
Total pot $36 | Rake $1.80 
Board [Ks 5h 7s Jc Ad]
Seat 1: fulsh81 folded before Flop (didn't bet)
Seat 2: AlKatrone folded before Flop (didn't bet)
Seat 3: HerrJanks showed [Qh Jh] and won ($34.20) with a pair of Jacks
Seat 4: matiko09 (button) folded before Flop (didn't bet)
Seat 5: toprmaw (small blind) showed [9c 9d] and lost with a pair of Nines
Seat 6: ilaviiitech (big blind) folded before Flop
Seat 7: suddend3ath folded before Flop (didn't bet)
Seat 8: nickreason17 folded before Flop (didn't bet)
Seat 9: IseeUcards folded before Flop (didn't bet)





PokerStars Hand #153149118398:  Hold'em No Limit ($1/$2 USD) - 2016/05/11 9:58:47 CET [2016/05/11 3:58:47 ET]
Table 'Pyrrha' 9-max Seat #6 is the button
Seat 1: matiko09 ($260.65 in chips) 
Seat 2: AlKatrone ($209.77 in chips) 
Seat 3: HerrJanks ($200 in chips) 
Seat 4: toprmaw ($230.30 in chips) 
Seat 5: suddend3ath ($322.87 in chips) 
Seat 6: semaantarek ($194 in chips) 
Seat 7: BigNickyy ($204.98 in chips) 
Seat 8: IseeUcards ($200 in chips) 
Seat 9: Piniker85 ($209.03 in chips) 
BigNickyy: posts small blind $1
IseeUcards: posts big blind $2
*** HOLE CARDS ***
Dealt to matiko09 [2c Qd]
Piniker85: folds 
matiko09: folds 
AlKatrone: folds 
HerrJanks: folds 
toprmaw: folds 
suddend3ath: raises $3 to $5
semaantarek: folds 
BigNickyy: folds 
IseeUcards: calls $3
*** FLOP *** [5c 9d Qs]
IseeUcards: checks 
suddend3ath: checks 
*** TURN *** [5c 9d Qs] [Jd]
IseeUcards: checks 
suddend3ath: bets $7
IseeUcards: calls $7
*** RIVER *** [5c 9d Qs Jd] [5s]
IseeUcards: checks 
suddend3ath: checks 
*** SHOW DOWN ***
IseeUcards: shows [7c 9c] (two pair, Nines and Fives)
suddend3ath: mucks hand 
IseeUcards collected $23.75 from pot
*** SUMMARY ***
Total pot $25 | Rake $1.25 
Board [5c 9d Qs Jd 5s]
Seat 1: matiko09 folded before Flop (didn't bet)
Seat 2: AlKatrone folded before Flop (didn't bet)
Seat 3: HerrJanks folded before Flop (didn't bet)
Seat 4: toprmaw folded before Flop (didn't bet)
Seat 5: suddend3ath mucked [Ah Th]
Seat 6: semaantarek (button) folded before Flop (didn't bet)
Seat 7: BigNickyy (small blind) folded before Flop
Seat 8: IseeUcards (big blind) showed [7c 9c] and won ($23.75) with two pair, Nines and Fives
Seat 9: Piniker85 folded before Flop (didn't bet)





PokerStars Hand #153149123972:  Hold'em No Limit ($0.50/$1.00 USD) - 2016/05/11 9:59:08 CET [2016/05/11 3:59:08 ET]
Table 'Eukrate II' 9-max Seat #5 is the button
Seat 1: rolik374 ($37.50 in chips) 
Seat 2: matiko09 ($101.50 in chips) 
Seat 3: ilaviiitech ($105 in chips) 
Seat 4: nickreason17 ($111.23 in chips) 
Seat 5: flk.Dasas ($100 in chips) 
Seat 6: Dantist1122 ($100 in chips) 
Seat 7: Yeomine ($40 in chips) 
Dantist1122: posts small blind $0.50
Yeomine: posts big blind $1
ebashupoker: sits out 
IseeUcards: sits out 
*** HOLE CARDS ***
Dealt to matiko09 [9h Ac]
rolik374: folds 
matiko09: folds 
ilaviiitech: folds 
nickreason17: raises $1.50 to $2.50
flk.Dasas: folds 
Dantist1122: raises $6.50 to $9
Yeomine: folds 
nickreason17: folds 
Uncalled bet ($6.50) returned to Dantist1122
Yeomine leaves the table
Dantist1122 collected $6 from pot
Dantist1122: doesn't show hand 
*** SUMMARY ***
Total pot $6 | Rake $0 
Seat 1: rolik374 folded before Flop (didn't bet)
Seat 2: matiko09 folded before Flop (didn't bet)
Seat 3: ilaviiitech folded before Flop (didn't bet)
Seat 4: nickreason17 folded before Flop
Seat 5: flk.Dasas (button) folded before Flop (didn't bet)
Seat 6: Dantist1122 (small blind) collected ($6)
Seat 7: Yeomine (big blind) folded before Flop





PokerStars Hand #153149127339:  Hold'em No Limit ($0.50/$1.00 USD) - 2016/05/11 9:59:21 CET [2016/05/11 3:59:21 ET]
Table 'Sun' 9-max Seat #7 is the button
Seat 1: myatiy 96 ($101.12 in chips) 
Seat 2: jojohny0211 ($104.12 in chips) 
Seat 4: jd20102007 ($33.61 in chips) 
Seat 5: AlKatrone ($100 in chips) 
Seat 6: matiko09 ($101.50 in chips) 
Seat 7: ilaviiitech ($111.30 in chips) 
Seat 9: toprmaw ($100 in chips) 
Glushchenko will be allowed to play after the button
toprmaw: posts small blind $0.50
myatiy 96: posts big blind $1
mycka86: sits out 
*** HOLE CARDS ***
Dealt to matiko09 [Ks Qh]
jojohny0211: raises $2 to $3
jd20102007: folds 
AlKatrone: folds 
matiko09: folds 
ilaviiitech: folds 
toprmaw: folds 
myatiy 96: calls $2
*** FLOP *** [5s Qs 2c]
myatiy 96: checks 
jojohny0211: checks 
*** TURN *** [5s Qs 2c] [4s]
myatiy 96: checks 
jojohny0211: bets $2
myatiy 96: calls $2
*** RIVER *** [5s Qs 2c 4s] [3d]
myatiy 96: checks 
jojohny0211: bets $5.89
myatiy 96: calls $5.89
*** SHOW DOWN ***
jojohny0211: shows [6h 6c] (a straight, Deuce to Six)
myatiy 96: mucks hand 
jojohny0211 collected $21.17 from pot
*** SUMMARY ***
Total pot $22.28 | Rake $1.11 
Board [5s Qs 2c 4s 3d]
Seat 1: myatiy 96 (big blind) mucked [Qd Ad]
Seat 2: jojohny0211 showed [6h 6c] and won ($21.17) with a straight, Deuce to Six
Seat 4: jd20102007 folded before Flop (didn't bet)
Seat 5: AlKatrone folded before Flop (didn't bet)
Seat 6: matiko09 folded before Flop (didn't bet)
Seat 7: ilaviiitech (button) folded before Flop (didn't bet)
Seat 9: toprmaw (small blind) folded before Flop





PokerStars Hand #153149128160:  Hold'em No Limit ($0.50/$1.00 USD) - 2016/05/11 9:59:24 CET [2016/05/11 3:59:24 ET]
Table 'Frisia' 9-max Seat #5 is the button
Seat 1: matiko09 ($101.50 in chips) 
Seat 2: AlKatrone ($106 in chips) 
Seat 3: flk.Dasas ($110.60 in chips) 
Seat 4: ilaviiitech ($100 in chips) 
Seat 5: toprmaw ($100 in chips) 
Seat 6: teerajaja ($100 in chips) 
Seat 7: Glushchenko ($100 in chips) 
Seat 8: vanilica ($100 in chips) 
Seat 9: ninomorper ($97.78 in chips) 
teerajaja: posts small blind $0.50
Glushchenko: posts big blind $1
*** HOLE CARDS ***
Dealt to matiko09 [2h 8s]
vanilica: folds 
ninomorper: folds 
matiko09: folds 
AlKatrone: folds 
flk.Dasas: folds 
ilaviiitech: folds 
toprmaw: raises $2 to $3
teerajaja: folds 
Glushchenko: folds 
Uncalled bet ($2) returned to toprmaw
toprmaw collected $2.50 from pot
toprmaw: doesn't show hand 
*** SUMMARY ***
Total pot $2.50 | Rake $0 
Seat 1: matiko09 folded before Flop (didn't bet)
Seat 2: AlKatrone folded before Flop (didn't bet)
Seat 3: flk.Dasas folded before Flop (didn't bet)
Seat 4: ilaviiitech folded before Flop (didn't bet)
Seat 5: toprmaw (button) collected ($2.50)
Seat 6: teerajaja (small blind) folded before Flop
Seat 7: Glushchenko (big blind) folded before Flop
Seat 8: vanilica folded before Flop (didn't bet)
Seat 9: ninomorper folded before Flop (didn't bet)





PokerStars Hand #153149131243:  Hold'em No Limit ($0.50/$1.00 USD) - 2016/05/11 9:59:35 CET [2016/05/11 3:59:35 ET]
Table 'Eukrate II' 9-max Seat #6 is the button
Seat 1: rolik374 ($37.50 in chips) 
Seat 2: matiko09 ($101.50 in chips) 
Seat 3: ilaviiitech ($105 in chips) 
Seat 4: nickreason17 ($108.73 in chips) 
Seat 5: flk.Dasas ($100 in chips) 
Seat 6: Dantist1122 ($103.50 in chips) 
ebashupoker will be allowed to play after the button
IseeUcards will be allowed to play after the button
rolik374: posts small blind $0.50
matiko09: posts big blind $1
*** HOLE CARDS ***
Dealt to matiko09 [8h 5c]
ilaviiitech: raises $2 to $3
teerajaja joins the table at seat #7 
nickreason17: calls $3
flk.Dasas: folds 
Dantist1122: folds 
rolik374: folds 
matiko09: folds 
*** FLOP *** [6d Kh 7c]
ilaviiitech: bets $4.62
nickreason17: calls $4.62
*** TURN *** [6d Kh 7c] [3d]
ilaviiitech: bets $10.33
nickreason17: folds 
Uncalled bet ($10.33) returned to ilaviiitech
ilaviiitech collected $15.90 from pot
ilaviiitech: doesn't show hand 
*** SUMMARY ***
Total pot $16.74 | Rake $0.84 
Board [6d Kh 7c 3d]
Seat 1: rolik374 (small blind) folded before Flop
Seat 2: matiko09 (big blind) folded before Flop
Seat 3: ilaviiitech collected ($15.90)
Seat 4: nickreason17 folded on the Turn
Seat 5: flk.Dasas folded before Flop (didn't bet)
Seat 6: Dantist1122 (button) folded before Flop (didn't bet)





PokerStars Hand #153149134748:  Hold'em No Limit ($1/$2 USD) - 2016/05/11 9:59:48 CET [2016/05/11 3:59:48 ET]
Table 'Pyrrha' 9-max Seat #7 is the button
Seat 1: matiko09 ($260.65 in chips) 
Seat 2: AlKatrone ($209.77 in chips) 
Seat 3: HerrJanks ($200 in chips) 
Seat 4: toprmaw ($230.30 in chips) 
Seat 5: suddend3ath ($310.87 in chips) 
Seat 6: semaantarek ($194 in chips) 
Seat 7: BigNickyy ($203.98 in chips) 
Seat 8: IseeUcards ($211.75 in chips) 
Seat 9: Piniker85 ($209.03 in chips) 
IseeUcards: posts small blind $1
Piniker85: posts big blind $2
*** HOLE CARDS ***
Dealt to matiko09 [Th 9s]
matiko09: folds 
AlKatrone: raises $4 to $6
HerrJanks: folds 
toprmaw: folds 
suddend3ath: folds 
semaantarek: folds 
BigNickyy: raises $10 to $16
IseeUcards: folds 
Piniker85: folds 
AlKatrone: folds 
Uncalled bet ($10) returned to BigNickyy
BigNickyy collected $15 from pot
BigNickyy: doesn't show hand 
*** SUMMARY ***
Total pot $15 | Rake $0 
Seat 1: matiko09 folded before Flop (didn't bet)
Seat 2: AlKatrone folded before Flop
Seat 3: HerrJanks folded before Flop (didn't bet)
Seat 4: toprmaw folded before Flop (didn't bet)
Seat 5: suddend3ath folded before Flop (didn't bet)
Seat 6: semaantarek folded before Flop (didn't bet)
Seat 7: BigNickyy (button) collected ($15)
Seat 8: IseeUcards (small blind) folded before Flop
Seat 9: Piniker85 (big blind) folded before Flop





PokerStars Hand #153149136301:  Hold'em No Limit ($1/$2 USD) - 2016/05/11 9:59:54 CET [2016/05/11 3:59:54 ET]
Table 'Almach' 9-max Seat #5 is the button
Seat 1: fulsh81 ($100.75 in chips) 
Seat 2: AlKatrone ($231.50 in chips) 
Seat 3: HerrJanks ($217.20 in chips) 
Seat 4: matiko09 ($213.75 in chips) 
Seat 5: toprmaw ($200 in chips) 
Seat 6: ilaviiitech ($200 in chips) 
Seat 7: suddend3ath ($201 in chips) 
Seat 8: nickreason17 ($217.40 in chips) 
Seat 9: IseeUcards ($200 in chips) 
ilaviiitech: posts small blind $1
suddend3ath: posts big blind $2
*** HOLE CARDS ***
Dealt to matiko09 [9d 4c]
nickreason17: folds 
IseeUcards: folds 
fulsh81: calls $2
AlKatrone: folds 
HerrJanks: folds 
matiko09: folds 
toprmaw: folds 
ilaviiitech: folds 
suddend3ath: raises $6 to $8
fulsh81: calls $6
*** FLOP *** [2h 5s Ks]
suddend3ath: bets $10
fulsh81: calls $10
*** TURN *** [2h 5s Ks] [4h]
suddend3ath: bets $22
fulsh81: folds 
Uncalled bet ($22) returned to suddend3ath
suddend3ath collected $35.15 from pot
suddend3ath: doesn't show hand 
*** SUMMARY ***
Total pot $37 | Rake $1.85 
Board [2h 5s Ks 4h]
Seat 1: fulsh81 folded on the Turn
Seat 2: AlKatrone folded before Flop (didn't bet)
Seat 3: HerrJanks folded before Flop (didn't bet)
Seat 4: matiko09 folded before Flop (didn't bet)
Seat 5: toprmaw (button) folded before Flop (didn't bet)
Seat 6: ilaviiitech (small blind) folded before Flop
Seat 7: suddend3ath (big blind) collected ($35.15)
Seat 8: nickreason17 folded before Flop (didn't bet)
Seat 9: IseeUcards folded before Flop (didn't bet)





PokerStars Hand #153149139818:  Hold'em No Limit ($0.50/$1.00 USD) - 2016/05/11 10:00:07 CET [2016/05/11 4:00:07 ET]
Table 'Irenaea' 9-max Seat #2 is the button
Seat 1: nickreason17 ($113 in chips) 
Seat 2: suddend3ath ($100 in chips) 
Seat 3: Jersey197022 ($178.15 in chips) 
Seat 4: matiko09 ($100 in chips) 
Seat 5: picka4u ($90 in chips) 
Seat 6: braindamage8 ($133.92 in chips) 
Seat 8: toprmaw ($240.62 in chips) 
Seat 9: BKA12 ($103.94 in chips) 
Jersey197022: posts small blind $0.50
matiko09: posts big blind $1
myatiy 96: sits out 
*** HOLE CARDS ***
Dealt to matiko09 [9c Jd]
picka4u: folds 
braindamage8: folds 
toprmaw: folds 
BKA12: folds 
nickreason17: folds 
suddend3ath: folds 
Jersey197022: raises $1 to $2
matiko09: calls $1
*** FLOP *** [Th 3h 9h]
Jersey197022: bets $1.90
matiko09: calls $1.90
*** TURN *** [Th 3h 9h] [Ah]
Jersey197022: bets $1
matiko09: folds 
Uncalled bet ($1) returned to Jersey197022
Jersey197022 collected $7.41 from pot
Jersey197022: doesn't show hand 
*** SUMMARY ***
Total pot $7.80 | Rake $0.39 
Board [Th 3h 9h Ah]
Seat 1: nickreason17 folded before Flop (didn't bet)
Seat 2: suddend3ath (button) folded before Flop (didn't bet)
Seat 3: Jersey197022 (small blind) collected ($7.41)
Seat 4: matiko09 (big blind) folded on the Turn
Seat 5: picka4u folded before Flop (didn't bet)
Seat 6: braindamage8 folded before Flop (didn't bet)
Seat 8: toprmaw folded before Flop (didn't bet)
Seat 9: BKA12 folded before Flop (didn't bet)





PokerStars Hand #153149141340:  Hold'em No Limit ($0.50/$1.00 USD) - 2016/05/11 10:00:12 CET [2016/05/11 4:00:12 ET]
Table 'Frisia' 9-max Seat #6 is the button
Seat 1: matiko09 ($101.50 in chips) 
Seat 2: AlKatrone ($106 in chips) 
Seat 3: flk.Dasas ($110.60 in chips) 
Seat 4: ilaviiitech ($100 in chips) 
Seat 5: toprmaw ($101.50 in chips) 
Seat 6: teerajaja ($100 in chips) 
Seat 7: Glushchenko ($100 in chips) 
Seat 9: ninomorper ($97.78 in chips) 
Glushchenko: posts small blind $0.50
vanilica: is sitting out 
ninomorper: posts big blind $1
*** HOLE CARDS ***
Dealt to matiko09 [4h 7s]
vanilica leaves the table
mycka86 joins the table at seat #8 
matiko09: folds 
AlKatrone has timed out
AlKatrone: folds 
flk.Dasas: folds 
ilaviiitech: raises $2 to $3
toprmaw: folds 
teerajaja: folds 
Glushchenko: calls $2.50
ninomorper: folds 
*** FLOP *** [7h Tc 3d]
Glushchenko: checks 
ilaviiitech: checks 
*** TURN *** [7h Tc 3d] [Th]
Glushchenko: checks 
ilaviiitech: checks 
*** RIVER *** [7h Tc 3d Th] [2h]
Glushchenko: checks 
ilaviiitech: checks 
*** SHOW DOWN ***
Glushchenko: shows [Kd Jd] (a pair of Tens)
ilaviiitech: mucks hand 
Glushchenko collected $6.65 from pot
*** SUMMARY ***
Total pot $7 | Rake $0.35 
Board [7h Tc 3d Th 2h]
Seat 1: matiko09 folded before Flop (didn't bet)
Seat 2: AlKatrone folded before Flop (didn't bet)
Seat 3: flk.Dasas folded before Flop (didn't bet)
Seat 4: ilaviiitech mucked [Jc Qc]
Seat 5: toprmaw folded before Flop (didn't bet)
Seat 6: teerajaja (button) folded before Flop (didn't bet)
Seat 7: Glushchenko (small blind) showed [Kd Jd] and won ($6.65) with a pair of Tens
Seat 9: ninomorper (big blind) folded before Flop





